profile,name,age,iban,trx_id,timestamp,city,trx_type,trx_cat,amount_eur,balance
buyer_1,Luis,28,ES18209585214414889696,TRX_N-00001-34331689,2022-01-01T04:27:18,Bilbao,incomes,salary,1320.37,2596.36
buyer_1,Luis,28,ES18209585214414889696,TRX_N-00002-15014737,2022-01-01T04:27:18,Bilbao,incomes,salary_partner,1021.78,3618.14
buyer_1,Luis,28,ES18209585214414889696,TRX_N-00003-77486226,2022-01-02T22:50:46,Bilbao,expenses,children,-69.89,3548.25
buyer_1,Luis,28,ES18209585214414889696,TRX_N-00004-80344654,2022-01-04T08:33:56,Bilbao,expenses,mortgage,-1090.03,2458.22
buyer_1,Luis,28,ES18209585214414889696,TRX_N-00005-25899786,2022-01-04T20:44:42,Bilbao,expenses,transport,-83.4,2374.82
buyer_1,Luis,28,ES18209585214414889696,TRX_N-00006-54176462,2022-01-05T15:20:23,Bilbao,expenses,water,-41.53,2333.29
buyer_1,Luis,28,ES18209585214414889696,TRX_N-00007-09466988,2022-01-05T20:49:35,Bilbao,expenses,electricity,-52.99,2280.3
buyer_1,Luis,28,ES18209585214414889696,TRX_N-00008-68699661,2022-01-05T12:46:36,Bilbao,expenses,gas,-76.78,2203.52
buyer_1,Luis,28,ES18209585214414889696,TRX_N-00009-26048236,2022-01-05T16:57:49,Bilbao,expenses,food,-113.55,2089.97
buyer_1,Luis,28,ES18209585214414889696,TRX_N-00010-72945105,2022-01-05T23:38:42,Bilbao,expenses,clothing,-45.99,2043.98
buyer_1,Luis,28,ES18209585214414889696,TRX_N-00011-29736191,2022-01-06T14:39:38,Bilbao,expenses,repairs,-202.33,1841.65
buyer_1,Luis,28,ES18209585214414889696,TRX_N-00012-66582083,2022-01-07T13:08:27,Bilbao,expenses,internet,-42.0,1799.65
buyer_1,Luis,28,ES18209585214414889696,TRX_N-00013-68752466,2022-01-07T08:32:51,Bilbao,expenses,cash,-100.0,1699.65
buyer_1,Luis,28,ES18209585214414889696,TRX_N-00014-99668952,2022-01-08T14:16:02,Bilbao,expenses,phone,-40.23,1659.42
buyer_1,Luis,28,ES18209585214414889696,TRX_N-00015-50608669,2022-01-09T02:52:41,Bilbao,expenses,education,-48.07,1611.35
buyer_1,Luis,28,ES18209585214414889696,TRX_N-00016-17574187,2022-01-09T17:29:45,Bilbao,expenses,cash,-100.0,1511.35
buyer_1,Luis,28,ES18209585214414889696,TRX_N-00017-22144653,2022-01-10T10:48:56,Bilbao,expenses,transport,-77.01,1434.34
buyer_1,Luis,28,ES18209585214414889696,TRX_N-00018-23201236,2022-01-11T19:35:23,Bilbao,expenses,education,-69.1,1365.24
buyer_1,Luis,28,ES18209585214414889696,TRX_N-00019-43955417,2022-01-11T01:31:09,Bilbao,expenses,cash,-100.0,1265.24
buyer_1,Luis,28,ES18209585214414889696,TRX_N-00020-02277464,2022-01-12T11:31:40,Bilbao,expenses,healthcare,-157.67,1107.57
buyer_1,Luis,28,ES18209585214414889696,TRX_N-00021-41342701,2022-01-13T15:57:24,Bilbao,expenses,gifts,-799.52,308.05
buyer_1,Luis,28,ES18209585214414889696,TRX_N-00022-31088784,2022-01-14T21:57:41,Bilbao,expenses,leisure,-31.45,276.6
buyer_1,Luis,28,ES18209585214414889696,TRX_N-00023-29232612,2022-01-15T10:13:05,Bilbao,expenses,food,-120.37,156.23
buyer_1,Luis,28,ES18209585214414889696,TRX_N-00024-13493709,2022-01-15T18:31:18,Bilbao,expenses,leisure,-73.46,82.77
buyer_1,Luis,28,ES18209585214414889696,TRX_N-00025-46400368,2022-01-18T06:41:04,Bilbao,expenses,food,-117.69,-34.92
buyer_1,Luis,28,ES18209585214414889696,TRX_N-00026-86425040,2022-01-22T12:33:51,Bilbao,expenses,cash,-100.0,-134.92
buyer_1,Luis,28,ES18209585214414889696,TRX_N-00027-70590813,2022-01-22T20:08:48,Bilbao,expenses,repairs,-307.6,-442.52
buyer_1,Luis,28,ES18209585214414889696,TRX_N-00028-73874096,2022-01-23T15:24:28,Bilbao,expenses,cash,-100.0,-542.52
buyer_1,Luis,28,ES18209585214414889696,TRX_N-00029-86349940,2022-01-28T20:05:16,Arrasate,expenses,food,-105.06,-647.58
buyer_1,Luis,28,ES18209585214414889696,TRX_N-00030-93568509,2022-01-28T22:00:42,Bilbao,expenses,cash,-100.0,-747.58
buyer_1,Luis,28,ES18209585214414889696,TRX_N-00031-30198754,2022-01-29T16:08:46,Bilbao,expenses,clothing,-153.17,-900.75
buyer_1,Luis,28,ES18209585214414889696,TRX_N-00032-72409021,2022-01-30T13:14:16,Bilbao,expenses,education,-77.11,-977.86
buyer_1,Luis,28,ES18209585214414889696,TRX_N-00033-88458077,2022-02-01T13:17:51,Bilbao,incomes,salary,1320.37,342.51
buyer_1,Luis,28,ES18209585214414889696,TRX_N-00034-54556815,2022-02-01T13:17:51,Bilbao,incomes,salary_partner,1021.78,1364.29
buyer_1,Luis,28,ES18209585214414889696,TRX_N-00035-38240985,2022-02-02T16:58:56,Bilbao,expenses,food,-76.74,1287.55
buyer_1,Luis,28,ES18209585214414889696,TRX_N-00036-57989864,2022-02-03T08:01:25,Barakaldo,expenses,food,-118.67,1168.88
buyer_1,Luis,28,ES18209585214414889696,TRX_N-00037-54929361,2022-02-04T20:44:49,Bilbao,expenses,mortgage,-1090.03,78.85
buyer_1,Luis,28,ES18209585214414889696,TRX_N-00038-42249371,2022-02-04T10:26:00,Zarautz,expenses,food,-82.46,-3.61
buyer_1,Luis,28,ES18209585214414889696,TRX_N-00039-14590910,2022-02-04T21:01:14,Berango,expenses,appliances,-371.77,-375.38
buyer_1,Luis,28,ES18209585214414889696,TRX_N-00040-63591039,2022-02-05T11:45:24,Bilbao,expenses,internet,-42.0,-417.38
buyer_1,Luis,28,ES18209585214414889696,TRX_N-00041-67059580,2022-02-05T13:36:33,Bilbao,expenses,phone,-37.39,-454.77
buyer_1,Luis,28,ES18209585214414889696,TRX_N-00042-94193090,2022-02-06T21:38:39,Bilbao,expenses,water,-27.41,-482.18
buyer_1,Luis,28,ES18209585214414889696,TRX_N-00043-82249380,2022-02-06T17:22:34,Bilbao,expenses,electricity,-37.67,-519.85
buyer_1,Luis,28,ES18209585214414889696,TRX_N-00044-50669229,2022-02-06T17:28:58,Bilbao,expenses,gas,-41.74,-561.59
buyer_1,Luis,28,ES18209585214414889696,TRX_N-00045-03911704,2022-02-06T20:14:13,Bilbao,expenses,food,-81.93,-643.52
buyer_1,Luis,28,ES18209585214414889696,TRX_N-00046-71570855,2022-02-06T14:13:11,Bilbao,expenses,leisure,-36.71,-680.23
buyer_1,Luis,28,ES18209585214414889696,TRX_N-00047-46740174,2022-02-07T07:33:39,Bilbao,expenses,repairs,-57.02,-737.25
buyer_1,Luis,28,ES18209585214414889696,TRX_N-00048-02712926,2022-02-08T00:17:39,Bilbao,expenses,gifts,-824.84,-1562.09
buyer_1,Luis,28,ES18209585214414889696,TRX_N-00049-21341793,2022-02-09T20:37:46,Bilbao,expenses,leisure,-26.7,-1588.79
buyer_1,Luis,28,ES18209585214414889696,TRX_N-00050-51485400,2022-02-12T23:30:31,Bilbao,expenses,cash,-100.0,-1688.79
buyer_1,Luis,28,ES18209585214414889696,TRX_N-00051-31318400,2022-02-12T09:46:41,Bilbao,expenses,children,-150.86,-1839.65
buyer_1,Luis,28,ES18209585214414889696,TRX_N-00052-05717623,2022-02-13T08:14:45,Bilbao,expenses,food,-71.33,-1910.98
buyer_1,Luis,28,ES18209585214414889696,TRX_N-00053-07390254,2022-02-13T18:07:20,Santurtzi,expenses,education,-69.06,-1980.04
buyer_1,Luis,28,ES18209585214414889696,TRX_N-00054-82434286,2022-02-15T18:08:26,Bilbao,expenses,transport,-64.32,-2044.36
buyer_1,Luis,28,ES18209585214414889696,TRX_N-00055-38089402,2022-02-17T12:47:11,Bilbao,expenses,cash,-100.0,-2144.36
buyer_1,Luis,28,ES18209585214414889696,TRX_N-00056-49137718,2022-02-19T19:46:20,Bilbao,expenses,repairs,-218.99,-2363.35
buyer_1,Luis,28,ES18209585214414889696,TRX_N-00057-44059444,2022-02-20T18:52:00,Bilbao,expenses,food,-86.54,-2449.89
buyer_1,Luis,28,ES18209585214414889696,TRX_N-00058-22961422,2022-02-21T14:03:47,Bilbao,expenses,gifts,-477.48,-2927.37
buyer_1,Luis,28,ES18209585214414889696,TRX_N-00059-11714287,2022-02-23T11:35:23,Bilbao,expenses,food,-80.69,-3008.06
buyer_1,Luis,28,ES18209585214414889696,TRX_N-00060-69287414,2022-02-24T14:41:06,Bilbao,expenses,leisure,-30.26,-3038.32
buyer_1,Luis,28,ES18209585214414889696,TRX_N-00061-53070089,2022-02-24T16:49:45,Hernani,expenses,clothing,-80.98,-3119.3
buyer_1,Luis,28,ES18209585214414889696,TRX_N-00062-18920984,2022-02-25T17:31:19,Santurtzi,expenses,education,-59.85,-3179.15
buyer_1,Luis,28,ES18209585214414889696,TRX_N-00063-64195174,2022-02-26T11:51:31,Bilbao,expenses,repairs,-108.76,-3287.91
buyer_1,Luis,28,ES18209585214414889696,TRX_N-00064-91066958,2022-02-27T04:17:28,Barakaldo,expenses,cash,-100.0,-3387.91
buyer_1,Luis,28,ES18209585214414889696,TRX_N-00065-80625442,2022-02-28T20:00:33,Bilbao,expenses,leisure,-24.75,-3412.66
buyer_1,Luis,28,ES18209585214414889696,TRX_N-00066-40406123,2022-03-01T08:50:02,Bilbao,incomes,salary,1320.37,-2092.29
buyer_1,Luis,28,ES18209585214414889696,TRX_N-00067-44907234,2022-03-01T08:50:02,Bilbao,incomes,salary_partner,1021.78,-1070.51
buyer_1,Luis,28,ES18209585214414889696,TRX_N-00068-55057329,2022-03-03T19:55:22,Bilbao,expenses,food,-119.67,-1190.18
buyer_1,Luis,28,ES18209585214414889696,TRX_N-00069-92538977,2022-03-04T13:42:16,Bilbao,expenses,mortgage,-1090.03,-2280.21
buyer_1,Luis,28,ES18209585214414889696,TRX_N-00070-45123043,2022-03-04T09:02:45,Amurrio,expenses,food,-97.5,-2377.71
buyer_1,Luis,28,ES18209585214414889696,TRX_N-00071-61003063,2022-03-05T15:57:29,Bilbao,expenses,water,-34.74,-2412.45
buyer_1,Luis,28,ES18209585214414889696,TRX_N-00072-62069680,2022-03-05T16:00:03,Bilbao,expenses,electricity,-49.28,-2461.73
buyer_1,Luis,28,ES18209585214414889696,TRX_N-00073-31018068,2022-03-07T11:34:40,Bilbao,expenses,phone,-44.73,-2506.46
buyer_1,Luis,28,ES18209585214414889696,TRX_N-00074-47164417,2022-03-07T22:31:37,Bilbao,expenses,cash,-100.0,-2606.46
buyer_1,Luis,28,ES18209585214414889696,TRX_N-00075-13857076,2022-03-07T08:05:16,Bilbao,expenses,gifts,-195.78,-2802.24
buyer_1,Luis,28,ES18209585214414889696,TRX_N-00076-48954074,2022-03-08T08:34:19,Bilbao,expenses,gas,-89.31,-2891.55
buyer_1,Luis,28,ES18209585214414889696,TRX_N-00077-96899536,2022-03-08T12:08:58,Bilbao,expenses,internet,-42.0,-2933.55
buyer_1,Luis,28,ES18209585214414889696,TRX_N-00078-15629661,2022-03-09T08:26:53,Bilbao,expenses,leisure,-69.38,-3002.93
buyer_1,Luis,28,ES18209585214414889696,TRX_N-00079-62873448,2022-03-10T18:46:57,Bilbao,expenses,appliances,-83.29,-3086.22
buyer_1,Luis,28,ES18209585214414889696,TRX_N-00080-32929216,2022-03-10T17:25:56,Bilbao,expenses,gifts,-668.38,-3754.6
buyer_1,Luis,28,ES18209585214414889696,TRX_N-00081-84417419,2022-03-13T11:49:01,Bilbao,expenses,food,-85.22,-3839.82
buyer_1,Luis,28,ES18209585214414889696,TRX_N-00082-97601404,2022-03-14T20:11:17,Bilbao,expenses,leisure,-82.8,-3922.62
buyer_1,Luis,28,ES18209585214414889696,TRX_N-00083-32325339,2022-03-16T20:16:25,Bilbao,expenses,repairs,-166.37,-4088.99
buyer_1,Luis,28,ES18209585214414889696,TRX_N-00084-58441229,2022-03-17T11:35:18,Bilbao,expenses,education,-73.54,-4162.53
buyer_1,Luis,28,ES18209585214414889696,TRX_N-00085-93431386,2022-03-22T13:39:45,Bilbao,expenses,children,-237.67,-4400.2
buyer_1,Luis,28,ES18209585214414889696,TRX_N-00086-49978139,2022-03-23T12:16:28,Bilbao,expenses,food,-89.55,-4489.75
buyer_1,Luis,28,ES18209585214414889696,TRX_N-00087-18131727,2022-03-23T10:02:33,Bilbao,expenses,transport,-88.62,-4578.37
buyer_1,Luis,28,ES18209585214414889696,TRX_N-00088-95623618,2022-03-24T04:12:37,Bilbao,expenses,food,-73.98,-4652.35
buyer_1,Luis,28,ES18209585214414889696,TRX_N-00089-97189752,2022-03-24T02:52:37,Bilbao,expenses,clothing,-84.12,-4736.47
buyer_1,Luis,28,ES18209585214414889696,TRX_N-00090-11858066,2022-03-26T08:54:10,Bilbao,expenses,cash,-100.0,-4836.47
buyer_1,Luis,28,ES18209585214414889696,TRX_N-00091-62612116,2022-03-28T19:14:50,Bilbao,expenses,food,-67.58,-4904.05
buyer_1,Luis,28,ES18209585214414889696,TRX_N-00092-52803272,2022-03-29T20:54:02,Bilbao,expenses,leisure,-54.17,-4958.22
buyer_1,Luis,28,ES18209585214414889696,TRX_N-00093-02510828,2022-03-30T13:34:54,Bilbao,expenses,leisure,-34.22,-4992.44
buyer_1,Luis,28,ES18209585214414889696,TRX_N-00094-10262568,2022-03-31T09:22:20,Bilbao,expenses,transport,-41.76,-5034.2
buyer_1,Luis,28,ES18209585214414889696,TRX_N-00095-67705006,2022-03-31T09:33:49,Bilbao,expenses,leisure,-68.1,-5102.3
buyer_1,Luis,28,ES18209585214414889696,TRX_N-00096-70631364,2022-04-01T09:12:12,Bilbao,incomes,salary,1320.37,-3781.93
buyer_1,Luis,28,ES18209585214414889696,TRX_N-00097-19461229,2022-04-01T09:12:12,Bilbao,incomes,salary_partner,1021.78,-2760.15
buyer_1,Luis,28,ES18209585214414889696,TRX_N-00098-02595991,2022-04-01T09:12:12,Bilbao,incomes,extra_income,134.54,-2625.61
buyer_1,Luis,28,ES18209585214414889696,TRX_N-00099-48822476,2022-04-01T09:09:28,Bilbao,expenses,children,-152.18,-2777.79
buyer_1,Luis,28,ES18209585214414889696,TRX_N-00100-07459113,2022-04-03T09:52:11,Arrasate,expenses,gifts,-614.04,-3391.83
buyer_1,Luis,28,ES18209585214414889696,TRX_N-00101-09354136,2022-04-04T00:02:11,Bilbao,expenses,mortgage,-1090.03,-4481.86
buyer_1,Luis,28,ES18209585214414889696,TRX_N-00102-70277390,2022-04-05T17:15:39,Bilbao,expenses,healthcare,-110.09,-4591.95
buyer_1,Luis,28,ES18209585214414889696,TRX_N-00103-45505155,2022-04-06T11:56:07,Bilbao,expenses,water,-44.84,-4636.79
buyer_1,Luis,28,ES18209585214414889696,TRX_N-00104-74679097,2022-04-07T15:48:43,Bilbao,expenses,gas,-114.46,-4751.25
buyer_1,Luis,28,ES18209585214414889696,TRX_N-00105-82113048,2022-04-07T13:30:11,Bilbao,expenses,leisure,-52.62,-4803.87
buyer_1,Luis,28,ES18209585214414889696,TRX_N-00106-90980697,2022-04-07T12:59:40,Bilbao,expenses,healthcare,-45.79,-4849.66
buyer_1,Luis,28,ES18209585214414889696,TRX_N-00107-58635241,2022-04-07T18:45:53,Bilbao,expenses,cash,-100.0,-4949.66
buyer_1,Luis,28,ES18209585214414889696,TRX_N-00108-95341523,2022-04-08T10:55:21,Bilbao,expenses,electricity,-47.7,-4997.36
buyer_1,Luis,28,ES18209585214414889696,TRX_N-00109-72482112,2022-04-08T15:29:30,Bilbao,expenses,internet,-42.0,-5039.36
buyer_1,Luis,28,ES18209585214414889696,TRX_N-00110-95299786,2022-04-08T13:15:55,Bilbao,expenses,phone,-35.05,-5074.41
buyer_1,Luis,28,ES18209585214414889696,TRX_N-00111-23175228,2022-04-08T19:14:03,Bilbao,expenses,food,-80.21,-5154.62
buyer_1,Luis,28,ES18209585214414889696,TRX_N-00112-21400612,2022-04-12T12:22:55,Arrasate,expenses,food,-116.55,-5271.17
buyer_1,Luis,28,ES18209585214414889696,TRX_N-00113-84128501,2022-04-12T15:30:08,Bilbao,expenses,transport,-87.09,-5358.26
buyer_1,Luis,28,ES18209585214414889696,TRX_N-00114-52448122,2022-04-13T13:47:14,Bilbao,expenses,food,-113.43,-5471.69
buyer_1,Luis,28,ES18209585214414889696,TRX_N-00115-49548889,2022-04-16T08:51:16,Bilbao,expenses,leisure,-41.55,-5513.24
buyer_1,Luis,28,ES18209585214414889696,TRX_N-00116-86616132,2022-04-16T13:51:08,Bilbao,expenses,cash,-100.0,-5613.24
buyer_1,Luis,28,ES18209585214414889696,TRX_N-00117-90857193,2022-04-19T09:16:47,Bilbao,expenses,appliances,-137.18,-5750.42
buyer_1,Luis,28,ES18209585214414889696,TRX_N-00118-49201373,2022-04-24T09:56:44,Bilbao,expenses,leisure,-84.09,-5834.51
buyer_1,Luis,28,ES18209585214414889696,TRX_N-00119-58616132,2022-04-24T13:04:08,Bilbao,expenses,clothing,-125.3,-5959.81
buyer_1,Luis,28,ES18209585214414889696,TRX_N-00120-34878158,2022-04-24T08:11:10,Bilbao,expenses,travel,-923.78,-6883.59
buyer_1,Luis,28,ES18209585214414889696,TRX_N-00121-52974506,2022-04-26T11:16:49,Bilbao,expenses,cash,-100.0,-6983.59
buyer_1,Luis,28,ES18209585214414889696,TRX_N-00122-42513513,2022-04-30T15:49:49,Bilbao,expenses,children,-150.65,-7134.24
buyer_1,Luis,28,ES18209585214414889696,TRX_N-00123-18083676,2022-05-01T03:21:24,Bilbao,incomes,salary,1320.37,-5813.87
buyer_1,Luis,28,ES18209585214414889696,TRX_N-00124-57112430,2022-05-01T03:21:24,Bilbao,incomes,salary_partner,1021.78,-4792.09
buyer_1,Luis,28,ES18209585214414889696,TRX_N-00125-90394718,2022-05-02T10:23:52,Bilbao,expenses,cash,-100.0,-4892.09
buyer_1,Luis,28,ES18209585214414889696,TRX_N-00126-34480378,2022-05-03T19:32:21,Bilbao,expenses,food,-92.42,-4984.51
buyer_1,Luis,28,ES18209585214414889696,TRX_N-00127-23126987,2022-05-04T20:31:05,Bilbao,expenses,mortgage,-1090.03,-6074.54
buyer_1,Luis,28,ES18209585214414889696,TRX_N-00128-67350441,2022-05-04T10:58:05,Bilbao,expenses,leisure,-47.76,-6122.3
buyer_1,Luis,28,ES18209585214414889696,TRX_N-00129-59648813,2022-05-04T08:53:43,Bilbao,expenses,cash,-100.0,-6222.3
buyer_1,Luis,28,ES18209585214414889696,TRX_N-00130-95626061,2022-05-05T18:51:26,Bilbao,expenses,water,-27.23,-6249.53
buyer_1,Luis,28,ES18209585214414889696,TRX_N-00131-14772372,2022-05-05T08:33:27,Bilbao,expenses,leisure,-63.75,-6313.28
buyer_1,Luis,28,ES18209585214414889696,TRX_N-00132-42667048,2022-05-06T12:14:19,Bilbao,expenses,internet,-42.0,-6355.28
buyer_1,Luis,28,ES18209585214414889696,TRX_N-00133-67984158,2022-05-07T12:34:24,Bilbao,expenses,electricity,-32.89,-6388.17
buyer_1,Luis,28,ES18209585214414889696,TRX_N-00134-08372867,2022-05-07T11:44:27,Bilbao,expenses,gas,-112.6,-6500.77
buyer_1,Luis,28,ES18209585214414889696,TRX_N-00135-04106730,2022-05-08T12:03:10,Bilbao,expenses,phone,-32.65,-6533.42
buyer_1,Luis,28,ES18209585214414889696,TRX_N-00136-07686972,2022-05-11T11:04:15,Bilbao,expenses,food,-74.58,-6608.0
buyer_1,Luis,28,ES18209585214414889696,TRX_N-00137-48853795,2022-05-13T11:04:55,Bilbao,expenses,education,-65.48,-6673.48
buyer_1,Luis,28,ES18209585214414889696,TRX_N-00138-89799619,2022-05-17T22:10:59,Bilbao,expenses,transport,-72.14,-6745.62
buyer_1,Luis,28,ES18209585214414889696,TRX_N-00139-74533758,2022-05-17T16:48:57,Bilbao,expenses,leisure,-82.97,-6828.59
buyer_1,Luis,28,ES18209585214414889696,TRX_N-00140-43304141,2022-05-18T10:48:29,Bilbao,expenses,food,-73.89,-6902.48
buyer_1,Luis,28,ES18209585214414889696,TRX_N-00141-41851126,2022-05-18T11:24:20,Bilbao,expenses,transport,-77.78,-6980.26
buyer_1,Luis,28,ES18209585214414889696,TRX_N-00142-03742027,2022-05-18T16:43:03,Bilbao,expenses,cash,-100.0,-7080.26
buyer_1,Luis,28,ES18209585214414889696,TRX_N-00143-62669330,2022-05-19T12:02:09,Bilbao,expenses,cash,-100.0,-7180.26
buyer_1,Luis,28,ES18209585214414889696,TRX_N-00144-61594535,2022-05-21T13:00:04,Donostia,expenses,leisure,-36.92,-7217.18
buyer_1,Luis,28,ES18209585214414889696,TRX_N-00145-79516083,2022-05-24T12:48:29,Bilbao,expenses,healthcare,-97.5,-7314.68
buyer_1,Luis,28,ES18209585214414889696,TRX_N-00146-11275928,2022-05-25T09:52:12,Bilbao,expenses,appliances,-397.29,-7711.97
buyer_1,Luis,28,ES18209585214414889696,TRX_N-00147-89924462,2022-05-25T13:47:24,Bilbao,expenses,repairs,-199.71,-7911.68
buyer_1,Luis,28,ES18209585214414889696,TRX_N-00148-83432325,2022-05-29T19:59:48,Oyón-Oion,expenses,clothing,-107.58,-8019.26
buyer_1,Luis,28,ES18209585214414889696,TRX_N-00149-49501217,2022-05-29T12:45:11,Bilbao,expenses,repairs,-153.27,-8172.53
buyer_1,Luis,28,ES18209585214414889696,TRX_N-00150-28212125,2022-05-31T16:15:46,Bilbao,expenses,cash,-100.0,-8272.53
buyer_1,Luis,28,ES18209585214414889696,TRX_N-00151-87937735,2022-06-01T16:59:24,Bilbao,incomes,salary,1320.37,-6952.16
buyer_1,Luis,28,ES18209585214414889696,TRX_N-00152-91836854,2022-06-01T16:59:24,Bilbao,incomes,salary_partner,1021.78,-5930.38
buyer_1,Luis,28,ES18209585214414889696,TRX_N-00153-01545469,2022-06-01T16:59:24,Bilbao,incomes,salary_bonus,990.21,-4940.17
buyer_1,Luis,28,ES18209585214414889696,TRX_N-00154-09306071,2022-06-01T16:59:24,Bilbao,incomes,salary_partner_bonus,810.35,-4129.82
buyer_1,Luis,28,ES18209585214414889696,TRX_N-00155-12639098,2022-06-01T10:12:37,Bilbao,expenses,taxes,-1379.68,-5509.5
buyer_1,Luis,28,ES18209585214414889696,TRX_N-00156-55557791,2022-06-01T19:57:25,Bilbao,expenses,insurance,-349.03,-5858.53
buyer_1,Luis,28,ES18209585214414889696,TRX_N-00157-09429221,2022-06-01T19:42:41,Eibar,expenses,repairs,-147.7,-6006.23
buyer_1,Luis,28,ES18209585214414889696,TRX_N-00158-66307539,2022-06-01T16:09:47,Bilbao,expenses,children,-219.05,-6225.28
buyer_1,Luis,28,ES18209585214414889696,TRX_N-00159-09824800,2022-06-04T16:30:03,Bilbao,expenses,mortgage,-1090.03,-7315.31
buyer_1,Luis,28,ES18209585214414889696,TRX_N-00160-98991311,2022-06-05T18:30:45,Bilbao,expenses,electricity,-81.62,-7396.93
buyer_1,Luis,28,ES18209585214414889696,TRX_N-00161-73552501,2022-06-06T11:48:01,Bilbao,expenses,gas,-65.41,-7462.34
buyer_1,Luis,28,ES18209585214414889696,TRX_N-00162-45678533,2022-06-06T16:02:29,Bilbao,expenses,phone,-39.51,-7501.85
buyer_1,Luis,28,ES18209585214414889696,TRX_N-00163-69048445,2022-06-07T15:23:22,Galdakao,expenses,food,-66.93,-7568.78
buyer_1,Luis,28,ES18209585214414889696,TRX_N-00164-05549315,2022-06-08T18:46:19,Bilbao,expenses,water,-26.98,-7595.76
buyer_1,Luis,28,ES18209585214414889696,TRX_N-00165-04470474,2022-06-08T18:05:36,Bilbao,expenses,internet,-42.0,-7637.76
buyer_1,Luis,28,ES18209585214414889696,TRX_N-00166-62683914,2022-06-09T16:55:22,Bilbao,expenses,cash,-100.0,-7737.76
buyer_1,Luis,28,ES18209585214414889696,TRX_N-00167-40214235,2022-06-09T16:05:50,Bilbao,expenses,travel,-1566.9,-9304.66
buyer_1,Luis,28,ES18209585214414889696,TRX_N-00168-33507005,2022-06-10T15:12:00,Bilbao,expenses,food,-68.31,-9372.97
buyer_1,Luis,28,ES18209585214414889696,TRX_N-00169-10647767,2022-06-10T10:19:11,Bilbao,expenses,transport,-77.11,-9450.08
buyer_1,Luis,28,ES18209585214414889696,TRX_N-00170-48734168,2022-06-10T16:34:47,Leioa,expenses,appliances,-215.66,-9665.74
buyer_1,Luis,28,ES18209585214414889696,TRX_N-00171-75419337,2022-06-10T23:24:43,Bilbao,expenses,repairs,-122.7,-9788.44
buyer_1,Luis,28,ES18209585214414889696,TRX_N-00172-79544097,2022-06-11T08:35:23,Bilbao,expenses,gifts,-69.03,-9857.47
buyer_1,Luis,28,ES18209585214414889696,TRX_N-00173-98363887,2022-06-13T16:32:54,Bilbao,expenses,food,-121.09,-9978.56
buyer_1,Luis,28,ES18209585214414889696,TRX_N-00174-31921904,2022-06-13T17:47:32,Bilbao,expenses,transport,-44.91,-10023.47
buyer_1,Luis,28,ES18209585214414889696,TRX_N-00175-78793106,2022-06-13T19:24:36,Bilbao,expenses,leisure,-84.54,-10108.01
buyer_1,Luis,28,ES18209585214414889696,TRX_N-00176-26721034,2022-06-13T18:55:53,Bilbao,expenses,cash,-100.0,-10208.01
buyer_1,Luis,28,ES18209585214414889696,TRX_N-00177-43929658,2022-06-14T14:09:43,Bilbao,expenses,transport,-86.25,-10294.26
buyer_1,Luis,28,ES18209585214414889696,TRX_N-00178-21092221,2022-06-14T20:13:46,Alegría-Dulantzi,expenses,education,-53.55,-10347.81
buyer_1,Luis,28,ES18209585214414889696,TRX_N-00179-97030754,2022-06-14T12:49:46,Pasaia,expenses,cash,-100.0,-10447.81
buyer_1,Luis,28,ES18209585214414889696,TRX_N-00180-87925506,2022-06-15T15:37:49,Bilbao,expenses,healthcare,-101.05,-10548.86
buyer_1,Luis,28,ES18209585214414889696,TRX_N-00181-68997623,2022-06-15T11:05:53,Bilbao,expenses,travel,-963.5,-11512.36
buyer_1,Luis,28,ES18209585214414889696,TRX_N-00182-95717935,2022-06-19T16:12:15,Bilbao,expenses,food,-87.95,-11600.31
buyer_1,Luis,28,ES18209585214414889696,TRX_N-00183-45894770,2022-06-19T22:10:58,Bilbao,expenses,cash,-100.0,-11700.31
buyer_1,Luis,28,ES18209585214414889696,TRX_N-00184-53767681,2022-06-20T17:25:36,Zarautz,expenses,clothing,-136.51,-11836.82
buyer_1,Luis,28,ES18209585214414889696,TRX_N-00185-48581266,2022-06-23T04:14:32,Bilbao,expenses,leisure,-76.38,-11913.2
buyer_1,Luis,28,ES18209585214414889696,TRX_N-00186-20299193,2022-06-24T16:38:05,Getxo,expenses,cash,-100.0,-12013.2
buyer_1,Luis,28,ES18209585214414889696,TRX_N-00187-31428071,2022-06-26T10:00:29,Bilbao,expenses,leisure,-58.58,-12071.78
buyer_1,Luis,28,ES18209585214414889696,TRX_N-00188-64342629,2022-06-27T05:54:40,Bilbao,expenses,transport,-59.16,-12130.94
buyer_1,Luis,28,ES18209585214414889696,TRX_N-00189-89217320,2022-06-27T08:49:51,Bilbao,expenses,education,-57.46,-12188.4
buyer_1,Luis,28,ES18209585214414889696,TRX_N-00190-53592929,2022-06-28T09:24:21,Bilbao,expenses,food,-60.82,-12249.22
buyer_1,Luis,28,ES18209585214414889696,TRX_N-00191-19692451,2022-06-28T11:42:41,Durango,expenses,transport,-59.09,-12308.31
buyer_1,Luis,28,ES18209585214414889696,TRX_N-00192-26752587,2022-06-30T23:24:55,Bilbao,expenses,children,-177.28,-12485.59
buyer_1,Luis,28,ES18209585214414889696,TRX_N-00193-25362699,2022-07-01T10:08:30,Bilbao,incomes,salary,1320.37,-11165.22
buyer_1,Luis,28,ES18209585214414889696,TRX_N-00194-61149414,2022-07-01T10:08:30,Bilbao,incomes,salary_partner,1021.78,-10143.44
buyer_1,Luis,28,ES18209585214414889696,TRX_N-00195-91349992,2022-07-02T16:11:46,Bilbao,expenses,transport,-74.9,-10218.34
buyer_1,Luis,28,ES18209585214414889696,TRX_N-00196-89792747,2022-07-03T16:29:14,Bilbao,expenses,appliances,-216.55,-10434.89
buyer_1,Luis,28,ES18209585214414889696,TRX_N-00197-29043971,2022-07-04T14:50:36,Bilbao,expenses,mortgage,-1090.03,-11524.92
buyer_1,Luis,28,ES18209585214414889696,TRX_N-00198-79615504,2022-07-05T18:30:18,Bilbao,expenses,gas,-66.38,-11591.3
buyer_1,Luis,28,ES18209585214414889696,TRX_N-00199-60602202,2022-07-05T19:43:03,Bilbao,expenses,internet,-42.0,-11633.3
buyer_1,Luis,28,ES18209585214414889696,TRX_N-00200-28992889,2022-07-05T15:39:57,Bilbao,expenses,phone,-33.44,-11666.74
buyer_1,Luis,28,ES18209585214414889696,TRX_N-00201-65704137,2022-07-06T02:13:30,Zarautz,expenses,food,-119.82,-11786.56
buyer_1,Luis,28,ES18209585214414889696,TRX_N-00202-05076707,2022-07-06T09:48:32,Bilbao,expenses,cash,-100.0,-11886.56
buyer_1,Luis,28,ES18209585214414889696,TRX_N-00203-59267356,2022-07-07T19:42:24,Bilbao,expenses,electricity,-62.63,-11949.19
buyer_1,Luis,28,ES18209585214414889696,TRX_N-00204-40431810,2022-07-08T15:43:16,Bilbao,expenses,water,-24.27,-11973.46
buyer_1,Luis,28,ES18209585214414889696,TRX_N-00205-82922576,2022-07-08T14:35:02,Bilbao,expenses,food,-86.99,-12060.45
buyer_1,Luis,28,ES18209585214414889696,TRX_N-00206-12766504,2022-07-08T14:38:31,Bilbao,expenses,cash,-100.0,-12160.45
buyer_1,Luis,28,ES18209585214414889696,TRX_N-00207-48225240,2022-07-11T12:25:40,Bilbao,expenses,food,-122.77,-12283.22
buyer_1,Luis,28,ES18209585214414889696,TRX_N-00208-87783224,2022-07-11T10:12:31,Bilbao,expenses,transport,-78.55,-12361.77
buyer_1,Luis,28,ES18209585214414889696,TRX_N-00209-66411177,2022-07-11T18:27:41,Bilbao,expenses,travel,-609.68,-12971.45
buyer_1,Luis,28,ES18209585214414889696,TRX_N-00210-17745056,2022-07-11T10:15:05,Bilbao,expenses,children,-151.86,-13123.31
buyer_1,Luis,28,ES18209585214414889696,TRX_N-00211-41252749,2022-07-12T17:04:53,Bilbao,expenses,cash,-100.0,-13223.31
buyer_1,Luis,28,ES18209585214414889696,TRX_N-00212-89905105,2022-07-13T19:38:38,Bilbao,expenses,children,-154.23,-13377.54
buyer_1,Luis,28,ES18209585214414889696,TRX_N-00213-68470381,2022-07-14T14:05:34,Bilbao,expenses,food,-63.75,-13441.29
buyer_1,Luis,28,ES18209585214414889696,TRX_N-00214-15738872,2022-07-16T20:43:36,Bilbao,expenses,leisure,-60.3,-13501.59
buyer_1,Luis,28,ES18209585214414889696,TRX_N-00215-21473625,2022-07-16T16:24:53,Bilbao,expenses,healthcare,-170.58,-13672.17
buyer_1,Luis,28,ES18209585214414889696,TRX_N-00216-83212517,2022-07-16T10:51:54,Bilbao,expenses,repairs,-197.71,-13869.88
buyer_1,Luis,28,ES18209585214414889696,TRX_N-00217-14834413,2022-07-17T09:59:00,Bilbao,expenses,gifts,-659.7,-14529.58
buyer_1,Luis,28,ES18209585214414889696,TRX_N-00218-80546519,2022-07-21T11:49:42,Bilbao,expenses,food,-79.96,-14609.54
buyer_1,Luis,28,ES18209585214414889696,TRX_N-00219-35223615,2022-07-21T14:01:29,Bilbao,expenses,repairs,-111.78,-14721.32
buyer_1,Luis,28,ES18209585214414889696,TRX_N-00220-81132628,2022-07-24T11:45:37,Zarautz,expenses,food,-93.69,-14815.01
buyer_1,Luis,28,ES18209585214414889696,TRX_N-00221-73123608,2022-07-27T13:27:43,Bilbao,expenses,transport,-70.36,-14885.37
buyer_1,Luis,28,ES18209585214414889696,TRX_N-00222-37413112,2022-07-27T15:22:45,Bilbao,expenses,cash,-100.0,-14985.37
buyer_1,Luis,28,ES18209585214414889696,TRX_N-00223-15432001,2022-07-27T15:14:38,Bilbao,expenses,appliances,-87.95,-15073.32
buyer_1,Luis,28,ES18209585214414889696,TRX_N-00224-73351097,2022-07-28T09:48:16,Bilbao,expenses,repairs,-107.07,-15180.39
buyer_1,Luis,28,ES18209585214414889696,TRX_N-00225-07667213,2022-07-30T13:43:13,Bilbao,expenses,food,-110.84,-15291.23
buyer_1,Luis,28,ES18209585214414889696,TRX_N-00226-26027185,2022-07-30T17:46:42,Bilbao,expenses,leisure,-23.48,-15314.71
buyer_1,Luis,28,ES18209585214414889696,TRX_N-00227-57931498,2022-07-30T19:18:20,Lasarte-Oria,expenses,cash,-100.0,-15414.71
buyer_1,Luis,28,ES18209585214414889696,TRX_N-00228-57385808,2022-07-31T20:25:36,Alegría-Dulantzi,expenses,cash,-100.0,-15514.71
buyer_1,Luis,28,ES18209585214414889696,TRX_N-00229-63430977,2022-08-01T18:19:19,Bilbao,incomes,salary,1320.37,-14194.34
buyer_1,Luis,28,ES18209585214414889696,TRX_N-00230-13969498,2022-08-01T18:19:19,Bilbao,incomes,salary_partner,1021.78,-13172.56
buyer_1,Luis,28,ES18209585214414889696,TRX_N-00231-32105306,2022-08-01T18:19:19,Bilbao,incomes,extra_income,134.54,-13038.02
buyer_1,Luis,28,ES18209585214414889696,TRX_N-00232-21119812,2022-08-01T14:44:51,Bilbao,expenses,transport,-58.41,-13096.43
buyer_1,Luis,28,ES18209585214414889696,TRX_N-00233-98725894,2022-08-03T10:34:46,Bilbao,expenses,food,-87.35,-13183.78
buyer_1,Luis,28,ES18209585214414889696,TRX_N-00234-16180233,2022-08-03T08:49:01,Bilbao,expenses,transport,-54.73,-13238.51
buyer_1,Luis,28,ES18209585214414889696,TRX_N-00235-81907649,2022-08-03T15:31:57,Hondarribia,expenses,cash,-100.0,-13338.51
buyer_1,Luis,28,ES18209585214414889696,TRX_N-00236-76613014,2022-08-04T11:44:09,Bilbao,expenses,mortgage,-1090.03,-14428.54
buyer_1,Luis,28,ES18209585214414889696,TRX_N-00237-78101053,2022-08-04T19:28:59,Bilbao,expenses,leisure,-46.29,-14474.83
buyer_1,Luis,28,ES18209585214414889696,TRX_N-00238-61036269,2022-08-05T08:06:35,Bilbao,expenses,internet,-42.0,-14516.83
buyer_1,Luis,28,ES18209585214414889696,TRX_N-00239-52714265,2022-08-06T17:40:54,Bilbao,expenses,phone,-37.63,-14554.46
buyer_1,Luis,28,ES18209585214414889696,TRX_N-00240-39532017,2022-08-07T19:04:35,Bilbao,expenses,gifts,-443.72,-14998.18
buyer_1,Luis,28,ES18209585214414889696,TRX_N-00241-93448161,2022-08-08T10:49:11,Bilbao,expenses,electricity,-26.55,-15024.73
buyer_1,Luis,28,ES18209585214414889696,TRX_N-00242-40703076,2022-08-08T17:25:17,Bilbao,expenses,water,-35.58,-15060.31
buyer_1,Luis,28,ES18209585214414889696,TRX_N-00243-69163266,2022-08-08T14:15:59,Bilbao,expenses,gas,-93.73,-15154.04
buyer_1,Luis,28,ES18209585214414889696,TRX_N-00244-16662491,2022-08-08T16:28:52,Bilbao,expenses,food,-91.59,-15245.63
buyer_1,Luis,28,ES18209585214414889696,TRX_N-00245-70599853,2022-08-08T14:57:52,Bilbao,expenses,healthcare,-145.24,-15390.87
buyer_1,Luis,28,ES18209585214414889696,TRX_N-00246-34214940,2022-08-09T00:34:20,Bilbao,expenses,transport,-81.44,-15472.31
buyer_1,Luis,28,ES18209585214414889696,TRX_N-00247-63667321,2022-08-09T09:39:18,Bilbao,expenses,clothing,-144.56,-15616.87
buyer_1,Luis,28,ES18209585214414889696,TRX_N-00248-78577743,2022-08-10T02:17:04,Bilbao,expenses,cash,-100.0,-15716.87
buyer_1,Luis,28,ES18209585214414889696,TRX_N-00249-18797516,2022-08-11T09:51:23,Bilbao,expenses,clothing,-94.39,-15811.26
buyer_1,Luis,28,ES18209585214414889696,TRX_N-00250-61015655,2022-08-11T16:53:36,Bilbao,expenses,repairs,-321.45,-16132.71
buyer_1,Luis,28,ES18209585214414889696,TRX_N-00251-52981013,2022-08-13T23:46:31,Bilbao,expenses,food,-105.41,-16238.12
buyer_1,Luis,28,ES18209585214414889696,TRX_N-00252-01424462,2022-08-14T09:06:52,Andoain,expenses,leisure,-49.27,-16287.39
buyer_1,Luis,28,ES18209585214414889696,TRX_N-00253-60374110,2022-08-15T13:19:35,Bilbao,expenses,leisure,-46.23,-16333.62
buyer_1,Luis,28,ES18209585214414889696,TRX_N-00254-22815594,2022-08-17T16:05:56,Bilbao,expenses,clothing,-140.06,-16473.68
buyer_1,Luis,28,ES18209585214414889696,TRX_N-00255-41988748,2022-08-19T23:18:47,Bilbao,expenses,food,-62.29,-16535.97
buyer_1,Luis,28,ES18209585214414889696,TRX_N-00256-64985513,2022-08-20T17:52:29,Bilbao,expenses,transport,-49.84,-16585.81
buyer_1,Luis,28,ES18209585214414889696,TRX_N-00257-68236243,2022-08-21T21:17:07,Bilbao,expenses,food,-62.35,-16648.16
buyer_1,Luis,28,ES18209585214414889696,TRX_N-00258-29090993,2022-08-22T14:11:48,Bilbao,expenses,cash,-100.0,-16748.16
buyer_1,Luis,28,ES18209585214414889696,TRX_N-00259-84740433,2022-08-24T13:10:45,Bilbao,expenses,transport,-70.41,-16818.57
buyer_1,Luis,28,ES18209585214414889696,TRX_N-00260-25247095,2022-08-24T03:18:02,Bilbao,expenses,leisure,-43.74,-16862.31
buyer_1,Luis,28,ES18209585214414889696,TRX_N-00261-14783483,2022-08-24T12:43:28,Irun,expenses,appliances,-364.51,-17226.82
buyer_1,Luis,28,ES18209585214414889696,TRX_N-00262-97746392,2022-08-25T15:59:00,Bilbao,expenses,food,-62.37,-17289.19
buyer_1,Luis,28,ES18209585214414889696,TRX_N-00263-08431820,2022-08-29T09:15:09,Bilbao,expenses,children,-56.49,-17345.68
buyer_1,Luis,28,ES18209585214414889696,TRX_N-00264-08324650,2022-08-30T20:34:24,Elciego,expenses,transport,-60.43,-17406.11
buyer_1,Luis,28,ES18209585214414889696,TRX_N-00265-61703929,2022-08-31T18:45:21,Getxo,expenses,leisure,-21.24,-17427.35
buyer_1,Luis,28,ES18209585214414889696,TRX_N-00266-22833360,2022-09-01T15:01:29,Bilbao,incomes,salary,1320.37,-16106.98
buyer_1,Luis,28,ES18209585214414889696,TRX_N-00267-34442870,2022-09-01T15:01:29,Bilbao,incomes,salary_partner,1021.78,-15085.2
buyer_1,Luis,28,ES18209585214414889696,TRX_N-00268-40622537,2022-09-01T16:14:00,Zuia,expenses,food,-81.2,-15166.4
buyer_1,Luis,28,ES18209585214414889696,TRX_N-00269-79160171,2022-09-01T12:50:58,Bermeo,expenses,cash,-100.0,-15266.4
buyer_1,Luis,28,ES18209585214414889696,TRX_N-00270-35613888,2022-09-02T08:42:29,Bilbao,expenses,food,-76.46,-15342.86
buyer_1,Luis,28,ES18209585214414889696,TRX_N-00271-99772502,2022-09-02T15:10:16,Bilbao,expenses,education,-59.92,-15402.78
buyer_1,Luis,28,ES18209585214414889696,TRX_N-00272-42381290,2022-09-04T10:35:57,Bilbao,expenses,mortgage,-1090.03,-16492.81
buyer_1,Luis,28,ES18209585214414889696,TRX_N-00273-62036405,2022-09-05T19:19:34,Bilbao,expenses,electricity,-62.02,-16554.83
buyer_1,Luis,28,ES18209585214414889696,TRX_N-00274-22728377,2022-09-05T14:21:53,Bilbao,expenses,food,-106.94,-16661.77
buyer_1,Luis,28,ES18209585214414889696,TRX_N-00275-42305886,2022-09-06T15:47:39,Bilbao,expenses,water,-41.66,-16703.43
buyer_1,Luis,28,ES18209585214414889696,TRX_N-00276-43589147,2022-09-06T20:15:48,Bilbao,expenses,food,-98.41,-16801.84
buyer_1,Luis,28,ES18209585214414889696,TRX_N-00277-21329047,2022-09-07T05:50:17,Bilbao,expenses,gas,-92.39,-16894.23
buyer_1,Luis,28,ES18209585214414889696,TRX_N-00278-38067545,2022-09-08T08:40:28,Bilbao,expenses,internet,-42.0,-16936.23
buyer_1,Luis,28,ES18209585214414889696,TRX_N-00279-04247917,2022-09-08T17:07:30,Bilbao,expenses,phone,-30.2,-16966.43
buyer_1,Luis,28,ES18209585214414889696,TRX_N-00280-33818992,2022-09-09T15:23:36,Bilbao,expenses,food,-115.21,-17081.64
buyer_1,Luis,28,ES18209585214414889696,TRX_N-00281-80667450,2022-09-10T15:54:57,Bilbao,expenses,cash,-100.0,-17181.64
buyer_1,Luis,28,ES18209585214414889696,TRX_N-00282-88747584,2022-09-11T18:19:26,Bilbao,expenses,repairs,-202.93,-17384.57
buyer_1,Luis,28,ES18209585214414889696,TRX_N-00283-58654417,2022-09-13T18:59:43,Bilbao,expenses,food,-71.44,-17456.01
buyer_1,Luis,28,ES18209585214414889696,TRX_N-00284-31180766,2022-09-13T23:17:55,Bilbao,expenses,leisure,-63.65,-17519.66
buyer_1,Luis,28,ES18209585214414889696,TRX_N-00285-34402174,2022-09-14T11:49:28,Bilbao,expenses,transport,-72.39,-17592.05
buyer_1,Luis,28,ES18209585214414889696,TRX_N-00286-68680574,2022-09-14T18:58:26,Bilbao,expenses,children,-204.79,-17796.84
buyer_1,Luis,28,ES18209585214414889696,TRX_N-00287-12296100,2022-09-15T11:10:25,Bilbao,expenses,clothing,-154.31,-17951.15
buyer_1,Luis,28,ES18209585214414889696,TRX_N-00288-81080098,2022-09-15T20:21:11,Bilbao,expenses,repairs,-283.88,-18235.03
buyer_1,Luis,28,ES18209585214414889696,TRX_N-00289-91809506,2022-09-16T01:15:21,Galdakao,expenses,transport,-80.39,-18315.42
buyer_1,Luis,28,ES18209585214414889696,TRX_N-00290-25380498,2022-09-17T11:29:42,Oyón-Oion,expenses,transport,-45.9,-18361.32
buyer_1,Luis,28,ES18209585214414889696,TRX_N-00291-85125547,2022-09-18T17:47:18,Bilbao,expenses,cash,-100.0,-18461.32
buyer_1,Luis,28,ES18209585214414889696,TRX_N-00292-25899455,2022-09-19T17:55:06,Bilbao,expenses,food,-93.04,-18554.36
buyer_1,Luis,28,ES18209585214414889696,TRX_N-00293-22857874,2022-09-19T22:02:25,Vitoria-Gasteiz,expenses,cash,-100.0,-18654.36
buyer_1,Luis,28,ES18209585214414889696,TRX_N-00294-57319996,2022-09-22T19:15:52,Bilbao,expenses,transport,-71.5,-18725.86
buyer_1,Luis,28,ES18209585214414889696,TRX_N-00295-91847441,2022-09-23T15:03:45,Bilbao,expenses,transport,-58.24,-18784.1
buyer_1,Luis,28,ES18209585214414889696,TRX_N-00296-22418913,2022-09-23T08:13:41,Bilbao,expenses,cash,-100.0,-18884.1
buyer_1,Luis,28,ES18209585214414889696,TRX_N-00297-76675424,2022-09-26T00:17:30,Bilbao,expenses,transport,-57.25,-18941.35
buyer_1,Luis,28,ES18209585214414889696,TRX_N-00298-45710407,2022-09-27T19:09:27,Bilbao,expenses,education,-57.96,-18999.31
buyer_1,Luis,28,ES18209585214414889696,TRX_N-00299-87970707,2022-09-28T18:30:58,Bilbao,expenses,gifts,-609.56,-19608.87
buyer_1,Luis,28,ES18209585214414889696,TRX_N-00300-17908526,2022-09-28T14:37:09,Bilbao,expenses,children,-102.07,-19710.94
buyer_1,Luis,28,ES18209585214414889696,TRX_N-00301-13632817,2022-09-29T17:09:46,Bilbao,expenses,cash,-100.0,-19810.94
buyer_1,Luis,28,ES18209585214414889696,TRX_N-00302-16732128,2022-10-01T20:39:08,Bilbao,incomes,salary,1320.37,-18490.57
buyer_1,Luis,28,ES18209585214414889696,TRX_N-00303-94985766,2022-10-01T20:39:08,Bilbao,incomes,salary_partner,1021.78,-17468.79
buyer_1,Luis,28,ES18209585214414889696,TRX_N-00304-48486274,2022-10-01T12:22:14,Amurrio,expenses,food,-79.35,-17548.14
buyer_1,Luis,28,ES18209585214414889696,TRX_N-00305-18656345,2022-10-01T13:34:36,Portugalete,expenses,cash,-100.0,-17648.14
buyer_1,Luis,28,ES18209585214414889696,TRX_N-00306-99090926,2022-10-02T08:09:45,Bilbao,expenses,food,-62.43,-17710.57
buyer_1,Luis,28,ES18209585214414889696,TRX_N-00307-43718309,2022-10-03T09:01:10,Bilbao,expenses,food,-91.36,-17801.93
buyer_1,Luis,28,ES18209585214414889696,TRX_N-00308-86735167,2022-10-03T17:51:07,Bilbao,expenses,transport,-57.97,-17859.9
buyer_1,Luis,28,ES18209585214414889696,TRX_N-00309-37918298,2022-10-04T10:16:54,Bilbao,expenses,mortgage,-1090.03,-18949.93
buyer_1,Luis,28,ES18209585214414889696,TRX_N-00310-49064876,2022-10-04T18:49:19,Bilbao,expenses,appliances,-259.9,-19209.83
buyer_1,Luis,28,ES18209585214414889696,TRX_N-00311-41436380,2022-10-04T15:19:40,Bilbao,expenses,repairs,-246.89,-19456.72
buyer_1,Luis,28,ES18209585214414889696,TRX_N-00312-88670159,2022-10-05T14:43:36,Bilbao,expenses,phone,-31.4,-19488.12
buyer_1,Luis,28,ES18209585214414889696,TRX_N-00313-69747183,2022-10-06T14:34:02,Bilbao,expenses,appliances,-403.33,-19891.45
buyer_1,Luis,28,ES18209585214414889696,TRX_N-00314-28248605,2022-10-07T00:00:26,Bilbao,expenses,internet,-42.0,-19933.45
buyer_1,Luis,28,ES18209585214414889696,TRX_N-00315-84431281,2022-10-08T16:11:43,Bilbao,expenses,gas,-41.2,-19974.65
buyer_1,Luis,28,ES18209585214414889696,TRX_N-00316-77347184,2022-10-08T17:02:00,Bilbao,expenses,water,-22.17,-19996.82
buyer_1,Luis,28,ES18209585214414889696,TRX_N-00317-59645544,2022-10-08T14:07:35,Bilbao,expenses,electricity,-76.12,-20072.94
buyer_1,Luis,28,ES18209585214414889696,TRX_N-00318-48897703,2022-10-08T17:06:22,Bilbao,expenses,food,-63.03,-20135.97
buyer_1,Luis,28,ES18209585214414889696,TRX_N-00319-68880098,2022-10-11T08:45:59,Bilbao,expenses,repairs,-138.44,-20274.41
buyer_1,Luis,28,ES18209585214414889696,TRX_N-00320-11792081,2022-10-14T11:11:37,Bilbao,expenses,education,-57.38,-20331.79
buyer_1,Luis,28,ES18209585214414889696,TRX_N-00321-46210970,2022-10-14T20:48:28,Bilbao,expenses,cash,-100.0,-20431.79
buyer_1,Luis,28,ES18209585214414889696,TRX_N-00322-27421373,2022-10-15T12:33:49,Bilbao,expenses,transport,-56.8,-20488.59
buyer_1,Luis,28,ES18209585214414889696,TRX_N-00323-76654060,2022-10-16T15:37:32,Bilbao,expenses,food,-118.03,-20606.62
buyer_1,Luis,28,ES18209585214414889696,TRX_N-00324-56205296,2022-10-16T13:16:23,Bilbao,expenses,leisure,-33.83,-20640.45
buyer_1,Luis,28,ES18209585214414889696,TRX_N-00325-31892058,2022-10-16T19:17:01,Barakaldo,expenses,cash,-100.0,-20740.45
buyer_1,Luis,28,ES18209585214414889696,TRX_N-00326-45727212,2022-10-16T19:41:11,Bilbao,expenses,repairs,-246.45,-20986.9
buyer_1,Luis,28,ES18209585214414889696,TRX_N-00327-11519393,2022-10-17T20:27:24,Bilbao,expenses,children,-78.92,-21065.82
buyer_1,Luis,28,ES18209585214414889696,TRX_N-00328-13551889,2022-10-18T15:13:18,Bilbao,expenses,cash,-100.0,-21165.82
buyer_1,Luis,28,ES18209585214414889696,TRX_N-00329-15351582,2022-10-19T12:12:40,Bilbao,expenses,food,-115.54,-21281.36
buyer_1,Luis,28,ES18209585214414889696,TRX_N-00330-03714879,2022-10-19T20:37:37,Elciego,expenses,healthcare,-148.58,-21429.94
buyer_1,Luis,28,ES18209585214414889696,TRX_N-00331-88499081,2022-10-20T12:33:51,Bilbao,expenses,cash,-100.0,-21529.94
buyer_1,Luis,28,ES18209585214414889696,TRX_N-00332-39143314,2022-10-23T16:11:40,Bilbao,expenses,transport,-76.64,-21606.58
buyer_1,Luis,28,ES18209585214414889696,TRX_N-00333-67998457,2022-10-24T14:35:38,Bilbao,expenses,cash,-100.0,-21706.58
buyer_1,Luis,28,ES18209585214414889696,TRX_N-00334-06059526,2022-10-24T17:22:33,Bilbao,expenses,gifts,-759.44,-22466.02
buyer_1,Luis,28,ES18209585214414889696,TRX_N-00335-38920390,2022-10-25T15:15:17,Bilbao,expenses,food,-113.47,-22579.49
buyer_1,Luis,28,ES18209585214414889696,TRX_N-00336-75250603,2022-10-25T18:32:22,Bilbao,expenses,transport,-55.77,-22635.26
buyer_1,Luis,28,ES18209585214414889696,TRX_N-00337-89894892,2022-10-26T10:41:22,Basauri,expenses,leisure,-24.81,-22660.07
buyer_1,Luis,28,ES18209585214414889696,TRX_N-00338-66483889,2022-10-29T13:41:40,Bilbao,expenses,leisure,-66.64,-22726.71
buyer_1,Luis,28,ES18209585214414889696,TRX_N-00339-59214025,2022-10-30T08:00:14,Arrasate,expenses,cash,-100.0,-22826.71
buyer_1,Luis,28,ES18209585214414889696,TRX_N-00340-43560919,2022-10-31T16:37:04,Bilbao,expenses,transport,-63.45,-22890.16
buyer_1,Luis,28,ES18209585214414889696,TRX_N-00341-03859169,2022-10-31T20:39:45,Bilbao,expenses,cash,-100.0,-22990.16
buyer_1,Luis,28,ES18209585214414889696,TRX_N-00342-19887086,2022-11-01T16:22:54,Bilbao,incomes,salary,1320.37,-21669.79
buyer_1,Luis,28,ES18209585214414889696,TRX_N-00343-71776349,2022-11-01T16:22:54,Bilbao,incomes,salary_partner,1021.78,-20648.01
buyer_1,Luis,28,ES18209585214414889696,TRX_N-00344-02551032,2022-11-01T16:22:54,Bilbao,incomes,extra_income,134.54,-20513.47
buyer_1,Luis,28,ES18209585214414889696,TRX_N-00345-68319513,2022-11-01T16:27:14,Bilbao,expenses,transport,-88.95,-20602.42
buyer_1,Luis,28,ES18209585214414889696,TRX_N-00346-10049131,2022-11-01T20:58:35,Bilbao,expenses,leisure,-80.81,-20683.23
buyer_1,Luis,28,ES18209585214414889696,TRX_N-00347-43818891,2022-11-01T17:38:02,Bilbao,expenses,children,-137.3,-20820.53
buyer_1,Luis,28,ES18209585214414889696,TRX_N-00348-85809623,2022-11-02T06:47:15,Bilbao,expenses,transport,-47.02,-20867.55
buyer_1,Luis,28,ES18209585214414889696,TRX_N-00349-98876996,2022-11-03T00:44:33,Bilbao,expenses,leisure,-36.46,-20904.01
buyer_1,Luis,28,ES18209585214414889696,TRX_N-00350-20630987,2022-11-03T21:14:10,Bilbao,expenses,children,-256.93,-21160.94
buyer_1,Luis,28,ES18209585214414889696,TRX_N-00351-69623301,2022-11-04T10:46:57,Bilbao,expenses,mortgage,-1090.03,-22250.97
buyer_1,Luis,28,ES18209585214414889696,TRX_N-00352-67137955,2022-11-04T21:47:23,Bilbao,expenses,food,-106.8,-22357.77
buyer_1,Luis,28,ES18209585214414889696,TRX_N-00353-52598247,2022-11-05T20:21:12,Bilbao,expenses,gas,-56.96,-22414.73
buyer_1,Luis,28,ES18209585214414889696,TRX_N-00354-18247059,2022-11-05T15:31:55,Bilbao,expenses,internet,-42.0,-22456.73
buyer_1,Luis,28,ES18209585214414889696,TRX_N-00355-78263590,2022-11-06T17:00:43,Bilbao,expenses,phone,-44.35,-22501.08
buyer_1,Luis,28,ES18209585214414889696,TRX_N-00356-44910632,2022-11-07T08:47:10,Bilbao,expenses,cash,-100.0,-22601.08
buyer_1,Luis,28,ES18209585214414889696,TRX_N-00357-06565523,2022-11-08T22:35:57,Bilbao,expenses,water,-37.15,-22638.23
buyer_1,Luis,28,ES18209585214414889696,TRX_N-00358-24331328,2022-11-08T02:27:09,Bilbao,expenses,electricity,-76.1,-22714.33
buyer_1,Luis,28,ES18209585214414889696,TRX_N-00359-04718986,2022-11-08T10:28:28,Bilbao,expenses,education,-62.82,-22777.15
buyer_1,Luis,28,ES18209585214414889696,TRX_N-00360-73343072,2022-11-09T16:13:26,Bilbao,expenses,leisure,-42.05,-22819.2
buyer_1,Luis,28,ES18209585214414889696,TRX_N-00361-34326305,2022-11-09T19:05:13,Bilbao,expenses,cash,-100.0,-22919.2
buyer_1,Luis,28,ES18209585214414889696,TRX_N-00362-36596903,2022-11-10T09:20:31,Getxo,expenses,food,-83.15,-23002.35
buyer_1,Luis,28,ES18209585214414889696,TRX_N-00363-82827356,2022-11-10T20:26:22,Bilbao,expenses,healthcare,-55.67,-23058.02
buyer_1,Luis,28,ES18209585214414889696,TRX_N-00364-60752271,2022-11-10T11:40:17,Durango,expenses,cash,-100.0,-23158.02
buyer_1,Luis,28,ES18209585214414889696,TRX_N-00365-29942872,2022-11-10T18:19:47,Bilbao,expenses,repairs,-179.71,-23337.73
buyer_1,Luis,28,ES18209585214414889696,TRX_N-00366-47315396,2022-11-11T13:30:21,Bilbao,expenses,gifts,-456.77,-23794.5
buyer_1,Luis,28,ES18209585214414889696,TRX_N-00367-22277719,2022-11-12T15:43:58,Bilbao,expenses,clothing,-136.77,-23931.27
buyer_1,Luis,28,ES18209585214414889696,TRX_N-00368-17879391,2022-11-13T08:43:57,Vitoria-Gasteiz,expenses,travel,-1759.49,-25690.76
buyer_1,Luis,28,ES18209585214414889696,TRX_N-00369-87936279,2022-11-14T11:47:39,Bilbao,expenses,food,-81.54,-25772.3
buyer_1,Luis,28,ES18209585214414889696,TRX_N-00370-36616143,2022-11-14T11:58:54,Bilbao,expenses,leisure,-61.34,-25833.64
buyer_1,Luis,28,ES18209585214414889696,TRX_N-00371-90592738,2022-11-17T14:34:08,Zuia,expenses,transport,-40.9,-25874.54
buyer_1,Luis,28,ES18209585214414889696,TRX_N-00372-49852128,2022-11-17T08:07:40,Bilbao,expenses,education,-52.28,-25926.82
buyer_1,Luis,28,ES18209585214414889696,TRX_N-00373-35920551,2022-11-17T10:21:45,Bilbao,expenses,repairs,-288.7,-26215.52
buyer_1,Luis,28,ES18209585214414889696,TRX_N-00374-20390612,2022-11-18T20:18:09,Lasarte-Oria,expenses,food,-115.26,-26330.78
buyer_1,Luis,28,ES18209585214414889696,TRX_N-00375-28058808,2022-11-18T20:55:24,Bilbao,expenses,appliances,-307.87,-26638.65
buyer_1,Luis,28,ES18209585214414889696,TRX_N-00376-22279994,2022-11-19T12:21:24,Bilbao,expenses,clothing,-108.54,-26747.19
buyer_1,Luis,28,ES18209585214414889696,TRX_N-00377-34310874,2022-11-20T13:23:02,Bilbao,expenses,food,-123.49,-26870.68
buyer_1,Luis,28,ES18209585214414889696,TRX_N-00378-87394046,2022-11-23T19:23:57,Bilbao,expenses,food,-63.49,-26934.17
buyer_1,Luis,28,ES18209585214414889696,TRX_N-00379-92664229,2022-11-23T17:29:50,Bilbao,expenses,repairs,-159.68,-27093.85
buyer_1,Luis,28,ES18209585214414889696,TRX_N-00380-39477754,2022-11-24T09:47:32,Basauri,expenses,transport,-63.92,-27157.77
buyer_1,Luis,28,ES18209585214414889696,TRX_N-00381-65753369,2022-11-24T18:41:51,Labastida,expenses,leisure,-69.74,-27227.51
buyer_1,Luis,28,ES18209585214414889696,TRX_N-00382-58940767,2022-11-25T12:38:55,Erandio,expenses,food,-73.08,-27300.59
buyer_1,Luis,28,ES18209585214414889696,TRX_N-00383-78657982,2022-11-26T09:57:24,Bilbao,expenses,transport,-47.77,-27348.36
buyer_1,Luis,28,ES18209585214414889696,TRX_N-00384-45456331,2022-11-29T13:19:42,Bilbao,expenses,clothing,-79.53,-27427.89
buyer_1,Luis,28,ES18209585214414889696,TRX_N-00385-44267503,2022-11-29T15:43:24,Bilbao,expenses,cash,-100.0,-27527.89
buyer_1,Luis,28,ES18209585214414889696,TRX_N-00386-73494793,2022-11-29T14:02:05,Bilbao,expenses,children,-73.1,-27600.99
buyer_1,Luis,28,ES18209585214414889696,TRX_N-00387-36814378,2022-11-30T11:18:30,Bilbao,expenses,cash,-100.0,-27700.99
buyer_1,Luis,28,ES18209585214414889696,TRX_N-00388-80400896,2022-12-01T19:10:10,Bilbao,incomes,salary,1320.37,-26380.62
buyer_1,Luis,28,ES18209585214414889696,TRX_N-00389-60682671,2022-12-01T19:10:10,Bilbao,incomes,salary_partner,1021.78,-25358.84
buyer_1,Luis,28,ES18209585214414889696,TRX_N-00390-35912896,2022-12-01T19:10:10,Bilbao,incomes,salary_bonus,976.37,-24382.47
buyer_1,Luis,28,ES18209585214414889696,TRX_N-00391-48129280,2022-12-01T19:10:10,Bilbao,incomes,salary_partner_bonus,803.18,-23579.29
buyer_1,Luis,28,ES18209585214414889696,TRX_N-00392-74285741,2022-12-01T13:34:40,Bilbao,expenses,cash,-100.0,-23679.29
buyer_1,Luis,28,ES18209585214414889696,TRX_N-00393-35628188,2022-12-01T00:30:47,Bilbao,expenses,gifts,-733.51,-24412.8
buyer_1,Luis,28,ES18209585214414889696,TRX_N-00394-62541680,2022-12-02T20:49:37,Bilbao,expenses,transport,-84.69,-24497.49
buyer_1,Luis,28,ES18209585214414889696,TRX_N-00395-36650167,2022-12-02T20:58:54,Bilbao,expenses,healthcare,-105.6,-24603.09
buyer_1,Luis,28,ES18209585214414889696,TRX_N-00396-53525692,2022-12-03T23:25:47,Hondarribia,expenses,leisure,-60.31,-24663.4
buyer_1,Luis,28,ES18209585214414889696,TRX_N-00397-83820069,2022-12-04T19:44:48,Bilbao,expenses,mortgage,-1090.03,-25753.43
buyer_1,Luis,28,ES18209585214414889696,TRX_N-00398-46849661,2022-12-04T12:46:24,Bilbao,expenses,food,-109.71,-25863.14
buyer_1,Luis,28,ES18209585214414889696,TRX_N-00399-91749746,2022-12-04T19:24:12,Bilbao,expenses,gifts,-566.18,-26429.32
buyer_1,Luis,28,ES18209585214414889696,TRX_N-00400-42537298,2022-12-05T15:52:42,Bilbao,expenses,phone,-44.56,-26473.88
buyer_1,Luis,28,ES18209585214414889696,TRX_N-00401-94525846,2022-12-05T21:22:12,Leioa,expenses,leisure,-84.04,-26557.92
buyer_1,Luis,28,ES18209585214414889696,TRX_N-00402-09326426,2022-12-06T18:41:35,Bilbao,expenses,water,-30.1,-26588.02
buyer_1,Luis,28,ES18209585214414889696,TRX_N-00403-09272566,2022-12-06T12:53:35,Bilbao,expenses,electricity,-46.09,-26634.11
buyer_1,Luis,28,ES18209585214414889696,TRX_N-00404-61326894,2022-12-06T08:23:09,Errenteria,expenses,transport,-86.65,-26720.76
buyer_1,Luis,28,ES18209585214414889696,TRX_N-00405-48312577,2022-12-07T12:27:12,Berango,expenses,appliances,-187.46,-26908.22
buyer_1,Luis,28,ES18209585214414889696,TRX_N-00406-84844630,2022-12-08T10:56:08,Bilbao,expenses,gas,-94.1,-27002.32
buyer_1,Luis,28,ES18209585214414889696,TRX_N-00407-08271201,2022-12-08T13:43:39,Bilbao,expenses,internet,-42.0,-27044.32
buyer_1,Luis,28,ES18209585214414889696,TRX_N-00408-87002581,2022-12-11T11:44:37,Bilbao,expenses,cash,-100.0,-27144.32
buyer_1,Luis,28,ES18209585214414889696,TRX_N-00409-31998903,2022-12-13T19:38:33,Bilbao,expenses,clothing,-104.27,-27248.59
buyer_1,Luis,28,ES18209585214414889696,TRX_N-00410-83698662,2022-12-14T11:45:13,Bilbao,expenses,leisure,-67.54,-27316.13
buyer_1,Luis,28,ES18209585214414889696,TRX_N-00411-27966495,2022-12-14T18:03:33,Elciego,expenses,cash,-100.0,-27416.13
buyer_1,Luis,28,ES18209585214414889696,TRX_N-00412-16288462,2022-12-14T20:04:50,Bilbao,expenses,gifts,-614.83,-28030.96
buyer_1,Luis,28,ES18209585214414889696,TRX_N-00413-56805553,2022-12-15T19:24:10,Irun,expenses,gifts,-777.8,-28808.76
buyer_1,Luis,28,ES18209585214414889696,TRX_N-00414-18208458,2022-12-16T19:59:00,Santurtzi,expenses,clothing,-66.3,-28875.06
buyer_1,Luis,28,ES18209585214414889696,TRX_N-00415-04871209,2022-12-16T09:39:19,Pasaia,expenses,cash,-100.0,-28975.06
buyer_1,Luis,28,ES18209585214414889696,TRX_N-00416-99657367,2022-12-17T16:48:40,Bilbao,expenses,food,-74.41,-29049.47
buyer_1,Luis,28,ES18209585214414889696,TRX_N-00417-59751382,2022-12-17T11:08:58,Andoain,expenses,repairs,-299.02,-29348.49
buyer_1,Luis,28,ES18209585214414889696,TRX_N-00418-53434035,2022-12-18T08:12:13,Leioa,expenses,appliances,-337.39,-29685.88
buyer_1,Luis,28,ES18209585214414889696,TRX_N-00419-57379725,2022-12-20T13:12:38,Bilbao,expenses,children,-105.45,-29791.33
buyer_1,Luis,28,ES18209585214414889696,TRX_N-00420-39056899,2022-12-21T05:32:05,Bilbao,expenses,gifts,-162.1,-29953.43
buyer_1,Luis,28,ES18209585214414889696,TRX_N-00421-47125986,2022-12-22T17:52:48,Bilbao,expenses,leisure,-75.75,-30029.18
buyer_1,Luis,28,ES18209585214414889696,TRX_N-00422-54144243,2022-12-23T09:31:13,Bilbao,expenses,food,-118.32,-30147.5
buyer_1,Luis,28,ES18209585214414889696,TRX_N-00423-23857700,2022-12-24T17:50:57,Bilbao,expenses,leisure,-71.81,-30219.31
buyer_1,Luis,28,ES18209585214414889696,TRX_N-00424-82991975,2022-12-24T17:27:23,Basauri,expenses,cash,-100.0,-30319.31
buyer_1,Luis,28,ES18209585214414889696,TRX_N-00425-13709983,2022-12-28T10:12:50,Bilbao,expenses,children,-66.58,-30385.89
buyer_1,Luis,28,ES18209585214414889696,TRX_N-00426-68880455,2022-12-29T10:17:12,Bilbao,expenses,transport,-87.64,-30473.53
buyer_1,Luis,28,ES18209585214414889696,TRX_N-00427-79480522,2022-12-29T09:11:52,Bilbao,expenses,appliances,-386.57,-30860.1
buyer_1,Luis,28,ES18209585214414889696,TRX_N-00428-40620053,2022-12-30T20:23:58,Bilbao,expenses,cash,-100.0,-30960.1
buyer_1,Luis,28,ES18209585214414889696,TRX_N-00429-90791981,2022-12-31T11:04:08,Bilbao,expenses,transport,-71.18,-31031.28
buyer_1,Luis,28,ES18209585214414889696,TRX_N-00430-12155142,2022-12-31T15:00:21,Bilbao,expenses,clothing,-58.13,-31089.41
buyer_1,Luis,28,ES18209585214414889696,TRX_N-00431-99987521,2022-12-31T19:16:26,Bilbao,expenses,cash,-100.0,-31189.41
buyer_1,Luis,28,ES18209585214414889696,TRX_N-00432-66475170,2023-01-01T08:59:20,Bilbao,incomes,salary,1348.39,-29841.02
buyer_1,Luis,28,ES18209585214414889696,TRX_N-00433-72778285,2023-01-01T08:59:20,Bilbao,incomes,salary_partner,1043.47,-28797.55
buyer_1,Luis,28,ES18209585214414889696,TRX_N-00434-08491931,2023-01-01T11:51:01,Bilbao,expenses,repairs,-314.13,-29111.68
buyer_1,Luis,28,ES18209585214414889696,TRX_N-00435-94902739,2023-01-02T19:44:39,Lasarte-Oria,expenses,education,-55.79,-29167.47
buyer_1,Luis,28,ES18209585214414889696,TRX_N-00436-04727501,2023-01-02T19:48:24,Bilbao,expenses,repairs,-190.27,-29357.74
buyer_1,Luis,28,ES18209585214414889696,TRX_N-00437-88299473,2023-01-04T19:51:12,Bilbao,expenses,mortgage,-1090.03,-30447.77
buyer_1,Luis,28,ES18209585214414889696,TRX_N-00438-74852726,2023-01-05T17:21:36,Bilbao,expenses,healthcare,-139.02,-30586.79
buyer_1,Luis,28,ES18209585214414889696,TRX_N-00439-15667723,2023-01-05T09:29:48,Salvatierra/Agurain,expenses,cash,-100.0,-30686.79
buyer_1,Luis,28,ES18209585214414889696,TRX_N-00440-03603304,2023-01-06T14:51:32,Bilbao,expenses,gas,-42.78,-30729.57
buyer_1,Luis,28,ES18209585214414889696,TRX_N-00441-06159837,2023-01-06T12:08:46,Bilbao,expenses,internet,-42.0,-30771.57
buyer_1,Luis,28,ES18209585214414889696,TRX_N-00442-55964288,2023-01-06T10:15:41,Labastida,expenses,gifts,-103.62,-30875.19
buyer_1,Luis,28,ES18209585214414889696,TRX_N-00443-99643455,2023-01-07T09:57:58,Bilbao,expenses,cash,-100.0,-30975.19
buyer_1,Luis,28,ES18209585214414889696,TRX_N-00444-23475727,2023-01-08T21:27:22,Bilbao,expenses,phone,-43.25,-31018.44
buyer_1,Luis,28,ES18209585214414889696,TRX_N-00445-91875731,2023-01-08T12:00:50,Bilbao,expenses,water,-39.96,-31058.4
buyer_1,Luis,28,ES18209585214414889696,TRX_N-00446-61284811,2023-01-08T09:24:19,Bilbao,expenses,electricity,-38.36,-31096.76
buyer_1,Luis,28,ES18209585214414889696,TRX_N-00447-43129585,2023-01-08T10:44:26,Bilbao,expenses,food,-104.24,-31201.0
buyer_1,Luis,28,ES18209585214414889696,TRX_N-00448-12146910,2023-01-10T15:11:54,Bilbao,expenses,gifts,-426.52,-31627.52
buyer_1,Luis,28,ES18209585214414889696,TRX_N-00449-51392327,2023-01-12T11:55:24,Bilbao,expenses,leisure,-21.48,-31649.0
buyer_1,Luis,28,ES18209585214414889696,TRX_N-00450-30503806,2023-01-12T18:54:22,Bilbao,expenses,gifts,-683.71,-32332.71
buyer_1,Luis,28,ES18209585214414889696,TRX_N-00451-99622048,2023-01-14T06:21:07,Arrasate,expenses,cash,-100.0,-32432.71
buyer_1,Luis,28,ES18209585214414889696,TRX_N-00452-65219863,2023-01-15T16:30:10,Bilbao,expenses,appliances,-315.7,-32748.41
buyer_1,Luis,28,ES18209585214414889696,TRX_N-00453-97539103,2023-01-19T05:16:42,Bilbao,expenses,cash,-100.0,-32848.41
buyer_1,Luis,28,ES18209585214414889696,TRX_N-00454-71481616,2023-01-20T13:59:31,Bilbao,expenses,cash,-100.0,-32948.41
buyer_1,Luis,28,ES18209585214414889696,TRX_N-00455-19474072,2023-01-21T17:43:24,Bilbao,expenses,transport,-77.51,-33025.92
buyer_1,Luis,28,ES18209585214414889696,TRX_N-00456-73845002,2023-01-22T19:55:36,Bilbao,expenses,healthcare,-135.43,-33161.35
buyer_1,Luis,28,ES18209585214414889696,TRX_N-00457-66714251,2023-01-24T11:28:41,Santurtzi,expenses,gifts,-609.13,-33770.48
buyer_1,Luis,28,ES18209585214414889696,TRX_N-00458-03372078,2023-01-25T20:11:22,Bilbao,expenses,food,-101.29,-33871.77
buyer_1,Luis,28,ES18209585214414889696,TRX_N-00459-20129526,2023-01-25T14:15:35,Bilbao,expenses,cash,-100.0,-33971.77
buyer_1,Luis,28,ES18209585214414889696,TRX_N-00460-00020322,2023-01-27T10:27:36,Bilbao,expenses,transport,-82.96,-34054.73
buyer_1,Luis,28,ES18209585214414889696,TRX_N-00461-43340229,2023-01-27T16:40:47,Bilbao,expenses,travel,-735.06,-34789.79
buyer_1,Luis,28,ES18209585214414889696,TRX_N-00462-62861066,2023-01-28T11:42:00,Bilbao,expenses,gifts,-497.53,-35287.32
buyer_1,Luis,28,ES18209585214414889696,TRX_N-00463-55596048,2023-01-29T15:34:01,Bilbao,expenses,food,-74.51,-35361.83
buyer_1,Luis,28,ES18209585214414889696,TRX_N-00464-54467512,2023-01-29T09:20:28,Bilbao,expenses,education,-46.28,-35408.11
buyer_1,Luis,28,ES18209585214414889696,TRX_N-00465-82949665,2023-01-29T14:07:37,Bilbao,expenses,gifts,-346.94,-35755.05
buyer_1,Luis,28,ES18209585214414889696,TRX_N-00466-53597475,2023-01-30T19:11:55,Bilbao,expenses,cash,-100.0,-35855.05
buyer_1,Luis,28,ES18209585214414889696,TRX_N-00467-22787919,2023-01-31T22:18:41,Bilbao,expenses,clothing,-47.56,-35902.61
buyer_1,Luis,28,ES18209585214414889696,TRX_N-00468-75303432,2023-02-01T03:17:19,Bilbao,incomes,salary,1348.39,-34554.22
buyer_1,Luis,28,ES18209585214414889696,TRX_N-00469-30248284,2023-02-01T03:17:19,Bilbao,incomes,salary_partner,1043.47,-33510.75
buyer_1,Luis,28,ES18209585214414889696,TRX_N-00470-18141401,2023-02-01T03:17:19,Bilbao,incomes,extra_income,134.54,-33376.21
buyer_1,Luis,28,ES18209585214414889696,TRX_N-00471-76591120,2023-02-01T11:51:50,Bilbao,expenses,education,-46.85,-33423.06
buyer_1,Luis,28,ES18209585214414889696,TRX_N-00472-60872126,2023-02-01T15:21:41,Sestao,expenses,cash,-100.0,-33523.06
buyer_1,Luis,28,ES18209585214414889696,TRX_N-00473-38762573,2023-02-01T10:52:59,Errenteria,expenses,repairs,-183.32,-33706.38
buyer_1,Luis,28,ES18209585214414889696,TRX_N-00474-53095678,2023-02-02T19:43:20,Bilbao,expenses,transport,-69.93,-33776.31
buyer_1,Luis,28,ES18209585214414889696,TRX_N-00475-16826497,2023-02-02T19:46:25,Bilbao,expenses,cash,-100.0,-33876.31
buyer_1,Luis,28,ES18209585214414889696,TRX_N-00476-75097807,2023-02-04T18:47:13,Bilbao,expenses,mortgage,-1090.03,-34966.34
buyer_1,Luis,28,ES18209585214414889696,TRX_N-00477-06274938,2023-02-04T05:20:31,Bilbao,expenses,food,-89.84,-35056.18
buyer_1,Luis,28,ES18209585214414889696,TRX_N-00478-24121057,2023-02-04T17:50:22,Bilbao,expenses,clothing,-123.29,-35179.47
buyer_1,Luis,28,ES18209585214414889696,TRX_N-00479-55197122,2023-02-04T13:08:44,Bilbao,expenses,cash,-100.0,-35279.47
buyer_1,Luis,28,ES18209585214414889696,TRX_N-00480-84907443,2023-02-04T20:55:36,Bilbao,expenses,appliances,-94.54,-35374.01
buyer_1,Luis,28,ES18209585214414889696,TRX_N-00481-14386422,2023-02-05T18:58:00,Bilbao,expenses,gas,-37.79,-35411.8
buyer_1,Luis,28,ES18209585214414889696,TRX_N-00482-26505039,2023-02-05T20:55:55,Bermeo,expenses,food,-60.92,-35472.72
buyer_1,Luis,28,ES18209585214414889696,TRX_N-00483-07570873,2023-02-05T13:19:30,Bilbao,expenses,gifts,-566.02,-36038.74
buyer_1,Luis,28,ES18209585214414889696,TRX_N-00484-38498004,2023-02-06T07:17:45,Bilbao,expenses,water,-29.41,-36068.15
buyer_1,Luis,28,ES18209585214414889696,TRX_N-00485-42844451,2023-02-06T11:47:48,Bilbao,expenses,cash,-100.0,-36168.15
buyer_1,Luis,28,ES18209585214414889696,TRX_N-00486-99506893,2023-02-08T23:40:21,Bilbao,expenses,phone,-44.67,-36212.82
buyer_1,Luis,28,ES18209585214414889696,TRX_N-00487-51413473,2023-02-08T12:53:58,Bilbao,expenses,electricity,-69.69,-36282.51
buyer_1,Luis,28,ES18209585214414889696,TRX_N-00488-73422505,2023-02-08T10:32:08,Bilbao,expenses,internet,-42.0,-36324.51
buyer_1,Luis,28,ES18209585214414889696,TRX_N-00489-09637190,2023-02-11T12:12:29,Bilbao,expenses,cash,-100.0,-36424.51
buyer_1,Luis,28,ES18209585214414889696,TRX_N-00490-36872296,2023-02-12T11:26:53,Bilbao,expenses,food,-78.76,-36503.27
buyer_1,Luis,28,ES18209585214414889696,TRX_N-00491-32764701,2023-02-12T13:46:52,Bilbao,expenses,leisure,-50.1,-36553.37
buyer_1,Luis,28,ES18209585214414889696,TRX_N-00492-24772185,2023-02-15T08:29:20,Bilbao,expenses,leisure,-80.4,-36633.77
buyer_1,Luis,28,ES18209585214414889696,TRX_N-00493-54853685,2023-02-15T12:25:51,Bilbao,expenses,travel,-1161.34,-37795.11
buyer_1,Luis,28,ES18209585214414889696,TRX_N-00494-30911059,2023-02-16T08:08:30,Bilbao,expenses,leisure,-42.22,-37837.33
buyer_1,Luis,28,ES18209585214414889696,TRX_N-00495-23305795,2023-02-16T05:51:45,Bilbao,expenses,education,-58.65,-37895.98
buyer_1,Luis,28,ES18209585214414889696,TRX_N-00496-44853763,2023-02-17T08:15:48,Bilbao,expenses,leisure,-29.41,-37925.39
buyer_1,Luis,28,ES18209585214414889696,TRX_N-00497-87683936,2023-02-18T19:00:12,Bilbao,expenses,cash,-100.0,-38025.39
buyer_1,Luis,28,ES18209585214414889696,TRX_N-00498-33014957,2023-02-19T14:25:13,Bilbao,expenses,repairs,-193.7,-38219.09
buyer_1,Luis,28,ES18209585214414889696,TRX_N-00499-93275440,2023-02-20T12:09:00,Alegría-Dulantzi,expenses,gifts,-150.36,-38369.45
buyer_1,Luis,28,ES18209585214414889696,TRX_N-00500-10983820,2023-02-24T20:59:34,Oyón-Oion,expenses,cash,-100.0,-38469.45
buyer_1,Luis,28,ES18209585214414889696,TRX_N-00501-59539193,2023-02-25T17:19:29,Bilbao,expenses,food,-113.27,-38582.72
buyer_1,Luis,28,ES18209585214414889696,TRX_N-00502-29196843,2023-02-26T09:26:49,Bilbao,expenses,leisure,-37.14,-38619.86
buyer_1,Luis,28,ES18209585214414889696,TRX_N-00503-74937761,2023-02-26T22:31:35,Bilbao,expenses,gifts,-704.5,-39324.36
buyer_1,Luis,28,ES18209585214414889696,TRX_N-00504-32068456,2023-02-27T12:31:42,Bilbao,expenses,appliances,-286.22,-39610.58
buyer_1,Luis,28,ES18209585214414889696,TRX_N-00505-40258160,2023-03-01T13:03:49,Bilbao,incomes,salary,1348.39,-38262.19
buyer_1,Luis,28,ES18209585214414889696,TRX_N-00506-54897775,2023-03-01T13:03:49,Bilbao,incomes,salary_partner,1043.47,-37218.72
buyer_1,Luis,28,ES18209585214414889696,TRX_N-00507-04506478,2023-03-01T15:11:15,Bilbao,expenses,transport,-79.24,-37297.96
buyer_1,Luis,28,ES18209585214414889696,TRX_N-00508-37837474,2023-03-01T05:27:49,Bilbao,expenses,clothing,-95.02,-37392.98
buyer_1,Luis,28,ES18209585214414889696,TRX_N-00509-28537932,2023-03-03T23:26:30,Bilbao,expenses,transport,-80.23,-37473.21
buyer_1,Luis,28,ES18209585214414889696,TRX_N-00510-95126758,2023-03-04T15:11:30,Bilbao,expenses,mortgage,-1090.03,-38563.24
buyer_1,Luis,28,ES18209585214414889696,TRX_N-00511-89216827,2023-03-04T12:23:44,Bilbao,expenses,appliances,-277.4,-38840.64
buyer_1,Luis,28,ES18209585214414889696,TRX_N-00512-68179369,2023-03-05T10:04:53,Bilbao,expenses,cash,-100.0,-38940.64
buyer_1,Luis,28,ES18209585214414889696,TRX_N-00513-45207594,2023-03-05T13:48:28,Bilbao,expenses,repairs,-135.26,-39075.9
buyer_1,Luis,28,ES18209585214414889696,TRX_N-00514-08626953,2023-03-05T17:16:47,Elciego,expenses,gifts,-99.65,-39175.55
buyer_1,Luis,28,ES18209585214414889696,TRX_N-00515-22264516,2023-03-06T17:54:22,Elciego,expenses,appliances,-274.44,-39449.99
buyer_1,Luis,28,ES18209585214414889696,TRX_N-00516-50230323,2023-03-07T12:04:08,Bilbao,expenses,electricity,-68.94,-39518.93
buyer_1,Luis,28,ES18209585214414889696,TRX_N-00517-65705131,2023-03-07T09:03:11,Bilbao,expenses,healthcare,-176.68,-39695.61
buyer_1,Luis,28,ES18209585214414889696,TRX_N-00518-70443500,2023-03-08T19:09:42,Bilbao,expenses,water,-23.18,-39718.79
buyer_1,Luis,28,ES18209585214414889696,TRX_N-00519-77367306,2023-03-08T14:40:40,Bilbao,expenses,gas,-101.55,-39820.34
buyer_1,Luis,28,ES18209585214414889696,TRX_N-00520-68134289,2023-03-08T18:47:05,Bilbao,expenses,internet,-42.0,-39862.34
buyer_1,Luis,28,ES18209585214414889696,TRX_N-00521-19124480,2023-03-08T21:07:45,Bilbao,expenses,phone,-36.17,-39898.51
buyer_1,Luis,28,ES18209585214414889696,TRX_N-00522-45967335,2023-03-08T09:56:44,Zarautz,expenses,cash,-100.0,-39998.51
buyer_1,Luis,28,ES18209585214414889696,TRX_N-00523-07156736,2023-03-09T09:49:55,Bilbao,expenses,transport,-42.12,-40040.63
buyer_1,Luis,28,ES18209585214414889696,TRX_N-00524-59423708,2023-03-11T18:39:03,Bilbao,expenses,food,-83.19,-40123.82
buyer_1,Luis,28,ES18209585214414889696,TRX_N-00525-71534712,2023-03-11T18:23:21,Bilbao,expenses,transport,-42.53,-40166.35
buyer_1,Luis,28,ES18209585214414889696,TRX_N-00526-12383487,2023-03-11T14:50:58,Bilbao,expenses,gifts,-608.56,-40774.91
buyer_1,Luis,28,ES18209585214414889696,TRX_N-00527-01955422,2023-03-12T19:25:51,Bilbao,expenses,transport,-51.73,-40826.64
buyer_1,Luis,28,ES18209585214414889696,TRX_N-00528-81111311,2023-03-12T17:43:26,Bilbao,expenses,clothing,-52.31,-40878.95
buyer_1,Luis,28,ES18209585214414889696,TRX_N-00529-74098618,2023-03-14T16:52:19,Bilbao,expenses,food,-116.55,-40995.5
buyer_1,Luis,28,ES18209585214414889696,TRX_N-00530-59106173,2023-03-14T13:32:33,Bilbao,expenses,education,-72.17,-41067.67
buyer_1,Luis,28,ES18209585214414889696,TRX_N-00531-66856520,2023-03-14T09:57:57,Bilbao,expenses,children,-67.07,-41134.74
buyer_1,Luis,28,ES18209585214414889696,TRX_N-00532-61149729,2023-03-15T08:53:13,Bilbao,expenses,leisure,-43.72,-41178.46
buyer_1,Luis,28,ES18209585214414889696,TRX_N-00533-39840897,2023-03-15T06:05:45,Bilbao,expenses,gifts,-485.68,-41664.14
buyer_1,Luis,28,ES18209585214414889696,TRX_N-00534-97289728,2023-03-16T09:02:14,Bilbao,expenses,cash,-100.0,-41764.14
buyer_1,Luis,28,ES18209585214414889696,TRX_N-00535-74586815,2023-03-17T18:11:35,Bilbao,expenses,healthcare,-99.44,-41863.58
buyer_1,Luis,28,ES18209585214414889696,TRX_N-00536-41731928,2023-03-17T20:45:04,Berango,expenses,repairs,-245.39,-42108.97
buyer_1,Luis,28,ES18209585214414889696,TRX_N-00537-16187987,2023-03-19T08:08:55,Errenteria,expenses,food,-77.53,-42186.5
buyer_1,Luis,28,ES18209585214414889696,TRX_N-00538-70784076,2023-03-21T19:49:23,Bilbao,expenses,food,-117.93,-42304.43
buyer_1,Luis,28,ES18209585214414889696,TRX_N-00539-70492468,2023-03-21T08:05:15,Basauri,expenses,gifts,-294.56,-42598.99
buyer_1,Luis,28,ES18209585214414889696,TRX_N-00540-78694155,2023-03-25T13:19:00,Bilbao,expenses,food,-69.02,-42668.01
buyer_1,Luis,28,ES18209585214414889696,TRX_N-00541-23963763,2023-03-25T16:21:12,Bilbao,expenses,leisure,-64.98,-42732.99
buyer_1,Luis,28,ES18209585214414889696,TRX_N-00542-81599215,2023-03-26T10:53:35,Hernani,expenses,education,-73.34,-42806.33
buyer_1,Luis,28,ES18209585214414889696,TRX_N-00543-89213622,2023-03-29T19:47:26,Bilbao,expenses,gifts,-526.57,-43332.9
buyer_1,Luis,28,ES18209585214414889696,TRX_N-00544-62889973,2023-03-31T06:30:40,Bilbao,expenses,cash,-100.0,-43432.9
buyer_1,Luis,28,ES18209585214414889696,TRX_N-00545-93861196,2023-04-01T16:55:51,Bilbao,incomes,salary,1348.39,-42084.51
buyer_1,Luis,28,ES18209585214414889696,TRX_N-00546-34721850,2023-04-01T16:55:51,Bilbao,incomes,salary_partner,1043.47,-41041.04
buyer_1,Luis,28,ES18209585214414889696,TRX_N-00547-47025783,2023-04-02T16:14:36,Bermeo,expenses,food,-101.35,-41142.39
buyer_1,Luis,28,ES18209585214414889696,TRX_N-00548-39776626,2023-04-03T15:17:32,Berango,expenses,repairs,-41.7,-41184.09
buyer_1,Luis,28,ES18209585214414889696,TRX_N-00549-81545114,2023-04-04T09:44:04,Bilbao,expenses,mortgage,-1090.03,-42274.12
buyer_1,Luis,28,ES18209585214414889696,TRX_N-00550-22219038,2023-04-04T11:13:20,Iruña de Oca,expenses,clothing,-119.74,-42393.86
buyer_1,Luis,28,ES18209585214414889696,TRX_N-00551-92145177,2023-04-05T16:11:22,Bilbao,expenses,water,-24.74,-42418.6
buyer_1,Luis,28,ES18209585214414889696,TRX_N-00552-87099330,2023-04-05T10:16:20,Bilbao,expenses,gas,-81.57,-42500.17
buyer_1,Luis,28,ES18209585214414889696,TRX_N-00553-20357134,2023-04-05T12:49:43,Bilbao,expenses,internet,-42.0,-42542.17
buyer_1,Luis,28,ES18209585214414889696,TRX_N-00554-87321747,2023-04-06T00:24:34,Bilbao,expenses,phone,-41.59,-42583.76
buyer_1,Luis,28,ES18209585214414889696,TRX_N-00555-70108197,2023-04-07T19:37:35,Bilbao,expenses,electricity,-54.68,-42638.44
buyer_1,Luis,28,ES18209585214414889696,TRX_N-00556-40704547,2023-04-07T18:03:12,Bilbao,expenses,transport,-84.0,-42722.44
buyer_1,Luis,28,ES18209585214414889696,TRX_N-00557-34246810,2023-04-07T20:03:00,Bilbao,expenses,gifts,-727.52,-43449.96
buyer_1,Luis,28,ES18209585214414889696,TRX_N-00558-65245772,2023-04-08T17:34:14,Bilbao,expenses,transport,-59.04,-43509.0
buyer_1,Luis,28,ES18209585214414889696,TRX_N-00559-52164705,2023-04-10T10:08:10,Zuia,expenses,food,-69.09,-43578.09
buyer_1,Luis,28,ES18209585214414889696,TRX_N-00560-58907153,2023-04-11T16:26:23,Bilbao,expenses,transport,-80.21,-43658.3
buyer_1,Luis,28,ES18209585214414889696,TRX_N-00561-67871296,2023-04-11T10:15:35,Bilbao,expenses,leisure,-49.44,-43707.74
buyer_1,Luis,28,ES18209585214414889696,TRX_N-00562-63403847,2023-04-14T08:59:59,Bilbao,expenses,children,-115.18,-43822.92
buyer_1,Luis,28,ES18209585214414889696,TRX_N-00563-05031409,2023-04-15T08:42:14,Bilbao,expenses,food,-97.38,-43920.3
buyer_1,Luis,28,ES18209585214414889696,TRX_N-00564-34747377,2023-04-15T11:06:54,Bilbao,expenses,appliances,-108.18,-44028.48
buyer_1,Luis,28,ES18209585214414889696,TRX_N-00565-85529831,2023-04-15T22:05:11,Bilbao,expenses,repairs,-322.59,-44351.07
buyer_1,Luis,28,ES18209585214414889696,TRX_N-00566-64542200,2023-04-16T19:43:20,Bilbao,expenses,repairs,-235.09,-44586.16
buyer_1,Luis,28,ES18209585214414889696,TRX_N-00567-13448687,2023-04-18T08:34:45,Bilbao,expenses,food,-114.71,-44700.87
buyer_1,Luis,28,ES18209585214414889696,TRX_N-00568-81061439,2023-04-19T11:06:01,Eibar,expenses,food,-120.17,-44821.04
buyer_1,Luis,28,ES18209585214414889696,TRX_N-00569-95101897,2023-04-19T03:00:05,Vitoria-Gasteiz,expenses,transport,-75.06,-44896.1
buyer_1,Luis,28,ES18209585214414889696,TRX_N-00570-41034661,2023-04-19T10:18:27,Bilbao,expenses,repairs,-92.53,-44988.63
buyer_1,Luis,28,ES18209585214414889696,TRX_N-00571-33807951,2023-04-19T14:40:10,Bilbao,expenses,children,-250.64,-45239.27
buyer_1,Luis,28,ES18209585214414889696,TRX_N-00572-97999426,2023-04-22T10:27:15,Bilbao,expenses,food,-80.58,-45319.85
buyer_1,Luis,28,ES18209585214414889696,TRX_N-00573-58744870,2023-04-22T15:10:20,Bilbao,expenses,leisure,-46.36,-45366.21
buyer_1,Luis,28,ES18209585214414889696,TRX_N-00574-63183286,2023-04-24T12:11:20,Bilbao,expenses,food,-105.18,-45471.39
buyer_1,Luis,28,ES18209585214414889696,TRX_N-00575-69295275,2023-04-26T14:38:36,Sestao,expenses,clothing,-142.47,-45613.86
buyer_1,Luis,28,ES18209585214414889696,TRX_N-00576-38553164,2023-04-26T10:41:47,Bilbao,expenses,cash,-100.0,-45713.86
buyer_1,Luis,28,ES18209585214414889696,TRX_N-00577-97187439,2023-04-27T08:15:36,Portugalete,expenses,food,-105.59,-45819.45
buyer_1,Luis,28,ES18209585214414889696,TRX_N-00578-97431464,2023-04-28T04:11:27,Bilbao,expenses,cash,-100.0,-45919.45
buyer_1,Luis,28,ES18209585214414889696,TRX_N-00579-33342072,2023-04-29T20:29:39,Bilbao,expenses,food,-88.89,-46008.34
buyer_1,Luis,28,ES18209585214414889696,TRX_N-00580-52890918,2023-04-29T17:14:15,Bilbao,expenses,travel,-1715.04,-47723.38
buyer_1,Luis,28,ES18209585214414889696,TRX_N-00581-76796952,2023-04-30T19:29:15,Bilbao,expenses,leisure,-19.7,-47743.08
buyer_1,Luis,28,ES18209585214414889696,TRX_N-00582-25878776,2023-05-01T07:20:43,Bilbao,incomes,salary,1348.39,-46394.69
buyer_1,Luis,28,ES18209585214414889696,TRX_N-00583-04286232,2023-05-01T07:20:43,Bilbao,incomes,salary_partner,1043.47,-45351.22
buyer_1,Luis,28,ES18209585214414889696,TRX_N-00584-13484334,2023-05-01T09:55:15,Bilbao,expenses,transport,-62.28,-45413.5
buyer_1,Luis,28,ES18209585214414889696,TRX_N-00585-13062524,2023-05-01T03:35:08,Bilbao,expenses,leisure,-73.06,-45486.56
buyer_1,Luis,28,ES18209585214414889696,TRX_N-00586-24708181,2023-05-02T20:19:11,Bilbao,expenses,transport,-55.31,-45541.87
buyer_1,Luis,28,ES18209585214414889696,TRX_N-00587-57231295,2023-05-03T20:48:32,Bilbao,expenses,leisure,-21.31,-45563.18
buyer_1,Luis,28,ES18209585214414889696,TRX_N-00588-91580544,2023-05-04T17:31:36,Bilbao,expenses,mortgage,-1090.03,-46653.21
buyer_1,Luis,28,ES18209585214414889696,TRX_N-00589-43709543,2023-05-04T15:25:36,Bilbao,expenses,healthcare,-65.61,-46718.82
buyer_1,Luis,28,ES18209585214414889696,TRX_N-00590-21058885,2023-05-04T20:44:53,Bilbao,expenses,travel,-497.52,-47216.34
buyer_1,Luis,28,ES18209585214414889696,TRX_N-00591-14832090,2023-05-05T11:18:38,Bilbao,expenses,water,-34.75,-47251.09
buyer_1,Luis,28,ES18209585214414889696,TRX_N-00592-89945228,2023-05-05T11:06:57,Bilbao,expenses,repairs,-255.92,-47507.01
buyer_1,Luis,28,ES18209585214414889696,TRX_N-00593-44046859,2023-05-06T22:22:52,Bilbao,expenses,electricity,-84.7,-47591.71
buyer_1,Luis,28,ES18209585214414889696,TRX_N-00594-42498968,2023-05-06T20:33:35,Bilbao,expenses,gas,-88.98,-47680.69
buyer_1,Luis,28,ES18209585214414889696,TRX_N-00595-40244865,2023-05-07T17:57:36,Bilbao,expenses,internet,-42.0,-47722.69
buyer_1,Luis,28,ES18209585214414889696,TRX_N-00596-84270915,2023-05-07T11:40:13,Bilbao,expenses,phone,-34.64,-47757.33
buyer_1,Luis,28,ES18209585214414889696,TRX_N-00597-79011579,2023-05-07T15:47:02,Bilbao,expenses,cash,-100.0,-47857.33
buyer_1,Luis,28,ES18209585214414889696,TRX_N-00598-00169480,2023-05-08T15:10:14,Bilbao,expenses,cash,-100.0,-47957.33
buyer_1,Luis,28,ES18209585214414889696,TRX_N-00599-93518823,2023-05-09T13:36:45,Bilbao,expenses,leisure,-51.8,-48009.13
buyer_1,Luis,28,ES18209585214414889696,TRX_N-00600-08488026,2023-05-12T03:30:06,Lasarte-Oria,expenses,food,-63.66,-48072.79
buyer_1,Luis,28,ES18209585214414889696,TRX_N-00601-17363555,2023-05-13T09:12:04,Bilbao,expenses,education,-58.05,-48130.84
buyer_1,Luis,28,ES18209585214414889696,TRX_N-00602-32291317,2023-05-15T08:00:11,Bilbao,expenses,food,-113.21,-48244.05
buyer_1,Luis,28,ES18209585214414889696,TRX_N-00603-28260170,2023-05-15T09:01:10,Bilbao,expenses,gifts,-337.31,-48581.36
buyer_1,Luis,28,ES18209585214414889696,TRX_N-00604-16157232,2023-05-19T16:06:11,Bilbao,expenses,leisure,-57.07,-48638.43
buyer_1,Luis,28,ES18209585214414889696,TRX_N-00605-91789103,2023-05-24T08:15:16,Hernani,expenses,education,-48.75,-48687.18
buyer_1,Luis,28,ES18209585214414889696,TRX_N-00606-89966810,2023-05-27T16:11:49,Bilbao,expenses,leisure,-83.18,-48770.36
buyer_1,Luis,28,ES18209585214414889696,TRX_N-00607-61238242,2023-05-27T13:13:40,Bilbao,expenses,cash,-100.0,-48870.36
buyer_1,Luis,28,ES18209585214414889696,TRX_N-00608-03688340,2023-05-28T16:29:45,Lasarte-Oria,expenses,leisure,-53.87,-48924.23
buyer_1,Luis,28,ES18209585214414889696,TRX_N-00609-43824548,2023-05-28T10:03:37,Amurrio,expenses,travel,-445.43,-49369.66
buyer_1,Luis,28,ES18209585214414889696,TRX_N-00610-45161858,2023-05-29T11:08:12,Bilbao,expenses,gifts,-739.28,-50108.94
buyer_1,Luis,28,ES18209585214414889696,TRX_N-00611-79041904,2023-05-30T09:21:50,Eibar,expenses,food,-118.06,-50227.0
buyer_1,Luis,28,ES18209585214414889696,TRX_N-00612-47077344,2023-05-30T14:32:54,Bilbao,expenses,healthcare,-158.38,-50385.38
buyer_1,Luis,28,ES18209585214414889696,TRX_N-00613-01493561,2023-05-31T09:43:12,Erandio,expenses,cash,-100.0,-50485.38
buyer_1,Luis,28,ES18209585214414889696,TRX_N-00614-35907990,2023-06-01T13:05:32,Bilbao,incomes,salary,1348.39,-49136.99
buyer_1,Luis,28,ES18209585214414889696,TRX_N-00615-71150101,2023-06-01T13:05:32,Bilbao,incomes,salary_partner,1043.47,-48093.52
buyer_1,Luis,28,ES18209585214414889696,TRX_N-00616-55719880,2023-06-01T13:05:32,Bilbao,incomes,extra_income,134.54,-47958.98
buyer_1,Luis,28,ES18209585214414889696,TRX_N-00617-37568167,2023-06-01T13:05:32,Bilbao,incomes,salary_bonus,952.2,-47006.78
buyer_1,Luis,28,ES18209585214414889696,TRX_N-00618-95253628,2023-06-01T13:05:32,Bilbao,incomes,salary_partner_bonus,804.08,-46202.7
buyer_1,Luis,28,ES18209585214414889696,TRX_N-00619-35216979,2023-06-01T22:11:27,Bilbao,expenses,clothing,-65.09,-46267.79
buyer_1,Luis,28,ES18209585214414889696,TRX_N-00620-24520041,2023-06-02T21:01:24,Sopela,expenses,clothing,-88.07,-46355.86
buyer_1,Luis,28,ES18209585214414889696,TRX_N-00621-50308669,2023-06-03T09:21:35,Bilbao,expenses,food,-96.47,-46452.33
buyer_1,Luis,28,ES18209585214414889696,TRX_N-00622-84616720,2023-06-04T21:13:02,Bilbao,expenses,mortgage,-1090.03,-47542.36
buyer_1,Luis,28,ES18209585214414889696,TRX_N-00623-68850146,2023-06-05T17:25:33,Bilbao,expenses,water,-23.51,-47565.87
buyer_1,Luis,28,ES18209585214414889696,TRX_N-00624-85451145,2023-06-07T14:46:43,Bilbao,expenses,gas,-41.38,-47607.25
buyer_1,Luis,28,ES18209585214414889696,TRX_N-00625-82103186,2023-06-07T11:33:08,Bilbao,expenses,internet,-42.0,-47649.25
buyer_1,Luis,28,ES18209585214414889696,TRX_N-00626-68642992,2023-06-08T19:31:15,Bilbao,expenses,taxes,-1768.06,-49417.31
buyer_1,Luis,28,ES18209585214414889696,TRX_N-00627-30246040,2023-06-08T11:02:37,Bilbao,expenses,insurance,-594.63,-50011.94
buyer_1,Luis,28,ES18209585214414889696,TRX_N-00628-68559560,2023-06-08T01:59:47,Bilbao,expenses,electricity,-54.11,-50066.05
buyer_1,Luis,28,ES18209585214414889696,TRX_N-00629-45384297,2023-06-08T08:21:27,Bilbao,expenses,phone,-33.19,-50099.24
buyer_1,Luis,28,ES18209585214414889696,TRX_N-00630-88911842,2023-06-08T23:50:38,Bilbao,expenses,gifts,-350.92,-50450.16
buyer_1,Luis,28,ES18209585214414889696,TRX_N-00631-09746916,2023-06-09T13:35:51,Bilbao,expenses,food,-66.93,-50517.09
buyer_1,Luis,28,ES18209585214414889696,TRX_N-00632-73239715,2023-06-12T13:15:06,Elciego,expenses,cash,-100.0,-50617.09
buyer_1,Luis,28,ES18209585214414889696,TRX_N-00633-01376818,2023-06-14T09:48:41,Bilbao,expenses,leisure,-49.96,-50667.05
buyer_1,Luis,28,ES18209585214414889696,TRX_N-00634-35956995,2023-06-15T20:00:08,Bilbao,expenses,transport,-78.64,-50745.69
buyer_1,Luis,28,ES18209585214414889696,TRX_N-00635-01320383,2023-06-15T03:37:24,Bilbao,expenses,cash,-100.0,-50845.69
buyer_1,Luis,28,ES18209585214414889696,TRX_N-00636-14120610,2023-06-17T20:19:05,Bilbao,expenses,cash,-100.0,-50945.69
buyer_1,Luis,28,ES18209585214414889696,TRX_N-00637-15150331,2023-06-19T17:16:13,Bilbao,expenses,cash,-100.0,-51045.69
buyer_1,Luis,28,ES18209585214414889696,TRX_N-00638-53141396,2023-06-19T16:43:22,Bilbao,expenses,repairs,-269.79,-51315.48
buyer_1,Luis,28,ES18209585214414889696,TRX_N-00639-06039608,2023-06-20T20:15:32,Labastida,expenses,cash,-100.0,-51415.48
buyer_1,Luis,28,ES18209585214414889696,TRX_N-00640-22155196,2023-06-21T01:34:51,Bilbao,expenses,gifts,-423.66,-51839.14
buyer_1,Luis,28,ES18209585214414889696,TRX_N-00641-98905634,2023-06-26T14:15:24,Bilbao,expenses,leisure,-51.85,-51890.99
buyer_1,Luis,28,ES18209585214414889696,TRX_N-00642-16546566,2023-06-27T11:55:42,Bilbao,expenses,repairs,-298.99,-52189.98
buyer_1,Luis,28,ES18209585214414889696,TRX_N-00643-13250955,2023-06-28T09:46:51,Bilbao,expenses,appliances,-337.95,-52527.93
buyer_1,Luis,28,ES18209585214414889696,TRX_N-00644-81152829,2023-06-28T09:54:25,Bilbao,expenses,children,-189.16,-52717.09
buyer_1,Luis,28,ES18209585214414889696,TRX_N-00645-07880126,2023-06-29T02:11:22,Bilbao,expenses,food,-113.23,-52830.32
buyer_1,Luis,28,ES18209585214414889696,TRX_N-00646-31995425,2023-06-29T01:03:31,Bilbao,expenses,clothing,-91.87,-52922.19
buyer_1,Luis,28,ES18209585214414889696,TRX_N-00647-67597025,2023-06-30T07:29:14,Arrasate,expenses,cash,-100.0,-53022.19
buyer_1,Luis,28,ES18209585214414889696,TRX_N-00648-40908144,2023-07-01T15:56:27,Bilbao,incomes,salary,1348.39,-51673.8
buyer_1,Luis,28,ES18209585214414889696,TRX_N-00649-31552936,2023-07-01T15:56:27,Bilbao,incomes,salary_partner,1043.47,-50630.33
buyer_1,Luis,28,ES18209585214414889696,TRX_N-00650-74401390,2023-07-01T14:17:02,Bilbao,expenses,food,-61.85,-50692.18
buyer_1,Luis,28,ES18209585214414889696,TRX_N-00651-25449475,2023-07-01T08:33:32,Bilbao,expenses,healthcare,-156.6,-50848.78
buyer_1,Luis,28,ES18209585214414889696,TRX_N-00652-50131629,2023-07-01T18:08:05,Bilbao,expenses,education,-42.48,-50891.26
buyer_1,Luis,28,ES18209585214414889696,TRX_N-00653-94007192,2023-07-03T02:12:14,Bilbao,expenses,cash,-100.0,-50991.26
buyer_1,Luis,28,ES18209585214414889696,TRX_N-00654-81737413,2023-07-04T19:39:01,Bilbao,expenses,mortgage,-1090.03,-52081.29
buyer_1,Luis,28,ES18209585214414889696,TRX_N-00655-38044255,2023-07-05T13:30:31,Bilbao,expenses,gas,-93.33,-52174.62
buyer_1,Luis,28,ES18209585214414889696,TRX_N-00656-75605868,2023-07-05T10:04:30,Bilbao,expenses,transport,-64.72,-52239.34
buyer_1,Luis,28,ES18209585214414889696,TRX_N-00657-91305742,2023-07-05T16:48:28,Bilbao,expenses,cash,-100.0,-52339.34
buyer_1,Luis,28,ES18209585214414889696,TRX_N-00658-12032181,2023-07-06T16:09:06,Bilbao,expenses,water,-32.34,-52371.68
buyer_1,Luis,28,ES18209585214414889696,TRX_N-00659-62109003,2023-07-07T12:59:16,Bilbao,expenses,internet,-42.0,-52413.68
buyer_1,Luis,28,ES18209585214414889696,TRX_N-00660-18598026,2023-07-07T20:28:47,Bilbao,expenses,leisure,-59.56,-52473.24
buyer_1,Luis,28,ES18209585214414889696,TRX_N-00661-94041624,2023-07-08T20:09:58,Bilbao,expenses,electricity,-81.32,-52554.56
buyer_1,Luis,28,ES18209585214414889696,TRX_N-00662-48013116,2023-07-08T02:18:15,Bilbao,expenses,phone,-38.55,-52593.11
buyer_1,Luis,28,ES18209585214414889696,TRX_N-00663-46983845,2023-07-09T09:01:13,Bilbao,expenses,cash,-100.0,-52693.11
buyer_1,Luis,28,ES18209585214414889696,TRX_N-00664-53880666,2023-07-09T18:25:09,Bilbao,expenses,children,-279.76,-52972.87
buyer_1,Luis,28,ES18209585214414889696,TRX_N-00665-77754956,2023-07-10T01:32:00,Bilbao,expenses,gifts,-201.3,-53174.17
buyer_1,Luis,28,ES18209585214414889696,TRX_N-00666-11707977,2023-07-12T01:35:50,Vitoria-Gasteiz,expenses,transport,-40.09,-53214.26
buyer_1,Luis,28,ES18209585214414889696,TRX_N-00667-79686262,2023-07-14T15:49:50,Erandio,expenses,transport,-69.41,-53283.67
buyer_1,Luis,28,ES18209585214414889696,TRX_N-00668-63405535,2023-07-14T12:46:30,Erandio,expenses,gifts,-192.17,-53475.84
buyer_1,Luis,28,ES18209585214414889696,TRX_N-00669-63668890,2023-07-16T12:33:53,Bilbao,expenses,cash,-100.0,-53575.84
buyer_1,Luis,28,ES18209585214414889696,TRX_N-00670-80170857,2023-07-17T13:41:25,Bilbao,expenses,food,-96.31,-53672.15
buyer_1,Luis,28,ES18209585214414889696,TRX_N-00671-74894896,2023-07-18T23:06:28,Bilbao,expenses,food,-70.59,-53742.74
buyer_1,Luis,28,ES18209585214414889696,TRX_N-00672-08720308,2023-07-19T17:56:14,Portugalete,expenses,leisure,-76.76,-53819.5
buyer_1,Luis,28,ES18209585214414889696,TRX_N-00673-96359432,2023-07-20T16:08:42,Bilbao,expenses,food,-86.99,-53906.49
buyer_1,Luis,28,ES18209585214414889696,TRX_N-00674-15166356,2023-07-25T08:29:35,Bilbao,expenses,leisure,-82.46,-53988.95
buyer_1,Luis,28,ES18209585214414889696,TRX_N-00675-18651912,2023-07-27T08:26:36,Bilbao,expenses,cash,-100.0,-54088.95
buyer_1,Luis,28,ES18209585214414889696,TRX_N-00676-63877278,2023-07-30T10:17:27,Bilbao,expenses,repairs,-283.65,-54372.6
buyer_1,Luis,28,ES18209585214414889696,TRX_N-00677-95469524,2023-08-01T16:07:52,Bilbao,incomes,salary,1348.39,-53024.21
buyer_1,Luis,28,ES18209585214414889696,TRX_N-00678-97259086,2023-08-01T16:07:52,Bilbao,incomes,salary_partner,1043.47,-51980.74
buyer_1,Luis,28,ES18209585214414889696,TRX_N-00679-98215467,2023-08-01T15:50:00,Bilbao,expenses,healthcare,-188.66,-52169.4
buyer_1,Luis,28,ES18209585214414889696,TRX_N-00680-84405091,2023-08-01T16:30:18,Bilbao,expenses,education,-61.52,-52230.92
buyer_1,Luis,28,ES18209585214414889696,TRX_N-00681-85815255,2023-08-01T09:34:07,Bilbao,expenses,repairs,-316.17,-52547.09
buyer_1,Luis,28,ES18209585214414889696,TRX_N-00682-45366445,2023-08-02T20:35:41,Bilbao,expenses,cash,-100.0,-52647.09
buyer_1,Luis,28,ES18209585214414889696,TRX_N-00683-94369562,2023-08-03T21:50:51,Bilbao,expenses,transport,-86.34,-52733.43
buyer_1,Luis,28,ES18209585214414889696,TRX_N-00684-44576120,2023-08-04T17:58:19,Bilbao,expenses,mortgage,-1090.03,-53823.46
buyer_1,Luis,28,ES18209585214414889696,TRX_N-00685-26806469,2023-08-05T08:58:13,Bilbao,expenses,gas,-69.61,-53893.07
buyer_1,Luis,28,ES18209585214414889696,TRX_N-00686-83369324,2023-08-06T09:25:16,Bilbao,expenses,food,-60.85,-53953.92
buyer_1,Luis,28,ES18209585214414889696,TRX_N-00687-63665087,2023-08-06T11:39:09,Bilbao,expenses,leisure,-54.41,-54008.33
buyer_1,Luis,28,ES18209585214414889696,TRX_N-00688-27604136,2023-08-06T07:10:00,Bilbao,expenses,clothing,-48.07,-54056.4
buyer_1,Luis,28,ES18209585214414889696,TRX_N-00689-26964602,2023-08-07T11:46:56,Bilbao,expenses,internet,-42.0,-54098.4
buyer_1,Luis,28,ES18209585214414889696,TRX_N-00690-12006515,2023-08-08T15:17:36,Bilbao,expenses,water,-32.82,-54131.22
buyer_1,Luis,28,ES18209585214414889696,TRX_N-00691-86222893,2023-08-08T14:21:35,Bilbao,expenses,electricity,-66.76,-54197.98
buyer_1,Luis,28,ES18209585214414889696,TRX_N-00692-02655308,2023-08-08T18:09:51,Bilbao,expenses,phone,-36.1,-54234.08
buyer_1,Luis,28,ES18209585214414889696,TRX_N-00693-79284783,2023-08-08T12:15:31,Mungia,expenses,food,-85.11,-54319.19
buyer_1,Luis,28,ES18209585214414889696,TRX_N-00694-04739882,2023-08-08T16:53:55,Bilbao,expenses,leisure,-40.52,-54359.71
buyer_1,Luis,28,ES18209585214414889696,TRX_N-00695-05967918,2023-08-10T23:32:46,Bilbao,expenses,leisure,-54.57,-54414.28
buyer_1,Luis,28,ES18209585214414889696,TRX_N-00696-60529315,2023-08-11T12:05:40,Bilbao,expenses,food,-82.62,-54496.9
buyer_1,Luis,28,ES18209585214414889696,TRX_N-00697-99803190,2023-08-12T20:50:46,Bilbao,expenses,leisure,-29.56,-54526.46
buyer_1,Luis,28,ES18209585214414889696,TRX_N-00698-37344078,2023-08-13T19:15:22,Alegría-Dulantzi,expenses,appliances,-102.02,-54628.48
buyer_1,Luis,28,ES18209585214414889696,TRX_N-00699-72454457,2023-08-18T12:18:32,Bilbao,expenses,children,-209.65,-54838.13
buyer_1,Luis,28,ES18209585214414889696,TRX_N-00700-93909431,2023-08-19T08:44:42,Bilbao,expenses,cash,-100.0,-54938.13
buyer_1,Luis,28,ES18209585214414889696,TRX_N-00701-06271847,2023-08-20T14:07:10,Bilbao,expenses,repairs,-141.75,-55079.88
buyer_1,Luis,28,ES18209585214414889696,TRX_N-00702-20322655,2023-08-21T14:17:07,Bilbao,expenses,food,-117.25,-55197.13
buyer_1,Luis,28,ES18209585214414889696,TRX_N-00703-95778045,2023-08-21T15:56:09,Sopela,expenses,cash,-100.0,-55297.13
buyer_1,Luis,28,ES18209585214414889696,TRX_N-00704-88271478,2023-08-22T20:01:39,Bilbao,expenses,leisure,-53.05,-55350.18
buyer_1,Luis,28,ES18209585214414889696,TRX_N-00705-97454845,2023-08-23T14:51:39,Bilbao,expenses,food,-121.45,-55471.63
buyer_1,Luis,28,ES18209585214414889696,TRX_N-00706-55348284,2023-08-24T12:01:01,Bilbao,expenses,cash,-100.0,-55571.63
buyer_1,Luis,28,ES18209585214414889696,TRX_N-00707-43090627,2023-08-24T07:53:10,Bilbao,expenses,children,-51.22,-55622.85
buyer_1,Luis,28,ES18209585214414889696,TRX_N-00708-85094576,2023-08-25T08:41:06,Sestao,expenses,cash,-100.0,-55722.85
buyer_1,Luis,28,ES18209585214414889696,TRX_N-00709-99364810,2023-08-29T15:18:47,Bilbao,expenses,education,-70.34,-55793.19
buyer_1,Luis,28,ES18209585214414889696,TRX_N-00710-31477128,2023-08-29T18:09:24,Mungia,expenses,cash,-100.0,-55893.19
buyer_1,Luis,28,ES18209585214414889696,TRX_N-00711-72106946,2023-08-29T09:44:34,Bilbao,expenses,repairs,-164.2,-56057.39
buyer_1,Luis,28,ES18209585214414889696,TRX_N-00712-93601823,2023-08-30T16:50:56,Bilbao,expenses,leisure,-24.42,-56081.81
buyer_1,Luis,28,ES18209585214414889696,TRX_N-00713-94387635,2023-08-30T14:36:41,Bilbao,expenses,cash,-100.0,-56181.81
buyer_1,Luis,28,ES18209585214414889696,TRX_N-00714-22103909,2023-08-30T11:17:55,Oyón-Oion,expenses,repairs,-131.46,-56313.27
buyer_1,Luis,28,ES18209585214414889696,TRX_N-00715-26792112,2023-08-31T13:07:54,Bilbao,expenses,leisure,-62.06,-56375.33
buyer_1,Luis,28,ES18209585214414889696,TRX_N-00716-74360827,2023-08-31T13:57:32,Bilbao,expenses,repairs,-280.3,-56655.63
buyer_1,Luis,28,ES18209585214414889696,TRX_N-00717-86021045,2023-09-01T19:22:50,Bilbao,incomes,salary,1348.39,-55307.24
buyer_1,Luis,28,ES18209585214414889696,TRX_N-00718-45562412,2023-09-01T19:22:50,Bilbao,incomes,salary_partner,1043.47,-54263.77
buyer_1,Luis,28,ES18209585214414889696,TRX_N-00719-43214626,2023-09-01T19:22:50,Bilbao,incomes,extra_income,134.54,-54129.23
buyer_1,Luis,28,ES18209585214414889696,TRX_N-00720-82694715,2023-09-03T19:24:59,Bilbao,expenses,transport,-41.83,-54171.06
buyer_1,Luis,28,ES18209585214414889696,TRX_N-00721-10890876,2023-09-04T19:05:56,Bilbao,expenses,mortgage,-1090.03,-55261.09
buyer_1,Luis,28,ES18209585214414889696,TRX_N-00722-90103664,2023-09-04T19:53:54,Bilbao,expenses,transport,-57.76,-55318.85
buyer_1,Luis,28,ES18209585214414889696,TRX_N-00723-78142949,2023-09-04T20:23:30,Pasaia,expenses,cash,-100.0,-55418.85
buyer_1,Luis,28,ES18209585214414889696,TRX_N-00724-09458045,2023-09-06T09:10:07,Bilbao,expenses,phone,-43.07,-55461.92
buyer_1,Luis,28,ES18209585214414889696,TRX_N-00725-46750299,2023-09-06T12:15:37,Bilbao,expenses,cash,-100.0,-55561.92
buyer_1,Luis,28,ES18209585214414889696,TRX_N-00726-70057820,2023-09-06T08:45:42,Bilbao,expenses,children,-278.38,-55840.3
buyer_1,Luis,28,ES18209585214414889696,TRX_N-00727-64929227,2023-09-07T18:15:14,Bilbao,expenses,water,-27.89,-55868.19
buyer_1,Luis,28,ES18209585214414889696,TRX_N-00728-40996336,2023-09-07T09:30:41,Bilbao,expenses,gas,-80.41,-55948.6
buyer_1,Luis,28,ES18209585214414889696,TRX_N-00729-19443536,2023-09-07T17:12:27,Bilbao,expenses,food,-65.86,-56014.46
buyer_1,Luis,28,ES18209585214414889696,TRX_N-00730-34470335,2023-09-08T10:54:37,Bilbao,expenses,electricity,-88.56,-56103.02
buyer_1,Luis,28,ES18209585214414889696,TRX_N-00731-35675240,2023-09-08T13:03:31,Bilbao,expenses,internet,-42.0,-56145.02
buyer_1,Luis,28,ES18209585214414889696,TRX_N-00732-62223295,2023-09-08T13:32:32,Sopela,expenses,clothing,-132.58,-56277.6
buyer_1,Luis,28,ES18209585214414889696,TRX_N-00733-84650701,2023-09-09T14:14:20,Bilbao,expenses,transport,-51.18,-56328.78
buyer_1,Luis,28,ES18209585214414889696,TRX_N-00734-94206310,2023-09-09T11:21:45,Bilbao,expenses,cash,-100.0,-56428.78
buyer_1,Luis,28,ES18209585214414889696,TRX_N-00735-75176838,2023-09-09T11:56:41,Bilbao,expenses,children,-91.83,-56520.61
buyer_1,Luis,28,ES18209585214414889696,TRX_N-00736-68945870,2023-09-10T18:04:45,Erandio,expenses,food,-102.41,-56623.02
buyer_1,Luis,28,ES18209585214414889696,TRX_N-00737-23204473,2023-09-14T10:16:49,Bermeo,expenses,food,-88.02,-56711.04
buyer_1,Luis,28,ES18209585214414889696,TRX_N-00738-67762668,2023-09-14T14:45:13,Bilbao,expenses,transport,-43.65,-56754.69
buyer_1,Luis,28,ES18209585214414889696,TRX_N-00739-55489143,2023-09-16T10:56:51,Bilbao,expenses,leisure,-67.94,-56822.63
buyer_1,Luis,28,ES18209585214414889696,TRX_N-00740-92142096,2023-09-16T12:59:47,Bilbao,expenses,cash,-100.0,-56922.63
buyer_1,Luis,28,ES18209585214414889696,TRX_N-00741-93933439,2023-09-17T23:48:58,Bilbao,expenses,transport,-71.7,-56994.33
buyer_1,Luis,28,ES18209585214414889696,TRX_N-00742-12856056,2023-09-18T20:14:58,Bilbao,expenses,cash,-100.0,-57094.33
buyer_1,Luis,28,ES18209585214414889696,TRX_N-00743-27442709,2023-09-19T17:01:28,Bilbao,expenses,leisure,-77.31,-57171.64
buyer_1,Luis,28,ES18209585214414889696,TRX_N-00744-09535219,2023-09-20T16:19:02,Bilbao,expenses,leisure,-73.84,-57245.48
buyer_1,Luis,28,ES18209585214414889696,TRX_N-00745-70411231,2023-09-20T10:07:45,Bilbao,expenses,cash,-100.0,-57345.48
buyer_1,Luis,28,ES18209585214414889696,TRX_N-00746-28449144,2023-09-20T12:43:23,Bilbao,expenses,gifts,-186.39,-57531.87
buyer_1,Luis,28,ES18209585214414889696,TRX_N-00747-71744397,2023-09-21T09:44:26,Bilbao,expenses,leisure,-27.67,-57559.54
buyer_1,Luis,28,ES18209585214414889696,TRX_N-00748-35876286,2023-09-21T14:59:45,Bilbao,expenses,cash,-100.0,-57659.54
buyer_1,Luis,28,ES18209585214414889696,TRX_N-00749-49758914,2023-09-21T20:52:04,Errenteria,expenses,appliances,-277.06,-57936.6
buyer_1,Luis,28,ES18209585214414889696,TRX_N-00750-85497232,2023-09-22T18:45:19,Bilbao,expenses,food,-117.8,-58054.4
buyer_1,Luis,28,ES18209585214414889696,TRX_N-00751-64821708,2023-09-22T18:27:19,Bilbao,expenses,gifts,-739.5,-58793.9
buyer_1,Luis,28,ES18209585214414889696,TRX_N-00752-07644744,2023-09-23T11:56:23,Bilbao,expenses,leisure,-42.17,-58836.07
buyer_1,Luis,28,ES18209585214414889696,TRX_N-00753-46290633,2023-09-23T09:06:03,Bilbao,expenses,gifts,-623.9,-59459.97
buyer_1,Luis,28,ES18209585214414889696,TRX_N-00754-00229284,2023-09-24T15:11:41,Bilbao,expenses,cash,-100.0,-59559.97
buyer_1,Luis,28,ES18209585214414889696,TRX_N-00755-92517705,2023-09-24T08:59:11,Galdakao,expenses,repairs,-308.01,-59867.98
buyer_1,Luis,28,ES18209585214414889696,TRX_N-00756-82337231,2023-09-25T09:30:04,Bilbao,expenses,children,-259.61,-60127.59
buyer_1,Luis,28,ES18209585214414889696,TRX_N-00757-36042866,2023-09-26T17:51:35,Mungia,expenses,gifts,-108.27,-60235.86
buyer_1,Luis,28,ES18209585214414889696,TRX_N-00758-35799560,2023-09-27T16:52:26,Hondarribia,expenses,food,-73.6,-60309.46
buyer_1,Luis,28,ES18209585214414889696,TRX_N-00759-19596749,2023-09-27T01:52:46,Berango,expenses,leisure,-54.75,-60364.21
buyer_1,Luis,28,ES18209585214414889696,TRX_N-00760-01949673,2023-09-28T08:02:27,Leioa,expenses,clothing,-123.34,-60487.55
buyer_1,Luis,28,ES18209585214414889696,TRX_N-00761-23017856,2023-09-28T02:11:52,Arrasate,expenses,appliances,-273.31,-60760.86
buyer_1,Luis,28,ES18209585214414889696,TRX_N-00762-70454598,2023-09-29T09:46:59,Bilbao,expenses,food,-62.27,-60823.13
buyer_1,Luis,28,ES18209585214414889696,TRX_N-00763-36218235,2023-09-29T08:58:26,Bilbao,expenses,cash,-100.0,-60923.13
buyer_1,Luis,28,ES18209585214414889696,TRX_N-00764-38821946,2023-10-01T20:38:29,Bilbao,incomes,salary,1348.39,-59574.74
buyer_1,Luis,28,ES18209585214414889696,TRX_N-00765-07654959,2023-10-01T20:38:29,Bilbao,incomes,salary_partner,1043.47,-58531.27
buyer_1,Luis,28,ES18209585214414889696,TRX_N-00766-55487745,2023-10-02T13:51:24,Elciego,expenses,cash,-100.0,-58631.27
buyer_1,Luis,28,ES18209585214414889696,TRX_N-00767-26413351,2023-10-04T13:40:10,Bilbao,expenses,mortgage,-1090.03,-59721.3
buyer_1,Luis,28,ES18209585214414889696,TRX_N-00768-41276754,2023-10-04T13:48:13,Labastida,expenses,leisure,-43.31,-59764.61
buyer_1,Luis,28,ES18209585214414889696,TRX_N-00769-57792227,2023-10-05T10:53:17,Bilbao,expenses,phone,-37.71,-59802.32
buyer_1,Luis,28,ES18209585214414889696,TRX_N-00770-34847928,2023-10-05T12:03:14,Bilbao,expenses,leisure,-66.19,-59868.51
buyer_1,Luis,28,ES18209585214414889696,TRX_N-00771-37092978,2023-10-06T15:25:57,Bilbao,expenses,electricity,-39.19,-59907.7
buyer_1,Luis,28,ES18209585214414889696,TRX_N-00772-59804198,2023-10-06T18:56:12,Bilbao,expenses,internet,-42.0,-59949.7
buyer_1,Luis,28,ES18209585214414889696,TRX_N-00773-85839840,2023-10-06T14:18:43,Bilbao,expenses,leisure,-49.51,-59999.21
buyer_1,Luis,28,ES18209585214414889696,TRX_N-00774-79615457,2023-10-06T18:14:48,Bilbao,expenses,cash,-100.0,-60099.21
buyer_1,Luis,28,ES18209585214414889696,TRX_N-00775-75244312,2023-10-07T10:48:32,Bilbao,expenses,transport,-49.89,-60149.1
buyer_1,Luis,28,ES18209585214414889696,TRX_N-00776-21649823,2023-10-08T17:48:43,Bilbao,expenses,water,-38.86,-60187.96
buyer_1,Luis,28,ES18209585214414889696,TRX_N-00777-61129857,2023-10-08T17:20:04,Bilbao,expenses,gas,-107.66,-60295.62
buyer_1,Luis,28,ES18209585214414889696,TRX_N-00778-99068313,2023-10-09T17:38:27,Leioa,expenses,cash,-100.0,-60395.62
buyer_1,Luis,28,ES18209585214414889696,TRX_N-00779-34610965,2023-10-10T21:59:18,Bilbao,expenses,transport,-81.71,-60477.33
buyer_1,Luis,28,ES18209585214414889696,TRX_N-00780-63258411,2023-10-12T15:44:00,Bilbao,expenses,leisure,-41.31,-60518.64
buyer_1,Luis,28,ES18209585214414889696,TRX_N-00781-96918321,2023-10-13T18:31:56,Bilbao,expenses,food,-75.08,-60593.72
buyer_1,Luis,28,ES18209585214414889696,TRX_N-00782-98272231,2023-10-13T18:35:19,Bilbao,expenses,travel,-413.67,-61007.39
buyer_1,Luis,28,ES18209585214414889696,TRX_N-00783-95388458,2023-10-14T08:30:57,Bilbao,expenses,food,-112.87,-61120.26
buyer_1,Luis,28,ES18209585214414889696,TRX_N-00784-45224652,2023-10-16T16:48:59,Bilbao,expenses,cash,-100.0,-61220.26
buyer_1,Luis,28,ES18209585214414889696,TRX_N-00785-61202682,2023-10-19T20:59:11,Bilbao,expenses,cash,-100.0,-61320.26
buyer_1,Luis,28,ES18209585214414889696,TRX_N-00786-41871828,2023-10-21T14:18:51,Bilbao,expenses,transport,-57.98,-61378.24
buyer_1,Luis,28,ES18209585214414889696,TRX_N-00787-57702389,2023-10-22T17:04:34,Bilbao,expenses,food,-105.8,-61484.04
buyer_1,Luis,28,ES18209585214414889696,TRX_N-00788-16796075,2023-10-22T14:54:22,Bilbao,expenses,cash,-100.0,-61584.04
buyer_1,Luis,28,ES18209585214414889696,TRX_N-00789-88515693,2023-10-23T01:02:49,Bilbao,expenses,food,-88.97,-61673.01
buyer_1,Luis,28,ES18209585214414889696,TRX_N-00790-64194134,2023-10-23T15:12:48,Bilbao,expenses,appliances,-260.32,-61933.33
buyer_1,Luis,28,ES18209585214414889696,TRX_N-00791-98816082,2023-10-24T21:57:27,Bilbao,expenses,leisure,-55.84,-61989.17
buyer_1,Luis,28,ES18209585214414889696,TRX_N-00792-86468391,2023-10-24T17:53:30,Bilbao,expenses,cash,-100.0,-62089.17
buyer_1,Luis,28,ES18209585214414889696,TRX_N-00793-03805555,2023-10-24T17:52:51,Bilbao,expenses,repairs,-207.68,-62296.85
buyer_1,Luis,28,ES18209585214414889696,TRX_N-00794-62889186,2023-10-26T13:26:13,Bilbao,expenses,travel,-652.88,-62949.73
buyer_1,Luis,28,ES18209585214414889696,TRX_N-00795-55066925,2023-10-29T17:35:09,Basauri,expenses,education,-54.65,-63004.38
buyer_1,Luis,28,ES18209585214414889696,TRX_N-00796-94183487,2023-10-29T14:57:39,Bilbao,expenses,cash,-100.0,-63104.38
buyer_1,Luis,28,ES18209585214414889696,TRX_N-00797-85191487,2023-10-31T19:10:05,Bilbao,expenses,children,-239.84,-63344.22
buyer_1,Luis,28,ES18209585214414889696,TRX_N-00798-39390815,2023-11-01T17:15:31,Bilbao,incomes,salary,1348.39,-61995.83
buyer_1,Luis,28,ES18209585214414889696,TRX_N-00799-66309292,2023-11-01T17:15:31,Bilbao,incomes,salary_partner,1043.47,-60952.36
buyer_1,Luis,28,ES18209585214414889696,TRX_N-00800-24057812,2023-11-02T18:44:03,Bilbao,expenses,cash,-100.0,-61052.36
buyer_1,Luis,28,ES18209585214414889696,TRX_N-00801-01801286,2023-11-02T10:45:21,Bilbao,expenses,repairs,-326.21,-61378.57
buyer_1,Luis,28,ES18209585214414889696,TRX_N-00802-00630152,2023-11-04T22:30:32,Bilbao,expenses,mortgage,-1090.03,-62468.6
buyer_1,Luis,28,ES18209585214414889696,TRX_N-00803-14539687,2023-11-04T13:29:01,Bilbao,expenses,transport,-87.92,-62556.52
buyer_1,Luis,28,ES18209585214414889696,TRX_N-00804-04313088,2023-11-04T05:23:21,Bilbao,expenses,leisure,-37.05,-62593.57
buyer_1,Luis,28,ES18209585214414889696,TRX_N-00805-53721987,2023-11-05T17:16:52,Bilbao,expenses,internet,-42.0,-62635.57
buyer_1,Luis,28,ES18209585214414889696,TRX_N-00806-25631149,2023-11-05T08:40:27,Bilbao,expenses,phone,-43.78,-62679.35
buyer_1,Luis,28,ES18209585214414889696,TRX_N-00807-26401623,2023-11-05T23:39:28,Bilbao,expenses,food,-120.06,-62799.41
buyer_1,Luis,28,ES18209585214414889696,TRX_N-00808-85982407,2023-11-06T12:06:55,Bilbao,expenses,water,-36.17,-62835.58
buyer_1,Luis,28,ES18209585214414889696,TRX_N-00809-64641706,2023-11-06T17:50:54,Bilbao,expenses,electricity,-51.72,-62887.3
buyer_1,Luis,28,ES18209585214414889696,TRX_N-00810-31742715,2023-11-07T11:22:19,Bilbao,expenses,cash,-100.0,-62987.3
buyer_1,Luis,28,ES18209585214414889696,TRX_N-00811-76701097,2023-11-08T16:49:08,Bilbao,expenses,gas,-88.66,-63075.96
buyer_1,Luis,28,ES18209585214414889696,TRX_N-00812-00406952,2023-11-08T10:17:37,Bilbao,expenses,leisure,-83.36,-63159.32
buyer_1,Luis,28,ES18209585214414889696,TRX_N-00813-46537931,2023-11-08T17:33:50,Bilbao,expenses,appliances,-356.99,-63516.31
buyer_1,Luis,28,ES18209585214414889696,TRX_N-00814-15418942,2023-11-09T11:57:30,Amurrio,expenses,cash,-100.0,-63616.31
buyer_1,Luis,28,ES18209585214414889696,TRX_N-00815-98125902,2023-11-10T11:16:42,Irun,expenses,gifts,-548.98,-64165.29
buyer_1,Luis,28,ES18209585214414889696,TRX_N-00816-15002100,2023-11-12T17:01:31,Bilbao,expenses,clothing,-126.87,-64292.16
buyer_1,Luis,28,ES18209585214414889696,TRX_N-00817-08045995,2023-11-13T00:36:05,Bilbao,expenses,children,-180.14,-64472.3
buyer_1,Luis,28,ES18209585214414889696,TRX_N-00818-84471286,2023-11-14T02:03:05,Bilbao,expenses,food,-69.16,-64541.46
buyer_1,Luis,28,ES18209585214414889696,TRX_N-00819-42657458,2023-11-15T11:30:30,Bilbao,expenses,cash,-100.0,-64641.46
buyer_1,Luis,28,ES18209585214414889696,TRX_N-00820-32370803,2023-11-17T11:15:29,Bilbao,expenses,repairs,-228.74,-64870.2
buyer_1,Luis,28,ES18209585214414889696,TRX_N-00821-68983741,2023-11-19T17:51:37,Bilbao,expenses,cash,-100.0,-64970.2
buyer_1,Luis,28,ES18209585214414889696,TRX_N-00822-77139089,2023-11-19T11:40:54,Bilbao,expenses,travel,-1390.55,-66360.75
buyer_1,Luis,28,ES18209585214414889696,TRX_N-00823-24851709,2023-11-20T21:31:58,Bilbao,expenses,transport,-85.9,-66446.65
buyer_1,Luis,28,ES18209585214414889696,TRX_N-00824-70321443,2023-11-20T23:43:57,Bilbao,expenses,healthcare,-66.47,-66513.12
buyer_1,Luis,28,ES18209585214414889696,TRX_N-00825-41868646,2023-11-20T10:36:04,Bilbao,expenses,cash,-100.0,-66613.12
buyer_1,Luis,28,ES18209585214414889696,TRX_N-00826-36116377,2023-11-21T11:21:12,Bilbao,expenses,food,-108.06,-66721.18
buyer_1,Luis,28,ES18209585214414889696,TRX_N-00827-84335248,2023-11-21T18:02:27,Bilbao,expenses,cash,-100.0,-66821.18
buyer_1,Luis,28,ES18209585214414889696,TRX_N-00828-32004030,2023-11-21T12:53:44,Bilbao,expenses,children,-120.38,-66941.56
buyer_1,Luis,28,ES18209585214414889696,TRX_N-00829-78141650,2023-11-22T14:37:40,Iruña de Oca,expenses,repairs,-92.03,-67033.59
buyer_1,Luis,28,ES18209585214414889696,TRX_N-00830-33844344,2023-11-23T16:30:45,Bilbao,expenses,transport,-59.89,-67093.48
buyer_1,Luis,28,ES18209585214414889696,TRX_N-00831-44337500,2023-11-23T14:56:28,Bilbao,expenses,education,-59.2,-67152.68
buyer_1,Luis,28,ES18209585214414889696,TRX_N-00832-45503989,2023-11-24T04:35:43,Bilbao,expenses,leisure,-46.46,-67199.14
buyer_1,Luis,28,ES18209585214414889696,TRX_N-00833-02297939,2023-11-25T13:03:20,Bilbao,expenses,repairs,-69.86,-67269.0
buyer_1,Luis,28,ES18209585214414889696,TRX_N-00834-13824055,2023-11-26T16:18:54,Bilbao,expenses,food,-99.87,-67368.87
buyer_1,Luis,28,ES18209585214414889696,TRX_N-00835-35393748,2023-11-26T11:37:09,Bilbao,expenses,cash,-100.0,-67468.87
buyer_1,Luis,28,ES18209585214414889696,TRX_N-00836-41911058,2023-11-27T09:46:23,Bilbao,expenses,transport,-71.46,-67540.33
buyer_1,Luis,28,ES18209585214414889696,TRX_N-00837-23856898,2023-11-27T18:27:06,Bilbao,expenses,appliances,-406.38,-67946.71
buyer_1,Luis,28,ES18209585214414889696,TRX_N-00838-01770834,2023-11-28T14:15:51,Bilbao,expenses,children,-167.24,-68113.95
buyer_1,Luis,28,ES18209585214414889696,TRX_N-00839-75124879,2023-11-29T16:23:17,Bermeo,expenses,healthcare,-128.59,-68242.54
buyer_1,Luis,28,ES18209585214414889696,TRX_N-00840-86128738,2023-12-01T04:27:43,Bilbao,incomes,salary,1348.39,-66894.15
buyer_1,Luis,28,ES18209585214414889696,TRX_N-00841-19883201,2023-12-01T04:27:43,Bilbao,incomes,salary_partner,1043.47,-65850.68
buyer_1,Luis,28,ES18209585214414889696,TRX_N-00842-18034150,2023-12-01T04:27:43,Bilbao,incomes,extra_income,134.54,-65716.14
buyer_1,Luis,28,ES18209585214414889696,TRX_N-00843-29010104,2023-12-01T04:27:43,Bilbao,incomes,salary_bonus,966.45,-64749.69
buyer_1,Luis,28,ES18209585214414889696,TRX_N-00844-96249539,2023-12-01T04:27:43,Bilbao,incomes,salary_partner_bonus,736.9,-64012.79
buyer_1,Luis,28,ES18209585214414889696,TRX_N-00845-17330263,2023-12-01T08:43:45,Bilbao,expenses,food,-95.31,-64108.1
buyer_1,Luis,28,ES18209585214414889696,TRX_N-00846-93555968,2023-12-01T13:36:04,Bilbao,expenses,leisure,-43.36,-64151.46
buyer_1,Luis,28,ES18209585214414889696,TRX_N-00847-78771953,2023-12-01T21:56:26,Salvatierra/Agurain,expenses,cash,-100.0,-64251.46
buyer_1,Luis,28,ES18209585214414889696,TRX_N-00848-70994898,2023-12-03T08:58:32,Bilbao,expenses,leisure,-78.45,-64329.91
buyer_1,Luis,28,ES18209585214414889696,TRX_N-00849-95493871,2023-12-03T19:09:21,Bilbao,expenses,education,-50.46,-64380.37
buyer_1,Luis,28,ES18209585214414889696,TRX_N-00850-54146893,2023-12-03T15:15:21,Bilbao,expenses,children,-155.57,-64535.94
buyer_1,Luis,28,ES18209585214414889696,TRX_N-00851-44974954,2023-12-04T22:59:54,Bilbao,expenses,mortgage,-1090.03,-65625.97
buyer_1,Luis,28,ES18209585214414889696,TRX_N-00852-13567384,2023-12-06T10:38:08,Bilbao,expenses,water,-43.16,-65669.13
buyer_1,Luis,28,ES18209585214414889696,TRX_N-00853-85273096,2023-12-06T20:18:46,Bilbao,expenses,electricity,-77.14,-65746.27
buyer_1,Luis,28,ES18209585214414889696,TRX_N-00854-31450743,2023-12-06T21:03:24,Bilbao,expenses,internet,-42.0,-65788.27
buyer_1,Luis,28,ES18209585214414889696,TRX_N-00855-37570676,2023-12-06T12:11:40,Bilbao,expenses,healthcare,-56.32,-65844.59
buyer_1,Luis,28,ES18209585214414889696,TRX_N-00856-26141452,2023-12-07T18:25:03,Bilbao,expenses,phone,-33.02,-65877.61
buyer_1,Luis,28,ES18209585214414889696,TRX_N-00857-20810916,2023-12-07T20:54:12,Bilbao,expenses,food,-120.33,-65997.94
buyer_1,Luis,28,ES18209585214414889696,TRX_N-00858-18947842,2023-12-07T17:24:43,Bilbao,expenses,cash,-100.0,-66097.94
buyer_1,Luis,28,ES18209585214414889696,TRX_N-00859-13553666,2023-12-08T15:17:20,Bilbao,expenses,gas,-110.81,-66208.75
buyer_1,Luis,28,ES18209585214414889696,TRX_N-00860-51770717,2023-12-10T12:58:22,Bilbao,expenses,cash,-100.0,-66308.75
buyer_1,Luis,28,ES18209585214414889696,TRX_N-00861-72918053,2023-12-12T19:37:26,Bilbao,expenses,transport,-49.1,-66357.85
buyer_1,Luis,28,ES18209585214414889696,TRX_N-00862-57927651,2023-12-14T10:05:44,Bilbao,expenses,leisure,-38.29,-66396.14
buyer_1,Luis,28,ES18209585214414889696,TRX_N-00863-91853841,2023-12-14T10:38:02,Bilbao,expenses,cash,-100.0,-66496.14
buyer_1,Luis,28,ES18209585214414889696,TRX_N-00864-15334137,2023-12-19T10:18:28,Bilbao,expenses,gifts,-579.31,-67075.45
buyer_1,Luis,28,ES18209585214414889696,TRX_N-00865-01001819,2023-12-22T19:17:07,Bilbao,expenses,cash,-100.0,-67175.45
buyer_1,Luis,28,ES18209585214414889696,TRX_N-00866-31151279,2023-12-25T10:11:44,Vitoria-Gasteiz,expenses,transport,-66.68,-67242.13
buyer_1,Luis,28,ES18209585214414889696,TRX_N-00867-22101535,2023-12-25T18:29:02,Bilbao,expenses,leisure,-73.94,-67316.07
buyer_1,Luis,28,ES18209585214414889696,TRX_N-00868-74306593,2023-12-26T21:01:08,Bilbao,expenses,food,-70.98,-67387.05
buyer_1,Luis,28,ES18209585214414889696,TRX_N-00869-32670122,2023-12-26T16:09:52,Bilbao,expenses,transport,-79.2,-67466.25
buyer_1,Luis,28,ES18209585214414889696,TRX_N-00870-21238673,2023-12-27T17:02:54,Bilbao,expenses,food,-99.66,-67565.91
buyer_1,Luis,28,ES18209585214414889696,TRX_N-00871-78795035,2023-12-28T17:03:37,Bilbao,expenses,leisure,-32.84,-67598.75
buyer_1,Luis,28,ES18209585214414889696,TRX_N-00872-99890315,2023-12-28T10:15:31,Bilbao,expenses,healthcare,-51.08,-67649.83
buyer_1,Luis,28,ES18209585214414889696,TRX_N-00873-22475455,2023-12-29T16:27:48,Hondarribia,expenses,transport,-67.5,-67717.33
buyer_1,Luis,28,ES18209585214414889696,TRX_N-00874-30048806,2023-12-30T08:40:19,Irun,expenses,food,-95.15,-67812.48
buyer_1,Luis,28,ES18209585214414889696,TRX_N-00875-30094848,2023-12-30T20:46:30,Bilbao,expenses,cash,-100.0,-67912.48
buyer_1,Luis,28,ES18209585214414889696,TRX_N-00876-89806376,2024-01-01T09:21:39,Bilbao,incomes,salary,1377.12,-66535.36
buyer_1,Luis,28,ES18209585214414889696,TRX_N-00877-47462412,2024-01-01T09:21:39,Bilbao,incomes,salary_partner,1065.7,-65469.66
buyer_1,Luis,28,ES18209585214414889696,TRX_N-00878-74288865,2024-01-01T13:03:57,Bilbao,expenses,cash,-100.0,-65569.66
buyer_1,Luis,28,ES18209585214414889696,TRX_N-00879-33856279,2024-01-03T12:57:43,Bilbao,expenses,food,-73.04,-65642.7
buyer_1,Luis,28,ES18209585214414889696,TRX_N-00880-91455461,2024-01-03T12:09:37,Zuia,expenses,transport,-77.7,-65720.4
buyer_1,Luis,28,ES18209585214414889696,TRX_N-00881-85297376,2024-01-03T19:50:03,Bilbao,expenses,cash,-100.0,-65820.4
buyer_1,Luis,28,ES18209585214414889696,TRX_N-00882-76312777,2024-01-04T11:17:39,Bilbao,expenses,mortgage,-1090.03,-66910.43
buyer_1,Luis,28,ES18209585214414889696,TRX_N-00883-11349776,2024-01-05T14:39:12,Bilbao,expenses,water,-34.4,-66944.83
buyer_1,Luis,28,ES18209585214414889696,TRX_N-00884-24602077,2024-01-07T14:16:07,Bilbao,expenses,gas,-43.96,-66988.79
buyer_1,Luis,28,ES18209585214414889696,TRX_N-00885-17748008,2024-01-07T00:57:15,Bilbao,expenses,phone,-32.04,-67020.83
buyer_1,Luis,28,ES18209585214414889696,TRX_N-00886-51860300,2024-01-07T05:30:24,Bilbao,expenses,healthcare,-71.69,-67092.52
buyer_1,Luis,28,ES18209585214414889696,TRX_N-00887-74205572,2024-01-08T13:46:31,Bilbao,expenses,electricity,-55.44,-67147.96
buyer_1,Luis,28,ES18209585214414889696,TRX_N-00888-41668941,2024-01-08T17:38:17,Bilbao,expenses,internet,-42.0,-67189.96
buyer_1,Luis,28,ES18209585214414889696,TRX_N-00889-70066355,2024-01-10T17:50:44,Bilbao,expenses,food,-119.8,-67309.76
buyer_1,Luis,28,ES18209585214414889696,TRX_N-00890-46876354,2024-01-10T10:39:04,Bilbao,expenses,cash,-100.0,-67409.76
buyer_1,Luis,28,ES18209585214414889696,TRX_N-00891-54660075,2024-01-11T23:00:17,Bilbao,expenses,food,-115.18,-67524.94
buyer_1,Luis,28,ES18209585214414889696,TRX_N-00892-33339452,2024-01-12T17:07:36,Bilbao,expenses,cash,-100.0,-67624.94
buyer_1,Luis,28,ES18209585214414889696,TRX_N-00893-38876284,2024-01-13T13:24:38,Bilbao,expenses,leisure,-68.99,-67693.93
buyer_1,Luis,28,ES18209585214414889696,TRX_N-00894-85999448,2024-01-13T10:07:03,Getxo,expenses,cash,-100.0,-67793.93
buyer_1,Luis,28,ES18209585214414889696,TRX_N-00895-40500220,2024-01-14T20:01:00,Bilbao,expenses,leisure,-33.08,-67827.01
buyer_1,Luis,28,ES18209585214414889696,TRX_N-00896-98445865,2024-01-15T15:19:01,Bilbao,expenses,cash,-100.0,-67927.01
buyer_1,Luis,28,ES18209585214414889696,TRX_N-00897-41536706,2024-01-16T14:37:00,Bilbao,expenses,cash,-100.0,-68027.01
buyer_1,Luis,28,ES18209585214414889696,TRX_N-00898-70195106,2024-01-18T21:10:53,Bilbao,expenses,cash,-100.0,-68127.01
buyer_1,Luis,28,ES18209585214414889696,TRX_N-00899-12206853,2024-01-19T13:10:01,Bilbao,expenses,transport,-71.1,-68198.11
buyer_1,Luis,28,ES18209585214414889696,TRX_N-00900-24128449,2024-01-19T20:52:44,Bilbao,expenses,cash,-100.0,-68298.11
buyer_1,Luis,28,ES18209585214414889696,TRX_N-00901-57398571,2024-01-19T11:07:09,Hondarribia,expenses,appliances,-232.04,-68530.15
buyer_1,Luis,28,ES18209585214414889696,TRX_N-00902-29230633,2024-01-21T16:51:45,Bilbao,expenses,food,-71.87,-68602.02
buyer_1,Luis,28,ES18209585214414889696,TRX_N-00903-67089971,2024-01-22T18:31:05,Bilbao,expenses,transport,-60.85,-68662.87
buyer_1,Luis,28,ES18209585214414889696,TRX_N-00904-39171553,2024-01-22T18:28:50,Bilbao,expenses,cash,-100.0,-68762.87
buyer_1,Luis,28,ES18209585214414889696,TRX_N-00905-49290133,2024-01-23T15:24:16,Donostia,expenses,food,-97.36,-68860.23
buyer_1,Luis,28,ES18209585214414889696,TRX_N-00906-82561811,2024-01-24T13:18:00,Salvatierra/Agurain,expenses,cash,-100.0,-68960.23
buyer_1,Luis,28,ES18209585214414889696,TRX_N-00907-01229738,2024-01-26T20:38:31,Bilbao,expenses,education,-49.49,-69009.72
buyer_1,Luis,28,ES18209585214414889696,TRX_N-00908-93722768,2024-01-27T04:49:52,Bilbao,expenses,food,-96.15,-69105.87
buyer_1,Luis,28,ES18209585214414889696,TRX_N-00909-55276310,2024-01-27T13:30:41,Bilbao,expenses,repairs,-165.66,-69271.53
buyer_1,Luis,28,ES18209585214414889696,TRX_N-00910-27956118,2024-01-29T19:58:02,Bilbao,expenses,leisure,-22.04,-69293.57
buyer_1,Luis,28,ES18209585214414889696,TRX_N-00911-98613554,2024-01-30T05:19:52,Bilbao,expenses,leisure,-34.01,-69327.58
buyer_1,Luis,28,ES18209585214414889696,TRX_N-00912-25623187,2024-01-31T14:19:01,Bilbao,expenses,food,-110.15,-69437.73
buyer_1,Luis,28,ES18209585214414889696,TRX_N-00913-72710777,2024-01-31T17:42:05,Bilbao,expenses,cash,-100.0,-69537.73
buyer_1,Luis,28,ES18209585214414889696,TRX_N-00914-26417470,2024-01-31T11:19:51,Bilbao,expenses,repairs,-177.99,-69715.72
buyer_1,Luis,28,ES18209585214414889696,TRX_N-00915-03555641,2024-02-01T09:57:43,Bilbao,incomes,salary,1377.12,-68338.6
buyer_1,Luis,28,ES18209585214414889696,TRX_N-00916-54441453,2024-02-01T09:57:43,Bilbao,incomes,salary_partner,1065.7,-67272.9
buyer_1,Luis,28,ES18209585214414889696,TRX_N-00917-45353419,2024-02-01T12:14:42,Bilbao,expenses,leisure,-25.71,-67298.61
buyer_1,Luis,28,ES18209585214414889696,TRX_N-00918-17803077,2024-02-01T08:06:42,Bilbao,expenses,cash,-100.0,-67398.61
buyer_1,Luis,28,ES18209585214414889696,TRX_N-00919-55614942,2024-02-02T09:06:27,Bilbao,expenses,cash,-100.0,-67498.61
buyer_1,Luis,28,ES18209585214414889696,TRX_N-00920-13465211,2024-02-04T13:34:25,Bilbao,expenses,mortgage,-1090.03,-68588.64
buyer_1,Luis,28,ES18209585214414889696,TRX_N-00921-71755554,2024-02-05T04:42:21,Bilbao,expenses,phone,-32.23,-68620.87
buyer_1,Luis,28,ES18209585214414889696,TRX_N-00922-50342484,2024-02-05T10:52:08,Sestao,expenses,healthcare,-179.09,-68799.96
buyer_1,Luis,28,ES18209585214414889696,TRX_N-00923-93476299,2024-02-05T00:04:49,Erandio,expenses,travel,-288.51,-69088.47
buyer_1,Luis,28,ES18209585214414889696,TRX_N-00924-66823692,2024-02-06T14:40:13,Bilbao,expenses,electricity,-35.59,-69124.06
buyer_1,Luis,28,ES18209585214414889696,TRX_N-00925-67803510,2024-02-06T20:51:48,Bilbao,expenses,gas,-89.96,-69214.02
buyer_1,Luis,28,ES18209585214414889696,TRX_N-00926-20421564,2024-02-07T14:50:45,Bilbao,expenses,transport,-54.82,-69268.84
buyer_1,Luis,28,ES18209585214414889696,TRX_N-00927-78097428,2024-02-07T17:43:58,Bilbao,expenses,gifts,-173.31,-69442.15
buyer_1,Luis,28,ES18209585214414889696,TRX_N-00928-10205492,2024-02-08T12:28:00,Bilbao,expenses,water,-35.19,-69477.34
buyer_1,Luis,28,ES18209585214414889696,TRX_N-00929-86441258,2024-02-08T00:12:31,Bilbao,expenses,internet,-42.0,-69519.34
buyer_1,Luis,28,ES18209585214414889696,TRX_N-00930-78215608,2024-02-08T16:28:40,Leioa,expenses,leisure,-54.62,-69573.96
buyer_1,Luis,28,ES18209585214414889696,TRX_N-00931-43098352,2024-02-10T21:35:41,Donostia,expenses,appliances,-398.18,-69972.14
buyer_1,Luis,28,ES18209585214414889696,TRX_N-00932-07485068,2024-02-13T12:36:31,Bilbao,expenses,transport,-76.32,-70048.46
buyer_1,Luis,28,ES18209585214414889696,TRX_N-00933-11754522,2024-02-13T19:11:48,Bilbao,expenses,leisure,-56.75,-70105.21
buyer_1,Luis,28,ES18209585214414889696,TRX_N-00934-81792884,2024-02-13T18:15:14,Bilbao,expenses,healthcare,-103.66,-70208.87
buyer_1,Luis,28,ES18209585214414889696,TRX_N-00935-64112226,2024-02-14T02:09:45,Bilbao,expenses,transport,-44.5,-70253.37
buyer_1,Luis,28,ES18209585214414889696,TRX_N-00936-39161702,2024-02-16T19:58:02,Bilbao,expenses,transport,-50.15,-70303.52
buyer_1,Luis,28,ES18209585214414889696,TRX_N-00937-00352195,2024-02-17T16:58:59,Galdakao,expenses,food,-111.16,-70414.68
buyer_1,Luis,28,ES18209585214414889696,TRX_N-00938-48233053,2024-02-17T16:01:17,Bilbao,expenses,cash,-100.0,-70514.68
buyer_1,Luis,28,ES18209585214414889696,TRX_N-00939-86529129,2024-02-18T18:20:55,Bilbao,expenses,repairs,-31.4,-70546.08
buyer_1,Luis,28,ES18209585214414889696,TRX_N-00940-73484088,2024-02-19T11:05:57,Bilbao,expenses,leisure,-83.41,-70629.49
buyer_1,Luis,28,ES18209585214414889696,TRX_N-00941-99652122,2024-02-20T09:18:18,Bilbao,expenses,leisure,-37.41,-70666.9
buyer_1,Luis,28,ES18209585214414889696,TRX_N-00942-06045227,2024-02-22T22:52:23,Bilbao,expenses,cash,-100.0,-70766.9
buyer_1,Luis,28,ES18209585214414889696,TRX_N-00943-65243492,2024-02-25T09:14:22,Bilbao,expenses,transport,-84.7,-70851.6
buyer_1,Luis,28,ES18209585214414889696,TRX_N-00944-97392949,2024-02-28T20:10:10,Bilbao,expenses,cash,-100.0,-70951.6
buyer_1,Luis,28,ES18209585214414889696,TRX_N-00945-20870401,2024-03-01T16:57:57,Bilbao,incomes,salary,1377.12,-69574.48
buyer_1,Luis,28,ES18209585214414889696,TRX_N-00946-47062393,2024-03-01T16:57:57,Bilbao,incomes,salary_partner,1065.7,-68508.78
buyer_1,Luis,28,ES18209585214414889696,TRX_N-00947-31013439,2024-03-03T12:17:27,Bilbao,expenses,leisure,-68.68,-68577.46
buyer_1,Luis,28,ES18209585214414889696,TRX_N-00948-45360451,2024-03-04T10:26:55,Bilbao,expenses,mortgage,-1090.03,-69667.49
buyer_1,Luis,28,ES18209585214414889696,TRX_N-00949-62939108,2024-03-04T20:37:25,Bilbao,expenses,food,-98.8,-69766.29
buyer_1,Luis,28,ES18209585214414889696,TRX_N-00950-95770964,2024-03-04T19:49:12,Bilbao,expenses,leisure,-62.48,-69828.77
buyer_1,Luis,28,ES18209585214414889696,TRX_N-00951-83897322,2024-03-06T13:41:10,Bilbao,expenses,gas,-62.33,-69891.1
buyer_1,Luis,28,ES18209585214414889696,TRX_N-00952-64609675,2024-03-06T17:17:11,Bilbao,expenses,leisure,-43.77,-69934.87
buyer_1,Luis,28,ES18209585214414889696,TRX_N-00953-68936756,2024-03-06T02:07:31,Bilbao,expenses,children,-71.35,-70006.22
buyer_1,Luis,28,ES18209585214414889696,TRX_N-00954-64283476,2024-03-07T11:14:30,Bilbao,expenses,water,-36.16,-70042.38
buyer_1,Luis,28,ES18209585214414889696,TRX_N-00955-48582355,2024-03-07T18:35:33,Bilbao,expenses,internet,-42.0,-70084.38
buyer_1,Luis,28,ES18209585214414889696,TRX_N-00956-53282377,2024-03-07T13:37:31,Bilbao,expenses,food,-73.75,-70158.13
buyer_1,Luis,28,ES18209585214414889696,TRX_N-00957-60405151,2024-03-08T18:07:39,Bilbao,expenses,electricity,-50.68,-70208.81
buyer_1,Luis,28,ES18209585214414889696,TRX_N-00958-07212685,2024-03-08T20:08:22,Bilbao,expenses,phone,-39.96,-70248.77
buyer_1,Luis,28,ES18209585214414889696,TRX_N-00959-66943815,2024-03-11T14:11:28,Leioa,expenses,gifts,-53.05,-70301.82
buyer_1,Luis,28,ES18209585214414889696,TRX_N-00960-72054743,2024-03-13T18:19:05,Bilbao,expenses,leisure,-50.8,-70352.62
buyer_1,Luis,28,ES18209585214414889696,TRX_N-00961-92276291,2024-03-14T14:36:49,Bilbao,expenses,transport,-71.33,-70423.95
buyer_1,Luis,28,ES18209585214414889696,TRX_N-00962-55719745,2024-03-15T09:07:23,Bilbao,expenses,repairs,-225.54,-70649.49
buyer_1,Luis,28,ES18209585214414889696,TRX_N-00963-06086777,2024-03-19T08:41:48,Bilbao,expenses,cash,-100.0,-70749.49
buyer_1,Luis,28,ES18209585214414889696,TRX_N-00964-29873618,2024-03-19T06:59:10,Bilbao,expenses,children,-75.79,-70825.28
buyer_1,Luis,28,ES18209585214414889696,TRX_N-00965-99905579,2024-03-22T19:07:22,Bilbao,expenses,clothing,-45.6,-70870.88
buyer_1,Luis,28,ES18209585214414889696,TRX_N-00966-91669725,2024-03-23T10:11:20,Hondarribia,expenses,leisure,-59.76,-70930.64
buyer_1,Luis,28,ES18209585214414889696,TRX_N-00967-53841605,2024-03-23T09:47:47,Bilbao,expenses,gifts,-192.44,-71123.08
buyer_1,Luis,28,ES18209585214414889696,TRX_N-00968-17491090,2024-03-24T17:46:51,Sestao,expenses,cash,-100.0,-71223.08
buyer_1,Luis,28,ES18209585214414889696,TRX_N-00969-87604361,2024-03-25T22:16:04,Bilbao,expenses,food,-95.72,-71318.8
buyer_1,Luis,28,ES18209585214414889696,TRX_N-00970-24652501,2024-03-25T13:22:19,Bilbao,expenses,leisure,-28.25,-71347.05
buyer_1,Luis,28,ES18209585214414889696,TRX_N-00971-65340650,2024-03-25T12:20:00,Pasaia,expenses,clothing,-64.4,-71411.45
buyer_1,Luis,28,ES18209585214414889696,TRX_N-00972-25260963,2024-03-25T09:43:38,Bilbao,expenses,cash,-100.0,-71511.45
buyer_1,Luis,28,ES18209585214414889696,TRX_N-00973-61229335,2024-03-27T10:56:16,Bermeo,expenses,food,-91.61,-71603.06
buyer_1,Luis,28,ES18209585214414889696,TRX_N-00974-85692784,2024-03-27T13:23:24,Sestao,expenses,leisure,-25.73,-71628.79
buyer_1,Luis,28,ES18209585214414889696,TRX_N-00975-13815316,2024-03-28T07:36:14,Bilbao,expenses,leisure,-19.65,-71648.44
buyer_1,Luis,28,ES18209585214414889696,TRX_N-00976-48827210,2024-03-28T10:49:21,Bilbao,expenses,children,-195.25,-71843.69
buyer_1,Luis,28,ES18209585214414889696,TRX_N-00977-47175743,2024-03-29T21:47:05,Bilbao,expenses,appliances,-189.13,-72032.82
buyer_1,Luis,28,ES18209585214414889696,TRX_N-00978-85056938,2024-03-30T02:16:40,Labastida,expenses,repairs,-215.05,-72247.87
buyer_1,Luis,28,ES18209585214414889696,TRX_N-00979-89637896,2024-04-01T09:21:49,Bilbao,incomes,salary,1377.12,-70870.75
buyer_1,Luis,28,ES18209585214414889696,TRX_N-00980-62159461,2024-04-01T09:21:49,Bilbao,incomes,salary_partner,1065.7,-69805.05
buyer_1,Luis,28,ES18209585214414889696,TRX_N-00981-01303582,2024-04-01T09:21:49,Bilbao,incomes,extra_income,134.54,-69670.51
buyer_1,Luis,28,ES18209585214414889696,TRX_N-00982-33688483,2024-04-02T18:42:23,Bilbao,expenses,gifts,-342.9,-70013.41
buyer_1,Luis,28,ES18209585214414889696,TRX_N-00983-60408316,2024-04-04T08:41:15,Bilbao,expenses,mortgage,-1090.03,-71103.44
buyer_1,Luis,28,ES18209585214414889696,TRX_N-00984-09646642,2024-04-05T17:29:44,Bilbao,expenses,gas,-85.17,-71188.61
buyer_1,Luis,28,ES18209585214414889696,TRX_N-00985-04022787,2024-04-05T16:19:16,Bilbao,expenses,transport,-41.0,-71229.61
buyer_1,Luis,28,ES18209585214414889696,TRX_N-00986-85040497,2024-04-06T21:46:21,Bilbao,expenses,water,-41.06,-71270.67
buyer_1,Luis,28,ES18209585214414889696,TRX_N-00987-43115108,2024-04-06T17:31:55,Bilbao,expenses,phone,-44.54,-71315.21
buyer_1,Luis,28,ES18209585214414889696,TRX_N-00988-77214579,2024-04-06T15:32:40,Bermeo,expenses,leisure,-63.77,-71378.98
buyer_1,Luis,28,ES18209585214414889696,TRX_N-00989-35813760,2024-04-07T13:10:58,Bilbao,expenses,electricity,-33.46,-71412.44
buyer_1,Luis,28,ES18209585214414889696,TRX_N-00990-80844701,2024-04-08T12:58:19,Bilbao,expenses,internet,-42.0,-71454.44
buyer_1,Luis,28,ES18209585214414889696,TRX_N-00991-25761610,2024-04-08T07:19:59,Bilbao,expenses,children,-144.69,-71599.13
buyer_1,Luis,28,ES18209585214414889696,TRX_N-00992-30758078,2024-04-10T20:22:39,Bilbao,expenses,transport,-80.23,-71679.36
buyer_1,Luis,28,ES18209585214414889696,TRX_N-00993-55412672,2024-04-11T08:29:24,Bilbao,expenses,children,-89.49,-71768.85
buyer_1,Luis,28,ES18209585214414889696,TRX_N-00994-45247333,2024-04-12T19:00:10,Bilbao,expenses,appliances,-163.65,-71932.5
buyer_1,Luis,28,ES18209585214414889696,TRX_N-00995-02650262,2024-04-13T13:18:15,Bilbao,expenses,transport,-46.51,-71979.01
buyer_1,Luis,28,ES18209585214414889696,TRX_N-00996-83386244,2024-04-15T23:42:29,Bilbao,expenses,leisure,-77.67,-72056.68
buyer_1,Luis,28,ES18209585214414889696,TRX_N-00997-07814497,2024-04-21T15:53:05,Bilbao,expenses,food,-73.35,-72130.03
buyer_1,Luis,28,ES18209585214414889696,TRX_N-00998-45072368,2024-04-21T13:23:47,Bilbao,expenses,leisure,-40.77,-72170.8
buyer_1,Luis,28,ES18209585214414889696,TRX_N-00999-34068253,2024-04-21T18:49:41,Bilbao,expenses,cash,-100.0,-72270.8
buyer_1,Luis,28,ES18209585214414889696,TRX_N-01000-95364488,2024-04-22T10:21:10,Bilbao,expenses,healthcare,-158.27,-72429.07
buyer_1,Luis,28,ES18209585214414889696,TRX_N-01001-48990536,2024-04-23T09:16:56,Bilbao,expenses,cash,-100.0,-72529.07
buyer_1,Luis,28,ES18209585214414889696,TRX_N-01002-29652987,2024-04-25T12:13:43,Hernani,expenses,healthcare,-95.67,-72624.74
buyer_1,Luis,28,ES18209585214414889696,TRX_N-01003-10217806,2024-04-27T15:44:08,Bermeo,expenses,repairs,-277.3,-72902.04
buyer_1,Luis,28,ES18209585214414889696,TRX_N-01004-36144421,2024-04-28T15:20:58,Bilbao,expenses,leisure,-24.38,-72926.42
buyer_1,Luis,28,ES18209585214414889696,TRX_N-01005-33335198,2024-04-28T20:21:35,Bilbao,expenses,education,-52.72,-72979.14
buyer_1,Luis,28,ES18209585214414889696,TRX_N-01006-97911520,2024-04-28T23:52:19,Bilbao,expenses,gifts,-351.17,-73330.31
buyer_1,Luis,28,ES18209585214414889696,TRX_N-01007-06246273,2024-04-30T08:29:17,Hernani,expenses,cash,-100.0,-73430.31
buyer_1,Luis,28,ES18209585214414889696,TRX_N-01008-96977249,2024-05-01T09:00:43,Bilbao,incomes,salary,1377.12,-72053.19
buyer_1,Luis,28,ES18209585214414889696,TRX_N-01009-25477138,2024-05-01T09:00:43,Bilbao,incomes,salary_partner,1065.7,-70987.49
buyer_1,Luis,28,ES18209585214414889696,TRX_N-01010-76241735,2024-05-01T03:08:22,Bilbao,expenses,repairs,-33.13,-71020.62
buyer_1,Luis,28,ES18209585214414889696,TRX_N-01011-34431761,2024-05-02T15:07:15,Bilbao,expenses,food,-115.44,-71136.06
buyer_1,Luis,28,ES18209585214414889696,TRX_N-01012-92887051,2024-05-03T09:35:36,Bilbao,expenses,repairs,-281.81,-71417.87
buyer_1,Luis,28,ES18209585214414889696,TRX_N-01013-27446468,2024-05-04T22:07:59,Bilbao,expenses,mortgage,-1090.03,-72507.9
buyer_1,Luis,28,ES18209585214414889696,TRX_N-01014-78509196,2024-05-04T14:05:33,Irun,expenses,transport,-52.09,-72559.99
buyer_1,Luis,28,ES18209585214414889696,TRX_N-01015-59670684,2024-05-05T12:59:44,Bilbao,expenses,water,-31.13,-72591.12
buyer_1,Luis,28,ES18209585214414889696,TRX_N-01016-15189197,2024-05-05T23:33:56,Bilbao,expenses,phone,-31.33,-72622.45
buyer_1,Luis,28,ES18209585214414889696,TRX_N-01017-05584128,2024-05-06T19:16:02,Bilbao,expenses,electricity,-62.61,-72685.06
buyer_1,Luis,28,ES18209585214414889696,TRX_N-01018-13462705,2024-05-07T15:51:52,Bilbao,expenses,gas,-71.39,-72756.45
buyer_1,Luis,28,ES18209585214414889696,TRX_N-01019-91399341,2024-05-07T02:36:56,Sestao,expenses,cash,-100.0,-72856.45
buyer_1,Luis,28,ES18209585214414889696,TRX_N-01020-51520687,2024-05-08T17:51:18,Bilbao,expenses,internet,-42.0,-72898.45
buyer_1,Luis,28,ES18209585214414889696,TRX_N-01021-78267570,2024-05-08T20:41:27,Bilbao,expenses,transport,-52.1,-72950.55
buyer_1,Luis,28,ES18209585214414889696,TRX_N-01022-26975950,2024-05-09T19:01:47,Bilbao,expenses,education,-48.82,-72999.37
buyer_1,Luis,28,ES18209585214414889696,TRX_N-01023-75034143,2024-05-11T22:55:55,Bilbao,expenses,cash,-100.0,-73099.37
buyer_1,Luis,28,ES18209585214414889696,TRX_N-01024-97582701,2024-05-11T13:43:41,Bilbao,expenses,children,-254.51,-73353.88
buyer_1,Luis,28,ES18209585214414889696,TRX_N-01025-65559791,2024-05-13T18:20:16,Bilbao,expenses,cash,-100.0,-73453.88
buyer_1,Luis,28,ES18209585214414889696,TRX_N-01026-34480953,2024-05-15T08:57:42,Bilbao,expenses,travel,-1465.91,-74919.79
buyer_1,Luis,28,ES18209585214414889696,TRX_N-01027-05165889,2024-05-16T16:50:31,Bilbao,expenses,food,-69.57,-74989.36
buyer_1,Luis,28,ES18209585214414889696,TRX_N-01028-03285404,2024-05-16T17:24:13,Bilbao,expenses,education,-65.77,-75055.13
buyer_1,Luis,28,ES18209585214414889696,TRX_N-01029-25632189,2024-05-16T21:06:06,Portugalete,expenses,gifts,-386.74,-75441.87
buyer_1,Luis,28,ES18209585214414889696,TRX_N-01030-93071834,2024-05-17T11:14:56,Bilbao,expenses,leisure,-22.06,-75463.93
buyer_1,Luis,28,ES18209585214414889696,TRX_N-01031-55334385,2024-05-17T08:28:06,Bilbao,expenses,cash,-100.0,-75563.93
buyer_1,Luis,28,ES18209585214414889696,TRX_N-01032-07443879,2024-05-18T09:42:52,Bilbao,expenses,clothing,-93.66,-75657.59
buyer_1,Luis,28,ES18209585214414889696,TRX_N-01033-56294696,2024-05-19T12:06:46,Bilbao,expenses,food,-103.46,-75761.05
buyer_1,Luis,28,ES18209585214414889696,TRX_N-01034-91341395,2024-05-19T08:22:00,Bilbao,expenses,gifts,-147.75,-75908.8
buyer_1,Luis,28,ES18209585214414889696,TRX_N-01035-06080042,2024-05-20T08:38:48,Bilbao,expenses,cash,-100.0,-76008.8
buyer_1,Luis,28,ES18209585214414889696,TRX_N-01036-42385824,2024-05-23T08:38:30,Bilbao,expenses,food,-106.64,-76115.44
buyer_1,Luis,28,ES18209585214414889696,TRX_N-01037-27279426,2024-05-24T13:23:29,Oyón-Oion,expenses,food,-93.18,-76208.62
buyer_1,Luis,28,ES18209585214414889696,TRX_N-01038-43508709,2024-05-24T13:10:25,Bilbao,expenses,appliances,-299.2,-76507.82
buyer_1,Luis,28,ES18209585214414889696,TRX_N-01039-01236014,2024-05-25T08:41:35,Bilbao,expenses,clothing,-142.71,-76650.53
buyer_1,Luis,28,ES18209585214414889696,TRX_N-01040-40986474,2024-05-26T16:58:20,Bilbao,expenses,cash,-100.0,-76750.53
buyer_1,Luis,28,ES18209585214414889696,TRX_N-01041-48512264,2024-05-26T12:12:23,Bilbao,expenses,gifts,-656.6,-77407.13
buyer_1,Luis,28,ES18209585214414889696,TRX_N-01042-71346826,2024-05-30T19:04:19,Bilbao,expenses,transport,-56.68,-77463.81
buyer_1,Luis,28,ES18209585214414889696,TRX_N-01043-77181183,2024-05-30T02:17:44,Bilbao,expenses,healthcare,-42.0,-77505.81
buyer_1,Luis,28,ES18209585214414889696,TRX_N-01044-68863605,2024-05-30T19:06:30,Bilbao,expenses,cash,-100.0,-77605.81
buyer_1,Luis,28,ES18209585214414889696,TRX_N-01045-00643179,2024-05-31T20:36:02,Bilbao,expenses,cash,-100.0,-77705.81
buyer_1,Luis,28,ES18209585214414889696,TRX_N-01046-24463445,2024-06-01T10:04:32,Bilbao,incomes,salary,1377.12,-76328.69
buyer_1,Luis,28,ES18209585214414889696,TRX_N-01047-16368988,2024-06-01T10:04:32,Bilbao,incomes,salary_partner,1065.7,-75262.99
buyer_1,Luis,28,ES18209585214414889696,TRX_N-01048-99761854,2024-06-01T10:04:32,Bilbao,incomes,salary_bonus,992.06,-74270.93
buyer_1,Luis,28,ES18209585214414889696,TRX_N-01049-89964501,2024-06-01T10:04:32,Bilbao,incomes,salary_partner_bonus,755.29,-73515.64
buyer_1,Luis,28,ES18209585214414889696,TRX_N-01050-78874837,2024-06-01T13:01:51,Bilbao,expenses,taxes,-1396.7,-74912.34
buyer_1,Luis,28,ES18209585214414889696,TRX_N-01051-59785766,2024-06-01T11:40:19,Bilbao,expenses,insurance,-522.52,-75434.86
buyer_1,Luis,28,ES18209585214414889696,TRX_N-01052-16324645,2024-06-02T15:30:14,Bilbao,expenses,food,-114.67,-75549.53
buyer_1,Luis,28,ES18209585214414889696,TRX_N-01053-10507758,2024-06-02T19:49:54,Bilbao,expenses,cash,-100.0,-75649.53
buyer_1,Luis,28,ES18209585214414889696,TRX_N-01054-67533995,2024-06-04T15:05:58,Bilbao,expenses,mortgage,-1090.03,-76739.56
buyer_1,Luis,28,ES18209585214414889696,TRX_N-01055-82286742,2024-06-04T11:11:22,Bilbao,expenses,leisure,-59.03,-76798.59
buyer_1,Luis,28,ES18209585214414889696,TRX_N-01056-98993646,2024-06-05T20:07:31,Bilbao,expenses,internet,-42.0,-76840.59
buyer_1,Luis,28,ES18209585214414889696,TRX_N-01057-90634516,2024-06-06T05:03:56,Bilbao,expenses,electricity,-81.15,-76921.74
buyer_1,Luis,28,ES18209585214414889696,TRX_N-01058-18631971,2024-06-06T13:11:36,Bilbao,expenses,leisure,-78.1,-76999.84
buyer_1,Luis,28,ES18209585214414889696,TRX_N-01059-16015437,2024-06-06T18:27:07,Bilbao,expenses,clothing,-139.77,-77139.61
buyer_1,Luis,28,ES18209585214414889696,TRX_N-01060-79700915,2024-06-07T19:48:04,Bilbao,expenses,water,-31.56,-77171.17
buyer_1,Luis,28,ES18209585214414889696,TRX_N-01061-53548326,2024-06-07T20:31:23,Bilbao,expenses,phone,-44.92,-77216.09
buyer_1,Luis,28,ES18209585214414889696,TRX_N-01062-60288723,2024-06-07T22:30:17,Erandio,expenses,cash,-100.0,-77316.09
buyer_1,Luis,28,ES18209585214414889696,TRX_N-01063-39401740,2024-06-08T16:59:32,Bilbao,expenses,gas,-64.25,-77380.34
buyer_1,Luis,28,ES18209585214414889696,TRX_N-01064-27914508,2024-06-10T12:09:54,Bilbao,expenses,cash,-100.0,-77480.34
buyer_1,Luis,28,ES18209585214414889696,TRX_N-01065-39229059,2024-06-11T18:51:34,Bilbao,expenses,transport,-51.77,-77532.11
buyer_1,Luis,28,ES18209585214414889696,TRX_N-01066-64128746,2024-06-14T14:56:02,Bilbao,expenses,cash,-100.0,-77632.11
buyer_1,Luis,28,ES18209585214414889696,TRX_N-01067-38453432,2024-06-15T21:26:55,Bilbao,expenses,transport,-88.98,-77721.09
buyer_1,Luis,28,ES18209585214414889696,TRX_N-01068-13146380,2024-06-17T09:48:12,Erandio,expenses,healthcare,-107.73,-77828.82
buyer_1,Luis,28,ES18209585214414889696,TRX_N-01069-26260676,2024-06-17T10:28:48,Bilbao,expenses,cash,-100.0,-77928.82
buyer_1,Luis,28,ES18209585214414889696,TRX_N-01070-10609279,2024-06-18T20:40:49,Errenteria,expenses,education,-75.47,-78004.29
buyer_1,Luis,28,ES18209585214414889696,TRX_N-01071-17127483,2024-06-21T17:26:31,Bilbao,expenses,transport,-74.28,-78078.57
buyer_1,Luis,28,ES18209585214414889696,TRX_N-01072-19366187,2024-06-21T11:19:30,Bilbao,expenses,travel,-1393.23,-79471.8
buyer_1,Luis,28,ES18209585214414889696,TRX_N-01073-48941385,2024-06-21T10:06:15,Bilbao,expenses,children,-57.1,-79528.9
buyer_1,Luis,28,ES18209585214414889696,TRX_N-01074-34436541,2024-06-22T14:09:08,Bilbao,expenses,education,-62.75,-79591.65
buyer_1,Luis,28,ES18209585214414889696,TRX_N-01075-47258593,2024-06-23T09:22:35,Bilbao,expenses,food,-88.36,-79680.01
buyer_1,Luis,28,ES18209585214414889696,TRX_N-01076-90689151,2024-06-28T16:13:01,Bilbao,expenses,food,-92.68,-79772.69
buyer_1,Luis,28,ES18209585214414889696,TRX_N-01077-59771095,2024-06-29T19:35:16,Bilbao,expenses,leisure,-65.61,-79838.3
buyer_1,Luis,28,ES18209585214414889696,TRX_N-01078-49790409,2024-06-29T16:24:43,Bilbao,expenses,education,-76.33,-79914.63
buyer_1,Luis,28,ES18209585214414889696,TRX_N-01079-14520758,2024-06-30T20:17:42,Bilbao,expenses,repairs,-244.48,-80159.11
buyer_1,Luis,28,ES18209585214414889696,TRX_N-01080-22936884,2024-07-01T21:51:46,Bilbao,incomes,salary,1377.12,-78781.99
buyer_1,Luis,28,ES18209585214414889696,TRX_N-01081-41305818,2024-07-01T21:51:46,Bilbao,incomes,salary_partner,1065.7,-77716.29
buyer_1,Luis,28,ES18209585214414889696,TRX_N-01082-85853719,2024-07-01T17:16:26,Bilbao,expenses,transport,-60.03,-77776.32
buyer_1,Luis,28,ES18209585214414889696,TRX_N-01083-49522453,2024-07-01T10:30:01,Bilbao,expenses,healthcare,-44.48,-77820.8
buyer_1,Luis,28,ES18209585214414889696,TRX_N-01084-16831947,2024-07-01T15:38:39,Bilbao,expenses,children,-104.17,-77924.97
buyer_1,Luis,28,ES18209585214414889696,TRX_N-01085-70019572,2024-07-03T20:48:05,Bilbao,expenses,leisure,-66.42,-77991.39
buyer_1,Luis,28,ES18209585214414889696,TRX_N-01086-72239727,2024-07-03T13:27:27,Bilbao,expenses,clothing,-108.8,-78100.19
buyer_1,Luis,28,ES18209585214414889696,TRX_N-01087-99631758,2024-07-04T16:57:58,Bilbao,expenses,mortgage,-1090.03,-79190.22
buyer_1,Luis,28,ES18209585214414889696,TRX_N-01088-08582707,2024-07-06T19:13:37,Bilbao,expenses,phone,-42.45,-79232.67
buyer_1,Luis,28,ES18209585214414889696,TRX_N-01089-75541409,2024-07-06T20:42:45,Bilbao,expenses,cash,-100.0,-79332.67
buyer_1,Luis,28,ES18209585214414889696,TRX_N-01090-52573604,2024-07-07T14:37:40,Bilbao,expenses,water,-29.76,-79362.43
buyer_1,Luis,28,ES18209585214414889696,TRX_N-01091-53234300,2024-07-07T19:47:04,Bilbao,expenses,gas,-72.55,-79434.98
buyer_1,Luis,28,ES18209585214414889696,TRX_N-01092-63282548,2024-07-07T12:08:45,Bilbao,expenses,transport,-71.8,-79506.78
buyer_1,Luis,28,ES18209585214414889696,TRX_N-01093-89254805,2024-07-07T10:00:36,Bilbao,expenses,healthcare,-133.87,-79640.65
buyer_1,Luis,28,ES18209585214414889696,TRX_N-01094-46099658,2024-07-08T19:48:45,Bilbao,expenses,electricity,-46.83,-79687.48
buyer_1,Luis,28,ES18209585214414889696,TRX_N-01095-81725492,2024-07-08T11:32:42,Bilbao,expenses,internet,-42.0,-79729.48
buyer_1,Luis,28,ES18209585214414889696,TRX_N-01096-24560040,2024-07-11T13:02:14,Bilbao,expenses,transport,-67.0,-79796.48
buyer_1,Luis,28,ES18209585214414889696,TRX_N-01097-47193653,2024-07-11T14:34:08,Bilbao,expenses,gifts,-595.64,-80392.12
buyer_1,Luis,28,ES18209585214414889696,TRX_N-01098-16595269,2024-07-13T12:32:24,Zuia,expenses,transport,-66.88,-80459.0
buyer_1,Luis,28,ES18209585214414889696,TRX_N-01099-20242467,2024-07-13T17:14:58,Bilbao,expenses,cash,-100.0,-80559.0
buyer_1,Luis,28,ES18209585214414889696,TRX_N-01100-99274968,2024-07-13T18:34:54,Bilbao,expenses,repairs,-60.18,-80619.18
buyer_1,Luis,28,ES18209585214414889696,TRX_N-01101-65618252,2024-07-14T10:59:06,Bilbao,expenses,food,-64.27,-80683.45
buyer_1,Luis,28,ES18209585214414889696,TRX_N-01102-20336594,2024-07-14T12:31:54,Bilbao,expenses,cash,-100.0,-80783.45
buyer_1,Luis,28,ES18209585214414889696,TRX_N-01103-61232908,2024-07-16T14:40:09,Bilbao,expenses,leisure,-77.28,-80860.73
buyer_1,Luis,28,ES18209585214414889696,TRX_N-01104-24568099,2024-07-19T20:18:58,Bilbao,expenses,education,-66.28,-80927.01
buyer_1,Luis,28,ES18209585214414889696,TRX_N-01105-39048031,2024-07-20T20:14:26,Bilbao,expenses,leisure,-80.29,-81007.3
buyer_1,Luis,28,ES18209585214414889696,TRX_N-01106-03758540,2024-07-20T14:02:49,Eibar,expenses,repairs,-246.2,-81253.5
buyer_1,Luis,28,ES18209585214414889696,TRX_N-01107-41029601,2024-07-21T23:10:09,Durango,expenses,transport,-80.37,-81333.87
buyer_1,Luis,28,ES18209585214414889696,TRX_N-01108-97682702,2024-07-21T18:00:26,Bilbao,expenses,leisure,-27.39,-81361.26
buyer_1,Luis,28,ES18209585214414889696,TRX_N-01109-35155516,2024-07-21T16:48:18,Bilbao,expenses,clothing,-78.01,-81439.27
buyer_1,Luis,28,ES18209585214414889696,TRX_N-01110-53983902,2024-07-21T16:24:31,Amurrio,expenses,gifts,-281.34,-81720.61
buyer_1,Luis,28,ES18209585214414889696,TRX_N-01111-24901902,2024-07-22T13:34:47,Bilbao,expenses,cash,-100.0,-81820.61
buyer_1,Luis,28,ES18209585214414889696,TRX_N-01112-92205938,2024-07-22T14:04:34,Bilbao,expenses,gifts,-409.96,-82230.57
buyer_1,Luis,28,ES18209585214414889696,TRX_N-01113-81880330,2024-07-23T13:32:08,Bilbao,expenses,appliances,-158.71,-82389.28
buyer_1,Luis,28,ES18209585214414889696,TRX_N-01114-17227439,2024-07-23T10:32:32,Bilbao,expenses,repairs,-265.22,-82654.5
buyer_1,Luis,28,ES18209585214414889696,TRX_N-01115-86365455,2024-07-24T13:50:00,Barakaldo,expenses,cash,-100.0,-82754.5
buyer_1,Luis,28,ES18209585214414889696,TRX_N-01116-32323853,2024-07-25T11:47:28,Bilbao,expenses,food,-77.94,-82832.44
buyer_1,Luis,28,ES18209585214414889696,TRX_N-01117-42086894,2024-07-26T14:24:56,Zarautz,expenses,transport,-77.1,-82909.54
buyer_1,Luis,28,ES18209585214414889696,TRX_N-01118-28906717,2024-07-26T17:54:14,Bilbao,expenses,leisure,-24.52,-82934.06
buyer_1,Luis,28,ES18209585214414889696,TRX_N-01119-77096815,2024-07-28T01:13:58,Bilbao,expenses,food,-83.91,-83017.97
buyer_1,Luis,28,ES18209585214414889696,TRX_N-01120-31648747,2024-07-28T17:14:40,Bilbao,expenses,gifts,-541.51,-83559.48
buyer_1,Luis,28,ES18209585214414889696,TRX_N-01121-89939262,2024-07-28T19:52:52,Bilbao,expenses,children,-200.27,-83759.75
buyer_1,Luis,28,ES18209585214414889696,TRX_N-01122-33662105,2024-07-29T08:04:47,Bilbao,expenses,leisure,-76.13,-83835.88
buyer_1,Luis,28,ES18209585214414889696,TRX_N-01123-67320615,2024-07-30T12:53:59,Bilbao,expenses,cash,-100.0,-83935.88
buyer_1,Luis,28,ES18209585214414889696,TRX_N-01124-58995042,2024-08-01T10:37:20,Bilbao,incomes,salary,1377.12,-82558.76
buyer_1,Luis,28,ES18209585214414889696,TRX_N-01125-74781989,2024-08-01T10:37:20,Bilbao,incomes,salary_partner,1065.7,-81493.06
buyer_1,Luis,28,ES18209585214414889696,TRX_N-01126-06898319,2024-08-01T10:37:20,Bilbao,incomes,extra_income,134.54,-81358.52
buyer_1,Luis,28,ES18209585214414889696,TRX_N-01127-89006231,2024-08-02T19:44:24,Bilbao,expenses,food,-96.13,-81454.65
buyer_1,Luis,28,ES18209585214414889696,TRX_N-01128-17667132,2024-08-02T10:41:48,Bilbao,expenses,transport,-76.96,-81531.61
buyer_1,Luis,28,ES18209585214414889696,TRX_N-01129-29736181,2024-08-02T16:11:35,Bilbao,expenses,gifts,-57.59,-81589.2
buyer_1,Luis,28,ES18209585214414889696,TRX_N-01130-56421040,2024-08-03T10:24:01,Bilbao,expenses,clothing,-145.07,-81734.27
buyer_1,Luis,28,ES18209585214414889696,TRX_N-01131-34526344,2024-08-04T10:59:38,Bilbao,expenses,mortgage,-1090.03,-82824.3
buyer_1,Luis,28,ES18209585214414889696,TRX_N-01132-06298364,2024-08-05T09:25:02,Bilbao,expenses,water,-39.66,-82863.96
buyer_1,Luis,28,ES18209585214414889696,TRX_N-01133-32361342,2024-08-07T22:15:29,Bilbao,expenses,internet,-42.0,-82905.96
buyer_1,Luis,28,ES18209585214414889696,TRX_N-01134-45104027,2024-08-07T03:11:55,Bilbao,expenses,education,-68.89,-82974.85
buyer_1,Luis,28,ES18209585214414889696,TRX_N-01135-87175232,2024-08-08T18:02:55,Bilbao,expenses,electricity,-41.59,-83016.44
buyer_1,Luis,28,ES18209585214414889696,TRX_N-01136-55339052,2024-08-08T14:21:09,Bilbao,expenses,gas,-82.09,-83098.53
buyer_1,Luis,28,ES18209585214414889696,TRX_N-01137-06769941,2024-08-08T17:46:55,Bilbao,expenses,phone,-43.45,-83141.98
buyer_1,Luis,28,ES18209585214414889696,TRX_N-01138-02131875,2024-08-08T19:02:43,Bilbao,expenses,food,-82.97,-83224.95
buyer_1,Luis,28,ES18209585214414889696,TRX_N-01139-44409411,2024-08-08T17:12:57,Lasarte-Oria,expenses,transport,-74.89,-83299.84
buyer_1,Luis,28,ES18209585214414889696,TRX_N-01140-56944146,2024-08-08T08:18:11,Bilbao,expenses,repairs,-246.09,-83545.93
buyer_1,Luis,28,ES18209585214414889696,TRX_N-01141-77354995,2024-08-09T18:17:56,Bilbao,expenses,food,-97.53,-83643.46
buyer_1,Luis,28,ES18209585214414889696,TRX_N-01142-25720432,2024-08-12T11:04:48,Bilbao,expenses,leisure,-23.12,-83666.58
buyer_1,Luis,28,ES18209585214414889696,TRX_N-01143-40090971,2024-08-13T18:46:20,Bilbao,expenses,transport,-61.01,-83727.59
buyer_1,Luis,28,ES18209585214414889696,TRX_N-01144-56985294,2024-08-13T19:43:04,Irun,expenses,appliances,-212.41,-83940.0
buyer_1,Luis,28,ES18209585214414889696,TRX_N-01145-70554207,2024-08-13T16:14:45,Bilbao,expenses,repairs,-146.55,-84086.55
buyer_1,Luis,28,ES18209585214414889696,TRX_N-01146-02314433,2024-08-17T01:04:14,Bilbao,expenses,leisure,-67.96,-84154.51
buyer_1,Luis,28,ES18209585214414889696,TRX_N-01147-83434301,2024-08-17T21:57:50,Bilbao,expenses,repairs,-161.75,-84316.26
buyer_1,Luis,28,ES18209585214414889696,TRX_N-01148-75714112,2024-08-18T08:08:51,Errenteria,expenses,cash,-100.0,-84416.26
buyer_1,Luis,28,ES18209585214414889696,TRX_N-01149-92229421,2024-08-18T09:19:09,Bilbao,expenses,gifts,-402.72,-84818.98
buyer_1,Luis,28,ES18209585214414889696,TRX_N-01150-93155544,2024-08-20T00:14:45,Bilbao,expenses,education,-50.2,-84869.18
buyer_1,Luis,28,ES18209585214414889696,TRX_N-01151-04210169,2024-08-23T11:40:20,Bilbao,expenses,cash,-100.0,-84969.18
buyer_1,Luis,28,ES18209585214414889696,TRX_N-01152-72756923,2024-08-26T04:54:13,Bilbao,expenses,travel,-1671.88,-86641.06
buyer_1,Luis,28,ES18209585214414889696,TRX_N-01153-82155279,2024-08-27T11:09:28,Bilbao,expenses,transport,-48.59,-86689.65
buyer_1,Luis,28,ES18209585214414889696,TRX_N-01154-10578210,2024-08-27T13:15:39,Bilbao,expenses,cash,-100.0,-86789.65
buyer_1,Luis,28,ES18209585214414889696,TRX_N-01155-08680645,2024-08-31T16:12:55,Bilbao,expenses,clothing,-74.0,-86863.65
buyer_1,Luis,28,ES18209585214414889696,TRX_N-01156-24757232,2024-08-31T19:25:52,Bilbao,expenses,gifts,-105.3,-86968.95
buyer_1,Luis,28,ES18209585214414889696,TRX_N-01157-57843055,2024-09-01T17:26:55,Bilbao,incomes,salary,1377.12,-85591.83
buyer_1,Luis,28,ES18209585214414889696,TRX_N-01158-14772816,2024-09-01T17:26:55,Bilbao,incomes,salary_partner,1065.7,-84526.13
buyer_1,Luis,28,ES18209585214414889696,TRX_N-01159-43400775,2024-09-02T13:05:16,Bilbao,expenses,cash,-100.0,-84626.13
buyer_1,Luis,28,ES18209585214414889696,TRX_N-01160-17285281,2024-09-03T08:58:09,Bilbao,expenses,cash,-100.0,-84726.13
buyer_1,Luis,28,ES18209585214414889696,TRX_N-01161-29908608,2024-09-04T08:20:51,Bilbao,expenses,mortgage,-1090.03,-85816.16
buyer_1,Luis,28,ES18209585214414889696,TRX_N-01162-15936065,2024-09-05T14:19:35,Bilbao,expenses,transport,-64.42,-85880.58
buyer_1,Luis,28,ES18209585214414889696,TRX_N-01163-99205953,2024-09-05T17:23:31,Bilbao,expenses,cash,-100.0,-85980.58
buyer_1,Luis,28,ES18209585214414889696,TRX_N-01164-95154840,2024-09-06T17:57:25,Bilbao,expenses,gas,-37.06,-86017.64
buyer_1,Luis,28,ES18209585214414889696,TRX_N-01165-91809424,2024-09-07T01:05:33,Bilbao,expenses,electricity,-20.66,-86038.3
buyer_1,Luis,28,ES18209585214414889696,TRX_N-01166-43097576,2024-09-07T16:40:30,Bilbao,expenses,phone,-35.16,-86073.46
buyer_1,Luis,28,ES18209585214414889696,TRX_N-01167-80717188,2024-09-07T19:09:11,Bilbao,expenses,children,-163.59,-86237.05
buyer_1,Luis,28,ES18209585214414889696,TRX_N-01168-82928112,2024-09-08T14:25:40,Bilbao,expenses,water,-38.38,-86275.43
buyer_1,Luis,28,ES18209585214414889696,TRX_N-01169-12302550,2024-09-08T10:27:25,Bilbao,expenses,internet,-42.0,-86317.43
buyer_1,Luis,28,ES18209585214414889696,TRX_N-01170-61229468,2024-09-08T20:37:02,Bilbao,expenses,transport,-43.38,-86360.81
buyer_1,Luis,28,ES18209585214414889696,TRX_N-01171-00515785,2024-09-09T19:13:56,Bilbao,expenses,cash,-100.0,-86460.81
buyer_1,Luis,28,ES18209585214414889696,TRX_N-01172-09336549,2024-09-10T19:30:28,Galdakao,expenses,education,-55.55,-86516.36
buyer_1,Luis,28,ES18209585214414889696,TRX_N-01173-23196965,2024-09-10T14:04:22,Bilbao,expenses,repairs,-230.72,-86747.08
buyer_1,Luis,28,ES18209585214414889696,TRX_N-01174-43478358,2024-09-14T12:56:54,Bilbao,expenses,food,-121.49,-86868.57
buyer_1,Luis,28,ES18209585214414889696,TRX_N-01175-04399698,2024-09-14T10:15:51,Bilbao,expenses,repairs,-35.92,-86904.49
buyer_1,Luis,28,ES18209585214414889696,TRX_N-01176-55621654,2024-09-15T14:00:55,Bilbao,expenses,transport,-64.0,-86968.49
buyer_1,Luis,28,ES18209585214414889696,TRX_N-01177-92781091,2024-09-15T11:24:24,Bilbao,expenses,cash,-100.0,-87068.49
buyer_1,Luis,28,ES18209585214414889696,TRX_N-01178-16383014,2024-09-16T13:33:00,Bilbao,expenses,repairs,-86.49,-87154.98
buyer_1,Luis,28,ES18209585214414889696,TRX_N-01179-62066032,2024-09-17T23:27:36,Bilbao,expenses,cash,-100.0,-87254.98
buyer_1,Luis,28,ES18209585214414889696,TRX_N-01180-00603111,2024-09-17T11:45:12,Errenteria,expenses,gifts,-275.61,-87530.59
buyer_1,Luis,28,ES18209585214414889696,TRX_N-01181-17363772,2024-09-18T18:12:51,Bilbao,expenses,leisure,-43.35,-87573.94
buyer_1,Luis,28,ES18209585214414889696,TRX_N-01182-04835557,2024-09-19T17:04:42,Bilbao,expenses,food,-93.39,-87667.33
buyer_1,Luis,28,ES18209585214414889696,TRX_N-01183-49222981,2024-09-19T08:14:42,Bilbao,expenses,cash,-100.0,-87767.33
buyer_1,Luis,28,ES18209585214414889696,TRX_N-01184-04682260,2024-09-21T14:24:36,Bilbao,expenses,food,-109.23,-87876.56
buyer_1,Luis,28,ES18209585214414889696,TRX_N-01185-91328109,2024-09-24T19:29:32,Bilbao,expenses,clothing,-143.71,-88020.27
buyer_1,Luis,28,ES18209585214414889696,TRX_N-01186-65658697,2024-09-24T20:22:28,Bilbao,expenses,cash,-100.0,-88120.27
buyer_1,Luis,28,ES18209585214414889696,TRX_N-01187-53540811,2024-09-26T14:39:34,Bilbao,expenses,transport,-87.86,-88208.13
buyer_1,Luis,28,ES18209585214414889696,TRX_N-01188-21154938,2024-09-30T15:14:13,Bilbao,expenses,transport,-53.08,-88261.21
buyer_1,Luis,28,ES18209585214414889696,TRX_N-01189-92975397,2024-10-01T17:24:54,Bilbao,incomes,salary,1377.12,-86884.09
buyer_1,Luis,28,ES18209585214414889696,TRX_N-01190-35099075,2024-10-01T17:24:54,Bilbao,incomes,salary_partner,1065.7,-85818.39
buyer_1,Luis,28,ES18209585214414889696,TRX_N-01191-59740705,2024-10-02T13:53:02,Bilbao,expenses,leisure,-80.2,-85898.59
buyer_1,Luis,28,ES18209585214414889696,TRX_N-01192-19612013,2024-10-03T14:21:47,Bilbao,expenses,cash,-100.0,-85998.59
buyer_1,Luis,28,ES18209585214414889696,TRX_N-01193-44189186,2024-10-03T11:11:20,Bilbao,expenses,gifts,-577.77,-86576.36
buyer_1,Luis,28,ES18209585214414889696,TRX_N-01194-20597535,2024-10-04T19:47:15,Bilbao,expenses,mortgage,-1090.03,-87666.39
buyer_1,Luis,28,ES18209585214414889696,TRX_N-01195-04664321,2024-10-05T15:57:50,Bilbao,expenses,food,-106.72,-87773.11
buyer_1,Luis,28,ES18209585214414889696,TRX_N-01196-54520943,2024-10-05T11:43:35,Bilbao,expenses,leisure,-37.14,-87810.25
buyer_1,Luis,28,ES18209585214414889696,TRX_N-01197-65629881,2024-10-06T09:46:17,Bilbao,expenses,electricity,-55.08,-87865.33
buyer_1,Luis,28,ES18209585214414889696,TRX_N-01198-32225548,2024-10-06T15:05:59,Bilbao,expenses,gas,-49.87,-87915.2
buyer_1,Luis,28,ES18209585214414889696,TRX_N-01199-69300582,2024-10-06T17:47:55,Bilbao,expenses,transport,-65.73,-87980.93
buyer_1,Luis,28,ES18209585214414889696,TRX_N-01200-74313002,2024-10-07T17:31:48,Elciego,expenses,cash,-100.0,-88080.93
buyer_1,Luis,28,ES18209585214414889696,TRX_N-01201-37564425,2024-10-08T12:41:19,Bilbao,expenses,internet,-42.0,-88122.93
buyer_1,Luis,28,ES18209585214414889696,TRX_N-01202-25101783,2024-10-08T09:19:57,Bilbao,expenses,water,-35.84,-88158.77
buyer_1,Luis,28,ES18209585214414889696,TRX_N-01203-63002828,2024-10-08T20:27:08,Bilbao,expenses,phone,-40.05,-88198.82
buyer_1,Luis,28,ES18209585214414889696,TRX_N-01204-01316461,2024-10-08T14:46:33,Bilbao,expenses,cash,-100.0,-88298.82
buyer_2,Carmen,40,ES39209541173898369721,TRX_N-00001-56668059,2022-01-01T16:22:22,Zarautz,incomes,salary,1325.37,2326.76
buyer_2,Carmen,40,ES39209541173898369721,TRX_N-00002-52255943,2022-01-01T16:22:22,Zarautz,incomes,salary_partner,1398.01,3724.77
buyer_2,Carmen,40,ES39209541173898369721,TRX_N-00003-32537430,2022-01-03T17:50:34,Zarautz,expenses,food,-116.87,3607.9
buyer_2,Carmen,40,ES39209541173898369721,TRX_N-00004-31891861,2022-01-03T04:51:05,Zarautz,expenses,clothing,-124.38,3483.52
buyer_2,Carmen,40,ES39209541173898369721,TRX_N-00005-66032668,2022-01-04T04:36:40,Zarautz,expenses,mortgage,-882.99,2600.53
buyer_2,Carmen,40,ES39209541173898369721,TRX_N-00006-52746797,2022-01-05T09:45:58,Zarautz,expenses,water,-20.24,2580.29
buyer_2,Carmen,40,ES39209541173898369721,TRX_N-00007-72945653,2022-01-05T06:04:24,Zarautz,expenses,gas,-87.91,2492.38
buyer_2,Carmen,40,ES39209541173898369721,TRX_N-00008-43147171,2022-01-05T11:04:05,Zarautz,expenses,phone,-31.93,2460.45
buyer_2,Carmen,40,ES39209541173898369721,TRX_N-00009-62113946,2022-01-07T15:10:25,Zarautz,expenses,electricity,-73.54,2386.91
buyer_2,Carmen,40,ES39209541173898369721,TRX_N-00010-92578575,2022-01-07T14:57:32,Zarautz,expenses,leisure,-31.29,2355.62
buyer_2,Carmen,40,ES39209541173898369721,TRX_N-00011-51977909,2022-01-08T20:41:31,Zarautz,expenses,internet,-42.0,2313.62
buyer_2,Carmen,40,ES39209541173898369721,TRX_N-00012-04500777,2022-01-08T15:41:21,Labastida,expenses,transport,-43.78,2269.84
buyer_2,Carmen,40,ES39209541173898369721,TRX_N-00013-27368347,2022-01-08T08:22:43,Zarautz,expenses,cash,-100.0,2169.84
buyer_2,Carmen,40,ES39209541173898369721,TRX_N-00014-75169885,2022-01-09T13:40:03,Zarautz,expenses,transport,-85.5,2084.34
buyer_2,Carmen,40,ES39209541173898369721,TRX_N-00015-25438216,2022-01-09T10:37:08,Zarautz,expenses,appliances,-217.74,1866.6
buyer_2,Carmen,40,ES39209541173898369721,TRX_N-00016-68884746,2022-01-09T14:42:37,Zarautz,expenses,children,-170.5,1696.1
buyer_2,Carmen,40,ES39209541173898369721,TRX_N-00017-90397027,2022-01-13T11:27:50,Zarautz,expenses,food,-78.89,1617.21
buyer_2,Carmen,40,ES39209541173898369721,TRX_N-00018-68744840,2022-01-13T23:30:15,Zarautz,expenses,transport,-70.38,1546.83
buyer_2,Carmen,40,ES39209541173898369721,TRX_N-00019-27022284,2022-01-13T11:50:58,Zarautz,expenses,leisure,-23.85,1522.98
buyer_2,Carmen,40,ES39209541173898369721,TRX_N-00020-73392340,2022-01-13T17:37:37,Zarautz,expenses,children,-244.07,1278.91
buyer_2,Carmen,40,ES39209541173898369721,TRX_N-00021-76898177,2022-01-14T18:48:30,Zarautz,expenses,transport,-69.87,1209.04
buyer_2,Carmen,40,ES39209541173898369721,TRX_N-00022-52676872,2022-01-14T03:08:18,Zarautz,expenses,appliances,-169.04,1040.0
buyer_2,Carmen,40,ES39209541173898369721,TRX_N-00023-35308889,2022-01-14T23:09:03,Sestao,expenses,repairs,-260.86,779.14
buyer_2,Carmen,40,ES39209541173898369721,TRX_N-00024-85135674,2022-01-18T13:47:36,Zarautz,expenses,food,-124.47,654.67
buyer_2,Carmen,40,ES39209541173898369721,TRX_N-00025-60945504,2022-01-19T09:17:31,Zarautz,expenses,cash,-100.0,554.67
buyer_2,Carmen,40,ES39209541173898369721,TRX_N-00026-41371267,2022-01-19T16:11:04,Zarautz,expenses,repairs,-165.11,389.56
buyer_2,Carmen,40,ES39209541173898369721,TRX_N-00027-76751948,2022-01-21T15:33:12,Zarautz,expenses,education,-60.19,329.37
buyer_2,Carmen,40,ES39209541173898369721,TRX_N-00028-70864089,2022-01-22T10:50:31,Salvatierra/Agurain,expenses,food,-77.02,252.35
buyer_2,Carmen,40,ES39209541173898369721,TRX_N-00029-06485088,2022-01-22T12:48:41,Zarautz,expenses,repairs,-202.44,49.91
buyer_2,Carmen,40,ES39209541173898369721,TRX_N-00030-68179463,2022-01-23T19:07:55,Lasarte-Oria,expenses,food,-79.57,-29.66
buyer_2,Carmen,40,ES39209541173898369721,TRX_N-00031-72119494,2022-01-23T16:34:48,Zarautz,expenses,leisure,-28.14,-57.8
buyer_2,Carmen,40,ES39209541173898369721,TRX_N-00032-31778639,2022-01-23T13:01:57,Arrasate,expenses,cash,-100.0,-157.8
buyer_2,Carmen,40,ES39209541173898369721,TRX_N-00033-55406151,2022-01-23T09:10:00,Zarautz,expenses,gifts,-684.27,-842.07
buyer_2,Carmen,40,ES39209541173898369721,TRX_N-00034-25906414,2022-01-24T15:36:17,Zarautz,expenses,healthcare,-88.79,-930.86
buyer_2,Carmen,40,ES39209541173898369721,TRX_N-00035-86644946,2022-01-25T19:05:44,Donostia,expenses,clothing,-60.82,-991.68
buyer_2,Carmen,40,ES39209541173898369721,TRX_N-00036-03603167,2022-01-25T14:38:46,Zarautz,expenses,cash,-100.0,-1091.68
buyer_2,Carmen,40,ES39209541173898369721,TRX_N-00037-96565696,2022-01-26T19:27:11,Zarautz,expenses,food,-98.86,-1190.54
buyer_2,Carmen,40,ES39209541173898369721,TRX_N-00038-01857457,2022-01-26T08:30:01,Zarautz,expenses,leisure,-53.51,-1244.05
buyer_2,Carmen,40,ES39209541173898369721,TRX_N-00039-62277431,2022-01-26T23:29:41,Zarautz,expenses,children,-276.24,-1520.29
buyer_2,Carmen,40,ES39209541173898369721,TRX_N-00040-43413019,2022-01-27T11:31:16,Zarautz,expenses,food,-60.31,-1580.6
buyer_2,Carmen,40,ES39209541173898369721,TRX_N-00041-76473254,2022-02-01T20:33:48,Zarautz,incomes,salary,1325.37,-255.23
buyer_2,Carmen,40,ES39209541173898369721,TRX_N-00042-51474257,2022-02-01T20:33:48,Zarautz,incomes,salary_partner,1398.01,1142.78
buyer_2,Carmen,40,ES39209541173898369721,TRX_N-00043-27231810,2022-02-02T11:23:29,Durango,expenses,transport,-53.26,1089.52
buyer_2,Carmen,40,ES39209541173898369721,TRX_N-00044-71485060,2022-02-03T12:41:14,Zarautz,expenses,leisure,-28.32,1061.2
buyer_2,Carmen,40,ES39209541173898369721,TRX_N-00045-57754011,2022-02-04T18:31:08,Zarautz,expenses,mortgage,-882.99,178.21
buyer_2,Carmen,40,ES39209541173898369721,TRX_N-00046-21380376,2022-02-04T20:57:34,Elciego,expenses,cash,-100.0,78.21
buyer_2,Carmen,40,ES39209541173898369721,TRX_N-00047-95042908,2022-02-05T10:35:20,Zarautz,expenses,water,-22.43,55.78
buyer_2,Carmen,40,ES39209541173898369721,TRX_N-00048-62769723,2022-02-05T09:55:23,Zarautz,expenses,transport,-54.81,0.97
buyer_2,Carmen,40,ES39209541173898369721,TRX_N-00049-50520244,2022-02-06T09:48:58,Zarautz,expenses,electricity,-59.98,-59.01
buyer_2,Carmen,40,ES39209541173898369721,TRX_N-00050-27224550,2022-02-06T13:37:29,Zarautz,expenses,transport,-54.32,-113.33
buyer_2,Carmen,40,ES39209541173898369721,TRX_N-00051-88905612,2022-02-06T17:35:40,Zarautz,expenses,leisure,-84.09,-197.42
buyer_2,Carmen,40,ES39209541173898369721,TRX_N-00052-12293329,2022-02-06T10:07:49,Zarautz,expenses,education,-77.36,-274.78
buyer_2,Carmen,40,ES39209541173898369721,TRX_N-00053-70198623,2022-02-07T09:56:40,Zarautz,expenses,gas,-70.25,-345.03
buyer_2,Carmen,40,ES39209541173898369721,TRX_N-00054-71653501,2022-02-07T09:53:09,Zarautz,expenses,cash,-100.0,-445.03
buyer_2,Carmen,40,ES39209541173898369721,TRX_N-00055-72640025,2022-02-08T12:40:27,Zarautz,expenses,internet,-42.0,-487.03
buyer_2,Carmen,40,ES39209541173898369721,TRX_N-00056-43921438,2022-02-08T14:33:32,Zarautz,expenses,phone,-41.83,-528.86
buyer_2,Carmen,40,ES39209541173898369721,TRX_N-00057-69586017,2022-02-08T11:41:06,Zarautz,expenses,clothing,-93.66,-622.52
buyer_2,Carmen,40,ES39209541173898369721,TRX_N-00058-43399107,2022-02-09T13:33:20,Zarautz,expenses,cash,-100.0,-722.52
buyer_2,Carmen,40,ES39209541173898369721,TRX_N-00059-80192564,2022-02-10T10:28:17,Zarautz,expenses,food,-120.38,-842.9
buyer_2,Carmen,40,ES39209541173898369721,TRX_N-00060-65950211,2022-02-10T18:44:05,Zarautz,expenses,transport,-65.77,-908.67
buyer_2,Carmen,40,ES39209541173898369721,TRX_N-00061-53272284,2022-02-10T13:04:48,Zarautz,expenses,leisure,-54.08,-962.75
buyer_2,Carmen,40,ES39209541173898369721,TRX_N-00062-19755742,2022-02-14T11:02:33,Zarautz,expenses,transport,-88.1,-1050.85
buyer_2,Carmen,40,ES39209541173898369721,TRX_N-00063-87145908,2022-02-14T14:17:25,Zarautz,expenses,repairs,-49.69,-1100.54
buyer_2,Carmen,40,ES39209541173898369721,TRX_N-00064-20949852,2022-02-15T16:03:52,Zarautz,expenses,repairs,-221.79,-1322.33
buyer_2,Carmen,40,ES39209541173898369721,TRX_N-00065-35477767,2022-02-16T17:51:39,Zarautz,expenses,food,-104.73,-1427.06
buyer_2,Carmen,40,ES39209541173898369721,TRX_N-00066-17306162,2022-02-17T01:28:58,Lasarte-Oria,expenses,leisure,-61.5,-1488.56
buyer_2,Carmen,40,ES39209541173898369721,TRX_N-00067-72122988,2022-02-17T20:50:34,Zarautz,expenses,cash,-100.0,-1588.56
buyer_2,Carmen,40,ES39209541173898369721,TRX_N-00068-15397898,2022-02-18T08:24:07,Zarautz,expenses,leisure,-71.65,-1660.21
buyer_2,Carmen,40,ES39209541173898369721,TRX_N-00069-22994676,2022-02-20T02:41:47,Andoain,expenses,leisure,-66.72,-1726.93
buyer_2,Carmen,40,ES39209541173898369721,TRX_N-00070-17940737,2022-02-21T14:49:36,Zarautz,expenses,food,-81.78,-1808.71
buyer_2,Carmen,40,ES39209541173898369721,TRX_N-00071-23931795,2022-02-21T22:20:23,Llodio,expenses,cash,-100.0,-1908.71
buyer_2,Carmen,40,ES39209541173898369721,TRX_N-00072-90704505,2022-02-27T08:58:11,Santurtzi,expenses,food,-95.19,-2003.9
buyer_2,Carmen,40,ES39209541173898369721,TRX_N-00073-02252370,2022-02-27T17:35:08,Zarautz,expenses,clothing,-147.94,-2151.84
buyer_2,Carmen,40,ES39209541173898369721,TRX_N-00074-80557245,2022-02-27T07:29:54,Zarautz,expenses,education,-48.05,-2199.89
buyer_2,Carmen,40,ES39209541173898369721,TRX_N-00075-46135546,2022-02-28T05:59:42,Zarautz,expenses,food,-63.67,-2263.56
buyer_2,Carmen,40,ES39209541173898369721,TRX_N-00076-90072149,2022-02-28T11:10:08,Zarautz,expenses,education,-65.39,-2328.95
buyer_2,Carmen,40,ES39209541173898369721,TRX_N-00077-22490704,2022-02-28T20:26:01,Bermeo,expenses,cash,-100.0,-2428.95
buyer_2,Carmen,40,ES39209541173898369721,TRX_N-00078-40900070,2022-03-01T08:44:47,Zarautz,incomes,salary,1325.37,-1103.58
buyer_2,Carmen,40,ES39209541173898369721,TRX_N-00079-86362976,2022-03-01T08:44:47,Zarautz,incomes,salary_partner,1398.01,294.43
buyer_2,Carmen,40,ES39209541173898369721,TRX_N-00080-62786311,2022-03-04T09:25:37,Zarautz,expenses,mortgage,-882.99,-588.56
buyer_2,Carmen,40,ES39209541173898369721,TRX_N-00081-97028983,2022-03-04T19:59:58,Zarautz,expenses,healthcare,-149.32,-737.88
buyer_2,Carmen,40,ES39209541173898369721,TRX_N-00082-86149504,2022-03-04T06:43:39,Errenteria,expenses,appliances,-109.96,-847.84
buyer_2,Carmen,40,ES39209541173898369721,TRX_N-00083-24062947,2022-03-05T10:34:17,Zarautz,expenses,water,-40.22,-888.06
buyer_2,Carmen,40,ES39209541173898369721,TRX_N-00084-05675301,2022-03-05T10:39:16,Zarautz,expenses,gas,-81.69,-969.75
buyer_2,Carmen,40,ES39209541173898369721,TRX_N-00085-06598168,2022-03-05T08:19:02,Zarautz,expenses,leisure,-61.04,-1030.79
buyer_2,Carmen,40,ES39209541173898369721,TRX_N-00086-53080893,2022-03-05T08:49:00,Oyón-Oion,expenses,clothing,-60.03,-1090.82
buyer_2,Carmen,40,ES39209541173898369721,TRX_N-00087-19950094,2022-03-06T11:12:17,Zarautz,expenses,electricity,-80.12,-1170.94
buyer_2,Carmen,40,ES39209541173898369721,TRX_N-00088-62210417,2022-03-06T11:50:53,Zarautz,expenses,cash,-100.0,-1270.94
buyer_2,Carmen,40,ES39209541173898369721,TRX_N-00089-47247502,2022-03-06T16:34:04,Zarautz,expenses,repairs,-77.55,-1348.49
buyer_2,Carmen,40,ES39209541173898369721,TRX_N-00090-64065016,2022-03-07T11:44:01,Zarautz,expenses,food,-89.02,-1437.51
buyer_2,Carmen,40,ES39209541173898369721,TRX_N-00091-86169224,2022-03-08T17:10:53,Zarautz,expenses,internet,-42.0,-1479.51
buyer_2,Carmen,40,ES39209541173898369721,TRX_N-00092-95660984,2022-03-08T21:25:13,Zarautz,expenses,phone,-34.89,-1514.4
buyer_2,Carmen,40,ES39209541173898369721,TRX_N-00093-79103945,2022-03-08T18:04:19,Zarautz,expenses,gifts,-703.86,-2218.26
buyer_2,Carmen,40,ES39209541173898369721,TRX_N-00094-02029590,2022-03-09T13:24:47,Zarautz,expenses,transport,-60.13,-2278.39
buyer_2,Carmen,40,ES39209541173898369721,TRX_N-00095-56443437,2022-03-10T17:07:22,Zarautz,expenses,food,-87.93,-2366.32
buyer_2,Carmen,40,ES39209541173898369721,TRX_N-00096-96098108,2022-03-11T14:48:37,Zarautz,expenses,transport,-81.69,-2448.01
buyer_2,Carmen,40,ES39209541173898369721,TRX_N-00097-26043027,2022-03-12T10:46:17,Zarautz,expenses,food,-103.85,-2551.86
buyer_2,Carmen,40,ES39209541173898369721,TRX_N-00098-17756290,2022-03-12T09:53:18,Zarautz,expenses,leisure,-80.52,-2632.38
buyer_2,Carmen,40,ES39209541173898369721,TRX_N-00099-62135002,2022-03-13T08:09:13,Barakaldo,expenses,leisure,-38.91,-2671.29
buyer_2,Carmen,40,ES39209541173898369721,TRX_N-00100-21305903,2022-03-14T10:29:31,Zarautz,expenses,food,-101.63,-2772.92
buyer_2,Carmen,40,ES39209541173898369721,TRX_N-00101-03385511,2022-03-15T16:50:59,Zarautz,expenses,food,-119.85,-2892.77
buyer_2,Carmen,40,ES39209541173898369721,TRX_N-00102-19622190,2022-03-15T16:20:01,Zarautz,expenses,clothing,-95.5,-2988.27
buyer_2,Carmen,40,ES39209541173898369721,TRX_N-00103-38848457,2022-03-18T19:15:42,Zarautz,expenses,cash,-100.0,-3088.27
buyer_2,Carmen,40,ES39209541173898369721,TRX_N-00104-62009707,2022-03-19T17:13:17,Zarautz,expenses,transport,-79.87,-3168.14
buyer_2,Carmen,40,ES39209541173898369721,TRX_N-00105-99707372,2022-03-23T13:27:47,Zarautz,expenses,education,-78.47,-3246.61
buyer_2,Carmen,40,ES39209541173898369721,TRX_N-00106-41130414,2022-03-24T16:14:19,Zarautz,expenses,transport,-79.36,-3325.97
buyer_2,Carmen,40,ES39209541173898369721,TRX_N-00107-60094506,2022-03-27T16:50:26,Zarautz,expenses,appliances,-234.49,-3560.46
buyer_2,Carmen,40,ES39209541173898369721,TRX_N-00108-16960300,2022-03-28T18:15:05,Zarautz,expenses,leisure,-39.71,-3600.17
buyer_2,Carmen,40,ES39209541173898369721,TRX_N-00109-55085513,2022-03-30T09:25:31,Zarautz,expenses,food,-64.63,-3664.8
buyer_2,Carmen,40,ES39209541173898369721,TRX_N-00110-62700430,2022-03-30T10:51:28,Barakaldo,expenses,education,-50.64,-3715.44
buyer_2,Carmen,40,ES39209541173898369721,TRX_N-00111-31486628,2022-03-31T10:55:30,Iruña de Oca,expenses,gifts,-457.9,-4173.34
buyer_2,Carmen,40,ES39209541173898369721,TRX_N-00112-73141971,2022-04-01T18:17:15,Zarautz,incomes,salary,1325.37,-2847.97
buyer_2,Carmen,40,ES39209541173898369721,TRX_N-00113-46141576,2022-04-01T18:17:15,Zarautz,incomes,salary_partner,1398.01,-1449.96
buyer_2,Carmen,40,ES39209541173898369721,TRX_N-00114-41228577,2022-04-01T18:17:15,Zarautz,incomes,extra_income,159.61,-1290.35
buyer_2,Carmen,40,ES39209541173898369721,TRX_N-00115-72182779,2022-04-02T08:25:21,Zarautz,expenses,leisure,-20.96,-1311.31
buyer_2,Carmen,40,ES39209541173898369721,TRX_N-00116-30782840,2022-04-02T10:17:28,Zarautz,expenses,clothing,-106.58,-1417.89
buyer_2,Carmen,40,ES39209541173898369721,TRX_N-00117-43182061,2022-04-02T15:43:37,Zarautz,expenses,healthcare,-80.17,-1498.06
buyer_2,Carmen,40,ES39209541173898369721,TRX_N-00118-58187720,2022-04-02T18:50:53,Pasaia,expenses,travel,-1244.0,-2742.06
buyer_2,Carmen,40,ES39209541173898369721,TRX_N-00119-90372523,2022-04-04T14:45:53,Zarautz,expenses,mortgage,-882.99,-3625.05
buyer_2,Carmen,40,ES39209541173898369721,TRX_N-00120-03870826,2022-04-04T16:36:37,Salvatierra/Agurain,expenses,healthcare,-168.92,-3793.97
buyer_2,Carmen,40,ES39209541173898369721,TRX_N-00121-90864295,2022-04-05T17:57:47,Zarautz,expenses,water,-38.03,-3832.0
buyer_2,Carmen,40,ES39209541173898369721,TRX_N-00122-94898703,2022-04-05T13:21:10,Zarautz,expenses,phone,-30.27,-3862.27
buyer_2,Carmen,40,ES39209541173898369721,TRX_N-00123-68504994,2022-04-05T10:36:15,Zarautz,expenses,gifts,-235.84,-4098.11
buyer_2,Carmen,40,ES39209541173898369721,TRX_N-00124-97682613,2022-04-06T08:07:06,Zarautz,expenses,food,-103.73,-4201.84
buyer_2,Carmen,40,ES39209541173898369721,TRX_N-00125-07602678,2022-04-07T13:24:05,Zarautz,expenses,internet,-42.0,-4243.84
buyer_2,Carmen,40,ES39209541173898369721,TRX_N-00126-61034372,2022-04-07T18:07:31,Zarautz,expenses,transport,-64.28,-4308.12
buyer_2,Carmen,40,ES39209541173898369721,TRX_N-00127-35803817,2022-04-08T12:16:47,Zarautz,expenses,gas,-40.37,-4348.49
buyer_2,Carmen,40,ES39209541173898369721,TRX_N-00128-98397415,2022-04-08T20:13:34,Zarautz,expenses,electricity,-24.2,-4372.69
buyer_2,Carmen,40,ES39209541173898369721,TRX_N-00129-01966652,2022-04-10T20:55:23,Zarautz,expenses,cash,-100.0,-4472.69
buyer_2,Carmen,40,ES39209541173898369721,TRX_N-00130-44587327,2022-04-11T02:32:52,Zarautz,expenses,education,-45.79,-4518.48
buyer_2,Carmen,40,ES39209541173898369721,TRX_N-00131-05638292,2022-04-11T13:24:59,Zarautz,expenses,appliances,-139.11,-4657.59
buyer_2,Carmen,40,ES39209541173898369721,TRX_N-00132-44658534,2022-04-12T09:58:25,Zarautz,expenses,food,-60.47,-4718.06
buyer_2,Carmen,40,ES39209541173898369721,TRX_N-00133-51678200,2022-04-13T09:50:37,Zarautz,expenses,repairs,-199.12,-4917.18
buyer_2,Carmen,40,ES39209541173898369721,TRX_N-00134-03067645,2022-04-15T20:15:16,Zarautz,expenses,education,-44.28,-4961.46
buyer_2,Carmen,40,ES39209541173898369721,TRX_N-00135-61218772,2022-04-15T14:00:11,Zarautz,expenses,cash,-100.0,-5061.46
buyer_2,Carmen,40,ES39209541173898369721,TRX_N-00136-38514881,2022-04-17T16:12:56,Zarautz,expenses,repairs,-186.37,-5247.83
buyer_2,Carmen,40,ES39209541173898369721,TRX_N-00137-16239057,2022-04-18T09:00:00,Zarautz,expenses,food,-68.96,-5316.79
buyer_2,Carmen,40,ES39209541173898369721,TRX_N-00138-64682670,2022-04-18T10:18:24,Zarautz,expenses,repairs,-295.23,-5612.02
buyer_2,Carmen,40,ES39209541173898369721,TRX_N-00139-36212617,2022-04-19T12:38:15,Zarautz,expenses,leisure,-80.31,-5692.33
buyer_2,Carmen,40,ES39209541173898369721,TRX_N-00140-70071229,2022-04-20T18:32:11,Getxo,expenses,food,-108.79,-5801.12
buyer_2,Carmen,40,ES39209541173898369721,TRX_N-00141-70882822,2022-04-20T13:39:20,Zarautz,expenses,leisure,-57.4,-5858.52
buyer_2,Carmen,40,ES39209541173898369721,TRX_N-00142-01322240,2022-04-21T23:20:31,Zarautz,expenses,children,-52.71,-5911.23
buyer_2,Carmen,40,ES39209541173898369721,TRX_N-00143-66013062,2022-04-22T12:51:09,Zarautz,expenses,children,-85.74,-5996.97
buyer_2,Carmen,40,ES39209541173898369721,TRX_N-00144-00987440,2022-04-27T15:20:36,Hondarribia,expenses,transport,-46.92,-6043.89
buyer_2,Carmen,40,ES39209541173898369721,TRX_N-00145-06141593,2022-04-27T22:31:45,Zarautz,expenses,leisure,-72.31,-6116.2
buyer_2,Carmen,40,ES39209541173898369721,TRX_N-00146-80833723,2022-04-30T20:18:17,Zarautz,expenses,transport,-62.65,-6178.85
buyer_2,Carmen,40,ES39209541173898369721,TRX_N-00147-99452996,2022-05-01T09:22:14,Zarautz,incomes,salary,1325.37,-4853.48
buyer_2,Carmen,40,ES39209541173898369721,TRX_N-00148-80181164,2022-05-01T09:22:14,Zarautz,incomes,salary_partner,1398.01,-3455.47
buyer_2,Carmen,40,ES39209541173898369721,TRX_N-00149-29237305,2022-05-03T11:41:38,Alegría-Dulantzi,expenses,transport,-60.06,-3515.53
buyer_2,Carmen,40,ES39209541173898369721,TRX_N-00150-87412754,2022-05-03T18:25:36,Zarautz,expenses,leisure,-64.78,-3580.31
buyer_2,Carmen,40,ES39209541173898369721,TRX_N-00151-95956426,2022-05-04T05:57:11,Zarautz,expenses,mortgage,-882.99,-4463.3
buyer_2,Carmen,40,ES39209541173898369721,TRX_N-00152-96925584,2022-05-04T18:37:23,Zarautz,expenses,leisure,-69.94,-4533.24
buyer_2,Carmen,40,ES39209541173898369721,TRX_N-00153-80830107,2022-05-05T09:39:40,Zarautz,expenses,electricity,-86.04,-4619.28
buyer_2,Carmen,40,ES39209541173898369721,TRX_N-00154-10047229,2022-05-06T15:01:28,Zarautz,expenses,gas,-90.32,-4709.6
buyer_2,Carmen,40,ES39209541173898369721,TRX_N-00155-91964422,2022-05-06T20:05:19,Zarautz,expenses,phone,-39.68,-4749.28
buyer_2,Carmen,40,ES39209541173898369721,TRX_N-00156-25711798,2022-05-06T15:28:57,Zarautz,expenses,cash,-100.0,-4849.28
buyer_2,Carmen,40,ES39209541173898369721,TRX_N-00157-22272378,2022-05-07T18:37:37,Zarautz,expenses,internet,-42.0,-4891.28
buyer_2,Carmen,40,ES39209541173898369721,TRX_N-00158-40554835,2022-05-08T22:02:18,Zarautz,expenses,water,-40.46,-4931.74
buyer_2,Carmen,40,ES39209541173898369721,TRX_N-00159-84637428,2022-05-08T23:10:40,Zarautz,expenses,food,-110.16,-5041.9
buyer_2,Carmen,40,ES39209541173898369721,TRX_N-00160-47079486,2022-05-10T08:34:32,Zarautz,expenses,cash,-100.0,-5141.9
buyer_2,Carmen,40,ES39209541173898369721,TRX_N-00161-23799366,2022-05-10T08:01:36,Zarautz,expenses,gifts,-657.14,-5799.04
buyer_2,Carmen,40,ES39209541173898369721,TRX_N-00162-89987025,2022-05-11T11:26:10,Zarautz,expenses,travel,-1700.94,-7499.98
buyer_2,Carmen,40,ES39209541173898369721,TRX_N-00163-09994654,2022-05-12T21:08:29,Zarautz,expenses,cash,-100.0,-7599.98
buyer_2,Carmen,40,ES39209541173898369721,TRX_N-00164-22351393,2022-05-13T20:52:57,Zarautz,expenses,cash,-100.0,-7699.98
buyer_2,Carmen,40,ES39209541173898369721,TRX_N-00165-86048275,2022-05-15T13:10:23,Salvatierra/Agurain,expenses,repairs,-274.93,-7974.91
buyer_2,Carmen,40,ES39209541173898369721,TRX_N-00166-72806270,2022-05-16T08:47:14,Amurrio,expenses,transport,-62.41,-8037.32
buyer_2,Carmen,40,ES39209541173898369721,TRX_N-00167-39539343,2022-05-16T20:11:17,Zarautz,expenses,leisure,-72.82,-8110.14
buyer_2,Carmen,40,ES39209541173898369721,TRX_N-00168-33119751,2022-05-17T16:06:26,Zarautz,expenses,leisure,-57.65,-8167.79
buyer_2,Carmen,40,ES39209541173898369721,TRX_N-00169-26662348,2022-05-19T09:33:15,Zarautz,expenses,food,-89.49,-8257.28
buyer_2,Carmen,40,ES39209541173898369721,TRX_N-00170-24899275,2022-05-21T10:53:55,Zarautz,expenses,leisure,-60.82,-8318.1
buyer_2,Carmen,40,ES39209541173898369721,TRX_N-00171-84342520,2022-05-25T17:34:11,Zarautz,expenses,cash,-100.0,-8418.1
buyer_2,Carmen,40,ES39209541173898369721,TRX_N-00172-67575282,2022-05-27T18:20:55,Zarautz,expenses,cash,-100.0,-8518.1
buyer_2,Carmen,40,ES39209541173898369721,TRX_N-00173-67118501,2022-05-29T13:21:08,Zarautz,expenses,transport,-53.83,-8571.93
buyer_2,Carmen,40,ES39209541173898369721,TRX_N-00174-40694234,2022-05-29T16:21:38,Zarautz,expenses,cash,-100.0,-8671.93
buyer_2,Carmen,40,ES39209541173898369721,TRX_N-00175-30165705,2022-05-30T11:00:05,Zarautz,expenses,children,-246.87,-8918.8
buyer_2,Carmen,40,ES39209541173898369721,TRX_N-00176-98923816,2022-05-31T17:54:08,Zarautz,expenses,food,-66.62,-8985.42
buyer_2,Carmen,40,ES39209541173898369721,TRX_N-00177-24709716,2022-05-31T08:06:18,Zarautz,expenses,gifts,-507.9,-9493.32
buyer_2,Carmen,40,ES39209541173898369721,TRX_N-00178-55640783,2022-06-01T13:41:52,Zarautz,incomes,salary,1325.37,-8167.95
buyer_2,Carmen,40,ES39209541173898369721,TRX_N-00179-17939652,2022-06-01T13:41:52,Zarautz,incomes,salary_partner,1398.01,-6769.94
buyer_2,Carmen,40,ES39209541173898369721,TRX_N-00180-88408956,2022-06-01T13:41:52,Zarautz,incomes,salary_bonus,934.27,-5835.67
buyer_2,Carmen,40,ES39209541173898369721,TRX_N-00181-05001985,2022-06-01T13:41:52,Zarautz,incomes,salary_partner_bonus,1015.08,-4820.59
buyer_2,Carmen,40,ES39209541173898369721,TRX_N-00182-44930045,2022-06-01T10:59:15,Basauri,expenses,food,-107.75,-4928.34
buyer_2,Carmen,40,ES39209541173898369721,TRX_N-00183-31577852,2022-06-02T13:37:07,Alegría-Dulantzi,expenses,transport,-58.31,-4986.65
buyer_2,Carmen,40,ES39209541173898369721,TRX_N-00184-05144150,2022-06-03T05:02:15,Zarautz,expenses,food,-124.88,-5111.53
buyer_2,Carmen,40,ES39209541173898369721,TRX_N-00185-60594491,2022-06-04T10:20:11,Zarautz,expenses,mortgage,-882.99,-5994.52
buyer_2,Carmen,40,ES39209541173898369721,TRX_N-00186-83862037,2022-06-04T06:23:02,Zarautz,expenses,repairs,-90.27,-6084.79
buyer_2,Carmen,40,ES39209541173898369721,TRX_N-00187-94786858,2022-06-04T21:53:18,Zarautz,expenses,gifts,-386.66,-6471.45
buyer_2,Carmen,40,ES39209541173898369721,TRX_N-00188-10641367,2022-06-05T09:46:45,Zarautz,expenses,water,-25.59,-6497.04
buyer_2,Carmen,40,ES39209541173898369721,TRX_N-00189-04364713,2022-06-05T15:00:31,Zarautz,expenses,electricity,-82.59,-6579.63
buyer_2,Carmen,40,ES39209541173898369721,TRX_N-00190-50887433,2022-06-05T15:42:33,Zarautz,expenses,leisure,-81.74,-6661.37
buyer_2,Carmen,40,ES39209541173898369721,TRX_N-00191-53144069,2022-06-06T18:14:03,Zarautz,expenses,internet,-42.0,-6703.37
buyer_2,Carmen,40,ES39209541173898369721,TRX_N-00192-26412815,2022-06-07T15:53:56,Zarautz,expenses,repairs,-299.35,-7002.72
buyer_2,Carmen,40,ES39209541173898369721,TRX_N-00193-52406279,2022-06-07T12:06:13,Zarautz,expenses,children,-227.24,-7229.96
buyer_2,Carmen,40,ES39209541173898369721,TRX_N-00194-79433108,2022-06-08T17:45:48,Zarautz,expenses,gas,-92.72,-7322.68
buyer_2,Carmen,40,ES39209541173898369721,TRX_N-00195-15683343,2022-06-08T19:11:29,Zarautz,expenses,phone,-40.15,-7362.83
buyer_2,Carmen,40,ES39209541173898369721,TRX_N-00196-76215907,2022-06-08T11:10:31,Zarautz,expenses,repairs,-201.14,-7563.97
buyer_2,Carmen,40,ES39209541173898369721,TRX_N-00197-08959834,2022-06-10T11:27:12,Zarautz,expenses,cash,-100.0,-7663.97
buyer_2,Carmen,40,ES39209541173898369721,TRX_N-00198-65686263,2022-06-11T14:05:20,Zarautz,expenses,cash,-100.0,-7763.97
buyer_2,Carmen,40,ES39209541173898369721,TRX_N-00199-47056386,2022-06-12T16:51:19,Elciego,expenses,clothing,-124.53,-7888.5
buyer_2,Carmen,40,ES39209541173898369721,TRX_N-00200-52401581,2022-06-13T18:34:05,Zarautz,expenses,cash,-100.0,-7988.5
buyer_2,Carmen,40,ES39209541173898369721,TRX_N-00201-21162461,2022-06-15T10:04:56,Zarautz,expenses,transport,-80.53,-8069.03
buyer_2,Carmen,40,ES39209541173898369721,TRX_N-00202-71695873,2022-06-16T14:37:25,Zarautz,expenses,children,-81.7,-8150.73
buyer_2,Carmen,40,ES39209541173898369721,TRX_N-00203-01492551,2022-06-17T20:20:24,Zarautz,expenses,travel,-452.19,-8602.92
buyer_2,Carmen,40,ES39209541173898369721,TRX_N-00204-69267431,2022-06-20T11:57:41,Zarautz,expenses,transport,-47.28,-8650.2
buyer_2,Carmen,40,ES39209541173898369721,TRX_N-00205-76040107,2022-06-20T12:43:04,Zarautz,expenses,cash,-100.0,-8750.2
buyer_2,Carmen,40,ES39209541173898369721,TRX_N-00206-00989185,2022-06-22T14:37:44,Zarautz,expenses,repairs,-133.25,-8883.45
buyer_2,Carmen,40,ES39209541173898369721,TRX_N-00207-91682154,2022-06-23T15:42:19,Zarautz,expenses,leisure,-64.24,-8947.69
buyer_2,Carmen,40,ES39209541173898369721,TRX_N-00208-26181859,2022-06-23T14:00:13,Zarautz,expenses,repairs,-41.92,-8989.61
buyer_2,Carmen,40,ES39209541173898369721,TRX_N-00209-53057371,2022-06-24T13:22:21,Zarautz,expenses,transport,-50.08,-9039.69
buyer_2,Carmen,40,ES39209541173898369721,TRX_N-00210-09939286,2022-06-24T15:40:25,Zarautz,expenses,gifts,-547.03,-9586.72
buyer_2,Carmen,40,ES39209541173898369721,TRX_N-00211-88817609,2022-06-25T11:48:48,Zarautz,expenses,transport,-82.85,-9669.57
buyer_2,Carmen,40,ES39209541173898369721,TRX_N-00212-30875156,2022-06-26T18:28:15,Zarautz,expenses,leisure,-60.21,-9729.78
buyer_2,Carmen,40,ES39209541173898369721,TRX_N-00213-12922497,2022-06-29T12:56:59,Zarautz,expenses,education,-42.03,-9771.81
buyer_2,Carmen,40,ES39209541173898369721,TRX_N-00214-04860273,2022-06-30T14:35:43,Zarautz,expenses,food,-82.13,-9853.94
buyer_2,Carmen,40,ES39209541173898369721,TRX_N-00215-82544834,2022-07-01T20:07:56,Zarautz,incomes,salary,1325.37,-8528.57
buyer_2,Carmen,40,ES39209541173898369721,TRX_N-00216-98609658,2022-07-01T20:07:56,Zarautz,incomes,salary_partner,1398.01,-7130.56
buyer_2,Carmen,40,ES39209541173898369721,TRX_N-00217-54275655,2022-07-01T20:07:56,Zarautz,incomes,extra_income,159.61,-6970.95
buyer_2,Carmen,40,ES39209541173898369721,TRX_N-00218-54773798,2022-07-01T06:00:19,Zarautz,expenses,repairs,-162.71,-7133.66
buyer_2,Carmen,40,ES39209541173898369721,TRX_N-00219-50309288,2022-07-01T12:03:52,Zarautz,expenses,children,-277.6,-7411.26
buyer_2,Carmen,40,ES39209541173898369721,TRX_N-00220-96406991,2022-07-03T23:50:31,Zarautz,expenses,healthcare,-188.03,-7599.29
buyer_2,Carmen,40,ES39209541173898369721,TRX_N-00221-07266360,2022-07-03T16:08:06,Zarautz,expenses,repairs,-326.96,-7926.25
buyer_2,Carmen,40,ES39209541173898369721,TRX_N-00222-02021523,2022-07-04T11:16:01,Zarautz,expenses,mortgage,-882.99,-8809.24
buyer_2,Carmen,40,ES39209541173898369721,TRX_N-00223-60565354,2022-07-04T19:05:38,Amurrio,expenses,leisure,-81.42,-8890.66
buyer_2,Carmen,40,ES39209541173898369721,TRX_N-00224-20750502,2022-07-04T14:10:29,Zarautz,expenses,repairs,-273.76,-9164.42
buyer_2,Carmen,40,ES39209541173898369721,TRX_N-00225-23996848,2022-07-05T16:48:20,Zarautz,expenses,water,-37.32,-9201.74
buyer_2,Carmen,40,ES39209541173898369721,TRX_N-00226-11600683,2022-07-05T20:52:33,Zarautz,expenses,internet,-42.0,-9243.74
buyer_2,Carmen,40,ES39209541173898369721,TRX_N-00227-68703437,2022-07-06T16:57:51,Zarautz,expenses,gas,-113.84,-9357.58
buyer_2,Carmen,40,ES39209541173898369721,TRX_N-00228-91048214,2022-07-06T13:32:50,Zarautz,expenses,phone,-30.1,-9387.68
buyer_2,Carmen,40,ES39209541173898369721,TRX_N-00229-72177649,2022-07-06T19:37:14,Hondarribia,expenses,clothing,-96.58,-9484.26
buyer_2,Carmen,40,ES39209541173898369721,TRX_N-00230-57170766,2022-07-06T14:35:49,Zarautz,expenses,cash,-100.0,-9584.26
buyer_2,Carmen,40,ES39209541173898369721,TRX_N-00231-67817132,2022-07-07T00:35:24,Zarautz,expenses,transport,-71.37,-9655.63
buyer_2,Carmen,40,ES39209541173898369721,TRX_N-00232-18427058,2022-07-08T10:58:39,Zarautz,expenses,electricity,-52.87,-9708.5
buyer_2,Carmen,40,ES39209541173898369721,TRX_N-00233-19923339,2022-07-08T03:48:28,Zarautz,expenses,food,-87.21,-9795.71
buyer_2,Carmen,40,ES39209541173898369721,TRX_N-00234-65906975,2022-07-08T09:48:52,Lasarte-Oria,expenses,transport,-59.85,-9855.56
buyer_2,Carmen,40,ES39209541173898369721,TRX_N-00235-63167242,2022-07-09T14:01:10,Zarautz,expenses,repairs,-322.5,-10178.06
buyer_2,Carmen,40,ES39209541173898369721,TRX_N-00236-00572855,2022-07-12T11:11:30,Zarautz,expenses,cash,-100.0,-10278.06
buyer_2,Carmen,40,ES39209541173898369721,TRX_N-00237-49947322,2022-07-13T12:21:50,Zarautz,expenses,transport,-89.05,-10367.11
buyer_2,Carmen,40,ES39209541173898369721,TRX_N-00238-71810928,2022-07-14T06:22:35,Barakaldo,expenses,clothing,-119.53,-10486.64
buyer_2,Carmen,40,ES39209541173898369721,TRX_N-00239-00069134,2022-07-16T04:38:07,Zarautz,expenses,transport,-51.73,-10538.37
buyer_2,Carmen,40,ES39209541173898369721,TRX_N-00240-10798844,2022-07-16T13:13:26,Zarautz,expenses,cash,-100.0,-10638.37
buyer_2,Carmen,40,ES39209541173898369721,TRX_N-00241-85572248,2022-07-17T23:14:12,Zarautz,expenses,cash,-100.0,-10738.37
buyer_2,Carmen,40,ES39209541173898369721,TRX_N-00242-82039490,2022-07-18T08:02:10,Zarautz,expenses,healthcare,-122.36,-10860.73
buyer_2,Carmen,40,ES39209541173898369721,TRX_N-00243-44132147,2022-07-19T21:18:09,Lasarte-Oria,expenses,leisure,-83.88,-10944.61
buyer_2,Carmen,40,ES39209541173898369721,TRX_N-00244-19949972,2022-07-20T16:27:55,Llodio,expenses,leisure,-40.63,-10985.24
buyer_2,Carmen,40,ES39209541173898369721,TRX_N-00245-64783795,2022-07-22T09:20:46,Zarautz,expenses,cash,-100.0,-11085.24
buyer_2,Carmen,40,ES39209541173898369721,TRX_N-00246-08124469,2022-07-22T22:51:18,Zarautz,expenses,repairs,-288.75,-11373.99
buyer_2,Carmen,40,ES39209541173898369721,TRX_N-00247-43107609,2022-07-24T19:33:01,Zarautz,expenses,food,-110.07,-11484.06
buyer_2,Carmen,40,ES39209541173898369721,TRX_N-00248-88833158,2022-07-24T19:55:24,Zarautz,expenses,repairs,-219.78,-11703.84
buyer_2,Carmen,40,ES39209541173898369721,TRX_N-00249-05618619,2022-07-25T10:04:39,Alegría-Dulantzi,expenses,leisure,-68.34,-11772.18
buyer_2,Carmen,40,ES39209541173898369721,TRX_N-00250-85210062,2022-07-26T02:03:19,Zarautz,expenses,repairs,-136.48,-11908.66
buyer_2,Carmen,40,ES39209541173898369721,TRX_N-00251-09943789,2022-07-27T13:16:06,Zarautz,expenses,food,-106.6,-12015.26
buyer_2,Carmen,40,ES39209541173898369721,TRX_N-00252-05839745,2022-07-27T15:40:08,Zarautz,expenses,transport,-73.42,-12088.68
buyer_2,Carmen,40,ES39209541173898369721,TRX_N-00253-14013019,2022-07-27T18:55:48,Zarautz,expenses,leisure,-45.71,-12134.39
buyer_2,Carmen,40,ES39209541173898369721,TRX_N-00254-36480194,2022-07-28T12:13:12,Zarautz,expenses,cash,-100.0,-12234.39
buyer_2,Carmen,40,ES39209541173898369721,TRX_N-00255-66983996,2022-07-28T09:03:27,Zarautz,expenses,appliances,-164.94,-12399.33
buyer_2,Carmen,40,ES39209541173898369721,TRX_N-00256-73204634,2022-07-29T19:58:53,Zarautz,expenses,food,-73.08,-12472.41
buyer_2,Carmen,40,ES39209541173898369721,TRX_N-00257-42862875,2022-07-29T18:21:12,Errenteria,expenses,transport,-78.67,-12551.08
buyer_2,Carmen,40,ES39209541173898369721,TRX_N-00258-20958622,2022-07-31T16:28:03,Zarautz,expenses,food,-98.75,-12649.83
buyer_2,Carmen,40,ES39209541173898369721,TRX_N-00259-03407411,2022-07-31T11:38:47,Zarautz,expenses,cash,-100.0,-12749.83
buyer_2,Carmen,40,ES39209541173898369721,TRX_N-00260-70409096,2022-08-01T15:52:28,Zarautz,incomes,salary,1325.37,-11424.46
buyer_2,Carmen,40,ES39209541173898369721,TRX_N-00261-58493396,2022-08-01T15:52:28,Zarautz,incomes,salary_partner,1398.01,-10026.45
buyer_2,Carmen,40,ES39209541173898369721,TRX_N-00262-87142867,2022-08-01T16:24:52,Zarautz,expenses,children,-196.88,-10223.33
buyer_2,Carmen,40,ES39209541173898369721,TRX_N-00263-99023505,2022-08-04T09:43:23,Zarautz,expenses,mortgage,-882.99,-11106.32
buyer_2,Carmen,40,ES39209541173898369721,TRX_N-00264-24615270,2022-08-05T04:24:14,Zarautz,expenses,internet,-42.0,-11148.32
buyer_2,Carmen,40,ES39209541173898369721,TRX_N-00265-93417933,2022-08-05T17:49:43,Zarautz,expenses,food,-107.6,-11255.92
buyer_2,Carmen,40,ES39209541173898369721,TRX_N-00266-58742505,2022-08-06T14:28:08,Zarautz,expenses,gas,-61.78,-11317.7
buyer_2,Carmen,40,ES39209541173898369721,TRX_N-00267-41628393,2022-08-06T19:21:49,Zarautz,expenses,leisure,-84.31,-11402.01
buyer_2,Carmen,40,ES39209541173898369721,TRX_N-00268-91568655,2022-08-07T11:19:55,Zarautz,expenses,food,-107.47,-11509.48
buyer_2,Carmen,40,ES39209541173898369721,TRX_N-00269-40013883,2022-08-07T12:42:55,Zarautz,expenses,leisure,-29.42,-11538.9
buyer_2,Carmen,40,ES39209541173898369721,TRX_N-00270-44735304,2022-08-07T18:48:40,Zarautz,expenses,appliances,-245.53,-11784.43
buyer_2,Carmen,40,ES39209541173898369721,TRX_N-00271-33108179,2022-08-08T18:46:56,Zarautz,expenses,water,-41.85,-11826.28
buyer_2,Carmen,40,ES39209541173898369721,TRX_N-00272-15690359,2022-08-08T20:04:47,Zarautz,expenses,electricity,-60.35,-11886.63
buyer_2,Carmen,40,ES39209541173898369721,TRX_N-00273-02727889,2022-08-08T08:28:26,Zarautz,expenses,phone,-35.14,-11921.77
buyer_2,Carmen,40,ES39209541173898369721,TRX_N-00274-16725806,2022-08-08T14:52:29,Zarautz,expenses,children,-156.33,-12078.1
buyer_2,Carmen,40,ES39209541173898369721,TRX_N-00275-29043370,2022-08-09T16:42:36,Zarautz,expenses,food,-73.19,-12151.29
buyer_2,Carmen,40,ES39209541173898369721,TRX_N-00276-77032477,2022-08-10T20:12:57,Zuia,expenses,leisure,-74.84,-12226.13
buyer_2,Carmen,40,ES39209541173898369721,TRX_N-00277-18544674,2022-08-11T13:33:35,Zarautz,expenses,food,-100.53,-12326.66
buyer_2,Carmen,40,ES39209541173898369721,TRX_N-00278-55740904,2022-08-11T17:28:10,Oyón-Oion,expenses,clothing,-94.18,-12420.84
buyer_2,Carmen,40,ES39209541173898369721,TRX_N-00279-32787819,2022-08-15T15:20:16,Pasaia,expenses,education,-51.85,-12472.69
buyer_2,Carmen,40,ES39209541173898369721,TRX_N-00280-71968058,2022-08-19T18:07:38,Zarautz,expenses,cash,-100.0,-12572.69
buyer_2,Carmen,40,ES39209541173898369721,TRX_N-00281-00595607,2022-08-20T19:13:34,Zarautz,expenses,clothing,-76.21,-12648.9
buyer_2,Carmen,40,ES39209541173898369721,TRX_N-00282-14204838,2022-08-20T03:08:40,Zarautz,expenses,cash,-100.0,-12748.9
buyer_2,Carmen,40,ES39209541173898369721,TRX_N-00283-61326916,2022-08-23T21:38:52,Zarautz,expenses,cash,-100.0,-12848.9
buyer_2,Carmen,40,ES39209541173898369721,TRX_N-00284-89918994,2022-08-25T10:25:29,Zarautz,expenses,cash,-100.0,-12948.9
buyer_2,Carmen,40,ES39209541173898369721,TRX_N-00285-93484420,2022-08-26T10:34:02,Zarautz,expenses,repairs,-205.18,-13154.08
buyer_2,Carmen,40,ES39209541173898369721,TRX_N-00286-34075659,2022-08-28T15:18:47,Zarautz,expenses,leisure,-64.58,-13218.66
buyer_2,Carmen,40,ES39209541173898369721,TRX_N-00287-66274827,2022-08-29T09:44:21,Galdakao,expenses,cash,-100.0,-13318.66
buyer_2,Carmen,40,ES39209541173898369721,TRX_N-00288-92866159,2022-08-30T21:33:41,Zarautz,expenses,transport,-54.57,-13373.23
buyer_2,Carmen,40,ES39209541173898369721,TRX_N-00289-06963939,2022-08-31T14:31:05,Lasarte-Oria,expenses,cash,-100.0,-13473.23
buyer_2,Carmen,40,ES39209541173898369721,TRX_N-00290-45874566,2022-09-01T17:45:08,Zarautz,incomes,salary,1325.37,-12147.86
buyer_2,Carmen,40,ES39209541173898369721,TRX_N-00291-42322647,2022-09-01T17:45:08,Zarautz,incomes,salary_partner,1398.01,-10749.85
buyer_2,Carmen,40,ES39209541173898369721,TRX_N-00292-53780207,2022-09-01T21:30:50,Zarautz,expenses,gifts,-375.6,-11125.45
buyer_2,Carmen,40,ES39209541173898369721,TRX_N-00293-61475347,2022-09-03T20:28:15,Zarautz,expenses,gifts,-175.99,-11301.44
buyer_2,Carmen,40,ES39209541173898369721,TRX_N-00294-71839776,2022-09-04T18:28:04,Zarautz,expenses,mortgage,-882.99,-12184.43
buyer_2,Carmen,40,ES39209541173898369721,TRX_N-00295-84103956,2022-09-05T16:44:04,Zarautz,expenses,internet,-42.0,-12226.43
buyer_2,Carmen,40,ES39209541173898369721,TRX_N-00296-48710915,2022-09-05T15:58:21,Zarautz,expenses,food,-67.49,-12293.92
buyer_2,Carmen,40,ES39209541173898369721,TRX_N-00297-70937895,2022-09-05T14:33:26,Zarautz,expenses,education,-59.74,-12353.66
buyer_2,Carmen,40,ES39209541173898369721,TRX_N-00298-40174708,2022-09-06T05:57:30,Zarautz,expenses,phone,-35.01,-12388.67
buyer_2,Carmen,40,ES39209541173898369721,TRX_N-00299-40762217,2022-09-06T15:34:19,Zarautz,expenses,transport,-61.17,-12449.84
buyer_2,Carmen,40,ES39209541173898369721,TRX_N-00300-42395338,2022-09-07T22:14:50,Zarautz,expenses,gas,-72.34,-12522.18
buyer_2,Carmen,40,ES39209541173898369721,TRX_N-00301-01764816,2022-09-08T20:30:52,Zarautz,expenses,electricity,-21.22,-12543.4
buyer_2,Carmen,40,ES39209541173898369721,TRX_N-00302-93002103,2022-09-08T16:40:44,Zarautz,expenses,water,-27.93,-12571.33
buyer_2,Carmen,40,ES39209541173898369721,TRX_N-00303-35677962,2022-09-09T18:48:47,Zarautz,expenses,food,-122.06,-12693.39
buyer_2,Carmen,40,ES39209541173898369721,TRX_N-00304-21359138,2022-09-09T01:11:17,Elciego,expenses,cash,-100.0,-12793.39
buyer_2,Carmen,40,ES39209541173898369721,TRX_N-00305-68550767,2022-09-10T19:26:37,Zarautz,expenses,food,-90.29,-12883.68
buyer_2,Carmen,40,ES39209541173898369721,TRX_N-00306-82177791,2022-09-10T15:24:23,Zarautz,expenses,leisure,-28.93,-12912.61
buyer_2,Carmen,40,ES39209541173898369721,TRX_N-00307-28211419,2022-09-12T13:31:45,Zarautz,expenses,cash,-100.0,-13012.61
buyer_2,Carmen,40,ES39209541173898369721,TRX_N-00308-57680875,2022-09-13T20:53:25,Zarautz,expenses,transport,-87.82,-13100.43
buyer_2,Carmen,40,ES39209541173898369721,TRX_N-00309-10853512,2022-09-15T16:58:15,Zarautz,expenses,repairs,-257.35,-13357.78
buyer_2,Carmen,40,ES39209541173898369721,TRX_N-00310-59205141,2022-09-15T18:03:16,Hernani,expenses,gifts,-678.82,-14036.6
buyer_2,Carmen,40,ES39209541173898369721,TRX_N-00311-36260563,2022-09-16T10:40:13,Zarautz,expenses,transport,-79.7,-14116.3
buyer_2,Carmen,40,ES39209541173898369721,TRX_N-00312-83188003,2022-09-17T06:08:59,Erandio,expenses,transport,-50.09,-14166.39
buyer_2,Carmen,40,ES39209541173898369721,TRX_N-00313-87185235,2022-09-17T13:41:40,Zarautz,expenses,leisure,-65.11,-14231.5
buyer_2,Carmen,40,ES39209541173898369721,TRX_N-00314-43904064,2022-09-17T14:23:23,Zarautz,expenses,repairs,-156.08,-14387.58
buyer_2,Carmen,40,ES39209541173898369721,TRX_N-00315-12947578,2022-09-20T08:06:33,Zarautz,expenses,leisure,-80.75,-14468.33
buyer_2,Carmen,40,ES39209541173898369721,TRX_N-00316-87004359,2022-09-21T20:21:08,Zarautz,expenses,cash,-100.0,-14568.33
buyer_2,Carmen,40,ES39209541173898369721,TRX_N-00317-13777497,2022-09-24T19:00:46,Zarautz,expenses,education,-70.31,-14638.64
buyer_2,Carmen,40,ES39209541173898369721,TRX_N-00318-21947521,2022-09-28T16:52:25,Zarautz,expenses,leisure,-43.28,-14681.92
buyer_2,Carmen,40,ES39209541173898369721,TRX_N-00319-10465842,2022-09-28T09:36:46,Zarautz,expenses,cash,-100.0,-14781.92
buyer_2,Carmen,40,ES39209541173898369721,TRX_N-00320-24704911,2022-10-01T23:22:25,Zarautz,incomes,salary,1325.37,-13456.55
buyer_2,Carmen,40,ES39209541173898369721,TRX_N-00321-42442506,2022-10-01T23:22:25,Zarautz,incomes,salary_partner,1398.01,-12058.54
buyer_2,Carmen,40,ES39209541173898369721,TRX_N-00322-47932129,2022-10-01T23:22:25,Zarautz,incomes,extra_income,159.61,-11898.93
buyer_2,Carmen,40,ES39209541173898369721,TRX_N-00323-50153677,2022-10-01T12:43:08,Eibar,expenses,cash,-100.0,-11998.93
buyer_2,Carmen,40,ES39209541173898369721,TRX_N-00324-15837686,2022-10-02T09:51:19,Zarautz,expenses,food,-89.46,-12088.39
buyer_2,Carmen,40,ES39209541173898369721,TRX_N-00325-91125931,2022-10-02T09:48:36,Zarautz,expenses,transport,-63.13,-12151.52
buyer_2,Carmen,40,ES39209541173898369721,TRX_N-00326-62800533,2022-10-04T19:19:43,Zarautz,expenses,mortgage,-882.99,-13034.51
buyer_2,Carmen,40,ES39209541173898369721,TRX_N-00327-40931831,2022-10-04T08:43:51,Zarautz,expenses,leisure,-68.55,-13103.06
buyer_2,Carmen,40,ES39209541173898369721,TRX_N-00328-27594016,2022-10-05T20:14:00,Zarautz,expenses,gas,-56.35,-13159.41
buyer_2,Carmen,40,ES39209541173898369721,TRX_N-00329-08043720,2022-10-05T22:16:34,Zarautz,expenses,internet,-42.0,-13201.41
buyer_2,Carmen,40,ES39209541173898369721,TRX_N-00330-60778053,2022-10-05T15:44:46,Zarautz,expenses,transport,-85.81,-13287.22
buyer_2,Carmen,40,ES39209541173898369721,TRX_N-00331-51495217,2022-10-05T22:06:43,Zarautz,expenses,leisure,-69.12,-13356.34
buyer_2,Carmen,40,ES39209541173898369721,TRX_N-00332-39906856,2022-10-05T14:39:08,Zarautz,expenses,travel,-1891.37,-15247.71
buyer_2,Carmen,40,ES39209541173898369721,TRX_N-00333-26328954,2022-10-06T13:30:54,Zarautz,expenses,food,-119.66,-15367.37
buyer_2,Carmen,40,ES39209541173898369721,TRX_N-00334-79442734,2022-10-07T12:30:49,Zarautz,expenses,phone,-30.21,-15397.58
buyer_2,Carmen,40,ES39209541173898369721,TRX_N-00335-39529056,2022-10-07T18:08:56,Zarautz,expenses,repairs,-305.27,-15702.85
buyer_2,Carmen,40,ES39209541173898369721,TRX_N-00336-51480397,2022-10-08T12:43:44,Zarautz,expenses,water,-28.94,-15731.79
buyer_2,Carmen,40,ES39209541173898369721,TRX_N-00337-41121113,2022-10-08T13:39:13,Zarautz,expenses,electricity,-20.86,-15752.65
buyer_2,Carmen,40,ES39209541173898369721,TRX_N-00338-98154621,2022-10-10T03:46:03,Zarautz,expenses,cash,-100.0,-15852.65
buyer_2,Carmen,40,ES39209541173898369721,TRX_N-00339-07212764,2022-10-12T16:24:47,Zarautz,expenses,repairs,-54.11,-15906.76
buyer_2,Carmen,40,ES39209541173898369721,TRX_N-00340-17662953,2022-10-14T18:27:56,Zarautz,expenses,clothing,-113.32,-16020.08
buyer_2,Carmen,40,ES39209541173898369721,TRX_N-00341-51123900,2022-10-14T20:16:45,Zarautz,expenses,children,-116.67,-16136.75
buyer_2,Carmen,40,ES39209541173898369721,TRX_N-00342-83487844,2022-10-15T20:55:32,Zarautz,expenses,repairs,-255.66,-16392.41
buyer_2,Carmen,40,ES39209541173898369721,TRX_N-00343-56049992,2022-10-17T15:39:05,Oyón-Oion,expenses,clothing,-55.29,-16447.7
buyer_2,Carmen,40,ES39209541173898369721,TRX_N-00344-66494232,2022-10-18T10:23:24,Zarautz,expenses,cash,-100.0,-16547.7
buyer_2,Carmen,40,ES39209541173898369721,TRX_N-00345-75239526,2022-10-21T20:14:10,Zarautz,expenses,leisure,-20.59,-16568.29
buyer_2,Carmen,40,ES39209541173898369721,TRX_N-00346-90966908,2022-10-21T04:56:07,Zarautz,expenses,cash,-100.0,-16668.29
buyer_2,Carmen,40,ES39209541173898369721,TRX_N-00347-99619117,2022-10-23T19:22:10,Zarautz,expenses,gifts,-524.08,-17192.37
buyer_2,Carmen,40,ES39209541173898369721,TRX_N-00348-95114739,2022-10-25T08:19:32,Zarautz,expenses,healthcare,-83.92,-17276.29
buyer_2,Carmen,40,ES39209541173898369721,TRX_N-00349-96207177,2022-10-27T16:53:22,Zarautz,expenses,transport,-64.48,-17340.77
buyer_2,Carmen,40,ES39209541173898369721,TRX_N-00350-50462763,2022-10-27T16:09:35,Zarautz,expenses,clothing,-102.69,-17443.46
buyer_2,Carmen,40,ES39209541173898369721,TRX_N-00351-88336237,2022-10-29T16:29:40,Zarautz,expenses,education,-71.35,-17514.81
buyer_2,Carmen,40,ES39209541173898369721,TRX_N-00352-40770155,2022-10-29T14:48:57,Zarautz,expenses,gifts,-127.86,-17642.67
buyer_2,Carmen,40,ES39209541173898369721,TRX_N-00353-07237845,2022-11-01T09:54:43,Zarautz,incomes,salary,1325.37,-16317.3
buyer_2,Carmen,40,ES39209541173898369721,TRX_N-00354-09178101,2022-11-01T09:54:43,Zarautz,incomes,salary_partner,1398.01,-14919.29
buyer_2,Carmen,40,ES39209541173898369721,TRX_N-00355-85356603,2022-11-01T21:29:06,Zarautz,expenses,transport,-83.68,-15002.97
buyer_2,Carmen,40,ES39209541173898369721,TRX_N-00356-29691564,2022-11-01T16:43:10,Sopela,expenses,healthcare,-90.14,-15093.11
buyer_2,Carmen,40,ES39209541173898369721,TRX_N-00357-01806719,2022-11-02T14:23:42,Zarautz,expenses,food,-99.82,-15192.93
buyer_2,Carmen,40,ES39209541173898369721,TRX_N-00358-83859183,2022-11-02T19:42:32,Zarautz,expenses,leisure,-32.62,-15225.55
buyer_2,Carmen,40,ES39209541173898369721,TRX_N-00359-07669514,2022-11-03T10:27:37,Zarautz,expenses,cash,-100.0,-15325.55
buyer_2,Carmen,40,ES39209541173898369721,TRX_N-00360-54769002,2022-11-04T00:30:58,Zarautz,expenses,mortgage,-882.99,-16208.54
buyer_2,Carmen,40,ES39209541173898369721,TRX_N-00361-42473808,2022-11-04T13:58:19,Zarautz,expenses,repairs,-90.01,-16298.55
buyer_2,Carmen,40,ES39209541173898369721,TRX_N-00362-93590791,2022-11-05T19:10:48,Zarautz,expenses,water,-37.02,-16335.57
buyer_2,Carmen,40,ES39209541173898369721,TRX_N-00363-81794039,2022-11-05T16:57:25,Zarautz,expenses,electricity,-68.48,-16404.05
buyer_2,Carmen,40,ES39209541173898369721,TRX_N-00364-68297648,2022-11-06T16:55:09,Zarautz,expenses,phone,-34.24,-16438.29
buyer_2,Carmen,40,ES39209541173898369721,TRX_N-00365-29103201,2022-11-06T09:18:42,Zarautz,expenses,healthcare,-83.94,-16522.23
buyer_2,Carmen,40,ES39209541173898369721,TRX_N-00366-67810275,2022-11-06T11:50:36,Zarautz,expenses,cash,-100.0,-16622.23
buyer_2,Carmen,40,ES39209541173898369721,TRX_N-00367-56996473,2022-11-08T19:32:15,Zarautz,expenses,internet,-42.0,-16664.23
buyer_2,Carmen,40,ES39209541173898369721,TRX_N-00368-49404756,2022-11-08T10:47:45,Zarautz,expenses,gas,-30.46,-16694.69
buyer_2,Carmen,40,ES39209541173898369721,TRX_N-00369-42896398,2022-11-08T18:58:12,Zarautz,expenses,cash,-100.0,-16794.69
buyer_2,Carmen,40,ES39209541173898369721,TRX_N-00370-77447954,2022-11-13T17:07:10,Barakaldo,expenses,leisure,-21.65,-16816.34
buyer_2,Carmen,40,ES39209541173898369721,TRX_N-00371-01771828,2022-11-13T09:30:30,Zarautz,expenses,repairs,-122.41,-16938.75
buyer_2,Carmen,40,ES39209541173898369721,TRX_N-00372-93119768,2022-11-15T14:52:06,Sopela,expenses,cash,-100.0,-17038.75
buyer_2,Carmen,40,ES39209541173898369721,TRX_N-00373-17561298,2022-11-16T16:33:28,Zarautz,expenses,leisure,-29.6,-17068.35
buyer_2,Carmen,40,ES39209541173898369721,TRX_N-00374-46947802,2022-11-16T21:57:25,Zarautz,expenses,cash,-100.0,-17168.35
buyer_2,Carmen,40,ES39209541173898369721,TRX_N-00375-54915339,2022-11-18T19:30:12,Mungia,expenses,transport,-66.65,-17235.0
buyer_2,Carmen,40,ES39209541173898369721,TRX_N-00376-41020228,2022-11-18T13:10:15,Hondarribia,expenses,leisure,-77.47,-17312.47
buyer_2,Carmen,40,ES39209541173898369721,TRX_N-00377-86512238,2022-11-21T23:37:49,Zarautz,expenses,food,-103.41,-17415.88
buyer_2,Carmen,40,ES39209541173898369721,TRX_N-00378-91563510,2022-11-22T04:42:58,Berango,expenses,leisure,-53.14,-17469.02
buyer_2,Carmen,40,ES39209541173898369721,TRX_N-00379-98580760,2022-11-25T15:32:40,Zarautz,expenses,leisure,-81.11,-17550.13
buyer_2,Carmen,40,ES39209541173898369721,TRX_N-00380-76011944,2022-11-25T10:24:29,Zarautz,expenses,appliances,-199.39,-17749.52
buyer_2,Carmen,40,ES39209541173898369721,TRX_N-00381-96751280,2022-11-25T09:14:43,Santurtzi,expenses,gifts,-286.81,-18036.33
buyer_2,Carmen,40,ES39209541173898369721,TRX_N-00382-69500159,2022-11-27T16:20:17,Zarautz,expenses,food,-68.08,-18104.41
buyer_2,Carmen,40,ES39209541173898369721,TRX_N-00383-54554219,2022-11-27T18:47:23,Zarautz,expenses,healthcare,-62.52,-18166.93
buyer_2,Carmen,40,ES39209541173898369721,TRX_N-00384-07470552,2022-11-28T13:49:56,Zarautz,expenses,cash,-100.0,-18266.93
buyer_2,Carmen,40,ES39209541173898369721,TRX_N-00385-99561663,2022-11-30T08:58:15,Zarautz,expenses,food,-121.43,-18388.36
buyer_2,Carmen,40,ES39209541173898369721,TRX_N-00386-54901135,2022-11-30T13:24:25,Zarautz,expenses,healthcare,-85.53,-18473.89
buyer_2,Carmen,40,ES39209541173898369721,TRX_N-00387-50233447,2022-12-01T17:59:31,Zarautz,incomes,salary,1325.37,-17148.52
buyer_2,Carmen,40,ES39209541173898369721,TRX_N-00388-28355535,2022-12-01T17:59:31,Zarautz,incomes,salary_partner,1398.01,-15750.51
buyer_2,Carmen,40,ES39209541173898369721,TRX_N-00389-88377224,2022-12-01T17:59:31,Zarautz,incomes,salary_bonus,936.95,-14813.56
buyer_2,Carmen,40,ES39209541173898369721,TRX_N-00390-56279975,2022-12-01T17:59:31,Zarautz,incomes,salary_partner_bonus,999.81,-13813.75
buyer_2,Carmen,40,ES39209541173898369721,TRX_N-00391-47909581,2022-12-01T13:18:32,Irun,expenses,leisure,-52.78,-13866.53
buyer_2,Carmen,40,ES39209541173898369721,TRX_N-00392-56419288,2022-12-02T20:23:37,Erandio,expenses,transport,-66.8,-13933.33
buyer_2,Carmen,40,ES39209541173898369721,TRX_N-00393-07221089,2022-12-02T06:00:14,Portugalete,expenses,education,-45.26,-13978.59
buyer_2,Carmen,40,ES39209541173898369721,TRX_N-00394-11124094,2022-12-03T12:43:35,Zarautz,expenses,appliances,-389.67,-14368.26
buyer_2,Carmen,40,ES39209541173898369721,TRX_N-00395-22363327,2022-12-04T18:39:20,Zarautz,expenses,mortgage,-882.99,-15251.25
buyer_2,Carmen,40,ES39209541173898369721,TRX_N-00396-07380023,2022-12-04T11:24:25,Zarautz,expenses,transport,-71.13,-15322.38
buyer_2,Carmen,40,ES39209541173898369721,TRX_N-00397-07285040,2022-12-05T12:10:06,Zarautz,expenses,gas,-79.33,-15401.71
buyer_2,Carmen,40,ES39209541173898369721,TRX_N-00398-10266998,2022-12-05T08:48:35,Zarautz,expenses,internet,-42.0,-15443.71
buyer_2,Carmen,40,ES39209541173898369721,TRX_N-00399-48049205,2022-12-05T08:36:38,Zarautz,expenses,transport,-59.69,-15503.4
buyer_2,Carmen,40,ES39209541173898369721,TRX_N-00400-05628779,2022-12-05T14:09:41,Zarautz,expenses,children,-63.09,-15566.49
buyer_2,Carmen,40,ES39209541173898369721,TRX_N-00401-00105790,2022-12-07T16:56:46,Zarautz,expenses,water,-39.33,-15605.82
buyer_2,Carmen,40,ES39209541173898369721,TRX_N-00402-99614877,2022-12-07T15:14:32,Zarautz,expenses,electricity,-34.92,-15640.74
buyer_2,Carmen,40,ES39209541173898369721,TRX_N-00403-80688022,2022-12-07T20:57:11,Zarautz,expenses,food,-68.86,-15709.6
buyer_2,Carmen,40,ES39209541173898369721,TRX_N-00404-28705250,2022-12-08T18:46:00,Zarautz,expenses,phone,-43.45,-15753.05
buyer_2,Carmen,40,ES39209541173898369721,TRX_N-00405-06182301,2022-12-08T11:05:03,Zarautz,expenses,cash,-100.0,-15853.05
buyer_2,Carmen,40,ES39209541173898369721,TRX_N-00406-82340632,2022-12-08T13:33:33,Zarautz,expenses,appliances,-324.16,-16177.21
buyer_2,Carmen,40,ES39209541173898369721,TRX_N-00407-55701791,2022-12-09T13:43:25,Zarautz,expenses,clothing,-66.24,-16243.45
buyer_2,Carmen,40,ES39209541173898369721,TRX_N-00408-10693349,2022-12-09T20:15:39,Zarautz,expenses,cash,-100.0,-16343.45
buyer_2,Carmen,40,ES39209541173898369721,TRX_N-00409-63698993,2022-12-09T15:13:11,Zarautz,expenses,gifts,-468.88,-16812.33
buyer_2,Carmen,40,ES39209541173898369721,TRX_N-00410-25022579,2022-12-10T15:23:42,Zarautz,expenses,repairs,-133.41,-16945.74
buyer_2,Carmen,40,ES39209541173898369721,TRX_N-00411-32859723,2022-12-10T20:18:53,Zarautz,expenses,gifts,-541.52,-17487.26
buyer_2,Carmen,40,ES39209541173898369721,TRX_N-00412-25601677,2022-12-11T23:12:32,Zarautz,expenses,children,-175.55,-17662.81
buyer_2,Carmen,40,ES39209541173898369721,TRX_N-00413-44038856,2022-12-13T12:12:42,Elciego,expenses,transport,-43.34,-17706.15
buyer_2,Carmen,40,ES39209541173898369721,TRX_N-00414-36756737,2022-12-13T16:31:52,Zarautz,expenses,cash,-100.0,-17806.15
buyer_2,Carmen,40,ES39209541173898369721,TRX_N-00415-71301430,2022-12-14T14:22:19,Zarautz,expenses,cash,-100.0,-17906.15
buyer_2,Carmen,40,ES39209541173898369721,TRX_N-00416-89345409,2022-12-15T16:46:55,Zarautz,expenses,cash,-100.0,-18006.15
buyer_2,Carmen,40,ES39209541173898369721,TRX_N-00417-76796165,2022-12-15T09:49:58,Donostia,expenses,travel,-893.34,-18899.49
buyer_2,Carmen,40,ES39209541173898369721,TRX_N-00418-62726753,2022-12-16T11:55:12,Salvatierra/Agurain,expenses,food,-95.46,-18994.95
buyer_2,Carmen,40,ES39209541173898369721,TRX_N-00419-60736734,2022-12-16T10:51:03,Zarautz,expenses,transport,-83.31,-19078.26
buyer_2,Carmen,40,ES39209541173898369721,TRX_N-00420-28648799,2022-12-16T22:44:28,Zarautz,expenses,gifts,-417.59,-19495.85
buyer_2,Carmen,40,ES39209541173898369721,TRX_N-00421-49529386,2022-12-17T17:41:58,Zarautz,expenses,food,-90.64,-19586.49
buyer_2,Carmen,40,ES39209541173898369721,TRX_N-00422-69420700,2022-12-17T10:20:03,Zarautz,expenses,education,-64.44,-19650.93
buyer_2,Carmen,40,ES39209541173898369721,TRX_N-00423-19659486,2022-12-19T03:08:03,Zarautz,expenses,cash,-100.0,-19750.93
buyer_2,Carmen,40,ES39209541173898369721,TRX_N-00424-04337852,2022-12-20T19:32:09,Zarautz,expenses,food,-108.95,-19859.88
buyer_2,Carmen,40,ES39209541173898369721,TRX_N-00425-13834003,2022-12-23T22:41:50,Zarautz,expenses,food,-99.33,-19959.21
buyer_2,Carmen,40,ES39209541173898369721,TRX_N-00426-58025302,2022-12-24T08:51:45,Zarautz,expenses,leisure,-73.85,-20033.06
buyer_2,Carmen,40,ES39209541173898369721,TRX_N-00427-49710626,2022-12-24T08:12:22,Zarautz,expenses,education,-63.14,-20096.2
buyer_2,Carmen,40,ES39209541173898369721,TRX_N-00428-02143484,2022-12-24T10:09:22,Zarautz,expenses,cash,-100.0,-20196.2
buyer_2,Carmen,40,ES39209541173898369721,TRX_N-00429-17057665,2022-12-26T15:42:59,Zarautz,expenses,food,-69.78,-20265.98
buyer_2,Carmen,40,ES39209541173898369721,TRX_N-00430-69817412,2022-12-26T04:12:36,Zarautz,expenses,cash,-100.0,-20365.98
buyer_2,Carmen,40,ES39209541173898369721,TRX_N-00431-90600624,2022-12-28T16:48:23,Zarautz,expenses,cash,-100.0,-20465.98
buyer_2,Carmen,40,ES39209541173898369721,TRX_N-00432-21342032,2023-01-01T13:30:35,Zarautz,incomes,salary,1374.64,-19091.34
buyer_2,Carmen,40,ES39209541173898369721,TRX_N-00433-96496385,2023-01-01T13:30:35,Zarautz,incomes,salary_partner,1449.98,-17641.36
buyer_2,Carmen,40,ES39209541173898369721,TRX_N-00434-84725350,2023-01-01T17:05:29,Andoain,expenses,food,-83.22,-17724.58
buyer_2,Carmen,40,ES39209541173898369721,TRX_N-00435-72282837,2023-01-01T03:13:56,Zarautz,expenses,leisure,-62.93,-17787.51
buyer_2,Carmen,40,ES39209541173898369721,TRX_N-00436-59333705,2023-01-02T04:58:10,Zarautz,expenses,transport,-45.8,-17833.31
buyer_2,Carmen,40,ES39209541173898369721,TRX_N-00437-90819416,2023-01-04T12:57:14,Zarautz,expenses,mortgage,-882.99,-18716.3
buyer_2,Carmen,40,ES39209541173898369721,TRX_N-00438-99167896,2023-01-04T13:13:08,Zarautz,expenses,food,-97.64,-18813.94
buyer_2,Carmen,40,ES39209541173898369721,TRX_N-00439-52722013,2023-01-04T16:16:52,Zarautz,expenses,cash,-100.0,-18913.94
buyer_2,Carmen,40,ES39209541173898369721,TRX_N-00440-42807210,2023-01-05T07:59:51,Zarautz,expenses,internet,-42.0,-18955.94
buyer_2,Carmen,40,ES39209541173898369721,TRX_N-00441-44884561,2023-01-05T10:53:34,Zarautz,expenses,transport,-57.72,-19013.66
buyer_2,Carmen,40,ES39209541173898369721,TRX_N-00442-39756535,2023-01-05T12:17:21,Zarautz,expenses,leisure,-71.13,-19084.79
buyer_2,Carmen,40,ES39209541173898369721,TRX_N-00443-72535362,2023-01-05T08:40:52,Barakaldo,expenses,cash,-100.0,-19184.79
buyer_2,Carmen,40,ES39209541173898369721,TRX_N-00444-58095498,2023-01-06T19:00:47,Zarautz,expenses,food,-75.67,-19260.46
buyer_2,Carmen,40,ES39209541173898369721,TRX_N-00445-65514075,2023-01-06T22:03:33,Zarautz,expenses,repairs,-148.93,-19409.39
buyer_2,Carmen,40,ES39209541173898369721,TRX_N-00446-20609744,2023-01-07T18:11:02,Zarautz,expenses,gas,-83.58,-19492.97
buyer_2,Carmen,40,ES39209541173898369721,TRX_N-00447-42079221,2023-01-07T10:28:51,Zarautz,expenses,phone,-39.85,-19532.82
buyer_2,Carmen,40,ES39209541173898369721,TRX_N-00448-13970179,2023-01-07T19:10:33,Pasaia,expenses,clothing,-75.22,-19608.04
buyer_2,Carmen,40,ES39209541173898369721,TRX_N-00449-20018736,2023-01-08T16:36:07,Zarautz,expenses,water,-27.78,-19635.82
buyer_2,Carmen,40,ES39209541173898369721,TRX_N-00450-04374364,2023-01-08T13:13:58,Zarautz,expenses,electricity,-62.82,-19698.64
buyer_2,Carmen,40,ES39209541173898369721,TRX_N-00451-41178061,2023-01-08T12:06:23,Zarautz,expenses,travel,-1685.48,-21384.12
buyer_2,Carmen,40,ES39209541173898369721,TRX_N-00452-62711180,2023-01-10T13:50:43,Zarautz,expenses,leisure,-30.04,-21414.16
buyer_2,Carmen,40,ES39209541173898369721,TRX_N-00453-23556085,2023-01-11T15:38:09,Zarautz,expenses,cash,-100.0,-21514.16
buyer_2,Carmen,40,ES39209541173898369721,TRX_N-00454-96169656,2023-01-13T08:54:21,Zarautz,expenses,food,-92.5,-21606.66
buyer_2,Carmen,40,ES39209541173898369721,TRX_N-00455-11927344,2023-01-13T01:45:39,Zarautz,expenses,education,-46.26,-21652.92
buyer_2,Carmen,40,ES39209541173898369721,TRX_N-00456-59058872,2023-01-14T17:34:11,Zarautz,expenses,healthcare,-83.75,-21736.67
buyer_2,Carmen,40,ES39209541173898369721,TRX_N-00457-39709239,2023-01-15T14:01:56,Zarautz,expenses,food,-73.57,-21810.24
buyer_2,Carmen,40,ES39209541173898369721,TRX_N-00458-19680217,2023-01-17T17:57:48,Irun,expenses,food,-94.85,-21905.09
buyer_2,Carmen,40,ES39209541173898369721,TRX_N-00459-48796438,2023-01-17T19:30:34,Zarautz,expenses,gifts,-289.37,-22194.46
buyer_2,Carmen,40,ES39209541173898369721,TRX_N-00460-47901289,2023-01-17T14:21:34,Zarautz,expenses,children,-225.55,-22420.01
buyer_2,Carmen,40,ES39209541173898369721,TRX_N-00461-79311693,2023-01-19T20:54:11,Zarautz,expenses,children,-63.27,-22483.28
buyer_2,Carmen,40,ES39209541173898369721,TRX_N-00462-34777713,2023-01-20T18:26:24,Zarautz,expenses,transport,-68.82,-22552.1
buyer_2,Carmen,40,ES39209541173898369721,TRX_N-00463-71697323,2023-01-24T14:54:27,Zarautz,expenses,cash,-100.0,-22652.1
buyer_2,Carmen,40,ES39209541173898369721,TRX_N-00464-02931779,2023-01-24T10:33:12,Zarautz,expenses,children,-114.38,-22766.48
buyer_2,Carmen,40,ES39209541173898369721,TRX_N-00465-00963692,2023-01-25T15:10:30,Zarautz,expenses,cash,-100.0,-22866.48
buyer_2,Carmen,40,ES39209541173898369721,TRX_N-00466-46636196,2023-01-25T15:04:47,Erandio,expenses,appliances,-207.83,-23074.31
buyer_2,Carmen,40,ES39209541173898369721,TRX_N-00467-57270088,2023-01-26T22:31:42,Zarautz,expenses,cash,-100.0,-23174.31
buyer_2,Carmen,40,ES39209541173898369721,TRX_N-00468-96888675,2023-01-27T01:57:57,Zarautz,expenses,leisure,-76.13,-23250.44
buyer_2,Carmen,40,ES39209541173898369721,TRX_N-00469-25096420,2023-01-29T09:52:10,Errenteria,expenses,education,-72.29,-23322.73
buyer_2,Carmen,40,ES39209541173898369721,TRX_N-00470-37545552,2023-02-01T04:26:13,Zarautz,incomes,salary,1374.64,-21948.09
buyer_2,Carmen,40,ES39209541173898369721,TRX_N-00471-31945503,2023-02-01T04:26:13,Zarautz,incomes,salary_partner,1449.98,-20498.11
buyer_2,Carmen,40,ES39209541173898369721,TRX_N-00472-73116446,2023-02-01T04:26:13,Zarautz,incomes,extra_income,159.61,-20338.5
buyer_2,Carmen,40,ES39209541173898369721,TRX_N-00473-21907480,2023-02-01T13:52:57,Irun,expenses,transport,-83.24,-20421.74
buyer_2,Carmen,40,ES39209541173898369721,TRX_N-00474-53307603,2023-02-01T10:18:01,Zarautz,expenses,leisure,-71.87,-20493.61
buyer_2,Carmen,40,ES39209541173898369721,TRX_N-00475-57164692,2023-02-02T10:05:11,Zarautz,expenses,repairs,-306.95,-20800.56
buyer_2,Carmen,40,ES39209541173898369721,TRX_N-00476-98088625,2023-02-02T14:14:48,Zarautz,expenses,children,-146.42,-20946.98
buyer_2,Carmen,40,ES39209541173898369721,TRX_N-00477-61144886,2023-02-03T09:02:57,Zarautz,expenses,food,-69.27,-21016.25
buyer_2,Carmen,40,ES39209541173898369721,TRX_N-00478-41191936,2023-02-03T08:56:03,Oyón-Oion,expenses,leisure,-72.32,-21088.57
buyer_2,Carmen,40,ES39209541173898369721,TRX_N-00479-15317323,2023-02-03T15:11:26,Errenteria,expenses,appliances,-254.3,-21342.87
buyer_2,Carmen,40,ES39209541173898369721,TRX_N-00480-93501180,2023-02-04T12:54:05,Zarautz,expenses,mortgage,-882.99,-22225.86
buyer_2,Carmen,40,ES39209541173898369721,TRX_N-00481-74921864,2023-02-04T20:13:34,Zarautz,expenses,food,-94.64,-22320.5
buyer_2,Carmen,40,ES39209541173898369721,TRX_N-00482-39695091,2023-02-05T20:03:37,Zarautz,expenses,electricity,-22.08,-22342.58
buyer_2,Carmen,40,ES39209541173898369721,TRX_N-00483-57334133,2023-02-05T18:49:56,Zarautz,expenses,gas,-41.17,-22383.75
buyer_2,Carmen,40,ES39209541173898369721,TRX_N-00484-14595097,2023-02-05T12:27:18,Zarautz,expenses,internet,-42.0,-22425.75
buyer_2,Carmen,40,ES39209541173898369721,TRX_N-00485-39598224,2023-02-05T15:52:25,Vitoria-Gasteiz,expenses,food,-118.02,-22543.77
buyer_2,Carmen,40,ES39209541173898369721,TRX_N-00486-04788239,2023-02-05T14:58:57,Mungia,expenses,gifts,-596.21,-23139.98
buyer_2,Carmen,40,ES39209541173898369721,TRX_N-00487-31698776,2023-02-06T05:12:02,Zarautz,expenses,phone,-37.35,-23177.33
buyer_2,Carmen,40,ES39209541173898369721,TRX_N-00488-41229805,2023-02-07T23:03:45,Zarautz,expenses,food,-105.15,-23282.48
buyer_2,Carmen,40,ES39209541173898369721,TRX_N-00489-44373831,2023-02-07T16:06:04,Zarautz,expenses,leisure,-28.27,-23310.75
buyer_2,Carmen,40,ES39209541173898369721,TRX_N-00490-90337043,2023-02-07T09:41:03,Zarautz,expenses,clothing,-72.87,-23383.62
buyer_2,Carmen,40,ES39209541173898369721,TRX_N-00491-24221075,2023-02-08T21:15:53,Zarautz,expenses,water,-41.29,-23424.91
buyer_2,Carmen,40,ES39209541173898369721,TRX_N-00492-04180424,2023-02-09T08:01:08,Zarautz,expenses,food,-109.71,-23534.62
buyer_2,Carmen,40,ES39209541173898369721,TRX_N-00493-60746282,2023-02-11T12:24:50,Zarautz,expenses,cash,-100.0,-23634.62
buyer_2,Carmen,40,ES39209541173898369721,TRX_N-00494-85115490,2023-02-12T12:41:35,Zarautz,expenses,gifts,-731.49,-24366.11
buyer_2,Carmen,40,ES39209541173898369721,TRX_N-00495-64267986,2023-02-13T11:28:31,Zarautz,expenses,cash,-100.0,-24466.11
buyer_2,Carmen,40,ES39209541173898369721,TRX_N-00496-99635506,2023-02-14T04:06:40,Zarautz,expenses,food,-64.75,-24530.86
buyer_2,Carmen,40,ES39209541173898369721,TRX_N-00497-51443236,2023-02-14T14:16:01,Zarautz,expenses,transport,-82.02,-24612.88
buyer_2,Carmen,40,ES39209541173898369721,TRX_N-00498-03954581,2023-02-14T14:15:08,Zarautz,expenses,cash,-100.0,-24712.88
buyer_2,Carmen,40,ES39209541173898369721,TRX_N-00499-59644546,2023-02-15T19:59:16,Oyón-Oion,expenses,leisure,-24.66,-24737.54
buyer_2,Carmen,40,ES39209541173898369721,TRX_N-00500-57878151,2023-02-15T21:19:29,Zarautz,expenses,cash,-100.0,-24837.54
buyer_2,Carmen,40,ES39209541173898369721,TRX_N-00501-45578877,2023-02-16T08:28:53,Zarautz,expenses,education,-71.77,-24909.31
buyer_2,Carmen,40,ES39209541173898369721,TRX_N-00502-63350983,2023-02-19T12:16:57,Arrasate,expenses,gifts,-473.75,-25383.06
buyer_2,Carmen,40,ES39209541173898369721,TRX_N-00503-82440507,2023-02-20T13:27:11,Sestao,expenses,education,-46.64,-25429.7
buyer_2,Carmen,40,ES39209541173898369721,TRX_N-00504-32022637,2023-02-21T17:34:36,Zarautz,expenses,food,-123.8,-25553.5
buyer_2,Carmen,40,ES39209541173898369721,TRX_N-00505-11342156,2023-02-21T20:01:42,Zarautz,expenses,gifts,-658.97,-26212.47
buyer_2,Carmen,40,ES39209541173898369721,TRX_N-00506-56472429,2023-02-24T12:45:27,Leioa,expenses,transport,-75.15,-26287.62
buyer_2,Carmen,40,ES39209541173898369721,TRX_N-00507-02530028,2023-02-25T20:39:38,Zarautz,expenses,leisure,-82.13,-26369.75
buyer_2,Carmen,40,ES39209541173898369721,TRX_N-00508-25437526,2023-02-25T05:18:34,Zarautz,expenses,education,-54.24,-26423.99
buyer_2,Carmen,40,ES39209541173898369721,TRX_N-00509-10770077,2023-02-27T08:59:38,Zarautz,expenses,cash,-100.0,-26523.99
buyer_2,Carmen,40,ES39209541173898369721,TRX_N-00510-13561737,2023-02-27T17:43:37,Zarautz,expenses,repairs,-236.93,-26760.92
buyer_2,Carmen,40,ES39209541173898369721,TRX_N-00511-90575675,2023-03-01T17:24:27,Zarautz,incomes,salary,1374.64,-25386.28
buyer_2,Carmen,40,ES39209541173898369721,TRX_N-00512-20247176,2023-03-01T17:24:27,Zarautz,incomes,salary_partner,1449.98,-23936.3
buyer_2,Carmen,40,ES39209541173898369721,TRX_N-00513-09551424,2023-03-01T11:35:06,Zarautz,expenses,clothing,-135.67,-24071.97
buyer_2,Carmen,40,ES39209541173898369721,TRX_N-00514-64879266,2023-03-02T16:58:29,Zarautz,expenses,cash,-100.0,-24171.97
buyer_2,Carmen,40,ES39209541173898369721,TRX_N-00515-53387652,2023-03-04T11:03:28,Zarautz,expenses,mortgage,-882.99,-25054.96
buyer_2,Carmen,40,ES39209541173898369721,TRX_N-00516-86148562,2023-03-04T23:03:50,Zarautz,expenses,food,-117.15,-25172.11
buyer_2,Carmen,40,ES39209541173898369721,TRX_N-00517-23105503,2023-03-05T19:26:38,Zarautz,expenses,clothing,-93.81,-25265.92
buyer_2,Carmen,40,ES39209541173898369721,TRX_N-00518-90979898,2023-03-05T09:32:42,Zuia,expenses,cash,-100.0,-25365.92
buyer_2,Carmen,40,ES39209541173898369721,TRX_N-00519-95364018,2023-03-05T11:51:39,Zarautz,expenses,repairs,-235.23,-25601.15
buyer_2,Carmen,40,ES39209541173898369721,TRX_N-00520-22043384,2023-03-06T16:54:31,Zarautz,expenses,gas,-80.04,-25681.19
buyer_2,Carmen,40,ES39209541173898369721,TRX_N-00521-94599158,2023-03-06T12:39:43,Zarautz,expenses,internet,-42.0,-25723.19
buyer_2,Carmen,40,ES39209541173898369721,TRX_N-00522-92001632,2023-03-06T12:09:40,Zarautz,expenses,phone,-39.46,-25762.65
buyer_2,Carmen,40,ES39209541173898369721,TRX_N-00523-22332478,2023-03-07T18:31:40,Zarautz,expenses,water,-23.04,-25785.69
buyer_2,Carmen,40,ES39209541173898369721,TRX_N-00524-96312173,2023-03-07T19:15:47,Zarautz,expenses,repairs,-256.63,-26042.32
buyer_2,Carmen,40,ES39209541173898369721,TRX_N-00525-10338846,2023-03-08T05:05:05,Zarautz,expenses,electricity,-50.72,-26093.04
buyer_2,Carmen,40,ES39209541173898369721,TRX_N-00526-30408336,2023-03-09T19:26:11,Zarautz,expenses,food,-121.25,-26214.29
buyer_2,Carmen,40,ES39209541173898369721,TRX_N-00527-31122941,2023-03-09T19:01:59,Zarautz,expenses,gifts,-609.48,-26823.77
buyer_2,Carmen,40,ES39209541173898369721,TRX_N-00528-63305495,2023-03-10T16:03:41,Zarautz,expenses,transport,-83.77,-26907.54
buyer_2,Carmen,40,ES39209541173898369721,TRX_N-00529-43908266,2023-03-13T17:13:47,Zarautz,expenses,transport,-77.57,-26985.11
buyer_2,Carmen,40,ES39209541173898369721,TRX_N-00530-62493647,2023-03-13T15:15:40,Zarautz,expenses,leisure,-33.06,-27018.17
buyer_2,Carmen,40,ES39209541173898369721,TRX_N-00531-85844211,2023-03-14T15:29:44,Zarautz,expenses,cash,-100.0,-27118.17
buyer_2,Carmen,40,ES39209541173898369721,TRX_N-00532-08839043,2023-03-17T11:23:44,Bilbao,expenses,transport,-80.56,-27198.73
buyer_2,Carmen,40,ES39209541173898369721,TRX_N-00533-00296526,2023-03-18T14:34:00,Sestao,expenses,education,-43.06,-27241.79
buyer_2,Carmen,40,ES39209541173898369721,TRX_N-00534-61119692,2023-03-20T11:55:56,Erandio,expenses,education,-75.73,-27317.52
buyer_2,Carmen,40,ES39209541173898369721,TRX_N-00535-51156680,2023-03-20T17:34:14,Zarautz,expenses,cash,-100.0,-27417.52
buyer_2,Carmen,40,ES39209541173898369721,TRX_N-00536-70835776,2023-03-20T09:24:01,Zarautz,expenses,children,-133.77,-27551.29
buyer_2,Carmen,40,ES39209541173898369721,TRX_N-00537-90922015,2023-03-22T13:57:50,Zarautz,expenses,gifts,-293.22,-27844.51
buyer_2,Carmen,40,ES39209541173898369721,TRX_N-00538-38101141,2023-03-24T19:39:11,Zarautz,expenses,food,-69.77,-27914.28
buyer_2,Carmen,40,ES39209541173898369721,TRX_N-00539-75505326,2023-03-24T08:39:26,Zarautz,expenses,repairs,-105.71,-28019.99
buyer_2,Carmen,40,ES39209541173898369721,TRX_N-00540-24273803,2023-03-26T20:23:30,Zarautz,expenses,food,-123.94,-28143.93
buyer_2,Carmen,40,ES39209541173898369721,TRX_N-00541-15764798,2023-03-26T16:23:55,Zarautz,expenses,cash,-100.0,-28243.93
buyer_2,Carmen,40,ES39209541173898369721,TRX_N-00542-88784341,2023-03-27T15:18:26,Zarautz,expenses,appliances,-391.75,-28635.68
buyer_2,Carmen,40,ES39209541173898369721,TRX_N-00543-06862094,2023-03-30T18:25:42,Zarautz,expenses,food,-110.57,-28746.25
buyer_2,Carmen,40,ES39209541173898369721,TRX_N-00544-75097007,2023-03-31T16:04:09,Andoain,expenses,education,-59.96,-28806.21
buyer_2,Carmen,40,ES39209541173898369721,TRX_N-00545-58856542,2023-03-31T22:12:28,Zarautz,expenses,gifts,-187.66,-28993.87
buyer_2,Carmen,40,ES39209541173898369721,TRX_N-00546-24433534,2023-04-01T19:31:24,Zarautz,incomes,salary,1374.64,-27619.23
buyer_2,Carmen,40,ES39209541173898369721,TRX_N-00547-95845483,2023-04-01T19:31:24,Zarautz,incomes,salary_partner,1449.98,-26169.25
buyer_2,Carmen,40,ES39209541173898369721,TRX_N-00548-41154795,2023-04-01T09:31:03,Zarautz,expenses,transport,-89.2,-26258.45
buyer_2,Carmen,40,ES39209541173898369721,TRX_N-00549-85689028,2023-04-01T08:54:54,Andoain,expenses,education,-43.08,-26301.53
buyer_2,Carmen,40,ES39209541173898369721,TRX_N-00550-52088819,2023-04-03T20:55:53,Zarautz,expenses,leisure,-64.67,-26366.2
buyer_2,Carmen,40,ES39209541173898369721,TRX_N-00551-33504021,2023-04-04T20:41:33,Zarautz,expenses,mortgage,-882.99,-27249.19
buyer_2,Carmen,40,ES39209541173898369721,TRX_N-00552-38891996,2023-04-04T23:34:52,Zarautz,expenses,transport,-55.71,-27304.9
buyer_2,Carmen,40,ES39209541173898369721,TRX_N-00553-84534090,2023-04-06T20:03:56,Zarautz,expenses,electricity,-74.75,-27379.65
buyer_2,Carmen,40,ES39209541173898369721,TRX_N-00554-64661261,2023-04-06T12:12:56,Zarautz,expenses,gas,-76.42,-27456.07
buyer_2,Carmen,40,ES39209541173898369721,TRX_N-00555-46375690,2023-04-06T20:01:10,Zarautz,expenses,internet,-42.0,-27498.07
buyer_2,Carmen,40,ES39209541173898369721,TRX_N-00556-54568134,2023-04-06T18:08:14,Leioa,expenses,education,-48.49,-27546.56
buyer_2,Carmen,40,ES39209541173898369721,TRX_N-00557-28535418,2023-04-06T14:34:40,Pasaia,expenses,cash,-100.0,-27646.56
buyer_2,Carmen,40,ES39209541173898369721,TRX_N-00558-01196760,2023-04-06T11:33:35,Zarautz,expenses,repairs,-180.93,-27827.49
buyer_2,Carmen,40,ES39209541173898369721,TRX_N-00559-09937448,2023-04-07T13:19:36,Zarautz,expenses,phone,-43.32,-27870.81
buyer_2,Carmen,40,ES39209541173898369721,TRX_N-00560-18080035,2023-04-08T12:04:50,Zarautz,expenses,water,-33.82,-27904.63
buyer_2,Carmen,40,ES39209541173898369721,TRX_N-00561-55559156,2023-04-08T08:04:44,Zarautz,expenses,leisure,-55.02,-27959.65
buyer_2,Carmen,40,ES39209541173898369721,TRX_N-00562-37723520,2023-04-08T14:07:46,Zarautz,expenses,clothing,-72.22,-28031.87
buyer_2,Carmen,40,ES39209541173898369721,TRX_N-00563-24574345,2023-04-09T00:15:13,Zarautz,expenses,gifts,-429.67,-28461.54
buyer_2,Carmen,40,ES39209541173898369721,TRX_N-00564-42740702,2023-04-12T19:49:15,Irun,expenses,cash,-100.0,-28561.54
buyer_2,Carmen,40,ES39209541173898369721,TRX_N-00565-56625131,2023-04-12T13:10:12,Portugalete,expenses,travel,-1795.41,-30356.95
buyer_2,Carmen,40,ES39209541173898369721,TRX_N-00566-14906996,2023-04-13T18:12:21,Zarautz,expenses,food,-108.44,-30465.39
buyer_2,Carmen,40,ES39209541173898369721,TRX_N-00567-69921995,2023-04-14T20:04:44,Zarautz,expenses,transport,-43.91,-30509.3
buyer_2,Carmen,40,ES39209541173898369721,TRX_N-00568-60432979,2023-04-14T08:48:13,Zarautz,expenses,cash,-100.0,-30609.3
buyer_2,Carmen,40,ES39209541173898369721,TRX_N-00569-10231318,2023-04-16T17:11:29,Zarautz,expenses,food,-95.78,-30705.08
buyer_2,Carmen,40,ES39209541173898369721,TRX_N-00570-60046232,2023-04-16T16:49:26,Zarautz,expenses,cash,-100.0,-30805.08
buyer_2,Carmen,40,ES39209541173898369721,TRX_N-00571-57467150,2023-04-20T00:36:36,Zarautz,expenses,food,-65.16,-30870.24
buyer_2,Carmen,40,ES39209541173898369721,TRX_N-00572-68131455,2023-04-20T09:59:44,Zarautz,expenses,cash,-100.0,-30970.24
buyer_2,Carmen,40,ES39209541173898369721,TRX_N-00573-87732279,2023-04-20T14:05:34,Lasarte-Oria,expenses,appliances,-168.23,-31138.47
buyer_2,Carmen,40,ES39209541173898369721,TRX_N-00574-02831743,2023-04-20T10:22:43,Zarautz,expenses,repairs,-311.91,-31450.38
buyer_2,Carmen,40,ES39209541173898369721,TRX_N-00575-37852549,2023-04-20T18:21:11,Zarautz,expenses,children,-161.24,-31611.62
buyer_2,Carmen,40,ES39209541173898369721,TRX_N-00576-75102399,2023-04-21T16:10:36,Vitoria-Gasteiz,expenses,appliances,-185.57,-31797.19
buyer_2,Carmen,40,ES39209541173898369721,TRX_N-00577-33464947,2023-04-21T20:32:09,Zarautz,expenses,repairs,-274.33,-32071.52
buyer_2,Carmen,40,ES39209541173898369721,TRX_N-00578-43766066,2023-04-21T18:02:49,Mungia,expenses,gifts,-237.74,-32309.26
buyer_2,Carmen,40,ES39209541173898369721,TRX_N-00579-84445580,2023-04-24T10:12:25,Zarautz,expenses,travel,-292.8,-32602.06
buyer_2,Carmen,40,ES39209541173898369721,TRX_N-00580-00542864,2023-04-25T10:41:25,Zarautz,expenses,food,-123.0,-32725.06
buyer_2,Carmen,40,ES39209541173898369721,TRX_N-00581-61022791,2023-04-25T12:10:03,Zarautz,expenses,transport,-47.81,-32772.87
buyer_2,Carmen,40,ES39209541173898369721,TRX_N-00582-50192188,2023-04-25T11:17:16,Zarautz,expenses,clothing,-53.05,-32825.92
buyer_2,Carmen,40,ES39209541173898369721,TRX_N-00583-10691823,2023-04-25T12:24:08,Zarautz,expenses,healthcare,-157.01,-32982.93
buyer_2,Carmen,40,ES39209541173898369721,TRX_N-00584-31260855,2023-04-30T14:35:45,Zarautz,expenses,leisure,-50.88,-33033.81
buyer_2,Carmen,40,ES39209541173898369721,TRX_N-00585-22245004,2023-04-30T10:00:36,Zarautz,expenses,cash,-100.0,-33133.81
buyer_2,Carmen,40,ES39209541173898369721,TRX_N-00586-94729493,2023-05-01T12:03:05,Zarautz,incomes,salary,1374.64,-31759.17
buyer_2,Carmen,40,ES39209541173898369721,TRX_N-00587-02056210,2023-05-01T12:03:05,Zarautz,incomes,salary_partner,1449.98,-30309.19
buyer_2,Carmen,40,ES39209541173898369721,TRX_N-00588-16148941,2023-05-01T07:43:27,Zarautz,expenses,clothing,-126.75,-30435.94
buyer_2,Carmen,40,ES39209541173898369721,TRX_N-00589-96297876,2023-05-01T08:50:50,Zarautz,expenses,education,-61.82,-30497.76
buyer_2,Carmen,40,ES39209541173898369721,TRX_N-00590-98071316,2023-05-03T16:56:49,Zarautz,expenses,cash,-100.0,-30597.76
buyer_2,Carmen,40,ES39209541173898369721,TRX_N-00591-66608889,2023-05-03T16:54:06,Zarautz,expenses,gifts,-576.2,-31173.96
buyer_2,Carmen,40,ES39209541173898369721,TRX_N-00592-72095085,2023-05-04T17:15:16,Zarautz,expenses,mortgage,-882.99,-32056.95
buyer_2,Carmen,40,ES39209541173898369721,TRX_N-00593-97598836,2023-05-04T20:32:42,Zarautz,expenses,transport,-79.36,-32136.31
buyer_2,Carmen,40,ES39209541173898369721,TRX_N-00594-95200494,2023-05-05T14:04:02,Zarautz,expenses,water,-37.62,-32173.93
buyer_2,Carmen,40,ES39209541173898369721,TRX_N-00595-45479520,2023-05-05T17:23:34,Zarautz,expenses,food,-64.52,-32238.45
buyer_2,Carmen,40,ES39209541173898369721,TRX_N-00596-37577196,2023-05-05T09:03:05,Zarautz,expenses,cash,-100.0,-32338.45
buyer_2,Carmen,40,ES39209541173898369721,TRX_N-00597-67228914,2023-05-06T14:06:24,Zarautz,expenses,internet,-42.0,-32380.45
buyer_2,Carmen,40,ES39209541173898369721,TRX_N-00598-39576109,2023-05-06T09:42:01,Zarautz,expenses,gifts,-778.1,-33158.55
buyer_2,Carmen,40,ES39209541173898369721,TRX_N-00599-97101524,2023-05-07T14:48:06,Zarautz,expenses,cash,-100.0,-33258.55
buyer_2,Carmen,40,ES39209541173898369721,TRX_N-00600-33991298,2023-05-08T22:28:46,Zarautz,expenses,electricity,-80.68,-33339.23
buyer_2,Carmen,40,ES39209541173898369721,TRX_N-00601-94565841,2023-05-08T19:07:47,Zarautz,expenses,gas,-60.48,-33399.71
buyer_2,Carmen,40,ES39209541173898369721,TRX_N-00602-78605791,2023-05-08T08:27:27,Zarautz,expenses,phone,-42.51,-33442.22
buyer_2,Carmen,40,ES39209541173898369721,TRX_N-00603-55347565,2023-05-10T14:01:22,Zarautz,expenses,transport,-84.49,-33526.71
buyer_2,Carmen,40,ES39209541173898369721,TRX_N-00604-36798221,2023-05-16T08:39:50,Zarautz,expenses,transport,-74.7,-33601.41
buyer_2,Carmen,40,ES39209541173898369721,TRX_N-00605-54933651,2023-05-17T18:26:35,Iruña de Oca,expenses,leisure,-58.09,-33659.5
buyer_2,Carmen,40,ES39209541173898369721,TRX_N-00606-84927890,2023-05-19T13:11:10,Zarautz,expenses,transport,-72.82,-33732.32
buyer_2,Carmen,40,ES39209541173898369721,TRX_N-00607-91472194,2023-05-21T00:04:57,Zarautz,expenses,food,-104.42,-33836.74
buyer_2,Carmen,40,ES39209541173898369721,TRX_N-00608-97528525,2023-05-22T13:07:55,Zarautz,expenses,leisure,-41.45,-33878.19
buyer_2,Carmen,40,ES39209541173898369721,TRX_N-00609-63587712,2023-05-22T17:58:13,Zarautz,expenses,education,-53.0,-33931.19
buyer_2,Carmen,40,ES39209541173898369721,TRX_N-00610-76063364,2023-05-22T14:08:06,Zarautz,expenses,cash,-100.0,-34031.19
buyer_2,Carmen,40,ES39209541173898369721,TRX_N-00611-01575133,2023-05-23T11:17:31,Zarautz,expenses,children,-233.91,-34265.1
buyer_2,Carmen,40,ES39209541173898369721,TRX_N-00612-71935088,2023-05-26T13:00:04,Zarautz,expenses,repairs,-319.3,-34584.4
buyer_2,Carmen,40,ES39209541173898369721,TRX_N-00613-62657505,2023-05-27T11:24:25,Zarautz,expenses,leisure,-23.59,-34607.99
buyer_2,Carmen,40,ES39209541173898369721,TRX_N-00614-27774073,2023-05-28T22:00:40,Alegría-Dulantzi,expenses,appliances,-320.57,-34928.56
buyer_2,Carmen,40,ES39209541173898369721,TRX_N-00615-23073673,2023-05-29T22:48:51,Zarautz,expenses,cash,-100.0,-35028.56
buyer_2,Carmen,40,ES39209541173898369721,TRX_N-00616-54050165,2023-05-30T15:19:53,Erandio,expenses,appliances,-154.82,-35183.38
buyer_2,Carmen,40,ES39209541173898369721,TRX_N-00617-88642948,2023-06-01T12:54:21,Zarautz,incomes,salary,1374.64,-33808.74
buyer_2,Carmen,40,ES39209541173898369721,TRX_N-00618-28914546,2023-06-01T12:54:21,Zarautz,incomes,salary_partner,1449.98,-32358.76
buyer_2,Carmen,40,ES39209541173898369721,TRX_N-00619-28692449,2023-06-01T12:54:21,Zarautz,incomes,extra_income,159.61,-32199.15
buyer_2,Carmen,40,ES39209541173898369721,TRX_N-00620-46134568,2023-06-01T12:54:21,Zarautz,incomes,salary_bonus,1051.95,-31147.2
buyer_2,Carmen,40,ES39209541173898369721,TRX_N-00621-03482076,2023-06-01T12:54:21,Zarautz,incomes,salary_partner_bonus,1039.14,-30108.06
buyer_2,Carmen,40,ES39209541173898369721,TRX_N-00622-25389640,2023-06-01T10:29:50,Zarautz,expenses,healthcare,-42.51,-30150.57
buyer_2,Carmen,40,ES39209541173898369721,TRX_N-00623-73591820,2023-06-04T23:21:01,Zarautz,expenses,mortgage,-882.99,-31033.56
buyer_2,Carmen,40,ES39209541173898369721,TRX_N-00624-99491611,2023-06-04T12:52:16,Zarautz,expenses,cash,-100.0,-31133.56
buyer_2,Carmen,40,ES39209541173898369721,TRX_N-00625-42092013,2023-06-05T14:29:21,Zarautz,expenses,electricity,-64.52,-31198.08
buyer_2,Carmen,40,ES39209541173898369721,TRX_N-00626-46677333,2023-06-05T18:34:36,Zarautz,expenses,phone,-39.01,-31237.09
buyer_2,Carmen,40,ES39209541173898369721,TRX_N-00627-85308839,2023-06-06T08:40:34,Zarautz,expenses,food,-63.08,-31300.17
buyer_2,Carmen,40,ES39209541173898369721,TRX_N-00628-65230777,2023-06-06T13:25:27,Zarautz,expenses,cash,-100.0,-31400.17
buyer_2,Carmen,40,ES39209541173898369721,TRX_N-00629-56050374,2023-06-07T16:48:53,Zarautz,expenses,food,-95.26,-31495.43
buyer_2,Carmen,40,ES39209541173898369721,TRX_N-00630-70856836,2023-06-08T12:21:29,Zarautz,expenses,water,-23.44,-31518.87
buyer_2,Carmen,40,ES39209541173898369721,TRX_N-00631-75206208,2023-06-08T08:49:05,Zarautz,expenses,gas,-71.13,-31590.0
buyer_2,Carmen,40,ES39209541173898369721,TRX_N-00632-70881946,2023-06-08T10:04:24,Zarautz,expenses,internet,-42.0,-31632.0
buyer_2,Carmen,40,ES39209541173898369721,TRX_N-00633-07133850,2023-06-09T05:42:26,Elciego,expenses,leisure,-28.69,-31660.69
buyer_2,Carmen,40,ES39209541173898369721,TRX_N-00634-49828844,2023-06-10T20:32:54,Zarautz,expenses,cash,-100.0,-31760.69
buyer_2,Carmen,40,ES39209541173898369721,TRX_N-00635-81535330,2023-06-15T04:16:08,Zarautz,expenses,healthcare,-73.39,-31834.08
buyer_2,Carmen,40,ES39209541173898369721,TRX_N-00636-43678829,2023-06-15T15:16:57,Zarautz,expenses,cash,-100.0,-31934.08
buyer_2,Carmen,40,ES39209541173898369721,TRX_N-00637-10967388,2023-06-15T19:59:28,Zarautz,expenses,travel,-707.75,-32641.83
buyer_2,Carmen,40,ES39209541173898369721,TRX_N-00638-22952394,2023-06-16T08:47:20,Amurrio,expenses,travel,-590.71,-33232.54
buyer_2,Carmen,40,ES39209541173898369721,TRX_N-00639-69154574,2023-06-17T10:03:36,Zarautz,expenses,cash,-100.0,-33332.54
buyer_2,Carmen,40,ES39209541173898369721,TRX_N-00640-06757941,2023-06-19T09:14:45,Zarautz,expenses,food,-114.09,-33446.63
buyer_2,Carmen,40,ES39209541173898369721,TRX_N-00641-66187456,2023-06-19T18:27:00,Zarautz,expenses,cash,-100.0,-33546.63
buyer_2,Carmen,40,ES39209541173898369721,TRX_N-00642-69416754,2023-06-20T16:01:07,Zarautz,expenses,travel,-878.61,-34425.24
buyer_2,Carmen,40,ES39209541173898369721,TRX_N-00643-43318370,2023-06-22T18:16:58,Zarautz,expenses,cash,-100.0,-34525.24
buyer_2,Carmen,40,ES39209541173898369721,TRX_N-00644-13898453,2023-06-23T03:12:27,Sestao,expenses,leisure,-61.89,-34587.13
buyer_2,Carmen,40,ES39209541173898369721,TRX_N-00645-55339344,2023-06-26T11:12:06,Zarautz,expenses,food,-112.31,-34699.44
buyer_2,Carmen,40,ES39209541173898369721,TRX_N-00646-66008746,2023-06-26T08:17:20,Zarautz,expenses,clothing,-156.43,-34855.87
buyer_2,Carmen,40,ES39209541173898369721,TRX_N-00647-32894996,2023-06-26T23:51:17,Zarautz,expenses,repairs,-93.21,-34949.08
buyer_2,Carmen,40,ES39209541173898369721,TRX_N-00648-26148975,2023-06-27T09:54:22,Zarautz,expenses,transport,-87.56,-35036.64
buyer_2,Carmen,40,ES39209541173898369721,TRX_N-00649-92862180,2023-06-27T23:20:18,Zarautz,expenses,repairs,-41.95,-35078.59
buyer_2,Carmen,40,ES39209541173898369721,TRX_N-00650-85159296,2023-06-28T20:59:17,Zarautz,expenses,food,-119.95,-35198.54
buyer_2,Carmen,40,ES39209541173898369721,TRX_N-00651-98928820,2023-06-28T17:06:11,Zarautz,expenses,cash,-100.0,-35298.54
buyer_2,Carmen,40,ES39209541173898369721,TRX_N-00652-94307999,2023-06-28T19:52:31,Zarautz,expenses,travel,-1756.06,-37054.6
buyer_2,Carmen,40,ES39209541173898369721,TRX_N-00653-53811422,2023-06-29T20:37:56,Zarautz,expenses,transport,-56.67,-37111.27
buyer_2,Carmen,40,ES39209541173898369721,TRX_N-00654-17591814,2023-06-30T18:20:02,Zarautz,expenses,appliances,-304.68,-37415.95
buyer_2,Carmen,40,ES39209541173898369721,TRX_N-00655-17346071,2023-07-01T16:38:17,Zarautz,incomes,salary,1374.64,-36041.31
buyer_2,Carmen,40,ES39209541173898369721,TRX_N-00656-06032825,2023-07-01T16:38:17,Zarautz,incomes,salary_partner,1449.98,-34591.33
buyer_2,Carmen,40,ES39209541173898369721,TRX_N-00657-58476825,2023-07-01T08:15:45,Zarautz,expenses,food,-111.71,-34703.04
buyer_2,Carmen,40,ES39209541173898369721,TRX_N-00658-09744159,2023-07-03T00:30:45,Zarautz,expenses,cash,-100.0,-34803.04
buyer_2,Carmen,40,ES39209541173898369721,TRX_N-00659-38399827,2023-07-04T18:37:38,Zarautz,expenses,mortgage,-882.99,-35686.03
buyer_2,Carmen,40,ES39209541173898369721,TRX_N-00660-60425825,2023-07-05T15:22:44,Zarautz,expenses,electricity,-81.02,-35767.05
buyer_2,Carmen,40,ES39209541173898369721,TRX_N-00661-57981153,2023-07-05T15:52:17,Zarautz,expenses,gas,-97.26,-35864.31
buyer_2,Carmen,40,ES39209541173898369721,TRX_N-00662-27876940,2023-07-05T20:51:28,Zarautz,expenses,leisure,-42.19,-35906.5
buyer_2,Carmen,40,ES39209541173898369721,TRX_N-00663-27481362,2023-07-06T15:48:10,Zarautz,expenses,water,-29.3,-35935.8
buyer_2,Carmen,40,ES39209541173898369721,TRX_N-00664-63200136,2023-07-06T10:10:09,Zarautz,expenses,phone,-38.96,-35974.76
buyer_2,Carmen,40,ES39209541173898369721,TRX_N-00665-02058792,2023-07-06T16:32:31,Zarautz,expenses,food,-94.42,-36069.18
buyer_2,Carmen,40,ES39209541173898369721,TRX_N-00666-32765327,2023-07-07T20:43:32,Zarautz,expenses,leisure,-45.23,-36114.41
buyer_2,Carmen,40,ES39209541173898369721,TRX_N-00667-77239270,2023-07-08T10:10:36,Zarautz,expenses,internet,-42.0,-36156.41
buyer_2,Carmen,40,ES39209541173898369721,TRX_N-00668-10005527,2023-07-08T18:47:02,Zarautz,expenses,healthcare,-66.27,-36222.68
buyer_2,Carmen,40,ES39209541173898369721,TRX_N-00669-83335112,2023-07-09T12:34:18,Zarautz,expenses,food,-75.22,-36297.9
buyer_2,Carmen,40,ES39209541173898369721,TRX_N-00670-47866356,2023-07-09T16:09:25,Zarautz,expenses,leisure,-84.89,-36382.79
buyer_2,Carmen,40,ES39209541173898369721,TRX_N-00671-33593064,2023-07-09T15:04:21,Zarautz,expenses,children,-134.98,-36517.77
buyer_2,Carmen,40,ES39209541173898369721,TRX_N-00672-50648932,2023-07-11T09:57:07,Hernani,expenses,food,-107.69,-36625.46
buyer_2,Carmen,40,ES39209541173898369721,TRX_N-00673-92089146,2023-07-13T13:06:53,Zarautz,expenses,transport,-58.18,-36683.64
buyer_2,Carmen,40,ES39209541173898369721,TRX_N-00674-07753531,2023-07-13T09:43:38,Basauri,expenses,cash,-100.0,-36783.64
buyer_2,Carmen,40,ES39209541173898369721,TRX_N-00675-08692548,2023-07-13T19:43:17,Zarautz,expenses,repairs,-72.72,-36856.36
buyer_2,Carmen,40,ES39209541173898369721,TRX_N-00676-15964709,2023-07-14T13:17:14,Bilbao,expenses,leisure,-74.72,-36931.08
buyer_2,Carmen,40,ES39209541173898369721,TRX_N-00677-84776855,2023-07-14T17:11:27,Zarautz,expenses,cash,-100.0,-37031.08
buyer_2,Carmen,40,ES39209541173898369721,TRX_N-00678-50672417,2023-07-18T14:09:50,Leioa,expenses,transport,-70.18,-37101.26
buyer_2,Carmen,40,ES39209541173898369721,TRX_N-00679-81819953,2023-07-18T19:11:10,Zarautz,expenses,leisure,-75.66,-37176.92
buyer_2,Carmen,40,ES39209541173898369721,TRX_N-00680-36999319,2023-07-19T08:37:48,Alegría-Dulantzi,expenses,cash,-100.0,-37276.92
buyer_2,Carmen,40,ES39209541173898369721,TRX_N-00681-92968634,2023-07-20T06:43:02,Zarautz,expenses,leisure,-35.77,-37312.69
buyer_2,Carmen,40,ES39209541173898369721,TRX_N-00682-02120174,2023-07-20T08:22:22,Zarautz,expenses,repairs,-314.02,-37626.71
buyer_2,Carmen,40,ES39209541173898369721,TRX_N-00683-43935080,2023-07-20T11:52:54,Getxo,expenses,gifts,-125.02,-37751.73
buyer_2,Carmen,40,ES39209541173898369721,TRX_N-00684-54262364,2023-07-20T10:05:30,Zarautz,expenses,children,-205.57,-37957.3
buyer_2,Carmen,40,ES39209541173898369721,TRX_N-00685-80994286,2023-07-25T12:45:24,Zarautz,expenses,appliances,-242.97,-38200.27
buyer_2,Carmen,40,ES39209541173898369721,TRX_N-00686-60159138,2023-07-27T14:15:35,Zarautz,expenses,travel,-1617.57,-39817.84
buyer_2,Carmen,40,ES39209541173898369721,TRX_N-00687-47424522,2023-07-28T22:31:43,Zarautz,expenses,leisure,-37.14,-39854.98
buyer_2,Carmen,40,ES39209541173898369721,TRX_N-00688-93761389,2023-07-28T12:00:17,Zarautz,expenses,education,-60.49,-39915.47
buyer_2,Carmen,40,ES39209541173898369721,TRX_N-00689-36471915,2023-07-29T14:50:05,Zarautz,expenses,gifts,-209.01,-40124.48
buyer_2,Carmen,40,ES39209541173898369721,TRX_N-00690-23729362,2023-07-30T09:00:38,Alegría-Dulantzi,expenses,gifts,-292.41,-40416.89
buyer_2,Carmen,40,ES39209541173898369721,TRX_N-00691-19950375,2023-07-31T15:29:54,Zarautz,expenses,food,-107.37,-40524.26
buyer_2,Carmen,40,ES39209541173898369721,TRX_N-00692-82562692,2023-07-31T17:20:20,Zarautz,expenses,education,-75.97,-40600.23
buyer_2,Carmen,40,ES39209541173898369721,TRX_N-00693-34292335,2023-08-01T10:24:20,Zarautz,incomes,salary,1374.64,-39225.59
buyer_2,Carmen,40,ES39209541173898369721,TRX_N-00694-58343987,2023-08-01T10:24:20,Zarautz,incomes,salary_partner,1449.98,-37775.61
buyer_2,Carmen,40,ES39209541173898369721,TRX_N-00695-62034234,2023-08-02T12:43:34,Sestao,expenses,transport,-73.44,-37849.05
buyer_2,Carmen,40,ES39209541173898369721,TRX_N-00696-18985749,2023-08-02T11:28:54,Zarautz,expenses,leisure,-71.07,-37920.12
buyer_2,Carmen,40,ES39209541173898369721,TRX_N-00697-84576080,2023-08-02T17:43:30,Zarautz,expenses,cash,-100.0,-38020.12
buyer_2,Carmen,40,ES39209541173898369721,TRX_N-00698-79444364,2023-08-02T10:38:55,Zarautz,expenses,gifts,-631.41,-38651.53
buyer_2,Carmen,40,ES39209541173898369721,TRX_N-00699-39573148,2023-08-04T12:12:30,Zarautz,expenses,mortgage,-882.99,-39534.52
buyer_2,Carmen,40,ES39209541173898369721,TRX_N-00700-67533582,2023-08-04T14:48:09,Zarautz,expenses,cash,-100.0,-39634.52
buyer_2,Carmen,40,ES39209541173898369721,TRX_N-00701-44313476,2023-08-05T15:58:45,Zarautz,expenses,gas,-59.78,-39694.3
buyer_2,Carmen,40,ES39209541173898369721,TRX_N-00702-22078883,2023-08-06T16:48:36,Zarautz,expenses,phone,-38.63,-39732.93
buyer_2,Carmen,40,ES39209541173898369721,TRX_N-00703-04987133,2023-08-07T18:23:46,Zarautz,expenses,children,-97.23,-39830.16
buyer_2,Carmen,40,ES39209541173898369721,TRX_N-00704-46605890,2023-08-08T10:38:59,Zarautz,expenses,internet,-42.0,-39872.16
buyer_2,Carmen,40,ES39209541173898369721,TRX_N-00705-91219360,2023-08-08T04:32:59,Zarautz,expenses,water,-28.5,-39900.66
buyer_2,Carmen,40,ES39209541173898369721,TRX_N-00706-39075135,2023-08-08T11:14:37,Zarautz,expenses,electricity,-70.95,-39971.61
buyer_2,Carmen,40,ES39209541173898369721,TRX_N-00707-36889802,2023-08-08T13:46:19,Alegría-Dulantzi,expenses,food,-113.74,-40085.35
buyer_2,Carmen,40,ES39209541173898369721,TRX_N-00708-93928703,2023-08-09T12:50:09,Zarautz,expenses,food,-117.94,-40203.29
buyer_2,Carmen,40,ES39209541173898369721,TRX_N-00709-59299420,2023-08-11T10:57:31,Zarautz,expenses,transport,-52.2,-40255.49
buyer_2,Carmen,40,ES39209541173898369721,TRX_N-00710-63110801,2023-08-13T11:23:13,Zarautz,expenses,appliances,-294.41,-40549.9
buyer_2,Carmen,40,ES39209541173898369721,TRX_N-00711-38724710,2023-08-14T14:20:33,Hondarribia,expenses,leisure,-59.04,-40608.94
buyer_2,Carmen,40,ES39209541173898369721,TRX_N-00712-55485682,2023-08-14T16:36:54,Zarautz,expenses,cash,-100.0,-40708.94
buyer_2,Carmen,40,ES39209541173898369721,TRX_N-00713-38227516,2023-08-14T08:17:25,Hondarribia,expenses,repairs,-36.83,-40745.77
buyer_2,Carmen,40,ES39209541173898369721,TRX_N-00714-98054346,2023-08-15T16:28:44,Zarautz,expenses,leisure,-64.46,-40810.23
buyer_2,Carmen,40,ES39209541173898369721,TRX_N-00715-42190919,2023-08-16T10:40:54,Zarautz,expenses,food,-93.88,-40904.11
buyer_2,Carmen,40,ES39209541173898369721,TRX_N-00716-76072223,2023-08-16T10:29:07,Zarautz,expenses,clothing,-79.02,-40983.13
buyer_2,Carmen,40,ES39209541173898369721,TRX_N-00717-33579404,2023-08-16T08:36:31,Zarautz,expenses,repairs,-316.57,-41299.7
buyer_2,Carmen,40,ES39209541173898369721,TRX_N-00718-58502520,2023-08-18T17:21:19,Zarautz,expenses,repairs,-98.48,-41398.18
buyer_2,Carmen,40,ES39209541173898369721,TRX_N-00719-98099947,2023-08-19T18:08:20,Zarautz,expenses,food,-62.86,-41461.04
buyer_2,Carmen,40,ES39209541173898369721,TRX_N-00720-80747700,2023-08-21T21:50:30,Zarautz,expenses,food,-66.16,-41527.2
buyer_2,Carmen,40,ES39209541173898369721,TRX_N-00721-83635373,2023-08-21T09:59:52,Zarautz,expenses,repairs,-216.3,-41743.5
buyer_2,Carmen,40,ES39209541173898369721,TRX_N-00722-16428721,2023-08-25T15:54:06,Zarautz,expenses,cash,-100.0,-41843.5
buyer_2,Carmen,40,ES39209541173898369721,TRX_N-00723-57140186,2023-08-26T22:31:49,Zarautz,expenses,clothing,-156.22,-41999.72
buyer_2,Carmen,40,ES39209541173898369721,TRX_N-00724-71883840,2023-08-27T20:20:21,Zarautz,expenses,transport,-43.29,-42043.01
buyer_2,Carmen,40,ES39209541173898369721,TRX_N-00725-31993551,2023-08-28T20:59:06,Zarautz,expenses,food,-109.26,-42152.27
buyer_2,Carmen,40,ES39209541173898369721,TRX_N-00726-52600313,2023-08-29T19:17:36,Zarautz,expenses,leisure,-29.21,-42181.48
buyer_2,Carmen,40,ES39209541173898369721,TRX_N-00727-37363414,2023-08-29T00:46:52,Zarautz,expenses,cash,-100.0,-42281.48
buyer_2,Carmen,40,ES39209541173898369721,TRX_N-00728-03781562,2023-08-30T19:08:01,Zarautz,expenses,food,-80.37,-42361.85
buyer_2,Carmen,40,ES39209541173898369721,TRX_N-00729-13418153,2023-09-01T15:49:28,Zarautz,incomes,salary,1374.64,-40987.21
buyer_2,Carmen,40,ES39209541173898369721,TRX_N-00730-10052386,2023-09-01T15:49:28,Zarautz,incomes,salary_partner,1449.98,-39537.23
buyer_2,Carmen,40,ES39209541173898369721,TRX_N-00731-67550195,2023-09-01T15:05:35,Zarautz,expenses,children,-60.56,-39597.79
buyer_2,Carmen,40,ES39209541173898369721,TRX_N-00732-19166976,2023-09-02T13:58:06,Zarautz,expenses,education,-61.82,-39659.61
buyer_2,Carmen,40,ES39209541173898369721,TRX_N-00733-42603983,2023-09-02T12:38:11,Galdakao,expenses,cash,-100.0,-39759.61
buyer_2,Carmen,40,ES39209541173898369721,TRX_N-00734-83441862,2023-09-02T08:12:59,Zarautz,expenses,repairs,-107.75,-39867.36
buyer_2,Carmen,40,ES39209541173898369721,TRX_N-00735-58218447,2023-09-04T18:32:46,Zarautz,expenses,mortgage,-882.99,-40750.35
buyer_2,Carmen,40,ES39209541173898369721,TRX_N-00736-54121697,2023-09-04T13:29:15,Zarautz,expenses,food,-96.82,-40847.17
buyer_2,Carmen,40,ES39209541173898369721,TRX_N-00737-49707744,2023-09-04T18:43:55,Zarautz,expenses,education,-50.2,-40897.37
buyer_2,Carmen,40,ES39209541173898369721,TRX_N-00738-44894073,2023-09-06T05:21:14,Zarautz,expenses,electricity,-21.03,-40918.4
buyer_2,Carmen,40,ES39209541173898369721,TRX_N-00739-73822310,2023-09-06T21:43:39,Zarautz,expenses,gas,-98.88,-41017.28
buyer_2,Carmen,40,ES39209541173898369721,TRX_N-00740-76590718,2023-09-06T08:49:10,Zarautz,expenses,internet,-42.0,-41059.28
buyer_2,Carmen,40,ES39209541173898369721,TRX_N-00741-39889493,2023-09-06T22:14:00,Zarautz,expenses,leisure,-34.46,-41093.74
buyer_2,Carmen,40,ES39209541173898369721,TRX_N-00742-26387508,2023-09-07T13:24:52,Zarautz,expenses,water,-31.43,-41125.17
buyer_2,Carmen,40,ES39209541173898369721,TRX_N-00743-43267459,2023-09-07T11:12:02,Zarautz,expenses,gifts,-252.63,-41377.8
buyer_2,Carmen,40,ES39209541173898369721,TRX_N-00744-38167844,2023-09-08T09:36:54,Zarautz,expenses,phone,-42.71,-41420.51
buyer_2,Carmen,40,ES39209541173898369721,TRX_N-00745-62385096,2023-09-09T10:51:05,Zarautz,expenses,food,-94.88,-41515.39
buyer_2,Carmen,40,ES39209541173898369721,TRX_N-00746-17476859,2023-09-09T08:42:13,Zarautz,expenses,repairs,-171.12,-41686.51
buyer_2,Carmen,40,ES39209541173898369721,TRX_N-00747-39965138,2023-09-11T08:41:45,Zarautz,expenses,food,-74.49,-41761.0
buyer_2,Carmen,40,ES39209541173898369721,TRX_N-00748-93893635,2023-09-11T18:03:49,Zarautz,expenses,cash,-100.0,-41861.0
buyer_2,Carmen,40,ES39209541173898369721,TRX_N-00749-46772829,2023-09-14T09:30:41,Amurrio,expenses,food,-109.05,-41970.05
buyer_2,Carmen,40,ES39209541173898369721,TRX_N-00750-51999796,2023-09-21T20:00:16,Zarautz,expenses,leisure,-41.52,-42011.57
buyer_2,Carmen,40,ES39209541173898369721,TRX_N-00751-32880442,2023-09-21T16:25:18,Bermeo,expenses,education,-68.83,-42080.4
buyer_2,Carmen,40,ES39209541173898369721,TRX_N-00752-69365911,2023-09-21T09:24:05,Zarautz,expenses,repairs,-172.63,-42253.03
buyer_2,Carmen,40,ES39209541173898369721,TRX_N-00753-92195789,2023-09-22T20:41:43,Lasarte-Oria,expenses,food,-102.03,-42355.06
buyer_2,Carmen,40,ES39209541173898369721,TRX_N-00754-75520058,2023-09-26T23:48:06,Zarautz,expenses,leisure,-18.94,-42374.0
buyer_2,Carmen,40,ES39209541173898369721,TRX_N-00755-55819959,2023-09-28T10:56:07,Zarautz,expenses,children,-127.25,-42501.25
buyer_2,Carmen,40,ES39209541173898369721,TRX_N-00756-39495877,2023-09-29T08:18:34,Zarautz,expenses,food,-74.2,-42575.45
buyer_2,Carmen,40,ES39209541173898369721,TRX_N-00757-09129737,2023-09-29T11:05:39,Zarautz,expenses,gifts,-213.6,-42789.05
buyer_2,Carmen,40,ES39209541173898369721,TRX_N-00758-34338374,2023-09-30T11:00:12,Zarautz,expenses,leisure,-76.86,-42865.91
buyer_2,Carmen,40,ES39209541173898369721,TRX_N-00759-93797251,2023-09-30T22:31:23,Zarautz,expenses,cash,-100.0,-42965.91
buyer_2,Carmen,40,ES39209541173898369721,TRX_N-00760-21968812,2023-10-01T06:04:35,Zarautz,incomes,salary,1374.64,-41591.27
buyer_2,Carmen,40,ES39209541173898369721,TRX_N-00761-55319878,2023-10-01T06:04:35,Zarautz,incomes,salary_partner,1449.98,-40141.29
buyer_2,Carmen,40,ES39209541173898369721,TRX_N-00762-75775481,2023-10-01T06:04:35,Zarautz,incomes,extra_income,159.61,-39981.68
buyer_2,Carmen,40,ES39209541173898369721,TRX_N-00763-92899628,2023-10-03T14:27:26,Zarautz,expenses,leisure,-36.1,-40017.78
buyer_2,Carmen,40,ES39209541173898369721,TRX_N-00764-60589375,2023-10-04T23:51:11,Zarautz,expenses,mortgage,-882.99,-40900.77
buyer_2,Carmen,40,ES39209541173898369721,TRX_N-00765-21054290,2023-10-05T16:49:01,Zarautz,expenses,gas,-30.71,-40931.48
buyer_2,Carmen,40,ES39209541173898369721,TRX_N-00766-96990414,2023-10-05T20:43:18,Zarautz,expenses,internet,-42.0,-40973.48
buyer_2,Carmen,40,ES39209541173898369721,TRX_N-00767-13575933,2023-10-05T18:42:33,Zarautz,expenses,phone,-31.85,-41005.33
buyer_2,Carmen,40,ES39209541173898369721,TRX_N-00768-50141829,2023-10-05T14:01:02,Zarautz,expenses,food,-73.43,-41078.76
buyer_2,Carmen,40,ES39209541173898369721,TRX_N-00769-92559899,2023-10-05T10:25:06,Zarautz,expenses,transport,-69.14,-41147.9
buyer_2,Carmen,40,ES39209541173898369721,TRX_N-00770-39009037,2023-10-07T18:10:47,Zarautz,expenses,gifts,-154.16,-41302.06
buyer_2,Carmen,40,ES39209541173898369721,TRX_N-00771-31868956,2023-10-08T05:11:24,Zarautz,expenses,water,-37.85,-41339.91
buyer_2,Carmen,40,ES39209541173898369721,TRX_N-00772-40386157,2023-10-08T12:16:42,Zarautz,expenses,electricity,-51.42,-41391.33
buyer_2,Carmen,40,ES39209541173898369721,TRX_N-00773-19605546,2023-10-09T20:39:55,Durango,expenses,transport,-52.54,-41443.87
buyer_2,Carmen,40,ES39209541173898369721,TRX_N-00774-27096052,2023-10-12T19:45:18,Zarautz,expenses,transport,-43.02,-41486.89
buyer_2,Carmen,40,ES39209541173898369721,TRX_N-00775-50423521,2023-10-12T10:59:32,Zarautz,expenses,children,-203.65,-41690.54
buyer_2,Carmen,40,ES39209541173898369721,TRX_N-00776-65150732,2023-10-13T00:55:26,Zarautz,expenses,children,-249.26,-41939.8
buyer_2,Carmen,40,ES39209541173898369721,TRX_N-00777-22386042,2023-10-14T07:24:56,Zarautz,expenses,children,-218.73,-42158.53
buyer_2,Carmen,40,ES39209541173898369721,TRX_N-00778-16365265,2023-10-15T09:16:59,Elciego,expenses,food,-113.32,-42271.85
buyer_2,Carmen,40,ES39209541173898369721,TRX_N-00779-71478574,2023-10-15T08:40:10,Zarautz,expenses,clothing,-58.54,-42330.39
buyer_2,Carmen,40,ES39209541173898369721,TRX_N-00780-82699926,2023-10-15T19:13:49,Zarautz,expenses,gifts,-51.44,-42381.83
buyer_2,Carmen,40,ES39209541173898369721,TRX_N-00781-24759443,2023-10-16T20:20:21,Zarautz,expenses,education,-73.92,-42455.75
buyer_2,Carmen,40,ES39209541173898369721,TRX_N-00782-92590348,2023-10-17T17:00:32,Zarautz,expenses,food,-120.42,-42576.17
buyer_2,Carmen,40,ES39209541173898369721,TRX_N-00783-25330144,2023-10-19T15:46:32,Zarautz,expenses,food,-66.25,-42642.42
buyer_2,Carmen,40,ES39209541173898369721,TRX_N-00784-24345191,2023-10-19T08:47:02,Zarautz,expenses,transport,-74.4,-42716.82
buyer_2,Carmen,40,ES39209541173898369721,TRX_N-00785-48790864,2023-10-19T10:25:58,Zarautz,expenses,cash,-100.0,-42816.82
buyer_2,Carmen,40,ES39209541173898369721,TRX_N-00786-20816387,2023-10-19T19:29:28,Bilbao,expenses,gifts,-504.2,-43321.02
buyer_2,Carmen,40,ES39209541173898369721,TRX_N-00787-03558975,2023-10-23T09:36:53,Zarautz,expenses,gifts,-529.93,-43850.95
buyer_2,Carmen,40,ES39209541173898369721,TRX_N-00788-25286457,2023-10-24T08:26:04,Zarautz,expenses,education,-63.02,-43913.97
buyer_2,Carmen,40,ES39209541173898369721,TRX_N-00789-65230001,2023-10-24T20:01:35,Zarautz,expenses,repairs,-296.68,-44210.65
buyer_2,Carmen,40,ES39209541173898369721,TRX_N-00790-79359525,2023-10-25T18:17:41,Zarautz,expenses,leisure,-30.04,-44240.69
buyer_2,Carmen,40,ES39209541173898369721,TRX_N-00791-45906316,2023-10-27T09:53:42,Barakaldo,expenses,food,-69.03,-44309.72
buyer_2,Carmen,40,ES39209541173898369721,TRX_N-00792-19944279,2023-10-28T19:20:09,Zarautz,expenses,cash,-100.0,-44409.72
buyer_2,Carmen,40,ES39209541173898369721,TRX_N-00793-76749339,2023-10-30T20:30:45,Zarautz,expenses,cash,-100.0,-44509.72
buyer_2,Carmen,40,ES39209541173898369721,TRX_N-00794-75125153,2023-10-31T13:53:01,Zarautz,expenses,leisure,-69.32,-44579.04
buyer_2,Carmen,40,ES39209541173898369721,TRX_N-00795-30122246,2023-11-01T11:23:17,Zarautz,incomes,salary,1374.64,-43204.4
buyer_2,Carmen,40,ES39209541173898369721,TRX_N-00796-52607444,2023-11-01T11:23:17,Zarautz,incomes,salary_partner,1449.98,-41754.42
buyer_2,Carmen,40,ES39209541173898369721,TRX_N-00797-08816909,2023-11-02T17:57:13,Zarautz,expenses,transport,-61.62,-41816.04
buyer_2,Carmen,40,ES39209541173898369721,TRX_N-00798-18057830,2023-11-02T03:09:11,Zarautz,expenses,leisure,-53.12,-41869.16
buyer_2,Carmen,40,ES39209541173898369721,TRX_N-00799-57352477,2023-11-03T23:42:14,Zarautz,expenses,food,-89.63,-41958.79
buyer_2,Carmen,40,ES39209541173898369721,TRX_N-00800-60483088,2023-11-04T16:45:21,Zarautz,expenses,mortgage,-882.99,-42841.78
buyer_2,Carmen,40,ES39209541173898369721,TRX_N-00801-20911379,2023-11-05T20:46:22,Zarautz,expenses,healthcare,-161.85,-43003.63
buyer_2,Carmen,40,ES39209541173898369721,TRX_N-00802-53667920,2023-11-06T15:06:52,Zarautz,expenses,water,-37.75,-43041.38
buyer_2,Carmen,40,ES39209541173898369721,TRX_N-00803-58537303,2023-11-06T12:21:07,Zarautz,expenses,gas,-91.01,-43132.39
buyer_2,Carmen,40,ES39209541173898369721,TRX_N-00804-07769060,2023-11-06T00:18:01,Zarautz,expenses,leisure,-53.04,-43185.43
buyer_2,Carmen,40,ES39209541173898369721,TRX_N-00805-57188944,2023-11-06T16:28:07,Zarautz,expenses,appliances,-224.15,-43409.58
buyer_2,Carmen,40,ES39209541173898369721,TRX_N-00806-30296477,2023-11-07T10:32:56,Zarautz,expenses,gifts,-42.12,-43451.7
buyer_2,Carmen,40,ES39209541173898369721,TRX_N-00807-27520592,2023-11-08T20:11:43,Zarautz,expenses,electricity,-53.98,-43505.68
buyer_2,Carmen,40,ES39209541173898369721,TRX_N-00808-78147134,2023-11-08T23:01:27,Zarautz,expenses,internet,-42.0,-43547.68
buyer_2,Carmen,40,ES39209541173898369721,TRX_N-00809-37036300,2023-11-08T20:15:22,Zarautz,expenses,phone,-37.14,-43584.82
buyer_2,Carmen,40,ES39209541173898369721,TRX_N-00810-66071814,2023-11-11T11:41:37,Zarautz,expenses,transport,-58.35,-43643.17
buyer_2,Carmen,40,ES39209541173898369721,TRX_N-00811-38391946,2023-11-12T14:33:01,Zarautz,expenses,education,-43.03,-43686.2
buyer_2,Carmen,40,ES39209541173898369721,TRX_N-00812-13544511,2023-11-14T18:41:03,Zarautz,expenses,food,-113.37,-43799.57
buyer_2,Carmen,40,ES39209541173898369721,TRX_N-00813-52644335,2023-11-14T14:25:19,Zarautz,expenses,leisure,-36.98,-43836.55
buyer_2,Carmen,40,ES39209541173898369721,TRX_N-00814-39145827,2023-11-14T03:03:21,Lasarte-Oria,expenses,clothing,-159.29,-43995.84
buyer_2,Carmen,40,ES39209541173898369721,TRX_N-00815-82475755,2023-11-15T16:21:46,Zarautz,expenses,children,-172.04,-44167.88
buyer_2,Carmen,40,ES39209541173898369721,TRX_N-00816-19282166,2023-11-17T09:37:10,Zarautz,expenses,leisure,-83.03,-44250.91
buyer_2,Carmen,40,ES39209541173898369721,TRX_N-00817-93924244,2023-11-17T07:29:54,Zarautz,expenses,appliances,-204.24,-44455.15
buyer_2,Carmen,40,ES39209541173898369721,TRX_N-00818-89914870,2023-11-19T21:04:59,Sestao,expenses,cash,-100.0,-44555.15
buyer_2,Carmen,40,ES39209541173898369721,TRX_N-00819-19920792,2023-11-25T19:15:36,Zarautz,expenses,leisure,-34.62,-44589.77
buyer_2,Carmen,40,ES39209541173898369721,TRX_N-00820-57699456,2023-11-26T11:44:57,Zarautz,expenses,leisure,-47.1,-44636.87
buyer_2,Carmen,40,ES39209541173898369721,TRX_N-00821-08132808,2023-11-26T16:13:25,Zarautz,expenses,clothing,-99.87,-44736.74
buyer_2,Carmen,40,ES39209541173898369721,TRX_N-00822-10406983,2023-12-01T16:35:39,Zarautz,incomes,salary,1374.64,-43362.1
buyer_2,Carmen,40,ES39209541173898369721,TRX_N-00823-74483472,2023-12-01T16:35:39,Zarautz,incomes,salary_partner,1449.98,-41912.12
buyer_2,Carmen,40,ES39209541173898369721,TRX_N-00824-65329589,2023-12-01T16:35:39,Zarautz,incomes,salary_bonus,1077.02,-40835.1
buyer_2,Carmen,40,ES39209541173898369721,TRX_N-00825-54438464,2023-12-01T16:35:39,Zarautz,incomes,salary_partner_bonus,1134.17,-39700.93
buyer_2,Carmen,40,ES39209541173898369721,TRX_N-00826-94842731,2023-12-02T18:46:42,Zarautz,expenses,food,-60.29,-39761.22
buyer_2,Carmen,40,ES39209541173898369721,TRX_N-00827-21783280,2023-12-04T13:17:25,Zarautz,expenses,mortgage,-882.99,-40644.21
buyer_2,Carmen,40,ES39209541173898369721,TRX_N-00828-24353237,2023-12-04T10:53:01,Zarautz,expenses,cash,-100.0,-40744.21
buyer_2,Carmen,40,ES39209541173898369721,TRX_N-00829-52210847,2023-12-05T19:34:17,Zarautz,expenses,electricity,-32.37,-40776.58
buyer_2,Carmen,40,ES39209541173898369721,TRX_N-00830-76432609,2023-12-05T18:25:38,Zarautz,expenses,internet,-42.0,-40818.58
buyer_2,Carmen,40,ES39209541173898369721,TRX_N-00831-89674327,2023-12-05T04:29:32,Zarautz,expenses,transport,-41.35,-40859.93
buyer_2,Carmen,40,ES39209541173898369721,TRX_N-00832-43064667,2023-12-06T11:00:27,Zarautz,expenses,phone,-38.52,-40898.45
buyer_2,Carmen,40,ES39209541173898369721,TRX_N-00833-86186523,2023-12-06T19:20:51,Zarautz,expenses,food,-114.66,-41013.11
buyer_2,Carmen,40,ES39209541173898369721,TRX_N-00834-58008564,2023-12-07T13:01:43,Zarautz,expenses,children,-197.9,-41211.01
buyer_2,Carmen,40,ES39209541173898369721,TRX_N-00835-58034280,2023-12-08T12:14:46,Zarautz,expenses,water,-28.48,-41239.49
buyer_2,Carmen,40,ES39209541173898369721,TRX_N-00836-40632094,2023-12-08T15:47:28,Zarautz,expenses,gas,-108.1,-41347.59
buyer_2,Carmen,40,ES39209541173898369721,TRX_N-00837-93160928,2023-12-08T11:15:33,Zarautz,expenses,food,-86.55,-41434.14
buyer_2,Carmen,40,ES39209541173898369721,TRX_N-00838-24998827,2023-12-09T15:37:46,Zarautz,expenses,cash,-100.0,-41534.14
buyer_2,Carmen,40,ES39209541173898369721,TRX_N-00839-01390346,2023-12-10T13:12:06,Zarautz,expenses,leisure,-29.23,-41563.37
buyer_2,Carmen,40,ES39209541173898369721,TRX_N-00840-80231388,2023-12-11T16:22:42,Zarautz,expenses,repairs,-119.13,-41682.5
buyer_2,Carmen,40,ES39209541173898369721,TRX_N-00841-25733308,2023-12-12T13:39:50,Zarautz,expenses,travel,-1193.0,-42875.5
buyer_2,Carmen,40,ES39209541173898369721,TRX_N-00842-94955032,2023-12-13T13:34:17,Zuia,expenses,healthcare,-106.4,-42981.9
buyer_2,Carmen,40,ES39209541173898369721,TRX_N-00843-97725241,2023-12-13T19:46:16,Iruña de Oca,expenses,repairs,-116.19,-43098.09
buyer_2,Carmen,40,ES39209541173898369721,TRX_N-00844-16135741,2023-12-14T11:35:58,Zarautz,expenses,food,-75.11,-43173.2
buyer_2,Carmen,40,ES39209541173898369721,TRX_N-00845-86552343,2023-12-14T14:38:57,Zarautz,expenses,leisure,-84.69,-43257.89
buyer_2,Carmen,40,ES39209541173898369721,TRX_N-00846-63658600,2023-12-15T06:57:22,Zarautz,expenses,repairs,-189.9,-43447.79
buyer_2,Carmen,40,ES39209541173898369721,TRX_N-00847-45954134,2023-12-16T17:43:12,Zarautz,expenses,transport,-70.81,-43518.6
buyer_2,Carmen,40,ES39209541173898369721,TRX_N-00848-22651384,2023-12-16T11:10:48,Zarautz,expenses,gifts,-63.77,-43582.37
buyer_2,Carmen,40,ES39209541173898369721,TRX_N-00849-45306969,2023-12-17T13:28:47,Zarautz,expenses,cash,-100.0,-43682.37
buyer_2,Carmen,40,ES39209541173898369721,TRX_N-00850-41823159,2023-12-18T18:04:44,Zarautz,expenses,cash,-100.0,-43782.37
buyer_2,Carmen,40,ES39209541173898369721,TRX_N-00851-46376765,2023-12-19T19:41:34,Zarautz,expenses,transport,-50.04,-43832.41
buyer_2,Carmen,40,ES39209541173898369721,TRX_N-00852-99241021,2023-12-19T18:40:56,Zarautz,expenses,leisure,-21.03,-43853.44
buyer_2,Carmen,40,ES39209541173898369721,TRX_N-00853-61047621,2023-12-19T19:00:08,Zarautz,expenses,clothing,-70.92,-43924.36
buyer_2,Carmen,40,ES39209541173898369721,TRX_N-00854-95979846,2023-12-20T12:17:17,Arrasate,expenses,travel,-1480.65,-45405.01
buyer_2,Carmen,40,ES39209541173898369721,TRX_N-00855-96977898,2023-12-21T13:34:07,Elciego,expenses,food,-122.23,-45527.24
buyer_2,Carmen,40,ES39209541173898369721,TRX_N-00856-59541753,2023-12-21T15:53:37,Zarautz,expenses,clothing,-83.41,-45610.65
buyer_2,Carmen,40,ES39209541173898369721,TRX_N-00857-31779084,2023-12-22T20:42:51,Zarautz,expenses,food,-124.68,-45735.33
buyer_2,Carmen,40,ES39209541173898369721,TRX_N-00858-68859631,2023-12-22T06:49:36,Zarautz,expenses,transport,-42.02,-45777.35
buyer_2,Carmen,40,ES39209541173898369721,TRX_N-00859-58322312,2023-12-23T11:12:51,Zarautz,expenses,leisure,-81.5,-45858.85
buyer_2,Carmen,40,ES39209541173898369721,TRX_N-00860-26061141,2023-12-23T10:51:06,Zarautz,expenses,cash,-100.0,-45958.85
buyer_2,Carmen,40,ES39209541173898369721,TRX_N-00861-59315578,2023-12-24T12:50:25,Zarautz,expenses,repairs,-310.42,-46269.27
buyer_2,Carmen,40,ES39209541173898369721,TRX_N-00862-17920592,2023-12-25T11:11:54,Zarautz,expenses,education,-55.83,-46325.1
buyer_2,Carmen,40,ES39209541173898369721,TRX_N-00863-15376429,2023-12-26T08:44:01,Galdakao,expenses,transport,-82.82,-46407.92
buyer_2,Carmen,40,ES39209541173898369721,TRX_N-00864-40579627,2023-12-26T13:38:48,Zarautz,expenses,leisure,-70.96,-46478.88
buyer_2,Carmen,40,ES39209541173898369721,TRX_N-00865-09566865,2023-12-26T19:29:41,Zarautz,expenses,repairs,-92.04,-46570.92
buyer_2,Carmen,40,ES39209541173898369721,TRX_N-00866-70722652,2023-12-27T13:34:17,Basauri,expenses,gifts,-399.38,-46970.3
buyer_2,Carmen,40,ES39209541173898369721,TRX_N-00867-16058701,2023-12-29T20:55:52,Zarautz,expenses,cash,-100.0,-47070.3
buyer_2,Carmen,40,ES39209541173898369721,TRX_N-00868-84111995,2023-12-31T08:02:10,Zarautz,expenses,transport,-67.08,-47137.38
buyer_2,Carmen,40,ES39209541173898369721,TRX_N-00869-08019383,2024-01-01T13:14:03,Zarautz,incomes,salary,1418.5,-45718.88
buyer_2,Carmen,40,ES39209541173898369721,TRX_N-00870-82624802,2024-01-01T13:14:03,Zarautz,incomes,salary_partner,1496.25,-44222.63
buyer_2,Carmen,40,ES39209541173898369721,TRX_N-00871-31790078,2024-01-01T13:14:03,Zarautz,incomes,extra_income,159.61,-44063.02
buyer_2,Carmen,40,ES39209541173898369721,TRX_N-00872-20286082,2024-01-01T12:19:22,Zarautz,expenses,cash,-100.0,-44163.02
buyer_2,Carmen,40,ES39209541173898369721,TRX_N-00873-72165242,2024-01-02T16:26:49,Zarautz,expenses,healthcare,-129.6,-44292.62
buyer_2,Carmen,40,ES39209541173898369721,TRX_N-00874-20648150,2024-01-02T12:49:00,Zarautz,expenses,children,-168.03,-44460.65
buyer_2,Carmen,40,ES39209541173898369721,TRX_N-00875-73435670,2024-01-04T16:05:02,Zarautz,expenses,mortgage,-882.99,-45343.64
buyer_2,Carmen,40,ES39209541173898369721,TRX_N-00876-98450154,2024-01-05T23:14:50,Zarautz,expenses,leisure,-21.88,-45365.52
buyer_2,Carmen,40,ES39209541173898369721,TRX_N-00877-30743652,2024-01-05T15:27:14,Lasarte-Oria,expenses,clothing,-77.81,-45443.33
buyer_2,Carmen,40,ES39209541173898369721,TRX_N-00878-59158835,2024-01-05T18:48:43,Zarautz,expenses,healthcare,-144.48,-45587.81
buyer_2,Carmen,40,ES39209541173898369721,TRX_N-00879-31014793,2024-01-06T10:53:15,Zarautz,expenses,food,-115.11,-45702.92
buyer_2,Carmen,40,ES39209541173898369721,TRX_N-00880-51841027,2024-01-07T05:24:11,Zarautz,expenses,electricity,-50.14,-45753.06
buyer_2,Carmen,40,ES39209541173898369721,TRX_N-00881-70253370,2024-01-08T16:05:23,Zarautz,expenses,gas,-31.93,-45784.99
buyer_2,Carmen,40,ES39209541173898369721,TRX_N-00882-08201900,2024-01-08T14:02:55,Zarautz,expenses,water,-24.26,-45809.25
buyer_2,Carmen,40,ES39209541173898369721,TRX_N-00883-98456924,2024-01-08T17:42:36,Zarautz,expenses,internet,-42.0,-45851.25
buyer_2,Carmen,40,ES39209541173898369721,TRX_N-00884-13756821,2024-01-08T17:30:14,Zarautz,expenses,phone,-37.34,-45888.59
buyer_2,Carmen,40,ES39209541173898369721,TRX_N-00885-11006935,2024-01-09T09:16:54,Zarautz,expenses,transport,-50.69,-45939.28
buyer_2,Carmen,40,ES39209541173898369721,TRX_N-00886-35585712,2024-01-09T18:12:58,Zarautz,expenses,gifts,-226.09,-46165.37
buyer_2,Carmen,40,ES39209541173898369721,TRX_N-00887-09962288,2024-01-12T09:36:46,Zarautz,expenses,food,-77.56,-46242.93
buyer_2,Carmen,40,ES39209541173898369721,TRX_N-00888-83504908,2024-01-13T18:05:33,Zarautz,expenses,food,-86.28,-46329.21
buyer_2,Carmen,40,ES39209541173898369721,TRX_N-00889-97898040,2024-01-13T17:50:26,Vitoria-Gasteiz,expenses,cash,-100.0,-46429.21
buyer_2,Carmen,40,ES39209541173898369721,TRX_N-00890-58255125,2024-01-14T08:52:08,Zarautz,expenses,food,-109.79,-46539.0
buyer_2,Carmen,40,ES39209541173898369721,TRX_N-00891-58327409,2024-01-16T18:41:08,Zarautz,expenses,education,-54.54,-46593.54
buyer_2,Carmen,40,ES39209541173898369721,TRX_N-00892-40626320,2024-01-16T19:57:14,Zarautz,expenses,gifts,-593.97,-47187.51
buyer_2,Carmen,40,ES39209541173898369721,TRX_N-00893-21706181,2024-01-17T11:15:00,Zarautz,expenses,leisure,-32.88,-47220.39
buyer_2,Carmen,40,ES39209541173898369721,TRX_N-00894-23661475,2024-01-18T10:16:35,Zarautz,expenses,food,-79.16,-47299.55
buyer_2,Carmen,40,ES39209541173898369721,TRX_N-00895-37432173,2024-01-18T13:17:34,Zarautz,expenses,transport,-51.9,-47351.45
buyer_2,Carmen,40,ES39209541173898369721,TRX_N-00896-02049173,2024-01-18T20:08:43,Zarautz,expenses,leisure,-73.19,-47424.64
buyer_2,Carmen,40,ES39209541173898369721,TRX_N-00897-87289456,2024-01-20T17:07:08,Zuia,expenses,repairs,-285.69,-47710.33
buyer_2,Carmen,40,ES39209541173898369721,TRX_N-00898-03358926,2024-01-21T14:27:40,Zarautz,expenses,gifts,-459.26,-48169.59
buyer_2,Carmen,40,ES39209541173898369721,TRX_N-00899-19806381,2024-01-22T10:48:09,Zarautz,expenses,food,-63.51,-48233.1
buyer_2,Carmen,40,ES39209541173898369721,TRX_N-00900-31210741,2024-01-22T18:56:07,Zarautz,expenses,clothing,-117.78,-48350.88
buyer_2,Carmen,40,ES39209541173898369721,TRX_N-00901-52382611,2024-01-23T14:45:11,Zarautz,expenses,clothing,-97.8,-48448.68
buyer_2,Carmen,40,ES39209541173898369721,TRX_N-00902-69545713,2024-01-24T13:48:27,Zarautz,expenses,transport,-78.35,-48527.03
buyer_2,Carmen,40,ES39209541173898369721,TRX_N-00903-35323474,2024-01-25T20:32:00,Zarautz,expenses,repairs,-250.38,-48777.41
buyer_2,Carmen,40,ES39209541173898369721,TRX_N-00904-08425222,2024-01-27T19:59:39,Llodio,expenses,clothing,-119.94,-48897.35
buyer_2,Carmen,40,ES39209541173898369721,TRX_N-00905-78524567,2024-01-28T23:56:49,Zarautz,expenses,food,-96.63,-48993.98
buyer_2,Carmen,40,ES39209541173898369721,TRX_N-00906-66585591,2024-01-30T08:04:06,Zarautz,expenses,education,-53.48,-49047.46
buyer_2,Carmen,40,ES39209541173898369721,TRX_N-00907-39107765,2024-01-31T13:41:12,Zarautz,expenses,clothing,-118.51,-49165.97
buyer_2,Carmen,40,ES39209541173898369721,TRX_N-00908-15950521,2024-02-01T17:45:38,Zarautz,incomes,salary,1418.5,-47747.47
buyer_2,Carmen,40,ES39209541173898369721,TRX_N-00909-07538335,2024-02-01T17:45:38,Zarautz,incomes,salary_partner,1496.25,-46251.22
buyer_2,Carmen,40,ES39209541173898369721,TRX_N-00910-05967036,2024-02-01T11:45:21,Zarautz,expenses,children,-137.59,-46388.81
buyer_2,Carmen,40,ES39209541173898369721,TRX_N-00911-42972273,2024-02-02T23:26:06,Barakaldo,expenses,cash,-100.0,-46488.81
buyer_2,Carmen,40,ES39209541173898369721,TRX_N-00912-41319915,2024-02-03T20:54:58,Zarautz,expenses,food,-94.37,-46583.18
buyer_2,Carmen,40,ES39209541173898369721,TRX_N-00913-57978221,2024-02-03T15:03:20,Zuia,expenses,leisure,-43.53,-46626.71
buyer_2,Carmen,40,ES39209541173898369721,TRX_N-00914-37747395,2024-02-04T20:02:26,Zarautz,expenses,mortgage,-882.99,-47509.7
buyer_2,Carmen,40,ES39209541173898369721,TRX_N-00915-48416314,2024-02-05T19:02:09,Zarautz,expenses,internet,-42.0,-47551.7
buyer_2,Carmen,40,ES39209541173898369721,TRX_N-00916-42631865,2024-02-05T20:34:36,Zarautz,expenses,phone,-35.07,-47586.77
buyer_2,Carmen,40,ES39209541173898369721,TRX_N-00917-41246214,2024-02-05T08:23:28,Arrasate,expenses,transport,-80.2,-47666.97
buyer_2,Carmen,40,ES39209541173898369721,TRX_N-00918-08751715,2024-02-05T08:02:31,Zarautz,expenses,leisure,-64.25,-47731.22
buyer_2,Carmen,40,ES39209541173898369721,TRX_N-00919-23383945,2024-02-06T10:38:46,Zarautz,expenses,electricity,-59.9,-47791.12
buyer_2,Carmen,40,ES39209541173898369721,TRX_N-00920-52872885,2024-02-06T13:37:49,Eibar,expenses,clothing,-107.03,-47898.15
buyer_2,Carmen,40,ES39209541173898369721,TRX_N-00921-21355581,2024-02-07T10:13:27,Zarautz,expenses,water,-43.33,-47941.48
buyer_2,Carmen,40,ES39209541173898369721,TRX_N-00922-13297246,2024-02-08T15:45:23,Zarautz,expenses,gas,-42.21,-47983.69
buyer_2,Carmen,40,ES39209541173898369721,TRX_N-00923-79807462,2024-02-09T09:54:11,Zarautz,expenses,cash,-100.0,-48083.69
buyer_2,Carmen,40,ES39209541173898369721,TRX_N-00924-65155864,2024-02-12T12:15:03,Zarautz,expenses,cash,-100.0,-48183.69
buyer_2,Carmen,40,ES39209541173898369721,TRX_N-00925-52088240,2024-02-12T13:53:41,Zarautz,expenses,repairs,-124.25,-48307.94
buyer_2,Carmen,40,ES39209541173898369721,TRX_N-00926-67989782,2024-02-13T15:34:00,Zarautz,expenses,clothing,-97.37,-48405.31
buyer_2,Carmen,40,ES39209541173898369721,TRX_N-00927-29948088,2024-02-13T10:00:09,Vitoria-Gasteiz,expenses,cash,-100.0,-48505.31
buyer_2,Carmen,40,ES39209541173898369721,TRX_N-00928-05011143,2024-02-13T23:48:16,Errenteria,expenses,repairs,-270.4,-48775.71
buyer_2,Carmen,40,ES39209541173898369721,TRX_N-00929-92113294,2024-02-15T01:55:33,Salvatierra/Agurain,expenses,food,-81.53,-48857.24
buyer_2,Carmen,40,ES39209541173898369721,TRX_N-00930-06061746,2024-02-17T09:46:58,Zarautz,expenses,leisure,-36.33,-48893.57
buyer_2,Carmen,40,ES39209541173898369721,TRX_N-00931-81763104,2024-02-18T21:21:32,Zarautz,expenses,cash,-100.0,-48993.57
buyer_2,Carmen,40,ES39209541173898369721,TRX_N-00932-93748559,2024-02-19T21:01:59,Zarautz,expenses,food,-64.77,-49058.34
buyer_2,Carmen,40,ES39209541173898369721,TRX_N-00933-69111492,2024-02-19T08:11:05,Zarautz,expenses,clothing,-155.41,-49213.75
buyer_2,Carmen,40,ES39209541173898369721,TRX_N-00934-18357458,2024-02-25T10:53:46,Zarautz,expenses,food,-97.34,-49311.09
buyer_2,Carmen,40,ES39209541173898369721,TRX_N-00935-28827493,2024-02-26T17:11:54,Zarautz,expenses,transport,-89.35,-49400.44
buyer_2,Carmen,40,ES39209541173898369721,TRX_N-00936-68524993,2024-02-27T09:25:20,Zarautz,expenses,food,-101.63,-49502.07
buyer_2,Carmen,40,ES39209541173898369721,TRX_N-00937-88970071,2024-02-29T22:07:22,Zuia,expenses,food,-94.64,-49596.71
buyer_2,Carmen,40,ES39209541173898369721,TRX_N-00938-47302817,2024-03-01T23:17:22,Zarautz,incomes,salary,1418.5,-48178.21
buyer_2,Carmen,40,ES39209541173898369721,TRX_N-00939-50145157,2024-03-01T23:17:22,Zarautz,incomes,salary_partner,1496.25,-46681.96
buyer_2,Carmen,40,ES39209541173898369721,TRX_N-00940-91342947,2024-03-01T23:50:18,Zarautz,expenses,transport,-58.35,-46740.31
buyer_2,Carmen,40,ES39209541173898369721,TRX_N-00941-96779890,2024-03-01T10:16:20,Zarautz,expenses,cash,-100.0,-46840.31
buyer_2,Carmen,40,ES39209541173898369721,TRX_N-00942-08636838,2024-03-01T08:29:50,Zarautz,expenses,repairs,-111.29,-46951.6
buyer_2,Carmen,40,ES39209541173898369721,TRX_N-00943-09094329,2024-03-01T09:52:14,Zarautz,expenses,gifts,-497.7,-47449.3
buyer_2,Carmen,40,ES39209541173898369721,TRX_N-00944-22085116,2024-03-02T05:25:14,Arrasate,expenses,gifts,-607.41,-48056.71
buyer_2,Carmen,40,ES39209541173898369721,TRX_N-00945-48922588,2024-03-04T14:07:34,Zarautz,expenses,mortgage,-882.99,-48939.7
buyer_2,Carmen,40,ES39209541173898369721,TRX_N-00946-93168046,2024-03-04T16:30:57,Zarautz,expenses,food,-77.19,-49016.89
buyer_2,Carmen,40,ES39209541173898369721,TRX_N-00947-74939751,2024-03-07T14:05:02,Zarautz,expenses,water,-38.08,-49054.97
buyer_2,Carmen,40,ES39209541173898369721,TRX_N-00948-92029232,2024-03-07T10:16:48,Zarautz,expenses,gas,-107.11,-49162.08
buyer_2,Carmen,40,ES39209541173898369721,TRX_N-00949-53398204,2024-03-07T03:50:23,Zarautz,expenses,internet,-42.0,-49204.08
buyer_2,Carmen,40,ES39209541173898369721,TRX_N-00950-91076757,2024-03-08T01:21:10,Zarautz,expenses,phone,-44.21,-49248.29
buyer_2,Carmen,40,ES39209541173898369721,TRX_N-00951-46023504,2024-03-08T02:34:15,Zarautz,expenses,electricity,-65.04,-49313.33
buyer_2,Carmen,40,ES39209541173898369721,TRX_N-00952-52447260,2024-03-08T10:19:50,Zarautz,expenses,gifts,-794.21,-50107.54
buyer_2,Carmen,40,ES39209541173898369721,TRX_N-00953-10021696,2024-03-09T20:08:07,Zarautz,expenses,food,-117.33,-50224.87
buyer_2,Carmen,40,ES39209541173898369721,TRX_N-00954-97014982,2024-03-09T15:46:26,Zarautz,expenses,transport,-51.39,-50276.26
buyer_2,Carmen,40,ES39209541173898369721,TRX_N-00955-55154796,2024-03-10T09:24:14,Zarautz,expenses,leisure,-60.15,-50336.41
buyer_2,Carmen,40,ES39209541173898369721,TRX_N-00956-78267339,2024-03-10T15:20:32,Llodio,expenses,cash,-100.0,-50436.41
buyer_2,Carmen,40,ES39209541173898369721,TRX_N-00957-73886746,2024-03-11T15:49:15,Zarautz,expenses,repairs,-186.9,-50623.31
buyer_2,Carmen,40,ES39209541173898369721,TRX_N-00958-92682693,2024-03-15T15:27:12,Zarautz,expenses,education,-55.4,-50678.71
buyer_2,Carmen,40,ES39209541173898369721,TRX_N-00959-80049157,2024-03-15T13:47:57,Zarautz,expenses,children,-71.75,-50750.46
buyer_2,Carmen,40,ES39209541173898369721,TRX_N-00960-73218914,2024-03-16T10:34:06,Zarautz,expenses,leisure,-69.0,-50819.46
buyer_2,Carmen,40,ES39209541173898369721,TRX_N-00961-65809506,2024-03-17T08:03:29,Llodio,expenses,cash,-100.0,-50919.46
buyer_2,Carmen,40,ES39209541173898369721,TRX_N-00962-41449257,2024-03-18T17:18:06,Arrasate,expenses,leisure,-73.23,-50992.69
buyer_2,Carmen,40,ES39209541173898369721,TRX_N-00963-39503142,2024-03-19T15:05:28,Galdakao,expenses,gifts,-475.55,-51468.24
buyer_2,Carmen,40,ES39209541173898369721,TRX_N-00964-04566124,2024-03-21T10:02:09,Zarautz,expenses,cash,-100.0,-51568.24
buyer_2,Carmen,40,ES39209541173898369721,TRX_N-00965-63191658,2024-03-21T16:54:23,Zarautz,expenses,children,-63.7,-51631.94
buyer_2,Carmen,40,ES39209541173898369721,TRX_N-00966-14515841,2024-03-22T12:46:10,Zarautz,expenses,leisure,-43.14,-51675.08
buyer_2,Carmen,40,ES39209541173898369721,TRX_N-00967-93159715,2024-03-24T03:34:33,Zarautz,expenses,clothing,-111.96,-51787.04
buyer_2,Carmen,40,ES39209541173898369721,TRX_N-00968-17189548,2024-03-26T15:08:47,Zarautz,expenses,food,-110.37,-51897.41
buyer_2,Carmen,40,ES39209541173898369721,TRX_N-00969-21805088,2024-03-27T07:44:21,Zarautz,expenses,cash,-100.0,-51997.41
buyer_2,Carmen,40,ES39209541173898369721,TRX_N-00970-46870511,2024-03-27T09:09:43,Zarautz,expenses,repairs,-111.83,-52109.24
buyer_2,Carmen,40,ES39209541173898369721,TRX_N-00971-10955359,2024-03-28T20:32:02,Erandio,expenses,transport,-89.11,-52198.35
buyer_2,Carmen,40,ES39209541173898369721,TRX_N-00972-80698215,2024-03-28T11:36:47,Zarautz,expenses,education,-51.67,-52250.02
buyer_2,Carmen,40,ES39209541173898369721,TRX_N-00973-62876744,2024-03-28T18:09:31,Zarautz,expenses,repairs,-272.9,-52522.92
buyer_2,Carmen,40,ES39209541173898369721,TRX_N-00974-85531414,2024-03-31T15:33:18,Zarautz,expenses,food,-104.81,-52627.73
buyer_2,Carmen,40,ES39209541173898369721,TRX_N-00975-66134398,2024-04-01T23:36:43,Zarautz,incomes,salary,1418.5,-51209.23
buyer_2,Carmen,40,ES39209541173898369721,TRX_N-00976-16737514,2024-04-01T23:36:43,Zarautz,incomes,salary_partner,1496.25,-49712.98
buyer_2,Carmen,40,ES39209541173898369721,TRX_N-00977-89536769,2024-04-01T23:36:43,Zarautz,incomes,extra_income,159.61,-49553.37
buyer_2,Carmen,40,ES39209541173898369721,TRX_N-00978-84347735,2024-04-01T13:32:56,Portugalete,expenses,food,-75.65,-49629.02
buyer_2,Carmen,40,ES39209541173898369721,TRX_N-00979-57633396,2024-04-01T13:36:07,Zarautz,expenses,leisure,-44.64,-49673.66
buyer_2,Carmen,40,ES39209541173898369721,TRX_N-00980-15424397,2024-04-01T19:08:16,Zarautz,expenses,cash,-100.0,-49773.66
buyer_2,Carmen,40,ES39209541173898369721,TRX_N-00981-64656084,2024-04-02T16:56:58,Zarautz,expenses,cash,-100.0,-49873.66
buyer_2,Carmen,40,ES39209541173898369721,TRX_N-00982-48785152,2024-04-02T08:40:34,Zarautz,expenses,children,-118.76,-49992.42
buyer_2,Carmen,40,ES39209541173898369721,TRX_N-00983-76217397,2024-04-03T15:16:42,Zarautz,expenses,food,-74.05,-50066.47
buyer_2,Carmen,40,ES39209541173898369721,TRX_N-00984-48129719,2024-04-03T22:34:53,Zarautz,expenses,leisure,-55.19,-50121.66
buyer_2,Carmen,40,ES39209541173898369721,TRX_N-00985-23145115,2024-04-04T15:05:46,Zarautz,expenses,mortgage,-882.99,-51004.65
buyer_2,Carmen,40,ES39209541173898369721,TRX_N-00986-41186799,2024-04-04T03:47:16,Zarautz,expenses,food,-69.0,-51073.65
buyer_2,Carmen,40,ES39209541173898369721,TRX_N-00987-21288584,2024-04-04T15:29:41,Zarautz,expenses,leisure,-84.44,-51158.09
buyer_2,Carmen,40,ES39209541173898369721,TRX_N-00988-75119286,2024-04-04T09:58:05,Zarautz,expenses,cash,-100.0,-51258.09
buyer_2,Carmen,40,ES39209541173898369721,TRX_N-00989-93844144,2024-04-05T08:43:17,Zarautz,expenses,electricity,-77.23,-51335.32
buyer_2,Carmen,40,ES39209541173898369721,TRX_N-00990-40280224,2024-04-06T23:13:07,Zarautz,expenses,gas,-90.94,-51426.26
buyer_2,Carmen,40,ES39209541173898369721,TRX_N-00991-86769714,2024-04-07T22:06:34,Zarautz,expenses,phone,-36.14,-51462.4
buyer_2,Carmen,40,ES39209541173898369721,TRX_N-00992-90149605,2024-04-07T18:18:22,Zarautz,expenses,cash,-100.0,-51562.4
buyer_2,Carmen,40,ES39209541173898369721,TRX_N-00993-66985430,2024-04-07T05:05:12,Zarautz,expenses,repairs,-163.57,-51725.97
buyer_2,Carmen,40,ES39209541173898369721,TRX_N-00994-99259618,2024-04-08T14:14:30,Zarautz,expenses,internet,-42.0,-51767.97
buyer_2,Carmen,40,ES39209541173898369721,TRX_N-00995-46308482,2024-04-08T10:42:46,Zarautz,expenses,water,-39.34,-51807.31
buyer_2,Carmen,40,ES39209541173898369721,TRX_N-00996-48738003,2024-04-08T18:00:51,Zarautz,expenses,repairs,-185.4,-51992.71
buyer_2,Carmen,40,ES39209541173898369721,TRX_N-00997-98749667,2024-04-09T11:47:09,Zarautz,expenses,clothing,-52.14,-52044.85
buyer_2,Carmen,40,ES39209541173898369721,TRX_N-00998-15651602,2024-04-11T20:25:01,Elciego,expenses,transport,-77.44,-52122.29
buyer_2,Carmen,40,ES39209541173898369721,TRX_N-00999-74837038,2024-04-11T23:46:41,Zarautz,expenses,cash,-100.0,-52222.29
buyer_2,Carmen,40,ES39209541173898369721,TRX_N-01000-06937470,2024-04-12T01:30:28,Zarautz,expenses,cash,-100.0,-52322.29
buyer_2,Carmen,40,ES39209541173898369721,TRX_N-01001-14480575,2024-04-12T08:39:20,Zarautz,expenses,travel,-1392.4,-53714.69
buyer_2,Carmen,40,ES39209541173898369721,TRX_N-01002-25968509,2024-04-13T14:42:34,Zarautz,expenses,transport,-46.51,-53761.2
buyer_2,Carmen,40,ES39209541173898369721,TRX_N-01003-94060599,2024-04-15T19:13:47,Zarautz,expenses,education,-51.06,-53812.26
buyer_2,Carmen,40,ES39209541173898369721,TRX_N-01004-09831437,2024-04-17T12:19:40,Zarautz,expenses,food,-64.32,-53876.58
buyer_2,Carmen,40,ES39209541173898369721,TRX_N-01005-10157405,2024-04-17T08:56:13,Zarautz,expenses,leisure,-78.08,-53954.66
buyer_2,Carmen,40,ES39209541173898369721,TRX_N-01006-25198749,2024-04-17T15:49:59,Zarautz,expenses,cash,-100.0,-54054.66
buyer_2,Carmen,40,ES39209541173898369721,TRX_N-01007-45475059,2024-04-21T21:45:38,Zarautz,expenses,cash,-100.0,-54154.66
buyer_2,Carmen,40,ES39209541173898369721,TRX_N-01008-29034071,2024-04-23T18:35:52,Zarautz,expenses,healthcare,-133.5,-54288.16
buyer_2,Carmen,40,ES39209541173898369721,TRX_N-01009-46025314,2024-04-23T15:00:59,Zarautz,expenses,repairs,-72.42,-54360.58
buyer_2,Carmen,40,ES39209541173898369721,TRX_N-01010-18595394,2024-04-24T09:44:57,Zarautz,expenses,leisure,-38.98,-54399.56
buyer_2,Carmen,40,ES39209541173898369721,TRX_N-01011-66327077,2024-04-25T08:49:46,Hondarribia,expenses,clothing,-123.85,-54523.41
buyer_2,Carmen,40,ES39209541173898369721,TRX_N-01012-58092251,2024-04-28T02:35:41,Zarautz,expenses,cash,-100.0,-54623.41
buyer_2,Carmen,40,ES39209541173898369721,TRX_N-01013-53139181,2024-04-29T21:27:28,Berango,expenses,cash,-100.0,-54723.41
buyer_2,Carmen,40,ES39209541173898369721,TRX_N-01014-50903549,2024-05-01T14:16:07,Zarautz,incomes,salary,1418.5,-53304.91
buyer_2,Carmen,40,ES39209541173898369721,TRX_N-01015-89732444,2024-05-01T14:16:07,Zarautz,incomes,salary_partner,1496.25,-51808.66
buyer_2,Carmen,40,ES39209541173898369721,TRX_N-01016-91182784,2024-05-01T21:07:04,Zarautz,expenses,appliances,-389.31,-52197.97
buyer_2,Carmen,40,ES39209541173898369721,TRX_N-01017-16862261,2024-05-03T09:38:09,Zarautz,expenses,food,-118.08,-52316.05
buyer_2,Carmen,40,ES39209541173898369721,TRX_N-01018-20253959,2024-05-03T11:48:12,Basauri,expenses,transport,-45.57,-52361.62
buyer_2,Carmen,40,ES39209541173898369721,TRX_N-01019-65692820,2024-05-03T18:37:29,Zarautz,expenses,cash,-100.0,-52461.62
buyer_2,Carmen,40,ES39209541173898369721,TRX_N-01020-11305743,2024-05-04T12:54:05,Zarautz,expenses,mortgage,-882.99,-53344.61
buyer_2,Carmen,40,ES39209541173898369721,TRX_N-01021-12609776,2024-05-04T06:49:24,Zarautz,expenses,gifts,-413.94,-53758.55
buyer_2,Carmen,40,ES39209541173898369721,TRX_N-01022-14171665,2024-05-05T13:48:07,Zarautz,expenses,electricity,-55.51,-53814.06
buyer_2,Carmen,40,ES39209541173898369721,TRX_N-01023-62819760,2024-05-05T18:15:18,Zarautz,expenses,phone,-36.06,-53850.12
buyer_2,Carmen,40,ES39209541173898369721,TRX_N-01024-78725717,2024-05-06T15:14:57,Zarautz,expenses,leisure,-51.15,-53901.27
buyer_2,Carmen,40,ES39209541173898369721,TRX_N-01025-36816371,2024-05-06T15:39:27,Zarautz,expenses,travel,-422.74,-54324.01
buyer_2,Carmen,40,ES39209541173898369721,TRX_N-01026-59620949,2024-05-07T08:56:08,Zarautz,expenses,water,-36.23,-54360.24
buyer_2,Carmen,40,ES39209541173898369721,TRX_N-01027-87729847,2024-05-08T12:24:14,Zarautz,expenses,gas,-109.7,-54469.94
buyer_2,Carmen,40,ES39209541173898369721,TRX_N-01028-54193934,2024-05-08T00:24:11,Zarautz,expenses,internet,-42.0,-54511.94
buyer_2,Carmen,40,ES39209541173898369721,TRX_N-01029-91786201,2024-05-10T19:29:27,Zarautz,expenses,cash,-100.0,-54611.94
buyer_2,Carmen,40,ES39209541173898369721,TRX_N-01030-28911772,2024-05-12T14:00:37,Pasaia,expenses,food,-102.95,-54714.89
buyer_2,Carmen,40,ES39209541173898369721,TRX_N-01031-96416995,2024-05-12T19:39:02,Zarautz,expenses,cash,-100.0,-54814.89
buyer_2,Carmen,40,ES39209541173898369721,TRX_N-01032-03141093,2024-05-13T12:04:31,Amurrio,expenses,cash,-100.0,-54914.89
buyer_2,Carmen,40,ES39209541173898369721,TRX_N-01033-24937402,2024-05-14T23:48:44,Zarautz,expenses,clothing,-51.29,-54966.18
buyer_2,Carmen,40,ES39209541173898369721,TRX_N-01034-76829448,2024-05-15T17:46:00,Zarautz,expenses,clothing,-63.19,-55029.37
buyer_2,Carmen,40,ES39209541173898369721,TRX_N-01035-25519670,2024-05-16T23:08:22,Zarautz,expenses,clothing,-151.59,-55180.96
buyer_2,Carmen,40,ES39209541173898369721,TRX_N-01036-06259948,2024-05-17T15:49:20,Zarautz,expenses,travel,-1583.0,-56763.96
buyer_2,Carmen,40,ES39209541173898369721,TRX_N-01037-78720794,2024-05-19T11:57:00,Zarautz,expenses,food,-104.52,-56868.48
buyer_2,Carmen,40,ES39209541173898369721,TRX_N-01038-80059094,2024-05-20T19:58:38,Zarautz,expenses,transport,-74.45,-56942.93
buyer_2,Carmen,40,ES39209541173898369721,TRX_N-01039-92635621,2024-05-20T00:26:24,Zarautz,expenses,leisure,-38.47,-56981.4
buyer_2,Carmen,40,ES39209541173898369721,TRX_N-01040-65332774,2024-05-20T22:52:35,Zarautz,expenses,children,-61.66,-57043.06
buyer_2,Carmen,40,ES39209541173898369721,TRX_N-01041-36557331,2024-05-21T10:50:28,Zarautz,expenses,gifts,-684.44,-57727.5
buyer_2,Carmen,40,ES39209541173898369721,TRX_N-01042-58719670,2024-05-22T16:19:28,Zarautz,expenses,cash,-100.0,-57827.5
buyer_2,Carmen,40,ES39209541173898369721,TRX_N-01043-50565997,2024-05-24T12:47:25,Zarautz,expenses,travel,-1509.33,-59336.83
buyer_2,Carmen,40,ES39209541173898369721,TRX_N-01044-99323121,2024-05-25T08:06:25,Zarautz,expenses,transport,-55.0,-59391.83
buyer_2,Carmen,40,ES39209541173898369721,TRX_N-01045-31670623,2024-05-25T10:27:39,Zarautz,expenses,cash,-100.0,-59491.83
buyer_2,Carmen,40,ES39209541173898369721,TRX_N-01046-85309654,2024-05-28T17:42:29,Zarautz,expenses,travel,-288.58,-59780.41
buyer_2,Carmen,40,ES39209541173898369721,TRX_N-01047-03695748,2024-05-30T14:25:47,Zarautz,expenses,cash,-100.0,-59880.41
buyer_2,Carmen,40,ES39209541173898369721,TRX_N-01048-94663741,2024-05-31T15:21:24,Zarautz,expenses,clothing,-116.96,-59997.37
buyer_2,Carmen,40,ES39209541173898369721,TRX_N-01049-29549287,2024-05-31T09:34:31,Zarautz,expenses,gifts,-472.58,-60469.95
buyer_2,Carmen,40,ES39209541173898369721,TRX_N-01050-59907885,2024-05-31T20:36:28,Zarautz,expenses,children,-183.19,-60653.14
buyer_2,Carmen,40,ES39209541173898369721,TRX_N-01051-10068972,2024-06-01T18:16:36,Zarautz,incomes,salary,1418.5,-59234.64
buyer_2,Carmen,40,ES39209541173898369721,TRX_N-01052-81003946,2024-06-01T18:16:36,Zarautz,incomes,salary_partner,1496.25,-57738.39
buyer_2,Carmen,40,ES39209541173898369721,TRX_N-01053-67938409,2024-06-01T18:16:36,Zarautz,incomes,salary_bonus,993.2,-56745.19
buyer_2,Carmen,40,ES39209541173898369721,TRX_N-01054-35250239,2024-06-01T18:16:36,Zarautz,incomes,salary_partner_bonus,1120.52,-55624.67
buyer_2,Carmen,40,ES39209541173898369721,TRX_N-01055-31431010,2024-06-01T08:40:09,Zarautz,expenses,transport,-59.3,-55683.97
buyer_2,Carmen,40,ES39209541173898369721,TRX_N-01056-15736140,2024-06-02T08:46:22,Zarautz,expenses,leisure,-65.92,-55749.89
buyer_2,Carmen,40,ES39209541173898369721,TRX_N-01057-46162421,2024-06-02T09:45:31,Zarautz,expenses,cash,-100.0,-55849.89
buyer_2,Carmen,40,ES39209541173898369721,TRX_N-01058-87464843,2024-06-04T12:12:24,Zarautz,expenses,mortgage,-882.99,-56732.88
buyer_2,Carmen,40,ES39209541173898369721,TRX_N-01059-75309020,2024-06-06T11:11:20,Zarautz,expenses,electricity,-50.04,-56782.92
buyer_2,Carmen,40,ES39209541173898369721,TRX_N-01060-73755752,2024-06-06T10:39:35,Zarautz,expenses,gas,-82.24,-56865.16
buyer_2,Carmen,40,ES39209541173898369721,TRX_N-01061-56969506,2024-06-06T10:50:24,Zarautz,expenses,internet,-42.0,-56907.16
buyer_2,Carmen,40,ES39209541173898369721,TRX_N-01062-42031322,2024-06-06T10:56:43,Zarautz,expenses,travel,-1770.53,-58677.69
buyer_2,Carmen,40,ES39209541173898369721,TRX_N-01063-14529772,2024-06-07T19:23:10,Zarautz,expenses,phone,-37.85,-58715.54
buyer_2,Carmen,40,ES39209541173898369721,TRX_N-01064-57014086,2024-06-08T20:45:00,Zarautz,expenses,water,-35.36,-58750.9
buyer_2,Carmen,40,ES39209541173898369721,TRX_N-01065-48948391,2024-06-08T13:07:08,Zarautz,expenses,cash,-100.0,-58850.9
buyer_2,Carmen,40,ES39209541173898369721,TRX_N-01066-72062331,2024-06-09T15:38:04,Zarautz,expenses,transport,-65.37,-58916.27
buyer_2,Carmen,40,ES39209541173898369721,TRX_N-01067-42218201,2024-06-09T19:43:28,Zarautz,expenses,leisure,-30.01,-58946.28
buyer_2,Carmen,40,ES39209541173898369721,TRX_N-01068-73863586,2024-06-11T18:03:56,Zarautz,expenses,leisure,-18.97,-58965.25
buyer_2,Carmen,40,ES39209541173898369721,TRX_N-01069-02370516,2024-06-12T10:49:25,Zarautz,expenses,leisure,-75.75,-59041.0
buyer_2,Carmen,40,ES39209541173898369721,TRX_N-01070-28195779,2024-06-17T19:52:24,Zarautz,expenses,leisure,-82.57,-59123.57
buyer_2,Carmen,40,ES39209541173898369721,TRX_N-01071-62113172,2024-06-18T20:01:43,Zarautz,expenses,leisure,-44.8,-59168.37
buyer_2,Carmen,40,ES39209541173898369721,TRX_N-01072-84577152,2024-06-18T06:14:31,Zarautz,expenses,travel,-1552.8,-60721.17
buyer_2,Carmen,40,ES39209541173898369721,TRX_N-01073-64299618,2024-06-18T20:58:43,Zarautz,expenses,repairs,-110.86,-60832.03
buyer_2,Carmen,40,ES39209541173898369721,TRX_N-01074-27921089,2024-06-19T16:40:13,Zarautz,expenses,cash,-100.0,-60932.03
buyer_2,Carmen,40,ES39209541173898369721,TRX_N-01075-37836078,2024-06-20T19:37:06,Zarautz,expenses,transport,-71.26,-61003.29
buyer_2,Carmen,40,ES39209541173898369721,TRX_N-01076-78167049,2024-06-22T08:58:16,Zuia,expenses,repairs,-83.65,-61086.94
buyer_2,Carmen,40,ES39209541173898369721,TRX_N-01077-23064128,2024-06-23T15:12:52,Portugalete,expenses,repairs,-72.29,-61159.23
buyer_2,Carmen,40,ES39209541173898369721,TRX_N-01078-89721168,2024-06-30T19:14:29,Zarautz,expenses,cash,-100.0,-61259.23
buyer_2,Carmen,40,ES39209541173898369721,TRX_N-01079-18185211,2024-07-01T10:40:58,Zarautz,incomes,salary,1418.5,-59840.73
buyer_2,Carmen,40,ES39209541173898369721,TRX_N-01080-79414262,2024-07-01T10:40:58,Zarautz,incomes,salary_partner,1496.25,-58344.48
buyer_2,Carmen,40,ES39209541173898369721,TRX_N-01081-50815608,2024-07-01T10:01:59,Errenteria,expenses,leisure,-37.53,-58382.01
buyer_2,Carmen,40,ES39209541173898369721,TRX_N-01082-53276412,2024-07-01T17:31:41,Zarautz,expenses,clothing,-119.97,-58501.98
buyer_2,Carmen,40,ES39209541173898369721,TRX_N-01083-11592386,2024-07-02T12:24:45,Zarautz,expenses,transport,-76.74,-58578.72
buyer_2,Carmen,40,ES39209541173898369721,TRX_N-01084-52126967,2024-07-03T13:34:28,Zarautz,expenses,education,-66.4,-58645.12
buyer_2,Carmen,40,ES39209541173898369721,TRX_N-01085-02531142,2024-07-03T15:33:26,Zarautz,expenses,cash,-100.0,-58745.12
buyer_2,Carmen,40,ES39209541173898369721,TRX_N-01086-59096228,2024-07-04T19:14:39,Zarautz,expenses,mortgage,-882.99,-59628.11
buyer_2,Carmen,40,ES39209541173898369721,TRX_N-01087-19043398,2024-07-05T00:49:58,Zarautz,expenses,water,-20.99,-59649.1
buyer_2,Carmen,40,ES39209541173898369721,TRX_N-01088-34610680,2024-07-05T12:36:20,Zarautz,expenses,electricity,-62.45,-59711.55
buyer_2,Carmen,40,ES39209541173898369721,TRX_N-01089-67907987,2024-07-05T08:55:29,Zarautz,expenses,transport,-75.1,-59786.65
buyer_2,Carmen,40,ES39209541173898369721,TRX_N-01090-55397160,2024-07-05T23:37:24,Zarautz,expenses,cash,-100.0,-59886.65
buyer_2,Carmen,40,ES39209541173898369721,TRX_N-01091-50126540,2024-07-06T11:38:42,Zarautz,expenses,gas,-111.83,-59998.48
buyer_2,Carmen,40,ES39209541173898369721,TRX_N-01092-62168480,2024-07-06T15:36:46,Zarautz,expenses,cash,-100.0,-60098.48
buyer_2,Carmen,40,ES39209541173898369721,TRX_N-01093-84551847,2024-07-07T16:58:31,Zarautz,expenses,cash,-100.0,-60198.48
buyer_2,Carmen,40,ES39209541173898369721,TRX_N-01094-37684631,2024-07-07T08:48:31,Zarautz,expenses,appliances,-77.65,-60276.13
buyer_2,Carmen,40,ES39209541173898369721,TRX_N-01095-29401753,2024-07-08T12:51:24,Zarautz,expenses,internet,-42.0,-60318.13
buyer_2,Carmen,40,ES39209541173898369721,TRX_N-01096-58406426,2024-07-08T16:04:11,Zarautz,expenses,phone,-31.88,-60350.01
buyer_2,Carmen,40,ES39209541173898369721,TRX_N-01097-66908462,2024-07-08T10:10:32,Sestao,expenses,cash,-100.0,-60450.01
buyer_2,Carmen,40,ES39209541173898369721,TRX_N-01098-38109218,2024-07-09T00:43:51,Zarautz,expenses,transport,-84.02,-60534.03
buyer_2,Carmen,40,ES39209541173898369721,TRX_N-01099-12580649,2024-07-10T09:14:23,Bermeo,expenses,cash,-100.0,-60634.03
buyer_2,Carmen,40,ES39209541173898369721,TRX_N-01100-38204611,2024-07-11T13:12:06,Zarautz,expenses,leisure,-66.03,-60700.06
buyer_2,Carmen,40,ES39209541173898369721,TRX_N-01101-50628693,2024-07-13T15:46:13,Zarautz,expenses,healthcare,-146.19,-60846.25
buyer_2,Carmen,40,ES39209541173898369721,TRX_N-01102-01987922,2024-07-15T18:19:45,Zarautz,expenses,leisure,-53.49,-60899.74
buyer_2,Carmen,40,ES39209541173898369721,TRX_N-01103-85055501,2024-07-16T11:03:02,Zarautz,expenses,cash,-100.0,-60999.74
buyer_2,Carmen,40,ES39209541173898369721,TRX_N-01104-05273392,2024-07-16T08:17:11,Labastida,expenses,repairs,-47.26,-61047.0
buyer_2,Carmen,40,ES39209541173898369721,TRX_N-01105-14963871,2024-07-17T23:09:41,Zarautz,expenses,transport,-61.88,-61108.88
buyer_2,Carmen,40,ES39209541173898369721,TRX_N-01106-51122567,2024-07-18T10:29:35,Zarautz,expenses,food,-121.3,-61230.18
buyer_2,Carmen,40,ES39209541173898369721,TRX_N-01107-34986045,2024-07-18T15:41:54,Salvatierra/Agurain,expenses,leisure,-33.8,-61263.98
buyer_2,Carmen,40,ES39209541173898369721,TRX_N-01108-00010008,2024-07-19T09:21:37,Zarautz,expenses,food,-124.72,-61388.7
buyer_2,Carmen,40,ES39209541173898369721,TRX_N-01109-47042684,2024-07-21T11:46:15,Arrasate,expenses,education,-61.28,-61449.98
buyer_2,Carmen,40,ES39209541173898369721,TRX_N-01110-32787483,2024-07-22T18:05:13,Zarautz,expenses,food,-61.19,-61511.17
buyer_2,Carmen,40,ES39209541173898369721,TRX_N-01111-50900667,2024-07-22T19:07:14,Eibar,expenses,transport,-57.98,-61569.15
buyer_2,Carmen,40,ES39209541173898369721,TRX_N-01112-13500591,2024-07-22T14:56:01,Zarautz,expenses,gifts,-552.16,-62121.31
buyer_2,Carmen,40,ES39209541173898369721,TRX_N-01113-13498378,2024-07-23T09:36:33,Zarautz,expenses,food,-102.18,-62223.49
buyer_2,Carmen,40,ES39209541173898369721,TRX_N-01114-54042728,2024-07-24T20:48:47,Zarautz,expenses,leisure,-51.65,-62275.14
buyer_2,Carmen,40,ES39209541173898369721,TRX_N-01115-40520302,2024-07-26T11:23:05,Zarautz,expenses,repairs,-85.19,-62360.33
buyer_2,Carmen,40,ES39209541173898369721,TRX_N-01116-26547465,2024-07-27T19:15:22,Zarautz,expenses,cash,-100.0,-62460.33
buyer_2,Carmen,40,ES39209541173898369721,TRX_N-01117-48089940,2024-07-29T13:14:38,Zarautz,expenses,leisure,-61.34,-62521.67
buyer_2,Carmen,40,ES39209541173898369721,TRX_N-01118-69781032,2024-07-29T17:39:35,Zarautz,expenses,cash,-100.0,-62621.67
buyer_2,Carmen,40,ES39209541173898369721,TRX_N-01119-96621238,2024-07-31T14:25:29,Zarautz,expenses,leisure,-84.39,-62706.06
buyer_2,Carmen,40,ES39209541173898369721,TRX_N-01120-68701653,2024-08-01T18:11:20,Zarautz,incomes,salary,1418.5,-61287.56
buyer_2,Carmen,40,ES39209541173898369721,TRX_N-01121-00029894,2024-08-01T18:11:20,Zarautz,incomes,salary_partner,1496.25,-59791.31
buyer_2,Carmen,40,ES39209541173898369721,TRX_N-01122-40523060,2024-08-01T18:11:20,Zarautz,incomes,extra_income,159.61,-59631.7
buyer_2,Carmen,40,ES39209541173898369721,TRX_N-01123-07098264,2024-08-01T18:33:29,Zarautz,expenses,clothing,-87.1,-59718.8
buyer_2,Carmen,40,ES39209541173898369721,TRX_N-01124-20422711,2024-08-01T09:38:17,Zarautz,expenses,cash,-100.0,-59818.8
buyer_2,Carmen,40,ES39209541173898369721,TRX_N-01125-79676806,2024-08-02T07:57:30,Zarautz,expenses,cash,-100.0,-59918.8
buyer_2,Carmen,40,ES39209541173898369721,TRX_N-01126-79981193,2024-08-04T18:31:10,Zarautz,expenses,mortgage,-882.99,-60801.79
buyer_2,Carmen,40,ES39209541173898369721,TRX_N-01127-54882175,2024-08-05T14:29:12,Zarautz,expenses,children,-196.34,-60998.13
buyer_2,Carmen,40,ES39209541173898369721,TRX_N-01128-21096639,2024-08-06T13:49:46,Zarautz,expenses,water,-31.73,-61029.86
buyer_2,Carmen,40,ES39209541173898369721,TRX_N-01129-01773592,2024-08-07T08:12:36,Zarautz,expenses,gas,-90.06,-61119.92
buyer_2,Carmen,40,ES39209541173898369721,TRX_N-01130-55439191,2024-08-07T18:07:45,Zarautz,expenses,phone,-35.66,-61155.58
buyer_2,Carmen,40,ES39209541173898369721,TRX_N-01131-87319591,2024-08-07T16:30:10,Zarautz,expenses,food,-83.48,-61239.06
buyer_2,Carmen,40,ES39209541173898369721,TRX_N-01132-28848252,2024-08-07T07:41:43,Zarautz,expenses,appliances,-384.17,-61623.23
buyer_2,Carmen,40,ES39209541173898369721,TRX_N-01133-87702649,2024-08-08T02:55:14,Zarautz,expenses,internet,-42.0,-61665.23
buyer_2,Carmen,40,ES39209541173898369721,TRX_N-01134-88689594,2024-08-08T12:55:59,Zarautz,expenses,electricity,-72.93,-61738.16
buyer_2,Carmen,40,ES39209541173898369721,TRX_N-01135-75984309,2024-08-08T23:30:01,Zarautz,expenses,leisure,-65.33,-61803.49
buyer_2,Carmen,40,ES39209541173898369721,TRX_N-01136-00083252,2024-08-09T18:33:26,Zarautz,expenses,education,-70.44,-61873.93
buyer_2,Carmen,40,ES39209541173898369721,TRX_N-01137-15991738,2024-08-12T20:54:54,Durango,expenses,appliances,-226.31,-62100.24
buyer_2,Carmen,40,ES39209541173898369721,TRX_N-01138-56407526,2024-08-13T10:36:54,Iruña de Oca,expenses,transport,-73.07,-62173.31
buyer_2,Carmen,40,ES39209541173898369721,TRX_N-01139-77041528,2024-08-13T19:15:53,Llodio,expenses,travel,-1187.6,-63360.91
buyer_2,Carmen,40,ES39209541173898369721,TRX_N-01140-84794919,2024-08-15T13:28:11,Zarautz,expenses,cash,-100.0,-63460.91
buyer_2,Carmen,40,ES39209541173898369721,TRX_N-01141-30876407,2024-08-24T10:47:57,Zarautz,expenses,leisure,-59.43,-63520.34
buyer_2,Carmen,40,ES39209541173898369721,TRX_N-01142-42009293,2024-08-25T18:46:46,Zarautz,expenses,transport,-88.46,-63608.8
buyer_2,Carmen,40,ES39209541173898369721,TRX_N-01143-66595770,2024-08-27T13:08:58,Zarautz,expenses,cash,-100.0,-63708.8
buyer_2,Carmen,40,ES39209541173898369721,TRX_N-01144-55920055,2024-08-28T08:12:22,Zarautz,expenses,leisure,-84.11,-63792.91
buyer_2,Carmen,40,ES39209541173898369721,TRX_N-01145-50649492,2024-08-31T15:54:50,Zarautz,expenses,cash,-100.0,-63892.91
buyer_2,Carmen,40,ES39209541173898369721,TRX_N-01146-87333352,2024-09-01T18:26:31,Zarautz,incomes,salary,1418.5,-62474.41
buyer_2,Carmen,40,ES39209541173898369721,TRX_N-01147-53232716,2024-09-01T18:26:31,Zarautz,incomes,salary_partner,1496.25,-60978.16
buyer_2,Carmen,40,ES39209541173898369721,TRX_N-01148-13786540,2024-09-01T15:53:59,Zarautz,expenses,food,-73.39,-61051.55
buyer_2,Carmen,40,ES39209541173898369721,TRX_N-01149-15617029,2024-09-04T17:31:46,Zarautz,expenses,mortgage,-882.99,-61934.54
buyer_2,Carmen,40,ES39209541173898369721,TRX_N-01150-24354437,2024-09-04T17:52:22,Zarautz,expenses,cash,-100.0,-62034.54
buyer_2,Carmen,40,ES39209541173898369721,TRX_N-01151-93932641,2024-09-04T12:23:02,Zarautz,expenses,appliances,-252.37,-62286.91
buyer_2,Carmen,40,ES39209541173898369721,TRX_N-01152-87820469,2024-09-05T20:04:23,Zarautz,expenses,phone,-35.45,-62322.36
buyer_2,Carmen,40,ES39209541173898369721,TRX_N-01153-95406755,2024-09-06T16:33:19,Zarautz,expenses,electricity,-27.8,-62350.16
buyer_2,Carmen,40,ES39209541173898369721,TRX_N-01154-39650159,2024-09-07T15:26:51,Zarautz,expenses,gas,-77.79,-62427.95
buyer_2,Carmen,40,ES39209541173898369721,TRX_N-01155-85088762,2024-09-07T11:25:05,Zarautz,expenses,internet,-42.0,-62469.95
buyer_2,Carmen,40,ES39209541173898369721,TRX_N-01156-82866598,2024-09-07T19:09:28,Zarautz,expenses,children,-224.2,-62694.15
buyer_2,Carmen,40,ES39209541173898369721,TRX_N-01157-65963266,2024-09-08T13:16:25,Zarautz,expenses,water,-40.46,-62734.61
buyer_2,Carmen,40,ES39209541173898369721,TRX_N-01158-15149268,2024-09-10T11:22:08,Zarautz,expenses,cash,-100.0,-62834.61
buyer_2,Carmen,40,ES39209541173898369721,TRX_N-01159-76485691,2024-09-10T08:35:17,Zarautz,expenses,repairs,-142.39,-62977.0
buyer_2,Carmen,40,ES39209541173898369721,TRX_N-01160-37245030,2024-09-12T11:22:45,Zarautz,expenses,education,-77.93,-63054.93
buyer_2,Carmen,40,ES39209541173898369721,TRX_N-01161-38167233,2024-09-12T17:55:11,Zarautz,expenses,cash,-100.0,-63154.93
buyer_2,Carmen,40,ES39209541173898369721,TRX_N-01162-13219665,2024-09-15T09:23:50,Zarautz,expenses,food,-115.75,-63270.68
buyer_2,Carmen,40,ES39209541173898369721,TRX_N-01163-10685998,2024-09-16T16:40:45,Zarautz,expenses,leisure,-34.22,-63304.9
buyer_2,Carmen,40,ES39209541173898369721,TRX_N-01164-20646994,2024-09-16T11:34:35,Galdakao,expenses,repairs,-167.68,-63472.58
buyer_2,Carmen,40,ES39209541173898369721,TRX_N-01165-64537163,2024-09-17T08:29:09,Zarautz,expenses,clothing,-131.88,-63604.46
buyer_2,Carmen,40,ES39209541173898369721,TRX_N-01166-00238782,2024-09-18T05:27:47,Zarautz,expenses,leisure,-73.41,-63677.87
buyer_2,Carmen,40,ES39209541173898369721,TRX_N-01167-94790901,2024-09-18T22:11:17,Zarautz,expenses,healthcare,-136.13,-63814.0
buyer_2,Carmen,40,ES39209541173898369721,TRX_N-01168-14055722,2024-09-19T13:56:16,Zarautz,expenses,education,-53.66,-63867.66
buyer_2,Carmen,40,ES39209541173898369721,TRX_N-01169-29783885,2024-09-19T10:26:35,Zarautz,expenses,gifts,-477.15,-64344.81
buyer_2,Carmen,40,ES39209541173898369721,TRX_N-01170-54081613,2024-09-20T09:14:01,Sestao,expenses,leisure,-50.12,-64394.93
buyer_2,Carmen,40,ES39209541173898369721,TRX_N-01171-31246848,2024-09-21T23:59:52,Zarautz,expenses,cash,-100.0,-64494.93
buyer_2,Carmen,40,ES39209541173898369721,TRX_N-01172-79575678,2024-09-23T15:51:59,Zarautz,expenses,food,-103.66,-64598.59
buyer_2,Carmen,40,ES39209541173898369721,TRX_N-01173-42700299,2024-09-23T22:06:02,Zarautz,expenses,travel,-306.01,-64904.6
buyer_2,Carmen,40,ES39209541173898369721,TRX_N-01174-94053629,2024-09-24T15:09:49,Zarautz,expenses,education,-55.83,-64960.43
buyer_2,Carmen,40,ES39209541173898369721,TRX_N-01175-11859944,2024-09-24T15:46:02,Zarautz,expenses,cash,-100.0,-65060.43
buyer_2,Carmen,40,ES39209541173898369721,TRX_N-01176-90752674,2024-09-27T22:02:28,Zarautz,expenses,appliances,-185.39,-65245.82
buyer_2,Carmen,40,ES39209541173898369721,TRX_N-01177-76413916,2024-09-28T15:28:24,Zarautz,expenses,food,-106.64,-65352.46
buyer_2,Carmen,40,ES39209541173898369721,TRX_N-01178-53708971,2024-09-28T11:38:11,Zarautz,expenses,transport,-79.07,-65431.53
buyer_2,Carmen,40,ES39209541173898369721,TRX_N-01179-81375509,2024-09-28T18:10:02,Zarautz,expenses,cash,-100.0,-65531.53
buyer_2,Carmen,40,ES39209541173898369721,TRX_N-01180-63458202,2024-09-29T12:46:59,Hondarribia,expenses,transport,-43.63,-65575.16
buyer_2,Carmen,40,ES39209541173898369721,TRX_N-01181-12743227,2024-09-29T18:20:04,Zarautz,expenses,leisure,-82.23,-65657.39
buyer_2,Carmen,40,ES39209541173898369721,TRX_N-01182-54390075,2024-09-30T07:31:01,Labastida,expenses,education,-44.41,-65701.8
buyer_2,Carmen,40,ES39209541173898369721,TRX_N-01183-06362731,2024-10-01T12:30:54,Zarautz,incomes,salary,1418.5,-64283.3
buyer_2,Carmen,40,ES39209541173898369721,TRX_N-01184-63545719,2024-10-01T12:30:54,Zarautz,incomes,salary_partner,1496.25,-62787.05
buyer_2,Carmen,40,ES39209541173898369721,TRX_N-01185-08642324,2024-10-01T04:45:21,Zarautz,expenses,food,-91.37,-62878.42
buyer_2,Carmen,40,ES39209541173898369721,TRX_N-01186-77356259,2024-10-01T13:16:05,Zarautz,expenses,clothing,-87.87,-62966.29
buyer_2,Carmen,40,ES39209541173898369721,TRX_N-01187-75728543,2024-10-03T15:33:15,Zarautz,expenses,leisure,-53.67,-63019.96
buyer_2,Carmen,40,ES39209541173898369721,TRX_N-01188-08356199,2024-10-03T05:46:52,Zarautz,expenses,cash,-100.0,-63119.96
buyer_2,Carmen,40,ES39209541173898369721,TRX_N-01189-59354783,2024-10-04T18:54:33,Zarautz,expenses,mortgage,-882.99,-64002.95
buyer_2,Carmen,40,ES39209541173898369721,TRX_N-01190-96771488,2024-10-05T19:49:06,Zarautz,expenses,water,-30.18,-64033.13
buyer_2,Carmen,40,ES39209541173898369721,TRX_N-01191-96992747,2024-10-06T10:44:50,Zarautz,expenses,electricity,-49.49,-64082.62
buyer_2,Carmen,40,ES39209541173898369721,TRX_N-01192-83936000,2024-10-06T08:17:57,Zarautz,expenses,gas,-33.93,-64116.55
buyer_2,Carmen,40,ES39209541173898369721,TRX_N-01193-33104823,2024-10-06T02:18:12,Santurtzi,expenses,gifts,-239.44,-64355.99
buyer_2,Carmen,40,ES39209541173898369721,TRX_N-01194-88179185,2024-10-07T19:59:48,Zarautz,expenses,leisure,-46.5,-64402.49
buyer_2,Carmen,40,ES39209541173898369721,TRX_N-01195-65695779,2024-10-07T10:02:00,Zarautz,expenses,gifts,-718.26,-65120.75
buyer_2,Carmen,40,ES39209541173898369721,TRX_N-01196-90824420,2024-10-08T22:52:15,Zarautz,expenses,internet,-42.0,-65162.75
buyer_2,Carmen,40,ES39209541173898369721,TRX_N-01197-65346418,2024-10-08T21:13:51,Zarautz,expenses,phone,-37.52,-65200.27
buyer_3,Ana,35,ES04209538845447732310,TRX_N-00001-36774532,2022-01-01T09:39:06,Amurrio,incomes,salary,1229.29,2624.27
buyer_3,Ana,35,ES04209538845447732310,TRX_N-00002-17950905,2022-01-01T09:39:06,Amurrio,incomes,salary_partner,1119.91,3744.18
buyer_3,Ana,35,ES04209538845447732310,TRX_N-00003-42085122,2022-01-01T11:52:08,Amurrio,expenses,cash,-100.0,3644.18
buyer_3,Ana,35,ES04209538845447732310,TRX_N-00004-72639428,2022-01-04T20:07:16,Amurrio,expenses,mortgage,-874.64,2769.54
buyer_3,Ana,35,ES04209538845447732310,TRX_N-00005-76642300,2022-01-05T15:06:15,Amurrio,expenses,internet,-42.0,2727.54
buyer_3,Ana,35,ES04209538845447732310,TRX_N-00006-75492217,2022-01-06T10:18:10,Amurrio,expenses,water,-33.81,2693.73
buyer_3,Ana,35,ES04209538845447732310,TRX_N-00007-49808629,2022-01-06T18:08:38,Amurrio,expenses,phone,-44.07,2649.66
buyer_3,Ana,35,ES04209538845447732310,TRX_N-00008-32984640,2022-01-07T17:43:22,Amurrio,expenses,electricity,-50.23,2599.43
buyer_3,Ana,35,ES04209538845447732310,TRX_N-00009-70857473,2022-01-07T13:07:53,Amurrio,expenses,children,-84.4,2515.03
buyer_3,Ana,35,ES04209538845447732310,TRX_N-00010-94060860,2022-01-08T14:39:58,Amurrio,expenses,gas,-71.2,2443.83
buyer_3,Ana,35,ES04209538845447732310,TRX_N-00011-76625753,2022-01-10T15:42:28,Amurrio,expenses,food,-92.71,2351.12
buyer_3,Ana,35,ES04209538845447732310,TRX_N-00012-33521665,2022-01-10T13:13:38,Amurrio,expenses,cash,-100.0,2251.12
buyer_3,Ana,35,ES04209538845447732310,TRX_N-00013-36423630,2022-01-11T15:22:57,Amurrio,expenses,transport,-85.52,2165.6
buyer_3,Ana,35,ES04209538845447732310,TRX_N-00014-86419060,2022-01-17T15:06:17,Donostia,expenses,gifts,-77.93,2087.67
buyer_3,Ana,35,ES04209538845447732310,TRX_N-00015-77709128,2022-01-18T13:07:29,Amurrio,expenses,clothing,-128.88,1958.79
buyer_3,Ana,35,ES04209538845447732310,TRX_N-00016-77669339,2022-01-18T09:49:43,Amurrio,expenses,cash,-100.0,1858.79
buyer_3,Ana,35,ES04209538845447732310,TRX_N-00017-09112823,2022-01-19T14:24:41,Amurrio,expenses,gifts,-472.98,1385.81
buyer_3,Ana,35,ES04209538845447732310,TRX_N-00018-63995572,2022-01-20T13:22:50,Amurrio,expenses,education,-60.82,1324.99
buyer_3,Ana,35,ES04209538845447732310,TRX_N-00019-43754057,2022-01-21T17:07:51,Amurrio,expenses,food,-118.48,1206.51
buyer_3,Ana,35,ES04209538845447732310,TRX_N-00020-47530649,2022-01-21T21:32:56,Galdakao,expenses,leisure,-52.17,1154.34
buyer_3,Ana,35,ES04209538845447732310,TRX_N-00021-58966087,2022-01-25T15:46:28,Amurrio,expenses,cash,-100.0,1054.34
buyer_3,Ana,35,ES04209538845447732310,TRX_N-00022-71335379,2022-01-26T16:10:35,Amurrio,expenses,transport,-54.47,999.87
buyer_3,Ana,35,ES04209538845447732310,TRX_N-00023-43715830,2022-01-28T08:52:30,Amurrio,expenses,repairs,-290.94,708.93
buyer_3,Ana,35,ES04209538845447732310,TRX_N-00024-07650380,2022-01-29T19:10:01,Amurrio,expenses,cash,-100.0,608.93
buyer_3,Ana,35,ES04209538845447732310,TRX_N-00025-63007524,2022-01-30T18:49:40,Amurrio,expenses,food,-84.51,524.42
buyer_3,Ana,35,ES04209538845447732310,TRX_N-00026-61638505,2022-01-31T10:03:10,Amurrio,expenses,transport,-66.51,457.91
buyer_3,Ana,35,ES04209538845447732310,TRX_N-00027-78798583,2022-01-31T14:14:14,Amurrio,expenses,leisure,-37.25,420.66
buyer_3,Ana,35,ES04209538845447732310,TRX_N-00028-33488346,2022-01-31T16:50:54,Amurrio,expenses,clothing,-81.44,339.22
buyer_3,Ana,35,ES04209538845447732310,TRX_N-00029-76704164,2022-01-31T01:39:22,Irun,expenses,appliances,-161.82,177.4
buyer_3,Ana,35,ES04209538845447732310,TRX_N-00030-04795626,2022-02-01T17:55:03,Amurrio,incomes,salary,1229.29,1406.69
buyer_3,Ana,35,ES04209538845447732310,TRX_N-00031-66841040,2022-02-01T17:55:03,Amurrio,incomes,salary_partner,1119.91,2526.6
buyer_3,Ana,35,ES04209538845447732310,TRX_N-00032-71203972,2022-02-02T01:46:20,Errenteria,expenses,transport,-47.82,2478.78
buyer_3,Ana,35,ES04209538845447732310,TRX_N-00033-20842100,2022-02-02T17:53:39,Amurrio,expenses,leisure,-78.8,2399.98
buyer_3,Ana,35,ES04209538845447732310,TRX_N-00034-44503281,2022-02-04T16:41:17,Amurrio,expenses,mortgage,-874.64,1525.34
buyer_3,Ana,35,ES04209538845447732310,TRX_N-00035-37250458,2022-02-04T22:11:48,Amurrio,expenses,repairs,-268.24,1257.1
buyer_3,Ana,35,ES04209538845447732310,TRX_N-00036-63732408,2022-02-05T11:23:27,Amurrio,expenses,electricity,-43.96,1213.14
buyer_3,Ana,35,ES04209538845447732310,TRX_N-00037-32760731,2022-02-05T11:38:56,Amurrio,expenses,gas,-83.91,1129.23
buyer_3,Ana,35,ES04209538845447732310,TRX_N-00038-84259110,2022-02-05T22:02:02,Amurrio,expenses,internet,-42.0,1087.23
buyer_3,Ana,35,ES04209538845447732310,TRX_N-00039-15897161,2022-02-06T15:25:20,Amurrio,expenses,transport,-66.18,1021.05
buyer_3,Ana,35,ES04209538845447732310,TRX_N-00040-34198101,2022-02-06T13:01:31,Amurrio,expenses,education,-70.07,950.98
buyer_3,Ana,35,ES04209538845447732310,TRX_N-00041-98687746,2022-02-06T11:32:29,Amurrio,expenses,travel,-737.02,213.96
buyer_3,Ana,35,ES04209538845447732310,TRX_N-00042-68212712,2022-02-06T10:58:03,Amurrio,expenses,appliances,-364.31,-150.35
buyer_3,Ana,35,ES04209538845447732310,TRX_N-00043-69702475,2022-02-07T09:51:21,Amurrio,expenses,food,-93.1,-243.45
buyer_3,Ana,35,ES04209538845447732310,TRX_N-00044-28417167,2022-02-08T12:54:08,Amurrio,expenses,water,-36.2,-279.65
buyer_3,Ana,35,ES04209538845447732310,TRX_N-00045-47439225,2022-02-08T19:19:31,Amurrio,expenses,phone,-32.62,-312.27
buyer_3,Ana,35,ES04209538845447732310,TRX_N-00046-65506093,2022-02-08T18:09:17,Amurrio,expenses,transport,-85.66,-397.93
buyer_3,Ana,35,ES04209538845447732310,TRX_N-00047-33248670,2022-02-08T18:32:01,Amurrio,expenses,cash,-100.0,-497.93
buyer_3,Ana,35,ES04209538845447732310,TRX_N-00048-68660146,2022-02-09T12:59:57,Amurrio,expenses,transport,-75.41,-573.34
buyer_3,Ana,35,ES04209538845447732310,TRX_N-00049-02908582,2022-02-09T19:40:31,Alegría-Dulantzi,expenses,gifts,-843.67,-1417.01
buyer_3,Ana,35,ES04209538845447732310,TRX_N-00050-67971761,2022-02-11T23:53:32,Amurrio,expenses,food,-121.71,-1538.72
buyer_3,Ana,35,ES04209538845447732310,TRX_N-00051-43066859,2022-02-11T18:34:37,Amurrio,expenses,leisure,-71.97,-1610.69
buyer_3,Ana,35,ES04209538845447732310,TRX_N-00052-52415720,2022-02-13T22:20:26,Getxo,expenses,gifts,-625.08,-2235.77
buyer_3,Ana,35,ES04209538845447732310,TRX_N-00053-76598070,2022-02-14T21:19:16,Amurrio,expenses,leisure,-75.07,-2310.84
buyer_3,Ana,35,ES04209538845447732310,TRX_N-00054-82307437,2022-02-16T17:01:27,Bermeo,expenses,cash,-100.0,-2410.84
buyer_3,Ana,35,ES04209538845447732310,TRX_N-00055-70686018,2022-02-18T15:38:26,Amurrio,expenses,repairs,-111.85,-2522.69
buyer_3,Ana,35,ES04209538845447732310,TRX_N-00056-34227040,2022-02-19T08:56:42,Amurrio,expenses,transport,-68.58,-2591.27
buyer_3,Ana,35,ES04209538845447732310,TRX_N-00057-72603672,2022-02-21T19:46:52,Berango,expenses,transport,-83.68,-2674.95
buyer_3,Ana,35,ES04209538845447732310,TRX_N-00058-49045291,2022-02-22T08:30:12,Amurrio,expenses,food,-86.85,-2761.8
buyer_3,Ana,35,ES04209538845447732310,TRX_N-00059-21181626,2022-02-22T03:30:37,Amurrio,expenses,appliances,-352.28,-3114.08
buyer_3,Ana,35,ES04209538845447732310,TRX_N-00060-70937539,2022-02-23T16:11:14,Amurrio,expenses,transport,-46.19,-3160.27
buyer_3,Ana,35,ES04209538845447732310,TRX_N-00061-82655590,2022-02-24T09:16:29,Amurrio,expenses,leisure,-56.26,-3216.53
buyer_3,Ana,35,ES04209538845447732310,TRX_N-00062-36327836,2022-02-25T05:39:24,Amurrio,expenses,gifts,-458.24,-3674.77
buyer_3,Ana,35,ES04209538845447732310,TRX_N-00063-76896292,2022-02-26T10:41:35,Amurrio,expenses,cash,-100.0,-3774.77
buyer_3,Ana,35,ES04209538845447732310,TRX_N-00064-49253465,2022-02-27T10:23:19,Amurrio,expenses,transport,-77.45,-3852.22
buyer_3,Ana,35,ES04209538845447732310,TRX_N-00065-92003342,2022-02-28T14:05:56,Amurrio,expenses,food,-104.84,-3957.06
buyer_3,Ana,35,ES04209538845447732310,TRX_N-00066-60058127,2022-02-28T04:39:14,Amurrio,expenses,children,-89.59,-4046.65
buyer_3,Ana,35,ES04209538845447732310,TRX_N-00067-81887699,2022-03-01T12:50:08,Amurrio,incomes,salary,1229.29,-2817.36
buyer_3,Ana,35,ES04209538845447732310,TRX_N-00068-76150064,2022-03-01T12:50:08,Amurrio,incomes,salary_partner,1119.91,-1697.45
buyer_3,Ana,35,ES04209538845447732310,TRX_N-00069-99036934,2022-03-01T12:50:08,Amurrio,incomes,extra_income,209.99,-1487.46
buyer_3,Ana,35,ES04209538845447732310,TRX_N-00070-93427009,2022-03-01T12:16:43,Amurrio,expenses,transport,-77.72,-1565.18
buyer_3,Ana,35,ES04209538845447732310,TRX_N-00071-46365601,2022-03-03T04:50:37,Irun,expenses,clothing,-125.72,-1690.9
buyer_3,Ana,35,ES04209538845447732310,TRX_N-00072-80541055,2022-03-04T14:14:27,Amurrio,expenses,mortgage,-874.64,-2565.54
buyer_3,Ana,35,ES04209538845447732310,TRX_N-00073-33516440,2022-03-05T08:54:38,Amurrio,expenses,internet,-42.0,-2607.54
buyer_3,Ana,35,ES04209538845447732310,TRX_N-00074-72653256,2022-03-05T13:31:37,Amurrio,expenses,leisure,-65.03,-2672.57
buyer_3,Ana,35,ES04209538845447732310,TRX_N-00075-29771703,2022-03-05T19:36:21,Amurrio,expenses,cash,-100.0,-2772.57
buyer_3,Ana,35,ES04209538845447732310,TRX_N-00076-28935204,2022-03-06T15:45:20,Amurrio,expenses,electricity,-51.03,-2823.6
buyer_3,Ana,35,ES04209538845447732310,TRX_N-00077-31383859,2022-03-06T09:51:25,Amurrio,expenses,phone,-36.42,-2860.02
buyer_3,Ana,35,ES04209538845447732310,TRX_N-00078-16544372,2022-03-06T09:09:35,Amurrio,expenses,transport,-87.28,-2947.3
buyer_3,Ana,35,ES04209538845447732310,TRX_N-00079-82509303,2022-03-08T19:59:58,Amurrio,expenses,water,-44.39,-2991.69
buyer_3,Ana,35,ES04209538845447732310,TRX_N-00080-87935445,2022-03-08T18:59:05,Amurrio,expenses,gas,-98.32,-3090.01
buyer_3,Ana,35,ES04209538845447732310,TRX_N-00081-75616186,2022-03-09T16:46:24,Durango,expenses,repairs,-122.56,-3212.57
buyer_3,Ana,35,ES04209538845447732310,TRX_N-00082-41828634,2022-03-11T18:02:36,Amurrio,expenses,transport,-69.33,-3281.9
buyer_3,Ana,35,ES04209538845447732310,TRX_N-00083-19227935,2022-03-11T15:26:00,Amurrio,expenses,education,-60.8,-3342.7
buyer_3,Ana,35,ES04209538845447732310,TRX_N-00084-83927943,2022-03-13T08:12:41,Amurrio,expenses,food,-101.33,-3444.03
buyer_3,Ana,35,ES04209538845447732310,TRX_N-00085-71625875,2022-03-13T09:51:55,Amurrio,expenses,leisure,-58.22,-3502.25
buyer_3,Ana,35,ES04209538845447732310,TRX_N-00086-67180991,2022-03-13T08:03:18,Amurrio,expenses,gifts,-338.0,-3840.25
buyer_3,Ana,35,ES04209538845447732310,TRX_N-00087-17827368,2022-03-16T16:02:23,Amurrio,expenses,transport,-58.78,-3899.03
buyer_3,Ana,35,ES04209538845447732310,TRX_N-00088-09619256,2022-03-16T14:13:52,Amurrio,expenses,leisure,-32.13,-3931.16
buyer_3,Ana,35,ES04209538845447732310,TRX_N-00089-33311955,2022-03-17T08:15:56,Amurrio,expenses,transport,-86.58,-4017.74
buyer_3,Ana,35,ES04209538845447732310,TRX_N-00090-69341054,2022-03-18T14:58:45,Durango,expenses,cash,-100.0,-4117.74
buyer_3,Ana,35,ES04209538845447732310,TRX_N-00091-91150502,2022-03-20T11:36:47,Amurrio,expenses,repairs,-185.85,-4303.59
buyer_3,Ana,35,ES04209538845447732310,TRX_N-00092-14995990,2022-03-21T17:00:56,Amurrio,expenses,food,-78.26,-4381.85
buyer_3,Ana,35,ES04209538845447732310,TRX_N-00093-65373808,2022-03-21T17:36:50,Amurrio,expenses,repairs,-155.47,-4537.32
buyer_3,Ana,35,ES04209538845447732310,TRX_N-00094-70277840,2022-03-22T10:08:30,Andoain,expenses,cash,-100.0,-4637.32
buyer_3,Ana,35,ES04209538845447732310,TRX_N-00095-37826408,2022-03-24T22:27:24,Amurrio,expenses,leisure,-46.16,-4683.48
buyer_3,Ana,35,ES04209538845447732310,TRX_N-00096-56667676,2022-03-24T21:05:05,Amurrio,expenses,repairs,-190.56,-4874.04
buyer_3,Ana,35,ES04209538845447732310,TRX_N-00097-39775728,2022-03-25T16:54:31,Errenteria,expenses,food,-113.01,-4987.05
buyer_3,Ana,35,ES04209538845447732310,TRX_N-00098-79739348,2022-03-27T20:44:56,Amurrio,expenses,leisure,-81.56,-5068.61
buyer_3,Ana,35,ES04209538845447732310,TRX_N-00099-62251432,2022-03-27T21:02:24,Amurrio,expenses,appliances,-222.33,-5290.94
buyer_3,Ana,35,ES04209538845447732310,TRX_N-00100-97590601,2022-03-27T11:53:05,Amurrio,expenses,repairs,-234.4,-5525.34
buyer_3,Ana,35,ES04209538845447732310,TRX_N-00101-33840479,2022-03-28T18:25:59,Amurrio,expenses,repairs,-106.33,-5631.67
buyer_3,Ana,35,ES04209538845447732310,TRX_N-00102-35876109,2022-03-31T08:23:35,Amurrio,expenses,food,-95.21,-5726.88
buyer_3,Ana,35,ES04209538845447732310,TRX_N-00103-57044960,2022-03-31T10:00:10,Amurrio,expenses,healthcare,-159.53,-5886.41
buyer_3,Ana,35,ES04209538845447732310,TRX_N-00104-02859069,2022-04-01T19:57:44,Amurrio,incomes,salary,1229.29,-4657.12
buyer_3,Ana,35,ES04209538845447732310,TRX_N-00105-97049399,2022-04-01T19:57:44,Amurrio,incomes,salary_partner,1119.91,-3537.21
buyer_3,Ana,35,ES04209538845447732310,TRX_N-00106-62333331,2022-04-01T14:11:57,Amurrio,expenses,clothing,-136.87,-3674.08
buyer_3,Ana,35,ES04209538845447732310,TRX_N-00107-86106410,2022-04-02T08:08:30,Amurrio,expenses,cash,-100.0,-3774.08
buyer_3,Ana,35,ES04209538845447732310,TRX_N-00108-74205847,2022-04-03T20:51:31,Amurrio,expenses,food,-91.63,-3865.71
buyer_3,Ana,35,ES04209538845447732310,TRX_N-00109-93702137,2022-04-03T13:20:53,Pasaia,expenses,cash,-100.0,-3965.71
buyer_3,Ana,35,ES04209538845447732310,TRX_N-00110-07488868,2022-04-04T04:10:48,Amurrio,expenses,mortgage,-874.64,-4840.35
buyer_3,Ana,35,ES04209538845447732310,TRX_N-00111-52962197,2022-04-05T19:43:01,Sopela,expenses,education,-63.23,-4903.58
buyer_3,Ana,35,ES04209538845447732310,TRX_N-00112-90935988,2022-04-07T11:01:03,Amurrio,expenses,water,-29.76,-4933.34
buyer_3,Ana,35,ES04209538845447732310,TRX_N-00113-89097891,2022-04-07T14:36:32,Amurrio,expenses,electricity,-28.28,-4961.62
buyer_3,Ana,35,ES04209538845447732310,TRX_N-00114-54298638,2022-04-07T21:44:42,Amurrio,expenses,gas,-112.55,-5074.17
buyer_3,Ana,35,ES04209538845447732310,TRX_N-00115-07230865,2022-04-07T22:31:37,Amurrio,expenses,transport,-72.94,-5147.11
buyer_3,Ana,35,ES04209538845447732310,TRX_N-00116-84913829,2022-04-07T11:40:08,Amurrio,expenses,cash,-100.0,-5247.11
buyer_3,Ana,35,ES04209538845447732310,TRX_N-00117-98191939,2022-04-08T13:45:52,Amurrio,expenses,internet,-42.0,-5289.11
buyer_3,Ana,35,ES04209538845447732310,TRX_N-00118-70526065,2022-04-08T07:23:00,Amurrio,expenses,phone,-34.07,-5323.18
buyer_3,Ana,35,ES04209538845447732310,TRX_N-00119-64678907,2022-04-08T04:26:28,Amurrio,expenses,transport,-68.56,-5391.74
buyer_3,Ana,35,ES04209538845447732310,TRX_N-00120-33911225,2022-04-08T14:38:42,Amurrio,expenses,repairs,-57.94,-5449.68
buyer_3,Ana,35,ES04209538845447732310,TRX_N-00121-68533950,2022-04-09T19:53:21,Amurrio,expenses,transport,-78.16,-5527.84
buyer_3,Ana,35,ES04209538845447732310,TRX_N-00122-19489630,2022-04-12T17:01:36,Amurrio,expenses,clothing,-119.17,-5647.01
buyer_3,Ana,35,ES04209538845447732310,TRX_N-00123-38744045,2022-04-13T19:30:25,Amurrio,expenses,food,-120.9,-5767.91
buyer_3,Ana,35,ES04209538845447732310,TRX_N-00124-25383531,2022-04-14T09:04:02,Amurrio,expenses,gifts,-174.05,-5941.96
buyer_3,Ana,35,ES04209538845447732310,TRX_N-00125-87837542,2022-04-16T21:05:32,Amurrio,expenses,cash,-100.0,-6041.96
buyer_3,Ana,35,ES04209538845447732310,TRX_N-00126-64137687,2022-04-17T08:11:48,Berango,expenses,cash,-100.0,-6141.96
buyer_3,Ana,35,ES04209538845447732310,TRX_N-00127-56912512,2022-04-18T22:03:11,Amurrio,expenses,transport,-87.52,-6229.48
buyer_3,Ana,35,ES04209538845447732310,TRX_N-00128-17795301,2022-04-19T08:06:37,Getxo,expenses,leisure,-34.25,-6263.73
buyer_3,Ana,35,ES04209538845447732310,TRX_N-00129-94914856,2022-04-20T14:04:38,Amurrio,expenses,food,-108.64,-6372.37
buyer_3,Ana,35,ES04209538845447732310,TRX_N-00130-21237101,2022-04-20T18:53:08,Amurrio,expenses,cash,-100.0,-6472.37
buyer_3,Ana,35,ES04209538845447732310,TRX_N-00131-29537433,2022-04-22T12:38:51,Amurrio,expenses,cash,-100.0,-6572.37
buyer_3,Ana,35,ES04209538845447732310,TRX_N-00132-57419558,2022-04-23T19:48:31,Amurrio,expenses,cash,-100.0,-6672.37
buyer_3,Ana,35,ES04209538845447732310,TRX_N-00133-19907583,2022-04-25T12:56:27,Amurrio,expenses,cash,-100.0,-6772.37
buyer_3,Ana,35,ES04209538845447732310,TRX_N-00134-68043966,2022-04-26T10:23:54,Alegría-Dulantzi,expenses,clothing,-53.75,-6826.12
buyer_3,Ana,35,ES04209538845447732310,TRX_N-00135-67865796,2022-04-27T21:24:06,Getxo,expenses,food,-84.43,-6910.55
buyer_3,Ana,35,ES04209538845447732310,TRX_N-00136-67238229,2022-04-28T17:26:09,Amurrio,expenses,cash,-100.0,-7010.55
buyer_3,Ana,35,ES04209538845447732310,TRX_N-00137-48095690,2022-04-29T21:38:13,Amurrio,expenses,travel,-1536.96,-8547.51
buyer_3,Ana,35,ES04209538845447732310,TRX_N-00138-14062796,2022-05-01T15:09:52,Amurrio,incomes,salary,1229.29,-7318.22
buyer_3,Ana,35,ES04209538845447732310,TRX_N-00139-83154915,2022-05-01T15:09:52,Amurrio,incomes,salary_partner,1119.91,-6198.31
buyer_3,Ana,35,ES04209538845447732310,TRX_N-00140-99411867,2022-05-01T12:40:05,Amurrio,expenses,food,-78.64,-6276.95
buyer_3,Ana,35,ES04209538845447732310,TRX_N-00141-94754657,2022-05-02T14:50:58,Portugalete,expenses,leisure,-80.07,-6357.02
buyer_3,Ana,35,ES04209538845447732310,TRX_N-00142-99229124,2022-05-03T11:25:27,Amurrio,expenses,transport,-48.06,-6405.08
buyer_3,Ana,35,ES04209538845447732310,TRX_N-00143-66370339,2022-05-04T09:16:18,Amurrio,expenses,mortgage,-874.64,-7279.72
buyer_3,Ana,35,ES04209538845447732310,TRX_N-00144-33249674,2022-05-04T05:12:56,Amurrio,expenses,cash,-100.0,-7379.72
buyer_3,Ana,35,ES04209538845447732310,TRX_N-00145-03940382,2022-05-06T15:32:13,Amurrio,expenses,gas,-36.58,-7416.3
buyer_3,Ana,35,ES04209538845447732310,TRX_N-00146-88690510,2022-05-07T08:52:45,Amurrio,expenses,electricity,-77.67,-7493.97
buyer_3,Ana,35,ES04209538845447732310,TRX_N-00147-24839876,2022-05-08T15:30:02,Amurrio,expenses,water,-22.81,-7516.78
buyer_3,Ana,35,ES04209538845447732310,TRX_N-00148-87330641,2022-05-08T19:57:05,Amurrio,expenses,internet,-42.0,-7558.78
buyer_3,Ana,35,ES04209538845447732310,TRX_N-00149-19505806,2022-05-08T17:22:04,Amurrio,expenses,phone,-31.78,-7590.56
buyer_3,Ana,35,ES04209538845447732310,TRX_N-00150-49979672,2022-05-08T09:20:10,Amurrio,expenses,cash,-100.0,-7690.56
buyer_3,Ana,35,ES04209538845447732310,TRX_N-00151-78111326,2022-05-09T15:05:07,Bilbao,expenses,gifts,-507.55,-8198.11
buyer_3,Ana,35,ES04209538845447732310,TRX_N-00152-38736571,2022-05-10T17:19:33,Amurrio,expenses,food,-112.7,-8310.81
buyer_3,Ana,35,ES04209538845447732310,TRX_N-00153-55633081,2022-05-11T19:16:38,Amurrio,expenses,food,-119.85,-8430.66
buyer_3,Ana,35,ES04209538845447732310,TRX_N-00154-16198418,2022-05-11T02:04:00,Amurrio,expenses,transport,-65.65,-8496.31
buyer_3,Ana,35,ES04209538845447732310,TRX_N-00155-46458927,2022-05-11T13:25:19,Amurrio,expenses,travel,-1169.4,-9665.71
buyer_3,Ana,35,ES04209538845447732310,TRX_N-00156-11403303,2022-05-12T09:52:15,Amurrio,expenses,food,-108.08,-9773.79
buyer_3,Ana,35,ES04209538845447732310,TRX_N-00157-98638833,2022-05-12T17:43:48,Amurrio,expenses,healthcare,-75.86,-9849.65
buyer_3,Ana,35,ES04209538845447732310,TRX_N-00158-48584741,2022-05-14T20:30:09,Amurrio,expenses,leisure,-28.36,-9878.01
buyer_3,Ana,35,ES04209538845447732310,TRX_N-00159-57432557,2022-05-15T19:11:19,Amurrio,expenses,healthcare,-107.86,-9985.87
buyer_3,Ana,35,ES04209538845447732310,TRX_N-00160-35815787,2022-05-15T13:57:03,Amurrio,expenses,cash,-100.0,-10085.87
buyer_3,Ana,35,ES04209538845447732310,TRX_N-00161-17731729,2022-05-16T11:35:14,Zuia,expenses,food,-80.33,-10166.2
buyer_3,Ana,35,ES04209538845447732310,TRX_N-00162-49449887,2022-05-16T15:23:50,Amurrio,expenses,transport,-60.25,-10226.45
buyer_3,Ana,35,ES04209538845447732310,TRX_N-00163-38568249,2022-05-16T17:24:10,Amurrio,expenses,education,-63.51,-10289.96
buyer_3,Ana,35,ES04209538845447732310,TRX_N-00164-25715131,2022-05-17T22:18:41,Amurrio,expenses,clothing,-60.11,-10350.07
buyer_3,Ana,35,ES04209538845447732310,TRX_N-00165-93321295,2022-05-19T11:45:21,Amurrio,expenses,food,-116.78,-10466.85
buyer_3,Ana,35,ES04209538845447732310,TRX_N-00166-99962506,2022-05-20T13:23:43,Amurrio,expenses,cash,-100.0,-10566.85
buyer_3,Ana,35,ES04209538845447732310,TRX_N-00167-24583649,2022-05-21T02:54:35,Amurrio,expenses,repairs,-95.05,-10661.9
buyer_3,Ana,35,ES04209538845447732310,TRX_N-00168-93132110,2022-05-22T12:54:18,Amurrio,expenses,cash,-100.0,-10761.9
buyer_3,Ana,35,ES04209538845447732310,TRX_N-00169-44337506,2022-05-23T02:25:13,Amurrio,expenses,leisure,-67.34,-10829.24
buyer_3,Ana,35,ES04209538845447732310,TRX_N-00170-20568708,2022-05-25T16:20:40,Lasarte-Oria,expenses,clothing,-103.46,-10932.7
buyer_3,Ana,35,ES04209538845447732310,TRX_N-00171-14578691,2022-05-26T08:48:30,Amurrio,expenses,cash,-100.0,-11032.7
buyer_3,Ana,35,ES04209538845447732310,TRX_N-00172-49110481,2022-05-28T02:02:13,Amurrio,expenses,education,-62.18,-11094.88
buyer_3,Ana,35,ES04209538845447732310,TRX_N-00173-36671667,2022-06-01T12:25:17,Amurrio,incomes,salary,1229.29,-9865.59
buyer_3,Ana,35,ES04209538845447732310,TRX_N-00174-92934275,2022-06-01T12:25:17,Amurrio,incomes,salary_partner,1119.91,-8745.68
buyer_3,Ana,35,ES04209538845447732310,TRX_N-00175-48606184,2022-06-01T12:25:17,Amurrio,incomes,extra_income,209.99,-8535.69
buyer_3,Ana,35,ES04209538845447732310,TRX_N-00176-53239760,2022-06-01T12:25:17,Amurrio,incomes,salary_bonus,866.59,-7669.1
buyer_3,Ana,35,ES04209538845447732310,TRX_N-00177-45552817,2022-06-01T12:25:17,Amurrio,incomes,salary_partner_bonus,853.31,-6815.79
buyer_3,Ana,35,ES04209538845447732310,TRX_N-00178-77943334,2022-06-01T23:45:37,Amurrio,expenses,gifts,-149.12,-6964.91
buyer_3,Ana,35,ES04209538845447732310,TRX_N-00179-80300219,2022-06-02T01:47:07,Amurrio,expenses,cash,-100.0,-7064.91
buyer_3,Ana,35,ES04209538845447732310,TRX_N-00180-44722266,2022-06-02T18:54:19,Amurrio,expenses,repairs,-213.65,-7278.56
buyer_3,Ana,35,ES04209538845447732310,TRX_N-00181-91659791,2022-06-03T12:31:37,Amurrio,expenses,gifts,-456.21,-7734.77
buyer_3,Ana,35,ES04209538845447732310,TRX_N-00182-31182553,2022-06-04T20:04:33,Amurrio,expenses,mortgage,-874.64,-8609.41
buyer_3,Ana,35,ES04209538845447732310,TRX_N-00183-81794443,2022-06-05T13:13:55,Amurrio,expenses,electricity,-56.58,-8665.99
buyer_3,Ana,35,ES04209538845447732310,TRX_N-00184-10224530,2022-06-05T12:25:28,Amurrio,expenses,phone,-37.62,-8703.61
buyer_3,Ana,35,ES04209538845447732310,TRX_N-00185-34763476,2022-06-06T10:35:32,Amurrio,expenses,education,-42.93,-8746.54
buyer_3,Ana,35,ES04209538845447732310,TRX_N-00186-35797448,2022-06-07T10:01:06,Amurrio,expenses,internet,-42.0,-8788.54
buyer_3,Ana,35,ES04209538845447732310,TRX_N-00187-92592566,2022-06-08T09:22:14,Amurrio,expenses,water,-38.71,-8827.25
buyer_3,Ana,35,ES04209538845447732310,TRX_N-00188-49126560,2022-06-08T15:49:07,Amurrio,expenses,gas,-88.45,-8915.7
buyer_3,Ana,35,ES04209538845447732310,TRX_N-00189-68826709,2022-06-10T08:37:37,Amurrio,expenses,clothing,-121.62,-9037.32
buyer_3,Ana,35,ES04209538845447732310,TRX_N-00190-86818740,2022-06-11T17:31:33,Amurrio,expenses,repairs,-316.17,-9353.49
buyer_3,Ana,35,ES04209538845447732310,TRX_N-00191-89763397,2022-06-12T08:44:07,Amurrio,expenses,food,-70.66,-9424.15
buyer_3,Ana,35,ES04209538845447732310,TRX_N-00192-54964735,2022-06-12T10:51:42,Amurrio,expenses,leisure,-30.55,-9454.7
buyer_3,Ana,35,ES04209538845447732310,TRX_N-00193-74635098,2022-06-14T11:40:58,Amurrio,expenses,transport,-79.5,-9534.2
buyer_3,Ana,35,ES04209538845447732310,TRX_N-00194-14347495,2022-06-17T00:10:07,Amurrio,expenses,transport,-41.34,-9575.54
buyer_3,Ana,35,ES04209538845447732310,TRX_N-00195-70694531,2022-06-21T13:00:57,Amurrio,expenses,food,-96.98,-9672.52
buyer_3,Ana,35,ES04209538845447732310,TRX_N-00196-93007739,2022-06-21T20:17:51,Amurrio,expenses,cash,-100.0,-9772.52
buyer_3,Ana,35,ES04209538845447732310,TRX_N-00197-42401184,2022-06-23T14:36:45,Amurrio,expenses,appliances,-225.07,-9997.59
buyer_3,Ana,35,ES04209538845447732310,TRX_N-00198-40511865,2022-06-24T19:22:09,Amurrio,expenses,leisure,-20.15,-10017.74
buyer_3,Ana,35,ES04209538845447732310,TRX_N-00199-59918244,2022-06-25T15:29:52,Amurrio,expenses,food,-119.03,-10136.77
buyer_3,Ana,35,ES04209538845447732310,TRX_N-00200-09720581,2022-06-26T19:15:49,Amurrio,expenses,cash,-100.0,-10236.77
buyer_3,Ana,35,ES04209538845447732310,TRX_N-00201-38287218,2022-06-26T10:04:08,Bilbao,expenses,appliances,-244.46,-10481.23
buyer_3,Ana,35,ES04209538845447732310,TRX_N-00202-19352636,2022-06-27T18:47:08,Amurrio,expenses,transport,-82.56,-10563.79
buyer_3,Ana,35,ES04209538845447732310,TRX_N-00203-83047992,2022-06-28T18:23:59,Amurrio,expenses,transport,-87.71,-10651.5
buyer_3,Ana,35,ES04209538845447732310,TRX_N-00204-08561097,2022-06-29T20:25:29,Amurrio,expenses,cash,-100.0,-10751.5
buyer_3,Ana,35,ES04209538845447732310,TRX_N-00205-89040043,2022-06-30T08:57:21,Amurrio,expenses,leisure,-28.08,-10779.58
buyer_3,Ana,35,ES04209538845447732310,TRX_N-00206-12508651,2022-06-30T19:42:19,Amurrio,expenses,gifts,-38.79,-10818.37
buyer_3,Ana,35,ES04209538845447732310,TRX_N-00207-61619415,2022-07-01T20:56:48,Amurrio,incomes,salary,1229.29,-9589.08
buyer_3,Ana,35,ES04209538845447732310,TRX_N-00208-60575555,2022-07-01T20:56:48,Amurrio,incomes,salary_partner,1119.91,-8469.17
buyer_3,Ana,35,ES04209538845447732310,TRX_N-00209-17339902,2022-07-01T02:04:59,Zuia,expenses,cash,-100.0,-8569.17
buyer_3,Ana,35,ES04209538845447732310,TRX_N-00210-14243549,2022-07-04T11:14:12,Amurrio,expenses,mortgage,-874.64,-9443.81
buyer_3,Ana,35,ES04209538845447732310,TRX_N-00211-15563829,2022-07-04T14:30:06,Amurrio,expenses,repairs,-239.66,-9683.47
buyer_3,Ana,35,ES04209538845447732310,TRX_N-00212-27175326,2022-07-04T11:48:06,Amurrio,expenses,gifts,-172.67,-9856.14
buyer_3,Ana,35,ES04209538845447732310,TRX_N-00213-39166254,2022-07-05T17:26:58,Amurrio,expenses,electricity,-29.87,-9886.01
buyer_3,Ana,35,ES04209538845447732310,TRX_N-00214-42095536,2022-07-05T18:54:11,Amurrio,expenses,gas,-55.38,-9941.39
buyer_3,Ana,35,ES04209538845447732310,TRX_N-00215-58816875,2022-07-05T12:57:25,Amurrio,expenses,internet,-42.0,-9983.39
buyer_3,Ana,35,ES04209538845447732310,TRX_N-00216-07871389,2022-07-05T15:54:35,Amurrio,expenses,food,-76.54,-10059.93
buyer_3,Ana,35,ES04209538845447732310,TRX_N-00217-22836721,2022-07-06T09:58:19,Amurrio,expenses,repairs,-261.88,-10321.81
buyer_3,Ana,35,ES04209538845447732310,TRX_N-00218-43751812,2022-07-07T21:58:01,Amurrio,expenses,education,-63.78,-10385.59
buyer_3,Ana,35,ES04209538845447732310,TRX_N-00219-29563838,2022-07-07T12:12:07,Amurrio,expenses,repairs,-111.54,-10497.13
buyer_3,Ana,35,ES04209538845447732310,TRX_N-00220-40209413,2022-07-08T17:22:29,Amurrio,expenses,water,-29.01,-10526.14
buyer_3,Ana,35,ES04209538845447732310,TRX_N-00221-14658107,2022-07-08T08:26:35,Amurrio,expenses,phone,-30.35,-10556.49
buyer_3,Ana,35,ES04209538845447732310,TRX_N-00222-49848108,2022-07-08T02:53:09,Amurrio,expenses,food,-92.98,-10649.47
buyer_3,Ana,35,ES04209538845447732310,TRX_N-00223-34037918,2022-07-08T11:13:47,Amurrio,expenses,leisure,-29.69,-10679.16
buyer_3,Ana,35,ES04209538845447732310,TRX_N-00224-06489446,2022-07-09T12:36:48,Amurrio,expenses,education,-71.06,-10750.22
buyer_3,Ana,35,ES04209538845447732310,TRX_N-00225-87340788,2022-07-10T12:46:43,Amurrio,expenses,appliances,-246.69,-10996.91
buyer_3,Ana,35,ES04209538845447732310,TRX_N-00226-09245848,2022-07-11T20:29:40,Hernani,expenses,repairs,-240.53,-11237.44
buyer_3,Ana,35,ES04209538845447732310,TRX_N-00227-38844240,2022-07-12T15:31:16,Amurrio,expenses,education,-45.91,-11283.35
buyer_3,Ana,35,ES04209538845447732310,TRX_N-00228-18415007,2022-07-14T15:03:06,Amurrio,expenses,cash,-100.0,-11383.35
buyer_3,Ana,35,ES04209538845447732310,TRX_N-00229-03669411,2022-07-16T22:43:53,Amurrio,expenses,cash,-100.0,-11483.35
buyer_3,Ana,35,ES04209538845447732310,TRX_N-00230-48340754,2022-07-16T16:48:28,Amurrio,expenses,repairs,-145.07,-11628.42
buyer_3,Ana,35,ES04209538845447732310,TRX_N-00231-93134049,2022-07-19T14:51:12,Amurrio,expenses,food,-109.19,-11737.61
buyer_3,Ana,35,ES04209538845447732310,TRX_N-00232-84155103,2022-07-19T22:34:23,Amurrio,expenses,cash,-100.0,-11837.61
buyer_3,Ana,35,ES04209538845447732310,TRX_N-00233-13390093,2022-07-19T19:09:38,Amurrio,expenses,appliances,-88.27,-11925.88
buyer_3,Ana,35,ES04209538845447732310,TRX_N-00234-72076181,2022-07-20T11:43:35,Iruña de Oca,expenses,cash,-100.0,-12025.88
buyer_3,Ana,35,ES04209538845447732310,TRX_N-00235-57756074,2022-07-21T18:54:10,Amurrio,expenses,leisure,-48.34,-12074.22
buyer_3,Ana,35,ES04209538845447732310,TRX_N-00236-26912065,2022-07-22T11:22:11,Amurrio,expenses,cash,-100.0,-12174.22
buyer_3,Ana,35,ES04209538845447732310,TRX_N-00237-57879175,2022-07-23T10:23:52,Amurrio,expenses,transport,-42.68,-12216.9
buyer_3,Ana,35,ES04209538845447732310,TRX_N-00238-25320636,2022-07-26T08:41:51,Basauri,expenses,leisure,-44.6,-12261.5
buyer_3,Ana,35,ES04209538845447732310,TRX_N-00239-75571368,2022-07-26T16:34:36,Amurrio,expenses,cash,-100.0,-12361.5
buyer_3,Ana,35,ES04209538845447732310,TRX_N-00240-26710208,2022-07-27T17:20:31,Hondarribia,expenses,cash,-100.0,-12461.5
buyer_3,Ana,35,ES04209538845447732310,TRX_N-00241-50456836,2022-07-28T09:45:28,Amurrio,expenses,cash,-100.0,-12561.5
buyer_3,Ana,35,ES04209538845447732310,TRX_N-00242-94776454,2022-07-29T05:44:42,Amurrio,expenses,leisure,-58.4,-12619.9
buyer_3,Ana,35,ES04209538845447732310,TRX_N-00243-36546135,2022-07-30T11:05:33,Portugalete,expenses,leisure,-48.51,-12668.41
buyer_3,Ana,35,ES04209538845447732310,TRX_N-00244-53557510,2022-08-01T14:21:16,Amurrio,incomes,salary,1229.29,-11439.12
buyer_3,Ana,35,ES04209538845447732310,TRX_N-00245-65464269,2022-08-01T14:21:16,Amurrio,incomes,salary_partner,1119.91,-10319.21
buyer_3,Ana,35,ES04209538845447732310,TRX_N-00246-28729316,2022-08-01T12:14:02,Amurrio,expenses,repairs,-264.88,-10584.09
buyer_3,Ana,35,ES04209538845447732310,TRX_N-00247-80850344,2022-08-01T20:32:14,Amurrio,expenses,gifts,-205.34,-10789.43
buyer_3,Ana,35,ES04209538845447732310,TRX_N-00248-76987198,2022-08-04T07:16:31,Amurrio,expenses,mortgage,-874.64,-11664.07
buyer_3,Ana,35,ES04209538845447732310,TRX_N-00249-13868724,2022-08-04T16:06:49,Amurrio,expenses,cash,-100.0,-11764.07
buyer_3,Ana,35,ES04209538845447732310,TRX_N-00250-74786476,2022-08-05T08:56:48,Amurrio,expenses,water,-32.63,-11796.7
buyer_3,Ana,35,ES04209538845447732310,TRX_N-00251-81662350,2022-08-05T21:13:55,Irun,expenses,clothing,-117.34,-11914.04
buyer_3,Ana,35,ES04209538845447732310,TRX_N-00252-77496540,2022-08-05T06:00:40,Amurrio,expenses,cash,-100.0,-12014.04
buyer_3,Ana,35,ES04209538845447732310,TRX_N-00253-24575320,2022-08-06T13:10:51,Bilbao,expenses,cash,-100.0,-12114.04
buyer_3,Ana,35,ES04209538845447732310,TRX_N-00254-11987338,2022-08-07T11:16:33,Amurrio,expenses,internet,-42.0,-12156.04
buyer_3,Ana,35,ES04209538845447732310,TRX_N-00255-80679479,2022-08-07T10:49:19,Amurrio,expenses,phone,-38.43,-12194.47
buyer_3,Ana,35,ES04209538845447732310,TRX_N-00256-02156145,2022-08-07T19:44:33,Amurrio,expenses,children,-132.03,-12326.5
buyer_3,Ana,35,ES04209538845447732310,TRX_N-00257-57796131,2022-08-08T13:51:39,Amurrio,expenses,electricity,-36.66,-12363.16
buyer_3,Ana,35,ES04209538845447732310,TRX_N-00258-52383136,2022-08-08T18:02:58,Amurrio,expenses,gas,-42.85,-12406.01
buyer_3,Ana,35,ES04209538845447732310,TRX_N-00259-63653118,2022-08-09T16:18:11,Amurrio,expenses,transport,-56.96,-12462.97
buyer_3,Ana,35,ES04209538845447732310,TRX_N-00260-97530524,2022-08-11T18:37:02,Amurrio,expenses,leisure,-29.91,-12492.88
buyer_3,Ana,35,ES04209538845447732310,TRX_N-00261-60353597,2022-08-12T14:53:18,Amurrio,expenses,gifts,-703.38,-13196.26
buyer_3,Ana,35,ES04209538845447732310,TRX_N-00262-78334082,2022-08-13T18:36:24,Amurrio,expenses,food,-107.14,-13303.4
buyer_3,Ana,35,ES04209538845447732310,TRX_N-00263-39509508,2022-08-13T09:36:03,Amurrio,expenses,education,-60.0,-13363.4
buyer_3,Ana,35,ES04209538845447732310,TRX_N-00264-46776308,2022-08-13T15:50:55,Amurrio,expenses,cash,-100.0,-13463.4
buyer_3,Ana,35,ES04209538845447732310,TRX_N-00265-90937691,2022-08-14T18:39:53,Amurrio,expenses,food,-79.18,-13542.58
buyer_3,Ana,35,ES04209538845447732310,TRX_N-00266-91583826,2022-08-15T10:23:15,Amurrio,expenses,transport,-66.97,-13609.55
buyer_3,Ana,35,ES04209538845447732310,TRX_N-00267-19182911,2022-08-15T04:15:14,Portugalete,expenses,leisure,-41.42,-13650.97
buyer_3,Ana,35,ES04209538845447732310,TRX_N-00268-70294183,2022-08-19T21:32:40,Amurrio,expenses,leisure,-53.09,-13704.06
buyer_3,Ana,35,ES04209538845447732310,TRX_N-00269-04954722,2022-08-19T15:21:03,Amurrio,expenses,clothing,-79.89,-13783.95
buyer_3,Ana,35,ES04209538845447732310,TRX_N-00270-69474995,2022-08-25T10:09:13,Amurrio,expenses,clothing,-119.88,-13903.83
buyer_3,Ana,35,ES04209538845447732310,TRX_N-00271-73846986,2022-08-25T14:22:49,Irun,expenses,repairs,-232.67,-14136.5
buyer_3,Ana,35,ES04209538845447732310,TRX_N-00272-78842942,2022-08-26T19:11:46,Amurrio,expenses,gifts,-349.71,-14486.21
buyer_3,Ana,35,ES04209538845447732310,TRX_N-00273-84378172,2022-08-27T11:32:18,Amurrio,expenses,leisure,-56.33,-14542.54
buyer_3,Ana,35,ES04209538845447732310,TRX_N-00274-31801078,2022-08-27T09:50:14,Amurrio,expenses,cash,-100.0,-14642.54
buyer_3,Ana,35,ES04209538845447732310,TRX_N-00275-56939870,2022-08-30T19:34:27,Galdakao,expenses,repairs,-36.62,-14679.16
buyer_3,Ana,35,ES04209538845447732310,TRX_N-00276-20291506,2022-09-01T11:43:30,Amurrio,incomes,salary,1229.29,-13449.87
buyer_3,Ana,35,ES04209538845447732310,TRX_N-00277-26410805,2022-09-01T11:43:30,Amurrio,incomes,salary_partner,1119.91,-12329.96
buyer_3,Ana,35,ES04209538845447732310,TRX_N-00278-36325272,2022-09-01T11:43:30,Amurrio,incomes,extra_income,209.99,-12119.97
buyer_3,Ana,35,ES04209538845447732310,TRX_N-00279-42891928,2022-09-01T16:46:20,Amurrio,expenses,food,-62.32,-12182.29
buyer_3,Ana,35,ES04209538845447732310,TRX_N-00280-01917790,2022-09-04T11:43:14,Amurrio,expenses,mortgage,-874.64,-13056.93
buyer_3,Ana,35,ES04209538845447732310,TRX_N-00281-34610519,2022-09-04T09:42:30,Amurrio,expenses,transport,-55.89,-13112.82
buyer_3,Ana,35,ES04209538845447732310,TRX_N-00282-63397989,2022-09-04T12:01:56,Eibar,expenses,leisure,-60.35,-13173.17
buyer_3,Ana,35,ES04209538845447732310,TRX_N-00283-98480140,2022-09-05T18:27:50,Amurrio,expenses,water,-20.57,-13193.74
buyer_3,Ana,35,ES04209538845447732310,TRX_N-00284-86490680,2022-09-05T15:20:45,Zuia,expenses,clothing,-125.14,-13318.88
buyer_3,Ana,35,ES04209538845447732310,TRX_N-00285-09484630,2022-09-05T09:38:41,Santurtzi,expenses,repairs,-75.73,-13394.61
buyer_3,Ana,35,ES04209538845447732310,TRX_N-00286-06963044,2022-09-07T09:32:32,Amurrio,expenses,internet,-42.0,-13436.61
buyer_3,Ana,35,ES04209538845447732310,TRX_N-00287-69512220,2022-09-08T12:11:43,Amurrio,expenses,gas,-51.41,-13488.02
buyer_3,Ana,35,ES04209538845447732310,TRX_N-00288-98742713,2022-09-08T18:46:00,Amurrio,expenses,phone,-40.34,-13528.36
buyer_3,Ana,35,ES04209538845447732310,TRX_N-00289-67093403,2022-09-08T16:31:36,Amurrio,expenses,electricity,-62.72,-13591.08
buyer_3,Ana,35,ES04209538845447732310,TRX_N-00290-55853676,2022-09-12T12:46:43,Amurrio,expenses,food,-92.08,-13683.16
buyer_3,Ana,35,ES04209538845447732310,TRX_N-00291-80496611,2022-09-12T20:21:01,Amurrio,expenses,transport,-82.93,-13766.09
buyer_3,Ana,35,ES04209538845447732310,TRX_N-00292-42075004,2022-09-13T23:09:06,Amurrio,expenses,cash,-100.0,-13866.09
buyer_3,Ana,35,ES04209538845447732310,TRX_N-00293-98238860,2022-09-14T11:56:15,Amurrio,expenses,repairs,-195.12,-14061.21
buyer_3,Ana,35,ES04209538845447732310,TRX_N-00294-24644502,2022-09-16T18:47:42,Amurrio,expenses,repairs,-275.74,-14336.95
buyer_3,Ana,35,ES04209538845447732310,TRX_N-00295-08583876,2022-09-18T16:49:27,Amurrio,expenses,cash,-100.0,-14436.95
buyer_3,Ana,35,ES04209538845447732310,TRX_N-00296-53862390,2022-09-22T13:53:40,Zuia,expenses,travel,-551.0,-14987.95
buyer_3,Ana,35,ES04209538845447732310,TRX_N-00297-36856478,2022-09-22T11:16:39,Amurrio,expenses,gifts,-751.65,-15739.6
buyer_3,Ana,35,ES04209538845447732310,TRX_N-00298-67108006,2022-09-23T15:27:08,Amurrio,expenses,leisure,-28.06,-15767.66
buyer_3,Ana,35,ES04209538845447732310,TRX_N-00299-12404254,2022-09-23T11:12:25,Amurrio,expenses,cash,-100.0,-15867.66
buyer_3,Ana,35,ES04209538845447732310,TRX_N-00300-75328062,2022-09-24T09:35:58,Amurrio,expenses,food,-79.98,-15947.64
buyer_3,Ana,35,ES04209538845447732310,TRX_N-00301-84707367,2022-09-24T18:02:17,Amurrio,expenses,leisure,-67.8,-16015.44
buyer_3,Ana,35,ES04209538845447732310,TRX_N-00302-31209232,2022-09-25T01:41:41,Iruña de Oca,expenses,food,-85.88,-16101.32
buyer_3,Ana,35,ES04209538845447732310,TRX_N-00303-91477602,2022-09-25T13:34:05,Amurrio,expenses,children,-86.97,-16188.29
buyer_3,Ana,35,ES04209538845447732310,TRX_N-00304-55432617,2022-09-28T10:16:15,Amurrio,expenses,leisure,-79.39,-16267.68
buyer_3,Ana,35,ES04209538845447732310,TRX_N-00305-24482624,2022-09-30T16:54:22,Bilbao,expenses,cash,-100.0,-16367.68
buyer_3,Ana,35,ES04209538845447732310,TRX_N-00306-71373896,2022-10-01T18:16:03,Amurrio,incomes,salary,1229.29,-15138.39
buyer_3,Ana,35,ES04209538845447732310,TRX_N-00307-60943576,2022-10-01T18:16:03,Amurrio,incomes,salary_partner,1119.91,-14018.48
buyer_3,Ana,35,ES04209538845447732310,TRX_N-00308-51784241,2022-10-01T19:22:16,Amurrio,expenses,clothing,-159.47,-14177.95
buyer_3,Ana,35,ES04209538845447732310,TRX_N-00309-76316964,2022-10-01T13:54:35,Amurrio,expenses,education,-60.54,-14238.49
buyer_3,Ana,35,ES04209538845447732310,TRX_N-00310-57824180,2022-10-01T13:14:16,Amurrio,expenses,children,-243.5,-14481.99
buyer_3,Ana,35,ES04209538845447732310,TRX_N-00311-94194304,2022-10-02T11:18:35,Amurrio,expenses,food,-105.52,-14587.51
buyer_3,Ana,35,ES04209538845447732310,TRX_N-00312-95306452,2022-10-02T10:13:31,Amurrio,expenses,cash,-100.0,-14687.51
buyer_3,Ana,35,ES04209538845447732310,TRX_N-00313-62184651,2022-10-03T08:17:47,Pasaia,expenses,cash,-100.0,-14787.51
buyer_3,Ana,35,ES04209538845447732310,TRX_N-00314-45662494,2022-10-04T15:28:17,Amurrio,expenses,mortgage,-874.64,-15662.15
buyer_3,Ana,35,ES04209538845447732310,TRX_N-00315-98346781,2022-10-04T10:58:02,Amurrio,expenses,leisure,-65.57,-15727.72
buyer_3,Ana,35,ES04209538845447732310,TRX_N-00316-16170602,2022-10-05T11:51:56,Amurrio,expenses,water,-23.12,-15750.84
buyer_3,Ana,35,ES04209538845447732310,TRX_N-00317-27779518,2022-10-06T10:30:50,Amurrio,expenses,electricity,-24.69,-15775.53
buyer_3,Ana,35,ES04209538845447732310,TRX_N-00318-52411154,2022-10-06T22:49:51,Amurrio,expenses,gas,-60.84,-15836.37
buyer_3,Ana,35,ES04209538845447732310,TRX_N-00319-06038974,2022-10-06T09:31:31,Amurrio,expenses,phone,-39.47,-15875.84
buyer_3,Ana,35,ES04209538845447732310,TRX_N-00320-70059790,2022-10-08T07:35:32,Amurrio,expenses,internet,-42.0,-15917.84
buyer_3,Ana,35,ES04209538845447732310,TRX_N-00321-34176691,2022-10-08T14:26:24,Mungia,expenses,leisure,-78.19,-15996.03
buyer_3,Ana,35,ES04209538845447732310,TRX_N-00322-80001364,2022-10-10T13:04:25,Berango,expenses,leisure,-65.86,-16061.89
buyer_3,Ana,35,ES04209538845447732310,TRX_N-00323-73989186,2022-10-10T20:15:20,Amurrio,expenses,cash,-100.0,-16161.89
buyer_3,Ana,35,ES04209538845447732310,TRX_N-00324-89614615,2022-10-11T16:48:48,Amurrio,expenses,travel,-1753.02,-17914.91
buyer_3,Ana,35,ES04209538845447732310,TRX_N-00325-30315701,2022-10-12T11:07:02,Amurrio,expenses,cash,-100.0,-18014.91
buyer_3,Ana,35,ES04209538845447732310,TRX_N-00326-07727436,2022-10-14T22:22:40,Getxo,expenses,transport,-82.24,-18097.15
buyer_3,Ana,35,ES04209538845447732310,TRX_N-00327-04710175,2022-10-14T04:33:15,Amurrio,expenses,leisure,-57.12,-18154.27
buyer_3,Ana,35,ES04209538845447732310,TRX_N-00328-43982000,2022-10-16T04:36:28,Amurrio,expenses,food,-70.29,-18224.56
buyer_3,Ana,35,ES04209538845447732310,TRX_N-00329-89918196,2022-10-17T11:54:20,Amurrio,expenses,food,-64.48,-18289.04
buyer_3,Ana,35,ES04209538845447732310,TRX_N-00330-42155777,2022-10-19T23:56:20,Amurrio,expenses,gifts,-70.04,-18359.08
buyer_3,Ana,35,ES04209538845447732310,TRX_N-00331-59113471,2022-10-20T07:43:18,Amurrio,expenses,leisure,-64.69,-18423.77
buyer_3,Ana,35,ES04209538845447732310,TRX_N-00332-62794884,2022-10-20T10:48:38,Amurrio,expenses,appliances,-165.62,-18589.39
buyer_3,Ana,35,ES04209538845447732310,TRX_N-00333-13541526,2022-10-24T10:54:04,Amurrio,expenses,education,-43.25,-18632.64
buyer_3,Ana,35,ES04209538845447732310,TRX_N-00334-98987950,2022-10-27T17:25:26,Basauri,expenses,cash,-100.0,-18732.64
buyer_3,Ana,35,ES04209538845447732310,TRX_N-00335-99814471,2022-10-28T22:30:56,Amurrio,expenses,cash,-100.0,-18832.64
buyer_3,Ana,35,ES04209538845447732310,TRX_N-00336-76393513,2022-10-28T12:35:30,Hernani,expenses,repairs,-92.19,-18924.83
buyer_3,Ana,35,ES04209538845447732310,TRX_N-00337-99186426,2022-10-29T11:47:03,Amurrio,expenses,food,-81.85,-19006.68
buyer_3,Ana,35,ES04209538845447732310,TRX_N-00338-39754853,2022-10-31T11:14:23,Amurrio,expenses,food,-71.72,-19078.4
buyer_3,Ana,35,ES04209538845447732310,TRX_N-00339-85881890,2022-10-31T17:07:16,Amurrio,expenses,cash,-100.0,-19178.4
buyer_3,Ana,35,ES04209538845447732310,TRX_N-00340-15869817,2022-11-01T19:47:14,Amurrio,incomes,salary,1229.29,-17949.11
buyer_3,Ana,35,ES04209538845447732310,TRX_N-00341-69155538,2022-11-01T19:47:14,Amurrio,incomes,salary_partner,1119.91,-16829.2
buyer_3,Ana,35,ES04209538845447732310,TRX_N-00342-16729348,2022-11-01T19:38:35,Amurrio,expenses,food,-90.84,-16920.04
buyer_3,Ana,35,ES04209538845447732310,TRX_N-00343-53809970,2022-11-03T17:04:52,Amurrio,expenses,leisure,-67.22,-16987.26
buyer_3,Ana,35,ES04209538845447732310,TRX_N-00344-10854993,2022-11-04T22:35:36,Amurrio,expenses,mortgage,-874.64,-17861.9
buyer_3,Ana,35,ES04209538845447732310,TRX_N-00345-20085334,2022-11-04T19:58:24,Amurrio,expenses,transport,-43.39,-17905.29
buyer_3,Ana,35,ES04209538845447732310,TRX_N-00346-45547274,2022-11-05T10:22:18,Amurrio,expenses,phone,-43.39,-17948.68
buyer_3,Ana,35,ES04209538845447732310,TRX_N-00347-53635606,2022-11-06T12:51:43,Amurrio,expenses,transport,-55.47,-18004.15
buyer_3,Ana,35,ES04209538845447732310,TRX_N-00348-96650193,2022-11-06T20:11:04,Amurrio,expenses,leisure,-84.61,-18088.76
buyer_3,Ana,35,ES04209538845447732310,TRX_N-00349-77196314,2022-11-07T13:14:07,Amurrio,expenses,electricity,-26.57,-18115.33
buyer_3,Ana,35,ES04209538845447732310,TRX_N-00350-57283152,2022-11-07T14:10:27,Amurrio,expenses,food,-77.77,-18193.1
buyer_3,Ana,35,ES04209538845447732310,TRX_N-00351-78945299,2022-11-08T16:05:31,Amurrio,expenses,water,-42.95,-18236.05
buyer_3,Ana,35,ES04209538845447732310,TRX_N-00352-00204479,2022-11-08T14:28:51,Amurrio,expenses,gas,-39.85,-18275.9
buyer_3,Ana,35,ES04209538845447732310,TRX_N-00353-67536641,2022-11-08T12:49:00,Amurrio,expenses,internet,-42.0,-18317.9
buyer_3,Ana,35,ES04209538845447732310,TRX_N-00354-51881928,2022-11-09T18:11:21,Amurrio,expenses,leisure,-52.75,-18370.65
buyer_3,Ana,35,ES04209538845447732310,TRX_N-00355-04473108,2022-11-10T13:06:26,Amurrio,expenses,repairs,-71.02,-18441.67
buyer_3,Ana,35,ES04209538845447732310,TRX_N-00356-04407137,2022-11-11T21:10:39,Amurrio,expenses,leisure,-23.52,-18465.19
buyer_3,Ana,35,ES04209538845447732310,TRX_N-00357-42562765,2022-11-12T10:18:48,Amurrio,expenses,transport,-77.33,-18542.52
buyer_3,Ana,35,ES04209538845447732310,TRX_N-00358-49521627,2022-11-16T17:31:28,Amurrio,expenses,gifts,-406.51,-18949.03
buyer_3,Ana,35,ES04209538845447732310,TRX_N-00359-97947950,2022-11-17T21:53:54,Oyón-Oion,expenses,education,-77.11,-19026.14
buyer_3,Ana,35,ES04209538845447732310,TRX_N-00360-31689190,2022-11-18T15:13:32,Amurrio,expenses,leisure,-18.83,-19044.97
buyer_3,Ana,35,ES04209538845447732310,TRX_N-00361-13551284,2022-11-19T09:23:42,Amurrio,expenses,leisure,-47.68,-19092.65
buyer_3,Ana,35,ES04209538845447732310,TRX_N-00362-80226842,2022-11-22T08:53:08,Amurrio,expenses,repairs,-216.86,-19309.51
buyer_3,Ana,35,ES04209538845447732310,TRX_N-00363-33201029,2022-11-23T09:14:06,Llodio,expenses,appliances,-308.54,-19618.05
buyer_3,Ana,35,ES04209538845447732310,TRX_N-00364-78760903,2022-11-24T17:28:18,Amurrio,expenses,education,-62.73,-19680.78
buyer_3,Ana,35,ES04209538845447732310,TRX_N-00365-06122220,2022-11-29T22:47:23,Bermeo,expenses,food,-81.88,-19762.66
buyer_3,Ana,35,ES04209538845447732310,TRX_N-00366-45763370,2022-12-01T00:19:16,Amurrio,incomes,salary,1229.29,-18533.37
buyer_3,Ana,35,ES04209538845447732310,TRX_N-00367-94275922,2022-12-01T00:19:16,Amurrio,incomes,salary_partner,1119.91,-17413.46
buyer_3,Ana,35,ES04209538845447732310,TRX_N-00368-32094580,2022-12-01T00:19:16,Amurrio,incomes,extra_income,209.99,-17203.47
buyer_3,Ana,35,ES04209538845447732310,TRX_N-00369-62826779,2022-12-01T00:19:16,Amurrio,incomes,salary_bonus,967.95,-16235.52
buyer_3,Ana,35,ES04209538845447732310,TRX_N-00370-41829725,2022-12-01T00:19:16,Amurrio,incomes,salary_partner_bonus,827.13,-15408.39
buyer_3,Ana,35,ES04209538845447732310,TRX_N-00371-18674925,2022-12-01T17:58:02,Amurrio,expenses,healthcare,-147.64,-15556.03
buyer_3,Ana,35,ES04209538845447732310,TRX_N-00372-93424869,2022-12-02T10:12:51,Amurrio,expenses,food,-86.91,-15642.94
buyer_3,Ana,35,ES04209538845447732310,TRX_N-00373-93595316,2022-12-02T15:41:03,Amurrio,expenses,healthcare,-42.54,-15685.48
buyer_3,Ana,35,ES04209538845447732310,TRX_N-00374-33882503,2022-12-04T08:09:56,Amurrio,expenses,mortgage,-874.64,-16560.12
buyer_3,Ana,35,ES04209538845447732310,TRX_N-00375-50487412,2022-12-04T08:20:07,Amurrio,expenses,food,-76.65,-16636.77
buyer_3,Ana,35,ES04209538845447732310,TRX_N-00376-28241020,2022-12-04T15:16:27,Sopela,expenses,transport,-56.6,-16693.37
buyer_3,Ana,35,ES04209538845447732310,TRX_N-00377-04811063,2022-12-04T17:41:14,Amurrio,expenses,cash,-100.0,-16793.37
buyer_3,Ana,35,ES04209538845447732310,TRX_N-00378-09955235,2022-12-04T18:13:26,Amurrio,expenses,appliances,-133.19,-16926.56
buyer_3,Ana,35,ES04209538845447732310,TRX_N-00379-10362964,2022-12-05T10:44:48,Amurrio,expenses,water,-21.62,-16948.18
buyer_3,Ana,35,ES04209538845447732310,TRX_N-00380-11616892,2022-12-05T21:37:35,Amurrio,expenses,leisure,-66.54,-17014.72
buyer_3,Ana,35,ES04209538845447732310,TRX_N-00381-66775456,2022-12-06T09:53:37,Amurrio,expenses,electricity,-30.06,-17044.78
buyer_3,Ana,35,ES04209538845447732310,TRX_N-00382-17104984,2022-12-07T20:02:24,Amurrio,expenses,phone,-43.05,-17087.83
buyer_3,Ana,35,ES04209538845447732310,TRX_N-00383-97491430,2022-12-08T14:22:31,Amurrio,expenses,gas,-38.29,-17126.12
buyer_3,Ana,35,ES04209538845447732310,TRX_N-00384-16115143,2022-12-08T06:00:31,Amurrio,expenses,internet,-42.0,-17168.12
buyer_3,Ana,35,ES04209538845447732310,TRX_N-00385-57986606,2022-12-08T07:15:00,Amurrio,expenses,food,-79.79,-17247.91
buyer_3,Ana,35,ES04209538845447732310,TRX_N-00386-22877583,2022-12-09T14:57:05,Amurrio,expenses,education,-62.08,-17309.99
buyer_3,Ana,35,ES04209538845447732310,TRX_N-00387-93550368,2022-12-10T14:48:39,Amurrio,expenses,children,-163.33,-17473.32
buyer_3,Ana,35,ES04209538845447732310,TRX_N-00388-78735793,2022-12-11T14:08:43,Amurrio,expenses,food,-114.32,-17587.64
buyer_3,Ana,35,ES04209538845447732310,TRX_N-00389-72775804,2022-12-13T13:26:12,Amurrio,expenses,food,-121.58,-17709.22
buyer_3,Ana,35,ES04209538845447732310,TRX_N-00390-17205299,2022-12-16T15:57:33,Amurrio,expenses,gifts,-775.35,-18484.57
buyer_3,Ana,35,ES04209538845447732310,TRX_N-00391-31798420,2022-12-18T16:19:15,Iruña de Oca,expenses,food,-118.98,-18603.55
buyer_3,Ana,35,ES04209538845447732310,TRX_N-00392-04101090,2022-12-21T19:04:54,Amurrio,expenses,leisure,-66.99,-18670.54
buyer_3,Ana,35,ES04209538845447732310,TRX_N-00393-38539277,2022-12-24T09:25:06,Amurrio,expenses,gifts,-523.43,-19193.97
buyer_3,Ana,35,ES04209538845447732310,TRX_N-00394-59172829,2022-12-26T15:10:05,Amurrio,expenses,leisure,-52.24,-19246.21
buyer_3,Ana,35,ES04209538845447732310,TRX_N-00395-70535842,2022-12-27T10:01:54,Amurrio,expenses,food,-101.02,-19347.23
buyer_3,Ana,35,ES04209538845447732310,TRX_N-00396-08309503,2022-12-27T20:20:18,Amurrio,expenses,clothing,-97.46,-19444.69
buyer_3,Ana,35,ES04209538845447732310,TRX_N-00397-71007288,2022-12-27T08:50:49,Amurrio,expenses,cash,-100.0,-19544.69
buyer_3,Ana,35,ES04209538845447732310,TRX_N-00398-95218261,2022-12-29T13:29:15,Amurrio,expenses,leisure,-63.66,-19608.35
buyer_3,Ana,35,ES04209538845447732310,TRX_N-00399-58563140,2022-12-30T14:05:26,Amurrio,expenses,education,-61.2,-19669.55
buyer_3,Ana,35,ES04209538845447732310,TRX_N-00400-46871804,2023-01-01T22:59:28,Amurrio,incomes,salary,1277.87,-18391.68
buyer_3,Ana,35,ES04209538845447732310,TRX_N-00401-92862113,2023-01-01T22:59:28,Amurrio,incomes,salary_partner,1164.17,-17227.51
buyer_3,Ana,35,ES04209538845447732310,TRX_N-00402-65456792,2023-01-03T17:03:50,Amurrio,expenses,clothing,-59.83,-17287.34
buyer_3,Ana,35,ES04209538845447732310,TRX_N-00403-42054493,2023-01-03T10:51:22,Amurrio,expenses,healthcare,-185.29,-17472.63
buyer_3,Ana,35,ES04209538845447732310,TRX_N-00404-10157225,2023-01-03T13:15:01,Eibar,expenses,repairs,-311.69,-17784.32
buyer_3,Ana,35,ES04209538845447732310,TRX_N-00405-73460745,2023-01-04T18:56:49,Amurrio,expenses,mortgage,-874.64,-18658.96
buyer_3,Ana,35,ES04209538845447732310,TRX_N-00406-46815710,2023-01-05T15:57:31,Amurrio,expenses,water,-29.88,-18688.84
buyer_3,Ana,35,ES04209538845447732310,TRX_N-00407-10875408,2023-01-05T20:07:04,Amurrio,expenses,phone,-39.46,-18728.3
buyer_3,Ana,35,ES04209538845447732310,TRX_N-00408-27220135,2023-01-05T17:57:48,Vitoria-Gasteiz,expenses,clothing,-106.83,-18835.13
buyer_3,Ana,35,ES04209538845447732310,TRX_N-00409-30763674,2023-01-06T13:12:06,Amurrio,expenses,food,-60.1,-18895.23
buyer_3,Ana,35,ES04209538845447732310,TRX_N-00410-71437675,2023-01-06T08:18:08,Amurrio,expenses,education,-64.87,-18960.1
buyer_3,Ana,35,ES04209538845447732310,TRX_N-00411-78766452,2023-01-07T20:31:05,Amurrio,expenses,food,-80.8,-19040.9
buyer_3,Ana,35,ES04209538845447732310,TRX_N-00412-03732057,2023-01-07T06:18:11,Amurrio,expenses,leisure,-50.98,-19091.88
buyer_3,Ana,35,ES04209538845447732310,TRX_N-00413-23147326,2023-01-07T20:15:46,Amurrio,expenses,education,-72.43,-19164.31
buyer_3,Ana,35,ES04209538845447732310,TRX_N-00414-23483095,2023-01-08T08:15:25,Amurrio,expenses,electricity,-60.33,-19224.64
buyer_3,Ana,35,ES04209538845447732310,TRX_N-00415-28124445,2023-01-08T09:19:51,Amurrio,expenses,gas,-93.8,-19318.44
buyer_3,Ana,35,ES04209538845447732310,TRX_N-00416-17475968,2023-01-08T10:31:33,Amurrio,expenses,internet,-42.0,-19360.44
buyer_3,Ana,35,ES04209538845447732310,TRX_N-00417-10699875,2023-01-10T04:13:07,Amurrio,expenses,leisure,-67.9,-19428.34
buyer_3,Ana,35,ES04209538845447732310,TRX_N-00418-12964422,2023-01-11T09:23:24,Amurrio,expenses,gifts,-611.4,-20039.74
buyer_3,Ana,35,ES04209538845447732310,TRX_N-00419-34942171,2023-01-12T18:11:41,Amurrio,expenses,food,-111.16,-20150.9
buyer_3,Ana,35,ES04209538845447732310,TRX_N-00420-06684631,2023-01-12T20:57:45,Amurrio,expenses,gifts,-420.59,-20571.49
buyer_3,Ana,35,ES04209538845447732310,TRX_N-00421-92548436,2023-01-13T13:32:45,Lasarte-Oria,expenses,clothing,-68.54,-20640.03
buyer_3,Ana,35,ES04209538845447732310,TRX_N-00422-84827850,2023-01-14T17:41:00,Amurrio,expenses,leisure,-63.32,-20703.35
buyer_3,Ana,35,ES04209538845447732310,TRX_N-00423-18030672,2023-01-18T09:25:59,Amurrio,expenses,travel,-577.11,-21280.46
buyer_3,Ana,35,ES04209538845447732310,TRX_N-00424-09015505,2023-01-21T20:35:31,Amurrio,expenses,repairs,-192.19,-21472.65
buyer_3,Ana,35,ES04209538845447732310,TRX_N-00425-54554073,2023-01-21T12:24:40,Amurrio,expenses,gifts,-810.4,-22283.05
buyer_3,Ana,35,ES04209538845447732310,TRX_N-00426-39681178,2023-01-26T19:13:55,Amurrio,expenses,repairs,-106.87,-22389.92
buyer_3,Ana,35,ES04209538845447732310,TRX_N-00427-26301460,2023-01-27T15:34:27,Sopela,expenses,food,-105.58,-22495.5
buyer_3,Ana,35,ES04209538845447732310,TRX_N-00428-14071480,2023-01-28T17:49:44,Amurrio,expenses,food,-81.35,-22576.85
buyer_3,Ana,35,ES04209538845447732310,TRX_N-00429-57612165,2023-01-28T19:54:05,Amurrio,expenses,healthcare,-124.82,-22701.67
buyer_3,Ana,35,ES04209538845447732310,TRX_N-00430-81036004,2023-01-29T09:40:13,Amurrio,expenses,food,-74.91,-22776.58
buyer_3,Ana,35,ES04209538845447732310,TRX_N-00431-86778938,2023-01-29T14:40:38,Amurrio,expenses,cash,-100.0,-22876.58
buyer_3,Ana,35,ES04209538845447732310,TRX_N-00432-56764815,2023-02-01T19:19:40,Amurrio,incomes,salary,1277.87,-21598.71
buyer_3,Ana,35,ES04209538845447732310,TRX_N-00433-90972972,2023-02-01T19:19:40,Amurrio,incomes,salary_partner,1164.17,-20434.54
buyer_3,Ana,35,ES04209538845447732310,TRX_N-00434-73130768,2023-02-01T14:12:35,Amurrio,expenses,transport,-89.07,-20523.61
buyer_3,Ana,35,ES04209538845447732310,TRX_N-00435-74326313,2023-02-01T10:59:15,Amurrio,expenses,gifts,-70.1,-20593.71
buyer_3,Ana,35,ES04209538845447732310,TRX_N-00436-60765593,2023-02-02T10:48:21,Portugalete,expenses,leisure,-36.19,-20629.9
buyer_3,Ana,35,ES04209538845447732310,TRX_N-00437-92672115,2023-02-03T02:54:10,Amurrio,expenses,leisure,-33.85,-20663.75
buyer_3,Ana,35,ES04209538845447732310,TRX_N-00438-29759404,2023-02-03T20:34:39,Amurrio,expenses,cash,-100.0,-20763.75
buyer_3,Ana,35,ES04209538845447732310,TRX_N-00439-80184180,2023-02-04T06:29:32,Amurrio,expenses,mortgage,-874.64,-21638.39
buyer_3,Ana,35,ES04209538845447732310,TRX_N-00440-13120152,2023-02-04T23:13:38,Amurrio,expenses,cash,-100.0,-21738.39
buyer_3,Ana,35,ES04209538845447732310,TRX_N-00441-48319275,2023-02-05T15:51:07,Amurrio,expenses,electricity,-83.35,-21821.74
buyer_3,Ana,35,ES04209538845447732310,TRX_N-00442-48531689,2023-02-05T09:57:12,Amurrio,expenses,repairs,-216.44,-22038.18
buyer_3,Ana,35,ES04209538845447732310,TRX_N-00443-89621036,2023-02-07T18:30:48,Amurrio,expenses,water,-27.35,-22065.53
buyer_3,Ana,35,ES04209538845447732310,TRX_N-00444-78383692,2023-02-07T09:34:31,Amurrio,expenses,gas,-90.85,-22156.38
buyer_3,Ana,35,ES04209538845447732310,TRX_N-00445-13472942,2023-02-07T16:01:38,Amurrio,expenses,internet,-42.0,-22198.38
buyer_3,Ana,35,ES04209538845447732310,TRX_N-00446-26005666,2023-02-07T07:59:40,Amurrio,expenses,food,-70.43,-22268.81
buyer_3,Ana,35,ES04209538845447732310,TRX_N-00447-90531712,2023-02-07T15:55:09,Amurrio,expenses,cash,-100.0,-22368.81
buyer_3,Ana,35,ES04209538845447732310,TRX_N-00448-66753482,2023-02-08T07:52:07,Amurrio,expenses,phone,-35.7,-22404.51
buyer_3,Ana,35,ES04209538845447732310,TRX_N-00449-97152090,2023-02-08T11:53:40,Amurrio,expenses,repairs,-307.97,-22712.48
buyer_3,Ana,35,ES04209538845447732310,TRX_N-00450-37940038,2023-02-10T08:02:38,Amurrio,expenses,transport,-63.74,-22776.22
buyer_3,Ana,35,ES04209538845447732310,TRX_N-00451-47785689,2023-02-10T14:28:47,Amurrio,expenses,cash,-100.0,-22876.22
buyer_3,Ana,35,ES04209538845447732310,TRX_N-00452-04061358,2023-02-11T18:01:54,Amurrio,expenses,education,-63.82,-22940.04
buyer_3,Ana,35,ES04209538845447732310,TRX_N-00453-27866863,2023-02-12T09:47:28,Amurrio,expenses,transport,-42.02,-22982.06
buyer_3,Ana,35,ES04209538845447732310,TRX_N-00454-73072467,2023-02-14T15:02:44,Bermeo,expenses,travel,-922.05,-23904.11
buyer_3,Ana,35,ES04209538845447732310,TRX_N-00455-52216632,2023-02-17T05:06:01,Amurrio,expenses,transport,-87.61,-23991.72
buyer_3,Ana,35,ES04209538845447732310,TRX_N-00456-17696887,2023-02-17T16:40:00,Amurrio,expenses,clothing,-83.31,-24075.03
buyer_3,Ana,35,ES04209538845447732310,TRX_N-00457-12785216,2023-02-17T20:16:41,Amurrio,expenses,education,-66.87,-24141.9
buyer_3,Ana,35,ES04209538845447732310,TRX_N-00458-87004377,2023-02-19T00:45:44,Amurrio,expenses,leisure,-63.65,-24205.55
buyer_3,Ana,35,ES04209538845447732310,TRX_N-00459-45756334,2023-02-20T15:28:35,Amurrio,expenses,food,-121.95,-24327.5
buyer_3,Ana,35,ES04209538845447732310,TRX_N-00460-76744244,2023-02-20T20:22:49,Amurrio,expenses,gifts,-250.32,-24577.82
buyer_3,Ana,35,ES04209538845447732310,TRX_N-00461-87908466,2023-02-22T13:28:05,Amurrio,expenses,food,-107.31,-24685.13
buyer_3,Ana,35,ES04209538845447732310,TRX_N-00462-35437583,2023-02-22T22:31:26,Amurrio,expenses,repairs,-47.6,-24732.73
buyer_3,Ana,35,ES04209538845447732310,TRX_N-00463-98088119,2023-02-23T17:03:31,Amurrio,expenses,appliances,-142.22,-24874.95
buyer_3,Ana,35,ES04209538845447732310,TRX_N-00464-38637050,2023-02-23T18:57:32,Iruña de Oca,expenses,repairs,-308.85,-25183.8
buyer_3,Ana,35,ES04209538845447732310,TRX_N-00465-16311573,2023-02-24T20:45:25,Amurrio,expenses,gifts,-540.05,-25723.85
buyer_3,Ana,35,ES04209538845447732310,TRX_N-00466-82732755,2023-02-25T12:33:38,Amurrio,expenses,education,-67.89,-25791.74
buyer_3,Ana,35,ES04209538845447732310,TRX_N-00467-61864046,2023-02-27T12:26:43,Portugalete,expenses,cash,-100.0,-25891.74
buyer_3,Ana,35,ES04209538845447732310,TRX_N-00468-44000505,2023-02-28T13:42:37,Amurrio,expenses,food,-75.25,-25966.99
buyer_3,Ana,35,ES04209538845447732310,TRX_N-00469-62872509,2023-03-01T17:26:20,Amurrio,incomes,salary,1277.87,-24689.12
buyer_3,Ana,35,ES04209538845447732310,TRX_N-00470-97628103,2023-03-01T17:26:20,Amurrio,incomes,salary_partner,1164.17,-23524.95
buyer_3,Ana,35,ES04209538845447732310,TRX_N-00471-35896660,2023-03-01T17:26:20,Amurrio,incomes,extra_income,209.99,-23314.96
buyer_3,Ana,35,ES04209538845447732310,TRX_N-00472-91136297,2023-03-03T15:18:08,Amurrio,expenses,food,-105.84,-23420.8
buyer_3,Ana,35,ES04209538845447732310,TRX_N-00473-64931446,2023-03-04T19:23:54,Amurrio,expenses,mortgage,-874.64,-24295.44
buyer_3,Ana,35,ES04209538845447732310,TRX_N-00474-71205272,2023-03-04T08:32:51,Amurrio,expenses,leisure,-72.35,-24367.79
buyer_3,Ana,35,ES04209538845447732310,TRX_N-00475-74152731,2023-03-04T13:45:35,Oyón-Oion,expenses,cash,-100.0,-24467.79
buyer_3,Ana,35,ES04209538845447732310,TRX_N-00476-45165230,2023-03-05T16:16:02,Amurrio,expenses,electricity,-68.62,-24536.41
buyer_3,Ana,35,ES04209538845447732310,TRX_N-00477-29427892,2023-03-05T06:34:15,Amurrio,expenses,gas,-106.61,-24643.02
buyer_3,Ana,35,ES04209538845447732310,TRX_N-00478-85399818,2023-03-06T09:56:03,Amurrio,expenses,internet,-42.0,-24685.02
buyer_3,Ana,35,ES04209538845447732310,TRX_N-00479-47243798,2023-03-07T09:19:31,Amurrio,expenses,leisure,-45.44,-24730.46
buyer_3,Ana,35,ES04209538845447732310,TRX_N-00480-93768458,2023-03-07T20:49:06,Amurrio,expenses,cash,-100.0,-24830.46
buyer_3,Ana,35,ES04209538845447732310,TRX_N-00481-35995079,2023-03-08T08:25:26,Amurrio,expenses,water,-31.83,-24862.29
buyer_3,Ana,35,ES04209538845447732310,TRX_N-00482-84502832,2023-03-08T13:02:18,Amurrio,expenses,phone,-38.4,-24900.69
buyer_3,Ana,35,ES04209538845447732310,TRX_N-00483-69424647,2023-03-08T07:31:46,Amurrio,expenses,food,-74.95,-24975.64
buyer_3,Ana,35,ES04209538845447732310,TRX_N-00484-71097498,2023-03-09T17:23:39,Amurrio,expenses,appliances,-119.44,-25095.08
buyer_3,Ana,35,ES04209538845447732310,TRX_N-00485-00405491,2023-03-11T08:48:58,Amurrio,expenses,gifts,-489.63,-25584.71
buyer_3,Ana,35,ES04209538845447732310,TRX_N-00486-96166027,2023-03-13T20:05:40,Amurrio,expenses,children,-218.43,-25803.14
buyer_3,Ana,35,ES04209538845447732310,TRX_N-00487-16545740,2023-03-14T17:13:23,Amurrio,expenses,food,-71.19,-25874.33
buyer_3,Ana,35,ES04209538845447732310,TRX_N-00488-49169312,2023-03-15T23:31:14,Amurrio,expenses,cash,-100.0,-25974.33
buyer_3,Ana,35,ES04209538845447732310,TRX_N-00489-79508703,2023-03-16T17:09:39,Amurrio,expenses,appliances,-153.76,-26128.09
buyer_3,Ana,35,ES04209538845447732310,TRX_N-00490-52307219,2023-03-17T19:44:19,Amurrio,expenses,repairs,-70.63,-26198.72
buyer_3,Ana,35,ES04209538845447732310,TRX_N-00491-03648181,2023-03-21T16:49:35,Amurrio,expenses,gifts,-40.27,-26238.99
buyer_3,Ana,35,ES04209538845447732310,TRX_N-00492-11301904,2023-03-22T16:31:22,Amurrio,expenses,leisure,-48.75,-26287.74
buyer_3,Ana,35,ES04209538845447732310,TRX_N-00493-87623872,2023-03-23T10:55:45,Amurrio,expenses,clothing,-156.91,-26444.65
buyer_3,Ana,35,ES04209538845447732310,TRX_N-00494-42413005,2023-03-23T22:37:14,Amurrio,expenses,healthcare,-169.55,-26614.2
buyer_3,Ana,35,ES04209538845447732310,TRX_N-00495-07308820,2023-03-24T12:56:36,Amurrio,expenses,food,-124.46,-26738.66
buyer_3,Ana,35,ES04209538845447732310,TRX_N-00496-42144257,2023-03-24T12:29:52,Amurrio,expenses,cash,-100.0,-26838.66
buyer_3,Ana,35,ES04209538845447732310,TRX_N-00497-49520308,2023-03-24T18:34:17,Amurrio,expenses,repairs,-114.53,-26953.19
buyer_3,Ana,35,ES04209538845447732310,TRX_N-00498-73954358,2023-03-24T20:19:24,Amurrio,expenses,gifts,-268.06,-27221.25
buyer_3,Ana,35,ES04209538845447732310,TRX_N-00499-29886380,2023-03-25T12:02:07,Amurrio,expenses,food,-63.28,-27284.53
buyer_3,Ana,35,ES04209538845447732310,TRX_N-00500-25515190,2023-03-25T10:02:12,Pasaia,expenses,repairs,-95.84,-27380.37
buyer_3,Ana,35,ES04209538845447732310,TRX_N-00501-71981428,2023-03-26T11:39:26,Amurrio,expenses,leisure,-45.08,-27425.45
buyer_3,Ana,35,ES04209538845447732310,TRX_N-00502-60582919,2023-03-27T19:46:01,Amurrio,expenses,cash,-100.0,-27525.45
buyer_3,Ana,35,ES04209538845447732310,TRX_N-00503-41096394,2023-03-28T22:11:26,Amurrio,expenses,food,-94.01,-27619.46
buyer_3,Ana,35,ES04209538845447732310,TRX_N-00504-30986812,2023-03-28T14:25:42,Amurrio,expenses,leisure,-18.79,-27638.25
buyer_3,Ana,35,ES04209538845447732310,TRX_N-00505-34259022,2023-03-29T16:30:29,Amurrio,expenses,education,-76.81,-27715.06
buyer_3,Ana,35,ES04209538845447732310,TRX_N-00506-48352245,2023-03-30T14:32:17,Amurrio,expenses,food,-116.25,-27831.31
buyer_3,Ana,35,ES04209538845447732310,TRX_N-00507-86739083,2023-04-01T14:13:10,Amurrio,incomes,salary,1277.87,-26553.44
buyer_3,Ana,35,ES04209538845447732310,TRX_N-00508-18784858,2023-04-01T14:13:10,Amurrio,incomes,salary_partner,1164.17,-25389.27
buyer_3,Ana,35,ES04209538845447732310,TRX_N-00509-50325501,2023-04-01T19:32:16,Hondarribia,expenses,food,-95.1,-25484.37
buyer_3,Ana,35,ES04209538845447732310,TRX_N-00510-70264257,2023-04-01T11:29:57,Amurrio,expenses,clothing,-60.74,-25545.11
buyer_3,Ana,35,ES04209538845447732310,TRX_N-00511-30394618,2023-04-03T08:56:50,Zarautz,expenses,repairs,-180.48,-25725.59
buyer_3,Ana,35,ES04209538845447732310,TRX_N-00512-37059479,2023-04-04T12:53:13,Amurrio,expenses,mortgage,-874.64,-26600.23
buyer_3,Ana,35,ES04209538845447732310,TRX_N-00513-44960075,2023-04-05T18:04:08,Amurrio,expenses,internet,-42.0,-26642.23
buyer_3,Ana,35,ES04209538845447732310,TRX_N-00514-83580315,2023-04-06T16:14:57,Amurrio,expenses,food,-116.2,-26758.43
buyer_3,Ana,35,ES04209538845447732310,TRX_N-00515-58222578,2023-04-06T11:01:11,Amurrio,expenses,cash,-100.0,-26858.43
buyer_3,Ana,35,ES04209538845447732310,TRX_N-00516-68563969,2023-04-07T06:33:51,Amurrio,expenses,transport,-54.97,-26913.4
buyer_3,Ana,35,ES04209538845447732310,TRX_N-00517-51890237,2023-04-08T19:10:18,Amurrio,expenses,water,-30.43,-26943.83
buyer_3,Ana,35,ES04209538845447732310,TRX_N-00518-92835893,2023-04-08T19:52:44,Amurrio,expenses,electricity,-56.25,-27000.08
buyer_3,Ana,35,ES04209538845447732310,TRX_N-00519-88764295,2023-04-08T22:48:39,Amurrio,expenses,gas,-92.89,-27092.97
buyer_3,Ana,35,ES04209538845447732310,TRX_N-00520-06206569,2023-04-08T20:21:11,Amurrio,expenses,phone,-35.89,-27128.86
buyer_3,Ana,35,ES04209538845447732310,TRX_N-00521-67432608,2023-04-09T22:29:24,Barakaldo,expenses,food,-82.8,-27211.66
buyer_3,Ana,35,ES04209538845447732310,TRX_N-00522-37698239,2023-04-10T12:42:13,Amurrio,expenses,leisure,-63.49,-27275.15
buyer_3,Ana,35,ES04209538845447732310,TRX_N-00523-03093967,2023-04-11T13:45:35,Amurrio,expenses,children,-180.96,-27456.11
buyer_3,Ana,35,ES04209538845447732310,TRX_N-00524-58862074,2023-04-14T08:05:48,Sestao,expenses,transport,-59.23,-27515.34
buyer_3,Ana,35,ES04209538845447732310,TRX_N-00525-36042848,2023-04-19T16:53:49,Amurrio,expenses,food,-97.66,-27613.0
buyer_3,Ana,35,ES04209538845447732310,TRX_N-00526-30195055,2023-04-19T15:11:04,Amurrio,expenses,healthcare,-113.3,-27726.3
buyer_3,Ana,35,ES04209538845447732310,TRX_N-00527-56769824,2023-04-20T08:39:44,Amurrio,expenses,leisure,-29.59,-27755.89
buyer_3,Ana,35,ES04209538845447732310,TRX_N-00528-68120670,2023-04-22T16:53:25,Amurrio,expenses,transport,-63.32,-27819.21
buyer_3,Ana,35,ES04209538845447732310,TRX_N-00529-74999991,2023-04-24T23:44:45,Amurrio,expenses,food,-95.82,-27915.03
buyer_3,Ana,35,ES04209538845447732310,TRX_N-00530-74632533,2023-04-24T19:27:12,Amurrio,expenses,transport,-75.62,-27990.65
buyer_3,Ana,35,ES04209538845447732310,TRX_N-00531-61425121,2023-04-24T16:29:36,Amurrio,expenses,education,-70.71,-28061.36
buyer_3,Ana,35,ES04209538845447732310,TRX_N-00532-81232248,2023-04-24T14:58:28,Amurrio,expenses,cash,-100.0,-28161.36
buyer_3,Ana,35,ES04209538845447732310,TRX_N-00533-20944097,2023-04-25T18:55:52,Amurrio,expenses,food,-111.79,-28273.15
buyer_3,Ana,35,ES04209538845447732310,TRX_N-00534-31273771,2023-04-25T18:40:01,Amurrio,expenses,children,-143.06,-28416.21
buyer_3,Ana,35,ES04209538845447732310,TRX_N-00535-95774820,2023-04-26T18:39:03,Amurrio,expenses,children,-263.36,-28679.57
buyer_3,Ana,35,ES04209538845447732310,TRX_N-00536-81346388,2023-04-27T09:28:46,Salvatierra/Agurain,expenses,appliances,-339.29,-29018.86
buyer_3,Ana,35,ES04209538845447732310,TRX_N-00537-83900318,2023-04-30T09:56:52,Amurrio,expenses,leisure,-82.97,-29101.83
buyer_3,Ana,35,ES04209538845447732310,TRX_N-00538-85877888,2023-05-01T05:19:28,Amurrio,incomes,salary,1277.87,-27823.96
buyer_3,Ana,35,ES04209538845447732310,TRX_N-00539-02130028,2023-05-01T05:19:28,Amurrio,incomes,salary_partner,1164.17,-26659.79
buyer_3,Ana,35,ES04209538845447732310,TRX_N-00540-80924527,2023-05-02T20:04:20,Amurrio,expenses,food,-87.22,-26747.01
buyer_3,Ana,35,ES04209538845447732310,TRX_N-00541-67345049,2023-05-04T15:28:03,Amurrio,expenses,mortgage,-874.64,-27621.65
buyer_3,Ana,35,ES04209538845447732310,TRX_N-00542-14213690,2023-05-04T20:45:34,Amurrio,expenses,transport,-81.36,-27703.01
buyer_3,Ana,35,ES04209538845447732310,TRX_N-00543-77574209,2023-05-04T11:18:02,Amurrio,expenses,leisure,-79.96,-27782.97
buyer_3,Ana,35,ES04209538845447732310,TRX_N-00544-07939670,2023-05-05T20:22:32,Amurrio,expenses,gas,-63.07,-27846.04
buyer_3,Ana,35,ES04209538845447732310,TRX_N-00545-48512495,2023-05-06T22:54:35,Amurrio,expenses,water,-22.03,-27868.07
buyer_3,Ana,35,ES04209538845447732310,TRX_N-00546-56323999,2023-05-06T15:41:56,Amurrio,expenses,phone,-34.16,-27902.23
buyer_3,Ana,35,ES04209538845447732310,TRX_N-00547-15168567,2023-05-07T02:26:45,Amurrio,expenses,internet,-42.0,-27944.23
buyer_3,Ana,35,ES04209538845447732310,TRX_N-00548-03214675,2023-05-07T14:44:48,Amurrio,expenses,clothing,-92.64,-28036.87
buyer_3,Ana,35,ES04209538845447732310,TRX_N-00549-19287205,2023-05-07T15:24:31,Amurrio,expenses,cash,-100.0,-28136.87
buyer_3,Ana,35,ES04209538845447732310,TRX_N-00550-21541672,2023-05-08T15:45:33,Amurrio,expenses,electricity,-58.24,-28195.11
buyer_3,Ana,35,ES04209538845447732310,TRX_N-00551-76955601,2023-05-09T18:55:50,Pasaia,expenses,food,-67.35,-28262.46
buyer_3,Ana,35,ES04209538845447732310,TRX_N-00552-39909650,2023-05-10T18:21:23,Amurrio,expenses,appliances,-286.58,-28549.04
buyer_3,Ana,35,ES04209538845447732310,TRX_N-00553-70857004,2023-05-11T04:42:23,Amurrio,expenses,leisure,-56.97,-28606.01
buyer_3,Ana,35,ES04209538845447732310,TRX_N-00554-05611165,2023-05-11T04:28:29,Amurrio,expenses,gifts,-385.91,-28991.92
buyer_3,Ana,35,ES04209538845447732310,TRX_N-00555-56834028,2023-05-12T13:30:00,Amurrio,expenses,transport,-60.03,-29051.95
buyer_3,Ana,35,ES04209538845447732310,TRX_N-00556-96938579,2023-05-13T22:35:36,Amurrio,expenses,children,-87.13,-29139.08
buyer_3,Ana,35,ES04209538845447732310,TRX_N-00557-23730147,2023-05-15T20:42:45,Amurrio,expenses,leisure,-40.01,-29179.09
buyer_3,Ana,35,ES04209538845447732310,TRX_N-00558-48599043,2023-05-19T05:22:06,Amurrio,expenses,cash,-100.0,-29279.09
buyer_3,Ana,35,ES04209538845447732310,TRX_N-00559-90122614,2023-05-20T12:03:37,Amurrio,expenses,appliances,-163.18,-29442.27
buyer_3,Ana,35,ES04209538845447732310,TRX_N-00560-40401614,2023-05-22T08:14:40,Amurrio,expenses,food,-81.52,-29523.79
buyer_3,Ana,35,ES04209538845447732310,TRX_N-00561-52944974,2023-05-22T17:19:56,Amurrio,expenses,cash,-100.0,-29623.79
buyer_3,Ana,35,ES04209538845447732310,TRX_N-00562-29021581,2023-05-23T05:34:23,Amurrio,expenses,transport,-86.05,-29709.84
buyer_3,Ana,35,ES04209538845447732310,TRX_N-00563-71945626,2023-05-26T18:32:19,Amurrio,expenses,food,-60.16,-29770.0
buyer_3,Ana,35,ES04209538845447732310,TRX_N-00564-68991420,2023-05-28T13:35:10,Bilbao,expenses,repairs,-235.87,-30005.87
buyer_3,Ana,35,ES04209538845447732310,TRX_N-00565-82653464,2023-05-31T11:28:55,Amurrio,expenses,transport,-43.12,-30048.99
buyer_3,Ana,35,ES04209538845447732310,TRX_N-00566-66770047,2023-06-01T08:24:41,Amurrio,incomes,salary,1277.87,-28771.12
buyer_3,Ana,35,ES04209538845447732310,TRX_N-00567-21789946,2023-06-01T08:24:41,Amurrio,incomes,salary_partner,1164.17,-27606.95
buyer_3,Ana,35,ES04209538845447732310,TRX_N-00568-01507942,2023-06-01T08:24:41,Amurrio,incomes,salary_bonus,1021.49,-26585.46
buyer_3,Ana,35,ES04209538845447732310,TRX_N-00569-93598521,2023-06-01T08:24:41,Amurrio,incomes,salary_partner_bonus,909.3,-25676.16
buyer_3,Ana,35,ES04209538845447732310,TRX_N-00570-36594227,2023-06-01T03:28:12,Amurrio,expenses,clothing,-95.04,-25771.2
buyer_3,Ana,35,ES04209538845447732310,TRX_N-00571-75189017,2023-06-01T01:15:41,Amurrio,expenses,cash,-100.0,-25871.2
buyer_3,Ana,35,ES04209538845447732310,TRX_N-00572-94622858,2023-06-02T13:22:31,Llodio,expenses,food,-114.9,-25986.1
buyer_3,Ana,35,ES04209538845447732310,TRX_N-00573-37638841,2023-06-03T18:29:34,Amurrio,expenses,cash,-100.0,-26086.1
buyer_3,Ana,35,ES04209538845447732310,TRX_N-00574-61580960,2023-06-04T10:50:59,Amurrio,expenses,mortgage,-874.64,-26960.74
buyer_3,Ana,35,ES04209538845447732310,TRX_N-00575-42701402,2023-06-04T12:57:48,Hernani,expenses,leisure,-84.55,-27045.29
buyer_3,Ana,35,ES04209538845447732310,TRX_N-00576-86156059,2023-06-04T19:52:22,Amurrio,expenses,children,-192.6,-27237.89
buyer_3,Ana,35,ES04209538845447732310,TRX_N-00577-02346946,2023-06-05T20:07:04,Amurrio,expenses,phone,-43.26,-27281.15
buyer_3,Ana,35,ES04209538845447732310,TRX_N-00578-66076194,2023-06-06T16:03:56,Amurrio,expenses,leisure,-45.4,-27326.55
buyer_3,Ana,35,ES04209538845447732310,TRX_N-00579-58113011,2023-06-06T11:53:47,Amurrio,expenses,repairs,-253.37,-27579.92
buyer_3,Ana,35,ES04209538845447732310,TRX_N-00580-75799267,2023-06-07T14:12:28,Amurrio,expenses,gas,-113.83,-27693.75
buyer_3,Ana,35,ES04209538845447732310,TRX_N-00581-45122497,2023-06-08T14:17:57,Amurrio,expenses,water,-32.83,-27726.58
buyer_3,Ana,35,ES04209538845447732310,TRX_N-00582-25933072,2023-06-08T08:03:34,Amurrio,expenses,electricity,-89.11,-27815.69
buyer_3,Ana,35,ES04209538845447732310,TRX_N-00583-18957874,2023-06-08T10:03:10,Amurrio,expenses,internet,-42.0,-27857.69
buyer_3,Ana,35,ES04209538845447732310,TRX_N-00584-33744451,2023-06-10T15:51:37,Amurrio,expenses,food,-77.72,-27935.41
buyer_3,Ana,35,ES04209538845447732310,TRX_N-00585-79814838,2023-06-10T13:44:49,Amurrio,expenses,cash,-100.0,-28035.41
buyer_3,Ana,35,ES04209538845447732310,TRX_N-00586-87377445,2023-06-10T05:48:47,Andoain,expenses,repairs,-294.78,-28330.19
buyer_3,Ana,35,ES04209538845447732310,TRX_N-00587-19241184,2023-06-12T20:19:42,Amurrio,expenses,healthcare,-183.11,-28513.3
buyer_3,Ana,35,ES04209538845447732310,TRX_N-00588-33354932,2023-06-13T18:50:52,Amurrio,expenses,leisure,-33.43,-28546.73
buyer_3,Ana,35,ES04209538845447732310,TRX_N-00589-42375055,2023-06-13T08:36:55,Amurrio,expenses,clothing,-110.92,-28657.65
buyer_3,Ana,35,ES04209538845447732310,TRX_N-00590-84207852,2023-06-13T08:16:00,Amurrio,expenses,appliances,-281.84,-28939.49
buyer_3,Ana,35,ES04209538845447732310,TRX_N-00591-07093360,2023-06-14T03:01:22,Amurrio,expenses,travel,-1034.1,-29973.59
buyer_3,Ana,35,ES04209538845447732310,TRX_N-00592-18168505,2023-06-16T09:44:42,Amurrio,expenses,gifts,-386.32,-30359.91
buyer_3,Ana,35,ES04209538845447732310,TRX_N-00593-68955454,2023-06-17T10:37:41,Amurrio,expenses,cash,-100.0,-30459.91
buyer_3,Ana,35,ES04209538845447732310,TRX_N-00594-80184584,2023-06-20T16:42:58,Amurrio,expenses,gifts,-561.6,-31021.51
buyer_3,Ana,35,ES04209538845447732310,TRX_N-00595-17553983,2023-06-22T15:19:55,Amurrio,expenses,food,-86.55,-31108.06
buyer_3,Ana,35,ES04209538845447732310,TRX_N-00596-01602442,2023-06-23T11:57:31,Errenteria,expenses,cash,-100.0,-31208.06
buyer_3,Ana,35,ES04209538845447732310,TRX_N-00597-99902689,2023-06-24T21:20:19,Amurrio,expenses,leisure,-75.22,-31283.28
buyer_3,Ana,35,ES04209538845447732310,TRX_N-00598-89161521,2023-06-27T17:03:59,Erandio,expenses,leisure,-49.85,-31333.13
buyer_3,Ana,35,ES04209538845447732310,TRX_N-00599-43651882,2023-06-28T11:06:50,Donostia,expenses,cash,-100.0,-31433.13
buyer_3,Ana,35,ES04209538845447732310,TRX_N-00600-08606251,2023-06-30T03:40:22,Oyón-Oion,expenses,education,-45.29,-31478.42
buyer_3,Ana,35,ES04209538845447732310,TRX_N-00601-41403848,2023-07-01T19:12:14,Amurrio,incomes,salary,1277.87,-30200.55
buyer_3,Ana,35,ES04209538845447732310,TRX_N-00602-12198925,2023-07-01T19:12:14,Amurrio,incomes,salary_partner,1164.17,-29036.38
buyer_3,Ana,35,ES04209538845447732310,TRX_N-00603-15179413,2023-07-01T19:12:14,Amurrio,incomes,extra_income,209.99,-28826.39
buyer_3,Ana,35,ES04209538845447732310,TRX_N-00604-19436968,2023-07-01T15:12:41,Amurrio,expenses,cash,-100.0,-28926.39
buyer_3,Ana,35,ES04209538845447732310,TRX_N-00605-82917650,2023-07-04T20:57:56,Amurrio,expenses,mortgage,-874.64,-29801.03
buyer_3,Ana,35,ES04209538845447732310,TRX_N-00606-88586443,2023-07-04T19:12:46,Amurrio,expenses,education,-73.72,-29874.75
buyer_3,Ana,35,ES04209538845447732310,TRX_N-00607-72890126,2023-07-04T19:18:35,Hondarribia,expenses,gifts,-314.65,-30189.4
buyer_3,Ana,35,ES04209538845447732310,TRX_N-00608-57140635,2023-07-05T15:05:06,Amurrio,expenses,water,-20.68,-30210.08
buyer_3,Ana,35,ES04209538845447732310,TRX_N-00609-31406281,2023-07-06T19:39:00,Amurrio,expenses,food,-69.94,-30280.02
buyer_3,Ana,35,ES04209538845447732310,TRX_N-00610-96136782,2023-07-06T15:20:13,Amurrio,expenses,repairs,-251.76,-30531.78
buyer_3,Ana,35,ES04209538845447732310,TRX_N-00611-36091854,2023-07-07T14:39:31,Amurrio,expenses,gas,-45.02,-30576.8
buyer_3,Ana,35,ES04209538845447732310,TRX_N-00612-27514783,2023-07-08T12:10:16,Amurrio,expenses,electricity,-25.0,-30601.8
buyer_3,Ana,35,ES04209538845447732310,TRX_N-00613-59375836,2023-07-08T15:32:43,Amurrio,expenses,internet,-42.0,-30643.8
buyer_3,Ana,35,ES04209538845447732310,TRX_N-00614-41673260,2023-07-08T12:20:45,Amurrio,expenses,phone,-37.27,-30681.07
buyer_3,Ana,35,ES04209538845447732310,TRX_N-00615-96376273,2023-07-10T13:32:52,Errenteria,expenses,food,-111.01,-30792.08
buyer_3,Ana,35,ES04209538845447732310,TRX_N-00616-67519859,2023-07-10T16:09:30,Berango,expenses,leisure,-25.97,-30818.05
buyer_3,Ana,35,ES04209538845447732310,TRX_N-00617-11697830,2023-07-10T11:10:48,Errenteria,expenses,healthcare,-42.71,-30860.76
buyer_3,Ana,35,ES04209538845447732310,TRX_N-00618-97671981,2023-07-11T11:46:46,Amurrio,expenses,cash,-100.0,-30960.76
buyer_3,Ana,35,ES04209538845447732310,TRX_N-00619-23769889,2023-07-13T13:10:22,Amurrio,expenses,clothing,-125.16,-31085.92
buyer_3,Ana,35,ES04209538845447732310,TRX_N-00620-51744848,2023-07-13T16:40:38,Amurrio,expenses,repairs,-120.97,-31206.89
buyer_3,Ana,35,ES04209538845447732310,TRX_N-00621-34120235,2023-07-14T18:04:52,Amurrio,expenses,leisure,-55.78,-31262.67
buyer_3,Ana,35,ES04209538845447732310,TRX_N-00622-12770958,2023-07-14T17:57:40,Arrasate,expenses,cash,-100.0,-31362.67
buyer_3,Ana,35,ES04209538845447732310,TRX_N-00623-80899205,2023-07-14T05:55:59,Amurrio,expenses,gifts,-60.67,-31423.34
buyer_3,Ana,35,ES04209538845447732310,TRX_N-00624-42085479,2023-07-15T15:38:55,Irun,expenses,cash,-100.0,-31523.34
buyer_3,Ana,35,ES04209538845447732310,TRX_N-00625-41049628,2023-07-16T08:05:58,Amurrio,expenses,leisure,-36.44,-31559.78
buyer_3,Ana,35,ES04209538845447732310,TRX_N-00626-86065581,2023-07-16T16:42:05,Amurrio,expenses,appliances,-296.23,-31856.01
buyer_3,Ana,35,ES04209538845447732310,TRX_N-00627-39004779,2023-07-17T13:45:44,Amurrio,expenses,food,-73.23,-31929.24
buyer_3,Ana,35,ES04209538845447732310,TRX_N-00628-62214210,2023-07-17T03:13:55,Amurrio,expenses,repairs,-239.02,-32168.26
buyer_3,Ana,35,ES04209538845447732310,TRX_N-00629-33200952,2023-07-18T08:26:01,Portugalete,expenses,food,-106.12,-32274.38
buyer_3,Ana,35,ES04209538845447732310,TRX_N-00630-52865407,2023-07-19T20:10:30,Amurrio,expenses,cash,-100.0,-32374.38
buyer_3,Ana,35,ES04209538845447732310,TRX_N-00631-06781840,2023-07-19T11:25:55,Durango,expenses,gifts,-649.72,-33024.1
buyer_3,Ana,35,ES04209538845447732310,TRX_N-00632-23247944,2023-07-21T17:26:10,Amurrio,expenses,education,-57.41,-33081.51
buyer_3,Ana,35,ES04209538845447732310,TRX_N-00633-64697167,2023-07-21T20:15:10,Vitoria-Gasteiz,expenses,repairs,-215.05,-33296.56
buyer_3,Ana,35,ES04209538845447732310,TRX_N-00634-51506728,2023-07-23T02:59:22,Amurrio,expenses,transport,-65.21,-33361.77
buyer_3,Ana,35,ES04209538845447732310,TRX_N-00635-71086850,2023-07-24T08:38:26,Bilbao,expenses,transport,-63.77,-33425.54
buyer_3,Ana,35,ES04209538845447732310,TRX_N-00636-74579807,2023-07-24T10:47:28,Amurrio,expenses,clothing,-92.76,-33518.3
buyer_3,Ana,35,ES04209538845447732310,TRX_N-00637-50223696,2023-07-24T08:10:01,Hondarribia,expenses,gifts,-132.2,-33650.5
buyer_3,Ana,35,ES04209538845447732310,TRX_N-00638-82215794,2023-07-25T15:42:12,Amurrio,expenses,cash,-100.0,-33750.5
buyer_3,Ana,35,ES04209538845447732310,TRX_N-00639-92237953,2023-07-26T21:10:20,Amurrio,expenses,food,-89.15,-33839.65
buyer_3,Ana,35,ES04209538845447732310,TRX_N-00640-20109713,2023-07-27T05:27:46,Amurrio,expenses,cash,-100.0,-33939.65
buyer_3,Ana,35,ES04209538845447732310,TRX_N-00641-67409814,2023-08-01T12:16:20,Amurrio,incomes,salary,1277.87,-32661.78
buyer_3,Ana,35,ES04209538845447732310,TRX_N-00642-54248980,2023-08-01T12:16:20,Amurrio,incomes,salary_partner,1164.17,-31497.61
buyer_3,Ana,35,ES04209538845447732310,TRX_N-00643-24913197,2023-08-02T11:04:38,Amurrio,expenses,repairs,-309.43,-31807.04
buyer_3,Ana,35,ES04209538845447732310,TRX_N-00644-54125692,2023-08-03T18:39:32,Amurrio,expenses,gifts,-415.99,-32223.03
buyer_3,Ana,35,ES04209538845447732310,TRX_N-00645-19443346,2023-08-04T19:53:06,Amurrio,expenses,mortgage,-874.64,-33097.67
buyer_3,Ana,35,ES04209538845447732310,TRX_N-00646-19165133,2023-08-05T17:10:14,Amurrio,expenses,electricity,-80.13,-33177.8
buyer_3,Ana,35,ES04209538845447732310,TRX_N-00647-53148875,2023-08-05T16:27:19,Amurrio,expenses,internet,-42.0,-33219.8
buyer_3,Ana,35,ES04209538845447732310,TRX_N-00648-72702918,2023-08-05T04:27:34,Amurrio,expenses,appliances,-415.79,-33635.59
buyer_3,Ana,35,ES04209538845447732310,TRX_N-00649-92912802,2023-08-06T18:31:59,Oyón-Oion,expenses,transport,-76.03,-33711.62
buyer_3,Ana,35,ES04209538845447732310,TRX_N-00650-06264278,2023-08-07T12:13:16,Amurrio,expenses,gas,-92.7,-33804.32
buyer_3,Ana,35,ES04209538845447732310,TRX_N-00651-12035510,2023-08-07T06:45:08,Amurrio,expenses,phone,-44.28,-33848.6
buyer_3,Ana,35,ES04209538845447732310,TRX_N-00652-58467263,2023-08-07T17:39:38,Amurrio,expenses,cash,-100.0,-33948.6
buyer_3,Ana,35,ES04209538845447732310,TRX_N-00653-40289730,2023-08-08T18:56:59,Amurrio,expenses,water,-42.99,-33991.59
buyer_3,Ana,35,ES04209538845447732310,TRX_N-00654-50464476,2023-08-09T20:17:00,Amurrio,expenses,food,-69.83,-34061.42
buyer_3,Ana,35,ES04209538845447732310,TRX_N-00655-55230595,2023-08-11T13:49:15,Amurrio,expenses,cash,-100.0,-34161.42
buyer_3,Ana,35,ES04209538845447732310,TRX_N-00656-68421387,2023-08-12T11:27:00,Amurrio,expenses,cash,-100.0,-34261.42
buyer_3,Ana,35,ES04209538845447732310,TRX_N-00657-79586492,2023-08-12T01:52:56,Amurrio,expenses,gifts,-269.99,-34531.41
buyer_3,Ana,35,ES04209538845447732310,TRX_N-00658-07723452,2023-08-13T13:12:47,Amurrio,expenses,education,-76.33,-34607.74
buyer_3,Ana,35,ES04209538845447732310,TRX_N-00659-03831700,2023-08-14T23:49:08,Amurrio,expenses,cash,-100.0,-34707.74
buyer_3,Ana,35,ES04209538845447732310,TRX_N-00660-87374162,2023-08-14T23:44:23,Amurrio,expenses,repairs,-156.07,-34863.81
buyer_3,Ana,35,ES04209538845447732310,TRX_N-00661-12324856,2023-08-15T17:19:41,Amurrio,expenses,leisure,-46.67,-34910.48
buyer_3,Ana,35,ES04209538845447732310,TRX_N-00662-37888236,2023-08-19T09:44:56,Amurrio,expenses,children,-74.75,-34985.23
buyer_3,Ana,35,ES04209538845447732310,TRX_N-00663-18608228,2023-08-21T11:25:08,Basauri,expenses,clothing,-157.21,-35142.44
buyer_3,Ana,35,ES04209538845447732310,TRX_N-00664-60766753,2023-08-21T14:52:29,Amurrio,expenses,cash,-100.0,-35242.44
buyer_3,Ana,35,ES04209538845447732310,TRX_N-00665-54463340,2023-08-21T12:48:07,Amurrio,expenses,children,-134.91,-35377.35
buyer_3,Ana,35,ES04209538845447732310,TRX_N-00666-33420281,2023-08-23T23:04:30,Amurrio,expenses,cash,-100.0,-35477.35
buyer_3,Ana,35,ES04209538845447732310,TRX_N-00667-58650093,2023-08-25T14:33:53,Amurrio,expenses,clothing,-51.41,-35528.76
buyer_3,Ana,35,ES04209538845447732310,TRX_N-00668-72289992,2023-08-26T20:05:22,Amurrio,expenses,leisure,-74.59,-35603.35
buyer_3,Ana,35,ES04209538845447732310,TRX_N-00669-88584738,2023-08-26T20:37:40,Amurrio,expenses,cash,-100.0,-35703.35
buyer_3,Ana,35,ES04209538845447732310,TRX_N-00670-77623794,2023-08-28T12:23:42,Amurrio,expenses,transport,-68.16,-35771.51
buyer_3,Ana,35,ES04209538845447732310,TRX_N-00671-04120900,2023-08-29T17:23:47,Amurrio,expenses,cash,-100.0,-35871.51
buyer_3,Ana,35,ES04209538845447732310,TRX_N-00672-19204516,2023-09-01T09:31:10,Amurrio,incomes,salary,1277.87,-34593.64
buyer_3,Ana,35,ES04209538845447732310,TRX_N-00673-97462684,2023-09-01T09:31:10,Amurrio,incomes,salary_partner,1164.17,-33429.47
buyer_3,Ana,35,ES04209538845447732310,TRX_N-00674-58801447,2023-09-02T17:47:44,Amurrio,expenses,clothing,-50.07,-33479.54
buyer_3,Ana,35,ES04209538845447732310,TRX_N-00675-91297676,2023-09-02T13:51:29,Amurrio,expenses,repairs,-42.11,-33521.65
buyer_3,Ana,35,ES04209538845447732310,TRX_N-00676-64227821,2023-09-03T12:27:23,Amurrio,expenses,appliances,-215.46,-33737.11
buyer_3,Ana,35,ES04209538845447732310,TRX_N-00677-02395551,2023-09-04T09:17:47,Amurrio,expenses,mortgage,-874.64,-34611.75
buyer_3,Ana,35,ES04209538845447732310,TRX_N-00678-89815750,2023-09-05T16:15:38,Amurrio,expenses,leisure,-59.44,-34671.19
buyer_3,Ana,35,ES04209538845447732310,TRX_N-00679-78039371,2023-09-06T18:35:45,Amurrio,expenses,internet,-42.0,-34713.19
buyer_3,Ana,35,ES04209538845447732310,TRX_N-00680-70058264,2023-09-06T21:02:11,Amurrio,expenses,food,-124.1,-34837.29
buyer_3,Ana,35,ES04209538845447732310,TRX_N-00681-28370924,2023-09-06T19:58:20,Amurrio,expenses,leisure,-75.65,-34912.94
buyer_3,Ana,35,ES04209538845447732310,TRX_N-00682-90801779,2023-09-06T09:47:43,Amurrio,expenses,cash,-100.0,-35012.94
buyer_3,Ana,35,ES04209538845447732310,TRX_N-00683-57527548,2023-09-07T12:05:01,Amurrio,expenses,gas,-45.61,-35058.55
buyer_3,Ana,35,ES04209538845447732310,TRX_N-00684-97209410,2023-09-07T08:36:47,Amurrio,expenses,cash,-100.0,-35158.55
buyer_3,Ana,35,ES04209538845447732310,TRX_N-00685-03005935,2023-09-07T08:41:21,Amurrio,expenses,travel,-463.07,-35621.62
buyer_3,Ana,35,ES04209538845447732310,TRX_N-00686-17278328,2023-09-08T19:54:40,Amurrio,expenses,water,-24.83,-35646.45
buyer_3,Ana,35,ES04209538845447732310,TRX_N-00687-44794929,2023-09-08T08:03:42,Amurrio,expenses,electricity,-73.5,-35719.95
buyer_3,Ana,35,ES04209538845447732310,TRX_N-00688-50137200,2023-09-08T14:02:47,Amurrio,expenses,phone,-44.04,-35763.99
buyer_3,Ana,35,ES04209538845447732310,TRX_N-00689-94744737,2023-09-08T19:23:50,Amurrio,expenses,food,-124.8,-35888.79
buyer_3,Ana,35,ES04209538845447732310,TRX_N-00690-46573997,2023-09-09T17:07:07,Amurrio,expenses,education,-59.99,-35948.78
buyer_3,Ana,35,ES04209538845447732310,TRX_N-00691-00615333,2023-09-11T10:42:32,Amurrio,expenses,food,-122.08,-36070.86
buyer_3,Ana,35,ES04209538845447732310,TRX_N-00692-75834437,2023-09-11T20:20:23,Amurrio,expenses,transport,-49.86,-36120.72
buyer_3,Ana,35,ES04209538845447732310,TRX_N-00693-69012150,2023-09-11T10:50:21,Amurrio,expenses,clothing,-123.19,-36243.91
buyer_3,Ana,35,ES04209538845447732310,TRX_N-00694-19573687,2023-09-12T15:55:49,Amurrio,expenses,leisure,-39.19,-36283.1
buyer_3,Ana,35,ES04209538845447732310,TRX_N-00695-05162294,2023-09-14T12:14:53,Amurrio,expenses,cash,-100.0,-36383.1
buyer_3,Ana,35,ES04209538845447732310,TRX_N-00696-94715334,2023-09-17T13:19:47,Getxo,expenses,cash,-100.0,-36483.1
buyer_3,Ana,35,ES04209538845447732310,TRX_N-00697-45908646,2023-09-18T19:28:18,Amurrio,expenses,food,-72.67,-36555.77
buyer_3,Ana,35,ES04209538845447732310,TRX_N-00698-13126568,2023-09-18T18:21:48,Amurrio,expenses,cash,-100.0,-36655.77
buyer_3,Ana,35,ES04209538845447732310,TRX_N-00699-68431161,2023-09-20T20:09:10,Erandio,expenses,leisure,-43.38,-36699.15
buyer_3,Ana,35,ES04209538845447732310,TRX_N-00700-03756683,2023-09-20T11:15:45,Barakaldo,expenses,education,-70.5,-36769.65
buyer_3,Ana,35,ES04209538845447732310,TRX_N-00701-81603252,2023-09-21T23:55:33,Amurrio,expenses,clothing,-63.46,-36833.11
buyer_3,Ana,35,ES04209538845447732310,TRX_N-00702-73137512,2023-09-22T04:46:55,Amurrio,expenses,clothing,-104.55,-36937.66
buyer_3,Ana,35,ES04209538845447732310,TRX_N-00703-49620351,2023-09-24T12:37:01,Amurrio,expenses,cash,-100.0,-37037.66
buyer_3,Ana,35,ES04209538845447732310,TRX_N-00704-82426833,2023-09-25T10:31:10,Amurrio,expenses,transport,-81.83,-37119.49
buyer_3,Ana,35,ES04209538845447732310,TRX_N-00705-94603311,2023-09-26T18:44:27,Amurrio,expenses,food,-70.15,-37189.64
buyer_3,Ana,35,ES04209538845447732310,TRX_N-00706-97453844,2023-09-26T13:48:09,Amurrio,expenses,cash,-100.0,-37289.64
buyer_3,Ana,35,ES04209538845447732310,TRX_N-00707-11194611,2023-09-26T16:52:55,Amurrio,expenses,gifts,-729.19,-38018.83
buyer_3,Ana,35,ES04209538845447732310,TRX_N-00708-65183378,2023-09-27T12:47:16,Amurrio,expenses,education,-42.16,-38060.99
buyer_3,Ana,35,ES04209538845447732310,TRX_N-00709-43178749,2023-09-29T08:59:15,Amurrio,expenses,leisure,-79.96,-38140.95
buyer_3,Ana,35,ES04209538845447732310,TRX_N-00710-53794628,2023-09-30T16:32:04,Amurrio,expenses,leisure,-38.31,-38179.26
buyer_3,Ana,35,ES04209538845447732310,TRX_N-00711-71117423,2023-09-30T14:49:03,Amurrio,expenses,children,-55.85,-38235.11
buyer_3,Ana,35,ES04209538845447732310,TRX_N-00712-05068725,2023-10-01T06:14:01,Amurrio,incomes,salary,1277.87,-36957.24
buyer_3,Ana,35,ES04209538845447732310,TRX_N-00713-94256410,2023-10-01T06:14:01,Amurrio,incomes,salary_partner,1164.17,-35793.07
buyer_3,Ana,35,ES04209538845447732310,TRX_N-00714-81137924,2023-10-01T06:14:01,Amurrio,incomes,extra_income,209.99,-35583.08
buyer_3,Ana,35,ES04209538845447732310,TRX_N-00715-22420525,2023-10-04T11:18:16,Amurrio,expenses,mortgage,-874.64,-36457.72
buyer_3,Ana,35,ES04209538845447732310,TRX_N-00716-14265814,2023-10-04T17:39:41,Amurrio,expenses,healthcare,-68.31,-36526.03
buyer_3,Ana,35,ES04209538845447732310,TRX_N-00717-90358144,2023-10-05T10:07:09,Amurrio,expenses,internet,-42.0,-36568.03
buyer_3,Ana,35,ES04209538845447732310,TRX_N-00718-94878521,2023-10-06T10:39:39,Amurrio,expenses,electricity,-45.01,-36613.04
buyer_3,Ana,35,ES04209538845447732310,TRX_N-00719-52294180,2023-10-06T09:52:06,Amurrio,expenses,phone,-32.14,-36645.18
buyer_3,Ana,35,ES04209538845447732310,TRX_N-00720-55323783,2023-10-06T11:58:37,Amurrio,expenses,food,-86.52,-36731.7
buyer_3,Ana,35,ES04209538845447732310,TRX_N-00721-39846124,2023-10-06T08:00:13,Amurrio,expenses,healthcare,-186.93,-36918.63
buyer_3,Ana,35,ES04209538845447732310,TRX_N-00722-41001218,2023-10-07T13:29:17,Amurrio,expenses,food,-83.55,-37002.18
buyer_3,Ana,35,ES04209538845447732310,TRX_N-00723-10591378,2023-10-07T19:05:04,Amurrio,expenses,leisure,-42.35,-37044.53
buyer_3,Ana,35,ES04209538845447732310,TRX_N-00724-22357990,2023-10-08T19:43:00,Amurrio,expenses,water,-44.96,-37089.49
buyer_3,Ana,35,ES04209538845447732310,TRX_N-00725-01708486,2023-10-08T13:10:55,Amurrio,expenses,gas,-97.99,-37187.48
buyer_3,Ana,35,ES04209538845447732310,TRX_N-00726-99807628,2023-10-09T11:11:17,Basauri,expenses,food,-80.83,-37268.31
buyer_3,Ana,35,ES04209538845447732310,TRX_N-00727-42819748,2023-10-09T20:53:59,Amurrio,expenses,leisure,-69.78,-37338.09
buyer_3,Ana,35,ES04209538845447732310,TRX_N-00728-89535564,2023-10-13T17:23:44,Amurrio,expenses,children,-70.68,-37408.77
buyer_3,Ana,35,ES04209538845447732310,TRX_N-00729-06707247,2023-10-14T00:29:47,Lasarte-Oria,expenses,transport,-71.08,-37479.85
buyer_3,Ana,35,ES04209538845447732310,TRX_N-00730-38233313,2023-10-14T14:05:19,Amurrio,expenses,gifts,-686.64,-38166.49
buyer_3,Ana,35,ES04209538845447732310,TRX_N-00731-95484386,2023-10-15T14:00:46,Zuia,expenses,transport,-60.47,-38226.96
buyer_3,Ana,35,ES04209538845447732310,TRX_N-00732-48936153,2023-10-16T18:18:50,Amurrio,expenses,food,-123.6,-38350.56
buyer_3,Ana,35,ES04209538845447732310,TRX_N-00733-24616026,2023-10-16T14:28:18,Amurrio,expenses,leisure,-74.2,-38424.76
buyer_3,Ana,35,ES04209538845447732310,TRX_N-00734-88400410,2023-10-17T19:53:37,Amurrio,expenses,transport,-41.22,-38465.98
buyer_3,Ana,35,ES04209538845447732310,TRX_N-00735-43858565,2023-10-17T11:43:17,Amurrio,expenses,leisure,-51.24,-38517.22
buyer_3,Ana,35,ES04209538845447732310,TRX_N-00736-13940413,2023-10-17T13:18:43,Basauri,expenses,healthcare,-162.07,-38679.29
buyer_3,Ana,35,ES04209538845447732310,TRX_N-00737-35939073,2023-10-18T17:33:59,Amurrio,expenses,food,-98.64,-38777.93
buyer_3,Ana,35,ES04209538845447732310,TRX_N-00738-56043830,2023-10-18T12:03:46,Sopela,expenses,cash,-100.0,-38877.93
buyer_3,Ana,35,ES04209538845447732310,TRX_N-00739-32215156,2023-10-19T20:29:28,Erandio,expenses,cash,-100.0,-38977.93
buyer_3,Ana,35,ES04209538845447732310,TRX_N-00740-11540595,2023-10-19T08:35:02,Amurrio,expenses,gifts,-484.55,-39462.48
buyer_3,Ana,35,ES04209538845447732310,TRX_N-00741-05210267,2023-10-20T22:51:09,Amurrio,expenses,leisure,-68.97,-39531.45
buyer_3,Ana,35,ES04209538845447732310,TRX_N-00742-47974139,2023-10-20T09:15:20,Bilbao,expenses,cash,-100.0,-39631.45
buyer_3,Ana,35,ES04209538845447732310,TRX_N-00743-90315793,2023-10-22T16:04:58,Amurrio,expenses,appliances,-210.1,-39841.55
buyer_3,Ana,35,ES04209538845447732310,TRX_N-00744-71186100,2023-10-24T11:33:20,Amurrio,expenses,cash,-100.0,-39941.55
buyer_3,Ana,35,ES04209538845447732310,TRX_N-00745-72209435,2023-10-24T14:24:31,Mungia,expenses,gifts,-729.04,-40670.59
buyer_3,Ana,35,ES04209538845447732310,TRX_N-00746-81319913,2023-10-26T16:45:19,Amurrio,expenses,food,-83.02,-40753.61
buyer_3,Ana,35,ES04209538845447732310,TRX_N-00747-71310283,2023-10-27T10:56:16,Amurrio,expenses,cash,-100.0,-40853.61
buyer_3,Ana,35,ES04209538845447732310,TRX_N-00748-36088734,2023-10-30T08:33:13,Amurrio,expenses,food,-60.31,-40913.92
buyer_3,Ana,35,ES04209538845447732310,TRX_N-00749-28891144,2023-10-30T23:28:48,Amurrio,expenses,leisure,-82.03,-40995.95
buyer_3,Ana,35,ES04209538845447732310,TRX_N-00750-85086626,2023-10-31T04:41:56,Errenteria,expenses,leisure,-40.09,-41036.04
buyer_3,Ana,35,ES04209538845447732310,TRX_N-00751-43959427,2023-10-31T13:01:24,Basauri,expenses,cash,-100.0,-41136.04
buyer_3,Ana,35,ES04209538845447732310,TRX_N-00752-97525466,2023-11-01T17:16:43,Amurrio,incomes,salary,1277.87,-39858.17
buyer_3,Ana,35,ES04209538845447732310,TRX_N-00753-71913226,2023-11-01T17:16:43,Amurrio,incomes,salary_partner,1164.17,-38694.0
buyer_3,Ana,35,ES04209538845447732310,TRX_N-00754-30788447,2023-11-01T13:32:15,Amurrio,expenses,transport,-74.82,-38768.82
buyer_3,Ana,35,ES04209538845447732310,TRX_N-00755-60084024,2023-11-01T16:44:40,Amurrio,expenses,clothing,-159.64,-38928.46
buyer_3,Ana,35,ES04209538845447732310,TRX_N-00756-54882967,2023-11-01T21:57:40,Amurrio,expenses,education,-61.02,-38989.48
buyer_3,Ana,35,ES04209538845447732310,TRX_N-00757-36600627,2023-11-01T13:19:46,Amurrio,expenses,gifts,-717.83,-39707.31
buyer_3,Ana,35,ES04209538845447732310,TRX_N-00758-45136997,2023-11-02T17:18:49,Sestao,expenses,food,-123.63,-39830.94
buyer_3,Ana,35,ES04209538845447732310,TRX_N-00759-74381100,2023-11-03T10:06:54,Amurrio,expenses,cash,-100.0,-39930.94
buyer_3,Ana,35,ES04209538845447732310,TRX_N-00760-04519268,2023-11-04T10:09:59,Amurrio,expenses,mortgage,-874.64,-40805.58
buyer_3,Ana,35,ES04209538845447732310,TRX_N-00761-62806670,2023-11-05T20:40:29,Amurrio,expenses,phone,-33.69,-40839.27
buyer_3,Ana,35,ES04209538845447732310,TRX_N-00762-03804244,2023-11-06T17:30:13,Amurrio,expenses,gas,-81.51,-40920.78
buyer_3,Ana,35,ES04209538845447732310,TRX_N-00763-27157380,2023-11-06T11:15:38,Amurrio,expenses,food,-103.74,-41024.52
buyer_3,Ana,35,ES04209538845447732310,TRX_N-00764-10238757,2023-11-06T15:26:10,Galdakao,expenses,clothing,-119.12,-41143.64
buyer_3,Ana,35,ES04209538845447732310,TRX_N-00765-04081070,2023-11-07T14:12:40,Amurrio,expenses,leisure,-73.3,-41216.94
buyer_3,Ana,35,ES04209538845447732310,TRX_N-00766-20845442,2023-11-08T01:33:27,Amurrio,expenses,internet,-42.0,-41258.94
buyer_3,Ana,35,ES04209538845447732310,TRX_N-00767-82110529,2023-11-08T17:04:03,Amurrio,expenses,water,-29.81,-41288.75
buyer_3,Ana,35,ES04209538845447732310,TRX_N-00768-71940971,2023-11-08T14:53:23,Amurrio,expenses,electricity,-27.48,-41316.23
buyer_3,Ana,35,ES04209538845447732310,TRX_N-00769-36917044,2023-11-08T19:06:51,Amurrio,expenses,transport,-44.15,-41360.38
buyer_3,Ana,35,ES04209538845447732310,TRX_N-00770-73643747,2023-11-08T17:00:30,Hondarribia,expenses,clothing,-107.48,-41467.86
buyer_3,Ana,35,ES04209538845447732310,TRX_N-00771-97646348,2023-11-10T11:51:07,Amurrio,expenses,leisure,-64.08,-41531.94
buyer_3,Ana,35,ES04209538845447732310,TRX_N-00772-84660372,2023-11-12T10:04:51,Amurrio,expenses,healthcare,-125.94,-41657.88
buyer_3,Ana,35,ES04209538845447732310,TRX_N-00773-11644731,2023-11-13T20:48:56,Amurrio,expenses,gifts,-189.03,-41846.91
buyer_3,Ana,35,ES04209538845447732310,TRX_N-00774-57673812,2023-11-15T17:17:45,Amurrio,expenses,food,-88.32,-41935.23
buyer_3,Ana,35,ES04209538845447732310,TRX_N-00775-25194174,2023-11-18T06:26:22,Llodio,expenses,cash,-100.0,-42035.23
buyer_3,Ana,35,ES04209538845447732310,TRX_N-00776-56734218,2023-11-19T06:40:13,Amurrio,expenses,cash,-100.0,-42135.23
buyer_3,Ana,35,ES04209538845447732310,TRX_N-00777-32571700,2023-11-19T15:46:36,Amurrio,expenses,gifts,-657.37,-42792.6
buyer_3,Ana,35,ES04209538845447732310,TRX_N-00778-82259160,2023-11-20T11:35:24,Durango,expenses,food,-76.68,-42869.28
buyer_3,Ana,35,ES04209538845447732310,TRX_N-00779-00491602,2023-11-20T22:29:33,Amurrio,expenses,leisure,-32.18,-42901.46
buyer_3,Ana,35,ES04209538845447732310,TRX_N-00780-78427167,2023-11-21T11:35:39,Amurrio,expenses,cash,-100.0,-43001.46
buyer_3,Ana,35,ES04209538845447732310,TRX_N-00781-35638909,2023-11-22T17:43:58,Amurrio,expenses,food,-96.96,-43098.42
buyer_3,Ana,35,ES04209538845447732310,TRX_N-00782-47563476,2023-11-22T20:49:38,Amurrio,expenses,leisure,-27.64,-43126.06
buyer_3,Ana,35,ES04209538845447732310,TRX_N-00783-27454825,2023-11-22T13:01:24,Zuia,expenses,appliances,-81.63,-43207.69
buyer_3,Ana,35,ES04209538845447732310,TRX_N-00784-32075492,2023-11-23T16:09:06,Lasarte-Oria,expenses,gifts,-497.3,-43704.99
buyer_3,Ana,35,ES04209538845447732310,TRX_N-00785-64732386,2023-11-24T20:28:32,Durango,expenses,food,-65.65,-43770.64
buyer_3,Ana,35,ES04209538845447732310,TRX_N-00786-70809627,2023-11-26T11:34:28,Amurrio,expenses,transport,-44.12,-43814.76
buyer_3,Ana,35,ES04209538845447732310,TRX_N-00787-55698441,2023-11-27T11:49:19,Amurrio,expenses,cash,-100.0,-43914.76
buyer_3,Ana,35,ES04209538845447732310,TRX_N-00788-59503787,2023-11-28T17:40:03,Zarautz,expenses,food,-96.68,-44011.44
buyer_3,Ana,35,ES04209538845447732310,TRX_N-00789-04459422,2023-12-01T11:27:07,Amurrio,incomes,salary,1277.87,-42733.57
buyer_3,Ana,35,ES04209538845447732310,TRX_N-00790-64886359,2023-12-01T11:27:07,Amurrio,incomes,salary_partner,1164.17,-41569.4
buyer_3,Ana,35,ES04209538845447732310,TRX_N-00791-31800356,2023-12-01T11:27:07,Amurrio,incomes,salary_bonus,894.62,-40674.78
buyer_3,Ana,35,ES04209538845447732310,TRX_N-00792-45440678,2023-12-01T11:27:07,Amurrio,incomes,salary_partner_bonus,878.09,-39796.69
buyer_3,Ana,35,ES04209538845447732310,TRX_N-00793-06423105,2023-12-01T14:07:52,Amurrio,expenses,food,-99.75,-39896.44
buyer_3,Ana,35,ES04209538845447732310,TRX_N-00794-79092087,2023-12-02T18:46:05,Donostia,expenses,travel,-718.27,-40614.71
buyer_3,Ana,35,ES04209538845447732310,TRX_N-00795-24976137,2023-12-03T20:46:44,Amurrio,expenses,food,-79.84,-40694.55
buyer_3,Ana,35,ES04209538845447732310,TRX_N-00796-30103646,2023-12-03T14:30:25,Amurrio,expenses,cash,-100.0,-40794.55
buyer_3,Ana,35,ES04209538845447732310,TRX_N-00797-96761374,2023-12-04T11:19:36,Amurrio,expenses,mortgage,-874.64,-41669.19
buyer_3,Ana,35,ES04209538845447732310,TRX_N-00798-95276531,2023-12-05T09:35:15,Amurrio,expenses,electricity,-25.01,-41694.2
buyer_3,Ana,35,ES04209538845447732310,TRX_N-00799-21842827,2023-12-05T19:05:14,Amurrio,expenses,gas,-31.22,-41725.42
buyer_3,Ana,35,ES04209538845447732310,TRX_N-00800-29002652,2023-12-05T12:35:46,Amurrio,expenses,internet,-42.0,-41767.42
buyer_3,Ana,35,ES04209538845447732310,TRX_N-00801-05551280,2023-12-06T09:19:40,Amurrio,expenses,water,-21.57,-41788.99
buyer_3,Ana,35,ES04209538845447732310,TRX_N-00802-44255195,2023-12-06T21:53:07,Amurrio,expenses,cash,-100.0,-41888.99
buyer_3,Ana,35,ES04209538845447732310,TRX_N-00803-04813286,2023-12-07T06:45:00,Amurrio,expenses,phone,-43.38,-41932.37
buyer_3,Ana,35,ES04209538845447732310,TRX_N-00804-14558131,2023-12-07T12:02:28,Amurrio,expenses,leisure,-59.08,-41991.45
buyer_3,Ana,35,ES04209538845447732310,TRX_N-00805-59246048,2023-12-08T09:46:31,Sestao,expenses,food,-122.23,-42113.68
buyer_3,Ana,35,ES04209538845447732310,TRX_N-00806-31414642,2023-12-09T17:15:59,Amurrio,expenses,education,-62.24,-42175.92
buyer_3,Ana,35,ES04209538845447732310,TRX_N-00807-75102651,2023-12-10T23:40:31,Amurrio,expenses,leisure,-84.38,-42260.3
buyer_3,Ana,35,ES04209538845447732310,TRX_N-00808-44273662,2023-12-11T04:31:20,Amurrio,expenses,leisure,-56.56,-42316.86
buyer_3,Ana,35,ES04209538845447732310,TRX_N-00809-97011827,2023-12-11T10:53:06,Amurrio,expenses,repairs,-262.22,-42579.08
buyer_3,Ana,35,ES04209538845447732310,TRX_N-00810-23833157,2023-12-12T07:28:45,Amurrio,expenses,food,-86.36,-42665.44
buyer_3,Ana,35,ES04209538845447732310,TRX_N-00811-32858762,2023-12-14T11:08:42,Amurrio,expenses,leisure,-67.83,-42733.27
buyer_3,Ana,35,ES04209538845447732310,TRX_N-00812-88433434,2023-12-14T08:44:02,Amurrio,expenses,repairs,-88.8,-42822.07
buyer_3,Ana,35,ES04209538845447732310,TRX_N-00813-94502348,2023-12-16T10:31:49,Oyón-Oion,expenses,leisure,-83.6,-42905.67
buyer_3,Ana,35,ES04209538845447732310,TRX_N-00814-45446686,2023-12-16T20:41:47,Amurrio,expenses,cash,-100.0,-43005.67
buyer_3,Ana,35,ES04209538845447732310,TRX_N-00815-99443572,2023-12-20T08:13:12,Amurrio,expenses,gifts,-32.05,-43037.72
buyer_3,Ana,35,ES04209538845447732310,TRX_N-00816-61269546,2023-12-21T11:25:16,Oyón-Oion,expenses,leisure,-51.94,-43089.66
buyer_3,Ana,35,ES04209538845447732310,TRX_N-00817-38973370,2023-12-21T09:16:30,Amurrio,expenses,cash,-100.0,-43189.66
buyer_3,Ana,35,ES04209538845447732310,TRX_N-00818-42747008,2023-12-24T00:46:22,Amurrio,expenses,leisure,-29.66,-43219.32
buyer_3,Ana,35,ES04209538845447732310,TRX_N-00819-30058925,2023-12-26T23:56:03,Amurrio,expenses,leisure,-45.18,-43264.5
buyer_3,Ana,35,ES04209538845447732310,TRX_N-00820-80303231,2023-12-27T15:10:19,Amurrio,expenses,cash,-100.0,-43364.5
buyer_3,Ana,35,ES04209538845447732310,TRX_N-00821-86668813,2023-12-30T10:16:54,Mungia,expenses,food,-92.3,-43456.8
buyer_3,Ana,35,ES04209538845447732310,TRX_N-00822-74694674,2023-12-30T08:23:08,Amurrio,expenses,education,-63.75,-43520.55
buyer_3,Ana,35,ES04209538845447732310,TRX_N-00823-05347221,2023-12-30T14:07:13,Iruña de Oca,expenses,cash,-100.0,-43620.55
buyer_3,Ana,35,ES04209538845447732310,TRX_N-00824-07353676,2024-01-01T03:49:15,Amurrio,incomes,salary,1322.7,-42297.85
buyer_3,Ana,35,ES04209538845447732310,TRX_N-00825-81882552,2024-01-01T03:49:15,Amurrio,incomes,salary_partner,1205.01,-41092.84
buyer_3,Ana,35,ES04209538845447732310,TRX_N-00826-29127738,2024-01-01T03:33:45,Amurrio,expenses,food,-67.03,-41159.87
buyer_3,Ana,35,ES04209538845447732310,TRX_N-00827-58228108,2024-01-01T15:59:53,Amurrio,expenses,transport,-75.21,-41235.08
buyer_3,Ana,35,ES04209538845447732310,TRX_N-00828-92564546,2024-01-02T09:36:15,Elciego,expenses,food,-86.93,-41322.01
buyer_3,Ana,35,ES04209538845447732310,TRX_N-00829-45739781,2024-01-02T08:41:45,Amurrio,expenses,leisure,-77.73,-41399.74
buyer_3,Ana,35,ES04209538845447732310,TRX_N-00830-81557468,2024-01-02T21:53:35,Amurrio,expenses,healthcare,-121.67,-41521.41
buyer_3,Ana,35,ES04209538845447732310,TRX_N-00831-43906871,2024-01-02T09:18:18,Amurrio,expenses,gifts,-213.38,-41734.79
buyer_3,Ana,35,ES04209538845447732310,TRX_N-00832-47623601,2024-01-03T16:32:08,Amurrio,expenses,cash,-100.0,-41834.79
buyer_3,Ana,35,ES04209538845447732310,TRX_N-00833-01582043,2024-01-04T09:09:30,Amurrio,expenses,mortgage,-874.64,-42709.43
buyer_3,Ana,35,ES04209538845447732310,TRX_N-00834-69724537,2024-01-06T16:56:24,Amurrio,expenses,gas,-90.87,-42800.3
buyer_3,Ana,35,ES04209538845447732310,TRX_N-00835-85375206,2024-01-06T18:03:01,Sestao,expenses,food,-77.55,-42877.85
buyer_3,Ana,35,ES04209538845447732310,TRX_N-00836-57697461,2024-01-06T16:57:37,Amurrio,expenses,cash,-100.0,-42977.85
buyer_3,Ana,35,ES04209538845447732310,TRX_N-00837-61935874,2024-01-07T15:20:02,Amurrio,expenses,cash,-100.0,-43077.85
buyer_3,Ana,35,ES04209538845447732310,TRX_N-00838-24808034,2024-01-07T21:26:10,Amurrio,expenses,children,-52.68,-43130.53
buyer_3,Ana,35,ES04209538845447732310,TRX_N-00839-66632572,2024-01-08T10:13:16,Amurrio,expenses,water,-25.34,-43155.87
buyer_3,Ana,35,ES04209538845447732310,TRX_N-00840-19238102,2024-01-08T19:09:53,Amurrio,expenses,electricity,-77.71,-43233.58
buyer_3,Ana,35,ES04209538845447732310,TRX_N-00841-66426411,2024-01-08T15:51:11,Amurrio,expenses,internet,-42.0,-43275.58
buyer_3,Ana,35,ES04209538845447732310,TRX_N-00842-87871917,2024-01-08T15:57:19,Amurrio,expenses,phone,-32.75,-43308.33
buyer_3,Ana,35,ES04209538845447732310,TRX_N-00843-41604157,2024-01-10T19:29:09,Amurrio,expenses,clothing,-143.89,-43452.22
buyer_3,Ana,35,ES04209538845447732310,TRX_N-00844-19693990,2024-01-11T11:10:30,Amurrio,expenses,gifts,-72.43,-43524.65
buyer_3,Ana,35,ES04209538845447732310,TRX_N-00845-75766666,2024-01-15T21:31:40,Amurrio,expenses,leisure,-55.95,-43580.6
buyer_3,Ana,35,ES04209538845447732310,TRX_N-00846-84394589,2024-01-18T08:18:51,Elciego,expenses,healthcare,-188.34,-43768.94
buyer_3,Ana,35,ES04209538845447732310,TRX_N-00847-47323950,2024-01-19T20:04:05,Amurrio,expenses,appliances,-172.27,-43941.21
buyer_3,Ana,35,ES04209538845447732310,TRX_N-00848-10091339,2024-01-21T17:36:15,Amurrio,expenses,leisure,-67.24,-44008.45
buyer_3,Ana,35,ES04209538845447732310,TRX_N-00849-32838366,2024-01-21T19:21:47,Amurrio,expenses,cash,-100.0,-44108.45
buyer_3,Ana,35,ES04209538845447732310,TRX_N-00850-28202228,2024-01-22T20:07:23,Amurrio,expenses,transport,-42.79,-44151.24
buyer_3,Ana,35,ES04209538845447732310,TRX_N-00851-25505349,2024-01-25T20:55:28,Amurrio,expenses,appliances,-118.65,-44269.89
buyer_3,Ana,35,ES04209538845447732310,TRX_N-00852-77496530,2024-01-29T17:55:38,Amurrio,expenses,food,-84.8,-44354.69
buyer_3,Ana,35,ES04209538845447732310,TRX_N-00853-55248237,2024-01-30T11:14:14,Amurrio,expenses,cash,-100.0,-44454.69
buyer_3,Ana,35,ES04209538845447732310,TRX_N-00854-04476440,2024-01-31T13:22:42,Basauri,expenses,cash,-100.0,-44554.69
buyer_3,Ana,35,ES04209538845447732310,TRX_N-00855-56882218,2024-02-01T13:03:02,Amurrio,incomes,salary,1322.7,-43231.99
buyer_3,Ana,35,ES04209538845447732310,TRX_N-00856-51513149,2024-02-01T13:03:02,Amurrio,incomes,salary_partner,1205.01,-42026.98
buyer_3,Ana,35,ES04209538845447732310,TRX_N-00857-93579351,2024-02-01T13:03:02,Amurrio,incomes,extra_income,209.99,-41816.99
buyer_3,Ana,35,ES04209538845447732310,TRX_N-00858-81181231,2024-02-01T08:18:55,Amurrio,expenses,food,-70.21,-41887.2
buyer_3,Ana,35,ES04209538845447732310,TRX_N-00859-90482409,2024-02-02T19:02:53,Bilbao,expenses,food,-76.85,-41964.05
buyer_3,Ana,35,ES04209538845447732310,TRX_N-00860-01471659,2024-02-03T23:22:45,Basauri,expenses,leisure,-55.89,-42019.94
buyer_3,Ana,35,ES04209538845447732310,TRX_N-00861-80698839,2024-02-04T19:33:09,Amurrio,expenses,mortgage,-874.64,-42894.58
buyer_3,Ana,35,ES04209538845447732310,TRX_N-00862-99783768,2024-02-05T10:46:04,Amurrio,expenses,gas,-106.86,-43001.44
buyer_3,Ana,35,ES04209538845447732310,TRX_N-00863-27038797,2024-02-05T22:18:05,Amurrio,expenses,travel,-528.95,-43530.39
buyer_3,Ana,35,ES04209538845447732310,TRX_N-00864-86621920,2024-02-06T16:05:10,Amurrio,expenses,electricity,-45.73,-43576.12
buyer_3,Ana,35,ES04209538845447732310,TRX_N-00865-32223216,2024-02-06T08:05:15,Amurrio,expenses,internet,-42.0,-43618.12
buyer_3,Ana,35,ES04209538845447732310,TRX_N-00866-41566701,2024-02-06T11:28:41,Amurrio,expenses,cash,-100.0,-43718.12
buyer_3,Ana,35,ES04209538845447732310,TRX_N-00867-64993785,2024-02-08T16:28:24,Amurrio,expenses,phone,-38.14,-43756.26
buyer_3,Ana,35,ES04209538845447732310,TRX_N-00868-09701713,2024-02-08T19:16:26,Amurrio,expenses,water,-24.99,-43781.25
buyer_3,Ana,35,ES04209538845447732310,TRX_N-00869-99015759,2024-02-08T08:03:11,Amurrio,expenses,clothing,-52.09,-43833.34
buyer_3,Ana,35,ES04209538845447732310,TRX_N-00870-94355505,2024-02-11T14:18:32,Amurrio,expenses,gifts,-340.53,-44173.87
buyer_3,Ana,35,ES04209538845447732310,TRX_N-00871-21700663,2024-02-12T14:48:22,Amurrio,expenses,food,-113.23,-44287.1
buyer_3,Ana,35,ES04209538845447732310,TRX_N-00872-78720612,2024-02-12T09:59:21,Lasarte-Oria,expenses,clothing,-132.88,-44419.98
buyer_3,Ana,35,ES04209538845447732310,TRX_N-00873-11195615,2024-02-14T15:44:26,Amurrio,expenses,food,-67.14,-44487.12
buyer_3,Ana,35,ES04209538845447732310,TRX_N-00874-73783538,2024-02-14T18:54:52,Amurrio,expenses,repairs,-175.77,-44662.89
buyer_3,Ana,35,ES04209538845447732310,TRX_N-00875-35569315,2024-02-17T09:05:01,Amurrio,expenses,repairs,-69.85,-44732.74
buyer_3,Ana,35,ES04209538845447732310,TRX_N-00876-83007534,2024-02-18T19:36:04,Amurrio,expenses,repairs,-96.69,-44829.43
buyer_3,Ana,35,ES04209538845447732310,TRX_N-00877-90124923,2024-02-19T17:46:26,Amurrio,expenses,cash,-100.0,-44929.43
buyer_3,Ana,35,ES04209538845447732310,TRX_N-00878-62876449,2024-02-20T19:50:53,Amurrio,expenses,cash,-100.0,-45029.43
buyer_3,Ana,35,ES04209538845447732310,TRX_N-00879-66212805,2024-02-21T19:28:15,Amurrio,expenses,food,-103.03,-45132.46
buyer_3,Ana,35,ES04209538845447732310,TRX_N-00880-91326400,2024-02-24T18:18:48,Labastida,expenses,transport,-77.67,-45210.13
buyer_3,Ana,35,ES04209538845447732310,TRX_N-00881-15620007,2024-02-26T15:37:59,Sopela,expenses,clothing,-49.56,-45259.69
buyer_3,Ana,35,ES04209538845447732310,TRX_N-00882-33780117,2024-02-28T09:00:27,Amurrio,expenses,clothing,-154.19,-45413.88
buyer_3,Ana,35,ES04209538845447732310,TRX_N-00883-03675084,2024-02-28T05:47:29,Amurrio,expenses,education,-65.23,-45479.11
buyer_3,Ana,35,ES04209538845447732310,TRX_N-00884-23591395,2024-02-29T11:58:44,Amurrio,expenses,cash,-100.0,-45579.11
buyer_3,Ana,35,ES04209538845447732310,TRX_N-00885-07181430,2024-02-29T15:58:26,Amurrio,expenses,children,-265.8,-45844.91
buyer_3,Ana,35,ES04209538845447732310,TRX_N-00886-57493931,2024-03-01T10:59:53,Amurrio,incomes,salary,1322.7,-44522.21
buyer_3,Ana,35,ES04209538845447732310,TRX_N-00887-66232505,2024-03-01T10:59:53,Amurrio,incomes,salary_partner,1205.01,-43317.2
buyer_3,Ana,35,ES04209538845447732310,TRX_N-00888-88540160,2024-03-02T10:14:19,Amurrio,expenses,repairs,-155.43,-43472.63
buyer_3,Ana,35,ES04209538845447732310,TRX_N-00889-94866307,2024-03-03T16:54:02,Amurrio,expenses,food,-77.5,-43550.13
buyer_3,Ana,35,ES04209538845447732310,TRX_N-00890-75054484,2024-03-04T12:03:16,Amurrio,expenses,mortgage,-874.64,-44424.77
buyer_3,Ana,35,ES04209538845447732310,TRX_N-00891-83516672,2024-03-05T14:36:51,Amurrio,expenses,cash,-100.0,-44524.77
buyer_3,Ana,35,ES04209538845447732310,TRX_N-00892-57711191,2024-03-06T13:44:04,Amurrio,expenses,water,-22.46,-44547.23
buyer_3,Ana,35,ES04209538845447732310,TRX_N-00893-36527459,2024-03-06T06:42:33,Amurrio,expenses,transport,-55.09,-44602.32
buyer_3,Ana,35,ES04209538845447732310,TRX_N-00894-49160791,2024-03-06T22:34:42,Amurrio,expenses,cash,-100.0,-44702.32
buyer_3,Ana,35,ES04209538845447732310,TRX_N-00895-05348305,2024-03-07T20:47:53,Amurrio,expenses,electricity,-73.64,-44775.96
buyer_3,Ana,35,ES04209538845447732310,TRX_N-00896-01548626,2024-03-07T12:00:37,Amurrio,expenses,gas,-41.56,-44817.52
buyer_3,Ana,35,ES04209538845447732310,TRX_N-00897-54468564,2024-03-07T19:45:43,Amurrio,expenses,internet,-42.0,-44859.52
buyer_3,Ana,35,ES04209538845447732310,TRX_N-00898-64852824,2024-03-08T13:50:41,Amurrio,expenses,phone,-36.91,-44896.43
buyer_3,Ana,35,ES04209538845447732310,TRX_N-00899-16227455,2024-03-10T11:11:26,Amurrio,expenses,leisure,-29.11,-44925.54
buyer_3,Ana,35,ES04209538845447732310,TRX_N-00900-62936093,2024-03-10T22:14:46,Amurrio,expenses,repairs,-72.16,-44997.7
buyer_3,Ana,35,ES04209538845447732310,TRX_N-00901-72334285,2024-03-13T08:10:03,Amurrio,expenses,food,-113.42,-45111.12
buyer_3,Ana,35,ES04209538845447732310,TRX_N-00902-89422498,2024-03-13T02:54:18,Amurrio,expenses,repairs,-158.58,-45269.7
buyer_3,Ana,35,ES04209538845447732310,TRX_N-00903-98385404,2024-03-15T10:49:57,Amurrio,expenses,repairs,-285.33,-45555.03
buyer_3,Ana,35,ES04209538845447732310,TRX_N-00904-76308227,2024-03-16T13:05:35,Amurrio,expenses,leisure,-33.44,-45588.47
buyer_3,Ana,35,ES04209538845447732310,TRX_N-00905-21639968,2024-03-16T19:57:14,Amurrio,expenses,cash,-100.0,-45688.47
buyer_3,Ana,35,ES04209538845447732310,TRX_N-00906-78994928,2024-03-16T12:06:53,Durango,expenses,repairs,-36.11,-45724.58
buyer_3,Ana,35,ES04209538845447732310,TRX_N-00907-50413736,2024-03-17T14:26:16,Basauri,expenses,transport,-67.61,-45792.19
buyer_3,Ana,35,ES04209538845447732310,TRX_N-00908-75007134,2024-03-17T10:05:01,Amurrio,expenses,cash,-100.0,-45892.19
buyer_3,Ana,35,ES04209538845447732310,TRX_N-00909-98361157,2024-03-18T12:35:30,Iruña de Oca,expenses,transport,-78.68,-45970.87
buyer_3,Ana,35,ES04209538845447732310,TRX_N-00910-66876891,2024-03-19T05:58:23,Durango,expenses,transport,-77.44,-46048.31
buyer_3,Ana,35,ES04209538845447732310,TRX_N-00911-43376149,2024-03-19T09:41:45,Amurrio,expenses,education,-60.06,-46108.37
buyer_3,Ana,35,ES04209538845447732310,TRX_N-00912-54402773,2024-03-19T19:17:05,Amurrio,expenses,appliances,-310.91,-46419.28
buyer_3,Ana,35,ES04209538845447732310,TRX_N-00913-19198094,2024-03-23T17:31:21,Amurrio,expenses,education,-52.34,-46471.62
buyer_3,Ana,35,ES04209538845447732310,TRX_N-00914-92205712,2024-03-24T18:35:41,Amurrio,expenses,food,-116.87,-46588.49
buyer_3,Ana,35,ES04209538845447732310,TRX_N-00915-93034466,2024-03-25T05:16:06,Amurrio,expenses,repairs,-256.7,-46845.19
buyer_3,Ana,35,ES04209538845447732310,TRX_N-00916-49208813,2024-03-26T09:05:09,Amurrio,expenses,cash,-100.0,-46945.19
buyer_3,Ana,35,ES04209538845447732310,TRX_N-00917-98496776,2024-03-26T09:12:19,Amurrio,expenses,repairs,-169.32,-47114.51
buyer_3,Ana,35,ES04209538845447732310,TRX_N-00918-06833333,2024-03-27T20:46:51,Amurrio,expenses,leisure,-84.84,-47199.35
buyer_3,Ana,35,ES04209538845447732310,TRX_N-00919-80053691,2024-03-28T15:55:15,Leioa,expenses,leisure,-61.84,-47261.19
buyer_3,Ana,35,ES04209538845447732310,TRX_N-00920-96485393,2024-03-30T19:26:59,Amurrio,expenses,food,-115.84,-47377.03
buyer_3,Ana,35,ES04209538845447732310,TRX_N-00921-83128685,2024-03-31T14:08:45,Amurrio,expenses,clothing,-51.7,-47428.73
buyer_3,Ana,35,ES04209538845447732310,TRX_N-00922-17683796,2024-03-31T16:17:12,Zarautz,expenses,appliances,-296.98,-47725.71
buyer_3,Ana,35,ES04209538845447732310,TRX_N-00923-63931755,2024-04-01T11:33:26,Amurrio,incomes,salary,1322.7,-46403.01
buyer_3,Ana,35,ES04209538845447732310,TRX_N-00924-27492179,2024-04-01T11:33:26,Amurrio,incomes,salary_partner,1205.01,-45198.0
buyer_3,Ana,35,ES04209538845447732310,TRX_N-00925-28315028,2024-04-02T19:26:07,Amurrio,expenses,leisure,-61.94,-45259.94
buyer_3,Ana,35,ES04209538845447732310,TRX_N-00926-04955260,2024-04-03T15:42:42,Amurrio,expenses,leisure,-46.95,-45306.89
buyer_3,Ana,35,ES04209538845447732310,TRX_N-00927-75215926,2024-04-03T14:17:58,Labastida,expenses,cash,-100.0,-45406.89
buyer_3,Ana,35,ES04209538845447732310,TRX_N-00928-79857673,2024-04-04T09:08:51,Amurrio,expenses,mortgage,-874.64,-46281.53
buyer_3,Ana,35,ES04209538845447732310,TRX_N-00929-63438258,2024-04-05T01:49:03,Amurrio,expenses,electricity,-72.39,-46353.92
buyer_3,Ana,35,ES04209538845447732310,TRX_N-00930-16280894,2024-04-05T19:03:56,Amurrio,expenses,gas,-62.77,-46416.69
buyer_3,Ana,35,ES04209538845447732310,TRX_N-00931-23918475,2024-04-05T10:57:26,Amurrio,expenses,education,-63.24,-46479.93
buyer_3,Ana,35,ES04209538845447732310,TRX_N-00932-61277252,2024-04-05T16:27:14,Amurrio,expenses,cash,-100.0,-46579.93
buyer_3,Ana,35,ES04209538845447732310,TRX_N-00933-91684790,2024-04-06T22:28:56,Amurrio,expenses,phone,-40.95,-46620.88
buyer_3,Ana,35,ES04209538845447732310,TRX_N-00934-94950493,2024-04-08T08:49:38,Amurrio,expenses,internet,-42.0,-46662.88
buyer_3,Ana,35,ES04209538845447732310,TRX_N-00935-28047556,2024-04-08T12:46:10,Amurrio,expenses,water,-36.3,-46699.18
buyer_3,Ana,35,ES04209538845447732310,TRX_N-00936-35176901,2024-04-09T14:01:26,Amurrio,expenses,healthcare,-101.81,-46800.99
buyer_3,Ana,35,ES04209538845447732310,TRX_N-00937-73150312,2024-04-09T08:17:06,Iruña de Oca,expenses,cash,-100.0,-46900.99
buyer_3,Ana,35,ES04209538845447732310,TRX_N-00938-51046904,2024-04-10T15:47:43,Amurrio,expenses,transport,-59.71,-46960.7
buyer_3,Ana,35,ES04209538845447732310,TRX_N-00939-61647469,2024-04-10T21:47:05,Amurrio,expenses,cash,-100.0,-47060.7
buyer_3,Ana,35,ES04209538845447732310,TRX_N-00940-49847789,2024-04-10T23:37:55,Amurrio,expenses,gifts,-812.45,-47873.15
buyer_3,Ana,35,ES04209538845447732310,TRX_N-00941-53581725,2024-04-12T20:32:56,Amurrio,expenses,clothing,-51.48,-47924.63
buyer_3,Ana,35,ES04209538845447732310,TRX_N-00942-23822274,2024-04-13T16:24:19,Salvatierra/Agurain,expenses,appliances,-373.44,-48298.07
buyer_3,Ana,35,ES04209538845447732310,TRX_N-00943-35152295,2024-04-13T16:15:00,Amurrio,expenses,repairs,-287.96,-48586.03
buyer_3,Ana,35,ES04209538845447732310,TRX_N-00944-81264227,2024-04-14T18:50:32,Amurrio,expenses,food,-68.33,-48654.36
buyer_3,Ana,35,ES04209538845447732310,TRX_N-00945-89511121,2024-04-15T19:52:12,Elciego,expenses,leisure,-59.74,-48714.1
buyer_3,Ana,35,ES04209538845447732310,TRX_N-00946-08034377,2024-04-15T17:50:22,Amurrio,expenses,gifts,-592.87,-49306.97
buyer_3,Ana,35,ES04209538845447732310,TRX_N-00947-28044558,2024-04-16T20:46:44,Amurrio,expenses,gifts,-565.67,-49872.64
buyer_3,Ana,35,ES04209538845447732310,TRX_N-00948-09407276,2024-04-17T13:55:01,Amurrio,expenses,transport,-54.59,-49927.23
buyer_3,Ana,35,ES04209538845447732310,TRX_N-00949-06385394,2024-04-17T20:13:21,Amurrio,expenses,gifts,-250.71,-50177.94
buyer_3,Ana,35,ES04209538845447732310,TRX_N-00950-41736439,2024-04-18T12:22:39,Amurrio,expenses,education,-54.3,-50232.24
buyer_3,Ana,35,ES04209538845447732310,TRX_N-00951-75062076,2024-04-20T13:32:24,Alegría-Dulantzi,expenses,clothing,-102.78,-50335.02
buyer_3,Ana,35,ES04209538845447732310,TRX_N-00952-91087702,2024-04-22T15:33:38,Amurrio,expenses,leisure,-21.1,-50356.12
buyer_3,Ana,35,ES04209538845447732310,TRX_N-00953-35352495,2024-04-28T22:11:45,Amurrio,expenses,leisure,-59.49,-50415.61
buyer_3,Ana,35,ES04209538845447732310,TRX_N-00954-62706765,2024-05-01T10:16:41,Amurrio,incomes,salary,1322.7,-49092.91
buyer_3,Ana,35,ES04209538845447732310,TRX_N-00955-42296206,2024-05-01T10:16:41,Amurrio,incomes,salary_partner,1205.01,-47887.9
buyer_3,Ana,35,ES04209538845447732310,TRX_N-00956-74003956,2024-05-01T10:16:41,Amurrio,incomes,extra_income,209.99,-47677.91
buyer_3,Ana,35,ES04209538845447732310,TRX_N-00957-78888285,2024-05-04T16:20:16,Amurrio,expenses,mortgage,-874.64,-48552.55
buyer_3,Ana,35,ES04209538845447732310,TRX_N-00958-50258150,2024-05-05T14:15:29,Amurrio,expenses,internet,-42.0,-48594.55
buyer_3,Ana,35,ES04209538845447732310,TRX_N-00959-71769971,2024-05-05T18:50:58,Amurrio,expenses,phone,-34.43,-48628.98
buyer_3,Ana,35,ES04209538845447732310,TRX_N-00960-43533167,2024-05-05T13:36:54,Amurrio,expenses,transport,-78.74,-48707.72
buyer_3,Ana,35,ES04209538845447732310,TRX_N-00961-75390397,2024-05-05T18:26:38,Amurrio,expenses,cash,-100.0,-48807.72
buyer_3,Ana,35,ES04209538845447732310,TRX_N-00962-62598580,2024-05-06T16:11:00,Amurrio,expenses,electricity,-69.44,-48877.16
buyer_3,Ana,35,ES04209538845447732310,TRX_N-00963-32419926,2024-05-07T23:01:27,Mungia,expenses,transport,-81.88,-48959.04
buyer_3,Ana,35,ES04209538845447732310,TRX_N-00964-68028191,2024-05-07T09:31:06,Amurrio,expenses,repairs,-284.4,-49243.44
buyer_3,Ana,35,ES04209538845447732310,TRX_N-00965-70329654,2024-05-08T16:41:18,Amurrio,expenses,water,-41.4,-49284.84
buyer_3,Ana,35,ES04209538845447732310,TRX_N-00966-56040157,2024-05-08T08:12:52,Amurrio,expenses,gas,-111.45,-49396.29
buyer_3,Ana,35,ES04209538845447732310,TRX_N-00967-35143274,2024-05-09T20:47:13,Amurrio,expenses,transport,-89.95,-49486.24
buyer_3,Ana,35,ES04209538845447732310,TRX_N-00968-78981509,2024-05-20T20:40:56,Amurrio,expenses,leisure,-84.19,-49570.43
buyer_3,Ana,35,ES04209538845447732310,TRX_N-00969-41353544,2024-05-23T11:46:29,Amurrio,expenses,gifts,-570.77,-50141.2
buyer_3,Ana,35,ES04209538845447732310,TRX_N-00970-08213351,2024-05-24T13:57:11,Amurrio,expenses,food,-86.17,-50227.37
buyer_3,Ana,35,ES04209538845447732310,TRX_N-00971-26087985,2024-05-24T08:42:29,Amurrio,expenses,leisure,-22.95,-50250.32
buyer_3,Ana,35,ES04209538845447732310,TRX_N-00972-50380696,2024-05-25T11:18:37,Bilbao,expenses,transport,-53.57,-50303.89
buyer_3,Ana,35,ES04209538845447732310,TRX_N-00973-43440614,2024-05-27T12:18:35,Hernani,expenses,food,-98.26,-50402.15
buyer_3,Ana,35,ES04209538845447732310,TRX_N-00974-49660130,2024-05-27T16:33:56,Amurrio,expenses,children,-65.15,-50467.3
buyer_3,Ana,35,ES04209538845447732310,TRX_N-00975-06239025,2024-05-28T10:34:42,Amurrio,expenses,education,-47.77,-50515.07
buyer_3,Ana,35,ES04209538845447732310,TRX_N-00976-10817921,2024-05-30T14:58:44,Amurrio,expenses,transport,-89.68,-50604.75
buyer_3,Ana,35,ES04209538845447732310,TRX_N-00977-68334297,2024-05-30T23:50:29,Amurrio,expenses,clothing,-80.99,-50685.74
buyer_3,Ana,35,ES04209538845447732310,TRX_N-00978-95601604,2024-05-30T23:55:04,Amurrio,expenses,cash,-100.0,-50785.74
buyer_3,Ana,35,ES04209538845447732310,TRX_N-00979-75324580,2024-06-01T10:02:44,Amurrio,incomes,salary,1322.7,-49463.04
buyer_3,Ana,35,ES04209538845447732310,TRX_N-00980-98393428,2024-06-01T10:02:44,Amurrio,incomes,salary_partner,1205.01,-48258.03
buyer_3,Ana,35,ES04209538845447732310,TRX_N-00981-19052443,2024-06-01T10:02:44,Amurrio,incomes,salary_bonus,1029.86,-47228.17
buyer_3,Ana,35,ES04209538845447732310,TRX_N-00982-01273327,2024-06-01T10:02:44,Amurrio,incomes,salary_partner_bonus,907.45,-46320.72
buyer_3,Ana,35,ES04209538845447732310,TRX_N-00983-57998534,2024-06-01T18:19:30,Lasarte-Oria,expenses,leisure,-77.17,-46397.89
buyer_3,Ana,35,ES04209538845447732310,TRX_N-00984-04219956,2024-06-03T16:55:23,Portugalete,expenses,clothing,-129.09,-46526.98
buyer_3,Ana,35,ES04209538845447732310,TRX_N-00985-05702914,2024-06-04T20:02:57,Amurrio,expenses,mortgage,-874.64,-47401.62
buyer_3,Ana,35,ES04209538845447732310,TRX_N-00986-17682405,2024-06-05T15:25:54,Amurrio,expenses,cash,-100.0,-47501.62
buyer_3,Ana,35,ES04209538845447732310,TRX_N-00987-98956739,2024-06-07T20:52:20,Amurrio,expenses,electricity,-29.48,-47531.1
buyer_3,Ana,35,ES04209538845447732310,TRX_N-00988-84662273,2024-06-07T08:24:58,Amurrio,expenses,gas,-72.16,-47603.26
buyer_3,Ana,35,ES04209538845447732310,TRX_N-00989-00453659,2024-06-07T04:17:25,Berango,expenses,cash,-100.0,-47703.26
buyer_3,Ana,35,ES04209538845447732310,TRX_N-00990-36282290,2024-06-08T13:23:41,Amurrio,expenses,water,-35.56,-47738.82
buyer_3,Ana,35,ES04209538845447732310,TRX_N-00991-91872360,2024-06-08T21:32:26,Amurrio,expenses,internet,-42.0,-47780.82
buyer_3,Ana,35,ES04209538845447732310,TRX_N-00992-79711937,2024-06-08T11:57:26,Amurrio,expenses,phone,-44.18,-47825.0
buyer_3,Ana,35,ES04209538845447732310,TRX_N-00993-44952201,2024-06-08T10:19:14,Salvatierra/Agurain,expenses,travel,-477.63,-48302.63
buyer_3,Ana,35,ES04209538845447732310,TRX_N-00994-68522608,2024-06-10T14:48:08,Amurrio,expenses,travel,-1409.9,-49712.53
buyer_3,Ana,35,ES04209538845447732310,TRX_N-00995-29702304,2024-06-11T15:07:24,Amurrio,expenses,transport,-73.78,-49786.31
buyer_3,Ana,35,ES04209538845447732310,TRX_N-00996-06505856,2024-06-11T20:56:30,Amurrio,expenses,travel,-1625.09,-51411.4
buyer_3,Ana,35,ES04209538845447732310,TRX_N-00997-18004471,2024-06-11T10:53:28,Pasaia,expenses,gifts,-747.52,-52158.92
buyer_3,Ana,35,ES04209538845447732310,TRX_N-00998-13843570,2024-06-12T17:32:22,Amurrio,expenses,leisure,-33.02,-52191.94
buyer_3,Ana,35,ES04209538845447732310,TRX_N-00999-69060270,2024-06-12T12:35:20,Oyón-Oion,expenses,gifts,-605.18,-52797.12
buyer_3,Ana,35,ES04209538845447732310,TRX_N-01000-43239691,2024-06-13T07:08:01,Amurrio,expenses,food,-122.91,-52920.03
buyer_3,Ana,35,ES04209538845447732310,TRX_N-01001-07622408,2024-06-15T10:47:55,Amurrio,expenses,food,-108.54,-53028.57
buyer_3,Ana,35,ES04209538845447732310,TRX_N-01002-23633830,2024-06-16T12:26:06,Amurrio,expenses,cash,-100.0,-53128.57
buyer_3,Ana,35,ES04209538845447732310,TRX_N-01003-44425310,2024-06-19T20:18:26,Amurrio,expenses,gifts,-310.52,-53439.09
buyer_3,Ana,35,ES04209538845447732310,TRX_N-01004-39335772,2024-06-22T14:04:11,Amurrio,expenses,cash,-100.0,-53539.09
buyer_3,Ana,35,ES04209538845447732310,TRX_N-01005-30822548,2024-06-23T08:33:01,Amurrio,expenses,leisure,-41.96,-53581.05
buyer_3,Ana,35,ES04209538845447732310,TRX_N-01006-61645522,2024-06-23T09:16:25,Amurrio,expenses,gifts,-492.79,-54073.84
buyer_3,Ana,35,ES04209538845447732310,TRX_N-01007-81456665,2024-06-25T11:32:41,Amurrio,expenses,clothing,-61.7,-54135.54
buyer_3,Ana,35,ES04209538845447732310,TRX_N-01008-07217914,2024-06-25T09:09:12,Errenteria,expenses,cash,-100.0,-54235.54
buyer_3,Ana,35,ES04209538845447732310,TRX_N-01009-66824255,2024-06-26T17:16:21,Amurrio,expenses,food,-64.09,-54299.63
buyer_3,Ana,35,ES04209538845447732310,TRX_N-01010-23675167,2024-06-26T17:46:12,Amurrio,expenses,appliances,-414.88,-54714.51
buyer_3,Ana,35,ES04209538845447732310,TRX_N-01011-62707256,2024-06-26T13:51:57,Amurrio,expenses,children,-240.08,-54954.59
buyer_3,Ana,35,ES04209538845447732310,TRX_N-01012-60955507,2024-06-27T16:06:38,Amurrio,expenses,clothing,-48.6,-55003.19
buyer_3,Ana,35,ES04209538845447732310,TRX_N-01013-64824998,2024-06-28T06:21:05,Amurrio,expenses,leisure,-25.54,-55028.73
buyer_3,Ana,35,ES04209538845447732310,TRX_N-01014-55619103,2024-06-28T20:26:34,Amurrio,expenses,cash,-100.0,-55128.73
buyer_3,Ana,35,ES04209538845447732310,TRX_N-01015-64997173,2024-06-29T09:44:12,Amurrio,expenses,food,-76.85,-55205.58
buyer_3,Ana,35,ES04209538845447732310,TRX_N-01016-87451301,2024-06-29T22:39:07,Amurrio,expenses,transport,-69.93,-55275.51
buyer_3,Ana,35,ES04209538845447732310,TRX_N-01017-68370292,2024-06-30T11:53:18,Amurrio,expenses,gifts,-788.03,-56063.54
buyer_3,Ana,35,ES04209538845447732310,TRX_N-01018-56715070,2024-07-01T15:34:13,Amurrio,incomes,salary,1322.7,-54740.84
buyer_3,Ana,35,ES04209538845447732310,TRX_N-01019-44431584,2024-07-01T15:34:13,Amurrio,incomes,salary_partner,1205.01,-53535.83
buyer_3,Ana,35,ES04209538845447732310,TRX_N-01020-69253794,2024-07-01T16:49:36,Amurrio,expenses,leisure,-25.66,-53561.49
buyer_3,Ana,35,ES04209538845447732310,TRX_N-01021-36725736,2024-07-03T11:06:57,Basauri,expenses,transport,-53.07,-53614.56
buyer_3,Ana,35,ES04209538845447732310,TRX_N-01022-34956358,2024-07-03T05:05:51,Amurrio,expenses,children,-224.94,-53839.5
buyer_3,Ana,35,ES04209538845447732310,TRX_N-01023-50059017,2024-07-04T04:33:36,Amurrio,expenses,mortgage,-874.64,-54714.14
buyer_3,Ana,35,ES04209538845447732310,TRX_N-01024-20405874,2024-07-04T19:20:46,Amurrio,expenses,clothing,-61.96,-54776.1
buyer_3,Ana,35,ES04209538845447732310,TRX_N-01025-29895070,2024-07-05T16:49:56,Amurrio,expenses,electricity,-71.07,-54847.17
buyer_3,Ana,35,ES04209538845447732310,TRX_N-01026-86303813,2024-07-06T20:57:16,Amurrio,expenses,internet,-42.0,-54889.17
buyer_3,Ana,35,ES04209538845447732310,TRX_N-01027-78346705,2024-07-07T13:35:03,Amurrio,expenses,gas,-43.31,-54932.48
buyer_3,Ana,35,ES04209538845447732310,TRX_N-01028-86628659,2024-07-07T16:33:56,Amurrio,expenses,phone,-33.15,-54965.63
buyer_3,Ana,35,ES04209538845447732310,TRX_N-01029-66041835,2024-07-07T19:15:00,Donostia,expenses,food,-99.59,-55065.22
buyer_3,Ana,35,ES04209538845447732310,TRX_N-01030-05248331,2024-07-07T17:23:58,Amurrio,expenses,clothing,-73.19,-55138.41
buyer_3,Ana,35,ES04209538845447732310,TRX_N-01031-64374236,2024-07-07T17:13:25,Amurrio,expenses,repairs,-267.58,-55405.99
buyer_3,Ana,35,ES04209538845447732310,TRX_N-01032-27165821,2024-07-08T11:02:00,Amurrio,expenses,water,-37.62,-55443.61
buyer_3,Ana,35,ES04209538845447732310,TRX_N-01033-33791892,2024-07-09T06:25:38,Amurrio,expenses,transport,-61.16,-55504.77
buyer_3,Ana,35,ES04209538845447732310,TRX_N-01034-44494795,2024-07-10T15:36:46,Llodio,expenses,transport,-47.06,-55551.83
buyer_3,Ana,35,ES04209538845447732310,TRX_N-01035-29215941,2024-07-10T20:28:04,Amurrio,expenses,education,-63.32,-55615.15
buyer_3,Ana,35,ES04209538845447732310,TRX_N-01036-14023972,2024-07-10T20:40:57,Amurrio,expenses,cash,-100.0,-55715.15
buyer_3,Ana,35,ES04209538845447732310,TRX_N-01037-95799030,2024-07-11T14:01:29,Amurrio,expenses,repairs,-196.92,-55912.07
buyer_3,Ana,35,ES04209538845447732310,TRX_N-01038-21987818,2024-07-12T20:32:22,Amurrio,expenses,transport,-84.05,-55996.12
buyer_3,Ana,35,ES04209538845447732310,TRX_N-01039-05434207,2024-07-14T21:04:38,Amurrio,expenses,food,-116.21,-56112.33
buyer_3,Ana,35,ES04209538845447732310,TRX_N-01040-04324321,2024-07-15T15:44:14,Amurrio,expenses,food,-103.31,-56215.64
buyer_3,Ana,35,ES04209538845447732310,TRX_N-01041-26315823,2024-07-16T12:34:39,Amurrio,expenses,food,-76.24,-56291.88
buyer_3,Ana,35,ES04209538845447732310,TRX_N-01042-72632055,2024-07-16T21:40:59,Amurrio,expenses,gifts,-221.29,-56513.17
buyer_3,Ana,35,ES04209538845447732310,TRX_N-01043-15795227,2024-07-17T16:15:08,Amurrio,expenses,transport,-51.8,-56564.97
buyer_3,Ana,35,ES04209538845447732310,TRX_N-01044-49306566,2024-07-18T21:34:21,Amurrio,expenses,repairs,-303.23,-56868.2
buyer_3,Ana,35,ES04209538845447732310,TRX_N-01045-94315752,2024-07-19T13:35:39,Amurrio,expenses,leisure,-37.41,-56905.61
buyer_3,Ana,35,ES04209538845447732310,TRX_N-01046-36021149,2024-07-20T12:13:31,Durango,expenses,food,-80.73,-56986.34
buyer_3,Ana,35,ES04209538845447732310,TRX_N-01047-95850608,2024-07-20T17:04:39,Amurrio,expenses,appliances,-189.45,-57175.79
buyer_3,Ana,35,ES04209538845447732310,TRX_N-01048-23239649,2024-07-21T09:04:22,Amurrio,expenses,food,-87.32,-57263.11
buyer_3,Ana,35,ES04209538845447732310,TRX_N-01049-64259334,2024-07-23T13:52:32,Amurrio,expenses,travel,-1138.35,-58401.46
buyer_3,Ana,35,ES04209538845447732310,TRX_N-01050-17691822,2024-07-24T18:27:50,Amurrio,expenses,transport,-57.18,-58458.64
buyer_3,Ana,35,ES04209538845447732310,TRX_N-01051-63601715,2024-07-26T08:01:19,Amurrio,expenses,food,-78.7,-58537.34
buyer_3,Ana,35,ES04209538845447732310,TRX_N-01052-05193021,2024-07-28T16:02:13,Amurrio,expenses,leisure,-58.23,-58595.57
buyer_3,Ana,35,ES04209538845447732310,TRX_N-01053-32914222,2024-07-29T09:19:27,Amurrio,expenses,appliances,-102.77,-58698.34
buyer_3,Ana,35,ES04209538845447732310,TRX_N-01054-42518329,2024-07-30T15:47:18,Amurrio,expenses,appliances,-171.0,-58869.34
buyer_3,Ana,35,ES04209538845447732310,TRX_N-01055-89386434,2024-08-01T10:31:48,Amurrio,incomes,salary,1322.7,-57546.64
buyer_3,Ana,35,ES04209538845447732310,TRX_N-01056-43169949,2024-08-01T10:31:48,Amurrio,incomes,salary_partner,1205.01,-56341.63
buyer_3,Ana,35,ES04209538845447732310,TRX_N-01057-64342228,2024-08-01T09:34:01,Amurrio,expenses,transport,-80.68,-56422.31
buyer_3,Ana,35,ES04209538845447732310,TRX_N-01058-59772899,2024-08-02T10:21:28,Amurrio,expenses,food,-106.07,-56528.38
buyer_3,Ana,35,ES04209538845447732310,TRX_N-01059-96673471,2024-08-03T12:40:45,Labastida,expenses,transport,-85.19,-56613.57
buyer_3,Ana,35,ES04209538845447732310,TRX_N-01060-21503897,2024-08-03T10:34:15,Amurrio,expenses,cash,-100.0,-56713.57
buyer_3,Ana,35,ES04209538845447732310,TRX_N-01061-64341075,2024-08-04T20:27:13,Amurrio,expenses,mortgage,-874.64,-57588.21
buyer_3,Ana,35,ES04209538845447732310,TRX_N-01062-86623990,2024-08-04T16:53:45,Amurrio,expenses,food,-66.72,-57654.93
buyer_3,Ana,35,ES04209538845447732310,TRX_N-01063-43596197,2024-08-05T17:50:13,Amurrio,expenses,electricity,-67.91,-57722.84
buyer_3,Ana,35,ES04209538845447732310,TRX_N-01064-03516726,2024-08-06T17:33:27,Amurrio,expenses,food,-113.1,-57835.94
buyer_3,Ana,35,ES04209538845447732310,TRX_N-01065-06006059,2024-08-08T20:44:06,Amurrio,expenses,water,-44.62,-57880.56
buyer_3,Ana,35,ES04209538845447732310,TRX_N-01066-03418257,2024-08-08T14:35:56,Amurrio,expenses,gas,-85.37,-57965.93
buyer_3,Ana,35,ES04209538845447732310,TRX_N-01067-03129226,2024-08-08T14:30:11,Amurrio,expenses,internet,-42.0,-58007.93
buyer_3,Ana,35,ES04209538845447732310,TRX_N-01068-22069537,2024-08-08T19:56:28,Amurrio,expenses,phone,-39.47,-58047.4
buyer_3,Ana,35,ES04209538845447732310,TRX_N-01069-44142051,2024-08-08T18:46:00,Amurrio,expenses,food,-64.89,-58112.29
buyer_3,Ana,35,ES04209538845447732310,TRX_N-01070-40202127,2024-08-11T15:49:44,Amurrio,expenses,children,-143.84,-58256.13
buyer_3,Ana,35,ES04209538845447732310,TRX_N-01071-53010539,2024-08-12T05:27:02,Amurrio,expenses,food,-119.72,-58375.85
buyer_3,Ana,35,ES04209538845447732310,TRX_N-01072-39113678,2024-08-12T16:30:42,Amurrio,expenses,education,-56.11,-58431.96
buyer_3,Ana,35,ES04209538845447732310,TRX_N-01073-53864846,2024-08-13T18:41:35,Amurrio,expenses,education,-51.71,-58483.67
buyer_3,Ana,35,ES04209538845447732310,TRX_N-01074-67241593,2024-08-13T09:09:39,Amurrio,expenses,cash,-100.0,-58583.67
buyer_3,Ana,35,ES04209538845447732310,TRX_N-01075-92966715,2024-08-15T08:19:38,Amurrio,expenses,food,-66.85,-58650.52
buyer_3,Ana,35,ES04209538845447732310,TRX_N-01076-81359248,2024-08-16T19:23:05,Amurrio,expenses,leisure,-56.33,-58706.85
buyer_3,Ana,35,ES04209538845447732310,TRX_N-01077-54444022,2024-08-17T09:07:56,Amurrio,expenses,leisure,-32.56,-58739.41
buyer_3,Ana,35,ES04209538845447732310,TRX_N-01078-80432037,2024-08-18T20:39:11,Amurrio,expenses,children,-270.09,-59009.5
buyer_3,Ana,35,ES04209538845447732310,TRX_N-01079-59313483,2024-08-20T11:45:52,Mungia,expenses,cash,-100.0,-59109.5
buyer_3,Ana,35,ES04209538845447732310,TRX_N-01080-74403991,2024-08-21T23:37:15,Amurrio,expenses,food,-116.74,-59226.24
buyer_3,Ana,35,ES04209538845447732310,TRX_N-01081-35493346,2024-08-21T09:56:34,Amurrio,expenses,leisure,-58.3,-59284.54
buyer_3,Ana,35,ES04209538845447732310,TRX_N-01082-34588514,2024-08-22T16:12:07,Amurrio,expenses,repairs,-170.2,-59454.74
buyer_3,Ana,35,ES04209538845447732310,TRX_N-01083-89635452,2024-08-23T15:58:33,Amurrio,expenses,healthcare,-39.98,-59494.72
buyer_3,Ana,35,ES04209538845447732310,TRX_N-01084-29625066,2024-08-25T15:22:40,Amurrio,expenses,clothing,-152.59,-59647.31
buyer_3,Ana,35,ES04209538845447732310,TRX_N-01085-21692573,2024-08-26T08:05:12,Amurrio,expenses,transport,-70.4,-59717.71
buyer_3,Ana,35,ES04209538845447732310,TRX_N-01086-59047458,2024-08-31T20:04:06,Amurrio,expenses,food,-80.4,-59798.11
buyer_3,Ana,35,ES04209538845447732310,TRX_N-01087-52075136,2024-08-31T08:04:45,Amurrio,expenses,transport,-45.75,-59843.86
buyer_3,Ana,35,ES04209538845447732310,TRX_N-01088-89305821,2024-09-01T13:42:16,Amurrio,incomes,salary,1322.7,-58521.16
buyer_3,Ana,35,ES04209538845447732310,TRX_N-01089-59399539,2024-09-01T13:42:16,Amurrio,incomes,salary_partner,1205.01,-57316.15
buyer_3,Ana,35,ES04209538845447732310,TRX_N-01090-97969678,2024-09-01T13:42:16,Amurrio,incomes,extra_income,209.99,-57106.16
buyer_3,Ana,35,ES04209538845447732310,TRX_N-01091-26520311,2024-09-04T16:17:24,Amurrio,expenses,mortgage,-874.64,-57980.8
buyer_3,Ana,35,ES04209538845447732310,TRX_N-01092-98880780,2024-09-04T21:14:22,Amurrio,expenses,food,-72.77,-58053.57
buyer_3,Ana,35,ES04209538845447732310,TRX_N-01093-00133785,2024-09-06T18:35:14,Amurrio,expenses,gas,-35.57,-58089.14
buyer_3,Ana,35,ES04209538845447732310,TRX_N-01094-43459144,2024-09-06T16:28:11,Amurrio,expenses,transport,-84.72,-58173.86
buyer_3,Ana,35,ES04209538845447732310,TRX_N-01095-20462718,2024-09-07T12:17:26,Amurrio,expenses,phone,-43.84,-58217.7
buyer_3,Ana,35,ES04209538845447732310,TRX_N-01096-56607205,2024-09-07T19:02:20,Amurrio,expenses,food,-92.65,-58310.35
buyer_3,Ana,35,ES04209538845447732310,TRX_N-01097-57484462,2024-09-08T01:47:32,Amurrio,expenses,water,-25.61,-58335.96
buyer_3,Ana,35,ES04209538845447732310,TRX_N-01098-15114780,2024-09-08T20:17:31,Amurrio,expenses,electricity,-36.41,-58372.37
buyer_3,Ana,35,ES04209538845447732310,TRX_N-01099-40692421,2024-09-08T13:37:50,Amurrio,expenses,internet,-42.0,-58414.37
buyer_3,Ana,35,ES04209538845447732310,TRX_N-01100-70220471,2024-09-08T18:06:36,Alegría-Dulantzi,expenses,gifts,-754.56,-59168.93
buyer_3,Ana,35,ES04209538845447732310,TRX_N-01101-68292024,2024-09-09T17:15:11,Errenteria,expenses,leisure,-37.61,-59206.54
buyer_3,Ana,35,ES04209538845447732310,TRX_N-01102-83090629,2024-09-11T20:23:58,Amurrio,expenses,food,-108.01,-59314.55
buyer_3,Ana,35,ES04209538845447732310,TRX_N-01103-84575057,2024-09-11T20:12:49,Amurrio,expenses,transport,-40.04,-59354.59
buyer_3,Ana,35,ES04209538845447732310,TRX_N-01104-28041063,2024-09-11T22:25:51,Amurrio,expenses,cash,-100.0,-59454.59
buyer_3,Ana,35,ES04209538845447732310,TRX_N-01105-86761616,2024-09-12T11:02:06,Amurrio,expenses,appliances,-387.51,-59842.1
buyer_3,Ana,35,ES04209538845447732310,TRX_N-01106-52173844,2024-09-14T10:24:47,Andoain,expenses,food,-94.75,-59936.85
buyer_3,Ana,35,ES04209538845447732310,TRX_N-01107-35928959,2024-09-15T09:30:55,Amurrio,expenses,food,-79.67,-60016.52
buyer_3,Ana,35,ES04209538845447732310,TRX_N-01108-48410896,2024-09-15T21:16:42,Iruña de Oca,expenses,healthcare,-82.19,-60098.71
buyer_3,Ana,35,ES04209538845447732310,TRX_N-01109-75841614,2024-09-16T00:42:23,Amurrio,expenses,gifts,-150.34,-60249.05
buyer_3,Ana,35,ES04209538845447732310,TRX_N-01110-79651524,2024-09-18T17:58:54,Amurrio,expenses,leisure,-25.34,-60274.39
buyer_3,Ana,35,ES04209538845447732310,TRX_N-01111-40593639,2024-09-18T22:29:40,Sopela,expenses,gifts,-496.87,-60771.26
buyer_3,Ana,35,ES04209538845447732310,TRX_N-01112-12569517,2024-09-18T18:22:48,Amurrio,expenses,children,-207.04,-60978.3
buyer_3,Ana,35,ES04209538845447732310,TRX_N-01113-53689001,2024-09-19T15:15:03,Amurrio,expenses,transport,-41.25,-61019.55
buyer_3,Ana,35,ES04209538845447732310,TRX_N-01114-22643990,2024-09-19T16:19:41,Amurrio,expenses,leisure,-38.87,-61058.42
buyer_3,Ana,35,ES04209538845447732310,TRX_N-01115-40706449,2024-09-19T13:45:57,Amurrio,expenses,education,-53.03,-61111.45
buyer_3,Ana,35,ES04209538845447732310,TRX_N-01116-68138707,2024-09-20T19:24:50,Arrasate,expenses,food,-112.1,-61223.55
buyer_3,Ana,35,ES04209538845447732310,TRX_N-01117-79813777,2024-09-27T14:39:03,Amurrio,expenses,repairs,-295.15,-61518.7
buyer_3,Ana,35,ES04209538845447732310,TRX_N-01118-63521611,2024-09-28T17:40:34,Amurrio,expenses,food,-121.6,-61640.3
buyer_3,Ana,35,ES04209538845447732310,TRX_N-01119-46885913,2024-09-28T11:02:31,Amurrio,expenses,leisure,-57.45,-61697.75
buyer_3,Ana,35,ES04209538845447732310,TRX_N-01120-41464490,2024-09-29T16:28:52,Amurrio,expenses,food,-91.76,-61789.51
buyer_3,Ana,35,ES04209538845447732310,TRX_N-01121-20316042,2024-10-01T19:55:41,Amurrio,incomes,salary,1322.7,-60466.81
buyer_3,Ana,35,ES04209538845447732310,TRX_N-01122-87095697,2024-10-01T19:55:41,Amurrio,incomes,salary_partner,1205.01,-59261.8
buyer_3,Ana,35,ES04209538845447732310,TRX_N-01123-80337424,2024-10-01T16:34:43,Amurrio,expenses,healthcare,-140.65,-59402.45
buyer_3,Ana,35,ES04209538845447732310,TRX_N-01124-17426949,2024-10-01T14:26:34,Amurrio,expenses,cash,-100.0,-59502.45
buyer_3,Ana,35,ES04209538845447732310,TRX_N-01125-02319605,2024-10-04T14:14:33,Amurrio,expenses,mortgage,-874.64,-60377.09
buyer_3,Ana,35,ES04209538845447732310,TRX_N-01126-53782902,2024-10-05T12:04:23,Amurrio,expenses,gas,-105.78,-60482.87
buyer_3,Ana,35,ES04209538845447732310,TRX_N-01127-88389241,2024-10-05T11:02:46,Sestao,expenses,transport,-70.97,-60553.84
buyer_3,Ana,35,ES04209538845447732310,TRX_N-01128-98015118,2024-10-06T10:27:41,Amurrio,expenses,water,-30.77,-60584.61
buyer_3,Ana,35,ES04209538845447732310,TRX_N-01129-54629950,2024-10-07T09:17:01,Amurrio,expenses,phone,-31.13,-60615.74
buyer_3,Ana,35,ES04209538845447732310,TRX_N-01130-13852533,2024-10-07T10:19:12,Amurrio,expenses,leisure,-81.28,-60697.02
buyer_3,Ana,35,ES04209538845447732310,TRX_N-01131-82465587,2024-10-08T17:49:22,Amurrio,expenses,electricity,-20.72,-60717.74
buyer_3,Ana,35,ES04209538845447732310,TRX_N-01132-87026101,2024-10-08T20:33:48,Amurrio,expenses,internet,-42.0,-60759.74
buyer_3,Ana,35,ES04209538845447732310,TRX_N-01133-16806754,2024-10-08T15:27:24,Amurrio,expenses,leisure,-80.78,-60840.52
buyer_3,Ana,35,ES04209538845447732310,TRX_N-01134-47448267,2024-10-08T12:11:53,Amurrio,expenses,children,-84.49,-60925.01
buyer_4,Jorge,50,ES59209509865436075018,TRX_N-00001-45812731,2022-01-01T22:03:07,Galdakao,incomes,salary,1407.46,3219.88
buyer_4,Jorge,50,ES59209509865436075018,TRX_N-00002-95006749,2022-01-01T22:03:07,Galdakao,incomes,salary_partner,1330.17,4550.05
buyer_4,Jorge,50,ES59209509865436075018,TRX_N-00003-81607760,2022-01-01T19:30:00,Galdakao,expenses,food,-71.61,4478.44
buyer_4,Jorge,50,ES59209509865436075018,TRX_N-00004-77658730,2022-01-01T16:43:32,Galdakao,expenses,education,-76.86,4401.58
buyer_4,Jorge,50,ES59209509865436075018,TRX_N-00005-73404817,2022-01-02T17:40:59,Galdakao,expenses,repairs,-42.69,4358.89
buyer_4,Jorge,50,ES59209509865436075018,TRX_N-00006-23040191,2022-01-03T09:28:16,Galdakao,expenses,leisure,-76.62,4282.27
buyer_4,Jorge,50,ES59209509865436075018,TRX_N-00007-68293857,2022-01-03T19:25:09,Galdakao,expenses,healthcare,-96.21,4186.06
buyer_4,Jorge,50,ES59209509865436075018,TRX_N-00008-72132448,2022-01-04T18:23:08,Galdakao,expenses,mortgage,-858.17,3327.89
buyer_4,Jorge,50,ES59209509865436075018,TRX_N-00009-88351502,2022-01-05T00:15:56,Galdakao,expenses,electricity,-42.52,3285.37
buyer_4,Jorge,50,ES59209509865436075018,TRX_N-00010-96077800,2022-01-06T23:22:44,Galdakao,expenses,phone,-40.93,3244.44
buyer_4,Jorge,50,ES59209509865436075018,TRX_N-00011-66680099,2022-01-06T22:13:23,Galdakao,expenses,appliances,-142.74,3101.7
buyer_4,Jorge,50,ES59209509865436075018,TRX_N-00012-02641277,2022-01-07T18:08:04,Galdakao,expenses,healthcare,-150.35,2951.35
buyer_4,Jorge,50,ES59209509865436075018,TRX_N-00013-20597398,2022-01-08T14:10:09,Galdakao,expenses,water,-38.14,2913.21
buyer_4,Jorge,50,ES59209509865436075018,TRX_N-00014-00322069,2022-01-08T13:37:39,Galdakao,expenses,gas,-66.78,2846.43
buyer_4,Jorge,50,ES59209509865436075018,TRX_N-00015-34260405,2022-01-08T18:56:19,Galdakao,expenses,internet,-42.0,2804.43
buyer_4,Jorge,50,ES59209509865436075018,TRX_N-00016-32769939,2022-01-09T14:18:44,Galdakao,expenses,food,-73.84,2730.59
buyer_4,Jorge,50,ES59209509865436075018,TRX_N-00017-62262083,2022-01-09T16:01:37,Andoain,expenses,transport,-49.57,2681.02
buyer_4,Jorge,50,ES59209509865436075018,TRX_N-00018-20697062,2022-01-10T22:52:11,Amurrio,expenses,cash,-100.0,2581.02
buyer_4,Jorge,50,ES59209509865436075018,TRX_N-00019-30534254,2022-01-11T23:21:21,Galdakao,expenses,healthcare,-134.84,2446.18
buyer_4,Jorge,50,ES59209509865436075018,TRX_N-00020-88935933,2022-01-11T10:28:51,Galdakao,expenses,cash,-100.0,2346.18
buyer_4,Jorge,50,ES59209509865436075018,TRX_N-00021-50335855,2022-01-13T11:24:58,Galdakao,expenses,cash,-100.0,2246.18
buyer_4,Jorge,50,ES59209509865436075018,TRX_N-00022-86288885,2022-01-14T20:24:11,Galdakao,expenses,cash,-100.0,2146.18
buyer_4,Jorge,50,ES59209509865436075018,TRX_N-00023-60788614,2022-01-15T09:17:02,Getxo,expenses,transport,-65.6,2080.58
buyer_4,Jorge,50,ES59209509865436075018,TRX_N-00024-75677464,2022-01-15T08:19:59,Galdakao,expenses,repairs,-211.48,1869.1
buyer_4,Jorge,50,ES59209509865436075018,TRX_N-00025-49631937,2022-01-15T16:08:50,Galdakao,expenses,children,-158.75,1710.35
buyer_4,Jorge,50,ES59209509865436075018,TRX_N-00026-19448131,2022-01-17T17:11:52,Salvatierra/Agurain,expenses,food,-63.93,1646.42
buyer_4,Jorge,50,ES59209509865436075018,TRX_N-00027-28563685,2022-01-17T20:43:19,Galdakao,expenses,repairs,-95.18,1551.24
buyer_4,Jorge,50,ES59209509865436075018,TRX_N-00028-92706830,2022-01-20T10:57:38,Galdakao,expenses,transport,-73.26,1477.98
buyer_4,Jorge,50,ES59209509865436075018,TRX_N-00029-86814993,2022-01-21T10:44:51,Erandio,expenses,leisure,-83.93,1394.05
buyer_4,Jorge,50,ES59209509865436075018,TRX_N-00030-64709574,2022-01-21T19:52:50,Galdakao,expenses,cash,-100.0,1294.05
buyer_4,Jorge,50,ES59209509865436075018,TRX_N-00031-86593118,2022-01-22T23:23:05,Galdakao,expenses,food,-83.74,1210.31
buyer_4,Jorge,50,ES59209509865436075018,TRX_N-00032-20068635,2022-01-22T12:00:10,Mungia,expenses,gifts,-338.45,871.86
buyer_4,Jorge,50,ES59209509865436075018,TRX_N-00033-85482866,2022-01-23T00:28:53,Galdakao,expenses,clothing,-125.26,746.6
buyer_4,Jorge,50,ES59209509865436075018,TRX_N-00034-91620366,2022-01-23T16:48:51,Galdakao,expenses,cash,-100.0,646.6
buyer_4,Jorge,50,ES59209509865436075018,TRX_N-00035-02849586,2022-01-25T14:27:33,Galdakao,expenses,leisure,-20.36,626.24
buyer_4,Jorge,50,ES59209509865436075018,TRX_N-00036-89928054,2022-01-26T17:31:32,Galdakao,expenses,repairs,-181.67,444.57
buyer_4,Jorge,50,ES59209509865436075018,TRX_N-00037-95962192,2022-01-26T18:09:40,Sestao,expenses,gifts,-695.14,-250.57
buyer_4,Jorge,50,ES59209509865436075018,TRX_N-00038-01834411,2022-01-28T08:21:43,Galdakao,expenses,education,-63.55,-314.12
buyer_4,Jorge,50,ES59209509865436075018,TRX_N-00039-00835210,2022-01-30T09:17:30,Galdakao,expenses,cash,-100.0,-414.12
buyer_4,Jorge,50,ES59209509865436075018,TRX_N-00040-63865836,2022-02-01T19:50:12,Galdakao,incomes,salary,1407.46,993.34
buyer_4,Jorge,50,ES59209509865436075018,TRX_N-00041-72520864,2022-02-01T19:50:12,Galdakao,incomes,salary_partner,1330.17,2323.51
buyer_4,Jorge,50,ES59209509865436075018,TRX_N-00042-75386489,2022-02-01T19:35:15,Galdakao,expenses,leisure,-36.92,2286.59
buyer_4,Jorge,50,ES59209509865436075018,TRX_N-00043-57745469,2022-02-01T10:36:04,Galdakao,expenses,cash,-100.0,2186.59
buyer_4,Jorge,50,ES59209509865436075018,TRX_N-00044-23595937,2022-02-03T18:39:16,Galdakao,expenses,leisure,-29.26,2157.33
buyer_4,Jorge,50,ES59209509865436075018,TRX_N-00045-24652903,2022-02-04T13:50:38,Galdakao,expenses,mortgage,-858.17,1299.16
buyer_4,Jorge,50,ES59209509865436075018,TRX_N-00046-14844548,2022-02-04T19:58:56,Galdakao,expenses,transport,-40.94,1258.22
buyer_4,Jorge,50,ES59209509865436075018,TRX_N-00047-18334775,2022-02-05T17:25:50,Galdakao,expenses,electricity,-31.15,1227.07
buyer_4,Jorge,50,ES59209509865436075018,TRX_N-00048-57159323,2022-02-05T09:31:47,Galdakao,expenses,gas,-79.19,1147.88
buyer_4,Jorge,50,ES59209509865436075018,TRX_N-00049-56931503,2022-02-06T21:18:06,Galdakao,expenses,children,-177.25,970.63
buyer_4,Jorge,50,ES59209509865436075018,TRX_N-00050-28404476,2022-02-08T13:44:56,Galdakao,expenses,internet,-42.0,928.63
buyer_4,Jorge,50,ES59209509865436075018,TRX_N-00051-57134684,2022-02-08T11:16:33,Galdakao,expenses,water,-34.01,894.62
buyer_4,Jorge,50,ES59209509865436075018,TRX_N-00052-17092197,2022-02-08T04:47:48,Galdakao,expenses,phone,-33.4,861.22
buyer_4,Jorge,50,ES59209509865436075018,TRX_N-00053-54743293,2022-02-08T03:41:03,Galdakao,expenses,food,-85.29,775.93
buyer_4,Jorge,50,ES59209509865436075018,TRX_N-00054-43927880,2022-02-08T17:00:47,Lasarte-Oria,expenses,cash,-100.0,675.93
buyer_4,Jorge,50,ES59209509865436075018,TRX_N-00055-44244333,2022-02-10T22:45:54,Labastida,expenses,transport,-55.84,620.09
buyer_4,Jorge,50,ES59209509865436075018,TRX_N-00056-45475750,2022-02-11T08:35:42,Galdakao,expenses,cash,-100.0,520.09
buyer_4,Jorge,50,ES59209509865436075018,TRX_N-00057-04541722,2022-02-14T12:53:41,Galdakao,expenses,food,-124.8,395.29
buyer_4,Jorge,50,ES59209509865436075018,TRX_N-00058-98227761,2022-02-14T13:29:40,Galdakao,expenses,education,-70.62,324.67
buyer_4,Jorge,50,ES59209509865436075018,TRX_N-00059-17132585,2022-02-14T18:32:27,Galdakao,expenses,cash,-100.0,224.67
buyer_4,Jorge,50,ES59209509865436075018,TRX_N-00060-85411145,2022-02-14T15:21:58,Galdakao,expenses,repairs,-115.46,109.21
buyer_4,Jorge,50,ES59209509865436075018,TRX_N-00061-97421703,2022-02-15T15:22:36,Galdakao,expenses,education,-58.9,50.31
buyer_4,Jorge,50,ES59209509865436075018,TRX_N-00062-78431724,2022-02-16T23:02:47,Galdakao,expenses,transport,-45.86,4.45
buyer_4,Jorge,50,ES59209509865436075018,TRX_N-00063-86482343,2022-02-16T13:56:20,Galdakao,expenses,gifts,-525.31,-520.86
buyer_4,Jorge,50,ES59209509865436075018,TRX_N-00064-54993117,2022-02-17T16:35:52,Galdakao,expenses,cash,-100.0,-620.86
buyer_4,Jorge,50,ES59209509865436075018,TRX_N-00065-41999201,2022-02-17T16:45:07,Galdakao,expenses,repairs,-106.2,-727.06
buyer_4,Jorge,50,ES59209509865436075018,TRX_N-00066-10457890,2022-02-19T21:28:44,Galdakao,expenses,food,-105.38,-832.44
buyer_4,Jorge,50,ES59209509865436075018,TRX_N-00067-95291800,2022-02-21T20:18:32,Galdakao,expenses,children,-251.51,-1083.95
buyer_4,Jorge,50,ES59209509865436075018,TRX_N-00068-80204473,2022-02-22T18:39:24,Galdakao,expenses,cash,-100.0,-1183.95
buyer_4,Jorge,50,ES59209509865436075018,TRX_N-00069-78222999,2022-02-24T16:13:10,Galdakao,expenses,transport,-40.63,-1224.58
buyer_4,Jorge,50,ES59209509865436075018,TRX_N-00070-71448436,2022-02-24T15:09:37,Galdakao,expenses,leisure,-84.02,-1308.6
buyer_4,Jorge,50,ES59209509865436075018,TRX_N-00071-26137522,2022-02-24T19:01:32,Galdakao,expenses,cash,-100.0,-1408.6
buyer_4,Jorge,50,ES59209509865436075018,TRX_N-00072-32086636,2022-02-26T14:29:59,Galdakao,expenses,repairs,-197.06,-1605.66
buyer_4,Jorge,50,ES59209509865436075018,TRX_N-00073-65669684,2022-02-27T21:16:59,Galdakao,expenses,food,-66.24,-1671.9
buyer_4,Jorge,50,ES59209509865436075018,TRX_N-00074-62621171,2022-02-27T05:09:55,Arrasate,expenses,cash,-100.0,-1771.9
buyer_4,Jorge,50,ES59209509865436075018,TRX_N-00075-73048946,2022-02-27T10:29:11,Galdakao,expenses,gifts,-33.57,-1805.47
buyer_4,Jorge,50,ES59209509865436075018,TRX_N-00076-75915939,2022-03-01T22:07:28,Galdakao,incomes,salary,1407.46,-398.01
buyer_4,Jorge,50,ES59209509865436075018,TRX_N-00077-93480783,2022-03-01T22:07:28,Galdakao,incomes,salary_partner,1330.17,932.16
buyer_4,Jorge,50,ES59209509865436075018,TRX_N-00078-15529323,2022-03-01T18:16:47,Galdakao,expenses,food,-67.39,864.77
buyer_4,Jorge,50,ES59209509865436075018,TRX_N-00079-98239420,2022-03-01T17:40:44,Galdakao,expenses,travel,-804.77,60.0
buyer_4,Jorge,50,ES59209509865436075018,TRX_N-00080-21510007,2022-03-02T09:55:41,Galdakao,expenses,food,-77.94,-17.94
buyer_4,Jorge,50,ES59209509865436075018,TRX_N-00081-58883215,2022-03-02T17:43:10,Galdakao,expenses,healthcare,-101.77,-119.71
buyer_4,Jorge,50,ES59209509865436075018,TRX_N-00082-86317152,2022-03-02T01:21:49,Galdakao,expenses,cash,-100.0,-219.71
buyer_4,Jorge,50,ES59209509865436075018,TRX_N-00083-77462295,2022-03-03T13:48:53,Galdakao,expenses,food,-78.64,-298.35
buyer_4,Jorge,50,ES59209509865436075018,TRX_N-00084-96405373,2022-03-04T10:42:32,Galdakao,expenses,mortgage,-858.17,-1156.52
buyer_4,Jorge,50,ES59209509865436075018,TRX_N-00085-17401093,2022-03-04T20:59:09,Galdakao,expenses,transport,-56.52,-1213.04
buyer_4,Jorge,50,ES59209509865436075018,TRX_N-00086-93528477,2022-03-04T13:11:50,Labastida,expenses,leisure,-72.46,-1285.5
buyer_4,Jorge,50,ES59209509865436075018,TRX_N-00087-37320741,2022-03-04T14:48:04,Galdakao,expenses,repairs,-155.74,-1441.24
buyer_4,Jorge,50,ES59209509865436075018,TRX_N-00088-06469459,2022-03-05T15:42:56,Galdakao,expenses,cash,-100.0,-1541.24
buyer_4,Jorge,50,ES59209509865436075018,TRX_N-00089-61778073,2022-03-06T14:05:44,Galdakao,expenses,electricity,-22.97,-1564.21
buyer_4,Jorge,50,ES59209509865436075018,TRX_N-00090-32403469,2022-03-06T20:57:58,Galdakao,expenses,gas,-111.32,-1675.53
buyer_4,Jorge,50,ES59209509865436075018,TRX_N-00091-26476079,2022-03-06T10:36:49,Galdakao,expenses,cash,-100.0,-1775.53
buyer_4,Jorge,50,ES59209509865436075018,TRX_N-00092-39478698,2022-03-07T09:52:25,Galdakao,expenses,cash,-100.0,-1875.53
buyer_4,Jorge,50,ES59209509865436075018,TRX_N-00093-37320479,2022-03-08T15:41:58,Galdakao,expenses,water,-26.51,-1902.04
buyer_4,Jorge,50,ES59209509865436075018,TRX_N-00094-44604315,2022-03-08T12:22:41,Galdakao,expenses,internet,-42.0,-1944.04
buyer_4,Jorge,50,ES59209509865436075018,TRX_N-00095-10062917,2022-03-08T11:08:29,Galdakao,expenses,phone,-44.2,-1988.24
buyer_4,Jorge,50,ES59209509865436075018,TRX_N-00096-52520524,2022-03-08T10:54:20,Galdakao,expenses,food,-92.39,-2080.63
buyer_4,Jorge,50,ES59209509865436075018,TRX_N-00097-13941980,2022-03-08T18:52:30,Eibar,expenses,leisure,-63.28,-2143.91
buyer_4,Jorge,50,ES59209509865436075018,TRX_N-00098-99032902,2022-03-09T22:07:11,Errenteria,expenses,gifts,-268.08,-2411.99
buyer_4,Jorge,50,ES59209509865436075018,TRX_N-00099-19909138,2022-03-10T11:24:58,Galdakao,expenses,food,-109.79,-2521.78
buyer_4,Jorge,50,ES59209509865436075018,TRX_N-00100-06441912,2022-03-10T19:55:25,Alegría-Dulantzi,expenses,leisure,-54.69,-2576.47
buyer_4,Jorge,50,ES59209509865436075018,TRX_N-00101-35208134,2022-03-12T12:51:30,Berango,expenses,leisure,-69.7,-2646.17
buyer_4,Jorge,50,ES59209509865436075018,TRX_N-00102-36381997,2022-03-12T20:19:34,Galdakao,expenses,cash,-100.0,-2746.17
buyer_4,Jorge,50,ES59209509865436075018,TRX_N-00103-14714242,2022-03-13T08:21:50,Amurrio,expenses,cash,-100.0,-2846.17
buyer_4,Jorge,50,ES59209509865436075018,TRX_N-00104-68236036,2022-03-14T12:44:00,Galdakao,expenses,food,-84.36,-2930.53
buyer_4,Jorge,50,ES59209509865436075018,TRX_N-00105-73281670,2022-03-16T14:08:01,Galdakao,expenses,food,-86.18,-3016.71
buyer_4,Jorge,50,ES59209509865436075018,TRX_N-00106-57898190,2022-03-17T18:20:04,Galdakao,expenses,leisure,-48.04,-3064.75
buyer_4,Jorge,50,ES59209509865436075018,TRX_N-00107-73290679,2022-03-18T10:27:29,Galdakao,expenses,cash,-100.0,-3164.75
buyer_4,Jorge,50,ES59209509865436075018,TRX_N-00108-96225508,2022-03-19T17:02:14,Bilbao,expenses,transport,-86.53,-3251.28
buyer_4,Jorge,50,ES59209509865436075018,TRX_N-00109-83486330,2022-03-19T18:59:28,Galdakao,expenses,leisure,-66.7,-3317.98
buyer_4,Jorge,50,ES59209509865436075018,TRX_N-00110-21814563,2022-03-19T01:50:34,Galdakao,expenses,gifts,-840.31,-4158.29
buyer_4,Jorge,50,ES59209509865436075018,TRX_N-00111-27346798,2022-03-21T16:05:49,Galdakao,expenses,clothing,-105.44,-4263.73
buyer_4,Jorge,50,ES59209509865436075018,TRX_N-00112-96021487,2022-03-22T14:09:56,Galdakao,expenses,travel,-1057.37,-5321.1
buyer_4,Jorge,50,ES59209509865436075018,TRX_N-00113-82824921,2022-03-22T09:04:23,Galdakao,expenses,gifts,-184.77,-5505.87
buyer_4,Jorge,50,ES59209509865436075018,TRX_N-00114-49297400,2022-03-22T19:18:43,Galdakao,expenses,children,-226.18,-5732.05
buyer_4,Jorge,50,ES59209509865436075018,TRX_N-00115-65918080,2022-03-23T07:50:13,Galdakao,expenses,food,-112.1,-5844.15
buyer_4,Jorge,50,ES59209509865436075018,TRX_N-00116-36427497,2022-03-24T16:54:37,Barakaldo,expenses,cash,-100.0,-5944.15
buyer_4,Jorge,50,ES59209509865436075018,TRX_N-00117-22636300,2022-03-26T10:39:43,Galdakao,expenses,food,-65.3,-6009.45
buyer_4,Jorge,50,ES59209509865436075018,TRX_N-00118-34087716,2022-03-28T10:36:13,Galdakao,expenses,clothing,-100.14,-6109.59
buyer_4,Jorge,50,ES59209509865436075018,TRX_N-00119-08594574,2022-03-29T14:23:51,Galdakao,expenses,food,-119.18,-6228.77
buyer_4,Jorge,50,ES59209509865436075018,TRX_N-00120-76464949,2022-03-30T09:33:14,Galdakao,expenses,cash,-100.0,-6328.77
buyer_4,Jorge,50,ES59209509865436075018,TRX_N-00121-71632949,2022-03-31T10:05:56,Galdakao,expenses,leisure,-66.6,-6395.37
buyer_4,Jorge,50,ES59209509865436075018,TRX_N-00122-38244616,2022-03-31T11:01:19,Galdakao,expenses,clothing,-62.15,-6457.52
buyer_4,Jorge,50,ES59209509865436075018,TRX_N-00123-93046547,2022-04-01T16:59:08,Galdakao,incomes,salary,1407.46,-5050.06
buyer_4,Jorge,50,ES59209509865436075018,TRX_N-00124-24923714,2022-04-01T16:59:08,Galdakao,incomes,salary_partner,1330.17,-3719.89
buyer_4,Jorge,50,ES59209509865436075018,TRX_N-00125-22101951,2022-04-01T16:59:08,Galdakao,incomes,extra_income,189.14,-3530.75
buyer_4,Jorge,50,ES59209509865436075018,TRX_N-00126-24146352,2022-04-01T11:23:15,Galdakao,expenses,food,-76.73,-3607.48
buyer_4,Jorge,50,ES59209509865436075018,TRX_N-00127-95557107,2022-04-02T21:58:24,Arrasate,expenses,gifts,-804.06,-4411.54
buyer_4,Jorge,50,ES59209509865436075018,TRX_N-00128-78309937,2022-04-04T19:22:10,Galdakao,expenses,mortgage,-858.17,-5269.71
buyer_4,Jorge,50,ES59209509865436075018,TRX_N-00129-37746831,2022-04-04T15:42:36,Galdakao,expenses,transport,-81.24,-5350.95
buyer_4,Jorge,50,ES59209509865436075018,TRX_N-00130-83543298,2022-04-05T16:50:48,Galdakao,expenses,water,-33.24,-5384.19
buyer_4,Jorge,50,ES59209509865436075018,TRX_N-00131-11277143,2022-04-05T09:54:04,Galdakao,expenses,internet,-42.0,-5426.19
buyer_4,Jorge,50,ES59209509865436075018,TRX_N-00132-86596631,2022-04-05T17:48:17,Portugalete,expenses,cash,-100.0,-5526.19
buyer_4,Jorge,50,ES59209509865436075018,TRX_N-00133-54140027,2022-04-07T14:21:40,Galdakao,expenses,electricity,-31.97,-5558.16
buyer_4,Jorge,50,ES59209509865436075018,TRX_N-00134-91270651,2022-04-07T12:18:54,Amurrio,expenses,food,-80.18,-5638.34
buyer_4,Jorge,50,ES59209509865436075018,TRX_N-00135-58982415,2022-04-08T19:00:14,Galdakao,expenses,phone,-43.07,-5681.41
buyer_4,Jorge,50,ES59209509865436075018,TRX_N-00136-13869498,2022-04-08T20:10:10,Galdakao,expenses,gas,-63.66,-5745.07
buyer_4,Jorge,50,ES59209509865436075018,TRX_N-00137-73861539,2022-04-09T08:49:39,Arrasate,expenses,cash,-100.0,-5845.07
buyer_4,Jorge,50,ES59209509865436075018,TRX_N-00138-54216334,2022-04-10T11:39:34,Galdakao,expenses,children,-278.19,-6123.26
buyer_4,Jorge,50,ES59209509865436075018,TRX_N-00139-98527266,2022-04-11T16:36:56,Galdakao,expenses,education,-50.54,-6173.8
buyer_4,Jorge,50,ES59209509865436075018,TRX_N-00140-09230944,2022-04-12T15:09:16,Galdakao,expenses,children,-253.33,-6427.13
buyer_4,Jorge,50,ES59209509865436075018,TRX_N-00141-42545072,2022-04-13T17:44:56,Eibar,expenses,transport,-66.96,-6494.09
buyer_4,Jorge,50,ES59209509865436075018,TRX_N-00142-05418979,2022-04-13T19:34:28,Galdakao,expenses,leisure,-21.58,-6515.67
buyer_4,Jorge,50,ES59209509865436075018,TRX_N-00143-27120252,2022-04-14T08:23:25,Berango,expenses,food,-113.9,-6629.57
buyer_4,Jorge,50,ES59209509865436075018,TRX_N-00144-08210934,2022-04-14T10:46:46,Galdakao,expenses,cash,-100.0,-6729.57
buyer_4,Jorge,50,ES59209509865436075018,TRX_N-00145-29125926,2022-04-15T10:40:51,Pasaia,expenses,cash,-100.0,-6829.57
buyer_4,Jorge,50,ES59209509865436075018,TRX_N-00146-48352624,2022-04-16T15:51:06,Galdakao,expenses,transport,-40.81,-6870.38
buyer_4,Jorge,50,ES59209509865436075018,TRX_N-00147-91124829,2022-04-16T13:14:03,Galdakao,expenses,leisure,-70.46,-6940.84
buyer_4,Jorge,50,ES59209509865436075018,TRX_N-00148-23620089,2022-04-19T16:20:04,Galdakao,expenses,transport,-50.43,-6991.27
buyer_4,Jorge,50,ES59209509865436075018,TRX_N-00149-31157267,2022-04-23T15:32:03,Galdakao,expenses,transport,-51.77,-7043.04
buyer_4,Jorge,50,ES59209509865436075018,TRX_N-00150-45705184,2022-04-23T09:28:42,Galdakao,expenses,education,-47.99,-7091.03
buyer_4,Jorge,50,ES59209509865436075018,TRX_N-00151-91076914,2022-04-24T12:02:58,Galdakao,expenses,food,-111.66,-7202.69
buyer_4,Jorge,50,ES59209509865436075018,TRX_N-00152-77738492,2022-04-26T03:26:04,Galdakao,expenses,leisure,-56.38,-7259.07
buyer_4,Jorge,50,ES59209509865436075018,TRX_N-00153-57015056,2022-04-26T21:37:05,Galdakao,expenses,repairs,-275.26,-7534.33
buyer_4,Jorge,50,ES59209509865436075018,TRX_N-00154-63105542,2022-04-29T13:17:01,Barakaldo,expenses,leisure,-44.17,-7578.5
buyer_4,Jorge,50,ES59209509865436075018,TRX_N-00155-62190682,2022-04-29T08:31:21,Galdakao,expenses,cash,-100.0,-7678.5
buyer_4,Jorge,50,ES59209509865436075018,TRX_N-00156-68907501,2022-05-01T18:17:05,Galdakao,incomes,salary,1407.46,-6271.04
buyer_4,Jorge,50,ES59209509865436075018,TRX_N-00157-76609671,2022-05-01T18:17:05,Galdakao,incomes,salary_partner,1330.17,-4940.87
buyer_4,Jorge,50,ES59209509865436075018,TRX_N-00158-29023354,2022-05-01T18:30:22,Galdakao,expenses,food,-82.49,-5023.36
buyer_4,Jorge,50,ES59209509865436075018,TRX_N-00159-82255054,2022-05-02T00:55:45,Galdakao,expenses,cash,-100.0,-5123.36
buyer_4,Jorge,50,ES59209509865436075018,TRX_N-00160-12105643,2022-05-02T21:50:51,Galdakao,expenses,repairs,-125.98,-5249.34
buyer_4,Jorge,50,ES59209509865436075018,TRX_N-00161-24554031,2022-05-03T13:41:56,Galdakao,expenses,repairs,-240.73,-5490.07
buyer_4,Jorge,50,ES59209509865436075018,TRX_N-00162-93699568,2022-05-04T08:06:38,Galdakao,expenses,mortgage,-858.17,-6348.24
buyer_4,Jorge,50,ES59209509865436075018,TRX_N-00163-97649573,2022-05-05T02:10:47,Galdakao,expenses,phone,-41.9,-6390.14
buyer_4,Jorge,50,ES59209509865436075018,TRX_N-00164-54935380,2022-05-06T12:31:11,Galdakao,expenses,electricity,-68.15,-6458.29
buyer_4,Jorge,50,ES59209509865436075018,TRX_N-00165-84331740,2022-05-08T15:55:37,Galdakao,expenses,gas,-108.85,-6567.14
buyer_4,Jorge,50,ES59209509865436075018,TRX_N-00166-28878602,2022-05-08T16:38:37,Galdakao,expenses,internet,-42.0,-6609.14
buyer_4,Jorge,50,ES59209509865436075018,TRX_N-00167-51595511,2022-05-08T10:46:41,Galdakao,expenses,water,-24.22,-6633.36
buyer_4,Jorge,50,ES59209509865436075018,TRX_N-00168-11237939,2022-05-09T10:40:34,Galdakao,expenses,food,-84.06,-6717.42
buyer_4,Jorge,50,ES59209509865436075018,TRX_N-00169-60511116,2022-05-10T10:17:08,Galdakao,expenses,appliances,-399.75,-7117.17
buyer_4,Jorge,50,ES59209509865436075018,TRX_N-00170-53913552,2022-05-10T22:47:42,Mungia,expenses,repairs,-224.41,-7341.58
buyer_4,Jorge,50,ES59209509865436075018,TRX_N-00171-71796057,2022-05-11T22:57:23,Galdakao,expenses,healthcare,-61.15,-7402.73
buyer_4,Jorge,50,ES59209509865436075018,TRX_N-00172-96195493,2022-05-11T18:01:32,Galdakao,expenses,repairs,-69.03,-7471.76
buyer_4,Jorge,50,ES59209509865436075018,TRX_N-00173-70445488,2022-05-12T23:33:46,Galdakao,expenses,repairs,-78.28,-7550.04
buyer_4,Jorge,50,ES59209509865436075018,TRX_N-00174-00173109,2022-05-12T20:07:56,Galdakao,expenses,gifts,-769.05,-8319.09
buyer_4,Jorge,50,ES59209509865436075018,TRX_N-00175-18770527,2022-05-13T21:17:37,Galdakao,expenses,gifts,-782.22,-9101.31
buyer_4,Jorge,50,ES59209509865436075018,TRX_N-00176-73376497,2022-05-16T07:01:33,Galdakao,expenses,food,-64.7,-9166.01
buyer_4,Jorge,50,ES59209509865436075018,TRX_N-00177-79616100,2022-05-17T11:16:50,Galdakao,expenses,education,-58.13,-9224.14
buyer_4,Jorge,50,ES59209509865436075018,TRX_N-00178-24124055,2022-05-17T08:40:09,Galdakao,expenses,cash,-100.0,-9324.14
buyer_4,Jorge,50,ES59209509865436075018,TRX_N-00179-57993043,2022-05-20T09:00:31,Galdakao,expenses,cash,-100.0,-9424.14
buyer_4,Jorge,50,ES59209509865436075018,TRX_N-00180-56157265,2022-05-22T16:20:07,Barakaldo,expenses,food,-106.24,-9530.38
buyer_4,Jorge,50,ES59209509865436075018,TRX_N-00181-36849336,2022-05-23T16:59:40,Galdakao,expenses,transport,-58.1,-9588.48
buyer_4,Jorge,50,ES59209509865436075018,TRX_N-00182-95288720,2022-05-23T11:56:24,Galdakao,expenses,cash,-100.0,-9688.48
buyer_4,Jorge,50,ES59209509865436075018,TRX_N-00183-48330041,2022-05-24T04:25:19,Galdakao,expenses,food,-73.01,-9761.49
buyer_4,Jorge,50,ES59209509865436075018,TRX_N-00184-88243460,2022-05-24T12:10:25,Galdakao,expenses,leisure,-36.13,-9797.62
buyer_4,Jorge,50,ES59209509865436075018,TRX_N-00185-51313173,2022-05-24T19:30:07,Galdakao,expenses,cash,-100.0,-9897.62
buyer_4,Jorge,50,ES59209509865436075018,TRX_N-00186-96571475,2022-05-25T11:18:42,Iruña de Oca,expenses,food,-89.18,-9986.8
buyer_4,Jorge,50,ES59209509865436075018,TRX_N-00187-34086439,2022-05-27T13:27:58,Galdakao,expenses,cash,-100.0,-10086.8
buyer_4,Jorge,50,ES59209509865436075018,TRX_N-00188-58885410,2022-05-28T09:47:13,Galdakao,expenses,transport,-88.55,-10175.35
buyer_4,Jorge,50,ES59209509865436075018,TRX_N-00189-19669816,2022-05-29T17:25:25,Galdakao,expenses,education,-53.7,-10229.05
buyer_4,Jorge,50,ES59209509865436075018,TRX_N-00190-40721485,2022-05-29T12:58:19,Llodio,expenses,repairs,-264.84,-10493.89
buyer_4,Jorge,50,ES59209509865436075018,TRX_N-00191-76648138,2022-05-31T15:13:12,Galdakao,expenses,transport,-81.71,-10575.6
buyer_4,Jorge,50,ES59209509865436075018,TRX_N-00192-64820445,2022-05-31T19:43:28,Galdakao,expenses,gifts,-804.54,-11380.14
buyer_4,Jorge,50,ES59209509865436075018,TRX_N-00193-52491094,2022-06-01T18:57:41,Galdakao,incomes,salary,1407.46,-9972.68
buyer_4,Jorge,50,ES59209509865436075018,TRX_N-00194-19385702,2022-06-01T18:57:41,Galdakao,incomes,salary_partner,1330.17,-8642.51
buyer_4,Jorge,50,ES59209509865436075018,TRX_N-00195-10256097,2022-06-01T18:57:41,Galdakao,incomes,salary_bonus,1037.85,-7604.66
buyer_4,Jorge,50,ES59209509865436075018,TRX_N-00196-94902632,2022-06-01T18:57:41,Galdakao,incomes,salary_partner_bonus,957.47,-6647.19
buyer_4,Jorge,50,ES59209509865436075018,TRX_N-00197-72910500,2022-06-02T18:10:33,Galdakao,expenses,leisure,-60.57,-6707.76
buyer_4,Jorge,50,ES59209509865436075018,TRX_N-00198-68256023,2022-06-03T17:40:08,Galdakao,expenses,transport,-61.26,-6769.02
buyer_4,Jorge,50,ES59209509865436075018,TRX_N-00199-69830581,2022-06-04T08:28:47,Galdakao,expenses,mortgage,-858.17,-7627.19
buyer_4,Jorge,50,ES59209509865436075018,TRX_N-00200-67917627,2022-06-05T11:54:45,Galdakao,expenses,water,-32.77,-7659.96
buyer_4,Jorge,50,ES59209509865436075018,TRX_N-00201-89786160,2022-06-05T09:19:41,Galdakao,expenses,electricity,-23.09,-7683.05
buyer_4,Jorge,50,ES59209509865436075018,TRX_N-00202-87568299,2022-06-07T20:37:09,Galdakao,expenses,leisure,-75.49,-7758.54
buyer_4,Jorge,50,ES59209509865436075018,TRX_N-00203-35170265,2022-06-07T15:45:20,Galdakao,expenses,clothing,-54.59,-7813.13
buyer_4,Jorge,50,ES59209509865436075018,TRX_N-00204-85484090,2022-06-08T08:15:21,Galdakao,expenses,internet,-42.0,-7855.13
buyer_4,Jorge,50,ES59209509865436075018,TRX_N-00205-83571818,2022-06-08T16:11:00,Galdakao,expenses,gas,-104.09,-7959.22
buyer_4,Jorge,50,ES59209509865436075018,TRX_N-00206-45909605,2022-06-08T14:38:11,Galdakao,expenses,phone,-36.63,-7995.85
buyer_4,Jorge,50,ES59209509865436075018,TRX_N-00207-82416978,2022-06-08T18:58:30,Barakaldo,expenses,appliances,-370.15,-8366.0
buyer_4,Jorge,50,ES59209509865436075018,TRX_N-00208-97570230,2022-06-09T23:22:36,Santurtzi,expenses,food,-66.25,-8432.25
buyer_4,Jorge,50,ES59209509865436075018,TRX_N-00209-91020359,2022-06-10T11:36:37,Galdakao,expenses,cash,-100.0,-8532.25
buyer_4,Jorge,50,ES59209509865436075018,TRX_N-00210-91918219,2022-06-10T14:33:35,Alegría-Dulantzi,expenses,repairs,-142.37,-8674.62
buyer_4,Jorge,50,ES59209509865436075018,TRX_N-00211-91375805,2022-06-11T10:10:09,Galdakao,expenses,leisure,-58.91,-8733.53
buyer_4,Jorge,50,ES59209509865436075018,TRX_N-00212-81589327,2022-06-14T15:05:53,Galdakao,expenses,repairs,-177.13,-8910.66
buyer_4,Jorge,50,ES59209509865436075018,TRX_N-00213-79322861,2022-06-16T23:35:53,Galdakao,expenses,transport,-57.27,-8967.93
buyer_4,Jorge,50,ES59209509865436075018,TRX_N-00214-14576704,2022-06-18T17:24:32,Galdakao,expenses,food,-108.79,-9076.72
buyer_4,Jorge,50,ES59209509865436075018,TRX_N-00215-70163717,2022-06-20T20:49:07,Galdakao,expenses,transport,-61.19,-9137.91
buyer_4,Jorge,50,ES59209509865436075018,TRX_N-00216-30335922,2022-06-21T17:11:43,Galdakao,expenses,leisure,-82.71,-9220.62
buyer_4,Jorge,50,ES59209509865436075018,TRX_N-00217-08246602,2022-06-21T11:55:40,Galdakao,expenses,travel,-939.11,-10159.73
buyer_4,Jorge,50,ES59209509865436075018,TRX_N-00218-99513841,2022-06-22T11:05:59,Galdakao,expenses,repairs,-254.22,-10413.95
buyer_4,Jorge,50,ES59209509865436075018,TRX_N-00219-96348972,2022-06-23T23:34:02,Galdakao,expenses,leisure,-42.48,-10456.43
buyer_4,Jorge,50,ES59209509865436075018,TRX_N-00220-00999829,2022-06-23T15:33:50,Galdakao,expenses,cash,-100.0,-10556.43
buyer_4,Jorge,50,ES59209509865436075018,TRX_N-00221-26357195,2022-06-23T13:17:18,Galdakao,expenses,repairs,-308.4,-10864.83
buyer_4,Jorge,50,ES59209509865436075018,TRX_N-00222-87924824,2022-06-24T16:37:07,Vitoria-Gasteiz,expenses,leisure,-42.34,-10907.17
buyer_4,Jorge,50,ES59209509865436075018,TRX_N-00223-47020956,2022-06-28T19:22:41,Galdakao,expenses,food,-89.42,-10996.59
buyer_4,Jorge,50,ES59209509865436075018,TRX_N-00224-69619923,2022-06-29T08:07:19,Galdakao,expenses,food,-63.96,-11060.55
buyer_4,Jorge,50,ES59209509865436075018,TRX_N-00225-26630179,2022-06-29T08:26:09,Galdakao,expenses,transport,-77.04,-11137.59
buyer_4,Jorge,50,ES59209509865436075018,TRX_N-00226-82445596,2022-06-30T08:26:02,Galdakao,expenses,transport,-87.01,-11224.6
buyer_4,Jorge,50,ES59209509865436075018,TRX_N-00227-01625436,2022-07-01T11:05:42,Galdakao,incomes,salary,1407.46,-9817.14
buyer_4,Jorge,50,ES59209509865436075018,TRX_N-00228-40375377,2022-07-01T11:05:42,Galdakao,incomes,salary_partner,1330.17,-8486.97
buyer_4,Jorge,50,ES59209509865436075018,TRX_N-00229-97831425,2022-07-01T11:05:42,Galdakao,incomes,extra_income,189.14,-8297.83
buyer_4,Jorge,50,ES59209509865436075018,TRX_N-00230-05280429,2022-07-02T08:46:37,Galdakao,expenses,food,-62.13,-8359.96
buyer_4,Jorge,50,ES59209509865436075018,TRX_N-00231-66849662,2022-07-02T15:07:55,Galdakao,expenses,transport,-80.42,-8440.38
buyer_4,Jorge,50,ES59209509865436075018,TRX_N-00232-58653469,2022-07-03T18:02:09,Galdakao,expenses,cash,-100.0,-8540.38
buyer_4,Jorge,50,ES59209509865436075018,TRX_N-00233-84954830,2022-07-04T16:43:09,Galdakao,expenses,mortgage,-858.17,-9398.55
buyer_4,Jorge,50,ES59209509865436075018,TRX_N-00234-38135322,2022-07-04T13:33:09,Galdakao,expenses,transport,-45.03,-9443.58
buyer_4,Jorge,50,ES59209509865436075018,TRX_N-00235-10104424,2022-07-05T13:25:09,Galdakao,expenses,water,-38.24,-9481.82
buyer_4,Jorge,50,ES59209509865436075018,TRX_N-00236-28237957,2022-07-05T06:54:16,Galdakao,expenses,electricity,-88.0,-9569.82
buyer_4,Jorge,50,ES59209509865436075018,TRX_N-00237-14141067,2022-07-05T11:52:08,Galdakao,expenses,gas,-94.26,-9664.08
buyer_4,Jorge,50,ES59209509865436075018,TRX_N-00238-86049037,2022-07-06T17:35:44,Galdakao,expenses,phone,-39.22,-9703.3
buyer_4,Jorge,50,ES59209509865436075018,TRX_N-00239-74486396,2022-07-06T22:11:55,Galdakao,expenses,cash,-100.0,-9803.3
buyer_4,Jorge,50,ES59209509865436075018,TRX_N-00240-25902170,2022-07-07T16:37:15,Elciego,expenses,transport,-49.44,-9852.74
buyer_4,Jorge,50,ES59209509865436075018,TRX_N-00241-14102636,2022-07-08T09:12:35,Galdakao,expenses,internet,-42.0,-9894.74
buyer_4,Jorge,50,ES59209509865436075018,TRX_N-00242-07509084,2022-07-08T14:07:57,Galdakao,expenses,cash,-100.0,-9994.74
buyer_4,Jorge,50,ES59209509865436075018,TRX_N-00243-96378693,2022-07-09T20:17:17,Galdakao,expenses,cash,-100.0,-10094.74
buyer_4,Jorge,50,ES59209509865436075018,TRX_N-00244-93327724,2022-07-10T08:29:19,Galdakao,expenses,leisure,-38.22,-10132.96
buyer_4,Jorge,50,ES59209509865436075018,TRX_N-00245-43109799,2022-07-11T12:37:05,Galdakao,expenses,leisure,-36.52,-10169.48
buyer_4,Jorge,50,ES59209509865436075018,TRX_N-00246-20309343,2022-07-11T08:38:08,Galdakao,expenses,cash,-100.0,-10269.48
buyer_4,Jorge,50,ES59209509865436075018,TRX_N-00247-80255572,2022-07-13T09:43:52,Galdakao,expenses,transport,-59.92,-10329.4
buyer_4,Jorge,50,ES59209509865436075018,TRX_N-00248-22370407,2022-07-14T09:29:53,Galdakao,expenses,repairs,-316.33,-10645.73
buyer_4,Jorge,50,ES59209509865436075018,TRX_N-00249-81375693,2022-07-14T12:01:17,Galdakao,expenses,children,-273.6,-10919.33
buyer_4,Jorge,50,ES59209509865436075018,TRX_N-00250-85919105,2022-07-15T12:01:00,Galdakao,expenses,food,-86.49,-11005.82
buyer_4,Jorge,50,ES59209509865436075018,TRX_N-00251-05887866,2022-07-15T19:57:19,Galdakao,expenses,cash,-100.0,-11105.82
buyer_4,Jorge,50,ES59209509865436075018,TRX_N-00252-45255704,2022-07-16T19:40:40,Galdakao,expenses,cash,-100.0,-11205.82
buyer_4,Jorge,50,ES59209509865436075018,TRX_N-00253-97265027,2022-07-18T19:38:26,Berango,expenses,food,-66.39,-11272.21
buyer_4,Jorge,50,ES59209509865436075018,TRX_N-00254-23887401,2022-07-18T15:10:13,Galdakao,expenses,gifts,-294.31,-11566.52
buyer_4,Jorge,50,ES59209509865436075018,TRX_N-00255-06886120,2022-07-20T18:14:19,Galdakao,expenses,education,-65.98,-11632.5
buyer_4,Jorge,50,ES59209509865436075018,TRX_N-00256-00982847,2022-07-24T15:13:30,Galdakao,expenses,education,-69.82,-11702.32
buyer_4,Jorge,50,ES59209509865436075018,TRX_N-00257-91500520,2022-07-25T13:59:42,Galdakao,expenses,food,-74.37,-11776.69
buyer_4,Jorge,50,ES59209509865436075018,TRX_N-00258-89549392,2022-07-27T20:28:44,Galdakao,expenses,food,-66.35,-11843.04
buyer_4,Jorge,50,ES59209509865436075018,TRX_N-00259-60187033,2022-07-27T08:56:11,Galdakao,expenses,leisure,-34.9,-11877.94
buyer_4,Jorge,50,ES59209509865436075018,TRX_N-00260-70383950,2022-07-27T19:57:12,Galdakao,expenses,cash,-100.0,-11977.94
buyer_4,Jorge,50,ES59209509865436075018,TRX_N-00261-18086419,2022-07-29T20:25:01,Galdakao,expenses,travel,-1713.89,-13691.83
buyer_4,Jorge,50,ES59209509865436075018,TRX_N-00262-00743005,2022-07-31T09:34:07,Galdakao,expenses,repairs,-125.6,-13817.43
buyer_4,Jorge,50,ES59209509865436075018,TRX_N-00263-23689471,2022-08-01T19:06:19,Galdakao,incomes,salary,1407.46,-12409.97
buyer_4,Jorge,50,ES59209509865436075018,TRX_N-00264-79863317,2022-08-01T19:06:19,Galdakao,incomes,salary_partner,1330.17,-11079.8
buyer_4,Jorge,50,ES59209509865436075018,TRX_N-00265-82902715,2022-08-01T11:13:32,Galdakao,expenses,education,-64.6,-11144.4
buyer_4,Jorge,50,ES59209509865436075018,TRX_N-00266-37335914,2022-08-02T18:52:29,Galdakao,expenses,food,-72.79,-11217.19
buyer_4,Jorge,50,ES59209509865436075018,TRX_N-00267-40217582,2022-08-04T14:19:14,Galdakao,expenses,mortgage,-858.17,-12075.36
buyer_4,Jorge,50,ES59209509865436075018,TRX_N-00268-57513583,2022-08-04T13:44:35,Galdakao,expenses,transport,-75.85,-12151.21
buyer_4,Jorge,50,ES59209509865436075018,TRX_N-00269-77587922,2022-08-05T03:48:09,Galdakao,expenses,water,-43.57,-12194.78
buyer_4,Jorge,50,ES59209509865436075018,TRX_N-00270-53551645,2022-08-05T20:15:18,Galdakao,expenses,internet,-42.0,-12236.78
buyer_4,Jorge,50,ES59209509865436075018,TRX_N-00271-77838240,2022-08-07T10:17:47,Donostia,expenses,food,-79.63,-12316.41
buyer_4,Jorge,50,ES59209509865436075018,TRX_N-00272-58545405,2022-08-07T20:07:46,Galdakao,expenses,cash,-100.0,-12416.41
buyer_4,Jorge,50,ES59209509865436075018,TRX_N-00273-02675000,2022-08-08T15:58:40,Galdakao,expenses,electricity,-59.98,-12476.39
buyer_4,Jorge,50,ES59209509865436075018,TRX_N-00274-86318843,2022-08-08T16:55:16,Galdakao,expenses,gas,-108.93,-12585.32
buyer_4,Jorge,50,ES59209509865436075018,TRX_N-00275-26312714,2022-08-08T15:09:11,Galdakao,expenses,phone,-37.54,-12622.86
buyer_4,Jorge,50,ES59209509865436075018,TRX_N-00276-33754180,2022-08-09T14:36:15,Sopela,expenses,food,-72.19,-12695.05
buyer_4,Jorge,50,ES59209509865436075018,TRX_N-00277-87180815,2022-08-12T15:11:14,Galdakao,expenses,food,-70.4,-12765.45
buyer_4,Jorge,50,ES59209509865436075018,TRX_N-00278-93947110,2022-08-15T08:39:49,Galdakao,expenses,appliances,-138.77,-12904.22
buyer_4,Jorge,50,ES59209509865436075018,TRX_N-00279-89424385,2022-08-16T14:15:22,Galdakao,expenses,healthcare,-46.5,-12950.72
buyer_4,Jorge,50,ES59209509865436075018,TRX_N-00280-10979115,2022-08-16T17:48:27,Hondarribia,expenses,cash,-100.0,-13050.72
buyer_4,Jorge,50,ES59209509865436075018,TRX_N-00281-49190394,2022-08-18T12:38:20,Galdakao,expenses,appliances,-195.49,-13246.21
buyer_4,Jorge,50,ES59209509865436075018,TRX_N-00282-60364457,2022-08-18T18:14:31,Zarautz,expenses,repairs,-167.22,-13413.43
buyer_4,Jorge,50,ES59209509865436075018,TRX_N-00283-33319824,2022-08-19T23:50:40,Galdakao,expenses,transport,-84.1,-13497.53
buyer_4,Jorge,50,ES59209509865436075018,TRX_N-00284-20370857,2022-08-19T04:08:55,Galdakao,expenses,cash,-100.0,-13597.53
buyer_4,Jorge,50,ES59209509865436075018,TRX_N-00285-10351313,2022-08-24T18:17:21,Galdakao,expenses,cash,-100.0,-13697.53
buyer_4,Jorge,50,ES59209509865436075018,TRX_N-00286-58023062,2022-08-25T10:20:33,Galdakao,expenses,transport,-62.92,-13760.45
buyer_4,Jorge,50,ES59209509865436075018,TRX_N-00287-61244188,2022-08-25T20:29:51,Pasaia,expenses,gifts,-357.18,-14117.63
buyer_4,Jorge,50,ES59209509865436075018,TRX_N-00288-99401739,2022-08-26T19:45:36,Galdakao,expenses,transport,-46.06,-14163.69
buyer_4,Jorge,50,ES59209509865436075018,TRX_N-00289-59695262,2022-08-27T08:23:21,Galdakao,expenses,gifts,-128.37,-14292.06
buyer_4,Jorge,50,ES59209509865436075018,TRX_N-00290-75819871,2022-08-28T17:42:34,Galdakao,expenses,food,-96.86,-14388.92
buyer_4,Jorge,50,ES59209509865436075018,TRX_N-00291-88818921,2022-08-31T09:36:16,Galdakao,expenses,cash,-100.0,-14488.92
buyer_4,Jorge,50,ES59209509865436075018,TRX_N-00292-06398982,2022-09-01T23:36:28,Galdakao,incomes,salary,1407.46,-13081.46
buyer_4,Jorge,50,ES59209509865436075018,TRX_N-00293-54339914,2022-09-01T23:36:28,Galdakao,incomes,salary_partner,1330.17,-11751.29
buyer_4,Jorge,50,ES59209509865436075018,TRX_N-00294-85489334,2022-09-02T18:28:57,Galdakao,expenses,cash,-100.0,-11851.29
buyer_4,Jorge,50,ES59209509865436075018,TRX_N-00295-15023394,2022-09-03T12:58:44,Galdakao,expenses,healthcare,-149.9,-12001.19
buyer_4,Jorge,50,ES59209509865436075018,TRX_N-00296-28271032,2022-09-04T20:11:27,Galdakao,expenses,mortgage,-858.17,-12859.36
buyer_4,Jorge,50,ES59209509865436075018,TRX_N-00297-45992587,2022-09-04T17:19:37,Galdakao,expenses,leisure,-73.21,-12932.57
buyer_4,Jorge,50,ES59209509865436075018,TRX_N-00298-85789868,2022-09-05T10:02:13,Galdakao,expenses,electricity,-37.97,-12970.54
buyer_4,Jorge,50,ES59209509865436075018,TRX_N-00299-60240569,2022-09-05T18:45:39,Galdakao,expenses,phone,-35.8,-13006.34
buyer_4,Jorge,50,ES59209509865436075018,TRX_N-00300-62343820,2022-09-05T10:49:00,Galdakao,expenses,appliances,-186.03,-13192.37
buyer_4,Jorge,50,ES59209509865436075018,TRX_N-00301-53908488,2022-09-06T15:19:56,Galdakao,expenses,gas,-90.38,-13282.75
buyer_4,Jorge,50,ES59209509865436075018,TRX_N-00302-74483977,2022-09-06T17:39:26,Berango,expenses,transport,-81.95,-13364.7
buyer_4,Jorge,50,ES59209509865436075018,TRX_N-00303-86912763,2022-09-07T20:04:11,Galdakao,expenses,water,-33.32,-13398.02
buyer_4,Jorge,50,ES59209509865436075018,TRX_N-00304-11077280,2022-09-07T19:05:05,Galdakao,expenses,food,-107.53,-13505.55
buyer_4,Jorge,50,ES59209509865436075018,TRX_N-00305-94960362,2022-09-07T12:10:17,Bilbao,expenses,leisure,-78.07,-13583.62
buyer_4,Jorge,50,ES59209509865436075018,TRX_N-00306-27049943,2022-09-08T12:14:11,Galdakao,expenses,internet,-42.0,-13625.62
buyer_4,Jorge,50,ES59209509865436075018,TRX_N-00307-80898434,2022-09-08T14:58:18,Galdakao,expenses,food,-97.22,-13722.84
buyer_4,Jorge,50,ES59209509865436075018,TRX_N-00308-01401336,2022-09-12T17:03:31,Galdakao,expenses,repairs,-133.69,-13856.53
buyer_4,Jorge,50,ES59209509865436075018,TRX_N-00309-85791175,2022-09-13T08:31:28,Galdakao,expenses,appliances,-160.09,-14016.62
buyer_4,Jorge,50,ES59209509865436075018,TRX_N-00310-44239981,2022-09-15T15:14:53,Galdakao,expenses,transport,-41.98,-14058.6
buyer_4,Jorge,50,ES59209509865436075018,TRX_N-00311-80960126,2022-09-15T09:11:10,Galdakao,expenses,gifts,-721.75,-14780.35
buyer_4,Jorge,50,ES59209509865436075018,TRX_N-00312-87798788,2022-09-17T08:22:46,Galdakao,expenses,cash,-100.0,-14880.35
buyer_4,Jorge,50,ES59209509865436075018,TRX_N-00313-96647244,2022-09-18T03:44:26,Galdakao,expenses,transport,-85.47,-14965.82
buyer_4,Jorge,50,ES59209509865436075018,TRX_N-00314-13295894,2022-09-18T13:07:44,Portugalete,expenses,leisure,-61.92,-15027.74
buyer_4,Jorge,50,ES59209509865436075018,TRX_N-00315-93890060,2022-09-18T15:26:18,Galdakao,expenses,gifts,-305.31,-15333.05
buyer_4,Jorge,50,ES59209509865436075018,TRX_N-00316-89533073,2022-09-19T01:23:27,Galdakao,expenses,repairs,-63.59,-15396.64
buyer_4,Jorge,50,ES59209509865436075018,TRX_N-00317-83034825,2022-09-20T11:55:26,Galdakao,expenses,food,-124.66,-15521.3
buyer_4,Jorge,50,ES59209509865436075018,TRX_N-00318-39710893,2022-09-21T11:47:04,Galdakao,expenses,appliances,-178.46,-15699.76
buyer_4,Jorge,50,ES59209509865436075018,TRX_N-00319-83227465,2022-09-21T09:36:41,Galdakao,expenses,children,-152.76,-15852.52
buyer_4,Jorge,50,ES59209509865436075018,TRX_N-00320-69852804,2022-09-22T13:55:39,Galdakao,expenses,leisure,-55.68,-15908.2
buyer_4,Jorge,50,ES59209509865436075018,TRX_N-00321-38304663,2022-09-22T18:38:29,Galdakao,expenses,gifts,-337.53,-16245.73
buyer_4,Jorge,50,ES59209509865436075018,TRX_N-00322-33520244,2022-09-24T14:51:04,Elciego,expenses,transport,-52.31,-16298.04
buyer_4,Jorge,50,ES59209509865436075018,TRX_N-00323-78420830,2022-09-26T14:10:35,Galdakao,expenses,repairs,-66.97,-16365.01
buyer_4,Jorge,50,ES59209509865436075018,TRX_N-00324-31384868,2022-09-27T13:29:38,Galdakao,expenses,transport,-61.94,-16426.95
buyer_4,Jorge,50,ES59209509865436075018,TRX_N-00325-57719716,2022-09-28T15:02:50,Galdakao,expenses,healthcare,-62.87,-16489.82
buyer_4,Jorge,50,ES59209509865436075018,TRX_N-00326-43047677,2022-09-29T14:30:19,Galdakao,expenses,cash,-100.0,-16589.82
buyer_4,Jorge,50,ES59209509865436075018,TRX_N-00327-95995011,2022-09-30T13:44:03,Donostia,expenses,clothing,-131.71,-16721.53
buyer_4,Jorge,50,ES59209509865436075018,TRX_N-00328-71112866,2022-10-01T18:04:20,Galdakao,incomes,salary,1407.46,-15314.07
buyer_4,Jorge,50,ES59209509865436075018,TRX_N-00329-56019582,2022-10-01T18:04:20,Galdakao,incomes,salary_partner,1330.17,-13983.9
buyer_4,Jorge,50,ES59209509865436075018,TRX_N-00330-90380307,2022-10-01T20:50:25,Sestao,expenses,transport,-80.91,-14064.81
buyer_4,Jorge,50,ES59209509865436075018,TRX_N-00331-95052634,2022-10-01T09:29:28,Durango,expenses,cash,-100.0,-14164.81
buyer_4,Jorge,50,ES59209509865436075018,TRX_N-00332-86104441,2022-10-02T11:39:53,Galdakao,expenses,cash,-100.0,-14264.81
buyer_4,Jorge,50,ES59209509865436075018,TRX_N-00333-48514623,2022-10-03T12:35:15,Galdakao,expenses,transport,-81.34,-14346.15
buyer_4,Jorge,50,ES59209509865436075018,TRX_N-00334-43007331,2022-10-04T20:07:19,Galdakao,expenses,mortgage,-858.17,-15204.32
buyer_4,Jorge,50,ES59209509865436075018,TRX_N-00335-30377086,2022-10-05T13:50:40,Galdakao,expenses,phone,-36.96,-15241.28
buyer_4,Jorge,50,ES59209509865436075018,TRX_N-00336-42451830,2022-10-05T11:38:13,Galdakao,expenses,leisure,-41.86,-15283.14
buyer_4,Jorge,50,ES59209509865436075018,TRX_N-00337-95124754,2022-10-06T09:11:44,Galdakao,expenses,electricity,-26.22,-15309.36
buyer_4,Jorge,50,ES59209509865436075018,TRX_N-00338-90793879,2022-10-06T11:18:28,Galdakao,expenses,transport,-55.06,-15364.42
buyer_4,Jorge,50,ES59209509865436075018,TRX_N-00339-02787285,2022-10-06T16:01:32,Galdakao,expenses,clothing,-48.13,-15412.55
buyer_4,Jorge,50,ES59209509865436075018,TRX_N-00340-46410334,2022-10-07T14:23:28,Sopela,expenses,food,-79.28,-15491.83
buyer_4,Jorge,50,ES59209509865436075018,TRX_N-00341-45202586,2022-10-07T16:02:15,Galdakao,expenses,appliances,-325.84,-15817.67
buyer_4,Jorge,50,ES59209509865436075018,TRX_N-00342-61970405,2022-10-08T18:52:10,Galdakao,expenses,water,-27.83,-15845.5
buyer_4,Jorge,50,ES59209509865436075018,TRX_N-00343-84491258,2022-10-08T19:47:29,Galdakao,expenses,gas,-31.55,-15877.05
buyer_4,Jorge,50,ES59209509865436075018,TRX_N-00344-39570149,2022-10-08T06:21:09,Galdakao,expenses,internet,-42.0,-15919.05
buyer_4,Jorge,50,ES59209509865436075018,TRX_N-00345-62024195,2022-10-08T07:00:04,Galdakao,expenses,food,-110.7,-16029.75
buyer_4,Jorge,50,ES59209509865436075018,TRX_N-00346-87229986,2022-10-08T17:24:06,Galdakao,expenses,cash,-100.0,-16129.75
buyer_4,Jorge,50,ES59209509865436075018,TRX_N-00347-39930219,2022-10-09T21:25:15,Galdakao,expenses,clothing,-139.34,-16269.09
buyer_4,Jorge,50,ES59209509865436075018,TRX_N-00348-44849757,2022-10-10T14:45:37,Mungia,expenses,food,-73.56,-16342.65
buyer_4,Jorge,50,ES59209509865436075018,TRX_N-00349-70724158,2022-10-11T22:46:59,Galdakao,expenses,food,-64.94,-16407.59
buyer_4,Jorge,50,ES59209509865436075018,TRX_N-00350-99588258,2022-10-11T15:39:58,Galdakao,expenses,education,-70.4,-16477.99
buyer_4,Jorge,50,ES59209509865436075018,TRX_N-00351-03232072,2022-10-13T16:13:09,Galdakao,expenses,food,-69.12,-16547.11
buyer_4,Jorge,50,ES59209509865436075018,TRX_N-00352-05599669,2022-10-14T19:36:01,Galdakao,expenses,cash,-100.0,-16647.11
buyer_4,Jorge,50,ES59209509865436075018,TRX_N-00353-26817256,2022-10-15T14:48:13,Barakaldo,expenses,transport,-82.83,-16729.94
buyer_4,Jorge,50,ES59209509865436075018,TRX_N-00354-43376077,2022-10-15T08:18:07,Galdakao,expenses,appliances,-89.9,-16819.84
buyer_4,Jorge,50,ES59209509865436075018,TRX_N-00355-31262202,2022-10-16T08:34:51,Andoain,expenses,transport,-45.41,-16865.25
buyer_4,Jorge,50,ES59209509865436075018,TRX_N-00356-05073770,2022-10-16T04:13:44,Irun,expenses,cash,-100.0,-16965.25
buyer_4,Jorge,50,ES59209509865436075018,TRX_N-00357-73276084,2022-10-18T04:40:10,Galdakao,expenses,cash,-100.0,-17065.25
buyer_4,Jorge,50,ES59209509865436075018,TRX_N-00358-73913912,2022-10-19T16:09:38,Galdakao,expenses,leisure,-38.62,-17103.87
buyer_4,Jorge,50,ES59209509865436075018,TRX_N-00359-65125589,2022-10-20T10:46:31,Galdakao,expenses,cash,-100.0,-17203.87
buyer_4,Jorge,50,ES59209509865436075018,TRX_N-00360-23299963,2022-10-20T20:33:55,Galdakao,expenses,gifts,-629.6,-17833.47
buyer_4,Jorge,50,ES59209509865436075018,TRX_N-00361-54180477,2022-10-21T09:16:48,Galdakao,expenses,repairs,-63.65,-17897.12
buyer_4,Jorge,50,ES59209509865436075018,TRX_N-00362-09214480,2022-10-23T17:13:20,Galdakao,expenses,gifts,-351.13,-18248.25
buyer_4,Jorge,50,ES59209509865436075018,TRX_N-00363-31370615,2022-10-24T15:22:09,Galdakao,expenses,cash,-100.0,-18348.25
buyer_4,Jorge,50,ES59209509865436075018,TRX_N-00364-05900693,2022-10-27T18:29:49,Galdakao,expenses,clothing,-152.36,-18500.61
buyer_4,Jorge,50,ES59209509865436075018,TRX_N-00365-91728621,2022-10-29T01:31:22,Galdakao,expenses,clothing,-67.6,-18568.21
buyer_4,Jorge,50,ES59209509865436075018,TRX_N-00366-42333412,2022-10-29T17:49:18,Galdakao,expenses,appliances,-152.67,-18720.88
buyer_4,Jorge,50,ES59209509865436075018,TRX_N-00367-10251404,2022-11-01T15:32:08,Galdakao,incomes,salary,1407.46,-17313.42
buyer_4,Jorge,50,ES59209509865436075018,TRX_N-00368-09543764,2022-11-01T15:32:08,Galdakao,incomes,salary_partner,1330.17,-15983.25
buyer_4,Jorge,50,ES59209509865436075018,TRX_N-00369-74795811,2022-11-01T15:32:08,Galdakao,incomes,extra_income,189.14,-15794.11
buyer_4,Jorge,50,ES59209509865436075018,TRX_N-00370-68533718,2022-11-02T08:13:20,Galdakao,expenses,cash,-100.0,-15894.11
buyer_4,Jorge,50,ES59209509865436075018,TRX_N-00371-96153492,2022-11-03T10:47:50,Galdakao,expenses,cash,-100.0,-15994.11
buyer_4,Jorge,50,ES59209509865436075018,TRX_N-00372-10401465,2022-11-04T22:35:50,Galdakao,expenses,mortgage,-858.17,-16852.28
buyer_4,Jorge,50,ES59209509865436075018,TRX_N-00373-23336520,2022-11-05T09:02:42,Galdakao,expenses,gas,-96.42,-16948.7
buyer_4,Jorge,50,ES59209509865436075018,TRX_N-00374-77405447,2022-11-05T22:13:34,Galdakao,expenses,internet,-42.0,-16990.7
buyer_4,Jorge,50,ES59209509865436075018,TRX_N-00375-48059654,2022-11-05T03:34:01,Galdakao,expenses,phone,-39.33,-17030.03
buyer_4,Jorge,50,ES59209509865436075018,TRX_N-00376-02739537,2022-11-06T15:33:34,Galdakao,expenses,electricity,-58.23,-17088.26
buyer_4,Jorge,50,ES59209509865436075018,TRX_N-00377-30237029,2022-11-06T17:07:15,Elciego,expenses,food,-70.59,-17158.85
buyer_4,Jorge,50,ES59209509865436075018,TRX_N-00378-37166251,2022-11-08T09:22:31,Galdakao,expenses,water,-42.44,-17201.29
buyer_4,Jorge,50,ES59209509865436075018,TRX_N-00379-56975810,2022-11-09T19:55:18,Galdakao,expenses,transport,-70.8,-17272.09
buyer_4,Jorge,50,ES59209509865436075018,TRX_N-00380-32961819,2022-11-12T10:44:51,Galdakao,expenses,leisure,-57.85,-17329.94
buyer_4,Jorge,50,ES59209509865436075018,TRX_N-00381-92784811,2022-11-15T01:29:34,Galdakao,expenses,cash,-100.0,-17429.94
buyer_4,Jorge,50,ES59209509865436075018,TRX_N-00382-41106953,2022-11-15T13:41:04,Elciego,expenses,repairs,-259.61,-17689.55
buyer_4,Jorge,50,ES59209509865436075018,TRX_N-00383-20230832,2022-11-16T10:29:48,Galdakao,expenses,cash,-100.0,-17789.55
buyer_4,Jorge,50,ES59209509865436075018,TRX_N-00384-45214867,2022-11-17T19:18:37,Galdakao,expenses,gifts,-48.46,-17838.01
buyer_4,Jorge,50,ES59209509865436075018,TRX_N-00385-02332505,2022-11-18T09:09:18,Galdakao,expenses,children,-228.93,-18066.94
buyer_4,Jorge,50,ES59209509865436075018,TRX_N-00386-07329669,2022-11-19T20:23:28,Galdakao,expenses,education,-77.23,-18144.17
buyer_4,Jorge,50,ES59209509865436075018,TRX_N-00387-26437704,2022-11-19T13:18:15,Oyón-Oion,expenses,cash,-100.0,-18244.17
buyer_4,Jorge,50,ES59209509865436075018,TRX_N-00388-70651718,2022-11-20T15:01:35,Arrasate,expenses,gifts,-606.22,-18850.39
buyer_4,Jorge,50,ES59209509865436075018,TRX_N-00389-31446496,2022-11-21T12:04:24,Portugalete,expenses,cash,-100.0,-18950.39
buyer_4,Jorge,50,ES59209509865436075018,TRX_N-00390-24704699,2022-11-22T14:24:01,Galdakao,expenses,cash,-100.0,-19050.39
buyer_4,Jorge,50,ES59209509865436075018,TRX_N-00391-06749486,2022-11-23T15:02:15,Galdakao,expenses,transport,-85.44,-19135.83
buyer_4,Jorge,50,ES59209509865436075018,TRX_N-00392-54211673,2022-11-23T08:46:03,Galdakao,expenses,gifts,-796.6,-19932.43
buyer_4,Jorge,50,ES59209509865436075018,TRX_N-00393-59724230,2022-11-26T15:12:51,Galdakao,expenses,food,-106.95,-20039.38
buyer_4,Jorge,50,ES59209509865436075018,TRX_N-00394-53411853,2022-11-27T23:13:17,Galdakao,expenses,repairs,-100.92,-20140.3
buyer_4,Jorge,50,ES59209509865436075018,TRX_N-00395-13124111,2022-11-28T08:32:03,Galdakao,expenses,food,-65.01,-20205.31
buyer_4,Jorge,50,ES59209509865436075018,TRX_N-00396-21952649,2022-12-01T11:11:35,Galdakao,incomes,salary,1407.46,-18797.85
buyer_4,Jorge,50,ES59209509865436075018,TRX_N-00397-76705526,2022-12-01T11:11:35,Galdakao,incomes,salary_partner,1330.17,-17467.68
buyer_4,Jorge,50,ES59209509865436075018,TRX_N-00398-62236547,2022-12-01T11:11:35,Galdakao,incomes,salary_bonus,1019.59,-16448.09
buyer_4,Jorge,50,ES59209509865436075018,TRX_N-00399-47364255,2022-12-01T11:11:35,Galdakao,incomes,salary_partner_bonus,1036.89,-15411.2
buyer_4,Jorge,50,ES59209509865436075018,TRX_N-00400-83042444,2022-12-01T19:11:18,Galdakao,expenses,cash,-100.0,-15511.2
buyer_4,Jorge,50,ES59209509865436075018,TRX_N-00401-53054537,2022-12-03T04:24:39,Galdakao,expenses,food,-96.98,-15608.18
buyer_4,Jorge,50,ES59209509865436075018,TRX_N-00402-90367012,2022-12-04T21:47:43,Galdakao,expenses,mortgage,-858.17,-16466.35
buyer_4,Jorge,50,ES59209509865436075018,TRX_N-00403-97393352,2022-12-04T18:59:44,Galdakao,expenses,healthcare,-70.6,-16536.95
buyer_4,Jorge,50,ES59209509865436075018,TRX_N-00404-34834596,2022-12-05T11:29:00,Galdakao,expenses,electricity,-48.17,-16585.12
buyer_4,Jorge,50,ES59209509865436075018,TRX_N-00405-51841789,2022-12-05T08:21:47,Galdakao,expenses,phone,-42.42,-16627.54
buyer_4,Jorge,50,ES59209509865436075018,TRX_N-00406-90274709,2022-12-05T10:02:08,Galdakao,expenses,healthcare,-60.64,-16688.18
buyer_4,Jorge,50,ES59209509865436075018,TRX_N-00407-55038291,2022-12-06T13:44:55,Galdakao,expenses,gas,-63.83,-16752.01
buyer_4,Jorge,50,ES59209509865436075018,TRX_N-00408-66892052,2022-12-06T09:05:30,Vitoria-Gasteiz,expenses,transport,-55.81,-16807.82
buyer_4,Jorge,50,ES59209509865436075018,TRX_N-00409-37508270,2022-12-06T14:08:36,Galdakao,expenses,healthcare,-82.8,-16890.62
buyer_4,Jorge,50,ES59209509865436075018,TRX_N-00410-18360949,2022-12-06T09:22:35,Galdakao,expenses,children,-73.65,-16964.27
buyer_4,Jorge,50,ES59209509865436075018,TRX_N-00411-01522470,2022-12-07T17:28:15,Galdakao,expenses,cash,-100.0,-17064.27
buyer_4,Jorge,50,ES59209509865436075018,TRX_N-00412-68655969,2022-12-08T20:57:26,Galdakao,expenses,water,-26.68,-17090.95
buyer_4,Jorge,50,ES59209509865436075018,TRX_N-00413-47036871,2022-12-08T16:13:31,Galdakao,expenses,internet,-42.0,-17132.95
buyer_4,Jorge,50,ES59209509865436075018,TRX_N-00414-45473739,2022-12-08T12:39:21,Galdakao,expenses,cash,-100.0,-17232.95
buyer_4,Jorge,50,ES59209509865436075018,TRX_N-00415-26388694,2022-12-10T14:27:53,Portugalete,expenses,transport,-80.99,-17313.94
buyer_4,Jorge,50,ES59209509865436075018,TRX_N-00416-25130719,2022-12-12T11:30:02,Irun,expenses,transport,-45.25,-17359.19
buyer_4,Jorge,50,ES59209509865436075018,TRX_N-00417-62333527,2022-12-12T09:22:07,Galdakao,expenses,leisure,-76.67,-17435.86
buyer_4,Jorge,50,ES59209509865436075018,TRX_N-00418-56489858,2022-12-16T21:56:17,Galdakao,expenses,transport,-70.26,-17506.12
buyer_4,Jorge,50,ES59209509865436075018,TRX_N-00419-07472283,2022-12-16T10:18:02,Donostia,expenses,cash,-100.0,-17606.12
buyer_4,Jorge,50,ES59209509865436075018,TRX_N-00420-74211240,2022-12-17T13:52:33,Galdakao,expenses,cash,-100.0,-17706.12
buyer_4,Jorge,50,ES59209509865436075018,TRX_N-00421-89866325,2022-12-17T10:38:31,Galdakao,expenses,gifts,-693.67,-18399.79
buyer_4,Jorge,50,ES59209509865436075018,TRX_N-00422-98114012,2022-12-20T17:38:09,Galdakao,expenses,transport,-53.66,-18453.45
buyer_4,Jorge,50,ES59209509865436075018,TRX_N-00423-05711780,2022-12-20T10:59:51,Galdakao,expenses,cash,-100.0,-18553.45
buyer_4,Jorge,50,ES59209509865436075018,TRX_N-00424-13229658,2022-12-20T16:22:34,Galdakao,expenses,children,-185.36,-18738.81
buyer_4,Jorge,50,ES59209509865436075018,TRX_N-00425-38666019,2022-12-21T11:53:27,Galdakao,expenses,repairs,-140.7,-18879.51
buyer_4,Jorge,50,ES59209509865436075018,TRX_N-00426-82257695,2022-12-22T23:21:40,Galdakao,expenses,food,-116.86,-18996.37
buyer_4,Jorge,50,ES59209509865436075018,TRX_N-00427-49006129,2022-12-22T20:56:17,Hernani,expenses,travel,-1428.41,-20424.78
buyer_4,Jorge,50,ES59209509865436075018,TRX_N-00428-25275134,2022-12-23T12:00:24,Barakaldo,expenses,transport,-69.76,-20494.54
buyer_4,Jorge,50,ES59209509865436075018,TRX_N-00429-52079678,2022-12-24T18:55:27,Galdakao,expenses,leisure,-47.92,-20542.46
buyer_4,Jorge,50,ES59209509865436075018,TRX_N-00430-60098568,2022-12-25T19:01:39,Hernani,expenses,leisure,-82.59,-20625.05
buyer_4,Jorge,50,ES59209509865436075018,TRX_N-00431-00785483,2022-12-27T20:56:27,Hernani,expenses,food,-71.44,-20696.49
buyer_4,Jorge,50,ES59209509865436075018,TRX_N-00432-13204092,2022-12-27T08:31:24,Galdakao,expenses,leisure,-54.86,-20751.35
buyer_4,Jorge,50,ES59209509865436075018,TRX_N-00433-62159526,2022-12-27T10:14:50,Galdakao,expenses,travel,-1058.47,-21809.82
buyer_4,Jorge,50,ES59209509865436075018,TRX_N-00434-61103006,2022-12-28T14:35:46,Galdakao,expenses,leisure,-54.73,-21864.55
buyer_4,Jorge,50,ES59209509865436075018,TRX_N-00435-80049640,2022-12-29T13:05:25,Galdakao,expenses,food,-111.62,-21976.17
buyer_4,Jorge,50,ES59209509865436075018,TRX_N-00436-94414881,2022-12-29T17:55:19,Galdakao,expenses,leisure,-21.22,-21997.39
buyer_4,Jorge,50,ES59209509865436075018,TRX_N-00437-59735318,2022-12-31T12:08:34,Galdakao,expenses,gifts,-54.37,-22051.76
buyer_4,Jorge,50,ES59209509865436075018,TRX_N-00438-18010949,2023-01-01T17:13:57,Galdakao,incomes,salary,1441.16,-20610.6
buyer_4,Jorge,50,ES59209509865436075018,TRX_N-00439-15191084,2023-01-01T17:13:57,Galdakao,incomes,salary_partner,1362.02,-19248.58
buyer_4,Jorge,50,ES59209509865436075018,TRX_N-00440-02573516,2023-01-01T13:55:13,Galdakao,expenses,food,-87.66,-19336.24
buyer_4,Jorge,50,ES59209509865436075018,TRX_N-00441-13772313,2023-01-02T16:33:25,Galdakao,expenses,cash,-100.0,-19436.24
buyer_4,Jorge,50,ES59209509865436075018,TRX_N-00442-59166126,2023-01-02T19:29:05,Galdakao,expenses,children,-218.1,-19654.34
buyer_4,Jorge,50,ES59209509865436075018,TRX_N-00443-66461782,2023-01-04T08:41:19,Galdakao,expenses,mortgage,-858.17,-20512.51
buyer_4,Jorge,50,ES59209509865436075018,TRX_N-00444-14694834,2023-01-04T17:18:54,Vitoria-Gasteiz,expenses,food,-60.12,-20572.63
buyer_4,Jorge,50,ES59209509865436075018,TRX_N-00445-70792380,2023-01-04T11:25:29,Galdakao,expenses,leisure,-55.66,-20628.29
buyer_4,Jorge,50,ES59209509865436075018,TRX_N-00446-29638850,2023-01-05T08:51:00,Galdakao,expenses,electricity,-22.18,-20650.47
buyer_4,Jorge,50,ES59209509865436075018,TRX_N-00447-32132206,2023-01-06T12:12:17,Galdakao,expenses,water,-29.14,-20679.61
buyer_4,Jorge,50,ES59209509865436075018,TRX_N-00448-95700923,2023-01-06T21:55:40,Galdakao,expenses,internet,-42.0,-20721.61
buyer_4,Jorge,50,ES59209509865436075018,TRX_N-00449-41899549,2023-01-07T19:26:50,Galdakao,expenses,food,-62.99,-20784.6
buyer_4,Jorge,50,ES59209509865436075018,TRX_N-00450-19145874,2023-01-07T22:33:11,Galdakao,expenses,leisure,-32.21,-20816.81
buyer_4,Jorge,50,ES59209509865436075018,TRX_N-00451-50835666,2023-01-08T00:11:59,Galdakao,expenses,gas,-87.89,-20904.7
buyer_4,Jorge,50,ES59209509865436075018,TRX_N-00452-10820481,2023-01-08T12:34:16,Galdakao,expenses,phone,-31.22,-20935.92
buyer_4,Jorge,50,ES59209509865436075018,TRX_N-00453-08577112,2023-01-08T17:45:11,Galdakao,expenses,cash,-100.0,-21035.92
buyer_4,Jorge,50,ES59209509865436075018,TRX_N-00454-72878216,2023-01-11T09:32:16,Amurrio,expenses,leisure,-27.46,-21063.38
buyer_4,Jorge,50,ES59209509865436075018,TRX_N-00455-23501439,2023-01-11T12:49:07,Galdakao,expenses,cash,-100.0,-21163.38
buyer_4,Jorge,50,ES59209509865436075018,TRX_N-00456-80457183,2023-01-11T22:50:08,Galdakao,expenses,children,-211.31,-21374.69
buyer_4,Jorge,50,ES59209509865436075018,TRX_N-00457-31766664,2023-01-12T19:35:30,Labastida,expenses,clothing,-53.45,-21428.14
buyer_4,Jorge,50,ES59209509865436075018,TRX_N-00458-72809830,2023-01-13T18:48:30,Galdakao,expenses,food,-64.1,-21492.24
buyer_4,Jorge,50,ES59209509865436075018,TRX_N-00459-54385455,2023-01-13T15:58:32,Galdakao,expenses,transport,-87.29,-21579.53
buyer_4,Jorge,50,ES59209509865436075018,TRX_N-00460-46011408,2023-01-14T08:10:22,Galdakao,expenses,cash,-100.0,-21679.53
buyer_4,Jorge,50,ES59209509865436075018,TRX_N-00461-78413206,2023-01-15T20:15:44,Vitoria-Gasteiz,expenses,repairs,-106.25,-21785.78
buyer_4,Jorge,50,ES59209509865436075018,TRX_N-00462-34565345,2023-01-16T19:37:04,Galdakao,expenses,cash,-100.0,-21885.78
buyer_4,Jorge,50,ES59209509865436075018,TRX_N-00463-16743453,2023-01-19T23:47:59,Galdakao,expenses,healthcare,-187.94,-22073.72
buyer_4,Jorge,50,ES59209509865436075018,TRX_N-00464-83670238,2023-01-20T20:58:50,Galdakao,expenses,appliances,-293.51,-22367.23
buyer_4,Jorge,50,ES59209509865436075018,TRX_N-00465-20846631,2023-01-27T17:52:29,Alegría-Dulantzi,expenses,education,-60.29,-22427.52
buyer_4,Jorge,50,ES59209509865436075018,TRX_N-00466-86151117,2023-01-27T17:02:38,Galdakao,expenses,gifts,-781.66,-23209.18
buyer_4,Jorge,50,ES59209509865436075018,TRX_N-00467-07720795,2023-01-28T11:43:58,Galdakao,expenses,food,-117.33,-23326.51
buyer_4,Jorge,50,ES59209509865436075018,TRX_N-00468-32656999,2023-01-28T05:18:24,Galdakao,expenses,cash,-100.0,-23426.51
buyer_4,Jorge,50,ES59209509865436075018,TRX_N-00469-36205620,2023-01-29T06:29:42,Galdakao,expenses,leisure,-42.63,-23469.14
buyer_4,Jorge,50,ES59209509865436075018,TRX_N-00470-90888896,2023-01-30T15:05:54,Galdakao,expenses,cash,-100.0,-23569.14
buyer_4,Jorge,50,ES59209509865436075018,TRX_N-00471-08011677,2023-02-01T22:51:39,Galdakao,incomes,salary,1441.16,-22127.98
buyer_4,Jorge,50,ES59209509865436075018,TRX_N-00472-29206156,2023-02-01T22:51:39,Galdakao,incomes,salary_partner,1362.02,-20765.96
buyer_4,Jorge,50,ES59209509865436075018,TRX_N-00473-93436951,2023-02-03T12:42:15,Barakaldo,expenses,cash,-100.0,-20865.96
buyer_4,Jorge,50,ES59209509865436075018,TRX_N-00474-13117702,2023-02-04T15:55:01,Galdakao,expenses,mortgage,-858.17,-21724.13
buyer_4,Jorge,50,ES59209509865436075018,TRX_N-00475-97949938,2023-02-05T11:04:09,Pasaia,expenses,leisure,-51.38,-21775.51
buyer_4,Jorge,50,ES59209509865436075018,TRX_N-00476-60489307,2023-02-06T11:17:42,Galdakao,expenses,water,-23.58,-21799.09
buyer_4,Jorge,50,ES59209509865436075018,TRX_N-00477-98880778,2023-02-06T11:13:56,Galdakao,expenses,gas,-47.91,-21847.0
buyer_4,Jorge,50,ES59209509865436075018,TRX_N-00478-09374485,2023-02-06T11:03:38,Galdakao,expenses,internet,-42.0,-21889.0
buyer_4,Jorge,50,ES59209509865436075018,TRX_N-00479-84800327,2023-02-08T02:18:46,Galdakao,expenses,electricity,-37.17,-21926.17
buyer_4,Jorge,50,ES59209509865436075018,TRX_N-00480-80455982,2023-02-08T15:18:36,Galdakao,expenses,phone,-42.92,-21969.09
buyer_4,Jorge,50,ES59209509865436075018,TRX_N-00481-03384043,2023-02-08T17:29:05,Galdakao,expenses,children,-181.24,-22150.33
buyer_4,Jorge,50,ES59209509865436075018,TRX_N-00482-42753386,2023-02-10T15:33:54,Galdakao,expenses,children,-128.07,-22278.4
buyer_4,Jorge,50,ES59209509865436075018,TRX_N-00483-49685129,2023-02-13T10:35:56,Galdakao,expenses,transport,-55.69,-22334.09
buyer_4,Jorge,50,ES59209509865436075018,TRX_N-00484-62526249,2023-02-13T20:35:03,Galdakao,expenses,leisure,-64.51,-22398.6
buyer_4,Jorge,50,ES59209509865436075018,TRX_N-00485-91678523,2023-02-16T21:03:18,Oyón-Oion,expenses,transport,-53.04,-22451.64
buyer_4,Jorge,50,ES59209509865436075018,TRX_N-00486-47255749,2023-02-16T23:49:26,Galdakao,expenses,children,-230.24,-22681.88
buyer_4,Jorge,50,ES59209509865436075018,TRX_N-00487-76395299,2023-02-19T09:08:07,Galdakao,expenses,travel,-463.9,-23145.78
buyer_4,Jorge,50,ES59209509865436075018,TRX_N-00488-44162224,2023-02-21T16:19:29,Galdakao,expenses,cash,-100.0,-23245.78
buyer_4,Jorge,50,ES59209509865436075018,TRX_N-00489-66416534,2023-02-22T20:33:07,Galdakao,expenses,food,-84.32,-23330.1
buyer_4,Jorge,50,ES59209509865436075018,TRX_N-00490-68133876,2023-02-23T20:37:52,Galdakao,expenses,cash,-100.0,-23430.1
buyer_4,Jorge,50,ES59209509865436075018,TRX_N-00491-03332878,2023-02-25T09:35:32,Galdakao,expenses,repairs,-148.68,-23578.78
buyer_4,Jorge,50,ES59209509865436075018,TRX_N-00492-58068898,2023-02-27T20:57:51,Galdakao,expenses,leisure,-57.86,-23636.64
buyer_4,Jorge,50,ES59209509865436075018,TRX_N-00493-28714379,2023-02-28T09:55:41,Galdakao,expenses,education,-61.75,-23698.39
buyer_4,Jorge,50,ES59209509865436075018,TRX_N-00494-33003027,2023-03-01T20:14:49,Galdakao,incomes,salary,1441.16,-22257.23
buyer_4,Jorge,50,ES59209509865436075018,TRX_N-00495-88916758,2023-03-01T20:14:49,Galdakao,incomes,salary_partner,1362.02,-20895.21
buyer_4,Jorge,50,ES59209509865436075018,TRX_N-00496-42171720,2023-03-01T20:14:49,Galdakao,incomes,extra_income,189.14,-20706.07
buyer_4,Jorge,50,ES59209509865436075018,TRX_N-00497-70997827,2023-03-02T11:10:27,Galdakao,expenses,leisure,-41.32,-20747.39
buyer_4,Jorge,50,ES59209509865436075018,TRX_N-00498-57060450,2023-03-02T23:59:18,Galdakao,expenses,cash,-100.0,-20847.39
buyer_4,Jorge,50,ES59209509865436075018,TRX_N-00499-15373023,2023-03-04T09:56:40,Galdakao,expenses,mortgage,-858.17,-21705.56
buyer_4,Jorge,50,ES59209509865436075018,TRX_N-00500-24865624,2023-03-05T16:46:22,Barakaldo,expenses,clothing,-51.21,-21756.77
buyer_4,Jorge,50,ES59209509865436075018,TRX_N-00501-46781456,2023-03-06T03:48:22,Galdakao,expenses,water,-20.92,-21777.69
buyer_4,Jorge,50,ES59209509865436075018,TRX_N-00502-91924862,2023-03-06T17:34:14,Galdakao,expenses,phone,-34.77,-21812.46
buyer_4,Jorge,50,ES59209509865436075018,TRX_N-00503-76341108,2023-03-06T15:03:57,Galdakao,expenses,leisure,-82.84,-21895.3
buyer_4,Jorge,50,ES59209509865436075018,TRX_N-00504-84509093,2023-03-06T00:44:33,Galdakao,expenses,cash,-100.0,-21995.3
buyer_4,Jorge,50,ES59209509865436075018,TRX_N-00505-81381542,2023-03-08T13:39:55,Galdakao,expenses,electricity,-39.05,-22034.35
buyer_4,Jorge,50,ES59209509865436075018,TRX_N-00506-63756149,2023-03-08T14:56:10,Galdakao,expenses,gas,-58.77,-22093.12
buyer_4,Jorge,50,ES59209509865436075018,TRX_N-00507-29513250,2023-03-08T14:52:04,Galdakao,expenses,internet,-42.0,-22135.12
buyer_4,Jorge,50,ES59209509865436075018,TRX_N-00508-53795105,2023-03-08T14:08:08,Galdakao,expenses,transport,-54.58,-22189.7
buyer_4,Jorge,50,ES59209509865436075018,TRX_N-00509-82753404,2023-03-09T16:13:57,Galdakao,expenses,cash,-100.0,-22289.7
buyer_4,Jorge,50,ES59209509865436075018,TRX_N-00510-21191549,2023-03-10T00:48:58,Galdakao,expenses,leisure,-59.07,-22348.77
buyer_4,Jorge,50,ES59209509865436075018,TRX_N-00511-65143642,2023-03-12T14:26:03,Galdakao,expenses,repairs,-216.07,-22564.84
buyer_4,Jorge,50,ES59209509865436075018,TRX_N-00512-27136907,2023-03-13T17:11:07,Galdakao,expenses,transport,-43.93,-22608.77
buyer_4,Jorge,50,ES59209509865436075018,TRX_N-00513-92471443,2023-03-14T18:48:15,Galdakao,expenses,food,-77.5,-22686.27
buyer_4,Jorge,50,ES59209509865436075018,TRX_N-00514-56592683,2023-03-14T14:32:54,Galdakao,expenses,education,-56.2,-22742.47
buyer_4,Jorge,50,ES59209509865436075018,TRX_N-00515-98367868,2023-03-14T22:02:38,Galdakao,expenses,cash,-100.0,-22842.47
buyer_4,Jorge,50,ES59209509865436075018,TRX_N-00516-63406443,2023-03-15T17:28:06,Galdakao,expenses,transport,-59.26,-22901.73
buyer_4,Jorge,50,ES59209509865436075018,TRX_N-00517-08324103,2023-03-16T15:03:12,Eibar,expenses,transport,-55.93,-22957.66
buyer_4,Jorge,50,ES59209509865436075018,TRX_N-00518-61868898,2023-03-17T15:05:30,Galdakao,expenses,food,-73.99,-23031.65
buyer_4,Jorge,50,ES59209509865436075018,TRX_N-00519-91483255,2023-03-21T01:06:33,Alegría-Dulantzi,expenses,food,-87.31,-23118.96
buyer_4,Jorge,50,ES59209509865436075018,TRX_N-00520-58027458,2023-03-21T20:48:23,Galdakao,expenses,leisure,-51.6,-23170.56
buyer_4,Jorge,50,ES59209509865436075018,TRX_N-00521-54052266,2023-03-22T11:39:31,Galdakao,expenses,children,-205.3,-23375.86
buyer_4,Jorge,50,ES59209509865436075018,TRX_N-00522-08012636,2023-03-23T12:40:33,Galdakao,expenses,food,-62.09,-23437.95
buyer_4,Jorge,50,ES59209509865436075018,TRX_N-00523-88828072,2023-03-23T12:07:29,Galdakao,expenses,children,-275.03,-23712.98
buyer_4,Jorge,50,ES59209509865436075018,TRX_N-00524-13353119,2023-03-24T20:49:48,Galdakao,expenses,repairs,-138.03,-23851.01
buyer_4,Jorge,50,ES59209509865436075018,TRX_N-00525-28554182,2023-03-26T18:09:57,Galdakao,expenses,transport,-47.45,-23898.46
buyer_4,Jorge,50,ES59209509865436075018,TRX_N-00526-33479546,2023-03-26T08:41:41,Galdakao,expenses,cash,-100.0,-23998.46
buyer_4,Jorge,50,ES59209509865436075018,TRX_N-00527-49519333,2023-03-27T16:05:13,Galdakao,expenses,food,-70.15,-24068.61
buyer_4,Jorge,50,ES59209509865436075018,TRX_N-00528-83457322,2023-03-27T18:33:54,Galdakao,expenses,repairs,-200.9,-24269.51
buyer_4,Jorge,50,ES59209509865436075018,TRX_N-00529-63198731,2023-03-30T10:39:43,Galdakao,expenses,education,-71.18,-24340.69
buyer_4,Jorge,50,ES59209509865436075018,TRX_N-00530-93008620,2023-03-31T14:35:42,Galdakao,expenses,cash,-100.0,-24440.69
buyer_4,Jorge,50,ES59209509865436075018,TRX_N-00531-19953773,2023-04-01T16:08:45,Galdakao,incomes,salary,1441.16,-22999.53
buyer_4,Jorge,50,ES59209509865436075018,TRX_N-00532-35211280,2023-04-01T16:08:45,Galdakao,incomes,salary_partner,1362.02,-21637.51
buyer_4,Jorge,50,ES59209509865436075018,TRX_N-00533-34051204,2023-04-01T22:06:41,Galdakao,expenses,cash,-100.0,-21737.51
buyer_4,Jorge,50,ES59209509865436075018,TRX_N-00534-77512279,2023-04-02T12:23:51,Eibar,expenses,clothing,-134.24,-21871.75
buyer_4,Jorge,50,ES59209509865436075018,TRX_N-00535-54011705,2023-04-02T10:48:45,Galdakao,expenses,gifts,-707.65,-22579.4
buyer_4,Jorge,50,ES59209509865436075018,TRX_N-00536-98892676,2023-04-03T14:41:23,Lasarte-Oria,expenses,food,-83.58,-22662.98
buyer_4,Jorge,50,ES59209509865436075018,TRX_N-00537-04140634,2023-04-03T19:25:40,Galdakao,expenses,leisure,-30.45,-22693.43
buyer_4,Jorge,50,ES59209509865436075018,TRX_N-00538-51121488,2023-04-03T09:27:42,Galdakao,expenses,education,-60.93,-22754.36
buyer_4,Jorge,50,ES59209509865436075018,TRX_N-00539-66392941,2023-04-04T10:21:56,Galdakao,expenses,mortgage,-858.17,-23612.53
buyer_4,Jorge,50,ES59209509865436075018,TRX_N-00540-10593221,2023-04-04T12:31:02,Galdakao,expenses,transport,-81.51,-23694.04
buyer_4,Jorge,50,ES59209509865436075018,TRX_N-00541-44518598,2023-04-04T19:18:00,Galdakao,expenses,gifts,-321.37,-24015.41
buyer_4,Jorge,50,ES59209509865436075018,TRX_N-00542-37903923,2023-04-05T12:57:46,Galdakao,expenses,internet,-42.0,-24057.41
buyer_4,Jorge,50,ES59209509865436075018,TRX_N-00543-34187366,2023-04-07T13:46:59,Galdakao,expenses,gas,-41.96,-24099.37
buyer_4,Jorge,50,ES59209509865436075018,TRX_N-00544-94900903,2023-04-07T15:23:06,Galdakao,expenses,leisure,-44.4,-24143.77
buyer_4,Jorge,50,ES59209509865436075018,TRX_N-00545-62575327,2023-04-08T08:34:23,Galdakao,expenses,water,-42.58,-24186.35
buyer_4,Jorge,50,ES59209509865436075018,TRX_N-00546-59132377,2023-04-08T12:40:22,Galdakao,expenses,electricity,-34.14,-24220.49
buyer_4,Jorge,50,ES59209509865436075018,TRX_N-00547-79416387,2023-04-08T08:15:01,Galdakao,expenses,phone,-43.76,-24264.25
buyer_4,Jorge,50,ES59209509865436075018,TRX_N-00548-93427556,2023-04-08T20:03:26,Galdakao,expenses,transport,-61.8,-24326.05
buyer_4,Jorge,50,ES59209509865436075018,TRX_N-00549-84401324,2023-04-09T20:58:05,Galdakao,expenses,cash,-100.0,-24426.05
buyer_4,Jorge,50,ES59209509865436075018,TRX_N-00550-60700643,2023-04-10T09:53:35,Pasaia,expenses,food,-104.38,-24530.43
buyer_4,Jorge,50,ES59209509865436075018,TRX_N-00551-26194750,2023-04-10T12:57:25,Galdakao,expenses,healthcare,-65.4,-24595.83
buyer_4,Jorge,50,ES59209509865436075018,TRX_N-00552-07130184,2023-04-11T08:19:55,Galdakao,expenses,cash,-100.0,-24695.83
buyer_4,Jorge,50,ES59209509865436075018,TRX_N-00553-28878644,2023-04-12T19:47:46,Galdakao,expenses,cash,-100.0,-24795.83
buyer_4,Jorge,50,ES59209509865436075018,TRX_N-00554-82525672,2023-04-13T19:06:59,Galdakao,expenses,food,-65.93,-24861.76
buyer_4,Jorge,50,ES59209509865436075018,TRX_N-00555-28116117,2023-04-13T23:56:05,Galdakao,expenses,repairs,-261.51,-25123.27
buyer_4,Jorge,50,ES59209509865436075018,TRX_N-00556-55494106,2023-04-14T06:22:25,Galdakao,expenses,food,-77.65,-25200.92
buyer_4,Jorge,50,ES59209509865436075018,TRX_N-00557-38038072,2023-04-17T18:56:47,Galdakao,expenses,food,-93.77,-25294.69
buyer_4,Jorge,50,ES59209509865436075018,TRX_N-00558-82223755,2023-04-18T17:02:44,Galdakao,expenses,food,-83.04,-25377.73
buyer_4,Jorge,50,ES59209509865436075018,TRX_N-00559-79159989,2023-04-19T08:35:23,Galdakao,expenses,leisure,-75.14,-25452.87
buyer_4,Jorge,50,ES59209509865436075018,TRX_N-00560-07601309,2023-04-20T17:41:03,Galdakao,expenses,education,-58.01,-25510.88
buyer_4,Jorge,50,ES59209509865436075018,TRX_N-00561-67164430,2023-04-20T10:17:37,Galdakao,expenses,appliances,-151.96,-25662.84
buyer_4,Jorge,50,ES59209509865436075018,TRX_N-00562-05400403,2023-04-22T08:57:48,Galdakao,expenses,transport,-81.12,-25743.96
buyer_4,Jorge,50,ES59209509865436075018,TRX_N-00563-75981960,2023-04-23T09:26:47,Galdakao,expenses,food,-76.16,-25820.12
buyer_4,Jorge,50,ES59209509865436075018,TRX_N-00564-40477050,2023-04-25T11:36:07,Santurtzi,expenses,clothing,-53.73,-25873.85
buyer_4,Jorge,50,ES59209509865436075018,TRX_N-00565-77381366,2023-04-25T15:22:40,Galdakao,expenses,education,-75.78,-25949.63
buyer_4,Jorge,50,ES59209509865436075018,TRX_N-00566-10921831,2023-04-26T19:15:08,Salvatierra/Agurain,expenses,food,-102.43,-26052.06
buyer_4,Jorge,50,ES59209509865436075018,TRX_N-00567-86432378,2023-04-27T18:13:03,Elciego,expenses,food,-121.94,-26174.0
buyer_4,Jorge,50,ES59209509865436075018,TRX_N-00568-74845048,2023-04-27T10:19:28,Galdakao,expenses,leisure,-79.32,-26253.32
buyer_4,Jorge,50,ES59209509865436075018,TRX_N-00569-54878845,2023-04-28T15:26:06,Galdakao,expenses,cash,-100.0,-26353.32
buyer_4,Jorge,50,ES59209509865436075018,TRX_N-00570-17106948,2023-05-01T18:28:10,Galdakao,incomes,salary,1441.16,-24912.16
buyer_4,Jorge,50,ES59209509865436075018,TRX_N-00571-09844747,2023-05-01T18:28:10,Galdakao,incomes,salary_partner,1362.02,-23550.14
buyer_4,Jorge,50,ES59209509865436075018,TRX_N-00572-16760383,2023-05-04T08:15:06,Galdakao,expenses,mortgage,-858.17,-24408.31
buyer_4,Jorge,50,ES59209509865436075018,TRX_N-00573-83169397,2023-05-04T20:59:15,Iruña de Oca,expenses,food,-98.64,-24506.95
buyer_4,Jorge,50,ES59209509865436075018,TRX_N-00574-87865132,2023-05-05T19:51:30,Galdakao,expenses,gas,-56.29,-24563.24
buyer_4,Jorge,50,ES59209509865436075018,TRX_N-00575-15478253,2023-05-06T13:55:36,Galdakao,expenses,food,-102.02,-24665.26
buyer_4,Jorge,50,ES59209509865436075018,TRX_N-00576-89106844,2023-05-07T18:54:30,Galdakao,expenses,water,-40.44,-24705.7
buyer_4,Jorge,50,ES59209509865436075018,TRX_N-00577-34636442,2023-05-07T08:29:22,Galdakao,expenses,cash,-100.0,-24805.7
buyer_4,Jorge,50,ES59209509865436075018,TRX_N-00578-23118822,2023-05-07T23:00:34,Galdakao,expenses,repairs,-263.06,-25068.76
buyer_4,Jorge,50,ES59209509865436075018,TRX_N-00579-91971473,2023-05-07T11:10:55,Galdakao,expenses,gifts,-771.09,-25839.85
buyer_4,Jorge,50,ES59209509865436075018,TRX_N-00580-99354124,2023-05-08T14:05:46,Galdakao,expenses,internet,-42.0,-25881.85
buyer_4,Jorge,50,ES59209509865436075018,TRX_N-00581-46488062,2023-05-08T18:07:17,Galdakao,expenses,electricity,-42.88,-25924.73
buyer_4,Jorge,50,ES59209509865436075018,TRX_N-00582-27011253,2023-05-08T09:30:10,Galdakao,expenses,phone,-38.87,-25963.6
buyer_4,Jorge,50,ES59209509865436075018,TRX_N-00583-93632437,2023-05-08T21:35:45,Galdakao,expenses,transport,-52.63,-26016.23
buyer_4,Jorge,50,ES59209509865436075018,TRX_N-00584-12572745,2023-05-16T08:19:40,Galdakao,expenses,cash,-100.0,-26116.23
buyer_4,Jorge,50,ES59209509865436075018,TRX_N-00585-00734804,2023-05-19T19:32:51,Galdakao,expenses,leisure,-21.17,-26137.4
buyer_4,Jorge,50,ES59209509865436075018,TRX_N-00586-45564687,2023-05-21T18:39:29,Galdakao,expenses,cash,-100.0,-26237.4
buyer_4,Jorge,50,ES59209509865436075018,TRX_N-00587-22215929,2023-05-22T19:00:04,Galdakao,expenses,food,-121.75,-26359.15
buyer_4,Jorge,50,ES59209509865436075018,TRX_N-00588-09286889,2023-05-22T09:25:12,Galdakao,expenses,cash,-100.0,-26459.15
buyer_4,Jorge,50,ES59209509865436075018,TRX_N-00589-30696165,2023-05-23T14:33:38,Galdakao,expenses,transport,-86.59,-26545.74
buyer_4,Jorge,50,ES59209509865436075018,TRX_N-00590-65065478,2023-05-23T12:48:21,Galdakao,expenses,leisure,-42.24,-26587.98
buyer_4,Jorge,50,ES59209509865436075018,TRX_N-00591-16533855,2023-05-25T16:17:09,Galdakao,expenses,repairs,-154.91,-26742.89
buyer_4,Jorge,50,ES59209509865436075018,TRX_N-00592-79425381,2023-06-01T19:32:35,Galdakao,incomes,salary,1441.16,-25301.73
buyer_4,Jorge,50,ES59209509865436075018,TRX_N-00593-71715091,2023-06-01T19:32:35,Galdakao,incomes,salary_partner,1362.02,-23939.71
buyer_4,Jorge,50,ES59209509865436075018,TRX_N-00594-65020995,2023-06-01T19:32:35,Galdakao,incomes,salary_bonus,1014.57,-22925.14
buyer_4,Jorge,50,ES59209509865436075018,TRX_N-00595-52718059,2023-06-01T19:32:35,Galdakao,incomes,salary_partner_bonus,1042.31,-21882.83
buyer_4,Jorge,50,ES59209509865436075018,TRX_N-00596-38196830,2023-06-01T12:37:50,Galdakao,expenses,cash,-100.0,-21982.83
buyer_4,Jorge,50,ES59209509865436075018,TRX_N-00597-26540821,2023-06-02T09:11:48,Galdakao,expenses,transport,-71.56,-22054.39
buyer_4,Jorge,50,ES59209509865436075018,TRX_N-00598-05971621,2023-06-04T20:06:22,Galdakao,expenses,mortgage,-858.17,-22912.56
buyer_4,Jorge,50,ES59209509865436075018,TRX_N-00599-33752823,2023-06-04T08:50:25,Galdakao,expenses,education,-53.33,-22965.89
buyer_4,Jorge,50,ES59209509865436075018,TRX_N-00600-10695188,2023-06-05T14:48:49,Galdakao,expenses,water,-21.94,-22987.83
buyer_4,Jorge,50,ES59209509865436075018,TRX_N-00601-27190889,2023-06-05T13:54:28,Galdakao,expenses,internet,-42.0,-23029.83
buyer_4,Jorge,50,ES59209509865436075018,TRX_N-00602-29147013,2023-06-05T11:48:48,Galdakao,expenses,cash,-100.0,-23129.83
buyer_4,Jorge,50,ES59209509865436075018,TRX_N-00603-81845618,2023-06-05T10:52:19,Galdakao,expenses,appliances,-287.04,-23416.87
buyer_4,Jorge,50,ES59209509865436075018,TRX_N-00604-77185323,2023-06-06T22:42:02,Galdakao,expenses,phone,-34.48,-23451.35
buyer_4,Jorge,50,ES59209509865436075018,TRX_N-00605-40006266,2023-06-06T09:29:18,Oyón-Oion,expenses,transport,-49.21,-23500.56
buyer_4,Jorge,50,ES59209509865436075018,TRX_N-00606-47791460,2023-06-06T18:05:18,Galdakao,expenses,repairs,-293.68,-23794.24
buyer_4,Jorge,50,ES59209509865436075018,TRX_N-00607-82190963,2023-06-07T18:20:49,Galdakao,expenses,gas,-52.01,-23846.25
buyer_4,Jorge,50,ES59209509865436075018,TRX_N-00608-71848098,2023-06-07T18:30:58,Galdakao,expenses,children,-202.25,-24048.5
buyer_4,Jorge,50,ES59209509865436075018,TRX_N-00609-71418977,2023-06-08T10:07:18,Galdakao,expenses,electricity,-86.84,-24135.34
buyer_4,Jorge,50,ES59209509865436075018,TRX_N-00610-53371103,2023-06-08T11:22:56,Galdakao,expenses,leisure,-23.74,-24159.08
buyer_4,Jorge,50,ES59209509865436075018,TRX_N-00611-36349857,2023-06-12T03:02:08,Oyón-Oion,expenses,education,-47.76,-24206.84
buyer_4,Jorge,50,ES59209509865436075018,TRX_N-00612-51445834,2023-06-13T12:42:53,Galdakao,expenses,leisure,-26.23,-24233.07
buyer_4,Jorge,50,ES59209509865436075018,TRX_N-00613-99278466,2023-06-13T14:48:14,Galdakao,expenses,cash,-100.0,-24333.07
buyer_4,Jorge,50,ES59209509865436075018,TRX_N-00614-07918109,2023-06-15T19:01:04,Galdakao,expenses,clothing,-58.3,-24391.37
buyer_4,Jorge,50,ES59209509865436075018,TRX_N-00615-47457778,2023-06-16T11:41:51,Galdakao,expenses,leisure,-32.27,-24423.64
buyer_4,Jorge,50,ES59209509865436075018,TRX_N-00616-90476039,2023-06-17T12:54:04,Galdakao,expenses,leisure,-84.79,-24508.43
buyer_4,Jorge,50,ES59209509865436075018,TRX_N-00617-55289907,2023-06-19T20:44:53,Galdakao,expenses,clothing,-128.06,-24636.49
buyer_4,Jorge,50,ES59209509865436075018,TRX_N-00618-44569404,2023-06-20T13:15:51,Galdakao,expenses,gifts,-102.08,-24738.57
buyer_4,Jorge,50,ES59209509865436075018,TRX_N-00619-51943290,2023-06-22T10:37:42,Galdakao,expenses,gifts,-435.76,-25174.33
buyer_4,Jorge,50,ES59209509865436075018,TRX_N-00620-65572966,2023-06-23T12:41:49,Galdakao,expenses,healthcare,-98.77,-25273.1
buyer_4,Jorge,50,ES59209509865436075018,TRX_N-00621-89702381,2023-06-23T14:15:12,Galdakao,expenses,children,-116.25,-25389.35
buyer_4,Jorge,50,ES59209509865436075018,TRX_N-00622-31429409,2023-06-24T15:31:12,Galdakao,expenses,transport,-54.27,-25443.62
buyer_4,Jorge,50,ES59209509865436075018,TRX_N-00623-97731764,2023-06-24T13:32:51,Galdakao,expenses,cash,-100.0,-25543.62
buyer_4,Jorge,50,ES59209509865436075018,TRX_N-00624-54543629,2023-06-25T08:54:07,Durango,expenses,food,-105.76,-25649.38
buyer_4,Jorge,50,ES59209509865436075018,TRX_N-00625-67894120,2023-06-25T11:20:38,Galdakao,expenses,transport,-86.89,-25736.27
buyer_4,Jorge,50,ES59209509865436075018,TRX_N-00626-29091532,2023-06-27T13:36:41,Galdakao,expenses,food,-61.25,-25797.52
buyer_4,Jorge,50,ES59209509865436075018,TRX_N-00627-53092739,2023-06-27T18:55:32,Galdakao,expenses,repairs,-229.8,-26027.32
buyer_4,Jorge,50,ES59209509865436075018,TRX_N-00628-25819767,2023-06-30T14:38:21,Galdakao,expenses,leisure,-50.17,-26077.49
buyer_4,Jorge,50,ES59209509865436075018,TRX_N-00629-98942730,2023-07-01T11:09:26,Galdakao,incomes,salary,1441.16,-24636.33
buyer_4,Jorge,50,ES59209509865436075018,TRX_N-00630-28322500,2023-07-01T11:09:26,Galdakao,incomes,salary_partner,1362.02,-23274.31
buyer_4,Jorge,50,ES59209509865436075018,TRX_N-00631-49491835,2023-07-01T11:09:26,Galdakao,incomes,extra_income,189.14,-23085.17
buyer_4,Jorge,50,ES59209509865436075018,TRX_N-00632-20651023,2023-07-02T22:01:09,Sopela,expenses,education,-78.87,-23164.04
buyer_4,Jorge,50,ES59209509865436075018,TRX_N-00633-27517965,2023-07-04T02:43:55,Galdakao,expenses,mortgage,-858.17,-24022.21
buyer_4,Jorge,50,ES59209509865436075018,TRX_N-00634-06377719,2023-07-04T08:43:23,Galdakao,expenses,cash,-100.0,-24122.21
buyer_4,Jorge,50,ES59209509865436075018,TRX_N-00635-37567339,2023-07-04T06:01:20,Galdakao,expenses,repairs,-317.14,-24439.35
buyer_4,Jorge,50,ES59209509865436075018,TRX_N-00636-63480022,2023-07-05T09:57:43,Galdakao,expenses,electricity,-57.22,-24496.57
buyer_4,Jorge,50,ES59209509865436075018,TRX_N-00637-38969007,2023-07-05T11:42:48,Galdakao,expenses,phone,-41.71,-24538.28
buyer_4,Jorge,50,ES59209509865436075018,TRX_N-00638-98953284,2023-07-05T10:33:21,Bermeo,expenses,food,-61.35,-24599.63
buyer_4,Jorge,50,ES59209509865436075018,TRX_N-00639-96928234,2023-07-05T19:12:07,Galdakao,expenses,leisure,-42.45,-24642.08
buyer_4,Jorge,50,ES59209509865436075018,TRX_N-00640-15004793,2023-07-06T20:39:35,Galdakao,expenses,gas,-68.05,-24710.13
buyer_4,Jorge,50,ES59209509865436075018,TRX_N-00641-63907899,2023-07-07T23:29:38,Galdakao,expenses,water,-29.32,-24739.45
buyer_4,Jorge,50,ES59209509865436075018,TRX_N-00642-89139101,2023-07-07T12:10:58,Galdakao,expenses,food,-113.24,-24852.69
buyer_4,Jorge,50,ES59209509865436075018,TRX_N-00643-41623368,2023-07-07T13:14:52,Galdakao,expenses,clothing,-101.19,-24953.88
buyer_4,Jorge,50,ES59209509865436075018,TRX_N-00644-58903330,2023-07-08T11:57:31,Galdakao,expenses,internet,-42.0,-24995.88
buyer_4,Jorge,50,ES59209509865436075018,TRX_N-00645-04339059,2023-07-10T00:26:29,Galdakao,expenses,healthcare,-137.41,-25133.29
buyer_4,Jorge,50,ES59209509865436075018,TRX_N-00646-06256213,2023-07-11T14:25:40,Galdakao,expenses,food,-107.16,-25240.45
buyer_4,Jorge,50,ES59209509865436075018,TRX_N-00647-26500806,2023-07-11T00:27:41,Galdakao,expenses,leisure,-77.98,-25318.43
buyer_4,Jorge,50,ES59209509865436075018,TRX_N-00648-90717872,2023-07-15T12:14:43,Galdakao,expenses,clothing,-64.01,-25382.44
buyer_4,Jorge,50,ES59209509865436075018,TRX_N-00649-78149216,2023-07-16T13:55:47,Galdakao,expenses,transport,-58.72,-25441.16
buyer_4,Jorge,50,ES59209509865436075018,TRX_N-00650-69832024,2023-07-17T15:39:26,Galdakao,expenses,transport,-84.61,-25525.77
buyer_4,Jorge,50,ES59209509865436075018,TRX_N-00651-14180030,2023-07-17T10:14:15,Eibar,expenses,travel,-855.38,-26381.15
buyer_4,Jorge,50,ES59209509865436075018,TRX_N-00652-88246635,2023-07-17T07:46:58,Galdakao,expenses,gifts,-116.24,-26497.39
buyer_4,Jorge,50,ES59209509865436075018,TRX_N-00653-31961299,2023-07-19T17:48:20,Irun,expenses,cash,-100.0,-26597.39
buyer_4,Jorge,50,ES59209509865436075018,TRX_N-00654-21761118,2023-07-21T09:23:04,Galdakao,expenses,clothing,-55.65,-26653.04
buyer_4,Jorge,50,ES59209509865436075018,TRX_N-00655-64264441,2023-07-22T10:19:06,Galdakao,expenses,gifts,-210.82,-26863.86
buyer_4,Jorge,50,ES59209509865436075018,TRX_N-00656-00191077,2023-07-24T12:46:40,Galdakao,expenses,clothing,-99.88,-26963.74
buyer_4,Jorge,50,ES59209509865436075018,TRX_N-00657-77412139,2023-07-24T10:53:59,Galdakao,expenses,education,-75.88,-27039.62
buyer_4,Jorge,50,ES59209509865436075018,TRX_N-00658-32806113,2023-07-24T09:46:20,Iruña de Oca,expenses,cash,-100.0,-27139.62
buyer_4,Jorge,50,ES59209509865436075018,TRX_N-00659-14180788,2023-07-25T15:05:28,Galdakao,expenses,healthcare,-172.44,-27312.06
buyer_4,Jorge,50,ES59209509865436075018,TRX_N-00660-47517827,2023-07-26T19:49:38,Labastida,expenses,leisure,-50.4,-27362.46
buyer_4,Jorge,50,ES59209509865436075018,TRX_N-00661-96862844,2023-07-26T23:34:37,Galdakao,expenses,gifts,-567.3,-27929.76
buyer_4,Jorge,50,ES59209509865436075018,TRX_N-00662-59565923,2023-07-27T10:04:23,Galdakao,expenses,transport,-53.19,-27982.95
buyer_4,Jorge,50,ES59209509865436075018,TRX_N-00663-67673291,2023-07-27T11:45:01,Galdakao,expenses,cash,-100.0,-28082.95
buyer_4,Jorge,50,ES59209509865436075018,TRX_N-00664-50172324,2023-07-28T18:49:48,Eibar,expenses,leisure,-22.57,-28105.52
buyer_4,Jorge,50,ES59209509865436075018,TRX_N-00665-18937149,2023-07-31T04:40:30,Galdakao,expenses,appliances,-219.26,-28324.78
buyer_4,Jorge,50,ES59209509865436075018,TRX_N-00666-37305230,2023-08-01T19:51:08,Galdakao,incomes,salary,1441.16,-26883.62
buyer_4,Jorge,50,ES59209509865436075018,TRX_N-00667-65852017,2023-08-01T19:51:08,Galdakao,incomes,salary_partner,1362.02,-25521.6
buyer_4,Jorge,50,ES59209509865436075018,TRX_N-00668-56326955,2023-08-01T22:37:19,Santurtzi,expenses,repairs,-209.95,-25731.55
buyer_4,Jorge,50,ES59209509865436075018,TRX_N-00669-72808990,2023-08-03T14:43:28,Galdakao,expenses,education,-42.51,-25774.06
buyer_4,Jorge,50,ES59209509865436075018,TRX_N-00670-88103371,2023-08-04T12:45:51,Galdakao,expenses,mortgage,-858.17,-26632.23
buyer_4,Jorge,50,ES59209509865436075018,TRX_N-00671-50065741,2023-08-05T15:51:27,Galdakao,expenses,internet,-42.0,-26674.23
buyer_4,Jorge,50,ES59209509865436075018,TRX_N-00672-11059169,2023-08-05T15:06:38,Galdakao,expenses,food,-92.22,-26766.45
buyer_4,Jorge,50,ES59209509865436075018,TRX_N-00673-47293181,2023-08-06T23:53:23,Galdakao,expenses,electricity,-54.2,-26820.65
buyer_4,Jorge,50,ES59209509865436075018,TRX_N-00674-45423706,2023-08-07T06:39:36,Galdakao,expenses,phone,-30.69,-26851.34
buyer_4,Jorge,50,ES59209509865436075018,TRX_N-00675-73453204,2023-08-07T08:23:48,Galdakao,expenses,cash,-100.0,-26951.34
buyer_4,Jorge,50,ES59209509865436075018,TRX_N-00676-57360482,2023-08-08T12:16:29,Galdakao,expenses,water,-28.22,-26979.56
buyer_4,Jorge,50,ES59209509865436075018,TRX_N-00677-05680927,2023-08-08T08:13:32,Galdakao,expenses,gas,-77.54,-27057.1
buyer_4,Jorge,50,ES59209509865436075018,TRX_N-00678-76748517,2023-08-08T11:45:46,Galdakao,expenses,food,-76.96,-27134.06
buyer_4,Jorge,50,ES59209509865436075018,TRX_N-00679-56378785,2023-08-11T12:50:04,Galdakao,expenses,food,-102.55,-27236.61
buyer_4,Jorge,50,ES59209509865436075018,TRX_N-00680-50237516,2023-08-11T19:46:00,Galdakao,expenses,cash,-100.0,-27336.61
buyer_4,Jorge,50,ES59209509865436075018,TRX_N-00681-90039299,2023-08-12T12:09:02,Eibar,expenses,cash,-100.0,-27436.61
buyer_4,Jorge,50,ES59209509865436075018,TRX_N-00682-89828793,2023-08-13T09:50:42,Galdakao,expenses,food,-65.09,-27501.7
buyer_4,Jorge,50,ES59209509865436075018,TRX_N-00683-22972693,2023-08-13T09:06:21,Galdakao,expenses,transport,-50.5,-27552.2
buyer_4,Jorge,50,ES59209509865436075018,TRX_N-00684-25998787,2023-08-15T09:32:14,Galdakao,expenses,gifts,-412.34,-27964.54
buyer_4,Jorge,50,ES59209509865436075018,TRX_N-00685-20002041,2023-08-17T17:35:36,Galdakao,expenses,food,-112.56,-28077.1
buyer_4,Jorge,50,ES59209509865436075018,TRX_N-00686-42812690,2023-08-18T17:34:57,Galdakao,expenses,transport,-53.75,-28130.85
buyer_4,Jorge,50,ES59209509865436075018,TRX_N-00687-35713328,2023-08-18T22:45:38,Galdakao,expenses,education,-78.04,-28208.89
buyer_4,Jorge,50,ES59209509865436075018,TRX_N-00688-96628041,2023-08-20T08:12:21,Arrasate,expenses,cash,-100.0,-28308.89
buyer_4,Jorge,50,ES59209509865436075018,TRX_N-00689-64595372,2023-08-20T14:54:41,Galdakao,expenses,repairs,-56.08,-28364.97
buyer_4,Jorge,50,ES59209509865436075018,TRX_N-00690-47539024,2023-08-21T20:26:32,Errenteria,expenses,leisure,-41.12,-28406.09
buyer_4,Jorge,50,ES59209509865436075018,TRX_N-00691-31143085,2023-08-22T18:38:17,Galdakao,expenses,repairs,-259.89,-28665.98
buyer_4,Jorge,50,ES59209509865436075018,TRX_N-00692-48535551,2023-08-23T14:26:17,Galdakao,expenses,food,-85.55,-28751.53
buyer_4,Jorge,50,ES59209509865436075018,TRX_N-00693-69537595,2023-08-23T11:40:41,Portugalete,expenses,travel,-1378.41,-30129.94
buyer_4,Jorge,50,ES59209509865436075018,TRX_N-00694-15423809,2023-08-26T06:45:35,Galdakao,expenses,gifts,-473.27,-30603.21
buyer_4,Jorge,50,ES59209509865436075018,TRX_N-00695-58711706,2023-08-26T19:01:53,Galdakao,expenses,children,-221.99,-30825.2
buyer_4,Jorge,50,ES59209509865436075018,TRX_N-00696-48015214,2023-08-29T05:47:49,Galdakao,expenses,cash,-100.0,-30925.2
buyer_4,Jorge,50,ES59209509865436075018,TRX_N-00697-32048992,2023-08-30T01:06:30,Sopela,expenses,cash,-100.0,-31025.2
buyer_4,Jorge,50,ES59209509865436075018,TRX_N-00698-43495953,2023-08-31T13:22:06,Galdakao,expenses,healthcare,-155.47,-31180.67
buyer_4,Jorge,50,ES59209509865436075018,TRX_N-00699-06116947,2023-08-31T03:45:45,Galdakao,expenses,cash,-100.0,-31280.67
buyer_4,Jorge,50,ES59209509865436075018,TRX_N-00700-03014847,2023-09-01T13:27:15,Galdakao,incomes,salary,1441.16,-29839.51
buyer_4,Jorge,50,ES59209509865436075018,TRX_N-00701-70788283,2023-09-01T13:27:15,Galdakao,incomes,salary_partner,1362.02,-28477.49
buyer_4,Jorge,50,ES59209509865436075018,TRX_N-00702-45271744,2023-09-02T16:37:08,Iruña de Oca,expenses,appliances,-245.37,-28722.86
buyer_4,Jorge,50,ES59209509865436075018,TRX_N-00703-07453547,2023-09-02T15:34:51,Galdakao,expenses,gifts,-815.91,-29538.77
buyer_4,Jorge,50,ES59209509865436075018,TRX_N-00704-90721290,2023-09-03T20:25:27,Hernani,expenses,cash,-100.0,-29638.77
buyer_4,Jorge,50,ES59209509865436075018,TRX_N-00705-57165222,2023-09-04T15:16:01,Galdakao,expenses,mortgage,-858.17,-30496.94
buyer_4,Jorge,50,ES59209509865436075018,TRX_N-00706-50673478,2023-09-04T05:45:36,Galdakao,expenses,leisure,-36.81,-30533.75
buyer_4,Jorge,50,ES59209509865436075018,TRX_N-00707-23134706,2023-09-04T11:14:59,Galdakao,expenses,children,-95.34,-30629.09
buyer_4,Jorge,50,ES59209509865436075018,TRX_N-00708-89084022,2023-09-05T11:04:28,Galdakao,expenses,electricity,-20.98,-30650.07
buyer_4,Jorge,50,ES59209509865436075018,TRX_N-00709-97523014,2023-09-05T14:43:10,Galdakao,expenses,internet,-42.0,-30692.07
buyer_4,Jorge,50,ES59209509865436075018,TRX_N-00710-16957995,2023-09-05T13:31:20,Galdakao,expenses,phone,-38.83,-30730.9
buyer_4,Jorge,50,ES59209509865436075018,TRX_N-00711-16500673,2023-09-05T14:28:44,Galdakao,expenses,transport,-55.29,-30786.19
buyer_4,Jorge,50,ES59209509865436075018,TRX_N-00712-70325634,2023-09-05T13:11:24,Galdakao,expenses,education,-44.6,-30830.79
buyer_4,Jorge,50,ES59209509865436075018,TRX_N-00713-66842295,2023-09-06T16:09:23,Hernani,expenses,repairs,-97.01,-30927.8
buyer_4,Jorge,50,ES59209509865436075018,TRX_N-00714-03957848,2023-09-06T11:50:18,Galdakao,expenses,gifts,-714.09,-31641.89
buyer_4,Jorge,50,ES59209509865436075018,TRX_N-00715-80811596,2023-09-07T10:28:28,Galdakao,expenses,gas,-104.15,-31746.04
buyer_4,Jorge,50,ES59209509865436075018,TRX_N-00716-29877826,2023-09-08T20:55:38,Galdakao,expenses,water,-28.73,-31774.77
buyer_4,Jorge,50,ES59209509865436075018,TRX_N-00717-98405311,2023-09-08T16:55:55,Donostia,expenses,repairs,-318.45,-32093.22
buyer_4,Jorge,50,ES59209509865436075018,TRX_N-00718-32245246,2023-09-10T01:34:12,Galdakao,expenses,cash,-100.0,-32193.22
buyer_4,Jorge,50,ES59209509865436075018,TRX_N-00719-16427574,2023-09-12T23:05:12,Galdakao,expenses,transport,-47.73,-32240.95
buyer_4,Jorge,50,ES59209509865436075018,TRX_N-00720-86065488,2023-09-13T16:05:54,Galdakao,expenses,food,-77.52,-32318.47
buyer_4,Jorge,50,ES59209509865436075018,TRX_N-00721-64959964,2023-09-14T06:21:22,Galdakao,expenses,repairs,-140.14,-32458.61
buyer_4,Jorge,50,ES59209509865436075018,TRX_N-00722-11146059,2023-09-15T20:34:31,Zarautz,expenses,education,-47.93,-32506.54
buyer_4,Jorge,50,ES59209509865436075018,TRX_N-00723-49425005,2023-09-18T09:55:00,Galdakao,expenses,transport,-64.22,-32570.76
buyer_4,Jorge,50,ES59209509865436075018,TRX_N-00724-72465343,2023-09-23T16:12:30,Galdakao,expenses,cash,-100.0,-32670.76
buyer_4,Jorge,50,ES59209509865436075018,TRX_N-00725-35987765,2023-09-24T16:36:30,Galdakao,expenses,clothing,-148.07,-32818.83
buyer_4,Jorge,50,ES59209509865436075018,TRX_N-00726-14557175,2023-09-24T16:03:05,Galdakao,expenses,repairs,-233.11,-33051.94
buyer_4,Jorge,50,ES59209509865436075018,TRX_N-00727-85144452,2023-09-26T17:25:16,Galdakao,expenses,leisure,-44.45,-33096.39
buyer_4,Jorge,50,ES59209509865436075018,TRX_N-00728-85978022,2023-09-26T13:17:50,Galdakao,expenses,cash,-100.0,-33196.39
buyer_4,Jorge,50,ES59209509865436075018,TRX_N-00729-42894697,2023-09-27T10:59:11,Galdakao,expenses,appliances,-364.99,-33561.38
buyer_4,Jorge,50,ES59209509865436075018,TRX_N-00730-46579665,2023-09-28T13:39:21,Mungia,expenses,leisure,-22.72,-33584.1
buyer_4,Jorge,50,ES59209509865436075018,TRX_N-00731-18349461,2023-09-29T13:26:42,Galdakao,expenses,food,-95.85,-33679.95
buyer_4,Jorge,50,ES59209509865436075018,TRX_N-00732-87138917,2023-09-29T20:40:41,Errenteria,expenses,transport,-43.63,-33723.58
buyer_4,Jorge,50,ES59209509865436075018,TRX_N-00733-45102131,2023-09-29T18:26:38,Berango,expenses,cash,-100.0,-33823.58
buyer_4,Jorge,50,ES59209509865436075018,TRX_N-00734-54661126,2023-10-01T23:35:47,Galdakao,incomes,salary,1441.16,-32382.42
buyer_4,Jorge,50,ES59209509865436075018,TRX_N-00735-60357532,2023-10-01T23:35:47,Galdakao,incomes,salary_partner,1362.02,-31020.4
buyer_4,Jorge,50,ES59209509865436075018,TRX_N-00736-01033592,2023-10-01T23:35:47,Galdakao,incomes,extra_income,189.14,-30831.26
buyer_4,Jorge,50,ES59209509865436075018,TRX_N-00737-32195056,2023-10-02T10:51:40,Galdakao,expenses,food,-65.6,-30896.86
buyer_4,Jorge,50,ES59209509865436075018,TRX_N-00738-68019040,2023-10-02T18:31:01,Galdakao,expenses,transport,-83.33,-30980.19
buyer_4,Jorge,50,ES59209509865436075018,TRX_N-00739-06690016,2023-10-02T03:55:53,Galdakao,expenses,leisure,-62.52,-31042.71
buyer_4,Jorge,50,ES59209509865436075018,TRX_N-00740-84432142,2023-10-03T19:54:04,Mungia,expenses,transport,-81.47,-31124.18
buyer_4,Jorge,50,ES59209509865436075018,TRX_N-00741-87300182,2023-10-03T19:47:23,Hernani,expenses,cash,-100.0,-31224.18
buyer_4,Jorge,50,ES59209509865436075018,TRX_N-00742-71212591,2023-10-04T13:38:49,Galdakao,expenses,mortgage,-858.17,-32082.35
buyer_4,Jorge,50,ES59209509865436075018,TRX_N-00743-84661548,2023-10-05T13:12:58,Galdakao,expenses,clothing,-130.35,-32212.7
buyer_4,Jorge,50,ES59209509865436075018,TRX_N-00744-79899440,2023-10-05T18:58:36,Galdakao,expenses,repairs,-94.04,-32306.74
buyer_4,Jorge,50,ES59209509865436075018,TRX_N-00745-10470116,2023-10-06T17:41:25,Galdakao,expenses,internet,-42.0,-32348.74
buyer_4,Jorge,50,ES59209509865436075018,TRX_N-00746-95039485,2023-10-07T08:40:56,Portugalete,expenses,leisure,-51.98,-32400.72
buyer_4,Jorge,50,ES59209509865436075018,TRX_N-00747-35978892,2023-10-08T12:26:18,Galdakao,expenses,water,-28.77,-32429.49
buyer_4,Jorge,50,ES59209509865436075018,TRX_N-00748-30995605,2023-10-08T14:28:21,Galdakao,expenses,electricity,-41.39,-32470.88
buyer_4,Jorge,50,ES59209509865436075018,TRX_N-00749-28590849,2023-10-08T15:33:11,Galdakao,expenses,gas,-103.56,-32574.44
buyer_4,Jorge,50,ES59209509865436075018,TRX_N-00750-63600304,2023-10-08T07:26:50,Galdakao,expenses,phone,-34.39,-32608.83
buyer_4,Jorge,50,ES59209509865436075018,TRX_N-00751-82295101,2023-10-08T13:38:55,Galdakao,expenses,repairs,-255.41,-32864.24
buyer_4,Jorge,50,ES59209509865436075018,TRX_N-00752-93662535,2023-10-10T12:29:39,Galdakao,expenses,travel,-1344.0,-34208.24
buyer_4,Jorge,50,ES59209509865436075018,TRX_N-00753-90453611,2023-10-12T17:11:33,Zuia,expenses,healthcare,-44.29,-34252.53
buyer_4,Jorge,50,ES59209509865436075018,TRX_N-00754-56948556,2023-10-13T22:57:18,Galdakao,expenses,food,-94.04,-34346.57
buyer_4,Jorge,50,ES59209509865436075018,TRX_N-00755-09094870,2023-10-15T12:55:14,Galdakao,expenses,food,-64.22,-34410.79
buyer_4,Jorge,50,ES59209509865436075018,TRX_N-00756-14907866,2023-10-17T09:15:58,Galdakao,expenses,cash,-100.0,-34510.79
buyer_4,Jorge,50,ES59209509865436075018,TRX_N-00757-06334750,2023-10-17T02:37:49,Galdakao,expenses,gifts,-302.25,-34813.04
buyer_4,Jorge,50,ES59209509865436075018,TRX_N-00758-19960104,2023-10-20T20:58:33,Galdakao,expenses,transport,-41.47,-34854.51
buyer_4,Jorge,50,ES59209509865436075018,TRX_N-00759-46039939,2023-10-22T15:24:36,Galdakao,expenses,cash,-100.0,-34954.51
buyer_4,Jorge,50,ES59209509865436075018,TRX_N-00760-95854480,2023-10-23T14:56:59,Galdakao,expenses,clothing,-88.62,-35043.13
buyer_4,Jorge,50,ES59209509865436075018,TRX_N-00761-89010939,2023-10-24T21:02:55,Mungia,expenses,cash,-100.0,-35143.13
buyer_4,Jorge,50,ES59209509865436075018,TRX_N-00762-18272723,2023-10-26T15:40:28,Pasaia,expenses,transport,-45.7,-35188.83
buyer_4,Jorge,50,ES59209509865436075018,TRX_N-00763-01972008,2023-10-26T13:01:55,Getxo,expenses,gifts,-292.04,-35480.87
buyer_4,Jorge,50,ES59209509865436075018,TRX_N-00764-59499131,2023-10-27T11:11:48,Galdakao,expenses,transport,-45.76,-35526.63
buyer_4,Jorge,50,ES59209509865436075018,TRX_N-00765-11384769,2023-10-29T16:44:32,Galdakao,expenses,food,-116.7,-35643.33
buyer_4,Jorge,50,ES59209509865436075018,TRX_N-00766-75981534,2023-10-29T19:55:47,Galdakao,expenses,leisure,-48.78,-35692.11
buyer_4,Jorge,50,ES59209509865436075018,TRX_N-00767-19503749,2023-11-01T12:37:05,Galdakao,incomes,salary,1441.16,-34250.95
buyer_4,Jorge,50,ES59209509865436075018,TRX_N-00768-75446156,2023-11-01T12:37:05,Galdakao,incomes,salary_partner,1362.02,-32888.93
buyer_4,Jorge,50,ES59209509865436075018,TRX_N-00769-40071806,2023-11-01T14:09:28,Llodio,expenses,repairs,-313.1,-33202.03
buyer_4,Jorge,50,ES59209509865436075018,TRX_N-00770-84379498,2023-11-02T20:15:47,Durango,expenses,food,-78.93,-33280.96
buyer_4,Jorge,50,ES59209509865436075018,TRX_N-00771-75946795,2023-11-02T12:53:10,Galdakao,expenses,gifts,-673.75,-33954.71
buyer_4,Jorge,50,ES59209509865436075018,TRX_N-00772-16012969,2023-11-03T15:18:39,Galdakao,expenses,cash,-100.0,-34054.71
buyer_4,Jorge,50,ES59209509865436075018,TRX_N-00773-20085387,2023-11-03T11:47:19,Galdakao,expenses,appliances,-298.91,-34353.62
buyer_4,Jorge,50,ES59209509865436075018,TRX_N-00774-73654891,2023-11-04T09:23:38,Galdakao,expenses,mortgage,-858.17,-35211.79
buyer_4,Jorge,50,ES59209509865436075018,TRX_N-00775-65316606,2023-11-04T18:37:02,Galdakao,expenses,transport,-63.8,-35275.59
buyer_4,Jorge,50,ES59209509865436075018,TRX_N-00776-45868905,2023-11-05T23:34:37,Galdakao,expenses,leisure,-46.84,-35322.43
buyer_4,Jorge,50,ES59209509865436075018,TRX_N-00777-46104033,2023-11-06T07:44:25,Galdakao,expenses,electricity,-82.29,-35404.72
buyer_4,Jorge,50,ES59209509865436075018,TRX_N-00778-38264005,2023-11-06T15:23:11,Galdakao,expenses,internet,-42.0,-35446.72
buyer_4,Jorge,50,ES59209509865436075018,TRX_N-00779-08500205,2023-11-06T17:37:55,Galdakao,expenses,education,-76.27,-35522.99
buyer_4,Jorge,50,ES59209509865436075018,TRX_N-00780-18023662,2023-11-07T14:38:51,Galdakao,expenses,clothing,-61.0,-35583.99
buyer_4,Jorge,50,ES59209509865436075018,TRX_N-00781-02492840,2023-11-07T10:11:16,Galdakao,expenses,gifts,-260.93,-35844.92
buyer_4,Jorge,50,ES59209509865436075018,TRX_N-00782-91552398,2023-11-08T10:34:55,Galdakao,expenses,water,-42.78,-35887.7
buyer_4,Jorge,50,ES59209509865436075018,TRX_N-00783-44015140,2023-11-08T17:52:10,Galdakao,expenses,gas,-73.02,-35960.72
buyer_4,Jorge,50,ES59209509865436075018,TRX_N-00784-25559698,2023-11-08T01:42:22,Galdakao,expenses,phone,-38.2,-35998.92
buyer_4,Jorge,50,ES59209509865436075018,TRX_N-00785-63226802,2023-11-08T16:26:53,Galdakao,expenses,cash,-100.0,-36098.92
buyer_4,Jorge,50,ES59209509865436075018,TRX_N-00786-82934892,2023-11-11T17:26:00,Sopela,expenses,cash,-100.0,-36198.92
buyer_4,Jorge,50,ES59209509865436075018,TRX_N-00787-52358573,2023-11-13T17:22:56,Galdakao,expenses,repairs,-159.44,-36358.36
buyer_4,Jorge,50,ES59209509865436075018,TRX_N-00788-42460474,2023-11-14T12:23:56,Galdakao,expenses,leisure,-29.71,-36388.07
buyer_4,Jorge,50,ES59209509865436075018,TRX_N-00789-93142697,2023-11-15T18:35:33,Galdakao,expenses,food,-67.57,-36455.64
buyer_4,Jorge,50,ES59209509865436075018,TRX_N-00790-54572958,2023-11-15T18:56:16,Galdakao,expenses,repairs,-226.28,-36681.92
buyer_4,Jorge,50,ES59209509865436075018,TRX_N-00791-62230626,2023-11-16T16:24:38,Vitoria-Gasteiz,expenses,food,-96.38,-36778.3
buyer_4,Jorge,50,ES59209509865436075018,TRX_N-00792-87816680,2023-11-16T15:07:26,Galdakao,expenses,education,-51.48,-36829.78
buyer_4,Jorge,50,ES59209509865436075018,TRX_N-00793-79944764,2023-11-17T16:57:22,Galdakao,expenses,education,-62.01,-36891.79
buyer_4,Jorge,50,ES59209509865436075018,TRX_N-00794-85478382,2023-11-17T16:28:21,Galdakao,expenses,repairs,-64.4,-36956.19
buyer_4,Jorge,50,ES59209509865436075018,TRX_N-00795-06036461,2023-11-18T17:53:54,Hondarribia,expenses,transport,-41.5,-36997.69
buyer_4,Jorge,50,ES59209509865436075018,TRX_N-00796-52350481,2023-11-20T10:47:09,Pasaia,expenses,transport,-67.22,-37064.91
buyer_4,Jorge,50,ES59209509865436075018,TRX_N-00797-28463341,2023-11-20T06:14:27,Galdakao,expenses,clothing,-80.15,-37145.06
buyer_4,Jorge,50,ES59209509865436075018,TRX_N-00798-35403117,2023-11-21T17:32:12,Galdakao,expenses,cash,-100.0,-37245.06
buyer_4,Jorge,50,ES59209509865436075018,TRX_N-00799-15023907,2023-11-22T13:21:42,Galdakao,expenses,leisure,-53.13,-37298.19
buyer_4,Jorge,50,ES59209509865436075018,TRX_N-00800-20597557,2023-11-23T15:26:57,Galdakao,expenses,repairs,-46.6,-37344.79
buyer_4,Jorge,50,ES59209509865436075018,TRX_N-00801-40979187,2023-11-24T17:21:55,Galdakao,expenses,food,-67.16,-37411.95
buyer_4,Jorge,50,ES59209509865436075018,TRX_N-00802-76896019,2023-11-26T12:44:04,Galdakao,expenses,repairs,-34.99,-37446.94
buyer_4,Jorge,50,ES59209509865436075018,TRX_N-00803-07904440,2023-11-28T20:02:22,Galdakao,expenses,food,-92.67,-37539.61
buyer_4,Jorge,50,ES59209509865436075018,TRX_N-00804-41542275,2023-11-28T03:56:43,Galdakao,expenses,leisure,-75.17,-37614.78
buyer_4,Jorge,50,ES59209509865436075018,TRX_N-00805-70455416,2023-11-30T13:48:39,Galdakao,expenses,food,-68.07,-37682.85
buyer_4,Jorge,50,ES59209509865436075018,TRX_N-00806-59473036,2023-11-30T14:54:35,Berango,expenses,transport,-44.88,-37727.73
buyer_4,Jorge,50,ES59209509865436075018,TRX_N-00807-15534421,2023-11-30T14:46:38,Galdakao,expenses,leisure,-38.2,-37765.93
buyer_4,Jorge,50,ES59209509865436075018,TRX_N-00808-94883516,2023-11-30T16:53:28,Bermeo,expenses,cash,-100.0,-37865.93
buyer_4,Jorge,50,ES59209509865436075018,TRX_N-00809-13574114,2023-12-01T15:14:33,Galdakao,incomes,salary,1441.16,-36424.77
buyer_4,Jorge,50,ES59209509865436075018,TRX_N-00810-29578163,2023-12-01T15:14:33,Galdakao,incomes,salary_partner,1362.02,-35062.75
buyer_4,Jorge,50,ES59209509865436075018,TRX_N-00811-98585487,2023-12-01T15:14:33,Galdakao,incomes,salary_bonus,1079.14,-33983.61
buyer_4,Jorge,50,ES59209509865436075018,TRX_N-00812-04609664,2023-12-01T15:14:33,Galdakao,incomes,salary_partner_bonus,953.43,-33030.18
buyer_4,Jorge,50,ES59209509865436075018,TRX_N-00813-39704428,2023-12-01T18:54:06,Galdakao,expenses,cash,-100.0,-33130.18
buyer_4,Jorge,50,ES59209509865436075018,TRX_N-00814-51104015,2023-12-02T23:18:47,Irun,expenses,leisure,-19.34,-33149.52
buyer_4,Jorge,50,ES59209509865436075018,TRX_N-00815-19951157,2023-12-04T22:31:07,Galdakao,expenses,mortgage,-858.17,-34007.69
buyer_4,Jorge,50,ES59209509865436075018,TRX_N-00816-91974579,2023-12-05T10:59:42,Galdakao,expenses,internet,-42.0,-34049.69
buyer_4,Jorge,50,ES59209509865436075018,TRX_N-00817-55541838,2023-12-05T11:53:33,Galdakao,expenses,phone,-43.59,-34093.28
buyer_4,Jorge,50,ES59209509865436075018,TRX_N-00818-06938914,2023-12-05T11:12:33,Galdakao,expenses,repairs,-42.6,-34135.88
buyer_4,Jorge,50,ES59209509865436075018,TRX_N-00819-45799404,2023-12-06T16:57:23,Galdakao,expenses,electricity,-67.71,-34203.59
buyer_4,Jorge,50,ES59209509865436075018,TRX_N-00820-96519975,2023-12-06T11:45:57,Galdakao,expenses,gas,-66.79,-34270.38
buyer_4,Jorge,50,ES59209509865436075018,TRX_N-00821-45566545,2023-12-06T15:48:58,Galdakao,expenses,repairs,-50.95,-34321.33
buyer_4,Jorge,50,ES59209509865436075018,TRX_N-00822-89958587,2023-12-08T17:37:15,Galdakao,expenses,water,-26.96,-34348.29
buyer_4,Jorge,50,ES59209509865436075018,TRX_N-00823-23651204,2023-12-09T18:54:40,Galdakao,expenses,food,-117.72,-34466.01
buyer_4,Jorge,50,ES59209509865436075018,TRX_N-00824-17718308,2023-12-09T18:14:27,Galdakao,expenses,repairs,-303.12,-34769.13
buyer_4,Jorge,50,ES59209509865436075018,TRX_N-00825-66896175,2023-12-10T11:02:26,Arrasate,expenses,repairs,-246.52,-35015.65
buyer_4,Jorge,50,ES59209509865436075018,TRX_N-00826-30558194,2023-12-11T02:04:48,Galdakao,expenses,appliances,-123.74,-35139.39
buyer_4,Jorge,50,ES59209509865436075018,TRX_N-00827-56315928,2023-12-13T20:06:41,Zarautz,expenses,cash,-100.0,-35239.39
buyer_4,Jorge,50,ES59209509865436075018,TRX_N-00828-86337827,2023-12-20T18:25:52,Galdakao,expenses,appliances,-310.32,-35549.71
buyer_4,Jorge,50,ES59209509865436075018,TRX_N-00829-30244804,2023-12-21T08:53:55,Labastida,expenses,transport,-69.5,-35619.21
buyer_4,Jorge,50,ES59209509865436075018,TRX_N-00830-50005741,2023-12-21T20:17:13,Galdakao,expenses,repairs,-191.45,-35810.66
buyer_4,Jorge,50,ES59209509865436075018,TRX_N-00831-18623631,2023-12-24T16:00:06,Galdakao,expenses,repairs,-87.28,-35897.94
buyer_4,Jorge,50,ES59209509865436075018,TRX_N-00832-84664023,2023-12-26T23:04:59,Galdakao,expenses,leisure,-43.83,-35941.77
buyer_4,Jorge,50,ES59209509865436075018,TRX_N-00833-66141892,2023-12-27T16:07:15,Galdakao,expenses,cash,-100.0,-36041.77
buyer_4,Jorge,50,ES59209509865436075018,TRX_N-00834-94965055,2023-12-29T10:35:36,Berango,expenses,clothing,-92.65,-36134.42
buyer_4,Jorge,50,ES59209509865436075018,TRX_N-00835-88210846,2023-12-30T09:35:47,Galdakao,expenses,travel,-404.6,-36539.02
buyer_4,Jorge,50,ES59209509865436075018,TRX_N-00836-22694885,2023-12-31T04:26:53,Galdakao,expenses,leisure,-42.84,-36581.86
buyer_4,Jorge,50,ES59209509865436075018,TRX_N-00837-88163487,2024-01-01T13:35:54,Galdakao,incomes,salary,1485.8,-35096.06
buyer_4,Jorge,50,ES59209509865436075018,TRX_N-00838-44012372,2024-01-01T13:35:54,Galdakao,incomes,salary_partner,1404.21,-33691.85
buyer_4,Jorge,50,ES59209509865436075018,TRX_N-00839-61297787,2024-01-01T18:02:42,Galdakao,expenses,leisure,-79.85,-33771.7
buyer_4,Jorge,50,ES59209509865436075018,TRX_N-00840-77068513,2024-01-03T18:19:59,Galdakao,expenses,cash,-100.0,-33871.7
buyer_4,Jorge,50,ES59209509865436075018,TRX_N-00841-86346239,2024-01-04T15:15:25,Galdakao,expenses,mortgage,-858.17,-34729.87
buyer_4,Jorge,50,ES59209509865436075018,TRX_N-00842-95543094,2024-01-06T12:49:10,Galdakao,expenses,electricity,-52.42,-34782.29
buyer_4,Jorge,50,ES59209509865436075018,TRX_N-00843-64878755,2024-01-07T19:39:14,Galdakao,expenses,phone,-33.42,-34815.71
buyer_4,Jorge,50,ES59209509865436075018,TRX_N-00844-73603348,2024-01-08T13:57:29,Galdakao,expenses,water,-34.2,-34849.91
buyer_4,Jorge,50,ES59209509865436075018,TRX_N-00845-38280824,2024-01-08T13:55:33,Galdakao,expenses,gas,-82.7,-34932.61
buyer_4,Jorge,50,ES59209509865436075018,TRX_N-00846-44724309,2024-01-08T19:39:23,Galdakao,expenses,internet,-42.0,-34974.61
buyer_4,Jorge,50,ES59209509865436075018,TRX_N-00847-77654551,2024-01-08T01:15:00,Galdakao,expenses,leisure,-55.34,-35029.95
buyer_4,Jorge,50,ES59209509865436075018,TRX_N-00848-29171390,2024-01-08T18:35:00,Galdakao,expenses,appliances,-394.7,-35424.65
buyer_4,Jorge,50,ES59209509865436075018,TRX_N-00849-21808166,2024-01-09T20:20:28,Galdakao,expenses,food,-120.59,-35545.24
buyer_4,Jorge,50,ES59209509865436075018,TRX_N-00850-41497015,2024-01-10T17:31:47,Galdakao,expenses,cash,-100.0,-35645.24
buyer_4,Jorge,50,ES59209509865436075018,TRX_N-00851-46122023,2024-01-11T10:02:03,Galdakao,expenses,cash,-100.0,-35745.24
buyer_4,Jorge,50,ES59209509865436075018,TRX_N-00852-00632993,2024-01-13T19:33:40,Galdakao,expenses,gifts,-693.82,-36439.06
buyer_4,Jorge,50,ES59209509865436075018,TRX_N-00853-75113860,2024-01-15T16:10:56,Galdakao,expenses,food,-92.51,-36531.57
buyer_4,Jorge,50,ES59209509865436075018,TRX_N-00854-15432665,2024-01-15T16:25:38,Galdakao,expenses,transport,-74.55,-36606.12
buyer_4,Jorge,50,ES59209509865436075018,TRX_N-00855-35959897,2024-01-17T14:16:09,Galdakao,expenses,food,-94.03,-36700.15
buyer_4,Jorge,50,ES59209509865436075018,TRX_N-00856-44330631,2024-01-18T11:05:40,Portugalete,expenses,transport,-51.54,-36751.69
buyer_4,Jorge,50,ES59209509865436075018,TRX_N-00857-55853856,2024-01-19T09:37:48,Galdakao,expenses,food,-123.75,-36875.44
buyer_4,Jorge,50,ES59209509865436075018,TRX_N-00858-74666214,2024-01-19T08:38:15,Galdakao,expenses,transport,-88.05,-36963.49
buyer_4,Jorge,50,ES59209509865436075018,TRX_N-00859-23837562,2024-01-19T21:00:47,Galdakao,expenses,appliances,-249.96,-37213.45
buyer_4,Jorge,50,ES59209509865436075018,TRX_N-00860-15049557,2024-01-22T02:15:03,Galdakao,expenses,transport,-72.06,-37285.51
buyer_4,Jorge,50,ES59209509865436075018,TRX_N-00861-28645236,2024-01-22T10:06:34,Galdakao,expenses,cash,-100.0,-37385.51
buyer_4,Jorge,50,ES59209509865436075018,TRX_N-00862-58220702,2024-01-23T16:36:55,Galdakao,expenses,leisure,-21.91,-37407.42
buyer_4,Jorge,50,ES59209509865436075018,TRX_N-00863-19620118,2024-01-25T06:13:49,Galdakao,expenses,cash,-100.0,-37507.42
buyer_4,Jorge,50,ES59209509865436075018,TRX_N-00864-28417231,2024-01-25T09:13:24,Galdakao,expenses,repairs,-101.15,-37608.57
buyer_4,Jorge,50,ES59209509865436075018,TRX_N-00865-50648899,2024-01-26T20:07:20,Elciego,expenses,education,-55.79,-37664.36
buyer_4,Jorge,50,ES59209509865436075018,TRX_N-00866-53143344,2024-01-26T12:47:17,Barakaldo,expenses,gifts,-772.5,-38436.86
buyer_4,Jorge,50,ES59209509865436075018,TRX_N-00867-49355726,2024-01-27T09:58:04,Galdakao,expenses,transport,-48.09,-38484.95
buyer_4,Jorge,50,ES59209509865436075018,TRX_N-00868-89772729,2024-01-29T19:34:37,Galdakao,expenses,leisure,-29.83,-38514.78
buyer_4,Jorge,50,ES59209509865436075018,TRX_N-00869-77836199,2024-01-29T18:36:14,Galdakao,expenses,travel,-1626.82,-40141.6
buyer_4,Jorge,50,ES59209509865436075018,TRX_N-00870-61022807,2024-01-31T14:16:59,Galdakao,expenses,education,-50.81,-40192.41
buyer_4,Jorge,50,ES59209509865436075018,TRX_N-00871-17587159,2024-02-01T20:22:18,Galdakao,incomes,salary,1485.8,-38706.61
buyer_4,Jorge,50,ES59209509865436075018,TRX_N-00872-27053156,2024-02-01T20:22:18,Galdakao,incomes,salary_partner,1404.21,-37302.4
buyer_4,Jorge,50,ES59209509865436075018,TRX_N-00873-20535290,2024-02-01T20:22:18,Galdakao,incomes,extra_income,189.14,-37113.26
buyer_4,Jorge,50,ES59209509865436075018,TRX_N-00874-75482769,2024-02-02T12:17:13,Galdakao,expenses,education,-60.64,-37173.9
buyer_4,Jorge,50,ES59209509865436075018,TRX_N-00875-53152267,2024-02-04T13:17:32,Galdakao,expenses,mortgage,-858.17,-38032.07
buyer_4,Jorge,50,ES59209509865436075018,TRX_N-00876-11265774,2024-02-06T11:09:24,Galdakao,expenses,gas,-35.45,-38067.52
buyer_4,Jorge,50,ES59209509865436075018,TRX_N-00877-44829597,2024-02-06T10:30:55,Galdakao,expenses,internet,-42.0,-38109.52
buyer_4,Jorge,50,ES59209509865436075018,TRX_N-00878-34658749,2024-02-06T17:53:08,Galdakao,expenses,food,-120.25,-38229.77
buyer_4,Jorge,50,ES59209509865436075018,TRX_N-00879-77782495,2024-02-06T04:18:18,Galdakao,expenses,transport,-42.82,-38272.59
buyer_4,Jorge,50,ES59209509865436075018,TRX_N-00880-87433419,2024-02-06T10:36:52,Galdakao,expenses,leisure,-24.94,-38297.53
buyer_4,Jorge,50,ES59209509865436075018,TRX_N-00881-30469119,2024-02-08T02:07:53,Galdakao,expenses,water,-29.55,-38327.08
buyer_4,Jorge,50,ES59209509865436075018,TRX_N-00882-91039380,2024-02-08T09:49:41,Galdakao,expenses,electricity,-66.64,-38393.72
buyer_4,Jorge,50,ES59209509865436075018,TRX_N-00883-22154401,2024-02-08T20:50:55,Galdakao,expenses,phone,-43.9,-38437.62
buyer_4,Jorge,50,ES59209509865436075018,TRX_N-00884-10333449,2024-02-08T17:18:43,Zuia,expenses,leisure,-76.81,-38514.43
buyer_4,Jorge,50,ES59209509865436075018,TRX_N-00885-36096404,2024-02-09T18:28:51,Galdakao,expenses,food,-107.75,-38622.18
buyer_4,Jorge,50,ES59209509865436075018,TRX_N-00886-85796877,2024-02-09T10:14:39,Galdakao,expenses,transport,-80.76,-38702.94
buyer_4,Jorge,50,ES59209509865436075018,TRX_N-00887-87192873,2024-02-09T17:15:56,Galdakao,expenses,leisure,-18.16,-38721.1
buyer_4,Jorge,50,ES59209509865436075018,TRX_N-00888-54584498,2024-02-09T12:02:14,Galdakao,expenses,cash,-100.0,-38821.1
buyer_4,Jorge,50,ES59209509865436075018,TRX_N-00889-25071999,2024-02-09T12:36:52,Galdakao,expenses,appliances,-355.14,-39176.24
buyer_4,Jorge,50,ES59209509865436075018,TRX_N-00890-30395305,2024-02-10T15:05:25,Galdakao,expenses,repairs,-288.21,-39464.45
buyer_4,Jorge,50,ES59209509865436075018,TRX_N-00891-98677898,2024-02-11T09:12:38,Galdakao,expenses,cash,-100.0,-39564.45
buyer_4,Jorge,50,ES59209509865436075018,TRX_N-00892-25272639,2024-02-12T11:25:47,Barakaldo,expenses,repairs,-328.71,-39893.16
buyer_4,Jorge,50,ES59209509865436075018,TRX_N-00893-25321834,2024-02-12T16:02:41,Galdakao,expenses,gifts,-658.15,-40551.31
buyer_4,Jorge,50,ES59209509865436075018,TRX_N-00894-80909045,2024-02-13T19:43:01,Galdakao,expenses,food,-102.93,-40654.24
buyer_4,Jorge,50,ES59209509865436075018,TRX_N-00895-84237670,2024-02-14T09:02:18,Alegría-Dulantzi,expenses,cash,-100.0,-40754.24
buyer_4,Jorge,50,ES59209509865436075018,TRX_N-00896-85368955,2024-02-17T08:56:06,Galdakao,expenses,food,-84.0,-40838.24
buyer_4,Jorge,50,ES59209509865436075018,TRX_N-00897-69704265,2024-02-17T13:05:24,Galdakao,expenses,cash,-100.0,-40938.24
buyer_4,Jorge,50,ES59209509865436075018,TRX_N-00898-07057061,2024-02-17T17:41:45,Bilbao,expenses,repairs,-80.34,-41018.58
buyer_4,Jorge,50,ES59209509865436075018,TRX_N-00899-71956204,2024-02-18T12:00:02,Galdakao,expenses,cash,-100.0,-41118.58
buyer_4,Jorge,50,ES59209509865436075018,TRX_N-00900-23086256,2024-02-19T18:18:23,Galdakao,expenses,food,-96.71,-41215.29
buyer_4,Jorge,50,ES59209509865436075018,TRX_N-00901-58486895,2024-02-22T18:14:21,Galdakao,expenses,gifts,-720.75,-41936.04
buyer_4,Jorge,50,ES59209509865436075018,TRX_N-00902-45923168,2024-02-22T09:55:07,Galdakao,expenses,children,-147.94,-42083.98
buyer_4,Jorge,50,ES59209509865436075018,TRX_N-00903-85514770,2024-02-23T17:58:44,Galdakao,expenses,food,-86.54,-42170.52
buyer_4,Jorge,50,ES59209509865436075018,TRX_N-00904-77303697,2024-02-24T20:29:36,Galdakao,expenses,food,-118.13,-42288.65
buyer_4,Jorge,50,ES59209509865436075018,TRX_N-00905-97134642,2024-02-27T13:04:26,Galdakao,expenses,education,-74.32,-42362.97
buyer_4,Jorge,50,ES59209509865436075018,TRX_N-00906-45971276,2024-02-28T18:30:17,Alegría-Dulantzi,expenses,transport,-55.63,-42418.6
buyer_4,Jorge,50,ES59209509865436075018,TRX_N-00907-96659142,2024-02-28T17:08:43,Galdakao,expenses,clothing,-117.9,-42536.5
buyer_4,Jorge,50,ES59209509865436075018,TRX_N-00908-53103366,2024-03-01T19:07:05,Galdakao,incomes,salary,1485.8,-41050.7
buyer_4,Jorge,50,ES59209509865436075018,TRX_N-00909-11051517,2024-03-01T19:07:05,Galdakao,incomes,salary_partner,1404.21,-39646.49
buyer_4,Jorge,50,ES59209509865436075018,TRX_N-00910-58161572,2024-03-01T10:17:30,Galdakao,expenses,appliances,-382.79,-40029.28
buyer_4,Jorge,50,ES59209509865436075018,TRX_N-00911-64721219,2024-03-02T17:37:29,Galdakao,expenses,transport,-56.53,-40085.81
buyer_4,Jorge,50,ES59209509865436075018,TRX_N-00912-53603999,2024-03-03T11:05:35,Galdakao,expenses,education,-54.26,-40140.07
buyer_4,Jorge,50,ES59209509865436075018,TRX_N-00913-40897579,2024-03-04T14:24:58,Galdakao,expenses,mortgage,-858.17,-40998.24
buyer_4,Jorge,50,ES59209509865436075018,TRX_N-00914-96824241,2024-03-05T20:30:45,Galdakao,expenses,water,-39.06,-41037.3
buyer_4,Jorge,50,ES59209509865436075018,TRX_N-00915-17646952,2024-03-05T17:35:18,Galdakao,expenses,phone,-37.37,-41074.67
buyer_4,Jorge,50,ES59209509865436075018,TRX_N-00916-74346625,2024-03-06T20:29:48,Galdakao,expenses,electricity,-78.59,-41153.26
buyer_4,Jorge,50,ES59209509865436075018,TRX_N-00917-80274598,2024-03-06T16:14:51,Galdakao,expenses,internet,-42.0,-41195.26
buyer_4,Jorge,50,ES59209509865436075018,TRX_N-00918-70402895,2024-03-07T20:26:09,Galdakao,expenses,gifts,-629.24,-41824.5
buyer_4,Jorge,50,ES59209509865436075018,TRX_N-00919-66426396,2024-03-08T16:59:47,Galdakao,expenses,gas,-75.33,-41899.83
buyer_4,Jorge,50,ES59209509865436075018,TRX_N-00920-80659869,2024-03-10T16:42:51,Galdakao,expenses,cash,-100.0,-41999.83
buyer_4,Jorge,50,ES59209509865436075018,TRX_N-00921-66963658,2024-03-10T02:25:45,Galdakao,expenses,repairs,-259.15,-42258.98
buyer_4,Jorge,50,ES59209509865436075018,TRX_N-00922-90812890,2024-03-12T19:38:36,Galdakao,expenses,repairs,-295.64,-42554.62
buyer_4,Jorge,50,ES59209509865436075018,TRX_N-00923-39311881,2024-03-13T10:05:40,Galdakao,expenses,food,-113.18,-42667.8
buyer_4,Jorge,50,ES59209509865436075018,TRX_N-00924-25985169,2024-03-13T12:25:26,Galdakao,expenses,repairs,-172.56,-42840.36
buyer_4,Jorge,50,ES59209509865436075018,TRX_N-00925-74006951,2024-03-14T12:00:38,Galdakao,expenses,children,-131.68,-42972.04
buyer_4,Jorge,50,ES59209509865436075018,TRX_N-00926-54607980,2024-03-15T08:12:14,Galdakao,expenses,leisure,-48.19,-43020.23
buyer_4,Jorge,50,ES59209509865436075018,TRX_N-00927-31215151,2024-03-18T21:31:48,Galdakao,expenses,clothing,-87.0,-43107.23
buyer_4,Jorge,50,ES59209509865436075018,TRX_N-00928-59556614,2024-03-18T08:38:26,Galdakao,expenses,healthcare,-135.43,-43242.66
buyer_4,Jorge,50,ES59209509865436075018,TRX_N-00929-40085540,2024-03-19T19:01:34,Galdakao,expenses,repairs,-298.52,-43541.18
buyer_4,Jorge,50,ES59209509865436075018,TRX_N-00930-86875859,2024-03-20T14:45:37,Galdakao,expenses,children,-246.03,-43787.21
buyer_4,Jorge,50,ES59209509865436075018,TRX_N-00931-54532071,2024-03-21T15:16:53,Galdakao,expenses,healthcare,-97.76,-43884.97
buyer_4,Jorge,50,ES59209509865436075018,TRX_N-00932-22628338,2024-03-22T13:52:07,Portugalete,expenses,leisure,-82.17,-43967.14
buyer_4,Jorge,50,ES59209509865436075018,TRX_N-00933-77796099,2024-03-22T11:52:49,Galdakao,expenses,cash,-100.0,-44067.14
buyer_4,Jorge,50,ES59209509865436075018,TRX_N-00934-06563161,2024-03-22T20:00:27,Galdakao,expenses,gifts,-221.67,-44288.81
buyer_4,Jorge,50,ES59209509865436075018,TRX_N-00935-04717887,2024-03-23T16:17:22,Galdakao,expenses,healthcare,-110.04,-44398.85
buyer_4,Jorge,50,ES59209509865436075018,TRX_N-00936-19408010,2024-03-25T08:45:34,Galdakao,expenses,cash,-100.0,-44498.85
buyer_4,Jorge,50,ES59209509865436075018,TRX_N-00937-28851750,2024-03-25T08:08:29,Galdakao,expenses,children,-66.22,-44565.07
buyer_4,Jorge,50,ES59209509865436075018,TRX_N-00938-70578774,2024-03-27T16:16:37,Galdakao,expenses,food,-81.04,-44646.11
buyer_4,Jorge,50,ES59209509865436075018,TRX_N-00939-93310594,2024-03-27T15:01:34,Galdakao,expenses,gifts,-251.02,-44897.13
buyer_4,Jorge,50,ES59209509865436075018,TRX_N-00940-97031836,2024-03-28T18:10:50,Galdakao,expenses,children,-81.17,-44978.3
buyer_4,Jorge,50,ES59209509865436075018,TRX_N-00941-46528539,2024-03-30T10:45:19,Galdakao,expenses,cash,-100.0,-45078.3
buyer_4,Jorge,50,ES59209509865436075018,TRX_N-00942-13673894,2024-04-01T13:47:14,Galdakao,incomes,salary,1485.8,-43592.5
buyer_4,Jorge,50,ES59209509865436075018,TRX_N-00943-99986306,2024-04-01T13:47:14,Galdakao,incomes,salary_partner,1404.21,-42188.29
buyer_4,Jorge,50,ES59209509865436075018,TRX_N-00944-81435720,2024-04-01T18:47:07,Donostia,expenses,leisure,-53.43,-42241.72
buyer_4,Jorge,50,ES59209509865436075018,TRX_N-00945-35849376,2024-04-01T09:46:25,Basauri,expenses,cash,-100.0,-42341.72
buyer_4,Jorge,50,ES59209509865436075018,TRX_N-00946-86715392,2024-04-03T18:27:20,Basauri,expenses,leisure,-34.63,-42376.35
buyer_4,Jorge,50,ES59209509865436075018,TRX_N-00947-78894107,2024-04-03T14:32:25,Galdakao,expenses,cash,-100.0,-42476.35
buyer_4,Jorge,50,ES59209509865436075018,TRX_N-00948-40531576,2024-04-04T22:26:50,Galdakao,expenses,mortgage,-858.17,-43334.52
buyer_4,Jorge,50,ES59209509865436075018,TRX_N-00949-47998653,2024-04-05T15:39:02,Galdakao,expenses,gas,-105.08,-43439.6
buyer_4,Jorge,50,ES59209509865436075018,TRX_N-00950-39862010,2024-04-05T15:03:45,Galdakao,expenses,transport,-84.08,-43523.68
buyer_4,Jorge,50,ES59209509865436075018,TRX_N-00951-56444473,2024-04-06T19:33:14,Galdakao,expenses,phone,-40.85,-43564.53
buyer_4,Jorge,50,ES59209509865436075018,TRX_N-00952-53285761,2024-04-07T18:34:27,Galdakao,expenses,water,-34.78,-43599.31
buyer_4,Jorge,50,ES59209509865436075018,TRX_N-00953-16387396,2024-04-08T20:50:01,Galdakao,expenses,electricity,-51.18,-43650.49
buyer_4,Jorge,50,ES59209509865436075018,TRX_N-00954-09879015,2024-04-08T05:02:24,Galdakao,expenses,internet,-42.0,-43692.49
buyer_4,Jorge,50,ES59209509865436075018,TRX_N-00955-31971650,2024-04-08T13:08:03,Galdakao,expenses,clothing,-118.08,-43810.57
buyer_4,Jorge,50,ES59209509865436075018,TRX_N-00956-17545151,2024-04-09T21:39:17,Galdakao,expenses,leisure,-71.37,-43881.94
buyer_4,Jorge,50,ES59209509865436075018,TRX_N-00957-44382470,2024-04-09T01:47:56,Errenteria,expenses,cash,-100.0,-43981.94
buyer_4,Jorge,50,ES59209509865436075018,TRX_N-00958-32491668,2024-04-13T14:49:34,Galdakao,expenses,education,-64.26,-44046.2
buyer_4,Jorge,50,ES59209509865436075018,TRX_N-00959-83590737,2024-04-13T08:24:19,Salvatierra/Agurain,expenses,repairs,-283.25,-44329.45
buyer_4,Jorge,50,ES59209509865436075018,TRX_N-00960-79335484,2024-04-14T09:49:20,Galdakao,expenses,food,-95.19,-44424.64
buyer_4,Jorge,50,ES59209509865436075018,TRX_N-00961-97163654,2024-04-14T15:07:19,Galdakao,expenses,clothing,-147.46,-44572.1
buyer_4,Jorge,50,ES59209509865436075018,TRX_N-00962-44996529,2024-04-15T20:30:09,Galdakao,expenses,food,-113.75,-44685.85
buyer_4,Jorge,50,ES59209509865436075018,TRX_N-00963-81584469,2024-04-15T14:26:19,Galdakao,expenses,cash,-100.0,-44785.85
buyer_4,Jorge,50,ES59209509865436075018,TRX_N-00964-22185889,2024-04-16T22:48:31,Galdakao,expenses,cash,-100.0,-44885.85
buyer_4,Jorge,50,ES59209509865436075018,TRX_N-00965-98049797,2024-04-19T11:54:25,Galdakao,expenses,transport,-78.57,-44964.42
buyer_4,Jorge,50,ES59209509865436075018,TRX_N-00966-60801945,2024-04-20T09:56:56,Galdakao,expenses,food,-101.2,-45065.62
buyer_4,Jorge,50,ES59209509865436075018,TRX_N-00967-92814857,2024-04-20T09:51:19,Galdakao,expenses,cash,-100.0,-45165.62
buyer_4,Jorge,50,ES59209509865436075018,TRX_N-00968-59839440,2024-04-21T19:08:56,Galdakao,expenses,transport,-88.46,-45254.08
buyer_4,Jorge,50,ES59209509865436075018,TRX_N-00969-29359007,2024-04-21T20:07:11,Galdakao,expenses,clothing,-111.07,-45365.15
buyer_4,Jorge,50,ES59209509865436075018,TRX_N-00970-28267157,2024-04-21T08:31:59,Galdakao,expenses,cash,-100.0,-45465.15
buyer_4,Jorge,50,ES59209509865436075018,TRX_N-00971-26840571,2024-04-21T18:43:01,Galdakao,expenses,appliances,-123.22,-45588.37
buyer_4,Jorge,50,ES59209509865436075018,TRX_N-00972-79561530,2024-04-22T14:41:12,Galdakao,expenses,transport,-41.06,-45629.43
buyer_4,Jorge,50,ES59209509865436075018,TRX_N-00973-28499307,2024-04-23T10:29:31,Galdakao,expenses,food,-93.04,-45722.47
buyer_4,Jorge,50,ES59209509865436075018,TRX_N-00974-76566619,2024-04-24T12:54:03,Galdakao,expenses,appliances,-158.43,-45880.9
buyer_4,Jorge,50,ES59209509865436075018,TRX_N-00975-96325598,2024-04-25T21:39:45,Galdakao,expenses,leisure,-62.21,-45943.11
buyer_4,Jorge,50,ES59209509865436075018,TRX_N-00976-34484828,2024-04-26T08:31:58,Galdakao,expenses,healthcare,-75.64,-46018.75
buyer_4,Jorge,50,ES59209509865436075018,TRX_N-00977-67645443,2024-04-26T09:38:04,Galdakao,expenses,education,-70.35,-46089.1
buyer_4,Jorge,50,ES59209509865436075018,TRX_N-00978-72084043,2024-04-26T08:46:30,Galdakao,expenses,cash,-100.0,-46189.1
buyer_4,Jorge,50,ES59209509865436075018,TRX_N-00979-19816689,2024-04-28T09:10:09,Galdakao,expenses,food,-67.02,-46256.12
buyer_4,Jorge,50,ES59209509865436075018,TRX_N-00980-93264302,2024-04-28T01:52:19,Galdakao,expenses,leisure,-44.6,-46300.72
buyer_4,Jorge,50,ES59209509865436075018,TRX_N-00981-14051746,2024-04-28T15:23:45,Galdakao,expenses,healthcare,-158.08,-46458.8
buyer_4,Jorge,50,ES59209509865436075018,TRX_N-00982-46327890,2024-04-28T14:53:57,Bermeo,expenses,repairs,-305.66,-46764.46
buyer_4,Jorge,50,ES59209509865436075018,TRX_N-00983-80395099,2024-04-29T12:40:46,Galdakao,expenses,cash,-100.0,-46864.46
buyer_4,Jorge,50,ES59209509865436075018,TRX_N-00984-09606884,2024-05-01T23:54:09,Galdakao,incomes,salary,1485.8,-45378.66
buyer_4,Jorge,50,ES59209509865436075018,TRX_N-00985-24125379,2024-05-01T23:54:09,Galdakao,incomes,salary_partner,1404.21,-43974.45
buyer_4,Jorge,50,ES59209509865436075018,TRX_N-00986-39374695,2024-05-01T23:54:09,Galdakao,incomes,extra_income,189.14,-43785.31
buyer_4,Jorge,50,ES59209509865436075018,TRX_N-00987-89844390,2024-05-01T14:09:30,Hernani,expenses,repairs,-30.41,-43815.72
buyer_4,Jorge,50,ES59209509865436075018,TRX_N-00988-24922921,2024-05-02T20:49:23,Galdakao,expenses,cash,-100.0,-43915.72
buyer_4,Jorge,50,ES59209509865436075018,TRX_N-00989-24567095,2024-05-03T08:18:31,Galdakao,expenses,food,-121.1,-44036.82
buyer_4,Jorge,50,ES59209509865436075018,TRX_N-00990-37721430,2024-05-03T22:57:40,Galdakao,expenses,transport,-56.62,-44093.44
buyer_4,Jorge,50,ES59209509865436075018,TRX_N-00991-47331612,2024-05-03T11:02:26,Galdakao,expenses,children,-250.19,-44343.63
buyer_4,Jorge,50,ES59209509865436075018,TRX_N-00992-95089470,2024-05-04T23:08:24,Galdakao,expenses,mortgage,-858.17,-45201.8
buyer_4,Jorge,50,ES59209509865436075018,TRX_N-00993-75768231,2024-05-04T19:35:21,Galdakao,expenses,cash,-100.0,-45301.8
buyer_4,Jorge,50,ES59209509865436075018,TRX_N-00994-86507598,2024-05-05T13:28:46,Galdakao,expenses,leisure,-39.57,-45341.37
buyer_4,Jorge,50,ES59209509865436075018,TRX_N-00995-31906373,2024-05-06T15:39:51,Galdakao,expenses,gas,-111.13,-45452.5
buyer_4,Jorge,50,ES59209509865436075018,TRX_N-00996-41905011,2024-05-08T11:29:27,Galdakao,expenses,internet,-42.0,-45494.5
buyer_4,Jorge,50,ES59209509865436075018,TRX_N-00997-15550358,2024-05-08T13:48:35,Galdakao,expenses,water,-20.65,-45515.15
buyer_4,Jorge,50,ES59209509865436075018,TRX_N-00998-53832348,2024-05-08T08:10:55,Galdakao,expenses,electricity,-47.46,-45562.61
buyer_4,Jorge,50,ES59209509865436075018,TRX_N-00999-43459884,2024-05-08T13:20:01,Galdakao,expenses,phone,-33.97,-45596.58
buyer_4,Jorge,50,ES59209509865436075018,TRX_N-01000-00152871,2024-05-08T22:51:18,Galdakao,expenses,leisure,-72.94,-45669.52
buyer_4,Jorge,50,ES59209509865436075018,TRX_N-01001-17864126,2024-05-08T21:53:34,Arrasate,expenses,cash,-100.0,-45769.52
buyer_4,Jorge,50,ES59209509865436075018,TRX_N-01002-18187699,2024-05-08T11:56:46,Galdakao,expenses,gifts,-178.3,-45947.82
buyer_4,Jorge,50,ES59209509865436075018,TRX_N-01003-10280463,2024-05-09T10:06:32,Galdakao,expenses,cash,-100.0,-46047.82
buyer_4,Jorge,50,ES59209509865436075018,TRX_N-01004-75760664,2024-05-09T22:41:09,Galdakao,expenses,appliances,-107.43,-46155.25
buyer_4,Jorge,50,ES59209509865436075018,TRX_N-01005-25532908,2024-05-11T11:56:40,Galdakao,expenses,food,-120.78,-46276.03
buyer_4,Jorge,50,ES59209509865436075018,TRX_N-01006-31640788,2024-05-11T18:34:52,Galdakao,expenses,transport,-80.21,-46356.24
buyer_4,Jorge,50,ES59209509865436075018,TRX_N-01007-38095241,2024-05-12T20:00:29,Galdakao,expenses,appliances,-103.53,-46459.77
buyer_4,Jorge,50,ES59209509865436075018,TRX_N-01008-88449424,2024-05-14T02:47:32,Galdakao,expenses,repairs,-245.13,-46704.9
buyer_4,Jorge,50,ES59209509865436075018,TRX_N-01009-31102580,2024-05-19T14:49:25,Galdakao,expenses,leisure,-58.98,-46763.88
buyer_4,Jorge,50,ES59209509865436075018,TRX_N-01010-24327815,2024-05-20T09:00:48,Galdakao,expenses,clothing,-154.68,-46918.56
buyer_4,Jorge,50,ES59209509865436075018,TRX_N-01011-29721583,2024-05-20T15:22:19,Galdakao,expenses,cash,-100.0,-47018.56
buyer_4,Jorge,50,ES59209509865436075018,TRX_N-01012-45303983,2024-05-21T19:10:25,Zuia,expenses,food,-120.51,-47139.07
buyer_4,Jorge,50,ES59209509865436075018,TRX_N-01013-38946373,2024-05-21T14:41:07,Galdakao,expenses,repairs,-213.96,-47353.03
buyer_4,Jorge,50,ES59209509865436075018,TRX_N-01014-65631852,2024-05-22T10:39:17,Galdakao,expenses,leisure,-66.71,-47419.74
buyer_4,Jorge,50,ES59209509865436075018,TRX_N-01015-82470840,2024-05-22T08:04:08,Galdakao,expenses,appliances,-107.08,-47526.82
buyer_4,Jorge,50,ES59209509865436075018,TRX_N-01016-36512454,2024-05-24T16:58:07,Galdakao,expenses,food,-98.38,-47625.2
buyer_4,Jorge,50,ES59209509865436075018,TRX_N-01017-90772178,2024-05-24T13:09:41,Galdakao,expenses,repairs,-197.64,-47822.84
buyer_4,Jorge,50,ES59209509865436075018,TRX_N-01018-05360544,2024-05-24T17:53:00,Galdakao,expenses,gifts,-107.31,-47930.15
buyer_4,Jorge,50,ES59209509865436075018,TRX_N-01019-58305774,2024-05-25T09:55:46,Galdakao,expenses,cash,-100.0,-48030.15
buyer_4,Jorge,50,ES59209509865436075018,TRX_N-01020-92441636,2024-05-27T11:08:40,Galdakao,expenses,food,-99.96,-48130.11
buyer_4,Jorge,50,ES59209509865436075018,TRX_N-01021-49482906,2024-05-27T18:53:11,Galdakao,expenses,leisure,-22.22,-48152.33
buyer_4,Jorge,50,ES59209509865436075018,TRX_N-01022-24691530,2024-05-27T05:38:41,Galdakao,expenses,repairs,-314.43,-48466.76
buyer_4,Jorge,50,ES59209509865436075018,TRX_N-01023-66970873,2024-05-27T13:33:51,Galdakao,expenses,children,-242.08,-48708.84
buyer_4,Jorge,50,ES59209509865436075018,TRX_N-01024-15118972,2024-05-29T21:28:30,Galdakao,expenses,food,-97.69,-48806.53
buyer_4,Jorge,50,ES59209509865436075018,TRX_N-01025-15371246,2024-05-30T10:03:49,Galdakao,expenses,cash,-100.0,-48906.53
buyer_4,Jorge,50,ES59209509865436075018,TRX_N-01026-08987584,2024-05-31T12:06:01,Galdakao,expenses,gifts,-506.83,-49413.36
buyer_4,Jorge,50,ES59209509865436075018,TRX_N-01027-22891479,2024-06-01T20:38:38,Galdakao,incomes,salary,1485.8,-47927.56
buyer_4,Jorge,50,ES59209509865436075018,TRX_N-01028-60829470,2024-06-01T20:38:38,Galdakao,incomes,salary_partner,1404.21,-46523.35
buyer_4,Jorge,50,ES59209509865436075018,TRX_N-01029-26618435,2024-06-01T20:38:38,Galdakao,incomes,salary_bonus,1112.05,-45411.3
buyer_4,Jorge,50,ES59209509865436075018,TRX_N-01030-95741460,2024-06-01T20:38:38,Galdakao,incomes,salary_partner_bonus,1107.13,-44304.17
buyer_4,Jorge,50,ES59209509865436075018,TRX_N-01031-05522751,2024-06-01T18:29:24,Galdakao,expenses,food,-116.07,-44420.24
buyer_4,Jorge,50,ES59209509865436075018,TRX_N-01032-13943483,2024-06-01T10:01:47,Galdakao,expenses,leisure,-68.42,-44488.66
buyer_4,Jorge,50,ES59209509865436075018,TRX_N-01033-94273217,2024-06-01T11:15:49,Labastida,expenses,repairs,-254.7,-44743.36
buyer_4,Jorge,50,ES59209509865436075018,TRX_N-01034-40582283,2024-06-01T14:29:11,Galdakao,expenses,children,-240.56,-44983.92
buyer_4,Jorge,50,ES59209509865436075018,TRX_N-01035-45303391,2024-06-02T08:35:44,Galdakao,expenses,education,-46.22,-45030.14
buyer_4,Jorge,50,ES59209509865436075018,TRX_N-01036-28571533,2024-06-04T12:50:56,Galdakao,expenses,mortgage,-858.17,-45888.31
buyer_4,Jorge,50,ES59209509865436075018,TRX_N-01037-77580214,2024-06-04T18:10:06,Galdakao,expenses,travel,-459.47,-46347.78
buyer_4,Jorge,50,ES59209509865436075018,TRX_N-01038-89588116,2024-06-05T08:38:59,Galdakao,expenses,leisure,-76.99,-46424.77
buyer_4,Jorge,50,ES59209509865436075018,TRX_N-01039-45339356,2024-06-05T14:42:36,Galdakao,expenses,cash,-100.0,-46524.77
buyer_4,Jorge,50,ES59209509865436075018,TRX_N-01040-91984895,2024-06-06T08:40:59,Galdakao,expenses,electricity,-31.58,-46556.35
buyer_4,Jorge,50,ES59209509865436075018,TRX_N-01041-63726628,2024-06-06T22:56:10,Galdakao,expenses,food,-114.48,-46670.83
buyer_4,Jorge,50,ES59209509865436075018,TRX_N-01042-25436289,2024-06-08T08:07:12,Galdakao,expenses,gas,-31.66,-46702.49
buyer_4,Jorge,50,ES59209509865436075018,TRX_N-01043-25930577,2024-06-08T08:35:33,Galdakao,expenses,water,-41.29,-46743.78
buyer_4,Jorge,50,ES59209509865436075018,TRX_N-01044-27732912,2024-06-08T15:10:17,Galdakao,expenses,internet,-42.0,-46785.78
buyer_4,Jorge,50,ES59209509865436075018,TRX_N-01045-54526862,2024-06-08T12:53:34,Galdakao,expenses,phone,-30.72,-46816.5
buyer_4,Jorge,50,ES59209509865436075018,TRX_N-01046-46530052,2024-06-08T15:43:44,Galdakao,expenses,transport,-42.47,-46858.97
buyer_4,Jorge,50,ES59209509865436075018,TRX_N-01047-82871171,2024-06-09T12:02:27,Galdakao,expenses,food,-71.64,-46930.61
buyer_4,Jorge,50,ES59209509865436075018,TRX_N-01048-07887832,2024-06-09T17:27:29,Galdakao,expenses,leisure,-68.95,-46999.56
buyer_4,Jorge,50,ES59209509865436075018,TRX_N-01049-15468315,2024-06-09T16:52:27,Galdakao,expenses,cash,-100.0,-47099.56
buyer_4,Jorge,50,ES59209509865436075018,TRX_N-01050-10457179,2024-06-10T19:13:16,Galdakao,expenses,food,-109.15,-47208.71
buyer_4,Jorge,50,ES59209509865436075018,TRX_N-01051-67204234,2024-06-10T09:02:14,Galdakao,expenses,leisure,-47.59,-47256.3
buyer_4,Jorge,50,ES59209509865436075018,TRX_N-01052-34061534,2024-06-10T17:37:40,Galdakao,expenses,cash,-100.0,-47356.3
buyer_4,Jorge,50,ES59209509865436075018,TRX_N-01053-19386846,2024-06-12T18:09:26,Galdakao,expenses,food,-102.45,-47458.75
buyer_4,Jorge,50,ES59209509865436075018,TRX_N-01054-48123726,2024-06-13T20:01:08,Andoain,expenses,clothing,-135.31,-47594.06
buyer_4,Jorge,50,ES59209509865436075018,TRX_N-01055-17340840,2024-06-15T17:44:31,Galdakao,expenses,cash,-100.0,-47694.06
buyer_4,Jorge,50,ES59209509865436075018,TRX_N-01056-99833012,2024-06-15T12:21:51,Galdakao,expenses,appliances,-397.49,-48091.55
buyer_4,Jorge,50,ES59209509865436075018,TRX_N-01057-70116222,2024-06-16T13:48:06,Galdakao,expenses,gifts,-604.47,-48696.02
buyer_4,Jorge,50,ES59209509865436075018,TRX_N-01058-22583431,2024-06-18T14:28:21,Galdakao,expenses,clothing,-143.49,-48839.51
buyer_4,Jorge,50,ES59209509865436075018,TRX_N-01059-62101950,2024-06-19T10:40:30,Galdakao,expenses,cash,-100.0,-48939.51
buyer_4,Jorge,50,ES59209509865436075018,TRX_N-01060-27476531,2024-06-20T15:42:17,Galdakao,expenses,transport,-60.39,-48999.9
buyer_4,Jorge,50,ES59209509865436075018,TRX_N-01061-06587123,2024-06-20T08:51:43,Galdakao,expenses,leisure,-28.42,-49028.32
buyer_4,Jorge,50,ES59209509865436075018,TRX_N-01062-04788826,2024-06-22T19:06:42,Galdakao,expenses,food,-97.49,-49125.81
buyer_4,Jorge,50,ES59209509865436075018,TRX_N-01063-61958927,2024-06-22T17:39:05,Galdakao,expenses,clothing,-73.91,-49199.72
buyer_4,Jorge,50,ES59209509865436075018,TRX_N-01064-99158553,2024-06-22T14:34:54,Arrasate,expenses,cash,-100.0,-49299.72
buyer_4,Jorge,50,ES59209509865436075018,TRX_N-01065-38615379,2024-06-24T13:07:46,Galdakao,expenses,leisure,-57.14,-49356.86
buyer_4,Jorge,50,ES59209509865436075018,TRX_N-01066-45566252,2024-06-25T02:32:51,Oyón-Oion,expenses,travel,-1490.6,-50847.46
buyer_4,Jorge,50,ES59209509865436075018,TRX_N-01067-88999304,2024-06-26T12:10:44,Portugalete,expenses,transport,-58.66,-50906.12
buyer_4,Jorge,50,ES59209509865436075018,TRX_N-01068-88669107,2024-06-27T15:53:18,Galdakao,expenses,transport,-87.94,-50994.06
buyer_4,Jorge,50,ES59209509865436075018,TRX_N-01069-95472658,2024-06-29T13:52:35,Galdakao,expenses,leisure,-57.5,-51051.56
buyer_4,Jorge,50,ES59209509865436075018,TRX_N-01070-01089620,2024-06-29T10:22:09,Galdakao,expenses,travel,-1724.08,-52775.64
buyer_4,Jorge,50,ES59209509865436075018,TRX_N-01071-47652746,2024-06-29T00:29:32,Galdakao,expenses,repairs,-261.15,-53036.79
buyer_4,Jorge,50,ES59209509865436075018,TRX_N-01072-77934235,2024-07-01T20:07:13,Galdakao,incomes,salary,1485.8,-51550.99
buyer_4,Jorge,50,ES59209509865436075018,TRX_N-01073-14165839,2024-07-01T20:07:13,Galdakao,incomes,salary_partner,1404.21,-50146.78
buyer_4,Jorge,50,ES59209509865436075018,TRX_N-01074-46102025,2024-07-01T13:17:11,Galdakao,expenses,clothing,-59.02,-50205.8
buyer_4,Jorge,50,ES59209509865436075018,TRX_N-01075-38030445,2024-07-02T08:13:58,Vitoria-Gasteiz,expenses,gifts,-642.73,-50848.53
buyer_4,Jorge,50,ES59209509865436075018,TRX_N-01076-13426830,2024-07-03T09:43:31,Durango,expenses,education,-57.74,-50906.27
buyer_4,Jorge,50,ES59209509865436075018,TRX_N-01077-12137377,2024-07-03T09:05:48,Galdakao,expenses,cash,-100.0,-51006.27
buyer_4,Jorge,50,ES59209509865436075018,TRX_N-01078-10126708,2024-07-04T16:19:26,Galdakao,expenses,mortgage,-858.17,-51864.44
buyer_4,Jorge,50,ES59209509865436075018,TRX_N-01079-84434467,2024-07-04T10:30:23,Galdakao,expenses,transport,-51.16,-51915.6
buyer_4,Jorge,50,ES59209509865436075018,TRX_N-01080-36851578,2024-07-04T08:05:31,Galdakao,expenses,cash,-100.0,-52015.6
buyer_4,Jorge,50,ES59209509865436075018,TRX_N-01081-36227481,2024-07-05T18:44:37,Galdakao,expenses,food,-79.92,-52095.52
buyer_4,Jorge,50,ES59209509865436075018,TRX_N-01082-15462249,2024-07-05T09:17:58,Galdakao,expenses,leisure,-74.93,-52170.45
buyer_4,Jorge,50,ES59209509865436075018,TRX_N-01083-68314432,2024-07-05T21:31:17,Galdakao,expenses,cash,-100.0,-52270.45
buyer_4,Jorge,50,ES59209509865436075018,TRX_N-01084-72548627,2024-07-07T19:35:39,Galdakao,expenses,gas,-81.88,-52352.33
buyer_4,Jorge,50,ES59209509865436075018,TRX_N-01085-11428731,2024-07-08T16:44:41,Galdakao,expenses,water,-31.41,-52383.74
buyer_4,Jorge,50,ES59209509865436075018,TRX_N-01086-88034951,2024-07-08T11:24:43,Galdakao,expenses,electricity,-64.33,-52448.07
buyer_4,Jorge,50,ES59209509865436075018,TRX_N-01087-39238108,2024-07-08T17:23:52,Galdakao,expenses,internet,-42.0,-52490.07
buyer_4,Jorge,50,ES59209509865436075018,TRX_N-01088-83052255,2024-07-08T20:05:16,Galdakao,expenses,phone,-38.14,-52528.21
buyer_4,Jorge,50,ES59209509865436075018,TRX_N-01089-10833709,2024-07-10T11:09:23,Galdakao,expenses,cash,-100.0,-52628.21
buyer_4,Jorge,50,ES59209509865436075018,TRX_N-01090-98129384,2024-07-11T16:04:20,Galdakao,expenses,food,-92.26,-52720.47
buyer_4,Jorge,50,ES59209509865436075018,TRX_N-01091-52549679,2024-07-12T13:42:48,Galdakao,expenses,transport,-74.32,-52794.79
buyer_4,Jorge,50,ES59209509865436075018,TRX_N-01092-87155874,2024-07-12T13:27:44,Galdakao,expenses,cash,-100.0,-52894.79
buyer_4,Jorge,50,ES59209509865436075018,TRX_N-01093-08101354,2024-07-14T15:29:32,Galdakao,expenses,cash,-100.0,-52994.79
buyer_4,Jorge,50,ES59209509865436075018,TRX_N-01094-94480467,2024-07-15T17:04:07,Galdakao,expenses,cash,-100.0,-53094.79
buyer_4,Jorge,50,ES59209509865436075018,TRX_N-01095-89294804,2024-07-15T14:03:38,Galdakao,expenses,repairs,-27.95,-53122.74
buyer_4,Jorge,50,ES59209509865436075018,TRX_N-01096-37959244,2024-07-16T11:07:33,Galdakao,expenses,healthcare,-59.4,-53182.14
buyer_4,Jorge,50,ES59209509865436075018,TRX_N-01097-81948537,2024-07-17T17:43:11,Galdakao,expenses,healthcare,-151.0,-53333.14
buyer_4,Jorge,50,ES59209509865436075018,TRX_N-01098-17218530,2024-07-18T19:05:20,Barakaldo,expenses,clothing,-53.98,-53387.12
buyer_4,Jorge,50,ES59209509865436075018,TRX_N-01099-50877416,2024-07-20T10:06:58,Galdakao,expenses,cash,-100.0,-53487.12
buyer_4,Jorge,50,ES59209509865436075018,TRX_N-01100-12429429,2024-07-20T23:30:33,Galdakao,expenses,gifts,-56.71,-53543.83
buyer_4,Jorge,50,ES59209509865436075018,TRX_N-01101-08034638,2024-07-22T18:51:46,Errenteria,expenses,travel,-280.93,-53824.76
buyer_4,Jorge,50,ES59209509865436075018,TRX_N-01102-11798096,2024-07-24T08:21:26,Llodio,expenses,transport,-76.25,-53901.01
buyer_4,Jorge,50,ES59209509865436075018,TRX_N-01103-15120692,2024-07-25T23:19:36,Galdakao,expenses,transport,-75.51,-53976.52
buyer_4,Jorge,50,ES59209509865436075018,TRX_N-01104-03400488,2024-07-25T12:04:45,Galdakao,expenses,gifts,-682.39,-54658.91
buyer_4,Jorge,50,ES59209509865436075018,TRX_N-01105-28559038,2024-07-26T11:51:19,Galdakao,expenses,food,-82.64,-54741.55
buyer_4,Jorge,50,ES59209509865436075018,TRX_N-01106-61081762,2024-07-26T00:58:28,Galdakao,expenses,leisure,-54.08,-54795.63
buyer_4,Jorge,50,ES59209509865436075018,TRX_N-01107-07885484,2024-07-28T09:19:53,Galdakao,expenses,leisure,-32.84,-54828.47
buyer_4,Jorge,50,ES59209509865436075018,TRX_N-01108-43432379,2024-07-28T16:15:12,Galdakao,expenses,education,-64.42,-54892.89
buyer_4,Jorge,50,ES59209509865436075018,TRX_N-01109-87437192,2024-07-28T19:15:30,Galdakao,expenses,gifts,-416.72,-55309.61
buyer_4,Jorge,50,ES59209509865436075018,TRX_N-01110-26267654,2024-07-29T21:15:26,Hondarribia,expenses,transport,-44.5,-55354.11
buyer_4,Jorge,50,ES59209509865436075018,TRX_N-01111-68326544,2024-07-29T15:35:04,Galdakao,expenses,cash,-100.0,-55454.11
buyer_4,Jorge,50,ES59209509865436075018,TRX_N-01112-55900244,2024-07-29T10:36:13,Galdakao,expenses,appliances,-303.16,-55757.27
buyer_4,Jorge,50,ES59209509865436075018,TRX_N-01113-31877750,2024-07-30T17:04:55,Iruña de Oca,expenses,food,-81.72,-55838.99
buyer_4,Jorge,50,ES59209509865436075018,TRX_N-01114-50554930,2024-07-30T08:11:40,Galdakao,expenses,leisure,-66.13,-55905.12
buyer_4,Jorge,50,ES59209509865436075018,TRX_N-01115-68874136,2024-07-31T19:02:08,Galdakao,expenses,appliances,-124.65,-56029.77
buyer_4,Jorge,50,ES59209509865436075018,TRX_N-01116-41298581,2024-08-01T23:35:51,Galdakao,incomes,salary,1485.8,-54543.97
buyer_4,Jorge,50,ES59209509865436075018,TRX_N-01117-71800483,2024-08-01T23:35:51,Galdakao,incomes,salary_partner,1404.21,-53139.76
buyer_4,Jorge,50,ES59209509865436075018,TRX_N-01118-64718025,2024-08-01T23:35:51,Galdakao,incomes,extra_income,189.14,-52950.62
buyer_4,Jorge,50,ES59209509865436075018,TRX_N-01119-95715002,2024-08-01T09:14:57,Galdakao,expenses,transport,-82.11,-53032.73
buyer_4,Jorge,50,ES59209509865436075018,TRX_N-01120-02206079,2024-08-02T21:53:33,Galdakao,expenses,food,-71.2,-53103.93
buyer_4,Jorge,50,ES59209509865436075018,TRX_N-01121-16843459,2024-08-03T00:13:45,Galdakao,expenses,transport,-86.23,-53190.16
buyer_4,Jorge,50,ES59209509865436075018,TRX_N-01122-94462935,2024-08-03T11:50:05,Galdakao,expenses,clothing,-131.23,-53321.39
buyer_4,Jorge,50,ES59209509865436075018,TRX_N-01123-46396582,2024-08-04T14:05:25,Galdakao,expenses,mortgage,-858.17,-54179.56
buyer_4,Jorge,50,ES59209509865436075018,TRX_N-01124-28142790,2024-08-04T13:35:44,Galdakao,expenses,food,-79.5,-54259.06
buyer_4,Jorge,50,ES59209509865436075018,TRX_N-01125-25815672,2024-08-04T12:48:28,Galdakao,expenses,travel,-868.96,-55128.02
buyer_4,Jorge,50,ES59209509865436075018,TRX_N-01126-07697548,2024-08-05T19:55:19,Galdakao,expenses,internet,-42.0,-55170.02
buyer_4,Jorge,50,ES59209509865436075018,TRX_N-01127-22588009,2024-08-06T12:04:59,Galdakao,expenses,food,-82.1,-55252.12
buyer_4,Jorge,50,ES59209509865436075018,TRX_N-01128-12497685,2024-08-07T11:58:34,Galdakao,expenses,gas,-73.14,-55325.26
buyer_4,Jorge,50,ES59209509865436075018,TRX_N-01129-10363526,2024-08-07T11:15:52,Mungia,expenses,food,-73.59,-55398.85
buyer_4,Jorge,50,ES59209509865436075018,TRX_N-01130-93519396,2024-08-07T14:31:00,Galdakao,expenses,cash,-100.0,-55498.85
buyer_4,Jorge,50,ES59209509865436075018,TRX_N-01131-44117976,2024-08-07T15:41:38,Zarautz,expenses,repairs,-149.27,-55648.12
buyer_4,Jorge,50,ES59209509865436075018,TRX_N-01132-91273423,2024-08-08T17:51:14,Galdakao,expenses,electricity,-56.07,-55704.19
buyer_4,Jorge,50,ES59209509865436075018,TRX_N-01133-79276760,2024-08-08T22:05:02,Galdakao,expenses,water,-32.5,-55736.69
buyer_4,Jorge,50,ES59209509865436075018,TRX_N-01134-29868856,2024-08-08T20:22:03,Galdakao,expenses,phone,-42.6,-55779.29
buyer_4,Jorge,50,ES59209509865436075018,TRX_N-01135-16421533,2024-08-08T13:19:08,Galdakao,expenses,cash,-100.0,-55879.29
buyer_4,Jorge,50,ES59209509865436075018,TRX_N-01136-27199735,2024-08-08T17:37:54,Galdakao,expenses,travel,-717.57,-56596.86
buyer_4,Jorge,50,ES59209509865436075018,TRX_N-01137-79258061,2024-08-11T12:43:22,Galdakao,expenses,children,-112.69,-56709.55
buyer_4,Jorge,50,ES59209509865436075018,TRX_N-01138-31817159,2024-08-12T16:01:18,Galdakao,expenses,repairs,-244.44,-56953.99
buyer_4,Jorge,50,ES59209509865436075018,TRX_N-01139-00541394,2024-08-13T12:52:55,Galdakao,expenses,gifts,-259.21,-57213.2
buyer_4,Jorge,50,ES59209509865436075018,TRX_N-01140-85755955,2024-08-14T16:15:45,Hondarribia,expenses,food,-85.78,-57298.98
buyer_4,Jorge,50,ES59209509865436075018,TRX_N-01141-58769000,2024-08-16T21:53:08,Galdakao,expenses,food,-97.07,-57396.05
buyer_4,Jorge,50,ES59209509865436075018,TRX_N-01142-01540692,2024-08-16T07:11:58,Hernani,expenses,cash,-100.0,-57496.05
buyer_4,Jorge,50,ES59209509865436075018,TRX_N-01143-90345556,2024-08-17T14:52:46,Andoain,expenses,transport,-88.31,-57584.36
buyer_4,Jorge,50,ES59209509865436075018,TRX_N-01144-61841889,2024-08-17T13:13:18,Hernani,expenses,leisure,-41.58,-57625.94
buyer_4,Jorge,50,ES59209509865436075018,TRX_N-01145-33637155,2024-08-18T22:54:52,Galdakao,expenses,cash,-100.0,-57725.94
buyer_4,Jorge,50,ES59209509865436075018,TRX_N-01146-99652153,2024-08-20T13:11:02,Sestao,expenses,cash,-100.0,-57825.94
buyer_4,Jorge,50,ES59209509865436075018,TRX_N-01147-53721422,2024-08-21T08:32:27,Galdakao,expenses,cash,-100.0,-57925.94
buyer_4,Jorge,50,ES59209509865436075018,TRX_N-01148-68872641,2024-08-25T13:03:37,Durango,expenses,gifts,-159.7,-58085.64
buyer_4,Jorge,50,ES59209509865436075018,TRX_N-01149-50037927,2024-08-27T12:20:42,Galdakao,expenses,repairs,-88.39,-58174.03
buyer_4,Jorge,50,ES59209509865436075018,TRX_N-01150-30641785,2024-08-28T22:22:00,Lasarte-Oria,expenses,repairs,-101.54,-58275.57
buyer_4,Jorge,50,ES59209509865436075018,TRX_N-01151-10235489,2024-08-31T09:31:13,Galdakao,expenses,food,-103.0,-58378.57
buyer_4,Jorge,50,ES59209509865436075018,TRX_N-01152-39160131,2024-09-01T20:32:09,Galdakao,incomes,salary,1485.8,-56892.77
buyer_4,Jorge,50,ES59209509865436075018,TRX_N-01153-83437034,2024-09-01T20:32:09,Galdakao,incomes,salary_partner,1404.21,-55488.56
buyer_4,Jorge,50,ES59209509865436075018,TRX_N-01154-00360433,2024-09-01T20:18:12,Galdakao,expenses,leisure,-42.28,-55530.84
buyer_4,Jorge,50,ES59209509865436075018,TRX_N-01155-67920963,2024-09-02T16:33:05,Galdakao,expenses,cash,-100.0,-55630.84
buyer_4,Jorge,50,ES59209509865436075018,TRX_N-01156-36893635,2024-09-03T13:08:04,Galdakao,expenses,food,-79.72,-55710.56
buyer_4,Jorge,50,ES59209509865436075018,TRX_N-01157-26415564,2024-09-03T18:40:07,Galdakao,expenses,cash,-100.0,-55810.56
buyer_4,Jorge,50,ES59209509865436075018,TRX_N-01158-95388287,2024-09-04T22:05:24,Galdakao,expenses,mortgage,-858.17,-56668.73
buyer_4,Jorge,50,ES59209509865436075018,TRX_N-01159-94616089,2024-09-04T15:17:21,Galdakao,expenses,cash,-100.0,-56768.73
buyer_4,Jorge,50,ES59209509865436075018,TRX_N-01160-09339767,2024-09-05T17:05:10,Galdakao,expenses,gas,-73.44,-56842.17
buyer_4,Jorge,50,ES59209509865436075018,TRX_N-01161-47750892,2024-09-05T19:52:49,Galdakao,expenses,internet,-42.0,-56884.17
buyer_4,Jorge,50,ES59209509865436075018,TRX_N-01162-40138567,2024-09-05T13:40:42,Galdakao,expenses,cash,-100.0,-56984.17
buyer_4,Jorge,50,ES59209509865436075018,TRX_N-01163-79349978,2024-09-06T12:44:29,Galdakao,expenses,water,-28.48,-57012.65
buyer_4,Jorge,50,ES59209509865436075018,TRX_N-01164-65297209,2024-09-07T22:47:48,Galdakao,expenses,food,-86.05,-57098.7
buyer_4,Jorge,50,ES59209509865436075018,TRX_N-01165-16267868,2024-09-07T16:23:28,Galdakao,expenses,cash,-100.0,-57198.7
buyer_4,Jorge,50,ES59209509865436075018,TRX_N-01166-45800680,2024-09-08T14:03:26,Galdakao,expenses,electricity,-71.87,-57270.57
buyer_4,Jorge,50,ES59209509865436075018,TRX_N-01167-37373586,2024-09-08T17:58:29,Galdakao,expenses,phone,-39.06,-57309.63
buyer_4,Jorge,50,ES59209509865436075018,TRX_N-01168-11723936,2024-09-08T18:34:58,Galdakao,expenses,food,-103.95,-57413.58
buyer_4,Jorge,50,ES59209509865436075018,TRX_N-01169-22099156,2024-09-08T10:37:21,Galdakao,expenses,children,-92.39,-57505.97
buyer_4,Jorge,50,ES59209509865436075018,TRX_N-01170-64476815,2024-09-11T20:24:58,Galdakao,expenses,transport,-66.76,-57572.73
buyer_4,Jorge,50,ES59209509865436075018,TRX_N-01171-24381565,2024-09-11T15:56:25,Galdakao,expenses,cash,-100.0,-57672.73
buyer_4,Jorge,50,ES59209509865436075018,TRX_N-01172-93348268,2024-09-12T08:43:40,Galdakao,expenses,leisure,-63.67,-57736.4
buyer_4,Jorge,50,ES59209509865436075018,TRX_N-01173-44607866,2024-09-14T22:41:39,Galdakao,expenses,clothing,-122.29,-57858.69
buyer_4,Jorge,50,ES59209509865436075018,TRX_N-01174-52032385,2024-09-15T18:18:48,Galdakao,expenses,food,-123.64,-57982.33
buyer_4,Jorge,50,ES59209509865436075018,TRX_N-01175-73988694,2024-09-15T08:10:48,Galdakao,expenses,leisure,-27.03,-58009.36
buyer_4,Jorge,50,ES59209509865436075018,TRX_N-01176-81781532,2024-09-17T14:54:14,Getxo,expenses,transport,-62.81,-58072.17
buyer_4,Jorge,50,ES59209509865436075018,TRX_N-01177-15815878,2024-09-17T20:28:44,Galdakao,expenses,travel,-596.34,-58668.51
buyer_4,Jorge,50,ES59209509865436075018,TRX_N-01178-76299209,2024-09-18T18:46:22,Bermeo,expenses,transport,-71.23,-58739.74
buyer_4,Jorge,50,ES59209509865436075018,TRX_N-01179-92162563,2024-09-19T21:56:51,Galdakao,expenses,cash,-100.0,-58839.74
buyer_4,Jorge,50,ES59209509865436075018,TRX_N-01180-97378927,2024-09-21T22:12:35,Galdakao,expenses,gifts,-200.83,-59040.57
buyer_4,Jorge,50,ES59209509865436075018,TRX_N-01181-14929422,2024-09-23T03:22:53,Zarautz,expenses,cash,-100.0,-59140.57
buyer_4,Jorge,50,ES59209509865436075018,TRX_N-01182-76853634,2024-09-26T11:36:25,Galdakao,expenses,food,-70.97,-59211.54
buyer_4,Jorge,50,ES59209509865436075018,TRX_N-01183-79571377,2024-09-27T10:19:29,Galdakao,expenses,leisure,-50.37,-59261.91
buyer_4,Jorge,50,ES59209509865436075018,TRX_N-01184-10140564,2024-09-28T16:26:15,Galdakao,expenses,transport,-77.47,-59339.38
buyer_4,Jorge,50,ES59209509865436075018,TRX_N-01185-00458406,2024-09-28T20:53:57,Basauri,expenses,cash,-100.0,-59439.38
buyer_4,Jorge,50,ES59209509865436075018,TRX_N-01186-34462986,2024-09-30T21:15:27,Galdakao,expenses,cash,-100.0,-59539.38
buyer_4,Jorge,50,ES59209509865436075018,TRX_N-01187-03687790,2024-10-01T00:26:47,Galdakao,incomes,salary,1485.8,-58053.58
buyer_4,Jorge,50,ES59209509865436075018,TRX_N-01188-09984234,2024-10-01T00:26:47,Galdakao,incomes,salary_partner,1404.21,-56649.37
buyer_4,Jorge,50,ES59209509865436075018,TRX_N-01189-60615309,2024-10-01T14:02:44,Galdakao,expenses,children,-211.62,-56860.99
buyer_4,Jorge,50,ES59209509865436075018,TRX_N-01190-94373928,2024-10-02T17:07:37,Labastida,expenses,cash,-100.0,-56960.99
buyer_4,Jorge,50,ES59209509865436075018,TRX_N-01191-52975045,2024-10-02T17:41:40,Galdakao,expenses,children,-51.45,-57012.44
buyer_4,Jorge,50,ES59209509865436075018,TRX_N-01192-15242918,2024-10-03T17:36:05,Galdakao,expenses,transport,-80.99,-57093.43
buyer_4,Jorge,50,ES59209509865436075018,TRX_N-01193-38081598,2024-10-04T08:40:11,Galdakao,expenses,mortgage,-858.17,-57951.6
buyer_4,Jorge,50,ES59209509865436075018,TRX_N-01194-08688124,2024-10-05T17:59:06,Galdakao,expenses,internet,-42.0,-57993.6
buyer_4,Jorge,50,ES59209509865436075018,TRX_N-01195-64848816,2024-10-05T20:38:41,Galdakao,expenses,food,-116.19,-58109.79
buyer_4,Jorge,50,ES59209509865436075018,TRX_N-01196-43439319,2024-10-06T15:30:49,Galdakao,expenses,gas,-106.81,-58216.6
buyer_4,Jorge,50,ES59209509865436075018,TRX_N-01197-08545285,2024-10-06T20:16:12,Galdakao,expenses,phone,-44.57,-58261.17
buyer_4,Jorge,50,ES59209509865436075018,TRX_N-01198-62128664,2024-10-06T23:02:22,Galdakao,expenses,food,-65.48,-58326.65
buyer_4,Jorge,50,ES59209509865436075018,TRX_N-01199-20276309,2024-10-06T12:45:54,Galdakao,expenses,transport,-60.05,-58386.7
buyer_4,Jorge,50,ES59209509865436075018,TRX_N-01200-78682108,2024-10-06T11:50:54,Galdakao,expenses,clothing,-126.36,-58513.06
buyer_4,Jorge,50,ES59209509865436075018,TRX_N-01201-02276963,2024-10-07T19:41:06,Bilbao,expenses,clothing,-102.99,-58616.05
buyer_4,Jorge,50,ES59209509865436075018,TRX_N-01202-60699691,2024-10-08T13:39:34,Galdakao,expenses,water,-27.68,-58643.73
buyer_4,Jorge,50,ES59209509865436075018,TRX_N-01203-15317785,2024-10-08T13:19:55,Galdakao,expenses,electricity,-26.87,-58670.6
buyer_4,Jorge,50,ES59209509865436075018,TRX_N-01204-44825687,2024-10-08T23:44:17,Galdakao,expenses,food,-115.07,-58785.67
buyer_4,Jorge,50,ES59209509865436075018,TRX_N-01205-17454115,2024-10-08T16:15:12,Galdakao,expenses,transport,-41.94,-58827.61
buyer_5,Sara,30,ES70209577946926284453,TRX_N-00001-53333208,2022-01-01T08:14:40,Donostia,incomes,salary,1284.22,2793.85
buyer_5,Sara,30,ES70209577946926284453,TRX_N-00002-02271732,2022-01-01T08:14:40,Donostia,incomes,salary_partner,1678.59,4472.44
buyer_5,Sara,30,ES70209577946926284453,TRX_N-00003-91352838,2022-01-01T16:51:19,Salvatierra/Agurain,expenses,clothing,-138.6,4333.84
buyer_5,Sara,30,ES70209577946926284453,TRX_N-00004-02780455,2022-01-01T17:20:03,Donostia,expenses,education,-54.44,4279.4
buyer_5,Sara,30,ES70209577946926284453,TRX_N-00005-51477945,2022-01-02T11:13:57,Donostia,expenses,food,-73.1,4206.3
buyer_5,Sara,30,ES70209577946926284453,TRX_N-00006-34266639,2022-01-02T18:50:14,Donostia,expenses,cash,-100.0,4106.3
buyer_5,Sara,30,ES70209577946926284453,TRX_N-00007-36505287,2022-01-03T16:45:18,Donostia,expenses,clothing,-122.25,3984.05
buyer_5,Sara,30,ES70209577946926284453,TRX_N-00008-80765280,2022-01-03T15:34:31,Donostia,expenses,children,-220.68,3763.37
buyer_5,Sara,30,ES70209577946926284453,TRX_N-00009-49907162,2022-01-04T06:28:17,Donostia,expenses,mortgage,-897.77,2865.6
buyer_5,Sara,30,ES70209577946926284453,TRX_N-00010-05372979,2022-01-05T09:56:09,Donostia,expenses,electricity,-44.9,2820.7
buyer_5,Sara,30,ES70209577946926284453,TRX_N-00011-94336716,2022-01-06T10:30:46,Donostia,expenses,gas,-65.77,2754.93
buyer_5,Sara,30,ES70209577946926284453,TRX_N-00012-65287387,2022-01-06T19:06:15,Donostia,expenses,food,-106.0,2648.93
buyer_5,Sara,30,ES70209577946926284453,TRX_N-00013-64050187,2022-01-06T11:51:24,Donostia,expenses,transport,-65.2,2583.73
buyer_5,Sara,30,ES70209577946926284453,TRX_N-00014-32981237,2022-01-06T13:12:52,Donostia,expenses,children,-195.04,2388.69
buyer_5,Sara,30,ES70209577946926284453,TRX_N-00015-83037138,2022-01-07T18:07:13,Santurtzi,expenses,repairs,-196.48,2192.21
buyer_5,Sara,30,ES70209577946926284453,TRX_N-00016-14349289,2022-01-08T18:25:25,Donostia,expenses,phone,-38.88,2153.33
buyer_5,Sara,30,ES70209577946926284453,TRX_N-00017-27401621,2022-01-08T14:52:21,Donostia,expenses,water,-26.38,2126.95
buyer_5,Sara,30,ES70209577946926284453,TRX_N-00018-00025512,2022-01-08T17:04:11,Donostia,expenses,internet,-42.0,2084.95
buyer_5,Sara,30,ES70209577946926284453,TRX_N-00019-66579624,2022-01-08T17:05:14,Donostia,expenses,appliances,-175.13,1909.82
buyer_5,Sara,30,ES70209577946926284453,TRX_N-00020-16140037,2022-01-10T18:45:55,Donostia,expenses,food,-68.85,1840.97
buyer_5,Sara,30,ES70209577946926284453,TRX_N-00021-85037204,2022-01-12T14:19:47,Sopela,expenses,leisure,-57.44,1783.53
buyer_5,Sara,30,ES70209577946926284453,TRX_N-00022-70806116,2022-01-14T15:36:48,Donostia,expenses,leisure,-27.64,1755.89
buyer_5,Sara,30,ES70209577946926284453,TRX_N-00023-67869713,2022-01-14T11:42:33,Donostia,expenses,children,-242.43,1513.46
buyer_5,Sara,30,ES70209577946926284453,TRX_N-00024-84179668,2022-01-16T10:39:51,Donostia,expenses,food,-122.07,1391.39
buyer_5,Sara,30,ES70209577946926284453,TRX_N-00025-65492010,2022-01-16T20:09:36,Donostia,expenses,leisure,-67.58,1323.81
buyer_5,Sara,30,ES70209577946926284453,TRX_N-00026-25824104,2022-01-17T22:40:24,Donostia,expenses,transport,-51.33,1272.48
buyer_5,Sara,30,ES70209577946926284453,TRX_N-00027-63181278,2022-01-18T18:00:49,Donostia,expenses,leisure,-25.36,1247.12
buyer_5,Sara,30,ES70209577946926284453,TRX_N-00028-27539720,2022-01-18T19:58:07,Donostia,expenses,cash,-100.0,1147.12
buyer_5,Sara,30,ES70209577946926284453,TRX_N-00029-29550486,2022-01-20T18:59:01,Donostia,expenses,transport,-43.09,1104.03
buyer_5,Sara,30,ES70209577946926284453,TRX_N-00030-51945993,2022-01-21T08:55:21,Salvatierra/Agurain,expenses,education,-72.17,1031.86
buyer_5,Sara,30,ES70209577946926284453,TRX_N-00031-58235792,2022-01-22T13:30:38,Donostia,expenses,cash,-100.0,931.86
buyer_5,Sara,30,ES70209577946926284453,TRX_N-00032-67851996,2022-01-22T14:10:16,Donostia,expenses,gifts,-520.47,411.39
buyer_5,Sara,30,ES70209577946926284453,TRX_N-00033-11061612,2022-01-25T19:12:39,Donostia,expenses,repairs,-184.66,226.73
buyer_5,Sara,30,ES70209577946926284453,TRX_N-00034-22436896,2022-01-26T13:06:23,Donostia,expenses,education,-60.39,166.34
buyer_5,Sara,30,ES70209577946926284453,TRX_N-00035-91047702,2022-01-28T16:40:27,Galdakao,expenses,cash,-100.0,66.34
buyer_5,Sara,30,ES70209577946926284453,TRX_N-00036-33149556,2022-01-28T02:19:03,Donostia,expenses,repairs,-184.34,-118.0
buyer_5,Sara,30,ES70209577946926284453,TRX_N-00037-61605230,2022-01-30T18:21:09,Donostia,expenses,food,-61.33,-179.33
buyer_5,Sara,30,ES70209577946926284453,TRX_N-00038-43367322,2022-01-31T18:23:50,Sopela,expenses,cash,-100.0,-279.33
buyer_5,Sara,30,ES70209577946926284453,TRX_N-00039-11296252,2022-02-01T08:48:28,Donostia,incomes,salary,1284.22,1004.89
buyer_5,Sara,30,ES70209577946926284453,TRX_N-00040-70035815,2022-02-01T08:48:28,Donostia,incomes,salary_partner,1678.59,2683.48
buyer_5,Sara,30,ES70209577946926284453,TRX_N-00041-34530782,2022-02-02T12:54:26,Donostia,expenses,leisure,-79.5,2603.98
buyer_5,Sara,30,ES70209577946926284453,TRX_N-00042-13581701,2022-02-03T15:35:03,Donostia,expenses,transport,-72.19,2531.79
buyer_5,Sara,30,ES70209577946926284453,TRX_N-00043-12614169,2022-02-04T10:35:31,Donostia,expenses,mortgage,-897.77,1634.02
buyer_5,Sara,30,ES70209577946926284453,TRX_N-00044-53447794,2022-02-05T08:01:12,Donostia,expenses,water,-42.66,1591.36
buyer_5,Sara,30,ES70209577946926284453,TRX_N-00045-69277315,2022-02-06T09:13:33,Donostia,expenses,electricity,-43.41,1547.95
buyer_5,Sara,30,ES70209577946926284453,TRX_N-00046-16310352,2022-02-06T21:19:56,Donostia,expenses,food,-61.17,1486.78
buyer_5,Sara,30,ES70209577946926284453,TRX_N-00047-49443421,2022-02-07T14:35:50,Donostia,expenses,phone,-37.64,1449.14
buyer_5,Sara,30,ES70209577946926284453,TRX_N-00048-80759592,2022-02-07T15:10:59,Donostia,expenses,transport,-88.81,1360.33
buyer_5,Sara,30,ES70209577946926284453,TRX_N-00049-27437581,2022-02-08T09:42:05,Donostia,expenses,internet,-42.0,1318.33
buyer_5,Sara,30,ES70209577946926284453,TRX_N-00050-15969482,2022-02-08T18:05:27,Donostia,expenses,gas,-59.39,1258.94
buyer_5,Sara,30,ES70209577946926284453,TRX_N-00051-04499109,2022-02-09T08:05:23,Donostia,expenses,cash,-100.0,1158.94
buyer_5,Sara,30,ES70209577946926284453,TRX_N-00052-03221007,2022-02-12T18:32:52,Donostia,expenses,leisure,-63.15,1095.79
buyer_5,Sara,30,ES70209577946926284453,TRX_N-00053-71244954,2022-02-15T10:24:49,Donostia,expenses,education,-68.62,1027.17
buyer_5,Sara,30,ES70209577946926284453,TRX_N-00054-28898233,2022-02-18T18:45:38,Donostia,expenses,leisure,-60.27,966.9
buyer_5,Sara,30,ES70209577946926284453,TRX_N-00055-73402468,2022-02-22T13:05:28,Donostia,expenses,food,-68.82,898.08
buyer_5,Sara,30,ES70209577946926284453,TRX_N-00056-31702879,2022-02-22T09:47:32,Donostia,expenses,gifts,-337.38,560.7
buyer_5,Sara,30,ES70209577946926284453,TRX_N-00057-71114339,2022-02-24T06:51:27,Donostia,expenses,clothing,-118.17,442.53
buyer_5,Sara,30,ES70209577946926284453,TRX_N-00058-03469923,2022-02-24T10:12:22,Donostia,expenses,children,-156.12,286.41
buyer_5,Sara,30,ES70209577946926284453,TRX_N-00059-65687319,2022-02-26T13:00:56,Donostia,expenses,food,-98.02,188.39
buyer_5,Sara,30,ES70209577946926284453,TRX_N-00060-76941049,2022-02-26T16:36:16,Donostia,expenses,cash,-100.0,88.39
buyer_5,Sara,30,ES70209577946926284453,TRX_N-00061-10586168,2022-02-26T17:12:35,Donostia,expenses,appliances,-244.11,-155.72
buyer_5,Sara,30,ES70209577946926284453,TRX_N-00062-50131009,2022-02-28T16:16:04,Donostia,expenses,food,-94.17,-249.89
buyer_5,Sara,30,ES70209577946926284453,TRX_N-00063-21747220,2022-03-01T13:36:52,Donostia,incomes,salary,1284.22,1034.33
buyer_5,Sara,30,ES70209577946926284453,TRX_N-00064-52579213,2022-03-01T13:36:52,Donostia,incomes,salary_partner,1678.59,2712.92
buyer_5,Sara,30,ES70209577946926284453,TRX_N-00065-84853065,2022-03-01T14:44:28,Donostia,expenses,cash,-100.0,2612.92
buyer_5,Sara,30,ES70209577946926284453,TRX_N-00066-69918050,2022-03-02T22:09:23,Donostia,expenses,cash,-100.0,2512.92
buyer_5,Sara,30,ES70209577946926284453,TRX_N-00067-99854755,2022-03-02T12:25:16,Sestao,expenses,repairs,-319.51,2193.41
buyer_5,Sara,30,ES70209577946926284453,TRX_N-00068-72501946,2022-03-03T21:16:06,Errenteria,expenses,cash,-100.0,2093.41
buyer_5,Sara,30,ES70209577946926284453,TRX_N-00069-69552912,2022-03-04T10:31:10,Donostia,expenses,mortgage,-897.77,1195.64
buyer_5,Sara,30,ES70209577946926284453,TRX_N-00070-60358080,2022-03-04T10:31:53,Getxo,expenses,gifts,-88.02,1107.62
buyer_5,Sara,30,ES70209577946926284453,TRX_N-00071-46025266,2022-03-05T20:29:30,Donostia,expenses,gas,-48.13,1059.49
buyer_5,Sara,30,ES70209577946926284453,TRX_N-00072-41759594,2022-03-05T16:58:50,Donostia,expenses,phone,-44.11,1015.38
buyer_5,Sara,30,ES70209577946926284453,TRX_N-00073-18084429,2022-03-05T20:37:33,Donostia,expenses,cash,-100.0,915.38
buyer_5,Sara,30,ES70209577946926284453,TRX_N-00074-05508249,2022-03-06T13:17:57,Donostia,expenses,internet,-42.0,873.38
buyer_5,Sara,30,ES70209577946926284453,TRX_N-00075-64165687,2022-03-06T16:22:06,Donostia,expenses,cash,-100.0,773.38
buyer_5,Sara,30,ES70209577946926284453,TRX_N-00076-78064766,2022-03-07T08:34:18,Donostia,expenses,food,-113.97,659.41
buyer_5,Sara,30,ES70209577946926284453,TRX_N-00077-54011515,2022-03-08T19:21:38,Donostia,expenses,water,-40.83,618.58
buyer_5,Sara,30,ES70209577946926284453,TRX_N-00078-65541693,2022-03-08T19:02:59,Donostia,expenses,electricity,-53.82,564.76
buyer_5,Sara,30,ES70209577946926284453,TRX_N-00079-96017645,2022-03-11T13:10:45,Donostia,expenses,food,-110.31,454.45
buyer_5,Sara,30,ES70209577946926284453,TRX_N-00080-52802143,2022-03-11T20:37:53,Donostia,expenses,clothing,-100.68,353.77
buyer_5,Sara,30,ES70209577946926284453,TRX_N-00081-59892578,2022-03-12T17:03:11,Donostia,expenses,leisure,-56.69,297.08
buyer_5,Sara,30,ES70209577946926284453,TRX_N-00082-24878162,2022-03-15T19:00:07,Donostia,expenses,food,-111.65,185.43
buyer_5,Sara,30,ES70209577946926284453,TRX_N-00083-09964586,2022-03-15T23:58:42,Donostia,expenses,transport,-53.38,132.05
buyer_5,Sara,30,ES70209577946926284453,TRX_N-00084-88978050,2022-03-17T14:21:21,Donostia,expenses,gifts,-214.44,-82.39
buyer_5,Sara,30,ES70209577946926284453,TRX_N-00085-34720340,2022-03-19T00:33:54,Donostia,expenses,education,-42.65,-125.04
buyer_5,Sara,30,ES70209577946926284453,TRX_N-00086-92397409,2022-03-22T08:07:56,Donostia,expenses,cash,-100.0,-225.04
buyer_5,Sara,30,ES70209577946926284453,TRX_N-00087-15208624,2022-03-23T13:59:46,Donostia,expenses,appliances,-336.25,-561.29
buyer_5,Sara,30,ES70209577946926284453,TRX_N-00088-95872473,2022-03-24T09:56:59,Donostia,expenses,cash,-100.0,-661.29
buyer_5,Sara,30,ES70209577946926284453,TRX_N-00089-53172020,2022-03-24T20:16:00,Iruña de Oca,expenses,travel,-457.59,-1118.88
buyer_5,Sara,30,ES70209577946926284453,TRX_N-00090-27410702,2022-03-24T16:16:07,Donostia,expenses,repairs,-185.06,-1303.94
buyer_5,Sara,30,ES70209577946926284453,TRX_N-00091-27675533,2022-03-25T09:43:48,Donostia,expenses,cash,-100.0,-1403.94
buyer_5,Sara,30,ES70209577946926284453,TRX_N-00092-85013506,2022-03-26T12:07:30,Donostia,expenses,transport,-49.98,-1453.92
buyer_5,Sara,30,ES70209577946926284453,TRX_N-00093-97970701,2022-03-27T00:31:30,Donostia,expenses,clothing,-125.21,-1579.13
buyer_5,Sara,30,ES70209577946926284453,TRX_N-00094-66760202,2022-03-28T15:34:28,Donostia,expenses,leisure,-49.92,-1629.05
buyer_5,Sara,30,ES70209577946926284453,TRX_N-00095-97699299,2022-03-28T17:24:02,Donostia,expenses,cash,-100.0,-1729.05
buyer_5,Sara,30,ES70209577946926284453,TRX_N-00096-17092603,2022-04-01T09:31:41,Donostia,incomes,salary,1284.22,-444.83
buyer_5,Sara,30,ES70209577946926284453,TRX_N-00097-02849385,2022-04-01T09:31:41,Donostia,incomes,salary_partner,1678.59,1233.76
buyer_5,Sara,30,ES70209577946926284453,TRX_N-00098-56452606,2022-04-01T09:31:41,Donostia,incomes,extra_income,170.69,1404.45
buyer_5,Sara,30,ES70209577946926284453,TRX_N-00099-55125052,2022-04-01T12:33:41,Donostia,expenses,cash,-100.0,1304.45
buyer_5,Sara,30,ES70209577946926284453,TRX_N-00100-56466925,2022-04-03T16:17:25,Sopela,expenses,transport,-81.46,1222.99
buyer_5,Sara,30,ES70209577946926284453,TRX_N-00101-13717803,2022-04-03T09:49:39,Donostia,expenses,leisure,-49.82,1173.17
buyer_5,Sara,30,ES70209577946926284453,TRX_N-00102-48379755,2022-04-04T05:40:27,Donostia,expenses,mortgage,-897.77,275.4
buyer_5,Sara,30,ES70209577946926284453,TRX_N-00103-10037460,2022-04-05T22:03:35,Donostia,expenses,transport,-45.02,230.38
buyer_5,Sara,30,ES70209577946926284453,TRX_N-00104-61736209,2022-04-05T09:06:22,Donostia,expenses,repairs,-211.32,19.06
buyer_5,Sara,30,ES70209577946926284453,TRX_N-00105-94596685,2022-04-05T17:29:15,Donostia,expenses,children,-162.43,-143.37
buyer_5,Sara,30,ES70209577946926284453,TRX_N-00106-04579115,2022-04-06T16:33:24,Donostia,expenses,water,-41.87,-185.24
buyer_5,Sara,30,ES70209577946926284453,TRX_N-00107-34480685,2022-04-06T09:16:31,Donostia,expenses,gas,-67.3,-252.54
buyer_5,Sara,30,ES70209577946926284453,TRX_N-00108-14774465,2022-04-06T13:19:16,Donostia,expenses,internet,-42.0,-294.54
buyer_5,Sara,30,ES70209577946926284453,TRX_N-00109-79484015,2022-04-06T08:41:42,Donostia,expenses,phone,-38.28,-332.82
buyer_5,Sara,30,ES70209577946926284453,TRX_N-00110-79224842,2022-04-06T20:23:20,Donostia,expenses,transport,-81.72,-414.54
buyer_5,Sara,30,ES70209577946926284453,TRX_N-00111-38025433,2022-04-07T12:36:19,Donostia,expenses,transport,-67.77,-482.31
buyer_5,Sara,30,ES70209577946926284453,TRX_N-00112-57836679,2022-04-08T10:20:22,Donostia,expenses,electricity,-78.08,-560.39
buyer_5,Sara,30,ES70209577946926284453,TRX_N-00113-25491721,2022-04-08T17:17:13,Donostia,expenses,food,-64.3,-624.69
buyer_5,Sara,30,ES70209577946926284453,TRX_N-00114-78700589,2022-04-08T18:43:55,Donostia,expenses,transport,-69.44,-694.13
buyer_5,Sara,30,ES70209577946926284453,TRX_N-00115-81570397,2022-04-08T16:29:40,Donostia,expenses,cash,-100.0,-794.13
buyer_5,Sara,30,ES70209577946926284453,TRX_N-00116-84381343,2022-04-09T10:19:36,Donostia,expenses,leisure,-84.96,-879.09
buyer_5,Sara,30,ES70209577946926284453,TRX_N-00117-19389166,2022-04-09T01:59:19,Donostia,expenses,clothing,-146.76,-1025.85
buyer_5,Sara,30,ES70209577946926284453,TRX_N-00118-67612717,2022-04-11T12:17:47,Donostia,expenses,healthcare,-159.37,-1185.22
buyer_5,Sara,30,ES70209577946926284453,TRX_N-00119-42074838,2022-04-14T14:43:14,Donostia,expenses,transport,-47.15,-1232.37
buyer_5,Sara,30,ES70209577946926284453,TRX_N-00120-41815494,2022-04-15T19:17:19,Donostia,expenses,food,-70.68,-1303.05
buyer_5,Sara,30,ES70209577946926284453,TRX_N-00121-32765568,2022-04-15T13:46:44,Donostia,expenses,gifts,-615.36,-1918.41
buyer_5,Sara,30,ES70209577946926284453,TRX_N-00122-48382712,2022-04-16T08:13:30,Donostia,expenses,repairs,-231.95,-2150.36
buyer_5,Sara,30,ES70209577946926284453,TRX_N-00123-50193381,2022-04-17T08:06:57,Donostia,expenses,food,-61.09,-2211.45
buyer_5,Sara,30,ES70209577946926284453,TRX_N-00124-64962020,2022-04-20T09:18:57,Donostia,expenses,food,-60.72,-2272.17
buyer_5,Sara,30,ES70209577946926284453,TRX_N-00125-47357467,2022-04-21T13:27:36,Donostia,expenses,transport,-57.56,-2329.73
buyer_5,Sara,30,ES70209577946926284453,TRX_N-00126-20952244,2022-04-22T17:13:09,Donostia,expenses,food,-73.57,-2403.3
buyer_5,Sara,30,ES70209577946926284453,TRX_N-00127-83654520,2022-04-23T10:56:27,Donostia,expenses,gifts,-297.01,-2700.31
buyer_5,Sara,30,ES70209577946926284453,TRX_N-00128-68298549,2022-04-24T18:09:35,Donostia,expenses,food,-83.79,-2784.1
buyer_5,Sara,30,ES70209577946926284453,TRX_N-00129-89696558,2022-04-24T18:45:07,Irun,expenses,appliances,-398.95,-3183.05
buyer_5,Sara,30,ES70209577946926284453,TRX_N-00130-91561287,2022-04-25T16:55:40,Donostia,expenses,food,-60.96,-3244.01
buyer_5,Sara,30,ES70209577946926284453,TRX_N-00131-48060778,2022-04-25T09:38:03,Donostia,expenses,education,-78.43,-3322.44
buyer_5,Sara,30,ES70209577946926284453,TRX_N-00132-00173425,2022-04-27T12:12:33,Donostia,expenses,food,-91.19,-3413.63
buyer_5,Sara,30,ES70209577946926284453,TRX_N-00133-14108574,2022-04-27T14:36:30,Donostia,expenses,education,-72.76,-3486.39
buyer_5,Sara,30,ES70209577946926284453,TRX_N-00134-78508212,2022-04-27T15:49:38,Donostia,expenses,cash,-100.0,-3586.39
buyer_5,Sara,30,ES70209577946926284453,TRX_N-00135-01127742,2022-04-28T15:03:31,Donostia,expenses,leisure,-47.53,-3633.92
buyer_5,Sara,30,ES70209577946926284453,TRX_N-00136-33474550,2022-04-28T17:37:39,Donostia,expenses,repairs,-274.87,-3908.79
buyer_5,Sara,30,ES70209577946926284453,TRX_N-00137-91789457,2022-04-29T16:41:50,Donostia,expenses,education,-65.46,-3974.25
buyer_5,Sara,30,ES70209577946926284453,TRX_N-00138-20790814,2022-04-30T09:53:32,Donostia,expenses,transport,-77.75,-4052.0
buyer_5,Sara,30,ES70209577946926284453,TRX_N-00139-46855176,2022-05-01T09:56:49,Donostia,incomes,salary,1284.22,-2767.78
buyer_5,Sara,30,ES70209577946926284453,TRX_N-00140-26712660,2022-05-01T09:56:49,Donostia,incomes,salary_partner,1678.59,-1089.19
buyer_5,Sara,30,ES70209577946926284453,TRX_N-00141-32855317,2022-05-02T22:33:58,Donostia,expenses,cash,-100.0,-1189.19
buyer_5,Sara,30,ES70209577946926284453,TRX_N-00142-63907954,2022-05-03T18:08:50,Donostia,expenses,food,-124.87,-1314.06
buyer_5,Sara,30,ES70209577946926284453,TRX_N-00143-58180069,2022-05-03T16:51:48,Donostia,expenses,cash,-100.0,-1414.06
buyer_5,Sara,30,ES70209577946926284453,TRX_N-00144-51359018,2022-05-04T18:01:00,Donostia,expenses,mortgage,-897.77,-2311.83
buyer_5,Sara,30,ES70209577946926284453,TRX_N-00145-20551394,2022-05-04T14:20:23,Donostia,expenses,cash,-100.0,-2411.83
buyer_5,Sara,30,ES70209577946926284453,TRX_N-00146-47937185,2022-05-05T10:03:32,Donostia,expenses,water,-27.69,-2439.52
buyer_5,Sara,30,ES70209577946926284453,TRX_N-00147-32462972,2022-05-06T18:24:31,Donostia,expenses,electricity,-63.55,-2503.07
buyer_5,Sara,30,ES70209577946926284453,TRX_N-00148-94088743,2022-05-06T10:50:58,Donostia,expenses,cash,-100.0,-2603.07
buyer_5,Sara,30,ES70209577946926284453,TRX_N-00149-57662771,2022-05-08T15:28:11,Donostia,expenses,gas,-92.04,-2695.11
buyer_5,Sara,30,ES70209577946926284453,TRX_N-00150-74883748,2022-05-08T19:17:10,Donostia,expenses,internet,-42.0,-2737.11
buyer_5,Sara,30,ES70209577946926284453,TRX_N-00151-55991658,2022-05-08T20:27:23,Donostia,expenses,phone,-39.32,-2776.43
buyer_5,Sara,30,ES70209577946926284453,TRX_N-00152-75194319,2022-05-08T17:43:45,Donostia,expenses,food,-113.34,-2889.77
buyer_5,Sara,30,ES70209577946926284453,TRX_N-00153-21298918,2022-05-09T11:47:44,Barakaldo,expenses,leisure,-34.8,-2924.57
buyer_5,Sara,30,ES70209577946926284453,TRX_N-00154-62174112,2022-05-10T22:20:07,Donostia,expenses,clothing,-83.04,-3007.61
buyer_5,Sara,30,ES70209577946926284453,TRX_N-00155-08501439,2022-05-11T14:50:27,Donostia,expenses,leisure,-52.92,-3060.53
buyer_5,Sara,30,ES70209577946926284453,TRX_N-00156-85549393,2022-05-11T10:39:51,Donostia,expenses,cash,-100.0,-3160.53
buyer_5,Sara,30,ES70209577946926284453,TRX_N-00157-88138009,2022-05-15T11:04:11,Donostia,expenses,gifts,-673.79,-3834.32
buyer_5,Sara,30,ES70209577946926284453,TRX_N-00158-76684636,2022-05-15T23:10:06,Donostia,expenses,children,-82.28,-3916.6
buyer_5,Sara,30,ES70209577946926284453,TRX_N-00159-62176564,2022-05-16T23:00:36,Donostia,expenses,healthcare,-165.8,-4082.4
buyer_5,Sara,30,ES70209577946926284453,TRX_N-00160-91840119,2022-05-19T16:03:22,Donostia,expenses,cash,-100.0,-4182.4
buyer_5,Sara,30,ES70209577946926284453,TRX_N-00161-60405676,2022-05-20T09:39:26,Donostia,expenses,repairs,-71.26,-4253.66
buyer_5,Sara,30,ES70209577946926284453,TRX_N-00162-64128542,2022-05-21T11:46:58,Donostia,expenses,cash,-100.0,-4353.66
buyer_5,Sara,30,ES70209577946926284453,TRX_N-00163-57914116,2022-05-22T11:50:10,Eibar,expenses,repairs,-116.73,-4470.39
buyer_5,Sara,30,ES70209577946926284453,TRX_N-00164-07299052,2022-05-26T09:42:15,Donostia,expenses,education,-78.06,-4548.45
buyer_5,Sara,30,ES70209577946926284453,TRX_N-00165-60937715,2022-06-01T09:28:41,Donostia,incomes,salary,1284.22,-3264.23
buyer_5,Sara,30,ES70209577946926284453,TRX_N-00166-05154922,2022-06-01T09:28:41,Donostia,incomes,salary_partner,1678.59,-1585.64
buyer_5,Sara,30,ES70209577946926284453,TRX_N-00167-16640517,2022-06-01T09:28:41,Donostia,incomes,salary_bonus,928.92,-656.72
buyer_5,Sara,30,ES70209577946926284453,TRX_N-00168-57153205,2022-06-01T09:28:41,Donostia,incomes,salary_partner_bonus,1188.95,532.23
buyer_5,Sara,30,ES70209577946926284453,TRX_N-00169-26253276,2022-06-03T20:33:05,Barakaldo,expenses,gifts,-146.68,385.55
buyer_5,Sara,30,ES70209577946926284453,TRX_N-00170-77946988,2022-06-04T13:30:27,Donostia,expenses,mortgage,-897.77,-512.22
buyer_5,Sara,30,ES70209577946926284453,TRX_N-00171-76018961,2022-06-04T10:56:29,Donostia,expenses,clothing,-63.08,-575.3
buyer_5,Sara,30,ES70209577946926284453,TRX_N-00172-60483565,2022-06-05T01:53:58,Donostia,expenses,transport,-67.76,-643.06
buyer_5,Sara,30,ES70209577946926284453,TRX_N-00173-26336927,2022-06-05T15:37:33,Basauri,expenses,leisure,-37.87,-680.93
buyer_5,Sara,30,ES70209577946926284453,TRX_N-00174-41635979,2022-06-06T12:34:23,Donostia,expenses,water,-37.82,-718.75
buyer_5,Sara,30,ES70209577946926284453,TRX_N-00175-28999832,2022-06-07T12:24:16,Donostia,expenses,gas,-46.59,-765.34
buyer_5,Sara,30,ES70209577946926284453,TRX_N-00176-38562278,2022-06-07T22:02:13,Donostia,expenses,transport,-68.05,-833.39
buyer_5,Sara,30,ES70209577946926284453,TRX_N-00177-72126522,2022-06-08T12:38:49,Donostia,expenses,phone,-38.21,-871.6
buyer_5,Sara,30,ES70209577946926284453,TRX_N-00178-24934718,2022-06-08T20:41:16,Donostia,expenses,electricity,-65.66,-937.26
buyer_5,Sara,30,ES70209577946926284453,TRX_N-00179-33514144,2022-06-08T14:01:45,Donostia,expenses,internet,-42.0,-979.26
buyer_5,Sara,30,ES70209577946926284453,TRX_N-00180-57518272,2022-06-10T15:27:40,Donostia,expenses,clothing,-92.11,-1071.37
buyer_5,Sara,30,ES70209577946926284453,TRX_N-00181-24609297,2022-06-13T09:43:12,Donostia,expenses,food,-86.28,-1157.65
buyer_5,Sara,30,ES70209577946926284453,TRX_N-00182-53352543,2022-06-14T13:26:42,Donostia,expenses,cash,-100.0,-1257.65
buyer_5,Sara,30,ES70209577946926284453,TRX_N-00183-98025618,2022-06-17T11:53:56,Eibar,expenses,repairs,-160.81,-1418.46
buyer_5,Sara,30,ES70209577946926284453,TRX_N-00184-65375034,2022-06-18T20:37:31,Donostia,expenses,food,-83.7,-1502.16
buyer_5,Sara,30,ES70209577946926284453,TRX_N-00185-08595460,2022-06-18T14:40:35,Donostia,expenses,leisure,-48.08,-1550.24
buyer_5,Sara,30,ES70209577946926284453,TRX_N-00186-41700606,2022-06-20T08:03:40,Donostia,expenses,cash,-100.0,-1650.24
buyer_5,Sara,30,ES70209577946926284453,TRX_N-00187-61148322,2022-06-22T21:12:59,Irun,expenses,clothing,-95.4,-1745.64
buyer_5,Sara,30,ES70209577946926284453,TRX_N-00188-27170134,2022-06-24T15:52:09,Donostia,expenses,cash,-100.0,-1845.64
buyer_5,Sara,30,ES70209577946926284453,TRX_N-00189-43442662,2022-06-26T15:48:31,Donostia,expenses,food,-69.18,-1914.82
buyer_5,Sara,30,ES70209577946926284453,TRX_N-00190-96647380,2022-06-26T13:52:18,Donostia,expenses,leisure,-80.35,-1995.17
buyer_5,Sara,30,ES70209577946926284453,TRX_N-00191-16750650,2022-06-26T08:36:23,Donostia,expenses,cash,-100.0,-2095.17
buyer_5,Sara,30,ES70209577946926284453,TRX_N-00192-21706607,2022-06-26T22:27:46,Vitoria-Gasteiz,expenses,appliances,-78.44,-2173.61
buyer_5,Sara,30,ES70209577946926284453,TRX_N-00193-97136081,2022-06-28T08:44:22,Donostia,expenses,cash,-100.0,-2273.61
buyer_5,Sara,30,ES70209577946926284453,TRX_N-00194-14546772,2022-06-29T19:21:25,Donostia,expenses,leisure,-63.87,-2337.48
buyer_5,Sara,30,ES70209577946926284453,TRX_N-00195-91613493,2022-06-29T15:13:49,Donostia,expenses,cash,-100.0,-2437.48
buyer_5,Sara,30,ES70209577946926284453,TRX_N-00196-30524977,2022-06-30T12:39:29,Donostia,expenses,leisure,-35.2,-2472.68
buyer_5,Sara,30,ES70209577946926284453,TRX_N-00197-46937639,2022-07-01T14:54:24,Donostia,incomes,salary,1284.22,-1188.46
buyer_5,Sara,30,ES70209577946926284453,TRX_N-00198-46047422,2022-07-01T14:54:24,Donostia,incomes,salary_partner,1678.59,490.13
buyer_5,Sara,30,ES70209577946926284453,TRX_N-00199-65938517,2022-07-01T20:20:23,Donostia,expenses,food,-64.81,425.32
buyer_5,Sara,30,ES70209577946926284453,TRX_N-00200-76080852,2022-07-02T08:22:22,Donostia,expenses,cash,-100.0,325.32
buyer_5,Sara,30,ES70209577946926284453,TRX_N-00201-46201352,2022-07-04T10:53:30,Donostia,expenses,mortgage,-897.77,-572.45
buyer_5,Sara,30,ES70209577946926284453,TRX_N-00202-57943362,2022-07-05T10:17:16,Donostia,expenses,water,-27.18,-599.63
buyer_5,Sara,30,ES70209577946926284453,TRX_N-00203-86493031,2022-07-05T14:50:14,Donostia,expenses,food,-102.58,-702.21
buyer_5,Sara,30,ES70209577946926284453,TRX_N-00204-03337376,2022-07-05T09:00:24,Donostia,expenses,transport,-44.09,-746.3
buyer_5,Sara,30,ES70209577946926284453,TRX_N-00205-14096460,2022-07-06T17:59:27,Donostia,expenses,electricity,-82.62,-828.92
buyer_5,Sara,30,ES70209577946926284453,TRX_N-00206-57467067,2022-07-06T16:17:58,Donostia,expenses,phone,-37.17,-866.09
buyer_5,Sara,30,ES70209577946926284453,TRX_N-00207-93961711,2022-07-06T14:53:55,Durango,expenses,transport,-89.07,-955.16
buyer_5,Sara,30,ES70209577946926284453,TRX_N-00208-57602368,2022-07-07T05:14:46,Donostia,expenses,transport,-75.03,-1030.19
buyer_5,Sara,30,ES70209577946926284453,TRX_N-00209-84407649,2022-07-07T14:57:31,Donostia,expenses,cash,-100.0,-1130.19
buyer_5,Sara,30,ES70209577946926284453,TRX_N-00210-84442642,2022-07-08T16:55:37,Donostia,expenses,gas,-91.46,-1221.65
buyer_5,Sara,30,ES70209577946926284453,TRX_N-00211-59757583,2022-07-08T10:44:32,Donostia,expenses,internet,-42.0,-1263.65
buyer_5,Sara,30,ES70209577946926284453,TRX_N-00212-32895907,2022-07-10T14:44:59,Donostia,expenses,clothing,-122.09,-1385.74
buyer_5,Sara,30,ES70209577946926284453,TRX_N-00213-76229614,2022-07-10T22:51:35,Donostia,expenses,cash,-100.0,-1485.74
buyer_5,Sara,30,ES70209577946926284453,TRX_N-00214-19138398,2022-07-12T03:25:52,Donostia,expenses,leisure,-28.46,-1514.2
buyer_5,Sara,30,ES70209577946926284453,TRX_N-00215-64118786,2022-07-14T17:31:06,Donostia,expenses,leisure,-75.91,-1590.11
buyer_5,Sara,30,ES70209577946926284453,TRX_N-00216-14122558,2022-07-14T20:15:22,Donostia,expenses,cash,-100.0,-1690.11
buyer_5,Sara,30,ES70209577946926284453,TRX_N-00217-92228597,2022-07-17T18:20:39,Donostia,expenses,cash,-100.0,-1790.11
buyer_5,Sara,30,ES70209577946926284453,TRX_N-00218-61683129,2022-07-18T10:03:34,Donostia,expenses,cash,-100.0,-1890.11
buyer_5,Sara,30,ES70209577946926284453,TRX_N-00219-22957403,2022-07-18T15:48:44,Donostia,expenses,repairs,-325.26,-2215.37
buyer_5,Sara,30,ES70209577946926284453,TRX_N-00220-79315061,2022-07-20T09:05:58,Donostia,expenses,healthcare,-152.02,-2367.39
buyer_5,Sara,30,ES70209577946926284453,TRX_N-00221-84575813,2022-07-21T16:09:05,Donostia,expenses,food,-106.56,-2473.95
buyer_5,Sara,30,ES70209577946926284453,TRX_N-00222-39264483,2022-07-23T20:59:34,Donostia,expenses,leisure,-27.63,-2501.58
buyer_5,Sara,30,ES70209577946926284453,TRX_N-00223-02281263,2022-07-23T10:05:21,Donostia,expenses,clothing,-84.66,-2586.24
buyer_5,Sara,30,ES70209577946926284453,TRX_N-00224-34393580,2022-07-24T12:08:08,Donostia,expenses,leisure,-27.64,-2613.88
buyer_5,Sara,30,ES70209577946926284453,TRX_N-00225-00302531,2022-07-24T16:00:12,Donostia,expenses,cash,-100.0,-2713.88
buyer_5,Sara,30,ES70209577946926284453,TRX_N-00226-20544171,2022-07-25T18:45:33,Donostia,expenses,healthcare,-52.79,-2766.67
buyer_5,Sara,30,ES70209577946926284453,TRX_N-00227-54018337,2022-07-26T15:03:36,Donostia,expenses,repairs,-169.04,-2935.71
buyer_5,Sara,30,ES70209577946926284453,TRX_N-00228-68750588,2022-07-27T09:33:54,Donostia,expenses,education,-53.22,-2988.93
buyer_5,Sara,30,ES70209577946926284453,TRX_N-00229-98356082,2022-07-29T14:59:00,Donostia,expenses,healthcare,-59.88,-3048.81
buyer_5,Sara,30,ES70209577946926284453,TRX_N-00230-10231283,2022-07-30T17:24:43,Donostia,expenses,healthcare,-152.77,-3201.58
buyer_5,Sara,30,ES70209577946926284453,TRX_N-00231-45393220,2022-07-31T18:33:21,Donostia,expenses,leisure,-39.9,-3241.48
buyer_5,Sara,30,ES70209577946926284453,TRX_N-00232-37435342,2022-08-01T17:35:51,Donostia,incomes,salary,1284.22,-1957.26
buyer_5,Sara,30,ES70209577946926284453,TRX_N-00233-81883693,2022-08-01T17:35:51,Donostia,incomes,salary_partner,1678.59,-278.67
buyer_5,Sara,30,ES70209577946926284453,TRX_N-00234-55025075,2022-08-01T17:35:51,Donostia,incomes,extra_income,170.69,-107.98
buyer_5,Sara,30,ES70209577946926284453,TRX_N-00235-94219988,2022-08-02T22:39:12,Donostia,expenses,leisure,-36.47,-144.45
buyer_5,Sara,30,ES70209577946926284453,TRX_N-00236-27002360,2022-08-03T18:35:23,Donostia,expenses,food,-107.14,-251.59
buyer_5,Sara,30,ES70209577946926284453,TRX_N-00237-50242550,2022-08-04T19:42:55,Donostia,expenses,mortgage,-897.77,-1149.36
buyer_5,Sara,30,ES70209577946926284453,TRX_N-00238-58994903,2022-08-05T09:14:52,Donostia,expenses,phone,-41.36,-1190.72
buyer_5,Sara,30,ES70209577946926284453,TRX_N-00239-72344156,2022-08-05T15:47:27,Donostia,expenses,repairs,-28.84,-1219.56
buyer_5,Sara,30,ES70209577946926284453,TRX_N-00240-65961871,2022-08-06T12:30:43,Donostia,expenses,internet,-42.0,-1261.56
buyer_5,Sara,30,ES70209577946926284453,TRX_N-00241-49616052,2022-08-06T15:13:40,Donostia,expenses,food,-66.03,-1327.59
buyer_5,Sara,30,ES70209577946926284453,TRX_N-00242-56322966,2022-08-07T16:45:08,Donostia,expenses,electricity,-87.21,-1414.8
buyer_5,Sara,30,ES70209577946926284453,TRX_N-00243-16303808,2022-08-07T15:06:09,Donostia,expenses,gas,-112.87,-1527.67
buyer_5,Sara,30,ES70209577946926284453,TRX_N-00244-35971049,2022-08-07T23:14:16,Donostia,expenses,appliances,-240.05,-1767.72
buyer_5,Sara,30,ES70209577946926284453,TRX_N-00245-56595323,2022-08-08T08:25:54,Donostia,expenses,water,-21.83,-1789.55
buyer_5,Sara,30,ES70209577946926284453,TRX_N-00246-42359717,2022-08-10T15:17:55,Donostia,expenses,repairs,-156.96,-1946.51
buyer_5,Sara,30,ES70209577946926284453,TRX_N-00247-06595123,2022-08-11T18:56:49,Donostia,expenses,healthcare,-166.94,-2113.45
buyer_5,Sara,30,ES70209577946926284453,TRX_N-00248-57094687,2022-08-12T10:14:37,Donostia,expenses,transport,-46.65,-2160.1
buyer_5,Sara,30,ES70209577946926284453,TRX_N-00249-13399712,2022-08-13T10:42:08,Donostia,expenses,cash,-100.0,-2260.1
buyer_5,Sara,30,ES70209577946926284453,TRX_N-00250-44759659,2022-08-14T11:56:06,Donostia,expenses,leisure,-41.3,-2301.4
buyer_5,Sara,30,ES70209577946926284453,TRX_N-00251-03674600,2022-08-14T18:57:48,Donostia,expenses,cash,-100.0,-2401.4
buyer_5,Sara,30,ES70209577946926284453,TRX_N-00252-87600882,2022-08-15T08:20:08,Donostia,expenses,transport,-76.08,-2477.48
buyer_5,Sara,30,ES70209577946926284453,TRX_N-00253-26895629,2022-08-15T16:09:55,Donostia,expenses,clothing,-88.16,-2565.64
buyer_5,Sara,30,ES70209577946926284453,TRX_N-00254-31201154,2022-08-16T20:46:01,Donostia,expenses,education,-56.16,-2621.8
buyer_5,Sara,30,ES70209577946926284453,TRX_N-00255-87369334,2022-08-22T04:40:53,Donostia,expenses,clothing,-54.43,-2676.23
buyer_5,Sara,30,ES70209577946926284453,TRX_N-00256-88487312,2022-08-22T14:42:43,Donostia,expenses,repairs,-198.29,-2874.52
buyer_5,Sara,30,ES70209577946926284453,TRX_N-00257-13605080,2022-08-23T05:19:33,Donostia,expenses,gifts,-136.53,-3011.05
buyer_5,Sara,30,ES70209577946926284453,TRX_N-00258-99404886,2022-08-25T08:34:00,Donostia,expenses,leisure,-64.71,-3075.76
buyer_5,Sara,30,ES70209577946926284453,TRX_N-00259-93028126,2022-08-26T08:52:51,Donostia,expenses,healthcare,-55.35,-3131.11
buyer_5,Sara,30,ES70209577946926284453,TRX_N-00260-43611161,2022-08-27T19:40:38,Amurrio,expenses,clothing,-63.32,-3194.43
buyer_5,Sara,30,ES70209577946926284453,TRX_N-00261-92476599,2022-08-28T10:46:37,Erandio,expenses,leisure,-20.1,-3214.53
buyer_5,Sara,30,ES70209577946926284453,TRX_N-00262-22590016,2022-08-29T18:05:11,Donostia,expenses,food,-69.07,-3283.6
buyer_5,Sara,30,ES70209577946926284453,TRX_N-00263-52009690,2022-08-30T19:37:34,Donostia,expenses,leisure,-44.15,-3327.75
buyer_5,Sara,30,ES70209577946926284453,TRX_N-00264-05475400,2022-08-30T06:57:45,Hernani,expenses,travel,-1352.25,-4680.0
buyer_5,Sara,30,ES70209577946926284453,TRX_N-00265-79652808,2022-08-31T16:32:07,Donostia,expenses,cash,-100.0,-4780.0
buyer_5,Sara,30,ES70209577946926284453,TRX_N-00266-42879246,2022-09-01T10:55:28,Donostia,incomes,salary,1284.22,-3495.78
buyer_5,Sara,30,ES70209577946926284453,TRX_N-00267-07049823,2022-09-01T10:55:28,Donostia,incomes,salary_partner,1678.59,-1817.19
buyer_5,Sara,30,ES70209577946926284453,TRX_N-00268-39399284,2022-09-01T17:57:24,Donostia,expenses,food,-99.3,-1916.49
buyer_5,Sara,30,ES70209577946926284453,TRX_N-00269-41385932,2022-09-02T10:39:14,Donostia,expenses,transport,-48.82,-1965.31
buyer_5,Sara,30,ES70209577946926284453,TRX_N-00270-78205805,2022-09-02T08:13:07,Donostia,expenses,clothing,-59.15,-2024.46
buyer_5,Sara,30,ES70209577946926284453,TRX_N-00271-95311847,2022-09-04T17:18:25,Donostia,expenses,mortgage,-897.77,-2922.23
buyer_5,Sara,30,ES70209577946926284453,TRX_N-00272-61040423,2022-09-04T20:23:26,Donostia,expenses,repairs,-28.19,-2950.42
buyer_5,Sara,30,ES70209577946926284453,TRX_N-00273-25978015,2022-09-05T12:01:10,Donostia,expenses,transport,-69.08,-3019.5
buyer_5,Sara,30,ES70209577946926284453,TRX_N-00274-85003721,2022-09-06T06:04:52,Donostia,expenses,phone,-31.13,-3050.63
buyer_5,Sara,30,ES70209577946926284453,TRX_N-00275-65524011,2022-09-08T02:54:10,Donostia,expenses,internet,-42.0,-3092.63
buyer_5,Sara,30,ES70209577946926284453,TRX_N-00276-73045470,2022-09-08T12:18:16,Donostia,expenses,water,-44.06,-3136.69
buyer_5,Sara,30,ES70209577946926284453,TRX_N-00277-64531632,2022-09-08T10:40:57,Donostia,expenses,electricity,-72.64,-3209.33
buyer_5,Sara,30,ES70209577946926284453,TRX_N-00278-65659779,2022-09-08T14:39:04,Donostia,expenses,gas,-76.38,-3285.71
buyer_5,Sara,30,ES70209577946926284453,TRX_N-00279-59656701,2022-09-08T06:27:26,Leioa,expenses,gifts,-819.62,-4105.33
buyer_5,Sara,30,ES70209577946926284453,TRX_N-00280-24402255,2022-09-09T08:51:43,Donostia,expenses,cash,-100.0,-4205.33
buyer_5,Sara,30,ES70209577946926284453,TRX_N-00281-27709169,2022-09-10T20:26:31,Donostia,expenses,food,-107.57,-4312.9
buyer_5,Sara,30,ES70209577946926284453,TRX_N-00282-82727730,2022-09-10T02:28:54,Bermeo,expenses,leisure,-68.47,-4381.37
buyer_5,Sara,30,ES70209577946926284453,TRX_N-00283-97849996,2022-09-11T10:39:34,Hernani,expenses,transport,-84.79,-4466.16
buyer_5,Sara,30,ES70209577946926284453,TRX_N-00284-90665553,2022-09-11T22:46:12,Donostia,expenses,education,-48.3,-4514.46
buyer_5,Sara,30,ES70209577946926284453,TRX_N-00285-22818928,2022-09-12T16:44:06,Donostia,expenses,food,-70.98,-4585.44
buyer_5,Sara,30,ES70209577946926284453,TRX_N-00286-99844975,2022-09-12T18:56:55,Irun,expenses,clothing,-76.44,-4661.88
buyer_5,Sara,30,ES70209577946926284453,TRX_N-00287-24134730,2022-09-12T10:24:20,Donostia,expenses,cash,-100.0,-4761.88
buyer_5,Sara,30,ES70209577946926284453,TRX_N-00288-98646909,2022-09-12T08:51:02,Getxo,expenses,appliances,-103.3,-4865.18
buyer_5,Sara,30,ES70209577946926284453,TRX_N-00289-60740021,2022-09-13T15:08:59,Donostia,expenses,education,-46.52,-4911.7
buyer_5,Sara,30,ES70209577946926284453,TRX_N-00290-61944516,2022-09-15T10:12:04,Alegría-Dulantzi,expenses,transport,-70.62,-4982.32
buyer_5,Sara,30,ES70209577946926284453,TRX_N-00291-76107562,2022-09-16T11:56:16,Donostia,expenses,leisure,-26.39,-5008.71
buyer_5,Sara,30,ES70209577946926284453,TRX_N-00292-62975378,2022-09-20T05:14:45,Donostia,expenses,transport,-50.06,-5058.77
buyer_5,Sara,30,ES70209577946926284453,TRX_N-00293-99196050,2022-09-20T12:43:26,Donostia,expenses,cash,-100.0,-5158.77
buyer_5,Sara,30,ES70209577946926284453,TRX_N-00294-21683937,2022-09-21T16:58:23,Durango,expenses,clothing,-157.46,-5316.23
buyer_5,Sara,30,ES70209577946926284453,TRX_N-00295-73377552,2022-09-22T15:19:51,Donostia,expenses,leisure,-56.61,-5372.84
buyer_5,Sara,30,ES70209577946926284453,TRX_N-00296-03039137,2022-09-22T11:53:25,Donostia,expenses,cash,-100.0,-5472.84
buyer_5,Sara,30,ES70209577946926284453,TRX_N-00297-92013218,2022-09-23T18:46:55,Donostia,expenses,food,-120.04,-5592.88
buyer_5,Sara,30,ES70209577946926284453,TRX_N-00298-21743885,2022-09-25T15:56:16,Donostia,expenses,cash,-100.0,-5692.88
buyer_5,Sara,30,ES70209577946926284453,TRX_N-00299-75303326,2022-09-27T05:59:16,Zarautz,expenses,leisure,-38.77,-5731.65
buyer_5,Sara,30,ES70209577946926284453,TRX_N-00300-03542630,2022-10-01T15:20:40,Donostia,incomes,salary,1284.22,-4447.43
buyer_5,Sara,30,ES70209577946926284453,TRX_N-00301-36000183,2022-10-01T15:20:40,Donostia,incomes,salary_partner,1678.59,-2768.84
buyer_5,Sara,30,ES70209577946926284453,TRX_N-00302-73216500,2022-10-01T18:28:16,Donostia,expenses,cash,-100.0,-2868.84
buyer_5,Sara,30,ES70209577946926284453,TRX_N-00303-74145395,2022-10-02T17:34:42,Donostia,expenses,transport,-58.82,-2927.66
buyer_5,Sara,30,ES70209577946926284453,TRX_N-00304-72794896,2022-10-04T13:58:57,Donostia,expenses,mortgage,-897.77,-3825.43
buyer_5,Sara,30,ES70209577946926284453,TRX_N-00305-31209318,2022-10-04T18:41:59,Donostia,expenses,food,-71.72,-3897.15
buyer_5,Sara,30,ES70209577946926284453,TRX_N-00306-99075678,2022-10-04T12:16:44,Vitoria-Gasteiz,expenses,cash,-100.0,-3997.15
buyer_5,Sara,30,ES70209577946926284453,TRX_N-00307-69786914,2022-10-04T16:33:46,Donostia,expenses,children,-191.72,-4188.87
buyer_5,Sara,30,ES70209577946926284453,TRX_N-00308-93358929,2022-10-05T17:53:56,Donostia,expenses,water,-32.34,-4221.21
buyer_5,Sara,30,ES70209577946926284453,TRX_N-00309-67493939,2022-10-05T08:51:25,Donostia,expenses,phone,-41.71,-4262.92
buyer_5,Sara,30,ES70209577946926284453,TRX_N-00310-67401247,2022-10-05T18:09:21,Donostia,expenses,repairs,-33.46,-4296.38
buyer_5,Sara,30,ES70209577946926284453,TRX_N-00311-28473623,2022-10-06T18:43:18,Donostia,expenses,food,-98.57,-4394.95
buyer_5,Sara,30,ES70209577946926284453,TRX_N-00312-34316068,2022-10-06T00:40:36,Donostia,expenses,leisure,-61.02,-4455.97
buyer_5,Sara,30,ES70209577946926284453,TRX_N-00313-04655006,2022-10-06T13:27:18,Donostia,expenses,gifts,-378.59,-4834.56
buyer_5,Sara,30,ES70209577946926284453,TRX_N-00314-41646847,2022-10-07T15:51:35,Donostia,expenses,food,-104.71,-4939.27
buyer_5,Sara,30,ES70209577946926284453,TRX_N-00315-72099400,2022-10-07T09:51:03,Zuia,expenses,gifts,-491.98,-5431.25
buyer_5,Sara,30,ES70209577946926284453,TRX_N-00316-00433954,2022-10-08T12:08:54,Donostia,expenses,gas,-102.46,-5533.71
buyer_5,Sara,30,ES70209577946926284453,TRX_N-00317-81304317,2022-10-08T10:59:21,Donostia,expenses,electricity,-73.18,-5606.89
buyer_5,Sara,30,ES70209577946926284453,TRX_N-00318-49617915,2022-10-08T14:33:13,Donostia,expenses,internet,-42.0,-5648.89
buyer_5,Sara,30,ES70209577946926284453,TRX_N-00319-80358684,2022-10-10T09:55:40,Donostia,expenses,food,-89.75,-5738.64
buyer_5,Sara,30,ES70209577946926284453,TRX_N-00320-43800958,2022-10-11T19:39:21,Donostia,expenses,food,-69.78,-5808.42
buyer_5,Sara,30,ES70209577946926284453,TRX_N-00321-59157351,2022-10-11T15:13:16,Donostia,expenses,clothing,-93.41,-5901.83
buyer_5,Sara,30,ES70209577946926284453,TRX_N-00322-88737654,2022-10-12T17:26:37,Donostia,expenses,clothing,-143.28,-6045.11
buyer_5,Sara,30,ES70209577946926284453,TRX_N-00323-03359670,2022-10-17T10:47:28,Donostia,expenses,transport,-52.68,-6097.79
buyer_5,Sara,30,ES70209577946926284453,TRX_N-00324-17887039,2022-10-17T06:20:38,Donostia,expenses,repairs,-241.71,-6339.5
buyer_5,Sara,30,ES70209577946926284453,TRX_N-00325-11514900,2022-10-19T10:03:48,Donostia,expenses,children,-150.77,-6490.27
buyer_5,Sara,30,ES70209577946926284453,TRX_N-00326-97070550,2022-10-21T13:41:33,Donostia,expenses,leisure,-76.55,-6566.82
buyer_5,Sara,30,ES70209577946926284453,TRX_N-00327-37371146,2022-10-23T10:43:19,Donostia,expenses,cash,-100.0,-6666.82
buyer_5,Sara,30,ES70209577946926284453,TRX_N-00328-43531993,2022-10-23T05:18:45,Donostia,expenses,gifts,-718.72,-7385.54
buyer_5,Sara,30,ES70209577946926284453,TRX_N-00329-54809244,2022-10-28T06:27:34,Donostia,expenses,leisure,-66.35,-7451.89
buyer_5,Sara,30,ES70209577946926284453,TRX_N-00330-74009703,2022-10-29T07:52:14,Donostia,expenses,education,-62.75,-7514.64
buyer_5,Sara,30,ES70209577946926284453,TRX_N-00331-39230757,2022-10-30T16:39:44,Donostia,expenses,cash,-100.0,-7614.64
buyer_5,Sara,30,ES70209577946926284453,TRX_N-00332-40781931,2022-11-01T13:36:23,Donostia,incomes,salary,1284.22,-6330.42
buyer_5,Sara,30,ES70209577946926284453,TRX_N-00333-33066468,2022-11-01T13:36:23,Donostia,incomes,salary_partner,1678.59,-4651.83
buyer_5,Sara,30,ES70209577946926284453,TRX_N-00334-68937912,2022-11-01T13:36:23,Donostia,incomes,extra_income,170.69,-4481.14
buyer_5,Sara,30,ES70209577946926284453,TRX_N-00335-71791259,2022-11-02T17:32:09,Donostia,expenses,food,-70.36,-4551.5
buyer_5,Sara,30,ES70209577946926284453,TRX_N-00336-47085545,2022-11-04T19:48:34,Donostia,expenses,mortgage,-897.77,-5449.27
buyer_5,Sara,30,ES70209577946926284453,TRX_N-00337-19435210,2022-11-04T09:33:05,Donostia,expenses,food,-102.34,-5551.61
buyer_5,Sara,30,ES70209577946926284453,TRX_N-00338-65658283,2022-11-05T15:37:44,Donostia,expenses,phone,-42.34,-5593.95
buyer_5,Sara,30,ES70209577946926284453,TRX_N-00339-22811206,2022-11-05T19:37:02,Donostia,expenses,cash,-100.0,-5693.95
buyer_5,Sara,30,ES70209577946926284453,TRX_N-00340-96267226,2022-11-06T14:09:38,Donostia,expenses,water,-20.69,-5714.64
buyer_5,Sara,30,ES70209577946926284453,TRX_N-00341-10925054,2022-11-06T08:58:13,Donostia,expenses,internet,-42.0,-5756.64
buyer_5,Sara,30,ES70209577946926284453,TRX_N-00342-39347181,2022-11-07T08:47:26,Donostia,expenses,gas,-45.44,-5802.08
buyer_5,Sara,30,ES70209577946926284453,TRX_N-00343-68106640,2022-11-07T10:14:59,Donostia,expenses,leisure,-28.55,-5830.63
buyer_5,Sara,30,ES70209577946926284453,TRX_N-00344-04512568,2022-11-07T07:39:18,Donostia,expenses,healthcare,-91.71,-5922.34
buyer_5,Sara,30,ES70209577946926284453,TRX_N-00345-69624232,2022-11-08T23:54:30,Donostia,expenses,electricity,-26.82,-5949.16
buyer_5,Sara,30,ES70209577946926284453,TRX_N-00346-29773841,2022-11-08T14:24:40,Donostia,expenses,cash,-100.0,-6049.16
buyer_5,Sara,30,ES70209577946926284453,TRX_N-00347-16777935,2022-11-10T19:21:31,Donostia,expenses,food,-96.18,-6145.34
buyer_5,Sara,30,ES70209577946926284453,TRX_N-00348-91929792,2022-11-10T19:29:20,Donostia,expenses,leisure,-78.92,-6224.26
buyer_5,Sara,30,ES70209577946926284453,TRX_N-00349-31527702,2022-11-10T13:25:11,Pasaia,expenses,cash,-100.0,-6324.26
buyer_5,Sara,30,ES70209577946926284453,TRX_N-00350-60313600,2022-11-14T15:22:45,Bilbao,expenses,leisure,-56.89,-6381.15
buyer_5,Sara,30,ES70209577946926284453,TRX_N-00351-99868730,2022-11-16T20:26:47,Donostia,expenses,cash,-100.0,-6481.15
buyer_5,Sara,30,ES70209577946926284453,TRX_N-00352-95154483,2022-11-19T12:12:07,Donostia,expenses,food,-123.72,-6604.87
buyer_5,Sara,30,ES70209577946926284453,TRX_N-00353-01619904,2022-11-22T19:22:56,Donostia,expenses,cash,-100.0,-6704.87
buyer_5,Sara,30,ES70209577946926284453,TRX_N-00354-38708164,2022-11-23T11:41:00,Donostia,expenses,food,-79.06,-6783.93
buyer_5,Sara,30,ES70209577946926284453,TRX_N-00355-00596440,2022-11-23T07:01:47,Amurrio,expenses,leisure,-18.67,-6802.6
buyer_5,Sara,30,ES70209577946926284453,TRX_N-00356-94338008,2022-11-25T12:52:30,Erandio,expenses,leisure,-63.82,-6866.42
buyer_5,Sara,30,ES70209577946926284453,TRX_N-00357-42782157,2022-11-25T10:19:32,Donostia,expenses,education,-73.01,-6939.43
buyer_5,Sara,30,ES70209577946926284453,TRX_N-00358-55513314,2022-11-27T02:42:02,Donostia,expenses,repairs,-267.93,-7207.36
buyer_5,Sara,30,ES70209577946926284453,TRX_N-00359-36612767,2022-11-28T18:40:29,Donostia,expenses,food,-120.81,-7328.17
buyer_5,Sara,30,ES70209577946926284453,TRX_N-00360-09963843,2022-11-28T10:25:53,Donostia,expenses,clothing,-117.85,-7446.02
buyer_5,Sara,30,ES70209577946926284453,TRX_N-00361-14666277,2022-11-28T19:57:32,Donostia,expenses,appliances,-194.0,-7640.02
buyer_5,Sara,30,ES70209577946926284453,TRX_N-00362-64267005,2022-11-29T19:19:23,Donostia,expenses,cash,-100.0,-7740.02
buyer_5,Sara,30,ES70209577946926284453,TRX_N-00363-66345923,2022-11-30T10:40:38,Donostia,expenses,transport,-43.14,-7783.16
buyer_5,Sara,30,ES70209577946926284453,TRX_N-00364-67832644,2022-12-01T15:20:02,Donostia,incomes,salary,1284.22,-6498.94
buyer_5,Sara,30,ES70209577946926284453,TRX_N-00365-31737702,2022-12-01T15:20:02,Donostia,incomes,salary_partner,1678.59,-4820.35
buyer_5,Sara,30,ES70209577946926284453,TRX_N-00366-76414993,2022-12-01T15:20:02,Donostia,incomes,salary_bonus,901.47,-3918.88
buyer_5,Sara,30,ES70209577946926284453,TRX_N-00367-07641443,2022-12-01T15:20:02,Donostia,incomes,salary_partner_bonus,1274.8,-2644.08
buyer_5,Sara,30,ES70209577946926284453,TRX_N-00368-98310922,2022-12-01T12:33:16,Donostia,expenses,repairs,-322.02,-2966.1
buyer_5,Sara,30,ES70209577946926284453,TRX_N-00369-97872285,2022-12-02T16:18:54,Amurrio,expenses,appliances,-230.2,-3196.3
buyer_5,Sara,30,ES70209577946926284453,TRX_N-00370-31634276,2022-12-04T14:23:11,Donostia,expenses,mortgage,-897.77,-4094.07
buyer_5,Sara,30,ES70209577946926284453,TRX_N-00371-82220830,2022-12-04T14:04:12,Donostia,expenses,children,-279.38,-4373.45
buyer_5,Sara,30,ES70209577946926284453,TRX_N-00372-33850408,2022-12-05T19:01:00,Donostia,expenses,electricity,-47.79,-4421.24
buyer_5,Sara,30,ES70209577946926284453,TRX_N-00373-70848101,2022-12-05T13:24:09,Donostia,expenses,internet,-42.0,-4463.24
buyer_5,Sara,30,ES70209577946926284453,TRX_N-00374-18531463,2022-12-05T12:54:19,Donostia,expenses,food,-77.92,-4541.16
buyer_5,Sara,30,ES70209577946926284453,TRX_N-00375-32206895,2022-12-05T09:41:05,Donostia,expenses,children,-247.6,-4788.76
buyer_5,Sara,30,ES70209577946926284453,TRX_N-00376-10484316,2022-12-07T22:14:12,Basauri,expenses,appliances,-196.83,-4985.59
buyer_5,Sara,30,ES70209577946926284453,TRX_N-00377-03271725,2022-12-08T06:13:08,Donostia,expenses,water,-28.27,-5013.86
buyer_5,Sara,30,ES70209577946926284453,TRX_N-00378-10307073,2022-12-08T23:47:57,Donostia,expenses,gas,-37.59,-5051.45
buyer_5,Sara,30,ES70209577946926284453,TRX_N-00379-32555193,2022-12-08T21:51:32,Donostia,expenses,phone,-39.0,-5090.45
buyer_5,Sara,30,ES70209577946926284453,TRX_N-00380-41741986,2022-12-11T13:07:40,Donostia,expenses,gifts,-847.4,-5937.85
buyer_5,Sara,30,ES70209577946926284453,TRX_N-00381-47777002,2022-12-13T09:33:24,Elciego,expenses,food,-71.44,-6009.29
buyer_5,Sara,30,ES70209577946926284453,TRX_N-00382-35004100,2022-12-14T08:57:21,Donostia,expenses,leisure,-37.88,-6047.17
buyer_5,Sara,30,ES70209577946926284453,TRX_N-00383-10449233,2022-12-14T13:09:26,Donostia,expenses,clothing,-146.19,-6193.36
buyer_5,Sara,30,ES70209577946926284453,TRX_N-00384-18247290,2022-12-16T10:07:03,Donostia,expenses,cash,-100.0,-6293.36
buyer_5,Sara,30,ES70209577946926284453,TRX_N-00385-71168486,2022-12-17T16:55:20,Donostia,expenses,gifts,-524.81,-6818.17
buyer_5,Sara,30,ES70209577946926284453,TRX_N-00386-89721095,2022-12-18T17:49:40,Donostia,expenses,cash,-100.0,-6918.17
buyer_5,Sara,30,ES70209577946926284453,TRX_N-00387-14152456,2022-12-22T13:38:14,Donostia,expenses,leisure,-49.72,-6967.89
buyer_5,Sara,30,ES70209577946926284453,TRX_N-00388-90031047,2022-12-23T12:44:21,Andoain,expenses,food,-83.18,-7051.07
buyer_5,Sara,30,ES70209577946926284453,TRX_N-00389-37823884,2022-12-25T17:40:45,Donostia,expenses,leisure,-74.68,-7125.75
buyer_5,Sara,30,ES70209577946926284453,TRX_N-00390-78881880,2022-12-25T13:20:41,Donostia,expenses,cash,-100.0,-7225.75
buyer_5,Sara,30,ES70209577946926284453,TRX_N-00391-83410064,2022-12-28T16:42:33,Basauri,expenses,food,-60.81,-7286.56
buyer_5,Sara,30,ES70209577946926284453,TRX_N-00392-13761875,2022-12-28T13:57:49,Donostia,expenses,leisure,-26.38,-7312.94
buyer_5,Sara,30,ES70209577946926284453,TRX_N-00393-39911871,2022-12-29T10:26:44,Donostia,expenses,cash,-100.0,-7412.94
buyer_5,Sara,30,ES70209577946926284453,TRX_N-00394-83639078,2022-12-30T13:50:00,Barakaldo,expenses,food,-74.2,-7487.14
buyer_5,Sara,30,ES70209577946926284453,TRX_N-00395-09284964,2023-01-01T16:00:06,Donostia,incomes,salary,1328.51,-6158.63
buyer_5,Sara,30,ES70209577946926284453,TRX_N-00396-83749978,2023-01-01T16:00:06,Donostia,incomes,salary_partner,1736.49,-4422.14
buyer_5,Sara,30,ES70209577946926284453,TRX_N-00397-35794751,2023-01-04T12:42:19,Donostia,expenses,mortgage,-897.77,-5319.91
buyer_5,Sara,30,ES70209577946926284453,TRX_N-00398-08462282,2023-01-05T10:40:38,Donostia,expenses,electricity,-56.15,-5376.06
buyer_5,Sara,30,ES70209577946926284453,TRX_N-00399-77224752,2023-01-05T13:37:30,Donostia,expenses,gas,-38.18,-5414.24
buyer_5,Sara,30,ES70209577946926284453,TRX_N-00400-40915353,2023-01-05T14:03:07,Iruña de Oca,expenses,transport,-83.27,-5497.51
buyer_5,Sara,30,ES70209577946926284453,TRX_N-00401-35409816,2023-01-05T09:25:14,Donostia,expenses,cash,-100.0,-5597.51
buyer_5,Sara,30,ES70209577946926284453,TRX_N-00402-06054309,2023-01-06T12:30:30,Donostia,expenses,phone,-41.56,-5639.07
buyer_5,Sara,30,ES70209577946926284453,TRX_N-00403-80967215,2023-01-07T13:42:33,Donostia,expenses,water,-25.34,-5664.41
buyer_5,Sara,30,ES70209577946926284453,TRX_N-00404-87115282,2023-01-07T13:17:17,Donostia,expenses,transport,-46.21,-5710.62
buyer_5,Sara,30,ES70209577946926284453,TRX_N-00405-81498454,2023-01-07T19:15:00,Elciego,expenses,cash,-100.0,-5810.62
buyer_5,Sara,30,ES70209577946926284453,TRX_N-00406-20233150,2023-01-08T20:47:43,Donostia,expenses,internet,-42.0,-5852.62
buyer_5,Sara,30,ES70209577946926284453,TRX_N-00407-34230466,2023-01-08T20:36:31,Donostia,expenses,food,-120.46,-5973.08
buyer_5,Sara,30,ES70209577946926284453,TRX_N-00408-56760319,2023-01-09T18:43:14,Donostia,expenses,food,-118.53,-6091.61
buyer_5,Sara,30,ES70209577946926284453,TRX_N-00409-57972374,2023-01-09T17:02:32,Donostia,expenses,leisure,-44.8,-6136.41
buyer_5,Sara,30,ES70209577946926284453,TRX_N-00410-44282520,2023-01-09T16:35:15,Donostia,expenses,repairs,-84.58,-6220.99
buyer_5,Sara,30,ES70209577946926284453,TRX_N-00411-30233189,2023-01-10T09:47:20,Donostia,expenses,education,-52.0,-6272.99
buyer_5,Sara,30,ES70209577946926284453,TRX_N-00412-39711098,2023-01-11T02:36:21,Salvatierra/Agurain,expenses,food,-73.81,-6346.8
buyer_5,Sara,30,ES70209577946926284453,TRX_N-00413-42950120,2023-01-11T09:59:16,Donostia,expenses,gifts,-402.09,-6748.89
buyer_5,Sara,30,ES70209577946926284453,TRX_N-00414-97731754,2023-01-12T12:22:05,Getxo,expenses,gifts,-631.25,-7380.14
buyer_5,Sara,30,ES70209577946926284453,TRX_N-00415-74845655,2023-01-12T18:34:49,Donostia,expenses,children,-268.38,-7648.52
buyer_5,Sara,30,ES70209577946926284453,TRX_N-00416-11177194,2023-01-13T06:43:27,Donostia,expenses,healthcare,-140.11,-7788.63
buyer_5,Sara,30,ES70209577946926284453,TRX_N-00417-27801480,2023-01-15T15:53:08,Donostia,expenses,food,-107.75,-7896.38
buyer_5,Sara,30,ES70209577946926284453,TRX_N-00418-01253695,2023-01-16T11:27:51,Donostia,expenses,transport,-85.32,-7981.7
buyer_5,Sara,30,ES70209577946926284453,TRX_N-00419-82684226,2023-01-16T15:40:09,Donostia,expenses,gifts,-787.76,-8769.46
buyer_5,Sara,30,ES70209577946926284453,TRX_N-00420-36677390,2023-01-18T20:25:39,Donostia,expenses,food,-74.3,-8843.76
buyer_5,Sara,30,ES70209577946926284453,TRX_N-00421-44136105,2023-01-19T21:08:14,Donostia,expenses,healthcare,-184.46,-9028.22
buyer_5,Sara,30,ES70209577946926284453,TRX_N-00422-41369556,2023-01-20T15:20:39,Hernani,expenses,food,-117.49,-9145.71
buyer_5,Sara,30,ES70209577946926284453,TRX_N-00423-28404767,2023-01-20T22:34:26,Donostia,expenses,gifts,-527.55,-9673.26
buyer_5,Sara,30,ES70209577946926284453,TRX_N-00424-23027043,2023-01-20T02:46:02,Donostia,expenses,children,-135.77,-9809.03
buyer_5,Sara,30,ES70209577946926284453,TRX_N-00425-37381292,2023-01-21T05:06:17,Donostia,expenses,transport,-59.18,-9868.21
buyer_5,Sara,30,ES70209577946926284453,TRX_N-00426-34720953,2023-01-22T20:36:03,Donostia,expenses,leisure,-59.0,-9927.21
buyer_5,Sara,30,ES70209577946926284453,TRX_N-00427-28083202,2023-01-23T18:29:08,Donostia,expenses,transport,-50.53,-9977.74
buyer_5,Sara,30,ES70209577946926284453,TRX_N-00428-92846274,2023-01-24T11:31:29,Donostia,expenses,food,-88.69,-10066.43
buyer_5,Sara,30,ES70209577946926284453,TRX_N-00429-96600346,2023-01-26T09:17:16,Donostia,expenses,leisure,-23.04,-10089.47
buyer_5,Sara,30,ES70209577946926284453,TRX_N-00430-68673151,2023-01-28T22:57:14,Donostia,expenses,transport,-79.76,-10169.23
buyer_5,Sara,30,ES70209577946926284453,TRX_N-00431-52959439,2023-01-28T16:32:00,Donostia,expenses,children,-176.7,-10345.93
buyer_5,Sara,30,ES70209577946926284453,TRX_N-00432-65941920,2023-01-29T14:40:40,Donostia,expenses,clothing,-153.29,-10499.22
buyer_5,Sara,30,ES70209577946926284453,TRX_N-00433-69325165,2023-01-29T11:35:25,Donostia,expenses,healthcare,-116.73,-10615.95
buyer_5,Sara,30,ES70209577946926284453,TRX_N-00434-42777120,2023-01-30T14:46:59,Donostia,expenses,education,-66.21,-10682.16
buyer_5,Sara,30,ES70209577946926284453,TRX_N-00435-57395135,2023-02-01T16:14:52,Donostia,incomes,salary,1328.51,-9353.65
buyer_5,Sara,30,ES70209577946926284453,TRX_N-00436-24711503,2023-02-01T16:14:52,Donostia,incomes,salary_partner,1736.49,-7617.16
buyer_5,Sara,30,ES70209577946926284453,TRX_N-00437-64665513,2023-02-01T16:14:52,Donostia,incomes,extra_income,170.69,-7446.47
buyer_5,Sara,30,ES70209577946926284453,TRX_N-00438-93055589,2023-02-02T19:07:13,Donostia,expenses,food,-94.1,-7540.57
buyer_5,Sara,30,ES70209577946926284453,TRX_N-00439-59596320,2023-02-03T12:04:16,Donostia,expenses,transport,-45.64,-7586.21
buyer_5,Sara,30,ES70209577946926284453,TRX_N-00440-21993949,2023-02-03T09:46:10,Donostia,expenses,children,-178.96,-7765.17
buyer_5,Sara,30,ES70209577946926284453,TRX_N-00441-32509585,2023-02-04T18:08:18,Donostia,expenses,mortgage,-897.77,-8662.94
buyer_5,Sara,30,ES70209577946926284453,TRX_N-00442-75795568,2023-02-05T14:44:52,Donostia,expenses,gas,-63.91,-8726.85
buyer_5,Sara,30,ES70209577946926284453,TRX_N-00443-02852681,2023-02-06T18:47:12,Donostia,expenses,water,-30.64,-8757.49
buyer_5,Sara,30,ES70209577946926284453,TRX_N-00444-14968856,2023-02-06T05:22:00,Donostia,expenses,internet,-42.0,-8799.49
buyer_5,Sara,30,ES70209577946926284453,TRX_N-00445-18549923,2023-02-06T04:44:50,Donostia,expenses,phone,-33.52,-8833.01
buyer_5,Sara,30,ES70209577946926284453,TRX_N-00446-22253905,2023-02-06T03:36:53,Donostia,expenses,transport,-75.74,-8908.75
buyer_5,Sara,30,ES70209577946926284453,TRX_N-00447-05948096,2023-02-07T08:51:41,Donostia,expenses,transport,-41.74,-8950.49
buyer_5,Sara,30,ES70209577946926284453,TRX_N-00448-21415053,2023-02-07T19:45:21,Donostia,expenses,cash,-100.0,-9050.49
buyer_5,Sara,30,ES70209577946926284453,TRX_N-00449-84454334,2023-02-08T13:36:34,Donostia,expenses,electricity,-37.61,-9088.1
buyer_5,Sara,30,ES70209577946926284453,TRX_N-00450-65265177,2023-02-11T09:37:05,Donostia,expenses,food,-88.98,-9177.08
buyer_5,Sara,30,ES70209577946926284453,TRX_N-00451-08984981,2023-02-11T20:45:22,Lasarte-Oria,expenses,transport,-62.52,-9239.6
buyer_5,Sara,30,ES70209577946926284453,TRX_N-00452-18590291,2023-02-11T20:53:02,Donostia,expenses,leisure,-35.36,-9274.96
buyer_5,Sara,30,ES70209577946926284453,TRX_N-00453-06911843,2023-02-11T09:31:56,Donostia,expenses,repairs,-221.26,-9496.22
buyer_5,Sara,30,ES70209577946926284453,TRX_N-00454-01356789,2023-02-12T17:02:27,Donostia,expenses,leisure,-82.01,-9578.23
buyer_5,Sara,30,ES70209577946926284453,TRX_N-00455-48936452,2023-02-12T20:16:35,Donostia,expenses,cash,-100.0,-9678.23
buyer_5,Sara,30,ES70209577946926284453,TRX_N-00456-15504121,2023-02-12T13:50:05,Donostia,expenses,gifts,-189.97,-9868.2
buyer_5,Sara,30,ES70209577946926284453,TRX_N-00457-23335392,2023-02-13T12:50:00,Donostia,expenses,cash,-100.0,-9968.2
buyer_5,Sara,30,ES70209577946926284453,TRX_N-00458-05287920,2023-02-14T16:01:47,Donostia,expenses,education,-53.27,-10021.47
buyer_5,Sara,30,ES70209577946926284453,TRX_N-00459-24042755,2023-02-16T09:36:43,Donostia,expenses,leisure,-30.01,-10051.48
buyer_5,Sara,30,ES70209577946926284453,TRX_N-00460-25392140,2023-02-17T14:55:17,Vitoria-Gasteiz,expenses,leisure,-23.27,-10074.75
buyer_5,Sara,30,ES70209577946926284453,TRX_N-00461-13453302,2023-02-17T15:52:57,Salvatierra/Agurain,expenses,cash,-100.0,-10174.75
buyer_5,Sara,30,ES70209577946926284453,TRX_N-00462-77340161,2023-02-18T19:54:57,Donostia,expenses,leisure,-31.74,-10206.49
buyer_5,Sara,30,ES70209577946926284453,TRX_N-00463-22894167,2023-02-18T18:46:59,Basauri,expenses,appliances,-147.14,-10353.63
buyer_5,Sara,30,ES70209577946926284453,TRX_N-00464-68478989,2023-02-20T12:05:25,Donostia,expenses,food,-71.73,-10425.36
buyer_5,Sara,30,ES70209577946926284453,TRX_N-00465-55632038,2023-02-22T17:19:50,Donostia,expenses,leisure,-38.17,-10463.53
buyer_5,Sara,30,ES70209577946926284453,TRX_N-00466-89327898,2023-02-22T17:44:12,Donostia,expenses,travel,-1451.48,-11915.01
buyer_5,Sara,30,ES70209577946926284453,TRX_N-00467-28206139,2023-02-27T13:25:53,Eibar,expenses,food,-77.21,-11992.22
buyer_5,Sara,30,ES70209577946926284453,TRX_N-00468-21798585,2023-02-27T13:45:19,Donostia,expenses,transport,-44.12,-12036.34
buyer_5,Sara,30,ES70209577946926284453,TRX_N-00469-04920924,2023-02-27T13:46:55,Donostia,expenses,cash,-100.0,-12136.34
buyer_5,Sara,30,ES70209577946926284453,TRX_N-00470-34399240,2023-02-28T15:57:56,Donostia,expenses,healthcare,-135.84,-12272.18
buyer_5,Sara,30,ES70209577946926284453,TRX_N-00471-00360833,2023-02-28T13:08:54,Donostia,expenses,cash,-100.0,-12372.18
buyer_5,Sara,30,ES70209577946926284453,TRX_N-00472-92359363,2023-02-28T11:37:08,Donostia,expenses,gifts,-808.85,-13181.03
buyer_5,Sara,30,ES70209577946926284453,TRX_N-00473-02532252,2023-03-01T09:41:02,Donostia,incomes,salary,1328.51,-11852.52
buyer_5,Sara,30,ES70209577946926284453,TRX_N-00474-95555131,2023-03-01T09:41:02,Donostia,incomes,salary_partner,1736.49,-10116.03
buyer_5,Sara,30,ES70209577946926284453,TRX_N-00475-51669228,2023-03-01T16:19:04,Donostia,expenses,food,-73.51,-10189.54
buyer_5,Sara,30,ES70209577946926284453,TRX_N-00476-59373651,2023-03-02T12:46:47,Donostia,expenses,food,-83.25,-10272.79
buyer_5,Sara,30,ES70209577946926284453,TRX_N-00477-07787623,2023-03-02T15:13:40,Donostia,expenses,healthcare,-85.54,-10358.33
buyer_5,Sara,30,ES70209577946926284453,TRX_N-00478-55683753,2023-03-03T15:27:55,Donostia,expenses,food,-60.36,-10418.69
buyer_5,Sara,30,ES70209577946926284453,TRX_N-00479-24944133,2023-03-03T17:13:51,Donostia,expenses,gifts,-353.82,-10772.51
buyer_5,Sara,30,ES70209577946926284453,TRX_N-00480-15606392,2023-03-04T12:19:35,Donostia,expenses,mortgage,-897.77,-11670.28
buyer_5,Sara,30,ES70209577946926284453,TRX_N-00481-69160693,2023-03-04T22:08:09,Donostia,expenses,healthcare,-100.89,-11771.17
buyer_5,Sara,30,ES70209577946926284453,TRX_N-00482-96713759,2023-03-05T10:34:37,Donostia,expenses,gas,-37.95,-11809.12
buyer_5,Sara,30,ES70209577946926284453,TRX_N-00483-23229859,2023-03-05T17:32:31,Donostia,expenses,leisure,-50.93,-11860.05
buyer_5,Sara,30,ES70209577946926284453,TRX_N-00484-98629603,2023-03-05T20:09:25,Donostia,expenses,repairs,-264.86,-12124.91
buyer_5,Sara,30,ES70209577946926284453,TRX_N-00485-25799132,2023-03-06T20:00:15,Donostia,expenses,electricity,-64.92,-12189.83
buyer_5,Sara,30,ES70209577946926284453,TRX_N-00486-77482161,2023-03-07T17:40:56,Donostia,expenses,internet,-42.0,-12231.83
buyer_5,Sara,30,ES70209577946926284453,TRX_N-00487-72659376,2023-03-07T17:53:08,Donostia,expenses,repairs,-285.65,-12517.48
buyer_5,Sara,30,ES70209577946926284453,TRX_N-00488-73093287,2023-03-08T10:29:19,Donostia,expenses,water,-23.14,-12540.62
buyer_5,Sara,30,ES70209577946926284453,TRX_N-00489-77666224,2023-03-08T13:46:52,Donostia,expenses,phone,-39.43,-12580.05
buyer_5,Sara,30,ES70209577946926284453,TRX_N-00490-06381588,2023-03-08T10:12:07,Donostia,expenses,transport,-81.42,-12661.47
buyer_5,Sara,30,ES70209577946926284453,TRX_N-00491-19157816,2023-03-08T05:26:52,Donostia,expenses,cash,-100.0,-12761.47
buyer_5,Sara,30,ES70209577946926284453,TRX_N-00492-50283193,2023-03-08T10:51:48,Donostia,expenses,gifts,-235.0,-12996.47
buyer_5,Sara,30,ES70209577946926284453,TRX_N-00493-39293002,2023-03-09T14:06:45,Lasarte-Oria,expenses,food,-96.75,-13093.22
buyer_5,Sara,30,ES70209577946926284453,TRX_N-00494-23497166,2023-03-10T17:38:20,Donostia,expenses,food,-79.5,-13172.72
buyer_5,Sara,30,ES70209577946926284453,TRX_N-00495-06661184,2023-03-11T17:18:13,Donostia,expenses,transport,-40.63,-13213.35
buyer_5,Sara,30,ES70209577946926284453,TRX_N-00496-60683126,2023-03-12T20:55:33,Leioa,expenses,cash,-100.0,-13313.35
buyer_5,Sara,30,ES70209577946926284453,TRX_N-00497-83598684,2023-03-13T13:56:15,Donostia,expenses,leisure,-31.45,-13344.8
buyer_5,Sara,30,ES70209577946926284453,TRX_N-00498-69761003,2023-03-13T13:29:16,Donostia,expenses,travel,-1520.98,-14865.78
buyer_5,Sara,30,ES70209577946926284453,TRX_N-00499-91716708,2023-03-13T22:50:49,Donostia,expenses,gifts,-115.17,-14980.95
buyer_5,Sara,30,ES70209577946926284453,TRX_N-00500-74669964,2023-03-14T10:07:35,Donostia,expenses,transport,-72.9,-15053.85
buyer_5,Sara,30,ES70209577946926284453,TRX_N-00501-94774880,2023-03-18T19:57:09,Iruña de Oca,expenses,transport,-72.73,-15126.58
buyer_5,Sara,30,ES70209577946926284453,TRX_N-00502-44362040,2023-03-23T14:17:19,Hernani,expenses,gifts,-91.55,-15218.13
buyer_5,Sara,30,ES70209577946926284453,TRX_N-00503-33734677,2023-03-23T14:07:47,Donostia,expenses,children,-224.85,-15442.98
buyer_5,Sara,30,ES70209577946926284453,TRX_N-00504-94717823,2023-03-24T09:58:40,Donostia,expenses,transport,-62.66,-15505.64
buyer_5,Sara,30,ES70209577946926284453,TRX_N-00505-11369620,2023-03-25T21:52:09,Donostia,expenses,food,-93.47,-15599.11
buyer_5,Sara,30,ES70209577946926284453,TRX_N-00506-29986883,2023-03-25T21:34:03,Donostia,expenses,healthcare,-83.25,-15682.36
buyer_5,Sara,30,ES70209577946926284453,TRX_N-00507-97710843,2023-03-26T11:34:42,Donostia,expenses,food,-69.26,-15751.62
buyer_5,Sara,30,ES70209577946926284453,TRX_N-00508-95184182,2023-03-27T00:15:34,Errenteria,expenses,cash,-100.0,-15851.62
buyer_5,Sara,30,ES70209577946926284453,TRX_N-00509-18174802,2023-03-28T12:18:45,Donostia,expenses,leisure,-69.25,-15920.87
buyer_5,Sara,30,ES70209577946926284453,TRX_N-00510-35803515,2023-03-28T15:31:55,Donostia,expenses,education,-59.97,-15980.84
buyer_5,Sara,30,ES70209577946926284453,TRX_N-00511-11926570,2023-03-29T10:33:52,Donostia,expenses,cash,-100.0,-16080.84
buyer_5,Sara,30,ES70209577946926284453,TRX_N-00512-09221365,2023-03-30T08:35:08,Basauri,expenses,leisure,-57.39,-16138.23
buyer_5,Sara,30,ES70209577946926284453,TRX_N-00513-15663979,2023-03-31T11:44:18,Eibar,expenses,food,-68.26,-16206.49
buyer_5,Sara,30,ES70209577946926284453,TRX_N-00514-03587962,2023-03-31T19:59:17,Donostia,expenses,cash,-100.0,-16306.49
buyer_5,Sara,30,ES70209577946926284453,TRX_N-00515-63755242,2023-03-31T22:22:40,Donostia,expenses,appliances,-361.05,-16667.54
buyer_5,Sara,30,ES70209577946926284453,TRX_N-00516-18824057,2023-04-01T08:20:40,Donostia,incomes,salary,1328.51,-15339.03
buyer_5,Sara,30,ES70209577946926284453,TRX_N-00517-26957432,2023-04-01T08:20:40,Donostia,incomes,salary_partner,1736.49,-13602.54
buyer_5,Sara,30,ES70209577946926284453,TRX_N-00518-26230703,2023-04-01T09:25:38,Berango,expenses,clothing,-104.86,-13707.4
buyer_5,Sara,30,ES70209577946926284453,TRX_N-00519-17836653,2023-04-02T14:23:37,Donostia,expenses,repairs,-155.89,-13863.29
buyer_5,Sara,30,ES70209577946926284453,TRX_N-00520-72702376,2023-04-03T16:49:27,Donostia,expenses,repairs,-302.31,-14165.6
buyer_5,Sara,30,ES70209577946926284453,TRX_N-00521-92688378,2023-04-04T09:46:11,Donostia,expenses,mortgage,-897.77,-15063.37
buyer_5,Sara,30,ES70209577946926284453,TRX_N-00522-25208627,2023-04-04T14:30:33,Getxo,expenses,repairs,-188.95,-15252.32
buyer_5,Sara,30,ES70209577946926284453,TRX_N-00523-70078778,2023-04-05T15:03:57,Donostia,expenses,internet,-42.0,-15294.32
buyer_5,Sara,30,ES70209577946926284453,TRX_N-00524-23341446,2023-04-05T17:54:13,Donostia,expenses,food,-104.28,-15398.6
buyer_5,Sara,30,ES70209577946926284453,TRX_N-00525-83503186,2023-04-06T08:04:46,Donostia,expenses,phone,-42.01,-15440.61
buyer_5,Sara,30,ES70209577946926284453,TRX_N-00526-26187008,2023-04-06T12:29:03,Donostia,expenses,food,-73.31,-15513.92
buyer_5,Sara,30,ES70209577946926284453,TRX_N-00527-73123953,2023-04-07T17:50:20,Donostia,expenses,water,-26.5,-15540.42
buyer_5,Sara,30,ES70209577946926284453,TRX_N-00528-97915601,2023-04-07T18:32:40,Donostia,expenses,leisure,-27.31,-15567.73
buyer_5,Sara,30,ES70209577946926284453,TRX_N-00529-21329824,2023-04-07T14:18:36,Donostia,expenses,cash,-100.0,-15667.73
buyer_5,Sara,30,ES70209577946926284453,TRX_N-00530-32705550,2023-04-08T19:13:10,Donostia,expenses,electricity,-20.28,-15688.01
buyer_5,Sara,30,ES70209577946926284453,TRX_N-00531-14995354,2023-04-08T18:16:51,Donostia,expenses,gas,-68.28,-15756.29
buyer_5,Sara,30,ES70209577946926284453,TRX_N-00532-99716917,2023-04-09T09:24:59,Donostia,expenses,food,-60.01,-15816.3
buyer_5,Sara,30,ES70209577946926284453,TRX_N-00533-80068741,2023-04-12T15:54:45,Donostia,expenses,leisure,-78.87,-15895.17
buyer_5,Sara,30,ES70209577946926284453,TRX_N-00534-74095321,2023-04-14T04:23:42,Donostia,expenses,food,-96.48,-15991.65
buyer_5,Sara,30,ES70209577946926284453,TRX_N-00535-04861426,2023-04-14T17:51:00,Donostia,expenses,cash,-100.0,-16091.65
buyer_5,Sara,30,ES70209577946926284453,TRX_N-00536-49502252,2023-04-16T15:10:03,Donostia,expenses,healthcare,-147.25,-16238.9
buyer_5,Sara,30,ES70209577946926284453,TRX_N-00537-58388917,2023-04-18T14:29:47,Donostia,expenses,gifts,-81.75,-16320.65
buyer_5,Sara,30,ES70209577946926284453,TRX_N-00538-22828428,2023-04-19T08:38:19,Donostia,expenses,food,-71.82,-16392.47
buyer_5,Sara,30,ES70209577946926284453,TRX_N-00539-02984208,2023-04-21T09:28:25,Donostia,expenses,transport,-40.12,-16432.59
buyer_5,Sara,30,ES70209577946926284453,TRX_N-00540-51729650,2023-04-22T15:08:39,Oyón-Oion,expenses,food,-87.18,-16519.77
buyer_5,Sara,30,ES70209577946926284453,TRX_N-00541-38996569,2023-04-22T16:08:25,Donostia,expenses,cash,-100.0,-16619.77
buyer_5,Sara,30,ES70209577946926284453,TRX_N-00542-39429085,2023-04-23T12:34:00,Santurtzi,expenses,cash,-100.0,-16719.77
buyer_5,Sara,30,ES70209577946926284453,TRX_N-00543-29901378,2023-04-25T23:22:57,Leioa,expenses,leisure,-56.43,-16776.2
buyer_5,Sara,30,ES70209577946926284453,TRX_N-00544-94798189,2023-04-28T20:58:46,Donostia,expenses,food,-79.5,-16855.7
buyer_5,Sara,30,ES70209577946926284453,TRX_N-00545-36947182,2023-04-28T16:41:00,Donostia,expenses,children,-93.19,-16948.89
buyer_5,Sara,30,ES70209577946926284453,TRX_N-00546-57373720,2023-04-29T18:28:33,Donostia,expenses,children,-265.41,-17214.3
buyer_5,Sara,30,ES70209577946926284453,TRX_N-00547-50028956,2023-05-01T12:58:26,Donostia,incomes,salary,1328.51,-15885.79
buyer_5,Sara,30,ES70209577946926284453,TRX_N-00548-99017023,2023-05-01T12:58:26,Donostia,incomes,salary_partner,1736.49,-14149.3
buyer_5,Sara,30,ES70209577946926284453,TRX_N-00549-20743981,2023-05-01T12:58:26,Donostia,incomes,extra_income,170.69,-13978.61
buyer_5,Sara,30,ES70209577946926284453,TRX_N-00550-24505989,2023-05-01T18:59:21,Donostia,expenses,leisure,-22.29,-14000.9
buyer_5,Sara,30,ES70209577946926284453,TRX_N-00551-94201652,2023-05-03T10:54:56,Donostia,expenses,cash,-100.0,-14100.9
buyer_5,Sara,30,ES70209577946926284453,TRX_N-00552-26481610,2023-05-04T17:28:57,Donostia,expenses,mortgage,-897.77,-14998.67
buyer_5,Sara,30,ES70209577946926284453,TRX_N-00553-81295840,2023-05-05T14:55:53,Donostia,expenses,water,-29.97,-15028.64
buyer_5,Sara,30,ES70209577946926284453,TRX_N-00554-63129984,2023-05-05T08:47:03,Donostia,expenses,gas,-81.65,-15110.29
buyer_5,Sara,30,ES70209577946926284453,TRX_N-00555-64967587,2023-05-05T15:41:07,Donostia,expenses,leisure,-78.84,-15189.13
buyer_5,Sara,30,ES70209577946926284453,TRX_N-00556-60115869,2023-05-05T10:31:37,Donostia,expenses,cash,-100.0,-15289.13
buyer_5,Sara,30,ES70209577946926284453,TRX_N-00557-10409610,2023-05-07T08:45:47,Donostia,expenses,phone,-44.36,-15333.49
buyer_5,Sara,30,ES70209577946926284453,TRX_N-00558-84383361,2023-05-08T08:50:20,Donostia,expenses,internet,-42.0,-15375.49
buyer_5,Sara,30,ES70209577946926284453,TRX_N-00559-97023382,2023-05-08T13:08:49,Donostia,expenses,electricity,-55.02,-15430.51
buyer_5,Sara,30,ES70209577946926284453,TRX_N-00560-35858810,2023-05-08T13:59:07,Donostia,expenses,transport,-44.09,-15474.6
buyer_5,Sara,30,ES70209577946926284453,TRX_N-00561-57354369,2023-05-08T05:59:46,Galdakao,expenses,leisure,-60.3,-15534.9
buyer_5,Sara,30,ES70209577946926284453,TRX_N-00562-52040238,2023-05-09T11:41:33,Donostia,expenses,food,-73.37,-15608.27
buyer_5,Sara,30,ES70209577946926284453,TRX_N-00563-27981943,2023-05-10T21:27:11,Donostia,expenses,food,-83.78,-15692.05
buyer_5,Sara,30,ES70209577946926284453,TRX_N-00564-73174831,2023-05-14T09:30:08,Donostia,expenses,cash,-100.0,-15792.05
buyer_5,Sara,30,ES70209577946926284453,TRX_N-00565-65993999,2023-05-15T12:43:54,Donostia,expenses,gifts,-533.1,-16325.15
buyer_5,Sara,30,ES70209577946926284453,TRX_N-00566-75919698,2023-05-16T09:12:07,Getxo,expenses,leisure,-61.94,-16387.09
buyer_5,Sara,30,ES70209577946926284453,TRX_N-00567-61706589,2023-05-17T12:12:06,Donostia,expenses,cash,-100.0,-16487.09
buyer_5,Sara,30,ES70209577946926284453,TRX_N-00568-29424760,2023-05-18T12:25:26,Barakaldo,expenses,food,-65.26,-16552.35
buyer_5,Sara,30,ES70209577946926284453,TRX_N-00569-81001494,2023-05-19T11:19:13,Donostia,expenses,gifts,-538.14,-17090.49
buyer_5,Sara,30,ES70209577946926284453,TRX_N-00570-96071359,2023-05-20T18:48:53,Donostia,expenses,cash,-100.0,-17190.49
buyer_5,Sara,30,ES70209577946926284453,TRX_N-00571-55515057,2023-05-21T15:38:38,Donostia,expenses,repairs,-205.5,-17395.99
buyer_5,Sara,30,ES70209577946926284453,TRX_N-00572-31864113,2023-05-22T09:44:48,Donostia,expenses,food,-108.3,-17504.29
buyer_5,Sara,30,ES70209577946926284453,TRX_N-00573-10430453,2023-05-24T08:58:11,Donostia,expenses,healthcare,-150.69,-17654.98
buyer_5,Sara,30,ES70209577946926284453,TRX_N-00574-40429316,2023-05-28T12:48:20,Donostia,expenses,leisure,-53.78,-17708.76
buyer_5,Sara,30,ES70209577946926284453,TRX_N-00575-80508320,2023-05-28T12:33:16,Donostia,expenses,cash,-100.0,-17808.76
buyer_5,Sara,30,ES70209577946926284453,TRX_N-00576-09546454,2023-05-29T17:52:11,Donostia,expenses,cash,-100.0,-17908.76
buyer_5,Sara,30,ES70209577946926284453,TRX_N-00577-83282954,2023-05-30T14:50:57,Donostia,expenses,cash,-100.0,-18008.76
buyer_5,Sara,30,ES70209577946926284453,TRX_N-00578-87677589,2023-05-31T20:23:26,Donostia,expenses,transport,-41.79,-18050.55
buyer_5,Sara,30,ES70209577946926284453,TRX_N-00579-29682467,2023-05-31T15:57:08,Donostia,expenses,leisure,-68.45,-18119.0
buyer_5,Sara,30,ES70209577946926284453,TRX_N-00580-40834159,2023-06-01T15:16:07,Donostia,incomes,salary,1328.51,-16790.49
buyer_5,Sara,30,ES70209577946926284453,TRX_N-00581-48189155,2023-06-01T15:16:07,Donostia,incomes,salary_partner,1736.49,-15054.0
buyer_5,Sara,30,ES70209577946926284453,TRX_N-00582-55213625,2023-06-01T15:16:07,Donostia,incomes,salary_bonus,1037.2,-14016.8
buyer_5,Sara,30,ES70209577946926284453,TRX_N-00583-14708753,2023-06-01T15:16:07,Donostia,incomes,salary_partner_bonus,1373.33,-12643.47
buyer_5,Sara,30,ES70209577946926284453,TRX_N-00584-83646442,2023-06-04T12:48:04,Donostia,expenses,mortgage,-897.77,-13541.24
buyer_5,Sara,30,ES70209577946926284453,TRX_N-00585-39520509,2023-06-04T14:43:57,Donostia,expenses,gifts,-473.95,-14015.19
buyer_5,Sara,30,ES70209577946926284453,TRX_N-00586-35305582,2023-06-05T18:17:30,Donostia,expenses,gas,-44.78,-14059.97
buyer_5,Sara,30,ES70209577946926284453,TRX_N-00587-71240510,2023-06-05T16:26:36,Donostia,expenses,internet,-42.0,-14101.97
buyer_5,Sara,30,ES70209577946926284453,TRX_N-00588-91416935,2023-06-05T21:53:48,Zuia,expenses,food,-62.64,-14164.61
buyer_5,Sara,30,ES70209577946926284453,TRX_N-00589-70784785,2023-06-05T02:00:38,Donostia,expenses,appliances,-131.02,-14295.63
buyer_5,Sara,30,ES70209577946926284453,TRX_N-00590-63430315,2023-06-06T07:33:57,Donostia,expenses,electricity,-29.38,-14325.01
buyer_5,Sara,30,ES70209577946926284453,TRX_N-00591-99353977,2023-06-06T15:09:36,Donostia,expenses,healthcare,-82.7,-14407.71
buyer_5,Sara,30,ES70209577946926284453,TRX_N-00592-80986520,2023-06-06T18:50:52,Donostia,expenses,cash,-100.0,-14507.71
buyer_5,Sara,30,ES70209577946926284453,TRX_N-00593-15793159,2023-06-07T10:48:58,Labastida,expenses,clothing,-64.61,-14572.32
buyer_5,Sara,30,ES70209577946926284453,TRX_N-00594-86047903,2023-06-08T18:36:03,Donostia,expenses,water,-30.33,-14602.65
buyer_5,Sara,30,ES70209577946926284453,TRX_N-00595-88399564,2023-06-08T13:02:35,Donostia,expenses,phone,-37.84,-14640.49
buyer_5,Sara,30,ES70209577946926284453,TRX_N-00596-69062602,2023-06-09T15:41:53,Donostia,expenses,cash,-100.0,-14740.49
buyer_5,Sara,30,ES70209577946926284453,TRX_N-00597-44252542,2023-06-10T09:45:04,Donostia,expenses,gifts,-592.17,-15332.66
buyer_5,Sara,30,ES70209577946926284453,TRX_N-00598-83143165,2023-06-11T15:10:59,Donostia,expenses,food,-84.09,-15416.75
buyer_5,Sara,30,ES70209577946926284453,TRX_N-00599-30330634,2023-06-11T15:29:03,Donostia,expenses,clothing,-47.73,-15464.48
buyer_5,Sara,30,ES70209577946926284453,TRX_N-00600-62391616,2023-06-11T18:51:09,Donostia,expenses,repairs,-206.93,-15671.41
buyer_5,Sara,30,ES70209577946926284453,TRX_N-00601-70095824,2023-06-11T19:38:58,Donostia,expenses,gifts,-636.67,-16308.08
buyer_5,Sara,30,ES70209577946926284453,TRX_N-00602-48237733,2023-06-12T11:13:35,Donostia,expenses,food,-87.96,-16396.04
buyer_5,Sara,30,ES70209577946926284453,TRX_N-00603-46084223,2023-06-12T11:00:08,Donostia,expenses,transport,-56.74,-16452.78
buyer_5,Sara,30,ES70209577946926284453,TRX_N-00604-86259678,2023-06-12T01:49:30,Donostia,expenses,education,-49.56,-16502.34
buyer_5,Sara,30,ES70209577946926284453,TRX_N-00605-25835218,2023-06-12T21:45:28,Donostia,expenses,gifts,-401.76,-16904.1
buyer_5,Sara,30,ES70209577946926284453,TRX_N-00606-64714218,2023-06-13T17:51:39,Galdakao,expenses,cash,-100.0,-17004.1
buyer_5,Sara,30,ES70209577946926284453,TRX_N-00607-47727758,2023-06-15T08:10:40,Donostia,expenses,cash,-100.0,-17104.1
buyer_5,Sara,30,ES70209577946926284453,TRX_N-00608-51080284,2023-06-17T11:57:33,Llodio,expenses,food,-118.29,-17222.39
buyer_5,Sara,30,ES70209577946926284453,TRX_N-00609-69692479,2023-06-17T08:52:11,Donostia,expenses,healthcare,-141.39,-17363.78
buyer_5,Sara,30,ES70209577946926284453,TRX_N-00610-32487319,2023-06-17T07:52:19,Donostia,expenses,children,-223.55,-17587.33
buyer_5,Sara,30,ES70209577946926284453,TRX_N-00611-42649172,2023-06-20T14:40:15,Donostia,expenses,appliances,-327.45,-17914.78
buyer_5,Sara,30,ES70209577946926284453,TRX_N-00612-09015458,2023-06-21T18:09:17,Donostia,expenses,cash,-100.0,-18014.78
buyer_5,Sara,30,ES70209577946926284453,TRX_N-00613-72352032,2023-06-22T16:30:13,Lasarte-Oria,expenses,transport,-69.04,-18083.82
buyer_5,Sara,30,ES70209577946926284453,TRX_N-00614-63518343,2023-06-22T12:34:59,Donostia,expenses,appliances,-376.62,-18460.44
buyer_5,Sara,30,ES70209577946926284453,TRX_N-00615-58295846,2023-06-23T14:58:37,Donostia,expenses,clothing,-76.7,-18537.14
buyer_5,Sara,30,ES70209577946926284453,TRX_N-00616-15633086,2023-06-23T15:17:43,Donostia,expenses,repairs,-196.37,-18733.51
buyer_5,Sara,30,ES70209577946926284453,TRX_N-00617-16845913,2023-06-24T13:52:24,Donostia,expenses,leisure,-47.5,-18781.01
buyer_5,Sara,30,ES70209577946926284453,TRX_N-00618-49759902,2023-06-27T16:09:40,Donostia,expenses,appliances,-409.32,-19190.33
buyer_5,Sara,30,ES70209577946926284453,TRX_N-00619-60645194,2023-06-28T20:20:48,Donostia,expenses,food,-91.64,-19281.97
buyer_5,Sara,30,ES70209577946926284453,TRX_N-00620-56397981,2023-06-28T16:52:35,Donostia,expenses,appliances,-409.65,-19691.62
buyer_5,Sara,30,ES70209577946926284453,TRX_N-00621-81970269,2023-07-01T11:33:27,Donostia,incomes,salary,1328.51,-18363.11
buyer_5,Sara,30,ES70209577946926284453,TRX_N-00622-14097027,2023-07-01T11:33:27,Donostia,incomes,salary_partner,1736.49,-16626.62
buyer_5,Sara,30,ES70209577946926284453,TRX_N-00623-61720547,2023-07-02T20:17:30,Donostia,expenses,transport,-75.93,-16702.55
buyer_5,Sara,30,ES70209577946926284453,TRX_N-00624-25512601,2023-07-02T06:05:48,Donostia,expenses,clothing,-150.46,-16853.01
buyer_5,Sara,30,ES70209577946926284453,TRX_N-00625-23248678,2023-07-03T14:36:52,Donostia,expenses,food,-89.79,-16942.8
buyer_5,Sara,30,ES70209577946926284453,TRX_N-00626-41666789,2023-07-03T08:42:12,Donostia,expenses,leisure,-23.41,-16966.21
buyer_5,Sara,30,ES70209577946926284453,TRX_N-00627-13580545,2023-07-04T12:43:07,Donostia,expenses,mortgage,-897.77,-17863.98
buyer_5,Sara,30,ES70209577946926284453,TRX_N-00628-16656046,2023-07-04T08:49:39,Donostia,expenses,repairs,-253.62,-18117.6
buyer_5,Sara,30,ES70209577946926284453,TRX_N-00629-84891296,2023-07-05T02:55:17,Donostia,expenses,water,-23.56,-18141.16
buyer_5,Sara,30,ES70209577946926284453,TRX_N-00630-36665877,2023-07-05T09:00:11,Donostia,expenses,phone,-41.33,-18182.49
buyer_5,Sara,30,ES70209577946926284453,TRX_N-00631-30651876,2023-07-05T22:43:03,Donostia,expenses,transport,-88.1,-18270.59
buyer_5,Sara,30,ES70209577946926284453,TRX_N-00632-54896316,2023-07-05T21:41:20,Donostia,expenses,leisure,-76.7,-18347.29
buyer_5,Sara,30,ES70209577946926284453,TRX_N-00633-03528945,2023-07-05T18:16:11,Donostia,expenses,repairs,-164.26,-18511.55
buyer_5,Sara,30,ES70209577946926284453,TRX_N-00634-62822679,2023-07-06T16:33:06,Donostia,expenses,internet,-42.0,-18553.55
buyer_5,Sara,30,ES70209577946926284453,TRX_N-00635-72348899,2023-07-07T18:29:56,Lasarte-Oria,expenses,healthcare,-108.08,-18661.63
buyer_5,Sara,30,ES70209577946926284453,TRX_N-00636-42038427,2023-07-08T11:05:28,Donostia,expenses,electricity,-71.03,-18732.66
buyer_5,Sara,30,ES70209577946926284453,TRX_N-00637-61991230,2023-07-08T10:26:44,Donostia,expenses,gas,-86.55,-18819.21
buyer_5,Sara,30,ES70209577946926284453,TRX_N-00638-76286837,2023-07-08T18:01:56,Donostia,expenses,leisure,-19.48,-18838.69
buyer_5,Sara,30,ES70209577946926284453,TRX_N-00639-18024649,2023-07-08T08:34:07,Donostia,expenses,repairs,-94.47,-18933.16
buyer_5,Sara,30,ES70209577946926284453,TRX_N-00640-12850342,2023-07-09T10:39:00,Donostia,expenses,cash,-100.0,-19033.16
buyer_5,Sara,30,ES70209577946926284453,TRX_N-00641-36643638,2023-07-11T11:44:52,Donostia,expenses,leisure,-71.87,-19105.03
buyer_5,Sara,30,ES70209577946926284453,TRX_N-00642-77688805,2023-07-11T15:58:50,Donostia,expenses,cash,-100.0,-19205.03
buyer_5,Sara,30,ES70209577946926284453,TRX_N-00643-84856723,2023-07-16T17:37:39,Donostia,expenses,cash,-100.0,-19305.03
buyer_5,Sara,30,ES70209577946926284453,TRX_N-00644-89277393,2023-07-17T09:22:51,Donostia,expenses,cash,-100.0,-19405.03
buyer_5,Sara,30,ES70209577946926284453,TRX_N-00645-57724737,2023-07-20T09:57:01,Donostia,expenses,food,-115.53,-19520.56
buyer_5,Sara,30,ES70209577946926284453,TRX_N-00646-31968507,2023-07-20T20:41:33,Donostia,expenses,transport,-88.99,-19609.55
buyer_5,Sara,30,ES70209577946926284453,TRX_N-00647-36529003,2023-07-21T08:29:19,Donostia,expenses,gifts,-33.56,-19643.11
buyer_5,Sara,30,ES70209577946926284453,TRX_N-00648-01054964,2023-07-22T21:21:58,Donostia,expenses,food,-96.33,-19739.44
buyer_5,Sara,30,ES70209577946926284453,TRX_N-00649-37327941,2023-07-22T11:19:53,Donostia,expenses,cash,-100.0,-19839.44
buyer_5,Sara,30,ES70209577946926284453,TRX_N-00650-23579566,2023-07-23T10:23:33,Donostia,expenses,travel,-998.01,-20837.45
buyer_5,Sara,30,ES70209577946926284453,TRX_N-00651-09724825,2023-07-24T13:37:11,Donostia,expenses,leisure,-44.52,-20881.97
buyer_5,Sara,30,ES70209577946926284453,TRX_N-00652-35020085,2023-07-25T13:36:13,Donostia,expenses,gifts,-240.38,-21122.35
buyer_5,Sara,30,ES70209577946926284453,TRX_N-00653-63155767,2023-07-27T09:21:30,Donostia,expenses,food,-119.52,-21241.87
buyer_5,Sara,30,ES70209577946926284453,TRX_N-00654-84968960,2023-07-30T18:07:51,Donostia,expenses,healthcare,-70.03,-21311.9
buyer_5,Sara,30,ES70209577946926284453,TRX_N-00655-38961437,2023-07-31T09:13:58,Donostia,expenses,leisure,-50.97,-21362.87
buyer_5,Sara,30,ES70209577946926284453,TRX_N-00656-02792721,2023-07-31T07:53:50,Sopela,expenses,education,-68.34,-21431.21
buyer_5,Sara,30,ES70209577946926284453,TRX_N-00657-51779471,2023-08-01T19:24:36,Donostia,incomes,salary,1328.51,-20102.7
buyer_5,Sara,30,ES70209577946926284453,TRX_N-00658-50837087,2023-08-01T19:24:36,Donostia,incomes,salary_partner,1736.49,-18366.21
buyer_5,Sara,30,ES70209577946926284453,TRX_N-00659-06104927,2023-08-01T22:46:04,Donostia,expenses,education,-71.81,-18438.02
buyer_5,Sara,30,ES70209577946926284453,TRX_N-00660-38309189,2023-08-03T12:13:14,Donostia,expenses,food,-102.94,-18540.96
buyer_5,Sara,30,ES70209577946926284453,TRX_N-00661-18514178,2023-08-04T14:49:12,Donostia,expenses,mortgage,-897.77,-19438.73
buyer_5,Sara,30,ES70209577946926284453,TRX_N-00662-78375426,2023-08-05T16:27:41,Donostia,expenses,phone,-38.62,-19477.35
buyer_5,Sara,30,ES70209577946926284453,TRX_N-00663-62788947,2023-08-06T14:33:13,Donostia,expenses,gas,-91.05,-19568.4
buyer_5,Sara,30,ES70209577946926284453,TRX_N-00664-43663271,2023-08-06T19:54:43,Iruña de Oca,expenses,education,-66.68,-19635.08
buyer_5,Sara,30,ES70209577946926284453,TRX_N-00665-49842927,2023-08-06T19:07:08,Donostia,expenses,cash,-100.0,-19735.08
buyer_5,Sara,30,ES70209577946926284453,TRX_N-00666-93198546,2023-08-08T16:48:39,Donostia,expenses,water,-29.94,-19765.02
buyer_5,Sara,30,ES70209577946926284453,TRX_N-00667-53694428,2023-08-08T16:50:29,Donostia,expenses,electricity,-32.25,-19797.27
buyer_5,Sara,30,ES70209577946926284453,TRX_N-00668-15849032,2023-08-08T13:37:21,Donostia,expenses,internet,-42.0,-19839.27
buyer_5,Sara,30,ES70209577946926284453,TRX_N-00669-84505145,2023-08-08T12:57:26,Donostia,expenses,cash,-100.0,-19939.27
buyer_5,Sara,30,ES70209577946926284453,TRX_N-00670-88773161,2023-08-10T03:16:40,Donostia,expenses,transport,-61.21,-20000.48
buyer_5,Sara,30,ES70209577946926284453,TRX_N-00671-40934643,2023-08-10T12:45:01,Salvatierra/Agurain,expenses,cash,-100.0,-20100.48
buyer_5,Sara,30,ES70209577946926284453,TRX_N-00672-05932818,2023-08-10T09:16:06,Donostia,expenses,repairs,-324.26,-20424.74
buyer_5,Sara,30,ES70209577946926284453,TRX_N-00673-69166646,2023-08-14T18:31:44,Donostia,expenses,food,-124.98,-20549.72
buyer_5,Sara,30,ES70209577946926284453,TRX_N-00674-80795269,2023-08-18T14:24:29,Donostia,expenses,food,-89.79,-20639.51
buyer_5,Sara,30,ES70209577946926284453,TRX_N-00675-95896653,2023-08-21T19:19:58,Barakaldo,expenses,food,-69.14,-20708.65
buyer_5,Sara,30,ES70209577946926284453,TRX_N-00676-67868779,2023-08-21T11:56:21,Donostia,expenses,transport,-55.2,-20763.85
buyer_5,Sara,30,ES70209577946926284453,TRX_N-00677-98081554,2023-08-22T06:43:09,Erandio,expenses,food,-117.73,-20881.58
buyer_5,Sara,30,ES70209577946926284453,TRX_N-00678-24693583,2023-08-25T10:08:42,Donostia,expenses,repairs,-291.09,-21172.67
buyer_5,Sara,30,ES70209577946926284453,TRX_N-00679-01400774,2023-08-26T17:55:59,Donostia,expenses,food,-104.5,-21277.17
buyer_5,Sara,30,ES70209577946926284453,TRX_N-00680-62674588,2023-08-26T14:31:04,Donostia,expenses,cash,-100.0,-21377.17
buyer_5,Sara,30,ES70209577946926284453,TRX_N-00681-69373614,2023-08-26T11:20:03,Donostia,expenses,travel,-1410.27,-22787.44
buyer_5,Sara,30,ES70209577946926284453,TRX_N-00682-82295375,2023-08-29T13:45:42,Donostia,expenses,gifts,-771.27,-23558.71
buyer_5,Sara,30,ES70209577946926284453,TRX_N-00683-80051454,2023-08-30T15:05:52,Donostia,expenses,food,-77.5,-23636.21
buyer_5,Sara,30,ES70209577946926284453,TRX_N-00684-93939708,2023-08-30T17:57:13,Donostia,expenses,children,-134.37,-23770.58
buyer_5,Sara,30,ES70209577946926284453,TRX_N-00685-08736028,2023-09-01T19:54:55,Donostia,incomes,salary,1328.51,-22442.07
buyer_5,Sara,30,ES70209577946926284453,TRX_N-00686-99291293,2023-09-01T19:54:55,Donostia,incomes,salary_partner,1736.49,-20705.58
buyer_5,Sara,30,ES70209577946926284453,TRX_N-00687-14924994,2023-09-01T19:54:55,Donostia,incomes,extra_income,170.69,-20534.89
buyer_5,Sara,30,ES70209577946926284453,TRX_N-00688-69167395,2023-09-01T12:56:23,Donostia,expenses,leisure,-37.55,-20572.44
buyer_5,Sara,30,ES70209577946926284453,TRX_N-00689-60714973,2023-09-01T15:38:38,Donostia,expenses,healthcare,-154.72,-20727.16
buyer_5,Sara,30,ES70209577946926284453,TRX_N-00690-54626528,2023-09-02T08:55:30,Donostia,expenses,children,-267.54,-20994.7
buyer_5,Sara,30,ES70209577946926284453,TRX_N-00691-89469543,2023-09-03T07:14:59,Donostia,expenses,travel,-996.99,-21991.69
buyer_5,Sara,30,ES70209577946926284453,TRX_N-00692-90098064,2023-09-04T19:01:56,Donostia,expenses,mortgage,-897.77,-22889.46
buyer_5,Sara,30,ES70209577946926284453,TRX_N-00693-43851268,2023-09-04T12:24:19,Donostia,expenses,food,-89.04,-22978.5
buyer_5,Sara,30,ES70209577946926284453,TRX_N-00694-07139722,2023-09-06T15:34:43,Donostia,expenses,electricity,-63.9,-23042.4
buyer_5,Sara,30,ES70209577946926284453,TRX_N-00695-10853471,2023-09-06T14:41:01,Donostia,expenses,appliances,-259.08,-23301.48
buyer_5,Sara,30,ES70209577946926284453,TRX_N-00696-33938857,2023-09-07T14:08:44,Donostia,expenses,food,-71.05,-23372.53
buyer_5,Sara,30,ES70209577946926284453,TRX_N-00697-54110496,2023-09-08T10:25:39,Donostia,expenses,water,-44.59,-23417.12
buyer_5,Sara,30,ES70209577946926284453,TRX_N-00698-56983670,2023-09-08T11:49:09,Donostia,expenses,gas,-86.55,-23503.67
buyer_5,Sara,30,ES70209577946926284453,TRX_N-00699-39906134,2023-09-08T20:14:02,Donostia,expenses,internet,-42.0,-23545.67
buyer_5,Sara,30,ES70209577946926284453,TRX_N-00700-95322337,2023-09-08T07:35:27,Donostia,expenses,phone,-43.46,-23589.13
buyer_5,Sara,30,ES70209577946926284453,TRX_N-00701-09828328,2023-09-10T01:40:29,Donostia,expenses,children,-226.91,-23816.04
buyer_5,Sara,30,ES70209577946926284453,TRX_N-00702-84604593,2023-09-13T13:36:44,Donostia,expenses,transport,-56.07,-23872.11
buyer_5,Sara,30,ES70209577946926284453,TRX_N-00703-89529101,2023-09-13T21:38:33,Donostia,expenses,cash,-100.0,-23972.11
buyer_5,Sara,30,ES70209577946926284453,TRX_N-00704-36288256,2023-09-13T13:00:13,Donostia,expenses,repairs,-54.86,-24026.97
buyer_5,Sara,30,ES70209577946926284453,TRX_N-00705-12840376,2023-09-13T13:42:39,Donostia,expenses,gifts,-174.79,-24201.76
buyer_5,Sara,30,ES70209577946926284453,TRX_N-00706-53635721,2023-09-14T18:23:14,Donostia,expenses,clothing,-149.9,-24351.66
buyer_5,Sara,30,ES70209577946926284453,TRX_N-00707-57069450,2023-09-14T18:06:45,Hondarribia,expenses,healthcare,-116.64,-24468.3
buyer_5,Sara,30,ES70209577946926284453,TRX_N-00708-97424271,2023-09-14T05:21:12,Donostia,expenses,cash,-100.0,-24568.3
buyer_5,Sara,30,ES70209577946926284453,TRX_N-00709-06118228,2023-09-15T09:08:36,Donostia,expenses,food,-75.89,-24644.19
buyer_5,Sara,30,ES70209577946926284453,TRX_N-00710-43070124,2023-09-17T13:31:22,Donostia,expenses,cash,-100.0,-24744.19
buyer_5,Sara,30,ES70209577946926284453,TRX_N-00711-58303622,2023-09-20T02:38:54,Labastida,expenses,cash,-100.0,-24844.19
buyer_5,Sara,30,ES70209577946926284453,TRX_N-00712-10624476,2023-09-22T19:59:56,Donostia,expenses,clothing,-115.26,-24959.45
buyer_5,Sara,30,ES70209577946926284453,TRX_N-00713-33410052,2023-09-23T15:15:39,Donostia,expenses,leisure,-56.94,-25016.39
buyer_5,Sara,30,ES70209577946926284453,TRX_N-00714-98965238,2023-09-24T10:29:17,Donostia,expenses,gifts,-798.83,-25815.22
buyer_5,Sara,30,ES70209577946926284453,TRX_N-00715-51135673,2023-09-25T20:28:04,Donostia,expenses,repairs,-117.95,-25933.17
buyer_5,Sara,30,ES70209577946926284453,TRX_N-00716-08020594,2023-09-26T08:23:31,Andoain,expenses,leisure,-73.26,-26006.43
buyer_5,Sara,30,ES70209577946926284453,TRX_N-00717-51122030,2023-09-26T15:55:28,Donostia,expenses,clothing,-104.4,-26110.83
buyer_5,Sara,30,ES70209577946926284453,TRX_N-00718-10817599,2023-09-27T15:08:04,Donostia,expenses,children,-192.58,-26303.41
buyer_5,Sara,30,ES70209577946926284453,TRX_N-00719-61609785,2023-09-28T08:45:50,Donostia,expenses,cash,-100.0,-26403.41
buyer_5,Sara,30,ES70209577946926284453,TRX_N-00720-70996157,2023-09-29T17:14:09,Donostia,expenses,leisure,-60.92,-26464.33
buyer_5,Sara,30,ES70209577946926284453,TRX_N-00721-35359927,2023-09-29T08:30:33,Donostia,expenses,education,-54.18,-26518.51
buyer_5,Sara,30,ES70209577946926284453,TRX_N-00722-94832156,2023-09-30T10:12:13,Bermeo,expenses,food,-61.2,-26579.71
buyer_5,Sara,30,ES70209577946926284453,TRX_N-00723-18337452,2023-09-30T23:14:25,Donostia,expenses,leisure,-53.52,-26633.23
buyer_5,Sara,30,ES70209577946926284453,TRX_N-00724-51160892,2023-10-01T15:54:23,Donostia,incomes,salary,1328.51,-25304.72
buyer_5,Sara,30,ES70209577946926284453,TRX_N-00725-97652235,2023-10-01T15:54:23,Donostia,incomes,salary_partner,1736.49,-23568.23
buyer_5,Sara,30,ES70209577946926284453,TRX_N-00726-31963413,2023-10-01T12:13:13,Donostia,expenses,leisure,-53.94,-23622.17
buyer_5,Sara,30,ES70209577946926284453,TRX_N-00727-21323640,2023-10-03T14:06:12,Basauri,expenses,appliances,-342.7,-23964.87
buyer_5,Sara,30,ES70209577946926284453,TRX_N-00728-92453887,2023-10-03T10:55:42,Barakaldo,expenses,gifts,-223.69,-24188.56
buyer_5,Sara,30,ES70209577946926284453,TRX_N-00729-15138508,2023-10-04T08:07:24,Donostia,expenses,mortgage,-897.77,-25086.33
buyer_5,Sara,30,ES70209577946926284453,TRX_N-00730-64037015,2023-10-04T15:47:08,Donostia,expenses,repairs,-135.74,-25222.07
buyer_5,Sara,30,ES70209577946926284453,TRX_N-00731-44610198,2023-10-05T09:05:44,Donostia,expenses,leisure,-50.95,-25273.02
buyer_5,Sara,30,ES70209577946926284453,TRX_N-00732-23183212,2023-10-06T02:30:50,Donostia,expenses,water,-25.31,-25298.33
buyer_5,Sara,30,ES70209577946926284453,TRX_N-00733-19056144,2023-10-06T19:53:14,Donostia,expenses,gas,-30.84,-25329.17
buyer_5,Sara,30,ES70209577946926284453,TRX_N-00734-05081790,2023-10-08T18:25:00,Donostia,expenses,electricity,-23.66,-25352.83
buyer_5,Sara,30,ES70209577946926284453,TRX_N-00735-02559631,2023-10-08T12:37:18,Donostia,expenses,internet,-42.0,-25394.83
buyer_5,Sara,30,ES70209577946926284453,TRX_N-00736-28532670,2023-10-08T02:52:37,Donostia,expenses,phone,-35.35,-25430.18
buyer_5,Sara,30,ES70209577946926284453,TRX_N-00737-66153958,2023-10-08T10:12:24,Donostia,expenses,clothing,-74.5,-25504.68
buyer_5,Sara,30,ES70209577946926284453,TRX_N-00738-36953877,2023-10-10T14:40:59,Donostia,expenses,repairs,-316.43,-25821.11
buyer_5,Sara,30,ES70209577946926284453,TRX_N-00739-06714110,2023-10-11T18:18:14,Donostia,expenses,cash,-100.0,-25921.11
buyer_5,Sara,30,ES70209577946926284453,TRX_N-00740-25102830,2023-10-12T14:50:49,Donostia,expenses,food,-111.57,-26032.68
buyer_5,Sara,30,ES70209577946926284453,TRX_N-00741-41707937,2023-10-12T20:25:38,Donostia,expenses,cash,-100.0,-26132.68
buyer_5,Sara,30,ES70209577946926284453,TRX_N-00742-03361747,2023-10-16T20:21:55,Donostia,expenses,education,-64.95,-26197.63
buyer_5,Sara,30,ES70209577946926284453,TRX_N-00743-60474166,2023-10-16T12:29:02,Donostia,expenses,cash,-100.0,-26297.63
buyer_5,Sara,30,ES70209577946926284453,TRX_N-00744-92764060,2023-10-16T19:11:26,Donostia,expenses,children,-194.29,-26491.92
buyer_5,Sara,30,ES70209577946926284453,TRX_N-00745-14650390,2023-10-17T17:22:03,Donostia,expenses,cash,-100.0,-26591.92
buyer_5,Sara,30,ES70209577946926284453,TRX_N-00746-91990804,2023-10-18T14:28:41,Donostia,expenses,leisure,-58.35,-26650.27
buyer_5,Sara,30,ES70209577946926284453,TRX_N-00747-56664061,2023-10-19T16:36:55,Donostia,expenses,education,-59.19,-26709.46
buyer_5,Sara,30,ES70209577946926284453,TRX_N-00748-10179603,2023-10-21T16:12:24,Donostia,expenses,food,-70.19,-26779.65
buyer_5,Sara,30,ES70209577946926284453,TRX_N-00749-30624161,2023-10-23T15:54:35,Donostia,expenses,travel,-1827.95,-28607.6
buyer_5,Sara,30,ES70209577946926284453,TRX_N-00750-16810194,2023-10-24T16:51:07,Donostia,expenses,leisure,-21.24,-28628.84
buyer_5,Sara,30,ES70209577946926284453,TRX_N-00751-71444705,2023-10-25T20:09:30,Galdakao,expenses,gifts,-287.36,-28916.2
buyer_5,Sara,30,ES70209577946926284453,TRX_N-00752-29082044,2023-10-28T04:43:15,Donostia,expenses,repairs,-256.6,-29172.8
buyer_5,Sara,30,ES70209577946926284453,TRX_N-00753-21179423,2023-10-29T15:05:50,Donostia,expenses,cash,-100.0,-29272.8
buyer_5,Sara,30,ES70209577946926284453,TRX_N-00754-52158416,2023-10-31T11:48:41,Sopela,expenses,transport,-80.12,-29352.92
buyer_5,Sara,30,ES70209577946926284453,TRX_N-00755-85693538,2023-10-31T16:34:03,Donostia,expenses,children,-107.13,-29460.05
buyer_5,Sara,30,ES70209577946926284453,TRX_N-00756-57996284,2023-11-01T20:23:30,Donostia,incomes,salary,1328.51,-28131.54
buyer_5,Sara,30,ES70209577946926284453,TRX_N-00757-03405867,2023-11-01T20:23:30,Donostia,incomes,salary_partner,1736.49,-26395.05
buyer_5,Sara,30,ES70209577946926284453,TRX_N-00758-13459984,2023-11-01T05:21:44,Donostia,expenses,cash,-100.0,-26495.05
buyer_5,Sara,30,ES70209577946926284453,TRX_N-00759-87377675,2023-11-02T13:07:08,Santurtzi,expenses,leisure,-68.2,-26563.25
buyer_5,Sara,30,ES70209577946926284453,TRX_N-00760-20447636,2023-11-03T13:34:44,Donostia,expenses,leisure,-70.19,-26633.44
buyer_5,Sara,30,ES70209577946926284453,TRX_N-00761-65193319,2023-11-03T10:54:30,Donostia,expenses,children,-264.43,-26897.87
buyer_5,Sara,30,ES70209577946926284453,TRX_N-00762-09374600,2023-11-04T10:22:41,Donostia,expenses,mortgage,-897.77,-27795.64
buyer_5,Sara,30,ES70209577946926284453,TRX_N-00763-12554648,2023-11-05T19:03:34,Donostia,expenses,phone,-35.43,-27831.07
buyer_5,Sara,30,ES70209577946926284453,TRX_N-00764-22831196,2023-11-06T10:55:44,Donostia,expenses,internet,-42.0,-27873.07
buyer_5,Sara,30,ES70209577946926284453,TRX_N-00765-56615380,2023-11-07T23:16:44,Donostia,expenses,water,-39.36,-27912.43
buyer_5,Sara,30,ES70209577946926284453,TRX_N-00766-37713179,2023-11-07T19:51:10,Donostia,expenses,gifts,-58.97,-27971.4
buyer_5,Sara,30,ES70209577946926284453,TRX_N-00767-49554176,2023-11-08T03:18:15,Donostia,expenses,electricity,-82.07,-28053.47
buyer_5,Sara,30,ES70209577946926284453,TRX_N-00768-43238759,2023-11-08T19:10:45,Donostia,expenses,gas,-67.45,-28120.92
buyer_5,Sara,30,ES70209577946926284453,TRX_N-00769-35980305,2023-11-10T10:54:08,Donostia,expenses,cash,-100.0,-28220.92
buyer_5,Sara,30,ES70209577946926284453,TRX_N-00770-36596277,2023-11-10T17:08:53,Zuia,expenses,appliances,-106.61,-28327.53
buyer_5,Sara,30,ES70209577946926284453,TRX_N-00771-33526358,2023-11-11T22:37:58,Donostia,expenses,transport,-55.06,-28382.59
buyer_5,Sara,30,ES70209577946926284453,TRX_N-00772-48810161,2023-11-11T12:11:09,Hernani,expenses,repairs,-254.17,-28636.76
buyer_5,Sara,30,ES70209577946926284453,TRX_N-00773-95581703,2023-11-12T10:27:30,Labastida,expenses,cash,-100.0,-28736.76
buyer_5,Sara,30,ES70209577946926284453,TRX_N-00774-52139189,2023-11-13T19:53:27,Donostia,expenses,cash,-100.0,-28836.76
buyer_5,Sara,30,ES70209577946926284453,TRX_N-00775-63326175,2023-11-16T23:16:00,Donostia,expenses,clothing,-117.15,-28953.91
buyer_5,Sara,30,ES70209577946926284453,TRX_N-00776-81131783,2023-11-18T19:42:14,Donostia,expenses,cash,-100.0,-29053.91
buyer_5,Sara,30,ES70209577946926284453,TRX_N-00777-26500950,2023-11-18T16:23:00,Donostia,expenses,gifts,-667.3,-29721.21
buyer_5,Sara,30,ES70209577946926284453,TRX_N-00778-43305402,2023-11-20T17:45:01,Donostia,expenses,leisure,-84.36,-29805.57
buyer_5,Sara,30,ES70209577946926284453,TRX_N-00779-13309905,2023-11-20T16:26:24,Donostia,expenses,healthcare,-56.21,-29861.78
buyer_5,Sara,30,ES70209577946926284453,TRX_N-00780-56560342,2023-11-21T11:39:08,Donostia,expenses,transport,-56.01,-29917.79
buyer_5,Sara,30,ES70209577946926284453,TRX_N-00781-50185231,2023-11-21T12:00:38,Donostia,expenses,healthcare,-122.45,-30040.24
buyer_5,Sara,30,ES70209577946926284453,TRX_N-00782-47338626,2023-11-22T19:16:02,Donostia,expenses,appliances,-319.26,-30359.5
buyer_5,Sara,30,ES70209577946926284453,TRX_N-00783-56874195,2023-11-24T11:05:18,Donostia,expenses,transport,-71.1,-30430.6
buyer_5,Sara,30,ES70209577946926284453,TRX_N-00784-66126977,2023-11-24T14:23:56,Donostia,expenses,clothing,-158.09,-30588.69
buyer_5,Sara,30,ES70209577946926284453,TRX_N-00785-48463778,2023-11-24T12:09:18,Donostia,expenses,healthcare,-145.72,-30734.41
buyer_5,Sara,30,ES70209577946926284453,TRX_N-00786-07279378,2023-11-24T14:24:09,Donostia,expenses,cash,-100.0,-30834.41
buyer_5,Sara,30,ES70209577946926284453,TRX_N-00787-78589792,2023-11-25T14:05:50,Andoain,expenses,appliances,-262.16,-31096.57
buyer_5,Sara,30,ES70209577946926284453,TRX_N-00788-97570865,2023-11-27T15:21:14,Donostia,expenses,transport,-63.33,-31159.9
buyer_5,Sara,30,ES70209577946926284453,TRX_N-00789-86331873,2023-11-27T01:51:20,Donostia,expenses,clothing,-75.93,-31235.83
buyer_5,Sara,30,ES70209577946926284453,TRX_N-00790-40436313,2023-11-29T00:27:14,Donostia,expenses,cash,-100.0,-31335.83
buyer_5,Sara,30,ES70209577946926284453,TRX_N-00791-13057915,2023-11-29T16:54:12,Donostia,expenses,repairs,-223.37,-31559.2
buyer_5,Sara,30,ES70209577946926284453,TRX_N-00792-66531826,2023-12-01T17:18:27,Donostia,incomes,salary,1328.51,-30230.69
buyer_5,Sara,30,ES70209577946926284453,TRX_N-00793-44618753,2023-12-01T17:18:27,Donostia,incomes,salary_partner,1736.49,-28494.2
buyer_5,Sara,30,ES70209577946926284453,TRX_N-00794-79767307,2023-12-01T17:18:27,Donostia,incomes,salary_bonus,930.5,-27563.7
buyer_5,Sara,30,ES70209577946926284453,TRX_N-00795-18631416,2023-12-01T17:18:27,Donostia,incomes,salary_partner_bonus,1274.7,-26289.0
buyer_5,Sara,30,ES70209577946926284453,TRX_N-00796-40228653,2023-12-01T16:09:32,Donostia,expenses,leisure,-72.86,-26361.86
buyer_5,Sara,30,ES70209577946926284453,TRX_N-00797-78602674,2023-12-04T08:36:15,Donostia,expenses,mortgage,-897.77,-27259.63
buyer_5,Sara,30,ES70209577946926284453,TRX_N-00798-33441259,2023-12-05T17:05:55,Donostia,expenses,water,-43.8,-27303.43
buyer_5,Sara,30,ES70209577946926284453,TRX_N-00799-61037149,2023-12-05T23:21:09,Donostia,expenses,gas,-84.42,-27387.85
buyer_5,Sara,30,ES70209577946926284453,TRX_N-00800-81995563,2023-12-05T11:44:01,Donostia,expenses,transport,-59.31,-27447.16
buyer_5,Sara,30,ES70209577946926284453,TRX_N-00801-12572732,2023-12-06T20:05:10,Donostia,expenses,phone,-38.92,-27486.08
buyer_5,Sara,30,ES70209577946926284453,TRX_N-00802-10881024,2023-12-07T13:37:58,Donostia,expenses,food,-123.55,-27609.63
buyer_5,Sara,30,ES70209577946926284453,TRX_N-00803-08930088,2023-12-07T18:19:16,Basauri,expenses,cash,-100.0,-27709.63
buyer_5,Sara,30,ES70209577946926284453,TRX_N-00804-49344282,2023-12-08T12:00:41,Donostia,expenses,electricity,-27.96,-27737.59
buyer_5,Sara,30,ES70209577946926284453,TRX_N-00805-90353596,2023-12-08T10:20:38,Donostia,expenses,internet,-42.0,-27779.59
buyer_5,Sara,30,ES70209577946926284453,TRX_N-00806-96851732,2023-12-08T19:54:37,Donostia,expenses,education,-78.59,-27858.18
buyer_5,Sara,30,ES70209577946926284453,TRX_N-00807-06740931,2023-12-08T09:18:13,Donostia,expenses,repairs,-220.28,-28078.46
buyer_5,Sara,30,ES70209577946926284453,TRX_N-00808-05407834,2023-12-10T11:19:15,Donostia,expenses,clothing,-149.01,-28227.47
buyer_5,Sara,30,ES70209577946926284453,TRX_N-00809-22343329,2023-12-10T19:18:11,Donostia,expenses,repairs,-30.21,-28257.68
buyer_5,Sara,30,ES70209577946926284453,TRX_N-00810-78842744,2023-12-11T08:05:39,Donostia,expenses,leisure,-25.91,-28283.59
buyer_5,Sara,30,ES70209577946926284453,TRX_N-00811-58600438,2023-12-11T20:41:26,Donostia,expenses,appliances,-135.47,-28419.06
buyer_5,Sara,30,ES70209577946926284453,TRX_N-00812-82726357,2023-12-13T23:12:47,Donostia,expenses,education,-65.95,-28485.01
buyer_5,Sara,30,ES70209577946926284453,TRX_N-00813-16808943,2023-12-13T11:00:10,Donostia,expenses,cash,-100.0,-28585.01
buyer_5,Sara,30,ES70209577946926284453,TRX_N-00814-47629073,2023-12-14T02:22:14,Hondarribia,expenses,food,-101.06,-28686.07
buyer_5,Sara,30,ES70209577946926284453,TRX_N-00815-34632729,2023-12-14T20:50:04,Donostia,expenses,education,-49.44,-28735.51
buyer_5,Sara,30,ES70209577946926284453,TRX_N-00816-73836997,2023-12-15T23:33:44,Donostia,expenses,cash,-100.0,-28835.51
buyer_5,Sara,30,ES70209577946926284453,TRX_N-00817-31550739,2023-12-15T18:30:23,Donostia,expenses,repairs,-91.05,-28926.56
buyer_5,Sara,30,ES70209577946926284453,TRX_N-00818-68333690,2023-12-16T10:26:35,Donostia,expenses,food,-76.27,-29002.83
buyer_5,Sara,30,ES70209577946926284453,TRX_N-00819-02407607,2023-12-16T12:35:43,Donostia,expenses,clothing,-148.56,-29151.39
buyer_5,Sara,30,ES70209577946926284453,TRX_N-00820-65201277,2023-12-16T10:11:33,Donostia,expenses,cash,-100.0,-29251.39
buyer_5,Sara,30,ES70209577946926284453,TRX_N-00821-86693154,2023-12-17T20:18:22,Donostia,expenses,food,-123.79,-29375.18
buyer_5,Sara,30,ES70209577946926284453,TRX_N-00822-79922445,2023-12-17T18:09:12,Donostia,expenses,transport,-56.25,-29431.43
buyer_5,Sara,30,ES70209577946926284453,TRX_N-00823-51955478,2023-12-17T16:48:36,Donostia,expenses,leisure,-78.33,-29509.76
buyer_5,Sara,30,ES70209577946926284453,TRX_N-00824-86943352,2023-12-17T23:56:24,Donostia,expenses,cash,-100.0,-29609.76
buyer_5,Sara,30,ES70209577946926284453,TRX_N-00825-76911640,2023-12-19T12:36:40,Donostia,expenses,leisure,-30.79,-29640.55
buyer_5,Sara,30,ES70209577946926284453,TRX_N-00826-61544224,2023-12-20T18:23:14,Berango,expenses,repairs,-184.75,-29825.3
buyer_5,Sara,30,ES70209577946926284453,TRX_N-00827-64497494,2023-12-21T04:37:18,Donostia,expenses,cash,-100.0,-29925.3
buyer_5,Sara,30,ES70209577946926284453,TRX_N-00828-70638930,2023-12-22T22:30:40,Donostia,expenses,travel,-1043.84,-30969.14
buyer_5,Sara,30,ES70209577946926284453,TRX_N-00829-60627108,2023-12-23T04:48:44,Donostia,expenses,food,-120.92,-31090.06
buyer_5,Sara,30,ES70209577946926284453,TRX_N-00830-38287158,2023-12-25T08:38:38,Donostia,expenses,cash,-100.0,-31190.06
buyer_5,Sara,30,ES70209577946926284453,TRX_N-00831-49714534,2023-12-28T08:46:26,Donostia,expenses,cash,-100.0,-31290.06
buyer_5,Sara,30,ES70209577946926284453,TRX_N-00832-23272949,2023-12-29T10:30:41,Galdakao,expenses,cash,-100.0,-31390.06
buyer_5,Sara,30,ES70209577946926284453,TRX_N-00833-20830989,2023-12-29T14:40:54,Donostia,expenses,children,-109.28,-31499.34
buyer_5,Sara,30,ES70209577946926284453,TRX_N-00834-32835110,2023-12-31T13:08:26,Salvatierra/Agurain,expenses,repairs,-269.09,-31768.43
buyer_5,Sara,30,ES70209577946926284453,TRX_N-00835-87060216,2024-01-01T15:42:16,Donostia,incomes,salary,1355.99,-30412.44
buyer_5,Sara,30,ES70209577946926284453,TRX_N-00836-35251354,2024-01-01T15:42:16,Donostia,incomes,salary_partner,1772.4,-28640.04
buyer_5,Sara,30,ES70209577946926284453,TRX_N-00837-56691180,2024-01-01T15:42:16,Donostia,incomes,extra_income,170.69,-28469.35
buyer_5,Sara,30,ES70209577946926284453,TRX_N-00838-12014878,2024-01-01T16:38:54,Donostia,expenses,gifts,-541.88,-29011.23
buyer_5,Sara,30,ES70209577946926284453,TRX_N-00839-22793950,2024-01-02T09:30:46,Donostia,expenses,leisure,-61.71,-29072.94
buyer_5,Sara,30,ES70209577946926284453,TRX_N-00840-64525016,2024-01-04T19:13:46,Donostia,expenses,mortgage,-897.77,-29970.71
buyer_5,Sara,30,ES70209577946926284453,TRX_N-00841-90918079,2024-01-04T20:41:42,Donostia,expenses,cash,-100.0,-30070.71
buyer_5,Sara,30,ES70209577946926284453,TRX_N-00842-76851975,2024-01-05T12:17:15,Donostia,expenses,electricity,-39.6,-30110.31
buyer_5,Sara,30,ES70209577946926284453,TRX_N-00843-80009196,2024-01-06T19:57:16,Donostia,expenses,internet,-42.0,-30152.31
buyer_5,Sara,30,ES70209577946926284453,TRX_N-00844-36049872,2024-01-06T20:59:48,Donostia,expenses,cash,-100.0,-30252.31
buyer_5,Sara,30,ES70209577946926284453,TRX_N-00845-81429337,2024-01-07T09:27:21,Donostia,expenses,water,-33.03,-30285.34
buyer_5,Sara,30,ES70209577946926284453,TRX_N-00846-94039439,2024-01-07T17:31:33,Donostia,expenses,gas,-67.91,-30353.25
buyer_5,Sara,30,ES70209577946926284453,TRX_N-00847-23722812,2024-01-08T13:03:08,Donostia,expenses,phone,-32.83,-30386.08
buyer_5,Sara,30,ES70209577946926284453,TRX_N-00848-88266281,2024-01-08T08:06:44,Donostia,expenses,food,-67.9,-30453.98
buyer_5,Sara,30,ES70209577946926284453,TRX_N-00849-28530479,2024-01-09T13:48:28,Donostia,expenses,cash,-100.0,-30553.98
buyer_5,Sara,30,ES70209577946926284453,TRX_N-00850-00541296,2024-01-10T10:36:20,Donostia,expenses,children,-133.18,-30687.16
buyer_5,Sara,30,ES70209577946926284453,TRX_N-00851-16629646,2024-01-12T14:17:20,Donostia,expenses,transport,-69.31,-30756.47
buyer_5,Sara,30,ES70209577946926284453,TRX_N-00852-52775496,2024-01-12T11:19:09,Vitoria-Gasteiz,expenses,cash,-100.0,-30856.47
buyer_5,Sara,30,ES70209577946926284453,TRX_N-00853-95504277,2024-01-13T15:30:21,Vitoria-Gasteiz,expenses,healthcare,-102.59,-30959.06
buyer_5,Sara,30,ES70209577946926284453,TRX_N-00854-48076425,2024-01-15T18:38:10,Donostia,expenses,leisure,-51.05,-31010.11
buyer_5,Sara,30,ES70209577946926284453,TRX_N-00855-59583862,2024-01-16T21:35:52,Donostia,expenses,clothing,-107.92,-31118.03
buyer_5,Sara,30,ES70209577946926284453,TRX_N-00856-08032152,2024-01-17T16:31:39,Hernani,expenses,food,-123.9,-31241.93
buyer_5,Sara,30,ES70209577946926284453,TRX_N-00857-03098735,2024-01-18T17:32:00,Donostia,expenses,repairs,-131.19,-31373.12
buyer_5,Sara,30,ES70209577946926284453,TRX_N-00858-66158160,2024-01-20T11:12:39,Donostia,expenses,leisure,-56.85,-31429.97
buyer_5,Sara,30,ES70209577946926284453,TRX_N-00859-35859697,2024-01-20T10:53:35,Donostia,expenses,travel,-1414.29,-32844.26
buyer_5,Sara,30,ES70209577946926284453,TRX_N-00860-92381497,2024-01-21T08:57:12,Donostia,expenses,travel,-1093.95,-33938.21
buyer_5,Sara,30,ES70209577946926284453,TRX_N-00861-15440056,2024-01-23T11:03:00,Donostia,expenses,food,-112.9,-34051.11
buyer_5,Sara,30,ES70209577946926284453,TRX_N-00862-64016407,2024-01-23T14:43:38,Donostia,expenses,clothing,-81.83,-34132.94
buyer_5,Sara,30,ES70209577946926284453,TRX_N-00863-73072725,2024-01-23T14:11:09,Donostia,expenses,gifts,-446.53,-34579.47
buyer_5,Sara,30,ES70209577946926284453,TRX_N-00864-73651185,2024-01-25T10:36:15,Donostia,expenses,food,-121.67,-34701.14
buyer_5,Sara,30,ES70209577946926284453,TRX_N-00865-72452336,2024-01-28T15:04:05,Donostia,expenses,food,-72.55,-34773.69
buyer_5,Sara,30,ES70209577946926284453,TRX_N-00866-96875067,2024-01-29T18:15:09,Donostia,expenses,food,-83.16,-34856.85
buyer_5,Sara,30,ES70209577946926284453,TRX_N-00867-36642713,2024-01-30T21:16:33,Donostia,expenses,education,-66.69,-34923.54
buyer_5,Sara,30,ES70209577946926284453,TRX_N-00868-60339493,2024-01-31T15:21:56,Hernani,expenses,leisure,-46.82,-34970.36
buyer_5,Sara,30,ES70209577946926284453,TRX_N-00869-19211177,2024-02-01T12:43:13,Donostia,incomes,salary,1355.99,-33614.37
buyer_5,Sara,30,ES70209577946926284453,TRX_N-00870-80708061,2024-02-01T12:43:13,Donostia,incomes,salary_partner,1772.4,-31841.97
buyer_5,Sara,30,ES70209577946926284453,TRX_N-00871-87385073,2024-02-01T22:54:50,Donostia,expenses,cash,-100.0,-31941.97
buyer_5,Sara,30,ES70209577946926284453,TRX_N-00872-31282276,2024-02-04T12:46:47,Donostia,expenses,mortgage,-897.77,-32839.74
buyer_5,Sara,30,ES70209577946926284453,TRX_N-00873-04996362,2024-02-04T09:58:28,Zarautz,expenses,food,-109.23,-32948.97
buyer_5,Sara,30,ES70209577946926284453,TRX_N-00874-10765777,2024-02-05T08:40:22,Donostia,expenses,internet,-42.0,-32990.97
buyer_5,Sara,30,ES70209577946926284453,TRX_N-00875-42719161,2024-02-05T18:48:47,Donostia,expenses,food,-120.28,-33111.25
buyer_5,Sara,30,ES70209577946926284453,TRX_N-00876-88047984,2024-02-06T18:23:53,Donostia,expenses,phone,-36.65,-33147.9
buyer_5,Sara,30,ES70209577946926284453,TRX_N-00877-64864121,2024-02-06T11:10:08,Donostia,expenses,transport,-47.81,-33195.71
buyer_5,Sara,30,ES70209577946926284453,TRX_N-00878-79877216,2024-02-07T18:32:37,Donostia,expenses,food,-89.49,-33285.2
buyer_5,Sara,30,ES70209577946926284453,TRX_N-00879-19304761,2024-02-07T10:52:00,Donostia,expenses,cash,-100.0,-33385.2
buyer_5,Sara,30,ES70209577946926284453,TRX_N-00880-11416292,2024-02-07T17:13:53,Hondarribia,expenses,repairs,-88.16,-33473.36
buyer_5,Sara,30,ES70209577946926284453,TRX_N-00881-75453754,2024-02-08T13:37:49,Donostia,expenses,water,-28.62,-33501.98
buyer_5,Sara,30,ES70209577946926284453,TRX_N-00882-41077487,2024-02-08T11:27:31,Donostia,expenses,electricity,-78.66,-33580.64
buyer_5,Sara,30,ES70209577946926284453,TRX_N-00883-65436809,2024-02-08T17:00:56,Donostia,expenses,gas,-66.66,-33647.3
buyer_5,Sara,30,ES70209577946926284453,TRX_N-00884-16701929,2024-02-10T03:56:43,Eibar,expenses,repairs,-43.19,-33690.49
buyer_5,Sara,30,ES70209577946926284453,TRX_N-00885-03677349,2024-02-13T20:16:10,Donostia,expenses,repairs,-235.37,-33925.86
buyer_5,Sara,30,ES70209577946926284453,TRX_N-00886-33502289,2024-02-13T08:49:48,Donostia,expenses,gifts,-828.86,-34754.72
buyer_5,Sara,30,ES70209577946926284453,TRX_N-00887-09074296,2024-02-21T13:57:58,Barakaldo,expenses,cash,-100.0,-34854.72
buyer_5,Sara,30,ES70209577946926284453,TRX_N-00888-75184523,2024-02-21T09:23:33,Donostia,expenses,repairs,-324.1,-35178.82
buyer_5,Sara,30,ES70209577946926284453,TRX_N-00889-44049279,2024-02-21T11:32:06,Donostia,expenses,gifts,-632.9,-35811.72
buyer_5,Sara,30,ES70209577946926284453,TRX_N-00890-11007306,2024-02-22T08:43:00,Portugalete,expenses,leisure,-31.92,-35843.64
buyer_5,Sara,30,ES70209577946926284453,TRX_N-00891-86560603,2024-02-23T16:44:24,Donostia,expenses,food,-92.81,-35936.45
buyer_5,Sara,30,ES70209577946926284453,TRX_N-00892-32199516,2024-02-26T18:15:47,Donostia,expenses,clothing,-66.31,-36002.76
buyer_5,Sara,30,ES70209577946926284453,TRX_N-00893-80789219,2024-03-01T19:44:25,Donostia,incomes,salary,1355.99,-34646.77
buyer_5,Sara,30,ES70209577946926284453,TRX_N-00894-98555358,2024-03-01T19:44:25,Donostia,incomes,salary_partner,1772.4,-32874.37
buyer_5,Sara,30,ES70209577946926284453,TRX_N-00895-76326213,2024-03-01T18:32:53,Donostia,expenses,appliances,-166.56,-33040.93
buyer_5,Sara,30,ES70209577946926284453,TRX_N-00896-29933538,2024-03-02T09:25:27,Donostia,expenses,food,-75.96,-33116.89
buyer_5,Sara,30,ES70209577946926284453,TRX_N-00897-70023610,2024-03-02T19:18:32,Donostia,expenses,clothing,-142.42,-33259.31
buyer_5,Sara,30,ES70209577946926284453,TRX_N-00898-35617450,2024-03-02T01:53:08,Donostia,expenses,cash,-100.0,-33359.31
buyer_5,Sara,30,ES70209577946926284453,TRX_N-00899-75620337,2024-03-03T11:30:15,Alegría-Dulantzi,expenses,travel,-1135.45,-34494.76
buyer_5,Sara,30,ES70209577946926284453,TRX_N-00900-57643829,2024-03-04T23:49:14,Donostia,expenses,mortgage,-897.77,-35392.53
buyer_5,Sara,30,ES70209577946926284453,TRX_N-00901-40426045,2024-03-04T23:17:39,Donostia,expenses,transport,-46.28,-35438.81
buyer_5,Sara,30,ES70209577946926284453,TRX_N-00902-23221316,2024-03-04T10:31:46,Donostia,expenses,repairs,-164.01,-35602.82
buyer_5,Sara,30,ES70209577946926284453,TRX_N-00903-67653676,2024-03-05T18:32:14,Donostia,expenses,food,-76.3,-35679.12
buyer_5,Sara,30,ES70209577946926284453,TRX_N-00904-46021854,2024-03-06T14:15:24,Donostia,expenses,water,-35.9,-35715.02
buyer_5,Sara,30,ES70209577946926284453,TRX_N-00905-73465698,2024-03-07T11:01:56,Donostia,expenses,electricity,-31.69,-35746.71
buyer_5,Sara,30,ES70209577946926284453,TRX_N-00906-89185393,2024-03-07T12:17:03,Donostia,expenses,phone,-32.7,-35779.41
buyer_5,Sara,30,ES70209577946926284453,TRX_N-00907-57893796,2024-03-08T19:45:42,Donostia,expenses,gas,-39.03,-35818.44
buyer_5,Sara,30,ES70209577946926284453,TRX_N-00908-96452501,2024-03-08T11:21:44,Donostia,expenses,internet,-42.0,-35860.44
buyer_5,Sara,30,ES70209577946926284453,TRX_N-00909-55403551,2024-03-09T19:51:09,Donostia,expenses,food,-97.42,-35957.86
buyer_5,Sara,30,ES70209577946926284453,TRX_N-00910-79356418,2024-03-10T09:32:38,Donostia,expenses,healthcare,-73.86,-36031.72
buyer_5,Sara,30,ES70209577946926284453,TRX_N-00911-60186155,2024-03-12T19:34:06,Donostia,expenses,education,-63.88,-36095.6
buyer_5,Sara,30,ES70209577946926284453,TRX_N-00912-03420557,2024-03-13T10:02:51,Donostia,expenses,repairs,-107.21,-36202.81
buyer_5,Sara,30,ES70209577946926284453,TRX_N-00913-73050043,2024-03-15T09:01:57,Donostia,expenses,food,-101.71,-36304.52
buyer_5,Sara,30,ES70209577946926284453,TRX_N-00914-45400518,2024-03-18T19:03:44,Donostia,expenses,food,-123.44,-36427.96
buyer_5,Sara,30,ES70209577946926284453,TRX_N-00915-19177221,2024-03-18T11:36:49,Hondarribia,expenses,healthcare,-167.13,-36595.09
buyer_5,Sara,30,ES70209577946926284453,TRX_N-00916-50164062,2024-03-18T10:59:48,Donostia,expenses,cash,-100.0,-36695.09
buyer_5,Sara,30,ES70209577946926284453,TRX_N-00917-07302573,2024-03-21T18:39:05,Donostia,expenses,leisure,-21.87,-36716.96
buyer_5,Sara,30,ES70209577946926284453,TRX_N-00918-20525295,2024-03-21T18:48:25,Donostia,expenses,children,-84.67,-36801.63
buyer_5,Sara,30,ES70209577946926284453,TRX_N-00919-73671107,2024-03-22T21:36:13,Donostia,expenses,transport,-74.05,-36875.68
buyer_5,Sara,30,ES70209577946926284453,TRX_N-00920-67805835,2024-03-22T10:10:29,Donostia,expenses,leisure,-76.0,-36951.68
buyer_5,Sara,30,ES70209577946926284453,TRX_N-00921-01690833,2024-03-22T11:12:20,Barakaldo,expenses,cash,-100.0,-37051.68
buyer_5,Sara,30,ES70209577946926284453,TRX_N-00922-13445990,2024-03-26T09:22:26,Donostia,expenses,cash,-100.0,-37151.68
buyer_5,Sara,30,ES70209577946926284453,TRX_N-00923-99022869,2024-03-30T23:15:46,Donostia,expenses,cash,-100.0,-37251.68
buyer_5,Sara,30,ES70209577946926284453,TRX_N-00924-59964563,2024-03-31T10:36:00,Donostia,expenses,leisure,-43.49,-37295.17
buyer_5,Sara,30,ES70209577946926284453,TRX_N-00925-81499716,2024-03-31T13:04:44,Pasaia,expenses,repairs,-315.34,-37610.51
buyer_5,Sara,30,ES70209577946926284453,TRX_N-00926-13440351,2024-04-01T08:30:45,Donostia,incomes,salary,1355.99,-36254.52
buyer_5,Sara,30,ES70209577946926284453,TRX_N-00927-32253945,2024-04-01T08:30:45,Donostia,incomes,salary_partner,1772.4,-34482.12
buyer_5,Sara,30,ES70209577946926284453,TRX_N-00928-34914427,2024-04-03T10:57:44,Donostia,expenses,food,-115.21,-34597.33
buyer_5,Sara,30,ES70209577946926284453,TRX_N-00929-31898857,2024-04-03T10:58:59,Donostia,expenses,leisure,-52.2,-34649.53
buyer_5,Sara,30,ES70209577946926284453,TRX_N-00930-73372436,2024-04-03T10:24:19,Getxo,expenses,clothing,-128.43,-34777.96
buyer_5,Sara,30,ES70209577946926284453,TRX_N-00931-21268383,2024-04-04T20:16:21,Donostia,expenses,mortgage,-897.77,-35675.73
buyer_5,Sara,30,ES70209577946926284453,TRX_N-00932-25183581,2024-04-05T16:39:39,Donostia,expenses,clothing,-159.71,-35835.44
buyer_5,Sara,30,ES70209577946926284453,TRX_N-00933-52766494,2024-04-07T12:12:14,Donostia,expenses,gas,-82.33,-35917.77
buyer_5,Sara,30,ES70209577946926284453,TRX_N-00934-71551910,2024-04-07T18:47:00,Donostia,expenses,food,-69.43,-35987.2
buyer_5,Sara,30,ES70209577946926284453,TRX_N-00935-85185955,2024-04-07T14:34:32,Donostia,expenses,repairs,-262.53,-36249.73
buyer_5,Sara,30,ES70209577946926284453,TRX_N-00936-20171586,2024-04-08T11:54:41,Donostia,expenses,water,-29.93,-36279.66
buyer_5,Sara,30,ES70209577946926284453,TRX_N-00937-38946741,2024-04-08T17:26:50,Donostia,expenses,electricity,-63.34,-36343.0
buyer_5,Sara,30,ES70209577946926284453,TRX_N-00938-85428343,2024-04-08T10:33:55,Donostia,expenses,internet,-42.0,-36385.0
buyer_5,Sara,30,ES70209577946926284453,TRX_N-00939-53713703,2024-04-08T18:47:35,Donostia,expenses,phone,-40.9,-36425.9
buyer_5,Sara,30,ES70209577946926284453,TRX_N-00940-38419546,2024-04-08T20:31:52,Donostia,expenses,food,-90.14,-36516.04
buyer_5,Sara,30,ES70209577946926284453,TRX_N-00941-99183731,2024-04-08T17:07:29,Donostia,expenses,repairs,-278.79,-36794.83
buyer_5,Sara,30,ES70209577946926284453,TRX_N-00942-68329906,2024-04-09T02:55:04,Donostia,expenses,transport,-44.98,-36839.81
buyer_5,Sara,30,ES70209577946926284453,TRX_N-00943-39290226,2024-04-09T14:55:56,Donostia,expenses,leisure,-54.13,-36893.94
buyer_5,Sara,30,ES70209577946926284453,TRX_N-00944-37023297,2024-04-13T21:08:12,Donostia,expenses,transport,-42.99,-36936.93
buyer_5,Sara,30,ES70209577946926284453,TRX_N-00945-65982978,2024-04-13T08:23:18,Donostia,expenses,gifts,-663.38,-37600.31
buyer_5,Sara,30,ES70209577946926284453,TRX_N-00946-45276223,2024-04-14T21:09:34,Donostia,expenses,cash,-100.0,-37700.31
buyer_5,Sara,30,ES70209577946926284453,TRX_N-00947-12402364,2024-04-15T23:09:14,Donostia,expenses,healthcare,-165.39,-37865.7
buyer_5,Sara,30,ES70209577946926284453,TRX_N-00948-80679905,2024-04-15T15:32:31,Donostia,expenses,education,-46.4,-37912.1
buyer_5,Sara,30,ES70209577946926284453,TRX_N-00949-68880164,2024-04-15T08:04:27,Donostia,expenses,repairs,-285.03,-38197.13
buyer_5,Sara,30,ES70209577946926284453,TRX_N-00950-63227218,2024-04-16T08:58:38,Donostia,expenses,leisure,-60.03,-38257.16
buyer_5,Sara,30,ES70209577946926284453,TRX_N-00951-00011368,2024-04-17T18:00:29,Donostia,expenses,food,-96.46,-38353.62
buyer_5,Sara,30,ES70209577946926284453,TRX_N-00952-27978243,2024-04-22T10:29:13,Donostia,expenses,transport,-47.81,-38401.43
buyer_5,Sara,30,ES70209577946926284453,TRX_N-00953-94305997,2024-04-23T17:05:45,Donostia,expenses,education,-65.63,-38467.06
buyer_5,Sara,30,ES70209577946926284453,TRX_N-00954-44771727,2024-04-23T12:02:50,Donostia,expenses,repairs,-127.46,-38594.52
buyer_5,Sara,30,ES70209577946926284453,TRX_N-00955-55691407,2024-04-24T11:38:09,Donostia,expenses,transport,-77.17,-38671.69
buyer_5,Sara,30,ES70209577946926284453,TRX_N-00956-88665273,2024-04-24T12:19:36,Sopela,expenses,cash,-100.0,-38771.69
buyer_5,Sara,30,ES70209577946926284453,TRX_N-00957-12829342,2024-04-25T08:23:34,Donostia,expenses,cash,-100.0,-38871.69
buyer_5,Sara,30,ES70209577946926284453,TRX_N-00958-73703328,2024-04-26T15:55:51,Vitoria-Gasteiz,expenses,gifts,-95.33,-38967.02
buyer_5,Sara,30,ES70209577946926284453,TRX_N-00959-32513576,2024-04-27T15:09:21,Donostia,expenses,appliances,-312.23,-39279.25
buyer_5,Sara,30,ES70209577946926284453,TRX_N-00960-34685269,2024-04-28T19:28:22,Donostia,expenses,food,-67.8,-39347.05
buyer_5,Sara,30,ES70209577946926284453,TRX_N-00961-89060236,2024-04-28T14:59:29,Donostia,expenses,transport,-40.64,-39387.69
buyer_5,Sara,30,ES70209577946926284453,TRX_N-00962-09823450,2024-04-29T14:45:35,Donostia,expenses,leisure,-76.43,-39464.12
buyer_5,Sara,30,ES70209577946926284453,TRX_N-00963-73598022,2024-04-30T10:44:46,Donostia,expenses,food,-78.62,-39542.74
buyer_5,Sara,30,ES70209577946926284453,TRX_N-00964-28023623,2024-04-30T12:36:08,Zuia,expenses,transport,-64.48,-39607.22
buyer_5,Sara,30,ES70209577946926284453,TRX_N-00965-12261382,2024-04-30T19:08:22,Donostia,expenses,education,-51.74,-39658.96
buyer_5,Sara,30,ES70209577946926284453,TRX_N-00966-73376069,2024-05-01T14:58:32,Donostia,incomes,salary,1355.99,-38302.97
buyer_5,Sara,30,ES70209577946926284453,TRX_N-00967-19515339,2024-05-01T14:58:32,Donostia,incomes,salary_partner,1772.4,-36530.57
buyer_5,Sara,30,ES70209577946926284453,TRX_N-00968-36370344,2024-05-01T14:58:32,Donostia,incomes,extra_income,170.69,-36359.88
buyer_5,Sara,30,ES70209577946926284453,TRX_N-00969-37087727,2024-05-01T12:30:16,Donostia,expenses,leisure,-64.48,-36424.36
buyer_5,Sara,30,ES70209577946926284453,TRX_N-00970-63803704,2024-05-03T22:51:56,Donostia,expenses,cash,-100.0,-36524.36
buyer_5,Sara,30,ES70209577946926284453,TRX_N-00971-29247347,2024-05-04T12:31:18,Donostia,expenses,mortgage,-897.77,-37422.13
buyer_5,Sara,30,ES70209577946926284453,TRX_N-00972-70126932,2024-05-05T09:33:16,Irun,expenses,repairs,-41.49,-37463.62
buyer_5,Sara,30,ES70209577946926284453,TRX_N-00973-73858696,2024-05-06T14:38:03,Donostia,expenses,water,-38.19,-37501.81
buyer_5,Sara,30,ES70209577946926284453,TRX_N-00974-51142625,2024-05-06T13:22:10,Donostia,expenses,transport,-44.03,-37545.84
buyer_5,Sara,30,ES70209577946926284453,TRX_N-00975-02717211,2024-05-07T13:30:06,Donostia,expenses,gas,-76.2,-37622.04
buyer_5,Sara,30,ES70209577946926284453,TRX_N-00976-84067261,2024-05-07T13:03:52,Donostia,expenses,internet,-42.0,-37664.04
buyer_5,Sara,30,ES70209577946926284453,TRX_N-00977-79228370,2024-05-07T12:39:17,Donostia,expenses,phone,-41.61,-37705.65
buyer_5,Sara,30,ES70209577946926284453,TRX_N-00978-02189018,2024-05-08T13:54:09,Donostia,expenses,electricity,-73.49,-37779.14
buyer_5,Sara,30,ES70209577946926284453,TRX_N-00979-31833667,2024-05-08T19:11:45,Donostia,expenses,leisure,-75.11,-37854.25
buyer_5,Sara,30,ES70209577946926284453,TRX_N-00980-41887816,2024-05-10T04:56:25,Donostia,expenses,food,-106.78,-37961.03
buyer_5,Sara,30,ES70209577946926284453,TRX_N-00981-64301659,2024-05-10T20:52:10,Donostia,expenses,leisure,-21.24,-37982.27
buyer_5,Sara,30,ES70209577946926284453,TRX_N-00982-25673453,2024-05-10T06:19:24,Donostia,expenses,cash,-100.0,-38082.27
buyer_5,Sara,30,ES70209577946926284453,TRX_N-00983-22172169,2024-05-11T08:24:12,Donostia,expenses,cash,-100.0,-38182.27
buyer_5,Sara,30,ES70209577946926284453,TRX_N-00984-26423739,2024-05-11T05:49:28,Donostia,expenses,gifts,-841.15,-39023.42
buyer_5,Sara,30,ES70209577946926284453,TRX_N-00985-68817141,2024-05-13T17:04:10,Donostia,expenses,cash,-100.0,-39123.42
buyer_5,Sara,30,ES70209577946926284453,TRX_N-00986-38419552,2024-05-14T09:47:11,Zarautz,expenses,food,-105.02,-39228.44
buyer_5,Sara,30,ES70209577946926284453,TRX_N-00987-70438198,2024-05-14T19:15:38,Donostia,expenses,cash,-100.0,-39328.44
buyer_5,Sara,30,ES70209577946926284453,TRX_N-00988-89359207,2024-05-15T00:17:06,Donostia,expenses,leisure,-35.24,-39363.68
buyer_5,Sara,30,ES70209577946926284453,TRX_N-00989-75981535,2024-05-16T08:26:33,Donostia,expenses,education,-42.39,-39406.07
buyer_5,Sara,30,ES70209577946926284453,TRX_N-00990-72109709,2024-05-16T13:43:23,Donostia,expenses,children,-253.63,-39659.7
buyer_5,Sara,30,ES70209577946926284453,TRX_N-00991-48023679,2024-05-17T18:03:31,Donostia,expenses,food,-105.84,-39765.54
buyer_5,Sara,30,ES70209577946926284453,TRX_N-00992-00020782,2024-05-17T12:49:41,Amurrio,expenses,cash,-100.0,-39865.54
buyer_5,Sara,30,ES70209577946926284453,TRX_N-00993-17112052,2024-05-18T12:29:08,Donostia,expenses,cash,-100.0,-39965.54
buyer_5,Sara,30,ES70209577946926284453,TRX_N-00994-73809985,2024-05-22T19:52:20,Donostia,expenses,transport,-60.75,-40026.29
buyer_5,Sara,30,ES70209577946926284453,TRX_N-00995-14430073,2024-05-23T19:56:55,Donostia,expenses,food,-98.57,-40124.86
buyer_5,Sara,30,ES70209577946926284453,TRX_N-00996-20483531,2024-05-23T14:37:02,Alegría-Dulantzi,expenses,transport,-48.01,-40172.87
buyer_5,Sara,30,ES70209577946926284453,TRX_N-00997-17431309,2024-05-24T23:42:07,Donostia,expenses,food,-105.43,-40278.3
buyer_5,Sara,30,ES70209577946926284453,TRX_N-00998-23424311,2024-05-24T15:36:19,Donostia,expenses,clothing,-151.08,-40429.38
buyer_5,Sara,30,ES70209577946926284453,TRX_N-00999-81422140,2024-05-26T17:19:45,Donostia,expenses,healthcare,-140.7,-40570.08
buyer_5,Sara,30,ES70209577946926284453,TRX_N-01000-58738024,2024-05-27T17:05:51,Donostia,expenses,education,-64.18,-40634.26
buyer_5,Sara,30,ES70209577946926284453,TRX_N-01001-58500928,2024-05-27T20:32:52,Donostia,expenses,cash,-100.0,-40734.26
buyer_5,Sara,30,ES70209577946926284453,TRX_N-01002-91612443,2024-05-27T23:55:59,Donostia,expenses,gifts,-188.85,-40923.11
buyer_5,Sara,30,ES70209577946926284453,TRX_N-01003-43816619,2024-05-28T20:19:42,Donostia,expenses,food,-75.57,-40998.68
buyer_5,Sara,30,ES70209577946926284453,TRX_N-01004-45857167,2024-05-29T10:01:43,Donostia,expenses,food,-78.46,-41077.14
buyer_5,Sara,30,ES70209577946926284453,TRX_N-01005-18177538,2024-05-31T19:12:27,Labastida,expenses,cash,-100.0,-41177.14
buyer_5,Sara,30,ES70209577946926284453,TRX_N-01006-13110379,2024-05-31T09:26:25,Vitoria-Gasteiz,expenses,gifts,-616.59,-41793.73
buyer_5,Sara,30,ES70209577946926284453,TRX_N-01007-50274413,2024-06-01T18:26:24,Donostia,incomes,salary,1355.99,-40437.74
buyer_5,Sara,30,ES70209577946926284453,TRX_N-01008-27003487,2024-06-01T18:26:24,Donostia,incomes,salary_partner,1772.4,-38665.34
buyer_5,Sara,30,ES70209577946926284453,TRX_N-01009-65131842,2024-06-01T18:26:24,Donostia,incomes,salary_bonus,980.08,-37685.26
buyer_5,Sara,30,ES70209577946926284453,TRX_N-01010-20924727,2024-06-01T18:26:24,Donostia,incomes,salary_partner_bonus,1402.37,-36282.89
buyer_5,Sara,30,ES70209577946926284453,TRX_N-01011-12745019,2024-06-01T20:14:45,Donostia,expenses,food,-108.74,-36391.63
buyer_5,Sara,30,ES70209577946926284453,TRX_N-01012-23557795,2024-06-01T09:05:13,Donostia,expenses,travel,-769.79,-37161.42
buyer_5,Sara,30,ES70209577946926284453,TRX_N-01013-71227315,2024-06-02T20:59:55,Donostia,expenses,leisure,-40.6,-37202.02
buyer_5,Sara,30,ES70209577946926284453,TRX_N-01014-57526732,2024-06-02T13:10:48,Donostia,expenses,cash,-100.0,-37302.02
buyer_5,Sara,30,ES70209577946926284453,TRX_N-01015-79912137,2024-06-04T19:32:00,Donostia,expenses,mortgage,-897.77,-38199.79
buyer_5,Sara,30,ES70209577946926284453,TRX_N-01016-64085173,2024-06-04T00:03:43,Donostia,expenses,food,-116.32,-38316.11
buyer_5,Sara,30,ES70209577946926284453,TRX_N-01017-49011293,2024-06-05T12:39:37,Donostia,expenses,water,-44.92,-38361.03
buyer_5,Sara,30,ES70209577946926284453,TRX_N-01018-67737170,2024-06-05T18:14:59,Donostia,expenses,electricity,-24.35,-38385.38
buyer_5,Sara,30,ES70209577946926284453,TRX_N-01019-98041830,2024-06-05T19:34:09,Donostia,expenses,repairs,-83.52,-38468.9
buyer_5,Sara,30,ES70209577946926284453,TRX_N-01020-19725452,2024-06-06T15:38:03,Donostia,expenses,internet,-42.0,-38510.9
buyer_5,Sara,30,ES70209577946926284453,TRX_N-01021-73089353,2024-06-06T18:26:40,Donostia,expenses,phone,-40.47,-38551.37
buyer_5,Sara,30,ES70209577946926284453,TRX_N-01022-55341160,2024-06-06T08:24:01,Donostia,expenses,education,-67.44,-38618.81
buyer_5,Sara,30,ES70209577946926284453,TRX_N-01023-41965035,2024-06-07T17:16:30,Oyón-Oion,expenses,repairs,-218.81,-38837.62
buyer_5,Sara,30,ES70209577946926284453,TRX_N-01024-48558937,2024-06-08T17:44:26,Donostia,expenses,gas,-75.67,-38913.29
buyer_5,Sara,30,ES70209577946926284453,TRX_N-01025-32028916,2024-06-08T16:49:53,Donostia,expenses,cash,-100.0,-39013.29
buyer_5,Sara,30,ES70209577946926284453,TRX_N-01026-08646078,2024-06-08T19:11:01,Zuia,expenses,travel,-1112.71,-40126.0
buyer_5,Sara,30,ES70209577946926284453,TRX_N-01027-60297575,2024-06-09T16:52:25,Donostia,expenses,transport,-73.09,-40199.09
buyer_5,Sara,30,ES70209577946926284453,TRX_N-01028-64872892,2024-06-09T19:33:27,Donostia,expenses,gifts,-661.99,-40861.08
buyer_5,Sara,30,ES70209577946926284453,TRX_N-01029-08174257,2024-06-10T10:31:09,Sestao,expenses,food,-69.53,-40930.61
buyer_5,Sara,30,ES70209577946926284453,TRX_N-01030-03175597,2024-06-10T18:00:59,Donostia,expenses,children,-237.67,-41168.28
buyer_5,Sara,30,ES70209577946926284453,TRX_N-01031-98266583,2024-06-15T11:14:01,Donostia,expenses,healthcare,-62.22,-41230.5
buyer_5,Sara,30,ES70209577946926284453,TRX_N-01032-57963625,2024-06-17T18:06:26,Donostia,expenses,cash,-100.0,-41330.5
buyer_5,Sara,30,ES70209577946926284453,TRX_N-01033-86873966,2024-06-18T17:05:45,Zuia,expenses,transport,-65.49,-41395.99
buyer_5,Sara,30,ES70209577946926284453,TRX_N-01034-96309832,2024-06-18T20:46:42,Donostia,expenses,leisure,-61.76,-41457.75
buyer_5,Sara,30,ES70209577946926284453,TRX_N-01035-79607149,2024-06-18T14:03:08,Donostia,expenses,appliances,-159.65,-41617.4
buyer_5,Sara,30,ES70209577946926284453,TRX_N-01036-19760268,2024-06-20T13:26:44,Donostia,expenses,food,-83.3,-41700.7
buyer_5,Sara,30,ES70209577946926284453,TRX_N-01037-92589432,2024-06-21T05:44:42,Donostia,expenses,leisure,-71.08,-41771.78
buyer_5,Sara,30,ES70209577946926284453,TRX_N-01038-27047974,2024-06-21T11:09:55,Donostia,expenses,clothing,-120.52,-41892.3
buyer_5,Sara,30,ES70209577946926284453,TRX_N-01039-57591934,2024-06-21T20:43:50,Donostia,expenses,healthcare,-67.13,-41959.43
buyer_5,Sara,30,ES70209577946926284453,TRX_N-01040-14723287,2024-06-21T17:36:17,Donostia,expenses,cash,-100.0,-42059.43
buyer_5,Sara,30,ES70209577946926284453,TRX_N-01041-20409299,2024-06-23T09:49:56,Donostia,expenses,children,-178.21,-42237.64
buyer_5,Sara,30,ES70209577946926284453,TRX_N-01042-86705830,2024-06-25T13:53:42,Donostia,expenses,repairs,-235.79,-42473.43
buyer_5,Sara,30,ES70209577946926284453,TRX_N-01043-08197604,2024-06-26T00:25:17,Donostia,expenses,food,-96.17,-42569.6
buyer_5,Sara,30,ES70209577946926284453,TRX_N-01044-69630262,2024-06-26T19:10:40,Donostia,expenses,transport,-76.53,-42646.13
buyer_5,Sara,30,ES70209577946926284453,TRX_N-01045-06333048,2024-06-26T11:17:19,Donostia,expenses,leisure,-78.97,-42725.1
buyer_5,Sara,30,ES70209577946926284453,TRX_N-01046-91381059,2024-06-26T23:08:28,Donostia,expenses,cash,-100.0,-42825.1
buyer_5,Sara,30,ES70209577946926284453,TRX_N-01047-48059315,2024-06-26T03:55:21,Donostia,expenses,repairs,-199.57,-43024.67
buyer_5,Sara,30,ES70209577946926284453,TRX_N-01048-81064927,2024-06-27T10:28:01,Andoain,expenses,transport,-47.84,-43072.51
buyer_5,Sara,30,ES70209577946926284453,TRX_N-01049-18293594,2024-06-27T08:58:48,Donostia,expenses,leisure,-31.42,-43103.93
buyer_5,Sara,30,ES70209577946926284453,TRX_N-01050-53913383,2024-06-28T17:08:45,Hondarribia,expenses,food,-95.22,-43199.15
buyer_5,Sara,30,ES70209577946926284453,TRX_N-01051-79347095,2024-06-28T20:41:56,Labastida,expenses,education,-45.59,-43244.74
buyer_5,Sara,30,ES70209577946926284453,TRX_N-01052-06648111,2024-07-01T08:51:42,Donostia,incomes,salary,1355.99,-41888.75
buyer_5,Sara,30,ES70209577946926284453,TRX_N-01053-59051049,2024-07-01T08:51:42,Donostia,incomes,salary_partner,1772.4,-40116.35
buyer_5,Sara,30,ES70209577946926284453,TRX_N-01054-66601901,2024-07-01T12:42:22,Donostia,expenses,cash,-100.0,-40216.35
buyer_5,Sara,30,ES70209577946926284453,TRX_N-01055-38767529,2024-07-02T08:43:18,Andoain,expenses,clothing,-58.3,-40274.65
buyer_5,Sara,30,ES70209577946926284453,TRX_N-01056-66665558,2024-07-02T16:33:40,Donostia,expenses,children,-142.34,-40416.99
buyer_5,Sara,30,ES70209577946926284453,TRX_N-01057-57173912,2024-07-03T20:27:42,Donostia,expenses,transport,-68.5,-40485.49
buyer_5,Sara,30,ES70209577946926284453,TRX_N-01058-16696328,2024-07-03T17:19:34,Donostia,expenses,cash,-100.0,-40585.49
buyer_5,Sara,30,ES70209577946926284453,TRX_N-01059-43077421,2024-07-04T20:49:33,Donostia,expenses,mortgage,-897.77,-41483.26
buyer_5,Sara,30,ES70209577946926284453,TRX_N-01060-55807831,2024-07-05T19:41:11,Donostia,expenses,water,-37.51,-41520.77
buyer_5,Sara,30,ES70209577946926284453,TRX_N-01061-08529894,2024-07-06T14:59:30,Donostia,expenses,education,-76.48,-41597.25
buyer_5,Sara,30,ES70209577946926284453,TRX_N-01062-21550094,2024-07-07T10:18:01,Donostia,expenses,gas,-31.16,-41628.41
buyer_5,Sara,30,ES70209577946926284453,TRX_N-01063-16700740,2024-07-07T10:03:34,Donostia,expenses,internet,-42.0,-41670.41
buyer_5,Sara,30,ES70209577946926284453,TRX_N-01064-08476731,2024-07-08T16:45:14,Donostia,expenses,electricity,-36.6,-41707.01
buyer_5,Sara,30,ES70209577946926284453,TRX_N-01065-99028727,2024-07-08T14:25:45,Donostia,expenses,phone,-32.37,-41739.38
buyer_5,Sara,30,ES70209577946926284453,TRX_N-01066-27820813,2024-07-09T12:26:42,Donostia,expenses,food,-76.35,-41815.73
buyer_5,Sara,30,ES70209577946926284453,TRX_N-01067-37940011,2024-07-09T09:39:25,Donostia,expenses,gifts,-433.0,-42248.73
buyer_5,Sara,30,ES70209577946926284453,TRX_N-01068-37246390,2024-07-10T11:08:01,Donostia,expenses,gifts,-682.23,-42930.96
buyer_5,Sara,30,ES70209577946926284453,TRX_N-01069-62159001,2024-07-12T13:43:26,Donostia,expenses,repairs,-56.47,-42987.43
buyer_5,Sara,30,ES70209577946926284453,TRX_N-01070-08605959,2024-07-13T18:32:54,Donostia,expenses,appliances,-113.09,-43100.52
buyer_5,Sara,30,ES70209577946926284453,TRX_N-01071-84190428,2024-07-13T10:53:54,Donostia,expenses,repairs,-290.83,-43391.35
buyer_5,Sara,30,ES70209577946926284453,TRX_N-01072-63105388,2024-07-15T13:22:27,Oyón-Oion,expenses,leisure,-70.02,-43461.37
buyer_5,Sara,30,ES70209577946926284453,TRX_N-01073-76285091,2024-07-15T12:12:02,Donostia,expenses,education,-61.44,-43522.81
buyer_5,Sara,30,ES70209577946926284453,TRX_N-01074-50790197,2024-07-15T22:50:31,Donostia,expenses,children,-131.67,-43654.48
buyer_5,Sara,30,ES70209577946926284453,TRX_N-01075-88872342,2024-07-17T10:53:49,Donostia,expenses,food,-124.78,-43779.26
buyer_5,Sara,30,ES70209577946926284453,TRX_N-01076-18517201,2024-07-17T13:05:55,Donostia,expenses,education,-65.22,-43844.48
buyer_5,Sara,30,ES70209577946926284453,TRX_N-01077-56810676,2024-07-20T19:21:03,Donostia,expenses,leisure,-28.01,-43872.49
buyer_5,Sara,30,ES70209577946926284453,TRX_N-01078-19865291,2024-07-21T22:43:32,Donostia,expenses,food,-70.45,-43942.94
buyer_5,Sara,30,ES70209577946926284453,TRX_N-01079-13412827,2024-07-21T08:39:04,Donostia,expenses,cash,-100.0,-44042.94
buyer_5,Sara,30,ES70209577946926284453,TRX_N-01080-50330212,2024-07-22T23:51:31,Donostia,expenses,leisure,-41.28,-44084.22
buyer_5,Sara,30,ES70209577946926284453,TRX_N-01081-97182427,2024-07-22T20:46:48,Donostia,expenses,repairs,-287.53,-44371.75
buyer_5,Sara,30,ES70209577946926284453,TRX_N-01082-38033544,2024-07-24T17:26:49,Donostia,expenses,transport,-81.19,-44452.94
buyer_5,Sara,30,ES70209577946926284453,TRX_N-01083-41355559,2024-07-25T09:27:17,Basauri,expenses,transport,-66.34,-44519.28
buyer_5,Sara,30,ES70209577946926284453,TRX_N-01084-10119357,2024-07-26T22:29:57,Labastida,expenses,cash,-100.0,-44619.28
buyer_5,Sara,30,ES70209577946926284453,TRX_N-01085-85562460,2024-07-26T19:20:09,Donostia,expenses,gifts,-46.94,-44666.22
buyer_5,Sara,30,ES70209577946926284453,TRX_N-01086-18194508,2024-07-27T18:25:59,Salvatierra/Agurain,expenses,food,-72.44,-44738.66
buyer_5,Sara,30,ES70209577946926284453,TRX_N-01087-29571902,2024-07-27T15:03:33,Donostia,expenses,leisure,-40.41,-44779.07
buyer_5,Sara,30,ES70209577946926284453,TRX_N-01088-16755495,2024-07-28T10:07:29,Donostia,expenses,transport,-50.39,-44829.46
buyer_5,Sara,30,ES70209577946926284453,TRX_N-01089-53154770,2024-07-29T11:01:44,Bilbao,expenses,food,-96.77,-44926.23
buyer_5,Sara,30,ES70209577946926284453,TRX_N-01090-16319601,2024-07-29T09:57:51,Donostia,expenses,leisure,-65.51,-44991.74
buyer_5,Sara,30,ES70209577946926284453,TRX_N-01091-33045187,2024-08-01T02:02:03,Donostia,incomes,salary,1355.99,-43635.75
buyer_5,Sara,30,ES70209577946926284453,TRX_N-01092-50624513,2024-08-01T02:02:03,Donostia,incomes,salary_partner,1772.4,-41863.35
buyer_5,Sara,30,ES70209577946926284453,TRX_N-01093-22086622,2024-08-02T22:42:27,Donostia,expenses,cash,-100.0,-41963.35
buyer_5,Sara,30,ES70209577946926284453,TRX_N-01094-45827127,2024-08-02T01:22:40,Donostia,expenses,travel,-1024.49,-42987.84
buyer_5,Sara,30,ES70209577946926284453,TRX_N-01095-57788117,2024-08-03T12:40:51,Donostia,expenses,transport,-43.84,-43031.68
buyer_5,Sara,30,ES70209577946926284453,TRX_N-01096-14437821,2024-08-04T21:29:22,Donostia,expenses,mortgage,-897.77,-43929.45
buyer_5,Sara,30,ES70209577946926284453,TRX_N-01097-37459377,2024-08-04T15:43:13,Donostia,expenses,transport,-75.79,-44005.24
buyer_5,Sara,30,ES70209577946926284453,TRX_N-01098-28015294,2024-08-04T11:11:10,Donostia,expenses,leisure,-47.59,-44052.83
buyer_5,Sara,30,ES70209577946926284453,TRX_N-01099-38043235,2024-08-04T17:12:09,Donostia,expenses,cash,-100.0,-44152.83
buyer_5,Sara,30,ES70209577946926284453,TRX_N-01100-23592594,2024-08-05T11:34:02,Donostia,expenses,phone,-44.27,-44197.1
buyer_5,Sara,30,ES70209577946926284453,TRX_N-01101-99847718,2024-08-05T09:44:19,Donostia,expenses,clothing,-126.46,-44323.56
buyer_5,Sara,30,ES70209577946926284453,TRX_N-01102-08257540,2024-08-06T23:12:22,Donostia,expenses,electricity,-33.05,-44356.61
buyer_5,Sara,30,ES70209577946926284453,TRX_N-01103-07814032,2024-08-07T10:57:51,Hernani,expenses,food,-78.56,-44435.17
buyer_5,Sara,30,ES70209577946926284453,TRX_N-01104-08390924,2024-08-07T19:15:02,Donostia,expenses,repairs,-315.69,-44750.86
buyer_5,Sara,30,ES70209577946926284453,TRX_N-01105-83825882,2024-08-08T09:18:19,Donostia,expenses,water,-41.44,-44792.3
buyer_5,Sara,30,ES70209577946926284453,TRX_N-01106-58232910,2024-08-08T15:57:30,Donostia,expenses,gas,-75.71,-44868.01
buyer_5,Sara,30,ES70209577946926284453,TRX_N-01107-85628034,2024-08-08T17:39:26,Donostia,expenses,internet,-42.0,-44910.01
buyer_5,Sara,30,ES70209577946926284453,TRX_N-01108-87177032,2024-08-08T09:46:24,Donostia,expenses,cash,-100.0,-45010.01
buyer_5,Sara,30,ES70209577946926284453,TRX_N-01109-36414698,2024-08-09T20:57:52,Portugalete,expenses,repairs,-226.56,-45236.57
buyer_5,Sara,30,ES70209577946926284453,TRX_N-01110-34186806,2024-08-11T16:50:37,Donostia,expenses,leisure,-70.89,-45307.46
buyer_5,Sara,30,ES70209577946926284453,TRX_N-01111-64777999,2024-08-11T12:03:56,Donostia,expenses,gifts,-136.1,-45443.56
buyer_5,Sara,30,ES70209577946926284453,TRX_N-01112-46387221,2024-08-14T02:34:48,Basauri,expenses,leisure,-73.32,-45516.88
buyer_5,Sara,30,ES70209577946926284453,TRX_N-01113-48858788,2024-08-14T08:49:28,Eibar,expenses,travel,-1820.12,-47337.0
buyer_5,Sara,30,ES70209577946926284453,TRX_N-01114-83551821,2024-08-15T08:40:39,Donostia,expenses,repairs,-320.38,-47657.38
buyer_5,Sara,30,ES70209577946926284453,TRX_N-01115-24985323,2024-08-16T11:38:39,Galdakao,expenses,food,-60.92,-47718.3
buyer_5,Sara,30,ES70209577946926284453,TRX_N-01116-49447158,2024-08-16T12:55:14,Donostia,expenses,leisure,-63.18,-47781.48
buyer_5,Sara,30,ES70209577946926284453,TRX_N-01117-17172942,2024-08-16T18:23:18,Donostia,expenses,repairs,-222.67,-48004.15
buyer_5,Sara,30,ES70209577946926284453,TRX_N-01118-36891380,2024-08-18T16:46:12,Donostia,expenses,transport,-41.32,-48045.47
buyer_5,Sara,30,ES70209577946926284453,TRX_N-01119-04980502,2024-08-22T12:32:29,Donostia,expenses,transport,-84.52,-48129.99
buyer_5,Sara,30,ES70209577946926284453,TRX_N-01120-90424245,2024-08-23T15:14:24,Donostia,expenses,food,-114.55,-48244.54
buyer_5,Sara,30,ES70209577946926284453,TRX_N-01121-98152204,2024-08-25T09:08:08,Donostia,expenses,children,-84.26,-48328.8
buyer_5,Sara,30,ES70209577946926284453,TRX_N-01122-77699786,2024-08-26T13:19:32,Donostia,expenses,leisure,-42.85,-48371.65
buyer_5,Sara,30,ES70209577946926284453,TRX_N-01123-78483521,2024-08-29T12:31:22,Donostia,expenses,healthcare,-176.17,-48547.82
buyer_5,Sara,30,ES70209577946926284453,TRX_N-01124-83421434,2024-08-31T13:16:39,Donostia,expenses,transport,-68.04,-48615.86
buyer_5,Sara,30,ES70209577946926284453,TRX_N-01125-35081982,2024-09-01T03:34:01,Donostia,incomes,salary,1355.99,-47259.87
buyer_5,Sara,30,ES70209577946926284453,TRX_N-01126-57248164,2024-09-01T03:34:01,Donostia,incomes,salary_partner,1772.4,-45487.47
buyer_5,Sara,30,ES70209577946926284453,TRX_N-01127-56080721,2024-09-01T03:34:01,Donostia,incomes,extra_income,170.69,-45316.78
buyer_5,Sara,30,ES70209577946926284453,TRX_N-01128-13140292,2024-09-01T22:17:21,Donostia,expenses,repairs,-153.63,-45470.41
buyer_5,Sara,30,ES70209577946926284453,TRX_N-01129-21722995,2024-09-02T13:15:41,Donostia,expenses,food,-103.31,-45573.72
buyer_5,Sara,30,ES70209577946926284453,TRX_N-01130-85097016,2024-09-03T18:29:51,Donostia,expenses,food,-79.05,-45652.77
buyer_5,Sara,30,ES70209577946926284453,TRX_N-01131-25088455,2024-09-03T10:22:20,Donostia,expenses,leisure,-37.19,-45689.96
buyer_5,Sara,30,ES70209577946926284453,TRX_N-01132-90498556,2024-09-04T17:16:28,Donostia,expenses,mortgage,-897.77,-46587.73
buyer_5,Sara,30,ES70209577946926284453,TRX_N-01133-54989913,2024-09-05T14:50:38,Donostia,expenses,leisure,-83.08,-46670.81
buyer_5,Sara,30,ES70209577946926284453,TRX_N-01134-09655017,2024-09-06T11:26:40,Donostia,expenses,electricity,-40.21,-46711.02
buyer_5,Sara,30,ES70209577946926284453,TRX_N-01135-10290851,2024-09-06T10:27:20,Donostia,expenses,gas,-70.31,-46781.33
buyer_5,Sara,30,ES70209577946926284453,TRX_N-01136-79769837,2024-09-06T21:10:25,Donostia,expenses,internet,-42.0,-46823.33
buyer_5,Sara,30,ES70209577946926284453,TRX_N-01137-82055777,2024-09-06T15:20:30,Donostia,expenses,phone,-40.82,-46864.15
buyer_5,Sara,30,ES70209577946926284453,TRX_N-01138-02767940,2024-09-07T16:34:26,Donostia,expenses,water,-44.05,-46908.2
buyer_5,Sara,30,ES70209577946926284453,TRX_N-01139-30486659,2024-09-07T01:48:42,Leioa,expenses,leisure,-73.4,-46981.6
buyer_5,Sara,30,ES70209577946926284453,TRX_N-01140-58402768,2024-09-07T09:35:22,Donostia,expenses,children,-132.31,-47113.91
buyer_5,Sara,30,ES70209577946926284453,TRX_N-01141-50870046,2024-09-09T15:55:55,Donostia,expenses,food,-67.77,-47181.68
buyer_5,Sara,30,ES70209577946926284453,TRX_N-01142-62130333,2024-09-09T15:08:00,Donostia,expenses,transport,-84.99,-47266.67
buyer_5,Sara,30,ES70209577946926284453,TRX_N-01143-05366783,2024-09-12T20:22:14,Donostia,expenses,gifts,-700.34,-47967.01
buyer_5,Sara,30,ES70209577946926284453,TRX_N-01144-03235295,2024-09-14T20:41:27,Donostia,expenses,education,-47.04,-48014.05
buyer_5,Sara,30,ES70209577946926284453,TRX_N-01145-62628778,2024-09-17T08:45:34,Vitoria-Gasteiz,expenses,cash,-100.0,-48114.05
buyer_5,Sara,30,ES70209577946926284453,TRX_N-01146-50529025,2024-09-17T11:54:20,Pasaia,expenses,gifts,-614.75,-48728.8
buyer_5,Sara,30,ES70209577946926284453,TRX_N-01147-40044459,2024-09-19T20:57:32,Donostia,expenses,repairs,-170.86,-48899.66
buyer_5,Sara,30,ES70209577946926284453,TRX_N-01148-87566690,2024-09-20T17:18:00,Donostia,expenses,cash,-100.0,-48999.66
buyer_5,Sara,30,ES70209577946926284453,TRX_N-01149-56366601,2024-09-22T08:41:48,Donostia,expenses,leisure,-49.49,-49049.15
buyer_5,Sara,30,ES70209577946926284453,TRX_N-01150-68723694,2024-09-22T12:48:36,Hernani,expenses,cash,-100.0,-49149.15
buyer_5,Sara,30,ES70209577946926284453,TRX_N-01151-67874631,2024-09-23T16:29:20,Donostia,expenses,food,-73.21,-49222.36
buyer_5,Sara,30,ES70209577946926284453,TRX_N-01152-40723830,2024-09-23T20:13:09,Donostia,expenses,cash,-100.0,-49322.36
buyer_5,Sara,30,ES70209577946926284453,TRX_N-01153-64612317,2024-09-24T21:32:49,Donostia,expenses,children,-76.52,-49398.88
buyer_5,Sara,30,ES70209577946926284453,TRX_N-01154-34272627,2024-09-25T16:33:03,Arrasate,expenses,food,-93.85,-49492.73
buyer_5,Sara,30,ES70209577946926284453,TRX_N-01155-11608781,2024-09-25T20:54:02,Donostia,expenses,transport,-52.45,-49545.18
buyer_5,Sara,30,ES70209577946926284453,TRX_N-01156-10151770,2024-09-25T14:31:42,Donostia,expenses,children,-66.17,-49611.35
buyer_5,Sara,30,ES70209577946926284453,TRX_N-01157-20128019,2024-09-26T09:01:34,Llodio,expenses,food,-88.98,-49700.33
buyer_5,Sara,30,ES70209577946926284453,TRX_N-01158-48528522,2024-09-27T11:08:29,Donostia,expenses,food,-82.31,-49782.64
buyer_5,Sara,30,ES70209577946926284453,TRX_N-01159-73194231,2024-09-29T06:04:38,Galdakao,expenses,healthcare,-76.93,-49859.57
buyer_5,Sara,30,ES70209577946926284453,TRX_N-01160-71074839,2024-09-30T14:58:53,Donostia,expenses,repairs,-120.92,-49980.49
buyer_5,Sara,30,ES70209577946926284453,TRX_N-01161-65762901,2024-10-01T11:43:53,Donostia,incomes,salary,1355.99,-48624.5
buyer_5,Sara,30,ES70209577946926284453,TRX_N-01162-88874926,2024-10-01T11:43:53,Donostia,incomes,salary_partner,1772.4,-46852.1
buyer_5,Sara,30,ES70209577946926284453,TRX_N-01163-21994081,2024-10-02T11:24:35,Iruña de Oca,expenses,food,-106.67,-46958.77
buyer_5,Sara,30,ES70209577946926284453,TRX_N-01164-62981038,2024-10-04T14:33:54,Donostia,expenses,mortgage,-897.77,-47856.54
buyer_5,Sara,30,ES70209577946926284453,TRX_N-01165-50853590,2024-10-05T23:36:41,Donostia,expenses,water,-37.53,-47894.07
buyer_5,Sara,30,ES70209577946926284453,TRX_N-01166-78480344,2024-10-06T01:59:05,Donostia,expenses,internet,-42.0,-47936.07
buyer_5,Sara,30,ES70209577946926284453,TRX_N-01167-62810956,2024-10-06T09:01:16,Donostia,expenses,phone,-34.72,-47970.79
buyer_5,Sara,30,ES70209577946926284453,TRX_N-01168-16957111,2024-10-08T08:54:42,Donostia,expenses,electricity,-75.98,-48046.77
buyer_5,Sara,30,ES70209577946926284453,TRX_N-01169-22680059,2024-10-08T15:29:35,Donostia,expenses,gas,-37.97,-48084.74
buyer_5,Sara,30,ES70209577946926284453,TRX_N-01170-04751652,2024-10-08T15:39:14,Donostia,expenses,food,-101.73,-48186.47
buyer_6,Manuel,45,ES56209598028877404654,TRX_N-00001-72256864,2022-01-01T04:52:40,Vitoria-Gasteiz,incomes,salary,1460.55,3338.62
buyer_6,Manuel,45,ES56209598028877404654,TRX_N-00002-57890688,2022-01-01T04:52:40,Vitoria-Gasteiz,incomes,salary_partner,1380.78,4719.4
buyer_6,Manuel,45,ES56209598028877404654,TRX_N-00003-35025163,2022-01-02T14:32:06,Vitoria-Gasteiz,expenses,gifts,-280.64,4438.76
buyer_6,Manuel,45,ES56209598028877404654,TRX_N-00004-34580537,2022-01-04T19:24:20,Vitoria-Gasteiz,expenses,mortgage,-718.03,3720.73
buyer_6,Manuel,45,ES56209598028877404654,TRX_N-00005-97152832,2022-01-04T11:43:30,Vitoria-Gasteiz,expenses,leisure,-35.94,3684.79
buyer_6,Manuel,45,ES56209598028877404654,TRX_N-00006-68845574,2022-01-05T16:26:51,Vitoria-Gasteiz,expenses,water,-31.56,3653.23
buyer_6,Manuel,45,ES56209598028877404654,TRX_N-00007-30646276,2022-01-05T14:42:48,Vitoria-Gasteiz,expenses,electricity,-22.39,3630.84
buyer_6,Manuel,45,ES56209598028877404654,TRX_N-00008-38612612,2022-01-06T08:40:19,Vitoria-Gasteiz,expenses,gas,-86.0,3544.84
buyer_6,Manuel,45,ES56209598028877404654,TRX_N-00009-78769932,2022-01-06T17:39:07,Vitoria-Gasteiz,expenses,internet,-42.0,3502.84
buyer_6,Manuel,45,ES56209598028877404654,TRX_N-00010-56149012,2022-01-06T10:41:01,Vitoria-Gasteiz,expenses,cash,-100.0,3402.84
buyer_6,Manuel,45,ES56209598028877404654,TRX_N-00011-04129873,2022-01-06T17:45:34,Vitoria-Gasteiz,expenses,repairs,-34.14,3368.7
buyer_6,Manuel,45,ES56209598028877404654,TRX_N-00012-84294225,2022-01-06T11:24:39,Vitoria-Gasteiz,expenses,children,-183.22,3185.48
buyer_6,Manuel,45,ES56209598028877404654,TRX_N-00013-92659676,2022-01-07T17:01:16,Vitoria-Gasteiz,expenses,cash,-100.0,3085.48
buyer_6,Manuel,45,ES56209598028877404654,TRX_N-00014-01461787,2022-01-08T09:40:52,Vitoria-Gasteiz,expenses,phone,-35.06,3050.42
buyer_6,Manuel,45,ES56209598028877404654,TRX_N-00015-84994037,2022-01-11T12:48:20,Vitoria-Gasteiz,expenses,leisure,-77.49,2972.93
buyer_6,Manuel,45,ES56209598028877404654,TRX_N-00016-14881773,2022-01-11T19:02:46,Vitoria-Gasteiz,expenses,gifts,-542.71,2430.22
buyer_6,Manuel,45,ES56209598028877404654,TRX_N-00017-59431724,2022-01-12T10:12:46,Vitoria-Gasteiz,expenses,leisure,-57.27,2372.95
buyer_6,Manuel,45,ES56209598028877404654,TRX_N-00018-87339897,2022-01-14T18:05:30,Vitoria-Gasteiz,expenses,food,-73.13,2299.82
buyer_6,Manuel,45,ES56209598028877404654,TRX_N-00019-19596535,2022-01-15T09:21:16,Vitoria-Gasteiz,expenses,cash,-100.0,2199.82
buyer_6,Manuel,45,ES56209598028877404654,TRX_N-00020-88185154,2022-01-15T12:52:50,Vitoria-Gasteiz,expenses,children,-241.77,1958.05
buyer_6,Manuel,45,ES56209598028877404654,TRX_N-00021-45592926,2022-01-16T15:01:13,Vitoria-Gasteiz,expenses,appliances,-258.72,1699.33
buyer_6,Manuel,45,ES56209598028877404654,TRX_N-00022-19689978,2022-01-18T22:49:58,Vitoria-Gasteiz,expenses,food,-68.09,1631.24
buyer_6,Manuel,45,ES56209598028877404654,TRX_N-00023-25527646,2022-01-18T11:16:49,Vitoria-Gasteiz,expenses,appliances,-322.83,1308.41
buyer_6,Manuel,45,ES56209598028877404654,TRX_N-00024-96945088,2022-01-19T15:24:14,Vitoria-Gasteiz,expenses,appliances,-405.62,902.79
buyer_6,Manuel,45,ES56209598028877404654,TRX_N-00025-98888109,2022-01-21T08:18:32,Leioa,expenses,leisure,-64.31,838.48
buyer_6,Manuel,45,ES56209598028877404654,TRX_N-00026-70871726,2022-01-21T06:44:22,Vitoria-Gasteiz,expenses,education,-73.64,764.84
buyer_6,Manuel,45,ES56209598028877404654,TRX_N-00027-61463653,2022-01-23T15:56:14,Vitoria-Gasteiz,expenses,cash,-100.0,664.84
buyer_6,Manuel,45,ES56209598028877404654,TRX_N-00028-44081980,2022-01-25T10:30:52,Vitoria-Gasteiz,expenses,education,-64.6,600.24
buyer_6,Manuel,45,ES56209598028877404654,TRX_N-00029-45718134,2022-01-26T19:24:39,Vitoria-Gasteiz,expenses,transport,-62.91,537.33
buyer_6,Manuel,45,ES56209598028877404654,TRX_N-00030-67960040,2022-01-28T20:32:35,Vitoria-Gasteiz,expenses,transport,-66.28,471.05
buyer_6,Manuel,45,ES56209598028877404654,TRX_N-00031-83727700,2022-01-29T14:25:15,Vitoria-Gasteiz,expenses,transport,-86.82,384.23
buyer_6,Manuel,45,ES56209598028877404654,TRX_N-00032-21399426,2022-01-29T15:09:15,Vitoria-Gasteiz,expenses,cash,-100.0,284.23
buyer_6,Manuel,45,ES56209598028877404654,TRX_N-00033-79322958,2022-01-31T18:10:32,Vitoria-Gasteiz,expenses,food,-91.69,192.54
buyer_6,Manuel,45,ES56209598028877404654,TRX_N-00034-31990661,2022-02-01T03:38:55,Vitoria-Gasteiz,incomes,salary,1460.55,1653.09
buyer_6,Manuel,45,ES56209598028877404654,TRX_N-00035-71494006,2022-02-01T03:38:55,Vitoria-Gasteiz,incomes,salary_partner,1380.78,3033.87
buyer_6,Manuel,45,ES56209598028877404654,TRX_N-00036-04564550,2022-02-03T11:12:06,Labastida,expenses,cash,-100.0,2933.87
buyer_6,Manuel,45,ES56209598028877404654,TRX_N-00037-26364217,2022-02-04T08:01:51,Vitoria-Gasteiz,expenses,mortgage,-718.03,2215.84
buyer_6,Manuel,45,ES56209598028877404654,TRX_N-00038-48855631,2022-02-04T19:33:59,Vitoria-Gasteiz,expenses,transport,-45.58,2170.26
buyer_6,Manuel,45,ES56209598028877404654,TRX_N-00039-13381533,2022-02-05T22:17:46,Vitoria-Gasteiz,expenses,electricity,-89.36,2080.9
buyer_6,Manuel,45,ES56209598028877404654,TRX_N-00040-13929231,2022-02-07T08:36:33,Vitoria-Gasteiz,expenses,phone,-33.3,2047.6
buyer_6,Manuel,45,ES56209598028877404654,TRX_N-00041-64268389,2022-02-08T13:50:10,Vitoria-Gasteiz,expenses,internet,-42.0,2005.6
buyer_6,Manuel,45,ES56209598028877404654,TRX_N-00042-06518592,2022-02-08T08:06:31,Vitoria-Gasteiz,expenses,water,-23.53,1982.07
buyer_6,Manuel,45,ES56209598028877404654,TRX_N-00043-35032066,2022-02-08T20:12:02,Vitoria-Gasteiz,expenses,gas,-98.73,1883.34
buyer_6,Manuel,45,ES56209598028877404654,TRX_N-00044-56738000,2022-02-09T21:05:55,Vitoria-Gasteiz,expenses,children,-248.16,1635.18
buyer_6,Manuel,45,ES56209598028877404654,TRX_N-00045-74042100,2022-02-10T08:07:12,Vitoria-Gasteiz,expenses,cash,-100.0,1535.18
buyer_6,Manuel,45,ES56209598028877404654,TRX_N-00046-07708566,2022-02-11T22:34:01,Vitoria-Gasteiz,expenses,education,-52.72,1482.46
buyer_6,Manuel,45,ES56209598028877404654,TRX_N-00047-07725179,2022-02-13T17:53:39,Vitoria-Gasteiz,expenses,food,-79.96,1402.5
buyer_6,Manuel,45,ES56209598028877404654,TRX_N-00048-23890290,2022-02-13T08:55:10,Vitoria-Gasteiz,expenses,transport,-41.22,1361.28
buyer_6,Manuel,45,ES56209598028877404654,TRX_N-00049-16849440,2022-02-14T13:31:41,Vitoria-Gasteiz,expenses,food,-64.94,1296.34
buyer_6,Manuel,45,ES56209598028877404654,TRX_N-00050-42936696,2022-02-14T16:39:25,Vitoria-Gasteiz,expenses,transport,-41.77,1254.57
buyer_6,Manuel,45,ES56209598028877404654,TRX_N-00051-23738774,2022-02-14T19:36:28,Vitoria-Gasteiz,expenses,repairs,-144.83,1109.74
buyer_6,Manuel,45,ES56209598028877404654,TRX_N-00052-73593067,2022-02-15T09:41:24,Vitoria-Gasteiz,expenses,cash,-100.0,1009.74
buyer_6,Manuel,45,ES56209598028877404654,TRX_N-00053-77247016,2022-02-16T01:04:20,Vitoria-Gasteiz,expenses,gifts,-588.33,421.41
buyer_6,Manuel,45,ES56209598028877404654,TRX_N-00054-66774027,2022-02-17T15:24:20,Vitoria-Gasteiz,expenses,cash,-100.0,321.41
buyer_6,Manuel,45,ES56209598028877404654,TRX_N-00055-59454497,2022-02-18T19:55:17,Vitoria-Gasteiz,expenses,clothing,-74.63,246.78
buyer_6,Manuel,45,ES56209598028877404654,TRX_N-00056-43175913,2022-02-19T16:28:56,Vitoria-Gasteiz,expenses,leisure,-66.59,180.19
buyer_6,Manuel,45,ES56209598028877404654,TRX_N-00057-44348892,2022-02-21T15:07:54,Vitoria-Gasteiz,expenses,cash,-100.0,80.19
buyer_6,Manuel,45,ES56209598028877404654,TRX_N-00058-87707285,2022-02-22T14:10:14,Vitoria-Gasteiz,expenses,leisure,-65.66,14.53
buyer_6,Manuel,45,ES56209598028877404654,TRX_N-00059-44267250,2022-02-23T10:47:57,Hondarribia,expenses,food,-122.0,-107.47
buyer_6,Manuel,45,ES56209598028877404654,TRX_N-00060-41326234,2022-02-23T13:49:49,Vitoria-Gasteiz,expenses,transport,-45.1,-152.57
buyer_6,Manuel,45,ES56209598028877404654,TRX_N-00061-82264510,2022-02-25T18:32:23,Vitoria-Gasteiz,expenses,food,-124.62,-277.19
buyer_6,Manuel,45,ES56209598028877404654,TRX_N-00062-78122819,2022-02-25T12:44:19,Getxo,expenses,appliances,-297.38,-574.57
buyer_6,Manuel,45,ES56209598028877404654,TRX_N-00063-63380678,2022-02-26T13:11:16,Vitoria-Gasteiz,expenses,food,-109.89,-684.46
buyer_6,Manuel,45,ES56209598028877404654,TRX_N-00064-75625079,2022-02-28T19:28:24,Vitoria-Gasteiz,expenses,food,-75.77,-760.23
buyer_6,Manuel,45,ES56209598028877404654,TRX_N-00065-81937937,2022-02-28T15:17:50,Vitoria-Gasteiz,expenses,leisure,-67.04,-827.27
buyer_6,Manuel,45,ES56209598028877404654,TRX_N-00066-07339868,2022-03-01T09:23:31,Vitoria-Gasteiz,incomes,salary,1460.55,633.28
buyer_6,Manuel,45,ES56209598028877404654,TRX_N-00067-32545330,2022-03-01T09:23:31,Vitoria-Gasteiz,incomes,salary_partner,1380.78,2014.06
buyer_6,Manuel,45,ES56209598028877404654,TRX_N-00068-89169013,2022-03-01T12:51:58,Vitoria-Gasteiz,expenses,leisure,-23.3,1990.76
buyer_6,Manuel,45,ES56209598028877404654,TRX_N-00069-19616978,2022-03-02T03:20:02,Vitoria-Gasteiz,expenses,food,-79.21,1911.55
buyer_6,Manuel,45,ES56209598028877404654,TRX_N-00070-12983372,2022-03-04T14:28:52,Vitoria-Gasteiz,expenses,mortgage,-718.03,1193.52
buyer_6,Manuel,45,ES56209598028877404654,TRX_N-00071-12163920,2022-03-04T09:10:43,Arrasate,expenses,healthcare,-95.53,1097.99
buyer_6,Manuel,45,ES56209598028877404654,TRX_N-00072-06017480,2022-03-04T18:25:13,Vitoria-Gasteiz,expenses,cash,-100.0,997.99
buyer_6,Manuel,45,ES56209598028877404654,TRX_N-00073-71350411,2022-03-05T16:21:43,Vitoria-Gasteiz,expenses,phone,-43.33,954.66
buyer_6,Manuel,45,ES56209598028877404654,TRX_N-00074-16251191,2022-03-05T20:05:10,Vitoria-Gasteiz,expenses,healthcare,-187.74,766.92
buyer_6,Manuel,45,ES56209598028877404654,TRX_N-00075-28146640,2022-03-05T10:24:36,Vitoria-Gasteiz,expenses,gifts,-482.24,284.68
buyer_6,Manuel,45,ES56209598028877404654,TRX_N-00076-22301131,2022-03-07T20:39:37,Vitoria-Gasteiz,expenses,food,-106.77,177.91
buyer_6,Manuel,45,ES56209598028877404654,TRX_N-00077-88080078,2022-03-07T15:56:35,Vitoria-Gasteiz,expenses,cash,-100.0,77.91
buyer_6,Manuel,45,ES56209598028877404654,TRX_N-00078-37015898,2022-03-07T02:09:33,Vitoria-Gasteiz,expenses,repairs,-79.92,-2.01
buyer_6,Manuel,45,ES56209598028877404654,TRX_N-00079-64620697,2022-03-08T12:20:54,Vitoria-Gasteiz,expenses,gas,-78.69,-80.7
buyer_6,Manuel,45,ES56209598028877404654,TRX_N-00080-20477143,2022-03-08T14:24:01,Vitoria-Gasteiz,expenses,water,-40.8,-121.5
buyer_6,Manuel,45,ES56209598028877404654,TRX_N-00081-09851921,2022-03-08T19:44:07,Vitoria-Gasteiz,expenses,electricity,-54.59,-176.09
buyer_6,Manuel,45,ES56209598028877404654,TRX_N-00082-37319350,2022-03-08T03:42:54,Vitoria-Gasteiz,expenses,internet,-42.0,-218.09
buyer_6,Manuel,45,ES56209598028877404654,TRX_N-00083-90644674,2022-03-08T13:12:00,Vitoria-Gasteiz,expenses,transport,-58.83,-276.92
buyer_6,Manuel,45,ES56209598028877404654,TRX_N-00084-39386677,2022-03-08T15:02:28,Pasaia,expenses,leisure,-18.61,-295.53
buyer_6,Manuel,45,ES56209598028877404654,TRX_N-00085-33582209,2022-03-08T16:55:58,Vitoria-Gasteiz,expenses,cash,-100.0,-395.53
buyer_6,Manuel,45,ES56209598028877404654,TRX_N-00086-46955760,2022-03-10T18:40:23,Vitoria-Gasteiz,expenses,leisure,-71.15,-466.68
buyer_6,Manuel,45,ES56209598028877404654,TRX_N-00087-82008402,2022-03-14T13:36:58,Vitoria-Gasteiz,expenses,food,-84.19,-550.87
buyer_6,Manuel,45,ES56209598028877404654,TRX_N-00088-72571943,2022-03-16T10:47:08,Vitoria-Gasteiz,expenses,gifts,-237.31,-788.18
buyer_6,Manuel,45,ES56209598028877404654,TRX_N-00089-00885449,2022-03-19T10:08:36,Vitoria-Gasteiz,expenses,transport,-84.41,-872.59
buyer_6,Manuel,45,ES56209598028877404654,TRX_N-00090-19003594,2022-03-23T14:07:01,Vitoria-Gasteiz,expenses,gifts,-124.0,-996.59
buyer_6,Manuel,45,ES56209598028877404654,TRX_N-00091-31055113,2022-03-25T10:11:00,Vitoria-Gasteiz,expenses,cash,-100.0,-1096.59
buyer_6,Manuel,45,ES56209598028877404654,TRX_N-00092-60658313,2022-03-27T16:05:36,Vitoria-Gasteiz,expenses,education,-73.91,-1170.5
buyer_6,Manuel,45,ES56209598028877404654,TRX_N-00093-20293279,2022-03-27T19:13:42,Vitoria-Gasteiz,expenses,cash,-100.0,-1270.5
buyer_6,Manuel,45,ES56209598028877404654,TRX_N-00094-63776690,2022-03-28T17:57:47,Vitoria-Gasteiz,expenses,food,-110.04,-1380.54
buyer_6,Manuel,45,ES56209598028877404654,TRX_N-00095-31449331,2022-03-28T20:25:02,Mungia,expenses,cash,-100.0,-1480.54
buyer_6,Manuel,45,ES56209598028877404654,TRX_N-00096-68101080,2022-03-28T09:24:57,Vitoria-Gasteiz,expenses,gifts,-103.89,-1584.43
buyer_6,Manuel,45,ES56209598028877404654,TRX_N-00097-97350033,2022-03-31T03:21:30,Vitoria-Gasteiz,expenses,cash,-100.0,-1684.43
buyer_6,Manuel,45,ES56209598028877404654,TRX_N-00098-63659951,2022-04-01T20:47:48,Vitoria-Gasteiz,incomes,salary,1460.55,-223.88
buyer_6,Manuel,45,ES56209598028877404654,TRX_N-00099-61196800,2022-04-01T20:47:48,Vitoria-Gasteiz,incomes,salary_partner,1380.78,1156.9
buyer_6,Manuel,45,ES56209598028877404654,TRX_N-00100-94854156,2022-04-01T20:47:48,Vitoria-Gasteiz,incomes,extra_income,178.24,1335.14
buyer_6,Manuel,45,ES56209598028877404654,TRX_N-00101-87792078,2022-04-02T16:03:24,Zuia,expenses,education,-45.65,1289.49
buyer_6,Manuel,45,ES56209598028877404654,TRX_N-00102-39038009,2022-04-04T10:35:30,Vitoria-Gasteiz,expenses,mortgage,-718.03,571.46
buyer_6,Manuel,45,ES56209598028877404654,TRX_N-00103-36211591,2022-04-04T19:31:33,Vitoria-Gasteiz,expenses,cash,-100.0,471.46
buyer_6,Manuel,45,ES56209598028877404654,TRX_N-00104-50233931,2022-04-05T11:06:17,Vitoria-Gasteiz,expenses,phone,-39.51,431.95
buyer_6,Manuel,45,ES56209598028877404654,TRX_N-00105-25844252,2022-04-05T19:52:35,Vitoria-Gasteiz,expenses,transport,-57.87,374.08
buyer_6,Manuel,45,ES56209598028877404654,TRX_N-00106-65714671,2022-04-05T12:57:41,Vitoria-Gasteiz,expenses,leisure,-43.61,330.47
buyer_6,Manuel,45,ES56209598028877404654,TRX_N-00107-13022600,2022-04-06T19:56:15,Vitoria-Gasteiz,expenses,water,-20.61,309.86
buyer_6,Manuel,45,ES56209598028877404654,TRX_N-00108-41721402,2022-04-06T15:32:47,Vitoria-Gasteiz,expenses,leisure,-63.02,246.84
buyer_6,Manuel,45,ES56209598028877404654,TRX_N-00109-75651461,2022-04-06T15:57:13,Vitoria-Gasteiz,expenses,repairs,-331.2,-84.36
buyer_6,Manuel,45,ES56209598028877404654,TRX_N-00110-35632340,2022-04-08T19:06:56,Vitoria-Gasteiz,expenses,gas,-89.14,-173.5
buyer_6,Manuel,45,ES56209598028877404654,TRX_N-00111-55468369,2022-04-08T00:36:33,Vitoria-Gasteiz,expenses,electricity,-26.11,-199.61
buyer_6,Manuel,45,ES56209598028877404654,TRX_N-00112-28526080,2022-04-08T06:50:08,Vitoria-Gasteiz,expenses,internet,-42.0,-241.61
buyer_6,Manuel,45,ES56209598028877404654,TRX_N-00113-99737204,2022-04-12T16:09:10,Vitoria-Gasteiz,expenses,education,-42.52,-284.13
buyer_6,Manuel,45,ES56209598028877404654,TRX_N-00114-52479522,2022-04-12T12:56:51,Vitoria-Gasteiz,expenses,cash,-100.0,-384.13
buyer_6,Manuel,45,ES56209598028877404654,TRX_N-00115-63043596,2022-04-15T04:02:41,Vitoria-Gasteiz,expenses,cash,-100.0,-484.13
buyer_6,Manuel,45,ES56209598028877404654,TRX_N-00116-17212994,2022-04-17T19:46:09,Vitoria-Gasteiz,expenses,clothing,-148.16,-632.29
buyer_6,Manuel,45,ES56209598028877404654,TRX_N-00117-55733218,2022-04-18T16:21:45,Vitoria-Gasteiz,expenses,cash,-100.0,-732.29
buyer_6,Manuel,45,ES56209598028877404654,TRX_N-00118-87006005,2022-04-19T16:20:05,Vitoria-Gasteiz,expenses,appliances,-234.11,-966.4
buyer_6,Manuel,45,ES56209598028877404654,TRX_N-00119-74467191,2022-04-19T11:05:55,Vitoria-Gasteiz,expenses,repairs,-242.11,-1208.51
buyer_6,Manuel,45,ES56209598028877404654,TRX_N-00120-89402848,2022-04-20T19:52:26,Vitoria-Gasteiz,expenses,food,-60.76,-1269.27
buyer_6,Manuel,45,ES56209598028877404654,TRX_N-00121-34956078,2022-04-22T19:19:47,Vitoria-Gasteiz,expenses,leisure,-64.73,-1334.0
buyer_6,Manuel,45,ES56209598028877404654,TRX_N-00122-54719290,2022-04-22T12:39:08,Vitoria-Gasteiz,expenses,cash,-100.0,-1434.0
buyer_6,Manuel,45,ES56209598028877404654,TRX_N-00123-82807614,2022-04-22T13:23:47,Vitoria-Gasteiz,expenses,repairs,-322.33,-1756.33
buyer_6,Manuel,45,ES56209598028877404654,TRX_N-00124-92177044,2022-04-22T11:48:14,Vitoria-Gasteiz,expenses,children,-56.84,-1813.17
buyer_6,Manuel,45,ES56209598028877404654,TRX_N-00125-46162535,2022-04-24T11:00:14,Vitoria-Gasteiz,expenses,education,-44.35,-1857.52
buyer_6,Manuel,45,ES56209598028877404654,TRX_N-00126-69264889,2022-04-24T09:50:02,Vitoria-Gasteiz,expenses,travel,-1409.62,-3267.14
buyer_6,Manuel,45,ES56209598028877404654,TRX_N-00127-89318762,2022-04-25T14:27:51,Vitoria-Gasteiz,expenses,cash,-100.0,-3367.14
buyer_6,Manuel,45,ES56209598028877404654,TRX_N-00128-43878248,2022-04-28T20:07:34,Sopela,expenses,appliances,-123.61,-3490.75
buyer_6,Manuel,45,ES56209598028877404654,TRX_N-00129-03551227,2022-04-29T11:51:34,Vitoria-Gasteiz,expenses,children,-135.85,-3626.6
buyer_6,Manuel,45,ES56209598028877404654,TRX_N-00130-40734582,2022-04-30T08:19:17,Vitoria-Gasteiz,expenses,cash,-100.0,-3726.6
buyer_6,Manuel,45,ES56209598028877404654,TRX_N-00131-49842907,2022-05-01T20:23:45,Vitoria-Gasteiz,incomes,salary,1460.55,-2266.05
buyer_6,Manuel,45,ES56209598028877404654,TRX_N-00132-26401235,2022-05-01T20:23:45,Vitoria-Gasteiz,incomes,salary_partner,1380.78,-885.27
buyer_6,Manuel,45,ES56209598028877404654,TRX_N-00133-06636675,2022-05-01T16:43:10,Vitoria-Gasteiz,expenses,food,-71.92,-957.19
buyer_6,Manuel,45,ES56209598028877404654,TRX_N-00134-79009159,2022-05-02T04:12:23,Vitoria-Gasteiz,expenses,gifts,-35.54,-992.73
buyer_6,Manuel,45,ES56209598028877404654,TRX_N-00135-45783841,2022-05-03T19:47:46,Vitoria-Gasteiz,expenses,food,-104.73,-1097.46
buyer_6,Manuel,45,ES56209598028877404654,TRX_N-00136-87825009,2022-05-04T14:52:26,Vitoria-Gasteiz,expenses,mortgage,-718.03,-1815.49
buyer_6,Manuel,45,ES56209598028877404654,TRX_N-00137-72135021,2022-05-04T08:51:01,Vitoria-Gasteiz,expenses,transport,-79.78,-1895.27
buyer_6,Manuel,45,ES56209598028877404654,TRX_N-00138-85882698,2022-05-04T13:36:56,Vitoria-Gasteiz,expenses,cash,-100.0,-1995.27
buyer_6,Manuel,45,ES56209598028877404654,TRX_N-00139-98166232,2022-05-05T19:01:14,Vitoria-Gasteiz,expenses,water,-37.95,-2033.22
buyer_6,Manuel,45,ES56209598028877404654,TRX_N-00140-33306824,2022-05-05T17:52:49,Vitoria-Gasteiz,expenses,gas,-52.62,-2085.84
buyer_6,Manuel,45,ES56209598028877404654,TRX_N-00141-76133470,2022-05-06T13:25:19,Vitoria-Gasteiz,expenses,cash,-100.0,-2185.84
buyer_6,Manuel,45,ES56209598028877404654,TRX_N-00142-87665195,2022-05-06T20:23:14,Vitoria-Gasteiz,expenses,children,-120.2,-2306.04
buyer_6,Manuel,45,ES56209598028877404654,TRX_N-00143-49865421,2022-05-07T03:10:40,Vitoria-Gasteiz,expenses,leisure,-51.45,-2357.49
buyer_6,Manuel,45,ES56209598028877404654,TRX_N-00144-99725262,2022-05-07T14:14:25,Vitoria-Gasteiz,expenses,healthcare,-59.88,-2417.37
buyer_6,Manuel,45,ES56209598028877404654,TRX_N-00145-52733099,2022-05-07T12:12:12,Vitoria-Gasteiz,expenses,education,-76.02,-2493.39
buyer_6,Manuel,45,ES56209598028877404654,TRX_N-00146-19795455,2022-05-08T18:22:04,Vitoria-Gasteiz,expenses,electricity,-58.12,-2551.51
buyer_6,Manuel,45,ES56209598028877404654,TRX_N-00147-52394186,2022-05-08T13:03:07,Vitoria-Gasteiz,expenses,internet,-42.0,-2593.51
buyer_6,Manuel,45,ES56209598028877404654,TRX_N-00148-77060084,2022-05-08T19:43:02,Vitoria-Gasteiz,expenses,phone,-36.13,-2629.64
buyer_6,Manuel,45,ES56209598028877404654,TRX_N-00149-71685014,2022-05-10T14:17:18,Vitoria-Gasteiz,expenses,leisure,-35.36,-2665.0
buyer_6,Manuel,45,ES56209598028877404654,TRX_N-00150-84678198,2022-05-11T20:55:04,Vitoria-Gasteiz,expenses,leisure,-36.25,-2701.25
buyer_6,Manuel,45,ES56209598028877404654,TRX_N-00151-30926744,2022-05-11T15:15:47,Vitoria-Gasteiz,expenses,education,-69.95,-2771.2
buyer_6,Manuel,45,ES56209598028877404654,TRX_N-00152-16225818,2022-05-12T20:03:36,Vitoria-Gasteiz,expenses,cash,-100.0,-2871.2
buyer_6,Manuel,45,ES56209598028877404654,TRX_N-00153-72761874,2022-05-13T12:38:41,Vitoria-Gasteiz,expenses,cash,-100.0,-2971.2
buyer_6,Manuel,45,ES56209598028877404654,TRX_N-00154-15734054,2022-05-15T20:59:41,Eibar,expenses,clothing,-137.53,-3108.73
buyer_6,Manuel,45,ES56209598028877404654,TRX_N-00155-15907425,2022-05-16T09:46:38,Vitoria-Gasteiz,expenses,repairs,-151.16,-3259.89
buyer_6,Manuel,45,ES56209598028877404654,TRX_N-00156-38205185,2022-05-18T18:00:35,Vitoria-Gasteiz,expenses,cash,-100.0,-3359.89
buyer_6,Manuel,45,ES56209598028877404654,TRX_N-00157-17793227,2022-05-19T21:31:35,Vitoria-Gasteiz,expenses,children,-114.38,-3474.27
buyer_6,Manuel,45,ES56209598028877404654,TRX_N-00158-00573810,2022-05-20T18:38:44,Vitoria-Gasteiz,expenses,transport,-40.26,-3514.53
buyer_6,Manuel,45,ES56209598028877404654,TRX_N-00159-75161357,2022-05-20T17:06:02,Vitoria-Gasteiz,expenses,gifts,-80.74,-3595.27
buyer_6,Manuel,45,ES56209598028877404654,TRX_N-00160-63513849,2022-05-21T17:54:14,Vitoria-Gasteiz,expenses,food,-69.36,-3664.63
buyer_6,Manuel,45,ES56209598028877404654,TRX_N-00161-14672733,2022-05-22T16:01:50,Vitoria-Gasteiz,expenses,cash,-100.0,-3764.63
buyer_6,Manuel,45,ES56209598028877404654,TRX_N-00162-29264051,2022-05-24T00:01:32,Vitoria-Gasteiz,expenses,education,-55.47,-3820.1
buyer_6,Manuel,45,ES56209598028877404654,TRX_N-00163-65140348,2022-05-25T13:43:06,Labastida,expenses,cash,-100.0,-3920.1
buyer_6,Manuel,45,ES56209598028877404654,TRX_N-00164-04987771,2022-05-26T18:29:52,Vitoria-Gasteiz,expenses,cash,-100.0,-4020.1
buyer_6,Manuel,45,ES56209598028877404654,TRX_N-00165-50680296,2022-05-27T16:01:19,Vitoria-Gasteiz,expenses,cash,-100.0,-4120.1
buyer_6,Manuel,45,ES56209598028877404654,TRX_N-00166-72809207,2022-05-27T16:10:42,Vitoria-Gasteiz,expenses,appliances,-192.35,-4312.45
buyer_6,Manuel,45,ES56209598028877404654,TRX_N-00167-01708116,2022-05-28T17:04:12,Vitoria-Gasteiz,expenses,repairs,-138.74,-4451.19
buyer_6,Manuel,45,ES56209598028877404654,TRX_N-00168-36201255,2022-05-30T15:58:57,Lasarte-Oria,expenses,cash,-100.0,-4551.19
buyer_6,Manuel,45,ES56209598028877404654,TRX_N-00169-10572061,2022-05-31T12:50:47,Vitoria-Gasteiz,expenses,clothing,-103.83,-4655.02
buyer_6,Manuel,45,ES56209598028877404654,TRX_N-00170-22159334,2022-06-01T22:13:54,Vitoria-Gasteiz,incomes,salary,1460.55,-3194.47
buyer_6,Manuel,45,ES56209598028877404654,TRX_N-00171-38153559,2022-06-01T22:13:54,Vitoria-Gasteiz,incomes,salary_partner,1380.78,-1813.69
buyer_6,Manuel,45,ES56209598028877404654,TRX_N-00172-08559527,2022-06-01T22:13:54,Vitoria-Gasteiz,incomes,salary_bonus,1035.62,-778.07
buyer_6,Manuel,45,ES56209598028877404654,TRX_N-00173-62914666,2022-06-01T22:13:54,Vitoria-Gasteiz,incomes,salary_partner_bonus,1010.78,232.71
buyer_6,Manuel,45,ES56209598028877404654,TRX_N-00174-82720286,2022-06-02T02:56:33,Vitoria-Gasteiz,expenses,food,-76.31,156.4
buyer_6,Manuel,45,ES56209598028877404654,TRX_N-00175-99218444,2022-06-03T10:48:11,Vitoria-Gasteiz,expenses,transport,-78.33,78.07
buyer_6,Manuel,45,ES56209598028877404654,TRX_N-00176-50597597,2022-06-03T14:39:05,Vitoria-Gasteiz,expenses,clothing,-139.95,-61.88
buyer_6,Manuel,45,ES56209598028877404654,TRX_N-00177-39183008,2022-06-04T12:59:49,Vitoria-Gasteiz,expenses,mortgage,-718.03,-779.91
buyer_6,Manuel,45,ES56209598028877404654,TRX_N-00178-47463396,2022-06-05T09:50:41,Zuia,expenses,clothing,-107.9,-887.81
buyer_6,Manuel,45,ES56209598028877404654,TRX_N-00179-30841629,2022-06-05T18:00:19,Vitoria-Gasteiz,expenses,cash,-100.0,-987.81
buyer_6,Manuel,45,ES56209598028877404654,TRX_N-00180-41636609,2022-06-06T19:40:16,Vitoria-Gasteiz,expenses,water,-33.34,-1021.15
buyer_6,Manuel,45,ES56209598028877404654,TRX_N-00181-99725770,2022-06-06T15:26:34,Vitoria-Gasteiz,expenses,electricity,-60.33,-1081.48
buyer_6,Manuel,45,ES56209598028877404654,TRX_N-00182-25879475,2022-06-06T10:12:17,Vitoria-Gasteiz,expenses,phone,-36.24,-1117.72
buyer_6,Manuel,45,ES56209598028877404654,TRX_N-00183-90596949,2022-06-06T20:54:36,Vitoria-Gasteiz,expenses,food,-103.09,-1220.81
buyer_6,Manuel,45,ES56209598028877404654,TRX_N-00184-71326654,2022-06-07T09:03:54,Bermeo,expenses,repairs,-274.92,-1495.73
buyer_6,Manuel,45,ES56209598028877404654,TRX_N-00185-48817291,2022-06-08T08:03:31,Vitoria-Gasteiz,expenses,gas,-43.06,-1538.79
buyer_6,Manuel,45,ES56209598028877404654,TRX_N-00186-06598735,2022-06-08T15:09:03,Vitoria-Gasteiz,expenses,internet,-42.0,-1580.79
buyer_6,Manuel,45,ES56209598028877404654,TRX_N-00187-22801177,2022-06-10T21:24:08,Vitoria-Gasteiz,expenses,leisure,-46.62,-1627.41
buyer_6,Manuel,45,ES56209598028877404654,TRX_N-00188-21183216,2022-06-13T14:42:29,Vitoria-Gasteiz,expenses,leisure,-41.68,-1669.09
buyer_6,Manuel,45,ES56209598028877404654,TRX_N-00189-76413764,2022-06-13T14:43:10,Vitoria-Gasteiz,expenses,clothing,-108.53,-1777.62
buyer_6,Manuel,45,ES56209598028877404654,TRX_N-00190-77935269,2022-06-13T16:43:16,Vitoria-Gasteiz,expenses,repairs,-330.19,-2107.81
buyer_6,Manuel,45,ES56209598028877404654,TRX_N-00191-94494123,2022-06-17T10:37:12,Vitoria-Gasteiz,expenses,food,-72.51,-2180.32
buyer_6,Manuel,45,ES56209598028877404654,TRX_N-00192-68701996,2022-06-18T03:01:31,Vitoria-Gasteiz,expenses,repairs,-296.84,-2477.16
buyer_6,Manuel,45,ES56209598028877404654,TRX_N-00193-04641169,2022-06-20T10:01:18,Vitoria-Gasteiz,expenses,leisure,-68.33,-2545.49
buyer_6,Manuel,45,ES56209598028877404654,TRX_N-00194-65412920,2022-06-20T14:56:31,Vitoria-Gasteiz,expenses,cash,-100.0,-2645.49
buyer_6,Manuel,45,ES56209598028877404654,TRX_N-00195-30191669,2022-06-21T14:10:08,Vitoria-Gasteiz,expenses,transport,-65.04,-2710.53
buyer_6,Manuel,45,ES56209598028877404654,TRX_N-00196-88196418,2022-06-21T14:56:40,Vitoria-Gasteiz,expenses,clothing,-125.25,-2835.78
buyer_6,Manuel,45,ES56209598028877404654,TRX_N-00197-19886308,2022-06-21T15:26:04,Basauri,expenses,cash,-100.0,-2935.78
buyer_6,Manuel,45,ES56209598028877404654,TRX_N-00198-70328614,2022-06-22T20:40:01,Vitoria-Gasteiz,expenses,repairs,-157.69,-3093.47
buyer_6,Manuel,45,ES56209598028877404654,TRX_N-00199-57652184,2022-06-24T08:00:55,Vitoria-Gasteiz,expenses,food,-119.79,-3213.26
buyer_6,Manuel,45,ES56209598028877404654,TRX_N-00200-09184075,2022-06-24T22:25:38,Vitoria-Gasteiz,expenses,transport,-42.05,-3255.31
buyer_6,Manuel,45,ES56209598028877404654,TRX_N-00201-56856308,2022-06-25T14:05:30,Errenteria,expenses,repairs,-332.13,-3587.44
buyer_6,Manuel,45,ES56209598028877404654,TRX_N-00202-94579981,2022-06-26T16:27:02,Vitoria-Gasteiz,expenses,food,-102.51,-3689.95
buyer_6,Manuel,45,ES56209598028877404654,TRX_N-00203-05284692,2022-06-26T05:55:42,Vitoria-Gasteiz,expenses,healthcare,-149.3,-3839.25
buyer_6,Manuel,45,ES56209598028877404654,TRX_N-00204-10203243,2022-06-29T08:34:12,Vitoria-Gasteiz,expenses,clothing,-65.6,-3904.85
buyer_6,Manuel,45,ES56209598028877404654,TRX_N-00205-73499613,2022-07-01T18:49:36,Vitoria-Gasteiz,incomes,salary,1460.55,-2444.3
buyer_6,Manuel,45,ES56209598028877404654,TRX_N-00206-85173943,2022-07-01T18:49:36,Vitoria-Gasteiz,incomes,salary_partner,1380.78,-1063.52
buyer_6,Manuel,45,ES56209598028877404654,TRX_N-00207-24673445,2022-07-01T18:49:36,Vitoria-Gasteiz,incomes,extra_income,178.24,-885.28
buyer_6,Manuel,45,ES56209598028877404654,TRX_N-00208-73576674,2022-07-01T15:31:15,Vitoria-Gasteiz,expenses,cash,-100.0,-985.28
buyer_6,Manuel,45,ES56209598028877404654,TRX_N-00209-57777881,2022-07-04T11:35:08,Vitoria-Gasteiz,expenses,mortgage,-718.03,-1703.31
buyer_6,Manuel,45,ES56209598028877404654,TRX_N-00210-30891049,2022-07-04T11:30:53,Vitoria-Gasteiz,expenses,cash,-100.0,-1803.31
buyer_6,Manuel,45,ES56209598028877404654,TRX_N-00211-25665518,2022-07-04T12:53:23,Andoain,expenses,gifts,-496.08,-2299.39
buyer_6,Manuel,45,ES56209598028877404654,TRX_N-00212-75079123,2022-07-05T02:00:24,Vitoria-Gasteiz,expenses,gas,-69.15,-2368.54
buyer_6,Manuel,45,ES56209598028877404654,TRX_N-00213-35312181,2022-07-06T18:03:44,Vitoria-Gasteiz,expenses,phone,-33.67,-2402.21
buyer_6,Manuel,45,ES56209598028877404654,TRX_N-00214-77208157,2022-07-06T21:33:42,Vitoria-Gasteiz,expenses,travel,-1612.42,-4014.63
buyer_6,Manuel,45,ES56209598028877404654,TRX_N-00215-86344820,2022-07-07T18:32:18,Vitoria-Gasteiz,expenses,electricity,-30.91,-4045.54
buyer_6,Manuel,45,ES56209598028877404654,TRX_N-00216-34106476,2022-07-07T20:17:26,Andoain,expenses,cash,-100.0,-4145.54
buyer_6,Manuel,45,ES56209598028877404654,TRX_N-00217-88092005,2022-07-08T15:36:26,Vitoria-Gasteiz,expenses,water,-21.71,-4167.25
buyer_6,Manuel,45,ES56209598028877404654,TRX_N-00218-84981995,2022-07-08T11:49:43,Vitoria-Gasteiz,expenses,internet,-42.0,-4209.25
buyer_6,Manuel,45,ES56209598028877404654,TRX_N-00219-44885420,2022-07-12T11:10:22,Vitoria-Gasteiz,expenses,gifts,-667.59,-4876.84
buyer_6,Manuel,45,ES56209598028877404654,TRX_N-00220-29255383,2022-07-15T13:23:57,Vitoria-Gasteiz,expenses,transport,-50.37,-4927.21
buyer_6,Manuel,45,ES56209598028877404654,TRX_N-00221-87942106,2022-07-16T11:21:20,Zuia,expenses,healthcare,-170.55,-5097.76
buyer_6,Manuel,45,ES56209598028877404654,TRX_N-00222-67519869,2022-07-18T16:53:27,Irun,expenses,leisure,-38.26,-5136.02
buyer_6,Manuel,45,ES56209598028877404654,TRX_N-00223-59577707,2022-07-19T08:26:35,Vitoria-Gasteiz,expenses,food,-69.3,-5205.32
buyer_6,Manuel,45,ES56209598028877404654,TRX_N-00224-85025997,2022-07-19T19:25:47,Vitoria-Gasteiz,expenses,education,-66.82,-5272.14
buyer_6,Manuel,45,ES56209598028877404654,TRX_N-00225-89561338,2022-07-19T19:20:54,Barakaldo,expenses,cash,-100.0,-5372.14
buyer_6,Manuel,45,ES56209598028877404654,TRX_N-00226-10285063,2022-07-20T17:34:34,Vitoria-Gasteiz,expenses,repairs,-185.35,-5557.49
buyer_6,Manuel,45,ES56209598028877404654,TRX_N-00227-76661626,2022-07-22T20:16:16,Vitoria-Gasteiz,expenses,transport,-74.16,-5631.65
buyer_6,Manuel,45,ES56209598028877404654,TRX_N-00228-66958647,2022-07-22T21:29:34,Vitoria-Gasteiz,expenses,leisure,-28.55,-5660.2
buyer_6,Manuel,45,ES56209598028877404654,TRX_N-00229-62006131,2022-07-22T20:57:04,Vitoria-Gasteiz,expenses,appliances,-305.54,-5965.74
buyer_6,Manuel,45,ES56209598028877404654,TRX_N-00230-80780326,2022-07-23T16:13:05,Vitoria-Gasteiz,expenses,leisure,-54.3,-6020.04
buyer_6,Manuel,45,ES56209598028877404654,TRX_N-00231-01452025,2022-07-23T18:53:59,Vitoria-Gasteiz,expenses,cash,-100.0,-6120.04
buyer_6,Manuel,45,ES56209598028877404654,TRX_N-00232-29792971,2022-07-24T06:26:53,Vitoria-Gasteiz,expenses,gifts,-825.4,-6945.44
buyer_6,Manuel,45,ES56209598028877404654,TRX_N-00233-43128228,2022-07-25T19:36:21,Errenteria,expenses,food,-60.42,-7005.86
buyer_6,Manuel,45,ES56209598028877404654,TRX_N-00234-77008147,2022-07-25T12:43:10,Vitoria-Gasteiz,expenses,travel,-1212.74,-8218.6
buyer_6,Manuel,45,ES56209598028877404654,TRX_N-00235-33588338,2022-07-27T12:05:42,Vitoria-Gasteiz,expenses,transport,-70.44,-8289.04
buyer_6,Manuel,45,ES56209598028877404654,TRX_N-00236-73159020,2022-07-28T13:11:15,Vitoria-Gasteiz,expenses,gifts,-90.46,-8379.5
buyer_6,Manuel,45,ES56209598028877404654,TRX_N-00237-34043034,2022-07-29T09:06:43,Vitoria-Gasteiz,expenses,education,-51.4,-8430.9
buyer_6,Manuel,45,ES56209598028877404654,TRX_N-00238-90602280,2022-07-31T20:32:48,Vitoria-Gasteiz,expenses,travel,-453.04,-8883.94
buyer_6,Manuel,45,ES56209598028877404654,TRX_N-00239-90279862,2022-07-31T11:40:20,Vitoria-Gasteiz,expenses,gifts,-214.11,-9098.05
buyer_6,Manuel,45,ES56209598028877404654,TRX_N-00240-55143687,2022-08-01T17:27:55,Vitoria-Gasteiz,incomes,salary,1460.55,-7637.5
buyer_6,Manuel,45,ES56209598028877404654,TRX_N-00241-80808411,2022-08-01T17:27:55,Vitoria-Gasteiz,incomes,salary_partner,1380.78,-6256.72
buyer_6,Manuel,45,ES56209598028877404654,TRX_N-00242-71188224,2022-08-01T00:47:38,Vitoria-Gasteiz,expenses,food,-122.77,-6379.49
buyer_6,Manuel,45,ES56209598028877404654,TRX_N-00243-72592769,2022-08-01T08:12:22,Vitoria-Gasteiz,expenses,cash,-100.0,-6479.49
buyer_6,Manuel,45,ES56209598028877404654,TRX_N-00244-35442115,2022-08-02T11:23:30,Vitoria-Gasteiz,expenses,food,-116.57,-6596.06
buyer_6,Manuel,45,ES56209598028877404654,TRX_N-00245-14752153,2022-08-02T11:00:27,Vitoria-Gasteiz,expenses,gifts,-36.01,-6632.07
buyer_6,Manuel,45,ES56209598028877404654,TRX_N-00246-54408518,2022-08-04T13:44:28,Vitoria-Gasteiz,expenses,mortgage,-718.03,-7350.1
buyer_6,Manuel,45,ES56209598028877404654,TRX_N-00247-59099690,2022-08-04T16:55:22,Arrasate,expenses,healthcare,-53.75,-7403.85
buyer_6,Manuel,45,ES56209598028877404654,TRX_N-00248-58201320,2022-08-06T09:30:15,Vitoria-Gasteiz,expenses,phone,-44.37,-7448.22
buyer_6,Manuel,45,ES56209598028877404654,TRX_N-00249-00847988,2022-08-07T23:41:54,Vitoria-Gasteiz,expenses,gas,-51.05,-7499.27
buyer_6,Manuel,45,ES56209598028877404654,TRX_N-00250-36044462,2022-08-07T12:54:01,Vitoria-Gasteiz,expenses,internet,-42.0,-7541.27
buyer_6,Manuel,45,ES56209598028877404654,TRX_N-00251-88908078,2022-08-07T19:32:06,Lasarte-Oria,expenses,gifts,-284.22,-7825.49
buyer_6,Manuel,45,ES56209598028877404654,TRX_N-00252-50723554,2022-08-08T19:21:14,Vitoria-Gasteiz,expenses,water,-25.2,-7850.69
buyer_6,Manuel,45,ES56209598028877404654,TRX_N-00253-35114015,2022-08-08T19:46:11,Vitoria-Gasteiz,expenses,electricity,-77.27,-7927.96
buyer_6,Manuel,45,ES56209598028877404654,TRX_N-00254-21381879,2022-08-08T11:03:48,Vitoria-Gasteiz,expenses,repairs,-99.24,-8027.2
buyer_6,Manuel,45,ES56209598028877404654,TRX_N-00255-40096513,2022-08-08T10:56:14,Vitoria-Gasteiz,expenses,children,-270.33,-8297.53
buyer_6,Manuel,45,ES56209598028877404654,TRX_N-00256-52034600,2022-08-13T01:38:14,Vitoria-Gasteiz,expenses,children,-80.38,-8377.91
buyer_6,Manuel,45,ES56209598028877404654,TRX_N-00257-57855569,2022-08-14T13:38:16,Vitoria-Gasteiz,expenses,cash,-100.0,-8477.91
buyer_6,Manuel,45,ES56209598028877404654,TRX_N-00258-87714673,2022-08-15T10:35:13,Galdakao,expenses,food,-97.11,-8575.02
buyer_6,Manuel,45,ES56209598028877404654,TRX_N-00259-45657382,2022-08-16T14:49:43,Vitoria-Gasteiz,expenses,transport,-78.13,-8653.15
buyer_6,Manuel,45,ES56209598028877404654,TRX_N-00260-29941537,2022-08-16T09:49:53,Vitoria-Gasteiz,expenses,healthcare,-185.69,-8838.84
buyer_6,Manuel,45,ES56209598028877404654,TRX_N-00261-82472777,2022-08-16T18:55:50,Vitoria-Gasteiz,expenses,repairs,-115.38,-8954.22
buyer_6,Manuel,45,ES56209598028877404654,TRX_N-00262-86986905,2022-08-18T02:22:03,Vitoria-Gasteiz,expenses,repairs,-283.2,-9237.42
buyer_6,Manuel,45,ES56209598028877404654,TRX_N-00263-54843558,2022-08-19T17:41:10,Vitoria-Gasteiz,expenses,cash,-100.0,-9337.42
buyer_6,Manuel,45,ES56209598028877404654,TRX_N-00264-79373997,2022-08-20T23:08:02,Vitoria-Gasteiz,expenses,clothing,-119.85,-9457.27
buyer_6,Manuel,45,ES56209598028877404654,TRX_N-00265-34010783,2022-08-23T18:37:20,Vitoria-Gasteiz,expenses,education,-50.46,-9507.73
buyer_6,Manuel,45,ES56209598028877404654,TRX_N-00266-78809553,2022-08-24T20:26:08,Vitoria-Gasteiz,expenses,transport,-86.66,-9594.39
buyer_6,Manuel,45,ES56209598028877404654,TRX_N-00267-31843646,2022-08-25T16:20:36,Vitoria-Gasteiz,expenses,cash,-100.0,-9694.39
buyer_6,Manuel,45,ES56209598028877404654,TRX_N-00268-43118043,2022-08-25T16:27:33,Vitoria-Gasteiz,expenses,appliances,-236.1,-9930.49
buyer_6,Manuel,45,ES56209598028877404654,TRX_N-00269-99561335,2022-08-26T10:20:17,Vitoria-Gasteiz,expenses,transport,-65.66,-9996.15
buyer_6,Manuel,45,ES56209598028877404654,TRX_N-00270-05721927,2022-08-27T13:29:48,Vitoria-Gasteiz,expenses,food,-67.32,-10063.47
buyer_6,Manuel,45,ES56209598028877404654,TRX_N-00271-11584030,2022-09-01T17:25:39,Vitoria-Gasteiz,incomes,salary,1460.55,-8602.92
buyer_6,Manuel,45,ES56209598028877404654,TRX_N-00272-75468156,2022-09-01T17:25:39,Vitoria-Gasteiz,incomes,salary_partner,1380.78,-7222.14
buyer_6,Manuel,45,ES56209598028877404654,TRX_N-00273-97061663,2022-09-04T08:59:23,Vitoria-Gasteiz,expenses,mortgage,-718.03,-7940.17
buyer_6,Manuel,45,ES56209598028877404654,TRX_N-00274-58833753,2022-09-05T19:07:02,Vitoria-Gasteiz,expenses,gas,-42.99,-7983.16
buyer_6,Manuel,45,ES56209598028877404654,TRX_N-00275-40146358,2022-09-05T09:12:32,Vitoria-Gasteiz,expenses,phone,-33.06,-8016.22
buyer_6,Manuel,45,ES56209598028877404654,TRX_N-00276-16516524,2022-09-05T09:35:05,Vitoria-Gasteiz,expenses,transport,-50.7,-8066.92
buyer_6,Manuel,45,ES56209598028877404654,TRX_N-00277-07022796,2022-09-06T20:41:30,Vitoria-Gasteiz,expenses,repairs,-276.63,-8343.55
buyer_6,Manuel,45,ES56209598028877404654,TRX_N-00278-11318545,2022-09-08T11:04:45,Vitoria-Gasteiz,expenses,internet,-42.0,-8385.55
buyer_6,Manuel,45,ES56209598028877404654,TRX_N-00279-58649710,2022-09-08T09:00:22,Vitoria-Gasteiz,expenses,water,-37.27,-8422.82
buyer_6,Manuel,45,ES56209598028877404654,TRX_N-00280-07127068,2022-09-08T20:50:08,Vitoria-Gasteiz,expenses,electricity,-31.28,-8454.1
buyer_6,Manuel,45,ES56209598028877404654,TRX_N-00281-85714354,2022-09-10T18:54:49,Vitoria-Gasteiz,expenses,transport,-67.65,-8521.75
buyer_6,Manuel,45,ES56209598028877404654,TRX_N-00282-01668836,2022-09-10T11:24:53,Basauri,expenses,clothing,-51.42,-8573.17
buyer_6,Manuel,45,ES56209598028877404654,TRX_N-00283-16492787,2022-09-11T04:48:14,Vitoria-Gasteiz,expenses,food,-120.75,-8693.92
buyer_6,Manuel,45,ES56209598028877404654,TRX_N-00284-28040417,2022-09-11T17:32:34,Vitoria-Gasteiz,expenses,gifts,-336.66,-9030.58
buyer_6,Manuel,45,ES56209598028877404654,TRX_N-00285-80243789,2022-09-12T14:27:55,Vitoria-Gasteiz,expenses,leisure,-38.63,-9069.21
buyer_6,Manuel,45,ES56209598028877404654,TRX_N-00286-84348758,2022-09-12T13:55:01,Vitoria-Gasteiz,expenses,clothing,-114.01,-9183.22
buyer_6,Manuel,45,ES56209598028877404654,TRX_N-00287-20218034,2022-09-13T17:24:54,Vitoria-Gasteiz,expenses,education,-53.39,-9236.61
buyer_6,Manuel,45,ES56209598028877404654,TRX_N-00288-04107297,2022-09-14T15:36:35,Alegría-Dulantzi,expenses,food,-117.36,-9353.97
buyer_6,Manuel,45,ES56209598028877404654,TRX_N-00289-53319728,2022-09-14T16:03:47,Vitoria-Gasteiz,expenses,education,-60.08,-9414.05
buyer_6,Manuel,45,ES56209598028877404654,TRX_N-00290-44341500,2022-09-15T15:24:06,Bilbao,expenses,transport,-41.97,-9456.02
buyer_6,Manuel,45,ES56209598028877404654,TRX_N-00291-24935099,2022-09-15T12:17:01,Vitoria-Gasteiz,expenses,cash,-100.0,-9556.02
buyer_6,Manuel,45,ES56209598028877404654,TRX_N-00292-37433520,2022-09-18T12:18:25,Vitoria-Gasteiz,expenses,children,-135.64,-9691.66
buyer_6,Manuel,45,ES56209598028877404654,TRX_N-00293-19965834,2022-09-19T14:14:58,Lasarte-Oria,expenses,transport,-64.25,-9755.91
buyer_6,Manuel,45,ES56209598028877404654,TRX_N-00294-20584600,2022-09-21T11:35:39,Vitoria-Gasteiz,expenses,children,-64.57,-9820.48
buyer_6,Manuel,45,ES56209598028877404654,TRX_N-00295-03460474,2022-09-22T17:14:35,Vitoria-Gasteiz,expenses,children,-165.5,-9985.98
buyer_6,Manuel,45,ES56209598028877404654,TRX_N-00296-58565626,2022-09-23T08:17:56,Vitoria-Gasteiz,expenses,transport,-76.05,-10062.03
buyer_6,Manuel,45,ES56209598028877404654,TRX_N-00297-88217146,2022-09-24T16:26:28,Vitoria-Gasteiz,expenses,cash,-100.0,-10162.03
buyer_6,Manuel,45,ES56209598028877404654,TRX_N-00298-53291280,2022-09-24T09:48:20,Vitoria-Gasteiz,expenses,children,-175.4,-10337.43
buyer_6,Manuel,45,ES56209598028877404654,TRX_N-00299-76198608,2022-09-25T11:39:04,Getxo,expenses,transport,-77.64,-10415.07
buyer_6,Manuel,45,ES56209598028877404654,TRX_N-00300-33377951,2022-09-26T11:39:52,Vitoria-Gasteiz,expenses,food,-107.17,-10522.24
buyer_6,Manuel,45,ES56209598028877404654,TRX_N-00301-60882709,2022-09-26T10:57:49,Vitoria-Gasteiz,expenses,cash,-100.0,-10622.24
buyer_6,Manuel,45,ES56209598028877404654,TRX_N-00302-17003852,2022-09-27T15:08:21,Vitoria-Gasteiz,expenses,leisure,-62.84,-10685.08
buyer_6,Manuel,45,ES56209598028877404654,TRX_N-00303-99020297,2022-09-28T14:01:11,Vitoria-Gasteiz,expenses,leisure,-46.2,-10731.28
buyer_6,Manuel,45,ES56209598028877404654,TRX_N-00304-00204664,2022-09-29T12:15:58,Vitoria-Gasteiz,expenses,clothing,-96.18,-10827.46
buyer_6,Manuel,45,ES56209598028877404654,TRX_N-00305-53212314,2022-09-29T17:22:00,Sopela,expenses,cash,-100.0,-10927.46
buyer_6,Manuel,45,ES56209598028877404654,TRX_N-00306-33247745,2022-10-01T17:31:50,Vitoria-Gasteiz,incomes,salary,1460.55,-9466.91
buyer_6,Manuel,45,ES56209598028877404654,TRX_N-00307-16366247,2022-10-01T17:31:50,Vitoria-Gasteiz,incomes,salary_partner,1380.78,-8086.13
buyer_6,Manuel,45,ES56209598028877404654,TRX_N-00308-09860768,2022-10-01T17:31:50,Vitoria-Gasteiz,incomes,extra_income,178.24,-7907.89
buyer_6,Manuel,45,ES56209598028877404654,TRX_N-00309-62656791,2022-10-02T15:32:07,Vitoria-Gasteiz,expenses,education,-47.96,-7955.85
buyer_6,Manuel,45,ES56209598028877404654,TRX_N-00310-44886901,2022-10-03T09:51:44,Vitoria-Gasteiz,expenses,cash,-100.0,-8055.85
buyer_6,Manuel,45,ES56209598028877404654,TRX_N-00311-24311956,2022-10-04T13:18:37,Vitoria-Gasteiz,expenses,mortgage,-718.03,-8773.88
buyer_6,Manuel,45,ES56209598028877404654,TRX_N-00312-58569856,2022-10-05T10:33:03,Vitoria-Gasteiz,expenses,electricity,-65.59,-8839.47
buyer_6,Manuel,45,ES56209598028877404654,TRX_N-00313-67669677,2022-10-05T09:00:01,Vitoria-Gasteiz,expenses,gas,-62.06,-8901.53
buyer_6,Manuel,45,ES56209598028877404654,TRX_N-00314-03261969,2022-10-05T19:53:41,Vitoria-Gasteiz,expenses,phone,-37.28,-8938.81
buyer_6,Manuel,45,ES56209598028877404654,TRX_N-00315-27133814,2022-10-05T14:43:23,Vitoria-Gasteiz,expenses,repairs,-268.53,-9207.34
buyer_6,Manuel,45,ES56209598028877404654,TRX_N-00316-45964449,2022-10-07T04:40:01,Vitoria-Gasteiz,expenses,leisure,-18.78,-9226.12
buyer_6,Manuel,45,ES56209598028877404654,TRX_N-00317-58505802,2022-10-07T14:53:03,Errenteria,expenses,cash,-100.0,-9326.12
buyer_6,Manuel,45,ES56209598028877404654,TRX_N-00318-08666947,2022-10-08T08:41:59,Vitoria-Gasteiz,expenses,water,-41.69,-9367.81
buyer_6,Manuel,45,ES56209598028877404654,TRX_N-00319-63518563,2022-10-08T08:01:51,Vitoria-Gasteiz,expenses,internet,-42.0,-9409.81
buyer_6,Manuel,45,ES56209598028877404654,TRX_N-00320-45068365,2022-10-08T09:04:09,Vitoria-Gasteiz,expenses,leisure,-32.13,-9441.94
buyer_6,Manuel,45,ES56209598028877404654,TRX_N-00321-13973951,2022-10-10T09:13:46,Vitoria-Gasteiz,expenses,repairs,-234.51,-9676.45
buyer_6,Manuel,45,ES56209598028877404654,TRX_N-00322-61402901,2022-10-11T15:29:46,Vitoria-Gasteiz,expenses,children,-83.77,-9760.22
buyer_6,Manuel,45,ES56209598028877404654,TRX_N-00323-55515887,2022-10-12T14:58:28,Vitoria-Gasteiz,expenses,leisure,-52.4,-9812.62
buyer_6,Manuel,45,ES56209598028877404654,TRX_N-00324-02248981,2022-10-13T10:20:41,Vitoria-Gasteiz,expenses,children,-79.99,-9892.61
buyer_6,Manuel,45,ES56209598028877404654,TRX_N-00325-09361932,2022-10-14T15:35:20,Vitoria-Gasteiz,expenses,food,-87.0,-9979.61
buyer_6,Manuel,45,ES56209598028877404654,TRX_N-00326-91953110,2022-10-14T08:06:15,Vitoria-Gasteiz,expenses,transport,-45.98,-10025.59
buyer_6,Manuel,45,ES56209598028877404654,TRX_N-00327-58875506,2022-10-15T02:53:15,Vitoria-Gasteiz,expenses,cash,-100.0,-10125.59
buyer_6,Manuel,45,ES56209598028877404654,TRX_N-00328-03531888,2022-10-16T19:47:24,Hondarribia,expenses,clothing,-114.07,-10239.66
buyer_6,Manuel,45,ES56209598028877404654,TRX_N-00329-02782233,2022-10-16T23:45:02,Vitoria-Gasteiz,expenses,cash,-100.0,-10339.66
buyer_6,Manuel,45,ES56209598028877404654,TRX_N-00330-79359889,2022-10-17T08:12:16,Vitoria-Gasteiz,expenses,clothing,-123.8,-10463.46
buyer_6,Manuel,45,ES56209598028877404654,TRX_N-00331-55295668,2022-10-17T14:11:48,Portugalete,expenses,education,-45.98,-10509.44
buyer_6,Manuel,45,ES56209598028877404654,TRX_N-00332-64981871,2022-10-18T19:08:31,Vitoria-Gasteiz,expenses,leisure,-76.41,-10585.85
buyer_6,Manuel,45,ES56209598028877404654,TRX_N-00333-87801337,2022-10-18T22:19:25,Vitoria-Gasteiz,expenses,clothing,-124.25,-10710.1
buyer_6,Manuel,45,ES56209598028877404654,TRX_N-00334-46735690,2022-10-18T13:59:13,Vitoria-Gasteiz,expenses,gifts,-701.09,-11411.19
buyer_6,Manuel,45,ES56209598028877404654,TRX_N-00335-80678490,2022-10-19T16:02:49,Vitoria-Gasteiz,expenses,leisure,-27.04,-11438.23
buyer_6,Manuel,45,ES56209598028877404654,TRX_N-00336-95109992,2022-10-19T14:39:26,Vitoria-Gasteiz,expenses,children,-183.21,-11621.44
buyer_6,Manuel,45,ES56209598028877404654,TRX_N-00337-92326478,2022-10-20T13:09:38,Vitoria-Gasteiz,expenses,leisure,-20.79,-11642.23
buyer_6,Manuel,45,ES56209598028877404654,TRX_N-00338-55582268,2022-10-21T09:11:12,Vitoria-Gasteiz,expenses,cash,-100.0,-11742.23
buyer_6,Manuel,45,ES56209598028877404654,TRX_N-00339-40987094,2022-10-22T16:05:18,Vitoria-Gasteiz,expenses,food,-118.69,-11860.92
buyer_6,Manuel,45,ES56209598028877404654,TRX_N-00340-61147828,2022-10-22T19:57:45,Vitoria-Gasteiz,expenses,leisure,-25.14,-11886.06
buyer_6,Manuel,45,ES56209598028877404654,TRX_N-00341-50870964,2022-10-22T19:56:43,Santurtzi,expenses,travel,-1567.39,-13453.45
buyer_6,Manuel,45,ES56209598028877404654,TRX_N-00342-17109524,2022-10-23T09:41:31,Donostia,expenses,repairs,-256.14,-13709.59
buyer_6,Manuel,45,ES56209598028877404654,TRX_N-00343-71141749,2022-10-24T15:11:29,Getxo,expenses,food,-61.99,-13771.58
buyer_6,Manuel,45,ES56209598028877404654,TRX_N-00344-03177653,2022-10-24T20:40:46,Amurrio,expenses,repairs,-237.34,-14008.92
buyer_6,Manuel,45,ES56209598028877404654,TRX_N-00345-53456184,2022-10-26T03:16:46,Vitoria-Gasteiz,expenses,leisure,-51.3,-14060.22
buyer_6,Manuel,45,ES56209598028877404654,TRX_N-00346-18302115,2022-10-27T12:04:53,Vitoria-Gasteiz,expenses,repairs,-211.26,-14271.48
buyer_6,Manuel,45,ES56209598028877404654,TRX_N-00347-57990201,2022-10-29T22:34:21,Vitoria-Gasteiz,expenses,cash,-100.0,-14371.48
buyer_6,Manuel,45,ES56209598028877404654,TRX_N-00348-59506031,2022-10-30T19:39:50,Vitoria-Gasteiz,expenses,appliances,-383.85,-14755.33
buyer_6,Manuel,45,ES56209598028877404654,TRX_N-00349-87742653,2022-10-31T10:44:34,Vitoria-Gasteiz,expenses,cash,-100.0,-14855.33
buyer_6,Manuel,45,ES56209598028877404654,TRX_N-00350-99269751,2022-11-01T15:56:56,Vitoria-Gasteiz,incomes,salary,1460.55,-13394.78
buyer_6,Manuel,45,ES56209598028877404654,TRX_N-00351-69712595,2022-11-01T15:56:56,Vitoria-Gasteiz,incomes,salary_partner,1380.78,-12014.0
buyer_6,Manuel,45,ES56209598028877404654,TRX_N-00352-22300119,2022-11-01T20:44:38,Vitoria-Gasteiz,expenses,clothing,-47.74,-12061.74
buyer_6,Manuel,45,ES56209598028877404654,TRX_N-00353-77382347,2022-11-02T19:40:40,Vitoria-Gasteiz,expenses,education,-47.46,-12109.2
buyer_6,Manuel,45,ES56209598028877404654,TRX_N-00354-50046191,2022-11-04T06:03:28,Vitoria-Gasteiz,expenses,mortgage,-718.03,-12827.23
buyer_6,Manuel,45,ES56209598028877404654,TRX_N-00355-98890507,2022-11-04T09:56:41,Vitoria-Gasteiz,expenses,cash,-100.0,-12927.23
buyer_6,Manuel,45,ES56209598028877404654,TRX_N-00356-39268322,2022-11-05T11:09:16,Vitoria-Gasteiz,expenses,internet,-42.0,-12969.23
buyer_6,Manuel,45,ES56209598028877404654,TRX_N-00357-97377799,2022-11-06T15:18:35,Vitoria-Gasteiz,expenses,water,-33.5,-13002.73
buyer_6,Manuel,45,ES56209598028877404654,TRX_N-00358-07905718,2022-11-07T08:04:38,Vitoria-Gasteiz,expenses,electricity,-82.39,-13085.12
buyer_6,Manuel,45,ES56209598028877404654,TRX_N-00359-06614562,2022-11-07T18:26:50,Vitoria-Gasteiz,expenses,gas,-54.28,-13139.4
buyer_6,Manuel,45,ES56209598028877404654,TRX_N-00360-73644800,2022-11-08T19:42:18,Vitoria-Gasteiz,expenses,phone,-30.84,-13170.24
buyer_6,Manuel,45,ES56209598028877404654,TRX_N-00361-92094754,2022-11-10T20:51:08,Vitoria-Gasteiz,expenses,transport,-86.35,-13256.59
buyer_6,Manuel,45,ES56209598028877404654,TRX_N-00362-46483267,2022-11-12T19:02:27,Vitoria-Gasteiz,expenses,cash,-100.0,-13356.59
buyer_6,Manuel,45,ES56209598028877404654,TRX_N-00363-02046598,2022-11-12T20:50:08,Vitoria-Gasteiz,expenses,repairs,-319.76,-13676.35
buyer_6,Manuel,45,ES56209598028877404654,TRX_N-00364-67487319,2022-11-12T10:35:48,Vitoria-Gasteiz,expenses,gifts,-702.19,-14378.54
buyer_6,Manuel,45,ES56209598028877404654,TRX_N-00365-08369477,2022-11-16T09:57:56,Vitoria-Gasteiz,expenses,cash,-100.0,-14478.54
buyer_6,Manuel,45,ES56209598028877404654,TRX_N-00366-79623365,2022-11-17T02:52:39,Vitoria-Gasteiz,expenses,food,-83.06,-14561.6
buyer_6,Manuel,45,ES56209598028877404654,TRX_N-00367-20578640,2022-11-17T18:05:42,Vitoria-Gasteiz,expenses,cash,-100.0,-14661.6
buyer_6,Manuel,45,ES56209598028877404654,TRX_N-00368-59093610,2022-11-18T17:20:25,Vitoria-Gasteiz,expenses,food,-76.65,-14738.25
buyer_6,Manuel,45,ES56209598028877404654,TRX_N-00369-98649939,2022-11-18T16:16:45,Vitoria-Gasteiz,expenses,cash,-100.0,-14838.25
buyer_6,Manuel,45,ES56209598028877404654,TRX_N-00370-11386770,2022-11-18T18:55:50,Vitoria-Gasteiz,expenses,appliances,-194.46,-15032.71
buyer_6,Manuel,45,ES56209598028877404654,TRX_N-00371-74878108,2022-11-19T15:41:12,Vitoria-Gasteiz,expenses,leisure,-70.87,-15103.58
buyer_6,Manuel,45,ES56209598028877404654,TRX_N-00372-13634062,2022-11-20T13:57:43,Sestao,expenses,appliances,-82.27,-15185.85
buyer_6,Manuel,45,ES56209598028877404654,TRX_N-00373-91809627,2022-11-22T19:49:41,Vitoria-Gasteiz,expenses,food,-101.87,-15287.72
buyer_6,Manuel,45,ES56209598028877404654,TRX_N-00374-31373786,2022-11-24T18:56:00,Vitoria-Gasteiz,expenses,cash,-100.0,-15387.72
buyer_6,Manuel,45,ES56209598028877404654,TRX_N-00375-20962563,2022-11-25T08:11:42,Vitoria-Gasteiz,expenses,leisure,-40.14,-15427.86
buyer_6,Manuel,45,ES56209598028877404654,TRX_N-00376-91217163,2022-11-25T15:50:42,Vitoria-Gasteiz,expenses,repairs,-166.37,-15594.23
buyer_6,Manuel,45,ES56209598028877404654,TRX_N-00377-64730709,2022-11-29T11:17:59,Vitoria-Gasteiz,expenses,cash,-100.0,-15694.23
buyer_6,Manuel,45,ES56209598028877404654,TRX_N-00378-39123732,2022-11-30T20:11:52,Vitoria-Gasteiz,expenses,transport,-42.02,-15736.25
buyer_6,Manuel,45,ES56209598028877404654,TRX_N-00379-89822364,2022-11-30T11:58:42,Vitoria-Gasteiz,expenses,leisure,-81.84,-15818.09
buyer_6,Manuel,45,ES56209598028877404654,TRX_N-00380-92202998,2022-11-30T22:55:47,Vitoria-Gasteiz,expenses,cash,-100.0,-15918.09
buyer_6,Manuel,45,ES56209598028877404654,TRX_N-00381-18754980,2022-11-30T13:42:56,Elciego,expenses,repairs,-273.46,-16191.55
buyer_6,Manuel,45,ES56209598028877404654,TRX_N-00382-60408742,2022-11-30T20:16:50,Donostia,expenses,gifts,-825.27,-17016.82
buyer_6,Manuel,45,ES56209598028877404654,TRX_N-00383-80586206,2022-12-01T09:55:55,Vitoria-Gasteiz,incomes,salary,1460.55,-15556.27
buyer_6,Manuel,45,ES56209598028877404654,TRX_N-00384-39845587,2022-12-01T09:55:55,Vitoria-Gasteiz,incomes,salary_partner,1380.78,-14175.49
buyer_6,Manuel,45,ES56209598028877404654,TRX_N-00385-95225750,2022-12-01T09:55:55,Vitoria-Gasteiz,incomes,salary_bonus,1070.17,-13105.32
buyer_6,Manuel,45,ES56209598028877404654,TRX_N-00386-31414535,2022-12-01T09:55:55,Vitoria-Gasteiz,incomes,salary_partner_bonus,979.33,-12125.99
buyer_6,Manuel,45,ES56209598028877404654,TRX_N-00387-90604704,2022-12-01T11:24:32,Vitoria-Gasteiz,expenses,leisure,-19.28,-12145.27
buyer_6,Manuel,45,ES56209598028877404654,TRX_N-00388-50164456,2022-12-03T11:39:33,Vitoria-Gasteiz,expenses,transport,-65.04,-12210.31
buyer_6,Manuel,45,ES56209598028877404654,TRX_N-00389-11933225,2022-12-04T09:34:27,Vitoria-Gasteiz,expenses,mortgage,-718.03,-12928.34
buyer_6,Manuel,45,ES56209598028877404654,TRX_N-00390-49650670,2022-12-04T14:20:17,Vitoria-Gasteiz,expenses,transport,-43.11,-12971.45
buyer_6,Manuel,45,ES56209598028877404654,TRX_N-00391-35681364,2022-12-04T16:01:33,Vitoria-Gasteiz,expenses,repairs,-276.23,-13247.68
buyer_6,Manuel,45,ES56209598028877404654,TRX_N-00392-45154345,2022-12-05T20:59:26,Vitoria-Gasteiz,expenses,water,-26.5,-13274.18
buyer_6,Manuel,45,ES56209598028877404654,TRX_N-00393-06694639,2022-12-05T12:18:38,Vitoria-Gasteiz,expenses,phone,-44.59,-13318.77
buyer_6,Manuel,45,ES56209598028877404654,TRX_N-00394-58938359,2022-12-05T23:01:11,Vitoria-Gasteiz,expenses,transport,-83.44,-13402.21
buyer_6,Manuel,45,ES56209598028877404654,TRX_N-00395-81153091,2022-12-06T20:07:57,Vitoria-Gasteiz,expenses,electricity,-57.99,-13460.2
buyer_6,Manuel,45,ES56209598028877404654,TRX_N-00396-30470272,2022-12-06T10:12:14,Vitoria-Gasteiz,expenses,internet,-42.0,-13502.2
buyer_6,Manuel,45,ES56209598028877404654,TRX_N-00397-67037088,2022-12-07T15:40:53,Vitoria-Gasteiz,expenses,gas,-92.68,-13594.88
buyer_6,Manuel,45,ES56209598028877404654,TRX_N-00398-94587919,2022-12-07T23:31:18,Vitoria-Gasteiz,expenses,leisure,-35.66,-13630.54
buyer_6,Manuel,45,ES56209598028877404654,TRX_N-00399-58256567,2022-12-08T15:43:54,Vitoria-Gasteiz,expenses,transport,-40.06,-13670.6
buyer_6,Manuel,45,ES56209598028877404654,TRX_N-00400-19875273,2022-12-08T15:21:59,Vitoria-Gasteiz,expenses,healthcare,-81.72,-13752.32
buyer_6,Manuel,45,ES56209598028877404654,TRX_N-00401-31267939,2022-12-10T21:07:47,Vitoria-Gasteiz,expenses,leisure,-83.04,-13835.36
buyer_6,Manuel,45,ES56209598028877404654,TRX_N-00402-54340859,2022-12-11T19:15:57,Elciego,expenses,leisure,-70.04,-13905.4
buyer_6,Manuel,45,ES56209598028877404654,TRX_N-00403-89266874,2022-12-13T20:25:43,Vitoria-Gasteiz,expenses,food,-117.39,-14022.79
buyer_6,Manuel,45,ES56209598028877404654,TRX_N-00404-30427594,2022-12-13T10:56:13,Hondarribia,expenses,education,-59.84,-14082.63
buyer_6,Manuel,45,ES56209598028877404654,TRX_N-00405-62885666,2022-12-15T09:21:14,Vitoria-Gasteiz,expenses,food,-105.6,-14188.23
buyer_6,Manuel,45,ES56209598028877404654,TRX_N-00406-99777720,2022-12-16T08:01:29,Vitoria-Gasteiz,expenses,food,-90.04,-14278.27
buyer_6,Manuel,45,ES56209598028877404654,TRX_N-00407-72833531,2022-12-16T12:47:17,Vitoria-Gasteiz,expenses,gifts,-76.92,-14355.19
buyer_6,Manuel,45,ES56209598028877404654,TRX_N-00408-46273652,2022-12-20T23:41:54,Vitoria-Gasteiz,expenses,healthcare,-114.13,-14469.32
buyer_6,Manuel,45,ES56209598028877404654,TRX_N-00409-92982983,2022-12-21T17:10:04,Getxo,expenses,education,-69.04,-14538.36
buyer_6,Manuel,45,ES56209598028877404654,TRX_N-00410-86243931,2022-12-21T14:27:52,Vitoria-Gasteiz,expenses,gifts,-697.17,-15235.53
buyer_6,Manuel,45,ES56209598028877404654,TRX_N-00411-24539835,2022-12-21T19:05:48,Vitoria-Gasteiz,expenses,children,-128.71,-15364.24
buyer_6,Manuel,45,ES56209598028877404654,TRX_N-00412-12651153,2022-12-23T10:28:35,Vitoria-Gasteiz,expenses,food,-121.62,-15485.86
buyer_6,Manuel,45,ES56209598028877404654,TRX_N-00413-13209378,2022-12-23T15:59:35,Vitoria-Gasteiz,expenses,leisure,-44.4,-15530.26
buyer_6,Manuel,45,ES56209598028877404654,TRX_N-00414-09723253,2022-12-25T10:24:46,Vitoria-Gasteiz,expenses,clothing,-53.67,-15583.93
buyer_6,Manuel,45,ES56209598028877404654,TRX_N-00415-17051632,2022-12-26T14:01:33,Getxo,expenses,clothing,-101.3,-15685.23
buyer_6,Manuel,45,ES56209598028877404654,TRX_N-00416-10227477,2022-12-27T17:14:45,Vitoria-Gasteiz,expenses,cash,-100.0,-15785.23
buyer_6,Manuel,45,ES56209598028877404654,TRX_N-00417-94279052,2022-12-28T01:02:20,Vitoria-Gasteiz,expenses,cash,-100.0,-15885.23
buyer_6,Manuel,45,ES56209598028877404654,TRX_N-00418-39094964,2022-12-29T10:47:09,Vitoria-Gasteiz,expenses,appliances,-191.06,-16076.29
buyer_6,Manuel,45,ES56209598028877404654,TRX_N-00419-67136853,2022-12-30T09:46:48,Zuia,expenses,food,-88.07,-16164.36
buyer_6,Manuel,45,ES56209598028877404654,TRX_N-00420-79985826,2022-12-31T09:15:52,Vitoria-Gasteiz,expenses,cash,-100.0,-16264.36
buyer_6,Manuel,45,ES56209598028877404654,TRX_N-00421-79522949,2023-01-01T18:31:33,Vitoria-Gasteiz,incomes,salary,1515.3,-14749.06
buyer_6,Manuel,45,ES56209598028877404654,TRX_N-00422-93619854,2023-01-01T18:31:33,Vitoria-Gasteiz,incomes,salary_partner,1432.54,-13316.52
buyer_6,Manuel,45,ES56209598028877404654,TRX_N-00423-20767433,2023-01-02T18:56:11,Vitoria-Gasteiz,expenses,food,-82.09,-13398.61
buyer_6,Manuel,45,ES56209598028877404654,TRX_N-00424-06551325,2023-01-02T15:52:12,Vitoria-Gasteiz,expenses,gifts,-528.48,-13927.09
buyer_6,Manuel,45,ES56209598028877404654,TRX_N-00425-83461290,2023-01-04T15:16:41,Vitoria-Gasteiz,expenses,mortgage,-718.03,-14645.12
buyer_6,Manuel,45,ES56209598028877404654,TRX_N-00426-52753566,2023-01-04T18:08:10,Vitoria-Gasteiz,expenses,leisure,-76.66,-14721.78
buyer_6,Manuel,45,ES56209598028877404654,TRX_N-00427-27045291,2023-01-04T09:58:15,Vitoria-Gasteiz,expenses,gifts,-53.94,-14775.72
buyer_6,Manuel,45,ES56209598028877404654,TRX_N-00428-25739566,2023-01-05T12:54:29,Vitoria-Gasteiz,expenses,electricity,-21.66,-14797.38
buyer_6,Manuel,45,ES56209598028877404654,TRX_N-00429-13289934,2023-01-05T12:34:55,Vitoria-Gasteiz,expenses,leisure,-81.38,-14878.76
buyer_6,Manuel,45,ES56209598028877404654,TRX_N-00430-92537773,2023-01-06T11:17:59,Vitoria-Gasteiz,expenses,gas,-96.21,-14974.97
buyer_6,Manuel,45,ES56209598028877404654,TRX_N-00431-50486061,2023-01-07T19:50:49,Vitoria-Gasteiz,expenses,phone,-32.98,-15007.95
buyer_6,Manuel,45,ES56209598028877404654,TRX_N-00432-55911959,2023-01-08T23:57:53,Vitoria-Gasteiz,expenses,water,-38.49,-15046.44
buyer_6,Manuel,45,ES56209598028877404654,TRX_N-00433-35419835,2023-01-08T18:48:33,Vitoria-Gasteiz,expenses,internet,-42.0,-15088.44
buyer_6,Manuel,45,ES56209598028877404654,TRX_N-00434-56213153,2023-01-09T15:49:05,Vitoria-Gasteiz,expenses,food,-64.68,-15153.12
buyer_6,Manuel,45,ES56209598028877404654,TRX_N-00435-72342371,2023-01-10T16:35:07,Vitoria-Gasteiz,expenses,cash,-100.0,-15253.12
buyer_6,Manuel,45,ES56209598028877404654,TRX_N-00436-07987547,2023-01-12T20:01:49,Vitoria-Gasteiz,expenses,food,-94.56,-15347.68
buyer_6,Manuel,45,ES56209598028877404654,TRX_N-00437-04649443,2023-01-12T19:52:16,Vitoria-Gasteiz,expenses,cash,-100.0,-15447.68
buyer_6,Manuel,45,ES56209598028877404654,TRX_N-00438-61993554,2023-01-12T19:21:29,Vitoria-Gasteiz,expenses,repairs,-209.43,-15657.11
buyer_6,Manuel,45,ES56209598028877404654,TRX_N-00439-65936545,2023-01-13T11:30:01,Vitoria-Gasteiz,expenses,appliances,-131.86,-15788.97
buyer_6,Manuel,45,ES56209598028877404654,TRX_N-00440-49142726,2023-01-15T17:07:02,Vitoria-Gasteiz,expenses,food,-82.88,-15871.85
buyer_6,Manuel,45,ES56209598028877404654,TRX_N-00441-13949983,2023-01-15T15:51:23,Vitoria-Gasteiz,expenses,leisure,-65.27,-15937.12
buyer_6,Manuel,45,ES56209598028877404654,TRX_N-00442-35026931,2023-01-16T18:13:32,Vitoria-Gasteiz,expenses,food,-105.86,-16042.98
buyer_6,Manuel,45,ES56209598028877404654,TRX_N-00443-33815289,2023-01-16T18:54:19,Vitoria-Gasteiz,expenses,appliances,-301.16,-16344.14
buyer_6,Manuel,45,ES56209598028877404654,TRX_N-00444-71954509,2023-01-17T12:14:25,Vitoria-Gasteiz,expenses,transport,-75.35,-16419.49
buyer_6,Manuel,45,ES56209598028877404654,TRX_N-00445-47682918,2023-01-17T17:47:59,Vitoria-Gasteiz,expenses,travel,-1319.77,-17739.26
buyer_6,Manuel,45,ES56209598028877404654,TRX_N-00446-61919923,2023-01-18T13:08:52,Vitoria-Gasteiz,expenses,gifts,-158.72,-17897.98
buyer_6,Manuel,45,ES56209598028877404654,TRX_N-00447-95801729,2023-01-20T14:52:37,Vitoria-Gasteiz,expenses,leisure,-22.66,-17920.64
buyer_6,Manuel,45,ES56209598028877404654,TRX_N-00448-90225556,2023-01-21T15:43:31,Vitoria-Gasteiz,expenses,children,-115.51,-18036.15
buyer_6,Manuel,45,ES56209598028877404654,TRX_N-00449-45836499,2023-01-22T15:11:18,Vitoria-Gasteiz,expenses,leisure,-80.65,-18116.8
buyer_6,Manuel,45,ES56209598028877404654,TRX_N-00450-00921930,2023-01-22T17:11:42,Eibar,expenses,cash,-100.0,-18216.8
buyer_6,Manuel,45,ES56209598028877404654,TRX_N-00451-13645798,2023-01-24T16:23:55,Oyón-Oion,expenses,food,-84.62,-18301.42
buyer_6,Manuel,45,ES56209598028877404654,TRX_N-00452-22231645,2023-01-26T09:13:31,Vitoria-Gasteiz,expenses,gifts,-494.73,-18796.15
buyer_6,Manuel,45,ES56209598028877404654,TRX_N-00453-50262068,2023-01-27T19:14:36,Vitoria-Gasteiz,expenses,leisure,-81.93,-18878.08
buyer_6,Manuel,45,ES56209598028877404654,TRX_N-00454-57752548,2023-01-27T19:50:36,Vitoria-Gasteiz,expenses,cash,-100.0,-18978.08
buyer_6,Manuel,45,ES56209598028877404654,TRX_N-00455-32654513,2023-01-28T08:27:05,Vitoria-Gasteiz,expenses,cash,-100.0,-19078.08
buyer_6,Manuel,45,ES56209598028877404654,TRX_N-00456-95253123,2023-01-29T12:35:05,Vitoria-Gasteiz,expenses,transport,-61.9,-19139.98
buyer_6,Manuel,45,ES56209598028877404654,TRX_N-00457-95786799,2023-01-31T12:26:02,Vitoria-Gasteiz,expenses,education,-77.79,-19217.77
buyer_6,Manuel,45,ES56209598028877404654,TRX_N-00458-45828161,2023-02-01T16:56:33,Vitoria-Gasteiz,incomes,salary,1515.3,-17702.47
buyer_6,Manuel,45,ES56209598028877404654,TRX_N-00459-07537842,2023-02-01T16:56:33,Vitoria-Gasteiz,incomes,salary_partner,1432.54,-16269.93
buyer_6,Manuel,45,ES56209598028877404654,TRX_N-00460-81353350,2023-02-01T16:56:33,Vitoria-Gasteiz,incomes,extra_income,178.24,-16091.69
buyer_6,Manuel,45,ES56209598028877404654,TRX_N-00461-68879933,2023-02-01T23:00:23,Vitoria-Gasteiz,expenses,cash,-100.0,-16191.69
buyer_6,Manuel,45,ES56209598028877404654,TRX_N-00462-69171617,2023-02-03T18:55:11,Andoain,expenses,food,-109.93,-16301.62
buyer_6,Manuel,45,ES56209598028877404654,TRX_N-00463-53355843,2023-02-04T19:31:40,Vitoria-Gasteiz,expenses,mortgage,-718.03,-17019.65
buyer_6,Manuel,45,ES56209598028877404654,TRX_N-00464-03885965,2023-02-05T01:16:17,Vitoria-Gasteiz,expenses,phone,-38.36,-17058.01
buyer_6,Manuel,45,ES56209598028877404654,TRX_N-00465-71551786,2023-02-05T02:26:42,Erandio,expenses,clothing,-81.53,-17139.54
buyer_6,Manuel,45,ES56209598028877404654,TRX_N-00466-16825638,2023-02-05T08:04:29,Vitoria-Gasteiz,expenses,cash,-100.0,-17239.54
buyer_6,Manuel,45,ES56209598028877404654,TRX_N-00467-90766888,2023-02-06T21:31:43,Vitoria-Gasteiz,expenses,food,-116.52,-17356.06
buyer_6,Manuel,45,ES56209598028877404654,TRX_N-00468-23252614,2023-02-07T15:08:31,Vitoria-Gasteiz,expenses,gas,-32.75,-17388.81
buyer_6,Manuel,45,ES56209598028877404654,TRX_N-00469-19635406,2023-02-07T20:03:51,Vitoria-Gasteiz,expenses,gifts,-573.0,-17961.81
buyer_6,Manuel,45,ES56209598028877404654,TRX_N-00470-41617369,2023-02-08T14:20:26,Vitoria-Gasteiz,expenses,water,-33.34,-17995.15
buyer_6,Manuel,45,ES56209598028877404654,TRX_N-00471-51567177,2023-02-08T12:55:01,Vitoria-Gasteiz,expenses,electricity,-77.72,-18072.87
buyer_6,Manuel,45,ES56209598028877404654,TRX_N-00472-89014820,2023-02-08T18:46:40,Vitoria-Gasteiz,expenses,internet,-42.0,-18114.87
buyer_6,Manuel,45,ES56209598028877404654,TRX_N-00473-54230349,2023-02-08T12:40:22,Vitoria-Gasteiz,expenses,leisure,-28.71,-18143.58
buyer_6,Manuel,45,ES56209598028877404654,TRX_N-00474-33915522,2023-02-08T19:34:24,Vitoria-Gasteiz,expenses,cash,-100.0,-18243.58
buyer_6,Manuel,45,ES56209598028877404654,TRX_N-00475-69714645,2023-02-08T22:42:32,Vitoria-Gasteiz,expenses,gifts,-447.7,-18691.28
buyer_6,Manuel,45,ES56209598028877404654,TRX_N-00476-96863110,2023-02-09T11:35:27,Vitoria-Gasteiz,expenses,clothing,-150.42,-18841.7
buyer_6,Manuel,45,ES56209598028877404654,TRX_N-00477-78824423,2023-02-12T13:18:48,Vitoria-Gasteiz,expenses,clothing,-69.98,-18911.68
buyer_6,Manuel,45,ES56209598028877404654,TRX_N-00478-15056727,2023-02-13T08:36:04,Vitoria-Gasteiz,expenses,food,-124.33,-19036.01
buyer_6,Manuel,45,ES56209598028877404654,TRX_N-00479-86542388,2023-02-14T08:09:39,Vitoria-Gasteiz,expenses,clothing,-141.1,-19177.11
buyer_6,Manuel,45,ES56209598028877404654,TRX_N-00480-05059805,2023-02-15T22:25:35,Durango,expenses,leisure,-82.17,-19259.28
buyer_6,Manuel,45,ES56209598028877404654,TRX_N-00481-74435246,2023-02-16T12:10:59,Vitoria-Gasteiz,expenses,transport,-81.34,-19340.62
buyer_6,Manuel,45,ES56209598028877404654,TRX_N-00482-47592026,2023-02-18T13:48:59,Vitoria-Gasteiz,expenses,leisure,-72.94,-19413.56
buyer_6,Manuel,45,ES56209598028877404654,TRX_N-00483-70119587,2023-02-18T17:41:16,Vitoria-Gasteiz,expenses,appliances,-187.92,-19601.48
buyer_6,Manuel,45,ES56209598028877404654,TRX_N-00484-21538484,2023-02-19T19:56:19,Vitoria-Gasteiz,expenses,cash,-100.0,-19701.48
buyer_6,Manuel,45,ES56209598028877404654,TRX_N-00485-64024720,2023-02-20T06:40:19,Zuia,expenses,cash,-100.0,-19801.48
buyer_6,Manuel,45,ES56209598028877404654,TRX_N-00486-42949875,2023-02-20T15:17:04,Vitoria-Gasteiz,expenses,repairs,-238.65,-20040.13
buyer_6,Manuel,45,ES56209598028877404654,TRX_N-00487-36156146,2023-02-21T14:46:46,Vitoria-Gasteiz,expenses,healthcare,-77.23,-20117.36
buyer_6,Manuel,45,ES56209598028877404654,TRX_N-00488-13446416,2023-02-22T20:23:52,Vitoria-Gasteiz,expenses,food,-76.52,-20193.88
buyer_6,Manuel,45,ES56209598028877404654,TRX_N-00489-99706749,2023-02-22T18:46:24,Vitoria-Gasteiz,expenses,leisure,-71.51,-20265.39
buyer_6,Manuel,45,ES56209598028877404654,TRX_N-00490-59035626,2023-02-22T20:03:30,Basauri,expenses,cash,-100.0,-20365.39
buyer_6,Manuel,45,ES56209598028877404654,TRX_N-00491-45913275,2023-02-24T06:09:52,Vitoria-Gasteiz,expenses,healthcare,-92.31,-20457.7
buyer_6,Manuel,45,ES56209598028877404654,TRX_N-00492-11455380,2023-02-27T10:37:07,Vitoria-Gasteiz,expenses,transport,-51.02,-20508.72
buyer_6,Manuel,45,ES56209598028877404654,TRX_N-00493-88071787,2023-03-01T12:11:54,Vitoria-Gasteiz,incomes,salary,1515.3,-18993.42
buyer_6,Manuel,45,ES56209598028877404654,TRX_N-00494-98513352,2023-03-01T12:11:54,Vitoria-Gasteiz,incomes,salary_partner,1432.54,-17560.88
buyer_6,Manuel,45,ES56209598028877404654,TRX_N-00495-62183457,2023-03-02T20:03:55,Elciego,expenses,leisure,-77.08,-17637.96
buyer_6,Manuel,45,ES56209598028877404654,TRX_N-00496-13447775,2023-03-04T08:29:46,Vitoria-Gasteiz,expenses,mortgage,-718.03,-18355.99
buyer_6,Manuel,45,ES56209598028877404654,TRX_N-00497-95879870,2023-03-04T20:08:07,Vitoria-Gasteiz,expenses,food,-101.62,-18457.61
buyer_6,Manuel,45,ES56209598028877404654,TRX_N-00498-72826505,2023-03-04T17:36:03,Hernani,expenses,education,-52.1,-18509.71
buyer_6,Manuel,45,ES56209598028877404654,TRX_N-00499-58516222,2023-03-05T11:04:06,Vitoria-Gasteiz,expenses,water,-37.36,-18547.07
buyer_6,Manuel,45,ES56209598028877404654,TRX_N-00500-61926670,2023-03-05T20:12:30,Vitoria-Gasteiz,expenses,phone,-31.53,-18578.6
buyer_6,Manuel,45,ES56209598028877404654,TRX_N-00501-07703969,2023-03-05T13:36:14,Vitoria-Gasteiz,expenses,clothing,-52.55,-18631.15
buyer_6,Manuel,45,ES56209598028877404654,TRX_N-00502-05893409,2023-03-05T09:54:23,Vitoria-Gasteiz,expenses,cash,-100.0,-18731.15
buyer_6,Manuel,45,ES56209598028877404654,TRX_N-00503-59680805,2023-03-07T23:21:44,Vitoria-Gasteiz,expenses,electricity,-73.22,-18804.37
buyer_6,Manuel,45,ES56209598028877404654,TRX_N-00504-69088839,2023-03-07T12:53:17,Vitoria-Gasteiz,expenses,internet,-42.0,-18846.37
buyer_6,Manuel,45,ES56209598028877404654,TRX_N-00505-86691747,2023-03-07T22:20:51,Vitoria-Gasteiz,expenses,children,-141.58,-18987.95
buyer_6,Manuel,45,ES56209598028877404654,TRX_N-00506-72271597,2023-03-08T20:05:51,Vitoria-Gasteiz,expenses,gas,-42.79,-19030.74
buyer_6,Manuel,45,ES56209598028877404654,TRX_N-00507-59522902,2023-03-11T20:04:39,Vitoria-Gasteiz,expenses,children,-261.25,-19291.99
buyer_6,Manuel,45,ES56209598028877404654,TRX_N-00508-51896871,2023-03-12T04:30:16,Vitoria-Gasteiz,expenses,education,-47.07,-19339.06
buyer_6,Manuel,45,ES56209598028877404654,TRX_N-00509-70090092,2023-03-13T16:42:23,Pasaia,expenses,food,-89.64,-19428.7
buyer_6,Manuel,45,ES56209598028877404654,TRX_N-00510-04836065,2023-03-14T05:43:37,Vitoria-Gasteiz,expenses,cash,-100.0,-19528.7
buyer_6,Manuel,45,ES56209598028877404654,TRX_N-00511-38663106,2023-03-18T00:33:07,Vitoria-Gasteiz,expenses,food,-89.18,-19617.88
buyer_6,Manuel,45,ES56209598028877404654,TRX_N-00512-53662849,2023-03-19T19:44:22,Vitoria-Gasteiz,expenses,healthcare,-94.82,-19712.7
buyer_6,Manuel,45,ES56209598028877404654,TRX_N-00513-09677496,2023-03-19T13:18:18,Vitoria-Gasteiz,expenses,cash,-100.0,-19812.7
buyer_6,Manuel,45,ES56209598028877404654,TRX_N-00514-73596635,2023-03-19T09:20:50,Elciego,expenses,repairs,-324.88,-20137.58
buyer_6,Manuel,45,ES56209598028877404654,TRX_N-00515-95597072,2023-03-20T04:10:32,Vitoria-Gasteiz,expenses,food,-69.55,-20207.13
buyer_6,Manuel,45,ES56209598028877404654,TRX_N-00516-57454872,2023-03-20T22:00:15,Vitoria-Gasteiz,expenses,leisure,-32.79,-20239.92
buyer_6,Manuel,45,ES56209598028877404654,TRX_N-00517-15897045,2023-03-20T12:45:55,Portugalete,expenses,gifts,-350.52,-20590.44
buyer_6,Manuel,45,ES56209598028877404654,TRX_N-00518-49682506,2023-03-21T19:07:45,Vitoria-Gasteiz,expenses,education,-63.09,-20653.53
buyer_6,Manuel,45,ES56209598028877404654,TRX_N-00519-15118978,2023-03-21T08:20:42,Vitoria-Gasteiz,expenses,children,-117.36,-20770.89
buyer_6,Manuel,45,ES56209598028877404654,TRX_N-00520-04922516,2023-03-22T08:18:32,Vitoria-Gasteiz,expenses,leisure,-76.79,-20847.68
buyer_6,Manuel,45,ES56209598028877404654,TRX_N-00521-30178526,2023-03-24T15:28:43,Berango,expenses,food,-90.95,-20938.63
buyer_6,Manuel,45,ES56209598028877404654,TRX_N-00522-93106616,2023-03-24T10:41:49,Vitoria-Gasteiz,expenses,leisure,-69.22,-21007.85
buyer_6,Manuel,45,ES56209598028877404654,TRX_N-00523-10190416,2023-03-24T20:59:49,Vitoria-Gasteiz,expenses,children,-180.97,-21188.82
buyer_6,Manuel,45,ES56209598028877404654,TRX_N-00524-50469704,2023-03-28T16:15:26,Vitoria-Gasteiz,expenses,transport,-44.29,-21233.11
buyer_6,Manuel,45,ES56209598028877404654,TRX_N-00525-87428718,2023-03-29T22:38:56,Vitoria-Gasteiz,expenses,clothing,-107.95,-21341.06
buyer_6,Manuel,45,ES56209598028877404654,TRX_N-00526-32067718,2023-03-30T22:50:02,Oyón-Oion,expenses,clothing,-147.48,-21488.54
buyer_6,Manuel,45,ES56209598028877404654,TRX_N-00527-28475625,2023-03-30T15:58:44,Vitoria-Gasteiz,expenses,cash,-100.0,-21588.54
buyer_6,Manuel,45,ES56209598028877404654,TRX_N-00528-89910898,2023-03-30T11:09:05,Vitoria-Gasteiz,expenses,gifts,-537.64,-22126.18
buyer_6,Manuel,45,ES56209598028877404654,TRX_N-00529-62458170,2023-03-31T05:15:27,Vitoria-Gasteiz,expenses,education,-76.73,-22202.91
buyer_6,Manuel,45,ES56209598028877404654,TRX_N-00530-41701403,2023-04-01T16:16:53,Vitoria-Gasteiz,incomes,salary,1515.3,-20687.61
buyer_6,Manuel,45,ES56209598028877404654,TRX_N-00531-60730882,2023-04-01T16:16:53,Vitoria-Gasteiz,incomes,salary_partner,1432.54,-19255.07
buyer_6,Manuel,45,ES56209598028877404654,TRX_N-00532-11719491,2023-04-01T09:47:45,Vitoria-Gasteiz,expenses,food,-118.14,-19373.21
buyer_6,Manuel,45,ES56209598028877404654,TRX_N-00533-08069624,2023-04-01T19:54:30,Vitoria-Gasteiz,expenses,children,-121.54,-19494.75
buyer_6,Manuel,45,ES56209598028877404654,TRX_N-00534-40805125,2023-04-02T09:43:50,Vitoria-Gasteiz,expenses,leisure,-30.66,-19525.41
buyer_6,Manuel,45,ES56209598028877404654,TRX_N-00535-85597454,2023-04-02T06:41:48,Vitoria-Gasteiz,expenses,cash,-100.0,-19625.41
buyer_6,Manuel,45,ES56209598028877404654,TRX_N-00536-69921143,2023-04-02T12:30:56,Vitoria-Gasteiz,expenses,children,-123.25,-19748.66
buyer_6,Manuel,45,ES56209598028877404654,TRX_N-00537-65518608,2023-04-03T10:33:21,Vitoria-Gasteiz,expenses,leisure,-75.48,-19824.14
buyer_6,Manuel,45,ES56209598028877404654,TRX_N-00538-23395462,2023-04-03T14:48:32,Vitoria-Gasteiz,expenses,cash,-100.0,-19924.14
buyer_6,Manuel,45,ES56209598028877404654,TRX_N-00539-85378607,2023-04-04T17:38:03,Vitoria-Gasteiz,expenses,mortgage,-718.03,-20642.17
buyer_6,Manuel,45,ES56209598028877404654,TRX_N-00540-21656305,2023-04-05T13:39:19,Vitoria-Gasteiz,expenses,internet,-42.0,-20684.17
buyer_6,Manuel,45,ES56209598028877404654,TRX_N-00541-19616519,2023-04-05T13:58:08,Vitoria-Gasteiz,expenses,transport,-73.39,-20757.56
buyer_6,Manuel,45,ES56209598028877404654,TRX_N-00542-42688796,2023-04-05T18:40:03,Vitoria-Gasteiz,expenses,leisure,-33.47,-20791.03
buyer_6,Manuel,45,ES56209598028877404654,TRX_N-00543-59872986,2023-04-05T13:08:07,Salvatierra/Agurain,expenses,gifts,-604.43,-21395.46
buyer_6,Manuel,45,ES56209598028877404654,TRX_N-00544-22799759,2023-04-06T09:16:31,Vitoria-Gasteiz,expenses,cash,-100.0,-21495.46
buyer_6,Manuel,45,ES56209598028877404654,TRX_N-00545-33948320,2023-04-07T09:32:32,Vitoria-Gasteiz,expenses,electricity,-45.63,-21541.09
buyer_6,Manuel,45,ES56209598028877404654,TRX_N-00546-66662999,2023-04-07T17:34:26,Vitoria-Gasteiz,expenses,gas,-33.57,-21574.66
buyer_6,Manuel,45,ES56209598028877404654,TRX_N-00547-40896686,2023-04-07T11:22:18,Vitoria-Gasteiz,expenses,phone,-34.62,-21609.28
buyer_6,Manuel,45,ES56209598028877404654,TRX_N-00548-62155028,2023-04-08T17:35:22,Vitoria-Gasteiz,expenses,water,-21.29,-21630.57
buyer_6,Manuel,45,ES56209598028877404654,TRX_N-00549-21524327,2023-04-08T15:04:37,Zarautz,expenses,repairs,-280.26,-21910.83
buyer_6,Manuel,45,ES56209598028877404654,TRX_N-00550-90373819,2023-04-08T08:11:47,Vitoria-Gasteiz,expenses,children,-210.13,-22120.96
buyer_6,Manuel,45,ES56209598028877404654,TRX_N-00551-09870147,2023-04-10T06:59:56,Vitoria-Gasteiz,expenses,food,-122.14,-22243.1
buyer_6,Manuel,45,ES56209598028877404654,TRX_N-00552-35271121,2023-04-11T15:41:21,Vitoria-Gasteiz,expenses,food,-102.13,-22345.23
buyer_6,Manuel,45,ES56209598028877404654,TRX_N-00553-49796519,2023-04-12T09:32:29,Vitoria-Gasteiz,expenses,food,-121.82,-22467.05
buyer_6,Manuel,45,ES56209598028877404654,TRX_N-00554-64837837,2023-04-17T14:50:52,Vitoria-Gasteiz,expenses,cash,-100.0,-22567.05
buyer_6,Manuel,45,ES56209598028877404654,TRX_N-00555-92849874,2023-04-18T12:08:05,Getxo,expenses,cash,-100.0,-22667.05
buyer_6,Manuel,45,ES56209598028877404654,TRX_N-00556-97705729,2023-04-18T16:57:29,Vitoria-Gasteiz,expenses,gifts,-224.37,-22891.42
buyer_6,Manuel,45,ES56209598028877404654,TRX_N-00557-60203682,2023-04-20T16:12:51,Vitoria-Gasteiz,expenses,cash,-100.0,-22991.42
buyer_6,Manuel,45,ES56209598028877404654,TRX_N-00558-54915421,2023-04-21T02:10:22,Vitoria-Gasteiz,expenses,cash,-100.0,-23091.42
buyer_6,Manuel,45,ES56209598028877404654,TRX_N-00559-88473953,2023-04-24T00:56:46,Vitoria-Gasteiz,expenses,cash,-100.0,-23191.42
buyer_6,Manuel,45,ES56209598028877404654,TRX_N-00560-46403595,2023-04-25T11:43:10,Vitoria-Gasteiz,expenses,clothing,-115.33,-23306.75
buyer_6,Manuel,45,ES56209598028877404654,TRX_N-00561-90370167,2023-04-27T21:44:17,Vitoria-Gasteiz,expenses,cash,-100.0,-23406.75
buyer_6,Manuel,45,ES56209598028877404654,TRX_N-00562-06711058,2023-04-28T20:38:44,Vitoria-Gasteiz,expenses,leisure,-56.49,-23463.24
buyer_6,Manuel,45,ES56209598028877404654,TRX_N-00563-94425650,2023-04-30T08:40:31,Vitoria-Gasteiz,expenses,gifts,-717.09,-24180.33
buyer_6,Manuel,45,ES56209598028877404654,TRX_N-00564-41227068,2023-05-01T16:47:49,Vitoria-Gasteiz,incomes,salary,1515.3,-22665.03
buyer_6,Manuel,45,ES56209598028877404654,TRX_N-00565-35790608,2023-05-01T16:47:49,Vitoria-Gasteiz,incomes,salary_partner,1432.54,-21232.49
buyer_6,Manuel,45,ES56209598028877404654,TRX_N-00566-02540697,2023-05-01T12:11:39,Vitoria-Gasteiz,expenses,repairs,-254.13,-21486.62
buyer_6,Manuel,45,ES56209598028877404654,TRX_N-00567-92112424,2023-05-02T15:03:55,Vitoria-Gasteiz,expenses,cash,-100.0,-21586.62
buyer_6,Manuel,45,ES56209598028877404654,TRX_N-00568-98582723,2023-05-03T02:11:07,Hernani,expenses,education,-54.99,-21641.61
buyer_6,Manuel,45,ES56209598028877404654,TRX_N-00569-14768307,2023-05-04T17:02:56,Vitoria-Gasteiz,expenses,mortgage,-718.03,-22359.64
buyer_6,Manuel,45,ES56209598028877404654,TRX_N-00570-09505193,2023-05-04T19:51:11,Vitoria-Gasteiz,expenses,leisure,-26.66,-22386.3
buyer_6,Manuel,45,ES56209598028877404654,TRX_N-00571-80608983,2023-05-05T08:31:10,Vitoria-Gasteiz,expenses,electricity,-37.29,-22423.59
buyer_6,Manuel,45,ES56209598028877404654,TRX_N-00572-03279359,2023-05-05T16:19:02,Vitoria-Gasteiz,expenses,internet,-42.0,-22465.59
buyer_6,Manuel,45,ES56209598028877404654,TRX_N-00573-97543683,2023-05-05T06:16:30,Vitoria-Gasteiz,expenses,phone,-43.72,-22509.31
buyer_6,Manuel,45,ES56209598028877404654,TRX_N-00574-28537020,2023-05-06T15:17:52,Vitoria-Gasteiz,expenses,food,-75.05,-22584.36
buyer_6,Manuel,45,ES56209598028877404654,TRX_N-00575-51952248,2023-05-07T17:02:44,Vitoria-Gasteiz,expenses,healthcare,-185.38,-22769.74
buyer_6,Manuel,45,ES56209598028877404654,TRX_N-00576-55924635,2023-05-08T08:44:58,Vitoria-Gasteiz,expenses,gas,-94.34,-22864.08
buyer_6,Manuel,45,ES56209598028877404654,TRX_N-00577-69769821,2023-05-08T16:29:41,Vitoria-Gasteiz,expenses,water,-26.71,-22890.79
buyer_6,Manuel,45,ES56209598028877404654,TRX_N-00578-61876921,2023-05-09T11:20:05,Vitoria-Gasteiz,expenses,education,-76.67,-22967.46
buyer_6,Manuel,45,ES56209598028877404654,TRX_N-00579-79362205,2023-05-10T16:45:37,Vitoria-Gasteiz,expenses,cash,-100.0,-23067.46
buyer_6,Manuel,45,ES56209598028877404654,TRX_N-00580-90748462,2023-05-11T22:11:15,Hondarribia,expenses,cash,-100.0,-23167.46
buyer_6,Manuel,45,ES56209598028877404654,TRX_N-00581-14197262,2023-05-12T10:35:50,Vitoria-Gasteiz,expenses,transport,-66.86,-23234.32
buyer_6,Manuel,45,ES56209598028877404654,TRX_N-00582-29979896,2023-05-13T18:45:33,Vitoria-Gasteiz,expenses,food,-60.05,-23294.37
buyer_6,Manuel,45,ES56209598028877404654,TRX_N-00583-07864217,2023-05-15T08:16:46,Vitoria-Gasteiz,expenses,leisure,-39.88,-23334.25
buyer_6,Manuel,45,ES56209598028877404654,TRX_N-00584-21608674,2023-05-16T20:06:39,Barakaldo,expenses,cash,-100.0,-23434.25
buyer_6,Manuel,45,ES56209598028877404654,TRX_N-00585-49028302,2023-05-17T08:22:37,Vitoria-Gasteiz,expenses,transport,-48.73,-23482.98
buyer_6,Manuel,45,ES56209598028877404654,TRX_N-00586-12915463,2023-05-18T14:18:11,Vitoria-Gasteiz,expenses,food,-75.86,-23558.84
buyer_6,Manuel,45,ES56209598028877404654,TRX_N-00587-36991437,2023-05-21T22:15:41,Vitoria-Gasteiz,expenses,food,-68.4,-23627.24
buyer_6,Manuel,45,ES56209598028877404654,TRX_N-00588-34765608,2023-05-22T13:53:09,Vitoria-Gasteiz,expenses,children,-62.75,-23689.99
buyer_6,Manuel,45,ES56209598028877404654,TRX_N-00589-35977790,2023-05-23T09:03:49,Vitoria-Gasteiz,expenses,food,-89.84,-23779.83
buyer_6,Manuel,45,ES56209598028877404654,TRX_N-00590-66359916,2023-05-24T14:45:18,Arrasate,expenses,healthcare,-107.07,-23886.9
buyer_6,Manuel,45,ES56209598028877404654,TRX_N-00591-58611763,2023-05-25T11:34:53,Vitoria-Gasteiz,expenses,food,-122.11,-24009.01
buyer_6,Manuel,45,ES56209598028877404654,TRX_N-00592-45374321,2023-05-27T13:46:24,Vitoria-Gasteiz,expenses,clothing,-51.78,-24060.79
buyer_6,Manuel,45,ES56209598028877404654,TRX_N-00593-20916986,2023-05-27T00:06:59,Hondarribia,expenses,cash,-100.0,-24160.79
buyer_6,Manuel,45,ES56209598028877404654,TRX_N-00594-02779736,2023-05-29T13:21:28,Vitoria-Gasteiz,expenses,cash,-100.0,-24260.79
buyer_6,Manuel,45,ES56209598028877404654,TRX_N-00595-73499418,2023-05-30T14:08:50,Vitoria-Gasteiz,expenses,food,-90.98,-24351.77
buyer_6,Manuel,45,ES56209598028877404654,TRX_N-00596-84541862,2023-05-30T15:56:57,Amurrio,expenses,cash,-100.0,-24451.77
buyer_6,Manuel,45,ES56209598028877404654,TRX_N-00597-67360107,2023-05-31T13:01:38,Vitoria-Gasteiz,expenses,transport,-86.61,-24538.38
buyer_6,Manuel,45,ES56209598028877404654,TRX_N-00598-39566258,2023-05-31T15:20:14,Vitoria-Gasteiz,expenses,cash,-100.0,-24638.38
buyer_6,Manuel,45,ES56209598028877404654,TRX_N-00599-59150686,2023-06-01T21:06:45,Vitoria-Gasteiz,incomes,salary,1515.3,-23123.08
buyer_6,Manuel,45,ES56209598028877404654,TRX_N-00600-52147658,2023-06-01T21:06:45,Vitoria-Gasteiz,incomes,salary_partner,1432.54,-21690.54
buyer_6,Manuel,45,ES56209598028877404654,TRX_N-00601-39437851,2023-06-01T21:06:45,Vitoria-Gasteiz,incomes,extra_income,178.24,-21512.3
buyer_6,Manuel,45,ES56209598028877404654,TRX_N-00602-45260086,2023-06-01T21:06:45,Vitoria-Gasteiz,incomes,salary_bonus,1136.34,-20375.96
buyer_6,Manuel,45,ES56209598028877404654,TRX_N-00603-47500569,2023-06-01T21:06:45,Vitoria-Gasteiz,incomes,salary_partner_bonus,1044.05,-19331.91
buyer_6,Manuel,45,ES56209598028877404654,TRX_N-00604-06982862,2023-06-01T14:35:12,Vitoria-Gasteiz,expenses,cash,-100.0,-19431.91
buyer_6,Manuel,45,ES56209598028877404654,TRX_N-00605-69980710,2023-06-02T08:19:49,Vitoria-Gasteiz,expenses,education,-58.99,-19490.9
buyer_6,Manuel,45,ES56209598028877404654,TRX_N-00606-14544699,2023-06-02T15:39:30,Vitoria-Gasteiz,expenses,cash,-100.0,-19590.9
buyer_6,Manuel,45,ES56209598028877404654,TRX_N-00607-75859215,2023-06-04T12:47:01,Vitoria-Gasteiz,expenses,mortgage,-718.03,-20308.93
buyer_6,Manuel,45,ES56209598028877404654,TRX_N-00608-86111507,2023-06-05T16:52:09,Vitoria-Gasteiz,expenses,phone,-31.51,-20340.44
buyer_6,Manuel,45,ES56209598028877404654,TRX_N-00609-48657686,2023-06-05T15:43:47,Vitoria-Gasteiz,expenses,food,-105.97,-20446.41
buyer_6,Manuel,45,ES56209598028877404654,TRX_N-00610-76777459,2023-06-05T02:32:36,Vitoria-Gasteiz,expenses,cash,-100.0,-20546.41
buyer_6,Manuel,45,ES56209598028877404654,TRX_N-00611-71223242,2023-06-05T15:12:08,Vitoria-Gasteiz,expenses,repairs,-160.9,-20707.31
buyer_6,Manuel,45,ES56209598028877404654,TRX_N-00612-26749327,2023-06-05T11:40:42,Vitoria-Gasteiz,expenses,children,-111.38,-20818.69
buyer_6,Manuel,45,ES56209598028877404654,TRX_N-00613-78756502,2023-06-07T11:19:53,Vitoria-Gasteiz,expenses,gifts,-255.28,-21073.97
buyer_6,Manuel,45,ES56209598028877404654,TRX_N-00614-92676432,2023-06-07T19:24:22,Vitoria-Gasteiz,expenses,children,-93.88,-21167.85
buyer_6,Manuel,45,ES56209598028877404654,TRX_N-00615-50276115,2023-06-08T09:38:43,Vitoria-Gasteiz,expenses,water,-35.44,-21203.29
buyer_6,Manuel,45,ES56209598028877404654,TRX_N-00616-59896780,2023-06-08T16:24:32,Vitoria-Gasteiz,expenses,electricity,-45.65,-21248.94
buyer_6,Manuel,45,ES56209598028877404654,TRX_N-00617-91878745,2023-06-08T20:21:22,Vitoria-Gasteiz,expenses,gas,-35.21,-21284.15
buyer_6,Manuel,45,ES56209598028877404654,TRX_N-00618-72489883,2023-06-08T18:16:05,Vitoria-Gasteiz,expenses,internet,-42.0,-21326.15
buyer_6,Manuel,45,ES56209598028877404654,TRX_N-00619-52823168,2023-06-08T20:53:31,Vitoria-Gasteiz,expenses,food,-71.98,-21398.13
buyer_6,Manuel,45,ES56209598028877404654,TRX_N-00620-23453933,2023-06-08T12:29:55,Galdakao,expenses,appliances,-408.12,-21806.25
buyer_6,Manuel,45,ES56209598028877404654,TRX_N-00621-36754811,2023-06-09T04:14:21,Vitoria-Gasteiz,expenses,food,-88.3,-21894.55
buyer_6,Manuel,45,ES56209598028877404654,TRX_N-00622-60669535,2023-06-10T08:29:50,Vitoria-Gasteiz,expenses,food,-107.02,-22001.57
buyer_6,Manuel,45,ES56209598028877404654,TRX_N-00623-42845124,2023-06-10T20:06:01,Vitoria-Gasteiz,expenses,gifts,-500.57,-22502.14
buyer_6,Manuel,45,ES56209598028877404654,TRX_N-00624-91226241,2023-06-12T08:19:23,Galdakao,expenses,repairs,-79.22,-22581.36
buyer_6,Manuel,45,ES56209598028877404654,TRX_N-00625-23751089,2023-06-16T17:02:38,Vitoria-Gasteiz,expenses,cash,-100.0,-22681.36
buyer_6,Manuel,45,ES56209598028877404654,TRX_N-00626-95409457,2023-06-18T16:19:52,Vitoria-Gasteiz,expenses,food,-65.89,-22747.25
buyer_6,Manuel,45,ES56209598028877404654,TRX_N-00627-89976471,2023-06-18T14:27:00,Eibar,expenses,leisure,-60.57,-22807.82
buyer_6,Manuel,45,ES56209598028877404654,TRX_N-00628-69298384,2023-06-21T13:22:02,Vitoria-Gasteiz,expenses,leisure,-24.09,-22831.91
buyer_6,Manuel,45,ES56209598028877404654,TRX_N-00629-10704739,2023-06-21T10:26:12,Lasarte-Oria,expenses,cash,-100.0,-22931.91
buyer_6,Manuel,45,ES56209598028877404654,TRX_N-00630-08886435,2023-06-21T19:30:37,Vitoria-Gasteiz,expenses,gifts,-161.49,-23093.4
buyer_6,Manuel,45,ES56209598028877404654,TRX_N-00631-91031654,2023-06-22T15:50:29,Vitoria-Gasteiz,expenses,children,-207.52,-23300.92
buyer_6,Manuel,45,ES56209598028877404654,TRX_N-00632-08335996,2023-06-23T15:05:13,Iruña de Oca,expenses,food,-68.06,-23368.98
buyer_6,Manuel,45,ES56209598028877404654,TRX_N-00633-74874208,2023-06-25T22:38:01,Vitoria-Gasteiz,expenses,education,-44.84,-23413.82
buyer_6,Manuel,45,ES56209598028877404654,TRX_N-00634-16797360,2023-06-27T14:31:30,Vitoria-Gasteiz,expenses,children,-178.59,-23592.41
buyer_6,Manuel,45,ES56209598028877404654,TRX_N-00635-29714558,2023-06-28T08:47:22,Vitoria-Gasteiz,expenses,food,-87.24,-23679.65
buyer_6,Manuel,45,ES56209598028877404654,TRX_N-00636-73762097,2023-06-28T18:20:35,Vitoria-Gasteiz,expenses,transport,-85.91,-23765.56
buyer_6,Manuel,45,ES56209598028877404654,TRX_N-00637-95864330,2023-06-30T23:33:46,Vitoria-Gasteiz,expenses,appliances,-138.93,-23904.49
buyer_6,Manuel,45,ES56209598028877404654,TRX_N-00638-74346639,2023-07-01T05:09:34,Vitoria-Gasteiz,incomes,salary,1515.3,-22389.19
buyer_6,Manuel,45,ES56209598028877404654,TRX_N-00639-64614279,2023-07-01T05:09:34,Vitoria-Gasteiz,incomes,salary_partner,1432.54,-20956.65
buyer_6,Manuel,45,ES56209598028877404654,TRX_N-00640-23557738,2023-07-03T17:31:30,Vitoria-Gasteiz,expenses,education,-50.51,-21007.16
buyer_6,Manuel,45,ES56209598028877404654,TRX_N-00641-23041845,2023-07-04T17:24:44,Vitoria-Gasteiz,expenses,mortgage,-718.03,-21725.19
buyer_6,Manuel,45,ES56209598028877404654,TRX_N-00642-09887630,2023-07-05T16:27:49,Vitoria-Gasteiz,expenses,gifts,-44.32,-21769.51
buyer_6,Manuel,45,ES56209598028877404654,TRX_N-00643-78228672,2023-07-06T18:26:32,Vitoria-Gasteiz,expenses,water,-28.57,-21798.08
buyer_6,Manuel,45,ES56209598028877404654,TRX_N-00644-98497151,2023-07-06T17:56:30,Vitoria-Gasteiz,expenses,gas,-105.21,-21903.29
buyer_6,Manuel,45,ES56209598028877404654,TRX_N-00645-66940503,2023-07-07T16:55:20,Vitoria-Gasteiz,expenses,phone,-35.04,-21938.33
buyer_6,Manuel,45,ES56209598028877404654,TRX_N-00646-09325111,2023-07-08T13:05:34,Vitoria-Gasteiz,expenses,electricity,-28.84,-21967.17
buyer_6,Manuel,45,ES56209598028877404654,TRX_N-00647-19304213,2023-07-08T09:43:46,Vitoria-Gasteiz,expenses,internet,-42.0,-22009.17
buyer_6,Manuel,45,ES56209598028877404654,TRX_N-00648-18234270,2023-07-08T23:02:59,Vitoria-Gasteiz,expenses,food,-112.85,-22122.02
buyer_6,Manuel,45,ES56209598028877404654,TRX_N-00649-97657373,2023-07-08T21:28:37,Vitoria-Gasteiz,expenses,leisure,-75.02,-22197.04
buyer_6,Manuel,45,ES56209598028877404654,TRX_N-00650-88221284,2023-07-08T16:18:30,Vitoria-Gasteiz,expenses,cash,-100.0,-22297.04
buyer_6,Manuel,45,ES56209598028877404654,TRX_N-00651-32732273,2023-07-09T14:42:45,Vitoria-Gasteiz,expenses,travel,-1336.66,-23633.7
buyer_6,Manuel,45,ES56209598028877404654,TRX_N-00652-22520433,2023-07-09T19:17:27,Vitoria-Gasteiz,expenses,repairs,-104.01,-23737.71
buyer_6,Manuel,45,ES56209598028877404654,TRX_N-00653-73948298,2023-07-10T19:28:14,Vitoria-Gasteiz,expenses,food,-81.51,-23819.22
buyer_6,Manuel,45,ES56209598028877404654,TRX_N-00654-68902535,2023-07-11T22:41:43,Vitoria-Gasteiz,expenses,food,-97.35,-23916.57
buyer_6,Manuel,45,ES56209598028877404654,TRX_N-00655-92820987,2023-07-12T21:17:56,Vitoria-Gasteiz,expenses,food,-62.14,-23978.71
buyer_6,Manuel,45,ES56209598028877404654,TRX_N-00656-05199302,2023-07-13T12:23:54,Vitoria-Gasteiz,expenses,food,-115.7,-24094.41
buyer_6,Manuel,45,ES56209598028877404654,TRX_N-00657-04851890,2023-07-15T08:30:50,Vitoria-Gasteiz,expenses,repairs,-75.94,-24170.35
buyer_6,Manuel,45,ES56209598028877404654,TRX_N-00658-73941398,2023-07-16T08:18:41,Vitoria-Gasteiz,expenses,healthcare,-40.03,-24210.38
buyer_6,Manuel,45,ES56209598028877404654,TRX_N-00659-19561398,2023-07-16T14:39:10,Amurrio,expenses,education,-73.91,-24284.29
buyer_6,Manuel,45,ES56209598028877404654,TRX_N-00660-26963407,2023-07-16T20:36:38,Vitoria-Gasteiz,expenses,gifts,-248.6,-24532.89
buyer_6,Manuel,45,ES56209598028877404654,TRX_N-00661-43474380,2023-07-17T10:26:37,Vitoria-Gasteiz,expenses,leisure,-22.22,-24555.11
buyer_6,Manuel,45,ES56209598028877404654,TRX_N-00662-68551020,2023-07-18T20:04:50,Vitoria-Gasteiz,expenses,cash,-100.0,-24655.11
buyer_6,Manuel,45,ES56209598028877404654,TRX_N-00663-80806476,2023-07-18T13:07:36,Vitoria-Gasteiz,expenses,repairs,-58.77,-24713.88
buyer_6,Manuel,45,ES56209598028877404654,TRX_N-00664-92894378,2023-07-19T11:47:17,Vitoria-Gasteiz,expenses,leisure,-66.74,-24780.62
buyer_6,Manuel,45,ES56209598028877404654,TRX_N-00665-52025795,2023-07-20T09:05:49,Vitoria-Gasteiz,expenses,healthcare,-154.67,-24935.29
buyer_6,Manuel,45,ES56209598028877404654,TRX_N-00666-82746275,2023-07-22T19:41:24,Vitoria-Gasteiz,expenses,food,-68.76,-25004.05
buyer_6,Manuel,45,ES56209598028877404654,TRX_N-00667-72156270,2023-07-23T13:21:30,Vitoria-Gasteiz,expenses,leisure,-57.98,-25062.03
buyer_6,Manuel,45,ES56209598028877404654,TRX_N-00668-42387712,2023-07-24T14:39:38,Vitoria-Gasteiz,expenses,food,-81.33,-25143.36
buyer_6,Manuel,45,ES56209598028877404654,TRX_N-00669-16845753,2023-07-24T15:48:40,Vitoria-Gasteiz,expenses,cash,-100.0,-25243.36
buyer_6,Manuel,45,ES56209598028877404654,TRX_N-00670-36132011,2023-07-25T18:11:16,Vitoria-Gasteiz,expenses,food,-83.37,-25326.73
buyer_6,Manuel,45,ES56209598028877404654,TRX_N-00671-29029823,2023-07-25T08:26:15,Andoain,expenses,repairs,-39.74,-25366.47
buyer_6,Manuel,45,ES56209598028877404654,TRX_N-00672-79970248,2023-07-26T10:53:03,Vitoria-Gasteiz,expenses,cash,-100.0,-25466.47
buyer_6,Manuel,45,ES56209598028877404654,TRX_N-00673-82498129,2023-07-26T16:05:44,Vitoria-Gasteiz,expenses,gifts,-150.36,-25616.83
buyer_6,Manuel,45,ES56209598028877404654,TRX_N-00674-39572529,2023-07-29T19:44:55,Vitoria-Gasteiz,expenses,leisure,-64.66,-25681.49
buyer_6,Manuel,45,ES56209598028877404654,TRX_N-00675-51626728,2023-07-30T08:11:55,Andoain,expenses,repairs,-261.15,-25942.64
buyer_6,Manuel,45,ES56209598028877404654,TRX_N-00676-08162499,2023-07-31T10:43:03,Vitoria-Gasteiz,expenses,transport,-57.56,-26000.2
buyer_6,Manuel,45,ES56209598028877404654,TRX_N-00677-80893584,2023-07-31T07:55:30,Vitoria-Gasteiz,expenses,gifts,-625.4,-26625.6
buyer_6,Manuel,45,ES56209598028877404654,TRX_N-00678-35470370,2023-07-31T10:43:45,Vitoria-Gasteiz,expenses,children,-144.36,-26769.96
buyer_6,Manuel,45,ES56209598028877404654,TRX_N-00679-85615248,2023-08-01T14:30:38,Vitoria-Gasteiz,incomes,salary,1515.3,-25254.66
buyer_6,Manuel,45,ES56209598028877404654,TRX_N-00680-16463677,2023-08-01T14:30:38,Vitoria-Gasteiz,incomes,salary_partner,1432.54,-23822.12
buyer_6,Manuel,45,ES56209598028877404654,TRX_N-00681-61166741,2023-08-02T16:15:23,Vitoria-Gasteiz,expenses,food,-74.45,-23896.57
buyer_6,Manuel,45,ES56209598028877404654,TRX_N-00682-76032124,2023-08-02T07:19:37,Vitoria-Gasteiz,expenses,clothing,-101.34,-23997.91
buyer_6,Manuel,45,ES56209598028877404654,TRX_N-00683-43255914,2023-08-02T18:00:32,Vitoria-Gasteiz,expenses,cash,-100.0,-24097.91
buyer_6,Manuel,45,ES56209598028877404654,TRX_N-00684-03219348,2023-08-04T14:43:10,Vitoria-Gasteiz,expenses,mortgage,-718.03,-24815.94
buyer_6,Manuel,45,ES56209598028877404654,TRX_N-00685-15742332,2023-08-04T06:36:00,Vitoria-Gasteiz,expenses,cash,-100.0,-24915.94
buyer_6,Manuel,45,ES56209598028877404654,TRX_N-00686-92557283,2023-08-04T16:05:50,Vitoria-Gasteiz,expenses,gifts,-370.26,-25286.2
buyer_6,Manuel,45,ES56209598028877404654,TRX_N-00687-37593400,2023-08-05T14:55:27,Vitoria-Gasteiz,expenses,phone,-36.59,-25322.79
buyer_6,Manuel,45,ES56209598028877404654,TRX_N-00688-28004069,2023-08-07T10:35:11,Vitoria-Gasteiz,expenses,food,-60.69,-25383.48
buyer_6,Manuel,45,ES56209598028877404654,TRX_N-00689-77588896,2023-08-08T03:43:04,Vitoria-Gasteiz,expenses,water,-37.03,-25420.51
buyer_6,Manuel,45,ES56209598028877404654,TRX_N-00690-75239924,2023-08-08T09:05:22,Vitoria-Gasteiz,expenses,electricity,-87.24,-25507.75
buyer_6,Manuel,45,ES56209598028877404654,TRX_N-00691-74963343,2023-08-08T01:05:53,Vitoria-Gasteiz,expenses,gas,-56.75,-25564.5
buyer_6,Manuel,45,ES56209598028877404654,TRX_N-00692-58306096,2023-08-08T08:13:32,Vitoria-Gasteiz,expenses,internet,-42.0,-25606.5
buyer_6,Manuel,45,ES56209598028877404654,TRX_N-00693-43609905,2023-08-08T19:37:00,Vitoria-Gasteiz,expenses,transport,-70.24,-25676.74
buyer_6,Manuel,45,ES56209598028877404654,TRX_N-00694-42331113,2023-08-09T17:43:31,Donostia,expenses,clothing,-81.29,-25758.03
buyer_6,Manuel,45,ES56209598028877404654,TRX_N-00695-39893827,2023-08-09T14:52:56,Vitoria-Gasteiz,expenses,cash,-100.0,-25858.03
buyer_6,Manuel,45,ES56209598028877404654,TRX_N-00696-79872119,2023-08-09T16:59:04,Vitoria-Gasteiz,expenses,children,-243.56,-26101.59
buyer_6,Manuel,45,ES56209598028877404654,TRX_N-00697-54248470,2023-08-11T00:00:05,Vitoria-Gasteiz,expenses,repairs,-48.49,-26150.08
buyer_6,Manuel,45,ES56209598028877404654,TRX_N-00698-05663408,2023-08-12T15:25:22,Santurtzi,expenses,cash,-100.0,-26250.08
buyer_6,Manuel,45,ES56209598028877404654,TRX_N-00699-99383755,2023-08-15T08:58:37,Vitoria-Gasteiz,expenses,transport,-85.33,-26335.41
buyer_6,Manuel,45,ES56209598028877404654,TRX_N-00700-07105423,2023-08-16T17:05:55,Vitoria-Gasteiz,expenses,gifts,-837.2,-27172.61
buyer_6,Manuel,45,ES56209598028877404654,TRX_N-00701-62140062,2023-08-17T16:26:09,Vitoria-Gasteiz,expenses,food,-86.68,-27259.29
buyer_6,Manuel,45,ES56209598028877404654,TRX_N-00702-97477393,2023-08-17T13:54:12,Vitoria-Gasteiz,expenses,clothing,-152.79,-27412.08
buyer_6,Manuel,45,ES56209598028877404654,TRX_N-00703-66788480,2023-08-17T19:23:24,Vitoria-Gasteiz,expenses,repairs,-142.1,-27554.18
buyer_6,Manuel,45,ES56209598028877404654,TRX_N-00704-97006504,2023-08-19T19:51:35,Vitoria-Gasteiz,expenses,education,-43.44,-27597.62
buyer_6,Manuel,45,ES56209598028877404654,TRX_N-00705-96949522,2023-08-21T16:58:04,Vitoria-Gasteiz,expenses,food,-77.57,-27675.19
buyer_6,Manuel,45,ES56209598028877404654,TRX_N-00706-09838928,2023-08-22T20:03:14,Vitoria-Gasteiz,expenses,education,-54.16,-27729.35
buyer_6,Manuel,45,ES56209598028877404654,TRX_N-00707-97777561,2023-08-22T15:11:37,Vitoria-Gasteiz,expenses,cash,-100.0,-27829.35
buyer_6,Manuel,45,ES56209598028877404654,TRX_N-00708-20317970,2023-08-23T11:30:39,Sopela,expenses,repairs,-143.09,-27972.44
buyer_6,Manuel,45,ES56209598028877404654,TRX_N-00709-42056513,2023-08-24T09:14:26,Vitoria-Gasteiz,expenses,gifts,-711.23,-28683.67
buyer_6,Manuel,45,ES56209598028877404654,TRX_N-00710-82178831,2023-08-25T11:48:51,Vitoria-Gasteiz,expenses,healthcare,-79.34,-28763.01
buyer_6,Manuel,45,ES56209598028877404654,TRX_N-00711-46295513,2023-08-26T18:33:25,Vitoria-Gasteiz,expenses,clothing,-81.09,-28844.1
buyer_6,Manuel,45,ES56209598028877404654,TRX_N-00712-60719157,2023-08-27T08:08:25,Vitoria-Gasteiz,expenses,transport,-72.86,-28916.96
buyer_6,Manuel,45,ES56209598028877404654,TRX_N-00713-59414011,2023-08-27T15:05:04,Vitoria-Gasteiz,expenses,gifts,-562.35,-29479.31
buyer_6,Manuel,45,ES56209598028877404654,TRX_N-00714-38617606,2023-08-29T10:20:48,Vitoria-Gasteiz,expenses,food,-124.81,-29604.12
buyer_6,Manuel,45,ES56209598028877404654,TRX_N-00715-73545452,2023-08-30T22:23:52,Vitoria-Gasteiz,expenses,cash,-100.0,-29704.12
buyer_6,Manuel,45,ES56209598028877404654,TRX_N-00716-42373221,2023-08-31T20:17:16,Vitoria-Gasteiz,expenses,food,-99.09,-29803.21
buyer_6,Manuel,45,ES56209598028877404654,TRX_N-00717-17710687,2023-09-01T09:12:08,Vitoria-Gasteiz,incomes,salary,1515.3,-28287.91
buyer_6,Manuel,45,ES56209598028877404654,TRX_N-00718-82297876,2023-09-01T09:12:08,Vitoria-Gasteiz,incomes,salary_partner,1432.54,-26855.37
buyer_6,Manuel,45,ES56209598028877404654,TRX_N-00719-09689551,2023-09-01T09:12:08,Vitoria-Gasteiz,incomes,extra_income,178.24,-26677.13
buyer_6,Manuel,45,ES56209598028877404654,TRX_N-00720-72741827,2023-09-04T02:41:11,Vitoria-Gasteiz,expenses,mortgage,-718.03,-27395.16
buyer_6,Manuel,45,ES56209598028877404654,TRX_N-00721-24968961,2023-09-04T10:41:30,Vitoria-Gasteiz,expenses,leisure,-46.47,-27441.63
buyer_6,Manuel,45,ES56209598028877404654,TRX_N-00722-97391335,2023-09-04T22:44:35,Vitoria-Gasteiz,expenses,cash,-100.0,-27541.63
buyer_6,Manuel,45,ES56209598028877404654,TRX_N-00723-28183581,2023-09-04T11:02:39,Vitoria-Gasteiz,expenses,repairs,-218.24,-27759.87
buyer_6,Manuel,45,ES56209598028877404654,TRX_N-00724-81571465,2023-09-05T11:47:24,Vitoria-Gasteiz,expenses,water,-34.6,-27794.47
buyer_6,Manuel,45,ES56209598028877404654,TRX_N-00725-70022947,2023-09-05T20:16:26,Vitoria-Gasteiz,expenses,phone,-38.58,-27833.05
buyer_6,Manuel,45,ES56209598028877404654,TRX_N-00726-22235182,2023-09-05T16:29:16,Vitoria-Gasteiz,expenses,repairs,-282.07,-28115.12
buyer_6,Manuel,45,ES56209598028877404654,TRX_N-00727-83412642,2023-09-05T08:38:47,Vitoria-Gasteiz,expenses,gifts,-467.61,-28582.73
buyer_6,Manuel,45,ES56209598028877404654,TRX_N-00728-53533320,2023-09-06T21:48:56,Vitoria-Gasteiz,expenses,electricity,-46.86,-28629.59
buyer_6,Manuel,45,ES56209598028877404654,TRX_N-00729-62589699,2023-09-06T14:18:54,Vitoria-Gasteiz,expenses,gas,-43.52,-28673.11
buyer_6,Manuel,45,ES56209598028877404654,TRX_N-00730-48079930,2023-09-06T22:41:00,Vitoria-Gasteiz,expenses,internet,-42.0,-28715.11
buyer_6,Manuel,45,ES56209598028877404654,TRX_N-00731-84419644,2023-09-06T19:48:23,Vitoria-Gasteiz,expenses,food,-116.18,-28831.29
buyer_6,Manuel,45,ES56209598028877404654,TRX_N-00732-14421340,2023-09-06T09:10:40,Vitoria-Gasteiz,expenses,healthcare,-178.51,-29009.8
buyer_6,Manuel,45,ES56209598028877404654,TRX_N-00733-83241737,2023-09-08T20:42:12,Vitoria-Gasteiz,expenses,transport,-87.96,-29097.76
buyer_6,Manuel,45,ES56209598028877404654,TRX_N-00734-82048572,2023-09-08T14:57:31,Vitoria-Gasteiz,expenses,children,-210.6,-29308.36
buyer_6,Manuel,45,ES56209598028877404654,TRX_N-00735-99098354,2023-09-09T19:38:13,Vitoria-Gasteiz,expenses,clothing,-56.12,-29364.48
buyer_6,Manuel,45,ES56209598028877404654,TRX_N-00736-20397436,2023-09-10T08:53:00,Vitoria-Gasteiz,expenses,food,-99.11,-29463.59
buyer_6,Manuel,45,ES56209598028877404654,TRX_N-00737-01284379,2023-09-10T22:09:40,Vitoria-Gasteiz,expenses,cash,-100.0,-29563.59
buyer_6,Manuel,45,ES56209598028877404654,TRX_N-00738-13041304,2023-09-11T10:54:30,Vitoria-Gasteiz,expenses,leisure,-63.57,-29627.16
buyer_6,Manuel,45,ES56209598028877404654,TRX_N-00739-69472623,2023-09-11T11:38:42,Vitoria-Gasteiz,expenses,cash,-100.0,-29727.16
buyer_6,Manuel,45,ES56209598028877404654,TRX_N-00740-40484328,2023-09-11T09:53:15,Vitoria-Gasteiz,expenses,repairs,-136.58,-29863.74
buyer_6,Manuel,45,ES56209598028877404654,TRX_N-00741-74079362,2023-09-12T08:45:20,Vitoria-Gasteiz,expenses,transport,-52.02,-29915.76
buyer_6,Manuel,45,ES56209598028877404654,TRX_N-00742-84252133,2023-09-15T10:00:06,Vitoria-Gasteiz,expenses,healthcare,-77.45,-29993.21
buyer_6,Manuel,45,ES56209598028877404654,TRX_N-00743-21324458,2023-09-15T13:08:13,Vitoria-Gasteiz,expenses,repairs,-202.08,-30195.29
buyer_6,Manuel,45,ES56209598028877404654,TRX_N-00744-86534443,2023-09-16T12:05:28,Vitoria-Gasteiz,expenses,appliances,-81.31,-30276.6
buyer_6,Manuel,45,ES56209598028877404654,TRX_N-00745-69756062,2023-09-18T10:20:57,Vitoria-Gasteiz,expenses,cash,-100.0,-30376.6
buyer_6,Manuel,45,ES56209598028877404654,TRX_N-00746-95234899,2023-09-18T15:28:28,Vitoria-Gasteiz,expenses,appliances,-233.68,-30610.28
buyer_6,Manuel,45,ES56209598028877404654,TRX_N-00747-05348421,2023-09-19T10:50:45,Vitoria-Gasteiz,expenses,clothing,-69.91,-30680.19
buyer_6,Manuel,45,ES56209598028877404654,TRX_N-00748-30089842,2023-09-19T20:21:09,Vitoria-Gasteiz,expenses,cash,-100.0,-30780.19
buyer_6,Manuel,45,ES56209598028877404654,TRX_N-00749-34409036,2023-09-24T19:20:02,Vitoria-Gasteiz,expenses,leisure,-33.52,-30813.71
buyer_6,Manuel,45,ES56209598028877404654,TRX_N-00750-81081740,2023-09-26T12:58:49,Pasaia,expenses,food,-61.45,-30875.16
buyer_6,Manuel,45,ES56209598028877404654,TRX_N-00751-31942597,2023-09-26T12:06:13,Hondarribia,expenses,education,-74.14,-30949.3
buyer_6,Manuel,45,ES56209598028877404654,TRX_N-00752-47512427,2023-09-30T10:50:57,Vitoria-Gasteiz,expenses,cash,-100.0,-31049.3
buyer_6,Manuel,45,ES56209598028877404654,TRX_N-00753-95578334,2023-09-30T13:22:28,Vitoria-Gasteiz,expenses,appliances,-273.95,-31323.25
buyer_6,Manuel,45,ES56209598028877404654,TRX_N-00754-78417692,2023-10-01T17:24:51,Vitoria-Gasteiz,incomes,salary,1515.3,-29807.95
buyer_6,Manuel,45,ES56209598028877404654,TRX_N-00755-30894605,2023-10-01T17:24:51,Vitoria-Gasteiz,incomes,salary_partner,1432.54,-28375.41
buyer_6,Manuel,45,ES56209598028877404654,TRX_N-00756-92416750,2023-10-01T14:47:49,Santurtzi,expenses,leisure,-72.13,-28447.54
buyer_6,Manuel,45,ES56209598028877404654,TRX_N-00757-79620921,2023-10-03T20:26:30,Vitoria-Gasteiz,expenses,food,-116.21,-28563.75
buyer_6,Manuel,45,ES56209598028877404654,TRX_N-00758-46384805,2023-10-03T11:37:00,Vitoria-Gasteiz,expenses,cash,-100.0,-28663.75
buyer_6,Manuel,45,ES56209598028877404654,TRX_N-00759-50040112,2023-10-04T15:55:14,Vitoria-Gasteiz,expenses,mortgage,-718.03,-29381.78
buyer_6,Manuel,45,ES56209598028877404654,TRX_N-00760-61564609,2023-10-04T12:00:52,Vitoria-Gasteiz,expenses,transport,-54.91,-29436.69
buyer_6,Manuel,45,ES56209598028877404654,TRX_N-00761-63798027,2023-10-05T17:43:12,Vitoria-Gasteiz,expenses,electricity,-41.32,-29478.01
buyer_6,Manuel,45,ES56209598028877404654,TRX_N-00762-48850180,2023-10-05T10:59:24,Vitoria-Gasteiz,expenses,internet,-42.0,-29520.01
buyer_6,Manuel,45,ES56209598028877404654,TRX_N-00763-15761280,2023-10-05T15:33:58,Vitoria-Gasteiz,expenses,food,-102.01,-29622.02
buyer_6,Manuel,45,ES56209598028877404654,TRX_N-00764-44799733,2023-10-05T08:28:32,Vitoria-Gasteiz,expenses,cash,-100.0,-29722.02
buyer_6,Manuel,45,ES56209598028877404654,TRX_N-00765-24760375,2023-10-06T14:37:44,Vitoria-Gasteiz,expenses,leisure,-27.2,-29749.22
buyer_6,Manuel,45,ES56209598028877404654,TRX_N-00766-28613160,2023-10-06T15:00:39,Santurtzi,expenses,repairs,-183.11,-29932.33
buyer_6,Manuel,45,ES56209598028877404654,TRX_N-00767-09837889,2023-10-07T19:15:25,Vitoria-Gasteiz,expenses,gifts,-357.95,-30290.28
buyer_6,Manuel,45,ES56209598028877404654,TRX_N-00768-72750919,2023-10-08T20:52:32,Vitoria-Gasteiz,expenses,water,-26.27,-30316.55
buyer_6,Manuel,45,ES56209598028877404654,TRX_N-00769-65789413,2023-10-08T10:29:36,Vitoria-Gasteiz,expenses,gas,-83.62,-30400.17
buyer_6,Manuel,45,ES56209598028877404654,TRX_N-00770-73819251,2023-10-08T08:27:46,Vitoria-Gasteiz,expenses,phone,-31.96,-30432.13
buyer_6,Manuel,45,ES56209598028877404654,TRX_N-00771-80776208,2023-10-08T21:32:02,Vitoria-Gasteiz,expenses,appliances,-334.74,-30766.87
buyer_6,Manuel,45,ES56209598028877404654,TRX_N-00772-57913791,2023-10-09T15:07:26,Vitoria-Gasteiz,expenses,leisure,-50.0,-30816.87
buyer_6,Manuel,45,ES56209598028877404654,TRX_N-00773-74940298,2023-10-13T22:03:22,Vitoria-Gasteiz,expenses,food,-112.99,-30929.86
buyer_6,Manuel,45,ES56209598028877404654,TRX_N-00774-32328153,2023-10-13T15:27:14,Vitoria-Gasteiz,expenses,cash,-100.0,-31029.86
buyer_6,Manuel,45,ES56209598028877404654,TRX_N-00775-37746535,2023-10-13T19:21:50,Vitoria-Gasteiz,expenses,repairs,-284.56,-31314.42
buyer_6,Manuel,45,ES56209598028877404654,TRX_N-00776-05966502,2023-10-14T19:19:33,Vitoria-Gasteiz,expenses,leisure,-70.52,-31384.94
buyer_6,Manuel,45,ES56209598028877404654,TRX_N-00777-16016458,2023-10-16T06:07:08,Vitoria-Gasteiz,expenses,healthcare,-46.61,-31431.55
buyer_6,Manuel,45,ES56209598028877404654,TRX_N-00778-12477651,2023-10-17T01:24:42,Zuia,expenses,food,-116.23,-31547.78
buyer_6,Manuel,45,ES56209598028877404654,TRX_N-00779-16501491,2023-10-17T15:37:23,Alegría-Dulantzi,expenses,leisure,-52.47,-31600.25
buyer_6,Manuel,45,ES56209598028877404654,TRX_N-00780-75499975,2023-10-18T22:36:25,Vitoria-Gasteiz,expenses,transport,-58.54,-31658.79
buyer_6,Manuel,45,ES56209598028877404654,TRX_N-00781-94093679,2023-10-20T10:02:52,Durango,expenses,leisure,-57.77,-31716.56
buyer_6,Manuel,45,ES56209598028877404654,TRX_N-00782-94162792,2023-10-21T09:33:00,Amurrio,expenses,cash,-100.0,-31816.56
buyer_6,Manuel,45,ES56209598028877404654,TRX_N-00783-61572224,2023-10-23T20:56:15,Vitoria-Gasteiz,expenses,transport,-85.7,-31902.26
buyer_6,Manuel,45,ES56209598028877404654,TRX_N-00784-98009858,2023-10-23T20:23:39,Vitoria-Gasteiz,expenses,children,-89.96,-31992.22
buyer_6,Manuel,45,ES56209598028877404654,TRX_N-00785-65630374,2023-10-24T16:41:17,Erandio,expenses,leisure,-38.01,-32030.23
buyer_6,Manuel,45,ES56209598028877404654,TRX_N-00786-12661575,2023-10-24T14:27:17,Vitoria-Gasteiz,expenses,education,-61.31,-32091.54
buyer_6,Manuel,45,ES56209598028877404654,TRX_N-00787-02994082,2023-10-24T14:44:10,Eibar,expenses,gifts,-671.19,-32762.73
buyer_6,Manuel,45,ES56209598028877404654,TRX_N-00788-79529185,2023-10-27T12:02:13,Vitoria-Gasteiz,expenses,cash,-100.0,-32862.73
buyer_6,Manuel,45,ES56209598028877404654,TRX_N-00789-82079435,2023-10-28T12:33:31,Vitoria-Gasteiz,expenses,transport,-85.75,-32948.48
buyer_6,Manuel,45,ES56209598028877404654,TRX_N-00790-77366978,2023-10-28T10:49:11,Vitoria-Gasteiz,expenses,cash,-100.0,-33048.48
buyer_6,Manuel,45,ES56209598028877404654,TRX_N-00791-17490157,2023-10-29T11:30:19,Bilbao,expenses,clothing,-112.05,-33160.53
buyer_6,Manuel,45,ES56209598028877404654,TRX_N-00792-89402180,2023-10-31T11:41:58,Vitoria-Gasteiz,expenses,transport,-43.69,-33204.22
buyer_6,Manuel,45,ES56209598028877404654,TRX_N-00793-90701659,2023-10-31T19:24:58,Vitoria-Gasteiz,expenses,leisure,-41.25,-33245.47
buyer_6,Manuel,45,ES56209598028877404654,TRX_N-00794-30433353,2023-11-01T13:36:41,Vitoria-Gasteiz,incomes,salary,1515.3,-31730.17
buyer_6,Manuel,45,ES56209598028877404654,TRX_N-00795-35868275,2023-11-01T13:36:41,Vitoria-Gasteiz,incomes,salary_partner,1432.54,-30297.63
buyer_6,Manuel,45,ES56209598028877404654,TRX_N-00796-71354429,2023-11-03T16:37:16,Pasaia,expenses,food,-100.56,-30398.19
buyer_6,Manuel,45,ES56209598028877404654,TRX_N-00797-90094918,2023-11-04T09:00:57,Vitoria-Gasteiz,expenses,mortgage,-718.03,-31116.22
buyer_6,Manuel,45,ES56209598028877404654,TRX_N-00798-54684729,2023-11-05T09:14:09,Vitoria-Gasteiz,expenses,water,-22.34,-31138.56
buyer_6,Manuel,45,ES56209598028877404654,TRX_N-00799-44970364,2023-11-05T17:10:28,Vitoria-Gasteiz,expenses,appliances,-187.34,-31325.9
buyer_6,Manuel,45,ES56209598028877404654,TRX_N-00800-90354448,2023-11-06T22:51:13,Vitoria-Gasteiz,expenses,gas,-96.78,-31422.68
buyer_6,Manuel,45,ES56209598028877404654,TRX_N-00801-73705246,2023-11-07T15:26:47,Vitoria-Gasteiz,expenses,internet,-42.0,-31464.68
buyer_6,Manuel,45,ES56209598028877404654,TRX_N-00802-64550031,2023-11-08T08:49:42,Vitoria-Gasteiz,expenses,electricity,-78.72,-31543.4
buyer_6,Manuel,45,ES56209598028877404654,TRX_N-00803-69235659,2023-11-08T10:51:54,Vitoria-Gasteiz,expenses,phone,-38.15,-31581.55
buyer_6,Manuel,45,ES56209598028877404654,TRX_N-00804-38307096,2023-11-09T18:36:09,Bermeo,expenses,leisure,-30.47,-31612.02
buyer_6,Manuel,45,ES56209598028877404654,TRX_N-00805-58088792,2023-11-10T13:04:36,Vitoria-Gasteiz,expenses,food,-103.84,-31715.86
buyer_6,Manuel,45,ES56209598028877404654,TRX_N-00806-38725925,2023-11-12T17:47:43,Vitoria-Gasteiz,expenses,transport,-49.51,-31765.37
buyer_6,Manuel,45,ES56209598028877404654,TRX_N-00807-48079410,2023-11-12T16:57:14,Vitoria-Gasteiz,expenses,cash,-100.0,-31865.37
buyer_6,Manuel,45,ES56209598028877404654,TRX_N-00808-27532818,2023-11-12T12:43:48,Vitoria-Gasteiz,expenses,children,-197.69,-32063.06
buyer_6,Manuel,45,ES56209598028877404654,TRX_N-00809-81245405,2023-11-14T08:39:36,Vitoria-Gasteiz,expenses,children,-126.17,-32189.23
buyer_6,Manuel,45,ES56209598028877404654,TRX_N-00810-36064961,2023-11-15T17:30:31,Lasarte-Oria,expenses,food,-78.76,-32267.99
buyer_6,Manuel,45,ES56209598028877404654,TRX_N-00811-01640439,2023-11-15T10:03:06,Vitoria-Gasteiz,expenses,transport,-65.94,-32333.93
buyer_6,Manuel,45,ES56209598028877404654,TRX_N-00812-12532961,2023-11-17T22:46:31,Vitoria-Gasteiz,expenses,gifts,-607.35,-32941.28
buyer_6,Manuel,45,ES56209598028877404654,TRX_N-00813-46082435,2023-11-18T10:37:41,Vitoria-Gasteiz,expenses,transport,-51.09,-32992.37
buyer_6,Manuel,45,ES56209598028877404654,TRX_N-00814-04925723,2023-11-18T17:58:44,Vitoria-Gasteiz,expenses,leisure,-84.9,-33077.27
buyer_6,Manuel,45,ES56209598028877404654,TRX_N-00815-32967041,2023-11-20T05:43:43,Vitoria-Gasteiz,expenses,transport,-70.49,-33147.76
buyer_6,Manuel,45,ES56209598028877404654,TRX_N-00816-45515228,2023-11-22T19:44:57,Vitoria-Gasteiz,expenses,leisure,-49.12,-33196.88
buyer_6,Manuel,45,ES56209598028877404654,TRX_N-00817-05907574,2023-11-23T17:47:04,Vitoria-Gasteiz,expenses,food,-119.27,-33316.15
buyer_6,Manuel,45,ES56209598028877404654,TRX_N-00818-48466114,2023-11-23T11:23:15,Hernani,expenses,transport,-77.68,-33393.83
buyer_6,Manuel,45,ES56209598028877404654,TRX_N-00819-99133965,2023-11-23T09:33:57,Amurrio,expenses,cash,-100.0,-33493.83
buyer_6,Manuel,45,ES56209598028877404654,TRX_N-00820-84506239,2023-11-24T12:59:03,Vitoria-Gasteiz,expenses,transport,-82.11,-33575.94
buyer_6,Manuel,45,ES56209598028877404654,TRX_N-00821-93531671,2023-11-25T05:15:48,Vitoria-Gasteiz,expenses,food,-124.62,-33700.56
buyer_6,Manuel,45,ES56209598028877404654,TRX_N-00822-42346484,2023-11-25T16:38:37,Vitoria-Gasteiz,expenses,transport,-72.75,-33773.31
buyer_6,Manuel,45,ES56209598028877404654,TRX_N-00823-86023391,2023-11-26T10:43:19,Vitoria-Gasteiz,expenses,food,-63.01,-33836.32
buyer_6,Manuel,45,ES56209598028877404654,TRX_N-00824-96705662,2023-11-26T15:15:26,Vitoria-Gasteiz,expenses,gifts,-387.55,-34223.87
buyer_6,Manuel,45,ES56209598028877404654,TRX_N-00825-19064948,2023-11-29T11:33:31,Vitoria-Gasteiz,expenses,healthcare,-162.35,-34386.22
buyer_6,Manuel,45,ES56209598028877404654,TRX_N-00826-86953662,2023-11-29T09:28:43,Galdakao,expenses,repairs,-331.87,-34718.09
buyer_6,Manuel,45,ES56209598028877404654,TRX_N-00827-38481096,2023-12-01T07:53:01,Vitoria-Gasteiz,incomes,salary,1515.3,-33202.79
buyer_6,Manuel,45,ES56209598028877404654,TRX_N-00828-36472885,2023-12-01T07:53:01,Vitoria-Gasteiz,incomes,salary_partner,1432.54,-31770.25
buyer_6,Manuel,45,ES56209598028877404654,TRX_N-00829-64960468,2023-12-01T07:53:01,Vitoria-Gasteiz,incomes,extra_income,178.24,-31592.01
buyer_6,Manuel,45,ES56209598028877404654,TRX_N-00830-21580113,2023-12-01T07:53:01,Vitoria-Gasteiz,incomes,salary_bonus,1161.06,-30430.95
buyer_6,Manuel,45,ES56209598028877404654,TRX_N-00831-02744092,2023-12-01T07:53:01,Vitoria-Gasteiz,incomes,salary_partner_bonus,1091.58,-29339.37
buyer_6,Manuel,45,ES56209598028877404654,TRX_N-00832-77569634,2023-12-01T15:30:17,Vitoria-Gasteiz,expenses,food,-67.37,-29406.74
buyer_6,Manuel,45,ES56209598028877404654,TRX_N-00833-74004941,2023-12-01T15:32:41,Vitoria-Gasteiz,expenses,clothing,-147.97,-29554.71
buyer_6,Manuel,45,ES56209598028877404654,TRX_N-00834-40652620,2023-12-03T16:29:17,Vitoria-Gasteiz,expenses,food,-62.21,-29616.92
buyer_6,Manuel,45,ES56209598028877404654,TRX_N-00835-91211748,2023-12-03T14:40:02,Vitoria-Gasteiz,expenses,gifts,-183.16,-29800.08
buyer_6,Manuel,45,ES56209598028877404654,TRX_N-00836-05648017,2023-12-04T23:54:35,Vitoria-Gasteiz,expenses,mortgage,-718.03,-30518.11
buyer_6,Manuel,45,ES56209598028877404654,TRX_N-00837-15633491,2023-12-04T08:13:57,Vitoria-Gasteiz,expenses,transport,-65.67,-30583.78
buyer_6,Manuel,45,ES56209598028877404654,TRX_N-00838-97313243,2023-12-04T17:34:32,Vitoria-Gasteiz,expenses,leisure,-19.58,-30603.36
buyer_6,Manuel,45,ES56209598028877404654,TRX_N-00839-04455820,2023-12-05T18:35:09,Vitoria-Gasteiz,expenses,gas,-72.87,-30676.23
buyer_6,Manuel,45,ES56209598028877404654,TRX_N-00840-99109856,2023-12-05T10:24:46,Vitoria-Gasteiz,expenses,food,-85.88,-30762.11
buyer_6,Manuel,45,ES56209598028877404654,TRX_N-00841-60046311,2023-12-05T16:12:15,Vitoria-Gasteiz,expenses,healthcare,-152.19,-30914.3
buyer_6,Manuel,45,ES56209598028877404654,TRX_N-00842-01401869,2023-12-06T17:01:08,Vitoria-Gasteiz,expenses,electricity,-58.69,-30972.99
buyer_6,Manuel,45,ES56209598028877404654,TRX_N-00843-78587802,2023-12-06T20:14:59,Vitoria-Gasteiz,expenses,phone,-41.19,-31014.18
buyer_6,Manuel,45,ES56209598028877404654,TRX_N-00844-33529744,2023-12-06T12:50:23,Vitoria-Gasteiz,expenses,children,-182.95,-31197.13
buyer_6,Manuel,45,ES56209598028877404654,TRX_N-00845-92830201,2023-12-07T07:31:46,Vitoria-Gasteiz,expenses,water,-23.79,-31220.92
buyer_6,Manuel,45,ES56209598028877404654,TRX_N-00846-99075940,2023-12-07T21:15:48,Vitoria-Gasteiz,expenses,clothing,-48.39,-31269.31
buyer_6,Manuel,45,ES56209598028877404654,TRX_N-00847-56093362,2023-12-08T10:48:42,Vitoria-Gasteiz,expenses,internet,-42.0,-31311.31
buyer_6,Manuel,45,ES56209598028877404654,TRX_N-00848-53974203,2023-12-08T18:34:58,Vitoria-Gasteiz,expenses,healthcare,-169.69,-31481.0
buyer_6,Manuel,45,ES56209598028877404654,TRX_N-00849-70317558,2023-12-09T21:22:38,Vitoria-Gasteiz,expenses,transport,-82.27,-31563.27
buyer_6,Manuel,45,ES56209598028877404654,TRX_N-00850-55750389,2023-12-09T16:13:23,Vitoria-Gasteiz,expenses,clothing,-110.35,-31673.62
buyer_6,Manuel,45,ES56209598028877404654,TRX_N-00851-51724334,2023-12-10T12:27:07,Vitoria-Gasteiz,expenses,food,-108.73,-31782.35
buyer_6,Manuel,45,ES56209598028877404654,TRX_N-00852-80314535,2023-12-10T17:43:55,Vitoria-Gasteiz,expenses,cash,-100.0,-31882.35
buyer_6,Manuel,45,ES56209598028877404654,TRX_N-00853-05691080,2023-12-12T17:45:09,Vitoria-Gasteiz,expenses,leisure,-79.8,-31962.15
buyer_6,Manuel,45,ES56209598028877404654,TRX_N-00854-65377673,2023-12-12T16:11:41,Donostia,expenses,cash,-100.0,-32062.15
buyer_6,Manuel,45,ES56209598028877404654,TRX_N-00855-02078500,2023-12-14T15:38:07,Vitoria-Gasteiz,expenses,food,-100.79,-32162.94
buyer_6,Manuel,45,ES56209598028877404654,TRX_N-00856-13190400,2023-12-16T13:03:10,Vitoria-Gasteiz,expenses,leisure,-26.32,-32189.26
buyer_6,Manuel,45,ES56209598028877404654,TRX_N-00857-14740123,2023-12-16T12:06:02,Vitoria-Gasteiz,expenses,clothing,-77.79,-32267.05
buyer_6,Manuel,45,ES56209598028877404654,TRX_N-00858-95343569,2023-12-20T18:19:29,Vitoria-Gasteiz,expenses,transport,-40.66,-32307.71
buyer_6,Manuel,45,ES56209598028877404654,TRX_N-00859-31883379,2023-12-21T18:35:33,Vitoria-Gasteiz,expenses,cash,-100.0,-32407.71
buyer_6,Manuel,45,ES56209598028877404654,TRX_N-00860-00215729,2023-12-24T20:07:17,Vitoria-Gasteiz,expenses,repairs,-31.36,-32439.07
buyer_6,Manuel,45,ES56209598028877404654,TRX_N-00861-09466167,2023-12-24T14:26:11,Vitoria-Gasteiz,expenses,children,-182.66,-32621.73
buyer_6,Manuel,45,ES56209598028877404654,TRX_N-00862-28112704,2023-12-25T17:32:08,Oyón-Oion,expenses,food,-66.36,-32688.09
buyer_6,Manuel,45,ES56209598028877404654,TRX_N-00863-79061399,2023-12-26T01:49:47,Vitoria-Gasteiz,expenses,food,-111.94,-32800.03
buyer_6,Manuel,45,ES56209598028877404654,TRX_N-00864-97747132,2023-12-28T05:27:44,Lasarte-Oria,expenses,leisure,-61.84,-32861.87
buyer_6,Manuel,45,ES56209598028877404654,TRX_N-00865-14765361,2023-12-29T12:28:12,Leioa,expenses,cash,-100.0,-32961.87
buyer_6,Manuel,45,ES56209598028877404654,TRX_N-00866-94890751,2023-12-30T23:08:10,Vitoria-Gasteiz,expenses,transport,-57.22,-33019.09
buyer_6,Manuel,45,ES56209598028877404654,TRX_N-00867-31803450,2023-12-30T13:14:47,Vitoria-Gasteiz,expenses,education,-61.95,-33081.04
buyer_6,Manuel,45,ES56209598028877404654,TRX_N-00868-33116588,2023-12-30T14:38:56,Vitoria-Gasteiz,expenses,repairs,-193.47,-33274.51
buyer_6,Manuel,45,ES56209598028877404654,TRX_N-00869-20917912,2023-12-31T14:10:14,Vitoria-Gasteiz,expenses,leisure,-68.98,-33343.49
buyer_6,Manuel,45,ES56209598028877404654,TRX_N-00870-24120242,2023-12-31T15:45:54,Vitoria-Gasteiz,expenses,cash,-100.0,-33443.49
buyer_6,Manuel,45,ES56209598028877404654,TRX_N-00871-22700610,2024-01-01T11:01:27,Vitoria-Gasteiz,incomes,salary,1560.12,-31883.37
buyer_6,Manuel,45,ES56209598028877404654,TRX_N-00872-62318831,2024-01-01T11:01:27,Vitoria-Gasteiz,incomes,salary_partner,1474.91,-30408.46
buyer_6,Manuel,45,ES56209598028877404654,TRX_N-00873-78935668,2024-01-04T15:21:38,Vitoria-Gasteiz,expenses,mortgage,-718.03,-31126.49
buyer_6,Manuel,45,ES56209598028877404654,TRX_N-00874-78529758,2024-01-05T14:40:47,Vitoria-Gasteiz,expenses,electricity,-79.18,-31205.67
buyer_6,Manuel,45,ES56209598028877404654,TRX_N-00875-17250220,2024-01-05T08:46:25,Vitoria-Gasteiz,expenses,repairs,-69.84,-31275.51
buyer_6,Manuel,45,ES56209598028877404654,TRX_N-00876-37374078,2024-01-05T10:59:40,Vitoria-Gasteiz,expenses,gifts,-79.66,-31355.17
buyer_6,Manuel,45,ES56209598028877404654,TRX_N-00877-05538712,2024-01-06T12:42:37,Vitoria-Gasteiz,expenses,water,-27.02,-31382.19
buyer_6,Manuel,45,ES56209598028877404654,TRX_N-00878-94555433,2024-01-06T19:39:49,Vitoria-Gasteiz,expenses,gas,-68.77,-31450.96
buyer_6,Manuel,45,ES56209598028877404654,TRX_N-00879-09779417,2024-01-08T11:34:13,Vitoria-Gasteiz,expenses,phone,-36.59,-31487.55
buyer_6,Manuel,45,ES56209598028877404654,TRX_N-00880-52027828,2024-01-08T01:54:43,Vitoria-Gasteiz,expenses,internet,-42.0,-31529.55
buyer_6,Manuel,45,ES56209598028877404654,TRX_N-00881-21942885,2024-01-08T08:46:12,Vitoria-Gasteiz,expenses,repairs,-149.7,-31679.25
buyer_6,Manuel,45,ES56209598028877404654,TRX_N-00882-07148765,2024-01-08T00:22:30,Vitoria-Gasteiz,expenses,children,-173.08,-31852.33
buyer_6,Manuel,45,ES56209598028877404654,TRX_N-00883-32798513,2024-01-09T11:25:22,Pasaia,expenses,leisure,-39.03,-31891.36
buyer_6,Manuel,45,ES56209598028877404654,TRX_N-00884-56792943,2024-01-09T19:58:10,Vitoria-Gasteiz,expenses,cash,-100.0,-31991.36
buyer_6,Manuel,45,ES56209598028877404654,TRX_N-00885-66221016,2024-01-10T08:37:51,Vitoria-Gasteiz,expenses,education,-62.47,-32053.83
buyer_6,Manuel,45,ES56209598028877404654,TRX_N-00886-90326129,2024-01-11T09:34:27,Vitoria-Gasteiz,expenses,clothing,-154.68,-32208.51
buyer_6,Manuel,45,ES56209598028877404654,TRX_N-00887-08542698,2024-01-14T06:11:25,Vitoria-Gasteiz,expenses,education,-76.45,-32284.96
buyer_6,Manuel,45,ES56209598028877404654,TRX_N-00888-68998244,2024-01-14T12:46:57,Vitoria-Gasteiz,expenses,cash,-100.0,-32384.96
buyer_6,Manuel,45,ES56209598028877404654,TRX_N-00889-25514255,2024-01-14T12:06:43,Durango,expenses,gifts,-418.64,-32803.6
buyer_6,Manuel,45,ES56209598028877404654,TRX_N-00890-36972116,2024-01-18T21:52:47,Vitoria-Gasteiz,expenses,transport,-78.46,-32882.06
buyer_6,Manuel,45,ES56209598028877404654,TRX_N-00891-51855499,2024-01-18T10:05:42,Vitoria-Gasteiz,expenses,clothing,-144.74,-33026.8
buyer_6,Manuel,45,ES56209598028877404654,TRX_N-00892-09712075,2024-01-19T19:27:09,Vitoria-Gasteiz,expenses,gifts,-633.75,-33660.55
buyer_6,Manuel,45,ES56209598028877404654,TRX_N-00893-80269839,2024-01-20T11:07:34,Vitoria-Gasteiz,expenses,transport,-57.97,-33718.52
buyer_6,Manuel,45,ES56209598028877404654,TRX_N-00894-52102236,2024-01-20T12:15:03,Vitoria-Gasteiz,expenses,leisure,-22.1,-33740.62
buyer_6,Manuel,45,ES56209598028877404654,TRX_N-00895-10891101,2024-01-24T09:08:08,Vitoria-Gasteiz,expenses,food,-79.05,-33819.67
buyer_6,Manuel,45,ES56209598028877404654,TRX_N-00896-91238092,2024-01-24T16:51:10,Vitoria-Gasteiz,expenses,leisure,-49.45,-33869.12
buyer_6,Manuel,45,ES56209598028877404654,TRX_N-00897-45831797,2024-01-28T16:42:41,Vitoria-Gasteiz,expenses,cash,-100.0,-33969.12
buyer_6,Manuel,45,ES56209598028877404654,TRX_N-00898-53306862,2024-01-29T18:48:37,Vitoria-Gasteiz,expenses,transport,-68.63,-34037.75
buyer_6,Manuel,45,ES56209598028877404654,TRX_N-00899-95738296,2024-01-30T15:50:27,Vitoria-Gasteiz,expenses,children,-261.76,-34299.51
buyer_6,Manuel,45,ES56209598028877404654,TRX_N-00900-97379305,2024-01-31T15:19:44,Elciego,expenses,food,-72.23,-34371.74
buyer_6,Manuel,45,ES56209598028877404654,TRX_N-00901-28534310,2024-02-01T20:30:24,Vitoria-Gasteiz,incomes,salary,1560.12,-32811.62
buyer_6,Manuel,45,ES56209598028877404654,TRX_N-00902-10849504,2024-02-01T20:30:24,Vitoria-Gasteiz,incomes,salary_partner,1474.91,-31336.71
buyer_6,Manuel,45,ES56209598028877404654,TRX_N-00903-25746459,2024-02-01T14:58:04,Vitoria-Gasteiz,expenses,cash,-100.0,-31436.71
buyer_6,Manuel,45,ES56209598028877404654,TRX_N-00904-03159633,2024-02-04T20:13:04,Vitoria-Gasteiz,expenses,mortgage,-718.03,-32154.74
buyer_6,Manuel,45,ES56209598028877404654,TRX_N-00905-28731156,2024-02-04T15:50:28,Andoain,expenses,cash,-100.0,-32254.74
buyer_6,Manuel,45,ES56209598028877404654,TRX_N-00906-94114069,2024-02-05T08:29:30,Vitoria-Gasteiz,expenses,water,-20.77,-32275.51
buyer_6,Manuel,45,ES56209598028877404654,TRX_N-00907-27428146,2024-02-05T19:12:28,Vitoria-Gasteiz,expenses,internet,-42.0,-32317.51
buyer_6,Manuel,45,ES56209598028877404654,TRX_N-00908-96894660,2024-02-05T13:00:46,Vitoria-Gasteiz,expenses,phone,-30.8,-32348.31
buyer_6,Manuel,45,ES56209598028877404654,TRX_N-00909-41783212,2024-02-05T19:59:57,Vitoria-Gasteiz,expenses,gifts,-696.6,-33044.91
buyer_6,Manuel,45,ES56209598028877404654,TRX_N-00910-01351731,2024-02-08T18:22:05,Vitoria-Gasteiz,expenses,electricity,-43.61,-33088.52
buyer_6,Manuel,45,ES56209598028877404654,TRX_N-00911-92685998,2024-02-08T16:38:33,Vitoria-Gasteiz,expenses,gas,-65.08,-33153.6
buyer_6,Manuel,45,ES56209598028877404654,TRX_N-00912-97622702,2024-02-08T23:49:40,Vitoria-Gasteiz,expenses,food,-79.64,-33233.24
buyer_6,Manuel,45,ES56209598028877404654,TRX_N-00913-62400308,2024-02-09T15:08:09,Vitoria-Gasteiz,expenses,food,-110.59,-33343.83
buyer_6,Manuel,45,ES56209598028877404654,TRX_N-00914-58976130,2024-02-11T16:13:29,Vitoria-Gasteiz,expenses,education,-44.23,-33388.06
buyer_6,Manuel,45,ES56209598028877404654,TRX_N-00915-34508225,2024-02-11T14:03:18,Vitoria-Gasteiz,expenses,cash,-100.0,-33488.06
buyer_6,Manuel,45,ES56209598028877404654,TRX_N-00916-83491508,2024-02-12T20:07:13,Vitoria-Gasteiz,expenses,cash,-100.0,-33588.06
buyer_6,Manuel,45,ES56209598028877404654,TRX_N-00917-02776589,2024-02-13T12:05:05,Vitoria-Gasteiz,expenses,transport,-80.82,-33668.88
buyer_6,Manuel,45,ES56209598028877404654,TRX_N-00918-41515277,2024-02-14T15:06:11,Vitoria-Gasteiz,expenses,food,-95.11,-33763.99
buyer_6,Manuel,45,ES56209598028877404654,TRX_N-00919-27429921,2024-02-16T16:06:39,Vitoria-Gasteiz,expenses,gifts,-829.41,-34593.4
buyer_6,Manuel,45,ES56209598028877404654,TRX_N-00920-05513987,2024-02-17T04:44:09,Oyón-Oion,expenses,transport,-67.29,-34660.69
buyer_6,Manuel,45,ES56209598028877404654,TRX_N-00921-99159304,2024-02-19T15:43:00,Vitoria-Gasteiz,expenses,appliances,-200.54,-34861.23
buyer_6,Manuel,45,ES56209598028877404654,TRX_N-00922-42728077,2024-02-20T12:20:47,Eibar,expenses,food,-62.13,-34923.36
buyer_6,Manuel,45,ES56209598028877404654,TRX_N-00923-89392562,2024-02-21T17:38:26,Vitoria-Gasteiz,expenses,cash,-100.0,-35023.36
buyer_6,Manuel,45,ES56209598028877404654,TRX_N-00924-66689484,2024-02-21T16:38:44,Vitoria-Gasteiz,expenses,children,-113.24,-35136.6
buyer_6,Manuel,45,ES56209598028877404654,TRX_N-00925-49273712,2024-02-22T08:22:53,Vitoria-Gasteiz,expenses,cash,-100.0,-35236.6
buyer_6,Manuel,45,ES56209598028877404654,TRX_N-00926-59597444,2024-02-22T19:13:38,Vitoria-Gasteiz,expenses,repairs,-98.35,-35334.95
buyer_6,Manuel,45,ES56209598028877404654,TRX_N-00927-99978008,2024-02-24T16:57:29,Vitoria-Gasteiz,expenses,repairs,-148.0,-35482.95
buyer_6,Manuel,45,ES56209598028877404654,TRX_N-00928-64143043,2024-02-26T09:56:12,Vitoria-Gasteiz,expenses,leisure,-64.22,-35547.17
buyer_6,Manuel,45,ES56209598028877404654,TRX_N-00929-60609352,2024-02-28T13:49:57,Vitoria-Gasteiz,expenses,repairs,-73.3,-35620.47
buyer_6,Manuel,45,ES56209598028877404654,TRX_N-00930-38805112,2024-02-29T10:04:30,Vitoria-Gasteiz,expenses,leisure,-24.31,-35644.78
buyer_6,Manuel,45,ES56209598028877404654,TRX_N-00931-10588586,2024-03-01T10:10:03,Vitoria-Gasteiz,incomes,salary,1560.12,-34084.66
buyer_6,Manuel,45,ES56209598028877404654,TRX_N-00932-61786210,2024-03-01T10:10:03,Vitoria-Gasteiz,incomes,salary_partner,1474.91,-32609.75
buyer_6,Manuel,45,ES56209598028877404654,TRX_N-00933-01114469,2024-03-01T10:10:03,Vitoria-Gasteiz,incomes,extra_income,178.24,-32431.51
buyer_6,Manuel,45,ES56209598028877404654,TRX_N-00934-67658323,2024-03-01T09:04:09,Vitoria-Gasteiz,expenses,transport,-50.73,-32482.24
buyer_6,Manuel,45,ES56209598028877404654,TRX_N-00935-13200090,2024-03-03T09:45:30,Vitoria-Gasteiz,expenses,leisure,-40.63,-32522.87
buyer_6,Manuel,45,ES56209598028877404654,TRX_N-00936-10665963,2024-03-04T15:41:05,Vitoria-Gasteiz,expenses,mortgage,-718.03,-33240.9
buyer_6,Manuel,45,ES56209598028877404654,TRX_N-00937-19265417,2024-03-05T20:05:10,Vitoria-Gasteiz,expenses,water,-25.62,-33266.52
buyer_6,Manuel,45,ES56209598028877404654,TRX_N-00938-49506738,2024-03-05T16:21:41,Vitoria-Gasteiz,expenses,gas,-109.01,-33375.53
buyer_6,Manuel,45,ES56209598028877404654,TRX_N-00939-37843718,2024-03-05T15:49:02,Vitoria-Gasteiz,expenses,internet,-42.0,-33417.53
buyer_6,Manuel,45,ES56209598028877404654,TRX_N-00940-51008550,2024-03-07T10:37:03,Vitoria-Gasteiz,expenses,phone,-42.89,-33460.42
buyer_6,Manuel,45,ES56209598028877404654,TRX_N-00941-48287110,2024-03-07T14:08:34,Vitoria-Gasteiz,expenses,leisure,-30.1,-33490.52
buyer_6,Manuel,45,ES56209598028877404654,TRX_N-00942-61933431,2024-03-08T11:16:16,Vitoria-Gasteiz,expenses,electricity,-23.43,-33513.95
buyer_6,Manuel,45,ES56209598028877404654,TRX_N-00943-41730272,2024-03-09T17:08:02,Iruña de Oca,expenses,clothing,-147.29,-33661.24
buyer_6,Manuel,45,ES56209598028877404654,TRX_N-00944-02202496,2024-03-11T15:11:14,Vitoria-Gasteiz,expenses,education,-74.3,-33735.54
buyer_6,Manuel,45,ES56209598028877404654,TRX_N-00945-72252306,2024-03-14T01:23:41,Hondarribia,expenses,cash,-100.0,-33835.54
buyer_6,Manuel,45,ES56209598028877404654,TRX_N-00946-96415172,2024-03-15T14:00:30,Vitoria-Gasteiz,expenses,leisure,-59.74,-33895.28
buyer_6,Manuel,45,ES56209598028877404654,TRX_N-00947-40169309,2024-03-15T17:34:00,Vitoria-Gasteiz,expenses,gifts,-237.55,-34132.83
buyer_6,Manuel,45,ES56209598028877404654,TRX_N-00948-47031029,2024-03-17T02:22:36,Hondarribia,expenses,clothing,-149.34,-34282.17
buyer_6,Manuel,45,ES56209598028877404654,TRX_N-00949-81315145,2024-03-18T17:48:18,Vitoria-Gasteiz,expenses,leisure,-24.66,-34306.83
buyer_6,Manuel,45,ES56209598028877404654,TRX_N-00950-15598787,2024-03-18T19:44:52,Vitoria-Gasteiz,expenses,clothing,-95.41,-34402.24
buyer_6,Manuel,45,ES56209598028877404654,TRX_N-00951-19788551,2024-03-18T13:19:25,Vitoria-Gasteiz,expenses,education,-70.66,-34472.9
buyer_6,Manuel,45,ES56209598028877404654,TRX_N-00952-35006428,2024-03-19T14:50:42,Vitoria-Gasteiz,expenses,transport,-40.07,-34512.97
buyer_6,Manuel,45,ES56209598028877404654,TRX_N-00953-75709929,2024-03-19T15:29:31,Getxo,expenses,cash,-100.0,-34612.97
buyer_6,Manuel,45,ES56209598028877404654,TRX_N-00954-88852932,2024-03-20T15:30:20,Eibar,expenses,leisure,-84.96,-34697.93
buyer_6,Manuel,45,ES56209598028877404654,TRX_N-00955-49375780,2024-03-21T22:49:02,Barakaldo,expenses,food,-108.66,-34806.59
buyer_6,Manuel,45,ES56209598028877404654,TRX_N-00956-57850963,2024-03-21T19:33:52,Vitoria-Gasteiz,expenses,transport,-45.12,-34851.71
buyer_6,Manuel,45,ES56209598028877404654,TRX_N-00957-96850853,2024-03-21T09:06:22,Vitoria-Gasteiz,expenses,travel,-1312.48,-36164.19
buyer_6,Manuel,45,ES56209598028877404654,TRX_N-00958-18790072,2024-03-22T09:34:44,Vitoria-Gasteiz,expenses,repairs,-329.59,-36493.78
buyer_6,Manuel,45,ES56209598028877404654,TRX_N-00959-59380922,2024-03-23T16:55:20,Vitoria-Gasteiz,expenses,transport,-76.62,-36570.4
buyer_6,Manuel,45,ES56209598028877404654,TRX_N-00960-22666362,2024-03-23T10:09:27,Vitoria-Gasteiz,expenses,leisure,-65.1,-36635.5
buyer_6,Manuel,45,ES56209598028877404654,TRX_N-00961-75915285,2024-03-25T18:55:22,Vitoria-Gasteiz,expenses,leisure,-49.33,-36684.83
buyer_6,Manuel,45,ES56209598028877404654,TRX_N-00962-60966206,2024-03-26T19:52:18,Vitoria-Gasteiz,expenses,food,-88.49,-36773.32
buyer_6,Manuel,45,ES56209598028877404654,TRX_N-00963-63129995,2024-03-28T18:15:19,Vitoria-Gasteiz,expenses,food,-71.16,-36844.48
buyer_6,Manuel,45,ES56209598028877404654,TRX_N-00964-89340511,2024-03-28T21:35:49,Vitoria-Gasteiz,expenses,leisure,-24.46,-36868.94
buyer_6,Manuel,45,ES56209598028877404654,TRX_N-00965-69081332,2024-03-28T13:50:25,Bermeo,expenses,cash,-100.0,-36968.94
buyer_6,Manuel,45,ES56209598028877404654,TRX_N-00966-88512632,2024-03-28T03:09:57,Vitoria-Gasteiz,expenses,repairs,-291.73,-37260.67
buyer_6,Manuel,45,ES56209598028877404654,TRX_N-00967-44017129,2024-03-29T17:07:04,Vitoria-Gasteiz,expenses,leisure,-43.37,-37304.04
buyer_6,Manuel,45,ES56209598028877404654,TRX_N-00968-24724776,2024-04-01T09:28:33,Vitoria-Gasteiz,incomes,salary,1560.12,-35743.92
buyer_6,Manuel,45,ES56209598028877404654,TRX_N-00969-53194650,2024-04-01T09:28:33,Vitoria-Gasteiz,incomes,salary_partner,1474.91,-34269.01
buyer_6,Manuel,45,ES56209598028877404654,TRX_N-00970-07234759,2024-04-04T20:00:18,Vitoria-Gasteiz,expenses,mortgage,-718.03,-34987.04
buyer_6,Manuel,45,ES56209598028877404654,TRX_N-00971-84111710,2024-04-04T12:48:00,Alegría-Dulantzi,expenses,leisure,-83.23,-35070.27
buyer_6,Manuel,45,ES56209598028877404654,TRX_N-00972-38397137,2024-04-04T22:57:06,Vitoria-Gasteiz,expenses,education,-56.91,-35127.18
buyer_6,Manuel,45,ES56209598028877404654,TRX_N-00973-83348649,2024-04-05T15:17:42,Vitoria-Gasteiz,expenses,cash,-100.0,-35227.18
buyer_6,Manuel,45,ES56209598028877404654,TRX_N-00974-52238891,2024-04-07T15:45:02,Vitoria-Gasteiz,expenses,gifts,-51.18,-35278.36
buyer_6,Manuel,45,ES56209598028877404654,TRX_N-00975-44589400,2024-04-08T19:00:06,Vitoria-Gasteiz,expenses,water,-34.5,-35312.86
buyer_6,Manuel,45,ES56209598028877404654,TRX_N-00976-56878972,2024-04-08T14:02:47,Vitoria-Gasteiz,expenses,electricity,-80.08,-35392.94
buyer_6,Manuel,45,ES56209598028877404654,TRX_N-00977-82085183,2024-04-08T22:08:51,Vitoria-Gasteiz,expenses,gas,-68.24,-35461.18
buyer_6,Manuel,45,ES56209598028877404654,TRX_N-00978-17994168,2024-04-08T11:21:30,Vitoria-Gasteiz,expenses,internet,-42.0,-35503.18
buyer_6,Manuel,45,ES56209598028877404654,TRX_N-00979-53445739,2024-04-08T20:10:29,Vitoria-Gasteiz,expenses,phone,-30.06,-35533.24
buyer_6,Manuel,45,ES56209598028877404654,TRX_N-00980-89711545,2024-04-09T16:57:23,Vitoria-Gasteiz,expenses,gifts,-89.79,-35623.03
buyer_6,Manuel,45,ES56209598028877404654,TRX_N-00981-12944993,2024-04-10T05:18:15,Vitoria-Gasteiz,expenses,food,-87.7,-35710.73
buyer_6,Manuel,45,ES56209598028877404654,TRX_N-00982-19465845,2024-04-10T11:12:37,Vitoria-Gasteiz,expenses,appliances,-358.49,-36069.22
buyer_6,Manuel,45,ES56209598028877404654,TRX_N-00983-88587178,2024-04-11T16:07:27,Vitoria-Gasteiz,expenses,leisure,-68.21,-36137.43
buyer_6,Manuel,45,ES56209598028877404654,TRX_N-00984-65322524,2024-04-14T08:08:18,Vitoria-Gasteiz,expenses,cash,-100.0,-36237.43
buyer_6,Manuel,45,ES56209598028877404654,TRX_N-00985-54387882,2024-04-14T14:03:31,Vitoria-Gasteiz,expenses,children,-186.57,-36424.0
buyer_6,Manuel,45,ES56209598028877404654,TRX_N-00986-86357156,2024-04-17T09:05:15,Vitoria-Gasteiz,expenses,food,-120.04,-36544.04
buyer_6,Manuel,45,ES56209598028877404654,TRX_N-00987-71723312,2024-04-17T13:55:45,Vitoria-Gasteiz,expenses,repairs,-151.74,-36695.78
buyer_6,Manuel,45,ES56209598028877404654,TRX_N-00988-60513631,2024-04-19T21:12:00,Vitoria-Gasteiz,expenses,leisure,-30.65,-36726.43
buyer_6,Manuel,45,ES56209598028877404654,TRX_N-00989-90446567,2024-04-19T21:19:59,Vitoria-Gasteiz,expenses,cash,-100.0,-36826.43
buyer_6,Manuel,45,ES56209598028877404654,TRX_N-00990-92669790,2024-04-20T14:06:47,Vitoria-Gasteiz,expenses,clothing,-56.13,-36882.56
buyer_6,Manuel,45,ES56209598028877404654,TRX_N-00991-02812651,2024-04-21T16:57:08,Vitoria-Gasteiz,expenses,repairs,-315.55,-37198.11
buyer_6,Manuel,45,ES56209598028877404654,TRX_N-00992-39882615,2024-04-22T14:32:19,Vitoria-Gasteiz,expenses,food,-123.09,-37321.2
buyer_6,Manuel,45,ES56209598028877404654,TRX_N-00993-17139152,2024-04-22T09:32:15,Zuia,expenses,leisure,-61.23,-37382.43
buyer_6,Manuel,45,ES56209598028877404654,TRX_N-00994-80237883,2024-04-25T11:35:32,Vitoria-Gasteiz,expenses,cash,-100.0,-37482.43
buyer_6,Manuel,45,ES56209598028877404654,TRX_N-00995-75372550,2024-04-25T03:59:49,Vitoria-Gasteiz,expenses,repairs,-248.99,-37731.42
buyer_6,Manuel,45,ES56209598028877404654,TRX_N-00996-76401878,2024-04-26T10:42:04,Portugalete,expenses,leisure,-35.32,-37766.74
buyer_6,Manuel,45,ES56209598028877404654,TRX_N-00997-23119518,2024-04-26T08:26:44,Vitoria-Gasteiz,expenses,gifts,-193.94,-37960.68
buyer_6,Manuel,45,ES56209598028877404654,TRX_N-00998-03888890,2024-04-27T16:20:26,Vitoria-Gasteiz,expenses,food,-119.15,-38079.83
buyer_6,Manuel,45,ES56209598028877404654,TRX_N-00999-72050765,2024-04-29T14:45:57,Vitoria-Gasteiz,expenses,transport,-43.18,-38123.01
buyer_6,Manuel,45,ES56209598028877404654,TRX_N-01000-27708043,2024-04-30T09:08:14,Vitoria-Gasteiz,expenses,leisure,-72.57,-38195.58
buyer_6,Manuel,45,ES56209598028877404654,TRX_N-01001-38219673,2024-05-01T02:18:32,Vitoria-Gasteiz,incomes,salary,1560.12,-36635.46
buyer_6,Manuel,45,ES56209598028877404654,TRX_N-01002-45637221,2024-05-01T02:18:32,Vitoria-Gasteiz,incomes,salary_partner,1474.91,-35160.55
buyer_6,Manuel,45,ES56209598028877404654,TRX_N-01003-92617000,2024-05-01T07:03:17,Vitoria-Gasteiz,expenses,leisure,-51.64,-35212.19
buyer_6,Manuel,45,ES56209598028877404654,TRX_N-01004-83826438,2024-05-02T20:36:05,Vitoria-Gasteiz,expenses,food,-102.67,-35314.86
buyer_6,Manuel,45,ES56209598028877404654,TRX_N-01005-52229245,2024-05-03T21:50:14,Vitoria-Gasteiz,expenses,leisure,-71.44,-35386.3
buyer_6,Manuel,45,ES56209598028877404654,TRX_N-01006-13179233,2024-05-03T20:17:05,Vitoria-Gasteiz,expenses,healthcare,-41.27,-35427.57
buyer_6,Manuel,45,ES56209598028877404654,TRX_N-01007-82863511,2024-05-03T17:43:57,Vitoria-Gasteiz,expenses,education,-55.87,-35483.44
buyer_6,Manuel,45,ES56209598028877404654,TRX_N-01008-08337852,2024-05-04T06:37:13,Vitoria-Gasteiz,expenses,mortgage,-718.03,-36201.47
buyer_6,Manuel,45,ES56209598028877404654,TRX_N-01009-37222415,2024-05-05T16:51:01,Andoain,expenses,cash,-100.0,-36301.47
buyer_6,Manuel,45,ES56209598028877404654,TRX_N-01010-52078278,2024-05-06T04:14:29,Vitoria-Gasteiz,expenses,gas,-74.36,-36375.83
buyer_6,Manuel,45,ES56209598028877404654,TRX_N-01011-35253066,2024-05-06T17:24:43,Vitoria-Gasteiz,expenses,phone,-40.28,-36416.11
buyer_6,Manuel,45,ES56209598028877404654,TRX_N-01012-38841512,2024-05-06T10:30:44,Vitoria-Gasteiz,expenses,food,-82.44,-36498.55
buyer_6,Manuel,45,ES56209598028877404654,TRX_N-01013-49967218,2024-05-06T16:36:19,Vitoria-Gasteiz,expenses,leisure,-65.82,-36564.37
buyer_6,Manuel,45,ES56209598028877404654,TRX_N-01014-92800746,2024-05-07T11:46:00,Vitoria-Gasteiz,expenses,water,-33.45,-36597.82
buyer_6,Manuel,45,ES56209598028877404654,TRX_N-01015-14207758,2024-05-07T12:57:28,Vitoria-Gasteiz,expenses,cash,-100.0,-36697.82
buyer_6,Manuel,45,ES56209598028877404654,TRX_N-01016-24676776,2024-05-08T16:30:50,Vitoria-Gasteiz,expenses,electricity,-69.83,-36767.65
buyer_6,Manuel,45,ES56209598028877404654,TRX_N-01017-64429633,2024-05-08T18:34:17,Vitoria-Gasteiz,expenses,internet,-42.0,-36809.65
buyer_6,Manuel,45,ES56209598028877404654,TRX_N-01018-46462561,2024-05-09T16:59:28,Vitoria-Gasteiz,expenses,gifts,-618.54,-37428.19
buyer_6,Manuel,45,ES56209598028877404654,TRX_N-01019-81893413,2024-05-10T11:06:53,Vitoria-Gasteiz,expenses,leisure,-66.03,-37494.22
buyer_6,Manuel,45,ES56209598028877404654,TRX_N-01020-51157820,2024-05-11T18:24:01,Durango,expenses,repairs,-180.4,-37674.62
buyer_6,Manuel,45,ES56209598028877404654,TRX_N-01021-38049363,2024-05-13T16:01:59,Vitoria-Gasteiz,expenses,healthcare,-132.2,-37806.82
buyer_6,Manuel,45,ES56209598028877404654,TRX_N-01022-80726143,2024-05-16T15:20:14,Vitoria-Gasteiz,expenses,cash,-100.0,-37906.82
buyer_6,Manuel,45,ES56209598028877404654,TRX_N-01023-67926858,2024-05-17T20:19:27,Vitoria-Gasteiz,expenses,transport,-73.15,-37979.97
buyer_6,Manuel,45,ES56209598028877404654,TRX_N-01024-78437331,2024-05-17T09:11:33,Vitoria-Gasteiz,expenses,cash,-100.0,-38079.97
buyer_6,Manuel,45,ES56209598028877404654,TRX_N-01025-38243999,2024-05-18T10:01:00,Vitoria-Gasteiz,expenses,clothing,-53.83,-38133.8
buyer_6,Manuel,45,ES56209598028877404654,TRX_N-01026-96535399,2024-05-19T09:30:36,Vitoria-Gasteiz,expenses,food,-113.19,-38246.99
buyer_6,Manuel,45,ES56209598028877404654,TRX_N-01027-41718467,2024-05-19T11:08:45,Vitoria-Gasteiz,expenses,appliances,-371.2,-38618.19
buyer_6,Manuel,45,ES56209598028877404654,TRX_N-01028-01668578,2024-05-20T08:10:49,Vitoria-Gasteiz,expenses,food,-65.75,-38683.94
buyer_6,Manuel,45,ES56209598028877404654,TRX_N-01029-80205819,2024-05-20T11:06:01,Vitoria-Gasteiz,expenses,healthcare,-166.87,-38850.81
buyer_6,Manuel,45,ES56209598028877404654,TRX_N-01030-73290868,2024-05-21T09:19:13,Vitoria-Gasteiz,expenses,food,-84.67,-38935.48
buyer_6,Manuel,45,ES56209598028877404654,TRX_N-01031-89070517,2024-05-22T22:42:48,Elciego,expenses,transport,-75.62,-39011.1
buyer_6,Manuel,45,ES56209598028877404654,TRX_N-01032-10403599,2024-05-23T19:06:32,Vitoria-Gasteiz,expenses,repairs,-27.25,-39038.35
buyer_6,Manuel,45,ES56209598028877404654,TRX_N-01033-81126855,2024-05-24T09:14:16,Vitoria-Gasteiz,expenses,food,-87.88,-39126.23
buyer_6,Manuel,45,ES56209598028877404654,TRX_N-01034-10615467,2024-05-24T14:52:42,Vitoria-Gasteiz,expenses,cash,-100.0,-39226.23
buyer_6,Manuel,45,ES56209598028877404654,TRX_N-01035-59910715,2024-05-25T08:22:14,Vitoria-Gasteiz,expenses,food,-65.61,-39291.84
buyer_6,Manuel,45,ES56209598028877404654,TRX_N-01036-99462735,2024-05-27T12:55:46,Vitoria-Gasteiz,expenses,cash,-100.0,-39391.84
buyer_6,Manuel,45,ES56209598028877404654,TRX_N-01037-15282996,2024-05-27T09:04:38,Vitoria-Gasteiz,expenses,children,-218.66,-39610.5
buyer_6,Manuel,45,ES56209598028877404654,TRX_N-01038-84849530,2024-05-28T19:02:39,Vitoria-Gasteiz,expenses,transport,-73.05,-39683.55
buyer_6,Manuel,45,ES56209598028877404654,TRX_N-01039-10407526,2024-05-28T20:07:40,Leioa,expenses,leisure,-44.6,-39728.15
buyer_6,Manuel,45,ES56209598028877404654,TRX_N-01040-04622525,2024-05-28T19:59:00,Vitoria-Gasteiz,expenses,cash,-100.0,-39828.15
buyer_6,Manuel,45,ES56209598028877404654,TRX_N-01041-22654780,2024-05-29T12:36:55,Vitoria-Gasteiz,expenses,cash,-100.0,-39928.15
buyer_6,Manuel,45,ES56209598028877404654,TRX_N-01042-29979162,2024-05-30T21:35:59,Vitoria-Gasteiz,expenses,clothing,-122.12,-40050.27
buyer_6,Manuel,45,ES56209598028877404654,TRX_N-01043-76166582,2024-05-30T11:56:00,Vitoria-Gasteiz,expenses,education,-70.56,-40120.83
buyer_6,Manuel,45,ES56209598028877404654,TRX_N-01044-57411325,2024-06-01T12:43:35,Vitoria-Gasteiz,incomes,salary,1560.12,-38560.71
buyer_6,Manuel,45,ES56209598028877404654,TRX_N-01045-23388525,2024-06-01T12:43:35,Vitoria-Gasteiz,incomes,salary_partner,1474.91,-37085.8
buyer_6,Manuel,45,ES56209598028877404654,TRX_N-01046-37259952,2024-06-01T12:43:35,Vitoria-Gasteiz,incomes,extra_income,178.24,-36907.56
buyer_6,Manuel,45,ES56209598028877404654,TRX_N-01047-96554602,2024-06-01T12:43:35,Vitoria-Gasteiz,incomes,salary_bonus,1238.58,-35668.98
buyer_6,Manuel,45,ES56209598028877404654,TRX_N-01048-96208855,2024-06-01T12:43:35,Vitoria-Gasteiz,incomes,salary_partner_bonus,1043.16,-34625.82
buyer_6,Manuel,45,ES56209598028877404654,TRX_N-01049-44850007,2024-06-01T10:34:44,Vitoria-Gasteiz,expenses,leisure,-64.81,-34690.63
buyer_6,Manuel,45,ES56209598028877404654,TRX_N-01050-67532127,2024-06-04T12:21:30,Vitoria-Gasteiz,expenses,mortgage,-718.03,-35408.66
buyer_6,Manuel,45,ES56209598028877404654,TRX_N-01051-85907165,2024-06-05T11:00:43,Vitoria-Gasteiz,expenses,water,-22.35,-35431.01
buyer_6,Manuel,45,ES56209598028877404654,TRX_N-01052-55265554,2024-06-05T09:31:54,Vitoria-Gasteiz,expenses,gas,-63.47,-35494.48
buyer_6,Manuel,45,ES56209598028877404654,TRX_N-01053-01839670,2024-06-05T11:07:11,Vitoria-Gasteiz,expenses,gifts,-25.83,-35520.31
buyer_6,Manuel,45,ES56209598028877404654,TRX_N-01054-13902468,2024-06-06T11:44:27,Vitoria-Gasteiz,expenses,internet,-42.0,-35562.31
buyer_6,Manuel,45,ES56209598028877404654,TRX_N-01055-92510129,2024-06-06T15:37:23,Getxo,expenses,leisure,-49.79,-35612.1
buyer_6,Manuel,45,ES56209598028877404654,TRX_N-01056-60295276,2024-06-07T09:38:55,Vitoria-Gasteiz,expenses,electricity,-47.6,-35659.7
buyer_6,Manuel,45,ES56209598028877404654,TRX_N-01057-96216573,2024-06-08T06:50:05,Vitoria-Gasteiz,expenses,phone,-32.92,-35692.62
buyer_6,Manuel,45,ES56209598028877404654,TRX_N-01058-31734830,2024-06-08T20:02:21,Alegría-Dulantzi,expenses,food,-78.96,-35771.58
buyer_6,Manuel,45,ES56209598028877404654,TRX_N-01059-59081854,2024-06-08T21:00:18,Vitoria-Gasteiz,expenses,repairs,-307.84,-36079.42
buyer_6,Manuel,45,ES56209598028877404654,TRX_N-01060-35034729,2024-06-09T16:41:03,Vitoria-Gasteiz,expenses,gifts,-687.12,-36766.54
buyer_6,Manuel,45,ES56209598028877404654,TRX_N-01061-23650141,2024-06-10T20:55:37,Vitoria-Gasteiz,expenses,gifts,-285.98,-37052.52
buyer_6,Manuel,45,ES56209598028877404654,TRX_N-01062-09202007,2024-06-12T17:01:03,Vitoria-Gasteiz,expenses,clothing,-118.5,-37171.02
buyer_6,Manuel,45,ES56209598028877404654,TRX_N-01063-17468396,2024-06-12T08:50:56,Vitoria-Gasteiz,expenses,appliances,-350.75,-37521.77
buyer_6,Manuel,45,ES56209598028877404654,TRX_N-01064-82581305,2024-06-13T14:28:31,Errenteria,expenses,appliances,-324.64,-37846.41
buyer_6,Manuel,45,ES56209598028877404654,TRX_N-01065-82116737,2024-06-13T17:05:06,Vitoria-Gasteiz,expenses,gifts,-697.58,-38543.99
buyer_6,Manuel,45,ES56209598028877404654,TRX_N-01066-37039657,2024-06-14T00:28:50,Vitoria-Gasteiz,expenses,healthcare,-76.68,-38620.67
buyer_6,Manuel,45,ES56209598028877404654,TRX_N-01067-85243637,2024-06-14T10:16:48,Vitoria-Gasteiz,expenses,appliances,-217.62,-38838.29
buyer_6,Manuel,45,ES56209598028877404654,TRX_N-01068-34787791,2024-06-15T07:34:42,Getxo,expenses,gifts,-65.75,-38904.04
buyer_6,Manuel,45,ES56209598028877404654,TRX_N-01069-61925367,2024-06-16T16:28:35,Basauri,expenses,leisure,-69.94,-38973.98
buyer_6,Manuel,45,ES56209598028877404654,TRX_N-01070-79280737,2024-06-19T18:50:46,Berango,expenses,education,-49.09,-39023.07
buyer_6,Manuel,45,ES56209598028877404654,TRX_N-01071-19306582,2024-06-20T17:59:41,Portugalete,expenses,food,-61.51,-39084.58
buyer_6,Manuel,45,ES56209598028877404654,TRX_N-01072-26424547,2024-06-20T16:27:16,Vitoria-Gasteiz,expenses,clothing,-155.29,-39239.87
buyer_6,Manuel,45,ES56209598028877404654,TRX_N-01073-89812504,2024-06-20T12:00:25,Donostia,expenses,appliances,-397.36,-39637.23
buyer_6,Manuel,45,ES56209598028877404654,TRX_N-01074-05601250,2024-06-22T15:43:34,Vitoria-Gasteiz,expenses,food,-94.98,-39732.21
buyer_6,Manuel,45,ES56209598028877404654,TRX_N-01075-11922348,2024-06-23T19:19:30,Sopela,expenses,food,-61.01,-39793.22
buyer_6,Manuel,45,ES56209598028877404654,TRX_N-01076-81594795,2024-06-23T10:05:05,Vitoria-Gasteiz,expenses,transport,-66.59,-39859.81
buyer_6,Manuel,45,ES56209598028877404654,TRX_N-01077-90799906,2024-06-24T11:00:44,Vitoria-Gasteiz,expenses,education,-49.32,-39909.13
buyer_6,Manuel,45,ES56209598028877404654,TRX_N-01078-43811304,2024-06-25T16:53:23,Vitoria-Gasteiz,expenses,gifts,-793.34,-40702.47
buyer_6,Manuel,45,ES56209598028877404654,TRX_N-01079-58265161,2024-06-26T23:28:36,Vitoria-Gasteiz,expenses,transport,-71.03,-40773.5
buyer_6,Manuel,45,ES56209598028877404654,TRX_N-01080-91489326,2024-06-27T13:46:59,Vitoria-Gasteiz,expenses,leisure,-21.19,-40794.69
buyer_6,Manuel,45,ES56209598028877404654,TRX_N-01081-51366942,2024-06-28T13:53:44,Vitoria-Gasteiz,expenses,cash,-100.0,-40894.69
buyer_6,Manuel,45,ES56209598028877404654,TRX_N-01082-88122876,2024-06-29T14:52:08,Vitoria-Gasteiz,expenses,food,-114.5,-41009.19
buyer_6,Manuel,45,ES56209598028877404654,TRX_N-01083-12833445,2024-07-01T11:50:20,Vitoria-Gasteiz,incomes,salary,1560.12,-39449.07
buyer_6,Manuel,45,ES56209598028877404654,TRX_N-01084-27139783,2024-07-01T11:50:20,Vitoria-Gasteiz,incomes,salary_partner,1474.91,-37974.16
buyer_6,Manuel,45,ES56209598028877404654,TRX_N-01085-85186444,2024-07-01T19:41:02,Vitoria-Gasteiz,expenses,food,-101.43,-38075.59
buyer_6,Manuel,45,ES56209598028877404654,TRX_N-01086-08652319,2024-07-01T18:29:02,Vitoria-Gasteiz,expenses,cash,-100.0,-38175.59
buyer_6,Manuel,45,ES56209598028877404654,TRX_N-01087-35148991,2024-07-02T08:32:58,Vitoria-Gasteiz,expenses,repairs,-179.6,-38355.19
buyer_6,Manuel,45,ES56209598028877404654,TRX_N-01088-92837318,2024-07-03T19:42:36,Vitoria-Gasteiz,expenses,transport,-40.88,-38396.07
buyer_6,Manuel,45,ES56209598028877404654,TRX_N-01089-26728650,2024-07-03T12:37:48,Vitoria-Gasteiz,expenses,gifts,-809.86,-39205.93
buyer_6,Manuel,45,ES56209598028877404654,TRX_N-01090-19126211,2024-07-04T14:15:18,Vitoria-Gasteiz,expenses,mortgage,-718.03,-39923.96
buyer_6,Manuel,45,ES56209598028877404654,TRX_N-01091-92620923,2024-07-04T20:10:34,Vitoria-Gasteiz,expenses,food,-90.38,-40014.34
buyer_6,Manuel,45,ES56209598028877404654,TRX_N-01092-02109521,2024-07-04T14:57:08,Vitoria-Gasteiz,expenses,leisure,-19.68,-40034.02
buyer_6,Manuel,45,ES56209598028877404654,TRX_N-01093-14952759,2024-07-05T10:00:43,Vitoria-Gasteiz,expenses,electricity,-65.32,-40099.34
buyer_6,Manuel,45,ES56209598028877404654,TRX_N-01094-18857850,2024-07-05T09:57:57,Vitoria-Gasteiz,expenses,phone,-39.18,-40138.52
buyer_6,Manuel,45,ES56209598028877404654,TRX_N-01095-76334945,2024-07-05T16:24:51,Vitoria-Gasteiz,expenses,food,-79.99,-40218.51
buyer_6,Manuel,45,ES56209598028877404654,TRX_N-01096-08275102,2024-07-05T17:47:18,Vitoria-Gasteiz,expenses,clothing,-86.18,-40304.69
buyer_6,Manuel,45,ES56209598028877404654,TRX_N-01097-01264915,2024-07-06T20:00:26,Vitoria-Gasteiz,expenses,water,-23.28,-40327.97
buyer_6,Manuel,45,ES56209598028877404654,TRX_N-01098-44960546,2024-07-06T20:00:04,Vitoria-Gasteiz,expenses,leisure,-53.04,-40381.01
buyer_6,Manuel,45,ES56209598028877404654,TRX_N-01099-40608554,2024-07-06T11:28:17,Salvatierra/Agurain,expenses,healthcare,-81.06,-40462.07
buyer_6,Manuel,45,ES56209598028877404654,TRX_N-01100-99394771,2024-07-06T13:38:20,Basauri,expenses,education,-68.19,-40530.26
buyer_6,Manuel,45,ES56209598028877404654,TRX_N-01101-21552777,2024-07-06T09:39:33,Iruña de Oca,expenses,cash,-100.0,-40630.26
buyer_6,Manuel,45,ES56209598028877404654,TRX_N-01102-54402316,2024-07-07T12:20:43,Vitoria-Gasteiz,expenses,gas,-86.76,-40717.02
buyer_6,Manuel,45,ES56209598028877404654,TRX_N-01103-48645596,2024-07-07T21:58:56,Vitoria-Gasteiz,expenses,cash,-100.0,-40817.02
buyer_6,Manuel,45,ES56209598028877404654,TRX_N-01104-01988478,2024-07-07T18:46:37,Errenteria,expenses,appliances,-86.81,-40903.83
buyer_6,Manuel,45,ES56209598028877404654,TRX_N-01105-87340390,2024-07-08T08:17:38,Vitoria-Gasteiz,expenses,internet,-42.0,-40945.83
buyer_6,Manuel,45,ES56209598028877404654,TRX_N-01106-75076738,2024-07-08T18:02:06,Vitoria-Gasteiz,expenses,food,-112.85,-41058.68
buyer_6,Manuel,45,ES56209598028877404654,TRX_N-01107-29653066,2024-07-09T13:02:25,Vitoria-Gasteiz,expenses,leisure,-59.73,-41118.41
buyer_6,Manuel,45,ES56209598028877404654,TRX_N-01108-78963631,2024-07-12T18:16:57,Vitoria-Gasteiz,expenses,cash,-100.0,-41218.41
buyer_6,Manuel,45,ES56209598028877404654,TRX_N-01109-12778466,2024-07-13T09:02:18,Llodio,expenses,food,-94.77,-41313.18
buyer_6,Manuel,45,ES56209598028877404654,TRX_N-01110-61292530,2024-07-13T15:42:32,Arrasate,expenses,appliances,-96.01,-41409.19
buyer_6,Manuel,45,ES56209598028877404654,TRX_N-01111-81258810,2024-07-16T08:27:10,Vitoria-Gasteiz,expenses,clothing,-68.32,-41477.51
buyer_6,Manuel,45,ES56209598028877404654,TRX_N-01112-45192379,2024-07-17T15:07:49,Vitoria-Gasteiz,expenses,cash,-100.0,-41577.51
buyer_6,Manuel,45,ES56209598028877404654,TRX_N-01113-80290280,2024-07-17T08:38:55,Vitoria-Gasteiz,expenses,gifts,-720.79,-42298.3
buyer_6,Manuel,45,ES56209598028877404654,TRX_N-01114-59658671,2024-07-18T10:29:32,Vitoria-Gasteiz,expenses,food,-121.15,-42419.45
buyer_6,Manuel,45,ES56209598028877404654,TRX_N-01115-43508213,2024-07-18T14:18:29,Amurrio,expenses,leisure,-69.62,-42489.07
buyer_6,Manuel,45,ES56209598028877404654,TRX_N-01116-86696962,2024-07-21T18:07:51,Portugalete,expenses,healthcare,-129.81,-42618.88
buyer_6,Manuel,45,ES56209598028877404654,TRX_N-01117-42824636,2024-07-21T10:55:00,Hondarribia,expenses,gifts,-305.47,-42924.35
buyer_6,Manuel,45,ES56209598028877404654,TRX_N-01118-99636091,2024-07-22T12:23:05,Vitoria-Gasteiz,expenses,food,-82.88,-43007.23
buyer_6,Manuel,45,ES56209598028877404654,TRX_N-01119-90620140,2024-07-26T19:10:13,Vitoria-Gasteiz,expenses,cash,-100.0,-43107.23
buyer_6,Manuel,45,ES56209598028877404654,TRX_N-01120-39447899,2024-07-27T17:12:43,Oyón-Oion,expenses,healthcare,-55.0,-43162.23
buyer_6,Manuel,45,ES56209598028877404654,TRX_N-01121-63122891,2024-07-30T11:59:33,Vitoria-Gasteiz,expenses,leisure,-84.81,-43247.04
buyer_6,Manuel,45,ES56209598028877404654,TRX_N-01122-24174538,2024-08-01T12:57:11,Vitoria-Gasteiz,incomes,salary,1560.12,-41686.92
buyer_6,Manuel,45,ES56209598028877404654,TRX_N-01123-47775805,2024-08-01T12:57:11,Vitoria-Gasteiz,incomes,salary_partner,1474.91,-40212.01
buyer_6,Manuel,45,ES56209598028877404654,TRX_N-01124-99511433,2024-08-02T08:08:24,Vitoria-Gasteiz,expenses,leisure,-26.31,-40238.32
buyer_6,Manuel,45,ES56209598028877404654,TRX_N-01125-05947063,2024-08-03T09:25:05,Elciego,expenses,cash,-100.0,-40338.32
buyer_6,Manuel,45,ES56209598028877404654,TRX_N-01126-81675231,2024-08-03T11:27:50,Vitoria-Gasteiz,expenses,repairs,-96.77,-40435.09
buyer_6,Manuel,45,ES56209598028877404654,TRX_N-01127-07663301,2024-08-04T11:38:50,Vitoria-Gasteiz,expenses,mortgage,-718.03,-41153.12
buyer_6,Manuel,45,ES56209598028877404654,TRX_N-01128-94847646,2024-08-04T02:21:43,Lasarte-Oria,expenses,education,-67.14,-41220.26
buyer_6,Manuel,45,ES56209598028877404654,TRX_N-01129-43857838,2024-08-04T09:46:10,Hernani,expenses,travel,-1858.08,-43078.34
buyer_6,Manuel,45,ES56209598028877404654,TRX_N-01130-52247211,2024-08-05T01:37:47,Vitoria-Gasteiz,expenses,water,-43.97,-43122.31
buyer_6,Manuel,45,ES56209598028877404654,TRX_N-01131-12007434,2024-08-05T17:11:19,Vitoria-Gasteiz,expenses,electricity,-79.0,-43201.31
buyer_6,Manuel,45,ES56209598028877404654,TRX_N-01132-91316378,2024-08-05T19:53:39,Vitoria-Gasteiz,expenses,transport,-77.12,-43278.43
buyer_6,Manuel,45,ES56209598028877404654,TRX_N-01133-19709409,2024-08-06T19:31:51,Vitoria-Gasteiz,expenses,gas,-60.76,-43339.19
buyer_6,Manuel,45,ES56209598028877404654,TRX_N-01134-74601316,2024-08-07T23:59:43,Vitoria-Gasteiz,expenses,leisure,-53.67,-43392.86
buyer_6,Manuel,45,ES56209598028877404654,TRX_N-01135-55440256,2024-08-08T07:52:45,Vitoria-Gasteiz,expenses,internet,-42.0,-43434.86
buyer_6,Manuel,45,ES56209598028877404654,TRX_N-01136-13013455,2024-08-08T13:33:25,Vitoria-Gasteiz,expenses,phone,-42.22,-43477.08
buyer_6,Manuel,45,ES56209598028877404654,TRX_N-01137-78236984,2024-08-08T16:09:02,Lasarte-Oria,expenses,repairs,-176.29,-43653.37
buyer_6,Manuel,45,ES56209598028877404654,TRX_N-01138-43925669,2024-08-10T09:26:47,Vitoria-Gasteiz,expenses,appliances,-217.21,-43870.58
buyer_6,Manuel,45,ES56209598028877404654,TRX_N-01139-88101134,2024-08-11T17:15:41,Vitoria-Gasteiz,expenses,transport,-82.93,-43953.51
buyer_6,Manuel,45,ES56209598028877404654,TRX_N-01140-87064716,2024-08-12T16:11:07,Vitoria-Gasteiz,expenses,transport,-67.93,-44021.44
buyer_6,Manuel,45,ES56209598028877404654,TRX_N-01141-09179207,2024-08-12T19:08:56,Vitoria-Gasteiz,expenses,cash,-100.0,-44121.44
buyer_6,Manuel,45,ES56209598028877404654,TRX_N-01142-21641156,2024-08-13T20:59:59,Andoain,expenses,repairs,-256.83,-44378.27
buyer_6,Manuel,45,ES56209598028877404654,TRX_N-01143-14427020,2024-08-18T13:59:38,Vitoria-Gasteiz,expenses,cash,-100.0,-44478.27
buyer_6,Manuel,45,ES56209598028877404654,TRX_N-01144-20874479,2024-08-19T02:39:04,Vitoria-Gasteiz,expenses,cash,-100.0,-44578.27
buyer_6,Manuel,45,ES56209598028877404654,TRX_N-01145-35817754,2024-08-20T13:13:32,Vitoria-Gasteiz,expenses,transport,-75.89,-44654.16
buyer_6,Manuel,45,ES56209598028877404654,TRX_N-01146-28761823,2024-08-20T09:40:42,Vitoria-Gasteiz,expenses,leisure,-37.87,-44692.03
buyer_6,Manuel,45,ES56209598028877404654,TRX_N-01147-59268584,2024-08-20T17:01:17,Vitoria-Gasteiz,expenses,clothing,-145.43,-44837.46
buyer_6,Manuel,45,ES56209598028877404654,TRX_N-01148-62365393,2024-08-20T09:43:33,Vitoria-Gasteiz,expenses,cash,-100.0,-44937.46
buyer_6,Manuel,45,ES56209598028877404654,TRX_N-01149-59372312,2024-08-21T21:34:02,Vitoria-Gasteiz,expenses,leisure,-44.97,-44982.43
buyer_6,Manuel,45,ES56209598028877404654,TRX_N-01150-99942619,2024-08-22T09:07:52,Vitoria-Gasteiz,expenses,food,-120.47,-45102.9
buyer_6,Manuel,45,ES56209598028877404654,TRX_N-01151-29354311,2024-08-25T12:11:30,Vitoria-Gasteiz,expenses,cash,-100.0,-45202.9
buyer_6,Manuel,45,ES56209598028877404654,TRX_N-01152-26707362,2024-08-27T16:55:17,Vitoria-Gasteiz,expenses,transport,-71.59,-45274.49
buyer_6,Manuel,45,ES56209598028877404654,TRX_N-01153-15937802,2024-08-29T19:33:52,Vitoria-Gasteiz,expenses,food,-62.12,-45336.61
buyer_6,Manuel,45,ES56209598028877404654,TRX_N-01154-16660414,2024-08-29T08:29:30,Errenteria,expenses,repairs,-265.23,-45601.84
buyer_6,Manuel,45,ES56209598028877404654,TRX_N-01155-69901120,2024-08-30T19:51:51,Vitoria-Gasteiz,expenses,food,-120.02,-45721.86
buyer_6,Manuel,45,ES56209598028877404654,TRX_N-01156-50438602,2024-08-30T15:19:12,Leioa,expenses,transport,-65.01,-45786.87
buyer_6,Manuel,45,ES56209598028877404654,TRX_N-01157-23272394,2024-09-01T20:38:32,Vitoria-Gasteiz,incomes,salary,1560.12,-44226.75
buyer_6,Manuel,45,ES56209598028877404654,TRX_N-01158-06435642,2024-09-01T20:38:32,Vitoria-Gasteiz,incomes,salary_partner,1474.91,-42751.84
buyer_6,Manuel,45,ES56209598028877404654,TRX_N-01159-42855004,2024-09-01T20:38:32,Vitoria-Gasteiz,incomes,extra_income,178.24,-42573.6
buyer_6,Manuel,45,ES56209598028877404654,TRX_N-01160-74012921,2024-09-04T12:45:56,Vitoria-Gasteiz,expenses,mortgage,-718.03,-43291.63
buyer_6,Manuel,45,ES56209598028877404654,TRX_N-01161-95022688,2024-09-05T10:31:34,Alegría-Dulantzi,expenses,leisure,-64.84,-43356.47
buyer_6,Manuel,45,ES56209598028877404654,TRX_N-01162-88948897,2024-09-05T13:54:36,Vitoria-Gasteiz,expenses,gifts,-730.67,-44087.14
buyer_6,Manuel,45,ES56209598028877404654,TRX_N-01163-40350380,2024-09-06T08:54:17,Vitoria-Gasteiz,expenses,internet,-42.0,-44129.14
buyer_6,Manuel,45,ES56209598028877404654,TRX_N-01164-00199972,2024-09-07T08:44:58,Vitoria-Gasteiz,expenses,phone,-30.06,-44159.2
buyer_6,Manuel,45,ES56209598028877404654,TRX_N-01165-02926499,2024-09-07T20:00:02,Erandio,expenses,leisure,-48.1,-44207.3
buyer_6,Manuel,45,ES56209598028877404654,TRX_N-01166-49611773,2024-09-08T08:06:02,Vitoria-Gasteiz,expenses,gas,-98.44,-44305.74
buyer_6,Manuel,45,ES56209598028877404654,TRX_N-01167-54130896,2024-09-08T10:21:07,Vitoria-Gasteiz,expenses,water,-23.97,-44329.71
buyer_6,Manuel,45,ES56209598028877404654,TRX_N-01168-55389065,2024-09-08T15:30:46,Vitoria-Gasteiz,expenses,electricity,-36.65,-44366.36
buyer_6,Manuel,45,ES56209598028877404654,TRX_N-01169-95911883,2024-09-08T06:26:24,Vitoria-Gasteiz,expenses,travel,-1156.28,-45522.64
buyer_6,Manuel,45,ES56209598028877404654,TRX_N-01170-12472000,2024-09-10T12:17:12,Vitoria-Gasteiz,expenses,cash,-100.0,-45622.64
buyer_6,Manuel,45,ES56209598028877404654,TRX_N-01171-83443940,2024-09-12T16:14:45,Elciego,expenses,transport,-84.19,-45706.83
buyer_6,Manuel,45,ES56209598028877404654,TRX_N-01172-60122424,2024-09-12T11:27:05,Vitoria-Gasteiz,expenses,clothing,-131.38,-45838.21
buyer_6,Manuel,45,ES56209598028877404654,TRX_N-01173-70743628,2024-09-13T19:46:33,Vitoria-Gasteiz,expenses,food,-100.45,-45938.66
buyer_6,Manuel,45,ES56209598028877404654,TRX_N-01174-90765437,2024-09-14T20:02:08,Vitoria-Gasteiz,expenses,cash,-100.0,-46038.66
buyer_6,Manuel,45,ES56209598028877404654,TRX_N-01175-08442414,2024-09-15T08:13:14,Vitoria-Gasteiz,expenses,transport,-43.6,-46082.26
buyer_6,Manuel,45,ES56209598028877404654,TRX_N-01176-43174777,2024-09-17T11:13:57,Vitoria-Gasteiz,expenses,transport,-61.59,-46143.85
buyer_6,Manuel,45,ES56209598028877404654,TRX_N-01177-67371301,2024-09-18T17:09:57,Vitoria-Gasteiz,expenses,transport,-53.69,-46197.54
buyer_6,Manuel,45,ES56209598028877404654,TRX_N-01178-40303507,2024-09-18T10:35:23,Vitoria-Gasteiz,expenses,cash,-100.0,-46297.54
buyer_6,Manuel,45,ES56209598028877404654,TRX_N-01179-39559914,2024-09-18T18:20:36,Vitoria-Gasteiz,expenses,appliances,-281.09,-46578.63
buyer_6,Manuel,45,ES56209598028877404654,TRX_N-01180-15165546,2024-09-19T16:19:04,Hernani,expenses,leisure,-56.9,-46635.53
buyer_6,Manuel,45,ES56209598028877404654,TRX_N-01181-36817795,2024-09-19T12:42:23,Vitoria-Gasteiz,expenses,cash,-100.0,-46735.53
buyer_6,Manuel,45,ES56209598028877404654,TRX_N-01182-45808151,2024-09-20T14:28:37,Vitoria-Gasteiz,expenses,cash,-100.0,-46835.53
buyer_6,Manuel,45,ES56209598028877404654,TRX_N-01183-96100298,2024-09-21T11:39:24,Vitoria-Gasteiz,expenses,food,-109.05,-46944.58
buyer_6,Manuel,45,ES56209598028877404654,TRX_N-01184-65591567,2024-09-21T14:40:13,Vitoria-Gasteiz,expenses,cash,-100.0,-47044.58
buyer_6,Manuel,45,ES56209598028877404654,TRX_N-01185-45067779,2024-09-22T20:46:56,Vitoria-Gasteiz,expenses,repairs,-57.99,-47102.57
buyer_6,Manuel,45,ES56209598028877404654,TRX_N-01186-63916082,2024-09-23T10:31:00,Vitoria-Gasteiz,expenses,education,-55.15,-47157.72
buyer_6,Manuel,45,ES56209598028877404654,TRX_N-01187-92458113,2024-09-24T15:44:36,Vitoria-Gasteiz,expenses,gifts,-529.92,-47687.64
buyer_6,Manuel,45,ES56209598028877404654,TRX_N-01188-28665619,2024-09-25T14:45:29,Vitoria-Gasteiz,expenses,cash,-100.0,-47787.64
buyer_6,Manuel,45,ES56209598028877404654,TRX_N-01189-26329669,2024-09-26T16:53:38,Vitoria-Gasteiz,expenses,food,-103.5,-47891.14
buyer_6,Manuel,45,ES56209598028877404654,TRX_N-01190-11127536,2024-09-27T02:04:20,Vitoria-Gasteiz,expenses,clothing,-152.18,-48043.32
buyer_6,Manuel,45,ES56209598028877404654,TRX_N-01191-36273959,2024-10-01T15:44:39,Vitoria-Gasteiz,incomes,salary,1560.12,-46483.2
buyer_6,Manuel,45,ES56209598028877404654,TRX_N-01192-26791456,2024-10-01T15:44:39,Vitoria-Gasteiz,incomes,salary_partner,1474.91,-45008.29
buyer_6,Manuel,45,ES56209598028877404654,TRX_N-01193-66423529,2024-10-01T08:05:43,Vitoria-Gasteiz,expenses,transport,-68.05,-45076.34
buyer_6,Manuel,45,ES56209598028877404654,TRX_N-01194-11079414,2024-10-03T19:03:59,Vitoria-Gasteiz,expenses,transport,-62.42,-45138.76
buyer_6,Manuel,45,ES56209598028877404654,TRX_N-01195-02936676,2024-10-04T10:29:44,Vitoria-Gasteiz,expenses,mortgage,-718.03,-45856.79
buyer_6,Manuel,45,ES56209598028877404654,TRX_N-01196-97588181,2024-10-05T13:50:08,Vitoria-Gasteiz,expenses,water,-26.45,-45883.24
buyer_6,Manuel,45,ES56209598028877404654,TRX_N-01197-81553858,2024-10-05T19:20:04,Vitoria-Gasteiz,expenses,electricity,-78.18,-45961.42
buyer_6,Manuel,45,ES56209598028877404654,TRX_N-01198-11077991,2024-10-05T17:22:53,Vitoria-Gasteiz,expenses,food,-113.96,-46075.38
buyer_6,Manuel,45,ES56209598028877404654,TRX_N-01199-44364479,2024-10-06T20:38:24,Vitoria-Gasteiz,expenses,gas,-88.65,-46164.03
buyer_6,Manuel,45,ES56209598028877404654,TRX_N-01200-13152429,2024-10-06T08:10:04,Vitoria-Gasteiz,expenses,cash,-100.0,-46264.03
buyer_6,Manuel,45,ES56209598028877404654,TRX_N-01201-02997226,2024-10-07T08:49:06,Vitoria-Gasteiz,expenses,phone,-39.88,-46303.91
buyer_6,Manuel,45,ES56209598028877404654,TRX_N-01202-16527514,2024-10-07T16:53:34,Alegría-Dulantzi,expenses,cash,-100.0,-46403.91
buyer_6,Manuel,45,ES56209598028877404654,TRX_N-01203-73537231,2024-10-08T17:21:53,Vitoria-Gasteiz,expenses,internet,-42.0,-46445.91
buyer_6,Manuel,45,ES56209598028877404654,TRX_N-01204-95640336,2024-10-08T15:38:48,Vitoria-Gasteiz,expenses,food,-82.05,-46527.96
buyer_7,María,56,ES30209544742433791682,TRX_N-00001-08910878,2022-01-01T03:30:07,Portugalete,incomes,salary,1363.12,2675.62
buyer_7,María,56,ES30209544742433791682,TRX_N-00002-24944487,2022-01-01T03:30:07,Portugalete,incomes,salary_partner,1430.19,4105.81
buyer_7,María,56,ES30209544742433791682,TRX_N-00003-35783944,2022-01-02T20:18:10,Portugalete,expenses,food,-100.71,4005.1
buyer_7,María,56,ES30209544742433791682,TRX_N-00004-58203707,2022-01-02T15:34:39,Portugalete,expenses,education,-73.31,3931.79
buyer_7,María,56,ES30209544742433791682,TRX_N-00005-64876388,2022-01-02T19:37:43,Portugalete,expenses,cash,-100.0,3831.79
buyer_7,María,56,ES30209544742433791682,TRX_N-00006-73495865,2022-01-03T12:40:19,Portugalete,expenses,gifts,-307.43,3524.36
buyer_7,María,56,ES30209544742433791682,TRX_N-00007-01228638,2022-01-04T11:00:39,Portugalete,expenses,mortgage,-1052.07,2472.29
buyer_7,María,56,ES30209544742433791682,TRX_N-00008-97111963,2022-01-04T16:56:49,Portugalete,expenses,cash,-100.0,2372.29
buyer_7,María,56,ES30209544742433791682,TRX_N-00009-52628043,2022-01-05T09:10:36,Portugalete,expenses,electricity,-35.32,2336.97
buyer_7,María,56,ES30209544742433791682,TRX_N-00010-67124770,2022-01-05T18:27:18,Portugalete,expenses,gas,-66.42,2270.55
buyer_7,María,56,ES30209544742433791682,TRX_N-00011-26861559,2022-01-05T12:35:36,Portugalete,expenses,cash,-100.0,2170.55
buyer_7,María,56,ES30209544742433791682,TRX_N-00012-22503736,2022-01-06T06:19:28,Errenteria,expenses,clothing,-74.05,2096.5
buyer_7,María,56,ES30209544742433791682,TRX_N-00013-26780834,2022-01-08T10:09:53,Portugalete,expenses,phone,-43.03,2053.47
buyer_7,María,56,ES30209544742433791682,TRX_N-00014-88407960,2022-01-08T04:03:56,Portugalete,expenses,water,-43.09,2010.38
buyer_7,María,56,ES30209544742433791682,TRX_N-00015-74329211,2022-01-08T11:01:03,Portugalete,expenses,internet,-42.0,1968.38
buyer_7,María,56,ES30209544742433791682,TRX_N-00016-43285028,2022-01-09T20:03:02,Portugalete,expenses,transport,-69.77,1898.61
buyer_7,María,56,ES30209544742433791682,TRX_N-00017-50011457,2022-01-09T11:26:09,Portugalete,expenses,cash,-100.0,1798.61
buyer_7,María,56,ES30209544742433791682,TRX_N-00018-10107229,2022-01-09T13:19:48,Portugalete,expenses,appliances,-144.04,1654.57
buyer_7,María,56,ES30209544742433791682,TRX_N-00019-71024811,2022-01-10T10:27:08,Portugalete,expenses,transport,-82.25,1572.32
buyer_7,María,56,ES30209544742433791682,TRX_N-00020-00550024,2022-01-10T13:03:05,Zarautz,expenses,leisure,-27.66,1544.66
buyer_7,María,56,ES30209544742433791682,TRX_N-00021-74069690,2022-01-10T10:06:50,Portugalete,expenses,cash,-100.0,1444.66
buyer_7,María,56,ES30209544742433791682,TRX_N-00022-50299966,2022-01-11T18:37:39,Portugalete,expenses,leisure,-60.65,1384.01
buyer_7,María,56,ES30209544742433791682,TRX_N-00023-35429843,2022-01-12T16:35:55,Portugalete,expenses,cash,-100.0,1284.01
buyer_7,María,56,ES30209544742433791682,TRX_N-00024-89929870,2022-01-14T12:42:33,Portugalete,expenses,food,-116.75,1167.26
buyer_7,María,56,ES30209544742433791682,TRX_N-00025-49241411,2022-01-15T10:36:02,Portugalete,expenses,transport,-61.91,1105.35
buyer_7,María,56,ES30209544742433791682,TRX_N-00026-26868179,2022-01-17T12:53:23,Portugalete,expenses,transport,-81.93,1023.42
buyer_7,María,56,ES30209544742433791682,TRX_N-00027-14316525,2022-01-18T15:54:19,Portugalete,expenses,education,-42.62,980.8
buyer_7,María,56,ES30209544742433791682,TRX_N-00028-14749354,2022-01-18T08:48:50,Portugalete,expenses,cash,-100.0,880.8
buyer_7,María,56,ES30209544742433791682,TRX_N-00029-73474375,2022-01-18T10:09:58,Arrasate,expenses,repairs,-77.89,802.91
buyer_7,María,56,ES30209544742433791682,TRX_N-00030-28714543,2022-01-23T10:33:27,Portugalete,expenses,leisure,-54.99,747.92
buyer_7,María,56,ES30209544742433791682,TRX_N-00031-31780023,2022-01-23T23:31:37,Portugalete,expenses,gifts,-485.72,262.2
buyer_7,María,56,ES30209544742433791682,TRX_N-00032-21746305,2022-01-24T22:06:26,Portugalete,expenses,food,-61.48,200.72
buyer_7,María,56,ES30209544742433791682,TRX_N-00033-02681209,2022-01-25T14:30:44,Irun,expenses,repairs,-95.73,104.99
buyer_7,María,56,ES30209544742433791682,TRX_N-00034-67131037,2022-01-26T19:20:42,Portugalete,expenses,food,-81.7,23.29
buyer_7,María,56,ES30209544742433791682,TRX_N-00035-33083110,2022-01-26T20:39:21,Labastida,expenses,transport,-81.84,-58.55
buyer_7,María,56,ES30209544742433791682,TRX_N-00036-09179884,2022-01-26T09:49:58,Portugalete,expenses,leisure,-49.07,-107.62
buyer_7,María,56,ES30209544742433791682,TRX_N-00037-66909661,2022-01-26T13:55:10,Portugalete,expenses,repairs,-315.19,-422.81
buyer_7,María,56,ES30209544742433791682,TRX_N-00038-51933329,2022-01-27T20:23:29,Portugalete,expenses,leisure,-68.54,-491.35
buyer_7,María,56,ES30209544742433791682,TRX_N-00039-44235656,2022-01-27T14:51:00,Portugalete,expenses,cash,-100.0,-591.35
buyer_7,María,56,ES30209544742433791682,TRX_N-00040-73549951,2022-01-27T13:56:22,Portugalete,expenses,repairs,-142.96,-734.31
buyer_7,María,56,ES30209544742433791682,TRX_N-00041-10577961,2022-01-28T12:45:53,Portugalete,expenses,leisure,-30.41,-764.72
buyer_7,María,56,ES30209544742433791682,TRX_N-00042-86828871,2022-01-30T17:31:35,Hondarribia,expenses,leisure,-44.12,-808.84
buyer_7,María,56,ES30209544742433791682,TRX_N-00043-67382490,2022-01-31T22:17:27,Portugalete,expenses,repairs,-322.71,-1131.55
buyer_7,María,56,ES30209544742433791682,TRX_N-00044-87892142,2022-02-01T20:51:27,Portugalete,incomes,salary,1363.12,231.57
buyer_7,María,56,ES30209544742433791682,TRX_N-00045-31100973,2022-02-01T20:51:27,Portugalete,incomes,salary_partner,1430.19,1661.76
buyer_7,María,56,ES30209544742433791682,TRX_N-00046-20633490,2022-02-03T09:20:14,Portugalete,expenses,leisure,-22.84,1638.92
buyer_7,María,56,ES30209544742433791682,TRX_N-00047-28468576,2022-02-04T14:24:40,Portugalete,expenses,mortgage,-1052.07,586.85
buyer_7,María,56,ES30209544742433791682,TRX_N-00048-27632291,2022-02-04T18:55:11,Portugalete,expenses,food,-75.46,511.39
buyer_7,María,56,ES30209544742433791682,TRX_N-00049-22106525,2022-02-05T13:55:50,Portugalete,expenses,electricity,-40.4,470.99
buyer_7,María,56,ES30209544742433791682,TRX_N-00050-58043900,2022-02-05T07:05:52,Portugalete,expenses,gas,-59.6,411.39
buyer_7,María,56,ES30209544742433791682,TRX_N-00051-86517801,2022-02-06T22:54:43,Portugalete,expenses,leisure,-78.08,333.31
buyer_7,María,56,ES30209544742433791682,TRX_N-00052-90714176,2022-02-07T17:38:36,Portugalete,expenses,water,-27.99,305.32
buyer_7,María,56,ES30209544742433791682,TRX_N-00053-56090323,2022-02-07T14:09:10,Andoain,expenses,transport,-46.21,259.11
buyer_7,María,56,ES30209544742433791682,TRX_N-00054-23142559,2022-02-07T15:37:27,Portugalete,expenses,healthcare,-94.86,164.25
buyer_7,María,56,ES30209544742433791682,TRX_N-00055-46511955,2022-02-08T19:00:55,Portugalete,expenses,internet,-42.0,122.25
buyer_7,María,56,ES30209544742433791682,TRX_N-00056-97323961,2022-02-08T19:39:52,Portugalete,expenses,phone,-41.04,81.21
buyer_7,María,56,ES30209544742433791682,TRX_N-00057-85935737,2022-02-08T08:13:18,Portugalete,expenses,food,-65.39,15.82
buyer_7,María,56,ES30209544742433791682,TRX_N-00058-60231694,2022-02-08T09:59:26,Portugalete,expenses,children,-252.35,-236.53
buyer_7,María,56,ES30209544742433791682,TRX_N-00059-78070541,2022-02-09T19:54:31,Portugalete,expenses,cash,-100.0,-336.53
buyer_7,María,56,ES30209544742433791682,TRX_N-00060-31831326,2022-02-11T16:15:14,Portugalete,expenses,repairs,-246.21,-582.74
buyer_7,María,56,ES30209544742433791682,TRX_N-00061-60980514,2022-02-12T17:34:39,Portugalete,expenses,leisure,-79.59,-662.33
buyer_7,María,56,ES30209544742433791682,TRX_N-00062-13648752,2022-02-13T18:34:33,Portugalete,expenses,food,-124.32,-786.65
buyer_7,María,56,ES30209544742433791682,TRX_N-00063-92153800,2022-02-14T05:38:09,Portugalete,expenses,food,-108.45,-895.1
buyer_7,María,56,ES30209544742433791682,TRX_N-00064-73623199,2022-02-15T14:14:08,Portugalete,expenses,food,-119.26,-1014.36
buyer_7,María,56,ES30209544742433791682,TRX_N-00065-88241267,2022-02-19T14:06:41,Portugalete,expenses,food,-97.37,-1111.73
buyer_7,María,56,ES30209544742433791682,TRX_N-00066-23077863,2022-02-19T08:12:27,Portugalete,expenses,transport,-58.28,-1170.01
buyer_7,María,56,ES30209544742433791682,TRX_N-00067-50229602,2022-02-19T15:51:00,Portugalete,expenses,leisure,-30.27,-1200.28
buyer_7,María,56,ES30209544742433791682,TRX_N-00068-73607593,2022-02-21T21:58:32,Portugalete,expenses,food,-116.78,-1317.06
buyer_7,María,56,ES30209544742433791682,TRX_N-00069-58244242,2022-02-21T15:23:00,Portugalete,expenses,education,-70.94,-1388.0
buyer_7,María,56,ES30209544742433791682,TRX_N-00070-45782716,2022-02-21T14:18:42,Portugalete,expenses,gifts,-27.94,-1415.94
buyer_7,María,56,ES30209544742433791682,TRX_N-00071-14399909,2022-02-22T01:38:02,Portugalete,expenses,healthcare,-81.85,-1497.79
buyer_7,María,56,ES30209544742433791682,TRX_N-00072-64247026,2022-02-23T12:46:22,Portugalete,expenses,clothing,-67.77,-1565.56
buyer_7,María,56,ES30209544742433791682,TRX_N-00073-03112986,2022-02-23T17:15:18,Vitoria-Gasteiz,expenses,cash,-100.0,-1665.56
buyer_7,María,56,ES30209544742433791682,TRX_N-00074-27958205,2022-02-24T12:32:43,Portugalete,expenses,repairs,-118.7,-1784.26
buyer_7,María,56,ES30209544742433791682,TRX_N-00075-97288936,2022-02-26T07:15:57,Portugalete,expenses,transport,-70.13,-1854.39
buyer_7,María,56,ES30209544742433791682,TRX_N-00076-88689980,2022-02-27T20:48:08,Portugalete,expenses,food,-102.44,-1956.83
buyer_7,María,56,ES30209544742433791682,TRX_N-00077-86620676,2022-02-27T19:05:41,Portugalete,expenses,leisure,-20.53,-1977.36
buyer_7,María,56,ES30209544742433791682,TRX_N-00078-04033525,2022-03-01T18:24:29,Portugalete,incomes,salary,1363.12,-614.24
buyer_7,María,56,ES30209544742433791682,TRX_N-00079-64010412,2022-03-01T18:24:29,Portugalete,incomes,salary_partner,1430.19,815.95
buyer_7,María,56,ES30209544742433791682,TRX_N-00080-35639580,2022-03-01T18:24:29,Portugalete,incomes,extra_income,181.97,997.92
buyer_7,María,56,ES30209544742433791682,TRX_N-00081-82152822,2022-03-01T12:32:10,Portugalete,expenses,food,-97.27,900.65
buyer_7,María,56,ES30209544742433791682,TRX_N-00082-00901030,2022-03-02T12:50:24,Portugalete,expenses,food,-109.06,791.59
buyer_7,María,56,ES30209544742433791682,TRX_N-00083-77218323,2022-03-02T15:01:44,Portugalete,expenses,repairs,-177.69,613.9
buyer_7,María,56,ES30209544742433791682,TRX_N-00084-24668329,2022-03-03T14:13:50,Portugalete,expenses,food,-115.12,498.78
buyer_7,María,56,ES30209544742433791682,TRX_N-00085-38019326,2022-03-04T09:00:05,Portugalete,expenses,mortgage,-1052.07,-553.29
buyer_7,María,56,ES30209544742433791682,TRX_N-00086-03370277,2022-03-05T18:28:04,Portugalete,expenses,water,-35.08,-588.37
buyer_7,María,56,ES30209544742433791682,TRX_N-00087-09824341,2022-03-05T22:38:15,Portugalete,expenses,electricity,-55.28,-643.65
buyer_7,María,56,ES30209544742433791682,TRX_N-00088-88719113,2022-03-06T23:59:49,Alegría-Dulantzi,expenses,repairs,-77.86,-721.51
buyer_7,María,56,ES30209544742433791682,TRX_N-00089-27484910,2022-03-07T19:26:37,Portugalete,expenses,gas,-66.3,-787.81
buyer_7,María,56,ES30209544742433791682,TRX_N-00090-26305126,2022-03-07T08:04:29,Portugalete,expenses,internet,-42.0,-829.81
buyer_7,María,56,ES30209544742433791682,TRX_N-00091-54805689,2022-03-07T19:33:31,Portugalete,expenses,gifts,-122.01,-951.82
buyer_7,María,56,ES30209544742433791682,TRX_N-00092-12182149,2022-03-08T20:57:56,Portugalete,expenses,phone,-35.82,-987.64
buyer_7,María,56,ES30209544742433791682,TRX_N-00093-25388483,2022-03-08T17:58:52,Portugalete,expenses,cash,-100.0,-1087.64
buyer_7,María,56,ES30209544742433791682,TRX_N-00094-60708249,2022-03-09T11:53:15,Portugalete,expenses,children,-194.13,-1281.77
buyer_7,María,56,ES30209544742433791682,TRX_N-00095-57708284,2022-03-10T13:41:55,Portugalete,expenses,food,-72.73,-1354.5
buyer_7,María,56,ES30209544742433791682,TRX_N-00096-18429802,2022-03-11T19:43:59,Portugalete,expenses,transport,-85.34,-1439.84
buyer_7,María,56,ES30209544742433791682,TRX_N-00097-69103453,2022-03-12T09:34:00,Portugalete,expenses,food,-107.64,-1547.48
buyer_7,María,56,ES30209544742433791682,TRX_N-00098-38348873,2022-03-13T12:07:53,Portugalete,expenses,education,-66.69,-1614.17
buyer_7,María,56,ES30209544742433791682,TRX_N-00099-16122658,2022-03-13T10:04:29,Portugalete,expenses,cash,-100.0,-1714.17
buyer_7,María,56,ES30209544742433791682,TRX_N-00100-41111119,2022-03-13T20:30:02,Portugalete,expenses,appliances,-146.81,-1860.98
buyer_7,María,56,ES30209544742433791682,TRX_N-00101-77652745,2022-03-15T20:08:07,Portugalete,expenses,leisure,-62.55,-1923.53
buyer_7,María,56,ES30209544742433791682,TRX_N-00102-44870109,2022-03-18T22:48:31,Portugalete,expenses,food,-96.34,-2019.87
buyer_7,María,56,ES30209544742433791682,TRX_N-00103-41579896,2022-03-20T18:32:36,Portugalete,expenses,cash,-100.0,-2119.87
buyer_7,María,56,ES30209544742433791682,TRX_N-00104-79902707,2022-03-21T09:05:56,Portugalete,expenses,repairs,-291.3,-2411.17
buyer_7,María,56,ES30209544742433791682,TRX_N-00105-24641691,2022-03-22T15:54:49,Portugalete,expenses,cash,-100.0,-2511.17
buyer_7,María,56,ES30209544742433791682,TRX_N-00106-68877545,2022-03-26T05:58:10,Portugalete,expenses,food,-99.98,-2611.15
buyer_7,María,56,ES30209544742433791682,TRX_N-00107-95741334,2022-03-26T15:35:09,Portugalete,expenses,leisure,-62.8,-2673.95
buyer_7,María,56,ES30209544742433791682,TRX_N-00108-94835442,2022-03-28T17:42:52,Portugalete,expenses,gifts,-776.64,-3450.59
buyer_7,María,56,ES30209544742433791682,TRX_N-00109-55566511,2022-03-29T20:51:14,Portugalete,expenses,leisure,-37.18,-3487.77
buyer_7,María,56,ES30209544742433791682,TRX_N-00110-88325921,2022-03-30T15:50:37,Portugalete,expenses,gifts,-276.74,-3764.51
buyer_7,María,56,ES30209544742433791682,TRX_N-00111-60142341,2022-03-31T18:37:20,Portugalete,expenses,leisure,-70.82,-3835.33
buyer_7,María,56,ES30209544742433791682,TRX_N-00112-58710797,2022-04-01T04:54:08,Portugalete,incomes,salary,1363.12,-2472.21
buyer_7,María,56,ES30209544742433791682,TRX_N-00113-18019897,2022-04-01T04:54:08,Portugalete,incomes,salary_partner,1430.19,-1042.02
buyer_7,María,56,ES30209544742433791682,TRX_N-00114-00659480,2022-04-01T08:24:09,Barakaldo,expenses,leisure,-53.46,-1095.48
buyer_7,María,56,ES30209544742433791682,TRX_N-00115-14557697,2022-04-02T09:15:32,Portugalete,expenses,appliances,-181.24,-1276.72
buyer_7,María,56,ES30209544742433791682,TRX_N-00116-15577958,2022-04-03T09:28:25,Portugalete,expenses,transport,-85.49,-1362.21
buyer_7,María,56,ES30209544742433791682,TRX_N-00117-35354531,2022-04-03T08:26:34,Portugalete,expenses,leisure,-64.13,-1426.34
buyer_7,María,56,ES30209544742433791682,TRX_N-00118-64061185,2022-04-04T21:22:20,Portugalete,expenses,mortgage,-1052.07,-2478.41
buyer_7,María,56,ES30209544742433791682,TRX_N-00119-07238548,2022-04-04T11:08:01,Portugalete,expenses,food,-85.27,-2563.68
buyer_7,María,56,ES30209544742433791682,TRX_N-00120-44570154,2022-04-05T13:19:11,Portugalete,expenses,water,-44.91,-2608.59
buyer_7,María,56,ES30209544742433791682,TRX_N-00121-86584738,2022-04-07T14:35:22,Portugalete,expenses,leisure,-55.31,-2663.9
buyer_7,María,56,ES30209544742433791682,TRX_N-00122-69566482,2022-04-07T20:43:29,Portugalete,expenses,children,-224.16,-2888.06
buyer_7,María,56,ES30209544742433791682,TRX_N-00123-55762547,2022-04-08T20:58:13,Portugalete,expenses,electricity,-26.49,-2914.55
buyer_7,María,56,ES30209544742433791682,TRX_N-00124-35337369,2022-04-08T22:47:01,Portugalete,expenses,gas,-68.29,-2982.84
buyer_7,María,56,ES30209544742433791682,TRX_N-00125-49907183,2022-04-08T01:33:46,Portugalete,expenses,internet,-42.0,-3024.84
buyer_7,María,56,ES30209544742433791682,TRX_N-00126-50726429,2022-04-08T18:25:37,Portugalete,expenses,phone,-35.83,-3060.67
buyer_7,María,56,ES30209544742433791682,TRX_N-00127-77982256,2022-04-10T03:38:12,Portugalete,expenses,leisure,-68.1,-3128.77
buyer_7,María,56,ES30209544742433791682,TRX_N-00128-06370598,2022-04-10T06:14:40,Portugalete,expenses,gifts,-623.86,-3752.63
buyer_7,María,56,ES30209544742433791682,TRX_N-00129-80787950,2022-04-11T11:26:18,Portugalete,expenses,leisure,-35.87,-3788.5
buyer_7,María,56,ES30209544742433791682,TRX_N-00130-04612008,2022-04-12T12:04:50,Portugalete,expenses,clothing,-99.82,-3888.32
buyer_7,María,56,ES30209544742433791682,TRX_N-00131-07842703,2022-04-12T17:14:08,Alegría-Dulantzi,expenses,cash,-100.0,-3988.32
buyer_7,María,56,ES30209544742433791682,TRX_N-00132-13603112,2022-04-12T13:13:57,Iruña de Oca,expenses,repairs,-239.94,-4228.26
buyer_7,María,56,ES30209544742433791682,TRX_N-00133-78681336,2022-04-16T18:35:18,Portugalete,expenses,transport,-52.29,-4280.55
buyer_7,María,56,ES30209544742433791682,TRX_N-00134-24877311,2022-04-16T08:32:10,Portugalete,expenses,cash,-100.0,-4380.55
buyer_7,María,56,ES30209544742433791682,TRX_N-00135-16922213,2022-04-17T18:08:36,Portugalete,expenses,appliances,-282.63,-4663.18
buyer_7,María,56,ES30209544742433791682,TRX_N-00136-91392985,2022-04-18T15:26:32,Portugalete,expenses,food,-108.78,-4771.96
buyer_7,María,56,ES30209544742433791682,TRX_N-00137-19661129,2022-04-18T15:32:11,Portugalete,expenses,leisure,-24.49,-4796.45
buyer_7,María,56,ES30209544742433791682,TRX_N-00138-21085850,2022-04-20T19:29:12,Zuia,expenses,leisure,-44.49,-4840.94
buyer_7,María,56,ES30209544742433791682,TRX_N-00139-19434310,2022-04-20T20:57:08,Andoain,expenses,cash,-100.0,-4940.94
buyer_7,María,56,ES30209544742433791682,TRX_N-00140-06986504,2022-04-20T11:10:26,Portugalete,expenses,appliances,-110.8,-5051.74
buyer_7,María,56,ES30209544742433791682,TRX_N-00141-66770889,2022-04-21T15:38:46,Portugalete,expenses,cash,-100.0,-5151.74
buyer_7,María,56,ES30209544742433791682,TRX_N-00142-15867790,2022-04-21T11:15:22,Portugalete,expenses,gifts,-51.44,-5203.18
buyer_7,María,56,ES30209544742433791682,TRX_N-00143-67953878,2022-04-22T16:52:50,Amurrio,expenses,clothing,-149.78,-5352.96
buyer_7,María,56,ES30209544742433791682,TRX_N-00144-42625286,2022-04-22T16:42:10,Berango,expenses,cash,-100.0,-5452.96
buyer_7,María,56,ES30209544742433791682,TRX_N-00145-31712497,2022-04-22T17:41:19,Zarautz,expenses,gifts,-436.74,-5889.7
buyer_7,María,56,ES30209544742433791682,TRX_N-00146-41242671,2022-04-23T15:40:18,Portugalete,expenses,food,-110.0,-5999.7
buyer_7,María,56,ES30209544742433791682,TRX_N-00147-51568182,2022-04-23T13:21:20,Portugalete,expenses,education,-60.91,-6060.61
buyer_7,María,56,ES30209544742433791682,TRX_N-00148-12104726,2022-04-23T13:43:45,Portugalete,expenses,repairs,-156.99,-6217.6
buyer_7,María,56,ES30209544742433791682,TRX_N-00149-93710427,2022-04-26T23:38:37,Donostia,expenses,food,-98.98,-6316.58
buyer_7,María,56,ES30209544742433791682,TRX_N-00150-54879172,2022-04-28T09:37:13,Eibar,expenses,transport,-88.16,-6404.74
buyer_7,María,56,ES30209544742433791682,TRX_N-00151-91413658,2022-04-30T17:28:46,Portugalete,expenses,transport,-69.26,-6474.0
buyer_7,María,56,ES30209544742433791682,TRX_N-00152-33210755,2022-05-01T09:23:04,Portugalete,incomes,salary,1363.12,-5110.88
buyer_7,María,56,ES30209544742433791682,TRX_N-00153-29884704,2022-05-01T09:23:04,Portugalete,incomes,salary_partner,1430.19,-3680.69
buyer_7,María,56,ES30209544742433791682,TRX_N-00154-27737600,2022-05-01T10:06:55,Portugalete,expenses,cash,-100.0,-3780.69
buyer_7,María,56,ES30209544742433791682,TRX_N-00155-07842061,2022-05-02T14:39:29,Portugalete,expenses,cash,-100.0,-3880.69
buyer_7,María,56,ES30209544742433791682,TRX_N-00156-93689314,2022-05-02T19:51:33,Portugalete,expenses,children,-222.16,-4102.85
buyer_7,María,56,ES30209544742433791682,TRX_N-00157-31927020,2022-05-04T01:55:29,Portugalete,expenses,mortgage,-1052.07,-5154.92
buyer_7,María,56,ES30209544742433791682,TRX_N-00158-96281588,2022-05-04T11:33:36,Portugalete,expenses,cash,-100.0,-5254.92
buyer_7,María,56,ES30209544742433791682,TRX_N-00159-68550145,2022-05-05T14:35:23,Portugalete,expenses,gas,-96.68,-5351.6
buyer_7,María,56,ES30209544742433791682,TRX_N-00160-98580791,2022-05-05T17:47:45,Llodio,expenses,repairs,-326.9,-5678.5
buyer_7,María,56,ES30209544742433791682,TRX_N-00161-33284329,2022-05-06T19:48:25,Portugalete,expenses,water,-22.97,-5701.47
buyer_7,María,56,ES30209544742433791682,TRX_N-00162-27205572,2022-05-06T03:29:49,Portugalete,expenses,electricity,-40.2,-5741.67
buyer_7,María,56,ES30209544742433791682,TRX_N-00163-42942926,2022-05-07T15:29:31,Portugalete,expenses,phone,-38.02,-5779.69
buyer_7,María,56,ES30209544742433791682,TRX_N-00164-41671862,2022-05-07T13:40:10,Portugalete,expenses,food,-65.44,-5845.13
buyer_7,María,56,ES30209544742433791682,TRX_N-00165-04285337,2022-05-08T20:59:20,Portugalete,expenses,internet,-42.0,-5887.13
buyer_7,María,56,ES30209544742433791682,TRX_N-00166-10904048,2022-05-08T19:21:16,Portugalete,expenses,transport,-58.0,-5945.13
buyer_7,María,56,ES30209544742433791682,TRX_N-00167-04509978,2022-05-08T16:39:38,Santurtzi,expenses,gifts,-797.13,-6742.26
buyer_7,María,56,ES30209544742433791682,TRX_N-00168-62796588,2022-05-11T18:09:42,Portugalete,expenses,cash,-100.0,-6842.26
buyer_7,María,56,ES30209544742433791682,TRX_N-00169-91912669,2022-05-11T18:37:27,Portugalete,expenses,appliances,-343.45,-7185.71
buyer_7,María,56,ES30209544742433791682,TRX_N-00170-63901819,2022-05-12T11:45:06,Portugalete,expenses,cash,-100.0,-7285.71
buyer_7,María,56,ES30209544742433791682,TRX_N-00171-72606603,2022-05-13T14:42:53,Portugalete,expenses,leisure,-43.9,-7329.61
buyer_7,María,56,ES30209544742433791682,TRX_N-00172-30784678,2022-05-13T14:25:53,Portugalete,expenses,cash,-100.0,-7429.61
buyer_7,María,56,ES30209544742433791682,TRX_N-00173-42356813,2022-05-14T08:37:10,Portugalete,expenses,leisure,-19.46,-7449.07
buyer_7,María,56,ES30209544742433791682,TRX_N-00174-19014523,2022-05-16T08:45:37,Donostia,expenses,leisure,-37.4,-7486.47
buyer_7,María,56,ES30209544742433791682,TRX_N-00175-46922956,2022-05-17T17:26:51,Portugalete,expenses,transport,-48.23,-7534.7
buyer_7,María,56,ES30209544742433791682,TRX_N-00176-71117603,2022-05-18T12:48:41,Portugalete,expenses,transport,-41.01,-7575.71
buyer_7,María,56,ES30209544742433791682,TRX_N-00177-55159470,2022-05-18T16:50:18,Portugalete,expenses,gifts,-339.85,-7915.56
buyer_7,María,56,ES30209544742433791682,TRX_N-00178-65139356,2022-05-20T04:04:35,Labastida,expenses,food,-62.06,-7977.62
buyer_7,María,56,ES30209544742433791682,TRX_N-00179-48614966,2022-05-21T17:00:26,Portugalete,expenses,repairs,-128.44,-8106.06
buyer_7,María,56,ES30209544742433791682,TRX_N-00180-56081454,2022-05-23T08:35:55,Portugalete,expenses,food,-119.34,-8225.4
buyer_7,María,56,ES30209544742433791682,TRX_N-00181-60103230,2022-05-23T12:17:31,Portugalete,expenses,appliances,-217.77,-8443.17
buyer_7,María,56,ES30209544742433791682,TRX_N-00182-19992170,2022-05-25T14:17:43,Portugalete,expenses,transport,-81.03,-8524.2
buyer_7,María,56,ES30209544742433791682,TRX_N-00183-88053569,2022-05-25T09:19:04,Portugalete,expenses,leisure,-36.77,-8560.97
buyer_7,María,56,ES30209544742433791682,TRX_N-00184-57131071,2022-05-28T02:14:36,Portugalete,expenses,gifts,-636.17,-9197.14
buyer_7,María,56,ES30209544742433791682,TRX_N-00185-77353254,2022-05-29T12:29:18,Portugalete,expenses,food,-124.38,-9321.52
buyer_7,María,56,ES30209544742433791682,TRX_N-00186-03570297,2022-05-29T18:16:21,Portugalete,expenses,leisure,-37.44,-9358.96
buyer_7,María,56,ES30209544742433791682,TRX_N-00187-22757891,2022-05-29T11:04:11,Portugalete,expenses,cash,-100.0,-9458.96
buyer_7,María,56,ES30209544742433791682,TRX_N-00188-20495811,2022-05-29T15:49:43,Portugalete,expenses,gifts,-769.8,-10228.76
buyer_7,María,56,ES30209544742433791682,TRX_N-00189-21521006,2022-05-30T09:45:19,Iruña de Oca,expenses,food,-118.47,-10347.23
buyer_7,María,56,ES30209544742433791682,TRX_N-00190-43648092,2022-05-30T03:05:24,Portugalete,expenses,leisure,-66.36,-10413.59
buyer_7,María,56,ES30209544742433791682,TRX_N-00191-36025753,2022-05-30T13:12:48,Portugalete,expenses,cash,-100.0,-10513.59
buyer_7,María,56,ES30209544742433791682,TRX_N-00192-27538118,2022-05-31T12:47:45,Portugalete,expenses,transport,-58.83,-10572.42
buyer_7,María,56,ES30209544742433791682,TRX_N-00193-73293426,2022-06-01T15:01:34,Portugalete,incomes,salary,1363.12,-9209.3
buyer_7,María,56,ES30209544742433791682,TRX_N-00194-33068432,2022-06-01T15:01:34,Portugalete,incomes,salary_partner,1430.19,-7779.11
buyer_7,María,56,ES30209544742433791682,TRX_N-00195-01451444,2022-06-01T15:01:34,Portugalete,incomes,salary_bonus,982.87,-6796.24
buyer_7,María,56,ES30209544742433791682,TRX_N-00196-28975322,2022-06-01T15:01:34,Portugalete,incomes,salary_partner_bonus,1073.98,-5722.26
buyer_7,María,56,ES30209544742433791682,TRX_N-00197-17013186,2022-06-04T09:25:42,Portugalete,expenses,mortgage,-1052.07,-6774.33
buyer_7,María,56,ES30209544742433791682,TRX_N-00198-60311111,2022-06-04T12:44:34,Portugalete,expenses,leisure,-61.1,-6835.43
buyer_7,María,56,ES30209544742433791682,TRX_N-00199-17793351,2022-06-05T11:31:33,Portugalete,expenses,internet,-42.0,-6877.43
buyer_7,María,56,ES30209544742433791682,TRX_N-00200-96474631,2022-06-05T03:50:48,Portugalete,expenses,gifts,-47.14,-6924.57
buyer_7,María,56,ES30209544742433791682,TRX_N-00201-83946678,2022-06-06T12:20:33,Portugalete,expenses,water,-36.61,-6961.18
buyer_7,María,56,ES30209544742433791682,TRX_N-00202-08091190,2022-06-06T14:14:53,Portugalete,expenses,food,-76.07,-7037.25
buyer_7,María,56,ES30209544742433791682,TRX_N-00203-13339605,2022-06-06T14:42:01,Portugalete,expenses,cash,-100.0,-7137.25
buyer_7,María,56,ES30209544742433791682,TRX_N-00204-12966010,2022-06-08T16:01:44,Portugalete,expenses,electricity,-30.39,-7167.64
buyer_7,María,56,ES30209544742433791682,TRX_N-00205-58951314,2022-06-08T08:16:43,Portugalete,expenses,gas,-102.23,-7269.87
buyer_7,María,56,ES30209544742433791682,TRX_N-00206-32538880,2022-06-08T13:12:13,Portugalete,expenses,phone,-39.96,-7309.83
buyer_7,María,56,ES30209544742433791682,TRX_N-00207-24948801,2022-06-08T12:57:28,Portugalete,expenses,cash,-100.0,-7409.83
buyer_7,María,56,ES30209544742433791682,TRX_N-00208-21714126,2022-06-11T09:36:07,Portugalete,expenses,leisure,-21.32,-7431.15
buyer_7,María,56,ES30209544742433791682,TRX_N-00209-54312345,2022-06-11T15:56:59,Portugalete,expenses,clothing,-78.54,-7509.69
buyer_7,María,56,ES30209544742433791682,TRX_N-00210-45367564,2022-06-12T20:50:34,Sopela,expenses,repairs,-303.7,-7813.39
buyer_7,María,56,ES30209544742433791682,TRX_N-00211-75733203,2022-06-12T19:14:05,Portugalete,expenses,children,-77.85,-7891.24
buyer_7,María,56,ES30209544742433791682,TRX_N-00212-07456545,2022-06-13T14:37:03,Portugalete,expenses,repairs,-165.75,-8056.99
buyer_7,María,56,ES30209544742433791682,TRX_N-00213-42672608,2022-06-14T18:53:19,Galdakao,expenses,repairs,-98.83,-8155.82
buyer_7,María,56,ES30209544742433791682,TRX_N-00214-82823177,2022-06-20T15:24:03,Portugalete,expenses,cash,-100.0,-8255.82
buyer_7,María,56,ES30209544742433791682,TRX_N-00215-11128226,2022-06-21T14:18:12,Portugalete,expenses,transport,-68.73,-8324.55
buyer_7,María,56,ES30209544742433791682,TRX_N-00216-29437053,2022-06-21T19:00:35,Portugalete,expenses,cash,-100.0,-8424.55
buyer_7,María,56,ES30209544742433791682,TRX_N-00217-23621963,2022-06-21T21:55:37,Labastida,expenses,repairs,-219.06,-8643.61
buyer_7,María,56,ES30209544742433791682,TRX_N-00218-44381836,2022-06-22T16:26:16,Portugalete,expenses,leisure,-84.0,-8727.61
buyer_7,María,56,ES30209544742433791682,TRX_N-00219-57981394,2022-06-22T12:08:51,Portugalete,expenses,cash,-100.0,-8827.61
buyer_7,María,56,ES30209544742433791682,TRX_N-00220-45949703,2022-06-23T05:34:27,Portugalete,expenses,children,-250.95,-9078.56
buyer_7,María,56,ES30209544742433791682,TRX_N-00221-27847799,2022-06-25T23:47:50,Bilbao,expenses,repairs,-43.79,-9122.35
buyer_7,María,56,ES30209544742433791682,TRX_N-00222-78987422,2022-06-26T18:20:17,Portugalete,expenses,cash,-100.0,-9222.35
buyer_7,María,56,ES30209544742433791682,TRX_N-00223-12174940,2022-06-28T15:00:01,Portugalete,expenses,clothing,-63.55,-9285.9
buyer_7,María,56,ES30209544742433791682,TRX_N-00224-24848856,2022-06-28T09:15:37,Bermeo,expenses,cash,-100.0,-9385.9
buyer_7,María,56,ES30209544742433791682,TRX_N-00225-66449843,2022-06-29T12:54:58,Portugalete,expenses,leisure,-56.59,-9442.49
buyer_7,María,56,ES30209544742433791682,TRX_N-00226-64186889,2022-06-29T14:13:58,Basauri,expenses,cash,-100.0,-9542.49
buyer_7,María,56,ES30209544742433791682,TRX_N-00227-93773733,2022-06-29T14:07:15,Portugalete,expenses,children,-157.84,-9700.33
buyer_7,María,56,ES30209544742433791682,TRX_N-00228-41142993,2022-06-30T18:09:15,Elciego,expenses,clothing,-85.64,-9785.97
buyer_7,María,56,ES30209544742433791682,TRX_N-00229-75704565,2022-07-01T13:55:15,Portugalete,incomes,salary,1363.12,-8422.85
buyer_7,María,56,ES30209544742433791682,TRX_N-00230-97288930,2022-07-01T13:55:15,Portugalete,incomes,salary_partner,1430.19,-6992.66
buyer_7,María,56,ES30209544742433791682,TRX_N-00231-28423024,2022-07-01T13:55:15,Portugalete,incomes,extra_income,181.97,-6810.69
buyer_7,María,56,ES30209544742433791682,TRX_N-00232-01430920,2022-07-01T19:11:21,Portugalete,expenses,cash,-100.0,-6910.69
buyer_7,María,56,ES30209544742433791682,TRX_N-00233-67859039,2022-07-01T10:05:59,Getxo,expenses,travel,-1021.26,-7931.95
buyer_7,María,56,ES30209544742433791682,TRX_N-00234-61831400,2022-07-04T16:22:24,Portugalete,expenses,mortgage,-1052.07,-8984.02
buyer_7,María,56,ES30209544742433791682,TRX_N-00235-45350297,2022-07-04T18:22:21,Labastida,expenses,gifts,-210.89,-9194.91
buyer_7,María,56,ES30209544742433791682,TRX_N-00236-12693740,2022-07-05T14:48:52,Portugalete,expenses,appliances,-332.87,-9527.78
buyer_7,María,56,ES30209544742433791682,TRX_N-00237-98815017,2022-07-06T20:35:50,Portugalete,expenses,food,-102.91,-9630.69
buyer_7,María,56,ES30209544742433791682,TRX_N-00238-20941821,2022-07-06T10:16:30,Portugalete,expenses,leisure,-84.94,-9715.63
buyer_7,María,56,ES30209544742433791682,TRX_N-00239-98357516,2022-07-07T15:18:30,Portugalete,expenses,electricity,-38.63,-9754.26
buyer_7,María,56,ES30209544742433791682,TRX_N-00240-54154907,2022-07-07T20:18:17,Portugalete,expenses,phone,-40.83,-9795.09
buyer_7,María,56,ES30209544742433791682,TRX_N-00241-78650993,2022-07-08T15:22:24,Portugalete,expenses,water,-26.77,-9821.86
buyer_7,María,56,ES30209544742433791682,TRX_N-00242-62127174,2022-07-08T18:31:33,Portugalete,expenses,gas,-33.44,-9855.3
buyer_7,María,56,ES30209544742433791682,TRX_N-00243-25556306,2022-07-08T17:43:17,Portugalete,expenses,internet,-42.0,-9897.3
buyer_7,María,56,ES30209544742433791682,TRX_N-00244-80273638,2022-07-08T17:31:19,Portugalete,expenses,food,-115.21,-10012.51
buyer_7,María,56,ES30209544742433791682,TRX_N-00245-69569217,2022-07-09T12:59:19,Llodio,expenses,healthcare,-136.72,-10149.23
buyer_7,María,56,ES30209544742433791682,TRX_N-00246-10117826,2022-07-09T11:41:00,Berango,expenses,gifts,-389.92,-10539.15
buyer_7,María,56,ES30209544742433791682,TRX_N-00247-67671958,2022-07-10T19:25:24,Portugalete,expenses,cash,-100.0,-10639.15
buyer_7,María,56,ES30209544742433791682,TRX_N-00248-14292982,2022-07-10T19:36:30,Portugalete,expenses,children,-115.27,-10754.42
buyer_7,María,56,ES30209544742433791682,TRX_N-00249-15040939,2022-07-11T23:18:32,Portugalete,expenses,cash,-100.0,-10854.42
buyer_7,María,56,ES30209544742433791682,TRX_N-00250-49780637,2022-07-13T16:49:35,Portugalete,expenses,food,-76.63,-10931.05
buyer_7,María,56,ES30209544742433791682,TRX_N-00251-95232210,2022-07-14T17:08:34,Portugalete,expenses,food,-118.68,-11049.73
buyer_7,María,56,ES30209544742433791682,TRX_N-00252-37981765,2022-07-14T18:11:05,Portugalete,expenses,leisure,-57.84,-11107.57
buyer_7,María,56,ES30209544742433791682,TRX_N-00253-98144564,2022-07-15T20:28:50,Portugalete,expenses,food,-106.31,-11213.88
buyer_7,María,56,ES30209544742433791682,TRX_N-00254-83801453,2022-07-17T08:09:04,Portugalete,expenses,clothing,-94.01,-11307.89
buyer_7,María,56,ES30209544742433791682,TRX_N-00255-12288250,2022-07-17T17:34:57,Portugalete,expenses,gifts,-123.51,-11431.4
buyer_7,María,56,ES30209544742433791682,TRX_N-00256-39594806,2022-07-18T08:29:18,Portugalete,expenses,food,-67.6,-11499.0
buyer_7,María,56,ES30209544742433791682,TRX_N-00257-98006626,2022-07-18T10:42:39,Portugalete,expenses,repairs,-37.23,-11536.23
buyer_7,María,56,ES30209544742433791682,TRX_N-00258-17852269,2022-07-20T08:06:28,Portugalete,expenses,cash,-100.0,-11636.23
buyer_7,María,56,ES30209544742433791682,TRX_N-00259-62712303,2022-07-21T12:46:22,Llodio,expenses,transport,-46.65,-11682.88
buyer_7,María,56,ES30209544742433791682,TRX_N-00260-39516296,2022-07-21T14:08:05,Portugalete,expenses,repairs,-249.61,-11932.49
buyer_7,María,56,ES30209544742433791682,TRX_N-00261-81971918,2022-07-22T12:29:58,Portugalete,expenses,leisure,-41.22,-11973.71
buyer_7,María,56,ES30209544742433791682,TRX_N-00262-44529320,2022-07-22T10:28:13,Portugalete,expenses,gifts,-637.28,-12610.99
buyer_7,María,56,ES30209544742433791682,TRX_N-00263-39477429,2022-07-23T15:53:05,Zuia,expenses,transport,-74.35,-12685.34
buyer_7,María,56,ES30209544742433791682,TRX_N-00264-58162777,2022-07-24T09:09:31,Portugalete,expenses,transport,-60.27,-12745.61
buyer_7,María,56,ES30209544742433791682,TRX_N-00265-15673611,2022-07-24T19:32:25,Portugalete,expenses,leisure,-55.68,-12801.29
buyer_7,María,56,ES30209544742433791682,TRX_N-00266-69775124,2022-07-26T08:21:00,Bilbao,expenses,food,-98.3,-12899.59
buyer_7,María,56,ES30209544742433791682,TRX_N-00267-01536622,2022-07-27T18:41:07,Arrasate,expenses,repairs,-263.54,-13163.13
buyer_7,María,56,ES30209544742433791682,TRX_N-00268-27968310,2022-07-30T08:00:44,Erandio,expenses,transport,-50.54,-13213.67
buyer_7,María,56,ES30209544742433791682,TRX_N-00269-12396531,2022-07-30T14:29:34,Portugalete,expenses,leisure,-63.06,-13276.73
buyer_7,María,56,ES30209544742433791682,TRX_N-00270-19194575,2022-07-30T10:46:45,Portugalete,expenses,cash,-100.0,-13376.73
buyer_7,María,56,ES30209544742433791682,TRX_N-00271-10467524,2022-07-31T20:33:46,Portugalete,expenses,food,-77.16,-13453.89
buyer_7,María,56,ES30209544742433791682,TRX_N-00272-94086420,2022-08-01T08:11:03,Portugalete,incomes,salary,1363.12,-12090.77
buyer_7,María,56,ES30209544742433791682,TRX_N-00273-32496993,2022-08-01T08:11:03,Portugalete,incomes,salary_partner,1430.19,-10660.58
buyer_7,María,56,ES30209544742433791682,TRX_N-00274-72212688,2022-08-02T15:44:53,Portugalete,expenses,cash,-100.0,-10760.58
buyer_7,María,56,ES30209544742433791682,TRX_N-00275-19712161,2022-08-03T20:56:01,Hernani,expenses,transport,-59.1,-10819.68
buyer_7,María,56,ES30209544742433791682,TRX_N-00276-35811149,2022-08-03T18:56:46,Portugalete,expenses,repairs,-134.67,-10954.35
buyer_7,María,56,ES30209544742433791682,TRX_N-00277-42835289,2022-08-04T05:33:32,Portugalete,expenses,mortgage,-1052.07,-12006.42
buyer_7,María,56,ES30209544742433791682,TRX_N-00278-99179688,2022-08-04T18:58:51,Portugalete,expenses,transport,-66.18,-12072.6
buyer_7,María,56,ES30209544742433791682,TRX_N-00279-74623986,2022-08-05T11:19:17,Portugalete,expenses,clothing,-142.67,-12215.27
buyer_7,María,56,ES30209544742433791682,TRX_N-00280-55272548,2022-08-07T17:46:51,Portugalete,expenses,internet,-42.0,-12257.27
buyer_7,María,56,ES30209544742433791682,TRX_N-00281-88526400,2022-08-08T10:31:34,Portugalete,expenses,water,-37.54,-12294.81
buyer_7,María,56,ES30209544742433791682,TRX_N-00282-94640273,2022-08-08T09:06:30,Portugalete,expenses,electricity,-76.31,-12371.12
buyer_7,María,56,ES30209544742433791682,TRX_N-00283-81498984,2022-08-08T09:38:34,Portugalete,expenses,gas,-97.18,-12468.3
buyer_7,María,56,ES30209544742433791682,TRX_N-00284-19814620,2022-08-08T19:48:06,Portugalete,expenses,phone,-43.72,-12512.02
buyer_7,María,56,ES30209544742433791682,TRX_N-00285-48992482,2022-08-08T08:05:59,Llodio,expenses,repairs,-300.13,-12812.15
buyer_7,María,56,ES30209544742433791682,TRX_N-00286-08833976,2022-08-10T22:43:12,Portugalete,expenses,cash,-100.0,-12912.15
buyer_7,María,56,ES30209544742433791682,TRX_N-00287-05014112,2022-08-11T21:16:03,Portugalete,expenses,food,-84.72,-12996.87
buyer_7,María,56,ES30209544742433791682,TRX_N-00288-42049864,2022-08-12T12:31:37,Portugalete,expenses,food,-112.43,-13109.3
buyer_7,María,56,ES30209544742433791682,TRX_N-00289-81092329,2022-08-12T15:44:00,Portugalete,expenses,transport,-52.75,-13162.05
buyer_7,María,56,ES30209544742433791682,TRX_N-00290-88636611,2022-08-14T00:33:11,Portugalete,expenses,leisure,-80.83,-13242.88
buyer_7,María,56,ES30209544742433791682,TRX_N-00291-12216624,2022-08-15T08:03:22,Portugalete,expenses,food,-110.55,-13353.43
buyer_7,María,56,ES30209544742433791682,TRX_N-00292-96613350,2022-08-16T19:13:30,Portugalete,expenses,food,-92.0,-13445.43
buyer_7,María,56,ES30209544742433791682,TRX_N-00293-11981442,2022-08-18T03:53:07,Portugalete,expenses,transport,-46.94,-13492.37
buyer_7,María,56,ES30209544742433791682,TRX_N-00294-80847369,2022-08-20T11:27:56,Portugalete,expenses,leisure,-60.26,-13552.63
buyer_7,María,56,ES30209544742433791682,TRX_N-00295-57480657,2022-08-21T18:24:39,Amurrio,expenses,leisure,-32.67,-13585.3
buyer_7,María,56,ES30209544742433791682,TRX_N-00296-89560848,2022-08-22T01:02:38,Lasarte-Oria,expenses,cash,-100.0,-13685.3
buyer_7,María,56,ES30209544742433791682,TRX_N-00297-87192432,2022-08-23T16:29:53,Portugalete,expenses,leisure,-19.84,-13705.14
buyer_7,María,56,ES30209544742433791682,TRX_N-00298-43475685,2022-08-24T13:30:33,Portugalete,expenses,cash,-100.0,-13805.14
buyer_7,María,56,ES30209544742433791682,TRX_N-00299-67849056,2022-08-27T23:34:24,Portugalete,expenses,food,-121.58,-13926.72
buyer_7,María,56,ES30209544742433791682,TRX_N-00300-99030558,2022-08-27T09:54:02,Portugalete,expenses,education,-68.56,-13995.28
buyer_7,María,56,ES30209544742433791682,TRX_N-00301-45328821,2022-08-27T05:23:19,Portugalete,expenses,children,-217.76,-14213.04
buyer_7,María,56,ES30209544742433791682,TRX_N-00302-86589560,2022-08-31T21:41:39,Portugalete,expenses,leisure,-73.56,-14286.6
buyer_7,María,56,ES30209544742433791682,TRX_N-00303-88273165,2022-09-01T18:14:05,Portugalete,incomes,salary,1363.12,-12923.48
buyer_7,María,56,ES30209544742433791682,TRX_N-00304-33101564,2022-09-01T18:14:05,Portugalete,incomes,salary_partner,1430.19,-11493.29
buyer_7,María,56,ES30209544742433791682,TRX_N-00305-96913318,2022-09-01T17:00:02,Portugalete,expenses,clothing,-70.35,-11563.64
buyer_7,María,56,ES30209544742433791682,TRX_N-00306-45689151,2022-09-02T15:24:03,Portugalete,expenses,food,-111.36,-11675.0
buyer_7,María,56,ES30209544742433791682,TRX_N-00307-05679909,2022-09-02T21:59:04,Portugalete,expenses,education,-46.84,-11721.84
buyer_7,María,56,ES30209544742433791682,TRX_N-00308-84542694,2022-09-02T09:00:47,Portugalete,expenses,cash,-100.0,-11821.84
buyer_7,María,56,ES30209544742433791682,TRX_N-00309-50370753,2022-09-03T12:57:49,Portugalete,expenses,cash,-100.0,-11921.84
buyer_7,María,56,ES30209544742433791682,TRX_N-00310-16797326,2022-09-04T16:52:51,Portugalete,expenses,mortgage,-1052.07,-12973.91
buyer_7,María,56,ES30209544742433791682,TRX_N-00311-03813317,2022-09-05T14:34:02,Portugalete,expenses,water,-34.69,-13008.6
buyer_7,María,56,ES30209544742433791682,TRX_N-00312-28647258,2022-09-05T21:43:10,Portugalete,expenses,electricity,-68.41,-13077.01
buyer_7,María,56,ES30209544742433791682,TRX_N-00313-98301372,2022-09-05T17:14:06,Portugalete,expenses,internet,-42.0,-13119.01
buyer_7,María,56,ES30209544742433791682,TRX_N-00314-19987387,2022-09-05T11:27:09,Portugalete,expenses,food,-82.7,-13201.71
buyer_7,María,56,ES30209544742433791682,TRX_N-00315-35414934,2022-09-05T21:55:28,Portugalete,expenses,cash,-100.0,-13301.71
buyer_7,María,56,ES30209544742433791682,TRX_N-00316-04618901,2022-09-05T13:05:53,Portugalete,expenses,gifts,-575.54,-13877.25
buyer_7,María,56,ES30209544742433791682,TRX_N-00317-48917225,2022-09-06T17:08:27,Portugalete,expenses,transport,-80.76,-13958.01
buyer_7,María,56,ES30209544742433791682,TRX_N-00318-01110526,2022-09-06T08:55:59,Portugalete,expenses,clothing,-157.93,-14115.94
buyer_7,María,56,ES30209544742433791682,TRX_N-00319-46673411,2022-09-06T13:46:15,Portugalete,expenses,repairs,-37.03,-14152.97
buyer_7,María,56,ES30209544742433791682,TRX_N-00320-92170850,2022-09-08T16:23:33,Portugalete,expenses,gas,-82.98,-14235.95
buyer_7,María,56,ES30209544742433791682,TRX_N-00321-50344078,2022-09-08T17:21:03,Portugalete,expenses,phone,-30.91,-14266.86
buyer_7,María,56,ES30209544742433791682,TRX_N-00322-68262608,2022-09-08T10:01:20,Portugalete,expenses,cash,-100.0,-14366.86
buyer_7,María,56,ES30209544742433791682,TRX_N-00323-04496260,2022-09-12T11:23:31,Portugalete,expenses,cash,-100.0,-14466.86
buyer_7,María,56,ES30209544742433791682,TRX_N-00324-21709346,2022-09-13T19:41:22,Portugalete,expenses,leisure,-36.35,-14503.21
buyer_7,María,56,ES30209544742433791682,TRX_N-00325-51174593,2022-09-16T16:20:02,Portugalete,expenses,transport,-69.48,-14572.69
buyer_7,María,56,ES30209544742433791682,TRX_N-00326-39981465,2022-09-16T11:59:15,Donostia,expenses,clothing,-89.5,-14662.19
buyer_7,María,56,ES30209544742433791682,TRX_N-00327-89118527,2022-09-16T19:33:05,Portugalete,expenses,cash,-100.0,-14762.19
buyer_7,María,56,ES30209544742433791682,TRX_N-00328-36976758,2022-09-17T13:51:20,Portugalete,expenses,leisure,-69.01,-14831.2
buyer_7,María,56,ES30209544742433791682,TRX_N-00329-93807194,2022-09-17T13:00:13,Zuia,expenses,cash,-100.0,-14931.2
buyer_7,María,56,ES30209544742433791682,TRX_N-00330-59930889,2022-09-18T08:34:24,Portugalete,expenses,cash,-100.0,-15031.2
buyer_7,María,56,ES30209544742433791682,TRX_N-00331-56027201,2022-09-19T17:02:38,Eibar,expenses,leisure,-80.36,-15111.56
buyer_7,María,56,ES30209544742433791682,TRX_N-00332-89134388,2022-09-21T04:53:07,Portugalete,expenses,transport,-62.16,-15173.72
buyer_7,María,56,ES30209544742433791682,TRX_N-00333-32686172,2022-09-22T22:07:34,Portugalete,expenses,food,-112.02,-15285.74
buyer_7,María,56,ES30209544742433791682,TRX_N-00334-44223516,2022-09-24T16:11:51,Portugalete,expenses,children,-258.74,-15544.48
buyer_7,María,56,ES30209544742433791682,TRX_N-00335-89085214,2022-09-26T01:44:54,Portugalete,expenses,food,-103.49,-15647.97
buyer_7,María,56,ES30209544742433791682,TRX_N-00336-28233094,2022-09-26T18:34:43,Portugalete,expenses,gifts,-530.7,-16178.67
buyer_7,María,56,ES30209544742433791682,TRX_N-00337-32292700,2022-09-29T15:36:56,Portugalete,expenses,education,-44.27,-16222.94
buyer_7,María,56,ES30209544742433791682,TRX_N-00338-60027253,2022-10-01T12:09:50,Portugalete,incomes,salary,1363.12,-14859.82
buyer_7,María,56,ES30209544742433791682,TRX_N-00339-01503171,2022-10-01T12:09:50,Portugalete,incomes,salary_partner,1430.19,-13429.63
buyer_7,María,56,ES30209544742433791682,TRX_N-00340-64309368,2022-10-01T03:34:13,Portugalete,expenses,cash,-100.0,-13529.63
buyer_7,María,56,ES30209544742433791682,TRX_N-00341-54488838,2022-10-02T13:28:04,Erandio,expenses,repairs,-70.67,-13600.3
buyer_7,María,56,ES30209544742433791682,TRX_N-00342-83886195,2022-10-04T08:01:05,Portugalete,expenses,mortgage,-1052.07,-14652.37
buyer_7,María,56,ES30209544742433791682,TRX_N-00343-15590580,2022-10-04T15:13:34,Portugalete,expenses,clothing,-150.95,-14803.32
buyer_7,María,56,ES30209544742433791682,TRX_N-00344-29140741,2022-10-05T15:32:12,Portugalete,expenses,gas,-75.13,-14878.45
buyer_7,María,56,ES30209544742433791682,TRX_N-00345-52092502,2022-10-05T17:52:30,Portugalete,expenses,leisure,-29.76,-14908.21
buyer_7,María,56,ES30209544742433791682,TRX_N-00346-21515649,2022-10-06T19:31:09,Portugalete,expenses,electricity,-68.53,-14976.74
buyer_7,María,56,ES30209544742433791682,TRX_N-00347-65680686,2022-10-06T17:51:09,Portugalete,expenses,appliances,-283.57,-15260.31
buyer_7,María,56,ES30209544742433791682,TRX_N-00348-86982166,2022-10-07T19:39:45,Portugalete,expenses,food,-121.12,-15381.43
buyer_7,María,56,ES30209544742433791682,TRX_N-00349-05214083,2022-10-07T08:42:02,Portugalete,expenses,cash,-100.0,-15481.43
buyer_7,María,56,ES30209544742433791682,TRX_N-00350-45596221,2022-10-08T13:58:14,Portugalete,expenses,water,-32.26,-15513.69
buyer_7,María,56,ES30209544742433791682,TRX_N-00351-85262909,2022-10-08T22:25:35,Portugalete,expenses,internet,-42.0,-15555.69
buyer_7,María,56,ES30209544742433791682,TRX_N-00352-61467576,2022-10-08T19:49:53,Portugalete,expenses,phone,-39.71,-15595.4
buyer_7,María,56,ES30209544742433791682,TRX_N-00353-52240966,2022-10-08T14:54:59,Portugalete,expenses,leisure,-41.25,-15636.65
buyer_7,María,56,ES30209544742433791682,TRX_N-00354-18754195,2022-10-09T17:23:37,Portugalete,expenses,cash,-100.0,-15736.65
buyer_7,María,56,ES30209544742433791682,TRX_N-00355-08174766,2022-10-10T17:22:14,Portugalete,expenses,gifts,-462.59,-16199.24
buyer_7,María,56,ES30209544742433791682,TRX_N-00356-59483374,2022-10-11T10:38:59,Portugalete,expenses,transport,-40.17,-16239.41
buyer_7,María,56,ES30209544742433791682,TRX_N-00357-66732874,2022-10-15T18:49:36,Portugalete,expenses,cash,-100.0,-16339.41
buyer_7,María,56,ES30209544742433791682,TRX_N-00358-02189990,2022-10-17T15:36:10,Portugalete,expenses,food,-109.79,-16449.2
buyer_7,María,56,ES30209544742433791682,TRX_N-00359-63047875,2022-10-20T18:06:21,Portugalete,expenses,cash,-100.0,-16549.2
buyer_7,María,56,ES30209544742433791682,TRX_N-00360-80063575,2022-10-21T18:03:05,Alegría-Dulantzi,expenses,leisure,-83.46,-16632.66
buyer_7,María,56,ES30209544742433791682,TRX_N-00361-32490035,2022-10-22T17:54:12,Portugalete,expenses,travel,-862.62,-17495.28
buyer_7,María,56,ES30209544742433791682,TRX_N-00362-64605624,2022-10-23T14:46:17,Portugalete,expenses,repairs,-292.77,-17788.05
buyer_7,María,56,ES30209544742433791682,TRX_N-00363-13699986,2022-10-24T11:06:22,Portugalete,expenses,education,-73.02,-17861.07
buyer_7,María,56,ES30209544742433791682,TRX_N-00364-91670758,2022-10-25T19:26:48,Portugalete,expenses,education,-77.37,-17938.44
buyer_7,María,56,ES30209544742433791682,TRX_N-00365-23747444,2022-10-26T20:33:29,Portugalete,expenses,leisure,-35.42,-17973.86
buyer_7,María,56,ES30209544742433791682,TRX_N-00366-14335478,2022-10-28T22:49:16,Alegría-Dulantzi,expenses,leisure,-38.81,-18012.67
buyer_7,María,56,ES30209544742433791682,TRX_N-00367-85840381,2022-10-29T10:48:03,Portugalete,expenses,food,-79.37,-18092.04
buyer_7,María,56,ES30209544742433791682,TRX_N-00368-08163506,2022-10-30T19:06:58,Portugalete,expenses,food,-113.87,-18205.91
buyer_7,María,56,ES30209544742433791682,TRX_N-00369-66286996,2022-10-30T11:09:54,Portugalete,expenses,repairs,-193.8,-18399.71
buyer_7,María,56,ES30209544742433791682,TRX_N-00370-75953931,2022-10-31T14:42:49,Portugalete,expenses,gifts,-526.71,-18926.42
buyer_7,María,56,ES30209544742433791682,TRX_N-00371-83132921,2022-10-31T08:50:58,Portugalete,expenses,children,-53.94,-18980.36
buyer_7,María,56,ES30209544742433791682,TRX_N-00372-52953432,2022-11-01T13:15:24,Portugalete,incomes,salary,1363.12,-17617.24
buyer_7,María,56,ES30209544742433791682,TRX_N-00373-80374154,2022-11-01T13:15:24,Portugalete,incomes,salary_partner,1430.19,-16187.05
buyer_7,María,56,ES30209544742433791682,TRX_N-00374-89133515,2022-11-01T13:15:24,Portugalete,incomes,extra_income,181.97,-16005.08
buyer_7,María,56,ES30209544742433791682,TRX_N-00375-70966610,2022-11-01T22:56:45,Portugalete,expenses,transport,-55.55,-16060.63
buyer_7,María,56,ES30209544742433791682,TRX_N-00376-35114149,2022-11-01T16:28:31,Pasaia,expenses,leisure,-57.13,-16117.76
buyer_7,María,56,ES30209544742433791682,TRX_N-00377-67303830,2022-11-02T20:08:13,Portugalete,expenses,children,-272.55,-16390.31
buyer_7,María,56,ES30209544742433791682,TRX_N-00378-86733927,2022-11-03T18:02:53,Portugalete,expenses,repairs,-163.84,-16554.15
buyer_7,María,56,ES30209544742433791682,TRX_N-00379-69233248,2022-11-04T06:17:50,Portugalete,expenses,mortgage,-1052.07,-17606.22
buyer_7,María,56,ES30209544742433791682,TRX_N-00380-93090532,2022-11-05T16:34:19,Portugalete,expenses,water,-22.14,-17628.36
buyer_7,María,56,ES30209544742433791682,TRX_N-00381-03744932,2022-11-05T23:07:29,Portugalete,expenses,phone,-39.33,-17667.69
buyer_7,María,56,ES30209544742433791682,TRX_N-00382-62420307,2022-11-06T10:20:55,Portugalete,expenses,gas,-36.96,-17704.65
buyer_7,María,56,ES30209544742433791682,TRX_N-00383-03390018,2022-11-06T15:52:10,Portugalete,expenses,internet,-42.0,-17746.65
buyer_7,María,56,ES30209544742433791682,TRX_N-00384-37719684,2022-11-06T20:07:56,Portugalete,expenses,leisure,-29.98,-17776.63
buyer_7,María,56,ES30209544742433791682,TRX_N-00385-49800004,2022-11-08T22:45:03,Portugalete,expenses,electricity,-48.68,-17825.31
buyer_7,María,56,ES30209544742433791682,TRX_N-00386-63269786,2022-11-09T13:24:10,Portugalete,expenses,leisure,-26.56,-17851.87
buyer_7,María,56,ES30209544742433791682,TRX_N-00387-91808139,2022-11-09T09:38:14,Portugalete,expenses,cash,-100.0,-17951.87
buyer_7,María,56,ES30209544742433791682,TRX_N-00388-51280544,2022-11-11T12:28:05,Portugalete,expenses,food,-114.54,-18066.41
buyer_7,María,56,ES30209544742433791682,TRX_N-00389-47748876,2022-11-12T20:51:04,Portugalete,expenses,transport,-74.82,-18141.23
buyer_7,María,56,ES30209544742433791682,TRX_N-00390-13531050,2022-11-12T09:29:30,Portugalete,expenses,leisure,-68.75,-18209.98
buyer_7,María,56,ES30209544742433791682,TRX_N-00391-62140881,2022-11-13T16:42:39,Basauri,expenses,food,-121.35,-18331.33
buyer_7,María,56,ES30209544742433791682,TRX_N-00392-13827362,2022-11-13T11:09:04,Portugalete,expenses,transport,-82.4,-18413.73
buyer_7,María,56,ES30209544742433791682,TRX_N-00393-09088831,2022-11-14T16:05:51,Portugalete,expenses,cash,-100.0,-18513.73
buyer_7,María,56,ES30209544742433791682,TRX_N-00394-46631177,2022-11-15T18:47:25,Portugalete,expenses,cash,-100.0,-18613.73
buyer_7,María,56,ES30209544742433791682,TRX_N-00395-41867821,2022-11-16T22:31:55,Portugalete,expenses,food,-102.34,-18716.07
buyer_7,María,56,ES30209544742433791682,TRX_N-00396-19605191,2022-11-16T19:23:36,Amurrio,expenses,transport,-76.83,-18792.9
buyer_7,María,56,ES30209544742433791682,TRX_N-00397-09384103,2022-11-17T10:43:23,Portugalete,expenses,appliances,-161.91,-18954.81
buyer_7,María,56,ES30209544742433791682,TRX_N-00398-89170014,2022-11-20T14:03:22,Hondarribia,expenses,transport,-44.25,-18999.06
buyer_7,María,56,ES30209544742433791682,TRX_N-00399-63545563,2022-11-21T16:17:18,Portugalete,expenses,food,-75.44,-19074.5
buyer_7,María,56,ES30209544742433791682,TRX_N-00400-44112054,2022-11-22T12:13:56,Durango,expenses,repairs,-163.51,-19238.01
buyer_7,María,56,ES30209544742433791682,TRX_N-00401-99546976,2022-11-25T10:50:08,Portugalete,expenses,cash,-100.0,-19338.01
buyer_7,María,56,ES30209544742433791682,TRX_N-00402-23988281,2022-11-25T23:51:48,Portugalete,expenses,gifts,-697.44,-20035.45
buyer_7,María,56,ES30209544742433791682,TRX_N-00403-52729334,2022-11-27T17:34:00,Alegría-Dulantzi,expenses,leisure,-22.52,-20057.97
buyer_7,María,56,ES30209544742433791682,TRX_N-00404-50765202,2022-12-01T18:39:23,Portugalete,incomes,salary,1363.12,-18694.85
buyer_7,María,56,ES30209544742433791682,TRX_N-00405-33120666,2022-12-01T18:39:23,Portugalete,incomes,salary_partner,1430.19,-17264.66
buyer_7,María,56,ES30209544742433791682,TRX_N-00406-86204804,2022-12-01T18:39:23,Portugalete,incomes,salary_bonus,1078.2,-16186.46
buyer_7,María,56,ES30209544742433791682,TRX_N-00407-94045138,2022-12-01T18:39:23,Portugalete,incomes,salary_partner_bonus,1029.54,-15156.92
buyer_7,María,56,ES30209544742433791682,TRX_N-00408-73952788,2022-12-01T23:08:09,Hondarribia,expenses,cash,-100.0,-15256.92
buyer_7,María,56,ES30209544742433791682,TRX_N-00409-38482894,2022-12-01T23:16:13,Portugalete,expenses,gifts,-58.23,-15315.15
buyer_7,María,56,ES30209544742433791682,TRX_N-00410-18782870,2022-12-03T00:28:38,Portugalete,expenses,leisure,-53.36,-15368.51
buyer_7,María,56,ES30209544742433791682,TRX_N-00411-58436647,2022-12-04T14:22:38,Portugalete,expenses,mortgage,-1052.07,-16420.58
buyer_7,María,56,ES30209544742433791682,TRX_N-00412-36758846,2022-12-06T16:39:09,Portugalete,expenses,gas,-81.81,-16502.39
buyer_7,María,56,ES30209544742433791682,TRX_N-00413-30307601,2022-12-06T20:22:45,Portugalete,expenses,healthcare,-91.68,-16594.07
buyer_7,María,56,ES30209544742433791682,TRX_N-00414-01263201,2022-12-06T18:37:42,Portugalete,expenses,cash,-100.0,-16694.07
buyer_7,María,56,ES30209544742433791682,TRX_N-00415-72825797,2022-12-07T23:22:24,Portugalete,expenses,electricity,-76.19,-16770.26
buyer_7,María,56,ES30209544742433791682,TRX_N-00416-63477899,2022-12-08T17:50:39,Portugalete,expenses,water,-39.05,-16809.31
buyer_7,María,56,ES30209544742433791682,TRX_N-00417-55415140,2022-12-08T23:26:13,Portugalete,expenses,internet,-42.0,-16851.31
buyer_7,María,56,ES30209544742433791682,TRX_N-00418-52398086,2022-12-08T13:33:47,Portugalete,expenses,phone,-37.56,-16888.87
buyer_7,María,56,ES30209544742433791682,TRX_N-00419-53897273,2022-12-10T16:39:59,Portugalete,expenses,transport,-62.07,-16950.94
buyer_7,María,56,ES30209544742433791682,TRX_N-00420-51534268,2022-12-11T07:24:03,Portugalete,expenses,leisure,-78.01,-17028.95
buyer_7,María,56,ES30209544742433791682,TRX_N-00421-10313192,2022-12-13T18:02:50,Portugalete,expenses,children,-97.99,-17126.94
buyer_7,María,56,ES30209544742433791682,TRX_N-00422-41105541,2022-12-14T23:37:14,Portugalete,expenses,food,-89.18,-17216.12
buyer_7,María,56,ES30209544742433791682,TRX_N-00423-84152047,2022-12-15T11:54:53,Portugalete,expenses,food,-72.63,-17288.75
buyer_7,María,56,ES30209544742433791682,TRX_N-00424-11995829,2022-12-18T13:39:46,Portugalete,expenses,cash,-100.0,-17388.75
buyer_7,María,56,ES30209544742433791682,TRX_N-00425-08119592,2022-12-20T09:21:50,Portugalete,expenses,leisure,-81.48,-17470.23
buyer_7,María,56,ES30209544742433791682,TRX_N-00426-67822986,2022-12-22T11:34:38,Durango,expenses,travel,-660.26,-18130.49
buyer_7,María,56,ES30209544742433791682,TRX_N-00427-40528224,2022-12-28T20:30:36,Eibar,expenses,cash,-100.0,-18230.49
buyer_7,María,56,ES30209544742433791682,TRX_N-00428-00545148,2022-12-28T08:15:05,Portugalete,expenses,children,-199.31,-18429.8
buyer_7,María,56,ES30209544742433791682,TRX_N-00429-01292160,2022-12-30T10:02:29,Hernani,expenses,leisure,-36.2,-18466.0
buyer_7,María,56,ES30209544742433791682,TRX_N-00430-18692677,2022-12-30T13:28:02,Portugalete,expenses,cash,-100.0,-18566.0
buyer_7,María,56,ES30209544742433791682,TRX_N-00431-88074216,2022-12-31T18:48:56,Portugalete,expenses,cash,-100.0,-18666.0
buyer_7,María,56,ES30209544742433791682,TRX_N-00432-69859208,2023-01-01T13:17:53,Portugalete,incomes,salary,1417.21,-17248.79
buyer_7,María,56,ES30209544742433791682,TRX_N-00433-32682248,2023-01-01T13:17:53,Portugalete,incomes,salary_partner,1486.94,-15761.85
buyer_7,María,56,ES30209544742433791682,TRX_N-00434-30607161,2023-01-01T22:46:17,Portugalete,expenses,transport,-51.35,-15813.2
buyer_7,María,56,ES30209544742433791682,TRX_N-00435-98795685,2023-01-02T15:05:21,Barakaldo,expenses,cash,-100.0,-15913.2
buyer_7,María,56,ES30209544742433791682,TRX_N-00436-08313703,2023-01-03T19:35:52,Portugalete,expenses,clothing,-60.39,-15973.59
buyer_7,María,56,ES30209544742433791682,TRX_N-00437-78980987,2023-01-03T21:51:06,Pasaia,expenses,healthcare,-77.89,-16051.48
buyer_7,María,56,ES30209544742433791682,TRX_N-00438-06499380,2023-01-04T14:06:00,Portugalete,expenses,mortgage,-1052.07,-17103.55
buyer_7,María,56,ES30209544742433791682,TRX_N-00439-26664636,2023-01-05T20:20:17,Portugalete,expenses,electricity,-62.11,-17165.66
buyer_7,María,56,ES30209544742433791682,TRX_N-00440-70049216,2023-01-05T22:14:56,Portugalete,expenses,gas,-86.32,-17251.98
buyer_7,María,56,ES30209544742433791682,TRX_N-00441-53234168,2023-01-05T09:59:45,Portugalete,expenses,phone,-41.48,-17293.46
buyer_7,María,56,ES30209544742433791682,TRX_N-00442-51593519,2023-01-06T10:27:45,Portugalete,expenses,cash,-100.0,-17393.46
buyer_7,María,56,ES30209544742433791682,TRX_N-00443-04143585,2023-01-07T15:10:25,Portugalete,expenses,water,-28.4,-17421.86
buyer_7,María,56,ES30209544742433791682,TRX_N-00444-67729633,2023-01-07T09:32:11,Portugalete,expenses,leisure,-60.0,-17481.86
buyer_7,María,56,ES30209544742433791682,TRX_N-00445-01980692,2023-01-08T18:03:01,Portugalete,expenses,internet,-42.0,-17523.86
buyer_7,María,56,ES30209544742433791682,TRX_N-00446-30384931,2023-01-08T10:26:09,Portugalete,expenses,education,-69.84,-17593.7
buyer_7,María,56,ES30209544742433791682,TRX_N-00447-65041358,2023-01-09T15:36:47,Alegría-Dulantzi,expenses,food,-123.3,-17717.0
buyer_7,María,56,ES30209544742433791682,TRX_N-00448-05437752,2023-01-10T20:10:04,Portugalete,expenses,transport,-46.92,-17763.92
buyer_7,María,56,ES30209544742433791682,TRX_N-00449-12995826,2023-01-11T04:18:50,Portugalete,expenses,transport,-82.3,-17846.22
buyer_7,María,56,ES30209544742433791682,TRX_N-00450-32316556,2023-01-11T17:29:27,Portugalete,expenses,leisure,-67.98,-17914.2
buyer_7,María,56,ES30209544742433791682,TRX_N-00451-07870920,2023-01-11T08:40:34,Portugalete,expenses,children,-92.37,-18006.57
buyer_7,María,56,ES30209544742433791682,TRX_N-00452-20831858,2023-01-14T18:41:27,Portugalete,expenses,leisure,-66.79,-18073.36
buyer_7,María,56,ES30209544742433791682,TRX_N-00453-83136957,2023-01-17T18:25:54,Portugalete,expenses,food,-75.88,-18149.24
buyer_7,María,56,ES30209544742433791682,TRX_N-00454-42725802,2023-01-17T15:00:15,Portugalete,expenses,transport,-71.83,-18221.07
buyer_7,María,56,ES30209544742433791682,TRX_N-00455-68106379,2023-01-19T11:03:18,Erandio,expenses,cash,-100.0,-18321.07
buyer_7,María,56,ES30209544742433791682,TRX_N-00456-81190672,2023-01-20T14:03:55,Portugalete,expenses,cash,-100.0,-18421.07
buyer_7,María,56,ES30209544742433791682,TRX_N-00457-49855590,2023-01-23T19:35:10,Portugalete,expenses,clothing,-135.61,-18556.68
buyer_7,María,56,ES30209544742433791682,TRX_N-00458-88419208,2023-01-25T08:41:18,Portugalete,expenses,transport,-47.28,-18603.96
buyer_7,María,56,ES30209544742433791682,TRX_N-00459-28843532,2023-01-29T11:12:21,Portugalete,expenses,food,-62.43,-18666.39
buyer_7,María,56,ES30209544742433791682,TRX_N-00460-95187681,2023-01-31T20:39:33,Portugalete,expenses,leisure,-47.08,-18713.47
buyer_7,María,56,ES30209544742433791682,TRX_N-00461-74153603,2023-02-01T13:55:37,Portugalete,incomes,salary,1417.21,-17296.26
buyer_7,María,56,ES30209544742433791682,TRX_N-00462-88905128,2023-02-01T13:55:37,Portugalete,incomes,salary_partner,1486.94,-15809.32
buyer_7,María,56,ES30209544742433791682,TRX_N-00463-94499473,2023-02-01T13:55:37,Portugalete,incomes,extra_income,181.97,-15627.35
buyer_7,María,56,ES30209544742433791682,TRX_N-00464-04935674,2023-02-01T15:38:39,Portugalete,expenses,food,-69.14,-15696.49
buyer_7,María,56,ES30209544742433791682,TRX_N-00465-78717329,2023-02-01T18:43:29,Portugalete,expenses,repairs,-89.49,-15785.98
buyer_7,María,56,ES30209544742433791682,TRX_N-00466-50678092,2023-02-02T10:33:48,Portugalete,expenses,transport,-89.81,-15875.79
buyer_7,María,56,ES30209544742433791682,TRX_N-00467-61821066,2023-02-02T22:31:32,Amurrio,expenses,appliances,-380.84,-16256.63
buyer_7,María,56,ES30209544742433791682,TRX_N-00468-44033203,2023-02-02T11:53:26,Portugalete,expenses,gifts,-700.81,-16957.44
buyer_7,María,56,ES30209544742433791682,TRX_N-00469-37569151,2023-02-03T13:03:59,Portugalete,expenses,gifts,-810.05,-17767.49
buyer_7,María,56,ES30209544742433791682,TRX_N-00470-15428107,2023-02-04T14:45:34,Portugalete,expenses,mortgage,-1052.07,-18819.56
buyer_7,María,56,ES30209544742433791682,TRX_N-00471-98222801,2023-02-04T14:33:42,Hernani,expenses,leisure,-82.24,-18901.8
buyer_7,María,56,ES30209544742433791682,TRX_N-00472-57112197,2023-02-04T12:34:26,Portugalete,expenses,clothing,-156.51,-19058.31
buyer_7,María,56,ES30209544742433791682,TRX_N-00473-49769538,2023-02-04T11:54:16,Portugalete,expenses,cash,-100.0,-19158.31
buyer_7,María,56,ES30209544742433791682,TRX_N-00474-68288879,2023-02-06T18:59:43,Portugalete,expenses,electricity,-79.46,-19237.77
buyer_7,María,56,ES30209544742433791682,TRX_N-00475-42680198,2023-02-07T19:51:39,Portugalete,expenses,internet,-42.0,-19279.77
buyer_7,María,56,ES30209544742433791682,TRX_N-00476-45806390,2023-02-07T20:30:22,Portugalete,expenses,transport,-50.27,-19330.04
buyer_7,María,56,ES30209544742433791682,TRX_N-00477-51212411,2023-02-08T21:56:19,Portugalete,expenses,water,-32.51,-19362.55
buyer_7,María,56,ES30209544742433791682,TRX_N-00478-41728028,2023-02-08T12:55:40,Portugalete,expenses,gas,-91.14,-19453.69
buyer_7,María,56,ES30209544742433791682,TRX_N-00479-17489375,2023-02-08T19:47:18,Portugalete,expenses,phone,-38.89,-19492.58
buyer_7,María,56,ES30209544742433791682,TRX_N-00480-15868910,2023-02-09T14:28:23,Portugalete,expenses,cash,-100.0,-19592.58
buyer_7,María,56,ES30209544742433791682,TRX_N-00481-33355248,2023-02-10T20:56:35,Portugalete,expenses,cash,-100.0,-19692.58
buyer_7,María,56,ES30209544742433791682,TRX_N-00482-60247926,2023-02-11T10:52:06,Berango,expenses,food,-95.92,-19788.5
buyer_7,María,56,ES30209544742433791682,TRX_N-00483-41674115,2023-02-11T16:23:58,Portugalete,expenses,transport,-72.53,-19861.03
buyer_7,María,56,ES30209544742433791682,TRX_N-00484-13070124,2023-02-13T23:35:42,Portugalete,expenses,cash,-100.0,-19961.03
buyer_7,María,56,ES30209544742433791682,TRX_N-00485-27145485,2023-02-14T19:03:22,Portugalete,expenses,leisure,-26.53,-19987.56
buyer_7,María,56,ES30209544742433791682,TRX_N-00486-50309027,2023-02-14T08:14:28,Portugalete,expenses,cash,-100.0,-20087.56
buyer_7,María,56,ES30209544742433791682,TRX_N-00487-18328288,2023-02-17T23:40:06,Mungia,expenses,leisure,-42.79,-20130.35
buyer_7,María,56,ES30209544742433791682,TRX_N-00488-03347246,2023-02-19T19:27:21,Portugalete,expenses,children,-141.95,-20272.3
buyer_7,María,56,ES30209544742433791682,TRX_N-00489-44596151,2023-02-20T14:09:53,Portugalete,expenses,transport,-74.44,-20346.74
buyer_7,María,56,ES30209544742433791682,TRX_N-00490-13731310,2023-02-21T04:36:13,Portugalete,expenses,cash,-100.0,-20446.74
buyer_7,María,56,ES30209544742433791682,TRX_N-00491-79181961,2023-02-22T12:57:31,Errenteria,expenses,transport,-83.27,-20530.01
buyer_7,María,56,ES30209544742433791682,TRX_N-00492-63479527,2023-02-23T19:31:54,Mungia,expenses,cash,-100.0,-20630.01
buyer_7,María,56,ES30209544742433791682,TRX_N-00493-78103025,2023-02-24T18:08:56,Portugalete,expenses,leisure,-32.99,-20663.0
buyer_7,María,56,ES30209544742433791682,TRX_N-00494-27613947,2023-02-24T18:53:18,Galdakao,expenses,gifts,-515.75,-21178.75
buyer_7,María,56,ES30209544742433791682,TRX_N-00495-39881616,2023-02-26T19:06:52,Barakaldo,expenses,healthcare,-134.39,-21313.14
buyer_7,María,56,ES30209544742433791682,TRX_N-00496-85748976,2023-02-28T18:03:39,Portugalete,expenses,transport,-77.89,-21391.03
buyer_7,María,56,ES30209544742433791682,TRX_N-00497-75928978,2023-03-01T08:41:04,Portugalete,incomes,salary,1417.21,-19973.82
buyer_7,María,56,ES30209544742433791682,TRX_N-00498-52881577,2023-03-01T08:41:04,Portugalete,incomes,salary_partner,1486.94,-18486.88
buyer_7,María,56,ES30209544742433791682,TRX_N-00499-43061152,2023-03-01T20:59:47,Salvatierra/Agurain,expenses,cash,-100.0,-18586.88
buyer_7,María,56,ES30209544742433791682,TRX_N-00500-50810973,2023-03-03T11:32:15,Portugalete,expenses,leisure,-24.63,-18611.51
buyer_7,María,56,ES30209544742433791682,TRX_N-00501-98585805,2023-03-03T15:21:20,Portugalete,expenses,education,-77.29,-18688.8
buyer_7,María,56,ES30209544742433791682,TRX_N-00502-81131248,2023-03-04T09:29:19,Portugalete,expenses,mortgage,-1052.07,-19740.87
buyer_7,María,56,ES30209544742433791682,TRX_N-00503-80278450,2023-03-06T20:37:53,Portugalete,expenses,water,-30.61,-19771.48
buyer_7,María,56,ES30209544742433791682,TRX_N-00504-92996941,2023-03-06T08:33:45,Portugalete,expenses,electricity,-25.39,-19796.87
buyer_7,María,56,ES30209544742433791682,TRX_N-00505-48712167,2023-03-06T11:53:21,Portugalete,expenses,gas,-75.45,-19872.32
buyer_7,María,56,ES30209544742433791682,TRX_N-00506-04575697,2023-03-06T14:09:45,Portugalete,expenses,internet,-42.0,-19914.32
buyer_7,María,56,ES30209544742433791682,TRX_N-00507-95588274,2023-03-06T09:39:57,Portugalete,expenses,phone,-30.71,-19945.03
buyer_7,María,56,ES30209544742433791682,TRX_N-00508-21948415,2023-03-06T09:21:56,Portugalete,expenses,gifts,-274.92,-20219.95
buyer_7,María,56,ES30209544742433791682,TRX_N-00509-21847217,2023-03-07T14:06:45,Leioa,expenses,education,-56.5,-20276.45
buyer_7,María,56,ES30209544742433791682,TRX_N-00510-43358760,2023-03-10T19:26:38,Portugalete,expenses,transport,-65.11,-20341.56
buyer_7,María,56,ES30209544742433791682,TRX_N-00511-99470160,2023-03-11T10:54:24,Barakaldo,expenses,transport,-46.24,-20387.8
buyer_7,María,56,ES30209544742433791682,TRX_N-00512-21858722,2023-03-12T14:05:20,Portugalete,expenses,food,-108.87,-20496.67
buyer_7,María,56,ES30209544742433791682,TRX_N-00513-21908107,2023-03-12T11:17:45,Portugalete,expenses,clothing,-54.12,-20550.79
buyer_7,María,56,ES30209544742433791682,TRX_N-00514-75215018,2023-03-14T13:07:15,Zarautz,expenses,cash,-100.0,-20650.79
buyer_7,María,56,ES30209544742433791682,TRX_N-00515-91564821,2023-03-15T07:45:21,Portugalete,expenses,leisure,-21.67,-20672.46
buyer_7,María,56,ES30209544742433791682,TRX_N-00516-15977817,2023-03-15T15:44:30,Portugalete,expenses,children,-218.77,-20891.23
buyer_7,María,56,ES30209544742433791682,TRX_N-00517-09373925,2023-03-22T09:19:52,Portugalete,expenses,food,-106.01,-20997.24
buyer_7,María,56,ES30209544742433791682,TRX_N-00518-55692417,2023-03-22T20:43:42,Portugalete,expenses,cash,-100.0,-21097.24
buyer_7,María,56,ES30209544742433791682,TRX_N-00519-82824413,2023-03-23T14:59:12,Portugalete,expenses,cash,-100.0,-21197.24
buyer_7,María,56,ES30209544742433791682,TRX_N-00520-27569236,2023-03-24T19:07:34,Portugalete,expenses,repairs,-326.82,-21524.06
buyer_7,María,56,ES30209544742433791682,TRX_N-00521-80192371,2023-03-26T08:55:39,Portugalete,expenses,leisure,-75.31,-21599.37
buyer_7,María,56,ES30209544742433791682,TRX_N-00522-81493361,2023-03-26T20:34:27,Portugalete,expenses,clothing,-158.98,-21758.35
buyer_7,María,56,ES30209544742433791682,TRX_N-00523-47824761,2023-03-26T17:45:21,Portugalete,expenses,children,-244.18,-22002.53
buyer_7,María,56,ES30209544742433791682,TRX_N-00524-39041341,2023-03-28T20:46:31,Portugalete,expenses,clothing,-60.59,-22063.12
buyer_7,María,56,ES30209544742433791682,TRX_N-00525-92347323,2023-03-30T16:45:32,Portugalete,expenses,healthcare,-142.95,-22206.07
buyer_7,María,56,ES30209544742433791682,TRX_N-00526-62222467,2023-03-30T22:31:47,Sopela,expenses,cash,-100.0,-22306.07
buyer_7,María,56,ES30209544742433791682,TRX_N-00527-56331269,2023-03-31T22:49:54,Portugalete,expenses,travel,-469.64,-22775.71
buyer_7,María,56,ES30209544742433791682,TRX_N-00528-39195378,2023-04-01T13:09:41,Portugalete,incomes,salary,1417.21,-21358.5
buyer_7,María,56,ES30209544742433791682,TRX_N-00529-37260229,2023-04-01T13:09:41,Portugalete,incomes,salary_partner,1486.94,-19871.56
buyer_7,María,56,ES30209544742433791682,TRX_N-00530-74598235,2023-04-01T16:20:22,Irun,expenses,transport,-86.24,-19957.8
buyer_7,María,56,ES30209544742433791682,TRX_N-00531-99998759,2023-04-02T18:31:58,Portugalete,expenses,food,-71.02,-20028.82
buyer_7,María,56,ES30209544742433791682,TRX_N-00532-98879597,2023-04-04T09:21:41,Portugalete,expenses,mortgage,-1052.07,-21080.89
buyer_7,María,56,ES30209544742433791682,TRX_N-00533-55651554,2023-04-05T23:33:09,Portugalete,expenses,internet,-42.0,-21122.89
buyer_7,María,56,ES30209544742433791682,TRX_N-00534-83209441,2023-04-05T08:43:11,Portugalete,expenses,phone,-37.08,-21159.97
buyer_7,María,56,ES30209544742433791682,TRX_N-00535-88019967,2023-04-06T10:40:49,Portugalete,expenses,food,-72.96,-21232.93
buyer_7,María,56,ES30209544742433791682,TRX_N-00536-61096873,2023-04-06T08:14:13,Portugalete,expenses,cash,-100.0,-21332.93
buyer_7,María,56,ES30209544742433791682,TRX_N-00537-95142996,2023-04-07T09:42:17,Portugalete,expenses,water,-29.39,-21362.32
buyer_7,María,56,ES30209544742433791682,TRX_N-00538-53127850,2023-04-07T20:07:36,Portugalete,expenses,gas,-86.17,-21448.49
buyer_7,María,56,ES30209544742433791682,TRX_N-00539-85175869,2023-04-07T16:13:58,Portugalete,expenses,children,-60.35,-21508.84
buyer_7,María,56,ES30209544742433791682,TRX_N-00540-51056100,2023-04-08T10:09:42,Portugalete,expenses,electricity,-76.55,-21585.39
buyer_7,María,56,ES30209544742433791682,TRX_N-00541-72837191,2023-04-08T12:22:40,Portugalete,expenses,leisure,-59.54,-21644.93
buyer_7,María,56,ES30209544742433791682,TRX_N-00542-86305165,2023-04-10T22:17:48,Arrasate,expenses,transport,-61.66,-21706.59
buyer_7,María,56,ES30209544742433791682,TRX_N-00543-96382179,2023-04-10T22:57:53,Portugalete,expenses,leisure,-63.23,-21769.82
buyer_7,María,56,ES30209544742433791682,TRX_N-00544-28469827,2023-04-10T12:20:27,Portugalete,expenses,cash,-100.0,-21869.82
buyer_7,María,56,ES30209544742433791682,TRX_N-00545-17770528,2023-04-12T11:56:02,Portugalete,expenses,food,-77.31,-21947.13
buyer_7,María,56,ES30209544742433791682,TRX_N-00546-60543144,2023-04-12T17:58:45,Portugalete,expenses,children,-65.7,-22012.83
buyer_7,María,56,ES30209544742433791682,TRX_N-00547-23354714,2023-04-13T09:49:46,Portugalete,expenses,leisure,-35.82,-22048.65
buyer_7,María,56,ES30209544742433791682,TRX_N-00548-73765643,2023-04-14T10:29:04,Salvatierra/Agurain,expenses,education,-74.4,-22123.05
buyer_7,María,56,ES30209544742433791682,TRX_N-00549-60872179,2023-04-15T19:06:32,Portugalete,expenses,food,-109.39,-22232.44
buyer_7,María,56,ES30209544742433791682,TRX_N-00550-05261983,2023-04-16T11:09:55,Portugalete,expenses,appliances,-215.28,-22447.72
buyer_7,María,56,ES30209544742433791682,TRX_N-00551-27132488,2023-04-18T06:55:08,Portugalete,expenses,cash,-100.0,-22547.72
buyer_7,María,56,ES30209544742433791682,TRX_N-00552-54251492,2023-04-19T12:09:11,Portugalete,expenses,food,-74.09,-22621.81
buyer_7,María,56,ES30209544742433791682,TRX_N-00553-89664309,2023-04-20T16:14:01,Erandio,expenses,cash,-100.0,-22721.81
buyer_7,María,56,ES30209544742433791682,TRX_N-00554-54636966,2023-04-21T19:35:30,Portugalete,expenses,transport,-48.38,-22770.19
buyer_7,María,56,ES30209544742433791682,TRX_N-00555-77173439,2023-04-22T11:44:56,Alegría-Dulantzi,expenses,food,-84.12,-22854.31
buyer_7,María,56,ES30209544742433791682,TRX_N-00556-27705984,2023-04-25T13:36:50,Portugalete,expenses,food,-75.8,-22930.11
buyer_7,María,56,ES30209544742433791682,TRX_N-00557-89685316,2023-04-25T17:50:52,Portugalete,expenses,appliances,-189.89,-23120.0
buyer_7,María,56,ES30209544742433791682,TRX_N-00558-63168192,2023-04-25T21:27:51,Portugalete,expenses,gifts,-771.84,-23891.84
buyer_7,María,56,ES30209544742433791682,TRX_N-00559-50640912,2023-04-26T09:43:09,Portugalete,expenses,cash,-100.0,-23991.84
buyer_7,María,56,ES30209544742433791682,TRX_N-00560-72712716,2023-04-28T20:37:52,Portugalete,expenses,leisure,-32.2,-24024.04
buyer_7,María,56,ES30209544742433791682,TRX_N-00561-49771431,2023-04-28T15:18:20,Zarautz,expenses,cash,-100.0,-24124.04
buyer_7,María,56,ES30209544742433791682,TRX_N-00562-67841100,2023-04-29T12:19:18,Portugalete,expenses,leisure,-66.85,-24190.89
buyer_7,María,56,ES30209544742433791682,TRX_N-00563-65667483,2023-04-30T21:50:31,Portugalete,expenses,transport,-61.19,-24252.08
buyer_7,María,56,ES30209544742433791682,TRX_N-00564-31282444,2023-04-30T09:55:05,Portugalete,expenses,leisure,-65.48,-24317.56
buyer_7,María,56,ES30209544742433791682,TRX_N-00565-92043013,2023-05-01T15:41:43,Portugalete,incomes,salary,1417.21,-22900.35
buyer_7,María,56,ES30209544742433791682,TRX_N-00566-10677389,2023-05-01T15:41:43,Portugalete,incomes,salary_partner,1486.94,-21413.41
buyer_7,María,56,ES30209544742433791682,TRX_N-00567-31666288,2023-05-01T15:41:43,Portugalete,incomes,extra_income,181.97,-21231.44
buyer_7,María,56,ES30209544742433791682,TRX_N-00568-33590679,2023-05-01T17:22:33,Portugalete,expenses,cash,-100.0,-21331.44
buyer_7,María,56,ES30209544742433791682,TRX_N-00569-96091714,2023-05-02T19:53:28,Portugalete,expenses,education,-59.06,-21390.5
buyer_7,María,56,ES30209544742433791682,TRX_N-00570-34614607,2023-05-03T20:24:53,Portugalete,expenses,leisure,-81.03,-21471.53
buyer_7,María,56,ES30209544742433791682,TRX_N-00571-66061769,2023-05-03T18:35:54,Portugalete,expenses,healthcare,-70.62,-21542.15
buyer_7,María,56,ES30209544742433791682,TRX_N-00572-35987360,2023-05-03T14:39:36,Portugalete,expenses,travel,-811.42,-22353.57
buyer_7,María,56,ES30209544742433791682,TRX_N-00573-20711737,2023-05-04T11:25:50,Portugalete,expenses,mortgage,-1052.07,-23405.64
buyer_7,María,56,ES30209544742433791682,TRX_N-00574-26039072,2023-05-04T19:01:48,Portugalete,expenses,leisure,-63.87,-23469.51
buyer_7,María,56,ES30209544742433791682,TRX_N-00575-39761764,2023-05-05T19:26:08,Portugalete,expenses,water,-41.39,-23510.9
buyer_7,María,56,ES30209544742433791682,TRX_N-00576-61330955,2023-05-05T14:17:52,Irun,expenses,food,-113.2,-23624.1
buyer_7,María,56,ES30209544742433791682,TRX_N-00577-03765038,2023-05-06T13:11:14,Portugalete,expenses,phone,-41.22,-23665.32
buyer_7,María,56,ES30209544742433791682,TRX_N-00578-68292790,2023-05-06T11:21:32,Hernani,expenses,travel,-1154.05,-24819.37
buyer_7,María,56,ES30209544742433791682,TRX_N-00579-42815256,2023-05-07T11:46:51,Portugalete,expenses,gas,-66.4,-24885.77
buyer_7,María,56,ES30209544742433791682,TRX_N-00580-75457864,2023-05-08T11:49:21,Portugalete,expenses,electricity,-21.52,-24907.29
buyer_7,María,56,ES30209544742433791682,TRX_N-00581-14431482,2023-05-08T21:28:04,Portugalete,expenses,internet,-42.0,-24949.29
buyer_7,María,56,ES30209544742433791682,TRX_N-00582-48015988,2023-05-08T16:55:47,Portugalete,expenses,gifts,-849.3,-25798.59
buyer_7,María,56,ES30209544742433791682,TRX_N-00583-82034236,2023-05-09T12:15:59,Portugalete,expenses,food,-74.86,-25873.45
buyer_7,María,56,ES30209544742433791682,TRX_N-00584-85140200,2023-05-10T16:41:12,Portugalete,expenses,gifts,-524.51,-26397.96
buyer_7,María,56,ES30209544742433791682,TRX_N-00585-37469197,2023-05-11T10:30:43,Portugalete,expenses,healthcare,-97.71,-26495.67
buyer_7,María,56,ES30209544742433791682,TRX_N-00586-78622367,2023-05-13T20:24:34,Eibar,expenses,food,-68.98,-26564.65
buyer_7,María,56,ES30209544742433791682,TRX_N-00587-04484536,2023-05-13T17:07:46,Portugalete,expenses,clothing,-47.47,-26612.12
buyer_7,María,56,ES30209544742433791682,TRX_N-00588-22127947,2023-05-14T08:49:50,Portugalete,expenses,transport,-74.03,-26686.15
buyer_7,María,56,ES30209544742433791682,TRX_N-00589-82545369,2023-05-14T14:16:02,Portugalete,expenses,children,-193.25,-26879.4
buyer_7,María,56,ES30209544742433791682,TRX_N-00590-21822303,2023-05-15T14:38:28,Portugalete,expenses,transport,-77.81,-26957.21
buyer_7,María,56,ES30209544742433791682,TRX_N-00591-03592815,2023-05-17T16:48:23,Portugalete,expenses,gifts,-756.9,-27714.11
buyer_7,María,56,ES30209544742433791682,TRX_N-00592-08964028,2023-05-17T19:25:20,Portugalete,expenses,children,-164.16,-27878.27
buyer_7,María,56,ES30209544742433791682,TRX_N-00593-33630755,2023-05-19T17:32:37,Portugalete,expenses,transport,-43.6,-27921.87
buyer_7,María,56,ES30209544742433791682,TRX_N-00594-39103000,2023-05-19T14:06:00,Portugalete,expenses,children,-198.78,-28120.65
buyer_7,María,56,ES30209544742433791682,TRX_N-00595-51018987,2023-05-21T19:41:36,Portugalete,expenses,children,-126.83,-28247.48
buyer_7,María,56,ES30209544742433791682,TRX_N-00596-57479925,2023-05-22T10:14:36,Portugalete,expenses,clothing,-111.07,-28358.55
buyer_7,María,56,ES30209544742433791682,TRX_N-00597-15946459,2023-05-22T17:41:19,Portugalete,expenses,travel,-691.54,-29050.09
buyer_7,María,56,ES30209544742433791682,TRX_N-00598-75071760,2023-05-23T17:06:55,Portugalete,expenses,children,-248.86,-29298.95
buyer_7,María,56,ES30209544742433791682,TRX_N-00599-47344022,2023-05-24T09:56:27,Portugalete,expenses,food,-111.32,-29410.27
buyer_7,María,56,ES30209544742433791682,TRX_N-00600-26366238,2023-05-25T17:27:41,Portugalete,expenses,transport,-66.54,-29476.81
buyer_7,María,56,ES30209544742433791682,TRX_N-00601-29229969,2023-05-25T11:07:24,Portugalete,expenses,education,-60.95,-29537.76
buyer_7,María,56,ES30209544742433791682,TRX_N-00602-38595711,2023-05-26T12:07:58,Portugalete,expenses,repairs,-110.64,-29648.4
buyer_7,María,56,ES30209544742433791682,TRX_N-00603-79684172,2023-05-29T11:53:30,Portugalete,expenses,appliances,-120.6,-29769.0
buyer_7,María,56,ES30209544742433791682,TRX_N-00604-90623844,2023-05-31T20:11:45,Portugalete,expenses,food,-92.23,-29861.23
buyer_7,María,56,ES30209544742433791682,TRX_N-00605-24042475,2023-05-31T17:53:30,Portugalete,expenses,repairs,-303.48,-30164.71
buyer_7,María,56,ES30209544742433791682,TRX_N-00606-83150077,2023-06-01T17:47:46,Portugalete,incomes,salary,1417.21,-28747.5
buyer_7,María,56,ES30209544742433791682,TRX_N-00607-64475900,2023-06-01T17:47:46,Portugalete,incomes,salary_partner,1486.94,-27260.56
buyer_7,María,56,ES30209544742433791682,TRX_N-00608-99828616,2023-06-01T17:47:46,Portugalete,incomes,salary_bonus,1046.36,-26214.2
buyer_7,María,56,ES30209544742433791682,TRX_N-00609-34464617,2023-06-01T17:47:46,Portugalete,incomes,salary_partner_bonus,1081.67,-25132.53
buyer_7,María,56,ES30209544742433791682,TRX_N-00610-83819646,2023-06-01T12:08:32,Portugalete,expenses,transport,-55.67,-25188.2
buyer_7,María,56,ES30209544742433791682,TRX_N-00611-74761691,2023-06-02T20:38:57,Portugalete,expenses,food,-65.64,-25253.84
buyer_7,María,56,ES30209544742433791682,TRX_N-00612-89483313,2023-06-02T15:27:22,Portugalete,expenses,leisure,-49.63,-25303.47
buyer_7,María,56,ES30209544742433791682,TRX_N-00613-47007904,2023-06-03T12:30:09,Andoain,expenses,cash,-100.0,-25403.47
buyer_7,María,56,ES30209544742433791682,TRX_N-00614-09739871,2023-06-03T11:54:31,Portugalete,expenses,appliances,-317.59,-25721.06
buyer_7,María,56,ES30209544742433791682,TRX_N-00615-27053507,2023-06-04T11:54:54,Portugalete,expenses,mortgage,-1052.07,-26773.13
buyer_7,María,56,ES30209544742433791682,TRX_N-00616-17270635,2023-06-04T11:56:31,Portugalete,expenses,education,-56.93,-26830.06
buyer_7,María,56,ES30209544742433791682,TRX_N-00617-10584344,2023-06-06T08:46:07,Portugalete,expenses,cash,-100.0,-26930.06
buyer_7,María,56,ES30209544742433791682,TRX_N-00618-88960711,2023-06-06T22:28:11,Portugalete,expenses,gifts,-747.95,-27678.01
buyer_7,María,56,ES30209544742433791682,TRX_N-00619-95294252,2023-06-07T14:47:10,Portugalete,expenses,gas,-32.51,-27710.52
buyer_7,María,56,ES30209544742433791682,TRX_N-00620-05267388,2023-06-07T17:47:37,Portugalete,expenses,phone,-38.72,-27749.24
buyer_7,María,56,ES30209544742433791682,TRX_N-00621-86224033,2023-06-08T09:24:41,Portugalete,expenses,electricity,-79.03,-27828.27
buyer_7,María,56,ES30209544742433791682,TRX_N-00622-80001620,2023-06-08T11:43:55,Portugalete,expenses,internet,-42.0,-27870.27
buyer_7,María,56,ES30209544742433791682,TRX_N-00623-09964471,2023-06-08T11:56:22,Portugalete,expenses,water,-25.34,-27895.61
buyer_7,María,56,ES30209544742433791682,TRX_N-00624-23950458,2023-06-08T08:53:09,Portugalete,expenses,cash,-100.0,-27995.61
buyer_7,María,56,ES30209544742433791682,TRX_N-00625-14402575,2023-06-10T18:01:50,Portugalete,expenses,transport,-56.43,-28052.04
buyer_7,María,56,ES30209544742433791682,TRX_N-00626-11438817,2023-06-10T08:55:00,Portugalete,expenses,healthcare,-155.47,-28207.51
buyer_7,María,56,ES30209544742433791682,TRX_N-00627-61032662,2023-06-13T20:28:48,Portugalete,expenses,cash,-100.0,-28307.51
buyer_7,María,56,ES30209544742433791682,TRX_N-00628-87048267,2023-06-15T11:04:35,Portugalete,expenses,repairs,-67.51,-28375.02
buyer_7,María,56,ES30209544742433791682,TRX_N-00629-72978391,2023-06-18T17:26:11,Portugalete,expenses,transport,-87.23,-28462.25
buyer_7,María,56,ES30209544742433791682,TRX_N-00630-49935534,2023-06-19T11:08:27,Portugalete,expenses,cash,-100.0,-28562.25
buyer_7,María,56,ES30209544742433791682,TRX_N-00631-84803172,2023-06-21T17:16:36,Portugalete,expenses,cash,-100.0,-28662.25
buyer_7,María,56,ES30209544742433791682,TRX_N-00632-99983243,2023-06-23T08:33:09,Portugalete,expenses,repairs,-112.62,-28774.87
buyer_7,María,56,ES30209544742433791682,TRX_N-00633-51684339,2023-06-24T14:09:12,Portugalete,expenses,education,-53.4,-28828.27
buyer_7,María,56,ES30209544742433791682,TRX_N-00634-53999126,2023-06-24T14:53:54,Labastida,expenses,gifts,-645.92,-29474.19
buyer_7,María,56,ES30209544742433791682,TRX_N-00635-49360571,2023-06-25T10:50:35,Portugalete,expenses,education,-51.13,-29525.32
buyer_7,María,56,ES30209544742433791682,TRX_N-00636-74351058,2023-06-27T18:50:22,Portugalete,expenses,food,-93.45,-29618.77
buyer_7,María,56,ES30209544742433791682,TRX_N-00637-60827011,2023-06-27T18:41:40,Portugalete,expenses,children,-109.8,-29728.57
buyer_7,María,56,ES30209544742433791682,TRX_N-00638-23523367,2023-06-28T15:52:13,Portugalete,expenses,education,-46.3,-29774.87
buyer_7,María,56,ES30209544742433791682,TRX_N-00639-69114843,2023-07-01T23:22:58,Portugalete,incomes,salary,1417.21,-28357.66
buyer_7,María,56,ES30209544742433791682,TRX_N-00640-06665485,2023-07-01T23:22:58,Portugalete,incomes,salary_partner,1486.94,-26870.72
buyer_7,María,56,ES30209544742433791682,TRX_N-00641-96809842,2023-07-02T20:06:10,Portugalete,expenses,food,-89.56,-26960.28
buyer_7,María,56,ES30209544742433791682,TRX_N-00642-97449836,2023-07-03T12:29:22,Portugalete,expenses,food,-76.28,-27036.56
buyer_7,María,56,ES30209544742433791682,TRX_N-00643-52497761,2023-07-04T13:29:14,Portugalete,expenses,mortgage,-1052.07,-28088.63
buyer_7,María,56,ES30209544742433791682,TRX_N-00644-63595963,2023-07-06T08:02:57,Portugalete,expenses,water,-34.01,-28122.64
buyer_7,María,56,ES30209544742433791682,TRX_N-00645-38079769,2023-07-06T08:22:59,Portugalete,expenses,healthcare,-127.79,-28250.43
buyer_7,María,56,ES30209544742433791682,TRX_N-00646-16842969,2023-07-07T08:36:03,Portugalete,expenses,electricity,-75.72,-28326.15
buyer_7,María,56,ES30209544742433791682,TRX_N-00647-46584837,2023-07-07T15:36:59,Portugalete,expenses,internet,-42.0,-28368.15
buyer_7,María,56,ES30209544742433791682,TRX_N-00648-26441288,2023-07-07T18:30:04,Portugalete,expenses,children,-205.45,-28573.6
buyer_7,María,56,ES30209544742433791682,TRX_N-00649-17585521,2023-07-08T20:10:11,Portugalete,expenses,gas,-70.96,-28644.56
buyer_7,María,56,ES30209544742433791682,TRX_N-00650-74004438,2023-07-08T18:58:22,Portugalete,expenses,phone,-38.76,-28683.32
buyer_7,María,56,ES30209544742433791682,TRX_N-00651-67637960,2023-07-08T08:01:40,Portugalete,expenses,children,-75.0,-28758.32
buyer_7,María,56,ES30209544742433791682,TRX_N-00652-51999286,2023-07-09T12:15:09,Portugalete,expenses,clothing,-131.93,-28890.25
buyer_7,María,56,ES30209544742433791682,TRX_N-00653-29771186,2023-07-11T16:18:31,Portugalete,expenses,transport,-40.43,-28930.68
buyer_7,María,56,ES30209544742433791682,TRX_N-00654-27019436,2023-07-13T13:08:38,Portugalete,expenses,food,-103.25,-29033.93
buyer_7,María,56,ES30209544742433791682,TRX_N-00655-59974526,2023-07-13T14:29:20,Alegría-Dulantzi,expenses,repairs,-315.33,-29349.26
buyer_7,María,56,ES30209544742433791682,TRX_N-00656-70615948,2023-07-14T10:13:47,Portugalete,expenses,leisure,-64.08,-29413.34
buyer_7,María,56,ES30209544742433791682,TRX_N-00657-39841139,2023-07-14T23:04:19,Andoain,expenses,repairs,-288.72,-29702.06
buyer_7,María,56,ES30209544742433791682,TRX_N-00658-54989873,2023-07-15T15:04:58,Portugalete,expenses,gifts,-159.65,-29861.71
buyer_7,María,56,ES30209544742433791682,TRX_N-00659-08338345,2023-07-16T06:08:42,Portugalete,expenses,leisure,-60.61,-29922.32
buyer_7,María,56,ES30209544742433791682,TRX_N-00660-63643614,2023-07-16T14:01:24,Portugalete,expenses,clothing,-122.28,-30044.6
buyer_7,María,56,ES30209544742433791682,TRX_N-00661-15056340,2023-07-18T11:52:01,Portugalete,expenses,food,-117.15,-30161.75
buyer_7,María,56,ES30209544742433791682,TRX_N-00662-42365581,2023-07-18T12:03:26,Portugalete,expenses,children,-152.22,-30313.97
buyer_7,María,56,ES30209544742433791682,TRX_N-00663-82795371,2023-07-19T15:15:35,Portugalete,expenses,food,-66.21,-30380.18
buyer_7,María,56,ES30209544742433791682,TRX_N-00664-71897688,2023-07-19T18:21:23,Portugalete,expenses,children,-251.26,-30631.44
buyer_7,María,56,ES30209544742433791682,TRX_N-00665-16120967,2023-07-20T10:20:43,Portugalete,expenses,leisure,-38.63,-30670.07
buyer_7,María,56,ES30209544742433791682,TRX_N-00666-36059686,2023-07-21T20:00:36,Portugalete,expenses,food,-95.58,-30765.65
buyer_7,María,56,ES30209544742433791682,TRX_N-00667-53490444,2023-07-21T16:59:23,Pasaia,expenses,leisure,-50.63,-30816.28
buyer_7,María,56,ES30209544742433791682,TRX_N-00668-50289427,2023-07-21T16:40:58,Zarautz,expenses,clothing,-60.42,-30876.7
buyer_7,María,56,ES30209544742433791682,TRX_N-00669-03703053,2023-07-21T18:17:23,Portugalete,expenses,cash,-100.0,-30976.7
buyer_7,María,56,ES30209544742433791682,TRX_N-00670-23931695,2023-07-23T15:32:46,Portugalete,expenses,transport,-66.04,-31042.74
buyer_7,María,56,ES30209544742433791682,TRX_N-00671-37512908,2023-07-24T16:00:16,Portugalete,expenses,clothing,-49.46,-31092.2
buyer_7,María,56,ES30209544742433791682,TRX_N-00672-14025314,2023-07-27T22:41:44,Portugalete,expenses,transport,-79.19,-31171.39
buyer_7,María,56,ES30209544742433791682,TRX_N-00673-01834569,2023-07-29T13:49:58,Portugalete,expenses,children,-126.88,-31298.27
buyer_7,María,56,ES30209544742433791682,TRX_N-00674-39181997,2023-07-31T05:50:02,Portugalete,expenses,leisure,-51.47,-31349.74
buyer_7,María,56,ES30209544742433791682,TRX_N-00675-92217099,2023-08-01T09:41:32,Portugalete,incomes,salary,1417.21,-29932.53
buyer_7,María,56,ES30209544742433791682,TRX_N-00676-48072382,2023-08-01T09:41:32,Portugalete,incomes,salary_partner,1486.94,-28445.59
buyer_7,María,56,ES30209544742433791682,TRX_N-00677-21963145,2023-08-01T19:11:23,Portugalete,expenses,gifts,-670.45,-29116.04
buyer_7,María,56,ES30209544742433791682,TRX_N-00678-43027663,2023-08-02T17:45:38,Portugalete,expenses,transport,-62.18,-29178.22
buyer_7,María,56,ES30209544742433791682,TRX_N-00679-73587031,2023-08-02T14:47:36,Portugalete,expenses,leisure,-69.12,-29247.34
buyer_7,María,56,ES30209544742433791682,TRX_N-00680-83717700,2023-08-02T10:01:15,Portugalete,expenses,repairs,-284.44,-29531.78
buyer_7,María,56,ES30209544742433791682,TRX_N-00681-28182876,2023-08-03T05:42:19,Portugalete,expenses,travel,-1610.17,-31141.95
buyer_7,María,56,ES30209544742433791682,TRX_N-00682-45930501,2023-08-04T14:17:44,Portugalete,expenses,mortgage,-1052.07,-32194.02
buyer_7,María,56,ES30209544742433791682,TRX_N-00683-45143763,2023-08-04T16:15:43,Portugalete,expenses,transport,-68.17,-32262.19
buyer_7,María,56,ES30209544742433791682,TRX_N-00684-89350127,2023-08-04T10:43:09,Portugalete,expenses,education,-78.66,-32340.85
buyer_7,María,56,ES30209544742433791682,TRX_N-00685-40888492,2023-08-05T11:58:10,Portugalete,expenses,electricity,-84.98,-32425.83
buyer_7,María,56,ES30209544742433791682,TRX_N-00686-04401609,2023-08-05T17:41:37,Portugalete,expenses,leisure,-24.91,-32450.74
buyer_7,María,56,ES30209544742433791682,TRX_N-00687-09702481,2023-08-05T08:58:32,Portugalete,expenses,cash,-100.0,-32550.74
buyer_7,María,56,ES30209544742433791682,TRX_N-00688-23428864,2023-08-05T08:45:31,Portugalete,expenses,gifts,-153.43,-32704.17
buyer_7,María,56,ES30209544742433791682,TRX_N-00689-22570055,2023-08-06T17:13:52,Portugalete,expenses,water,-31.56,-32735.73
buyer_7,María,56,ES30209544742433791682,TRX_N-00690-16638487,2023-08-06T13:48:42,Portugalete,expenses,food,-91.85,-32827.58
buyer_7,María,56,ES30209544742433791682,TRX_N-00691-35117583,2023-08-07T20:41:35,Portugalete,expenses,food,-69.54,-32897.12
buyer_7,María,56,ES30209544742433791682,TRX_N-00692-59707352,2023-08-08T09:59:42,Portugalete,expenses,phone,-38.94,-32936.06
buyer_7,María,56,ES30209544742433791682,TRX_N-00693-14590397,2023-08-08T18:08:15,Portugalete,expenses,gas,-104.63,-33040.69
buyer_7,María,56,ES30209544742433791682,TRX_N-00694-18996629,2023-08-08T16:30:50,Portugalete,expenses,internet,-42.0,-33082.69
buyer_7,María,56,ES30209544742433791682,TRX_N-00695-34209695,2023-08-08T10:22:31,Bilbao,expenses,transport,-66.03,-33148.72
buyer_7,María,56,ES30209544742433791682,TRX_N-00696-34596297,2023-08-08T10:53:51,Portugalete,expenses,repairs,-291.52,-33440.24
buyer_7,María,56,ES30209544742433791682,TRX_N-00697-25964417,2023-08-10T01:09:05,Portugalete,expenses,leisure,-77.59,-33517.83
buyer_7,María,56,ES30209544742433791682,TRX_N-00698-81736845,2023-08-10T14:33:15,Berango,expenses,healthcare,-145.39,-33663.22
buyer_7,María,56,ES30209544742433791682,TRX_N-00699-22208040,2023-08-10T16:38:06,Alegría-Dulantzi,expenses,cash,-100.0,-33763.22
buyer_7,María,56,ES30209544742433791682,TRX_N-00700-84798711,2023-08-11T19:07:33,Portugalete,expenses,transport,-61.71,-33824.93
buyer_7,María,56,ES30209544742433791682,TRX_N-00701-89564708,2023-08-12T16:45:33,Portugalete,expenses,cash,-100.0,-33924.93
buyer_7,María,56,ES30209544742433791682,TRX_N-00702-61574339,2023-08-13T18:14:05,Berango,expenses,cash,-100.0,-34024.93
buyer_7,María,56,ES30209544742433791682,TRX_N-00703-37181359,2023-08-14T12:24:29,Portugalete,expenses,cash,-100.0,-34124.93
buyer_7,María,56,ES30209544742433791682,TRX_N-00704-84613331,2023-08-16T23:15:03,Portugalete,expenses,clothing,-63.26,-34188.19
buyer_7,María,56,ES30209544742433791682,TRX_N-00705-04906731,2023-08-17T15:12:16,Portugalete,expenses,food,-69.97,-34258.16
buyer_7,María,56,ES30209544742433791682,TRX_N-00706-31298266,2023-08-20T18:06:55,Portugalete,expenses,cash,-100.0,-34358.16
buyer_7,María,56,ES30209544742433791682,TRX_N-00707-63515894,2023-08-20T14:00:05,Portugalete,expenses,repairs,-205.77,-34563.93
buyer_7,María,56,ES30209544742433791682,TRX_N-00708-08575338,2023-08-21T07:54:33,Portugalete,expenses,appliances,-122.88,-34686.81
buyer_7,María,56,ES30209544742433791682,TRX_N-00709-92777720,2023-08-22T14:29:35,Portugalete,expenses,cash,-100.0,-34786.81
buyer_7,María,56,ES30209544742433791682,TRX_N-00710-04065154,2023-08-23T07:48:52,Portugalete,expenses,transport,-64.06,-34850.87
buyer_7,María,56,ES30209544742433791682,TRX_N-00711-11550795,2023-08-23T12:37:40,Portugalete,expenses,clothing,-79.18,-34930.05
buyer_7,María,56,ES30209544742433791682,TRX_N-00712-85989000,2023-08-23T04:12:10,Portugalete,expenses,gifts,-739.92,-35669.97
buyer_7,María,56,ES30209544742433791682,TRX_N-00713-19664969,2023-08-27T16:56:59,Portugalete,expenses,cash,-100.0,-35769.97
buyer_7,María,56,ES30209544742433791682,TRX_N-00714-08545231,2023-08-28T16:54:34,Portugalete,expenses,cash,-100.0,-35869.97
buyer_7,María,56,ES30209544742433791682,TRX_N-00715-72917237,2023-08-28T15:42:18,Basauri,expenses,repairs,-219.34,-36089.31
buyer_7,María,56,ES30209544742433791682,TRX_N-00716-54237009,2023-08-29T00:59:21,Portugalete,expenses,cash,-100.0,-36189.31
buyer_7,María,56,ES30209544742433791682,TRX_N-00717-99185416,2023-08-30T15:43:08,Portugalete,expenses,cash,-100.0,-36289.31
buyer_7,María,56,ES30209544742433791682,TRX_N-00718-22460228,2023-08-31T13:14:56,Hernani,expenses,education,-66.61,-36355.92
buyer_7,María,56,ES30209544742433791682,TRX_N-00719-78976880,2023-09-01T12:09:19,Portugalete,incomes,salary,1417.21,-34938.71
buyer_7,María,56,ES30209544742433791682,TRX_N-00720-84469297,2023-09-01T12:09:19,Portugalete,incomes,salary_partner,1486.94,-33451.77
buyer_7,María,56,ES30209544742433791682,TRX_N-00721-85366967,2023-09-01T12:09:19,Portugalete,incomes,extra_income,181.97,-33269.8
buyer_7,María,56,ES30209544742433791682,TRX_N-00722-66950477,2023-09-01T13:23:41,Portugalete,expenses,children,-244.64,-33514.44
buyer_7,María,56,ES30209544742433791682,TRX_N-00723-97860754,2023-09-03T15:07:48,Portugalete,expenses,cash,-100.0,-33614.44
buyer_7,María,56,ES30209544742433791682,TRX_N-00724-29907711,2023-09-04T13:19:43,Portugalete,expenses,mortgage,-1052.07,-34666.51
buyer_7,María,56,ES30209544742433791682,TRX_N-00725-75192739,2023-09-04T08:07:33,Santurtzi,expenses,leisure,-76.66,-34743.17
buyer_7,María,56,ES30209544742433791682,TRX_N-00726-97211742,2023-09-05T14:10:31,Portugalete,expenses,food,-96.88,-34840.05
buyer_7,María,56,ES30209544742433791682,TRX_N-00727-93125732,2023-09-05T19:03:39,Portugalete,expenses,clothing,-83.98,-34924.03
buyer_7,María,56,ES30209544742433791682,TRX_N-00728-38769633,2023-09-05T18:04:05,Portugalete,expenses,cash,-100.0,-35024.03
buyer_7,María,56,ES30209544742433791682,TRX_N-00729-94248088,2023-09-06T23:01:16,Portugalete,expenses,gas,-96.16,-35120.19
buyer_7,María,56,ES30209544742433791682,TRX_N-00730-52714028,2023-09-06T13:08:52,Portugalete,expenses,food,-64.54,-35184.73
buyer_7,María,56,ES30209544742433791682,TRX_N-00731-29393928,2023-09-06T13:41:00,Portugalete,expenses,transport,-80.87,-35265.6
buyer_7,María,56,ES30209544742433791682,TRX_N-00732-24361833,2023-09-07T18:47:35,Portugalete,expenses,leisure,-40.22,-35305.82
buyer_7,María,56,ES30209544742433791682,TRX_N-00733-53858174,2023-09-07T22:43:35,Salvatierra/Agurain,expenses,clothing,-116.0,-35421.82
buyer_7,María,56,ES30209544742433791682,TRX_N-00734-91270655,2023-09-08T13:12:14,Portugalete,expenses,internet,-42.0,-35463.82
buyer_7,María,56,ES30209544742433791682,TRX_N-00735-76261007,2023-09-08T11:17:07,Portugalete,expenses,water,-25.8,-35489.62
buyer_7,María,56,ES30209544742433791682,TRX_N-00736-40068571,2023-09-08T19:20:19,Portugalete,expenses,electricity,-60.25,-35549.87
buyer_7,María,56,ES30209544742433791682,TRX_N-00737-84659571,2023-09-08T09:58:55,Portugalete,expenses,phone,-44.85,-35594.72
buyer_7,María,56,ES30209544742433791682,TRX_N-00738-41955226,2023-09-08T19:51:21,Portugalete,expenses,cash,-100.0,-35694.72
buyer_7,María,56,ES30209544742433791682,TRX_N-00739-75428789,2023-09-09T16:09:29,Hondarribia,expenses,cash,-100.0,-35794.72
buyer_7,María,56,ES30209544742433791682,TRX_N-00740-04056450,2023-09-10T20:33:56,Portugalete,expenses,transport,-88.24,-35882.96
buyer_7,María,56,ES30209544742433791682,TRX_N-00741-53249474,2023-09-10T10:17:16,Durango,expenses,clothing,-129.87,-36012.83
buyer_7,María,56,ES30209544742433791682,TRX_N-00742-48835686,2023-09-11T13:51:44,Portugalete,expenses,cash,-100.0,-36112.83
buyer_7,María,56,ES30209544742433791682,TRX_N-00743-91850974,2023-09-13T17:23:42,Lasarte-Oria,expenses,food,-74.82,-36187.65
buyer_7,María,56,ES30209544742433791682,TRX_N-00744-87605897,2023-09-13T14:40:37,Portugalete,expenses,healthcare,-165.95,-36353.6
buyer_7,María,56,ES30209544742433791682,TRX_N-00745-57266099,2023-09-14T14:23:07,Portugalete,expenses,leisure,-23.66,-36377.26
buyer_7,María,56,ES30209544742433791682,TRX_N-00746-62599822,2023-09-15T18:54:43,Andoain,expenses,transport,-54.59,-36431.85
buyer_7,María,56,ES30209544742433791682,TRX_N-00747-41253905,2023-09-15T19:45:57,Portugalete,expenses,appliances,-317.81,-36749.66
buyer_7,María,56,ES30209544742433791682,TRX_N-00748-60636794,2023-09-16T12:53:08,Portugalete,expenses,gifts,-664.77,-37414.43
buyer_7,María,56,ES30209544742433791682,TRX_N-00749-65205340,2023-09-17T20:16:26,Portugalete,expenses,transport,-86.94,-37501.37
buyer_7,María,56,ES30209544742433791682,TRX_N-00750-66443344,2023-09-17T10:17:08,Portugalete,expenses,gifts,-340.52,-37841.89
buyer_7,María,56,ES30209544742433791682,TRX_N-00751-44837202,2023-09-18T15:47:19,Portugalete,expenses,food,-115.67,-37957.56
buyer_7,María,56,ES30209544742433791682,TRX_N-00752-72643013,2023-09-18T09:40:51,Portugalete,expenses,children,-77.21,-38034.77
buyer_7,María,56,ES30209544742433791682,TRX_N-00753-59777975,2023-09-19T15:19:16,Portugalete,expenses,leisure,-35.27,-38070.04
buyer_7,María,56,ES30209544742433791682,TRX_N-00754-52637682,2023-09-19T09:44:45,Portugalete,expenses,cash,-100.0,-38170.04
buyer_7,María,56,ES30209544742433791682,TRX_N-00755-23368040,2023-09-23T11:32:48,Portugalete,expenses,transport,-43.61,-38213.65
buyer_7,María,56,ES30209544742433791682,TRX_N-00756-75762608,2023-09-24T15:28:35,Portugalete,expenses,healthcare,-120.62,-38334.27
buyer_7,María,56,ES30209544742433791682,TRX_N-00757-44432268,2023-09-26T14:55:47,Zarautz,expenses,food,-74.56,-38408.83
buyer_7,María,56,ES30209544742433791682,TRX_N-00758-84221760,2023-09-27T11:19:53,Zuia,expenses,education,-70.63,-38479.46
buyer_7,María,56,ES30209544742433791682,TRX_N-00759-86798432,2023-09-28T08:58:18,Portugalete,expenses,cash,-100.0,-38579.46
buyer_7,María,56,ES30209544742433791682,TRX_N-00760-01361772,2023-09-29T18:48:07,Portugalete,expenses,repairs,-71.04,-38650.5
buyer_7,María,56,ES30209544742433791682,TRX_N-00761-62708713,2023-10-01T21:51:06,Portugalete,incomes,salary,1417.21,-37233.29
buyer_7,María,56,ES30209544742433791682,TRX_N-00762-82103812,2023-10-01T21:51:06,Portugalete,incomes,salary_partner,1486.94,-35746.35
buyer_7,María,56,ES30209544742433791682,TRX_N-00763-86913144,2023-10-01T18:01:47,Portugalete,expenses,transport,-80.85,-35827.2
buyer_7,María,56,ES30209544742433791682,TRX_N-00764-96317433,2023-10-01T12:50:12,Durango,expenses,education,-72.63,-35899.83
buyer_7,María,56,ES30209544742433791682,TRX_N-00765-42566278,2023-10-04T14:26:46,Portugalete,expenses,mortgage,-1052.07,-36951.9
buyer_7,María,56,ES30209544742433791682,TRX_N-00766-23822713,2023-10-05T16:37:01,Portugalete,expenses,electricity,-62.01,-37013.91
buyer_7,María,56,ES30209544742433791682,TRX_N-00767-34697077,2023-10-05T09:21:47,Portugalete,expenses,gas,-91.02,-37104.93
buyer_7,María,56,ES30209544742433791682,TRX_N-00768-16689564,2023-10-05T14:49:44,Portugalete,expenses,leisure,-78.35,-37183.28
buyer_7,María,56,ES30209544742433791682,TRX_N-00769-21355105,2023-10-05T18:33:37,Portugalete,expenses,education,-70.17,-37253.45
buyer_7,María,56,ES30209544742433791682,TRX_N-00770-26546770,2023-10-05T10:32:54,Andoain,expenses,gifts,-51.4,-37304.85
buyer_7,María,56,ES30209544742433791682,TRX_N-00771-36897737,2023-10-06T20:01:47,Portugalete,expenses,water,-37.34,-37342.19
buyer_7,María,56,ES30209544742433791682,TRX_N-00772-55114810,2023-10-06T15:41:08,Portugalete,expenses,phone,-41.63,-37383.82
buyer_7,María,56,ES30209544742433791682,TRX_N-00773-00782707,2023-10-07T14:33:36,Portugalete,expenses,food,-111.1,-37494.92
buyer_7,María,56,ES30209544742433791682,TRX_N-00774-77439254,2023-10-07T20:00:40,Mungia,expenses,leisure,-37.19,-37532.11
buyer_7,María,56,ES30209544742433791682,TRX_N-00775-67214074,2023-10-08T20:30:50,Portugalete,expenses,internet,-42.0,-37574.11
buyer_7,María,56,ES30209544742433791682,TRX_N-00776-28411039,2023-10-08T09:13:07,Portugalete,expenses,food,-105.96,-37680.07
buyer_7,María,56,ES30209544742433791682,TRX_N-00777-93199126,2023-10-09T20:34:10,Portugalete,expenses,leisure,-79.22,-37759.29
buyer_7,María,56,ES30209544742433791682,TRX_N-00778-73120115,2023-10-10T14:59:26,Portugalete,expenses,food,-77.91,-37837.2
buyer_7,María,56,ES30209544742433791682,TRX_N-00779-98134504,2023-10-10T06:20:58,Hondarribia,expenses,cash,-100.0,-37937.2
buyer_7,María,56,ES30209544742433791682,TRX_N-00780-57969819,2023-10-11T19:54:27,Portugalete,expenses,education,-59.24,-37996.44
buyer_7,María,56,ES30209544742433791682,TRX_N-00781-19484970,2023-10-14T23:07:47,Arrasate,expenses,cash,-100.0,-38096.44
buyer_7,María,56,ES30209544742433791682,TRX_N-00782-61599294,2023-10-15T10:25:06,Portugalete,expenses,food,-74.93,-38171.37
buyer_7,María,56,ES30209544742433791682,TRX_N-00783-91388222,2023-10-15T23:44:12,Portugalete,expenses,appliances,-118.19,-38289.56
buyer_7,María,56,ES30209544742433791682,TRX_N-00784-51655991,2023-10-17T13:33:33,Andoain,expenses,transport,-47.81,-38337.37
buyer_7,María,56,ES30209544742433791682,TRX_N-00785-64410808,2023-10-17T14:24:45,Portugalete,expenses,appliances,-417.43,-38754.8
buyer_7,María,56,ES30209544742433791682,TRX_N-00786-47645463,2023-10-18T20:09:37,Portugalete,expenses,leisure,-36.65,-38791.45
buyer_7,María,56,ES30209544742433791682,TRX_N-00787-65986195,2023-10-18T18:26:17,Portugalete,expenses,cash,-100.0,-38891.45
buyer_7,María,56,ES30209544742433791682,TRX_N-00788-95974957,2023-10-19T18:55:07,Portugalete,expenses,food,-71.5,-38962.95
buyer_7,María,56,ES30209544742433791682,TRX_N-00789-82705146,2023-10-19T15:51:31,Portugalete,expenses,leisure,-61.22,-39024.17
buyer_7,María,56,ES30209544742433791682,TRX_N-00790-15041434,2023-10-21T15:13:08,Donostia,expenses,food,-106.66,-39130.83
buyer_7,María,56,ES30209544742433791682,TRX_N-00791-13277480,2023-10-21T13:50:45,Portugalete,expenses,repairs,-210.14,-39340.97
buyer_7,María,56,ES30209544742433791682,TRX_N-00792-29032579,2023-10-22T15:22:48,Portugalete,expenses,gifts,-48.38,-39389.35
buyer_7,María,56,ES30209544742433791682,TRX_N-00793-77789774,2023-10-23T11:41:43,Portugalete,expenses,food,-91.86,-39481.21
buyer_7,María,56,ES30209544742433791682,TRX_N-00794-47663465,2023-10-23T17:16:11,Portugalete,expenses,leisure,-26.21,-39507.42
buyer_7,María,56,ES30209544742433791682,TRX_N-00795-78662267,2023-10-24T08:42:24,Portugalete,expenses,repairs,-104.64,-39612.06
buyer_7,María,56,ES30209544742433791682,TRX_N-00796-28233932,2023-10-25T18:06:00,Portugalete,expenses,food,-95.12,-39707.18
buyer_7,María,56,ES30209544742433791682,TRX_N-00797-22341246,2023-10-26T12:30:38,Portugalete,expenses,cash,-100.0,-39807.18
buyer_7,María,56,ES30209544742433791682,TRX_N-00798-61777543,2023-10-29T11:14:17,Portugalete,expenses,food,-77.9,-39885.08
buyer_7,María,56,ES30209544742433791682,TRX_N-00799-32974643,2023-10-31T12:03:06,Portugalete,expenses,transport,-89.5,-39974.58
buyer_7,María,56,ES30209544742433791682,TRX_N-00800-28804640,2023-11-01T09:34:05,Portugalete,incomes,salary,1417.21,-38557.37
buyer_7,María,56,ES30209544742433791682,TRX_N-00801-52788544,2023-11-01T09:34:05,Portugalete,incomes,salary_partner,1486.94,-37070.43
buyer_7,María,56,ES30209544742433791682,TRX_N-00802-81485947,2023-11-01T20:41:03,Bermeo,expenses,cash,-100.0,-37170.43
buyer_7,María,56,ES30209544742433791682,TRX_N-00803-64263205,2023-11-02T18:00:19,Portugalete,expenses,appliances,-78.8,-37249.23
buyer_7,María,56,ES30209544742433791682,TRX_N-00804-97672629,2023-11-04T07:32:33,Portugalete,expenses,mortgage,-1052.07,-38301.3
buyer_7,María,56,ES30209544742433791682,TRX_N-00805-82114739,2023-11-05T15:29:45,Portugalete,expenses,electricity,-83.46,-38384.76
buyer_7,María,56,ES30209544742433791682,TRX_N-00806-82749177,2023-11-06T09:13:47,Portugalete,expenses,water,-28.76,-38413.52
buyer_7,María,56,ES30209544742433791682,TRX_N-00807-08663844,2023-11-06T16:20:59,Portugalete,expenses,phone,-36.56,-38450.08
buyer_7,María,56,ES30209544742433791682,TRX_N-00808-12065020,2023-11-07T06:20:11,Portugalete,expenses,gas,-77.34,-38527.42
buyer_7,María,56,ES30209544742433791682,TRX_N-00809-90845999,2023-11-07T17:04:46,Portugalete,expenses,leisure,-74.22,-38601.64
buyer_7,María,56,ES30209544742433791682,TRX_N-00810-90713640,2023-11-08T12:12:23,Portugalete,expenses,internet,-42.0,-38643.64
buyer_7,María,56,ES30209544742433791682,TRX_N-00811-74656452,2023-11-08T09:35:01,Portugalete,expenses,cash,-100.0,-38743.64
buyer_7,María,56,ES30209544742433791682,TRX_N-00812-54358407,2023-11-10T12:35:03,Portugalete,expenses,leisure,-77.04,-38820.68
buyer_7,María,56,ES30209544742433791682,TRX_N-00813-16981697,2023-11-10T03:17:04,Portugalete,expenses,children,-276.77,-39097.45
buyer_7,María,56,ES30209544742433791682,TRX_N-00814-12926040,2023-11-11T11:54:41,Vitoria-Gasteiz,expenses,food,-73.12,-39170.57
buyer_7,María,56,ES30209544742433791682,TRX_N-00815-33884876,2023-11-11T17:30:26,Portugalete,expenses,leisure,-76.06,-39246.63
buyer_7,María,56,ES30209544742433791682,TRX_N-00816-26425787,2023-11-13T08:29:05,Portugalete,expenses,cash,-100.0,-39346.63
buyer_7,María,56,ES30209544742433791682,TRX_N-00817-11301178,2023-11-14T18:47:13,Portugalete,expenses,gifts,-504.61,-39851.24
buyer_7,María,56,ES30209544742433791682,TRX_N-00818-84715201,2023-11-15T13:05:54,Portugalete,expenses,children,-147.39,-39998.63
buyer_7,María,56,ES30209544742433791682,TRX_N-00819-43364952,2023-11-16T17:29:55,Iruña de Oca,expenses,leisure,-67.83,-40066.46
buyer_7,María,56,ES30209544742433791682,TRX_N-00820-49936849,2023-11-18T15:33:52,Donostia,expenses,cash,-100.0,-40166.46
buyer_7,María,56,ES30209544742433791682,TRX_N-00821-68547511,2023-11-18T04:23:58,Portugalete,expenses,repairs,-310.67,-40477.13
buyer_7,María,56,ES30209544742433791682,TRX_N-00822-83281908,2023-11-18T18:32:46,Portugalete,expenses,gifts,-761.47,-41238.6
buyer_7,María,56,ES30209544742433791682,TRX_N-00823-56622057,2023-11-20T09:23:29,Portugalete,expenses,healthcare,-53.22,-41291.82
buyer_7,María,56,ES30209544742433791682,TRX_N-00824-87162381,2023-11-20T18:00:56,Portugalete,expenses,gifts,-721.87,-42013.69
buyer_7,María,56,ES30209544742433791682,TRX_N-00825-62004421,2023-11-24T11:57:55,Portugalete,expenses,cash,-100.0,-42113.69
buyer_7,María,56,ES30209544742433791682,TRX_N-00826-18587522,2023-11-25T12:58:27,Portugalete,expenses,leisure,-39.23,-42152.92
buyer_7,María,56,ES30209544742433791682,TRX_N-00827-28658110,2023-11-25T11:14:31,Eibar,expenses,cash,-100.0,-42252.92
buyer_7,María,56,ES30209544742433791682,TRX_N-00828-27699236,2023-11-26T13:20:14,Portugalete,expenses,food,-114.14,-42367.06
buyer_7,María,56,ES30209544742433791682,TRX_N-00829-80719029,2023-11-27T15:58:29,Getxo,expenses,food,-108.19,-42475.25
buyer_7,María,56,ES30209544742433791682,TRX_N-00830-22829463,2023-11-27T12:40:15,Amurrio,expenses,repairs,-137.11,-42612.36
buyer_7,María,56,ES30209544742433791682,TRX_N-00831-24989251,2023-11-28T22:57:38,Portugalete,expenses,leisure,-55.43,-42667.79
buyer_7,María,56,ES30209544742433791682,TRX_N-00832-85710547,2023-11-28T01:11:03,Portugalete,expenses,children,-186.79,-42854.58
buyer_7,María,56,ES30209544742433791682,TRX_N-00833-84089064,2023-11-30T00:49:04,Santurtzi,expenses,food,-107.62,-42962.2
buyer_7,María,56,ES30209544742433791682,TRX_N-00834-48304145,2023-12-01T08:18:22,Portugalete,incomes,salary,1417.21,-41544.99
buyer_7,María,56,ES30209544742433791682,TRX_N-00835-12018709,2023-12-01T08:18:22,Portugalete,incomes,salary_partner,1486.94,-40058.05
buyer_7,María,56,ES30209544742433791682,TRX_N-00836-86134267,2023-12-01T08:18:22,Portugalete,incomes,salary_bonus,1064.12,-38993.93
buyer_7,María,56,ES30209544742433791682,TRX_N-00837-14238796,2023-12-01T08:18:22,Portugalete,incomes,salary_partner_bonus,1098.13,-37895.8
buyer_7,María,56,ES30209544742433791682,TRX_N-00838-41910280,2023-12-01T10:44:09,Portugalete,expenses,children,-209.52,-38105.32
buyer_7,María,56,ES30209544742433791682,TRX_N-00839-53478136,2023-12-04T09:01:26,Portugalete,expenses,mortgage,-1052.07,-39157.39
buyer_7,María,56,ES30209544742433791682,TRX_N-00840-52719865,2023-12-04T13:54:26,Portugalete,expenses,leisure,-46.93,-39204.32
buyer_7,María,56,ES30209544742433791682,TRX_N-00841-23482034,2023-12-04T08:46:55,Portugalete,expenses,education,-46.63,-39250.95
buyer_7,María,56,ES30209544742433791682,TRX_N-00842-66938219,2023-12-05T15:05:49,Portugalete,expenses,water,-34.21,-39285.16
buyer_7,María,56,ES30209544742433791682,TRX_N-00843-61617882,2023-12-05T17:54:17,Portugalete,expenses,gas,-108.58,-39393.74
buyer_7,María,56,ES30209544742433791682,TRX_N-00844-04608884,2023-12-06T08:24:20,Portugalete,expenses,electricity,-32.07,-39425.81
buyer_7,María,56,ES30209544742433791682,TRX_N-00845-88263607,2023-12-06T12:10:34,Portugalete,expenses,food,-106.93,-39532.74
buyer_7,María,56,ES30209544742433791682,TRX_N-00846-25875530,2023-12-06T09:56:23,Portugalete,expenses,education,-73.51,-39606.25
buyer_7,María,56,ES30209544742433791682,TRX_N-00847-72644318,2023-12-08T08:00:45,Portugalete,expenses,internet,-42.0,-39648.25
buyer_7,María,56,ES30209544742433791682,TRX_N-00848-71270642,2023-12-08T15:04:15,Portugalete,expenses,phone,-40.03,-39688.28
buyer_7,María,56,ES30209544742433791682,TRX_N-00849-22871769,2023-12-08T15:44:06,Portugalete,expenses,cash,-100.0,-39788.28
buyer_7,María,56,ES30209544742433791682,TRX_N-00850-26250464,2023-12-08T11:28:26,Portugalete,expenses,gifts,-731.75,-40520.03
buyer_7,María,56,ES30209544742433791682,TRX_N-00851-26529073,2023-12-12T22:31:41,Portugalete,expenses,gifts,-625.13,-41145.16
buyer_7,María,56,ES30209544742433791682,TRX_N-00852-93452587,2023-12-13T15:57:03,Portugalete,expenses,clothing,-52.04,-41197.2
buyer_7,María,56,ES30209544742433791682,TRX_N-00853-27343040,2023-12-13T18:50:13,Andoain,expenses,gifts,-750.02,-41947.22
buyer_7,María,56,ES30209544742433791682,TRX_N-00854-83371103,2023-12-15T17:13:34,Portugalete,expenses,food,-89.59,-42036.81
buyer_7,María,56,ES30209544742433791682,TRX_N-00855-57921361,2023-12-15T16:00:15,Portugalete,expenses,travel,-1786.27,-43823.08
buyer_7,María,56,ES30209544742433791682,TRX_N-00856-25162449,2023-12-15T10:00:55,Portugalete,expenses,repairs,-157.16,-43980.24
buyer_7,María,56,ES30209544742433791682,TRX_N-00857-21975038,2023-12-16T13:58:40,Portugalete,expenses,clothing,-98.17,-44078.41
buyer_7,María,56,ES30209544742433791682,TRX_N-00858-11950359,2023-12-16T17:14:08,Portugalete,expenses,repairs,-256.77,-44335.18
buyer_7,María,56,ES30209544742433791682,TRX_N-00859-53025222,2023-12-18T20:55:22,Portugalete,expenses,healthcare,-119.01,-44454.19
buyer_7,María,56,ES30209544742433791682,TRX_N-00860-31813954,2023-12-19T11:15:00,Portugalete,expenses,food,-98.05,-44552.24
buyer_7,María,56,ES30209544742433791682,TRX_N-00861-84583172,2023-12-19T08:02:11,Portugalete,expenses,leisure,-22.22,-44574.46
buyer_7,María,56,ES30209544742433791682,TRX_N-00862-46820252,2023-12-20T16:58:17,Salvatierra/Agurain,expenses,gifts,-728.12,-45302.58
buyer_7,María,56,ES30209544742433791682,TRX_N-00863-23764256,2023-12-24T09:14:21,Portugalete,expenses,leisure,-70.48,-45373.06
buyer_7,María,56,ES30209544742433791682,TRX_N-00864-59291048,2023-12-24T16:40:36,Portugalete,expenses,appliances,-276.14,-45649.2
buyer_7,María,56,ES30209544742433791682,TRX_N-00865-65238951,2023-12-25T03:04:10,Portugalete,expenses,leisure,-75.43,-45724.63
buyer_7,María,56,ES30209544742433791682,TRX_N-00866-19023791,2023-12-26T10:43:10,Portugalete,expenses,cash,-100.0,-45824.63
buyer_7,María,56,ES30209544742433791682,TRX_N-00867-13772274,2023-12-27T05:49:58,Portugalete,expenses,food,-93.23,-45917.86
buyer_7,María,56,ES30209544742433791682,TRX_N-00868-31883267,2023-12-27T16:06:08,Portugalete,expenses,leisure,-31.64,-45949.5
buyer_7,María,56,ES30209544742433791682,TRX_N-00869-73491378,2023-12-27T15:37:54,Portugalete,expenses,education,-55.67,-46005.17
buyer_7,María,56,ES30209544742433791682,TRX_N-00870-21812107,2023-12-28T18:29:53,Portugalete,expenses,healthcare,-73.82,-46078.99
buyer_7,María,56,ES30209544742433791682,TRX_N-00871-79805002,2023-12-28T12:28:11,Portugalete,expenses,cash,-100.0,-46178.99
buyer_7,María,56,ES30209544742433791682,TRX_N-00872-02336742,2024-01-01T19:21:29,Portugalete,incomes,salary,1454.66,-44724.33
buyer_7,María,56,ES30209544742433791682,TRX_N-00873-29279833,2024-01-01T19:21:29,Portugalete,incomes,salary_partner,1526.23,-43198.1
buyer_7,María,56,ES30209544742433791682,TRX_N-00874-01989788,2024-01-01T19:21:29,Portugalete,incomes,extra_income,181.97,-43016.13
buyer_7,María,56,ES30209544742433791682,TRX_N-00875-54434256,2024-01-04T17:24:28,Portugalete,expenses,mortgage,-1052.07,-44068.2
buyer_7,María,56,ES30209544742433791682,TRX_N-00876-26670784,2024-01-04T17:47:00,Portugalete,expenses,leisure,-27.43,-44095.63
buyer_7,María,56,ES30209544742433791682,TRX_N-00877-05709900,2024-01-04T02:45:49,Portugalete,expenses,education,-47.99,-44143.62
buyer_7,María,56,ES30209544742433791682,TRX_N-00878-71920891,2024-01-05T08:13:09,Portugalete,expenses,food,-102.34,-44245.96
buyer_7,María,56,ES30209544742433791682,TRX_N-00879-74029798,2024-01-06T15:15:14,Portugalete,expenses,repairs,-124.17,-44370.13
buyer_7,María,56,ES30209544742433791682,TRX_N-00880-87107623,2024-01-07T15:00:36,Portugalete,expenses,food,-71.3,-44441.43
buyer_7,María,56,ES30209544742433791682,TRX_N-00881-83504861,2024-01-07T12:57:31,Portugalete,expenses,transport,-67.11,-44508.54
buyer_7,María,56,ES30209544742433791682,TRX_N-00882-97146311,2024-01-08T23:50:46,Portugalete,expenses,electricity,-40.94,-44549.48
buyer_7,María,56,ES30209544742433791682,TRX_N-00883-73069520,2024-01-08T19:35:52,Portugalete,expenses,water,-33.51,-44582.99
buyer_7,María,56,ES30209544742433791682,TRX_N-00884-96942273,2024-01-08T11:42:47,Portugalete,expenses,gas,-42.73,-44625.72
buyer_7,María,56,ES30209544742433791682,TRX_N-00885-93632948,2024-01-08T15:41:15,Portugalete,expenses,internet,-42.0,-44667.72
buyer_7,María,56,ES30209544742433791682,TRX_N-00886-92489957,2024-01-08T21:31:03,Portugalete,expenses,phone,-36.1,-44703.82
buyer_7,María,56,ES30209544742433791682,TRX_N-00887-83379012,2024-01-08T20:19:17,Portugalete,expenses,food,-71.38,-44775.2
buyer_7,María,56,ES30209544742433791682,TRX_N-00888-23709763,2024-01-09T01:37:50,Portugalete,expenses,food,-81.52,-44856.72
buyer_7,María,56,ES30209544742433791682,TRX_N-00889-38499428,2024-01-09T12:58:00,Portugalete,expenses,leisure,-45.2,-44901.92
buyer_7,María,56,ES30209544742433791682,TRX_N-00890-98332231,2024-01-09T09:40:47,Portugalete,expenses,education,-73.57,-44975.49
buyer_7,María,56,ES30209544742433791682,TRX_N-00891-38265874,2024-01-10T18:42:18,Portugalete,expenses,transport,-75.37,-45050.86
buyer_7,María,56,ES30209544742433791682,TRX_N-00892-70063718,2024-01-10T23:46:32,Portugalete,expenses,cash,-100.0,-45150.86
buyer_7,María,56,ES30209544742433791682,TRX_N-00893-16507299,2024-01-11T23:22:03,Portugalete,expenses,food,-76.45,-45227.31
buyer_7,María,56,ES30209544742433791682,TRX_N-00894-61016132,2024-01-12T17:06:56,Portugalete,expenses,cash,-100.0,-45327.31
buyer_7,María,56,ES30209544742433791682,TRX_N-00895-78160389,2024-01-12T11:02:55,Erandio,expenses,gifts,-463.38,-45790.69
buyer_7,María,56,ES30209544742433791682,TRX_N-00896-65798127,2024-01-13T15:01:26,Galdakao,expenses,leisure,-80.95,-45871.64
buyer_7,María,56,ES30209544742433791682,TRX_N-00897-77861920,2024-01-15T13:26:28,Portugalete,expenses,leisure,-29.85,-45901.49
buyer_7,María,56,ES30209544742433791682,TRX_N-00898-03807377,2024-01-16T23:21:40,Elciego,expenses,food,-105.87,-46007.36
buyer_7,María,56,ES30209544742433791682,TRX_N-00899-87608608,2024-01-17T23:18:38,Portugalete,expenses,food,-116.77,-46124.13
buyer_7,María,56,ES30209544742433791682,TRX_N-00900-63005376,2024-01-18T20:49:09,Portugalete,expenses,food,-94.49,-46218.62
buyer_7,María,56,ES30209544742433791682,TRX_N-00901-61880866,2024-01-18T15:09:26,Portugalete,expenses,leisure,-68.21,-46286.83
buyer_7,María,56,ES30209544742433791682,TRX_N-00902-73230863,2024-01-19T18:01:12,Portugalete,expenses,food,-110.58,-46397.41
buyer_7,María,56,ES30209544742433791682,TRX_N-00903-07020409,2024-01-20T13:58:51,Portugalete,expenses,appliances,-397.39,-46794.8
buyer_7,María,56,ES30209544742433791682,TRX_N-00904-72359759,2024-01-21T14:03:50,Vitoria-Gasteiz,expenses,food,-83.99,-46878.79
buyer_7,María,56,ES30209544742433791682,TRX_N-00905-49496324,2024-01-21T15:54:04,Portugalete,expenses,healthcare,-116.01,-46994.8
buyer_7,María,56,ES30209544742433791682,TRX_N-00906-38468830,2024-01-21T10:06:16,Portugalete,expenses,travel,-1817.09,-48811.89
buyer_7,María,56,ES30209544742433791682,TRX_N-00907-17665181,2024-01-23T12:19:10,Portugalete,expenses,food,-62.9,-48874.79
buyer_7,María,56,ES30209544742433791682,TRX_N-00908-93171142,2024-01-24T10:07:06,Portugalete,expenses,transport,-76.63,-48951.42
buyer_7,María,56,ES30209544742433791682,TRX_N-00909-76150758,2024-01-27T11:07:28,Portugalete,expenses,food,-115.79,-49067.21
buyer_7,María,56,ES30209544742433791682,TRX_N-00910-54888100,2024-01-27T18:33:36,Portugalete,expenses,gifts,-727.83,-49795.04
buyer_7,María,56,ES30209544742433791682,TRX_N-00911-31381263,2024-01-31T14:25:19,Hondarribia,expenses,travel,-1523.45,-51318.49
buyer_7,María,56,ES30209544742433791682,TRX_N-00912-76164275,2024-02-01T09:34:35,Portugalete,incomes,salary,1454.66,-49863.83
buyer_7,María,56,ES30209544742433791682,TRX_N-00913-29197962,2024-02-01T09:34:35,Portugalete,incomes,salary_partner,1526.23,-48337.6
buyer_7,María,56,ES30209544742433791682,TRX_N-00914-32977760,2024-02-03T03:35:30,Portugalete,expenses,leisure,-54.15,-48391.75
buyer_7,María,56,ES30209544742433791682,TRX_N-00915-62728459,2024-02-04T08:41:17,Portugalete,expenses,mortgage,-1052.07,-49443.82
buyer_7,María,56,ES30209544742433791682,TRX_N-00916-49136551,2024-02-05T18:17:52,Portugalete,expenses,water,-39.59,-49483.41
buyer_7,María,56,ES30209544742433791682,TRX_N-00917-05019586,2024-02-05T19:38:16,Portugalete,expenses,gas,-33.18,-49516.59
buyer_7,María,56,ES30209544742433791682,TRX_N-00918-22943422,2024-02-06T20:54:19,Portugalete,expenses,internet,-42.0,-49558.59
buyer_7,María,56,ES30209544742433791682,TRX_N-00919-17573146,2024-02-06T08:49:46,Portugalete,expenses,phone,-44.07,-49602.66
buyer_7,María,56,ES30209544742433791682,TRX_N-00920-65926501,2024-02-08T20:05:39,Portugalete,expenses,electricity,-53.63,-49656.29
buyer_7,María,56,ES30209544742433791682,TRX_N-00921-51038948,2024-02-09T12:39:13,Getxo,expenses,transport,-54.43,-49710.72
buyer_7,María,56,ES30209544742433791682,TRX_N-00922-27372930,2024-02-09T17:18:09,Portugalete,expenses,cash,-100.0,-49810.72
buyer_7,María,56,ES30209544742433791682,TRX_N-00923-39688247,2024-02-10T16:16:35,Portugalete,expenses,transport,-56.93,-49867.65
buyer_7,María,56,ES30209544742433791682,TRX_N-00924-97439435,2024-02-10T20:20:06,Portugalete,expenses,cash,-100.0,-49967.65
buyer_7,María,56,ES30209544742433791682,TRX_N-00925-46030221,2024-02-13T12:08:31,Portugalete,expenses,cash,-100.0,-50067.65
buyer_7,María,56,ES30209544742433791682,TRX_N-00926-33165716,2024-02-13T20:08:58,Portugalete,expenses,gifts,-136.63,-50204.28
buyer_7,María,56,ES30209544742433791682,TRX_N-00927-54608937,2024-02-15T18:45:40,Portugalete,expenses,transport,-62.18,-50266.46
buyer_7,María,56,ES30209544742433791682,TRX_N-00928-60147334,2024-02-15T10:26:31,Portugalete,expenses,education,-63.93,-50330.39
buyer_7,María,56,ES30209544742433791682,TRX_N-00929-29313734,2024-02-16T15:37:45,Portugalete,expenses,appliances,-235.69,-50566.08
buyer_7,María,56,ES30209544742433791682,TRX_N-00930-68283919,2024-02-16T18:33:50,Iruña de Oca,expenses,repairs,-237.73,-50803.81
buyer_7,María,56,ES30209544742433791682,TRX_N-00931-20827034,2024-02-17T18:00:31,Portugalete,expenses,food,-114.71,-50918.52
buyer_7,María,56,ES30209544742433791682,TRX_N-00932-74675743,2024-02-18T11:11:02,Llodio,expenses,transport,-77.34,-50995.86
buyer_7,María,56,ES30209544742433791682,TRX_N-00933-27701320,2024-02-20T20:56:44,Irun,expenses,leisure,-49.85,-51045.71
buyer_7,María,56,ES30209544742433791682,TRX_N-00934-97348442,2024-02-20T13:06:47,Zuia,expenses,cash,-100.0,-51145.71
buyer_7,María,56,ES30209544742433791682,TRX_N-00935-63477400,2024-02-20T16:43:26,Portugalete,expenses,children,-238.78,-51384.49
buyer_7,María,56,ES30209544742433791682,TRX_N-00936-94420251,2024-02-21T21:42:16,Portugalete,expenses,food,-119.27,-51503.76
buyer_7,María,56,ES30209544742433791682,TRX_N-00937-77463815,2024-02-22T15:39:29,Portugalete,expenses,food,-81.16,-51584.92
buyer_7,María,56,ES30209544742433791682,TRX_N-00938-60009283,2024-02-23T18:28:07,Portugalete,expenses,leisure,-18.73,-51603.65
buyer_7,María,56,ES30209544742433791682,TRX_N-00939-39503219,2024-02-23T05:17:37,Berango,expenses,clothing,-52.98,-51656.63
buyer_7,María,56,ES30209544742433791682,TRX_N-00940-52812956,2024-02-25T19:40:40,Portugalete,expenses,clothing,-117.71,-51774.34
buyer_7,María,56,ES30209544742433791682,TRX_N-00941-32608274,2024-02-25T14:37:53,Mungia,expenses,cash,-100.0,-51874.34
buyer_7,María,56,ES30209544742433791682,TRX_N-00942-47209378,2024-02-27T19:37:10,Portugalete,expenses,leisure,-70.61,-51944.95
buyer_7,María,56,ES30209544742433791682,TRX_N-00943-61373037,2024-02-27T13:51:11,Portugalete,expenses,cash,-100.0,-52044.95
buyer_7,María,56,ES30209544742433791682,TRX_N-00944-44470436,2024-02-28T18:54:14,Portugalete,expenses,food,-77.09,-52122.04
buyer_7,María,56,ES30209544742433791682,TRX_N-00945-11184407,2024-03-01T22:14:28,Portugalete,incomes,salary,1454.66,-50667.38
buyer_7,María,56,ES30209544742433791682,TRX_N-00946-86475629,2024-03-01T22:14:28,Portugalete,incomes,salary_partner,1526.23,-49141.15
buyer_7,María,56,ES30209544742433791682,TRX_N-00947-31664430,2024-03-01T14:07:02,Portugalete,expenses,healthcare,-85.47,-49226.62
buyer_7,María,56,ES30209544742433791682,TRX_N-00948-95725763,2024-03-01T10:09:08,Portugalete,expenses,gifts,-790.46,-50017.08
buyer_7,María,56,ES30209544742433791682,TRX_N-00949-68543942,2024-03-02T04:00:13,Portugalete,expenses,leisure,-62.21,-50079.29
buyer_7,María,56,ES30209544742433791682,TRX_N-00950-93779054,2024-03-02T09:55:15,Portugalete,expenses,repairs,-163.05,-50242.34
buyer_7,María,56,ES30209544742433791682,TRX_N-00951-42839501,2024-03-03T09:41:52,Portugalete,expenses,cash,-100.0,-50342.34
buyer_7,María,56,ES30209544742433791682,TRX_N-00952-90257168,2024-03-04T13:04:12,Portugalete,expenses,mortgage,-1052.07,-51394.41
buyer_7,María,56,ES30209544742433791682,TRX_N-00953-57866489,2024-03-04T16:41:35,Portugalete,expenses,cash,-100.0,-51494.41
buyer_7,María,56,ES30209544742433791682,TRX_N-00954-15849865,2024-03-05T10:00:21,Portugalete,expenses,phone,-44.41,-51538.82
buyer_7,María,56,ES30209544742433791682,TRX_N-00955-32260020,2024-03-05T18:47:09,Portugalete,expenses,children,-138.49,-51677.31
buyer_7,María,56,ES30209544742433791682,TRX_N-00956-13941728,2024-03-06T14:54:47,Portugalete,expenses,electricity,-23.73,-51701.04
buyer_7,María,56,ES30209544742433791682,TRX_N-00957-26332619,2024-03-06T14:44:03,Portugalete,expenses,gas,-62.3,-51763.34
buyer_7,María,56,ES30209544742433791682,TRX_N-00958-57579411,2024-03-06T14:03:00,Portugalete,expenses,education,-64.75,-51828.09
buyer_7,María,56,ES30209544742433791682,TRX_N-00959-42917618,2024-03-07T17:57:28,Portugalete,expenses,leisure,-43.18,-51871.27
buyer_7,María,56,ES30209544742433791682,TRX_N-00960-24771186,2024-03-08T13:22:36,Portugalete,expenses,internet,-42.0,-51913.27
buyer_7,María,56,ES30209544742433791682,TRX_N-00961-74457695,2024-03-08T12:53:38,Portugalete,expenses,water,-39.71,-51952.98
buyer_7,María,56,ES30209544742433791682,TRX_N-00962-84486127,2024-03-08T11:24:19,Sestao,expenses,travel,-906.74,-52859.72
buyer_7,María,56,ES30209544742433791682,TRX_N-00963-73173394,2024-03-10T08:29:43,Oyón-Oion,expenses,leisure,-58.98,-52918.7
buyer_7,María,56,ES30209544742433791682,TRX_N-00964-69604548,2024-03-17T18:28:41,Portugalete,expenses,cash,-100.0,-53018.7
buyer_7,María,56,ES30209544742433791682,TRX_N-00965-41304469,2024-03-18T15:29:23,Portugalete,expenses,gifts,-147.71,-53166.41
buyer_7,María,56,ES30209544742433791682,TRX_N-00966-12437176,2024-03-19T16:27:30,Portugalete,expenses,leisure,-23.54,-53189.95
buyer_7,María,56,ES30209544742433791682,TRX_N-00967-33391408,2024-03-19T18:27:37,Portugalete,expenses,gifts,-167.96,-53357.91
buyer_7,María,56,ES30209544742433791682,TRX_N-00968-42936709,2024-03-21T07:12:54,Portugalete,expenses,transport,-86.21,-53444.12
buyer_7,María,56,ES30209544742433791682,TRX_N-00969-29000647,2024-03-22T09:59:02,Bilbao,expenses,healthcare,-70.57,-53514.69
buyer_7,María,56,ES30209544742433791682,TRX_N-00970-81518164,2024-03-24T11:31:32,Portugalete,expenses,appliances,-363.61,-53878.3
buyer_7,María,56,ES30209544742433791682,TRX_N-00971-07315849,2024-03-25T13:54:03,Portugalete,expenses,cash,-100.0,-53978.3
buyer_7,María,56,ES30209544742433791682,TRX_N-00972-03027666,2024-03-26T16:34:01,Portugalete,expenses,cash,-100.0,-54078.3
buyer_7,María,56,ES30209544742433791682,TRX_N-00973-13949805,2024-03-27T14:26:41,Salvatierra/Agurain,expenses,food,-63.22,-54141.52
buyer_7,María,56,ES30209544742433791682,TRX_N-00974-87009840,2024-03-28T13:57:28,Portugalete,expenses,food,-63.82,-54205.34
buyer_7,María,56,ES30209544742433791682,TRX_N-00975-41943183,2024-03-29T08:43:47,Portugalete,expenses,appliances,-143.17,-54348.51
buyer_7,María,56,ES30209544742433791682,TRX_N-00976-71740077,2024-03-31T09:04:09,Lasarte-Oria,expenses,cash,-100.0,-54448.51
buyer_7,María,56,ES30209544742433791682,TRX_N-00977-01567706,2024-04-01T15:29:32,Portugalete,incomes,salary,1454.66,-52993.85
buyer_7,María,56,ES30209544742433791682,TRX_N-00978-33383061,2024-04-01T15:29:32,Portugalete,incomes,salary_partner,1526.23,-51467.62
buyer_7,María,56,ES30209544742433791682,TRX_N-00979-96062545,2024-04-01T15:29:32,Portugalete,incomes,extra_income,181.97,-51285.65
buyer_7,María,56,ES30209544742433791682,TRX_N-00980-30504311,2024-04-01T13:19:06,Hernani,expenses,transport,-65.49,-51351.14
buyer_7,María,56,ES30209544742433791682,TRX_N-00981-02734498,2024-04-02T18:36:12,Portugalete,expenses,clothing,-144.96,-51496.1
buyer_7,María,56,ES30209544742433791682,TRX_N-00982-22114083,2024-04-02T06:03:19,Portugalete,expenses,children,-220.34,-51716.44
buyer_7,María,56,ES30209544742433791682,TRX_N-00983-24834330,2024-04-04T15:14:46,Portugalete,expenses,mortgage,-1052.07,-52768.51
buyer_7,María,56,ES30209544742433791682,TRX_N-00984-24425001,2024-04-04T14:44:06,Portugalete,expenses,clothing,-154.6,-52923.11
buyer_7,María,56,ES30209544742433791682,TRX_N-00985-54426603,2024-04-04T12:20:50,Getxo,expenses,gifts,-382.64,-53305.75
buyer_7,María,56,ES30209544742433791682,TRX_N-00986-58951163,2024-04-06T19:21:59,Portugalete,expenses,electricity,-71.54,-53377.29
buyer_7,María,56,ES30209544742433791682,TRX_N-00987-68578826,2024-04-06T03:11:05,Portugalete,expenses,leisure,-41.5,-53418.79
buyer_7,María,56,ES30209544742433791682,TRX_N-00988-13858189,2024-04-06T15:30:17,Portugalete,expenses,healthcare,-99.21,-53518.0
buyer_7,María,56,ES30209544742433791682,TRX_N-00989-44748177,2024-04-07T11:15:06,Portugalete,expenses,food,-110.57,-53628.57
buyer_7,María,56,ES30209544742433791682,TRX_N-00990-18794615,2024-04-07T18:30:39,Portugalete,expenses,cash,-100.0,-53728.57
buyer_7,María,56,ES30209544742433791682,TRX_N-00991-30310528,2024-04-08T20:23:37,Portugalete,expenses,phone,-42.17,-53770.74
buyer_7,María,56,ES30209544742433791682,TRX_N-00992-73011631,2024-04-08T14:49:53,Portugalete,expenses,water,-26.9,-53797.64
buyer_7,María,56,ES30209544742433791682,TRX_N-00993-37122244,2024-04-08T18:13:03,Portugalete,expenses,gas,-77.91,-53875.55
buyer_7,María,56,ES30209544742433791682,TRX_N-00994-31137429,2024-04-08T21:46:28,Portugalete,expenses,internet,-42.0,-53917.55
buyer_7,María,56,ES30209544742433791682,TRX_N-00995-84305957,2024-04-10T20:16:53,Portugalete,expenses,food,-83.26,-54000.81
buyer_7,María,56,ES30209544742433791682,TRX_N-00996-90928279,2024-04-10T07:36:16,Portugalete,expenses,leisure,-44.4,-54045.21
buyer_7,María,56,ES30209544742433791682,TRX_N-00997-12927974,2024-04-10T05:51:00,Portugalete,expenses,repairs,-153.01,-54198.22
buyer_7,María,56,ES30209544742433791682,TRX_N-00998-22806686,2024-04-11T10:05:41,Galdakao,expenses,transport,-74.63,-54272.85
buyer_7,María,56,ES30209544742433791682,TRX_N-00999-68620026,2024-04-11T11:05:33,Portugalete,expenses,clothing,-113.11,-54385.96
buyer_7,María,56,ES30209544742433791682,TRX_N-01000-69499633,2024-04-13T11:24:24,Alegría-Dulantzi,expenses,clothing,-111.6,-54497.56
buyer_7,María,56,ES30209544742433791682,TRX_N-01001-87296704,2024-04-13T08:33:02,Portugalete,expenses,repairs,-151.79,-54649.35
buyer_7,María,56,ES30209544742433791682,TRX_N-01002-06157150,2024-04-15T13:17:56,Portugalete,expenses,food,-115.02,-54764.37
buyer_7,María,56,ES30209544742433791682,TRX_N-01003-65623046,2024-04-16T18:52:48,Hernani,expenses,leisure,-30.62,-54794.99
buyer_7,María,56,ES30209544742433791682,TRX_N-01004-89911798,2024-04-17T14:24:18,Portugalete,expenses,children,-201.99,-54996.98
buyer_7,María,56,ES30209544742433791682,TRX_N-01005-11159743,2024-04-20T14:09:27,Portugalete,expenses,cash,-100.0,-55096.98
buyer_7,María,56,ES30209544742433791682,TRX_N-01006-09397956,2024-04-20T10:38:03,Portugalete,expenses,appliances,-318.88,-55415.86
buyer_7,María,56,ES30209544742433791682,TRX_N-01007-43650087,2024-04-21T18:31:48,Portugalete,expenses,transport,-47.62,-55463.48
buyer_7,María,56,ES30209544742433791682,TRX_N-01008-15266156,2024-04-25T02:32:19,Portugalete,expenses,cash,-100.0,-55563.48
buyer_7,María,56,ES30209544742433791682,TRX_N-01009-68797141,2024-04-26T15:57:40,Errenteria,expenses,food,-100.41,-55663.89
buyer_7,María,56,ES30209544742433791682,TRX_N-01010-06512647,2024-04-26T13:54:37,Portugalete,expenses,leisure,-20.97,-55684.86
buyer_7,María,56,ES30209544742433791682,TRX_N-01011-88931538,2024-04-28T13:48:12,Portugalete,expenses,healthcare,-149.32,-55834.18
buyer_7,María,56,ES30209544742433791682,TRX_N-01012-40224745,2024-05-01T17:52:27,Portugalete,incomes,salary,1454.66,-54379.52
buyer_7,María,56,ES30209544742433791682,TRX_N-01013-93860719,2024-05-01T17:52:27,Portugalete,incomes,salary_partner,1526.23,-52853.29
buyer_7,María,56,ES30209544742433791682,TRX_N-01014-51830485,2024-05-03T15:58:19,Portugalete,expenses,travel,-870.78,-53724.07
buyer_7,María,56,ES30209544742433791682,TRX_N-01015-12333324,2024-05-03T10:57:48,Portugalete,expenses,appliances,-213.81,-53937.88
buyer_7,María,56,ES30209544742433791682,TRX_N-01016-71822938,2024-05-04T10:06:54,Portugalete,expenses,mortgage,-1052.07,-54989.95
buyer_7,María,56,ES30209544742433791682,TRX_N-01017-11399871,2024-05-05T17:41:45,Portugalete,expenses,internet,-42.0,-55031.95
buyer_7,María,56,ES30209544742433791682,TRX_N-01018-90069529,2024-05-05T16:38:15,Portugalete,expenses,cash,-100.0,-55131.95
buyer_7,María,56,ES30209544742433791682,TRX_N-01019-00592889,2024-05-06T04:50:13,Portugalete,expenses,phone,-40.26,-55172.21
buyer_7,María,56,ES30209544742433791682,TRX_N-01020-88608671,2024-05-06T20:09:06,Alegría-Dulantzi,expenses,food,-121.41,-55293.62
buyer_7,María,56,ES30209544742433791682,TRX_N-01021-78426147,2024-05-06T11:40:18,Portugalete,expenses,transport,-61.81,-55355.43
buyer_7,María,56,ES30209544742433791682,TRX_N-01022-41428542,2024-05-07T16:59:23,Portugalete,expenses,water,-28.18,-55383.61
buyer_7,María,56,ES30209544742433791682,TRX_N-01023-10920073,2024-05-07T08:45:27,Portugalete,expenses,electricity,-80.75,-55464.36
buyer_7,María,56,ES30209544742433791682,TRX_N-01024-56339288,2024-05-07T16:32:35,Portugalete,expenses,transport,-60.49,-55524.85
buyer_7,María,56,ES30209544742433791682,TRX_N-01025-81708317,2024-05-07T12:27:34,Berango,expenses,gifts,-758.37,-56283.22
buyer_7,María,56,ES30209544742433791682,TRX_N-01026-37995381,2024-05-08T13:33:02,Portugalete,expenses,gas,-50.99,-56334.21
buyer_7,María,56,ES30209544742433791682,TRX_N-01027-81720804,2024-05-08T04:33:48,Portugalete,expenses,children,-55.79,-56390.0
buyer_7,María,56,ES30209544742433791682,TRX_N-01028-59300892,2024-05-10T09:24:47,Portugalete,expenses,cash,-100.0,-56490.0
buyer_7,María,56,ES30209544742433791682,TRX_N-01029-49648119,2024-05-12T17:19:25,Oyón-Oion,expenses,cash,-100.0,-56590.0
buyer_7,María,56,ES30209544742433791682,TRX_N-01030-03477058,2024-05-13T17:18:47,Mungia,expenses,cash,-100.0,-56690.0
buyer_7,María,56,ES30209544742433791682,TRX_N-01031-64951041,2024-05-14T08:31:12,Portugalete,expenses,education,-71.49,-56761.49
buyer_7,María,56,ES30209544742433791682,TRX_N-01032-91158278,2024-05-17T01:27:57,Portugalete,expenses,gifts,-271.03,-57032.52
buyer_7,María,56,ES30209544742433791682,TRX_N-01033-48206931,2024-05-18T20:16:52,Zuia,expenses,repairs,-240.31,-57272.83
buyer_7,María,56,ES30209544742433791682,TRX_N-01034-49576719,2024-05-19T13:04:22,Portugalete,expenses,cash,-100.0,-57372.83
buyer_7,María,56,ES30209544742433791682,TRX_N-01035-57089578,2024-05-21T19:10:14,Santurtzi,expenses,repairs,-195.94,-57568.77
buyer_7,María,56,ES30209544742433791682,TRX_N-01036-81894395,2024-05-23T18:14:03,Portugalete,expenses,cash,-100.0,-57668.77
buyer_7,María,56,ES30209544742433791682,TRX_N-01037-83987969,2024-05-24T08:36:14,Portugalete,expenses,food,-87.75,-57756.52
buyer_7,María,56,ES30209544742433791682,TRX_N-01038-51252225,2024-05-24T15:36:21,Donostia,expenses,gifts,-242.47,-57998.99
buyer_7,María,56,ES30209544742433791682,TRX_N-01039-97394434,2024-05-29T20:00:10,Portugalete,expenses,food,-123.83,-58122.82
buyer_7,María,56,ES30209544742433791682,TRX_N-01040-22628762,2024-05-29T22:42:20,Portugalete,expenses,cash,-100.0,-58222.82
buyer_7,María,56,ES30209544742433791682,TRX_N-01041-28985120,2024-05-29T17:10:53,Portugalete,expenses,repairs,-129.52,-58352.34
buyer_7,María,56,ES30209544742433791682,TRX_N-01042-98345468,2024-05-30T08:42:00,Hondarribia,expenses,transport,-55.95,-58408.29
buyer_7,María,56,ES30209544742433791682,TRX_N-01043-47145157,2024-05-31T20:48:50,Portugalete,expenses,transport,-52.2,-58460.49
buyer_7,María,56,ES30209544742433791682,TRX_N-01044-71517820,2024-06-01T17:36:54,Portugalete,incomes,salary,1454.66,-57005.83
buyer_7,María,56,ES30209544742433791682,TRX_N-01045-56655752,2024-06-01T17:36:54,Portugalete,incomes,salary_partner,1526.23,-55479.6
buyer_7,María,56,ES30209544742433791682,TRX_N-01046-20447112,2024-06-01T17:36:54,Portugalete,incomes,salary_bonus,1110.62,-54368.98
buyer_7,María,56,ES30209544742433791682,TRX_N-01047-38015111,2024-06-01T17:36:54,Portugalete,incomes,salary_partner_bonus,1146.91,-53222.07
buyer_7,María,56,ES30209544742433791682,TRX_N-01048-52217018,2024-06-03T11:34:58,Portugalete,expenses,food,-70.48,-53292.55
buyer_7,María,56,ES30209544742433791682,TRX_N-01049-25154819,2024-06-04T02:18:41,Portugalete,expenses,mortgage,-1052.07,-54344.62
buyer_7,María,56,ES30209544742433791682,TRX_N-01050-16918616,2024-06-04T18:56:53,Basauri,expenses,transport,-52.76,-54397.38
buyer_7,María,56,ES30209544742433791682,TRX_N-01051-84477797,2024-06-05T14:56:56,Portugalete,expenses,water,-26.68,-54424.06
buyer_7,María,56,ES30209544742433791682,TRX_N-01052-00380340,2024-06-05T09:23:30,Portugalete,expenses,electricity,-40.09,-54464.15
buyer_7,María,56,ES30209544742433791682,TRX_N-01053-11491172,2024-06-05T09:54:40,Portugalete,expenses,phone,-42.21,-54506.36
buyer_7,María,56,ES30209544742433791682,TRX_N-01054-99261369,2024-06-08T13:38:07,Portugalete,expenses,internet,-42.0,-54548.36
buyer_7,María,56,ES30209544742433791682,TRX_N-01055-82611237,2024-06-08T10:15:17,Portugalete,expenses,gas,-32.91,-54581.27
buyer_7,María,56,ES30209544742433791682,TRX_N-01056-20522404,2024-06-08T08:27:02,Portugalete,expenses,clothing,-107.21,-54688.48
buyer_7,María,56,ES30209544742433791682,TRX_N-01057-84279420,2024-06-08T16:02:11,Portugalete,expenses,appliances,-343.2,-55031.68
buyer_7,María,56,ES30209544742433791682,TRX_N-01058-62029767,2024-06-09T14:45:51,Portugalete,expenses,appliances,-395.21,-55426.89
buyer_7,María,56,ES30209544742433791682,TRX_N-01059-06930572,2024-06-09T19:45:10,Portugalete,expenses,children,-239.44,-55666.33
buyer_7,María,56,ES30209544742433791682,TRX_N-01060-30799526,2024-06-10T19:41:52,Portugalete,expenses,cash,-100.0,-55766.33
buyer_7,María,56,ES30209544742433791682,TRX_N-01061-01455517,2024-06-11T09:57:25,Portugalete,expenses,food,-109.1,-55875.43
buyer_7,María,56,ES30209544742433791682,TRX_N-01062-88981865,2024-06-11T21:40:40,Mungia,expenses,repairs,-260.11,-56135.54
buyer_7,María,56,ES30209544742433791682,TRX_N-01063-90209796,2024-06-12T14:22:38,Barakaldo,expenses,healthcare,-131.58,-56267.12
buyer_7,María,56,ES30209544742433791682,TRX_N-01064-61078442,2024-06-12T07:30:14,Lasarte-Oria,expenses,travel,-730.89,-56998.01
buyer_7,María,56,ES30209544742433791682,TRX_N-01065-58568629,2024-06-14T08:44:24,Portugalete,expenses,food,-69.82,-57067.83
buyer_7,María,56,ES30209544742433791682,TRX_N-01066-36777111,2024-06-14T20:54:30,Portugalete,expenses,cash,-100.0,-57167.83
buyer_7,María,56,ES30209544742433791682,TRX_N-01067-42489952,2024-06-16T11:12:52,Portugalete,expenses,food,-99.84,-57267.67
buyer_7,María,56,ES30209544742433791682,TRX_N-01068-63748880,2024-06-16T18:19:59,Sestao,expenses,leisure,-80.28,-57347.95
buyer_7,María,56,ES30209544742433791682,TRX_N-01069-22875514,2024-06-16T11:07:29,Portugalete,expenses,cash,-100.0,-57447.95
buyer_7,María,56,ES30209544742433791682,TRX_N-01070-33945965,2024-06-18T08:46:16,Portugalete,expenses,food,-89.71,-57537.66
buyer_7,María,56,ES30209544742433791682,TRX_N-01071-46856932,2024-06-18T12:43:42,Donostia,expenses,transport,-47.2,-57584.86
buyer_7,María,56,ES30209544742433791682,TRX_N-01072-80342120,2024-06-18T06:42:39,Santurtzi,expenses,leisure,-57.4,-57642.26
buyer_7,María,56,ES30209544742433791682,TRX_N-01073-88463558,2024-06-18T16:17:58,Portugalete,expenses,children,-248.84,-57891.1
buyer_7,María,56,ES30209544742433791682,TRX_N-01074-78766850,2024-06-20T13:02:48,Portugalete,expenses,cash,-100.0,-57991.1
buyer_7,María,56,ES30209544742433791682,TRX_N-01075-83953566,2024-06-21T15:19:15,Irun,expenses,transport,-43.42,-58034.52
buyer_7,María,56,ES30209544742433791682,TRX_N-01076-63449007,2024-06-26T12:40:12,Portugalete,expenses,transport,-71.14,-58105.66
buyer_7,María,56,ES30209544742433791682,TRX_N-01077-62231047,2024-06-26T05:53:40,Portugalete,expenses,children,-131.8,-58237.46
buyer_7,María,56,ES30209544742433791682,TRX_N-01078-75022310,2024-06-30T12:29:40,Portugalete,expenses,food,-124.25,-58361.71
buyer_7,María,56,ES30209544742433791682,TRX_N-01079-45702067,2024-06-30T19:54:35,Amurrio,expenses,cash,-100.0,-58461.71
buyer_7,María,56,ES30209544742433791682,TRX_N-01080-37224472,2024-07-01T08:08:50,Portugalete,incomes,salary,1454.66,-57007.05
buyer_7,María,56,ES30209544742433791682,TRX_N-01081-13365003,2024-07-01T08:08:50,Portugalete,incomes,salary_partner,1526.23,-55480.82
buyer_7,María,56,ES30209544742433791682,TRX_N-01082-59101762,2024-07-01T21:52:00,Salvatierra/Agurain,expenses,food,-87.49,-55568.31
buyer_7,María,56,ES30209544742433791682,TRX_N-01083-55375694,2024-07-02T19:21:26,Portugalete,expenses,cash,-100.0,-55668.31
buyer_7,María,56,ES30209544742433791682,TRX_N-01084-28701184,2024-07-03T09:22:50,Portugalete,expenses,food,-120.75,-55789.06
buyer_7,María,56,ES30209544742433791682,TRX_N-01085-46759991,2024-07-03T11:43:00,Portugalete,expenses,cash,-100.0,-55889.06
buyer_7,María,56,ES30209544742433791682,TRX_N-01086-42949029,2024-07-04T08:03:44,Portugalete,expenses,mortgage,-1052.07,-56941.13
buyer_7,María,56,ES30209544742433791682,TRX_N-01087-72611583,2024-07-04T13:02:31,Portugalete,expenses,transport,-88.03,-57029.16
buyer_7,María,56,ES30209544742433791682,TRX_N-01088-92494138,2024-07-05T21:03:23,Portugalete,expenses,gas,-98.76,-57127.92
buyer_7,María,56,ES30209544742433791682,TRX_N-01089-38636583,2024-07-05T11:31:01,Portugalete,expenses,internet,-42.0,-57169.92
buyer_7,María,56,ES30209544742433791682,TRX_N-01090-78447038,2024-07-05T18:19:20,Portugalete,expenses,phone,-36.7,-57206.62
buyer_7,María,56,ES30209544742433791682,TRX_N-01091-93963177,2024-07-05T11:43:45,Portugalete,expenses,repairs,-263.52,-57470.14
buyer_7,María,56,ES30209544742433791682,TRX_N-01092-20991168,2024-07-07T11:00:46,Santurtzi,expenses,gifts,-623.99,-58094.13
buyer_7,María,56,ES30209544742433791682,TRX_N-01093-17446959,2024-07-08T21:29:15,Portugalete,expenses,water,-38.85,-58132.98
buyer_7,María,56,ES30209544742433791682,TRX_N-01094-57126699,2024-07-08T16:40:51,Portugalete,expenses,electricity,-40.1,-58173.08
buyer_7,María,56,ES30209544742433791682,TRX_N-01095-12650361,2024-07-08T19:07:33,Portugalete,expenses,transport,-44.64,-58217.72
buyer_7,María,56,ES30209544742433791682,TRX_N-01096-57190059,2024-07-08T09:24:53,Portugalete,expenses,cash,-100.0,-58317.72
buyer_7,María,56,ES30209544742433791682,TRX_N-01097-78410699,2024-07-09T09:28:20,Portugalete,expenses,food,-99.63,-58417.35
buyer_7,María,56,ES30209544742433791682,TRX_N-01098-09262917,2024-07-09T13:35:10,Portugalete,expenses,transport,-42.76,-58460.11
buyer_7,María,56,ES30209544742433791682,TRX_N-01099-00409443,2024-07-15T20:59:20,Portugalete,expenses,healthcare,-137.13,-58597.24
buyer_7,María,56,ES30209544742433791682,TRX_N-01100-12265565,2024-07-16T17:19:59,Zuia,expenses,clothing,-90.91,-58688.15
buyer_7,María,56,ES30209544742433791682,TRX_N-01101-34985853,2024-07-16T18:54:43,Portugalete,expenses,education,-44.79,-58732.94
buyer_7,María,56,ES30209544742433791682,TRX_N-01102-64307149,2024-07-16T18:00:04,Portugalete,expenses,children,-126.6,-58859.54
buyer_7,María,56,ES30209544742433791682,TRX_N-01103-07342366,2024-07-17T02:32:28,Portugalete,expenses,food,-87.01,-58946.55
buyer_7,María,56,ES30209544742433791682,TRX_N-01104-76175473,2024-07-19T08:42:32,Portugalete,expenses,gifts,-438.83,-59385.38
buyer_7,María,56,ES30209544742433791682,TRX_N-01105-08526277,2024-07-21T20:58:04,Portugalete,expenses,leisure,-32.36,-59417.74
buyer_7,María,56,ES30209544742433791682,TRX_N-01106-11209043,2024-07-21T06:00:02,Eibar,expenses,gifts,-375.84,-59793.58
buyer_7,María,56,ES30209544742433791682,TRX_N-01107-82829830,2024-07-23T21:25:52,Portugalete,expenses,education,-77.46,-59871.04
buyer_7,María,56,ES30209544742433791682,TRX_N-01108-24828224,2024-07-27T13:55:17,Portugalete,expenses,food,-60.01,-59931.05
buyer_7,María,56,ES30209544742433791682,TRX_N-01109-16773570,2024-07-31T13:47:15,Portugalete,expenses,cash,-100.0,-60031.05
buyer_7,María,56,ES30209544742433791682,TRX_N-01110-68632222,2024-08-01T15:58:13,Portugalete,incomes,salary,1454.66,-58576.39
buyer_7,María,56,ES30209544742433791682,TRX_N-01111-64476245,2024-08-01T15:58:13,Portugalete,incomes,salary_partner,1526.23,-57050.16
buyer_7,María,56,ES30209544742433791682,TRX_N-01112-67568459,2024-08-01T15:58:13,Portugalete,incomes,extra_income,181.97,-56868.19
buyer_7,María,56,ES30209544742433791682,TRX_N-01113-07568165,2024-08-02T10:14:37,Portugalete,expenses,food,-91.57,-56959.76
buyer_7,María,56,ES30209544742433791682,TRX_N-01114-53162539,2024-08-03T10:56:56,Portugalete,expenses,cash,-100.0,-57059.76
buyer_7,María,56,ES30209544742433791682,TRX_N-01115-50396703,2024-08-04T20:58:10,Portugalete,expenses,mortgage,-1052.07,-58111.83
buyer_7,María,56,ES30209544742433791682,TRX_N-01116-98107435,2024-08-04T13:08:54,Portugalete,expenses,transport,-86.8,-58198.63
buyer_7,María,56,ES30209544742433791682,TRX_N-01117-82385496,2024-08-04T07:47:14,Erandio,expenses,cash,-100.0,-58298.63
buyer_7,María,56,ES30209544742433791682,TRX_N-01118-02026013,2024-08-05T13:57:38,Portugalete,expenses,water,-21.53,-58320.16
buyer_7,María,56,ES30209544742433791682,TRX_N-01119-82143081,2024-08-05T01:02:31,Portugalete,expenses,electricity,-24.75,-58344.91
buyer_7,María,56,ES30209544742433791682,TRX_N-01120-77809022,2024-08-05T12:55:59,Portugalete,expenses,appliances,-338.84,-58683.75
buyer_7,María,56,ES30209544742433791682,TRX_N-01121-73137796,2024-08-06T11:15:41,Portugalete,expenses,internet,-42.0,-58725.75
buyer_7,María,56,ES30209544742433791682,TRX_N-01122-24647023,2024-08-07T17:39:40,Portugalete,expenses,gas,-64.22,-58789.97
buyer_7,María,56,ES30209544742433791682,TRX_N-01123-23440211,2024-08-07T12:36:55,Portugalete,expenses,leisure,-32.25,-58822.22
buyer_7,María,56,ES30209544742433791682,TRX_N-01124-36707899,2024-08-08T12:47:00,Portugalete,expenses,phone,-42.42,-58864.64
buyer_7,María,56,ES30209544742433791682,TRX_N-01125-52578704,2024-08-09T19:01:27,Portugalete,expenses,transport,-86.03,-58950.67
buyer_7,María,56,ES30209544742433791682,TRX_N-01126-85745053,2024-08-12T08:36:33,Portugalete,expenses,cash,-100.0,-59050.67
buyer_7,María,56,ES30209544742433791682,TRX_N-01127-87558230,2024-08-12T08:13:32,Portugalete,expenses,gifts,-586.01,-59636.68
buyer_7,María,56,ES30209544742433791682,TRX_N-01128-02619864,2024-08-12T15:15:12,Portugalete,expenses,children,-145.35,-59782.03
buyer_7,María,56,ES30209544742433791682,TRX_N-01129-55534914,2024-08-14T01:41:19,Portugalete,expenses,clothing,-104.22,-59886.25
buyer_7,María,56,ES30209544742433791682,TRX_N-01130-31759816,2024-08-15T16:06:23,Durango,expenses,cash,-100.0,-59986.25
buyer_7,María,56,ES30209544742433791682,TRX_N-01131-72406392,2024-08-17T12:21:25,Portugalete,expenses,cash,-100.0,-60086.25
buyer_7,María,56,ES30209544742433791682,TRX_N-01132-29363240,2024-08-18T09:21:11,Portugalete,expenses,clothing,-140.78,-60227.03
buyer_7,María,56,ES30209544742433791682,TRX_N-01133-36156253,2024-08-19T17:12:33,Portugalete,expenses,leisure,-69.33,-60296.36
buyer_7,María,56,ES30209544742433791682,TRX_N-01134-84523261,2024-08-19T12:17:18,Portugalete,expenses,gifts,-821.95,-61118.31
buyer_7,María,56,ES30209544742433791682,TRX_N-01135-43993842,2024-08-20T14:49:55,Portugalete,expenses,leisure,-54.85,-61173.16
buyer_7,María,56,ES30209544742433791682,TRX_N-01136-16748993,2024-08-21T10:14:51,Portugalete,expenses,clothing,-106.49,-61279.65
buyer_7,María,56,ES30209544742433791682,TRX_N-01137-44207719,2024-08-23T16:02:15,Portugalete,expenses,food,-119.88,-61399.53
buyer_7,María,56,ES30209544742433791682,TRX_N-01138-09219742,2024-08-25T15:50:24,Portugalete,expenses,transport,-87.95,-61487.48
buyer_7,María,56,ES30209544742433791682,TRX_N-01139-37457134,2024-08-25T20:59:35,Portugalete,expenses,healthcare,-72.39,-61559.87
buyer_7,María,56,ES30209544742433791682,TRX_N-01140-28995722,2024-08-26T09:12:50,Portugalete,expenses,clothing,-107.61,-61667.48
buyer_7,María,56,ES30209544742433791682,TRX_N-01141-90774844,2024-08-26T18:52:39,Zuia,expenses,travel,-927.65,-62595.13
buyer_7,María,56,ES30209544742433791682,TRX_N-01142-05569763,2024-08-30T15:54:42,Portugalete,expenses,food,-68.61,-62663.74
buyer_7,María,56,ES30209544742433791682,TRX_N-01143-83536049,2024-08-30T11:08:26,Leioa,expenses,cash,-100.0,-62763.74
buyer_7,María,56,ES30209544742433791682,TRX_N-01144-00769879,2024-08-31T16:23:03,Portugalete,expenses,cash,-100.0,-62863.74
buyer_7,María,56,ES30209544742433791682,TRX_N-01145-32463990,2024-09-01T01:44:50,Portugalete,incomes,salary,1454.66,-61409.08
buyer_7,María,56,ES30209544742433791682,TRX_N-01146-83801348,2024-09-01T01:44:50,Portugalete,incomes,salary_partner,1526.23,-59882.85
buyer_7,María,56,ES30209544742433791682,TRX_N-01147-45591401,2024-09-01T16:16:59,Portugalete,expenses,transport,-57.7,-59940.55
buyer_7,María,56,ES30209544742433791682,TRX_N-01148-70690230,2024-09-04T13:08:14,Portugalete,expenses,mortgage,-1052.07,-60992.62
buyer_7,María,56,ES30209544742433791682,TRX_N-01149-61297332,2024-09-04T19:52:26,Portugalete,expenses,leisure,-74.34,-61066.96
buyer_7,María,56,ES30209544742433791682,TRX_N-01150-95377248,2024-09-05T10:32:56,Portugalete,expenses,gas,-102.48,-61169.44
buyer_7,María,56,ES30209544742433791682,TRX_N-01151-32435826,2024-09-05T10:29:33,Portugalete,expenses,appliances,-81.36,-61250.8
buyer_7,María,56,ES30209544742433791682,TRX_N-01152-49153897,2024-09-06T16:42:38,Portugalete,expenses,water,-30.9,-61281.7
buyer_7,María,56,ES30209544742433791682,TRX_N-01153-09657699,2024-09-06T04:10:43,Portugalete,expenses,internet,-42.0,-61323.7
buyer_7,María,56,ES30209544742433791682,TRX_N-01154-46215613,2024-09-07T18:30:04,Portugalete,expenses,phone,-39.57,-61363.27
buyer_7,María,56,ES30209544742433791682,TRX_N-01155-16188389,2024-09-07T15:04:39,Portugalete,expenses,transport,-83.95,-61447.22
buyer_7,María,56,ES30209544742433791682,TRX_N-01156-29124145,2024-09-07T10:25:29,Portugalete,expenses,cash,-100.0,-61547.22
buyer_7,María,56,ES30209544742433791682,TRX_N-01157-78814289,2024-09-08T20:20:25,Portugalete,expenses,electricity,-32.33,-61579.55
buyer_7,María,56,ES30209544742433791682,TRX_N-01158-17372390,2024-09-09T09:34:32,Durango,expenses,clothing,-141.22,-61720.77
buyer_7,María,56,ES30209544742433791682,TRX_N-01159-73288850,2024-09-11T14:05:09,Zuia,expenses,food,-71.13,-61791.9
buyer_7,María,56,ES30209544742433791682,TRX_N-01160-87469189,2024-09-12T13:27:39,Zuia,expenses,transport,-89.44,-61881.34
buyer_7,María,56,ES30209544742433791682,TRX_N-01161-34034038,2024-09-12T16:20:08,Portugalete,expenses,cash,-100.0,-61981.34
buyer_7,María,56,ES30209544742433791682,TRX_N-01162-86930223,2024-09-13T09:42:36,Portugalete,expenses,repairs,-64.95,-62046.29
buyer_7,María,56,ES30209544742433791682,TRX_N-01163-96721874,2024-09-14T01:03:56,Portugalete,expenses,children,-87.45,-62133.74
buyer_7,María,56,ES30209544742433791682,TRX_N-01164-48253636,2024-09-15T14:24:50,Portugalete,expenses,gifts,-386.57,-62520.31
buyer_7,María,56,ES30209544742433791682,TRX_N-01165-46863489,2024-09-18T17:05:15,Portugalete,expenses,cash,-100.0,-62620.31
buyer_7,María,56,ES30209544742433791682,TRX_N-01166-28520166,2024-09-20T20:55:09,Barakaldo,expenses,healthcare,-129.34,-62749.65
buyer_7,María,56,ES30209544742433791682,TRX_N-01167-57483121,2024-09-21T16:41:16,Portugalete,expenses,food,-68.84,-62818.49
buyer_7,María,56,ES30209544742433791682,TRX_N-01168-69280957,2024-09-21T20:18:24,Portugalete,expenses,repairs,-136.97,-62955.46
buyer_7,María,56,ES30209544742433791682,TRX_N-01169-32999862,2024-09-23T12:17:34,Portugalete,expenses,clothing,-98.45,-63053.91
buyer_7,María,56,ES30209544742433791682,TRX_N-01170-95698668,2024-09-24T11:46:45,Durango,expenses,food,-74.11,-63128.02
buyer_7,María,56,ES30209544742433791682,TRX_N-01171-97318029,2024-09-24T17:16:56,Portugalete,expenses,appliances,-348.44,-63476.46
buyer_7,María,56,ES30209544742433791682,TRX_N-01172-08053185,2024-09-25T21:20:06,Portugalete,expenses,transport,-48.63,-63525.09
buyer_7,María,56,ES30209544742433791682,TRX_N-01173-43708765,2024-09-26T12:38:47,Portugalete,expenses,food,-60.51,-63585.6
buyer_7,María,56,ES30209544742433791682,TRX_N-01174-96793301,2024-09-26T01:06:10,Portugalete,expenses,transport,-87.03,-63672.63
buyer_7,María,56,ES30209544742433791682,TRX_N-01175-68353202,2024-09-27T13:54:42,Portugalete,expenses,food,-87.5,-63760.13
buyer_7,María,56,ES30209544742433791682,TRX_N-01176-42757551,2024-09-27T19:08:41,Getxo,expenses,cash,-100.0,-63860.13
buyer_7,María,56,ES30209544742433791682,TRX_N-01177-80509970,2024-09-29T10:10:11,Portugalete,expenses,food,-99.28,-63959.41
buyer_7,María,56,ES30209544742433791682,TRX_N-01178-72222327,2024-10-01T09:25:27,Portugalete,incomes,salary,1454.66,-62504.75
buyer_7,María,56,ES30209544742433791682,TRX_N-01179-85563006,2024-10-01T09:25:27,Portugalete,incomes,salary_partner,1526.23,-60978.52
buyer_7,María,56,ES30209544742433791682,TRX_N-01180-61185811,2024-10-03T11:25:21,Portugalete,expenses,leisure,-40.82,-61019.34
buyer_7,María,56,ES30209544742433791682,TRX_N-01181-29898362,2024-10-04T20:47:15,Portugalete,expenses,mortgage,-1052.07,-62071.41
buyer_7,María,56,ES30209544742433791682,TRX_N-01182-89102927,2024-10-04T21:39:10,Portugalete,expenses,cash,-100.0,-62171.41
buyer_7,María,56,ES30209544742433791682,TRX_N-01183-80393985,2024-10-05T12:29:48,Portugalete,expenses,electricity,-78.36,-62249.77
buyer_7,María,56,ES30209544742433791682,TRX_N-01184-56115552,2024-10-05T18:31:33,Portugalete,expenses,gas,-67.8,-62317.57
buyer_7,María,56,ES30209544742433791682,TRX_N-01185-24627691,2024-10-05T10:06:47,Portugalete,expenses,leisure,-21.13,-62338.7
buyer_7,María,56,ES30209544742433791682,TRX_N-01186-16632440,2024-10-05T17:12:48,Portugalete,expenses,clothing,-106.95,-62445.65
buyer_7,María,56,ES30209544742433791682,TRX_N-01187-32503108,2024-10-06T22:02:16,Portugalete,expenses,transport,-43.93,-62489.58
buyer_7,María,56,ES30209544742433791682,TRX_N-01188-40288461,2024-10-06T03:16:05,Labastida,expenses,travel,-922.68,-63412.26
buyer_7,María,56,ES30209544742433791682,TRX_N-01189-23191697,2024-10-07T14:20:45,Portugalete,expenses,water,-34.24,-63446.5
buyer_7,María,56,ES30209544742433791682,TRX_N-01190-74525948,2024-10-07T17:12:49,Portugalete,expenses,travel,-650.47,-64096.97
buyer_7,María,56,ES30209544742433791682,TRX_N-01191-43074876,2024-10-08T09:43:25,Portugalete,expenses,internet,-42.0,-64138.97
buyer_7,María,56,ES30209544742433791682,TRX_N-01192-13795042,2024-10-08T15:23:12,Portugalete,expenses,phone,-37.71,-64176.68
buyer_8,Antonio,45,ES07209546103281907066,TRX_N-00001-15758079,2022-01-01T20:04:31,Labastida,incomes,salary,1387.44,2491.16
buyer_8,Antonio,45,ES07209546103281907066,TRX_N-00002-91646990,2022-01-01T20:04:31,Labastida,incomes,salary_partner,1560.7,4051.86
buyer_8,Antonio,45,ES07209546103281907066,TRX_N-00003-70263588,2022-01-01T15:46:16,Labastida,expenses,travel,-1161.54,2890.32
buyer_8,Antonio,45,ES07209546103281907066,TRX_N-00004-67511825,2022-01-01T10:23:58,Berango,expenses,gifts,-365.95,2524.37
buyer_8,Antonio,45,ES07209546103281907066,TRX_N-00005-25280254,2022-01-04T10:38:41,Labastida,expenses,mortgage,-970.96,1553.41
buyer_8,Antonio,45,ES07209546103281907066,TRX_N-00006-08301637,2022-01-04T15:44:44,Labastida,expenses,food,-97.87,1455.54
buyer_8,Antonio,45,ES07209546103281907066,TRX_N-00007-54368266,2022-01-04T19:06:53,Labastida,expenses,transport,-57.68,1397.86
buyer_8,Antonio,45,ES07209546103281907066,TRX_N-00008-94918485,2022-01-05T09:39:21,Labastida,expenses,water,-24.42,1373.44
buyer_8,Antonio,45,ES07209546103281907066,TRX_N-00009-29999191,2022-01-05T14:44:08,Labastida,expenses,gas,-114.85,1258.59
buyer_8,Antonio,45,ES07209546103281907066,TRX_N-00010-18160903,2022-01-06T15:51:50,Labastida,expenses,leisure,-29.95,1228.64
buyer_8,Antonio,45,ES07209546103281907066,TRX_N-00011-92372357,2022-01-06T15:38:14,Labastida,expenses,repairs,-67.94,1160.7
buyer_8,Antonio,45,ES07209546103281907066,TRX_N-00012-61558925,2022-01-07T18:19:24,Labastida,expenses,electricity,-89.19,1071.51
buyer_8,Antonio,45,ES07209546103281907066,TRX_N-00013-97085855,2022-01-07T18:08:04,Labastida,expenses,internet,-42.0,1029.51
buyer_8,Antonio,45,ES07209546103281907066,TRX_N-00014-65402229,2022-01-07T11:25:48,Labastida,expenses,food,-91.44,938.07
buyer_8,Antonio,45,ES07209546103281907066,TRX_N-00015-54688438,2022-01-07T17:16:49,Irun,expenses,leisure,-43.18,894.89
buyer_8,Antonio,45,ES07209546103281907066,TRX_N-00016-76189508,2022-01-08T15:37:40,Labastida,expenses,phone,-42.8,852.09
buyer_8,Antonio,45,ES07209546103281907066,TRX_N-00017-26842932,2022-01-09T12:11:55,Labastida,expenses,cash,-100.0,752.09
buyer_8,Antonio,45,ES07209546103281907066,TRX_N-00018-32704573,2022-01-10T12:05:20,Sestao,expenses,healthcare,-78.19,673.9
buyer_8,Antonio,45,ES07209546103281907066,TRX_N-00019-04865215,2022-01-11T10:42:05,Labastida,expenses,food,-122.45,551.45
buyer_8,Antonio,45,ES07209546103281907066,TRX_N-00020-40465612,2022-01-11T09:28:46,Labastida,expenses,leisure,-39.35,512.1
buyer_8,Antonio,45,ES07209546103281907066,TRX_N-00021-64848407,2022-01-11T16:19:55,Labastida,expenses,repairs,-200.58,311.52
buyer_8,Antonio,45,ES07209546103281907066,TRX_N-00022-89828320,2022-01-12T12:48:03,Labastida,expenses,cash,-100.0,211.52
buyer_8,Antonio,45,ES07209546103281907066,TRX_N-00023-93446985,2022-01-16T02:33:40,Labastida,expenses,repairs,-303.38,-91.86
buyer_8,Antonio,45,ES07209546103281907066,TRX_N-00024-51644856,2022-01-17T02:27:17,Labastida,expenses,clothing,-77.55,-169.41
buyer_8,Antonio,45,ES07209546103281907066,TRX_N-00025-50408398,2022-01-18T22:15:10,Labastida,expenses,cash,-100.0,-269.41
buyer_8,Antonio,45,ES07209546103281907066,TRX_N-00026-96025817,2022-01-19T11:29:50,Santurtzi,expenses,appliances,-120.31,-389.72
buyer_8,Antonio,45,ES07209546103281907066,TRX_N-00027-91643336,2022-01-20T15:09:31,Labastida,expenses,transport,-58.24,-447.96
buyer_8,Antonio,45,ES07209546103281907066,TRX_N-00028-16727122,2022-01-21T15:59:18,Labastida,expenses,leisure,-36.11,-484.07
buyer_8,Antonio,45,ES07209546103281907066,TRX_N-00029-08408004,2022-01-21T21:48:13,Labastida,expenses,repairs,-48.86,-532.93
buyer_8,Antonio,45,ES07209546103281907066,TRX_N-00030-27827612,2022-01-22T06:55:32,Leioa,expenses,appliances,-125.38,-658.31
buyer_8,Antonio,45,ES07209546103281907066,TRX_N-00031-88142115,2022-01-23T10:42:34,Hondarribia,expenses,food,-110.26,-768.57
buyer_8,Antonio,45,ES07209546103281907066,TRX_N-00032-49566937,2022-01-25T03:26:41,Labastida,expenses,leisure,-77.68,-846.25
buyer_8,Antonio,45,ES07209546103281907066,TRX_N-00033-01498726,2022-02-01T17:25:04,Labastida,incomes,salary,1387.44,541.19
buyer_8,Antonio,45,ES07209546103281907066,TRX_N-00034-24000867,2022-02-01T17:25:04,Labastida,incomes,salary_partner,1560.7,2101.89
buyer_8,Antonio,45,ES07209546103281907066,TRX_N-00035-72082262,2022-02-01T11:14:55,Labastida,expenses,leisure,-30.45,2071.44
buyer_8,Antonio,45,ES07209546103281907066,TRX_N-00036-99569603,2022-02-01T15:03:41,Labastida,expenses,cash,-100.0,1971.44
buyer_8,Antonio,45,ES07209546103281907066,TRX_N-00037-39465134,2022-02-01T12:59:12,Labastida,expenses,repairs,-206.91,1764.53
buyer_8,Antonio,45,ES07209546103281907066,TRX_N-00038-72898828,2022-02-01T11:11:49,Labastida,expenses,children,-126.88,1637.65
buyer_8,Antonio,45,ES07209546103281907066,TRX_N-00039-53314585,2022-02-02T03:04:11,Labastida,expenses,transport,-77.12,1560.53
buyer_8,Antonio,45,ES07209546103281907066,TRX_N-00040-76866426,2022-02-02T18:56:25,Labastida,expenses,cash,-100.0,1460.53
buyer_8,Antonio,45,ES07209546103281907066,TRX_N-00041-09578254,2022-02-03T22:13:02,Labastida,expenses,education,-71.14,1389.39
buyer_8,Antonio,45,ES07209546103281907066,TRX_N-00042-55036239,2022-02-03T15:47:00,Labastida,expenses,cash,-100.0,1289.39
buyer_8,Antonio,45,ES07209546103281907066,TRX_N-00043-49006852,2022-02-03T13:56:07,Pasaia,expenses,gifts,-372.63,916.76
buyer_8,Antonio,45,ES07209546103281907066,TRX_N-00044-90799815,2022-02-04T08:00:13,Labastida,expenses,mortgage,-970.96,-54.2
buyer_8,Antonio,45,ES07209546103281907066,TRX_N-00045-77563835,2022-02-04T10:54:06,Arrasate,expenses,food,-95.58,-149.78
buyer_8,Antonio,45,ES07209546103281907066,TRX_N-00046-32570134,2022-02-06T17:42:42,Labastida,expenses,internet,-42.0,-191.78
buyer_8,Antonio,45,ES07209546103281907066,TRX_N-00047-14851514,2022-02-06T09:48:46,Labastida,expenses,cash,-100.0,-291.78
buyer_8,Antonio,45,ES07209546103281907066,TRX_N-00048-88521635,2022-02-07T17:26:34,Labastida,expenses,electricity,-61.6,-353.38
buyer_8,Antonio,45,ES07209546103281907066,TRX_N-00049-78771917,2022-02-07T12:39:19,Labastida,expenses,food,-111.55,-464.93
buyer_8,Antonio,45,ES07209546103281907066,TRX_N-00050-27394632,2022-02-08T14:05:27,Labastida,expenses,water,-31.24,-496.17
buyer_8,Antonio,45,ES07209546103281907066,TRX_N-00051-91102046,2022-02-08T10:55:53,Labastida,expenses,gas,-52.11,-548.28
buyer_8,Antonio,45,ES07209546103281907066,TRX_N-00052-41413470,2022-02-08T10:04:23,Labastida,expenses,phone,-40.93,-589.21
buyer_8,Antonio,45,ES07209546103281907066,TRX_N-00053-61172804,2022-02-08T19:05:27,Labastida,expenses,cash,-100.0,-689.21
buyer_8,Antonio,45,ES07209546103281907066,TRX_N-00054-16180180,2022-02-09T16:12:03,Labastida,expenses,cash,-100.0,-789.21
buyer_8,Antonio,45,ES07209546103281907066,TRX_N-00055-11678175,2022-02-13T14:55:32,Labastida,expenses,leisure,-45.81,-835.02
buyer_8,Antonio,45,ES07209546103281907066,TRX_N-00056-48511279,2022-02-14T21:52:10,Labastida,expenses,leisure,-48.47,-883.49
buyer_8,Antonio,45,ES07209546103281907066,TRX_N-00057-36220484,2022-02-15T20:57:52,Labastida,expenses,healthcare,-65.14,-948.63
buyer_8,Antonio,45,ES07209546103281907066,TRX_N-00058-40078146,2022-02-16T20:23:54,Labastida,expenses,gifts,-427.26,-1375.89
buyer_8,Antonio,45,ES07209546103281907066,TRX_N-00059-26643412,2022-02-17T10:41:54,Labastida,expenses,transport,-78.36,-1454.25
buyer_8,Antonio,45,ES07209546103281907066,TRX_N-00060-23140307,2022-02-19T15:09:18,Labastida,expenses,food,-71.64,-1525.89
buyer_8,Antonio,45,ES07209546103281907066,TRX_N-00061-49831462,2022-02-20T18:01:57,Labastida,expenses,clothing,-158.2,-1684.09
buyer_8,Antonio,45,ES07209546103281907066,TRX_N-00062-57951892,2022-02-21T15:09:23,Labastida,expenses,cash,-100.0,-1784.09
buyer_8,Antonio,45,ES07209546103281907066,TRX_N-00063-91518228,2022-02-21T17:53:33,Labastida,expenses,repairs,-331.75,-2115.84
buyer_8,Antonio,45,ES07209546103281907066,TRX_N-00064-19162461,2022-02-22T13:23:45,Labastida,expenses,travel,-1118.4,-3234.24
buyer_8,Antonio,45,ES07209546103281907066,TRX_N-00065-11660040,2022-02-25T16:34:29,Portugalete,expenses,leisure,-84.12,-3318.36
buyer_8,Antonio,45,ES07209546103281907066,TRX_N-00066-34813107,2022-02-25T20:03:42,Labastida,expenses,repairs,-70.85,-3389.21
buyer_8,Antonio,45,ES07209546103281907066,TRX_N-00067-20780245,2022-02-26T16:41:53,Labastida,expenses,transport,-67.73,-3456.94
buyer_8,Antonio,45,ES07209546103281907066,TRX_N-00068-90844580,2022-02-27T12:00:11,Labastida,expenses,repairs,-27.97,-3484.91
buyer_8,Antonio,45,ES07209546103281907066,TRX_N-00069-67838595,2022-03-01T13:34:59,Labastida,incomes,salary,1387.44,-2097.47
buyer_8,Antonio,45,ES07209546103281907066,TRX_N-00070-10093295,2022-03-01T13:34:59,Labastida,incomes,salary_partner,1560.7,-536.77
buyer_8,Antonio,45,ES07209546103281907066,TRX_N-00071-89597792,2022-03-01T13:34:59,Labastida,incomes,extra_income,153.76,-383.01
buyer_8,Antonio,45,ES07209546103281907066,TRX_N-00072-13645888,2022-03-02T20:52:47,Labastida,expenses,clothing,-66.4,-449.41
buyer_8,Antonio,45,ES07209546103281907066,TRX_N-00073-67209236,2022-03-03T19:06:32,Santurtzi,expenses,cash,-100.0,-549.41
buyer_8,Antonio,45,ES07209546103281907066,TRX_N-00074-68798754,2022-03-03T15:32:51,Labastida,expenses,children,-119.8,-669.21
buyer_8,Antonio,45,ES07209546103281907066,TRX_N-00075-78893087,2022-03-04T20:54:09,Labastida,expenses,mortgage,-970.96,-1640.17
buyer_8,Antonio,45,ES07209546103281907066,TRX_N-00076-03740953,2022-03-05T07:57:36,Labastida,expenses,leisure,-83.1,-1723.27
buyer_8,Antonio,45,ES07209546103281907066,TRX_N-00077-16433482,2022-03-06T05:00:37,Labastida,expenses,water,-27.54,-1750.81
buyer_8,Antonio,45,ES07209546103281907066,TRX_N-00078-91327204,2022-03-06T11:10:53,Labastida,expenses,electricity,-35.77,-1786.58
buyer_8,Antonio,45,ES07209546103281907066,TRX_N-00079-61265623,2022-03-06T00:23:00,Labastida,expenses,gas,-59.0,-1845.58
buyer_8,Antonio,45,ES07209546103281907066,TRX_N-00080-03956595,2022-03-06T12:28:50,Labastida,expenses,transport,-83.35,-1928.93
buyer_8,Antonio,45,ES07209546103281907066,TRX_N-00081-95027994,2022-03-07T11:22:30,Labastida,expenses,internet,-42.0,-1970.93
buyer_8,Antonio,45,ES07209546103281907066,TRX_N-00082-65700614,2022-03-07T14:21:49,Labastida,expenses,repairs,-113.93,-2084.86
buyer_8,Antonio,45,ES07209546103281907066,TRX_N-00083-01143080,2022-03-08T11:25:11,Labastida,expenses,phone,-39.99,-2124.85
buyer_8,Antonio,45,ES07209546103281907066,TRX_N-00084-26904444,2022-03-09T20:48:29,Labastida,expenses,food,-74.1,-2198.95
buyer_8,Antonio,45,ES07209546103281907066,TRX_N-00085-31212539,2022-03-10T14:49:22,Zarautz,expenses,food,-69.74,-2268.69
buyer_8,Antonio,45,ES07209546103281907066,TRX_N-00086-09580147,2022-03-11T10:02:00,Labastida,expenses,cash,-100.0,-2368.69
buyer_8,Antonio,45,ES07209546103281907066,TRX_N-00087-07852317,2022-03-13T08:53:41,Labastida,expenses,appliances,-333.05,-2701.74
buyer_8,Antonio,45,ES07209546103281907066,TRX_N-00088-37002773,2022-03-14T11:26:19,Salvatierra/Agurain,expenses,transport,-51.98,-2753.72
buyer_8,Antonio,45,ES07209546103281907066,TRX_N-00089-52372602,2022-03-14T18:00:49,Labastida,expenses,cash,-100.0,-2853.72
buyer_8,Antonio,45,ES07209546103281907066,TRX_N-00090-82391482,2022-03-20T16:56:19,Berango,expenses,transport,-50.81,-2904.53
buyer_8,Antonio,45,ES07209546103281907066,TRX_N-00091-96099897,2022-03-20T15:52:04,Labastida,expenses,leisure,-41.53,-2946.06
buyer_8,Antonio,45,ES07209546103281907066,TRX_N-00092-88705808,2022-03-20T17:39:38,Labastida,expenses,cash,-100.0,-3046.06
buyer_8,Antonio,45,ES07209546103281907066,TRX_N-00093-08804617,2022-03-22T13:54:31,Labastida,expenses,appliances,-140.52,-3186.58
buyer_8,Antonio,45,ES07209546103281907066,TRX_N-00094-89841747,2022-03-23T11:32:37,Labastida,expenses,food,-74.33,-3260.91
buyer_8,Antonio,45,ES07209546103281907066,TRX_N-00095-72819768,2022-03-24T15:19:26,Alegría-Dulantzi,expenses,repairs,-67.81,-3328.72
buyer_8,Antonio,45,ES07209546103281907066,TRX_N-00096-09983478,2022-03-25T22:03:12,Bermeo,expenses,cash,-100.0,-3428.72
buyer_8,Antonio,45,ES07209546103281907066,TRX_N-00097-82763659,2022-03-26T20:45:52,Labastida,expenses,leisure,-50.76,-3479.48
buyer_8,Antonio,45,ES07209546103281907066,TRX_N-00098-85645934,2022-03-26T09:21:33,Labastida,expenses,clothing,-102.19,-3581.67
buyer_8,Antonio,45,ES07209546103281907066,TRX_N-00099-17784291,2022-03-30T12:04:40,Labastida,expenses,leisure,-46.99,-3628.66
buyer_8,Antonio,45,ES07209546103281907066,TRX_N-00100-18595850,2022-04-01T16:09:24,Labastida,incomes,salary,1387.44,-2241.22
buyer_8,Antonio,45,ES07209546103281907066,TRX_N-00101-89165989,2022-04-01T16:09:24,Labastida,incomes,salary_partner,1560.7,-680.52
buyer_8,Antonio,45,ES07209546103281907066,TRX_N-00102-24539909,2022-04-01T18:21:41,Labastida,expenses,food,-72.96,-753.48
buyer_8,Antonio,45,ES07209546103281907066,TRX_N-00103-25548237,2022-04-01T14:14:55,Pasaia,expenses,leisure,-84.0,-837.48
buyer_8,Antonio,45,ES07209546103281907066,TRX_N-00104-49962911,2022-04-01T10:35:38,Zarautz,expenses,clothing,-158.62,-996.1
buyer_8,Antonio,45,ES07209546103281907066,TRX_N-00105-24316127,2022-04-02T19:51:56,Labastida,expenses,food,-84.51,-1080.61
buyer_8,Antonio,45,ES07209546103281907066,TRX_N-00106-66132060,2022-04-02T20:44:36,Pasaia,expenses,leisure,-61.42,-1142.03
buyer_8,Antonio,45,ES07209546103281907066,TRX_N-00107-04461843,2022-04-04T14:07:00,Labastida,expenses,mortgage,-970.96,-2112.99
buyer_8,Antonio,45,ES07209546103281907066,TRX_N-00108-48472790,2022-04-04T22:37:52,Labastida,expenses,repairs,-63.28,-2176.27
buyer_8,Antonio,45,ES07209546103281907066,TRX_N-00109-97133149,2022-04-05T08:04:19,Labastida,expenses,electricity,-54.43,-2230.7
buyer_8,Antonio,45,ES07209546103281907066,TRX_N-00110-04723046,2022-04-05T15:11:11,Labastida,expenses,internet,-42.0,-2272.7
buyer_8,Antonio,45,ES07209546103281907066,TRX_N-00111-99642894,2022-04-05T09:24:58,Labastida,expenses,food,-83.86,-2356.56
buyer_8,Antonio,45,ES07209546103281907066,TRX_N-00112-64555858,2022-04-06T08:49:44,Labastida,expenses,gas,-71.69,-2428.25
buyer_8,Antonio,45,ES07209546103281907066,TRX_N-00113-01606483,2022-04-07T19:40:21,Labastida,expenses,phone,-40.54,-2468.79
buyer_8,Antonio,45,ES07209546103281907066,TRX_N-00114-49720472,2022-04-08T19:29:51,Labastida,expenses,water,-42.65,-2511.44
buyer_8,Antonio,45,ES07209546103281907066,TRX_N-00115-03150936,2022-04-08T13:41:22,Labastida,expenses,clothing,-61.22,-2572.66
buyer_8,Antonio,45,ES07209546103281907066,TRX_N-00116-42493619,2022-04-10T21:28:30,Labastida,expenses,repairs,-116.32,-2688.98
buyer_8,Antonio,45,ES07209546103281907066,TRX_N-00117-50613717,2022-04-11T22:34:35,Labastida,expenses,cash,-100.0,-2788.98
buyer_8,Antonio,45,ES07209546103281907066,TRX_N-00118-39848875,2022-04-13T21:34:40,Labastida,expenses,leisure,-62.7,-2851.68
buyer_8,Antonio,45,ES07209546103281907066,TRX_N-00119-85705256,2022-04-15T11:55:57,Sopela,expenses,gifts,-337.56,-3189.24
buyer_8,Antonio,45,ES07209546103281907066,TRX_N-00120-69690935,2022-04-17T00:57:11,Labastida,expenses,leisure,-66.47,-3255.71
buyer_8,Antonio,45,ES07209546103281907066,TRX_N-00121-01796163,2022-04-17T13:55:20,Labastida,expenses,cash,-100.0,-3355.71
buyer_8,Antonio,45,ES07209546103281907066,TRX_N-00122-11645149,2022-04-17T08:45:41,Labastida,expenses,repairs,-261.14,-3616.85
buyer_8,Antonio,45,ES07209546103281907066,TRX_N-00123-88607968,2022-04-18T11:02:30,Labastida,expenses,food,-105.49,-3722.34
buyer_8,Antonio,45,ES07209546103281907066,TRX_N-00124-17477595,2022-04-18T12:28:57,Labastida,expenses,cash,-100.0,-3822.34
buyer_8,Antonio,45,ES07209546103281907066,TRX_N-00125-98652432,2022-04-18T09:01:07,Labastida,expenses,repairs,-290.58,-4112.92
buyer_8,Antonio,45,ES07209546103281907066,TRX_N-00126-06202468,2022-04-18T10:24:43,Labastida,expenses,gifts,-586.46,-4699.38
buyer_8,Antonio,45,ES07209546103281907066,TRX_N-00127-35627196,2022-04-19T18:23:43,Sopela,expenses,cash,-100.0,-4799.38
buyer_8,Antonio,45,ES07209546103281907066,TRX_N-00128-28026630,2022-04-19T19:17:25,Sopela,expenses,appliances,-283.27,-5082.65
buyer_8,Antonio,45,ES07209546103281907066,TRX_N-00129-45066713,2022-04-21T14:36:07,Labastida,expenses,food,-73.26,-5155.91
buyer_8,Antonio,45,ES07209546103281907066,TRX_N-00130-47085087,2022-04-21T12:28:59,Labastida,expenses,cash,-100.0,-5255.91
buyer_8,Antonio,45,ES07209546103281907066,TRX_N-00131-64551740,2022-04-21T17:28:11,Labastida,expenses,repairs,-224.75,-5480.66
buyer_8,Antonio,45,ES07209546103281907066,TRX_N-00132-23823839,2022-04-24T14:24:47,Labastida,expenses,transport,-81.01,-5561.67
buyer_8,Antonio,45,ES07209546103281907066,TRX_N-00133-73160380,2022-04-24T18:31:10,Labastida,expenses,education,-57.91,-5619.58
buyer_8,Antonio,45,ES07209546103281907066,TRX_N-00134-83306711,2022-04-25T00:13:17,Labastida,expenses,clothing,-58.23,-5677.81
buyer_8,Antonio,45,ES07209546103281907066,TRX_N-00135-98646294,2022-04-27T18:18:05,Labastida,expenses,education,-48.49,-5726.3
buyer_8,Antonio,45,ES07209546103281907066,TRX_N-00136-01156015,2022-04-27T22:05:53,Labastida,expenses,cash,-100.0,-5826.3
buyer_8,Antonio,45,ES07209546103281907066,TRX_N-00137-42323607,2022-04-29T19:02:14,Labastida,expenses,appliances,-125.68,-5951.98
buyer_8,Antonio,45,ES07209546103281907066,TRX_N-00138-17557302,2022-05-01T20:16:04,Labastida,incomes,salary,1387.44,-4564.54
buyer_8,Antonio,45,ES07209546103281907066,TRX_N-00139-15510643,2022-05-01T20:16:04,Labastida,incomes,salary_partner,1560.7,-3003.84
buyer_8,Antonio,45,ES07209546103281907066,TRX_N-00140-13640579,2022-05-01T12:37:11,Labastida,expenses,food,-115.76,-3119.6
buyer_8,Antonio,45,ES07209546103281907066,TRX_N-00141-61057897,2022-05-02T23:52:48,Labastida,expenses,cash,-100.0,-3219.6
buyer_8,Antonio,45,ES07209546103281907066,TRX_N-00142-05469909,2022-05-03T00:40:53,Labastida,expenses,leisure,-80.74,-3300.34
buyer_8,Antonio,45,ES07209546103281907066,TRX_N-00143-93600443,2022-05-04T18:16:48,Labastida,expenses,mortgage,-970.96,-4271.3
buyer_8,Antonio,45,ES07209546103281907066,TRX_N-00144-97357454,2022-05-04T10:24:16,Labastida,expenses,clothing,-48.36,-4319.66
buyer_8,Antonio,45,ES07209546103281907066,TRX_N-00145-23643085,2022-05-04T23:55:04,Labastida,expenses,cash,-100.0,-4419.66
buyer_8,Antonio,45,ES07209546103281907066,TRX_N-00146-19191763,2022-05-05T08:21:13,Labastida,expenses,water,-43.74,-4463.4
buyer_8,Antonio,45,ES07209546103281907066,TRX_N-00147-01942705,2022-05-06T08:44:04,Labastida,expenses,electricity,-87.95,-4551.35
buyer_8,Antonio,45,ES07209546103281907066,TRX_N-00148-24490201,2022-05-06T22:35:12,Labastida,expenses,phone,-36.79,-4588.14
buyer_8,Antonio,45,ES07209546103281907066,TRX_N-00149-24051501,2022-05-07T13:32:15,Labastida,expenses,appliances,-265.62,-4853.76
buyer_8,Antonio,45,ES07209546103281907066,TRX_N-00150-45977050,2022-05-07T12:26:22,Labastida,expenses,repairs,-121.84,-4975.6
buyer_8,Antonio,45,ES07209546103281907066,TRX_N-00151-20858771,2022-05-08T09:28:27,Labastida,expenses,internet,-42.0,-5017.6
buyer_8,Antonio,45,ES07209546103281907066,TRX_N-00152-08152525,2022-05-08T16:42:07,Labastida,expenses,gas,-42.25,-5059.85
buyer_8,Antonio,45,ES07209546103281907066,TRX_N-00153-36415993,2022-05-08T12:45:55,Durango,expenses,food,-116.08,-5175.93
buyer_8,Antonio,45,ES07209546103281907066,TRX_N-00154-14398962,2022-05-08T17:18:04,Labastida,expenses,leisure,-60.43,-5236.36
buyer_8,Antonio,45,ES07209546103281907066,TRX_N-00155-99842285,2022-05-09T22:44:20,Labastida,expenses,food,-111.32,-5347.68
buyer_8,Antonio,45,ES07209546103281907066,TRX_N-00156-74801509,2022-05-13T15:23:35,Labastida,expenses,leisure,-59.08,-5406.76
buyer_8,Antonio,45,ES07209546103281907066,TRX_N-00157-89756405,2022-05-15T17:37:53,Labastida,expenses,food,-64.89,-5471.65
buyer_8,Antonio,45,ES07209546103281907066,TRX_N-00158-53451256,2022-05-15T20:03:46,Labastida,expenses,leisure,-55.58,-5527.23
buyer_8,Antonio,45,ES07209546103281907066,TRX_N-00159-55691293,2022-05-15T19:20:00,Labastida,expenses,clothing,-115.81,-5643.04
buyer_8,Antonio,45,ES07209546103281907066,TRX_N-00160-12087033,2022-05-19T12:18:19,Labastida,expenses,appliances,-382.36,-6025.4
buyer_8,Antonio,45,ES07209546103281907066,TRX_N-00161-64962080,2022-05-20T14:11:32,Labastida,expenses,food,-61.34,-6086.74
buyer_8,Antonio,45,ES07209546103281907066,TRX_N-00162-25642744,2022-05-21T10:54:37,Labastida,expenses,food,-110.78,-6197.52
buyer_8,Antonio,45,ES07209546103281907066,TRX_N-00163-33006364,2022-05-22T15:03:57,Labastida,expenses,education,-69.37,-6266.89
buyer_8,Antonio,45,ES07209546103281907066,TRX_N-00164-43010255,2022-05-22T11:57:19,Elciego,expenses,cash,-100.0,-6366.89
buyer_8,Antonio,45,ES07209546103281907066,TRX_N-00165-83505549,2022-05-23T21:29:14,Labastida,expenses,transport,-56.11,-6423.0
buyer_8,Antonio,45,ES07209546103281907066,TRX_N-00166-38194659,2022-05-23T20:45:46,Santurtzi,expenses,cash,-100.0,-6523.0
buyer_8,Antonio,45,ES07209546103281907066,TRX_N-00167-18592529,2022-05-23T20:59:38,Labastida,expenses,repairs,-285.26,-6808.26
buyer_8,Antonio,45,ES07209546103281907066,TRX_N-00168-10840412,2022-05-24T14:08:46,Labastida,expenses,transport,-54.38,-6862.64
buyer_8,Antonio,45,ES07209546103281907066,TRX_N-00169-39871368,2022-05-27T17:06:49,Bermeo,expenses,leisure,-41.49,-6904.13
buyer_8,Antonio,45,ES07209546103281907066,TRX_N-00170-66711466,2022-05-27T22:24:39,Labastida,expenses,gifts,-786.9,-7691.03
buyer_8,Antonio,45,ES07209546103281907066,TRX_N-00171-79236879,2022-05-28T13:13:10,Labastida,expenses,cash,-100.0,-7791.03
buyer_8,Antonio,45,ES07209546103281907066,TRX_N-00172-45502866,2022-05-29T08:07:54,Labastida,expenses,food,-85.54,-7876.57
buyer_8,Antonio,45,ES07209546103281907066,TRX_N-00173-92699270,2022-05-30T08:03:07,Labastida,expenses,repairs,-62.83,-7939.4
buyer_8,Antonio,45,ES07209546103281907066,TRX_N-00174-52056737,2022-05-31T11:13:04,Labastida,expenses,repairs,-50.1,-7989.5
buyer_8,Antonio,45,ES07209546103281907066,TRX_N-00175-08340623,2022-06-01T22:37:17,Labastida,incomes,salary,1387.44,-6602.06
buyer_8,Antonio,45,ES07209546103281907066,TRX_N-00176-76106206,2022-06-01T22:37:17,Labastida,incomes,salary_partner,1560.7,-5041.36
buyer_8,Antonio,45,ES07209546103281907066,TRX_N-00177-77913806,2022-06-01T22:37:17,Labastida,incomes,extra_income,153.76,-4887.6
buyer_8,Antonio,45,ES07209546103281907066,TRX_N-00178-08656314,2022-06-01T22:37:17,Labastida,incomes,salary_bonus,1050.34,-3837.26
buyer_8,Antonio,45,ES07209546103281907066,TRX_N-00179-77008343,2022-06-01T22:37:17,Labastida,incomes,salary_partner_bonus,1239.96,-2597.3
buyer_8,Antonio,45,ES07209546103281907066,TRX_N-00180-74911591,2022-06-01T18:43:31,Labastida,expenses,transport,-64.61,-2661.91
buyer_8,Antonio,45,ES07209546103281907066,TRX_N-00181-09069987,2022-06-02T06:34:05,Labastida,expenses,cash,-100.0,-2761.91
buyer_8,Antonio,45,ES07209546103281907066,TRX_N-00182-37747753,2022-06-03T06:04:41,Labastida,expenses,repairs,-161.89,-2923.8
buyer_8,Antonio,45,ES07209546103281907066,TRX_N-00183-40415974,2022-06-04T19:18:54,Labastida,expenses,mortgage,-970.96,-3894.76
buyer_8,Antonio,45,ES07209546103281907066,TRX_N-00184-09794581,2022-06-05T20:18:16,Labastida,expenses,water,-24.26,-3919.02
buyer_8,Antonio,45,ES07209546103281907066,TRX_N-00185-72383978,2022-06-05T14:28:53,Labastida,expenses,electricity,-49.02,-3968.04
buyer_8,Antonio,45,ES07209546103281907066,TRX_N-00186-16565485,2022-06-05T20:53:14,Labastida,expenses,gas,-66.89,-4034.93
buyer_8,Antonio,45,ES07209546103281907066,TRX_N-00187-91260846,2022-06-05T20:33:03,Labastida,expenses,cash,-100.0,-4134.93
buyer_8,Antonio,45,ES07209546103281907066,TRX_N-00188-75927479,2022-06-05T08:08:37,Labastida,expenses,appliances,-223.38,-4358.31
buyer_8,Antonio,45,ES07209546103281907066,TRX_N-00189-40395597,2022-06-06T23:40:33,Labastida,expenses,phone,-40.03,-4398.34
buyer_8,Antonio,45,ES07209546103281907066,TRX_N-00190-95330245,2022-06-06T08:31:26,Labastida,expenses,food,-115.04,-4513.38
buyer_8,Antonio,45,ES07209546103281907066,TRX_N-00191-62819998,2022-06-07T20:58:24,Labastida,expenses,children,-173.06,-4686.44
buyer_8,Antonio,45,ES07209546103281907066,TRX_N-00192-45751646,2022-06-08T17:23:08,Labastida,expenses,internet,-42.0,-4728.44
buyer_8,Antonio,45,ES07209546103281907066,TRX_N-00193-01657738,2022-06-09T19:10:38,Labastida,expenses,food,-81.47,-4809.91
buyer_8,Antonio,45,ES07209546103281907066,TRX_N-00194-24485235,2022-06-10T13:02:48,Hernani,expenses,leisure,-46.77,-4856.68
buyer_8,Antonio,45,ES07209546103281907066,TRX_N-00195-18236106,2022-06-12T02:00:53,Labastida,expenses,education,-52.11,-4908.79
buyer_8,Antonio,45,ES07209546103281907066,TRX_N-00196-47442469,2022-06-13T11:20:55,Errenteria,expenses,food,-84.83,-4993.62
buyer_8,Antonio,45,ES07209546103281907066,TRX_N-00197-56123634,2022-06-14T06:26:30,Labastida,expenses,children,-141.29,-5134.91
buyer_8,Antonio,45,ES07209546103281907066,TRX_N-00198-67206527,2022-06-15T18:29:06,Labastida,expenses,children,-114.12,-5249.03
buyer_8,Antonio,45,ES07209546103281907066,TRX_N-00199-66387974,2022-06-16T21:03:15,Labastida,expenses,repairs,-205.95,-5454.98
buyer_8,Antonio,45,ES07209546103281907066,TRX_N-00200-68919948,2022-06-17T09:03:25,Labastida,expenses,food,-63.1,-5518.08
buyer_8,Antonio,45,ES07209546103281907066,TRX_N-00201-18316128,2022-06-18T10:29:53,Labastida,expenses,gifts,-479.83,-5997.91
buyer_8,Antonio,45,ES07209546103281907066,TRX_N-00202-06942675,2022-06-19T08:12:58,Labastida,expenses,children,-113.97,-6111.88
buyer_8,Antonio,45,ES07209546103281907066,TRX_N-00203-89808027,2022-06-20T10:44:34,Lasarte-Oria,expenses,leisure,-65.95,-6177.83
buyer_8,Antonio,45,ES07209546103281907066,TRX_N-00204-09548850,2022-06-20T14:21:42,Labastida,expenses,cash,-100.0,-6277.83
buyer_8,Antonio,45,ES07209546103281907066,TRX_N-00205-57089053,2022-06-21T18:13:12,Labastida,expenses,cash,-100.0,-6377.83
buyer_8,Antonio,45,ES07209546103281907066,TRX_N-00206-36742185,2022-06-23T13:53:07,Labastida,expenses,food,-88.86,-6466.69
buyer_8,Antonio,45,ES07209546103281907066,TRX_N-00207-35601808,2022-06-23T19:58:41,Iruña de Oca,expenses,leisure,-56.62,-6523.31
buyer_8,Antonio,45,ES07209546103281907066,TRX_N-00208-02718991,2022-06-23T19:02:47,Labastida,expenses,education,-63.14,-6586.45
buyer_8,Antonio,45,ES07209546103281907066,TRX_N-00209-72234109,2022-06-23T10:16:53,Labastida,expenses,cash,-100.0,-6686.45
buyer_8,Antonio,45,ES07209546103281907066,TRX_N-00210-52531882,2022-06-23T12:42:17,Labastida,expenses,repairs,-326.94,-7013.39
buyer_8,Antonio,45,ES07209546103281907066,TRX_N-00211-74415856,2022-06-25T00:44:00,Labastida,expenses,food,-98.74,-7112.13
buyer_8,Antonio,45,ES07209546103281907066,TRX_N-00212-10911874,2022-06-27T11:32:36,Labastida,expenses,education,-73.13,-7185.26
buyer_8,Antonio,45,ES07209546103281907066,TRX_N-00213-36505870,2022-06-28T23:45:55,Labastida,expenses,cash,-100.0,-7285.26
buyer_8,Antonio,45,ES07209546103281907066,TRX_N-00214-71474211,2022-06-29T13:24:32,Labastida,expenses,healthcare,-185.95,-7471.21
buyer_8,Antonio,45,ES07209546103281907066,TRX_N-00215-49839291,2022-07-01T00:57:09,Labastida,incomes,salary,1387.44,-6083.77
buyer_8,Antonio,45,ES07209546103281907066,TRX_N-00216-99169973,2022-07-01T00:57:09,Labastida,incomes,salary_partner,1560.7,-4523.07
buyer_8,Antonio,45,ES07209546103281907066,TRX_N-00217-86798343,2022-07-01T22:05:48,Labastida,expenses,leisure,-61.39,-4584.46
buyer_8,Antonio,45,ES07209546103281907066,TRX_N-00218-56093517,2022-07-04T17:36:45,Labastida,expenses,mortgage,-970.96,-5555.42
buyer_8,Antonio,45,ES07209546103281907066,TRX_N-00219-25175273,2022-07-04T21:28:02,Labastida,expenses,leisure,-69.07,-5624.49
buyer_8,Antonio,45,ES07209546103281907066,TRX_N-00220-96462139,2022-07-05T19:54:50,Labastida,expenses,water,-39.0,-5663.49
buyer_8,Antonio,45,ES07209546103281907066,TRX_N-00221-91143155,2022-07-05T17:22:56,Labastida,expenses,phone,-43.53,-5707.02
buyer_8,Antonio,45,ES07209546103281907066,TRX_N-00222-99463397,2022-07-06T09:53:37,Labastida,expenses,gas,-89.86,-5796.88
buyer_8,Antonio,45,ES07209546103281907066,TRX_N-00223-83870793,2022-07-08T11:53:49,Labastida,expenses,electricity,-51.69,-5848.57
buyer_8,Antonio,45,ES07209546103281907066,TRX_N-00224-05805245,2022-07-08T15:51:03,Labastida,expenses,internet,-42.0,-5890.57
buyer_8,Antonio,45,ES07209546103281907066,TRX_N-00225-50302086,2022-07-08T06:06:22,Labastida,expenses,food,-111.35,-6001.92
buyer_8,Antonio,45,ES07209546103281907066,TRX_N-00226-44835384,2022-07-08T14:44:52,Labastida,expenses,repairs,-114.8,-6116.72
buyer_8,Antonio,45,ES07209546103281907066,TRX_N-00227-99911124,2022-07-09T18:32:00,Labastida,expenses,repairs,-176.53,-6293.25
buyer_8,Antonio,45,ES07209546103281907066,TRX_N-00228-01349512,2022-07-09T19:57:14,Labastida,expenses,gifts,-505.99,-6799.24
buyer_8,Antonio,45,ES07209546103281907066,TRX_N-00229-18048250,2022-07-10T09:51:11,Labastida,expenses,cash,-100.0,-6899.24
buyer_8,Antonio,45,ES07209546103281907066,TRX_N-00230-43095381,2022-07-11T15:25:15,Labastida,expenses,cash,-100.0,-6999.24
buyer_8,Antonio,45,ES07209546103281907066,TRX_N-00231-32599724,2022-07-12T17:22:35,Labastida,expenses,clothing,-102.97,-7102.21
buyer_8,Antonio,45,ES07209546103281907066,TRX_N-00232-15273061,2022-07-14T18:15:39,Labastida,expenses,transport,-55.1,-7157.31
buyer_8,Antonio,45,ES07209546103281907066,TRX_N-00233-90225995,2022-07-15T11:51:04,Labastida,expenses,cash,-100.0,-7257.31
buyer_8,Antonio,45,ES07209546103281907066,TRX_N-00234-55438540,2022-07-15T15:39:17,Labastida,expenses,gifts,-431.78,-7689.09
buyer_8,Antonio,45,ES07209546103281907066,TRX_N-00235-44779964,2022-07-16T10:49:08,Salvatierra/Agurain,expenses,repairs,-294.11,-7983.2
buyer_8,Antonio,45,ES07209546103281907066,TRX_N-00236-55235512,2022-07-20T08:08:32,Labastida,expenses,leisure,-68.29,-8051.49
buyer_8,Antonio,45,ES07209546103281907066,TRX_N-00237-02028842,2022-07-21T12:55:29,Labastida,expenses,food,-70.86,-8122.35
buyer_8,Antonio,45,ES07209546103281907066,TRX_N-00238-83438139,2022-07-21T09:16:25,Vitoria-Gasteiz,expenses,healthcare,-142.86,-8265.21
buyer_8,Antonio,45,ES07209546103281907066,TRX_N-00239-84640926,2022-07-22T13:12:31,Labastida,expenses,cash,-100.0,-8365.21
buyer_8,Antonio,45,ES07209546103281907066,TRX_N-00240-66529359,2022-07-24T08:10:01,Labastida,expenses,leisure,-78.22,-8443.43
buyer_8,Antonio,45,ES07209546103281907066,TRX_N-00241-00817548,2022-07-24T18:51:43,Labastida,expenses,education,-58.86,-8502.29
buyer_8,Antonio,45,ES07209546103281907066,TRX_N-00242-11911695,2022-07-24T03:30:07,Labastida,expenses,cash,-100.0,-8602.29
buyer_8,Antonio,45,ES07209546103281907066,TRX_N-00243-35498029,2022-07-24T10:02:10,Labastida,expenses,children,-216.3,-8818.59
buyer_8,Antonio,45,ES07209546103281907066,TRX_N-00244-61512873,2022-07-25T07:57:47,Labastida,expenses,transport,-64.4,-8882.99
buyer_8,Antonio,45,ES07209546103281907066,TRX_N-00245-77008569,2022-07-27T17:23:36,Labastida,expenses,food,-92.31,-8975.3
buyer_8,Antonio,45,ES07209546103281907066,TRX_N-00246-90468351,2022-07-27T18:11:07,Labastida,expenses,leisure,-61.64,-9036.94
buyer_8,Antonio,45,ES07209546103281907066,TRX_N-00247-86985083,2022-07-27T05:58:34,Amurrio,expenses,repairs,-271.94,-9308.88
buyer_8,Antonio,45,ES07209546103281907066,TRX_N-00248-32119522,2022-07-28T09:32:18,Labastida,expenses,food,-102.43,-9411.31
buyer_8,Antonio,45,ES07209546103281907066,TRX_N-00249-24364780,2022-07-28T10:32:43,Labastida,expenses,cash,-100.0,-9511.31
buyer_8,Antonio,45,ES07209546103281907066,TRX_N-00250-22860822,2022-07-29T15:33:09,Zarautz,expenses,gifts,-137.35,-9648.66
buyer_8,Antonio,45,ES07209546103281907066,TRX_N-00251-02224655,2022-07-30T15:16:21,Vitoria-Gasteiz,expenses,food,-64.03,-9712.69
buyer_8,Antonio,45,ES07209546103281907066,TRX_N-00252-04277191,2022-07-30T18:20:10,Labastida,expenses,appliances,-112.05,-9824.74
buyer_8,Antonio,45,ES07209546103281907066,TRX_N-00253-88189059,2022-07-31T11:32:35,Labastida,expenses,food,-114.27,-9939.01
buyer_8,Antonio,45,ES07209546103281907066,TRX_N-00254-43316534,2022-07-31T07:42:47,Labastida,expenses,leisure,-39.44,-9978.45
buyer_8,Antonio,45,ES07209546103281907066,TRX_N-00255-07739534,2022-07-31T13:46:00,Llodio,expenses,cash,-100.0,-10078.45
buyer_8,Antonio,45,ES07209546103281907066,TRX_N-00256-04349490,2022-08-01T07:10:01,Labastida,incomes,salary,1387.44,-8691.01
buyer_8,Antonio,45,ES07209546103281907066,TRX_N-00257-53582103,2022-08-01T07:10:01,Labastida,incomes,salary_partner,1560.7,-7130.31
buyer_8,Antonio,45,ES07209546103281907066,TRX_N-00258-89481003,2022-08-01T11:59:21,Labastida,expenses,clothing,-94.59,-7224.9
buyer_8,Antonio,45,ES07209546103281907066,TRX_N-00259-40970907,2022-08-01T13:43:08,Irun,expenses,cash,-100.0,-7324.9
buyer_8,Antonio,45,ES07209546103281907066,TRX_N-00260-76475839,2022-08-03T08:25:33,Labastida,expenses,children,-251.76,-7576.66
buyer_8,Antonio,45,ES07209546103281907066,TRX_N-00261-54546209,2022-08-04T13:06:35,Labastida,expenses,mortgage,-970.96,-8547.62
buyer_8,Antonio,45,ES07209546103281907066,TRX_N-00262-45001869,2022-08-04T18:37:27,Labastida,expenses,food,-61.69,-8609.31
buyer_8,Antonio,45,ES07209546103281907066,TRX_N-00263-24246272,2022-08-05T18:01:58,Labastida,expenses,gas,-66.75,-8676.06
buyer_8,Antonio,45,ES07209546103281907066,TRX_N-00264-59464935,2022-08-05T13:40:38,Labastida,expenses,phone,-40.84,-8716.9
buyer_8,Antonio,45,ES07209546103281907066,TRX_N-00265-06962329,2022-08-06T00:32:22,Labastida,expenses,electricity,-58.7,-8775.6
buyer_8,Antonio,45,ES07209546103281907066,TRX_N-00266-80516266,2022-08-07T15:11:14,Labastida,expenses,water,-37.67,-8813.27
buyer_8,Antonio,45,ES07209546103281907066,TRX_N-00267-85677496,2022-08-07T12:58:10,Labastida,expenses,gifts,-648.01,-9461.28
buyer_8,Antonio,45,ES07209546103281907066,TRX_N-00268-44376440,2022-08-08T14:58:08,Labastida,expenses,internet,-42.0,-9503.28
buyer_8,Antonio,45,ES07209546103281907066,TRX_N-00269-93409084,2022-08-08T03:52:37,Sestao,expenses,gifts,-307.31,-9810.59
buyer_8,Antonio,45,ES07209546103281907066,TRX_N-00270-95766095,2022-08-09T22:48:54,Labastida,expenses,leisure,-62.04,-9872.63
buyer_8,Antonio,45,ES07209546103281907066,TRX_N-00271-58991900,2022-08-09T02:55:41,Labastida,expenses,repairs,-171.24,-10043.87
buyer_8,Antonio,45,ES07209546103281907066,TRX_N-00272-58312627,2022-08-11T01:37:21,Salvatierra/Agurain,expenses,food,-96.82,-10140.69
buyer_8,Antonio,45,ES07209546103281907066,TRX_N-00273-13879185,2022-08-11T13:03:35,Labastida,expenses,healthcare,-149.78,-10290.47
buyer_8,Antonio,45,ES07209546103281907066,TRX_N-00274-68081082,2022-08-13T10:54:48,Labastida,expenses,leisure,-19.42,-10309.89
buyer_8,Antonio,45,ES07209546103281907066,TRX_N-00275-42506706,2022-08-15T16:36:37,Arrasate,expenses,food,-65.55,-10375.44
buyer_8,Antonio,45,ES07209546103281907066,TRX_N-00276-06717208,2022-08-15T19:52:45,Getxo,expenses,transport,-50.45,-10425.89
buyer_8,Antonio,45,ES07209546103281907066,TRX_N-00277-23238131,2022-08-16T17:10:15,Labastida,expenses,cash,-100.0,-10525.89
buyer_8,Antonio,45,ES07209546103281907066,TRX_N-00278-65226431,2022-08-17T17:17:04,Labastida,expenses,leisure,-58.26,-10584.15
buyer_8,Antonio,45,ES07209546103281907066,TRX_N-00279-46441963,2022-08-17T18:15:50,Labastida,expenses,cash,-100.0,-10684.15
buyer_8,Antonio,45,ES07209546103281907066,TRX_N-00280-31075016,2022-08-21T16:49:32,Vitoria-Gasteiz,expenses,food,-109.91,-10794.06
buyer_8,Antonio,45,ES07209546103281907066,TRX_N-00281-30178159,2022-08-21T19:47:55,Labastida,expenses,gifts,-618.89,-11412.95
buyer_8,Antonio,45,ES07209546103281907066,TRX_N-00282-79883863,2022-08-22T04:19:49,Labastida,expenses,food,-112.91,-11525.86
buyer_8,Antonio,45,ES07209546103281907066,TRX_N-00283-37114009,2022-08-24T13:23:41,Irun,expenses,transport,-82.19,-11608.05
buyer_8,Antonio,45,ES07209546103281907066,TRX_N-00284-62849250,2022-08-25T23:09:56,Labastida,expenses,food,-123.94,-11731.99
buyer_8,Antonio,45,ES07209546103281907066,TRX_N-00285-44108111,2022-08-25T14:46:49,Labastida,expenses,cash,-100.0,-11831.99
buyer_8,Antonio,45,ES07209546103281907066,TRX_N-00286-30603423,2022-08-26T05:13:23,Labastida,expenses,food,-75.28,-11907.27
buyer_8,Antonio,45,ES07209546103281907066,TRX_N-00287-54927120,2022-08-26T11:21:35,Leioa,expenses,leisure,-77.31,-11984.58
buyer_8,Antonio,45,ES07209546103281907066,TRX_N-00288-94830489,2022-08-26T09:13:58,Labastida,expenses,cash,-100.0,-12084.58
buyer_8,Antonio,45,ES07209546103281907066,TRX_N-00289-17718779,2022-08-27T19:30:46,Oyón-Oion,expenses,food,-61.88,-12146.46
buyer_8,Antonio,45,ES07209546103281907066,TRX_N-00290-18215567,2022-08-27T06:01:56,Labastida,expenses,leisure,-59.96,-12206.42
buyer_8,Antonio,45,ES07209546103281907066,TRX_N-00291-17074270,2022-08-27T18:28:37,Labastida,expenses,cash,-100.0,-12306.42
buyer_8,Antonio,45,ES07209546103281907066,TRX_N-00292-61591451,2022-08-28T08:24:14,Labastida,expenses,education,-44.92,-12351.34
buyer_8,Antonio,45,ES07209546103281907066,TRX_N-00293-02317809,2022-08-29T10:59:52,Labastida,expenses,cash,-100.0,-12451.34
buyer_8,Antonio,45,ES07209546103281907066,TRX_N-00294-20165351,2022-08-30T10:44:02,Labastida,expenses,healthcare,-75.01,-12526.35
buyer_8,Antonio,45,ES07209546103281907066,TRX_N-00295-46113522,2022-08-30T19:36:09,Labastida,expenses,appliances,-193.42,-12719.77
buyer_8,Antonio,45,ES07209546103281907066,TRX_N-00296-30588452,2022-09-01T18:01:37,Labastida,incomes,salary,1387.44,-11332.33
buyer_8,Antonio,45,ES07209546103281907066,TRX_N-00297-56333174,2022-09-01T18:01:37,Labastida,incomes,salary_partner,1560.7,-9771.63
buyer_8,Antonio,45,ES07209546103281907066,TRX_N-00298-68040099,2022-09-02T18:22:16,Labastida,expenses,cash,-100.0,-9871.63
buyer_8,Antonio,45,ES07209546103281907066,TRX_N-00299-88129102,2022-09-03T20:12:50,Labastida,expenses,clothing,-86.31,-9957.94
buyer_8,Antonio,45,ES07209546103281907066,TRX_N-00300-51804347,2022-09-03T16:41:13,Berango,expenses,cash,-100.0,-10057.94
buyer_8,Antonio,45,ES07209546103281907066,TRX_N-00301-56238518,2022-09-04T18:37:16,Labastida,expenses,mortgage,-970.96,-11028.9
buyer_8,Antonio,45,ES07209546103281907066,TRX_N-00302-36834017,2022-09-04T08:10:40,Labastida,expenses,transport,-46.58,-11075.48
buyer_8,Antonio,45,ES07209546103281907066,TRX_N-00303-93885153,2022-09-05T09:34:42,Labastida,expenses,water,-21.8,-11097.28
buyer_8,Antonio,45,ES07209546103281907066,TRX_N-00304-83807974,2022-09-05T17:29:39,Labastida,expenses,internet,-42.0,-11139.28
buyer_8,Antonio,45,ES07209546103281907066,TRX_N-00305-36668310,2022-09-05T16:19:36,Labastida,expenses,phone,-35.05,-11174.33
buyer_8,Antonio,45,ES07209546103281907066,TRX_N-00306-14137449,2022-09-07T10:42:00,Labastida,expenses,gas,-59.64,-11233.97
buyer_8,Antonio,45,ES07209546103281907066,TRX_N-00307-69127315,2022-09-07T03:55:56,Labastida,expenses,cash,-100.0,-11333.97
buyer_8,Antonio,45,ES07209546103281907066,TRX_N-00308-69531470,2022-09-08T16:36:35,Labastida,expenses,electricity,-65.18,-11399.15
buyer_8,Antonio,45,ES07209546103281907066,TRX_N-00309-03536453,2022-09-08T11:29:21,Eibar,expenses,cash,-100.0,-11499.15
buyer_8,Antonio,45,ES07209546103281907066,TRX_N-00310-26765290,2022-09-08T22:12:55,Zuia,expenses,appliances,-337.79,-11836.94
buyer_8,Antonio,45,ES07209546103281907066,TRX_N-00311-53889407,2022-09-10T05:43:38,Labastida,expenses,food,-118.37,-11955.31
buyer_8,Antonio,45,ES07209546103281907066,TRX_N-00312-08529368,2022-09-10T13:39:25,Labastida,expenses,cash,-100.0,-12055.31
buyer_8,Antonio,45,ES07209546103281907066,TRX_N-00313-52405855,2022-09-11T15:47:40,Labastida,expenses,food,-79.68,-12134.99
buyer_8,Antonio,45,ES07209546103281907066,TRX_N-00314-30740273,2022-09-12T11:43:28,Labastida,expenses,leisure,-46.23,-12181.22
buyer_8,Antonio,45,ES07209546103281907066,TRX_N-00315-61766355,2022-09-13T17:17:10,Labastida,expenses,food,-112.9,-12294.12
buyer_8,Antonio,45,ES07209546103281907066,TRX_N-00316-74891945,2022-09-13T08:20:00,Labastida,expenses,cash,-100.0,-12394.12
buyer_8,Antonio,45,ES07209546103281907066,TRX_N-00317-01250406,2022-09-14T12:01:10,Labastida,expenses,food,-81.15,-12475.27
buyer_8,Antonio,45,ES07209546103281907066,TRX_N-00318-69188679,2022-09-14T19:07:35,Labastida,expenses,leisure,-27.45,-12502.72
buyer_8,Antonio,45,ES07209546103281907066,TRX_N-00319-58466109,2022-09-15T18:21:21,Labastida,expenses,transport,-76.15,-12578.87
buyer_8,Antonio,45,ES07209546103281907066,TRX_N-00320-08521788,2022-09-15T19:30:56,Labastida,expenses,education,-63.2,-12642.07
buyer_8,Antonio,45,ES07209546103281907066,TRX_N-00321-45101822,2022-09-16T22:06:09,Mungia,expenses,food,-123.48,-12765.55
buyer_8,Antonio,45,ES07209546103281907066,TRX_N-00322-75052084,2022-09-18T22:07:21,Labastida,expenses,leisure,-45.57,-12811.12
buyer_8,Antonio,45,ES07209546103281907066,TRX_N-00323-80037943,2022-09-19T18:08:23,Labastida,expenses,food,-117.04,-12928.16
buyer_8,Antonio,45,ES07209546103281907066,TRX_N-00324-68326575,2022-09-19T19:58:04,Labastida,expenses,children,-198.69,-13126.85
buyer_8,Antonio,45,ES07209546103281907066,TRX_N-00325-18354535,2022-09-20T13:59:04,Donostia,expenses,food,-110.08,-13236.93
buyer_8,Antonio,45,ES07209546103281907066,TRX_N-00326-92190905,2022-09-23T17:13:19,Labastida,expenses,food,-112.79,-13349.72
buyer_8,Antonio,45,ES07209546103281907066,TRX_N-00327-07277633,2022-09-24T16:29:12,Labastida,expenses,cash,-100.0,-13449.72
buyer_8,Antonio,45,ES07209546103281907066,TRX_N-00328-12467909,2022-09-27T08:25:00,Labastida,expenses,gifts,-222.78,-13672.5
buyer_8,Antonio,45,ES07209546103281907066,TRX_N-00329-63347198,2022-09-30T12:34:20,Labastida,expenses,repairs,-145.43,-13817.93
buyer_8,Antonio,45,ES07209546103281907066,TRX_N-00330-03285370,2022-10-01T04:54:34,Labastida,incomes,salary,1387.44,-12430.49
buyer_8,Antonio,45,ES07209546103281907066,TRX_N-00331-50635248,2022-10-01T04:54:34,Labastida,incomes,salary_partner,1560.7,-10869.79
buyer_8,Antonio,45,ES07209546103281907066,TRX_N-00332-15692701,2022-10-01T04:54:34,Labastida,incomes,extra_income,153.76,-10716.03
buyer_8,Antonio,45,ES07209546103281907066,TRX_N-00333-01187782,2022-10-04T11:52:11,Labastida,expenses,mortgage,-970.96,-11686.99
buyer_8,Antonio,45,ES07209546103281907066,TRX_N-00334-21035653,2022-10-04T08:35:45,Labastida,expenses,food,-98.07,-11785.06
buyer_8,Antonio,45,ES07209546103281907066,TRX_N-00335-10500726,2022-10-04T20:27:41,Labastida,expenses,leisure,-35.48,-11820.54
buyer_8,Antonio,45,ES07209546103281907066,TRX_N-00336-64668465,2022-10-05T19:08:47,Labastida,expenses,cash,-100.0,-11920.54
buyer_8,Antonio,45,ES07209546103281907066,TRX_N-00337-28813218,2022-10-06T18:33:43,Labastida,expenses,electricity,-27.99,-11948.53
buyer_8,Antonio,45,ES07209546103281907066,TRX_N-00338-31393224,2022-10-06T01:10:37,Errenteria,expenses,food,-93.57,-12042.1
buyer_8,Antonio,45,ES07209546103281907066,TRX_N-00339-55783759,2022-10-07T16:14:53,Labastida,expenses,phone,-41.56,-12083.66
buyer_8,Antonio,45,ES07209546103281907066,TRX_N-00340-74747118,2022-10-07T15:30:35,Labastida,expenses,cash,-100.0,-12183.66
buyer_8,Antonio,45,ES07209546103281907066,TRX_N-00341-03006377,2022-10-08T22:55:50,Labastida,expenses,water,-37.85,-12221.51
buyer_8,Antonio,45,ES07209546103281907066,TRX_N-00342-55212392,2022-10-08T13:06:32,Labastida,expenses,gas,-35.22,-12256.73
buyer_8,Antonio,45,ES07209546103281907066,TRX_N-00343-95425710,2022-10-08T07:15:20,Labastida,expenses,internet,-42.0,-12298.73
buyer_8,Antonio,45,ES07209546103281907066,TRX_N-00344-24300850,2022-10-10T10:39:54,Labastida,expenses,cash,-100.0,-12398.73
buyer_8,Antonio,45,ES07209546103281907066,TRX_N-00345-82577429,2022-10-11T18:30:16,Pasaia,expenses,food,-108.45,-12507.18
buyer_8,Antonio,45,ES07209546103281907066,TRX_N-00346-10798723,2022-10-12T15:32:19,Leioa,expenses,gifts,-381.47,-12888.65
buyer_8,Antonio,45,ES07209546103281907066,TRX_N-00347-50015359,2022-10-13T16:19:21,Labastida,expenses,leisure,-37.31,-12925.96
buyer_8,Antonio,45,ES07209546103281907066,TRX_N-00348-92623765,2022-10-20T04:34:43,Bermeo,expenses,cash,-100.0,-13025.96
buyer_8,Antonio,45,ES07209546103281907066,TRX_N-00349-21581548,2022-10-25T16:28:21,Labastida,expenses,clothing,-58.61,-13084.57
buyer_8,Antonio,45,ES07209546103281907066,TRX_N-00350-78089528,2022-10-28T15:18:18,Irun,expenses,leisure,-71.92,-13156.49
buyer_8,Antonio,45,ES07209546103281907066,TRX_N-00351-00119475,2022-10-28T08:57:01,Errenteria,expenses,travel,-857.71,-14014.2
buyer_8,Antonio,45,ES07209546103281907066,TRX_N-00352-82262250,2022-10-30T22:22:35,Andoain,expenses,transport,-76.7,-14090.9
buyer_8,Antonio,45,ES07209546103281907066,TRX_N-00353-78702298,2022-10-31T13:42:01,Labastida,expenses,cash,-100.0,-14190.9
buyer_8,Antonio,45,ES07209546103281907066,TRX_N-00354-16508220,2022-11-01T12:05:25,Labastida,incomes,salary,1387.44,-12803.46
buyer_8,Antonio,45,ES07209546103281907066,TRX_N-00355-00687964,2022-11-01T12:05:25,Labastida,incomes,salary_partner,1560.7,-11242.76
buyer_8,Antonio,45,ES07209546103281907066,TRX_N-00356-07389924,2022-11-02T09:41:50,Labastida,expenses,travel,-1252.33,-12495.09
buyer_8,Antonio,45,ES07209546103281907066,TRX_N-00357-47925102,2022-11-04T15:22:12,Labastida,expenses,mortgage,-970.96,-13466.05
buyer_8,Antonio,45,ES07209546103281907066,TRX_N-00358-34459445,2022-11-05T17:25:11,Labastida,expenses,gifts,-660.48,-14126.53
buyer_8,Antonio,45,ES07209546103281907066,TRX_N-00359-79633209,2022-11-06T20:29:20,Labastida,expenses,water,-21.47,-14148.0
buyer_8,Antonio,45,ES07209546103281907066,TRX_N-00360-07650354,2022-11-06T19:53:04,Labastida,expenses,gas,-41.36,-14189.36
buyer_8,Antonio,45,ES07209546103281907066,TRX_N-00361-89287374,2022-11-06T17:05:35,Labastida,expenses,internet,-42.0,-14231.36
buyer_8,Antonio,45,ES07209546103281907066,TRX_N-00362-11300989,2022-11-06T20:27:21,Labastida,expenses,phone,-30.96,-14262.32
buyer_8,Antonio,45,ES07209546103281907066,TRX_N-00363-42645131,2022-11-07T21:41:23,Labastida,expenses,healthcare,-161.02,-14423.34
buyer_8,Antonio,45,ES07209546103281907066,TRX_N-00364-50809780,2022-11-07T23:35:32,Labastida,expenses,repairs,-155.85,-14579.19
buyer_8,Antonio,45,ES07209546103281907066,TRX_N-00365-28551033,2022-11-08T11:52:19,Labastida,expenses,electricity,-83.49,-14662.68
buyer_8,Antonio,45,ES07209546103281907066,TRX_N-00366-19229648,2022-11-08T10:55:25,Labastida,expenses,cash,-100.0,-14762.68
buyer_8,Antonio,45,ES07209546103281907066,TRX_N-00367-94263757,2022-11-09T11:50:10,Labastida,expenses,food,-101.71,-14864.39
buyer_8,Antonio,45,ES07209546103281907066,TRX_N-00368-70089162,2022-11-10T10:49:59,Labastida,expenses,cash,-100.0,-14964.39
buyer_8,Antonio,45,ES07209546103281907066,TRX_N-00369-87334910,2022-11-11T20:18:20,Getxo,expenses,education,-54.79,-15019.18
buyer_8,Antonio,45,ES07209546103281907066,TRX_N-00370-76954905,2022-11-13T08:02:22,Labastida,expenses,healthcare,-80.87,-15100.05
buyer_8,Antonio,45,ES07209546103281907066,TRX_N-00371-50583727,2022-11-14T11:38:46,Amurrio,expenses,leisure,-46.03,-15146.08
buyer_8,Antonio,45,ES07209546103281907066,TRX_N-00372-16484965,2022-11-16T16:18:25,Labastida,expenses,cash,-100.0,-15246.08
buyer_8,Antonio,45,ES07209546103281907066,TRX_N-00373-52104395,2022-11-17T20:56:32,Labastida,expenses,transport,-86.5,-15332.58
buyer_8,Antonio,45,ES07209546103281907066,TRX_N-00374-84900399,2022-11-18T08:50:33,Leioa,expenses,repairs,-30.13,-15362.71
buyer_8,Antonio,45,ES07209546103281907066,TRX_N-00375-96058553,2022-11-19T11:00:56,Labastida,expenses,repairs,-47.91,-15410.62
buyer_8,Antonio,45,ES07209546103281907066,TRX_N-00376-91473732,2022-11-21T18:08:44,Labastida,expenses,appliances,-264.52,-15675.14
buyer_8,Antonio,45,ES07209546103281907066,TRX_N-00377-16750165,2022-11-21T10:43:34,Labastida,expenses,repairs,-109.27,-15784.41
buyer_8,Antonio,45,ES07209546103281907066,TRX_N-00378-37056974,2022-11-23T15:40:40,Labastida,expenses,transport,-58.55,-15842.96
buyer_8,Antonio,45,ES07209546103281907066,TRX_N-00379-04188747,2022-11-23T21:03:07,Labastida,expenses,repairs,-310.34,-16153.3
buyer_8,Antonio,45,ES07209546103281907066,TRX_N-00380-14753165,2022-11-24T16:48:47,Labastida,expenses,food,-80.86,-16234.16
buyer_8,Antonio,45,ES07209546103281907066,TRX_N-00381-63392275,2022-11-25T16:59:27,Labastida,expenses,transport,-50.23,-16284.39
buyer_8,Antonio,45,ES07209546103281907066,TRX_N-00382-78605997,2022-11-25T11:13:01,Labastida,expenses,cash,-100.0,-16384.39
buyer_8,Antonio,45,ES07209546103281907066,TRX_N-00383-15092573,2022-11-27T14:56:40,Labastida,expenses,transport,-87.97,-16472.36
buyer_8,Antonio,45,ES07209546103281907066,TRX_N-00384-48741251,2022-11-27T17:43:48,Bermeo,expenses,repairs,-152.42,-16624.78
buyer_8,Antonio,45,ES07209546103281907066,TRX_N-00385-31708003,2022-11-28T08:15:40,Labastida,expenses,transport,-72.75,-16697.53
buyer_8,Antonio,45,ES07209546103281907066,TRX_N-00386-64361169,2022-11-28T14:06:46,Labastida,expenses,cash,-100.0,-16797.53
buyer_8,Antonio,45,ES07209546103281907066,TRX_N-00387-42011661,2022-11-29T09:13:03,Labastida,expenses,cash,-100.0,-16897.53
buyer_8,Antonio,45,ES07209546103281907066,TRX_N-00388-33476793,2022-11-30T10:07:05,Labastida,expenses,clothing,-119.07,-17016.6
buyer_8,Antonio,45,ES07209546103281907066,TRX_N-00389-57881936,2022-12-01T17:56:34,Labastida,incomes,salary,1387.44,-15629.16
buyer_8,Antonio,45,ES07209546103281907066,TRX_N-00390-07747205,2022-12-01T17:56:34,Labastida,incomes,salary_partner,1560.7,-14068.46
buyer_8,Antonio,45,ES07209546103281907066,TRX_N-00391-77044611,2022-12-01T17:56:34,Labastida,incomes,salary_bonus,1043.39,-13025.07
buyer_8,Antonio,45,ES07209546103281907066,TRX_N-00392-43340483,2022-12-01T17:56:34,Labastida,incomes,salary_partner_bonus,1144.06,-11881.01
buyer_8,Antonio,45,ES07209546103281907066,TRX_N-00393-42677098,2022-12-01T23:27:32,Labastida,expenses,cash,-100.0,-11981.01
buyer_8,Antonio,45,ES07209546103281907066,TRX_N-00394-61739779,2022-12-03T10:20:33,Labastida,expenses,cash,-100.0,-12081.01
buyer_8,Antonio,45,ES07209546103281907066,TRX_N-00395-96800201,2022-12-04T19:35:56,Labastida,expenses,mortgage,-970.96,-13051.97
buyer_8,Antonio,45,ES07209546103281907066,TRX_N-00396-62675357,2022-12-05T17:53:47,Labastida,expenses,water,-38.39,-13090.36
buyer_8,Antonio,45,ES07209546103281907066,TRX_N-00397-63418674,2022-12-05T14:17:27,Labastida,expenses,gas,-92.67,-13183.03
buyer_8,Antonio,45,ES07209546103281907066,TRX_N-00398-20329812,2022-12-05T09:15:56,Labastida,expenses,phone,-30.89,-13213.92
buyer_8,Antonio,45,ES07209546103281907066,TRX_N-00399-74638933,2022-12-05T21:02:05,Labastida,expenses,food,-86.99,-13300.91
buyer_8,Antonio,45,ES07209546103281907066,TRX_N-00400-50185609,2022-12-05T05:28:56,Labastida,expenses,leisure,-69.14,-13370.05
buyer_8,Antonio,45,ES07209546103281907066,TRX_N-00401-23568077,2022-12-05T10:35:41,Labastida,expenses,children,-234.57,-13604.62
buyer_8,Antonio,45,ES07209546103281907066,TRX_N-00402-38766826,2022-12-06T01:44:25,Labastida,expenses,electricity,-38.98,-13643.6
buyer_8,Antonio,45,ES07209546103281907066,TRX_N-00403-63450399,2022-12-07T00:18:21,Labastida,expenses,internet,-42.0,-13685.6
buyer_8,Antonio,45,ES07209546103281907066,TRX_N-00404-57627598,2022-12-07T10:36:31,Labastida,expenses,appliances,-190.7,-13876.3
buyer_8,Antonio,45,ES07209546103281907066,TRX_N-00405-40065222,2022-12-08T13:23:34,Labastida,expenses,education,-47.55,-13923.85
buyer_8,Antonio,45,ES07209546103281907066,TRX_N-00406-68885644,2022-12-08T18:07:32,Labastida,expenses,cash,-100.0,-14023.85
buyer_8,Antonio,45,ES07209546103281907066,TRX_N-00407-40111452,2022-12-10T15:42:03,Labastida,expenses,food,-73.44,-14097.29
buyer_8,Antonio,45,ES07209546103281907066,TRX_N-00408-29795285,2022-12-11T20:57:56,Labastida,expenses,education,-43.28,-14140.57
buyer_8,Antonio,45,ES07209546103281907066,TRX_N-00409-16595084,2022-12-12T18:12:00,Irun,expenses,cash,-100.0,-14240.57
buyer_8,Antonio,45,ES07209546103281907066,TRX_N-00410-70718166,2022-12-14T16:38:54,Labastida,expenses,transport,-74.6,-14315.17
buyer_8,Antonio,45,ES07209546103281907066,TRX_N-00411-24817640,2022-12-14T09:11:58,Labastida,expenses,cash,-100.0,-14415.17
buyer_8,Antonio,45,ES07209546103281907066,TRX_N-00412-53152069,2022-12-15T10:15:34,Labastida,expenses,appliances,-418.13,-14833.3
buyer_8,Antonio,45,ES07209546103281907066,TRX_N-00413-42133173,2022-12-16T13:06:06,Labastida,expenses,education,-74.44,-14907.74
buyer_8,Antonio,45,ES07209546103281907066,TRX_N-00414-39675471,2022-12-17T13:12:52,Labastida,expenses,leisure,-52.68,-14960.42
buyer_8,Antonio,45,ES07209546103281907066,TRX_N-00415-00037316,2022-12-17T22:15:04,Labastida,expenses,clothing,-107.47,-15067.89
buyer_8,Antonio,45,ES07209546103281907066,TRX_N-00416-84279109,2022-12-17T18:12:45,Alegría-Dulantzi,expenses,gifts,-161.98,-15229.87
buyer_8,Antonio,45,ES07209546103281907066,TRX_N-00417-90149696,2022-12-18T14:17:09,Labastida,expenses,gifts,-383.7,-15613.57
buyer_8,Antonio,45,ES07209546103281907066,TRX_N-00418-69292595,2022-12-21T07:45:18,Labastida,expenses,food,-95.55,-15709.12
buyer_8,Antonio,45,ES07209546103281907066,TRX_N-00419-70334559,2022-12-21T20:44:22,Labastida,expenses,transport,-55.05,-15764.17
buyer_8,Antonio,45,ES07209546103281907066,TRX_N-00420-19897839,2022-12-21T13:10:36,Labastida,expenses,leisure,-50.12,-15814.29
buyer_8,Antonio,45,ES07209546103281907066,TRX_N-00421-04683251,2022-12-23T23:03:45,Labastida,expenses,food,-81.76,-15896.05
buyer_8,Antonio,45,ES07209546103281907066,TRX_N-00422-41258845,2022-12-23T19:19:53,Labastida,expenses,cash,-100.0,-15996.05
buyer_8,Antonio,45,ES07209546103281907066,TRX_N-00423-66134935,2022-12-24T17:37:11,Labastida,expenses,transport,-75.56,-16071.61
buyer_8,Antonio,45,ES07209546103281907066,TRX_N-00424-63374894,2022-12-27T20:02:36,Labastida,expenses,food,-118.33,-16189.94
buyer_8,Antonio,45,ES07209546103281907066,TRX_N-00425-21697139,2022-12-29T18:47:28,Labastida,expenses,repairs,-273.03,-16462.97
buyer_8,Antonio,45,ES07209546103281907066,TRX_N-00426-66754283,2022-12-30T18:54:24,Labastida,expenses,transport,-81.32,-16544.29
buyer_8,Antonio,45,ES07209546103281907066,TRX_N-00427-41889271,2022-12-31T19:50:54,Labastida,expenses,food,-66.57,-16610.86
buyer_8,Antonio,45,ES07209546103281907066,TRX_N-00428-18648074,2023-01-01T18:46:00,Labastida,incomes,salary,1435.8,-15175.06
buyer_8,Antonio,45,ES07209546103281907066,TRX_N-00429-57435907,2023-01-01T18:46:00,Labastida,incomes,salary_partner,1615.1,-13559.96
buyer_8,Antonio,45,ES07209546103281907066,TRX_N-00430-18527646,2023-01-01T18:46:00,Labastida,incomes,extra_income,153.76,-13406.2
buyer_8,Antonio,45,ES07209546103281907066,TRX_N-00431-98631364,2023-01-01T20:47:34,Labastida,expenses,gifts,-686.19,-14092.39
buyer_8,Antonio,45,ES07209546103281907066,TRX_N-00432-46466402,2023-01-02T13:00:18,Labastida,expenses,cash,-100.0,-14192.39
buyer_8,Antonio,45,ES07209546103281907066,TRX_N-00433-68618808,2023-01-03T09:33:55,Labastida,expenses,children,-197.92,-14390.31
buyer_8,Antonio,45,ES07209546103281907066,TRX_N-00434-09884733,2023-01-04T17:41:17,Labastida,expenses,mortgage,-970.96,-15361.27
buyer_8,Antonio,45,ES07209546103281907066,TRX_N-00435-49114257,2023-01-05T22:18:23,Labastida,expenses,electricity,-75.66,-15436.93
buyer_8,Antonio,45,ES07209546103281907066,TRX_N-00436-26172238,2023-01-05T12:44:51,Labastida,expenses,transport,-66.97,-15503.9
buyer_8,Antonio,45,ES07209546103281907066,TRX_N-00437-77848677,2023-01-05T10:41:52,Labastida,expenses,leisure,-59.46,-15563.36
buyer_8,Antonio,45,ES07209546103281907066,TRX_N-00438-61111320,2023-01-05T09:32:55,Labastida,expenses,cash,-100.0,-15663.36
buyer_8,Antonio,45,ES07209546103281907066,TRX_N-00439-09318791,2023-01-07T10:56:27,Labastida,expenses,gas,-40.58,-15703.94
buyer_8,Antonio,45,ES07209546103281907066,TRX_N-00440-56460623,2023-01-07T16:22:23,Labastida,expenses,food,-97.49,-15801.43
buyer_8,Antonio,45,ES07209546103281907066,TRX_N-00441-13042100,2023-01-07T15:24:44,Labastida,expenses,leisure,-35.48,-15836.91
buyer_8,Antonio,45,ES07209546103281907066,TRX_N-00442-45169333,2023-01-08T19:17:10,Labastida,expenses,water,-41.21,-15878.12
buyer_8,Antonio,45,ES07209546103281907066,TRX_N-00443-59496010,2023-01-08T07:46:05,Labastida,expenses,internet,-42.0,-15920.12
buyer_8,Antonio,45,ES07209546103281907066,TRX_N-00444-49335963,2023-01-08T19:18:07,Labastida,expenses,phone,-30.72,-15950.84
buyer_8,Antonio,45,ES07209546103281907066,TRX_N-00445-55095174,2023-01-08T09:06:43,Labastida,expenses,food,-82.86,-16033.7
buyer_8,Antonio,45,ES07209546103281907066,TRX_N-00446-33524591,2023-01-09T12:28:26,Labastida,expenses,food,-62.56,-16096.26
buyer_8,Antonio,45,ES07209546103281907066,TRX_N-00447-79612624,2023-01-09T17:45:52,Labastida,expenses,appliances,-207.77,-16304.03
buyer_8,Antonio,45,ES07209546103281907066,TRX_N-00448-39633042,2023-01-10T15:25:25,Labastida,expenses,leisure,-31.49,-16335.52
buyer_8,Antonio,45,ES07209546103281907066,TRX_N-00449-67090062,2023-01-11T21:08:55,Labastida,expenses,clothing,-108.75,-16444.27
buyer_8,Antonio,45,ES07209546103281907066,TRX_N-00450-79248847,2023-01-12T14:02:07,Labastida,expenses,food,-98.61,-16542.88
buyer_8,Antonio,45,ES07209546103281907066,TRX_N-00451-82982096,2023-01-12T12:07:54,Labastida,expenses,children,-79.95,-16622.83
buyer_8,Antonio,45,ES07209546103281907066,TRX_N-00452-77187479,2023-01-13T00:11:49,Labastida,expenses,repairs,-126.99,-16749.82
buyer_8,Antonio,45,ES07209546103281907066,TRX_N-00453-33156906,2023-01-14T11:10:43,Labastida,expenses,food,-75.18,-16825.0
buyer_8,Antonio,45,ES07209546103281907066,TRX_N-00454-82219381,2023-01-14T16:01:40,Labastida,expenses,cash,-100.0,-16925.0
buyer_8,Antonio,45,ES07209546103281907066,TRX_N-00455-58470783,2023-01-14T09:24:42,Labastida,expenses,travel,-1745.57,-18670.57
buyer_8,Antonio,45,ES07209546103281907066,TRX_N-00456-58581147,2023-01-15T14:05:01,Labastida,expenses,appliances,-106.65,-18777.22
buyer_8,Antonio,45,ES07209546103281907066,TRX_N-00457-43572604,2023-01-15T19:54:39,Labastida,expenses,children,-176.03,-18953.25
buyer_8,Antonio,45,ES07209546103281907066,TRX_N-00458-25352348,2023-01-16T09:58:46,Zuia,expenses,transport,-52.98,-19006.23
buyer_8,Antonio,45,ES07209546103281907066,TRX_N-00459-02295428,2023-01-16T11:39:42,Sestao,expenses,cash,-100.0,-19106.23
buyer_8,Antonio,45,ES07209546103281907066,TRX_N-00460-61006537,2023-01-18T08:52:57,Labastida,expenses,cash,-100.0,-19206.23
buyer_8,Antonio,45,ES07209546103281907066,TRX_N-00461-95208651,2023-01-20T11:46:17,Labastida,expenses,food,-101.98,-19308.21
buyer_8,Antonio,45,ES07209546103281907066,TRX_N-00462-09158647,2023-01-27T04:06:11,Labastida,expenses,gifts,-785.66,-20093.87
buyer_8,Antonio,45,ES07209546103281907066,TRX_N-00463-81372277,2023-01-28T16:08:13,Salvatierra/Agurain,expenses,food,-116.29,-20210.16
buyer_8,Antonio,45,ES07209546103281907066,TRX_N-00464-06984836,2023-01-29T15:47:46,Labastida,expenses,cash,-100.0,-20310.16
buyer_8,Antonio,45,ES07209546103281907066,TRX_N-00465-21612216,2023-01-29T22:15:08,Labastida,expenses,repairs,-142.1,-20452.26
buyer_8,Antonio,45,ES07209546103281907066,TRX_N-00466-79089596,2023-01-30T14:35:51,Barakaldo,expenses,healthcare,-152.25,-20604.51
buyer_8,Antonio,45,ES07209546103281907066,TRX_N-00467-43895677,2023-01-31T13:53:01,Arrasate,expenses,appliances,-226.91,-20831.42
buyer_8,Antonio,45,ES07209546103281907066,TRX_N-00468-42571091,2023-02-01T04:57:14,Labastida,incomes,salary,1435.8,-19395.62
buyer_8,Antonio,45,ES07209546103281907066,TRX_N-00469-10800848,2023-02-01T04:57:14,Labastida,incomes,salary_partner,1615.1,-17780.52
buyer_8,Antonio,45,ES07209546103281907066,TRX_N-00470-61202760,2023-02-02T11:13:07,Zuia,expenses,clothing,-116.8,-17897.32
buyer_8,Antonio,45,ES07209546103281907066,TRX_N-00471-89383068,2023-02-03T12:01:59,Labastida,expenses,transport,-56.21,-17953.53
buyer_8,Antonio,45,ES07209546103281907066,TRX_N-00472-04904986,2023-02-04T22:38:14,Labastida,expenses,mortgage,-970.96,-18924.49
buyer_8,Antonio,45,ES07209546103281907066,TRX_N-00473-44094374,2023-02-04T08:22:54,Labastida,expenses,children,-246.81,-19171.3
buyer_8,Antonio,45,ES07209546103281907066,TRX_N-00474-06599227,2023-02-06T12:43:56,Labastida,expenses,gas,-79.55,-19250.85
buyer_8,Antonio,45,ES07209546103281907066,TRX_N-00475-67153605,2023-02-07T20:48:49,Labastida,expenses,electricity,-68.81,-19319.66
buyer_8,Antonio,45,ES07209546103281907066,TRX_N-00476-29529445,2023-02-07T09:09:31,Labastida,expenses,internet,-42.0,-19361.66
buyer_8,Antonio,45,ES07209546103281907066,TRX_N-00477-26813860,2023-02-07T10:40:54,Labastida,expenses,children,-125.0,-19486.66
buyer_8,Antonio,45,ES07209546103281907066,TRX_N-00478-45582787,2023-02-08T12:11:31,Labastida,expenses,water,-20.49,-19507.15
buyer_8,Antonio,45,ES07209546103281907066,TRX_N-00479-39649518,2023-02-08T08:22:09,Labastida,expenses,phone,-32.41,-19539.56
buyer_8,Antonio,45,ES07209546103281907066,TRX_N-00480-04584960,2023-02-09T13:31:22,Labastida,expenses,education,-46.4,-19585.96
buyer_8,Antonio,45,ES07209546103281907066,TRX_N-00481-78250334,2023-02-11T08:08:17,Labastida,expenses,leisure,-50.25,-19636.21
buyer_8,Antonio,45,ES07209546103281907066,TRX_N-00482-75262963,2023-02-11T11:05:15,Mungia,expenses,appliances,-311.62,-19947.83
buyer_8,Antonio,45,ES07209546103281907066,TRX_N-00483-44799725,2023-02-11T12:41:12,Elciego,expenses,repairs,-257.93,-20205.76
buyer_8,Antonio,45,ES07209546103281907066,TRX_N-00484-75206317,2023-02-12T18:17:00,Bermeo,expenses,transport,-80.32,-20286.08
buyer_8,Antonio,45,ES07209546103281907066,TRX_N-00485-24979090,2023-02-12T15:15:01,Labastida,expenses,cash,-100.0,-20386.08
buyer_8,Antonio,45,ES07209546103281907066,TRX_N-00486-53639970,2023-02-13T13:37:27,Durango,expenses,food,-100.24,-20486.32
buyer_8,Antonio,45,ES07209546103281907066,TRX_N-00487-50940171,2023-02-14T18:24:08,Labastida,expenses,education,-49.44,-20535.76
buyer_8,Antonio,45,ES07209546103281907066,TRX_N-00488-73247364,2023-02-14T13:27:34,Labastida,expenses,appliances,-319.61,-20855.37
buyer_8,Antonio,45,ES07209546103281907066,TRX_N-00489-94507032,2023-02-15T12:42:41,Labastida,expenses,cash,-100.0,-20955.37
buyer_8,Antonio,45,ES07209546103281907066,TRX_N-00490-69150645,2023-02-15T08:41:57,Labastida,expenses,children,-141.14,-21096.51
buyer_8,Antonio,45,ES07209546103281907066,TRX_N-00491-83749360,2023-02-16T17:45:13,Labastida,expenses,food,-117.24,-21213.75
buyer_8,Antonio,45,ES07209546103281907066,TRX_N-00492-99126695,2023-02-16T09:24:11,Labastida,expenses,leisure,-39.44,-21253.19
buyer_8,Antonio,45,ES07209546103281907066,TRX_N-00493-67837460,2023-02-16T16:40:36,Vitoria-Gasteiz,expenses,cash,-100.0,-21353.19
buyer_8,Antonio,45,ES07209546103281907066,TRX_N-00494-33525299,2023-02-17T16:24:13,Labastida,expenses,leisure,-83.58,-21436.77
buyer_8,Antonio,45,ES07209546103281907066,TRX_N-00495-09692299,2023-02-18T18:02:31,Labastida,expenses,food,-72.97,-21509.74
buyer_8,Antonio,45,ES07209546103281907066,TRX_N-00496-32625099,2023-02-18T15:24:58,Labastida,expenses,cash,-100.0,-21609.74
buyer_8,Antonio,45,ES07209546103281907066,TRX_N-00497-13567560,2023-02-18T14:28:30,Labastida,expenses,appliances,-118.06,-21727.8
buyer_8,Antonio,45,ES07209546103281907066,TRX_N-00498-48040834,2023-02-20T11:05:06,Labastida,expenses,leisure,-24.03,-21751.83
buyer_8,Antonio,45,ES07209546103281907066,TRX_N-00499-25967475,2023-02-20T14:21:45,Labastida,expenses,cash,-100.0,-21851.83
buyer_8,Antonio,45,ES07209546103281907066,TRX_N-00500-80754853,2023-02-20T08:21:36,Labastida,expenses,children,-255.82,-22107.65
buyer_8,Antonio,45,ES07209546103281907066,TRX_N-00501-79622557,2023-02-22T10:09:58,Labastida,expenses,leisure,-66.22,-22173.87
buyer_8,Antonio,45,ES07209546103281907066,TRX_N-00502-92163614,2023-02-22T12:28:41,Oyón-Oion,expenses,repairs,-156.08,-22329.95
buyer_8,Antonio,45,ES07209546103281907066,TRX_N-00503-99618606,2023-02-23T15:39:58,Labastida,expenses,transport,-42.47,-22372.42
buyer_8,Antonio,45,ES07209546103281907066,TRX_N-00504-82809169,2023-02-24T09:38:31,Labastida,expenses,transport,-55.41,-22427.83
buyer_8,Antonio,45,ES07209546103281907066,TRX_N-00505-03223491,2023-02-24T11:04:20,Labastida,expenses,gifts,-211.48,-22639.31
buyer_8,Antonio,45,ES07209546103281907066,TRX_N-00506-70187306,2023-02-25T12:41:25,Labastida,expenses,gifts,-323.49,-22962.8
buyer_8,Antonio,45,ES07209546103281907066,TRX_N-00507-79070151,2023-02-26T12:32:20,Labastida,expenses,cash,-100.0,-23062.8
buyer_8,Antonio,45,ES07209546103281907066,TRX_N-00508-13403672,2023-02-28T18:23:14,Labastida,expenses,food,-80.04,-23142.84
buyer_8,Antonio,45,ES07209546103281907066,TRX_N-00509-39727673,2023-02-28T23:43:50,Labastida,expenses,transport,-71.92,-23214.76
buyer_8,Antonio,45,ES07209546103281907066,TRX_N-00510-93206721,2023-03-01T19:51:08,Labastida,incomes,salary,1435.8,-21778.96
buyer_8,Antonio,45,ES07209546103281907066,TRX_N-00511-07291100,2023-03-01T19:51:08,Labastida,incomes,salary_partner,1615.1,-20163.86
buyer_8,Antonio,45,ES07209546103281907066,TRX_N-00512-03195152,2023-03-01T16:50:28,Labastida,expenses,food,-70.6,-20234.46
buyer_8,Antonio,45,ES07209546103281907066,TRX_N-00513-25137501,2023-03-01T20:45:03,Labastida,expenses,transport,-43.66,-20278.12
buyer_8,Antonio,45,ES07209546103281907066,TRX_N-00514-95637962,2023-03-01T12:37:44,Getxo,expenses,cash,-100.0,-20378.12
buyer_8,Antonio,45,ES07209546103281907066,TRX_N-00515-37030413,2023-03-01T11:28:33,Labastida,expenses,repairs,-261.14,-20639.26
buyer_8,Antonio,45,ES07209546103281907066,TRX_N-00516-96780510,2023-03-02T15:08:14,Labastida,expenses,food,-80.15,-20719.41
buyer_8,Antonio,45,ES07209546103281907066,TRX_N-00517-04667315,2023-03-02T10:40:49,Labastida,expenses,gifts,-204.61,-20924.02
buyer_8,Antonio,45,ES07209546103281907066,TRX_N-00518-47012319,2023-03-04T13:30:21,Labastida,expenses,mortgage,-970.96,-21894.98
buyer_8,Antonio,45,ES07209546103281907066,TRX_N-00519-49223895,2023-03-04T10:31:30,Labastida,expenses,food,-70.3,-21965.28
buyer_8,Antonio,45,ES07209546103281907066,TRX_N-00520-23584375,2023-03-05T09:08:18,Labastida,expenses,phone,-36.62,-22001.9
buyer_8,Antonio,45,ES07209546103281907066,TRX_N-00521-18281547,2023-03-05T14:32:57,Labastida,expenses,food,-116.51,-22118.41
buyer_8,Antonio,45,ES07209546103281907066,TRX_N-00522-13319070,2023-03-05T15:48:01,Labastida,expenses,cash,-100.0,-22218.41
buyer_8,Antonio,45,ES07209546103281907066,TRX_N-00523-42347531,2023-03-06T09:24:00,Labastida,expenses,gas,-108.81,-22327.22
buyer_8,Antonio,45,ES07209546103281907066,TRX_N-00524-05416453,2023-03-06T20:21:16,Labastida,expenses,internet,-42.0,-22369.22
buyer_8,Antonio,45,ES07209546103281907066,TRX_N-00525-00350839,2023-03-06T13:53:16,Labastida,expenses,leisure,-25.65,-22394.87
buyer_8,Antonio,45,ES07209546103281907066,TRX_N-00526-31102908,2023-03-07T12:25:45,Labastida,expenses,transport,-72.16,-22467.03
buyer_8,Antonio,45,ES07209546103281907066,TRX_N-00527-16298237,2023-03-08T20:41:03,Labastida,expenses,electricity,-35.82,-22502.85
buyer_8,Antonio,45,ES07209546103281907066,TRX_N-00528-29082034,2023-03-08T15:48:33,Labastida,expenses,water,-24.78,-22527.63
buyer_8,Antonio,45,ES07209546103281907066,TRX_N-00529-97678114,2023-03-08T13:36:17,Labastida,expenses,cash,-100.0,-22627.63
buyer_8,Antonio,45,ES07209546103281907066,TRX_N-00530-48091556,2023-03-09T14:53:57,Labastida,expenses,transport,-66.68,-22694.31
buyer_8,Antonio,45,ES07209546103281907066,TRX_N-00531-85070914,2023-03-09T22:10:35,Galdakao,expenses,education,-52.52,-22746.83
buyer_8,Antonio,45,ES07209546103281907066,TRX_N-00532-87105976,2023-03-09T15:12:45,Labastida,expenses,cash,-100.0,-22846.83
buyer_8,Antonio,45,ES07209546103281907066,TRX_N-00533-31975720,2023-03-09T20:26:01,Labastida,expenses,appliances,-298.27,-23145.1
buyer_8,Antonio,45,ES07209546103281907066,TRX_N-00534-44282714,2023-03-10T02:34:26,Labastida,expenses,transport,-89.25,-23234.35
buyer_8,Antonio,45,ES07209546103281907066,TRX_N-00535-95759971,2023-03-10T17:35:53,Labastida,expenses,cash,-100.0,-23334.35
buyer_8,Antonio,45,ES07209546103281907066,TRX_N-00536-02417351,2023-03-11T10:16:36,Labastida,expenses,gifts,-437.33,-23771.68
buyer_8,Antonio,45,ES07209546103281907066,TRX_N-00537-27143779,2023-03-12T13:39:01,Labastida,expenses,food,-72.26,-23843.94
buyer_8,Antonio,45,ES07209546103281907066,TRX_N-00538-38724524,2023-03-14T17:00:43,Labastida,expenses,cash,-100.0,-23943.94
buyer_8,Antonio,45,ES07209546103281907066,TRX_N-00539-78902396,2023-03-16T19:28:04,Labastida,expenses,cash,-100.0,-24043.94
buyer_8,Antonio,45,ES07209546103281907066,TRX_N-00540-62966031,2023-03-17T12:26:40,Labastida,expenses,transport,-69.5,-24113.44
buyer_8,Antonio,45,ES07209546103281907066,TRX_N-00541-10117356,2023-03-19T15:36:14,Labastida,expenses,leisure,-43.54,-24156.98
buyer_8,Antonio,45,ES07209546103281907066,TRX_N-00542-63682687,2023-03-20T21:46:00,Labastida,expenses,food,-77.89,-24234.87
buyer_8,Antonio,45,ES07209546103281907066,TRX_N-00543-49032359,2023-03-21T13:29:06,Labastida,expenses,leisure,-50.75,-24285.62
buyer_8,Antonio,45,ES07209546103281907066,TRX_N-00544-42235458,2023-03-22T16:34:24,Labastida,expenses,repairs,-188.31,-24473.93
buyer_8,Antonio,45,ES07209546103281907066,TRX_N-00545-59710498,2023-03-23T15:11:45,Eibar,expenses,cash,-100.0,-24573.93
buyer_8,Antonio,45,ES07209546103281907066,TRX_N-00546-60379680,2023-03-24T09:57:51,Leioa,expenses,leisure,-36.8,-24610.73
buyer_8,Antonio,45,ES07209546103281907066,TRX_N-00547-29576152,2023-03-26T17:28:12,Labastida,expenses,healthcare,-155.39,-24766.12
buyer_8,Antonio,45,ES07209546103281907066,TRX_N-00548-67419330,2023-03-26T16:12:05,Labastida,expenses,cash,-100.0,-24866.12
buyer_8,Antonio,45,ES07209546103281907066,TRX_N-00549-57834735,2023-03-27T08:10:58,Labastida,expenses,food,-91.91,-24958.03
buyer_8,Antonio,45,ES07209546103281907066,TRX_N-00550-86282197,2023-03-28T19:28:32,Labastida,expenses,transport,-78.05,-25036.08
buyer_8,Antonio,45,ES07209546103281907066,TRX_N-00551-55575767,2023-03-29T18:12:08,Labastida,expenses,food,-75.79,-25111.87
buyer_8,Antonio,45,ES07209546103281907066,TRX_N-00552-75132044,2023-03-31T12:52:48,Labastida,expenses,transport,-79.48,-25191.35
buyer_8,Antonio,45,ES07209546103281907066,TRX_N-00553-03682640,2023-03-31T17:57:01,Labastida,expenses,cash,-100.0,-25291.35
buyer_8,Antonio,45,ES07209546103281907066,TRX_N-00554-15208205,2023-04-01T13:25:03,Labastida,incomes,salary,1435.8,-23855.55
buyer_8,Antonio,45,ES07209546103281907066,TRX_N-00555-93393999,2023-04-01T13:25:03,Labastida,incomes,salary_partner,1615.1,-22240.45
buyer_8,Antonio,45,ES07209546103281907066,TRX_N-00556-85546770,2023-04-01T01:22:10,Labastida,expenses,children,-107.72,-22348.17
buyer_8,Antonio,45,ES07209546103281907066,TRX_N-00557-27003677,2023-04-02T17:35:19,Labastida,expenses,food,-87.56,-22435.73
buyer_8,Antonio,45,ES07209546103281907066,TRX_N-00558-44114501,2023-04-04T00:48:55,Labastida,expenses,mortgage,-970.96,-23406.69
buyer_8,Antonio,45,ES07209546103281907066,TRX_N-00559-75292774,2023-04-04T13:31:19,Labastida,expenses,leisure,-24.29,-23430.98
buyer_8,Antonio,45,ES07209546103281907066,TRX_N-00560-66507221,2023-04-04T23:23:54,Labastida,expenses,cash,-100.0,-23530.98
buyer_8,Antonio,45,ES07209546103281907066,TRX_N-00561-16599531,2023-04-06T11:11:00,Labastida,expenses,water,-29.56,-23560.54
buyer_8,Antonio,45,ES07209546103281907066,TRX_N-00562-82916170,2023-04-06T20:02:23,Labastida,expenses,phone,-38.17,-23598.71
buyer_8,Antonio,45,ES07209546103281907066,TRX_N-00563-23692082,2023-04-07T16:22:29,Labastida,expenses,electricity,-40.0,-23638.71
buyer_8,Antonio,45,ES07209546103281907066,TRX_N-00564-58416823,2023-04-07T09:48:00,Labastida,expenses,gas,-64.83,-23703.54
buyer_8,Antonio,45,ES07209546103281907066,TRX_N-00565-13042115,2023-04-07T07:16:50,Bilbao,expenses,leisure,-18.66,-23722.2
buyer_8,Antonio,45,ES07209546103281907066,TRX_N-00566-82962485,2023-04-07T17:14:36,Barakaldo,expenses,healthcare,-163.54,-23885.74
buyer_8,Antonio,45,ES07209546103281907066,TRX_N-00567-69738023,2023-04-08T14:58:12,Labastida,expenses,internet,-42.0,-23927.74
buyer_8,Antonio,45,ES07209546103281907066,TRX_N-00568-51380660,2023-04-10T21:43:09,Labastida,expenses,food,-107.05,-24034.79
buyer_8,Antonio,45,ES07209546103281907066,TRX_N-00569-61639575,2023-04-11T12:59:56,Arrasate,expenses,transport,-55.73,-24090.52
buyer_8,Antonio,45,ES07209546103281907066,TRX_N-00570-08243883,2023-04-13T11:49:01,Labastida,expenses,cash,-100.0,-24190.52
buyer_8,Antonio,45,ES07209546103281907066,TRX_N-00571-72705255,2023-04-14T03:04:22,Labastida,expenses,food,-93.9,-24284.42
buyer_8,Antonio,45,ES07209546103281907066,TRX_N-00572-95256031,2023-04-14T22:16:46,Labastida,expenses,cash,-100.0,-24384.42
buyer_8,Antonio,45,ES07209546103281907066,TRX_N-00573-79043970,2023-04-14T18:56:51,Labastida,expenses,gifts,-132.91,-24517.33
buyer_8,Antonio,45,ES07209546103281907066,TRX_N-00574-74936144,2023-04-15T15:33:59,Zuia,expenses,cash,-100.0,-24617.33
buyer_8,Antonio,45,ES07209546103281907066,TRX_N-00575-87457228,2023-04-16T12:35:05,Labastida,expenses,food,-68.48,-24685.81
buyer_8,Antonio,45,ES07209546103281907066,TRX_N-00576-02797760,2023-04-21T13:15:03,Labastida,expenses,children,-64.42,-24750.23
buyer_8,Antonio,45,ES07209546103281907066,TRX_N-00577-77760579,2023-04-22T11:58:36,Labastida,expenses,cash,-100.0,-24850.23
buyer_8,Antonio,45,ES07209546103281907066,TRX_N-00578-91676328,2023-04-22T22:55:05,Labastida,expenses,appliances,-295.55,-25145.78
buyer_8,Antonio,45,ES07209546103281907066,TRX_N-00579-99106590,2023-04-24T12:19:51,Labastida,expenses,cash,-100.0,-25245.78
buyer_8,Antonio,45,ES07209546103281907066,TRX_N-00580-35627560,2023-04-27T13:10:01,Labastida,expenses,clothing,-68.88,-25314.66
buyer_8,Antonio,45,ES07209546103281907066,TRX_N-00581-19883772,2023-04-27T20:20:19,Labastida,expenses,appliances,-326.04,-25640.7
buyer_8,Antonio,45,ES07209546103281907066,TRX_N-00582-33412489,2023-04-29T12:58:30,Zuia,expenses,cash,-100.0,-25740.7
buyer_8,Antonio,45,ES07209546103281907066,TRX_N-00583-97142454,2023-04-30T20:54:41,Labastida,expenses,clothing,-99.39,-25840.09
buyer_8,Antonio,45,ES07209546103281907066,TRX_N-00584-56979160,2023-04-30T11:53:26,Labastida,expenses,cash,-100.0,-25940.09
buyer_8,Antonio,45,ES07209546103281907066,TRX_N-00585-43021570,2023-04-30T17:32:06,Pasaia,expenses,repairs,-126.53,-26066.62
buyer_8,Antonio,45,ES07209546103281907066,TRX_N-00586-20161411,2023-05-01T10:18:06,Labastida,incomes,salary,1435.8,-24630.82
buyer_8,Antonio,45,ES07209546103281907066,TRX_N-00587-95378515,2023-05-01T10:18:06,Labastida,incomes,salary_partner,1615.1,-23015.72
buyer_8,Antonio,45,ES07209546103281907066,TRX_N-00588-88664702,2023-05-01T10:18:06,Labastida,incomes,extra_income,153.76,-22861.96
buyer_8,Antonio,45,ES07209546103281907066,TRX_N-00589-68900348,2023-05-01T08:46:13,Labastida,expenses,education,-50.87,-22912.83
buyer_8,Antonio,45,ES07209546103281907066,TRX_N-00590-29090336,2023-05-01T12:29:20,Labastida,expenses,children,-103.41,-23016.24
buyer_8,Antonio,45,ES07209546103281907066,TRX_N-00591-25462269,2023-05-02T10:22:37,Labastida,expenses,food,-70.68,-23086.92
buyer_8,Antonio,45,ES07209546103281907066,TRX_N-00592-54384823,2023-05-02T17:00:21,Labastida,expenses,cash,-100.0,-23186.92
buyer_8,Antonio,45,ES07209546103281907066,TRX_N-00593-85861618,2023-05-04T13:45:57,Labastida,expenses,mortgage,-970.96,-24157.88
buyer_8,Antonio,45,ES07209546103281907066,TRX_N-00594-87414550,2023-05-04T21:38:06,Labastida,expenses,repairs,-250.47,-24408.35
buyer_8,Antonio,45,ES07209546103281907066,TRX_N-00595-18076422,2023-05-05T14:17:51,Labastida,expenses,water,-22.11,-24430.46
buyer_8,Antonio,45,ES07209546103281907066,TRX_N-00596-55770381,2023-05-05T08:28:15,Labastida,expenses,cash,-100.0,-24530.46
buyer_8,Antonio,45,ES07209546103281907066,TRX_N-00597-74449697,2023-05-05T09:14:20,Labastida,expenses,appliances,-401.8,-24932.26
buyer_8,Antonio,45,ES07209546103281907066,TRX_N-00598-03838552,2023-05-06T10:56:23,Labastida,expenses,cash,-100.0,-25032.26
buyer_8,Antonio,45,ES07209546103281907066,TRX_N-00599-78649759,2023-05-07T11:54:29,Labastida,expenses,gas,-109.73,-25141.99
buyer_8,Antonio,45,ES07209546103281907066,TRX_N-00600-57557275,2023-05-08T16:28:41,Labastida,expenses,electricity,-50.88,-25192.87
buyer_8,Antonio,45,ES07209546103281907066,TRX_N-00601-40877148,2023-05-08T14:55:40,Labastida,expenses,internet,-42.0,-25234.87
buyer_8,Antonio,45,ES07209546103281907066,TRX_N-00602-33980463,2023-05-08T11:14:38,Labastida,expenses,phone,-37.48,-25272.35
buyer_8,Antonio,45,ES07209546103281907066,TRX_N-00603-44644339,2023-05-09T10:29:16,Labastida,expenses,clothing,-58.82,-25331.17
buyer_8,Antonio,45,ES07209546103281907066,TRX_N-00604-19653467,2023-05-11T20:54:31,Barakaldo,expenses,food,-112.83,-25444.0
buyer_8,Antonio,45,ES07209546103281907066,TRX_N-00605-08045854,2023-05-12T15:57:54,Labastida,expenses,transport,-88.42,-25532.42
buyer_8,Antonio,45,ES07209546103281907066,TRX_N-00606-55674633,2023-05-13T14:54:13,Labastida,expenses,clothing,-75.27,-25607.69
buyer_8,Antonio,45,ES07209546103281907066,TRX_N-00607-98565121,2023-05-13T09:33:40,Labastida,expenses,education,-66.38,-25674.07
buyer_8,Antonio,45,ES07209546103281907066,TRX_N-00608-64275143,2023-05-14T11:07:58,Zuia,expenses,repairs,-162.57,-25836.64
buyer_8,Antonio,45,ES07209546103281907066,TRX_N-00609-54608949,2023-05-16T12:05:43,Labastida,expenses,education,-60.0,-25896.64
buyer_8,Antonio,45,ES07209546103281907066,TRX_N-00610-08069932,2023-05-18T09:41:30,Labastida,expenses,children,-90.11,-25986.75
buyer_8,Antonio,45,ES07209546103281907066,TRX_N-00611-37528616,2023-05-21T13:54:39,Labastida,expenses,food,-120.21,-26106.96
buyer_8,Antonio,45,ES07209546103281907066,TRX_N-00612-71209485,2023-05-21T22:35:45,Iruña de Oca,expenses,leisure,-62.91,-26169.87
buyer_8,Antonio,45,ES07209546103281907066,TRX_N-00613-39767622,2023-05-22T20:36:45,Labastida,expenses,leisure,-49.38,-26219.25
buyer_8,Antonio,45,ES07209546103281907066,TRX_N-00614-00075793,2023-05-23T20:15:11,Labastida,expenses,food,-91.24,-26310.49
buyer_8,Antonio,45,ES07209546103281907066,TRX_N-00615-69641106,2023-05-24T17:32:24,Labastida,expenses,repairs,-178.95,-26489.44
buyer_8,Antonio,45,ES07209546103281907066,TRX_N-00616-94158226,2023-05-25T14:08:44,Labastida,expenses,leisure,-39.01,-26528.45
buyer_8,Antonio,45,ES07209546103281907066,TRX_N-00617-79430523,2023-05-25T17:07:30,Labastida,expenses,appliances,-213.03,-26741.48
buyer_8,Antonio,45,ES07209546103281907066,TRX_N-00618-51935242,2023-05-28T08:39:21,Galdakao,expenses,food,-67.34,-26808.82
buyer_8,Antonio,45,ES07209546103281907066,TRX_N-00619-84638606,2023-05-30T14:49:09,Labastida,expenses,healthcare,-160.82,-26969.64
buyer_8,Antonio,45,ES07209546103281907066,TRX_N-00620-18420931,2023-05-31T11:10:14,Labastida,expenses,repairs,-150.55,-27120.19
buyer_8,Antonio,45,ES07209546103281907066,TRX_N-00621-05054430,2023-06-01T12:59:55,Labastida,incomes,salary,1435.8,-25684.39
buyer_8,Antonio,45,ES07209546103281907066,TRX_N-00622-73651387,2023-06-01T12:59:55,Labastida,incomes,salary_partner,1615.1,-24069.29
buyer_8,Antonio,45,ES07209546103281907066,TRX_N-00623-15201618,2023-06-01T12:59:55,Labastida,incomes,salary_bonus,1032.45,-23036.84
buyer_8,Antonio,45,ES07209546103281907066,TRX_N-00624-78724308,2023-06-01T12:59:55,Labastida,incomes,salary_partner_bonus,1261.96,-21774.88
buyer_8,Antonio,45,ES07209546103281907066,TRX_N-00625-03614518,2023-06-01T13:52:11,Labastida,expenses,leisure,-72.36,-21847.24
buyer_8,Antonio,45,ES07209546103281907066,TRX_N-00626-81554987,2023-06-01T19:45:26,Hernani,expenses,clothing,-58.3,-21905.54
buyer_8,Antonio,45,ES07209546103281907066,TRX_N-00627-64864512,2023-06-01T15:37:54,Labastida,expenses,cash,-100.0,-22005.54
buyer_8,Antonio,45,ES07209546103281907066,TRX_N-00628-01679435,2023-06-02T19:35:11,Labastida,expenses,transport,-80.0,-22085.54
buyer_8,Antonio,45,ES07209546103281907066,TRX_N-00629-98404401,2023-06-04T18:12:22,Labastida,expenses,mortgage,-970.96,-23056.5
buyer_8,Antonio,45,ES07209546103281907066,TRX_N-00630-25857120,2023-06-05T15:16:56,Labastida,expenses,electricity,-30.29,-23086.79
buyer_8,Antonio,45,ES07209546103281907066,TRX_N-00631-31812708,2023-06-05T16:08:13,Labastida,expenses,phone,-36.72,-23123.51
buyer_8,Antonio,45,ES07209546103281907066,TRX_N-00632-53602589,2023-06-05T14:09:56,Labastida,expenses,cash,-100.0,-23223.51
buyer_8,Antonio,45,ES07209546103281907066,TRX_N-00633-22864708,2023-06-06T06:33:37,Oyón-Oion,expenses,food,-93.72,-23317.23
buyer_8,Antonio,45,ES07209546103281907066,TRX_N-00634-19502436,2023-06-06T13:54:45,Leioa,expenses,leisure,-43.78,-23361.01
buyer_8,Antonio,45,ES07209546103281907066,TRX_N-00635-24395770,2023-06-06T18:01:33,Labastida,expenses,clothing,-117.21,-23478.22
buyer_8,Antonio,45,ES07209546103281907066,TRX_N-00636-94539911,2023-06-07T04:08:46,Labastida,expenses,internet,-42.0,-23520.22
buyer_8,Antonio,45,ES07209546103281907066,TRX_N-00637-35660674,2023-06-08T09:43:34,Labastida,expenses,water,-33.88,-23554.1
buyer_8,Antonio,45,ES07209546103281907066,TRX_N-00638-61534191,2023-06-08T15:53:02,Labastida,expenses,gas,-108.26,-23662.36
buyer_8,Antonio,45,ES07209546103281907066,TRX_N-00639-12545555,2023-06-08T16:01:09,Labastida,expenses,transport,-66.82,-23729.18
buyer_8,Antonio,45,ES07209546103281907066,TRX_N-00640-00734997,2023-06-12T08:00:49,Labastida,expenses,food,-91.17,-23820.35
buyer_8,Antonio,45,ES07209546103281907066,TRX_N-00641-56875287,2023-06-12T09:09:08,Labastida,expenses,gifts,-452.19,-24272.54
buyer_8,Antonio,45,ES07209546103281907066,TRX_N-00642-40867858,2023-06-14T11:43:10,Labastida,expenses,cash,-100.0,-24372.54
buyer_8,Antonio,45,ES07209546103281907066,TRX_N-00643-40242937,2023-06-15T15:15:02,Labastida,expenses,food,-95.41,-24467.95
buyer_8,Antonio,45,ES07209546103281907066,TRX_N-00644-85038378,2023-06-17T04:29:37,Labastida,expenses,leisure,-74.38,-24542.33
buyer_8,Antonio,45,ES07209546103281907066,TRX_N-00645-64728618,2023-06-17T01:08:41,Labastida,expenses,cash,-100.0,-24642.33
buyer_8,Antonio,45,ES07209546103281907066,TRX_N-00646-80300486,2023-06-18T14:14:35,Labastida,expenses,food,-81.86,-24724.19
buyer_8,Antonio,45,ES07209546103281907066,TRX_N-00647-70505821,2023-06-18T08:13:20,Labastida,expenses,leisure,-51.09,-24775.28
buyer_8,Antonio,45,ES07209546103281907066,TRX_N-00648-38605136,2023-06-19T19:42:49,Labastida,expenses,transport,-65.39,-24840.67
buyer_8,Antonio,45,ES07209546103281907066,TRX_N-00649-79324425,2023-06-19T00:09:59,Arrasate,expenses,cash,-100.0,-24940.67
buyer_8,Antonio,45,ES07209546103281907066,TRX_N-00650-01974415,2023-06-20T13:03:41,Sopela,expenses,appliances,-307.86,-25248.53
buyer_8,Antonio,45,ES07209546103281907066,TRX_N-00651-89152972,2023-06-21T11:08:40,Labastida,expenses,cash,-100.0,-25348.53
buyer_8,Antonio,45,ES07209546103281907066,TRX_N-00652-25069916,2023-06-23T16:18:14,Labastida,expenses,transport,-52.79,-25401.32
buyer_8,Antonio,45,ES07209546103281907066,TRX_N-00653-67625346,2023-06-25T01:06:08,Labastida,expenses,repairs,-164.26,-25565.58
buyer_8,Antonio,45,ES07209546103281907066,TRX_N-00654-00573524,2023-06-28T10:08:15,Labastida,expenses,leisure,-70.67,-25636.25
buyer_8,Antonio,45,ES07209546103281907066,TRX_N-00655-73251601,2023-06-29T01:22:29,Labastida,expenses,transport,-64.83,-25701.08
buyer_8,Antonio,45,ES07209546103281907066,TRX_N-00656-24765505,2023-06-29T15:52:30,Zarautz,expenses,cash,-100.0,-25801.08
buyer_8,Antonio,45,ES07209546103281907066,TRX_N-00657-41220276,2023-06-29T16:08:01,Labastida,expenses,gifts,-531.66,-26332.74
buyer_8,Antonio,45,ES07209546103281907066,TRX_N-00658-73424853,2023-06-30T09:09:11,Labastida,expenses,cash,-100.0,-26432.74
buyer_8,Antonio,45,ES07209546103281907066,TRX_N-00659-65465048,2023-06-30T16:04:57,Labastida,expenses,gifts,-782.6,-27215.34
buyer_8,Antonio,45,ES07209546103281907066,TRX_N-00660-75684120,2023-07-01T08:59:13,Labastida,incomes,salary,1435.8,-25779.54
buyer_8,Antonio,45,ES07209546103281907066,TRX_N-00661-62116318,2023-07-01T08:59:13,Labastida,incomes,salary_partner,1615.1,-24164.44
buyer_8,Antonio,45,ES07209546103281907066,TRX_N-00662-15518861,2023-07-02T15:47:21,Llodio,expenses,food,-107.65,-24272.09
buyer_8,Antonio,45,ES07209546103281907066,TRX_N-00663-56950528,2023-07-02T12:30:45,Labastida,expenses,leisure,-27.52,-24299.61
buyer_8,Antonio,45,ES07209546103281907066,TRX_N-00664-01286891,2023-07-03T08:34:36,Labastida,expenses,education,-67.17,-24366.78
buyer_8,Antonio,45,ES07209546103281907066,TRX_N-00665-12359342,2023-07-04T10:07:52,Labastida,expenses,mortgage,-970.96,-25337.74
buyer_8,Antonio,45,ES07209546103281907066,TRX_N-00666-45183801,2023-07-04T11:53:11,Labastida,expenses,leisure,-52.93,-25390.67
buyer_8,Antonio,45,ES07209546103281907066,TRX_N-00667-91377158,2023-07-04T23:54:33,Labastida,expenses,repairs,-284.52,-25675.19
buyer_8,Antonio,45,ES07209546103281907066,TRX_N-00668-34469943,2023-07-04T17:20:37,Oyón-Oion,expenses,gifts,-705.71,-26380.9
buyer_8,Antonio,45,ES07209546103281907066,TRX_N-00669-66760717,2023-07-05T17:02:10,Labastida,expenses,water,-28.99,-26409.89
buyer_8,Antonio,45,ES07209546103281907066,TRX_N-00670-48839631,2023-07-06T02:45:54,Labastida,expenses,gas,-50.53,-26460.42
buyer_8,Antonio,45,ES07209546103281907066,TRX_N-00671-57646380,2023-07-06T09:08:32,Labastida,expenses,clothing,-55.47,-26515.89
buyer_8,Antonio,45,ES07209546103281907066,TRX_N-00672-84191428,2023-07-07T09:44:01,Labastida,expenses,phone,-43.4,-26559.29
buyer_8,Antonio,45,ES07209546103281907066,TRX_N-00673-15020140,2023-07-07T10:08:39,Labastida,expenses,transport,-73.16,-26632.45
buyer_8,Antonio,45,ES07209546103281907066,TRX_N-00674-63062597,2023-07-08T13:00:34,Labastida,expenses,electricity,-59.18,-26691.63
buyer_8,Antonio,45,ES07209546103281907066,TRX_N-00675-85357458,2023-07-08T22:24:08,Labastida,expenses,internet,-42.0,-26733.63
buyer_8,Antonio,45,ES07209546103281907066,TRX_N-00676-62626985,2023-07-08T16:42:43,Labastida,expenses,clothing,-96.69,-26830.32
buyer_8,Antonio,45,ES07209546103281907066,TRX_N-00677-42701043,2023-07-08T19:30:56,Leioa,expenses,gifts,-332.58,-27162.9
buyer_8,Antonio,45,ES07209546103281907066,TRX_N-00678-08157741,2023-07-09T07:52:22,Santurtzi,expenses,leisure,-24.68,-27187.58
buyer_8,Antonio,45,ES07209546103281907066,TRX_N-00679-37875937,2023-07-11T20:38:59,Labastida,expenses,education,-75.16,-27262.74
buyer_8,Antonio,45,ES07209546103281907066,TRX_N-00680-85468930,2023-07-14T16:11:53,Labastida,expenses,cash,-100.0,-27362.74
buyer_8,Antonio,45,ES07209546103281907066,TRX_N-00681-82904927,2023-07-14T16:56:54,Labastida,expenses,children,-203.3,-27566.04
buyer_8,Antonio,45,ES07209546103281907066,TRX_N-00682-94031134,2023-07-15T08:05:54,Getxo,expenses,healthcare,-150.76,-27716.8
buyer_8,Antonio,45,ES07209546103281907066,TRX_N-00683-94564434,2023-07-15T18:41:29,Labastida,expenses,education,-77.9,-27794.7
buyer_8,Antonio,45,ES07209546103281907066,TRX_N-00684-04006694,2023-07-16T11:25:59,Labastida,expenses,cash,-100.0,-27894.7
buyer_8,Antonio,45,ES07209546103281907066,TRX_N-00685-47845686,2023-07-17T09:47:20,Labastida,expenses,clothing,-65.76,-27960.46
buyer_8,Antonio,45,ES07209546103281907066,TRX_N-00686-48358936,2023-07-17T14:36:34,Labastida,expenses,cash,-100.0,-28060.46
buyer_8,Antonio,45,ES07209546103281907066,TRX_N-00687-23064351,2023-07-20T14:55:25,Labastida,expenses,food,-89.97,-28150.43
buyer_8,Antonio,45,ES07209546103281907066,TRX_N-00688-96221568,2023-07-20T17:44:09,Hondarribia,expenses,leisure,-61.66,-28212.09
buyer_8,Antonio,45,ES07209546103281907066,TRX_N-00689-82355193,2023-07-20T10:23:02,Labastida,expenses,cash,-100.0,-28312.09
buyer_8,Antonio,45,ES07209546103281907066,TRX_N-00690-59166712,2023-07-20T20:27:39,Labastida,expenses,gifts,-580.32,-28892.41
buyer_8,Antonio,45,ES07209546103281907066,TRX_N-00691-38050792,2023-07-21T13:48:53,Labastida,expenses,transport,-64.63,-28957.04
buyer_8,Antonio,45,ES07209546103281907066,TRX_N-00692-26604399,2023-07-21T17:28:13,Donostia,expenses,clothing,-113.75,-29070.79
buyer_8,Antonio,45,ES07209546103281907066,TRX_N-00693-09287943,2023-07-21T08:37:16,Galdakao,expenses,repairs,-41.79,-29112.58
buyer_8,Antonio,45,ES07209546103281907066,TRX_N-00694-08781412,2023-07-21T10:02:02,Amurrio,expenses,gifts,-296.73,-29409.31
buyer_8,Antonio,45,ES07209546103281907066,TRX_N-00695-44351155,2023-07-22T16:15:04,Labastida,expenses,clothing,-46.12,-29455.43
buyer_8,Antonio,45,ES07209546103281907066,TRX_N-00696-28584551,2023-07-22T08:38:14,Labastida,expenses,cash,-100.0,-29555.43
buyer_8,Antonio,45,ES07209546103281907066,TRX_N-00697-86178612,2023-07-23T20:37:35,Sopela,expenses,cash,-100.0,-29655.43
buyer_8,Antonio,45,ES07209546103281907066,TRX_N-00698-92238850,2023-07-24T16:25:39,Labastida,expenses,education,-48.75,-29704.18
buyer_8,Antonio,45,ES07209546103281907066,TRX_N-00699-03352671,2023-07-26T21:37:00,Labastida,expenses,cash,-100.0,-29804.18
buyer_8,Antonio,45,ES07209546103281907066,TRX_N-00700-26439641,2023-07-26T16:20:58,Labastida,expenses,children,-59.66,-29863.84
buyer_8,Antonio,45,ES07209546103281907066,TRX_N-00701-47420991,2023-07-27T20:45:33,Labastida,expenses,food,-77.54,-29941.38
buyer_8,Antonio,45,ES07209546103281907066,TRX_N-00702-42869901,2023-07-28T20:31:15,Labastida,expenses,food,-96.51,-30037.89
buyer_8,Antonio,45,ES07209546103281907066,TRX_N-00703-81260010,2023-07-29T13:26:32,Labastida,expenses,food,-107.63,-30145.52
buyer_8,Antonio,45,ES07209546103281907066,TRX_N-00704-07974094,2023-07-29T01:04:56,Labastida,expenses,leisure,-77.11,-30222.63
buyer_8,Antonio,45,ES07209546103281907066,TRX_N-00705-50599381,2023-08-01T03:03:37,Labastida,incomes,salary,1435.8,-28786.83
buyer_8,Antonio,45,ES07209546103281907066,TRX_N-00706-32247394,2023-08-01T03:03:37,Labastida,incomes,salary_partner,1615.1,-27171.73
buyer_8,Antonio,45,ES07209546103281907066,TRX_N-00707-94564173,2023-08-02T20:04:24,Hondarribia,expenses,transport,-77.58,-27249.31
buyer_8,Antonio,45,ES07209546103281907066,TRX_N-00708-38377726,2023-08-03T21:58:42,Labastida,expenses,cash,-100.0,-27349.31
buyer_8,Antonio,45,ES07209546103281907066,TRX_N-00709-95949933,2023-08-04T17:13:07,Labastida,expenses,mortgage,-970.96,-28320.27
buyer_8,Antonio,45,ES07209546103281907066,TRX_N-00710-00831314,2023-08-04T08:51:40,Labastida,expenses,children,-258.83,-28579.1
buyer_8,Antonio,45,ES07209546103281907066,TRX_N-00711-78310260,2023-08-08T18:23:06,Labastida,expenses,gas,-107.3,-28686.4
buyer_8,Antonio,45,ES07209546103281907066,TRX_N-00712-86273743,2023-08-08T10:23:04,Labastida,expenses,water,-24.36,-28710.76
buyer_8,Antonio,45,ES07209546103281907066,TRX_N-00713-73143656,2023-08-08T05:38:27,Labastida,expenses,electricity,-33.14,-28743.9
buyer_8,Antonio,45,ES07209546103281907066,TRX_N-00714-20467298,2023-08-08T23:17:59,Labastida,expenses,internet,-42.0,-28785.9
buyer_8,Antonio,45,ES07209546103281907066,TRX_N-00715-28154315,2023-08-08T18:20:29,Labastida,expenses,phone,-40.15,-28826.05
buyer_8,Antonio,45,ES07209546103281907066,TRX_N-00716-12796222,2023-08-08T13:56:29,Labastida,expenses,repairs,-288.72,-29114.77
buyer_8,Antonio,45,ES07209546103281907066,TRX_N-00717-18198310,2023-08-10T20:34:36,Pasaia,expenses,education,-53.84,-29168.61
buyer_8,Antonio,45,ES07209546103281907066,TRX_N-00718-85631210,2023-08-10T23:12:55,Labastida,expenses,repairs,-234.99,-29403.6
buyer_8,Antonio,45,ES07209546103281907066,TRX_N-00719-40741581,2023-08-13T22:03:09,Portugalete,expenses,repairs,-69.39,-29472.99
buyer_8,Antonio,45,ES07209546103281907066,TRX_N-00720-52374813,2023-08-13T14:52:40,Labastida,expenses,gifts,-643.71,-30116.7
buyer_8,Antonio,45,ES07209546103281907066,TRX_N-00721-66677276,2023-08-14T11:24:15,Labastida,expenses,leisure,-38.04,-30154.74
buyer_8,Antonio,45,ES07209546103281907066,TRX_N-00722-22271064,2023-08-16T18:18:42,Labastida,expenses,transport,-66.1,-30220.84
buyer_8,Antonio,45,ES07209546103281907066,TRX_N-00723-13770885,2023-08-16T19:30:31,Labastida,expenses,cash,-100.0,-30320.84
buyer_8,Antonio,45,ES07209546103281907066,TRX_N-00724-47184998,2023-08-18T03:17:03,Bermeo,expenses,transport,-47.24,-30368.08
buyer_8,Antonio,45,ES07209546103281907066,TRX_N-00725-56628956,2023-08-19T20:14:21,Santurtzi,expenses,repairs,-27.37,-30395.45
buyer_8,Antonio,45,ES07209546103281907066,TRX_N-00726-87501677,2023-08-22T12:10:51,Labastida,expenses,gifts,-521.48,-30916.93
buyer_8,Antonio,45,ES07209546103281907066,TRX_N-00727-52157837,2023-08-25T02:48:02,Labastida,expenses,transport,-48.28,-30965.21
buyer_8,Antonio,45,ES07209546103281907066,TRX_N-00728-80166830,2023-08-26T05:57:04,Labastida,expenses,transport,-79.52,-31044.73
buyer_8,Antonio,45,ES07209546103281907066,TRX_N-00729-69765413,2023-08-27T22:07:09,Labastida,expenses,leisure,-25.98,-31070.71
buyer_8,Antonio,45,ES07209546103281907066,TRX_N-00730-12952363,2023-08-27T15:34:40,Labastida,expenses,cash,-100.0,-31170.71
buyer_8,Antonio,45,ES07209546103281907066,TRX_N-00731-97076970,2023-08-28T02:57:42,Labastida,expenses,healthcare,-38.92,-31209.63
buyer_8,Antonio,45,ES07209546103281907066,TRX_N-00732-44405585,2023-08-28T14:22:27,Labastida,expenses,cash,-100.0,-31309.63
buyer_8,Antonio,45,ES07209546103281907066,TRX_N-00733-53315945,2023-08-30T09:30:03,Erandio,expenses,cash,-100.0,-31409.63
buyer_8,Antonio,45,ES07209546103281907066,TRX_N-00734-67233021,2023-09-01T11:35:24,Labastida,incomes,salary,1435.8,-29973.83
buyer_8,Antonio,45,ES07209546103281907066,TRX_N-00735-05825502,2023-09-01T11:35:24,Labastida,incomes,salary_partner,1615.1,-28358.73
buyer_8,Antonio,45,ES07209546103281907066,TRX_N-00736-34559062,2023-09-01T11:35:24,Labastida,incomes,extra_income,153.76,-28204.97
buyer_8,Antonio,45,ES07209546103281907066,TRX_N-00737-01771701,2023-09-03T06:59:11,Labastida,expenses,transport,-46.36,-28251.33
buyer_8,Antonio,45,ES07209546103281907066,TRX_N-00738-66457851,2023-09-04T23:47:41,Labastida,expenses,mortgage,-970.96,-29222.29
buyer_8,Antonio,45,ES07209546103281907066,TRX_N-00739-78353450,2023-09-05T17:02:24,Labastida,expenses,phone,-40.85,-29263.14
buyer_8,Antonio,45,ES07209546103281907066,TRX_N-00740-30436338,2023-09-06T20:59:41,Labastida,expenses,electricity,-51.18,-29314.32
buyer_8,Antonio,45,ES07209546103281907066,TRX_N-00741-31969935,2023-09-08T12:11:52,Labastida,expenses,internet,-42.0,-29356.32
buyer_8,Antonio,45,ES07209546103281907066,TRX_N-00742-33419012,2023-09-08T14:28:13,Labastida,expenses,water,-22.13,-29378.45
buyer_8,Antonio,45,ES07209546103281907066,TRX_N-00743-75357088,2023-09-08T13:02:17,Labastida,expenses,gas,-37.51,-29415.96
buyer_8,Antonio,45,ES07209546103281907066,TRX_N-00744-91761461,2023-09-10T19:36:11,Pasaia,expenses,leisure,-58.01,-29473.97
buyer_8,Antonio,45,ES07209546103281907066,TRX_N-00745-52828468,2023-09-11T13:53:55,Labastida,expenses,leisure,-42.49,-29516.46
buyer_8,Antonio,45,ES07209546103281907066,TRX_N-00746-87744932,2023-09-11T17:03:14,Labastida,expenses,cash,-100.0,-29616.46
buyer_8,Antonio,45,ES07209546103281907066,TRX_N-00747-54832672,2023-09-11T16:44:43,Labastida,expenses,repairs,-221.32,-29837.78
buyer_8,Antonio,45,ES07209546103281907066,TRX_N-00748-17514891,2023-09-12T13:18:36,Sopela,expenses,food,-110.27,-29948.05
buyer_8,Antonio,45,ES07209546103281907066,TRX_N-00749-70162858,2023-09-13T18:18:37,Labastida,expenses,food,-92.08,-30040.13
buyer_8,Antonio,45,ES07209546103281907066,TRX_N-00750-59725721,2023-09-13T23:44:03,Labastida,expenses,cash,-100.0,-30140.13
buyer_8,Antonio,45,ES07209546103281907066,TRX_N-00751-87273589,2023-09-14T16:45:35,Labastida,expenses,transport,-48.51,-30188.64
buyer_8,Antonio,45,ES07209546103281907066,TRX_N-00752-99128895,2023-09-16T20:43:14,Mungia,expenses,transport,-45.43,-30234.07
buyer_8,Antonio,45,ES07209546103281907066,TRX_N-00753-46991846,2023-09-16T09:23:41,Labastida,expenses,repairs,-62.09,-30296.16
buyer_8,Antonio,45,ES07209546103281907066,TRX_N-00754-09042319,2023-09-17T10:19:14,Labastida,expenses,cash,-100.0,-30396.16
buyer_8,Antonio,45,ES07209546103281907066,TRX_N-00755-93905940,2023-09-18T16:03:39,Labastida,expenses,education,-55.32,-30451.48
buyer_8,Antonio,45,ES07209546103281907066,TRX_N-00756-88064308,2023-09-20T09:48:13,Labastida,expenses,cash,-100.0,-30551.48
buyer_8,Antonio,45,ES07209546103281907066,TRX_N-00757-22719051,2023-09-22T15:35:40,Labastida,expenses,clothing,-82.95,-30634.43
buyer_8,Antonio,45,ES07209546103281907066,TRX_N-00758-40558425,2023-09-22T12:57:23,Labastida,expenses,gifts,-678.9,-31313.33
buyer_8,Antonio,45,ES07209546103281907066,TRX_N-00759-28887078,2023-09-24T12:57:21,Labastida,expenses,food,-117.45,-31430.78
buyer_8,Antonio,45,ES07209546103281907066,TRX_N-00760-55029981,2023-09-24T11:56:04,Labastida,expenses,repairs,-321.46,-31752.24
buyer_8,Antonio,45,ES07209546103281907066,TRX_N-00761-50652772,2023-09-26T05:41:45,Getxo,expenses,cash,-100.0,-31852.24
buyer_8,Antonio,45,ES07209546103281907066,TRX_N-00762-52038200,2023-09-26T09:35:57,Labastida,expenses,gifts,-143.02,-31995.26
buyer_8,Antonio,45,ES07209546103281907066,TRX_N-00763-43509600,2023-09-27T17:39:46,Labastida,expenses,clothing,-74.42,-32069.68
buyer_8,Antonio,45,ES07209546103281907066,TRX_N-00764-98341869,2023-09-27T18:04:44,Labastida,expenses,repairs,-257.11,-32326.79
buyer_8,Antonio,45,ES07209546103281907066,TRX_N-00765-49024301,2023-09-28T12:15:04,Labastida,expenses,cash,-100.0,-32426.79
buyer_8,Antonio,45,ES07209546103281907066,TRX_N-00766-84859124,2023-09-30T17:32:37,Labastida,expenses,education,-64.34,-32491.13
buyer_8,Antonio,45,ES07209546103281907066,TRX_N-00767-75969177,2023-10-01T20:25:41,Labastida,incomes,salary,1435.8,-31055.33
buyer_8,Antonio,45,ES07209546103281907066,TRX_N-00768-46893382,2023-10-01T20:25:41,Labastida,incomes,salary_partner,1615.1,-29440.23
buyer_8,Antonio,45,ES07209546103281907066,TRX_N-00769-38214344,2023-10-01T15:24:27,Labastida,expenses,appliances,-225.45,-29665.68
buyer_8,Antonio,45,ES07209546103281907066,TRX_N-00770-07469061,2023-10-02T02:33:35,Donostia,expenses,transport,-51.44,-29717.12
buyer_8,Antonio,45,ES07209546103281907066,TRX_N-00771-85197157,2023-10-04T13:59:25,Labastida,expenses,mortgage,-970.96,-30688.08
buyer_8,Antonio,45,ES07209546103281907066,TRX_N-00772-15989414,2023-10-04T17:44:49,Labastida,expenses,food,-87.48,-30775.56
buyer_8,Antonio,45,ES07209546103281907066,TRX_N-00773-99307425,2023-10-04T13:33:06,Labastida,expenses,leisure,-76.16,-30851.72
buyer_8,Antonio,45,ES07209546103281907066,TRX_N-00774-13228158,2023-10-05T12:08:28,Labastida,expenses,electricity,-23.92,-30875.64
buyer_8,Antonio,45,ES07209546103281907066,TRX_N-00775-43659895,2023-10-06T21:48:09,Labastida,expenses,clothing,-138.85,-31014.49
buyer_8,Antonio,45,ES07209546103281907066,TRX_N-00776-20320457,2023-10-08T05:46:03,Labastida,expenses,gas,-72.62,-31087.11
buyer_8,Antonio,45,ES07209546103281907066,TRX_N-00777-06949612,2023-10-08T19:47:17,Labastida,expenses,phone,-38.48,-31125.59
buyer_8,Antonio,45,ES07209546103281907066,TRX_N-00778-48241995,2023-10-08T13:50:21,Labastida,expenses,water,-43.6,-31169.19
buyer_8,Antonio,45,ES07209546103281907066,TRX_N-00779-04553134,2023-10-08T12:34:03,Labastida,expenses,internet,-42.0,-31211.19
buyer_8,Antonio,45,ES07209546103281907066,TRX_N-00780-54423920,2023-10-08T10:03:15,Labastida,expenses,clothing,-113.41,-31324.6
buyer_8,Antonio,45,ES07209546103281907066,TRX_N-00781-35472665,2023-10-08T20:38:07,Labastida,expenses,healthcare,-123.93,-31448.53
buyer_8,Antonio,45,ES07209546103281907066,TRX_N-00782-99380578,2023-10-11T22:59:58,Hernani,expenses,cash,-100.0,-31548.53
buyer_8,Antonio,45,ES07209546103281907066,TRX_N-00783-21841112,2023-10-11T20:25:52,Labastida,expenses,repairs,-79.57,-31628.1
buyer_8,Antonio,45,ES07209546103281907066,TRX_N-00784-05576737,2023-10-12T18:57:23,Iruña de Oca,expenses,cash,-100.0,-31728.1
buyer_8,Antonio,45,ES07209546103281907066,TRX_N-00785-02744451,2023-10-13T12:39:28,Labastida,expenses,transport,-83.32,-31811.42
buyer_8,Antonio,45,ES07209546103281907066,TRX_N-00786-02652718,2023-10-15T23:23:47,Labastida,expenses,transport,-86.53,-31897.95
buyer_8,Antonio,45,ES07209546103281907066,TRX_N-00787-06381776,2023-10-16T15:51:57,Labastida,expenses,healthcare,-116.27,-32014.22
buyer_8,Antonio,45,ES07209546103281907066,TRX_N-00788-23990815,2023-10-17T18:18:25,Labastida,expenses,leisure,-63.04,-32077.26
buyer_8,Antonio,45,ES07209546103281907066,TRX_N-00789-82237134,2023-10-18T11:32:48,Hondarribia,expenses,transport,-44.6,-32121.86
buyer_8,Antonio,45,ES07209546103281907066,TRX_N-00790-41061768,2023-10-18T00:26:38,Labastida,expenses,appliances,-224.72,-32346.58
buyer_8,Antonio,45,ES07209546103281907066,TRX_N-00791-14270105,2023-10-20T00:01:10,Santurtzi,expenses,gifts,-804.53,-33151.11
buyer_8,Antonio,45,ES07209546103281907066,TRX_N-00792-61161682,2023-10-21T11:10:59,Labastida,expenses,cash,-100.0,-33251.11
buyer_8,Antonio,45,ES07209546103281907066,TRX_N-00793-68553689,2023-10-24T11:57:24,Labastida,expenses,repairs,-216.88,-33467.99
buyer_8,Antonio,45,ES07209546103281907066,TRX_N-00794-43010202,2023-10-26T18:22:22,Labastida,expenses,transport,-50.01,-33518.0
buyer_8,Antonio,45,ES07209546103281907066,TRX_N-00795-62166618,2023-10-26T18:05:53,Labastida,expenses,leisure,-58.62,-33576.62
buyer_8,Antonio,45,ES07209546103281907066,TRX_N-00796-18123928,2023-10-27T08:12:41,Getxo,expenses,gifts,-690.18,-34266.8
buyer_8,Antonio,45,ES07209546103281907066,TRX_N-00797-59658407,2023-10-29T14:24:01,Labastida,expenses,food,-114.54,-34381.34
buyer_8,Antonio,45,ES07209546103281907066,TRX_N-00798-13052093,2023-10-29T20:44:43,Labastida,expenses,gifts,-553.97,-34935.31
buyer_8,Antonio,45,ES07209546103281907066,TRX_N-00799-43243802,2023-10-30T09:56:17,Labastida,expenses,food,-76.23,-35011.54
buyer_8,Antonio,45,ES07209546103281907066,TRX_N-00800-79177733,2023-11-01T20:38:58,Labastida,incomes,salary,1435.8,-33575.74
buyer_8,Antonio,45,ES07209546103281907066,TRX_N-00801-22991607,2023-11-01T20:38:58,Labastida,incomes,salary_partner,1615.1,-31960.64
buyer_8,Antonio,45,ES07209546103281907066,TRX_N-00802-12759293,2023-11-03T13:19:42,Erandio,expenses,food,-60.9,-32021.54
buyer_8,Antonio,45,ES07209546103281907066,TRX_N-00803-16291837,2023-11-04T10:59:21,Labastida,expenses,mortgage,-970.96,-32992.5
buyer_8,Antonio,45,ES07209546103281907066,TRX_N-00804-88403409,2023-11-04T12:04:11,Labastida,expenses,gifts,-108.59,-33101.09
buyer_8,Antonio,45,ES07209546103281907066,TRX_N-00805-32367474,2023-11-06T09:08:25,Labastida,expenses,food,-93.67,-33194.76
buyer_8,Antonio,45,ES07209546103281907066,TRX_N-00806-38819394,2023-11-07T08:52:16,Labastida,expenses,water,-24.34,-33219.1
buyer_8,Antonio,45,ES07209546103281907066,TRX_N-00807-29781547,2023-11-07T09:44:55,Labastida,expenses,electricity,-62.95,-33282.05
buyer_8,Antonio,45,ES07209546103281907066,TRX_N-00808-25410075,2023-11-07T16:01:31,Labastida,expenses,gas,-44.16,-33326.21
buyer_8,Antonio,45,ES07209546103281907066,TRX_N-00809-52323021,2023-11-07T13:12:28,Labastida,expenses,phone,-32.0,-33358.21
buyer_8,Antonio,45,ES07209546103281907066,TRX_N-00810-34407772,2023-11-07T11:37:44,Labastida,expenses,cash,-100.0,-33458.21
buyer_8,Antonio,45,ES07209546103281907066,TRX_N-00811-45316853,2023-11-08T19:16:44,Labastida,expenses,internet,-42.0,-33500.21
buyer_8,Antonio,45,ES07209546103281907066,TRX_N-00812-60137459,2023-11-08T21:27:32,Basauri,expenses,leisure,-42.48,-33542.69
buyer_8,Antonio,45,ES07209546103281907066,TRX_N-00813-12090374,2023-11-09T20:09:09,Labastida,expenses,cash,-100.0,-33642.69
buyer_8,Antonio,45,ES07209546103281907066,TRX_N-00814-50304984,2023-11-12T13:19:27,Labastida,expenses,cash,-100.0,-33742.69
buyer_8,Antonio,45,ES07209546103281907066,TRX_N-00815-10711175,2023-11-13T10:31:55,Labastida,expenses,cash,-100.0,-33842.69
buyer_8,Antonio,45,ES07209546103281907066,TRX_N-00816-33646643,2023-11-13T20:59:24,Labastida,expenses,children,-233.41,-34076.1
buyer_8,Antonio,45,ES07209546103281907066,TRX_N-00817-38454031,2023-11-15T13:46:05,Labastida,expenses,food,-110.21,-34186.31
buyer_8,Antonio,45,ES07209546103281907066,TRX_N-00818-73718339,2023-11-16T14:42:43,Labastida,expenses,food,-122.78,-34309.09
buyer_8,Antonio,45,ES07209546103281907066,TRX_N-00819-62531332,2023-11-20T10:58:29,Labastida,expenses,leisure,-67.95,-34377.04
buyer_8,Antonio,45,ES07209546103281907066,TRX_N-00820-77290084,2023-11-21T15:09:31,Lasarte-Oria,expenses,food,-112.74,-34489.78
buyer_8,Antonio,45,ES07209546103281907066,TRX_N-00821-22853810,2023-11-22T13:09:53,Labastida,expenses,repairs,-165.87,-34655.65
buyer_8,Antonio,45,ES07209546103281907066,TRX_N-00822-94180783,2023-11-23T05:05:11,Santurtzi,expenses,repairs,-196.3,-34851.95
buyer_8,Antonio,45,ES07209546103281907066,TRX_N-00823-34528478,2023-11-24T22:11:43,Labastida,expenses,food,-67.29,-34919.24
buyer_8,Antonio,45,ES07209546103281907066,TRX_N-00824-02107727,2023-11-25T09:43:52,Labastida,expenses,leisure,-47.43,-34966.67
buyer_8,Antonio,45,ES07209546103281907066,TRX_N-00825-32150512,2023-11-25T15:39:36,Labastida,expenses,repairs,-247.59,-35214.26
buyer_8,Antonio,45,ES07209546103281907066,TRX_N-00826-21513568,2023-11-26T09:37:45,Labastida,expenses,clothing,-151.26,-35365.52
buyer_8,Antonio,45,ES07209546103281907066,TRX_N-00827-23894809,2023-11-28T18:29:39,Labastida,expenses,food,-69.9,-35435.42
buyer_8,Antonio,45,ES07209546103281907066,TRX_N-00828-13865493,2023-11-29T12:15:44,Labastida,expenses,cash,-100.0,-35535.42
buyer_8,Antonio,45,ES07209546103281907066,TRX_N-00829-31642597,2023-12-01T16:18:23,Labastida,incomes,salary,1435.8,-34099.62
buyer_8,Antonio,45,ES07209546103281907066,TRX_N-00830-60054555,2023-12-01T16:18:23,Labastida,incomes,salary_partner,1615.1,-32484.52
buyer_8,Antonio,45,ES07209546103281907066,TRX_N-00831-48991061,2023-12-01T16:18:23,Labastida,incomes,extra_income,153.76,-32330.76
buyer_8,Antonio,45,ES07209546103281907066,TRX_N-00832-93462214,2023-12-01T16:18:23,Labastida,incomes,salary_bonus,1068.96,-31261.8
buyer_8,Antonio,45,ES07209546103281907066,TRX_N-00833-63820244,2023-12-01T16:18:23,Labastida,incomes,salary_partner_bonus,1176.03,-30085.77
buyer_8,Antonio,45,ES07209546103281907066,TRX_N-00834-63826644,2023-12-03T20:19:29,Zarautz,expenses,cash,-100.0,-30185.77
buyer_8,Antonio,45,ES07209546103281907066,TRX_N-00835-70389518,2023-12-04T13:53:52,Labastida,expenses,mortgage,-970.96,-31156.73
buyer_8,Antonio,45,ES07209546103281907066,TRX_N-00836-97723098,2023-12-05T09:52:08,Labastida,expenses,phone,-38.95,-31195.68
buyer_8,Antonio,45,ES07209546103281907066,TRX_N-00837-09304804,2023-12-05T13:12:02,Labastida,expenses,education,-74.96,-31270.64
buyer_8,Antonio,45,ES07209546103281907066,TRX_N-00838-34929786,2023-12-05T19:22:10,Erandio,expenses,appliances,-78.93,-31349.57
buyer_8,Antonio,45,ES07209546103281907066,TRX_N-00839-56858128,2023-12-06T16:06:11,Labastida,expenses,water,-37.28,-31386.85
buyer_8,Antonio,45,ES07209546103281907066,TRX_N-00840-66482582,2023-12-06T11:58:34,Labastida,expenses,electricity,-35.22,-31422.07
buyer_8,Antonio,45,ES07209546103281907066,TRX_N-00841-32921786,2023-12-06T19:36:22,Labastida,expenses,clothing,-83.33,-31505.4
buyer_8,Antonio,45,ES07209546103281907066,TRX_N-00842-27909222,2023-12-07T11:09:51,Labastida,expenses,gas,-30.41,-31535.81
buyer_8,Antonio,45,ES07209546103281907066,TRX_N-00843-01228309,2023-12-07T17:40:02,Labastida,expenses,leisure,-61.5,-31597.31
buyer_8,Antonio,45,ES07209546103281907066,TRX_N-00844-89530268,2023-12-07T13:29:09,Hernani,expenses,education,-57.66,-31654.97
buyer_8,Antonio,45,ES07209546103281907066,TRX_N-00845-31411904,2023-12-08T19:25:08,Labastida,expenses,internet,-42.0,-31696.97
buyer_8,Antonio,45,ES07209546103281907066,TRX_N-00846-41039823,2023-12-10T18:12:55,Labastida,expenses,transport,-83.16,-31780.13
buyer_8,Antonio,45,ES07209546103281907066,TRX_N-00847-67596203,2023-12-10T00:03:46,Labastida,expenses,healthcare,-101.04,-31881.17
buyer_8,Antonio,45,ES07209546103281907066,TRX_N-00848-77993464,2023-12-13T04:59:27,Labastida,expenses,cash,-100.0,-31981.17
buyer_8,Antonio,45,ES07209546103281907066,TRX_N-00849-87732741,2023-12-13T18:15:26,Labastida,expenses,repairs,-31.28,-32012.45
buyer_8,Antonio,45,ES07209546103281907066,TRX_N-00850-90527335,2023-12-14T09:37:05,Labastida,expenses,education,-53.01,-32065.46
buyer_8,Antonio,45,ES07209546103281907066,TRX_N-00851-00263382,2023-12-16T11:33:46,Labastida,expenses,travel,-1426.88,-33492.34
buyer_8,Antonio,45,ES07209546103281907066,TRX_N-00852-55800604,2023-12-17T23:54:14,Labastida,expenses,leisure,-29.49,-33521.83
buyer_8,Antonio,45,ES07209546103281907066,TRX_N-00853-34917023,2023-12-17T15:39:51,Labastida,expenses,cash,-100.0,-33621.83
buyer_8,Antonio,45,ES07209546103281907066,TRX_N-00854-97767638,2023-12-19T12:16:31,Labastida,expenses,clothing,-129.73,-33751.56
buyer_8,Antonio,45,ES07209546103281907066,TRX_N-00855-86804434,2023-12-20T12:09:29,Labastida,expenses,cash,-100.0,-33851.56
buyer_8,Antonio,45,ES07209546103281907066,TRX_N-00856-73675460,2023-12-21T16:46:24,Labastida,expenses,transport,-81.65,-33933.21
buyer_8,Antonio,45,ES07209546103281907066,TRX_N-00857-25143329,2023-12-22T11:02:04,Labastida,expenses,food,-87.96,-34021.17
buyer_8,Antonio,45,ES07209546103281907066,TRX_N-00858-14239314,2023-12-24T11:30:23,Labastida,expenses,education,-65.48,-34086.65
buyer_8,Antonio,45,ES07209546103281907066,TRX_N-00859-49475989,2023-12-25T18:35:10,Labastida,expenses,cash,-100.0,-34186.65
buyer_8,Antonio,45,ES07209546103281907066,TRX_N-00860-49194195,2023-12-26T12:10:48,Labastida,expenses,food,-117.91,-34304.56
buyer_8,Antonio,45,ES07209546103281907066,TRX_N-00861-12777277,2023-12-26T10:26:01,Labastida,expenses,cash,-100.0,-34404.56
buyer_8,Antonio,45,ES07209546103281907066,TRX_N-00862-69588702,2023-12-29T18:11:20,Labastida,expenses,cash,-100.0,-34504.56
buyer_8,Antonio,45,ES07209546103281907066,TRX_N-00863-51206330,2023-12-30T19:13:02,Labastida,expenses,food,-124.68,-34629.24
buyer_8,Antonio,45,ES07209546103281907066,TRX_N-00864-01227921,2023-12-30T01:31:36,Labastida,expenses,cash,-100.0,-34729.24
buyer_8,Antonio,45,ES07209546103281907066,TRX_N-00865-49639319,2023-12-31T02:50:46,Labastida,expenses,leisure,-62.38,-34791.62
buyer_8,Antonio,45,ES07209546103281907066,TRX_N-00866-32422426,2024-01-01T12:52:32,Labastida,incomes,salary,1472.3,-33319.32
buyer_8,Antonio,45,ES07209546103281907066,TRX_N-00867-04217316,2024-01-01T12:52:32,Labastida,incomes,salary_partner,1656.16,-31663.16
buyer_8,Antonio,45,ES07209546103281907066,TRX_N-00868-82235776,2024-01-02T11:06:30,Labastida,expenses,leisure,-46.21,-31709.37
buyer_8,Antonio,45,ES07209546103281907066,TRX_N-00869-64455462,2024-01-02T19:05:45,Labastida,expenses,education,-64.67,-31774.04
buyer_8,Antonio,45,ES07209546103281907066,TRX_N-00870-16676682,2024-01-04T17:45:18,Labastida,expenses,mortgage,-970.96,-32745.0
buyer_8,Antonio,45,ES07209546103281907066,TRX_N-00871-02949129,2024-01-05T08:31:25,Labastida,expenses,water,-24.04,-32769.04
buyer_8,Antonio,45,ES07209546103281907066,TRX_N-00872-07237822,2024-01-05T14:43:46,Labastida,expenses,electricity,-35.97,-32805.01
buyer_8,Antonio,45,ES07209546103281907066,TRX_N-00873-31946807,2024-01-05T19:15:47,Labastida,expenses,cash,-100.0,-32905.01
buyer_8,Antonio,45,ES07209546103281907066,TRX_N-00874-55358955,2024-01-06T06:28:50,Labastida,expenses,phone,-37.41,-32942.42
buyer_8,Antonio,45,ES07209546103281907066,TRX_N-00875-34295983,2024-01-06T14:40:38,Labastida,expenses,food,-122.35,-33064.77
buyer_8,Antonio,45,ES07209546103281907066,TRX_N-00876-97874334,2024-01-06T23:29:59,Sopela,expenses,gifts,-469.93,-33534.7
buyer_8,Antonio,45,ES07209546103281907066,TRX_N-00877-38360630,2024-01-08T08:42:53,Labastida,expenses,gas,-34.74,-33569.44
buyer_8,Antonio,45,ES07209546103281907066,TRX_N-00878-58187906,2024-01-08T12:02:52,Labastida,expenses,internet,-42.0,-33611.44
buyer_8,Antonio,45,ES07209546103281907066,TRX_N-00879-96116771,2024-01-08T08:05:12,Bermeo,expenses,cash,-100.0,-33711.44
buyer_8,Antonio,45,ES07209546103281907066,TRX_N-00880-78630266,2024-01-08T19:33:31,Labastida,expenses,travel,-1194.61,-34906.05
buyer_8,Antonio,45,ES07209546103281907066,TRX_N-00881-44836890,2024-01-10T08:01:00,Labastida,expenses,travel,-1118.99,-36025.04
buyer_8,Antonio,45,ES07209546103281907066,TRX_N-00882-79493103,2024-01-11T18:41:31,Labastida,expenses,leisure,-65.92,-36090.96
buyer_8,Antonio,45,ES07209546103281907066,TRX_N-00883-58303943,2024-01-13T18:08:09,Zuia,expenses,food,-84.68,-36175.64
buyer_8,Antonio,45,ES07209546103281907066,TRX_N-00884-03156408,2024-01-14T17:04:27,Labastida,expenses,education,-42.52,-36218.16
buyer_8,Antonio,45,ES07209546103281907066,TRX_N-00885-29018098,2024-01-15T16:44:59,Labastida,expenses,food,-123.95,-36342.11
buyer_8,Antonio,45,ES07209546103281907066,TRX_N-00886-41645985,2024-01-16T14:55:30,Labastida,expenses,travel,-1734.01,-38076.12
buyer_8,Antonio,45,ES07209546103281907066,TRX_N-00887-44117361,2024-01-17T15:09:39,Labastida,expenses,clothing,-131.98,-38208.1
buyer_8,Antonio,45,ES07209546103281907066,TRX_N-00888-51488417,2024-01-18T16:58:51,Labastida,expenses,food,-97.3,-38305.4
buyer_8,Antonio,45,ES07209546103281907066,TRX_N-00889-51561862,2024-01-18T10:00:27,Labastida,expenses,healthcare,-46.55,-38351.95
buyer_8,Antonio,45,ES07209546103281907066,TRX_N-00890-02926043,2024-01-18T05:19:55,Oyón-Oion,expenses,education,-45.86,-38397.81
buyer_8,Antonio,45,ES07209546103281907066,TRX_N-00891-82732197,2024-01-19T18:26:39,Labastida,expenses,cash,-100.0,-38497.81
buyer_8,Antonio,45,ES07209546103281907066,TRX_N-00892-48211716,2024-01-20T22:07:27,Eibar,expenses,cash,-100.0,-38597.81
buyer_8,Antonio,45,ES07209546103281907066,TRX_N-00893-14835567,2024-01-22T18:59:26,Labastida,expenses,cash,-100.0,-38697.81
buyer_8,Antonio,45,ES07209546103281907066,TRX_N-00894-25650181,2024-01-23T13:22:17,Labastida,expenses,leisure,-21.5,-38719.31
buyer_8,Antonio,45,ES07209546103281907066,TRX_N-00895-22949435,2024-01-23T11:00:38,Labastida,expenses,appliances,-191.39,-38910.7
buyer_8,Antonio,45,ES07209546103281907066,TRX_N-00896-56040720,2024-01-24T15:52:18,Labastida,expenses,cash,-100.0,-39010.7
buyer_8,Antonio,45,ES07209546103281907066,TRX_N-00897-71378540,2024-01-29T16:01:46,Labastida,expenses,cash,-100.0,-39110.7
buyer_8,Antonio,45,ES07209546103281907066,TRX_N-00898-22904154,2024-01-30T17:29:23,Oyón-Oion,expenses,food,-83.12,-39193.82
buyer_8,Antonio,45,ES07209546103281907066,TRX_N-00899-94235752,2024-01-31T14:55:28,Labastida,expenses,transport,-72.27,-39266.09
buyer_8,Antonio,45,ES07209546103281907066,TRX_N-00900-45563768,2024-02-01T02:27:38,Labastida,incomes,salary,1472.3,-37793.79
buyer_8,Antonio,45,ES07209546103281907066,TRX_N-00901-75324411,2024-02-01T02:27:38,Labastida,incomes,salary_partner,1656.16,-36137.63
buyer_8,Antonio,45,ES07209546103281907066,TRX_N-00902-58427787,2024-02-04T21:31:59,Labastida,expenses,mortgage,-970.96,-37108.59
buyer_8,Antonio,45,ES07209546103281907066,TRX_N-00903-14997865,2024-02-04T12:11:44,Labastida,expenses,food,-91.09,-37199.68
buyer_8,Antonio,45,ES07209546103281907066,TRX_N-00904-74577024,2024-02-05T10:07:33,Labastida,expenses,water,-36.64,-37236.32
buyer_8,Antonio,45,ES07209546103281907066,TRX_N-00905-30332558,2024-02-05T18:34:13,Labastida,expenses,gas,-55.98,-37292.3
buyer_8,Antonio,45,ES07209546103281907066,TRX_N-00906-74977684,2024-02-05T12:02:59,Labastida,expenses,food,-96.82,-37389.12
buyer_8,Antonio,45,ES07209546103281907066,TRX_N-00907-86468297,2024-02-05T18:49:38,Labastida,expenses,clothing,-91.55,-37480.67
buyer_8,Antonio,45,ES07209546103281907066,TRX_N-00908-07394823,2024-02-05T19:06:54,Labastida,expenses,cash,-100.0,-37580.67
buyer_8,Antonio,45,ES07209546103281907066,TRX_N-00909-18368424,2024-02-07T17:21:16,Labastida,expenses,cash,-100.0,-37680.67
buyer_8,Antonio,45,ES07209546103281907066,TRX_N-00910-54249909,2024-02-08T14:15:36,Labastida,expenses,internet,-42.0,-37722.67
buyer_8,Antonio,45,ES07209546103281907066,TRX_N-00911-92887258,2024-02-08T14:28:23,Labastida,expenses,electricity,-43.44,-37766.11
buyer_8,Antonio,45,ES07209546103281907066,TRX_N-00912-68133721,2024-02-08T16:05:01,Labastida,expenses,phone,-37.8,-37803.91
buyer_8,Antonio,45,ES07209546103281907066,TRX_N-00913-56872065,2024-02-08T09:35:39,Labastida,expenses,travel,-1000.75,-38804.66
buyer_8,Antonio,45,ES07209546103281907066,TRX_N-00914-73959974,2024-02-09T11:30:40,Labastida,expenses,leisure,-33.76,-38838.42
buyer_8,Antonio,45,ES07209546103281907066,TRX_N-00915-82879504,2024-02-09T22:55:15,Labastida,expenses,clothing,-126.84,-38965.26
buyer_8,Antonio,45,ES07209546103281907066,TRX_N-00916-66829659,2024-02-09T20:43:42,Labastida,expenses,gifts,-616.57,-39581.83
buyer_8,Antonio,45,ES07209546103281907066,TRX_N-00917-20346585,2024-02-10T22:48:36,Labastida,expenses,repairs,-113.02,-39694.85
buyer_8,Antonio,45,ES07209546103281907066,TRX_N-00918-40849326,2024-02-11T08:40:47,Labastida,expenses,clothing,-75.45,-39770.3
buyer_8,Antonio,45,ES07209546103281907066,TRX_N-00919-68857842,2024-02-11T20:45:02,Labastida,expenses,cash,-100.0,-39870.3
buyer_8,Antonio,45,ES07209546103281907066,TRX_N-00920-50256912,2024-02-12T10:25:16,Labastida,expenses,repairs,-43.21,-39913.51
buyer_8,Antonio,45,ES07209546103281907066,TRX_N-00921-43843851,2024-02-16T18:00:27,Labastida,expenses,cash,-100.0,-40013.51
buyer_8,Antonio,45,ES07209546103281907066,TRX_N-00922-09838603,2024-02-18T23:18:44,Labastida,expenses,leisure,-50.63,-40064.14
buyer_8,Antonio,45,ES07209546103281907066,TRX_N-00923-70264532,2024-02-18T10:55:16,Labastida,expenses,education,-67.92,-40132.06
buyer_8,Antonio,45,ES07209546103281907066,TRX_N-00924-83930065,2024-02-19T13:14:06,Santurtzi,expenses,food,-78.07,-40210.13
buyer_8,Antonio,45,ES07209546103281907066,TRX_N-00925-38470577,2024-02-20T18:11:56,Iruña de Oca,expenses,healthcare,-184.34,-40394.47
buyer_8,Antonio,45,ES07209546103281907066,TRX_N-00926-57889841,2024-02-22T19:08:34,Labastida,expenses,children,-247.25,-40641.72
buyer_8,Antonio,45,ES07209546103281907066,TRX_N-00927-02475580,2024-02-24T13:56:37,Labastida,expenses,clothing,-112.37,-40754.09
buyer_8,Antonio,45,ES07209546103281907066,TRX_N-00928-70865254,2024-02-25T14:07:26,Galdakao,expenses,transport,-67.46,-40821.55
buyer_8,Antonio,45,ES07209546103281907066,TRX_N-00929-68454957,2024-02-25T10:48:54,Labastida,expenses,cash,-100.0,-40921.55
buyer_8,Antonio,45,ES07209546103281907066,TRX_N-00930-03551668,2024-02-26T12:09:30,Labastida,expenses,leisure,-47.05,-40968.6
buyer_8,Antonio,45,ES07209546103281907066,TRX_N-00931-92571163,2024-02-26T20:17:18,Labastida,expenses,appliances,-160.6,-41129.2
buyer_8,Antonio,45,ES07209546103281907066,TRX_N-00932-90960463,2024-02-26T14:12:21,Labastida,expenses,children,-163.48,-41292.68
buyer_8,Antonio,45,ES07209546103281907066,TRX_N-00933-62376194,2024-02-28T13:40:24,Oyón-Oion,expenses,food,-65.69,-41358.37
buyer_8,Antonio,45,ES07209546103281907066,TRX_N-00934-19117624,2024-02-28T19:45:21,Labastida,expenses,clothing,-92.73,-41451.1
buyer_8,Antonio,45,ES07209546103281907066,TRX_N-00935-86652002,2024-03-01T14:46:27,Labastida,incomes,salary,1472.3,-39978.8
buyer_8,Antonio,45,ES07209546103281907066,TRX_N-00936-64517993,2024-03-01T14:46:27,Labastida,incomes,salary_partner,1656.16,-38322.64
buyer_8,Antonio,45,ES07209546103281907066,TRX_N-00937-57611608,2024-03-01T14:46:27,Labastida,incomes,extra_income,153.76,-38168.88
buyer_8,Antonio,45,ES07209546103281907066,TRX_N-00938-44809353,2024-03-03T08:43:52,Labastida,expenses,leisure,-80.46,-38249.34
buyer_8,Antonio,45,ES07209546103281907066,TRX_N-00939-80765788,2024-03-04T17:57:57,Labastida,expenses,mortgage,-970.96,-39220.3
buyer_8,Antonio,45,ES07209546103281907066,TRX_N-00940-73733075,2024-03-04T12:27:18,Labastida,expenses,food,-97.32,-39317.62
buyer_8,Antonio,45,ES07209546103281907066,TRX_N-00941-59978935,2024-03-05T11:11:30,Labastida,expenses,leisure,-26.56,-39344.18
buyer_8,Antonio,45,ES07209546103281907066,TRX_N-00942-43720552,2024-03-05T12:28:03,Labastida,expenses,repairs,-198.77,-39542.95
buyer_8,Antonio,45,ES07209546103281907066,TRX_N-00943-83175668,2024-03-06T12:57:38,Labastida,expenses,internet,-42.0,-39584.95
buyer_8,Antonio,45,ES07209546103281907066,TRX_N-00944-16188243,2024-03-07T23:50:52,Labastida,expenses,electricity,-26.82,-39611.77
buyer_8,Antonio,45,ES07209546103281907066,TRX_N-00945-04864162,2024-03-07T02:16:44,Labastida,expenses,cash,-100.0,-39711.77
buyer_8,Antonio,45,ES07209546103281907066,TRX_N-00946-96669308,2024-03-08T00:21:40,Labastida,expenses,water,-20.21,-39731.98
buyer_8,Antonio,45,ES07209546103281907066,TRX_N-00947-90577324,2024-03-08T15:00:05,Labastida,expenses,gas,-77.21,-39809.19
buyer_8,Antonio,45,ES07209546103281907066,TRX_N-00948-08442384,2024-03-08T18:23:44,Labastida,expenses,phone,-36.63,-39845.82
buyer_8,Antonio,45,ES07209546103281907066,TRX_N-00949-62883525,2024-03-08T17:01:59,Labastida,expenses,transport,-81.72,-39927.54
buyer_8,Antonio,45,ES07209546103281907066,TRX_N-00950-40826701,2024-03-08T20:57:32,Hernani,expenses,education,-67.73,-39995.27
buyer_8,Antonio,45,ES07209546103281907066,TRX_N-00951-26585169,2024-03-09T09:45:50,Labastida,expenses,cash,-100.0,-40095.27
buyer_8,Antonio,45,ES07209546103281907066,TRX_N-00952-72617481,2024-03-10T14:38:45,Labastida,expenses,cash,-100.0,-40195.27
buyer_8,Antonio,45,ES07209546103281907066,TRX_N-00953-16699790,2024-03-17T13:45:33,Labastida,expenses,food,-73.45,-40268.72
buyer_8,Antonio,45,ES07209546103281907066,TRX_N-00954-48571899,2024-03-17T03:02:00,Labastida,expenses,gifts,-612.05,-40880.77
buyer_8,Antonio,45,ES07209546103281907066,TRX_N-00955-92904344,2024-03-18T16:47:49,Labastida,expenses,transport,-76.2,-40956.97
buyer_8,Antonio,45,ES07209546103281907066,TRX_N-00956-36647136,2024-03-19T12:26:55,Labastida,expenses,leisure,-30.7,-40987.67
buyer_8,Antonio,45,ES07209546103281907066,TRX_N-00957-92238669,2024-03-19T08:25:22,Labastida,expenses,repairs,-297.0,-41284.67
buyer_8,Antonio,45,ES07209546103281907066,TRX_N-00958-26028739,2024-03-20T18:53:27,Labastida,expenses,cash,-100.0,-41384.67
buyer_8,Antonio,45,ES07209546103281907066,TRX_N-00959-51510659,2024-03-22T15:58:41,Labastida,expenses,food,-76.09,-41460.76
buyer_8,Antonio,45,ES07209546103281907066,TRX_N-00960-91612378,2024-03-23T20:23:14,Labastida,expenses,leisure,-57.66,-41518.42
buyer_8,Antonio,45,ES07209546103281907066,TRX_N-00961-19136084,2024-03-23T01:05:06,Labastida,expenses,cash,-100.0,-41618.42
buyer_8,Antonio,45,ES07209546103281907066,TRX_N-00962-20385932,2024-03-25T16:38:30,Labastida,expenses,transport,-76.24,-41694.66
buyer_8,Antonio,45,ES07209546103281907066,TRX_N-00963-10660663,2024-03-25T18:38:02,Labastida,expenses,cash,-100.0,-41794.66
buyer_8,Antonio,45,ES07209546103281907066,TRX_N-00964-64290739,2024-03-25T19:23:42,Labastida,expenses,children,-78.89,-41873.55
buyer_8,Antonio,45,ES07209546103281907066,TRX_N-00965-25163062,2024-03-26T18:25:29,Labastida,expenses,transport,-58.31,-41931.86
buyer_8,Antonio,45,ES07209546103281907066,TRX_N-00966-96099614,2024-03-26T18:09:37,Labastida,expenses,repairs,-162.19,-42094.05
buyer_8,Antonio,45,ES07209546103281907066,TRX_N-00967-44553095,2024-03-28T18:40:34,Labastida,expenses,appliances,-145.71,-42239.76
buyer_8,Antonio,45,ES07209546103281907066,TRX_N-00968-26017718,2024-03-29T19:57:52,Labastida,expenses,leisure,-57.96,-42297.72
buyer_8,Antonio,45,ES07209546103281907066,TRX_N-00969-12208767,2024-03-29T19:56:59,Labastida,expenses,appliances,-245.15,-42542.87
buyer_8,Antonio,45,ES07209546103281907066,TRX_N-00970-76977735,2024-03-29T11:50:47,Labastida,expenses,repairs,-192.16,-42735.03
buyer_8,Antonio,45,ES07209546103281907066,TRX_N-00971-94207994,2024-03-31T00:42:17,Labastida,expenses,food,-88.33,-42823.36
buyer_8,Antonio,45,ES07209546103281907066,TRX_N-00972-15905108,2024-03-31T15:44:48,Labastida,expenses,clothing,-146.45,-42969.81
buyer_8,Antonio,45,ES07209546103281907066,TRX_N-00973-84762625,2024-03-31T20:05:10,Labastida,expenses,appliances,-370.57,-43340.38
buyer_8,Antonio,45,ES07209546103281907066,TRX_N-00974-71551999,2024-04-01T12:41:59,Labastida,incomes,salary,1472.3,-41868.08
buyer_8,Antonio,45,ES07209546103281907066,TRX_N-00975-07698339,2024-04-01T12:41:59,Labastida,incomes,salary_partner,1656.16,-40211.92
buyer_8,Antonio,45,ES07209546103281907066,TRX_N-00976-14118566,2024-04-02T14:50:19,Labastida,expenses,food,-73.31,-40285.23
buyer_8,Antonio,45,ES07209546103281907066,TRX_N-00977-55250577,2024-04-04T07:47:10,Labastida,expenses,mortgage,-970.96,-41256.19
buyer_8,Antonio,45,ES07209546103281907066,TRX_N-00978-01440291,2024-04-04T06:05:16,Labastida,expenses,food,-67.95,-41324.14
buyer_8,Antonio,45,ES07209546103281907066,TRX_N-00979-13338429,2024-04-04T10:15:06,Labastida,expenses,transport,-80.15,-41404.29
buyer_8,Antonio,45,ES07209546103281907066,TRX_N-00980-62256410,2024-04-05T19:25:11,Leioa,expenses,food,-85.54,-41489.83
buyer_8,Antonio,45,ES07209546103281907066,TRX_N-00981-11038348,2024-04-06T20:28:20,Labastida,expenses,water,-33.8,-41523.63
buyer_8,Antonio,45,ES07209546103281907066,TRX_N-00982-15315349,2024-04-06T12:30:48,Mungia,expenses,food,-89.14,-41612.77
buyer_8,Antonio,45,ES07209546103281907066,TRX_N-00983-25225655,2024-04-07T13:46:45,Labastida,expenses,gas,-86.1,-41698.87
buyer_8,Antonio,45,ES07209546103281907066,TRX_N-00984-31162256,2024-04-07T19:26:56,Labastida,expenses,food,-63.73,-41762.6
buyer_8,Antonio,45,ES07209546103281907066,TRX_N-00985-79739145,2024-04-07T09:14:19,Labastida,expenses,repairs,-286.58,-42049.18
buyer_8,Antonio,45,ES07209546103281907066,TRX_N-00986-67990291,2024-04-08T13:47:59,Labastida,expenses,electricity,-89.78,-42138.96
buyer_8,Antonio,45,ES07209546103281907066,TRX_N-00987-72902931,2024-04-08T20:47:36,Labastida,expenses,internet,-42.0,-42180.96
buyer_8,Antonio,45,ES07209546103281907066,TRX_N-00988-95961407,2024-04-08T17:51:19,Labastida,expenses,phone,-42.75,-42223.71
buyer_8,Antonio,45,ES07209546103281907066,TRX_N-00989-33049942,2024-04-10T19:06:43,Zuia,expenses,clothing,-144.87,-42368.58
buyer_8,Antonio,45,ES07209546103281907066,TRX_N-00990-27714941,2024-04-11T22:51:26,Labastida,expenses,leisure,-38.96,-42407.54
buyer_8,Antonio,45,ES07209546103281907066,TRX_N-00991-98029391,2024-04-12T15:49:19,Labastida,expenses,repairs,-89.29,-42496.83
buyer_8,Antonio,45,ES07209546103281907066,TRX_N-00992-76345446,2024-04-13T18:30:00,Labastida,expenses,cash,-100.0,-42596.83
buyer_8,Antonio,45,ES07209546103281907066,TRX_N-00993-55808973,2024-04-14T00:01:46,Labastida,expenses,cash,-100.0,-42696.83
buyer_8,Antonio,45,ES07209546103281907066,TRX_N-00994-41579316,2024-04-15T10:03:42,Labastida,expenses,healthcare,-140.65,-42837.48
buyer_8,Antonio,45,ES07209546103281907066,TRX_N-00995-63240932,2024-04-16T17:00:07,Amurrio,expenses,transport,-67.07,-42904.55
buyer_8,Antonio,45,ES07209546103281907066,TRX_N-00996-84375624,2024-04-19T13:07:47,Labastida,expenses,food,-123.44,-43027.99
buyer_8,Antonio,45,ES07209546103281907066,TRX_N-00997-00360694,2024-04-21T19:28:58,Labastida,expenses,cash,-100.0,-43127.99
buyer_8,Antonio,45,ES07209546103281907066,TRX_N-00998-26598164,2024-04-23T05:00:11,Labastida,expenses,leisure,-57.48,-43185.47
buyer_8,Antonio,45,ES07209546103281907066,TRX_N-00999-02256449,2024-04-26T14:05:39,Labastida,expenses,education,-67.46,-43252.93
buyer_8,Antonio,45,ES07209546103281907066,TRX_N-01000-79914635,2024-04-26T13:03:47,Labastida,expenses,cash,-100.0,-43352.93
buyer_8,Antonio,45,ES07209546103281907066,TRX_N-01001-83025962,2024-04-27T01:33:52,Labastida,expenses,cash,-100.0,-43452.93
buyer_8,Antonio,45,ES07209546103281907066,TRX_N-01002-43360890,2024-04-28T22:47:47,Labastida,expenses,clothing,-48.25,-43501.18
buyer_8,Antonio,45,ES07209546103281907066,TRX_N-01003-57676713,2024-04-29T19:26:29,Labastida,expenses,food,-73.73,-43574.91
buyer_8,Antonio,45,ES07209546103281907066,TRX_N-01004-95004934,2024-04-30T20:36:53,Labastida,expenses,transport,-70.17,-43645.08
buyer_8,Antonio,45,ES07209546103281907066,TRX_N-01005-91485512,2024-05-01T11:00:13,Labastida,incomes,salary,1472.3,-42172.78
buyer_8,Antonio,45,ES07209546103281907066,TRX_N-01006-37573661,2024-05-01T11:00:13,Labastida,incomes,salary_partner,1656.16,-40516.62
buyer_8,Antonio,45,ES07209546103281907066,TRX_N-01007-40354119,2024-05-01T09:34:20,Labastida,expenses,food,-98.87,-40615.49
buyer_8,Antonio,45,ES07209546103281907066,TRX_N-01008-34684958,2024-05-02T10:49:42,Labastida,expenses,healthcare,-107.8,-40723.29
buyer_8,Antonio,45,ES07209546103281907066,TRX_N-01009-38590979,2024-05-03T10:45:19,Labastida,expenses,leisure,-80.71,-40804.0
buyer_8,Antonio,45,ES07209546103281907066,TRX_N-01010-63813685,2024-05-03T08:24:56,Eibar,expenses,gifts,-662.28,-41466.28
buyer_8,Antonio,45,ES07209546103281907066,TRX_N-01011-29940355,2024-05-04T10:17:34,Labastida,expenses,mortgage,-970.96,-42437.24
buyer_8,Antonio,45,ES07209546103281907066,TRX_N-01012-90577336,2024-05-04T19:38:01,Labastida,expenses,leisure,-55.98,-42493.22
buyer_8,Antonio,45,ES07209546103281907066,TRX_N-01013-30498930,2024-05-05T19:51:10,Labastida,expenses,internet,-42.0,-42535.22
buyer_8,Antonio,45,ES07209546103281907066,TRX_N-01014-24426117,2024-05-05T16:38:14,Llodio,expenses,travel,-510.23,-43045.45
buyer_8,Antonio,45,ES07209546103281907066,TRX_N-01015-53054984,2024-05-05T08:18:04,Labastida,expenses,children,-259.01,-43304.46
buyer_8,Antonio,45,ES07209546103281907066,TRX_N-01016-83357041,2024-05-07T14:59:12,Labastida,expenses,electricity,-21.48,-43325.94
buyer_8,Antonio,45,ES07209546103281907066,TRX_N-01017-82038325,2024-05-07T00:44:30,Labastida,expenses,gas,-77.72,-43403.66
buyer_8,Antonio,45,ES07209546103281907066,TRX_N-01018-88605906,2024-05-07T11:48:14,Labastida,expenses,phone,-31.1,-43434.76
buyer_8,Antonio,45,ES07209546103281907066,TRX_N-01019-72049074,2024-05-07T12:03:14,Labastida,expenses,food,-60.42,-43495.18
buyer_8,Antonio,45,ES07209546103281907066,TRX_N-01020-69241404,2024-05-07T15:48:38,Labastida,expenses,transport,-62.43,-43557.61
buyer_8,Antonio,45,ES07209546103281907066,TRX_N-01021-37746151,2024-05-08T15:30:28,Labastida,expenses,water,-36.31,-43593.92
buyer_8,Antonio,45,ES07209546103281907066,TRX_N-01022-54849519,2024-05-08T08:51:34,Labastida,expenses,food,-75.11,-43669.03
buyer_8,Antonio,45,ES07209546103281907066,TRX_N-01023-46050284,2024-05-08T20:21:41,Labastida,expenses,clothing,-118.5,-43787.53
buyer_8,Antonio,45,ES07209546103281907066,TRX_N-01024-91405743,2024-05-09T18:42:08,Labastida,expenses,children,-222.39,-44009.92
buyer_8,Antonio,45,ES07209546103281907066,TRX_N-01025-98963752,2024-05-10T18:09:32,Labastida,expenses,leisure,-31.09,-44041.01
buyer_8,Antonio,45,ES07209546103281907066,TRX_N-01026-53739410,2024-05-11T16:48:26,Labastida,expenses,cash,-100.0,-44141.01
buyer_8,Antonio,45,ES07209546103281907066,TRX_N-01027-72345590,2024-05-11T18:08:32,Labastida,expenses,appliances,-366.14,-44507.15
buyer_8,Antonio,45,ES07209546103281907066,TRX_N-01028-36491347,2024-05-17T10:57:23,Labastida,expenses,cash,-100.0,-44607.15
buyer_8,Antonio,45,ES07209546103281907066,TRX_N-01029-91117854,2024-05-17T19:48:36,Labastida,expenses,repairs,-92.83,-44699.98
buyer_8,Antonio,45,ES07209546103281907066,TRX_N-01030-78868984,2024-05-20T10:21:04,Labastida,expenses,leisure,-33.47,-44733.45
buyer_8,Antonio,45,ES07209546103281907066,TRX_N-01031-92352462,2024-05-21T08:27:40,Labastida,expenses,food,-71.7,-44805.15
buyer_8,Antonio,45,ES07209546103281907066,TRX_N-01032-01458083,2024-05-22T14:57:24,Labastida,expenses,cash,-100.0,-44905.15
buyer_8,Antonio,45,ES07209546103281907066,TRX_N-01033-08207514,2024-05-23T20:46:01,Labastida,expenses,food,-92.82,-44997.97
buyer_8,Antonio,45,ES07209546103281907066,TRX_N-01034-54509985,2024-05-25T18:33:22,Labastida,expenses,cash,-100.0,-45097.97
buyer_8,Antonio,45,ES07209546103281907066,TRX_N-01035-66339706,2024-05-26T18:34:52,Labastida,expenses,cash,-100.0,-45197.97
buyer_8,Antonio,45,ES07209546103281907066,TRX_N-01036-49836414,2024-05-27T09:18:27,Arrasate,expenses,food,-102.84,-45300.81
buyer_8,Antonio,45,ES07209546103281907066,TRX_N-01037-96495391,2024-05-27T16:53:05,Labastida,expenses,education,-72.16,-45372.97
buyer_8,Antonio,45,ES07209546103281907066,TRX_N-01038-39053820,2024-05-29T16:48:04,Labastida,expenses,cash,-100.0,-45472.97
buyer_8,Antonio,45,ES07209546103281907066,TRX_N-01039-54659049,2024-05-29T08:12:44,Labastida,expenses,gifts,-588.83,-46061.8
buyer_8,Antonio,45,ES07209546103281907066,TRX_N-01040-07595648,2024-05-30T23:48:06,Labastida,expenses,leisure,-26.67,-46088.47
buyer_8,Antonio,45,ES07209546103281907066,TRX_N-01041-34473020,2024-05-30T18:03:32,Labastida,expenses,education,-70.27,-46158.74
buyer_8,Antonio,45,ES07209546103281907066,TRX_N-01042-85522517,2024-06-01T18:25:11,Labastida,incomes,salary,1472.3,-44686.44
buyer_8,Antonio,45,ES07209546103281907066,TRX_N-01043-94957746,2024-06-01T18:25:11,Labastida,incomes,salary_partner,1656.16,-43030.28
buyer_8,Antonio,45,ES07209546103281907066,TRX_N-01044-61937543,2024-06-01T18:25:11,Labastida,incomes,extra_income,153.76,-42876.52
buyer_8,Antonio,45,ES07209546103281907066,TRX_N-01045-41236544,2024-06-01T18:25:11,Labastida,incomes,salary_bonus,1128.47,-41748.05
buyer_8,Antonio,45,ES07209546103281907066,TRX_N-01046-26053056,2024-06-01T18:25:11,Labastida,incomes,salary_partner_bonus,1264.4,-40483.65
buyer_8,Antonio,45,ES07209546103281907066,TRX_N-01047-70750350,2024-06-01T15:18:16,Labastida,expenses,appliances,-211.8,-40695.45
buyer_8,Antonio,45,ES07209546103281907066,TRX_N-01048-26980317,2024-06-01T03:26:24,Labastida,expenses,children,-140.54,-40835.99
buyer_8,Antonio,45,ES07209546103281907066,TRX_N-01049-55961834,2024-06-03T10:04:54,Labastida,expenses,clothing,-139.09,-40975.08
buyer_8,Antonio,45,ES07209546103281907066,TRX_N-01050-42060576,2024-06-03T21:48:58,Labastida,expenses,cash,-100.0,-41075.08
buyer_8,Antonio,45,ES07209546103281907066,TRX_N-01051-41604180,2024-06-04T00:38:16,Labastida,expenses,mortgage,-970.96,-42046.04
buyer_8,Antonio,45,ES07209546103281907066,TRX_N-01052-99735880,2024-06-05T09:52:34,Labastida,expenses,gas,-32.47,-42078.51
buyer_8,Antonio,45,ES07209546103281907066,TRX_N-01053-92064111,2024-06-05T02:36:27,Labastida,expenses,internet,-42.0,-42120.51
buyer_8,Antonio,45,ES07209546103281907066,TRX_N-01054-39076435,2024-06-05T11:24:34,Labastida,expenses,phone,-36.37,-42156.88
buyer_8,Antonio,45,ES07209546103281907066,TRX_N-01055-55526083,2024-06-05T20:11:01,Labastida,expenses,education,-54.37,-42211.25
buyer_8,Antonio,45,ES07209546103281907066,TRX_N-01056-78945442,2024-06-05T17:24:24,Labastida,expenses,cash,-100.0,-42311.25
buyer_8,Antonio,45,ES07209546103281907066,TRX_N-01057-76995671,2024-06-06T15:37:13,Labastida,expenses,electricity,-25.35,-42336.6
buyer_8,Antonio,45,ES07209546103281907066,TRX_N-01058-49460683,2024-06-06T16:26:54,Zarautz,expenses,food,-101.52,-42438.12
buyer_8,Antonio,45,ES07209546103281907066,TRX_N-01059-66252218,2024-06-06T14:37:47,Labastida,expenses,children,-189.33,-42627.45
buyer_8,Antonio,45,ES07209546103281907066,TRX_N-01060-48837928,2024-06-07T14:52:34,Labastida,expenses,repairs,-132.14,-42759.59
buyer_8,Antonio,45,ES07209546103281907066,TRX_N-01061-39292171,2024-06-08T18:29:37,Labastida,expenses,water,-33.72,-42793.31
buyer_8,Antonio,45,ES07209546103281907066,TRX_N-01062-91093895,2024-06-08T12:37:09,Labastida,expenses,transport,-72.09,-42865.4
buyer_8,Antonio,45,ES07209546103281907066,TRX_N-01063-77437345,2024-06-10T11:00:44,Labastida,expenses,cash,-100.0,-42965.4
buyer_8,Antonio,45,ES07209546103281907066,TRX_N-01064-66406980,2024-06-11T09:03:54,Vitoria-Gasteiz,expenses,food,-111.97,-43077.37
buyer_8,Antonio,45,ES07209546103281907066,TRX_N-01065-30548532,2024-06-12T21:44:10,Hondarribia,expenses,food,-124.55,-43201.92
buyer_8,Antonio,45,ES07209546103281907066,TRX_N-01066-33864666,2024-06-15T15:53:55,Lasarte-Oria,expenses,food,-96.82,-43298.74
buyer_8,Antonio,45,ES07209546103281907066,TRX_N-01067-94560003,2024-06-15T14:03:49,Labastida,expenses,clothing,-146.76,-43445.5
buyer_8,Antonio,45,ES07209546103281907066,TRX_N-01068-26201888,2024-06-16T10:17:55,Labastida,expenses,clothing,-101.39,-43546.89
buyer_8,Antonio,45,ES07209546103281907066,TRX_N-01069-66944519,2024-06-18T15:19:48,Labastida,expenses,appliances,-127.62,-43674.51
buyer_8,Antonio,45,ES07209546103281907066,TRX_N-01070-25989264,2024-06-19T14:27:53,Labastida,expenses,food,-124.87,-43799.38
buyer_8,Antonio,45,ES07209546103281907066,TRX_N-01071-48739752,2024-06-19T12:21:43,Labastida,expenses,cash,-100.0,-43899.38
buyer_8,Antonio,45,ES07209546103281907066,TRX_N-01072-32136754,2024-06-20T20:36:04,Labastida,expenses,repairs,-267.41,-44166.79
buyer_8,Antonio,45,ES07209546103281907066,TRX_N-01073-46832854,2024-06-21T14:41:15,Labastida,expenses,leisure,-50.61,-44217.4
buyer_8,Antonio,45,ES07209546103281907066,TRX_N-01074-47972561,2024-06-23T12:53:14,Labastida,expenses,cash,-100.0,-44317.4
buyer_8,Antonio,45,ES07209546103281907066,TRX_N-01075-53980761,2024-06-24T15:45:59,Labastida,expenses,children,-170.56,-44487.96
buyer_8,Antonio,45,ES07209546103281907066,TRX_N-01076-51511929,2024-06-26T18:34:32,Labastida,expenses,food,-118.35,-44606.31
buyer_8,Antonio,45,ES07209546103281907066,TRX_N-01077-25010976,2024-06-26T20:46:43,Labastida,expenses,transport,-62.48,-44668.79
buyer_8,Antonio,45,ES07209546103281907066,TRX_N-01078-66081476,2024-06-28T18:09:21,Labastida,expenses,cash,-100.0,-44768.79
buyer_8,Antonio,45,ES07209546103281907066,TRX_N-01079-76514577,2024-06-29T16:49:13,Sestao,expenses,leisure,-52.48,-44821.27
buyer_8,Antonio,45,ES07209546103281907066,TRX_N-01080-09784433,2024-07-01T18:00:57,Labastida,incomes,salary,1472.3,-43348.97
buyer_8,Antonio,45,ES07209546103281907066,TRX_N-01081-21898644,2024-07-01T18:00:57,Labastida,incomes,salary_partner,1656.16,-41692.81
buyer_8,Antonio,45,ES07209546103281907066,TRX_N-01082-75896253,2024-07-04T12:11:08,Labastida,expenses,mortgage,-970.96,-42663.77
buyer_8,Antonio,45,ES07209546103281907066,TRX_N-01083-37280394,2024-07-05T09:12:16,Labastida,expenses,gas,-96.63,-42760.4
buyer_8,Antonio,45,ES07209546103281907066,TRX_N-01084-87734787,2024-07-07T17:20:56,Labastida,expenses,water,-41.44,-42801.84
buyer_8,Antonio,45,ES07209546103281907066,TRX_N-01085-50351360,2024-07-08T16:23:37,Labastida,expenses,electricity,-62.95,-42864.79
buyer_8,Antonio,45,ES07209546103281907066,TRX_N-01086-56472506,2024-07-08T10:27:23,Labastida,expenses,internet,-42.0,-42906.79
buyer_8,Antonio,45,ES07209546103281907066,TRX_N-01087-62918386,2024-07-08T02:11:52,Labastida,expenses,phone,-42.7,-42949.49
buyer_8,Antonio,45,ES07209546103281907066,TRX_N-01088-71857810,2024-07-08T20:48:19,Labastida,expenses,food,-69.13,-43018.62
buyer_8,Antonio,45,ES07209546103281907066,TRX_N-01089-19255155,2024-07-08T14:54:14,Labastida,expenses,clothing,-106.77,-43125.39
buyer_8,Antonio,45,ES07209546103281907066,TRX_N-01090-54574893,2024-07-10T18:25:19,Labastida,expenses,healthcare,-56.43,-43181.82
buyer_8,Antonio,45,ES07209546103281907066,TRX_N-01091-61413261,2024-07-10T16:00:11,Labastida,expenses,education,-59.57,-43241.39
buyer_8,Antonio,45,ES07209546103281907066,TRX_N-01092-46621635,2024-07-14T08:27:57,Labastida,expenses,healthcare,-65.84,-43307.23
buyer_8,Antonio,45,ES07209546103281907066,TRX_N-01093-33471879,2024-07-15T12:41:51,Labastida,expenses,leisure,-31.44,-43338.67
buyer_8,Antonio,45,ES07209546103281907066,TRX_N-01094-89001996,2024-07-17T14:57:56,Labastida,expenses,appliances,-226.19,-43564.86
buyer_8,Antonio,45,ES07209546103281907066,TRX_N-01095-12111355,2024-07-18T12:08:23,Labastida,expenses,transport,-54.6,-43619.46
buyer_8,Antonio,45,ES07209546103281907066,TRX_N-01096-02168110,2024-07-18T15:08:06,Getxo,expenses,leisure,-76.05,-43695.51
buyer_8,Antonio,45,ES07209546103281907066,TRX_N-01097-66177804,2024-07-18T02:26:34,Andoain,expenses,education,-62.76,-43758.27
buyer_8,Antonio,45,ES07209546103281907066,TRX_N-01098-43096104,2024-07-19T16:43:24,Labastida,expenses,cash,-100.0,-43858.27
buyer_8,Antonio,45,ES07209546103281907066,TRX_N-01099-86113133,2024-07-21T11:32:51,Labastida,expenses,food,-60.75,-43919.02
buyer_8,Antonio,45,ES07209546103281907066,TRX_N-01100-24928912,2024-07-21T11:45:12,Andoain,expenses,gifts,-434.73,-44353.75
buyer_8,Antonio,45,ES07209546103281907066,TRX_N-01101-37126102,2024-07-23T17:05:31,Labastida,expenses,food,-71.87,-44425.62
buyer_8,Antonio,45,ES07209546103281907066,TRX_N-01102-91201455,2024-07-24T16:46:13,Labastida,expenses,transport,-66.56,-44492.18
buyer_8,Antonio,45,ES07209546103281907066,TRX_N-01103-07797060,2024-07-24T16:08:54,Labastida,expenses,leisure,-30.2,-44522.38
buyer_8,Antonio,45,ES07209546103281907066,TRX_N-01104-93534755,2024-07-25T17:45:21,Errenteria,expenses,food,-95.89,-44618.27
buyer_8,Antonio,45,ES07209546103281907066,TRX_N-01105-21623823,2024-07-25T12:55:49,Labastida,expenses,transport,-88.37,-44706.64
buyer_8,Antonio,45,ES07209546103281907066,TRX_N-01106-71067489,2024-07-25T13:22:10,Eibar,expenses,leisure,-21.51,-44728.15
buyer_8,Antonio,45,ES07209546103281907066,TRX_N-01107-75647933,2024-07-26T08:45:53,Labastida,expenses,transport,-67.51,-44795.66
buyer_8,Antonio,45,ES07209546103281907066,TRX_N-01108-37028085,2024-07-28T10:51:22,Pasaia,expenses,cash,-100.0,-44895.66
buyer_8,Antonio,45,ES07209546103281907066,TRX_N-01109-44288192,2024-07-29T12:26:21,Labastida,expenses,food,-78.33,-44973.99
buyer_8,Antonio,45,ES07209546103281907066,TRX_N-01110-15021039,2024-07-29T15:50:24,Labastida,expenses,transport,-72.27,-45046.26
buyer_8,Antonio,45,ES07209546103281907066,TRX_N-01111-89180855,2024-07-29T11:40:19,Labastida,expenses,clothing,-79.78,-45126.04
buyer_8,Antonio,45,ES07209546103281907066,TRX_N-01112-61223112,2024-07-30T10:04:18,Labastida,expenses,food,-108.58,-45234.62
buyer_8,Antonio,45,ES07209546103281907066,TRX_N-01113-69271033,2024-07-31T11:07:52,Labastida,expenses,leisure,-56.91,-45291.53
buyer_8,Antonio,45,ES07209546103281907066,TRX_N-01114-13659507,2024-07-31T15:34:38,Labastida,expenses,cash,-100.0,-45391.53
buyer_8,Antonio,45,ES07209546103281907066,TRX_N-01115-70739253,2024-08-01T03:55:13,Labastida,incomes,salary,1472.3,-43919.23
buyer_8,Antonio,45,ES07209546103281907066,TRX_N-01116-05016014,2024-08-01T03:55:13,Labastida,incomes,salary_partner,1656.16,-42263.07
buyer_8,Antonio,45,ES07209546103281907066,TRX_N-01117-64903151,2024-08-01T14:31:48,Labastida,expenses,transport,-82.55,-42345.62
buyer_8,Antonio,45,ES07209546103281907066,TRX_N-01118-52592550,2024-08-03T20:29:57,Labastida,expenses,education,-56.83,-42402.45
buyer_8,Antonio,45,ES07209546103281907066,TRX_N-01119-91812813,2024-08-04T10:41:13,Labastida,expenses,mortgage,-970.96,-43373.41
buyer_8,Antonio,45,ES07209546103281907066,TRX_N-01120-76543460,2024-08-05T16:19:08,Labastida,expenses,electricity,-52.03,-43425.44
buyer_8,Antonio,45,ES07209546103281907066,TRX_N-01121-41414123,2024-08-05T20:49:35,Labastida,expenses,gas,-46.82,-43472.26
buyer_8,Antonio,45,ES07209546103281907066,TRX_N-01122-20209874,2024-08-05T04:13:03,Labastida,expenses,internet,-42.0,-43514.26
buyer_8,Antonio,45,ES07209546103281907066,TRX_N-01123-33774854,2024-08-05T23:25:45,Labastida,expenses,phone,-41.35,-43555.61
buyer_8,Antonio,45,ES07209546103281907066,TRX_N-01124-60759175,2024-08-07T17:08:09,Bilbao,expenses,leisure,-75.96,-43631.57
buyer_8,Antonio,45,ES07209546103281907066,TRX_N-01125-31260760,2024-08-07T16:50:21,Labastida,expenses,children,-61.64,-43693.21
buyer_8,Antonio,45,ES07209546103281907066,TRX_N-01126-33961961,2024-08-08T11:34:46,Labastida,expenses,water,-30.17,-43723.38
buyer_8,Antonio,45,ES07209546103281907066,TRX_N-01127-75530973,2024-08-08T17:55:02,Labastida,expenses,food,-96.78,-43820.16
buyer_8,Antonio,45,ES07209546103281907066,TRX_N-01128-05576488,2024-08-08T14:03:05,Labastida,expenses,healthcare,-128.23,-43948.39
buyer_8,Antonio,45,ES07209546103281907066,TRX_N-01129-34692150,2024-08-10T09:38:05,Labastida,expenses,cash,-100.0,-44048.39
buyer_8,Antonio,45,ES07209546103281907066,TRX_N-01130-62167987,2024-08-11T11:27:56,Labastida,expenses,cash,-100.0,-44148.39
buyer_8,Antonio,45,ES07209546103281907066,TRX_N-01131-71921639,2024-08-11T15:32:35,Labastida,expenses,children,-264.31,-44412.7
buyer_8,Antonio,45,ES07209546103281907066,TRX_N-01132-07869352,2024-08-14T15:47:45,Labastida,expenses,children,-129.96,-44542.66
buyer_8,Antonio,45,ES07209546103281907066,TRX_N-01133-92920265,2024-08-16T20:13:09,Labastida,expenses,leisure,-35.12,-44577.78
buyer_8,Antonio,45,ES07209546103281907066,TRX_N-01134-90550787,2024-08-16T18:55:04,Labastida,expenses,travel,-971.88,-45549.66
buyer_8,Antonio,45,ES07209546103281907066,TRX_N-01135-15308765,2024-08-17T15:36:25,Labastida,expenses,appliances,-150.92,-45700.58
buyer_8,Antonio,45,ES07209546103281907066,TRX_N-01136-85638076,2024-08-18T20:50:06,Labastida,expenses,transport,-84.04,-45784.62
buyer_8,Antonio,45,ES07209546103281907066,TRX_N-01137-22030137,2024-08-20T19:47:40,Oyón-Oion,expenses,cash,-100.0,-45884.62
buyer_8,Antonio,45,ES07209546103281907066,TRX_N-01138-32815767,2024-08-21T13:05:21,Mungia,expenses,education,-66.16,-45950.78
buyer_8,Antonio,45,ES07209546103281907066,TRX_N-01139-20501719,2024-08-21T22:29:47,Labastida,expenses,cash,-100.0,-46050.78
buyer_8,Antonio,45,ES07209546103281907066,TRX_N-01140-97298232,2024-08-22T22:02:42,Labastida,expenses,gifts,-323.06,-46373.84
buyer_8,Antonio,45,ES07209546103281907066,TRX_N-01141-63799902,2024-08-25T06:41:46,Berango,expenses,leisure,-80.79,-46454.63
buyer_8,Antonio,45,ES07209546103281907066,TRX_N-01142-30022453,2024-08-26T09:35:10,Labastida,expenses,food,-114.53,-46569.16
buyer_8,Antonio,45,ES07209546103281907066,TRX_N-01143-99083015,2024-08-26T16:09:27,Labastida,expenses,leisure,-80.48,-46649.64
buyer_8,Antonio,45,ES07209546103281907066,TRX_N-01144-11519161,2024-08-27T16:17:25,Arrasate,expenses,cash,-100.0,-46749.64
buyer_8,Antonio,45,ES07209546103281907066,TRX_N-01145-26907476,2024-08-28T19:27:35,Labastida,expenses,repairs,-71.93,-46821.57
buyer_8,Antonio,45,ES07209546103281907066,TRX_N-01146-66867797,2024-08-29T13:21:23,Zuia,expenses,cash,-100.0,-46921.57
buyer_8,Antonio,45,ES07209546103281907066,TRX_N-01147-74698570,2024-08-30T21:58:34,Labastida,expenses,food,-87.52,-47009.09
buyer_8,Antonio,45,ES07209546103281907066,TRX_N-01148-55172821,2024-08-30T19:10:38,Labastida,expenses,clothing,-83.82,-47092.91
buyer_8,Antonio,45,ES07209546103281907066,TRX_N-01149-06577864,2024-08-30T21:24:03,Labastida,expenses,cash,-100.0,-47192.91
buyer_8,Antonio,45,ES07209546103281907066,TRX_N-01150-61667419,2024-08-31T14:21:34,Labastida,expenses,cash,-100.0,-47292.91
buyer_8,Antonio,45,ES07209546103281907066,TRX_N-01151-28353036,2024-09-01T17:12:13,Labastida,incomes,salary,1472.3,-45820.61
buyer_8,Antonio,45,ES07209546103281907066,TRX_N-01152-94619944,2024-09-01T17:12:13,Labastida,incomes,salary_partner,1656.16,-44164.45
buyer_8,Antonio,45,ES07209546103281907066,TRX_N-01153-37406604,2024-09-01T09:09:02,Labastida,expenses,food,-109.97,-44274.42
buyer_8,Antonio,45,ES07209546103281907066,TRX_N-01154-11229581,2024-09-01T14:26:01,Labastida,expenses,cash,-100.0,-44374.42
buyer_8,Antonio,45,ES07209546103281907066,TRX_N-01155-47970930,2024-09-03T14:30:36,Labastida,expenses,leisure,-68.42,-44442.84
buyer_8,Antonio,45,ES07209546103281907066,TRX_N-01156-26358836,2024-09-03T20:03:54,Labastida,expenses,cash,-100.0,-44542.84
buyer_8,Antonio,45,ES07209546103281907066,TRX_N-01157-57321710,2024-09-03T19:18:49,Labastida,expenses,gifts,-481.72,-45024.56
buyer_8,Antonio,45,ES07209546103281907066,TRX_N-01158-19353548,2024-09-04T12:47:06,Labastida,expenses,mortgage,-970.96,-45995.52
buyer_8,Antonio,45,ES07209546103281907066,TRX_N-01159-60449922,2024-09-05T08:49:43,Labastida,expenses,electricity,-60.58,-46056.1
buyer_8,Antonio,45,ES07209546103281907066,TRX_N-01160-18960106,2024-09-05T13:00:24,Labastida,expenses,phone,-42.23,-46098.33
buyer_8,Antonio,45,ES07209546103281907066,TRX_N-01161-58311080,2024-09-06T19:50:36,Labastida,expenses,internet,-42.0,-46140.33
buyer_8,Antonio,45,ES07209546103281907066,TRX_N-01162-68349575,2024-09-07T12:39:40,Labastida,expenses,gas,-73.66,-46213.99
buyer_8,Antonio,45,ES07209546103281907066,TRX_N-01163-77745530,2024-09-07T16:48:28,Labastida,expenses,food,-101.12,-46315.11
buyer_8,Antonio,45,ES07209546103281907066,TRX_N-01164-29199720,2024-09-08T05:38:55,Labastida,expenses,water,-23.6,-46338.71
buyer_8,Antonio,45,ES07209546103281907066,TRX_N-01165-73200378,2024-09-09T19:58:25,Labastida,expenses,transport,-70.05,-46408.76
buyer_8,Antonio,45,ES07209546103281907066,TRX_N-01166-23208345,2024-09-10T08:57:19,Labastida,expenses,children,-202.02,-46610.78
buyer_8,Antonio,45,ES07209546103281907066,TRX_N-01167-25143536,2024-09-11T14:07:09,Labastida,expenses,food,-86.53,-46697.31
buyer_8,Antonio,45,ES07209546103281907066,TRX_N-01168-39547347,2024-09-11T16:11:46,Labastida,expenses,education,-61.57,-46758.88
buyer_8,Antonio,45,ES07209546103281907066,TRX_N-01169-11333360,2024-09-14T11:41:37,Labastida,expenses,cash,-100.0,-46858.88
buyer_8,Antonio,45,ES07209546103281907066,TRX_N-01170-59350871,2024-09-14T05:50:29,Labastida,expenses,repairs,-77.44,-46936.32
buyer_8,Antonio,45,ES07209546103281907066,TRX_N-01171-38854361,2024-09-18T12:02:18,Labastida,expenses,appliances,-364.91,-47301.23
buyer_8,Antonio,45,ES07209546103281907066,TRX_N-01172-99189246,2024-09-20T15:01:47,Labastida,expenses,leisure,-23.48,-47324.71
buyer_8,Antonio,45,ES07209546103281907066,TRX_N-01173-53251438,2024-09-21T22:47:11,Labastida,expenses,food,-109.34,-47434.05
buyer_8,Antonio,45,ES07209546103281907066,TRX_N-01174-33007605,2024-09-21T15:26:24,Labastida,expenses,leisure,-26.64,-47460.69
buyer_8,Antonio,45,ES07209546103281907066,TRX_N-01175-37622737,2024-09-22T13:31:10,Labastida,expenses,food,-62.95,-47523.64
buyer_8,Antonio,45,ES07209546103281907066,TRX_N-01176-39946041,2024-09-22T08:23:21,Labastida,expenses,education,-58.04,-47581.68
buyer_8,Antonio,45,ES07209546103281907066,TRX_N-01177-04487998,2024-09-24T10:11:56,Labastida,expenses,food,-70.61,-47652.29
buyer_8,Antonio,45,ES07209546103281907066,TRX_N-01178-81352160,2024-09-24T04:48:37,Labastida,expenses,cash,-100.0,-47752.29
buyer_8,Antonio,45,ES07209546103281907066,TRX_N-01179-34796967,2024-09-27T10:02:25,Labastida,expenses,leisure,-41.12,-47793.41
buyer_8,Antonio,45,ES07209546103281907066,TRX_N-01180-63606087,2024-09-27T11:09:10,Labastida,expenses,cash,-100.0,-47893.41
buyer_8,Antonio,45,ES07209546103281907066,TRX_N-01181-53852668,2024-09-29T19:55:34,Labastida,expenses,food,-78.71,-47972.12
buyer_8,Antonio,45,ES07209546103281907066,TRX_N-01182-82458951,2024-09-29T18:42:20,Labastida,expenses,transport,-65.27,-48037.39
buyer_8,Antonio,45,ES07209546103281907066,TRX_N-01183-66947781,2024-09-30T14:27:11,Labastida,expenses,leisure,-49.95,-48087.34
buyer_8,Antonio,45,ES07209546103281907066,TRX_N-01184-51600748,2024-10-01T14:49:42,Labastida,incomes,salary,1472.3,-46615.04
buyer_8,Antonio,45,ES07209546103281907066,TRX_N-01185-39976073,2024-10-01T14:49:42,Labastida,incomes,salary_partner,1656.16,-44958.88
buyer_8,Antonio,45,ES07209546103281907066,TRX_N-01186-99615613,2024-10-01T14:49:42,Labastida,incomes,extra_income,153.76,-44805.12
buyer_8,Antonio,45,ES07209546103281907066,TRX_N-01187-75974714,2024-10-01T19:52:33,Labastida,expenses,food,-70.79,-44875.91
buyer_8,Antonio,45,ES07209546103281907066,TRX_N-01188-73867582,2024-10-03T10:49:02,Labastida,expenses,repairs,-188.35,-45064.26
buyer_8,Antonio,45,ES07209546103281907066,TRX_N-01189-70165646,2024-10-04T18:10:25,Labastida,expenses,mortgage,-970.96,-46035.22
buyer_8,Antonio,45,ES07209546103281907066,TRX_N-01190-97138388,2024-10-04T10:34:54,Labastida,expenses,leisure,-47.86,-46083.08
buyer_8,Antonio,45,ES07209546103281907066,TRX_N-01191-78109714,2024-10-04T20:01:50,Labastida,expenses,cash,-100.0,-46183.08
buyer_8,Antonio,45,ES07209546103281907066,TRX_N-01192-02547087,2024-10-04T16:22:55,Labastida,expenses,repairs,-329.37,-46512.45
buyer_8,Antonio,45,ES07209546103281907066,TRX_N-01193-52720076,2024-10-05T08:40:50,Labastida,expenses,clothing,-78.62,-46591.07
buyer_8,Antonio,45,ES07209546103281907066,TRX_N-01194-61200426,2024-10-07T18:15:10,Labastida,expenses,water,-27.72,-46618.79
buyer_8,Antonio,45,ES07209546103281907066,TRX_N-01195-79553180,2024-10-07T14:31:55,Labastida,expenses,phone,-42.26,-46661.05
buyer_8,Antonio,45,ES07209546103281907066,TRX_N-01196-91877351,2024-10-07T09:42:39,Labastida,expenses,leisure,-36.39,-46697.44
buyer_8,Antonio,45,ES07209546103281907066,TRX_N-01197-63527439,2024-10-07T08:15:09,Labastida,expenses,appliances,-227.6,-46925.04
buyer_8,Antonio,45,ES07209546103281907066,TRX_N-01198-96795241,2024-10-08T17:18:11,Labastida,expenses,electricity,-70.48,-46995.52
buyer_8,Antonio,45,ES07209546103281907066,TRX_N-01199-20055848,2024-10-08T16:49:49,Labastida,expenses,gas,-59.83,-47055.35
buyer_8,Antonio,45,ES07209546103281907066,TRX_N-01200-81180417,2024-10-08T13:34:11,Labastida,expenses,internet,-42.0,-47097.35
buyer_8,Antonio,45,ES07209546103281907066,TRX_N-01201-03908273,2024-10-08T14:19:55,Amurrio,expenses,cash,-100.0,-47197.35
