profile,name,age,iban,trx_id,timestamp,city,trx_type,trx_cat,amount_eur,balance
buyer_1,Luis,28,ES78209545511493038850,TRX_N-00001-32997603,2022-01-01T16:21:39,Bilbao,incomes,salary,1240.21,3149.43
buyer_1,Luis,28,ES78209545511493038850,TRX_N-00002-38250233,2022-01-01T16:21:39,Bilbao,incomes,salary_partner,1539.34,4688.77
buyer_1,Luis,28,ES78209545511493038850,TRX_N-00003-05039609,2022-01-04T17:32:46,Bilbao,expenses,mortgage,-974.82,3713.95
buyer_1,Luis,28,ES78209545511493038850,TRX_N-00004-47687257,2022-01-04T00:32:54,Bilbao,Expense,leisure,-63.44,3650.51
buyer_1,Luis,28,ES78209545511493038850,TRX_N-00005-36020534,2022-01-05T17:42:09,Bilbao,expenses,internet,-42.0,3608.51
buyer_1,Luis,28,ES78209545511493038850,TRX_N-00006-29835997,2022-01-05T15:57:49,Barakaldo,Expense,food,-94.49,3514.02
buyer_1,Luis,28,ES78209545511493038850,TRX_N-00007-37291222,2022-01-06T20:20:34,Bilbao,expenses,electricity,-23.22,3490.8
buyer_1,Luis,28,ES78209545511493038850,TRX_N-00008-19857078,2022-01-06T09:32:57,Bilbao,Expense,transport,-44.4,3446.4
buyer_1,Luis,28,ES78209545511493038850,TRX_N-00009-44192416,2022-01-07T15:26:08,Bilbao,Expense,repairs,-212.36,3234.04
buyer_1,Luis,28,ES78209545511493038850,TRX_N-00010-90330295,2022-01-08T19:44:32,Bilbao,expenses,water,-44.25,3189.79
buyer_1,Luis,28,ES78209545511493038850,TRX_N-00011-94653900,2022-01-08T18:27:47,Bilbao,expenses,gas,-68.78,3121.01
buyer_1,Luis,28,ES78209545511493038850,TRX_N-00012-25444039,2022-01-08T20:07:26,Bilbao,expenses,phone,-30.58,3090.43
buyer_1,Luis,28,ES78209545511493038850,TRX_N-00013-85107880,2022-01-08T20:32:42,Bilbao,Expense,transport,-74.06,3016.37
buyer_1,Luis,28,ES78209545511493038850,TRX_N-00014-67063365,2022-01-10T22:45:38,Bilbao,Expense,food,-78.52,2937.85
buyer_1,Luis,28,ES78209545511493038850,TRX_N-00015-72588821,2022-01-10T21:49:59,Bilbao,Expense,cash,-100.0,2837.85
buyer_1,Luis,28,ES78209545511493038850,TRX_N-00016-18866379,2022-01-10T12:33:09,Bilbao,expenses,children,-50.96,2786.89
buyer_1,Luis,28,ES78209545511493038850,TRX_N-00017-87913939,2022-01-12T17:49:43,Bilbao,Expense,cash,-100.0,2686.89
buyer_1,Luis,28,ES78209545511493038850,TRX_N-00018-73438512,2022-01-13T18:58:14,Bilbao,Expense,food,-113.97,2572.92
buyer_1,Luis,28,ES78209545511493038850,TRX_N-00019-10781330,2022-01-13T19:56:14,Bilbao,Expense,leisure,-28.75,2544.17
buyer_1,Luis,28,ES78209545511493038850,TRX_N-00020-69485317,2022-01-13T22:11:34,Bilbao,Expense,clothing,-105.93,2438.24
buyer_1,Luis,28,ES78209545511493038850,TRX_N-00021-70308425,2022-01-14T11:36:46,Bilbao,expenses,children,-156.01,2282.23
buyer_1,Luis,28,ES78209545511493038850,TRX_N-00022-65350119,2022-01-15T01:49:43,Bilbao,Expense,cash,-100.0,2182.23
buyer_1,Luis,28,ES78209545511493038850,TRX_N-00023-24229081,2022-01-17T12:44:51,Bilbao,Expense,leisure,-27.28,2154.95
buyer_1,Luis,28,ES78209545511493038850,TRX_N-00024-46706193,2022-01-17T21:14:51,Bilbao,Expense,repairs,-28.89,2126.06
buyer_1,Luis,28,ES78209545511493038850,TRX_N-00025-44282440,2022-01-19T00:09:38,Barakaldo,Expense,food,-123.8,2002.26
buyer_1,Luis,28,ES78209545511493038850,TRX_N-00026-24159836,2022-01-19T14:35:55,Bilbao,Expense,appliances,-350.66,1651.6
buyer_1,Luis,28,ES78209545511493038850,TRX_N-00027-73425180,2022-01-20T14:02:26,Bilbao,Expense,food,-101.85,1549.75
buyer_1,Luis,28,ES78209545511493038850,TRX_N-00028-17933210,2022-01-22T09:02:29,Arrasate,Expense,repairs,-312.99,1236.76
buyer_1,Luis,28,ES78209545511493038850,TRX_N-00029-37557237,2022-01-23T09:58:18,Erandio,Expense,food,-105.81,1130.95
buyer_1,Luis,28,ES78209545511493038850,TRX_N-00030-58037518,2022-01-23T23:31:11,Bilbao,expenses,children,-185.62,945.33
buyer_1,Luis,28,ES78209545511493038850,TRX_N-00031-03509825,2022-01-24T07:38:09,Bilbao,Expense,food,-70.44,874.89
buyer_1,Luis,28,ES78209545511493038850,TRX_N-00032-60183454,2022-01-26T12:15:18,Bilbao,Expense,food,-100.23,774.66
buyer_1,Luis,28,ES78209545511493038850,TRX_N-00033-57350013,2022-01-27T09:50:58,Bilbao,Expense,gifts,-805.35,-30.69
buyer_1,Luis,28,ES78209545511493038850,TRX_N-00034-56901050,2022-01-29T09:54:07,Santurtzi,Expense,repairs,-216.31,-247.0
buyer_1,Luis,28,ES78209545511493038850,TRX_N-00035-94146321,2022-01-30T12:06:06,Bilbao,Expense,cash,-100.0,-347.0
buyer_1,Luis,28,ES78209545511493038850,TRX_N-00036-32963781,2022-01-31T09:13:13,Bilbao,Expense,leisure,-79.82,-426.82
buyer_1,Luis,28,ES78209545511493038850,TRX_N-00037-50595689,2022-02-01T17:41:29,Bilbao,incomes,salary,1240.21,813.39
buyer_1,Luis,28,ES78209545511493038850,TRX_N-00038-96784900,2022-02-01T17:41:29,Bilbao,incomes,salary_partner,1539.34,2352.73
buyer_1,Luis,28,ES78209545511493038850,TRX_N-00039-12002894,2022-02-02T09:57:46,Bilbao,Expense,repairs,-54.52,2298.21
buyer_1,Luis,28,ES78209545511493038850,TRX_N-00040-77504042,2022-02-04T14:23:21,Bilbao,expenses,mortgage,-974.82,1323.39
buyer_1,Luis,28,ES78209545511493038850,TRX_N-00041-63446017,2022-02-05T20:50:23,Bilbao,Expense,clothing,-132.62,1190.77
buyer_1,Luis,28,ES78209545511493038850,TRX_N-00042-79633442,2022-02-05T13:38:31,Bilbao,Expense,repairs,-220.23,970.54
buyer_1,Luis,28,ES78209545511493038850,TRX_N-00043-22878337,2022-02-05T08:23:05,Salvatierra/Agurain,Expense,gifts,-707.25,263.29
buyer_1,Luis,28,ES78209545511493038850,TRX_N-00044-49894309,2022-02-06T09:35:53,Bilbao,expenses,water,-40.62,222.67
buyer_1,Luis,28,ES78209545511493038850,TRX_N-00045-97944805,2022-02-06T22:36:30,Bilbao,expenses,phone,-40.16,182.51
buyer_1,Luis,28,ES78209545511493038850,TRX_N-00046-70976820,2022-02-06T09:23:57,Portugalete,Expense,transport,-86.55,95.96
buyer_1,Luis,28,ES78209545511493038850,TRX_N-00047-55543010,2022-02-06T16:02:51,Bilbao,Expense,cash,-100.0,-4.04
buyer_1,Luis,28,ES78209545511493038850,TRX_N-00048-60351808,2022-02-07T18:02:50,Bilbao,Expense,food,-113.12,-117.16
buyer_1,Luis,28,ES78209545511493038850,TRX_N-00049-41846829,2022-02-08T09:02:24,Bilbao,expenses,electricity,-48.71,-165.87
buyer_1,Luis,28,ES78209545511493038850,TRX_N-00050-74825842,2022-02-08T15:27:52,Bilbao,expenses,gas,-73.1,-238.97
buyer_1,Luis,28,ES78209545511493038850,TRX_N-00051-31149399,2022-02-08T10:56:10,Bilbao,expenses,internet,-42.0,-280.97
buyer_1,Luis,28,ES78209545511493038850,TRX_N-00052-92559297,2022-02-08T18:32:35,Bilbao,Expense,leisure,-45.37,-326.34
buyer_1,Luis,28,ES78209545511493038850,TRX_N-00053-84624458,2022-02-09T09:57:55,Durango,Expense,food,-68.66,-395.0
buyer_1,Luis,28,ES78209545511493038850,TRX_N-00054-15959706,2022-02-09T17:05:17,Amurrio,Expense,leisure,-50.5,-445.5
buyer_1,Luis,28,ES78209545511493038850,TRX_N-00055-24425965,2022-02-09T12:42:38,Bilbao,Expense,cash,-100.0,-545.5
buyer_1,Luis,28,ES78209545511493038850,TRX_N-00056-12506216,2022-02-11T14:24:20,Bilbao,Expense,cash,-100.0,-645.5
buyer_1,Luis,28,ES78209545511493038850,TRX_N-00057-17469179,2022-02-14T23:40:02,Bilbao,Expense,cash,-100.0,-745.5
buyer_1,Luis,28,ES78209545511493038850,TRX_N-00058-11063344,2022-02-15T18:41:50,Bilbao,Expense,repairs,-142.96,-888.46
buyer_1,Luis,28,ES78209545511493038850,TRX_N-00059-56173401,2022-02-16T19:46:20,Bilbao,Expense,transport,-80.23,-968.69
buyer_1,Luis,28,ES78209545511493038850,TRX_N-00060-83465318,2022-02-16T12:00:34,Bilbao,Expense,cash,-100.0,-1068.69
buyer_1,Luis,28,ES78209545511493038850,TRX_N-00061-88379471,2022-02-17T08:44:11,Bilbao,Expense,food,-106.91,-1175.6
buyer_1,Luis,28,ES78209545511493038850,TRX_N-00062-94436196,2022-02-17T14:57:28,Bilbao,Expense,cash,-100.0,-1275.6
buyer_1,Luis,28,ES78209545511493038850,TRX_N-00063-15057766,2022-02-18T16:50:00,Bilbao,Expense,cash,-100.0,-1375.6
buyer_1,Luis,28,ES78209545511493038850,TRX_N-00064-27290599,2022-02-20T20:24:15,Bilbao,Expense,cash,-100.0,-1475.6
buyer_1,Luis,28,ES78209545511493038850,TRX_N-00065-64226819,2022-02-23T03:12:29,Bilbao,Expense,cash,-100.0,-1575.6
buyer_1,Luis,28,ES78209545511493038850,TRX_N-00066-14353096,2022-02-23T13:28:21,Salvatierra/Agurain,Expense,gifts,-665.93,-2241.53
buyer_1,Luis,28,ES78209545511493038850,TRX_N-00067-64501880,2022-02-26T09:38:28,Andoain,Expense,transport,-49.01,-2290.54
buyer_1,Luis,28,ES78209545511493038850,TRX_N-00068-67538609,2022-02-28T03:58:45,Bilbao,Expense,transport,-68.24,-2358.78
buyer_1,Luis,28,ES78209545511493038850,TRX_N-00069-27499077,2022-02-28T15:39:23,Bilbao,Expense,education,-74.0,-2432.78
buyer_1,Luis,28,ES78209545511493038850,TRX_N-00070-80421604,2022-02-28T09:31:13,Bilbao,Expense,appliances,-338.38,-2771.16
buyer_1,Luis,28,ES78209545511493038850,TRX_N-00071-58869796,2022-03-01T13:12:54,Bilbao,incomes,salary,1240.21,-1530.95
buyer_1,Luis,28,ES78209545511493038850,TRX_N-00072-37498635,2022-03-01T13:12:54,Bilbao,incomes,salary_partner,1539.34,8.39
buyer_1,Luis,28,ES78209545511493038850,TRX_N-00073-55893777,2022-03-01T03:54:08,Bilbao,Expense,clothing,-90.76,-82.37
buyer_1,Luis,28,ES78209545511493038850,TRX_N-00074-86804324,2022-03-03T10:17:47,Bilbao,Expense,leisure,-48.4,-130.77
buyer_1,Luis,28,ES78209545511493038850,TRX_N-00075-32209043,2022-03-03T09:17:22,Bilbao,Expense,cash,-100.0,-230.77
buyer_1,Luis,28,ES78209545511493038850,TRX_N-00076-91351347,2022-03-04T09:33:56,Bilbao,expenses,mortgage,-974.82,-1205.59
buyer_1,Luis,28,ES78209545511493038850,TRX_N-00077-63206498,2022-03-05T20:11:18,Bilbao,expenses,electricity,-71.75,-1277.34
buyer_1,Luis,28,ES78209545511493038850,TRX_N-00078-52702543,2022-03-05T15:25:44,Bilbao,expenses,phone,-41.39,-1318.73
buyer_1,Luis,28,ES78209545511493038850,TRX_N-00079-20524292,2022-03-05T17:31:08,Bilbao,Expense,leisure,-23.2,-1341.93
buyer_1,Luis,28,ES78209545511493038850,TRX_N-00080-70691642,2022-03-05T06:00:11,Bilbao,Expense,education,-72.99,-1414.92
buyer_1,Luis,28,ES78209545511493038850,TRX_N-00081-46972985,2022-03-06T14:45:44,Bilbao,expenses,water,-26.91,-1441.83
buyer_1,Luis,28,ES78209545511493038850,TRX_N-00082-76356762,2022-03-06T11:43:05,Bilbao,expenses,gas,-55.17,-1497.0
buyer_1,Luis,28,ES78209545511493038850,TRX_N-00083-92532671,2022-03-06T10:26:02,Sopela,Expense,leisure,-61.12,-1558.12
buyer_1,Luis,28,ES78209545511493038850,TRX_N-00084-90460497,2022-03-06T16:29:44,Oyón-Oion,Expense,cash,-100.0,-1658.12
buyer_1,Luis,28,ES78209545511493038850,TRX_N-00085-39858554,2022-03-07T09:16:29,Hernani,Expense,appliances,-329.57,-1987.69
buyer_1,Luis,28,ES78209545511493038850,TRX_N-00086-31145879,2022-03-08T08:38:58,Bilbao,expenses,internet,-42.0,-2029.69
buyer_1,Luis,28,ES78209545511493038850,TRX_N-00087-51959650,2022-03-08T09:00:18,Bilbao,Expense,cash,-100.0,-2129.69
buyer_1,Luis,28,ES78209545511493038850,TRX_N-00088-05654933,2022-03-09T11:14:09,Bilbao,expenses,children,-191.06,-2320.75
buyer_1,Luis,28,ES78209545511493038850,TRX_N-00089-15757509,2022-03-10T15:15:34,Bilbao,expenses,children,-175.65,-2496.4
buyer_1,Luis,28,ES78209545511493038850,TRX_N-00090-25125886,2022-03-11T10:37:48,Bilbao,Expense,food,-64.59,-2560.99
buyer_1,Luis,28,ES78209545511493038850,TRX_N-00091-37438058,2022-03-11T19:09:35,Llodio,Expense,clothing,-142.36,-2703.35
buyer_1,Luis,28,ES78209545511493038850,TRX_N-00092-64407426,2022-03-11T19:17:18,Bilbao,Expense,cash,-100.0,-2803.35
buyer_1,Luis,28,ES78209545511493038850,TRX_N-00093-23986991,2022-03-13T18:21:58,Bilbao,Expense,transport,-70.92,-2874.27
buyer_1,Luis,28,ES78209545511493038850,TRX_N-00094-99234768,2022-03-13T10:31:15,Bilbao,Expense,repairs,-332.59,-3206.86
buyer_1,Luis,28,ES78209545511493038850,TRX_N-00095-19263138,2022-03-14T09:21:46,Iruña de Oca,Expense,leisure,-75.17,-3282.03
buyer_1,Luis,28,ES78209545511493038850,TRX_N-00096-78427420,2022-03-15T15:01:14,Bilbao,Expense,education,-64.72,-3346.75
buyer_1,Luis,28,ES78209545511493038850,TRX_N-00097-54196640,2022-03-18T11:00:48,Bilbao,Expense,healthcare,-156.85,-3503.6
buyer_1,Luis,28,ES78209545511493038850,TRX_N-00098-11597619,2022-03-19T13:27:06,Bilbao,Expense,transport,-66.28,-3569.88
buyer_1,Luis,28,ES78209545511493038850,TRX_N-00099-85309022,2022-03-21T13:18:58,Bilbao,Expense,education,-45.72,-3615.6
buyer_1,Luis,28,ES78209545511493038850,TRX_N-00100-39193494,2022-03-21T02:30:35,Bilbao,Expense,cash,-100.0,-3715.6
buyer_1,Luis,28,ES78209545511493038850,TRX_N-00101-22370932,2022-03-23T12:11:31,Barakaldo,Expense,cash,-100.0,-3815.6
buyer_1,Luis,28,ES78209545511493038850,TRX_N-00102-10981800,2022-03-24T11:13:54,Bilbao,Expense,clothing,-108.65,-3924.25
buyer_1,Luis,28,ES78209545511493038850,TRX_N-00103-02146657,2022-03-24T08:38:01,Bilbao,Expense,cash,-100.0,-4024.25
buyer_1,Luis,28,ES78209545511493038850,TRX_N-00104-78010162,2022-03-26T13:35:53,Bilbao,Expense,leisure,-39.31,-4063.56
buyer_1,Luis,28,ES78209545511493038850,TRX_N-00105-60488032,2022-03-28T10:20:52,Bilbao,Expense,healthcare,-99.83,-4163.39
buyer_1,Luis,28,ES78209545511493038850,TRX_N-00106-49217306,2022-03-31T19:19:18,Galdakao,Expense,food,-89.39,-4252.78
buyer_1,Luis,28,ES78209545511493038850,TRX_N-00107-53173511,2022-03-31T19:45:08,Bilbao,Expense,education,-54.05,-4306.83
buyer_1,Luis,28,ES78209545511493038850,TRX_N-00108-76662524,2022-04-01T21:20:08,Bilbao,incomes,salary,1240.21,-3066.62
buyer_1,Luis,28,ES78209545511493038850,TRX_N-00109-42491573,2022-04-01T21:20:08,Bilbao,incomes,salary_partner,1539.34,-1527.28
buyer_1,Luis,28,ES78209545511493038850,TRX_N-00110-57397836,2022-04-01T21:20:08,Bilbao,incomes,extra_income,207.12,-1320.16
buyer_1,Luis,28,ES78209545511493038850,TRX_N-00111-58039727,2022-04-01T17:48:06,Bilbao,Expense,healthcare,-136.75,-1456.91
buyer_1,Luis,28,ES78209545511493038850,TRX_N-00112-19154803,2022-04-03T13:37:23,Eibar,Expense,food,-106.24,-1563.15
buyer_1,Luis,28,ES78209545511493038850,TRX_N-00113-41685867,2022-04-03T23:09:00,Bilbao,Expense,repairs,-43.29,-1606.44
buyer_1,Luis,28,ES78209545511493038850,TRX_N-00114-22708692,2022-04-04T13:11:54,Bilbao,expenses,mortgage,-974.82,-2581.26
buyer_1,Luis,28,ES78209545511493038850,TRX_N-00115-96471621,2022-04-04T18:54:41,Bilbao,Expense,travel,-1351.07,-3932.33
buyer_1,Luis,28,ES78209545511493038850,TRX_N-00116-01792970,2022-04-08T18:07:27,Bilbao,expenses,electricity,-87.28,-4019.61
buyer_1,Luis,28,ES78209545511493038850,TRX_N-00117-58377438,2022-04-08T19:44:08,Bilbao,expenses,gas,-54.9,-4074.51
buyer_1,Luis,28,ES78209545511493038850,TRX_N-00118-47833042,2022-04-08T19:38:08,Bilbao,expenses,water,-30.34,-4104.85
buyer_1,Luis,28,ES78209545511493038850,TRX_N-00119-95789820,2022-04-08T15:26:48,Bilbao,expenses,internet,-42.0,-4146.85
buyer_1,Luis,28,ES78209545511493038850,TRX_N-00120-43903701,2022-04-08T13:30:13,Bilbao,expenses,phone,-44.19,-4191.04
buyer_1,Luis,28,ES78209545511493038850,TRX_N-00121-24705099,2022-04-08T20:19:42,Bilbao,Expense,transport,-78.28,-4269.32
buyer_1,Luis,28,ES78209545511493038850,TRX_N-00122-11901168,2022-04-08T14:48:46,Bilbao,Expense,education,-74.18,-4343.5
buyer_1,Luis,28,ES78209545511493038850,TRX_N-00123-38749151,2022-04-08T08:25:20,Bilbao,expenses,children,-108.17,-4451.67
buyer_1,Luis,28,ES78209545511493038850,TRX_N-00124-09612301,2022-04-13T20:53:20,Bilbao,Expense,cash,-100.0,-4551.67
buyer_1,Luis,28,ES78209545511493038850,TRX_N-00125-16615639,2022-04-14T17:15:06,Bilbao,Expense,leisure,-56.76,-4608.43
buyer_1,Luis,28,ES78209545511493038850,TRX_N-00126-02306271,2022-04-14T10:19:50,Bilbao,Expense,cash,-100.0,-4708.43
buyer_1,Luis,28,ES78209545511493038850,TRX_N-00127-75267902,2022-04-14T09:40:42,Bilbao,expenses,children,-99.86,-4808.29
buyer_1,Luis,28,ES78209545511493038850,TRX_N-00128-87674328,2022-04-16T17:01:26,Bilbao,Expense,clothing,-123.77,-4932.06
buyer_1,Luis,28,ES78209545511493038850,TRX_N-00129-71778789,2022-04-17T08:58:42,Bilbao,Expense,repairs,-119.83,-5051.89
buyer_1,Luis,28,ES78209545511493038850,TRX_N-00130-08075618,2022-04-19T11:09:57,Bilbao,Expense,clothing,-105.62,-5157.51
buyer_1,Luis,28,ES78209545511493038850,TRX_N-00131-72824036,2022-04-19T14:31:33,Bermeo,Expense,education,-46.13,-5203.64
buyer_1,Luis,28,ES78209545511493038850,TRX_N-00132-15428147,2022-04-20T15:06:53,Barakaldo,Expense,transport,-71.11,-5274.75
buyer_1,Luis,28,ES78209545511493038850,TRX_N-00133-85795672,2022-04-24T09:04:42,Bilbao,Expense,leisure,-29.48,-5304.23
buyer_1,Luis,28,ES78209545511493038850,TRX_N-00134-92380945,2022-04-25T04:02:16,Bilbao,Expense,food,-96.24,-5400.47
buyer_1,Luis,28,ES78209545511493038850,TRX_N-00135-22681364,2022-04-27T08:52:01,Bilbao,Expense,food,-86.37,-5486.84
buyer_1,Luis,28,ES78209545511493038850,TRX_N-00136-05756262,2022-04-27T13:24:10,Bilbao,Expense,leisure,-78.94,-5565.78
buyer_1,Luis,28,ES78209545511493038850,TRX_N-00137-73438942,2022-04-27T14:37:30,Salvatierra/Agurain,Expense,repairs,-116.44,-5682.22
buyer_1,Luis,28,ES78209545511493038850,TRX_N-00138-89761800,2022-04-28T12:10:12,Bilbao,Expense,healthcare,-143.64,-5825.86
buyer_1,Luis,28,ES78209545511493038850,TRX_N-00139-18416179,2022-04-29T11:05:15,Bilbao,Expense,leisure,-57.22,-5883.08
buyer_1,Luis,28,ES78209545511493038850,TRX_N-00140-52222196,2022-05-01T16:12:02,Bilbao,incomes,salary,1240.21,-4642.87
buyer_1,Luis,28,ES78209545511493038850,TRX_N-00141-22154560,2022-05-01T16:12:02,Bilbao,incomes,salary_partner,1539.34,-3103.53
buyer_1,Luis,28,ES78209545511493038850,TRX_N-00142-95436752,2022-05-01T10:54:39,Zuia,Expense,cash,-100.0,-3203.53
buyer_1,Luis,28,ES78209545511493038850,TRX_N-00143-68528977,2022-05-03T11:00:13,Bilbao,Expense,appliances,-190.34,-3393.87
buyer_1,Luis,28,ES78209545511493038850,TRX_N-00144-71471413,2022-05-04T12:17:04,Bilbao,expenses,mortgage,-974.82,-4368.69
buyer_1,Luis,28,ES78209545511493038850,TRX_N-00145-19203437,2022-05-05T17:08:33,Bilbao,expenses,electricity,-84.61,-4453.3
buyer_1,Luis,28,ES78209545511493038850,TRX_N-00146-62627602,2022-05-06T09:02:13,Bilbao,expenses,phone,-35.52,-4488.82
buyer_1,Luis,28,ES78209545511493038850,TRX_N-00147-12181792,2022-05-07T10:46:38,Bilbao,expenses,gas,-57.87,-4546.69
buyer_1,Luis,28,ES78209545511493038850,TRX_N-00148-07787900,2022-05-08T17:23:21,Bilbao,expenses,water,-37.55,-4584.24
buyer_1,Luis,28,ES78209545511493038850,TRX_N-00149-47224770,2022-05-08T02:59:05,Bilbao,expenses,internet,-42.0,-4626.24
buyer_1,Luis,28,ES78209545511493038850,TRX_N-00150-73998274,2022-05-08T12:33:42,Bilbao,Expense,transport,-70.49,-4696.73
buyer_1,Luis,28,ES78209545511493038850,TRX_N-00151-72463810,2022-05-09T13:13:42,Bilbao,Expense,education,-61.86,-4758.59
buyer_1,Luis,28,ES78209545511493038850,TRX_N-00152-65166728,2022-05-09T16:38:23,Bilbao,Expense,cash,-100.0,-4858.59
buyer_1,Luis,28,ES78209545511493038850,TRX_N-00153-78546765,2022-05-11T16:29:19,Bilbao,expenses,children,-128.67,-4987.26
buyer_1,Luis,28,ES78209545511493038850,TRX_N-00154-23238694,2022-05-14T13:48:14,Bilbao,Expense,transport,-57.66,-5044.92
buyer_1,Luis,28,ES78209545511493038850,TRX_N-00155-02342225,2022-05-14T11:10:36,Bilbao,Expense,cash,-100.0,-5144.92
buyer_1,Luis,28,ES78209545511493038850,TRX_N-00156-86734530,2022-05-15T22:01:01,Salvatierra/Agurain,Expense,food,-86.16,-5231.08
buyer_1,Luis,28,ES78209545511493038850,TRX_N-00157-83289467,2022-05-16T08:56:03,Bilbao,Expense,travel,-484.32,-5715.4
buyer_1,Luis,28,ES78209545511493038850,TRX_N-00158-34128179,2022-05-17T18:08:27,Bilbao,Expense,cash,-100.0,-5815.4
buyer_1,Luis,28,ES78209545511493038850,TRX_N-00159-22627274,2022-05-17T22:19:11,Bilbao,Expense,repairs,-77.54,-5892.94
buyer_1,Luis,28,ES78209545511493038850,TRX_N-00160-25518015,2022-05-18T10:20:17,Vitoria-Gasteiz,Expense,food,-121.03,-6013.97
buyer_1,Luis,28,ES78209545511493038850,TRX_N-00161-61710490,2022-05-21T04:23:43,Bilbao,Expense,food,-123.14,-6137.11
buyer_1,Luis,28,ES78209545511493038850,TRX_N-00162-30476370,2022-05-22T13:06:29,Llodio,Expense,food,-123.3,-6260.41
buyer_1,Luis,28,ES78209545511493038850,TRX_N-00163-48448380,2022-05-24T15:54:02,Bilbao,Expense,repairs,-193.88,-6454.29
buyer_1,Luis,28,ES78209545511493038850,TRX_N-00164-83226768,2022-05-25T17:15:38,Bilbao,Expense,food,-60.13,-6514.42
buyer_1,Luis,28,ES78209545511493038850,TRX_N-00165-25505242,2022-05-25T16:35:09,Bilbao,Expense,cash,-100.0,-6614.42
buyer_1,Luis,28,ES78209545511493038850,TRX_N-00166-31617435,2022-05-27T19:51:47,Bilbao,Expense,travel,-1069.35,-7683.77
buyer_1,Luis,28,ES78209545511493038850,TRX_N-00167-89445206,2022-05-27T23:19:17,Bilbao,expenses,children,-61.33,-7745.1
buyer_1,Luis,28,ES78209545511493038850,TRX_N-00168-47200310,2022-05-28T11:05:13,Bilbao,Expense,transport,-45.82,-7790.92
buyer_1,Luis,28,ES78209545511493038850,TRX_N-00169-07995503,2022-05-31T08:58:42,Bilbao,Expense,cash,-100.0,-7890.92
buyer_1,Luis,28,ES78209545511493038850,TRX_N-00170-98818535,2022-06-01T08:11:10,Bilbao,incomes,salary,1240.21,-6650.71
buyer_1,Luis,28,ES78209545511493038850,TRX_N-00171-58322434,2022-06-01T08:11:10,Bilbao,incomes,salary_partner,1539.34,-5111.37
buyer_1,Luis,28,ES78209545511493038850,TRX_N-00172-51978878,2022-06-01T08:11:10,Bilbao,incomes,salary_bonus,906.31,-4205.06
buyer_1,Luis,28,ES78209545511493038850,TRX_N-00173-17037922,2022-06-01T08:11:10,Bilbao,incomes,salary_partner_bonus,1221.49,-2983.57
buyer_1,Luis,28,ES78209545511493038850,TRX_N-00174-08604214,2022-06-01T15:44:07,Bilbao,Expense,cash,-100.0,-3083.57
buyer_1,Luis,28,ES78209545511493038850,TRX_N-00175-52647234,2022-06-04T18:31:26,Bilbao,expenses,mortgage,-974.82,-4058.39
buyer_1,Luis,28,ES78209545511493038850,TRX_N-00176-25635778,2022-06-04T18:16:42,Bilbao,expenses,taxes,-1688.7,-5747.09
buyer_1,Luis,28,ES78209545511493038850,TRX_N-00177-25633821,2022-06-04T15:40:30,Bilbao,expenses,insurance,-545.54,-6292.63
buyer_1,Luis,28,ES78209545511493038850,TRX_N-00178-62695664,2022-06-05T18:46:36,Bilbao,expenses,gas,-73.63,-6366.26
buyer_1,Luis,28,ES78209545511493038850,TRX_N-00179-59024393,2022-06-05T16:25:37,Bilbao,expenses,phone,-36.38,-6402.64
buyer_1,Luis,28,ES78209545511493038850,TRX_N-00180-24938600,2022-06-05T08:02:01,Bilbao,Expense,healthcare,-181.9,-6584.54
buyer_1,Luis,28,ES78209545511493038850,TRX_N-00181-61773207,2022-06-06T04:55:36,Bilbao,Expense,transport,-42.72,-6627.26
buyer_1,Luis,28,ES78209545511493038850,TRX_N-00182-12857496,2022-06-08T20:32:21,Bilbao,expenses,water,-39.49,-6666.75
buyer_1,Luis,28,ES78209545511493038850,TRX_N-00183-59526413,2022-06-08T19:51:27,Bilbao,expenses,electricity,-78.94,-6745.69
buyer_1,Luis,28,ES78209545511493038850,TRX_N-00184-55797816,2022-06-08T18:17:53,Bilbao,expenses,internet,-42.0,-6787.69
buyer_1,Luis,28,ES78209545511493038850,TRX_N-00185-43410766,2022-06-10T09:06:16,Bilbao,Expense,leisure,-83.59,-6871.28
buyer_1,Luis,28,ES78209545511493038850,TRX_N-00186-43780829,2022-06-12T17:09:34,Bilbao,Expense,food,-89.13,-6960.41
buyer_1,Luis,28,ES78209545511493038850,TRX_N-00187-01676725,2022-06-14T11:36:36,Bilbao,Expense,education,-52.59,-7013.0
buyer_1,Luis,28,ES78209545511493038850,TRX_N-00188-48552391,2022-06-14T10:29:59,Bilbao,Expense,cash,-100.0,-7113.0
buyer_1,Luis,28,ES78209545511493038850,TRX_N-00189-44730075,2022-06-16T19:11:43,Bilbao,Expense,travel,-375.94,-7488.94
buyer_1,Luis,28,ES78209545511493038850,TRX_N-00190-53422919,2022-06-17T16:59:50,Eibar,Expense,food,-78.34,-7567.28
buyer_1,Luis,28,ES78209545511493038850,TRX_N-00191-53262112,2022-06-17T16:23:46,Bilbao,Expense,cash,-100.0,-7667.28
buyer_1,Luis,28,ES78209545511493038850,TRX_N-00192-73878400,2022-06-18T14:25:03,Bilbao,Expense,transport,-59.81,-7727.09
buyer_1,Luis,28,ES78209545511493038850,TRX_N-00193-60353058,2022-06-18T15:03:28,Bilbao,Expense,leisure,-22.26,-7749.35
buyer_1,Luis,28,ES78209545511493038850,TRX_N-00194-35093049,2022-06-19T15:28:51,Bilbao,Expense,healthcare,-110.04,-7859.39
buyer_1,Luis,28,ES78209545511493038850,TRX_N-00195-08704318,2022-06-19T05:47:03,Bilbao,Expense,cash,-100.0,-7959.39
buyer_1,Luis,28,ES78209545511493038850,TRX_N-00196-30238176,2022-06-25T13:32:59,Bilbao,Expense,food,-123.02,-8082.41
buyer_1,Luis,28,ES78209545511493038850,TRX_N-00197-80912557,2022-06-26T09:24:02,Bilbao,Expense,transport,-65.34,-8147.75
buyer_1,Luis,28,ES78209545511493038850,TRX_N-00198-57329287,2022-06-26T19:27:18,Galdakao,Expense,appliances,-172.59,-8320.34
buyer_1,Luis,28,ES78209545511493038850,TRX_N-00199-38111959,2022-06-27T06:56:59,Bilbao,Expense,healthcare,-180.22,-8500.56
buyer_1,Luis,28,ES78209545511493038850,TRX_N-00200-19994106,2022-06-28T12:13:44,Bilbao,Expense,clothing,-94.54,-8595.1
buyer_1,Luis,28,ES78209545511493038850,TRX_N-00201-06733076,2022-07-01T22:18:30,Bilbao,incomes,salary,1240.21,-7354.89
buyer_1,Luis,28,ES78209545511493038850,TRX_N-00202-36146455,2022-07-01T22:18:30,Bilbao,incomes,salary_partner,1539.34,-5815.55
buyer_1,Luis,28,ES78209545511493038850,TRX_N-00203-25125257,2022-07-01T17:53:37,Bilbao,Expense,cash,-100.0,-5915.55
buyer_1,Luis,28,ES78209545511493038850,TRX_N-00204-19915314,2022-07-02T10:12:36,Bilbao,Expense,repairs,-273.17,-6188.72
buyer_1,Luis,28,ES78209545511493038850,TRX_N-00205-12242466,2022-07-03T08:37:14,Andoain,Expense,education,-72.12,-6260.84
buyer_1,Luis,28,ES78209545511493038850,TRX_N-00206-81035445,2022-07-04T11:45:35,Bilbao,expenses,mortgage,-974.82,-7235.66
buyer_1,Luis,28,ES78209545511493038850,TRX_N-00207-53282933,2022-07-05T16:37:00,Bilbao,expenses,gas,-69.62,-7305.28
buyer_1,Luis,28,ES78209545511493038850,TRX_N-00208-31295630,2022-07-05T09:27:38,Bilbao,expenses,internet,-42.0,-7347.28
buyer_1,Luis,28,ES78209545511493038850,TRX_N-00209-53437633,2022-07-05T08:53:24,Bilbao,expenses,phone,-34.45,-7381.73
buyer_1,Luis,28,ES78209545511493038850,TRX_N-00210-61474686,2022-07-05T20:25:19,Bilbao,Expense,food,-124.12,-7505.85
buyer_1,Luis,28,ES78209545511493038850,TRX_N-00211-23360172,2022-07-06T11:58:40,Bilbao,expenses,water,-42.44,-7548.29
buyer_1,Luis,28,ES78209545511493038850,TRX_N-00212-41718849,2022-07-06T11:57:10,Bilbao,Expense,food,-92.86,-7641.15
buyer_1,Luis,28,ES78209545511493038850,TRX_N-00213-44804518,2022-07-06T22:45:11,Bilbao,Expense,appliances,-173.95,-7815.1
buyer_1,Luis,28,ES78209545511493038850,TRX_N-00214-77115740,2022-07-07T00:17:06,Bilbao,Expense,cash,-100.0,-7915.1
buyer_1,Luis,28,ES78209545511493038850,TRX_N-00215-99440900,2022-07-08T14:42:20,Bilbao,expenses,electricity,-69.53,-7984.63
buyer_1,Luis,28,ES78209545511493038850,TRX_N-00216-28048972,2022-07-08T19:38:25,Labastida,Expense,transport,-65.42,-8050.05
buyer_1,Luis,28,ES78209545511493038850,TRX_N-00217-93186274,2022-07-09T16:16:30,Bilbao,Expense,education,-46.21,-8096.26
buyer_1,Luis,28,ES78209545511493038850,TRX_N-00218-27124019,2022-07-10T10:55:26,Bilbao,Expense,leisure,-22.01,-8118.27
buyer_1,Luis,28,ES78209545511493038850,TRX_N-00219-85780562,2022-07-10T13:43:26,Bilbao,Expense,cash,-100.0,-8218.27
buyer_1,Luis,28,ES78209545511493038850,TRX_N-00220-20874234,2022-07-10T20:05:52,Bilbao,expenses,children,-116.08,-8334.35
buyer_1,Luis,28,ES78209545511493038850,TRX_N-00221-91743125,2022-07-11T08:25:36,Sestao,Expense,food,-61.08,-8395.43
buyer_1,Luis,28,ES78209545511493038850,TRX_N-00222-60548545,2022-07-13T17:40:11,Bilbao,expenses,children,-134.02,-8529.45
buyer_1,Luis,28,ES78209545511493038850,TRX_N-00223-82609599,2022-07-16T01:06:38,Durango,Expense,food,-97.03,-8626.48
buyer_1,Luis,28,ES78209545511493038850,TRX_N-00224-64108318,2022-07-16T11:29:31,Bilbao,Expense,cash,-100.0,-8726.48
buyer_1,Luis,28,ES78209545511493038850,TRX_N-00225-60811213,2022-07-19T12:43:21,Bilbao,Expense,repairs,-183.15,-8909.63
buyer_1,Luis,28,ES78209545511493038850,TRX_N-00226-23464164,2022-07-19T19:37:54,Bilbao,expenses,children,-156.1,-9065.73
buyer_1,Luis,28,ES78209545511493038850,TRX_N-00227-90172130,2022-07-20T18:36:17,Bilbao,Expense,clothing,-94.31,-9160.04
buyer_1,Luis,28,ES78209545511493038850,TRX_N-00228-52519667,2022-07-20T19:11:22,Bilbao,Expense,education,-70.05,-9230.09
buyer_1,Luis,28,ES78209545511493038850,TRX_N-00229-42540555,2022-07-21T23:11:54,Bilbao,Expense,food,-114.22,-9344.31
buyer_1,Luis,28,ES78209545511493038850,TRX_N-00230-84578902,2022-07-22T16:22:17,Bilbao,Expense,transport,-52.81,-9397.12
buyer_1,Luis,28,ES78209545511493038850,TRX_N-00231-48437582,2022-07-23T15:18:13,Bilbao,Expense,transport,-78.96,-9476.08
buyer_1,Luis,28,ES78209545511493038850,TRX_N-00232-35363874,2022-07-25T13:53:11,Bilbao,Expense,food,-111.94,-9588.02
buyer_1,Luis,28,ES78209545511493038850,TRX_N-00233-62248016,2022-07-25T17:34:35,Bilbao,Expense,transport,-86.13,-9674.15
buyer_1,Luis,28,ES78209545511493038850,TRX_N-00234-74587251,2022-07-25T17:58:34,Bilbao,expenses,children,-243.96,-9918.11
buyer_1,Luis,28,ES78209545511493038850,TRX_N-00235-57249813,2022-07-26T12:19:02,Bilbao,Expense,appliances,-254.84,-10172.95
buyer_1,Luis,28,ES78209545511493038850,TRX_N-00236-39152612,2022-07-26T08:49:21,Bilbao,Expense,repairs,-161.64,-10334.59
buyer_1,Luis,28,ES78209545511493038850,TRX_N-00237-54903799,2022-07-27T19:39:54,Bilbao,Expense,leisure,-23.22,-10357.81
buyer_1,Luis,28,ES78209545511493038850,TRX_N-00238-60077699,2022-07-27T12:34:27,Bilbao,Expense,appliances,-242.47,-10600.28
buyer_1,Luis,28,ES78209545511493038850,TRX_N-00239-69096333,2022-07-29T12:34:06,Bilbao,Expense,leisure,-18.61,-10618.89
buyer_1,Luis,28,ES78209545511493038850,TRX_N-00240-69783904,2022-07-30T17:27:19,Errenteria,Expense,cash,-100.0,-10718.89
buyer_1,Luis,28,ES78209545511493038850,TRX_N-00241-43027352,2022-07-30T21:09:45,Bilbao,Expense,repairs,-67.31,-10786.2
buyer_1,Luis,28,ES78209545511493038850,TRX_N-00242-88177489,2022-08-01T01:46:56,Bilbao,incomes,salary,1240.21,-9545.99
buyer_1,Luis,28,ES78209545511493038850,TRX_N-00243-58934586,2022-08-01T01:46:56,Bilbao,incomes,salary_partner,1539.34,-8006.65
buyer_1,Luis,28,ES78209545511493038850,TRX_N-00244-25132487,2022-08-01T01:46:56,Bilbao,incomes,extra_income,207.12,-7799.53
buyer_1,Luis,28,ES78209545511493038850,TRX_N-00245-24170195,2022-08-01T13:25:04,Eibar,Expense,food,-116.95,-7916.48
buyer_1,Luis,28,ES78209545511493038850,TRX_N-00246-61905785,2022-08-01T12:41:45,Hondarribia,Expense,transport,-70.49,-7986.97
buyer_1,Luis,28,ES78209545511493038850,TRX_N-00247-71900379,2022-08-02T08:34:53,Pasaia,Expense,food,-111.4,-8098.37
buyer_1,Luis,28,ES78209545511493038850,TRX_N-00248-55069778,2022-08-02T17:56:16,Alegría-Dulantzi,Expense,healthcare,-90.47,-8188.84
buyer_1,Luis,28,ES78209545511493038850,TRX_N-00249-41981002,2022-08-03T20:25:43,Berango,Expense,transport,-78.83,-8267.67
buyer_1,Luis,28,ES78209545511493038850,TRX_N-00250-25903750,2022-08-03T03:09:43,Bilbao,Expense,repairs,-200.34,-8468.01
buyer_1,Luis,28,ES78209545511493038850,TRX_N-00251-65860865,2022-08-03T23:15:59,Pasaia,Expense,gifts,-533.61,-9001.62
buyer_1,Luis,28,ES78209545511493038850,TRX_N-00252-36506385,2022-08-03T12:28:49,Bilbao,expenses,children,-223.48,-9225.1
buyer_1,Luis,28,ES78209545511493038850,TRX_N-00253-91018761,2022-08-04T16:38:35,Bilbao,expenses,mortgage,-974.82,-10199.92
buyer_1,Luis,28,ES78209545511493038850,TRX_N-00254-71766257,2022-08-04T22:04:41,Bilbao,expenses,children,-230.36,-10430.28
buyer_1,Luis,28,ES78209545511493038850,TRX_N-00255-82137481,2022-08-05T14:33:19,Bilbao,expenses,phone,-39.17,-10469.45
buyer_1,Luis,28,ES78209545511493038850,TRX_N-00256-38056793,2022-08-05T10:44:23,Bilbao,Expense,food,-124.53,-10593.98
buyer_1,Luis,28,ES78209545511493038850,TRX_N-00257-58149349,2022-08-05T15:45:27,Santurtzi,Expense,repairs,-327.68,-10921.66
buyer_1,Luis,28,ES78209545511493038850,TRX_N-00258-56379138,2022-08-06T12:11:48,Bilbao,expenses,gas,-100.19,-11021.85
buyer_1,Luis,28,ES78209545511493038850,TRX_N-00259-77709768,2022-08-07T10:31:36,Bilbao,expenses,water,-23.95,-11045.8
buyer_1,Luis,28,ES78209545511493038850,TRX_N-00260-93816953,2022-08-07T08:33:29,Bilbao,Expense,repairs,-202.41,-11248.21
buyer_1,Luis,28,ES78209545511493038850,TRX_N-00261-96614578,2022-08-08T19:52:35,Bilbao,expenses,electricity,-78.62,-11326.83
buyer_1,Luis,28,ES78209545511493038850,TRX_N-00262-89780271,2022-08-08T11:10:41,Bilbao,expenses,internet,-42.0,-11368.83
buyer_1,Luis,28,ES78209545511493038850,TRX_N-00263-82373702,2022-08-08T10:11:53,Arrasate,Expense,leisure,-31.37,-11400.2
buyer_1,Luis,28,ES78209545511493038850,TRX_N-00264-22202035,2022-08-09T13:04:37,Bilbao,Expense,leisure,-52.8,-11453.0
buyer_1,Luis,28,ES78209545511493038850,TRX_N-00265-83508600,2022-08-09T12:12:54,Bilbao,Expense,cash,-100.0,-11553.0
buyer_1,Luis,28,ES78209545511493038850,TRX_N-00266-13671895,2022-08-10T19:31:05,Bilbao,Expense,clothing,-102.74,-11655.74
buyer_1,Luis,28,ES78209545511493038850,TRX_N-00267-60263362,2022-08-10T09:57:09,Bilbao,Expense,gifts,-355.39,-12011.13
buyer_1,Luis,28,ES78209545511493038850,TRX_N-00268-49164608,2022-08-12T22:24:43,Bilbao,Expense,food,-80.36,-12091.49
buyer_1,Luis,28,ES78209545511493038850,TRX_N-00269-61729852,2022-08-14T18:28:09,Bilbao,Expense,leisure,-38.27,-12129.76
buyer_1,Luis,28,ES78209545511493038850,TRX_N-00270-88382855,2022-08-15T17:51:28,Bilbao,Expense,food,-117.06,-12246.82
buyer_1,Luis,28,ES78209545511493038850,TRX_N-00271-93769759,2022-08-15T09:33:18,Bilbao,Expense,repairs,-130.74,-12377.56
buyer_1,Luis,28,ES78209545511493038850,TRX_N-00272-68604404,2022-08-16T12:30:29,Bilbao,Expense,transport,-81.29,-12458.85
buyer_1,Luis,28,ES78209545511493038850,TRX_N-00273-41462940,2022-08-17T13:43:29,Bermeo,Expense,healthcare,-63.27,-12522.12
buyer_1,Luis,28,ES78209545511493038850,TRX_N-00274-92655507,2022-08-17T16:26:50,Bilbao,Expense,gifts,-378.65,-12900.77
buyer_1,Luis,28,ES78209545511493038850,TRX_N-00275-48040496,2022-08-19T06:50:44,Bilbao,Expense,transport,-61.02,-12961.79
buyer_1,Luis,28,ES78209545511493038850,TRX_N-00276-02973435,2022-08-19T05:02:30,Bilbao,Expense,leisure,-58.03,-13019.82
buyer_1,Luis,28,ES78209545511493038850,TRX_N-00277-11895830,2022-08-20T15:02:45,Bilbao,Expense,repairs,-228.38,-13248.2
buyer_1,Luis,28,ES78209545511493038850,TRX_N-00278-08390609,2022-08-22T18:52:32,Andoain,Expense,food,-72.13,-13320.33
buyer_1,Luis,28,ES78209545511493038850,TRX_N-00279-82491287,2022-08-22T18:08:28,Bilbao,Expense,cash,-100.0,-13420.33
buyer_1,Luis,28,ES78209545511493038850,TRX_N-00280-05214292,2022-08-22T21:41:59,Bilbao,Expense,gifts,-677.92,-14098.25
buyer_1,Luis,28,ES78209545511493038850,TRX_N-00281-94955008,2022-08-23T12:59:38,Basauri,Expense,leisure,-78.85,-14177.1
buyer_1,Luis,28,ES78209545511493038850,TRX_N-00282-19054312,2022-08-23T13:36:41,Bilbao,Expense,cash,-100.0,-14277.1
buyer_1,Luis,28,ES78209545511493038850,TRX_N-00283-35059388,2022-08-23T21:18:41,Bilbao,Expense,gifts,-28.01,-14305.11
buyer_1,Luis,28,ES78209545511493038850,TRX_N-00284-84835438,2022-08-24T18:10:17,Bilbao,Expense,food,-72.4,-14377.51
buyer_1,Luis,28,ES78209545511493038850,TRX_N-00285-35888299,2022-08-24T08:10:27,Bilbao,Expense,leisure,-73.29,-14450.8
buyer_1,Luis,28,ES78209545511493038850,TRX_N-00286-54934646,2022-08-25T14:28:29,Bilbao,Expense,repairs,-282.55,-14733.35
buyer_1,Luis,28,ES78209545511493038850,TRX_N-00287-58282908,2022-08-26T18:25:26,Bilbao,Expense,transport,-87.34,-14820.69
buyer_1,Luis,28,ES78209545511493038850,TRX_N-00288-60842239,2022-08-27T16:59:47,Andoain,Expense,transport,-76.27,-14896.96
buyer_1,Luis,28,ES78209545511493038850,TRX_N-00289-53223987,2022-08-28T08:04:24,Bilbao,Expense,leisure,-83.53,-14980.49
buyer_1,Luis,28,ES78209545511493038850,TRX_N-00290-28187587,2022-08-28T12:45:58,Bilbao,Expense,cash,-100.0,-15080.49
buyer_1,Luis,28,ES78209545511493038850,TRX_N-00291-67710672,2022-08-29T19:59:11,Bilbao,Expense,transport,-44.61,-15125.1
buyer_1,Luis,28,ES78209545511493038850,TRX_N-00292-19617561,2022-08-30T20:55:39,Errenteria,Expense,leisure,-69.5,-15194.6
buyer_1,Luis,28,ES78209545511493038850,TRX_N-00293-31341886,2022-08-31T08:51:22,Bilbao,Expense,cash,-100.0,-15294.6
buyer_1,Luis,28,ES78209545511493038850,TRX_N-00294-34953006,2022-09-01T20:49:54,Bilbao,incomes,salary,1240.21,-14054.39
buyer_1,Luis,28,ES78209545511493038850,TRX_N-00295-32466670,2022-09-01T20:49:54,Bilbao,incomes,salary_partner,1539.34,-12515.05
buyer_1,Luis,28,ES78209545511493038850,TRX_N-00296-09288698,2022-09-03T17:35:47,Alegría-Dulantzi,Expense,gifts,-311.22,-12826.27
buyer_1,Luis,28,ES78209545511493038850,TRX_N-00297-39981794,2022-09-04T16:50:44,Bilbao,expenses,mortgage,-974.82,-13801.09
buyer_1,Luis,28,ES78209545511493038850,TRX_N-00298-47106138,2022-09-05T14:29:42,Bilbao,Expense,cash,-100.0,-13901.09
buyer_1,Luis,28,ES78209545511493038850,TRX_N-00299-21192869,2022-09-05T19:58:09,Bilbao,Expense,gifts,-295.16,-14196.25
buyer_1,Luis,28,ES78209545511493038850,TRX_N-00300-43627923,2022-09-06T12:37:52,Bilbao,Expense,healthcare,-88.21,-14284.46
buyer_1,Luis,28,ES78209545511493038850,TRX_N-00301-50669563,2022-09-07T19:40:34,Bilbao,expenses,water,-35.82,-14320.28
buyer_1,Luis,28,ES78209545511493038850,TRX_N-00302-69220101,2022-09-07T21:33:19,Bilbao,expenses,electricity,-45.83,-14366.11
buyer_1,Luis,28,ES78209545511493038850,TRX_N-00303-32167215,2022-09-07T11:31:31,Bilbao,Expense,healthcare,-68.42,-14434.53
buyer_1,Luis,28,ES78209545511493038850,TRX_N-00304-60338663,2022-09-08T18:20:45,Bilbao,expenses,gas,-53.64,-14488.17
buyer_1,Luis,28,ES78209545511493038850,TRX_N-00305-60039008,2022-09-08T10:07:33,Bilbao,expenses,internet,-42.0,-14530.17
buyer_1,Luis,28,ES78209545511493038850,TRX_N-00306-09320540,2022-09-08T17:25:07,Bilbao,expenses,phone,-39.92,-14570.09
buyer_1,Luis,28,ES78209545511493038850,TRX_N-00307-40540382,2022-09-08T23:40:56,Amurrio,Expense,transport,-58.1,-14628.19
buyer_1,Luis,28,ES78209545511493038850,TRX_N-00308-52589279,2022-09-09T10:47:58,Bilbao,Expense,food,-81.26,-14709.45
buyer_1,Luis,28,ES78209545511493038850,TRX_N-00309-29820622,2022-09-10T21:28:01,Bilbao,Expense,leisure,-35.11,-14744.56
buyer_1,Luis,28,ES78209545511493038850,TRX_N-00310-45957547,2022-09-11T09:16:34,Bilbao,Expense,clothing,-51.71,-14796.27
buyer_1,Luis,28,ES78209545511493038850,TRX_N-00311-32000310,2022-09-11T16:13:37,Bilbao,Expense,education,-62.75,-14859.02
buyer_1,Luis,28,ES78209545511493038850,TRX_N-00312-04507859,2022-09-12T17:14:13,Errenteria,Expense,transport,-82.48,-14941.5
buyer_1,Luis,28,ES78209545511493038850,TRX_N-00313-65515116,2022-09-12T13:33:13,Bilbao,Expense,cash,-100.0,-15041.5
buyer_1,Luis,28,ES78209545511493038850,TRX_N-00314-08403997,2022-09-13T19:20:22,Bilbao,Expense,transport,-42.78,-15084.28
buyer_1,Luis,28,ES78209545511493038850,TRX_N-00315-26262418,2022-09-15T21:51:47,Bilbao,Expense,food,-74.79,-15159.07
buyer_1,Luis,28,ES78209545511493038850,TRX_N-00316-99319982,2022-09-18T09:03:37,Basauri,Expense,education,-69.91,-15228.98
buyer_1,Luis,28,ES78209545511493038850,TRX_N-00317-51051168,2022-09-20T19:13:49,Bilbao,Expense,leisure,-38.35,-15267.33
buyer_1,Luis,28,ES78209545511493038850,TRX_N-00318-46094669,2022-09-23T17:18:45,Bilbao,Expense,food,-122.03,-15389.36
buyer_1,Luis,28,ES78209545511493038850,TRX_N-00319-04316184,2022-09-23T03:56:41,Bilbao,Expense,transport,-81.24,-15470.6
buyer_1,Luis,28,ES78209545511493038850,TRX_N-00320-48170636,2022-09-25T14:56:53,Portugalete,Expense,education,-72.69,-15543.29
buyer_1,Luis,28,ES78209545511493038850,TRX_N-00321-55872410,2022-09-26T17:30:16,Bilbao,Expense,food,-98.62,-15641.91
buyer_1,Luis,28,ES78209545511493038850,TRX_N-00322-35899931,2022-09-27T19:39:17,Bilbao,Expense,transport,-57.15,-15699.06
buyer_1,Luis,28,ES78209545511493038850,TRX_N-00323-37365546,2022-09-27T18:42:16,Bilbao,Expense,gifts,-135.19,-15834.25
buyer_1,Luis,28,ES78209545511493038850,TRX_N-00324-75594434,2022-09-28T23:00:19,Bilbao,Expense,cash,-100.0,-15934.25
buyer_1,Luis,28,ES78209545511493038850,TRX_N-00325-62883239,2022-09-29T14:14:41,Bilbao,Expense,healthcare,-100.5,-16034.75
buyer_1,Luis,28,ES78209545511493038850,TRX_N-00326-69312819,2022-09-30T09:43:44,Bilbao,Expense,gifts,-236.48,-16271.23
buyer_1,Luis,28,ES78209545511493038850,TRX_N-00327-35060957,2022-10-01T17:21:25,Bilbao,incomes,salary,1240.21,-15031.02
buyer_1,Luis,28,ES78209545511493038850,TRX_N-00328-05429999,2022-10-01T17:21:25,Bilbao,incomes,salary_partner,1539.34,-13491.68
buyer_1,Luis,28,ES78209545511493038850,TRX_N-00329-15597976,2022-10-01T12:45:21,Bilbao,Expense,repairs,-269.35,-13761.03
buyer_1,Luis,28,ES78209545511493038850,TRX_N-00330-18898572,2022-10-03T16:43:28,Bilbao,Expense,education,-51.19,-13812.22
buyer_1,Luis,28,ES78209545511493038850,TRX_N-00331-35405373,2022-10-04T17:13:59,Bilbao,expenses,mortgage,-974.82,-14787.04
buyer_1,Luis,28,ES78209545511493038850,TRX_N-00332-06787179,2022-10-05T13:45:22,Bilbao,expenses,electricity,-41.53,-14828.57
buyer_1,Luis,28,ES78209545511493038850,TRX_N-00333-74291767,2022-10-05T02:49:04,Bilbao,expenses,gas,-91.24,-14919.81
buyer_1,Luis,28,ES78209545511493038850,TRX_N-00334-48294436,2022-10-05T18:10:50,Bilbao,Expense,education,-78.71,-14998.52
buyer_1,Luis,28,ES78209545511493038850,TRX_N-00335-97085431,2022-10-05T10:51:27,Bilbao,Expense,cash,-100.0,-15098.52
buyer_1,Luis,28,ES78209545511493038850,TRX_N-00336-09944024,2022-10-06T17:41:25,Bilbao,Expense,food,-120.32,-15218.84
buyer_1,Luis,28,ES78209545511493038850,TRX_N-00337-67049832,2022-10-08T20:15:06,Bilbao,expenses,water,-35.15,-15253.99
buyer_1,Luis,28,ES78209545511493038850,TRX_N-00338-03423014,2022-10-08T19:44:28,Bilbao,expenses,internet,-42.0,-15295.99
buyer_1,Luis,28,ES78209545511493038850,TRX_N-00339-43132062,2022-10-08T13:16:36,Bilbao,expenses,phone,-34.5,-15330.49
buyer_1,Luis,28,ES78209545511493038850,TRX_N-00340-76945925,2022-10-08T14:17:03,Bilbao,Expense,healthcare,-161.91,-15492.4
buyer_1,Luis,28,ES78209545511493038850,TRX_N-00341-34875135,2022-10-08T11:18:06,Zarautz,Expense,travel,-423.77,-15916.17
buyer_1,Luis,28,ES78209545511493038850,TRX_N-00342-82771692,2022-10-10T15:55:08,Bilbao,Expense,food,-97.18,-16013.35
buyer_1,Luis,28,ES78209545511493038850,TRX_N-00343-74937476,2022-10-13T18:56:59,Bilbao,Expense,healthcare,-183.05,-16196.4
buyer_1,Luis,28,ES78209545511493038850,TRX_N-00344-04186629,2022-10-14T10:04:52,Bilbao,Expense,clothing,-111.24,-16307.64
buyer_1,Luis,28,ES78209545511493038850,TRX_N-00345-27220613,2022-10-17T08:45:25,Bilbao,Expense,cash,-100.0,-16407.64
buyer_1,Luis,28,ES78209545511493038850,TRX_N-00346-21065879,2022-10-17T08:46:28,Bilbao,Expense,travel,-1563.13,-17970.77
buyer_1,Luis,28,ES78209545511493038850,TRX_N-00347-72951924,2022-10-18T10:44:09,Bilbao,Expense,transport,-40.04,-18010.81
buyer_1,Luis,28,ES78209545511493038850,TRX_N-00348-25844358,2022-10-19T09:27:16,Bilbao,Expense,leisure,-77.1,-18087.91
buyer_1,Luis,28,ES78209545511493038850,TRX_N-00349-12630036,2022-10-19T09:35:31,Bilbao,Expense,cash,-100.0,-18187.91
buyer_1,Luis,28,ES78209545511493038850,TRX_N-00350-08325717,2022-10-21T04:54:37,Bilbao,Expense,transport,-75.98,-18263.89
buyer_1,Luis,28,ES78209545511493038850,TRX_N-00351-37825671,2022-10-22T08:43:49,Bilbao,Expense,food,-107.87,-18371.76
buyer_1,Luis,28,ES78209545511493038850,TRX_N-00352-48741469,2022-10-23T11:17:59,Bilbao,Expense,food,-110.97,-18482.73
buyer_1,Luis,28,ES78209545511493038850,TRX_N-00353-69280865,2022-10-23T15:11:36,Mungia,Expense,cash,-100.0,-18582.73
buyer_1,Luis,28,ES78209545511493038850,TRX_N-00354-23668193,2022-10-24T20:12:41,Iruña de Oca,Expense,food,-73.19,-18655.92
buyer_1,Luis,28,ES78209545511493038850,TRX_N-00355-00227105,2022-10-24T10:18:21,Erandio,Expense,transport,-49.15,-18705.07
buyer_1,Luis,28,ES78209545511493038850,TRX_N-00356-35509486,2022-10-24T13:04:07,Bilbao,Expense,travel,-1089.36,-19794.43
buyer_1,Luis,28,ES78209545511493038850,TRX_N-00357-16755224,2022-10-27T08:58:09,Bilbao,Expense,clothing,-122.09,-19916.52
buyer_1,Luis,28,ES78209545511493038850,TRX_N-00358-70655331,2022-10-28T18:01:20,Bilbao,Expense,cash,-100.0,-20016.52
buyer_1,Luis,28,ES78209545511493038850,TRX_N-00359-04607476,2022-10-29T02:48:48,Bilbao,Expense,travel,-1603.93,-21620.45
buyer_1,Luis,28,ES78209545511493038850,TRX_N-00360-57125791,2022-11-01T19:41:48,Bilbao,incomes,salary,1240.21,-20380.24
buyer_1,Luis,28,ES78209545511493038850,TRX_N-00361-64097853,2022-11-01T19:41:48,Bilbao,incomes,salary_partner,1539.34,-18840.9
buyer_1,Luis,28,ES78209545511493038850,TRX_N-00362-11801096,2022-11-01T19:41:48,Bilbao,incomes,extra_income,207.12,-18633.78
buyer_1,Luis,28,ES78209545511493038850,TRX_N-00363-65820455,2022-11-02T14:49:26,Bilbao,expenses,children,-198.14,-18831.92
buyer_1,Luis,28,ES78209545511493038850,TRX_N-00364-49009492,2022-11-04T03:29:03,Bilbao,expenses,mortgage,-974.82,-19806.74
buyer_1,Luis,28,ES78209545511493038850,TRX_N-00365-87118805,2022-11-04T18:39:10,Hernani,Expense,repairs,-300.84,-20107.58
buyer_1,Luis,28,ES78209545511493038850,TRX_N-00366-38623397,2022-11-05T16:15:25,Bilbao,expenses,water,-40.5,-20148.08
buyer_1,Luis,28,ES78209545511493038850,TRX_N-00367-08899518,2022-11-06T21:42:21,Bilbao,expenses,gas,-95.74,-20243.82
buyer_1,Luis,28,ES78209545511493038850,TRX_N-00368-20673065,2022-11-07T03:04:31,Bilbao,expenses,phone,-37.84,-20281.66
buyer_1,Luis,28,ES78209545511493038850,TRX_N-00369-75527018,2022-11-07T20:52:51,Bilbao,Expense,transport,-44.89,-20326.55
buyer_1,Luis,28,ES78209545511493038850,TRX_N-00370-62916846,2022-11-08T15:17:54,Bilbao,expenses,electricity,-79.33,-20405.88
buyer_1,Luis,28,ES78209545511493038850,TRX_N-00371-38068389,2022-11-08T09:51:26,Bilbao,expenses,internet,-42.0,-20447.88
buyer_1,Luis,28,ES78209545511493038850,TRX_N-00372-97057161,2022-11-08T15:27:55,Bilbao,Expense,repairs,-94.15,-20542.03
buyer_1,Luis,28,ES78209545511493038850,TRX_N-00373-70251547,2022-11-08T13:56:31,Donostia,Expense,gifts,-700.93,-21242.96
buyer_1,Luis,28,ES78209545511493038850,TRX_N-00374-95237900,2022-11-10T23:04:34,Bilbao,Expense,food,-98.2,-21341.16
buyer_1,Luis,28,ES78209545511493038850,TRX_N-00375-94142031,2022-11-10T21:06:25,Bilbao,Expense,transport,-45.07,-21386.23
buyer_1,Luis,28,ES78209545511493038850,TRX_N-00376-97546712,2022-11-10T18:13:41,Bilbao,Expense,leisure,-28.24,-21414.47
buyer_1,Luis,28,ES78209545511493038850,TRX_N-00377-27252047,2022-11-10T16:35:29,Bilbao,Expense,cash,-100.0,-21514.47
buyer_1,Luis,28,ES78209545511493038850,TRX_N-00378-46728886,2022-11-10T19:39:26,Bilbao,Expense,repairs,-153.72,-21668.19
buyer_1,Luis,28,ES78209545511493038850,TRX_N-00379-37264059,2022-11-11T11:47:59,Bilbao,Expense,repairs,-252.0,-21920.19
buyer_1,Luis,28,ES78209545511493038850,TRX_N-00380-63386238,2022-11-15T19:34:42,Bilbao,Expense,appliances,-267.91,-22188.1
buyer_1,Luis,28,ES78209545511493038850,TRX_N-00381-10710831,2022-11-16T03:20:56,Bilbao,expenses,children,-117.31,-22305.41
buyer_1,Luis,28,ES78209545511493038850,TRX_N-00382-16704106,2022-11-17T08:40:53,Portugalete,Expense,cash,-100.0,-22405.41
buyer_1,Luis,28,ES78209545511493038850,TRX_N-00383-32047365,2022-11-20T14:19:34,Bilbao,Expense,education,-56.01,-22461.42
buyer_1,Luis,28,ES78209545511493038850,TRX_N-00384-65093546,2022-11-21T20:51:47,Bilbao,Expense,gifts,-215.86,-22677.28
buyer_1,Luis,28,ES78209545511493038850,TRX_N-00385-59276654,2022-11-22T05:53:06,Bilbao,Expense,transport,-87.93,-22765.21
buyer_1,Luis,28,ES78209545511493038850,TRX_N-00386-70706056,2022-11-22T19:58:08,Bilbao,expenses,children,-76.49,-22841.7
buyer_1,Luis,28,ES78209545511493038850,TRX_N-00387-18982020,2022-11-24T00:21:30,Bilbao,Expense,gifts,-812.92,-23654.62
buyer_1,Luis,28,ES78209545511493038850,TRX_N-00388-57633192,2022-11-25T14:35:58,Bilbao,Expense,leisure,-73.62,-23728.24
buyer_1,Luis,28,ES78209545511493038850,TRX_N-00389-08872570,2022-11-25T08:57:22,Bilbao,Expense,cash,-100.0,-23828.24
buyer_1,Luis,28,ES78209545511493038850,TRX_N-00390-55685218,2022-11-26T23:11:23,Bilbao,expenses,children,-158.35,-23986.59
buyer_1,Luis,28,ES78209545511493038850,TRX_N-00391-03513303,2022-11-28T14:40:37,Bilbao,Expense,food,-117.51,-24104.1
buyer_1,Luis,28,ES78209545511493038850,TRX_N-00392-90158417,2022-12-01T08:49:48,Bilbao,incomes,salary,1240.21,-22863.89
buyer_1,Luis,28,ES78209545511493038850,TRX_N-00393-44037689,2022-12-01T08:49:48,Bilbao,incomes,salary_partner,1539.34,-21324.55
buyer_1,Luis,28,ES78209545511493038850,TRX_N-00394-96049004,2022-12-01T08:49:48,Bilbao,incomes,salary_bonus,933.0,-20391.55
buyer_1,Luis,28,ES78209545511493038850,TRX_N-00395-04159013,2022-12-01T08:49:48,Bilbao,incomes,salary_partner_bonus,1166.95,-19224.6
buyer_1,Luis,28,ES78209545511493038850,TRX_N-00396-15985057,2022-12-01T14:00:51,Bilbao,Expense,clothing,-51.69,-19276.29
buyer_1,Luis,28,ES78209545511493038850,TRX_N-00397-77753727,2022-12-02T08:34:50,Lasarte-Oria,Expense,healthcare,-122.01,-19398.3
buyer_1,Luis,28,ES78209545511493038850,TRX_N-00398-91039009,2022-12-02T11:01:36,Bilbao,expenses,children,-150.17,-19548.47
buyer_1,Luis,28,ES78209545511493038850,TRX_N-00399-58683974,2022-12-04T13:57:53,Bilbao,expenses,mortgage,-974.82,-20523.29
buyer_1,Luis,28,ES78209545511493038850,TRX_N-00400-89076096,2022-12-05T21:25:50,Bilbao,expenses,internet,-42.0,-20565.29
buyer_1,Luis,28,ES78209545511493038850,TRX_N-00401-51309190,2022-12-06T12:52:09,Bilbao,expenses,gas,-33.87,-20599.16
buyer_1,Luis,28,ES78209545511493038850,TRX_N-00402-52876770,2022-12-06T12:17:09,Bilbao,Expense,food,-120.63,-20719.79
buyer_1,Luis,28,ES78209545511493038850,TRX_N-00403-20125854,2022-12-07T20:30:01,Bilbao,Expense,gifts,-600.52,-21320.31
buyer_1,Luis,28,ES78209545511493038850,TRX_N-00404-05161954,2022-12-08T12:50:55,Bilbao,expenses,water,-22.46,-21342.77
buyer_1,Luis,28,ES78209545511493038850,TRX_N-00405-47039907,2022-12-08T16:15:47,Bilbao,expenses,electricity,-69.34,-21412.11
buyer_1,Luis,28,ES78209545511493038850,TRX_N-00406-95794689,2022-12-08T16:21:32,Bilbao,expenses,phone,-40.66,-21452.77
buyer_1,Luis,28,ES78209545511493038850,TRX_N-00407-70122287,2022-12-08T13:51:37,Bilbao,expenses,children,-225.75,-21678.52
buyer_1,Luis,28,ES78209545511493038850,TRX_N-00408-49049786,2022-12-09T10:24:34,Bilbao,Expense,cash,-100.0,-21778.52
buyer_1,Luis,28,ES78209545511493038850,TRX_N-00409-84639003,2022-12-10T15:32:34,Bilbao,Expense,appliances,-382.75,-22161.27
buyer_1,Luis,28,ES78209545511493038850,TRX_N-00410-48299582,2022-12-13T14:47:28,Galdakao,Expense,leisure,-71.97,-22233.24
buyer_1,Luis,28,ES78209545511493038850,TRX_N-00411-20853017,2022-12-14T11:06:07,Alegría-Dulantzi,Expense,food,-110.52,-22343.76
buyer_1,Luis,28,ES78209545511493038850,TRX_N-00412-12325449,2022-12-14T14:58:52,Bilbao,Expense,healthcare,-108.35,-22452.11
buyer_1,Luis,28,ES78209545511493038850,TRX_N-00413-61841043,2022-12-14T16:03:03,Bilbao,Expense,cash,-100.0,-22552.11
buyer_1,Luis,28,ES78209545511493038850,TRX_N-00414-56007217,2022-12-15T08:07:55,Bilbao,Expense,clothing,-96.36,-22648.47
buyer_1,Luis,28,ES78209545511493038850,TRX_N-00415-67714498,2022-12-16T19:10:51,Bilbao,Expense,leisure,-65.44,-22713.91
buyer_1,Luis,28,ES78209545511493038850,TRX_N-00416-80288596,2022-12-17T18:38:31,Portugalete,Expense,food,-118.67,-22832.58
buyer_1,Luis,28,ES78209545511493038850,TRX_N-00417-64852158,2022-12-17T10:13:06,Bilbao,Expense,gifts,-443.07,-23275.65
buyer_1,Luis,28,ES78209545511493038850,TRX_N-00418-55099339,2022-12-20T10:26:44,Bilbao,Expense,cash,-100.0,-23375.65
buyer_1,Luis,28,ES78209545511493038850,TRX_N-00419-01020364,2022-12-20T14:19:05,Bilbao,Expense,gifts,-526.69,-23902.34
buyer_1,Luis,28,ES78209545511493038850,TRX_N-00420-11326352,2022-12-22T00:38:40,Bilbao,Expense,cash,-100.0,-24002.34
buyer_1,Luis,28,ES78209545511493038850,TRX_N-00421-20120354,2022-12-23T17:08:35,Bilbao,Expense,leisure,-32.15,-24034.49
buyer_1,Luis,28,ES78209545511493038850,TRX_N-00422-74282808,2022-12-28T09:38:33,Bilbao,Expense,clothing,-146.57,-24181.06
buyer_1,Luis,28,ES78209545511493038850,TRX_N-00423-67473545,2022-12-29T23:34:24,Bilbao,Expense,food,-99.39,-24280.45
buyer_1,Luis,28,ES78209545511493038850,TRX_N-00424-63306893,2022-12-29T17:18:11,Bilbao,Expense,travel,-1470.83,-25751.28
buyer_1,Luis,28,ES78209545511493038850,TRX_N-00425-07075896,2023-01-01T10:38:44,Bilbao,incomes,salary,1279.82,-24471.46
buyer_1,Luis,28,ES78209545511493038850,TRX_N-00426-98450487,2023-01-01T10:38:44,Bilbao,incomes,salary_partner,1588.51,-22882.95
buyer_1,Luis,28,ES78209545511493038850,TRX_N-00427-81266668,2023-01-03T18:43:36,Bilbao,Expense,repairs,-253.36,-23136.31
buyer_1,Luis,28,ES78209545511493038850,TRX_N-00428-65592123,2023-01-04T08:36:24,Bilbao,expenses,mortgage,-974.82,-24111.13
buyer_1,Luis,28,ES78209545511493038850,TRX_N-00429-96163468,2023-01-04T17:43:03,Labastida,Expense,leisure,-76.96,-24188.09
buyer_1,Luis,28,ES78209545511493038850,TRX_N-00430-11308049,2023-01-04T20:50:44,Bilbao,Expense,education,-61.09,-24249.18
buyer_1,Luis,28,ES78209545511493038850,TRX_N-00431-02594837,2023-01-06T08:48:04,Bilbao,expenses,water,-40.53,-24289.71
buyer_1,Luis,28,ES78209545511493038850,TRX_N-00432-36051554,2023-01-06T17:49:09,Bilbao,expenses,internet,-42.0,-24331.71
buyer_1,Luis,28,ES78209545511493038850,TRX_N-00433-38189124,2023-01-06T15:32:45,Lasarte-Oria,Expense,repairs,-306.65,-24638.36
buyer_1,Luis,28,ES78209545511493038850,TRX_N-00434-08497632,2023-01-08T16:00:03,Bilbao,expenses,electricity,-63.36,-24701.72
buyer_1,Luis,28,ES78209545511493038850,TRX_N-00435-76196443,2023-01-08T09:47:25,Bilbao,expenses,gas,-56.56,-24758.28
buyer_1,Luis,28,ES78209545511493038850,TRX_N-00436-10224038,2023-01-08T13:55:33,Bilbao,expenses,phone,-39.08,-24797.36
buyer_1,Luis,28,ES78209545511493038850,TRX_N-00437-99971167,2023-01-09T19:06:28,Barakaldo,Expense,food,-60.79,-24858.15
buyer_1,Luis,28,ES78209545511493038850,TRX_N-00438-84053818,2023-01-09T15:18:56,Bilbao,Expense,leisure,-47.36,-24905.51
buyer_1,Luis,28,ES78209545511493038850,TRX_N-00439-34736855,2023-01-09T18:17:25,Bilbao,Expense,cash,-100.0,-25005.51
buyer_1,Luis,28,ES78209545511493038850,TRX_N-00440-87875053,2023-01-10T12:37:38,Basauri,Expense,food,-84.84,-25090.35
buyer_1,Luis,28,ES78209545511493038850,TRX_N-00441-15892733,2023-01-11T13:24:52,Bilbao,expenses,children,-92.72,-25183.07
buyer_1,Luis,28,ES78209545511493038850,TRX_N-00442-29347744,2023-01-12T16:05:30,Bilbao,Expense,clothing,-148.31,-25331.38
buyer_1,Luis,28,ES78209545511493038850,TRX_N-00443-85322154,2023-01-12T21:39:14,Bilbao,Expense,gifts,-145.81,-25477.19
buyer_1,Luis,28,ES78209545511493038850,TRX_N-00444-43219918,2023-01-14T19:47:34,Bilbao,Expense,gifts,-413.0,-25890.19
buyer_1,Luis,28,ES78209545511493038850,TRX_N-00445-00498197,2023-01-17T10:38:36,Bilbao,Expense,cash,-100.0,-25990.19
buyer_1,Luis,28,ES78209545511493038850,TRX_N-00446-07494625,2023-01-19T09:18:57,Bilbao,Expense,transport,-74.94,-26065.13
buyer_1,Luis,28,ES78209545511493038850,TRX_N-00447-58163197,2023-01-20T15:01:58,Bilbao,Expense,food,-123.41,-26188.54
buyer_1,Luis,28,ES78209545511493038850,TRX_N-00448-76903221,2023-01-22T19:43:23,Bilbao,Expense,food,-80.77,-26269.31
buyer_1,Luis,28,ES78209545511493038850,TRX_N-00449-45756777,2023-01-22T02:25:11,Bilbao,Expense,leisure,-53.0,-26322.31
buyer_1,Luis,28,ES78209545511493038850,TRX_N-00450-32687437,2023-01-24T17:33:01,Bilbao,Expense,leisure,-34.09,-26356.4
buyer_1,Luis,28,ES78209545511493038850,TRX_N-00451-45334114,2023-01-24T10:26:18,Bilbao,Expense,cash,-100.0,-26456.4
buyer_1,Luis,28,ES78209545511493038850,TRX_N-00452-09572225,2023-01-25T19:45:17,Bilbao,Expense,repairs,-71.97,-26528.37
buyer_1,Luis,28,ES78209545511493038850,TRX_N-00453-55227287,2023-01-27T09:01:49,Bilbao,Expense,transport,-71.76,-26600.13
buyer_1,Luis,28,ES78209545511493038850,TRX_N-00454-69012159,2023-01-27T15:53:54,Bilbao,Expense,leisure,-45.84,-26645.97
buyer_1,Luis,28,ES78209545511493038850,TRX_N-00455-60970007,2023-01-30T18:48:16,Andoain,Expense,gifts,-444.96,-27090.93
buyer_1,Luis,28,ES78209545511493038850,TRX_N-00456-71999579,2023-02-01T03:12:30,Bilbao,incomes,salary,1279.82,-25811.11
buyer_1,Luis,28,ES78209545511493038850,TRX_N-00457-51755270,2023-02-01T03:12:30,Bilbao,incomes,salary_partner,1588.51,-24222.6
buyer_1,Luis,28,ES78209545511493038850,TRX_N-00458-89167438,2023-02-03T11:46:57,Vitoria-Gasteiz,Expense,leisure,-28.87,-24251.47
buyer_1,Luis,28,ES78209545511493038850,TRX_N-00459-87246454,2023-02-03T11:13:22,Labastida,Expense,education,-62.9,-24314.37
buyer_1,Luis,28,ES78209545511493038850,TRX_N-00460-07590403,2023-02-03T11:44:31,Bilbao,Expense,cash,-100.0,-24414.37
buyer_1,Luis,28,ES78209545511493038850,TRX_N-00461-32533221,2023-02-04T15:30:34,Bilbao,expenses,mortgage,-974.82,-25389.19
buyer_1,Luis,28,ES78209545511493038850,TRX_N-00462-60327621,2023-02-04T17:50:51,Hondarribia,Expense,food,-85.86,-25475.05
buyer_1,Luis,28,ES78209545511493038850,TRX_N-00463-47368678,2023-02-04T15:55:30,Bilbao,Expense,transport,-77.69,-25552.74
buyer_1,Luis,28,ES78209545511493038850,TRX_N-00464-70103419,2023-02-04T19:44:26,Bilbao,Expense,healthcare,-87.03,-25639.77
buyer_1,Luis,28,ES78209545511493038850,TRX_N-00465-64118022,2023-02-05T13:32:37,Bilbao,expenses,gas,-86.31,-25726.08
buyer_1,Luis,28,ES78209545511493038850,TRX_N-00466-32354526,2023-02-05T08:57:14,Bilbao,expenses,internet,-42.0,-25768.08
buyer_1,Luis,28,ES78209545511493038850,TRX_N-00467-72447207,2023-02-05T20:59:53,Bilbao,expenses,phone,-34.14,-25802.22
buyer_1,Luis,28,ES78209545511493038850,TRX_N-00468-26696812,2023-02-05T00:37:07,Arrasate,Expense,healthcare,-124.71,-25926.93
buyer_1,Luis,28,ES78209545511493038850,TRX_N-00469-81551102,2023-02-06T11:17:52,Bilbao,expenses,electricity,-81.36,-26008.29
buyer_1,Luis,28,ES78209545511493038850,TRX_N-00470-18010467,2023-02-07T13:50:49,Bilbao,Expense,cash,-100.0,-26108.29
buyer_1,Luis,28,ES78209545511493038850,TRX_N-00471-95128458,2023-02-08T15:19:54,Bilbao,expenses,water,-23.92,-26132.21
buyer_1,Luis,28,ES78209545511493038850,TRX_N-00472-78554199,2023-02-09T08:11:07,Bilbao,Expense,repairs,-34.74,-26166.95
buyer_1,Luis,28,ES78209545511493038850,TRX_N-00473-57128220,2023-02-11T18:36:37,Bilbao,Expense,cash,-100.0,-26266.95
buyer_1,Luis,28,ES78209545511493038850,TRX_N-00474-81765249,2023-02-13T09:36:02,Bilbao,Expense,transport,-53.56,-26320.51
buyer_1,Luis,28,ES78209545511493038850,TRX_N-00475-63647375,2023-02-14T18:38:23,Bilbao,Expense,transport,-50.15,-26370.66
buyer_1,Luis,28,ES78209545511493038850,TRX_N-00476-19636591,2023-02-14T12:28:31,Bilbao,Expense,cash,-100.0,-26470.66
buyer_1,Luis,28,ES78209545511493038850,TRX_N-00477-66822840,2023-02-17T11:35:12,Amurrio,Expense,cash,-100.0,-26570.66
buyer_1,Luis,28,ES78209545511493038850,TRX_N-00478-31645076,2023-02-18T18:23:42,Bilbao,Expense,food,-60.11,-26630.77
buyer_1,Luis,28,ES78209545511493038850,TRX_N-00479-63556692,2023-02-18T16:00:46,Bilbao,Expense,transport,-88.27,-26719.04
buyer_1,Luis,28,ES78209545511493038850,TRX_N-00480-32598085,2023-02-22T19:09:17,Zuia,Expense,leisure,-67.54,-26786.58
buyer_1,Luis,28,ES78209545511493038850,TRX_N-00481-30705137,2023-02-24T08:49:28,Bilbao,Expense,repairs,-292.6,-27079.18
buyer_1,Luis,28,ES78209545511493038850,TRX_N-00482-91302542,2023-02-25T20:54:19,Bilbao,Expense,food,-110.74,-27189.92
buyer_1,Luis,28,ES78209545511493038850,TRX_N-00483-28244240,2023-02-26T17:33:45,Arrasate,Expense,clothing,-132.1,-27322.02
buyer_1,Luis,28,ES78209545511493038850,TRX_N-00484-01404944,2023-02-28T16:14:30,Bilbao,Expense,transport,-61.27,-27383.29
buyer_1,Luis,28,ES78209545511493038850,TRX_N-00485-43182374,2023-02-28T13:07:38,Bilbao,Expense,gifts,-67.29,-27450.58
buyer_1,Luis,28,ES78209545511493038850,TRX_N-00486-33843715,2023-03-01T10:56:27,Bilbao,incomes,salary,1279.82,-26170.76
buyer_1,Luis,28,ES78209545511493038850,TRX_N-00487-19536234,2023-03-01T10:56:27,Bilbao,incomes,salary_partner,1588.51,-24582.25
buyer_1,Luis,28,ES78209545511493038850,TRX_N-00488-73809589,2023-03-01T10:56:27,Bilbao,incomes,extra_income,207.12,-24375.13
buyer_1,Luis,28,ES78209545511493038850,TRX_N-00489-62759511,2023-03-02T18:51:10,Barakaldo,Expense,transport,-79.09,-24454.22
buyer_1,Luis,28,ES78209545511493038850,TRX_N-00490-86367811,2023-03-04T19:45:15,Bilbao,expenses,mortgage,-974.82,-25429.04
buyer_1,Luis,28,ES78209545511493038850,TRX_N-00491-14209515,2023-03-05T16:44:55,Bilbao,expenses,electricity,-32.23,-25461.27
buyer_1,Luis,28,ES78209545511493038850,TRX_N-00492-58223790,2023-03-05T06:54:37,Bilbao,Expense,leisure,-56.48,-25517.75
buyer_1,Luis,28,ES78209545511493038850,TRX_N-00493-64270839,2023-03-06T13:44:44,Bilbao,expenses,phone,-36.07,-25553.82
buyer_1,Luis,28,ES78209545511493038850,TRX_N-00494-24518896,2023-03-06T12:27:10,Bilbao,Expense,food,-122.66,-25676.48
buyer_1,Luis,28,ES78209545511493038850,TRX_N-00495-39817799,2023-03-06T12:49:26,Galdakao,Expense,leisure,-75.22,-25751.7
buyer_1,Luis,28,ES78209545511493038850,TRX_N-00496-80939789,2023-03-06T09:27:03,Bilbao,Expense,cash,-100.0,-25851.7
buyer_1,Luis,28,ES78209545511493038850,TRX_N-00497-42108444,2023-03-07T20:35:38,Bilbao,expenses,gas,-61.89,-25913.59
buyer_1,Luis,28,ES78209545511493038850,TRX_N-00498-50603464,2023-03-07T12:48:54,Bilbao,Expense,leisure,-73.84,-25987.43
buyer_1,Luis,28,ES78209545511493038850,TRX_N-00499-18325724,2023-03-07T19:48:41,Bilbao,expenses,children,-239.48,-26226.91
buyer_1,Luis,28,ES78209545511493038850,TRX_N-00500-19271889,2023-03-08T16:13:39,Bilbao,expenses,water,-40.24,-26267.15
buyer_1,Luis,28,ES78209545511493038850,TRX_N-00501-91167651,2023-03-08T14:37:55,Bilbao,expenses,internet,-42.0,-26309.15
buyer_1,Luis,28,ES78209545511493038850,TRX_N-00502-84577610,2023-03-08T12:14:52,Berango,Expense,leisure,-41.94,-26351.09
buyer_1,Luis,28,ES78209545511493038850,TRX_N-00503-01899564,2023-03-10T16:39:55,Sestao,Expense,transport,-54.86,-26405.95
buyer_1,Luis,28,ES78209545511493038850,TRX_N-00504-32272267,2023-03-10T18:39:24,Llodio,Expense,gifts,-163.4,-26569.35
buyer_1,Luis,28,ES78209545511493038850,TRX_N-00505-77087130,2023-03-10T09:44:44,Bilbao,expenses,children,-125.96,-26695.31
buyer_1,Luis,28,ES78209545511493038850,TRX_N-00506-19896396,2023-03-11T18:55:26,Bilbao,Expense,food,-91.31,-26786.62
buyer_1,Luis,28,ES78209545511493038850,TRX_N-00507-11497220,2023-03-11T10:09:56,Bilbao,Expense,education,-66.9,-26853.52
buyer_1,Luis,28,ES78209545511493038850,TRX_N-00508-34879919,2023-03-11T14:14:42,Bilbao,Expense,cash,-100.0,-26953.52
buyer_1,Luis,28,ES78209545511493038850,TRX_N-00509-15482076,2023-03-11T16:08:46,Zarautz,Expense,gifts,-814.11,-27767.63
buyer_1,Luis,28,ES78209545511493038850,TRX_N-00510-64173726,2023-03-12T04:57:47,Irun,Expense,transport,-66.86,-27834.49
buyer_1,Luis,28,ES78209545511493038850,TRX_N-00511-26864173,2023-03-13T15:49:10,Bilbao,Expense,food,-117.51,-27952.0
buyer_1,Luis,28,ES78209545511493038850,TRX_N-00512-49784833,2023-03-14T09:10:32,Bilbao,Expense,leisure,-80.79,-28032.79
buyer_1,Luis,28,ES78209545511493038850,TRX_N-00513-20841652,2023-03-14T08:11:04,Bilbao,Expense,appliances,-84.73,-28117.52
buyer_1,Luis,28,ES78209545511493038850,TRX_N-00514-74163648,2023-03-15T00:19:00,Bilbao,Expense,gifts,-180.9,-28298.42
buyer_1,Luis,28,ES78209545511493038850,TRX_N-00515-89025892,2023-03-21T15:24:45,Bilbao,Expense,food,-116.04,-28414.46
buyer_1,Luis,28,ES78209545511493038850,TRX_N-00516-46962460,2023-03-23T13:31:20,Bilbao,Expense,cash,-100.0,-28514.46
buyer_1,Luis,28,ES78209545511493038850,TRX_N-00517-34540449,2023-03-23T07:11:08,Bilbao,Expense,repairs,-201.51,-28715.97
buyer_1,Luis,28,ES78209545511493038850,TRX_N-00518-63168851,2023-03-24T15:39:10,Bilbao,Expense,clothing,-91.7,-28807.67
buyer_1,Luis,28,ES78209545511493038850,TRX_N-00519-22392726,2023-03-27T17:02:20,Bilbao,Expense,transport,-80.44,-28888.11
buyer_1,Luis,28,ES78209545511493038850,TRX_N-00520-37569722,2023-03-31T14:16:33,Hondarribia,Expense,clothing,-93.92,-28982.03
buyer_1,Luis,28,ES78209545511493038850,TRX_N-00521-45776155,2023-03-31T19:54:11,Donostia,Expense,gifts,-35.95,-29017.98
buyer_1,Luis,28,ES78209545511493038850,TRX_N-00522-32166349,2023-03-31T13:10:18,Bilbao,expenses,children,-184.84,-29202.82
buyer_1,Luis,28,ES78209545511493038850,TRX_N-00523-92095950,2023-04-01T16:20:35,Bilbao,incomes,salary,1279.82,-27923.0
buyer_1,Luis,28,ES78209545511493038850,TRX_N-00524-85537478,2023-04-01T16:20:35,Bilbao,incomes,salary_partner,1588.51,-26334.49
buyer_1,Luis,28,ES78209545511493038850,TRX_N-00525-92593704,2023-04-01T12:23:20,Bilbao,Expense,healthcare,-149.27,-26483.76
buyer_1,Luis,28,ES78209545511493038850,TRX_N-00526-04184668,2023-04-01T19:52:35,Bilbao,Expense,cash,-100.0,-26583.76
buyer_1,Luis,28,ES78209545511493038850,TRX_N-00527-52779999,2023-04-02T16:53:29,Bilbao,Expense,food,-80.48,-26664.24
buyer_1,Luis,28,ES78209545511493038850,TRX_N-00528-66939164,2023-04-04T20:20:10,Bilbao,expenses,mortgage,-974.82,-27639.06
buyer_1,Luis,28,ES78209545511493038850,TRX_N-00529-49108193,2023-04-04T20:17:36,Bilbao,Expense,food,-87.41,-27726.47
buyer_1,Luis,28,ES78209545511493038850,TRX_N-00530-56990383,2023-04-05T08:07:18,Bilbao,expenses,water,-20.55,-27747.02
buyer_1,Luis,28,ES78209545511493038850,TRX_N-00531-59630119,2023-04-05T16:01:16,Bilbao,expenses,electricity,-32.42,-27779.44
buyer_1,Luis,28,ES78209545511493038850,TRX_N-00532-66922728,2023-04-05T15:57:31,Bilbao,expenses,internet,-42.0,-27821.44
buyer_1,Luis,28,ES78209545511493038850,TRX_N-00533-47322897,2023-04-05T20:19:55,Bilbao,expenses,phone,-37.26,-27858.7
buyer_1,Luis,28,ES78209545511493038850,TRX_N-00534-05527739,2023-04-07T18:39:44,Bilbao,expenses,gas,-96.38,-27955.08
buyer_1,Luis,28,ES78209545511493038850,TRX_N-00535-59501153,2023-04-08T12:09:14,Bilbao,Expense,transport,-84.0,-28039.08
buyer_1,Luis,28,ES78209545511493038850,TRX_N-00536-49818938,2023-04-08T12:22:54,Bilbao,Expense,appliances,-385.27,-28424.35
buyer_1,Luis,28,ES78209545511493038850,TRX_N-00537-13584573,2023-04-10T15:52:59,Bilbao,Expense,leisure,-26.63,-28450.98
buyer_1,Luis,28,ES78209545511493038850,TRX_N-00538-84281934,2023-04-11T16:29:46,Bilbao,Expense,cash,-100.0,-28550.98
buyer_1,Luis,28,ES78209545511493038850,TRX_N-00539-19113703,2023-04-11T17:28:38,Bermeo,Expense,appliances,-121.22,-28672.2
buyer_1,Luis,28,ES78209545511493038850,TRX_N-00540-98871512,2023-04-13T19:06:08,Erandio,Expense,repairs,-67.81,-28740.01
buyer_1,Luis,28,ES78209545511493038850,TRX_N-00541-90445034,2023-04-15T12:46:01,Bilbao,Expense,food,-114.55,-28854.56
buyer_1,Luis,28,ES78209545511493038850,TRX_N-00542-46530210,2023-04-15T09:14:56,Bilbao,Expense,travel,-956.56,-29811.12
buyer_1,Luis,28,ES78209545511493038850,TRX_N-00543-03668761,2023-04-16T08:18:56,Amurrio,Expense,food,-106.06,-29917.18
buyer_1,Luis,28,ES78209545511493038850,TRX_N-00544-63728265,2023-04-16T19:00:10,Bilbao,Expense,repairs,-238.46,-30155.64
buyer_1,Luis,28,ES78209545511493038850,TRX_N-00545-97834267,2023-04-17T16:00:11,Bilbao,Expense,repairs,-270.16,-30425.8
buyer_1,Luis,28,ES78209545511493038850,TRX_N-00546-90395438,2023-04-19T19:32:40,Bilbao,Expense,leisure,-57.05,-30482.85
buyer_1,Luis,28,ES78209545511493038850,TRX_N-00547-46769617,2023-04-20T17:37:30,Hondarribia,Expense,food,-65.91,-30548.76
buyer_1,Luis,28,ES78209545511493038850,TRX_N-00548-10316205,2023-04-20T10:12:00,Bilbao,Expense,transport,-58.36,-30607.12
buyer_1,Luis,28,ES78209545511493038850,TRX_N-00549-52343282,2023-04-21T15:47:44,Bilbao,Expense,travel,-508.09,-31115.21
buyer_1,Luis,28,ES78209545511493038850,TRX_N-00550-36710140,2023-04-23T08:43:19,Bilbao,Expense,repairs,-30.22,-31145.43
buyer_1,Luis,28,ES78209545511493038850,TRX_N-00551-56073352,2023-04-24T15:29:49,Iruña de Oca,Expense,cash,-100.0,-31245.43
buyer_1,Luis,28,ES78209545511493038850,TRX_N-00552-54287870,2023-04-25T14:15:11,Bilbao,Expense,leisure,-38.77,-31284.2
buyer_1,Luis,28,ES78209545511493038850,TRX_N-00553-21620802,2023-04-25T09:51:46,Bilbao,Expense,clothing,-106.51,-31390.71
buyer_1,Luis,28,ES78209545511493038850,TRX_N-00554-72220249,2023-04-26T12:39:09,Bilbao,Expense,food,-118.95,-31509.66
buyer_1,Luis,28,ES78209545511493038850,TRX_N-00555-22211008,2023-04-26T14:19:21,Bilbao,Expense,leisure,-29.91,-31539.57
buyer_1,Luis,28,ES78209545511493038850,TRX_N-00556-32834051,2023-04-27T23:57:55,Bilbao,Expense,repairs,-194.42,-31733.99
buyer_1,Luis,28,ES78209545511493038850,TRX_N-00557-74378587,2023-04-29T02:29:53,Bilbao,Expense,food,-103.16,-31837.15
buyer_1,Luis,28,ES78209545511493038850,TRX_N-00558-67642581,2023-05-01T23:50:33,Bilbao,incomes,salary,1279.82,-30557.33
buyer_1,Luis,28,ES78209545511493038850,TRX_N-00559-42313374,2023-05-01T23:50:33,Bilbao,incomes,salary_partner,1588.51,-28968.82
buyer_1,Luis,28,ES78209545511493038850,TRX_N-00560-22115089,2023-05-01T11:24:22,Bilbao,Expense,cash,-100.0,-29068.82
buyer_1,Luis,28,ES78209545511493038850,TRX_N-00561-37518205,2023-05-04T15:18:05,Bilbao,expenses,mortgage,-974.82,-30043.64
buyer_1,Luis,28,ES78209545511493038850,TRX_N-00562-27244412,2023-05-06T19:52:03,Bilbao,expenses,internet,-42.0,-30085.64
buyer_1,Luis,28,ES78209545511493038850,TRX_N-00563-96616869,2023-05-06T10:36:18,Bilbao,expenses,phone,-31.36,-30117.0
buyer_1,Luis,28,ES78209545511493038850,TRX_N-00564-02862607,2023-05-07T09:03:56,Bilbao,expenses,gas,-58.29,-30175.29
buyer_1,Luis,28,ES78209545511493038850,TRX_N-00565-93957819,2023-05-08T15:13:13,Bilbao,expenses,water,-24.88,-30200.17
buyer_1,Luis,28,ES78209545511493038850,TRX_N-00566-63784522,2023-05-08T10:16:34,Bilbao,expenses,electricity,-29.81,-30229.98
buyer_1,Luis,28,ES78209545511493038850,TRX_N-00567-75895851,2023-05-08T10:29:36,Bilbao,Expense,food,-81.54,-30311.52
buyer_1,Luis,28,ES78209545511493038850,TRX_N-00568-33080550,2023-05-09T18:13:07,Elciego,Expense,cash,-100.0,-30411.52
buyer_1,Luis,28,ES78209545511493038850,TRX_N-00569-50365755,2023-05-09T13:06:43,Bilbao,expenses,children,-135.97,-30547.49
buyer_1,Luis,28,ES78209545511493038850,TRX_N-00570-53984631,2023-05-10T14:10:54,Bilbao,Expense,cash,-100.0,-30647.49
buyer_1,Luis,28,ES78209545511493038850,TRX_N-00571-73708221,2023-05-10T20:45:11,Bilbao,Expense,travel,-1844.41,-32491.9
buyer_1,Luis,28,ES78209545511493038850,TRX_N-00572-15206125,2023-05-11T11:45:05,Bilbao,Expense,cash,-100.0,-32591.9
buyer_1,Luis,28,ES78209545511493038850,TRX_N-00573-46187350,2023-05-14T16:09:20,Bilbao,Expense,cash,-100.0,-32691.9
buyer_1,Luis,28,ES78209545511493038850,TRX_N-00574-25626580,2023-05-16T20:45:26,Bilbao,Expense,transport,-63.33,-32755.23
buyer_1,Luis,28,ES78209545511493038850,TRX_N-00575-92784066,2023-05-17T10:23:12,Bilbao,Expense,transport,-59.24,-32814.47
buyer_1,Luis,28,ES78209545511493038850,TRX_N-00576-34189038,2023-05-17T17:10:41,Bilbao,Expense,cash,-100.0,-32914.47
buyer_1,Luis,28,ES78209545511493038850,TRX_N-00577-58912053,2023-05-21T09:09:45,Bilbao,Expense,food,-83.28,-32997.75
buyer_1,Luis,28,ES78209545511493038850,TRX_N-00578-88672469,2023-05-21T16:45:42,Bilbao,Expense,gifts,-302.49,-33300.24
buyer_1,Luis,28,ES78209545511493038850,TRX_N-00579-60204013,2023-05-22T13:16:18,Bilbao,Expense,appliances,-136.78,-33437.02
buyer_1,Luis,28,ES78209545511493038850,TRX_N-00580-32189545,2023-05-22T11:20:49,Bilbao,Expense,repairs,-131.82,-33568.84
buyer_1,Luis,28,ES78209545511493038850,TRX_N-00581-36409018,2023-05-23T02:28:49,Bilbao,Expense,food,-89.11,-33657.95
buyer_1,Luis,28,ES78209545511493038850,TRX_N-00582-13621966,2023-05-23T19:53:56,Bilbao,Expense,leisure,-18.48,-33676.43
buyer_1,Luis,28,ES78209545511493038850,TRX_N-00583-64531423,2023-05-25T04:49:12,Bilbao,Expense,transport,-81.22,-33757.65
buyer_1,Luis,28,ES78209545511493038850,TRX_N-00584-33297502,2023-05-25T15:56:46,Bilbao,Expense,clothing,-123.39,-33881.04
buyer_1,Luis,28,ES78209545511493038850,TRX_N-00585-84254698,2023-05-25T14:50:37,Bilbao,Expense,cash,-100.0,-33981.04
buyer_1,Luis,28,ES78209545511493038850,TRX_N-00586-81775322,2023-05-27T20:00:33,Irun,Expense,food,-91.05,-34072.09
buyer_1,Luis,28,ES78209545511493038850,TRX_N-00587-53913006,2023-05-28T19:19:49,Bilbao,Expense,food,-87.47,-34159.56
buyer_1,Luis,28,ES78209545511493038850,TRX_N-00588-17582403,2023-05-28T18:06:50,Bilbao,Expense,transport,-55.24,-34214.8
buyer_1,Luis,28,ES78209545511493038850,TRX_N-00589-21338747,2023-06-01T17:47:42,Bilbao,incomes,salary,1279.82,-32934.98
buyer_1,Luis,28,ES78209545511493038850,TRX_N-00590-33553628,2023-06-01T17:47:42,Bilbao,incomes,salary_partner,1588.51,-31346.47
buyer_1,Luis,28,ES78209545511493038850,TRX_N-00591-26971627,2023-06-01T17:47:42,Bilbao,incomes,salary_bonus,1006.25,-30340.22
buyer_1,Luis,28,ES78209545511493038850,TRX_N-00592-17808861,2023-06-01T17:47:42,Bilbao,incomes,salary_partner_bonus,1138.75,-29201.47
buyer_1,Luis,28,ES78209545511493038850,TRX_N-00593-88819747,2023-06-01T09:22:49,Bilbao,expenses,taxes,-1540.18,-30741.65
buyer_1,Luis,28,ES78209545511493038850,TRX_N-00594-61765974,2023-06-01T12:47:20,Bilbao,expenses,insurance,-533.88,-31275.53
buyer_1,Luis,28,ES78209545511493038850,TRX_N-00595-64980160,2023-06-01T14:34:29,Bilbao,Expense,leisure,-73.75,-31349.28
buyer_1,Luis,28,ES78209545511493038850,TRX_N-00596-51717146,2023-06-02T08:48:17,Bilbao,Expense,cash,-100.0,-31449.28
buyer_1,Luis,28,ES78209545511493038850,TRX_N-00597-68289742,2023-06-02T11:44:10,Bilbao,Expense,gifts,-257.19,-31706.47
buyer_1,Luis,28,ES78209545511493038850,TRX_N-00598-87488734,2023-06-04T03:00:38,Bilbao,expenses,mortgage,-974.82,-32681.29
buyer_1,Luis,28,ES78209545511493038850,TRX_N-00599-62757109,2023-06-04T15:17:06,Bilbao,Expense,food,-115.34,-32796.63
buyer_1,Luis,28,ES78209545511493038850,TRX_N-00600-04592223,2023-06-04T15:16:26,Bilbao,expenses,children,-135.17,-32931.8
buyer_1,Luis,28,ES78209545511493038850,TRX_N-00601-87321388,2023-06-05T17:40:47,Bilbao,expenses,electricity,-83.75,-33015.55
buyer_1,Luis,28,ES78209545511493038850,TRX_N-00602-95427905,2023-06-05T17:16:36,Bilbao,Expense,transport,-80.17,-33095.72
buyer_1,Luis,28,ES78209545511493038850,TRX_N-00603-60001270,2023-06-07T17:28:01,Bilbao,Expense,cash,-100.0,-33195.72
buyer_1,Luis,28,ES78209545511493038850,TRX_N-00604-94292760,2023-06-08T10:56:14,Bilbao,expenses,gas,-87.02,-33282.74
buyer_1,Luis,28,ES78209545511493038850,TRX_N-00605-45096632,2023-06-08T09:14:38,Bilbao,expenses,internet,-42.0,-33324.74
buyer_1,Luis,28,ES78209545511493038850,TRX_N-00606-72744352,2023-06-08T16:55:18,Bilbao,expenses,water,-21.36,-33346.1
buyer_1,Luis,28,ES78209545511493038850,TRX_N-00607-45631692,2023-06-08T12:29:49,Bilbao,expenses,phone,-34.96,-33381.06
buyer_1,Luis,28,ES78209545511493038850,TRX_N-00608-99397503,2023-06-08T12:49:28,Bilbao,Expense,repairs,-165.97,-33547.03
buyer_1,Luis,28,ES78209545511493038850,TRX_N-00609-48100858,2023-06-10T13:42:55,Bilbao,Expense,education,-70.73,-33617.76
buyer_1,Luis,28,ES78209545511493038850,TRX_N-00610-95539239,2023-06-11T14:57:57,Bilbao,Expense,repairs,-93.58,-33711.34
buyer_1,Luis,28,ES78209545511493038850,TRX_N-00611-74330898,2023-06-13T17:46:23,Alegría-Dulantzi,Expense,cash,-100.0,-33811.34
buyer_1,Luis,28,ES78209545511493038850,TRX_N-00612-56914623,2023-06-14T11:32:57,Portugalete,Expense,food,-98.35,-33909.69
buyer_1,Luis,28,ES78209545511493038850,TRX_N-00613-34194289,2023-06-14T15:21:30,Bilbao,Expense,cash,-100.0,-34009.69
buyer_1,Luis,28,ES78209545511493038850,TRX_N-00614-24969004,2023-06-14T15:46:43,Portugalete,Expense,gifts,-144.08,-34153.77
buyer_1,Luis,28,ES78209545511493038850,TRX_N-00615-10661074,2023-06-15T19:36:34,Bilbao,Expense,food,-65.42,-34219.19
buyer_1,Luis,28,ES78209545511493038850,TRX_N-00616-52945331,2023-06-15T08:50:24,Bilbao,Expense,cash,-100.0,-34319.19
buyer_1,Luis,28,ES78209545511493038850,TRX_N-00617-48154094,2023-06-15T09:48:05,Barakaldo,Expense,repairs,-254.63,-34573.82
buyer_1,Luis,28,ES78209545511493038850,TRX_N-00618-29588128,2023-06-17T11:13:16,Bilbao,Expense,transport,-53.91,-34627.73
buyer_1,Luis,28,ES78209545511493038850,TRX_N-00619-72063978,2023-06-18T09:14:21,Bilbao,Expense,clothing,-47.08,-34674.81
buyer_1,Luis,28,ES78209545511493038850,TRX_N-00620-83279188,2023-06-20T10:05:27,Bilbao,Expense,food,-110.62,-34785.43
buyer_1,Luis,28,ES78209545511493038850,TRX_N-00621-95692595,2023-06-23T10:44:00,Bilbao,Expense,healthcare,-46.67,-34832.1
buyer_1,Luis,28,ES78209545511493038850,TRX_N-00622-22177762,2023-06-24T11:48:17,Bilbao,Expense,leisure,-42.02,-34874.12
buyer_1,Luis,28,ES78209545511493038850,TRX_N-00623-72419456,2023-06-24T12:58:39,Bilbao,Expense,clothing,-86.49,-34960.61
buyer_1,Luis,28,ES78209545511493038850,TRX_N-00624-01606019,2023-06-25T15:19:00,Pasaia,Expense,food,-94.57,-35055.18
buyer_1,Luis,28,ES78209545511493038850,TRX_N-00625-00712695,2023-06-26T16:59:48,Bilbao,Expense,transport,-52.08,-35107.26
buyer_1,Luis,28,ES78209545511493038850,TRX_N-00626-42648097,2023-06-26T18:03:29,Bilbao,Expense,leisure,-26.29,-35133.55
buyer_1,Luis,28,ES78209545511493038850,TRX_N-00627-60910697,2023-06-30T14:02:29,Durango,Expense,food,-109.13,-35242.68
buyer_1,Luis,28,ES78209545511493038850,TRX_N-00628-43722158,2023-06-30T20:17:03,Bilbao,Expense,healthcare,-94.24,-35336.92
buyer_1,Luis,28,ES78209545511493038850,TRX_N-00629-43922500,2023-07-01T13:48:50,Bilbao,incomes,salary,1279.82,-34057.1
buyer_1,Luis,28,ES78209545511493038850,TRX_N-00630-16751259,2023-07-01T13:48:50,Bilbao,incomes,salary_partner,1588.51,-32468.59
buyer_1,Luis,28,ES78209545511493038850,TRX_N-00631-86335147,2023-07-01T13:48:50,Bilbao,incomes,extra_income,207.12,-32261.47
buyer_1,Luis,28,ES78209545511493038850,TRX_N-00632-92992896,2023-07-02T08:27:26,Bilbao,Expense,food,-118.83,-32380.3
buyer_1,Luis,28,ES78209545511493038850,TRX_N-00633-96919103,2023-07-03T11:52:32,Bilbao,Expense,transport,-86.25,-32466.55
buyer_1,Luis,28,ES78209545511493038850,TRX_N-00634-61100329,2023-07-03T09:39:21,Erandio,Expense,cash,-100.0,-32566.55
buyer_1,Luis,28,ES78209545511493038850,TRX_N-00635-73840849,2023-07-04T19:26:09,Bilbao,expenses,mortgage,-974.82,-33541.37
buyer_1,Luis,28,ES78209545511493038850,TRX_N-00636-05999319,2023-07-06T11:10:37,Bilbao,expenses,water,-26.22,-33567.59
buyer_1,Luis,28,ES78209545511493038850,TRX_N-00637-25958004,2023-07-06T06:27:23,Bilbao,expenses,phone,-32.37,-33599.96
buyer_1,Luis,28,ES78209545511493038850,TRX_N-00638-41424404,2023-07-07T19:54:42,Bilbao,Expense,repairs,-309.23,-33909.19
buyer_1,Luis,28,ES78209545511493038850,TRX_N-00639-71867276,2023-07-08T09:00:27,Bilbao,expenses,electricity,-61.12,-33970.31
buyer_1,Luis,28,ES78209545511493038850,TRX_N-00640-72416106,2023-07-08T09:33:40,Bilbao,expenses,gas,-36.9,-34007.21
buyer_1,Luis,28,ES78209545511493038850,TRX_N-00641-03835377,2023-07-08T09:31:47,Bilbao,expenses,internet,-42.0,-34049.21
buyer_1,Luis,28,ES78209545511493038850,TRX_N-00642-05970464,2023-07-08T19:57:44,Bilbao,Expense,transport,-62.26,-34111.47
buyer_1,Luis,28,ES78209545511493038850,TRX_N-00643-79030338,2023-07-09T13:00:49,Bilbao,Expense,cash,-100.0,-34211.47
buyer_1,Luis,28,ES78209545511493038850,TRX_N-00644-30742312,2023-07-09T17:49:20,Bilbao,Expense,repairs,-294.35,-34505.82
buyer_1,Luis,28,ES78209545511493038850,TRX_N-00645-15569698,2023-07-10T21:32:57,Bilbao,Expense,food,-61.77,-34567.59
buyer_1,Luis,28,ES78209545511493038850,TRX_N-00646-91923155,2023-07-12T16:24:09,Berango,Expense,repairs,-175.01,-34742.6
buyer_1,Luis,28,ES78209545511493038850,TRX_N-00647-95487870,2023-07-15T13:19:47,Bilbao,expenses,children,-59.14,-34801.74
buyer_1,Luis,28,ES78209545511493038850,TRX_N-00648-32312401,2023-07-16T18:21:29,Bilbao,Expense,healthcare,-115.43,-34917.17
buyer_1,Luis,28,ES78209545511493038850,TRX_N-00649-26512482,2023-07-16T10:12:28,Bilbao,Expense,appliances,-407.62,-35324.79
buyer_1,Luis,28,ES78209545511493038850,TRX_N-00650-50295132,2023-07-17T15:55:50,Bilbao,Expense,cash,-100.0,-35424.79
buyer_1,Luis,28,ES78209545511493038850,TRX_N-00651-95197145,2023-07-22T18:12:50,Bilbao,expenses,children,-203.18,-35627.97
buyer_1,Luis,28,ES78209545511493038850,TRX_N-00652-65351003,2023-07-24T23:47:54,Bilbao,Expense,food,-100.66,-35728.63
buyer_1,Luis,28,ES78209545511493038850,TRX_N-00653-94048165,2023-07-24T08:41:10,Bilbao,expenses,children,-192.71,-35921.34
buyer_1,Luis,28,ES78209545511493038850,TRX_N-00654-26478413,2023-07-25T08:58:37,Bilbao,Expense,leisure,-18.19,-35939.53
buyer_1,Luis,28,ES78209545511493038850,TRX_N-00655-06189465,2023-07-25T11:39:19,Bilbao,Expense,cash,-100.0,-36039.53
buyer_1,Luis,28,ES78209545511493038850,TRX_N-00656-82983994,2023-07-26T22:26:45,Bilbao,Expense,food,-80.49,-36120.02
buyer_1,Luis,28,ES78209545511493038850,TRX_N-00657-68928845,2023-07-26T08:56:24,Bilbao,Expense,leisure,-53.35,-36173.37
buyer_1,Luis,28,ES78209545511493038850,TRX_N-00658-96384876,2023-07-26T03:29:43,Bilbao,expenses,children,-152.12,-36325.49
buyer_1,Luis,28,ES78209545511493038850,TRX_N-00659-24156806,2023-07-28T20:55:35,Bilbao,Expense,cash,-100.0,-36425.49
buyer_1,Luis,28,ES78209545511493038850,TRX_N-00660-66545396,2023-07-29T11:49:25,Bilbao,Expense,food,-103.02,-36528.51
buyer_1,Luis,28,ES78209545511493038850,TRX_N-00661-55149028,2023-08-01T12:33:37,Bilbao,incomes,salary,1279.82,-35248.69
buyer_1,Luis,28,ES78209545511493038850,TRX_N-00662-78623577,2023-08-01T12:33:37,Bilbao,incomes,salary_partner,1588.51,-33660.18
buyer_1,Luis,28,ES78209545511493038850,TRX_N-00663-94732391,2023-08-01T12:25:45,Basauri,Expense,repairs,-29.14,-33689.32
buyer_1,Luis,28,ES78209545511493038850,TRX_N-00664-93479366,2023-08-02T22:59:42,Bilbao,Expense,appliances,-213.22,-33902.54
buyer_1,Luis,28,ES78209545511493038850,TRX_N-00665-78575839,2023-08-03T09:18:32,Bilbao,Expense,food,-72.94,-33975.48
buyer_1,Luis,28,ES78209545511493038850,TRX_N-00666-83267925,2023-08-03T08:19:04,Durango,Expense,transport,-65.51,-34040.99
buyer_1,Luis,28,ES78209545511493038850,TRX_N-00667-99658992,2023-08-03T03:29:20,Bilbao,Expense,leisure,-81.04,-34122.03
buyer_1,Luis,28,ES78209545511493038850,TRX_N-00668-46981945,2023-08-04T20:41:41,Bilbao,expenses,mortgage,-974.82,-35096.85
buyer_1,Luis,28,ES78209545511493038850,TRX_N-00669-51897048,2023-08-05T13:59:12,Bilbao,expenses,water,-39.18,-35136.03
buyer_1,Luis,28,ES78209545511493038850,TRX_N-00670-61928728,2023-08-05T12:04:27,Bilbao,expenses,gas,-80.23,-35216.26
buyer_1,Luis,28,ES78209545511493038850,TRX_N-00671-34251236,2023-08-06T13:26:33,Bilbao,Expense,education,-48.56,-35264.82
buyer_1,Luis,28,ES78209545511493038850,TRX_N-00672-92709862,2023-08-06T22:37:09,Bilbao,Expense,cash,-100.0,-35364.82
buyer_1,Luis,28,ES78209545511493038850,TRX_N-00673-25430412,2023-08-07T08:53:56,Bilbao,expenses,electricity,-49.51,-35414.33
buyer_1,Luis,28,ES78209545511493038850,TRX_N-00674-99670661,2023-08-07T15:50:05,Bilbao,expenses,internet,-42.0,-35456.33
buyer_1,Luis,28,ES78209545511493038850,TRX_N-00675-07310984,2023-08-08T13:35:05,Bilbao,expenses,phone,-40.17,-35496.5
buyer_1,Luis,28,ES78209545511493038850,TRX_N-00676-24349272,2023-08-09T15:50:50,Bilbao,Expense,transport,-61.98,-35558.48
buyer_1,Luis,28,ES78209545511493038850,TRX_N-00677-97432445,2023-08-09T17:29:30,Bilbao,Expense,clothing,-85.93,-35644.41
buyer_1,Luis,28,ES78209545511493038850,TRX_N-00678-18610339,2023-08-10T13:03:07,Bilbao,Expense,transport,-59.9,-35704.31
buyer_1,Luis,28,ES78209545511493038850,TRX_N-00679-56684177,2023-08-12T12:17:58,Bilbao,Expense,food,-69.48,-35773.79
buyer_1,Luis,28,ES78209545511493038850,TRX_N-00680-30288133,2023-08-12T12:20:58,Hondarribia,Expense,repairs,-166.35,-35940.14
buyer_1,Luis,28,ES78209545511493038850,TRX_N-00681-56372390,2023-08-13T16:34:59,Portugalete,Expense,gifts,-506.91,-36447.05
buyer_1,Luis,28,ES78209545511493038850,TRX_N-00682-80516965,2023-08-14T19:51:19,Bilbao,Expense,cash,-100.0,-36547.05
buyer_1,Luis,28,ES78209545511493038850,TRX_N-00683-53643184,2023-08-16T18:23:27,Bilbao,Expense,cash,-100.0,-36647.05
buyer_1,Luis,28,ES78209545511493038850,TRX_N-00684-59654672,2023-08-17T16:45:50,Irun,Expense,cash,-100.0,-36747.05
buyer_1,Luis,28,ES78209545511493038850,TRX_N-00685-34676611,2023-08-19T15:49:28,Bilbao,Expense,repairs,-202.51,-36949.56
buyer_1,Luis,28,ES78209545511493038850,TRX_N-00686-32505378,2023-08-20T20:12:19,Bilbao,Expense,leisure,-56.19,-37005.75
buyer_1,Luis,28,ES78209545511493038850,TRX_N-00687-92103995,2023-08-21T09:46:28,Bilbao,Expense,healthcare,-149.75,-37155.5
buyer_1,Luis,28,ES78209545511493038850,TRX_N-00688-78796794,2023-08-22T13:38:44,Bilbao,Expense,cash,-100.0,-37255.5
buyer_1,Luis,28,ES78209545511493038850,TRX_N-00689-52472864,2023-08-24T17:18:27,Bilbao,Expense,food,-119.86,-37375.36
buyer_1,Luis,28,ES78209545511493038850,TRX_N-00690-11073895,2023-08-24T13:42:41,Bilbao,Expense,education,-62.42,-37437.78
buyer_1,Luis,28,ES78209545511493038850,TRX_N-00691-06556138,2023-08-24T08:39:08,Bilbao,Expense,cash,-100.0,-37537.78
buyer_1,Luis,28,ES78209545511493038850,TRX_N-00692-28273201,2023-08-25T22:17:28,Andoain,Expense,cash,-100.0,-37637.78
buyer_1,Luis,28,ES78209545511493038850,TRX_N-00693-06195086,2023-08-26T19:41:02,Bilbao,Expense,leisure,-27.08,-37664.86
buyer_1,Luis,28,ES78209545511493038850,TRX_N-00694-48600692,2023-08-28T19:14:56,Bilbao,Expense,cash,-100.0,-37764.86
buyer_1,Luis,28,ES78209545511493038850,TRX_N-00695-49294301,2023-08-28T13:20:56,Bilbao,Expense,appliances,-159.44,-37924.3
buyer_1,Luis,28,ES78209545511493038850,TRX_N-00696-96718605,2023-08-29T11:47:47,Bilbao,Expense,education,-61.19,-37985.49
buyer_1,Luis,28,ES78209545511493038850,TRX_N-00697-67799501,2023-08-29T09:56:50,Bilbao,Expense,gifts,-90.75,-38076.24
buyer_1,Luis,28,ES78209545511493038850,TRX_N-00698-09167246,2023-09-01T15:25:58,Bilbao,incomes,salary,1279.82,-36796.42
buyer_1,Luis,28,ES78209545511493038850,TRX_N-00699-33437051,2023-09-01T15:25:58,Bilbao,incomes,salary_partner,1588.51,-35207.91
buyer_1,Luis,28,ES78209545511493038850,TRX_N-00700-05014049,2023-09-01T06:54:29,Hernani,Expense,gifts,-327.94,-35535.85
buyer_1,Luis,28,ES78209545511493038850,TRX_N-00701-98016150,2023-09-03T19:28:36,Bilbao,Expense,leisure,-45.77,-35581.62
buyer_1,Luis,28,ES78209545511493038850,TRX_N-00702-34953632,2023-09-04T16:32:18,Bilbao,expenses,mortgage,-974.82,-36556.44
buyer_1,Luis,28,ES78209545511493038850,TRX_N-00703-34472001,2023-09-04T15:54:31,Portugalete,Expense,repairs,-150.08,-36706.52
buyer_1,Luis,28,ES78209545511493038850,TRX_N-00704-88624930,2023-09-05T01:17:44,Bilbao,expenses,internet,-42.0,-36748.52
buyer_1,Luis,28,ES78209545511493038850,TRX_N-00705-46290612,2023-09-05T17:42:27,Bilbao,expenses,phone,-35.51,-36784.03
buyer_1,Luis,28,ES78209545511493038850,TRX_N-00706-66755866,2023-09-05T11:30:45,Bilbao,expenses,children,-204.21,-36988.24
buyer_1,Luis,28,ES78209545511493038850,TRX_N-00707-85692781,2023-09-06T23:33:59,Bilbao,expenses,water,-44.41,-37032.65
buyer_1,Luis,28,ES78209545511493038850,TRX_N-00708-01400550,2023-09-06T11:35:47,Bilbao,expenses,electricity,-88.34,-37120.99
buyer_1,Luis,28,ES78209545511493038850,TRX_N-00709-38028909,2023-09-06T12:27:10,Bilbao,Expense,food,-95.97,-37216.96
buyer_1,Luis,28,ES78209545511493038850,TRX_N-00710-80940610,2023-09-07T19:30:28,Bilbao,Expense,leisure,-57.25,-37274.21
buyer_1,Luis,28,ES78209545511493038850,TRX_N-00711-51028005,2023-09-07T19:10:59,Bilbao,Expense,gifts,-821.46,-38095.67
buyer_1,Luis,28,ES78209545511493038850,TRX_N-00712-76949334,2023-09-08T12:53:45,Bilbao,expenses,gas,-32.97,-38128.64
buyer_1,Luis,28,ES78209545511493038850,TRX_N-00713-59705766,2023-09-08T08:03:42,Labastida,Expense,food,-61.09,-38189.73
buyer_1,Luis,28,ES78209545511493038850,TRX_N-00714-06906937,2023-09-09T08:03:52,Bilbao,Expense,leisure,-53.0,-38242.73
buyer_1,Luis,28,ES78209545511493038850,TRX_N-00715-86061862,2023-09-09T16:23:32,Bilbao,Expense,cash,-100.0,-38342.73
buyer_1,Luis,28,ES78209545511493038850,TRX_N-00716-56017352,2023-09-10T11:29:03,Bilbao,Expense,transport,-40.12,-38382.85
buyer_1,Luis,28,ES78209545511493038850,TRX_N-00717-92680917,2023-09-10T16:34:59,Labastida,Expense,cash,-100.0,-38482.85
buyer_1,Luis,28,ES78209545511493038850,TRX_N-00718-17355581,2023-09-13T19:32:21,Bilbao,Expense,food,-62.58,-38545.43
buyer_1,Luis,28,ES78209545511493038850,TRX_N-00719-68192918,2023-09-14T17:51:47,Bilbao,Expense,food,-88.14,-38633.57
buyer_1,Luis,28,ES78209545511493038850,TRX_N-00720-04208089,2023-09-16T08:18:49,Bilbao,Expense,cash,-100.0,-38733.57
buyer_1,Luis,28,ES78209545511493038850,TRX_N-00721-05691525,2023-09-16T20:30:00,Bilbao,expenses,children,-89.33,-38822.9
buyer_1,Luis,28,ES78209545511493038850,TRX_N-00722-26779629,2023-09-17T17:09:35,Hernani,Expense,transport,-88.5,-38911.4
buyer_1,Luis,28,ES78209545511493038850,TRX_N-00723-53168751,2023-09-18T22:23:31,Bilbao,Expense,food,-71.99,-38983.39
buyer_1,Luis,28,ES78209545511493038850,TRX_N-00724-23435902,2023-09-18T15:58:52,Irun,Expense,transport,-43.68,-39027.07
buyer_1,Luis,28,ES78209545511493038850,TRX_N-00725-84776336,2023-09-18T17:18:27,Bilbao,Expense,clothing,-120.89,-39147.96
buyer_1,Luis,28,ES78209545511493038850,TRX_N-00726-80543465,2023-09-18T17:57:06,Hernani,Expense,repairs,-33.04,-39181.0
buyer_1,Luis,28,ES78209545511493038850,TRX_N-00727-75288186,2023-09-19T09:04:41,Erandio,Expense,leisure,-83.36,-39264.36
buyer_1,Luis,28,ES78209545511493038850,TRX_N-00728-71986335,2023-09-21T09:41:57,Bilbao,Expense,gifts,-296.73,-39561.09
buyer_1,Luis,28,ES78209545511493038850,TRX_N-00729-52635658,2023-09-23T16:22:27,Bilbao,Expense,food,-65.01,-39626.1
buyer_1,Luis,28,ES78209545511493038850,TRX_N-00730-59254858,2023-09-25T19:33:11,Santurtzi,Expense,food,-122.28,-39748.38
buyer_1,Luis,28,ES78209545511493038850,TRX_N-00731-34338911,2023-09-26T11:49:10,Bilbao,Expense,repairs,-210.99,-39959.37
buyer_1,Luis,28,ES78209545511493038850,TRX_N-00732-60985865,2023-09-28T15:35:51,Bilbao,Expense,leisure,-62.29,-40021.66
buyer_1,Luis,28,ES78209545511493038850,TRX_N-00733-44505398,2023-09-28T09:13:16,Bilbao,Expense,appliances,-191.8,-40213.46
buyer_1,Luis,28,ES78209545511493038850,TRX_N-00734-11782734,2023-09-29T17:56:28,Bilbao,Expense,leisure,-55.14,-40268.6
buyer_1,Luis,28,ES78209545511493038850,TRX_N-00735-06349698,2023-10-01T11:05:59,Bilbao,incomes,salary,1279.82,-38988.78
buyer_1,Luis,28,ES78209545511493038850,TRX_N-00736-22153401,2023-10-01T11:05:59,Bilbao,incomes,salary_partner,1588.51,-37400.27
buyer_1,Luis,28,ES78209545511493038850,TRX_N-00737-59001226,2023-10-02T15:03:26,Bilbao,Expense,food,-88.07,-37488.34
buyer_1,Luis,28,ES78209545511493038850,TRX_N-00738-06102143,2023-10-02T11:20:48,Bilbao,Expense,cash,-100.0,-37588.34
buyer_1,Luis,28,ES78209545511493038850,TRX_N-00739-82019875,2023-10-02T14:01:27,Bilbao,Expense,repairs,-150.44,-37738.78
buyer_1,Luis,28,ES78209545511493038850,TRX_N-00740-81938035,2023-10-04T12:37:20,Bilbao,expenses,mortgage,-974.82,-38713.6
buyer_1,Luis,28,ES78209545511493038850,TRX_N-00741-40091216,2023-10-05T08:18:14,Bilbao,expenses,gas,-104.4,-38818.0
buyer_1,Luis,28,ES78209545511493038850,TRX_N-00742-40970463,2023-10-05T23:40:50,Hernani,Expense,transport,-86.13,-38904.13
buyer_1,Luis,28,ES78209545511493038850,TRX_N-00743-15387744,2023-10-05T08:20:12,Bilbao,Expense,cash,-100.0,-39004.13
buyer_1,Luis,28,ES78209545511493038850,TRX_N-00744-43665906,2023-10-06T14:35:43,Bilbao,Expense,repairs,-310.2,-39314.33
buyer_1,Luis,28,ES78209545511493038850,TRX_N-00745-51628954,2023-10-07T08:45:14,Bilbao,expenses,water,-37.19,-39351.52
buyer_1,Luis,28,ES78209545511493038850,TRX_N-00746-35779925,2023-10-07T11:23:18,Bilbao,expenses,electricity,-61.98,-39413.5
buyer_1,Luis,28,ES78209545511493038850,TRX_N-00747-64297922,2023-10-08T13:57:18,Bilbao,expenses,internet,-42.0,-39455.5
buyer_1,Luis,28,ES78209545511493038850,TRX_N-00748-38598067,2023-10-08T15:00:42,Bilbao,expenses,phone,-34.06,-39489.56
buyer_1,Luis,28,ES78209545511493038850,TRX_N-00749-14313612,2023-10-10T14:25:29,Bilbao,Expense,transport,-81.54,-39571.1
buyer_1,Luis,28,ES78209545511493038850,TRX_N-00750-05001035,2023-10-12T20:00:32,Bilbao,Expense,healthcare,-112.17,-39683.27
buyer_1,Luis,28,ES78209545511493038850,TRX_N-00751-77701664,2023-10-12T16:41:57,Bilbao,Expense,cash,-100.0,-39783.27
buyer_1,Luis,28,ES78209545511493038850,TRX_N-00752-16885760,2023-10-13T16:12:08,Bilbao,Expense,clothing,-157.19,-39940.46
buyer_1,Luis,28,ES78209545511493038850,TRX_N-00753-65818976,2023-10-13T13:46:29,Bilbao,Expense,cash,-100.0,-40040.46
buyer_1,Luis,28,ES78209545511493038850,TRX_N-00754-49536285,2023-10-13T14:39:27,Bilbao,Expense,appliances,-310.18,-40350.64
buyer_1,Luis,28,ES78209545511493038850,TRX_N-00755-34522599,2023-10-14T09:21:30,Bilbao,Expense,food,-115.01,-40465.65
buyer_1,Luis,28,ES78209545511493038850,TRX_N-00756-16315431,2023-10-15T11:56:38,Bilbao,Expense,food,-124.13,-40589.78
buyer_1,Luis,28,ES78209545511493038850,TRX_N-00757-26227555,2023-10-16T23:46:18,Bilbao,Expense,leisure,-67.92,-40657.7
buyer_1,Luis,28,ES78209545511493038850,TRX_N-00758-79889132,2023-10-17T04:46:46,Bilbao,Expense,transport,-71.68,-40729.38
buyer_1,Luis,28,ES78209545511493038850,TRX_N-00759-13925528,2023-10-18T20:51:38,Bilbao,Expense,food,-121.92,-40851.3
buyer_1,Luis,28,ES78209545511493038850,TRX_N-00760-07265377,2023-10-18T20:38:06,Hernani,Expense,cash,-100.0,-40951.3
buyer_1,Luis,28,ES78209545511493038850,TRX_N-00761-58891249,2023-10-19T13:26:24,Bilbao,Expense,repairs,-212.14,-41163.44
buyer_1,Luis,28,ES78209545511493038850,TRX_N-00762-55210158,2023-10-24T18:02:18,Bilbao,Expense,cash,-100.0,-41263.44
buyer_1,Luis,28,ES78209545511493038850,TRX_N-00763-38679209,2023-10-25T07:05:51,Bilbao,Expense,clothing,-81.21,-41344.65
buyer_1,Luis,28,ES78209545511493038850,TRX_N-00764-02966962,2023-10-27T14:25:45,Bilbao,Expense,cash,-100.0,-41444.65
buyer_1,Luis,28,ES78209545511493038850,TRX_N-00765-61736699,2023-10-27T08:08:13,Bilbao,Expense,repairs,-293.64,-41738.29
buyer_1,Luis,28,ES78209545511493038850,TRX_N-00766-39097729,2023-10-28T15:34:15,Bilbao,Expense,repairs,-326.65,-42064.94
buyer_1,Luis,28,ES78209545511493038850,TRX_N-00767-84471881,2023-10-29T23:18:42,Bilbao,Expense,leisure,-21.85,-42086.79
buyer_1,Luis,28,ES78209545511493038850,TRX_N-00768-96992953,2023-11-01T10:39:25,Bilbao,incomes,salary,1279.82,-40806.97
buyer_1,Luis,28,ES78209545511493038850,TRX_N-00769-43443306,2023-11-01T10:39:25,Bilbao,incomes,salary_partner,1588.51,-39218.46
buyer_1,Luis,28,ES78209545511493038850,TRX_N-00770-79445370,2023-11-01T10:39:25,Bilbao,incomes,extra_income,207.12,-39011.34
buyer_1,Luis,28,ES78209545511493038850,TRX_N-00771-57817422,2023-11-01T09:31:15,Bilbao,Expense,leisure,-18.79,-39030.13
buyer_1,Luis,28,ES78209545511493038850,TRX_N-00772-02246439,2023-11-02T16:41:25,Bilbao,Expense,food,-84.35,-39114.48
buyer_1,Luis,28,ES78209545511493038850,TRX_N-00773-63761158,2023-11-02T08:05:57,Bilbao,Expense,cash,-100.0,-39214.48
buyer_1,Luis,28,ES78209545511493038850,TRX_N-00774-28383200,2023-11-03T05:55:44,Mungia,Expense,gifts,-741.61,-39956.09
buyer_1,Luis,28,ES78209545511493038850,TRX_N-00775-71078876,2023-11-04T04:09:07,Bilbao,expenses,mortgage,-974.82,-40930.91
buyer_1,Luis,28,ES78209545511493038850,TRX_N-00776-24194754,2023-11-04T08:59:20,Bilbao,Expense,food,-111.04,-41041.95
buyer_1,Luis,28,ES78209545511493038850,TRX_N-00777-19281425,2023-11-05T11:42:27,Bilbao,expenses,gas,-110.61,-41152.56
buyer_1,Luis,28,ES78209545511493038850,TRX_N-00778-42925166,2023-11-05T10:22:57,Bilbao,Expense,leisure,-24.5,-41177.06
buyer_1,Luis,28,ES78209545511493038850,TRX_N-00779-30736627,2023-11-05T10:31:59,Bilbao,Expense,clothing,-96.35,-41273.41
buyer_1,Luis,28,ES78209545511493038850,TRX_N-00780-53348248,2023-11-06T15:30:53,Bilbao,expenses,water,-35.55,-41308.96
buyer_1,Luis,28,ES78209545511493038850,TRX_N-00781-41202970,2023-11-06T16:09:21,Santurtzi,Expense,healthcare,-81.83,-41390.79
buyer_1,Luis,28,ES78209545511493038850,TRX_N-00782-47027749,2023-11-07T20:47:13,Bilbao,expenses,electricity,-32.63,-41423.42
buyer_1,Luis,28,ES78209545511493038850,TRX_N-00783-32451985,2023-11-07T20:30:13,Bilbao,Expense,repairs,-189.97,-41613.39
buyer_1,Luis,28,ES78209545511493038850,TRX_N-00784-59295034,2023-11-08T20:08:23,Bilbao,expenses,internet,-42.0,-41655.39
buyer_1,Luis,28,ES78209545511493038850,TRX_N-00785-71566216,2023-11-08T17:21:18,Bilbao,expenses,phone,-32.0,-41687.39
buyer_1,Luis,28,ES78209545511493038850,TRX_N-00786-31110357,2023-11-08T19:27:04,Bilbao,expenses,children,-103.28,-41790.67
buyer_1,Luis,28,ES78209545511493038850,TRX_N-00787-51108578,2023-11-09T16:40:59,Vitoria-Gasteiz,Expense,transport,-66.76,-41857.43
buyer_1,Luis,28,ES78209545511493038850,TRX_N-00788-90210162,2023-11-11T10:47:10,Bilbao,Expense,gifts,-649.53,-42506.96
buyer_1,Luis,28,ES78209545511493038850,TRX_N-00789-87787194,2023-11-12T10:28:51,Bilbao,Expense,transport,-67.4,-42574.36
buyer_1,Luis,28,ES78209545511493038850,TRX_N-00790-77468389,2023-11-13T14:34:10,Bilbao,Expense,leisure,-23.51,-42597.87
buyer_1,Luis,28,ES78209545511493038850,TRX_N-00791-09204078,2023-11-14T08:31:36,Bilbao,Expense,food,-81.95,-42679.82
buyer_1,Luis,28,ES78209545511493038850,TRX_N-00792-08725023,2023-11-15T11:57:21,Durango,Expense,food,-112.76,-42792.58
buyer_1,Luis,28,ES78209545511493038850,TRX_N-00793-05151094,2023-11-17T20:26:45,Bilbao,Expense,food,-90.44,-42883.02
buyer_1,Luis,28,ES78209545511493038850,TRX_N-00794-90410764,2023-11-18T08:39:40,Bilbao,Expense,leisure,-39.36,-42922.38
buyer_1,Luis,28,ES78209545511493038850,TRX_N-00795-57079593,2023-11-19T20:25:15,Bilbao,Expense,transport,-70.16,-42992.54
buyer_1,Luis,28,ES78209545511493038850,TRX_N-00796-36496965,2023-11-20T11:35:42,Bilbao,Expense,cash,-100.0,-43092.54
buyer_1,Luis,28,ES78209545511493038850,TRX_N-00797-54938945,2023-11-22T16:13:07,Bilbao,Expense,transport,-80.81,-43173.35
buyer_1,Luis,28,ES78209545511493038850,TRX_N-00798-98564939,2023-11-22T17:54:23,Bilbao,Expense,leisure,-40.38,-43213.73
buyer_1,Luis,28,ES78209545511493038850,TRX_N-00799-41380044,2023-11-22T22:48:36,Bilbao,Expense,appliances,-108.2,-43321.93
buyer_1,Luis,28,ES78209545511493038850,TRX_N-00800-47146759,2023-11-23T04:10:38,Bilbao,Expense,repairs,-187.63,-43509.56
buyer_1,Luis,28,ES78209545511493038850,TRX_N-00801-52566739,2023-11-24T19:13:46,Bilbao,Expense,cash,-100.0,-43609.56
buyer_1,Luis,28,ES78209545511493038850,TRX_N-00802-51356152,2023-11-27T22:21:10,Sopela,Expense,repairs,-106.7,-43716.26
buyer_1,Luis,28,ES78209545511493038850,TRX_N-00803-11484038,2023-11-28T09:34:34,Bilbao,Expense,cash,-100.0,-43816.26
buyer_1,Luis,28,ES78209545511493038850,TRX_N-00804-53007190,2023-11-30T08:25:21,Bilbao,Expense,cash,-100.0,-43916.26
buyer_1,Luis,28,ES78209545511493038850,TRX_N-00805-67323945,2023-12-01T18:15:32,Bilbao,incomes,salary,1279.82,-42636.44
buyer_1,Luis,28,ES78209545511493038850,TRX_N-00806-54843570,2023-12-01T18:15:32,Bilbao,incomes,salary_partner,1588.51,-41047.93
buyer_1,Luis,28,ES78209545511493038850,TRX_N-00807-71971012,2023-12-01T18:15:32,Bilbao,incomes,salary_bonus,949.88,-40098.05
buyer_1,Luis,28,ES78209545511493038850,TRX_N-00808-23219985,2023-12-01T18:15:32,Bilbao,incomes,salary_partner_bonus,1113.51,-38984.54
buyer_1,Luis,28,ES78209545511493038850,TRX_N-00809-04757268,2023-12-01T19:14:49,Bilbao,Expense,gifts,-331.34,-39315.88
buyer_1,Luis,28,ES78209545511493038850,TRX_N-00810-18054317,2023-12-03T08:48:14,Bilbao,Expense,food,-108.0,-39423.88
buyer_1,Luis,28,ES78209545511493038850,TRX_N-00811-60216124,2023-12-03T17:43:57,Bilbao,Expense,clothing,-139.13,-39563.01
buyer_1,Luis,28,ES78209545511493038850,TRX_N-00812-31538802,2023-12-04T19:04:36,Bilbao,expenses,mortgage,-974.82,-40537.83
buyer_1,Luis,28,ES78209545511493038850,TRX_N-00813-36135304,2023-12-04T03:28:47,Mungia,Expense,transport,-60.09,-40597.92
buyer_1,Luis,28,ES78209545511493038850,TRX_N-00814-84568236,2023-12-05T20:27:14,Bilbao,expenses,water,-22.14,-40620.06
buyer_1,Luis,28,ES78209545511493038850,TRX_N-00815-96456277,2023-12-05T20:50:28,Bilbao,expenses,phone,-39.43,-40659.49
buyer_1,Luis,28,ES78209545511493038850,TRX_N-00816-55967476,2023-12-06T09:53:07,Bilbao,expenses,internet,-42.0,-40701.49
buyer_1,Luis,28,ES78209545511493038850,TRX_N-00817-48815549,2023-12-06T17:12:29,Bilbao,Expense,repairs,-164.28,-40865.77
buyer_1,Luis,28,ES78209545511493038850,TRX_N-00818-92995979,2023-12-08T20:50:03,Bilbao,expenses,gas,-103.37,-40969.14
buyer_1,Luis,28,ES78209545511493038850,TRX_N-00819-95256116,2023-12-08T13:38:58,Bilbao,expenses,electricity,-43.94,-41013.08
buyer_1,Luis,28,ES78209545511493038850,TRX_N-00820-96129838,2023-12-10T08:51:49,Bilbao,Expense,repairs,-186.15,-41199.23
buyer_1,Luis,28,ES78209545511493038850,TRX_N-00821-62555228,2023-12-12T17:25:15,Bilbao,Expense,food,-78.22,-41277.45
buyer_1,Luis,28,ES78209545511493038850,TRX_N-00822-12646799,2023-12-13T22:44:55,Bilbao,expenses,children,-238.62,-41516.07
buyer_1,Luis,28,ES78209545511493038850,TRX_N-00823-82729277,2023-12-14T18:58:03,Bilbao,Expense,gifts,-660.84,-42176.91
buyer_1,Luis,28,ES78209545511493038850,TRX_N-00824-15601026,2023-12-16T12:41:05,Bilbao,Expense,food,-121.84,-42298.75
buyer_1,Luis,28,ES78209545511493038850,TRX_N-00825-68331632,2023-12-18T11:14:07,Bilbao,Expense,clothing,-144.56,-42443.31
buyer_1,Luis,28,ES78209545511493038850,TRX_N-00826-07290864,2023-12-20T16:07:07,Bilbao,Expense,transport,-50.37,-42493.68
buyer_1,Luis,28,ES78209545511493038850,TRX_N-00827-03911054,2023-12-21T21:57:36,Bilbao,Expense,food,-76.75,-42570.43
buyer_1,Luis,28,ES78209545511493038850,TRX_N-00828-07393054,2023-12-21T18:46:02,Irun,Expense,leisure,-53.49,-42623.92
buyer_1,Luis,28,ES78209545511493038850,TRX_N-00829-55115939,2023-12-21T13:49:24,Bilbao,Expense,cash,-100.0,-42723.92
buyer_1,Luis,28,ES78209545511493038850,TRX_N-00830-62464348,2023-12-22T08:46:19,Bilbao,Expense,repairs,-288.96,-43012.88
buyer_1,Luis,28,ES78209545511493038850,TRX_N-00831-20747052,2023-12-25T00:01:53,Bilbao,Expense,food,-87.13,-43100.01
buyer_1,Luis,28,ES78209545511493038850,TRX_N-00832-50741702,2023-12-25T14:05:53,Bilbao,Expense,cash,-100.0,-43200.01
buyer_1,Luis,28,ES78209545511493038850,TRX_N-00833-43115263,2023-12-26T10:02:42,Bilbao,Expense,gifts,-678.27,-43878.28
buyer_1,Luis,28,ES78209545511493038850,TRX_N-00834-61205612,2023-12-28T16:07:21,Galdakao,Expense,food,-71.27,-43949.55
buyer_1,Luis,28,ES78209545511493038850,TRX_N-00835-04863024,2023-12-28T08:52:08,Bilbao,Expense,clothing,-47.29,-43996.84
buyer_1,Luis,28,ES78209545511493038850,TRX_N-00836-41152413,2023-12-31T15:24:38,Bilbao,Expense,education,-62.4,-44059.24
buyer_1,Luis,28,ES78209545511493038850,TRX_N-00837-46297114,2024-01-01T12:32:02,Bilbao,incomes,salary,1305.92,-42753.32
buyer_1,Luis,28,ES78209545511493038850,TRX_N-00838-23353796,2024-01-01T12:32:02,Bilbao,incomes,salary_partner,1620.91,-41132.41
buyer_1,Luis,28,ES78209545511493038850,TRX_N-00839-32318961,2024-01-01T18:09:59,Bilbao,Expense,food,-89.83,-41222.24
buyer_1,Luis,28,ES78209545511493038850,TRX_N-00840-59438586,2024-01-01T16:18:51,Bilbao,Expense,repairs,-29.82,-41252.06
buyer_1,Luis,28,ES78209545511493038850,TRX_N-00841-82848618,2024-01-03T06:50:48,Bilbao,Expense,healthcare,-74.78,-41326.84
buyer_1,Luis,28,ES78209545511493038850,TRX_N-00842-84883115,2024-01-04T12:29:38,Bilbao,expenses,mortgage,-974.82,-42301.66
buyer_1,Luis,28,ES78209545511493038850,TRX_N-00843-11971187,2024-01-05T12:37:45,Bilbao,expenses,electricity,-89.16,-42390.82
buyer_1,Luis,28,ES78209545511493038850,TRX_N-00844-10788782,2024-01-05T13:10:24,Errenteria,Expense,food,-69.69,-42460.51
buyer_1,Luis,28,ES78209545511493038850,TRX_N-00845-22581793,2024-01-05T19:51:24,Bilbao,Expense,transport,-87.86,-42548.37
buyer_1,Luis,28,ES78209545511493038850,TRX_N-00846-93261077,2024-01-06T11:57:16,Bilbao,Expense,transport,-69.76,-42618.13
buyer_1,Luis,28,ES78209545511493038850,TRX_N-00847-94924401,2024-01-06T14:22:30,Bilbao,Expense,healthcare,-162.3,-42780.43
buyer_1,Luis,28,ES78209545511493038850,TRX_N-00848-07287261,2024-01-07T07:31:07,Bilbao,expenses,gas,-45.8,-42826.23
buyer_1,Luis,28,ES78209545511493038850,TRX_N-00849-73605470,2024-01-08T09:34:12,Bilbao,expenses,internet,-42.0,-42868.23
buyer_1,Luis,28,ES78209545511493038850,TRX_N-00850-22482238,2024-01-08T04:10:04,Bilbao,expenses,water,-21.84,-42890.07
buyer_1,Luis,28,ES78209545511493038850,TRX_N-00851-07737766,2024-01-08T08:10:29,Bilbao,expenses,phone,-36.58,-42926.65
buyer_1,Luis,28,ES78209545511493038850,TRX_N-00852-60378163,2024-01-13T19:04:37,Bilbao,Expense,cash,-100.0,-43026.65
buyer_1,Luis,28,ES78209545511493038850,TRX_N-00853-08478690,2024-01-15T16:46:41,Bilbao,Expense,leisure,-78.86,-43105.51
buyer_1,Luis,28,ES78209545511493038850,TRX_N-00854-14056802,2024-01-15T17:29:30,Bilbao,Expense,clothing,-111.68,-43217.19
buyer_1,Luis,28,ES78209545511493038850,TRX_N-00855-60703349,2024-01-15T11:33:41,Bilbao,Expense,appliances,-192.14,-43409.33
buyer_1,Luis,28,ES78209545511493038850,TRX_N-00856-98449278,2024-01-15T17:30:17,Bilbao,Expense,repairs,-51.72,-43461.05
buyer_1,Luis,28,ES78209545511493038850,TRX_N-00857-05850093,2024-01-16T20:12:02,Bilbao,Expense,gifts,-167.02,-43628.07
buyer_1,Luis,28,ES78209545511493038850,TRX_N-00858-83007959,2024-01-19T19:24:29,Bilbao,Expense,education,-67.49,-43695.56
buyer_1,Luis,28,ES78209545511493038850,TRX_N-00859-94948131,2024-01-19T20:45:17,Bilbao,Expense,cash,-100.0,-43795.56
buyer_1,Luis,28,ES78209545511493038850,TRX_N-00860-53842711,2024-01-21T08:36:42,Bilbao,Expense,leisure,-80.4,-43875.96
buyer_1,Luis,28,ES78209545511493038850,TRX_N-00861-96400776,2024-01-22T14:10:38,Bilbao,Expense,transport,-67.22,-43943.18
buyer_1,Luis,28,ES78209545511493038850,TRX_N-00862-11243850,2024-01-25T15:43:23,Hernani,Expense,education,-75.62,-44018.8
buyer_1,Luis,28,ES78209545511493038850,TRX_N-00863-91062477,2024-01-25T03:37:16,Bilbao,Expense,cash,-100.0,-44118.8
buyer_1,Luis,28,ES78209545511493038850,TRX_N-00864-49285212,2024-01-25T13:07:03,Bilbao,Expense,repairs,-285.54,-44404.34
buyer_1,Luis,28,ES78209545511493038850,TRX_N-00865-79773432,2024-01-26T10:52:36,Bilbao,Expense,food,-113.96,-44518.3
buyer_1,Luis,28,ES78209545511493038850,TRX_N-00866-32461726,2024-01-30T13:14:27,Bilbao,Expense,education,-49.8,-44568.1
buyer_1,Luis,28,ES78209545511493038850,TRX_N-00867-60136271,2024-01-31T11:51:05,Bilbao,Expense,food,-107.61,-44675.71
buyer_1,Luis,28,ES78209545511493038850,TRX_N-00868-28240170,2024-01-31T11:09:16,Bilbao,Expense,cash,-100.0,-44775.71
buyer_1,Luis,28,ES78209545511493038850,TRX_N-00869-90862068,2024-01-31T19:24:33,Bilbao,Expense,travel,-406.07,-45181.78
buyer_1,Luis,28,ES78209545511493038850,TRX_N-00870-34176490,2024-02-01T14:51:07,Bilbao,incomes,salary,1305.92,-43875.86
buyer_1,Luis,28,ES78209545511493038850,TRX_N-00871-42290036,2024-02-01T14:51:07,Bilbao,incomes,salary_partner,1620.91,-42254.95
buyer_1,Luis,28,ES78209545511493038850,TRX_N-00872-63275727,2024-02-01T20:45:37,Bilbao,Expense,food,-113.76,-42368.71
buyer_1,Luis,28,ES78209545511493038850,TRX_N-00873-48791210,2024-02-03T18:58:09,Lasarte-Oria,Expense,transport,-69.28,-42437.99
buyer_1,Luis,28,ES78209545511493038850,TRX_N-00874-90578214,2024-02-04T15:41:09,Bilbao,expenses,mortgage,-974.82,-43412.81
buyer_1,Luis,28,ES78209545511493038850,TRX_N-00875-69503785,2024-02-04T10:47:19,Pasaia,Expense,transport,-54.4,-43467.21
buyer_1,Luis,28,ES78209545511493038850,TRX_N-00876-98091881,2024-02-06T13:23:51,Bilbao,expenses,electricity,-51.05,-43518.26
buyer_1,Luis,28,ES78209545511493038850,TRX_N-00877-51758825,2024-02-06T12:27:10,Bilbao,Expense,transport,-55.03,-43573.29
buyer_1,Luis,28,ES78209545511493038850,TRX_N-00878-57798016,2024-02-06T18:45:23,Bilbao,Expense,clothing,-155.72,-43729.01
buyer_1,Luis,28,ES78209545511493038850,TRX_N-00879-58588370,2024-02-06T19:28:53,Bilbao,Expense,travel,-369.71,-44098.72
buyer_1,Luis,28,ES78209545511493038850,TRX_N-00880-26807870,2024-02-06T11:02:33,Bilbao,Expense,repairs,-152.48,-44251.2
buyer_1,Luis,28,ES78209545511493038850,TRX_N-00881-58266721,2024-02-07T13:54:20,Bilbao,expenses,gas,-53.56,-44304.76
buyer_1,Luis,28,ES78209545511493038850,TRX_N-00882-11830363,2024-02-07T10:11:21,Bilbao,Expense,education,-62.7,-44367.46
buyer_1,Luis,28,ES78209545511493038850,TRX_N-00883-94016949,2024-02-08T14:39:21,Bilbao,expenses,water,-20.07,-44387.53
buyer_1,Luis,28,ES78209545511493038850,TRX_N-00884-11475200,2024-02-08T08:17:17,Bilbao,expenses,internet,-42.0,-44429.53
buyer_1,Luis,28,ES78209545511493038850,TRX_N-00885-78410238,2024-02-08T19:03:36,Bilbao,expenses,phone,-40.91,-44470.44
buyer_1,Luis,28,ES78209545511493038850,TRX_N-00886-51574598,2024-02-08T01:24:57,Bilbao,Expense,food,-83.78,-44554.22
buyer_1,Luis,28,ES78209545511493038850,TRX_N-00887-50072865,2024-02-09T11:09:36,Bilbao,Expense,cash,-100.0,-44654.22
buyer_1,Luis,28,ES78209545511493038850,TRX_N-00888-69296263,2024-02-12T20:30:52,Bilbao,Expense,cash,-100.0,-44754.22
buyer_1,Luis,28,ES78209545511493038850,TRX_N-00889-56838022,2024-02-13T21:40:01,Bilbao,Expense,food,-117.17,-44871.39
buyer_1,Luis,28,ES78209545511493038850,TRX_N-00890-65575914,2024-02-13T21:04:10,Bilbao,Expense,transport,-40.3,-44911.69
buyer_1,Luis,28,ES78209545511493038850,TRX_N-00891-37581318,2024-02-14T08:32:46,Bilbao,Expense,food,-124.37,-45036.06
buyer_1,Luis,28,ES78209545511493038850,TRX_N-00892-53936610,2024-02-17T13:19:14,Bilbao,Expense,cash,-100.0,-45136.06
buyer_1,Luis,28,ES78209545511493038850,TRX_N-00893-26625580,2024-02-18T02:04:00,Basauri,Expense,food,-108.81,-45244.87
buyer_1,Luis,28,ES78209545511493038850,TRX_N-00894-85851440,2024-02-18T09:00:52,Bilbao,Expense,education,-58.56,-45303.43
buyer_1,Luis,28,ES78209545511493038850,TRX_N-00895-58485954,2024-02-19T18:57:27,Bilbao,Expense,clothing,-119.24,-45422.67
buyer_1,Luis,28,ES78209545511493038850,TRX_N-00896-89594700,2024-02-21T16:44:59,Bilbao,Expense,food,-94.83,-45517.5
buyer_1,Luis,28,ES78209545511493038850,TRX_N-00897-10702237,2024-02-22T10:49:56,Bilbao,Expense,appliances,-76.65,-45594.15
buyer_1,Luis,28,ES78209545511493038850,TRX_N-00898-97973926,2024-02-23T08:31:19,Leioa,Expense,cash,-100.0,-45694.15
buyer_1,Luis,28,ES78209545511493038850,TRX_N-00899-72248599,2024-02-23T08:13:41,Bilbao,Expense,repairs,-60.13,-45754.28
buyer_1,Luis,28,ES78209545511493038850,TRX_N-00900-42705988,2024-02-24T19:12:09,Andoain,Expense,leisure,-52.75,-45807.03
buyer_1,Luis,28,ES78209545511493038850,TRX_N-00901-35368063,2024-02-26T17:17:16,Bilbao,Expense,repairs,-264.76,-46071.79
buyer_1,Luis,28,ES78209545511493038850,TRX_N-00902-07896157,2024-02-28T15:47:10,Bilbao,Expense,gifts,-113.06,-46184.85
buyer_1,Luis,28,ES78209545511493038850,TRX_N-00903-55319265,2024-03-01T08:16:41,Bilbao,incomes,salary,1305.92,-44878.93
buyer_1,Luis,28,ES78209545511493038850,TRX_N-00904-68345472,2024-03-01T08:16:41,Bilbao,incomes,salary_partner,1620.91,-43258.02
buyer_1,Luis,28,ES78209545511493038850,TRX_N-00905-53081188,2024-03-01T08:16:41,Bilbao,incomes,extra_income,207.12,-43050.9
buyer_1,Luis,28,ES78209545511493038850,TRX_N-00906-64432279,2024-03-01T11:49:31,Bilbao,Expense,leisure,-32.52,-43083.42
buyer_1,Luis,28,ES78209545511493038850,TRX_N-00907-77887911,2024-03-01T19:51:06,Bilbao,Expense,cash,-100.0,-43183.42
buyer_1,Luis,28,ES78209545511493038850,TRX_N-00908-34760008,2024-03-03T15:12:15,Bilbao,Expense,gifts,-365.15,-43548.57
buyer_1,Luis,28,ES78209545511493038850,TRX_N-00909-63327126,2024-03-04T22:24:09,Bilbao,expenses,mortgage,-974.82,-44523.39
buyer_1,Luis,28,ES78209545511493038850,TRX_N-00910-25085900,2024-03-04T11:23:32,Bilbao,Expense,transport,-41.02,-44564.41
buyer_1,Luis,28,ES78209545511493038850,TRX_N-00911-64062822,2024-03-05T08:02:46,Bilbao,Expense,cash,-100.0,-44664.41
buyer_1,Luis,28,ES78209545511493038850,TRX_N-00912-98706103,2024-03-06T18:31:32,Bilbao,expenses,electricity,-88.49,-44752.9
buyer_1,Luis,28,ES78209545511493038850,TRX_N-00913-75950696,2024-03-08T08:37:00,Bilbao,expenses,gas,-100.04,-44852.94
buyer_1,Luis,28,ES78209545511493038850,TRX_N-00914-21741257,2024-03-08T10:16:01,Bilbao,expenses,phone,-35.63,-44888.57
buyer_1,Luis,28,ES78209545511493038850,TRX_N-00915-95734166,2024-03-08T12:59:30,Bilbao,expenses,water,-42.94,-44931.51
buyer_1,Luis,28,ES78209545511493038850,TRX_N-00916-70419592,2024-03-08T16:31:45,Bilbao,expenses,internet,-42.0,-44973.51
buyer_1,Luis,28,ES78209545511493038850,TRX_N-00917-86958796,2024-03-08T18:20:45,Bilbao,Expense,leisure,-45.35,-45018.86
buyer_1,Luis,28,ES78209545511493038850,TRX_N-00918-95597144,2024-03-08T23:08:51,Bilbao,Expense,cash,-100.0,-45118.86
buyer_1,Luis,28,ES78209545511493038850,TRX_N-00919-58953446,2024-03-08T12:03:42,Bilbao,expenses,children,-119.22,-45238.08
buyer_1,Luis,28,ES78209545511493038850,TRX_N-00920-27847344,2024-03-11T10:01:22,Bilbao,expenses,children,-260.23,-45498.31
buyer_1,Luis,28,ES78209545511493038850,TRX_N-00921-92442352,2024-03-13T12:02:34,Basauri,Expense,leisure,-81.68,-45579.99
buyer_1,Luis,28,ES78209545511493038850,TRX_N-00922-49350326,2024-03-13T15:36:54,Bilbao,Expense,cash,-100.0,-45679.99
buyer_1,Luis,28,ES78209545511493038850,TRX_N-00923-85656272,2024-03-14T14:26:02,Bilbao,Expense,travel,-393.16,-46073.15
buyer_1,Luis,28,ES78209545511493038850,TRX_N-00924-44911445,2024-03-15T19:45:46,Bilbao,Expense,cash,-100.0,-46173.15
buyer_1,Luis,28,ES78209545511493038850,TRX_N-00925-69662009,2024-03-22T22:11:06,Bilbao,expenses,children,-73.26,-46246.41
buyer_1,Luis,28,ES78209545511493038850,TRX_N-00926-45458303,2024-03-23T16:59:48,Iruña de Oca,Expense,cash,-100.0,-46346.41
buyer_1,Luis,28,ES78209545511493038850,TRX_N-00927-17619719,2024-03-23T20:09:24,Bilbao,Expense,gifts,-370.67,-46717.08
buyer_1,Luis,28,ES78209545511493038850,TRX_N-00928-14777232,2024-03-23T22:46:42,Bilbao,expenses,children,-141.68,-46858.76
buyer_1,Luis,28,ES78209545511493038850,TRX_N-00929-04701832,2024-03-25T10:05:33,Andoain,Expense,transport,-68.92,-46927.68
buyer_1,Luis,28,ES78209545511493038850,TRX_N-00930-07468564,2024-03-28T15:05:35,Hernani,Expense,leisure,-28.46,-46956.14
buyer_1,Luis,28,ES78209545511493038850,TRX_N-00931-89975558,2024-04-01T17:49:11,Bilbao,incomes,salary,1305.92,-45650.22
buyer_1,Luis,28,ES78209545511493038850,TRX_N-00932-22557148,2024-04-01T17:49:11,Bilbao,incomes,salary_partner,1620.91,-44029.31
buyer_1,Luis,28,ES78209545511493038850,TRX_N-00933-45965948,2024-04-01T13:08:12,Elciego,Expense,food,-120.38,-44149.69
buyer_1,Luis,28,ES78209545511493038850,TRX_N-00934-98854395,2024-04-01T16:57:02,Elciego,Expense,transport,-71.79,-44221.48
buyer_1,Luis,28,ES78209545511493038850,TRX_N-00935-57146714,2024-04-02T15:51:22,Bilbao,Expense,transport,-76.62,-44298.1
buyer_1,Luis,28,ES78209545511493038850,TRX_N-00936-29753747,2024-04-02T12:28:03,Basauri,Expense,cash,-100.0,-44398.1
buyer_1,Luis,28,ES78209545511493038850,TRX_N-00937-64846188,2024-04-03T21:08:47,Bilbao,Expense,cash,-100.0,-44498.1
buyer_1,Luis,28,ES78209545511493038850,TRX_N-00938-56597070,2024-04-04T14:21:45,Bilbao,expenses,mortgage,-974.82,-45472.92
buyer_1,Luis,28,ES78209545511493038850,TRX_N-00939-65643157,2024-04-05T17:54:31,Bilbao,expenses,gas,-110.96,-45583.88
buyer_1,Luis,28,ES78209545511493038850,TRX_N-00940-11923511,2024-04-05T20:18:24,Bilbao,Expense,transport,-53.58,-45637.46
buyer_1,Luis,28,ES78209545511493038850,TRX_N-00941-06529372,2024-04-05T16:01:14,Bilbao,Expense,cash,-100.0,-45737.46
buyer_1,Luis,28,ES78209545511493038850,TRX_N-00942-47627171,2024-04-06T18:04:04,Bilbao,expenses,water,-38.79,-45776.25
buyer_1,Luis,28,ES78209545511493038850,TRX_N-00943-54919404,2024-04-06T22:38:40,Bilbao,Expense,food,-90.51,-45866.76
buyer_1,Luis,28,ES78209545511493038850,TRX_N-00944-43826185,2024-04-06T10:13:31,Errenteria,Expense,cash,-100.0,-45966.76
buyer_1,Luis,28,ES78209545511493038850,TRX_N-00945-88672365,2024-04-06T15:29:25,Bilbao,Expense,repairs,-78.93,-46045.69
buyer_1,Luis,28,ES78209545511493038850,TRX_N-00946-97041837,2024-04-07T23:59:29,Bilbao,Expense,clothing,-140.04,-46185.73
buyer_1,Luis,28,ES78209545511493038850,TRX_N-00947-12672847,2024-04-08T10:37:57,Bilbao,expenses,electricity,-20.33,-46206.06
buyer_1,Luis,28,ES78209545511493038850,TRX_N-00948-69248621,2024-04-08T09:42:10,Bilbao,expenses,internet,-42.0,-46248.06
buyer_1,Luis,28,ES78209545511493038850,TRX_N-00949-89791622,2024-04-08T14:21:38,Bilbao,expenses,phone,-30.59,-46278.65
buyer_1,Luis,28,ES78209545511493038850,TRX_N-00950-17544907,2024-04-08T18:07:48,Bilbao,Expense,food,-98.72,-46377.37
buyer_1,Luis,28,ES78209545511493038850,TRX_N-00951-34634491,2024-04-08T18:22:21,Santurtzi,Expense,healthcare,-119.21,-46496.58
buyer_1,Luis,28,ES78209545511493038850,TRX_N-00952-04744521,2024-04-08T11:58:42,Oyón-Oion,Expense,cash,-100.0,-46596.58
buyer_1,Luis,28,ES78209545511493038850,TRX_N-00953-19667254,2024-04-08T15:43:48,Bilbao,Expense,repairs,-186.34,-46782.92
buyer_1,Luis,28,ES78209545511493038850,TRX_N-00954-51097672,2024-04-16T18:32:43,Leioa,Expense,food,-84.2,-46867.12
buyer_1,Luis,28,ES78209545511493038850,TRX_N-00955-07363775,2024-04-16T20:29:35,Leioa,Expense,travel,-1174.26,-48041.38
buyer_1,Luis,28,ES78209545511493038850,TRX_N-00956-55065219,2024-04-18T19:53:03,Santurtzi,Expense,transport,-79.83,-48121.21
buyer_1,Luis,28,ES78209545511493038850,TRX_N-00957-06582282,2024-04-18T09:47:52,Bilbao,Expense,cash,-100.0,-48221.21
buyer_1,Luis,28,ES78209545511493038850,TRX_N-00958-27413918,2024-04-19T18:06:00,Bilbao,Expense,clothing,-102.49,-48323.7
buyer_1,Luis,28,ES78209545511493038850,TRX_N-00959-78249067,2024-04-19T15:35:42,Bilbao,Expense,cash,-100.0,-48423.7
buyer_1,Luis,28,ES78209545511493038850,TRX_N-00960-98660671,2024-04-19T14:29:02,Bilbao,Expense,repairs,-280.99,-48704.69
buyer_1,Luis,28,ES78209545511493038850,TRX_N-00961-37418416,2024-04-20T23:50:22,Getxo,Expense,repairs,-330.02,-49034.71
buyer_1,Luis,28,ES78209545511493038850,TRX_N-00962-40679471,2024-04-21T17:14:33,Bilbao,Expense,leisure,-43.33,-49078.04
buyer_1,Luis,28,ES78209545511493038850,TRX_N-00963-91714211,2024-04-21T20:21:01,Bilbao,Expense,clothing,-101.05,-49179.09
buyer_1,Luis,28,ES78209545511493038850,TRX_N-00964-65689626,2024-04-22T12:11:07,Bilbao,Expense,food,-110.89,-49289.98
buyer_1,Luis,28,ES78209545511493038850,TRX_N-00965-72531269,2024-04-22T12:48:56,Leioa,Expense,cash,-100.0,-49389.98
buyer_1,Luis,28,ES78209545511493038850,TRX_N-00966-69325038,2024-04-22T15:36:17,Bilbao,expenses,children,-120.75,-49510.73
buyer_1,Luis,28,ES78209545511493038850,TRX_N-00967-54289916,2024-04-24T16:26:46,Bilbao,Expense,food,-60.24,-49570.97
buyer_1,Luis,28,ES78209545511493038850,TRX_N-00968-54824698,2024-04-25T13:54:30,Hondarribia,Expense,food,-62.32,-49633.29
buyer_1,Luis,28,ES78209545511493038850,TRX_N-00969-83722570,2024-04-25T13:29:12,Bilbao,Expense,education,-58.51,-49691.8
buyer_1,Luis,28,ES78209545511493038850,TRX_N-00970-44530354,2024-04-29T14:47:18,Bermeo,Expense,leisure,-39.91,-49731.71
buyer_1,Luis,28,ES78209545511493038850,TRX_N-00971-94701657,2024-04-29T13:45:15,Bilbao,Expense,cash,-100.0,-49831.71
buyer_1,Luis,28,ES78209545511493038850,TRX_N-00972-17993531,2024-04-30T03:50:07,Berango,Expense,healthcare,-141.02,-49972.73
buyer_1,Luis,28,ES78209545511493038850,TRX_N-00973-35193106,2024-05-01T19:37:59,Bilbao,incomes,salary,1305.92,-48666.81
buyer_1,Luis,28,ES78209545511493038850,TRX_N-00974-13378014,2024-05-01T19:37:59,Bilbao,incomes,salary_partner,1620.91,-47045.9
buyer_1,Luis,28,ES78209545511493038850,TRX_N-00975-81149044,2024-05-02T20:07:09,Berango,Expense,gifts,-178.91,-47224.81
buyer_1,Luis,28,ES78209545511493038850,TRX_N-00976-56400006,2024-05-04T23:41:30,Bilbao,expenses,mortgage,-974.82,-48199.63
buyer_1,Luis,28,ES78209545511493038850,TRX_N-00977-39277673,2024-05-05T13:12:38,Bilbao,expenses,electricity,-23.64,-48223.27
buyer_1,Luis,28,ES78209545511493038850,TRX_N-00978-52399078,2024-05-05T19:57:45,Bilbao,expenses,internet,-42.0,-48265.27
buyer_1,Luis,28,ES78209545511493038850,TRX_N-00979-89136895,2024-05-05T09:42:37,Bilbao,Expense,food,-103.87,-48369.14
buyer_1,Luis,28,ES78209545511493038850,TRX_N-00980-41286254,2024-05-05T11:53:18,Bilbao,expenses,children,-76.65,-48445.79
buyer_1,Luis,28,ES78209545511493038850,TRX_N-00981-24195634,2024-05-06T10:57:35,Bilbao,expenses,water,-25.52,-48471.31
buyer_1,Luis,28,ES78209545511493038850,TRX_N-00982-03559416,2024-05-06T18:14:42,Bilbao,Expense,food,-91.29,-48562.6
buyer_1,Luis,28,ES78209545511493038850,TRX_N-00983-32904612,2024-05-06T20:18:56,Bilbao,Expense,clothing,-159.76,-48722.36
buyer_1,Luis,28,ES78209545511493038850,TRX_N-00984-53371934,2024-05-08T06:59:04,Bilbao,expenses,phone,-32.42,-48754.78
buyer_1,Luis,28,ES78209545511493038850,TRX_N-00985-09314907,2024-05-08T18:58:55,Bilbao,expenses,gas,-83.09,-48837.87
buyer_1,Luis,28,ES78209545511493038850,TRX_N-00986-09977576,2024-05-09T15:56:25,Bilbao,Expense,transport,-70.17,-48908.04
buyer_1,Luis,28,ES78209545511493038850,TRX_N-00987-48715208,2024-05-13T20:39:15,Bilbao,Expense,cash,-100.0,-49008.04
buyer_1,Luis,28,ES78209545511493038850,TRX_N-00988-92781623,2024-05-14T13:49:31,Bilbao,Expense,healthcare,-112.1,-49120.14
buyer_1,Luis,28,ES78209545511493038850,TRX_N-00989-68626347,2024-05-15T23:08:30,Bilbao,Expense,food,-63.64,-49183.78
buyer_1,Luis,28,ES78209545511493038850,TRX_N-00990-59062503,2024-05-16T09:56:57,Bilbao,Expense,leisure,-66.72,-49250.5
buyer_1,Luis,28,ES78209545511493038850,TRX_N-00991-01662901,2024-05-18T10:35:08,Labastida,Expense,cash,-100.0,-49350.5
buyer_1,Luis,28,ES78209545511493038850,TRX_N-00992-64405595,2024-05-19T18:09:41,Bilbao,Expense,leisure,-48.73,-49399.23
buyer_1,Luis,28,ES78209545511493038850,TRX_N-00993-00446216,2024-05-19T16:20:17,Bilbao,Expense,clothing,-123.9,-49523.13
buyer_1,Luis,28,ES78209545511493038850,TRX_N-00994-65925303,2024-05-19T16:57:16,Mungia,Expense,repairs,-82.07,-49605.2
buyer_1,Luis,28,ES78209545511493038850,TRX_N-00995-01281720,2024-05-21T10:07:18,Bilbao,Expense,transport,-50.41,-49655.61
buyer_1,Luis,28,ES78209545511493038850,TRX_N-00996-52714787,2024-05-21T06:04:39,Bilbao,Expense,cash,-100.0,-49755.61
buyer_1,Luis,28,ES78209545511493038850,TRX_N-00997-23525231,2024-05-24T15:53:24,Bilbao,Expense,education,-60.54,-49816.15
buyer_1,Luis,28,ES78209545511493038850,TRX_N-00998-55378881,2024-05-27T18:03:24,Bilbao,Expense,transport,-85.54,-49901.69
buyer_1,Luis,28,ES78209545511493038850,TRX_N-00999-79990333,2024-05-28T19:09:41,Bilbao,Expense,transport,-76.14,-49977.83
buyer_1,Luis,28,ES78209545511493038850,TRX_N-01000-42593932,2024-05-29T16:09:57,Bilbao,Expense,transport,-61.62,-50039.45
buyer_1,Luis,28,ES78209545511493038850,TRX_N-01001-58813017,2024-06-01T13:17:18,Bilbao,incomes,salary,1305.92,-48733.53
buyer_1,Luis,28,ES78209545511493038850,TRX_N-01002-39946986,2024-06-01T13:17:18,Bilbao,incomes,salary_partner,1620.91,-47112.62
buyer_1,Luis,28,ES78209545511493038850,TRX_N-01003-62293232,2024-06-01T13:17:18,Bilbao,incomes,extra_income,207.12,-46905.5
buyer_1,Luis,28,ES78209545511493038850,TRX_N-01004-86736780,2024-06-01T13:17:18,Bilbao,incomes,salary_bonus,1019.46,-45886.04
buyer_1,Luis,28,ES78209545511493038850,TRX_N-01005-45511495,2024-06-01T13:17:18,Bilbao,incomes,salary_partner_bonus,1263.37,-44622.67
buyer_1,Luis,28,ES78209545511493038850,TRX_N-01006-80587946,2024-06-01T23:03:50,Bilbao,expenses,taxes,-1644.54,-46267.21
buyer_1,Luis,28,ES78209545511493038850,TRX_N-01007-55223599,2024-06-01T08:39:35,Bilbao,expenses,insurance,-584.05,-46851.26
buyer_1,Luis,28,ES78209545511493038850,TRX_N-01008-51527004,2024-06-01T02:51:14,Bilbao,Expense,cash,-100.0,-46951.26
buyer_1,Luis,28,ES78209545511493038850,TRX_N-01009-67906972,2024-06-02T13:22:10,Bilbao,Expense,repairs,-144.55,-47095.81
buyer_1,Luis,28,ES78209545511493038850,TRX_N-01010-90600762,2024-06-04T10:21:16,Bilbao,expenses,mortgage,-974.82,-48070.63
buyer_1,Luis,28,ES78209545511493038850,TRX_N-01011-85155792,2024-06-04T08:55:19,Bilbao,Expense,food,-78.37,-48149.0
buyer_1,Luis,28,ES78209545511493038850,TRX_N-01012-77070442,2024-06-04T13:31:38,Bilbao,Expense,leisure,-69.34,-48218.34
buyer_1,Luis,28,ES78209545511493038850,TRX_N-01013-69379867,2024-06-05T12:53:27,Bilbao,expenses,electricity,-69.17,-48287.51
buyer_1,Luis,28,ES78209545511493038850,TRX_N-01014-28250768,2024-06-05T11:28:43,Bilbao,Expense,repairs,-189.95,-48477.46
buyer_1,Luis,28,ES78209545511493038850,TRX_N-01015-67009373,2024-06-07T09:42:42,Bilbao,expenses,water,-39.99,-48517.45
buyer_1,Luis,28,ES78209545511493038850,TRX_N-01016-43129190,2024-06-07T08:52:38,Bilbao,expenses,gas,-45.98,-48563.43
buyer_1,Luis,28,ES78209545511493038850,TRX_N-01017-25569723,2024-06-07T08:33:04,Bilbao,expenses,phone,-33.54,-48596.97
buyer_1,Luis,28,ES78209545511493038850,TRX_N-01018-87520066,2024-06-08T23:45:01,Bilbao,expenses,internet,-42.0,-48638.97
buyer_1,Luis,28,ES78209545511493038850,TRX_N-01019-73545686,2024-06-09T10:21:14,Bilbao,Expense,repairs,-294.42,-48933.39
buyer_1,Luis,28,ES78209545511493038850,TRX_N-01020-71699268,2024-06-11T11:04:01,Bilbao,Expense,food,-67.51,-49000.9
buyer_1,Luis,28,ES78209545511493038850,TRX_N-01021-16091682,2024-06-11T08:44:20,Bilbao,Expense,transport,-53.18,-49054.08
buyer_1,Luis,28,ES78209545511493038850,TRX_N-01022-61240420,2024-06-14T21:24:19,Bilbao,Expense,food,-102.47,-49156.55
buyer_1,Luis,28,ES78209545511493038850,TRX_N-01023-43234657,2024-06-15T13:31:59,Bilbao,Expense,food,-74.89,-49231.44
buyer_1,Luis,28,ES78209545511493038850,TRX_N-01024-85095409,2024-06-15T21:13:55,Bilbao,Expense,transport,-61.56,-49293.0
buyer_1,Luis,28,ES78209545511493038850,TRX_N-01025-88080224,2024-06-16T16:12:07,Bilbao,Expense,education,-51.3,-49344.3
buyer_1,Luis,28,ES78209545511493038850,TRX_N-01026-06326595,2024-06-17T12:11:54,Bilbao,Expense,transport,-50.07,-49394.37
buyer_1,Luis,28,ES78209545511493038850,TRX_N-01027-13188279,2024-06-19T20:14:21,Bilbao,Expense,food,-69.27,-49463.64
buyer_1,Luis,28,ES78209545511493038850,TRX_N-01028-11045086,2024-06-20T12:06:35,Bilbao,Expense,food,-117.69,-49581.33
buyer_1,Luis,28,ES78209545511493038850,TRX_N-01029-04318629,2024-06-21T08:41:14,Bilbao,Expense,cash,-100.0,-49681.33
buyer_1,Luis,28,ES78209545511493038850,TRX_N-01030-21117013,2024-06-23T16:37:20,Salvatierra/Agurain,Expense,cash,-100.0,-49781.33
buyer_1,Luis,28,ES78209545511493038850,TRX_N-01031-12586479,2024-06-25T06:46:03,Bilbao,Expense,appliances,-119.35,-49900.68
buyer_1,Luis,28,ES78209545511493038850,TRX_N-01032-52134483,2024-06-25T16:59:49,Bilbao,Expense,repairs,-168.32,-50069.0
buyer_1,Luis,28,ES78209545511493038850,TRX_N-01033-79975957,2024-06-30T09:06:46,Mungia,Expense,cash,-100.0,-50169.0
buyer_1,Luis,28,ES78209545511493038850,TRX_N-01034-80300729,2024-07-01T11:39:49,Bilbao,incomes,salary,1305.92,-48863.08
buyer_1,Luis,28,ES78209545511493038850,TRX_N-01035-92078507,2024-07-01T11:39:49,Bilbao,incomes,salary_partner,1620.91,-47242.17
buyer_1,Luis,28,ES78209545511493038850,TRX_N-01036-28913554,2024-07-04T17:47:32,Bilbao,expenses,mortgage,-974.82,-48216.99
buyer_1,Luis,28,ES78209545511493038850,TRX_N-01037-41261683,2024-07-04T20:17:18,Bilbao,Expense,transport,-49.93,-48266.92
buyer_1,Luis,28,ES78209545511493038850,TRX_N-01038-60756739,2024-07-05T08:19:39,Vitoria-Gasteiz,Expense,clothing,-131.87,-48398.79
buyer_1,Luis,28,ES78209545511493038850,TRX_N-01039-39890543,2024-07-06T16:37:03,Bilbao,expenses,electricity,-60.58,-48459.37
buyer_1,Luis,28,ES78209545511493038850,TRX_N-01040-33903027,2024-07-06T20:43:10,Bilbao,expenses,gas,-87.01,-48546.38
buyer_1,Luis,28,ES78209545511493038850,TRX_N-01041-92312230,2024-07-06T18:37:48,Bilbao,expenses,internet,-42.0,-48588.38
buyer_1,Luis,28,ES78209545511493038850,TRX_N-01042-33388294,2024-07-06T14:30:14,Bilbao,expenses,phone,-43.65,-48632.03
buyer_1,Luis,28,ES78209545511493038850,TRX_N-01043-03686150,2024-07-06T10:02:13,Bilbao,Expense,cash,-100.0,-48732.03
buyer_1,Luis,28,ES78209545511493038850,TRX_N-01044-54943513,2024-07-07T22:12:27,Bilbao,expenses,water,-29.86,-48761.89
buyer_1,Luis,28,ES78209545511493038850,TRX_N-01045-70805296,2024-07-11T21:09:10,Bilbao,Expense,transport,-86.56,-48848.45
buyer_1,Luis,28,ES78209545511493038850,TRX_N-01046-72066465,2024-07-11T14:57:51,Bilbao,Expense,repairs,-259.37,-49107.82
buyer_1,Luis,28,ES78209545511493038850,TRX_N-01047-48641328,2024-07-13T17:24:23,Bilbao,Expense,clothing,-109.39,-49217.21
buyer_1,Luis,28,ES78209545511493038850,TRX_N-01048-69634419,2024-07-14T09:20:41,Amurrio,Expense,leisure,-68.13,-49285.34
buyer_1,Luis,28,ES78209545511493038850,TRX_N-01049-12434537,2024-07-16T09:07:17,Bilbao,Expense,education,-48.14,-49333.48
buyer_1,Luis,28,ES78209545511493038850,TRX_N-01050-02661000,2024-07-16T16:06:30,Bilbao,Expense,cash,-100.0,-49433.48
buyer_1,Luis,28,ES78209545511493038850,TRX_N-01051-07410012,2024-07-18T14:14:54,Bilbao,Expense,cash,-100.0,-49533.48
buyer_1,Luis,28,ES78209545511493038850,TRX_N-01052-58962286,2024-07-19T14:33:02,Bilbao,Expense,food,-119.75,-49653.23
buyer_1,Luis,28,ES78209545511493038850,TRX_N-01053-84668320,2024-07-19T20:10:42,Bilbao,Expense,clothing,-80.49,-49733.72
buyer_1,Luis,28,ES78209545511493038850,TRX_N-01054-11837499,2024-07-22T15:00:52,Bilbao,Expense,appliances,-336.4,-50070.12
buyer_1,Luis,28,ES78209545511493038850,TRX_N-01055-36321477,2024-07-24T15:51:55,Bilbao,Expense,food,-110.79,-50180.91
buyer_1,Luis,28,ES78209545511493038850,TRX_N-01056-55821163,2024-07-24T19:49:20,Bilbao,Expense,gifts,-463.54,-50644.45
buyer_1,Luis,28,ES78209545511493038850,TRX_N-01057-42037558,2024-07-25T05:40:51,Bilbao,Expense,repairs,-78.58,-50723.03
buyer_1,Luis,28,ES78209545511493038850,TRX_N-01058-62691540,2024-07-26T11:48:44,Bilbao,Expense,leisure,-76.9,-50799.93
buyer_1,Luis,28,ES78209545511493038850,TRX_N-01059-61171465,2024-07-27T20:59:53,Bilbao,Expense,leisure,-44.3,-50844.23
buyer_1,Luis,28,ES78209545511493038850,TRX_N-01060-45469118,2024-07-28T13:11:10,Labastida,Expense,food,-117.1,-50961.33
buyer_1,Luis,28,ES78209545511493038850,TRX_N-01061-44712538,2024-07-28T10:56:19,Bilbao,Expense,leisure,-51.63,-51012.96
buyer_1,Luis,28,ES78209545511493038850,TRX_N-01062-96741047,2024-07-30T18:01:51,Bilbao,Expense,food,-83.38,-51096.34
buyer_1,Luis,28,ES78209545511493038850,TRX_N-01063-43877941,2024-07-30T08:01:59,Bilbao,Expense,leisure,-33.29,-51129.63
buyer_1,Luis,28,ES78209545511493038850,TRX_N-01064-29744365,2024-08-01T10:53:46,Bilbao,incomes,salary,1305.92,-49823.71
buyer_1,Luis,28,ES78209545511493038850,TRX_N-01065-76234953,2024-08-01T10:53:46,Bilbao,incomes,salary_partner,1620.91,-48202.8
buyer_1,Luis,28,ES78209545511493038850,TRX_N-01066-76190349,2024-08-02T12:46:00,Bilbao,Expense,cash,-100.0,-48302.8
buyer_1,Luis,28,ES78209545511493038850,TRX_N-01067-74204516,2024-08-03T11:02:10,Bilbao,Expense,food,-79.54,-48382.34
buyer_1,Luis,28,ES78209545511493038850,TRX_N-01068-10379106,2024-08-04T11:55:26,Bilbao,expenses,mortgage,-974.82,-49357.16
buyer_1,Luis,28,ES78209545511493038850,TRX_N-01069-52335528,2024-08-05T15:18:12,Bilbao,expenses,internet,-42.0,-49399.16
buyer_1,Luis,28,ES78209545511493038850,TRX_N-01070-75901105,2024-08-05T16:05:42,Bilbao,Expense,transport,-76.4,-49475.56
buyer_1,Luis,28,ES78209545511493038850,TRX_N-01071-99295211,2024-08-07T19:37:14,Bilbao,expenses,water,-34.17,-49509.73
buyer_1,Luis,28,ES78209545511493038850,TRX_N-01072-31985310,2024-08-07T14:34:40,Bilbao,expenses,electricity,-44.16,-49553.89
buyer_1,Luis,28,ES78209545511493038850,TRX_N-01073-68706305,2024-08-08T20:17:55,Bilbao,expenses,gas,-63.03,-49616.92
buyer_1,Luis,28,ES78209545511493038850,TRX_N-01074-87648207,2024-08-08T19:23:59,Bilbao,expenses,phone,-43.77,-49660.69
buyer_1,Luis,28,ES78209545511493038850,TRX_N-01075-06333473,2024-08-08T12:50:46,Bilbao,Expense,transport,-89.18,-49749.87
buyer_1,Luis,28,ES78209545511493038850,TRX_N-01076-98077371,2024-08-10T18:33:04,Bilbao,Expense,leisure,-18.9,-49768.77
buyer_1,Luis,28,ES78209545511493038850,TRX_N-01077-28578043,2024-08-12T20:24:33,Bilbao,Expense,food,-99.33,-49868.1
buyer_1,Luis,28,ES78209545511493038850,TRX_N-01078-85577686,2024-08-12T20:01:36,Bilbao,Expense,clothing,-52.48,-49920.58
buyer_1,Luis,28,ES78209545511493038850,TRX_N-01079-20510813,2024-08-12T16:48:54,Barakaldo,Expense,appliances,-243.49,-50164.07
buyer_1,Luis,28,ES78209545511493038850,TRX_N-01080-20037412,2024-08-16T13:20:22,Bilbao,Expense,cash,-100.0,-50264.07
buyer_1,Luis,28,ES78209545511493038850,TRX_N-01081-38360266,2024-08-17T08:07:29,Bilbao,Expense,transport,-83.4,-50347.47
buyer_1,Luis,28,ES78209545511493038850,TRX_N-01082-75608622,2024-08-17T22:22:30,Bilbao,Expense,cash,-100.0,-50447.47
buyer_1,Luis,28,ES78209545511493038850,TRX_N-01083-15765487,2024-08-18T22:18:50,Bilbao,Expense,leisure,-56.16,-50503.63
buyer_1,Luis,28,ES78209545511493038850,TRX_N-01084-35312441,2024-08-19T11:48:35,Erandio,Expense,leisure,-29.92,-50533.55
buyer_1,Luis,28,ES78209545511493038850,TRX_N-01085-58952275,2024-08-22T13:19:08,Bilbao,Expense,food,-80.3,-50613.85
buyer_1,Luis,28,ES78209545511493038850,TRX_N-01086-43750736,2024-08-22T19:44:57,Bilbao,Expense,clothing,-114.03,-50727.88
buyer_1,Luis,28,ES78209545511493038850,TRX_N-01087-30820056,2024-08-22T12:12:01,Basauri,Expense,gifts,-726.67,-51454.55
buyer_1,Luis,28,ES78209545511493038850,TRX_N-01088-12770702,2024-08-23T20:40:06,Bilbao,Expense,transport,-43.49,-51498.04
buyer_1,Luis,28,ES78209545511493038850,TRX_N-01089-72785213,2024-08-23T13:06:23,Bilbao,Expense,cash,-100.0,-51598.04
buyer_1,Luis,28,ES78209545511493038850,TRX_N-01090-88786727,2024-08-24T09:45:04,Bilbao,Expense,gifts,-483.12,-52081.16
buyer_1,Luis,28,ES78209545511493038850,TRX_N-01091-64976804,2024-08-25T22:59:44,Bilbao,Expense,leisure,-18.57,-52099.73
buyer_1,Luis,28,ES78209545511493038850,TRX_N-01092-99459333,2024-08-26T16:04:54,Bilbao,Expense,transport,-76.25,-52175.98
buyer_1,Luis,28,ES78209545511493038850,TRX_N-01093-41418868,2024-08-27T20:07:16,Bilbao,Expense,cash,-100.0,-52275.98
buyer_1,Luis,28,ES78209545511493038850,TRX_N-01094-41000037,2024-08-28T14:26:48,Alegría-Dulantzi,Expense,cash,-100.0,-52375.98
buyer_1,Luis,28,ES78209545511493038850,TRX_N-01095-67051563,2024-08-29T20:51:02,Sestao,Expense,leisure,-84.49,-52460.47
buyer_1,Luis,28,ES78209545511493038850,TRX_N-01096-25084891,2024-08-29T15:58:31,Labastida,Expense,clothing,-124.39,-52584.86
buyer_1,Luis,28,ES78209545511493038850,TRX_N-01097-47555624,2024-09-01T15:32:44,Bilbao,incomes,salary,1305.92,-51278.94
buyer_1,Luis,28,ES78209545511493038850,TRX_N-01098-01264194,2024-09-01T15:32:44,Bilbao,incomes,salary_partner,1620.91,-49658.03
buyer_1,Luis,28,ES78209545511493038850,TRX_N-01099-52875443,2024-09-03T04:39:05,Bilbao,Expense,education,-62.4,-49720.43
buyer_1,Luis,28,ES78209545511493038850,TRX_N-01100-64123446,2024-09-04T17:57:00,Bilbao,expenses,mortgage,-974.82,-50695.25
buyer_1,Luis,28,ES78209545511493038850,TRX_N-01101-14996043,2024-09-05T10:48:49,Bilbao,Expense,transport,-54.09,-50749.34
buyer_1,Luis,28,ES78209545511493038850,TRX_N-01102-93923943,2024-09-06T09:28:27,Bilbao,expenses,water,-32.99,-50782.33
buyer_1,Luis,28,ES78209545511493038850,TRX_N-01103-92319611,2024-09-06T23:43:23,Bilbao,expenses,gas,-82.16,-50864.49
buyer_1,Luis,28,ES78209545511493038850,TRX_N-01104-23077792,2024-09-06T18:16:22,Bilbao,expenses,internet,-42.0,-50906.49
buyer_1,Luis,28,ES78209545511493038850,TRX_N-01105-17454143,2024-09-06T12:30:06,Bilbao,Expense,cash,-100.0,-51006.49
buyer_1,Luis,28,ES78209545511493038850,TRX_N-01106-07407565,2024-09-08T06:57:29,Bilbao,expenses,electricity,-61.66,-51068.15
buyer_1,Luis,28,ES78209545511493038850,TRX_N-01107-03647711,2024-09-08T16:20:28,Bilbao,expenses,phone,-39.25,-51107.4
buyer_1,Luis,28,ES78209545511493038850,TRX_N-01108-82524324,2024-09-08T15:43:32,Bilbao,Expense,transport,-40.94,-51148.34
buyer_1,Luis,28,ES78209545511493038850,TRX_N-01109-32407867,2024-09-09T06:11:24,Lasarte-Oria,Expense,cash,-100.0,-51248.34
buyer_1,Luis,28,ES78209545511493038850,TRX_N-01110-65039666,2024-09-10T18:48:06,Bilbao,Expense,clothing,-85.01,-51333.35
buyer_1,Luis,28,ES78209545511493038850,TRX_N-01111-87976019,2024-09-11T16:34:14,Bilbao,Expense,clothing,-62.11,-51395.46
buyer_1,Luis,28,ES78209545511493038850,TRX_N-01112-60931054,2024-09-11T03:58:45,Bilbao,Expense,gifts,-340.16,-51735.62
buyer_1,Luis,28,ES78209545511493038850,TRX_N-01113-73799745,2024-09-12T12:21:14,Bilbao,Expense,food,-96.02,-51831.64
buyer_1,Luis,28,ES78209545511493038850,TRX_N-01114-02073475,2024-09-12T17:50:14,Bilbao,Expense,clothing,-146.17,-51977.81
buyer_1,Luis,28,ES78209545511493038850,TRX_N-01115-12509879,2024-09-12T17:57:50,Bilbao,Expense,travel,-1492.99,-53470.8
buyer_1,Luis,28,ES78209545511493038850,TRX_N-01116-86520854,2024-09-13T17:56:56,Bilbao,Expense,clothing,-139.11,-53609.91
buyer_1,Luis,28,ES78209545511493038850,TRX_N-01117-62899797,2024-09-13T08:46:45,Bilbao,Expense,repairs,-280.64,-53890.55
buyer_1,Luis,28,ES78209545511493038850,TRX_N-01118-97447980,2024-09-17T19:59:48,Bilbao,Expense,transport,-56.26,-53946.81
buyer_1,Luis,28,ES78209545511493038850,TRX_N-01119-19616087,2024-09-18T17:14:06,Bilbao,Expense,education,-71.73,-54018.54
buyer_1,Luis,28,ES78209545511493038850,TRX_N-01120-55530353,2024-09-19T04:24:27,Bilbao,Expense,healthcare,-75.22,-54093.76
buyer_1,Luis,28,ES78209545511493038850,TRX_N-01121-68357601,2024-09-19T12:42:52,Irun,Expense,repairs,-273.56,-54367.32
buyer_1,Luis,28,ES78209545511493038850,TRX_N-01122-67528273,2024-09-22T10:24:03,Bilbao,Expense,food,-74.67,-54441.99
buyer_1,Luis,28,ES78209545511493038850,TRX_N-01123-67146467,2024-09-23T10:26:26,Bilbao,Expense,transport,-82.5,-54524.49
buyer_1,Luis,28,ES78209545511493038850,TRX_N-01124-34890525,2024-09-25T23:14:41,Salvatierra/Agurain,Expense,leisure,-53.24,-54577.73
buyer_1,Luis,28,ES78209545511493038850,TRX_N-01125-27780616,2024-09-28T22:41:02,Bilbao,Expense,leisure,-76.09,-54653.82
buyer_1,Luis,28,ES78209545511493038850,TRX_N-01126-50447842,2024-09-28T10:02:18,Bilbao,Expense,cash,-100.0,-54753.82
buyer_1,Luis,28,ES78209545511493038850,TRX_N-01127-67545311,2024-09-28T21:22:50,Bilbao,Expense,gifts,-331.72,-55085.54
buyer_1,Luis,28,ES78209545511493038850,TRX_N-01128-42492747,2024-09-30T10:31:52,Sopela,Expense,clothing,-60.73,-55146.27
buyer_1,Luis,28,ES78209545511493038850,TRX_N-01129-70219016,2024-09-30T11:50:11,Bilbao,Expense,education,-58.44,-55204.71
buyer_1,Luis,28,ES78209545511493038850,TRX_N-01130-71658687,2024-10-01T23:59:44,Bilbao,incomes,salary,1305.92,-53898.79
buyer_1,Luis,28,ES78209545511493038850,TRX_N-01131-39003791,2024-10-01T23:59:44,Bilbao,incomes,salary_partner,1620.91,-52277.88
buyer_1,Luis,28,ES78209545511493038850,TRX_N-01132-69433829,2024-10-01T23:59:44,Bilbao,incomes,extra_income,207.12,-52070.76
buyer_1,Luis,28,ES78209545511493038850,TRX_N-01133-13852818,2024-10-01T07:25:37,Bilbao,Expense,leisure,-61.42,-52132.18
buyer_1,Luis,28,ES78209545511493038850,TRX_N-01134-74447575,2024-10-03T09:24:05,Bilbao,Expense,food,-69.79,-52201.97
buyer_1,Luis,28,ES78209545511493038850,TRX_N-01135-28218945,2024-10-03T08:48:47,Bilbao,Expense,leisure,-24.44,-52226.41
buyer_1,Luis,28,ES78209545511493038850,TRX_N-01136-41480487,2024-10-04T13:03:52,Bilbao,expenses,mortgage,-974.82,-53201.23
buyer_1,Luis,28,ES78209545511493038850,TRX_N-01137-58544018,2024-10-04T19:51:05,Bilbao,Expense,healthcare,-39.35,-53240.58
buyer_1,Luis,28,ES78209545511493038850,TRX_N-01138-70816731,2024-10-05T10:34:28,Bilbao,expenses,internet,-42.0,-53282.58
buyer_1,Luis,28,ES78209545511493038850,TRX_N-01139-43003103,2024-10-05T05:03:27,Bilbao,Expense,transport,-65.35,-53347.93
buyer_1,Luis,28,ES78209545511493038850,TRX_N-01140-03427170,2024-10-06T16:17:10,Bilbao,expenses,water,-30.3,-53378.23
buyer_1,Luis,28,ES78209545511493038850,TRX_N-01141-18545721,2024-10-06T08:26:58,Bilbao,expenses,phone,-33.62,-53411.85
buyer_1,Luis,28,ES78209545511493038850,TRX_N-01142-32770764,2024-10-06T13:18:45,Bilbao,Expense,cash,-100.0,-53511.85
buyer_1,Luis,28,ES78209545511493038850,TRX_N-01143-03416422,2024-10-08T13:00:46,Bilbao,expenses,electricity,-54.46,-53566.31
buyer_1,Luis,28,ES78209545511493038850,TRX_N-01144-15331848,2024-10-08T18:57:16,Bilbao,expenses,gas,-49.21,-53615.52
