profile,name,age,iban,trx_id,timestamp,city,trx_type,trx_cat,amount_eur,balance
buyer_1,Luis,,ES41209538904585312595,TRX_N-00001-20761654,2022-01-01T12:02:38,Bilbao,incomes,salary,2945.2,5983.73
buyer_1,Luis,,ES41209538904585312595,TRX_N-00002-88067825,2022-01-03T16:55:39,Bilbao,expenses,food,-119.39,5864.34
buyer_1,Luis,,ES41209538904585312595,TRX_N-00003-58166546,2022-01-03T13:21:00,Bilbao,expenses,transport,-86.13,5778.21
buyer_1,Luis,,ES41209538904585312595,TRX_N-00004-35051445,2022-01-03T08:47:43,Bilbao,expenses,cash,-100.0,5678.21
buyer_1,Luis,,ES41209538904585312595,TRX_N-00005-61126916,2022-01-04T12:46:09,Bilbao,expenses,rent,-700.2,4978.01
buyer_1,Luis,,ES41209538904585312595,TRX_N-00006-06410991,2022-01-04T18:25:51,Hondarribia,expenses,cash,-100.0,4878.01
buyer_1,Luis,,ES41209538904585312595,TRX_N-00007-10202485,2022-01-04T01:35:55,Irun,expenses,repairs,-178.33,4699.68
buyer_1,Luis,,ES41209538904585312595,TRX_N-00008-60404778,2022-01-05T12:25:41,Bilbao,expenses,internet,-42.0,4657.68
buyer_1,Luis,,ES41209538904585312595,TRX_N-00009-23651190,2022-01-05T07:59:57,Bilbao,expenses,food,-113.54,4544.14
buyer_1,Luis,,ES41209538904585312595,TRX_N-00010-23552463,2022-01-05T03:34:05,Bilbao,expenses,education,-59.05,4485.09
buyer_1,Luis,,ES41209538904585312595,TRX_N-00011-32157724,2022-01-05T13:49:29,Bilbao,expenses,cash,-100.0,4385.09
buyer_1,Luis,,ES41209538904585312595,TRX_N-00012-78683298,2022-01-06T13:43:13,Bilbao,expenses,gas,-66.79,4318.3
buyer_1,Luis,,ES41209538904585312595,TRX_N-00013-26759792,2022-01-06T17:54:08,Donostia,expenses,clothing,-79.09,4239.21
buyer_1,Luis,,ES41209538904585312595,TRX_N-00014-33056526,2022-01-07T16:36:57,Bilbao,expenses,phone,-44.88,4194.33
buyer_1,Luis,,ES41209538904585312595,TRX_N-00015-07624080,2022-01-08T15:16:40,Bilbao,expenses,water,-27.75,4166.58
buyer_1,Luis,,ES41209538904585312595,TRX_N-00016-95991191,2022-01-08T14:19:58,Bilbao,expenses,electricity,-59.48,4107.1
buyer_1,Luis,,ES41209538904585312595,TRX_N-00017-25310179,2022-01-10T12:23:31,Bilbao,expenses,cash,-100.0,4007.1
buyer_1,Luis,,ES41209538904585312595,TRX_N-00018-12555313,2022-01-13T18:19:03,Bilbao,expenses,food,-92.91,3914.19
buyer_1,Luis,,ES41209538904585312595,TRX_N-00019-37324763,2022-01-14T10:27:44,Mungia,expenses,repairs,-330.11,3584.08
buyer_1,Luis,,ES41209538904585312595,TRX_N-00020-89542201,2022-01-21T23:16:54,Bilbao,expenses,cash,-100.0,3484.08
buyer_1,Luis,,ES41209538904585312595,TRX_N-00021-87452823,2022-01-23T12:27:27,Bilbao,expenses,food,-107.5,3376.58
buyer_1,Luis,,ES41209538904585312595,TRX_N-00022-62198576,2022-01-25T16:03:19,Getxo,expenses,food,-106.88,3269.7
buyer_1,Luis,,ES41209538904585312595,TRX_N-00023-40438048,2022-01-26T22:57:18,Bilbao,expenses,food,-121.09,3148.61
buyer_1,Luis,,ES41209538904585312595,TRX_N-00024-55209667,2022-01-26T17:41:01,Durango,expenses,gifts,-88.69,3059.92
buyer_1,Luis,,ES41209538904585312595,TRX_N-00025-55960004,2022-01-31T17:01:02,Bilbao,expenses,transport,-47.95,3011.97
buyer_1,Luis,,ES41209538904585312595,TRX_N-00026-41621143,2022-01-31T12:11:18,Bilbao,expenses,cash,-100.0,2911.97
buyer_1,Luis,,ES41209538904585312595,TRX_N-00027-35362334,2022-02-01T21:13:01,Bilbao,incomes,salary,2945.2,5857.17
buyer_1,Luis,,ES41209538904585312595,TRX_N-00028-85019565,2022-02-02T08:09:29,Bilbao,expenses,food,-75.43,5781.74
buyer_1,Luis,,ES41209538904585312595,TRX_N-00029-70159255,2022-02-03T15:46:47,Bilbao,expenses,clothing,-99.11,5682.63
buyer_1,Luis,,ES41209538904585312595,TRX_N-00030-00866480,2022-02-03T19:43:06,Bilbao,expenses,appliances,-354.47,5328.16
buyer_1,Luis,,ES41209538904585312595,TRX_N-00031-69338907,2022-02-04T20:00:25,Bilbao,expenses,rent,-700.2,4627.96
buyer_1,Luis,,ES41209538904585312595,TRX_N-00032-46394996,2022-02-06T17:42:26,Bilbao,expenses,water,-28.28,4599.68
buyer_1,Luis,,ES41209538904585312595,TRX_N-00033-34924942,2022-02-06T10:13:10,Bilbao,expenses,electricity,-25.52,4574.16
buyer_1,Luis,,ES41209538904585312595,TRX_N-00034-30118898,2022-02-06T08:56:20,Bilbao,expenses,internet,-42.0,4532.16
buyer_1,Luis,,ES41209538904585312595,TRX_N-00035-82836514,2022-02-06T12:09:24,Bilbao,expenses,food,-124.88,4407.28
buyer_1,Luis,,ES41209538904585312595,TRX_N-00036-41030931,2022-02-06T13:15:25,Bilbao,expenses,repairs,-253.87,4153.41
buyer_1,Luis,,ES41209538904585312595,TRX_N-00037-70090722,2022-02-07T17:27:43,Bilbao,expenses,leisure,-52.49,4100.92
buyer_1,Luis,,ES41209538904585312595,TRX_N-00038-88976042,2022-02-08T15:21:36,Bilbao,expenses,gas,-100.13,4000.79
buyer_1,Luis,,ES41209538904585312595,TRX_N-00039-68862008,2022-02-08T23:18:43,Bilbao,expenses,phone,-37.25,3963.54
buyer_1,Luis,,ES41209538904585312595,TRX_N-00040-22112140,2022-02-08T01:23:09,Bilbao,expenses,food,-109.29,3854.25
buyer_1,Luis,,ES41209538904585312595,TRX_N-00041-53368466,2022-02-08T20:04:14,Irun,expenses,cash,-100.0,3754.25
buyer_1,Luis,,ES41209538904585312595,TRX_N-00042-90651403,2022-02-10T22:53:18,Bilbao,expenses,cash,-100.0,3654.25
buyer_1,Luis,,ES41209538904585312595,TRX_N-00043-72323521,2022-02-11T20:43:46,Bilbao,expenses,food,-85.47,3568.78
buyer_1,Luis,,ES41209538904585312595,TRX_N-00044-74280232,2022-02-11T11:28:28,Lasarte-Oria,expenses,healthcare,-75.63,3493.15
buyer_1,Luis,,ES41209538904585312595,TRX_N-00045-74328347,2022-02-12T08:50:01,Erandio,expenses,food,-122.52,3370.63
buyer_1,Luis,,ES41209538904585312595,TRX_N-00046-77711561,2022-02-12T16:09:38,Bilbao,expenses,cash,-100.0,3270.63
buyer_1,Luis,,ES41209538904585312595,TRX_N-00047-64347110,2022-02-14T22:31:50,Bilbao,expenses,leisure,-56.54,3214.09
buyer_1,Luis,,ES41209538904585312595,TRX_N-00048-73123570,2022-02-14T20:53:27,Bilbao,expenses,cash,-100.0,3114.09
buyer_1,Luis,,ES41209538904585312595,TRX_N-00049-33089062,2022-02-15T18:49:08,Bilbao,expenses,leisure,-71.76,3042.33
buyer_1,Luis,,ES41209538904585312595,TRX_N-00050-52915562,2022-02-16T15:22:01,Sestao,expenses,cash,-100.0,2942.33
buyer_1,Luis,,ES41209538904585312595,TRX_N-00051-34222919,2022-02-19T21:04:40,Bilbao,expenses,food,-93.86,2848.47
buyer_1,Luis,,ES41209538904585312595,TRX_N-00052-25192092,2022-02-21T13:37:39,Bilbao,expenses,cash,-100.0,2748.47
buyer_1,Luis,,ES41209538904585312595,TRX_N-00053-92092183,2022-02-24T20:19:58,Portugalete,expenses,transport,-67.61,2680.86
buyer_1,Luis,,ES41209538904585312595,TRX_N-00054-92347033,2022-02-24T20:17:29,Barakaldo,expenses,cash,-100.0,2580.86
buyer_1,Luis,,ES41209538904585312595,TRX_N-00055-65120417,2022-02-25T14:00:18,Bilbao,expenses,cash,-100.0,2480.86
buyer_1,Luis,,ES41209538904585312595,TRX_N-00056-09092244,2022-02-26T11:59:22,Bilbao,expenses,leisure,-51.7,2429.16
buyer_1,Luis,,ES41209538904585312595,TRX_N-00057-32687889,2022-02-27T08:31:58,Bilbao,expenses,cash,-100.0,2329.16
buyer_1,Luis,,ES41209538904585312595,TRX_N-00058-63112463,2022-02-28T21:03:46,Bilbao,expenses,food,-109.65,2219.51
buyer_1,Luis,,ES41209538904585312595,TRX_N-00059-59220743,2022-02-28T16:17:36,Bilbao,expenses,cash,-100.0,2119.51
buyer_1,Luis,,ES41209538904585312595,TRX_N-00060-59473687,2022-02-28T12:37:42,Bilbao,expenses,appliances,-334.6,1784.91
buyer_1,Luis,,ES41209538904585312595,TRX_N-00061-56257467,2022-02-28T15:57:40,Bilbao,expenses,gifts,-204.02,1580.89
buyer_1,Luis,,ES41209538904585312595,TRX_N-00062-89241556,2022-03-01T14:47:26,Bilbao,incomes,salary,2945.2,4526.09
buyer_1,Luis,,ES41209538904585312595,TRX_N-00063-24345855,2022-03-01T19:23:02,Bilbao,expenses,cash,-100.0,4426.09
buyer_1,Luis,,ES41209538904585312595,TRX_N-00064-49686925,2022-03-03T10:16:47,Bilbao,expenses,food,-112.27,4313.82
buyer_1,Luis,,ES41209538904585312595,TRX_N-00065-44031801,2022-03-04T10:12:24,Bilbao,expenses,rent,-700.2,3613.62
buyer_1,Luis,,ES41209538904585312595,TRX_N-00066-71155667,2022-03-05T22:39:47,Bilbao,expenses,electricity,-33.06,3580.56
buyer_1,Luis,,ES41209538904585312595,TRX_N-00067-12283176,2022-03-05T18:53:06,Bilbao,expenses,internet,-42.0,3538.56
buyer_1,Luis,,ES41209538904585312595,TRX_N-00068-35896579,2022-03-07T10:29:18,Bilbao,expenses,phone,-35.51,3503.05
buyer_1,Luis,,ES41209538904585312595,TRX_N-00069-39626549,2022-03-08T16:08:41,Bilbao,expenses,water,-23.65,3479.4
buyer_1,Luis,,ES41209538904585312595,TRX_N-00070-88910612,2022-03-08T00:00:17,Bilbao,expenses,gas,-84.75,3394.65
buyer_1,Luis,,ES41209538904585312595,TRX_N-00071-21753340,2022-03-09T08:08:04,Zuia,expenses,cash,-100.0,3294.65
buyer_1,Luis,,ES41209538904585312595,TRX_N-00072-96254403,2022-03-10T22:52:07,Bilbao,expenses,education,-70.26,3224.39
buyer_1,Luis,,ES41209538904585312595,TRX_N-00073-74809394,2022-03-11T18:54:01,Bilbao,expenses,repairs,-27.57,3196.82
buyer_1,Luis,,ES41209538904585312595,TRX_N-00074-09322529,2022-03-12T18:43:47,Bilbao,expenses,cash,-100.0,3096.82
buyer_1,Luis,,ES41209538904585312595,TRX_N-00075-97738383,2022-03-13T15:50:10,Bilbao,expenses,food,-98.99,2997.83
buyer_1,Luis,,ES41209538904585312595,TRX_N-00076-82678546,2022-03-14T22:58:37,Bilbao,expenses,cash,-100.0,2897.83
buyer_1,Luis,,ES41209538904585312595,TRX_N-00077-83780290,2022-03-14T15:17:02,Bilbao,expenses,repairs,-91.17,2806.66
buyer_1,Luis,,ES41209538904585312595,TRX_N-00078-46228093,2022-03-17T20:06:47,Bilbao,expenses,food,-112.15,2694.51
buyer_1,Luis,,ES41209538904585312595,TRX_N-00079-12494116,2022-03-17T20:34:09,Bilbao,expenses,clothing,-98.69,2595.82
buyer_1,Luis,,ES41209538904585312595,TRX_N-00080-84172650,2022-03-18T15:08:47,Bilbao,expenses,education,-55.72,2540.1
buyer_1,Luis,,ES41209538904585312595,TRX_N-00081-03429085,2022-03-18T11:54:23,Bilbao,expenses,repairs,-257.19,2282.91
buyer_1,Luis,,ES41209538904585312595,TRX_N-00082-38214942,2022-03-19T15:16:35,Bilbao,expenses,food,-83.85,2199.06
buyer_1,Luis,,ES41209538904585312595,TRX_N-00083-10902943,2022-03-19T10:18:07,Bilbao,expenses,cash,-100.0,2099.06
buyer_1,Luis,,ES41209538904585312595,TRX_N-00084-89028028,2022-03-20T02:40:45,Bilbao,expenses,food,-121.66,1977.4
buyer_1,Luis,,ES41209538904585312595,TRX_N-00085-85918454,2022-03-21T15:07:33,Bilbao,expenses,leisure,-59.09,1918.31
buyer_1,Luis,,ES41209538904585312595,TRX_N-00086-63336714,2022-03-21T22:50:47,Bilbao,expenses,cash,-100.0,1818.31
buyer_1,Luis,,ES41209538904585312595,TRX_N-00087-85259545,2022-03-22T08:36:01,Bilbao,expenses,gifts,-404.43,1413.88
buyer_1,Luis,,ES41209538904585312595,TRX_N-00088-35638968,2022-03-24T18:34:35,Bilbao,expenses,food,-68.99,1344.89
buyer_1,Luis,,ES41209538904585312595,TRX_N-00089-01975629,2022-03-24T08:31:47,Bilbao,expenses,leisure,-30.15,1314.74
buyer_1,Luis,,ES41209538904585312595,TRX_N-00090-19157079,2022-03-25T08:53:51,Bilbao,expenses,repairs,-55.15,1259.59
buyer_1,Luis,,ES41209538904585312595,TRX_N-00091-80936031,2022-03-26T04:57:53,Bilbao,expenses,healthcare,-76.05,1183.54
buyer_1,Luis,,ES41209538904585312595,TRX_N-00092-79792358,2022-03-26T23:05:05,Bilbao,expenses,cash,-100.0,1083.54
buyer_1,Luis,,ES41209538904585312595,TRX_N-00093-00044912,2022-03-29T16:39:48,Bilbao,expenses,leisure,-65.76,1017.78
buyer_1,Luis,,ES41209538904585312595,TRX_N-00094-02198544,2022-03-29T17:55:48,Errenteria,expenses,cash,-100.0,917.78
buyer_1,Luis,,ES41209538904585312595,TRX_N-00095-14212909,2022-03-30T13:00:27,Bilbao,expenses,leisure,-52.03,865.75
buyer_1,Luis,,ES41209538904585312595,TRX_N-00096-50451501,2022-03-30T08:54:56,Bilbao,expenses,repairs,-316.95,548.8
buyer_1,Luis,,ES41209538904585312595,TRX_N-00097-85103958,2022-03-31T16:04:42,Errenteria,expenses,cash,-100.0,448.8
buyer_1,Luis,,ES41209538904585312595,TRX_N-00098-97701774,2022-04-01T10:54:17,Bilbao,incomes,salary,2945.2,3394.0
buyer_1,Luis,,ES41209538904585312595,TRX_N-00099-34239685,2022-04-01T10:54:17,Bilbao,incomes,extra_income,349.57,3743.57
buyer_1,Luis,,ES41209538904585312595,TRX_N-00100-83451820,2022-04-01T11:25:52,Bilbao,expenses,food,-96.88,3646.69
buyer_1,Luis,,ES41209538904585312595,TRX_N-00101-19197421,2022-04-01T08:59:22,Bilbao,expenses,repairs,-47.84,3598.85
buyer_1,Luis,,ES41209538904585312595,TRX_N-00102-48885313,2022-04-02T04:07:38,Bilbao,expenses,appliances,-198.97,3399.88
buyer_1,Luis,,ES41209538904585312595,TRX_N-00103-32526693,2022-04-03T04:47:54,Santurtzi,expenses,clothing,-74.96,3324.92
buyer_1,Luis,,ES41209538904585312595,TRX_N-00104-42877348,2022-04-04T18:14:53,Bilbao,expenses,rent,-700.2,2624.72
buyer_1,Luis,,ES41209538904585312595,TRX_N-00105-76815048,2022-04-04T15:11:47,Bilbao,expenses,gifts,-691.97,1932.75
buyer_1,Luis,,ES41209538904585312595,TRX_N-00106-51659012,2022-04-05T12:39:52,Bilbao,expenses,gas,-71.67,1861.08
buyer_1,Luis,,ES41209538904585312595,TRX_N-00107-96665677,2022-04-05T23:27:45,Bilbao,expenses,internet,-42.0,1819.08
buyer_1,Luis,,ES41209538904585312595,TRX_N-00108-81306095,2022-04-07T02:41:07,Durango,expenses,cash,-100.0,1719.08
buyer_1,Luis,,ES41209538904585312595,TRX_N-00109-96951896,2022-04-08T22:21:53,Bilbao,expenses,electricity,-85.15,1633.93
buyer_1,Luis,,ES41209538904585312595,TRX_N-00110-13667075,2022-04-08T10:49:53,Bilbao,expenses,phone,-42.94,1590.99
buyer_1,Luis,,ES41209538904585312595,TRX_N-00111-31710289,2022-04-08T15:20:37,Bilbao,expenses,water,-31.15,1559.84
buyer_1,Luis,,ES41209538904585312595,TRX_N-00112-28602271,2022-04-09T13:10:23,Bilbao,expenses,transport,-45.2,1514.64
buyer_1,Luis,,ES41209538904585312595,TRX_N-00113-47161920,2022-04-11T17:09:38,Bilbao,expenses,clothing,-52.04,1462.6
buyer_1,Luis,,ES41209538904585312595,TRX_N-00114-86497173,2022-04-12T13:23:45,Bilbao,expenses,leisure,-62.21,1400.39
buyer_1,Luis,,ES41209538904585312595,TRX_N-00115-42364829,2022-04-13T19:39:35,Zarautz,expenses,transport,-88.55,1311.84
buyer_1,Luis,,ES41209538904585312595,TRX_N-00116-94312455,2022-04-14T09:37:33,Bilbao,expenses,leisure,-76.52,1235.32
buyer_1,Luis,,ES41209538904585312595,TRX_N-00117-87907676,2022-04-15T05:57:37,Zarautz,expenses,leisure,-70.5,1164.82
buyer_1,Luis,,ES41209538904585312595,TRX_N-00118-71599718,2022-04-16T23:17:24,Sopela,expenses,cash,-100.0,1064.82
buyer_1,Luis,,ES41209538904585312595,TRX_N-00119-46062449,2022-04-17T00:31:10,Bilbao,expenses,cash,-100.0,964.82
buyer_1,Luis,,ES41209538904585312595,TRX_N-00120-77602986,2022-04-18T20:05:43,Bilbao,expenses,cash,-100.0,864.82
buyer_1,Luis,,ES41209538904585312595,TRX_N-00121-71311383,2022-04-19T12:16:51,Bilbao,expenses,transport,-85.87,778.95
buyer_1,Luis,,ES41209538904585312595,TRX_N-00122-66174067,2022-04-19T10:02:11,Bilbao,expenses,gifts,-502.39,276.56
buyer_1,Luis,,ES41209538904585312595,TRX_N-00123-53649958,2022-04-19T20:49:29,Bilbao,expenses,car,-224.03,52.53
buyer_1,Luis,,ES41209538904585312595,TRX_N-00124-87596582,2022-04-20T18:08:17,Bilbao,expenses,food,-72.22,-19.69
buyer_1,Luis,,ES41209538904585312595,TRX_N-00125-32162671,2022-04-20T12:39:26,Bilbao,expenses,cash,-100.0,-119.69
buyer_1,Luis,,ES41209538904585312595,TRX_N-00126-30162889,2022-04-20T17:34:56,Galdakao,expenses,appliances,-232.46,-352.15
buyer_1,Luis,,ES41209538904585312595,TRX_N-00127-44736734,2022-04-23T21:06:36,Bilbao,expenses,clothing,-62.67,-414.82
buyer_1,Luis,,ES41209538904585312595,TRX_N-00128-86168053,2022-04-26T19:12:12,Bilbao,expenses,transport,-48.06,-462.88
buyer_1,Luis,,ES41209538904585312595,TRX_N-00129-53283296,2022-05-01T13:04:42,Bilbao,incomes,salary,2945.2,2482.32
buyer_1,Luis,,ES41209538904585312595,TRX_N-00130-49565554,2022-05-01T19:09:56,Bilbao,expenses,education,-64.28,2418.04
buyer_1,Luis,,ES41209538904585312595,TRX_N-00131-80739505,2022-05-02T14:59:53,Bilbao,expenses,food,-81.13,2336.91
buyer_1,Luis,,ES41209538904585312595,TRX_N-00132-74949234,2022-05-03T11:50:29,Bilbao,expenses,cash,-100.0,2236.91
buyer_1,Luis,,ES41209538904585312595,TRX_N-00133-52979555,2022-05-03T11:45:29,Bilbao,expenses,appliances,-276.46,1960.45
buyer_1,Luis,,ES41209538904585312595,TRX_N-00134-52320026,2022-05-04T17:19:49,Bilbao,expenses,rent,-700.2,1260.25
buyer_1,Luis,,ES41209538904585312595,TRX_N-00135-32321101,2022-05-04T20:43:45,Bilbao,expenses,food,-103.05,1157.2
buyer_1,Luis,,ES41209538904585312595,TRX_N-00136-15702569,2022-05-05T17:44:44,Bilbao,expenses,gas,-76.05,1081.15
buyer_1,Luis,,ES41209538904585312595,TRX_N-00137-02886546,2022-05-05T02:18:15,Bilbao,expenses,phone,-36.3,1044.85
buyer_1,Luis,,ES41209538904585312595,TRX_N-00138-73283869,2022-05-06T12:57:25,Bilbao,expenses,transport,-80.72,964.13
buyer_1,Luis,,ES41209538904585312595,TRX_N-00139-75724917,2022-05-06T01:25:17,Bilbao,expenses,cash,-100.0,864.13
buyer_1,Luis,,ES41209538904585312595,TRX_N-00140-48398738,2022-05-06T12:10:23,Bilbao,expenses,gifts,-374.33,489.8
buyer_1,Luis,,ES41209538904585312595,TRX_N-00141-96103241,2022-05-07T20:49:02,Bilbao,expenses,gifts,-842.41,-352.61
buyer_1,Luis,,ES41209538904585312595,TRX_N-00142-36318803,2022-05-08T13:51:48,Bilbao,expenses,electricity,-21.7,-374.31
buyer_1,Luis,,ES41209538904585312595,TRX_N-00143-80313657,2022-05-08T05:14:49,Bilbao,expenses,water,-27.87,-402.18
buyer_1,Luis,,ES41209538904585312595,TRX_N-00144-02758777,2022-05-08T04:14:29,Bilbao,expenses,internet,-42.0,-444.18
buyer_1,Luis,,ES41209538904585312595,TRX_N-00145-53373254,2022-05-09T09:49:56,Labastida,expenses,food,-101.7,-545.88
buyer_1,Luis,,ES41209538904585312595,TRX_N-00146-05255226,2022-05-09T19:16:21,Andoain,expenses,cash,-100.0,-645.88
buyer_1,Luis,,ES41209538904585312595,TRX_N-00147-17125640,2022-05-09T18:49:49,Bilbao,expenses,gifts,-500.28,-1146.16
buyer_1,Luis,,ES41209538904585312595,TRX_N-00148-49080233,2022-05-11T08:53:10,Bilbao,expenses,leisure,-69.8,-1215.96
buyer_1,Luis,,ES41209538904585312595,TRX_N-00149-37140391,2022-05-12T13:53:00,Bilbao,expenses,cash,-100.0,-1315.96
buyer_1,Luis,,ES41209538904585312595,TRX_N-00150-56598974,2022-05-12T20:25:45,Bilbao,expenses,repairs,-28.02,-1343.98
buyer_1,Luis,,ES41209538904585312595,TRX_N-00151-84616590,2022-05-16T13:14:32,Bilbao,expenses,food,-120.95,-1464.93
buyer_1,Luis,,ES41209538904585312595,TRX_N-00152-22450724,2022-05-16T21:25:32,Sopela,expenses,leisure,-62.25,-1527.18
buyer_1,Luis,,ES41209538904585312595,TRX_N-00153-72489687,2022-05-16T13:44:32,Bilbao,expenses,cash,-100.0,-1627.18
buyer_1,Luis,,ES41209538904585312595,TRX_N-00154-18964801,2022-05-17T20:39:45,Bilbao,expenses,repairs,-292.1,-1919.28
buyer_1,Luis,,ES41209538904585312595,TRX_N-00155-42519838,2022-05-19T16:33:06,Durango,expenses,repairs,-206.34,-2125.62
buyer_1,Luis,,ES41209538904585312595,TRX_N-00156-25459957,2022-05-20T16:30:19,Bilbao,expenses,cash,-100.0,-2225.62
buyer_1,Luis,,ES41209538904585312595,TRX_N-00157-88439015,2022-05-21T10:33:02,Andoain,expenses,cash,-100.0,-2325.62
buyer_1,Luis,,ES41209538904585312595,TRX_N-00158-73398145,2022-05-22T23:05:32,Galdakao,expenses,clothing,-135.49,-2461.11
buyer_1,Luis,,ES41209538904585312595,TRX_N-00159-95612980,2022-05-23T16:07:40,Bilbao,expenses,food,-68.27,-2529.38
buyer_1,Luis,,ES41209538904585312595,TRX_N-00160-21000888,2022-05-23T10:28:58,Bilbao,expenses,clothing,-109.75,-2639.13
buyer_1,Luis,,ES41209538904585312595,TRX_N-00161-15233419,2022-05-24T02:55:22,Zarautz,expenses,gifts,-746.56,-3385.69
buyer_1,Luis,,ES41209538904585312595,TRX_N-00162-62809007,2022-05-26T08:59:27,Bilbao,expenses,food,-67.53,-3453.22
buyer_1,Luis,,ES41209538904585312595,TRX_N-00163-47959131,2022-05-26T18:29:56,Bilbao,expenses,transport,-44.2,-3497.42
buyer_1,Luis,,ES41209538904585312595,TRX_N-00164-14761145,2022-05-26T18:01:47,Bilbao,expenses,cash,-100.0,-3597.42
buyer_1,Luis,,ES41209538904585312595,TRX_N-00165-44418995,2022-05-27T13:33:59,Bilbao,expenses,food,-88.81,-3686.23
buyer_1,Luis,,ES41209538904585312595,TRX_N-00166-02352430,2022-05-27T02:33:49,Bilbao,expenses,cash,-100.0,-3786.23
buyer_1,Luis,,ES41209538904585312595,TRX_N-00167-57813233,2022-05-30T18:05:15,Bilbao,expenses,leisure,-61.74,-3847.97
buyer_1,Luis,,ES41209538904585312595,TRX_N-00168-41719311,2022-06-01T11:29:10,Bilbao,incomes,salary,2945.2,-902.77
buyer_1,Luis,,ES41209538904585312595,TRX_N-00169-73438433,2022-06-01T11:29:10,Bilbao,incomes,salary_bonus,2269.18,1366.41
buyer_1,Luis,,ES41209538904585312595,TRX_N-00170-46023312,2022-06-01T16:50:02,Bilbao,expenses,leisure,-24.02,1342.39
buyer_1,Luis,,ES41209538904585312595,TRX_N-00171-43267707,2022-06-02T17:30:58,Bilbao,expenses,taxes,-1686.05,-343.66
buyer_1,Luis,,ES41209538904585312595,TRX_N-00172-82436866,2022-06-02T13:09:03,Bilbao,expenses,insurance,-419.39,-763.05
buyer_1,Luis,,ES41209538904585312595,TRX_N-00173-69087169,2022-06-02T11:05:36,Getxo,expenses,food,-104.44,-867.49
buyer_1,Luis,,ES41209538904585312595,TRX_N-00174-25543101,2022-06-03T20:52:31,Oyón-Oion,expenses,food,-95.29,-962.78
buyer_1,Luis,,ES41209538904585312595,TRX_N-00175-03340955,2022-06-03T15:43:30,Bilbao,expenses,healthcare,-179.53,-1142.31
buyer_1,Luis,,ES41209538904585312595,TRX_N-00176-94965603,2022-06-04T12:32:17,Bilbao,expenses,rent,-700.2,-1842.51
buyer_1,Luis,,ES41209538904585312595,TRX_N-00177-01402906,2022-06-04T20:38:24,Eibar,expenses,clothing,-62.65,-1905.16
buyer_1,Luis,,ES41209538904585312595,TRX_N-00178-35915147,2022-06-05T20:06:23,Bilbao,expenses,phone,-33.77,-1938.93
buyer_1,Luis,,ES41209538904585312595,TRX_N-00179-46855741,2022-06-06T12:28:32,Bilbao,expenses,water,-29.75,-1968.68
buyer_1,Luis,,ES41209538904585312595,TRX_N-00180-67709802,2022-06-08T13:02:26,Bilbao,expenses,electricity,-55.57,-2024.25
buyer_1,Luis,,ES41209538904585312595,TRX_N-00181-04858688,2022-06-08T08:49:31,Bilbao,expenses,gas,-113.37,-2137.62
buyer_1,Luis,,ES41209538904585312595,TRX_N-00182-94614047,2022-06-08T19:50:53,Bilbao,expenses,internet,-42.0,-2179.62
buyer_1,Luis,,ES41209538904585312595,TRX_N-00183-09682187,2022-06-09T12:51:46,Bilbao,expenses,repairs,-295.09,-2474.71
buyer_1,Luis,,ES41209538904585312595,TRX_N-00184-62460464,2022-06-10T01:28:32,Bilbao,expenses,education,-61.19,-2535.9
buyer_1,Luis,,ES41209538904585312595,TRX_N-00185-14517300,2022-06-11T11:12:48,Bilbao,expenses,cash,-100.0,-2635.9
buyer_1,Luis,,ES41209538904585312595,TRX_N-00186-16109040,2022-06-12T10:47:16,Bilbao,expenses,food,-88.76,-2724.66
buyer_1,Luis,,ES41209538904585312595,TRX_N-00187-75268995,2022-06-13T12:51:14,Bilbao,expenses,transport,-86.88,-2811.54
buyer_1,Luis,,ES41209538904585312595,TRX_N-00188-10875713,2022-06-15T17:41:56,Bilbao,expenses,food,-115.73,-2927.27
buyer_1,Luis,,ES41209538904585312595,TRX_N-00189-47679065,2022-06-17T10:28:21,Bilbao,expenses,education,-55.0,-2982.27
buyer_1,Luis,,ES41209538904585312595,TRX_N-00190-03798215,2022-06-17T03:48:49,Bilbao,expenses,cash,-100.0,-3082.27
buyer_1,Luis,,ES41209538904585312595,TRX_N-00191-56964345,2022-06-20T12:35:40,Bilbao,expenses,leisure,-23.78,-3106.05
buyer_1,Luis,,ES41209538904585312595,TRX_N-00192-01834316,2022-06-22T18:44:08,Errenteria,expenses,cash,-100.0,-3206.05
buyer_1,Luis,,ES41209538904585312595,TRX_N-00193-24154254,2022-06-23T16:57:33,Mungia,expenses,food,-119.91,-3325.96
buyer_1,Luis,,ES41209538904585312595,TRX_N-00194-49670392,2022-06-23T21:50:46,Bilbao,expenses,clothing,-103.77,-3429.73
buyer_1,Luis,,ES41209538904585312595,TRX_N-00195-66851583,2022-06-26T19:23:58,Bilbao,expenses,cash,-100.0,-3529.73
buyer_1,Luis,,ES41209538904585312595,TRX_N-00196-33968394,2022-06-27T12:54:27,Bilbao,expenses,food,-92.74,-3622.47
buyer_1,Luis,,ES41209538904585312595,TRX_N-00197-08801539,2022-06-28T11:13:52,Bilbao,expenses,repairs,-328.66,-3951.13
buyer_1,Luis,,ES41209538904585312595,TRX_N-00198-32577310,2022-06-29T16:28:40,Bilbao,expenses,cash,-100.0,-4051.13
buyer_1,Luis,,ES41209538904585312595,TRX_N-00199-37519138,2022-07-01T15:53:00,Bilbao,incomes,salary,2945.2,-1105.93
buyer_1,Luis,,ES41209538904585312595,TRX_N-00200-22161931,2022-07-02T15:16:45,Bilbao,expenses,transport,-52.08,-1158.01
buyer_1,Luis,,ES41209538904585312595,TRX_N-00201-71410126,2022-07-02T15:20:47,Bilbao,expenses,travel,-1532.7,-2690.71
buyer_1,Luis,,ES41209538904585312595,TRX_N-00202-33426857,2022-07-03T09:09:21,Oyón-Oion,expenses,leisure,-33.76,-2724.47
buyer_1,Luis,,ES41209538904585312595,TRX_N-00203-34292808,2022-07-03T09:32:45,Bilbao,expenses,education,-69.03,-2793.5
buyer_1,Luis,,ES41209538904585312595,TRX_N-00204-51438234,2022-07-04T18:01:43,Bilbao,expenses,rent,-700.2,-3493.7
buyer_1,Luis,,ES41209538904585312595,TRX_N-00205-84863077,2022-07-05T23:08:29,Bilbao,expenses,internet,-42.0,-3535.7
buyer_1,Luis,,ES41209538904585312595,TRX_N-00206-97614144,2022-07-06T13:12:58,Bilbao,expenses,electricity,-82.36,-3618.06
buyer_1,Luis,,ES41209538904585312595,TRX_N-00207-68599204,2022-07-06T06:39:02,Erandio,expenses,food,-75.47,-3693.53
buyer_1,Luis,,ES41209538904585312595,TRX_N-00208-14680192,2022-07-07T18:41:43,Bilbao,expenses,phone,-42.89,-3736.42
buyer_1,Luis,,ES41209538904585312595,TRX_N-00209-42846193,2022-07-07T16:15:46,Bilbao,expenses,healthcare,-154.18,-3890.6
buyer_1,Luis,,ES41209538904585312595,TRX_N-00210-69421381,2022-07-08T10:35:17,Bilbao,expenses,water,-27.02,-3917.62
buyer_1,Luis,,ES41209538904585312595,TRX_N-00211-76231845,2022-07-08T19:49:16,Bilbao,expenses,gas,-92.6,-4010.22
buyer_1,Luis,,ES41209538904585312595,TRX_N-00212-76420544,2022-07-08T12:43:05,Bilbao,expenses,gifts,-744.76,-4754.98
buyer_1,Luis,,ES41209538904585312595,TRX_N-00213-89117070,2022-07-10T11:34:01,Bilbao,expenses,cash,-100.0,-4854.98
buyer_1,Luis,,ES41209538904585312595,TRX_N-00214-03868816,2022-07-11T16:45:27,Bilbao,expenses,clothing,-155.67,-5010.65
buyer_1,Luis,,ES41209538904585312595,TRX_N-00215-24720561,2022-07-14T18:20:20,Bilbao,expenses,food,-83.21,-5093.86
buyer_1,Luis,,ES41209538904585312595,TRX_N-00216-13456573,2022-07-14T21:05:43,Bilbao,expenses,clothing,-151.89,-5245.75
buyer_1,Luis,,ES41209538904585312595,TRX_N-00217-11056079,2022-07-16T23:42:21,Bilbao,expenses,repairs,-291.22,-5536.97
buyer_1,Luis,,ES41209538904585312595,TRX_N-00218-39917570,2022-07-17T22:48:49,Bilbao,expenses,food,-71.63,-5608.6
buyer_1,Luis,,ES41209538904585312595,TRX_N-00219-30915613,2022-07-18T17:50:54,Lasarte-Oria,expenses,travel,-1871.84,-7480.44
buyer_1,Luis,,ES41209538904585312595,TRX_N-00220-62724732,2022-07-19T19:54:37,Bilbao,expenses,food,-112.92,-7593.36
buyer_1,Luis,,ES41209538904585312595,TRX_N-00221-30418827,2022-07-20T19:45:42,Bilbao,expenses,leisure,-42.7,-7636.06
buyer_1,Luis,,ES41209538904585312595,TRX_N-00222-27526979,2022-07-22T17:42:53,Bilbao,expenses,transport,-45.47,-7681.53
buyer_1,Luis,,ES41209538904585312595,TRX_N-00223-64660936,2022-07-23T12:44:44,Bilbao,expenses,leisure,-59.68,-7741.21
buyer_1,Luis,,ES41209538904585312595,TRX_N-00224-89583705,2022-07-24T12:13:57,Bilbao,expenses,repairs,-189.25,-7930.46
buyer_1,Luis,,ES41209538904585312595,TRX_N-00225-34640618,2022-07-25T12:54:04,Bilbao,expenses,leisure,-28.77,-7959.23
buyer_1,Luis,,ES41209538904585312595,TRX_N-00226-29497442,2022-07-30T14:10:09,Bilbao,expenses,food,-76.27,-8035.5
buyer_1,Luis,,ES41209538904585312595,TRX_N-00227-27311089,2022-07-30T14:06:28,Bilbao,expenses,cash,-100.0,-8135.5
buyer_1,Luis,,ES41209538904585312595,TRX_N-00228-87163949,2022-07-31T16:34:45,Bilbao,expenses,transport,-65.55,-8201.05
buyer_1,Luis,,ES41209538904585312595,TRX_N-00229-02323709,2022-08-01T14:01:33,Bilbao,incomes,salary,2945.2,-5255.85
buyer_1,Luis,,ES41209538904585312595,TRX_N-00230-37061150,2022-08-01T14:01:33,Bilbao,incomes,extra_income,349.57,-4906.28
buyer_1,Luis,,ES41209538904585312595,TRX_N-00231-49929749,2022-08-01T12:08:20,Bilbao,expenses,food,-65.22,-4971.5
buyer_1,Luis,,ES41209538904585312595,TRX_N-00232-95051417,2022-08-04T19:08:35,Bilbao,expenses,rent,-700.2,-5671.7
buyer_1,Luis,,ES41209538904585312595,TRX_N-00233-95403140,2022-08-04T15:22:34,Bilbao,expenses,clothing,-69.7,-5741.4
buyer_1,Luis,,ES41209538904585312595,TRX_N-00234-03101969,2022-08-04T15:21:16,Hondarribia,expenses,cash,-100.0,-5841.4
buyer_1,Luis,,ES41209538904585312595,TRX_N-00235-00720415,2022-08-05T15:55:30,Bilbao,expenses,electricity,-26.41,-5867.81
buyer_1,Luis,,ES41209538904585312595,TRX_N-00236-17996318,2022-08-05T17:29:29,Bilbao,expenses,phone,-41.26,-5909.07
buyer_1,Luis,,ES41209538904585312595,TRX_N-00237-50666862,2022-08-05T22:13:38,Bilbao,expenses,cash,-100.0,-6009.07
buyer_1,Luis,,ES41209538904585312595,TRX_N-00238-75733302,2022-08-06T15:34:22,Bilbao,expenses,internet,-42.0,-6051.07
buyer_1,Luis,,ES41209538904585312595,TRX_N-00239-85280341,2022-08-07T08:41:19,Bilbao,expenses,water,-33.54,-6084.61
buyer_1,Luis,,ES41209538904585312595,TRX_N-00240-72072430,2022-08-07T21:28:40,Bilbao,expenses,gas,-60.7,-6145.31
buyer_1,Luis,,ES41209538904585312595,TRX_N-00241-32342759,2022-08-08T16:39:13,Bilbao,expenses,cash,-100.0,-6245.31
buyer_1,Luis,,ES41209538904585312595,TRX_N-00242-68697479,2022-08-09T15:30:11,Arrasate,expenses,leisure,-52.5,-6297.81
buyer_1,Luis,,ES41209538904585312595,TRX_N-00243-59065636,2022-08-09T18:36:33,Bilbao,expenses,gifts,-783.12,-7080.93
buyer_1,Luis,,ES41209538904585312595,TRX_N-00244-62322509,2022-08-17T18:33:20,Bilbao,expenses,appliances,-355.74,-7436.67
buyer_1,Luis,,ES41209538904585312595,TRX_N-00245-46968960,2022-08-19T08:37:33,Bilbao,expenses,cash,-100.0,-7536.67
buyer_1,Luis,,ES41209538904585312595,TRX_N-00246-44643134,2022-08-22T13:46:12,Bilbao,expenses,transport,-53.34,-7590.01
buyer_1,Luis,,ES41209538904585312595,TRX_N-00247-44701097,2022-08-23T09:59:42,Bilbao,expenses,repairs,-102.56,-7692.57
buyer_1,Luis,,ES41209538904585312595,TRX_N-00248-81807291,2022-08-24T17:53:32,Bilbao,expenses,transport,-48.48,-7741.05
buyer_1,Luis,,ES41209538904585312595,TRX_N-00249-60095055,2022-08-24T17:12:37,Bilbao,expenses,leisure,-29.67,-7770.72
buyer_1,Luis,,ES41209538904585312595,TRX_N-00250-74627200,2022-08-24T08:52:54,Bilbao,expenses,education,-69.89,-7840.61
buyer_1,Luis,,ES41209538904585312595,TRX_N-00251-37864939,2022-08-24T18:41:37,Hondarribia,expenses,repairs,-329.9,-8170.51
buyer_1,Luis,,ES41209538904585312595,TRX_N-00252-22425766,2022-08-25T12:22:17,Bilbao,expenses,transport,-77.85,-8248.36
buyer_1,Luis,,ES41209538904585312595,TRX_N-00253-37742635,2022-08-30T09:17:46,Bilbao,expenses,food,-65.72,-8314.08
buyer_1,Luis,,ES41209538904585312595,TRX_N-00254-23819210,2022-08-31T12:58:20,Bilbao,expenses,food,-94.15,-8408.23
buyer_1,Luis,,ES41209538904585312595,TRX_N-00255-44838681,2022-09-01T18:52:09,Bilbao,incomes,salary,2945.2,-5463.03
buyer_1,Luis,,ES41209538904585312595,TRX_N-00256-89247009,2022-09-01T12:24:05,Bilbao,expenses,cash,-100.0,-5563.03
buyer_1,Luis,,ES41209538904585312595,TRX_N-00257-82771756,2022-09-04T20:16:29,Bilbao,expenses,rent,-700.2,-6263.23
buyer_1,Luis,,ES41209538904585312595,TRX_N-00258-43265711,2022-09-05T23:36:33,Bilbao,expenses,water,-22.44,-6285.67
buyer_1,Luis,,ES41209538904585312595,TRX_N-00259-57853246,2022-09-05T08:03:22,Bilbao,expenses,gas,-90.48,-6376.15
buyer_1,Luis,,ES41209538904585312595,TRX_N-00260-48864443,2022-09-05T17:51:38,Bilbao,expenses,internet,-42.0,-6418.15
buyer_1,Luis,,ES41209538904585312595,TRX_N-00261-32554308,2022-09-08T11:54:08,Bilbao,expenses,phone,-33.44,-6451.59
buyer_1,Luis,,ES41209538904585312595,TRX_N-00262-12224357,2022-09-08T17:01:41,Bilbao,expenses,electricity,-73.34,-6524.93
buyer_1,Luis,,ES41209538904585312595,TRX_N-00263-20034246,2022-09-08T09:36:26,Lasarte-Oria,expenses,transport,-45.88,-6570.81
buyer_1,Luis,,ES41209538904585312595,TRX_N-00264-68866151,2022-09-09T08:50:19,Hernani,expenses,clothing,-63.7,-6634.51
buyer_1,Luis,,ES41209538904585312595,TRX_N-00265-97924428,2022-09-11T17:48:18,Bilbao,expenses,cash,-100.0,-6734.51
buyer_1,Luis,,ES41209538904585312595,TRX_N-00266-92060912,2022-09-12T22:56:10,Bilbao,expenses,repairs,-66.62,-6801.13
buyer_1,Luis,,ES41209538904585312595,TRX_N-00267-12779585,2022-09-13T21:18:50,Bilbao,expenses,repairs,-253.7,-7054.83
buyer_1,Luis,,ES41209538904585312595,TRX_N-00268-75965448,2022-09-19T10:40:31,Erandio,expenses,food,-116.91,-7171.74
buyer_1,Luis,,ES41209538904585312595,TRX_N-00269-94194936,2022-09-20T22:16:18,Bilbao,expenses,transport,-53.45,-7225.19
buyer_1,Luis,,ES41209538904585312595,TRX_N-00270-61044689,2022-09-20T15:42:20,Berango,expenses,cash,-100.0,-7325.19
buyer_1,Luis,,ES41209538904585312595,TRX_N-00271-46257459,2022-09-22T15:52:13,Bilbao,expenses,food,-66.07,-7391.26
buyer_1,Luis,,ES41209538904585312595,TRX_N-00272-72519161,2022-09-22T19:32:29,Bilbao,expenses,leisure,-46.18,-7437.44
buyer_1,Luis,,ES41209538904585312595,TRX_N-00273-28119026,2022-09-23T10:29:02,Bilbao,expenses,food,-66.12,-7503.56
buyer_1,Luis,,ES41209538904585312595,TRX_N-00274-33820218,2022-09-24T09:57:04,Bilbao,expenses,cash,-100.0,-7603.56
buyer_1,Luis,,ES41209538904585312595,TRX_N-00275-77348938,2022-09-25T20:20:19,Bilbao,expenses,transport,-73.92,-7677.48
buyer_1,Luis,,ES41209538904585312595,TRX_N-00276-57788672,2022-09-28T12:52:26,Bilbao,expenses,food,-120.19,-7797.67
buyer_1,Luis,,ES41209538904585312595,TRX_N-00277-54404961,2022-09-28T19:05:39,Bilbao,expenses,healthcare,-83.46,-7881.13
buyer_1,Luis,,ES41209538904585312595,TRX_N-00278-57610470,2022-09-30T08:55:38,Bilbao,expenses,cash,-100.0,-7981.13
buyer_1,Luis,,ES41209538904585312595,TRX_N-00279-64461806,2022-09-30T08:00:48,Bilbao,expenses,gifts,-689.67,-8670.8
buyer_1,Luis,,ES41209538904585312595,TRX_N-00280-27189907,2022-10-01T09:07:10,Bilbao,incomes,salary,2945.2,-5725.6
buyer_1,Luis,,ES41209538904585312595,TRX_N-00281-75833711,2022-10-02T11:33:20,Bilbao,expenses,repairs,-62.84,-5788.44
buyer_1,Luis,,ES41209538904585312595,TRX_N-00282-23676986,2022-10-03T16:10:38,Bilbao,expenses,cash,-100.0,-5888.44
buyer_1,Luis,,ES41209538904585312595,TRX_N-00283-66991090,2022-10-04T14:08:38,Bilbao,expenses,rent,-700.2,-6588.64
buyer_1,Luis,,ES41209538904585312595,TRX_N-00284-30374108,2022-10-04T16:26:23,Bilbao,expenses,clothing,-157.43,-6746.07
buyer_1,Luis,,ES41209538904585312595,TRX_N-00285-98849464,2022-10-05T08:54:20,Bilbao,expenses,phone,-44.98,-6791.05
buyer_1,Luis,,ES41209538904585312595,TRX_N-00286-40702382,2022-10-05T20:16:58,Bilbao,expenses,repairs,-320.7,-7111.75
buyer_1,Luis,,ES41209538904585312595,TRX_N-00287-06597035,2022-10-06T09:40:57,Bilbao,expenses,electricity,-28.61,-7140.36
buyer_1,Luis,,ES41209538904585312595,TRX_N-00288-69880796,2022-10-07T20:54:28,Bilbao,expenses,gas,-51.84,-7192.2
buyer_1,Luis,,ES41209538904585312595,TRX_N-00289-15997094,2022-10-07T20:09:04,Bilbao,expenses,internet,-42.0,-7234.2
buyer_1,Luis,,ES41209538904585312595,TRX_N-00290-79299324,2022-10-08T11:58:05,Bilbao,expenses,water,-39.69,-7273.89
buyer_1,Luis,,ES41209538904585312595,TRX_N-00291-55156591,2022-10-09T09:39:29,Bilbao,expenses,cash,-100.0,-7373.89
buyer_1,Luis,,ES41209538904585312595,TRX_N-00292-31789516,2022-10-09T13:36:52,Bilbao,expenses,repairs,-309.52,-7683.41
buyer_1,Luis,,ES41209538904585312595,TRX_N-00293-34802106,2022-10-10T08:51:22,Bilbao,expenses,cash,-100.0,-7783.41
buyer_1,Luis,,ES41209538904585312595,TRX_N-00294-08498457,2022-10-12T07:05:37,Bilbao,expenses,cash,-100.0,-7883.41
buyer_1,Luis,,ES41209538904585312595,TRX_N-00295-90820157,2022-10-13T10:53:41,Bilbao,expenses,leisure,-54.79,-7938.2
buyer_1,Luis,,ES41209538904585312595,TRX_N-00296-18187477,2022-10-15T22:50:34,Bilbao,expenses,education,-45.8,-7984.0
buyer_1,Luis,,ES41209538904585312595,TRX_N-00297-91289614,2022-10-16T07:17:14,Bilbao,expenses,leisure,-41.57,-8025.57
buyer_1,Luis,,ES41209538904585312595,TRX_N-00298-74121005,2022-10-16T15:46:34,Bilbao,expenses,clothing,-107.61,-8133.18
buyer_1,Luis,,ES41209538904585312595,TRX_N-00299-40217971,2022-10-17T21:21:44,Bilbao,expenses,leisure,-51.92,-8185.1
buyer_1,Luis,,ES41209538904585312595,TRX_N-00300-12510717,2022-10-18T15:36:17,Bilbao,expenses,food,-67.31,-8252.41
buyer_1,Luis,,ES41209538904585312595,TRX_N-00301-48867423,2022-10-18T06:05:02,Bilbao,expenses,gifts,-41.13,-8293.54
buyer_1,Luis,,ES41209538904585312595,TRX_N-00302-38724167,2022-10-19T11:44:10,Bilbao,expenses,repairs,-326.03,-8619.57
buyer_1,Luis,,ES41209538904585312595,TRX_N-00303-41072690,2022-10-20T14:03:55,Bilbao,expenses,transport,-46.49,-8666.06
buyer_1,Luis,,ES41209538904585312595,TRX_N-00304-74749007,2022-10-20T10:45:59,Bilbao,expenses,leisure,-36.25,-8702.31
buyer_1,Luis,,ES41209538904585312595,TRX_N-00305-62838362,2022-10-21T09:31:01,Bilbao,expenses,clothing,-129.48,-8831.79
buyer_1,Luis,,ES41209538904585312595,TRX_N-00306-49007854,2022-10-21T11:30:43,Portugalete,expenses,cash,-100.0,-8931.79
buyer_1,Luis,,ES41209538904585312595,TRX_N-00307-90491082,2022-10-22T20:15:08,Bilbao,expenses,clothing,-100.77,-9032.56
buyer_1,Luis,,ES41209538904585312595,TRX_N-00308-24331612,2022-10-24T18:00:54,Oyón-Oion,expenses,leisure,-35.4,-9067.96
buyer_1,Luis,,ES41209538904585312595,TRX_N-00309-42705903,2022-10-25T09:50:20,Bilbao,expenses,transport,-56.9,-9124.86
buyer_1,Luis,,ES41209538904585312595,TRX_N-00310-43843831,2022-10-25T18:38:30,Bilbao,expenses,cash,-100.0,-9224.86
buyer_1,Luis,,ES41209538904585312595,TRX_N-00311-89571594,2022-10-26T15:26:36,Bilbao,expenses,clothing,-156.32,-9381.18
buyer_1,Luis,,ES41209538904585312595,TRX_N-00312-04830637,2022-10-26T23:12:31,Bilbao,expenses,healthcare,-114.08,-9495.26
buyer_1,Luis,,ES41209538904585312595,TRX_N-00313-56920075,2022-10-27T17:27:52,Hernani,expenses,cash,-100.0,-9595.26
buyer_1,Luis,,ES41209538904585312595,TRX_N-00314-25068511,2022-10-28T18:18:11,Berango,expenses,leisure,-62.74,-9658.0
buyer_1,Luis,,ES41209538904585312595,TRX_N-00315-95382656,2022-10-30T20:32:53,Bilbao,expenses,food,-64.35,-9722.35
buyer_1,Luis,,ES41209538904585312595,TRX_N-00316-29381742,2022-10-30T11:00:27,Bilbao,expenses,leisure,-80.12,-9802.47
buyer_1,Luis,,ES41209538904585312595,TRX_N-00317-90854300,2022-10-30T19:02:42,Elciego,expenses,healthcare,-175.65,-9978.12
buyer_1,Luis,,ES41209538904585312595,TRX_N-00318-19698302,2022-11-01T18:09:42,Bilbao,incomes,salary,2945.2,-7032.92
buyer_1,Luis,,ES41209538904585312595,TRX_N-00319-65083038,2022-11-01T15:40:33,Bilbao,expenses,transport,-52.1,-7085.02
buyer_1,Luis,,ES41209538904585312595,TRX_N-00320-11597516,2022-11-04T02:32:38,Bilbao,expenses,rent,-700.2,-7785.22
buyer_1,Luis,,ES41209538904585312595,TRX_N-00321-36776703,2022-11-05T21:12:09,Bilbao,expenses,internet,-42.0,-7827.22
buyer_1,Luis,,ES41209538904585312595,TRX_N-00322-40092409,2022-11-06T15:36:52,Bilbao,expenses,leisure,-22.75,-7849.97
buyer_1,Luis,,ES41209538904585312595,TRX_N-00323-24706041,2022-11-07T09:02:28,Bilbao,expenses,food,-85.44,-7935.41
buyer_1,Luis,,ES41209538904585312595,TRX_N-00324-81472546,2022-11-08T09:03:01,Bilbao,expenses,water,-40.77,-7976.18
buyer_1,Luis,,ES41209538904585312595,TRX_N-00325-67651236,2022-11-08T09:14:47,Bilbao,expenses,electricity,-68.95,-8045.13
buyer_1,Luis,,ES41209538904585312595,TRX_N-00326-00151972,2022-11-08T12:52:14,Bilbao,expenses,gas,-57.03,-8102.16
buyer_1,Luis,,ES41209538904585312595,TRX_N-00327-86132639,2022-11-08T20:59:31,Bilbao,expenses,phone,-31.61,-8133.77
buyer_1,Luis,,ES41209538904585312595,TRX_N-00328-45697869,2022-11-08T15:01:53,Bilbao,expenses,healthcare,-103.95,-8237.72
buyer_1,Luis,,ES41209538904585312595,TRX_N-00329-30684034,2022-11-10T15:48:38,Bilbao,expenses,repairs,-93.13,-8330.85
buyer_1,Luis,,ES41209538904585312595,TRX_N-00330-36118240,2022-11-11T17:03:12,Bilbao,expenses,transport,-61.36,-8392.21
buyer_1,Luis,,ES41209538904585312595,TRX_N-00331-25428414,2022-11-12T14:33:28,Errenteria,expenses,cash,-100.0,-8492.21
buyer_1,Luis,,ES41209538904585312595,TRX_N-00332-30402112,2022-11-13T16:16:37,Bilbao,expenses,leisure,-53.08,-8545.29
buyer_1,Luis,,ES41209538904585312595,TRX_N-00333-08646697,2022-11-13T17:36:41,Bilbao,expenses,cash,-100.0,-8645.29
buyer_1,Luis,,ES41209538904585312595,TRX_N-00334-78497645,2022-11-13T08:41:46,Bilbao,expenses,repairs,-302.22,-8947.51
buyer_1,Luis,,ES41209538904585312595,TRX_N-00335-09376529,2022-11-14T12:28:18,Alegría-Dulantzi,expenses,food,-112.71,-9060.22
buyer_1,Luis,,ES41209538904585312595,TRX_N-00336-90501978,2022-11-14T15:25:45,Bilbao,expenses,leisure,-58.36,-9118.58
buyer_1,Luis,,ES41209538904585312595,TRX_N-00337-02263193,2022-11-14T15:07:18,Bilbao,expenses,gifts,-838.84,-9957.42
buyer_1,Luis,,ES41209538904585312595,TRX_N-00338-56911996,2022-11-15T12:02:36,Bilbao,expenses,food,-113.09,-10070.51
buyer_1,Luis,,ES41209538904585312595,TRX_N-00339-49877038,2022-11-15T21:09:54,Elciego,expenses,cash,-100.0,-10170.51
buyer_1,Luis,,ES41209538904585312595,TRX_N-00340-20360815,2022-11-16T11:59:53,Zarautz,expenses,repairs,-78.3,-10248.81
buyer_1,Luis,,ES41209538904585312595,TRX_N-00341-81628837,2022-11-19T13:27:26,Bilbao,expenses,food,-74.14,-10322.95
buyer_1,Luis,,ES41209538904585312595,TRX_N-00342-24138766,2022-11-19T18:28:40,Bilbao,expenses,transport,-87.67,-10410.62
buyer_1,Luis,,ES41209538904585312595,TRX_N-00343-60118644,2022-11-20T15:59:05,Bilbao,expenses,repairs,-196.36,-10606.98
buyer_1,Luis,,ES41209538904585312595,TRX_N-00344-08693065,2022-11-20T14:04:45,Bilbao,expenses,gifts,-655.76,-11262.74
buyer_1,Luis,,ES41209538904585312595,TRX_N-00345-75278505,2022-11-22T16:51:04,Bilbao,expenses,leisure,-81.47,-11344.21
buyer_1,Luis,,ES41209538904585312595,TRX_N-00346-09001293,2022-11-23T15:10:55,Bilbao,expenses,leisure,-36.2,-11380.41
buyer_1,Luis,,ES41209538904585312595,TRX_N-00347-75981248,2022-11-23T10:40:57,Bilbao,expenses,repairs,-255.61,-11636.02
buyer_1,Luis,,ES41209538904585312595,TRX_N-00348-49676367,2022-11-24T16:36:01,Bilbao,expenses,cash,-100.0,-11736.02
buyer_1,Luis,,ES41209538904585312595,TRX_N-00349-96740606,2022-11-24T14:26:48,Bilbao,expenses,repairs,-76.33,-11812.35
buyer_1,Luis,,ES41209538904585312595,TRX_N-00350-25699052,2022-11-26T10:12:11,Bilbao,expenses,cash,-100.0,-11912.35
buyer_1,Luis,,ES41209538904585312595,TRX_N-00351-03811686,2022-11-27T17:14:28,Bilbao,expenses,education,-58.04,-11970.39
buyer_1,Luis,,ES41209538904585312595,TRX_N-00352-22451089,2022-11-30T12:25:57,Bilbao,expenses,food,-100.78,-12071.17
buyer_1,Luis,,ES41209538904585312595,TRX_N-00353-57037216,2022-11-30T18:47:05,Bilbao,expenses,cash,-100.0,-12171.17
buyer_1,Luis,,ES41209538904585312595,TRX_N-00354-75898834,2022-12-01T15:19:42,Bilbao,incomes,salary,2945.2,-9225.97
buyer_1,Luis,,ES41209538904585312595,TRX_N-00355-12035395,2022-12-01T15:19:42,Bilbao,incomes,extra_income,349.57,-8876.4
buyer_1,Luis,,ES41209538904585312595,TRX_N-00356-88721507,2022-12-01T15:19:42,Bilbao,incomes,salary_bonus,2071.44,-6804.96
buyer_1,Luis,,ES41209538904585312595,TRX_N-00357-59893486,2022-12-02T07:53:14,Hondarribia,expenses,healthcare,-79.33,-6884.29
buyer_1,Luis,,ES41209538904585312595,TRX_N-00358-36999580,2022-12-02T19:57:27,Bilbao,expenses,cash,-100.0,-6984.29
buyer_1,Luis,,ES41209538904585312595,TRX_N-00359-42645367,2022-12-03T13:08:22,Sestao,expenses,food,-65.6,-7049.89
buyer_1,Luis,,ES41209538904585312595,TRX_N-00360-58098050,2022-12-03T16:16:10,Bilbao,expenses,transport,-89.88,-7139.77
buyer_1,Luis,,ES41209538904585312595,TRX_N-00361-91747980,2022-12-03T09:48:34,Bilbao,expenses,cash,-100.0,-7239.77
buyer_1,Luis,,ES41209538904585312595,TRX_N-00362-01176445,2022-12-04T11:12:21,Bilbao,expenses,rent,-700.2,-7939.97
buyer_1,Luis,,ES41209538904585312595,TRX_N-00363-03728844,2022-12-04T12:26:59,Bilbao,expenses,transport,-41.09,-7981.06
buyer_1,Luis,,ES41209538904585312595,TRX_N-00364-17956093,2022-12-05T18:29:00,Bilbao,expenses,internet,-42.0,-8023.06
buyer_1,Luis,,ES41209538904585312595,TRX_N-00365-07458957,2022-12-05T17:47:43,Bilbao,expenses,phone,-40.39,-8063.45
buyer_1,Luis,,ES41209538904585312595,TRX_N-00366-16045484,2022-12-06T22:49:55,Bilbao,expenses,food,-71.19,-8134.64
buyer_1,Luis,,ES41209538904585312595,TRX_N-00367-79013806,2022-12-07T11:07:53,Bilbao,expenses,gifts,-758.97,-8893.61
buyer_1,Luis,,ES41209538904585312595,TRX_N-00368-56385084,2022-12-08T11:57:57,Bilbao,expenses,water,-39.24,-8932.85
buyer_1,Luis,,ES41209538904585312595,TRX_N-00369-05766602,2022-12-08T21:51:22,Bilbao,expenses,electricity,-75.97,-9008.82
buyer_1,Luis,,ES41209538904585312595,TRX_N-00370-79858200,2022-12-08T10:56:57,Bilbao,expenses,gas,-102.31,-9111.13
buyer_1,Luis,,ES41209538904585312595,TRX_N-00371-11512758,2022-12-08T14:36:30,Basauri,expenses,transport,-58.53,-9169.66
buyer_1,Luis,,ES41209538904585312595,TRX_N-00372-91646245,2022-12-08T17:10:51,Bilbao,expenses,leisure,-38.2,-9207.86
buyer_1,Luis,,ES41209538904585312595,TRX_N-00373-42421917,2022-12-09T14:14:23,Bilbao,expenses,clothing,-76.92,-9284.78
buyer_1,Luis,,ES41209538904585312595,TRX_N-00374-52351455,2022-12-11T15:02:06,Bilbao,expenses,leisure,-73.47,-9358.25
buyer_1,Luis,,ES41209538904585312595,TRX_N-00375-88754226,2022-12-13T15:43:38,Labastida,expenses,cash,-100.0,-9458.25
buyer_1,Luis,,ES41209538904585312595,TRX_N-00376-75420286,2022-12-13T02:45:43,Bilbao,expenses,gifts,-287.46,-9745.71
buyer_1,Luis,,ES41209538904585312595,TRX_N-00377-33844543,2022-12-14T09:01:01,Leioa,expenses,food,-95.97,-9841.68
buyer_1,Luis,,ES41209538904585312595,TRX_N-00378-69149909,2022-12-15T19:52:08,Bilbao,expenses,leisure,-30.95,-9872.63
buyer_1,Luis,,ES41209538904585312595,TRX_N-00379-69047447,2022-12-15T23:02:31,Bilbao,expenses,cash,-100.0,-9972.63
buyer_1,Luis,,ES41209538904585312595,TRX_N-00380-31318158,2022-12-16T09:23:47,Bilbao,expenses,food,-63.68,-10036.31
buyer_1,Luis,,ES41209538904585312595,TRX_N-00381-41238081,2022-12-16T18:43:43,Hernani,expenses,transport,-60.53,-10096.84
buyer_1,Luis,,ES41209538904585312595,TRX_N-00382-60785445,2022-12-17T08:01:29,Bilbao,expenses,food,-64.75,-10161.59
buyer_1,Luis,,ES41209538904585312595,TRX_N-00383-74978197,2022-12-17T14:17:11,Bilbao,expenses,healthcare,-40.29,-10201.88
buyer_1,Luis,,ES41209538904585312595,TRX_N-00384-31818463,2022-12-18T11:47:06,Bilbao,expenses,food,-117.96,-10319.84
buyer_1,Luis,,ES41209538904585312595,TRX_N-00385-47301664,2022-12-18T18:34:34,Bilbao,expenses,repairs,-229.88,-10549.72
buyer_1,Luis,,ES41209538904585312595,TRX_N-00386-74150415,2022-12-20T11:48:49,Eibar,expenses,transport,-41.34,-10591.06
buyer_1,Luis,,ES41209538904585312595,TRX_N-00387-03656135,2022-12-21T22:09:55,Bilbao,expenses,food,-75.85,-10666.91
buyer_1,Luis,,ES41209538904585312595,TRX_N-00388-88565914,2022-12-22T19:52:05,Oyón-Oion,expenses,food,-115.39,-10782.3
buyer_1,Luis,,ES41209538904585312595,TRX_N-00389-57358816,2022-12-24T13:37:41,Bilbao,expenses,food,-89.16,-10871.46
buyer_1,Luis,,ES41209538904585312595,TRX_N-00390-45876133,2022-12-24T20:37:42,Durango,expenses,cash,-100.0,-10971.46
buyer_1,Luis,,ES41209538904585312595,TRX_N-00391-70351394,2022-12-25T18:23:28,Bilbao,expenses,transport,-52.78,-11024.24
buyer_1,Luis,,ES41209538904585312595,TRX_N-00392-71831256,2022-12-26T13:41:48,Bilbao,expenses,education,-76.22,-11100.46
buyer_1,Luis,,ES41209538904585312595,TRX_N-00393-20068521,2022-12-27T12:30:12,Bilbao,expenses,repairs,-111.16,-11211.62
buyer_1,Luis,,ES41209538904585312595,TRX_N-00394-84534639,2022-12-29T03:16:42,Santurtzi,expenses,cash,-100.0,-11311.62
buyer_1,Luis,,ES41209538904585312595,TRX_N-00395-90527862,2022-12-29T18:20:00,Bilbao,expenses,gifts,-85.19,-11396.81
buyer_1,Luis,,ES41209538904585312595,TRX_N-00396-58362005,2022-12-31T13:46:14,Bilbao,expenses,food,-99.56,-11496.37
buyer_1,Luis,,ES41209538904585312595,TRX_N-00397-66568934,2023-01-01T11:46:52,Bilbao,incomes,salary,3053.37,-8443.0
buyer_1,Luis,,ES41209538904585312595,TRX_N-00398-00155965,2023-01-01T20:12:38,Bermeo,expenses,healthcare,-76.29,-8519.29
buyer_1,Luis,,ES41209538904585312595,TRX_N-00399-48943459,2023-01-02T07:40:47,Bilbao,expenses,food,-100.22,-8619.51
buyer_1,Luis,,ES41209538904585312595,TRX_N-00400-74901217,2023-01-03T15:45:15,Bilbao,expenses,transport,-83.57,-8703.08
buyer_1,Luis,,ES41209538904585312595,TRX_N-00401-45152697,2023-01-03T22:02:24,Bilbao,expenses,clothing,-150.0,-8853.08
buyer_1,Luis,,ES41209538904585312595,TRX_N-00402-12864774,2023-01-04T11:05:49,Bilbao,expenses,rent,-700.2,-9553.28
buyer_1,Luis,,ES41209538904585312595,TRX_N-00403-24345131,2023-01-04T18:05:58,Bilbao,expenses,leisure,-40.26,-9593.54
buyer_1,Luis,,ES41209538904585312595,TRX_N-00404-71483898,2023-01-06T15:17:06,Bilbao,expenses,cash,-100.0,-9693.54
buyer_1,Luis,,ES41209538904585312595,TRX_N-00405-04180892,2023-01-07T08:48:25,Bilbao,expenses,transport,-67.11,-9760.65
buyer_1,Luis,,ES41209538904585312595,TRX_N-00406-68374479,2023-01-08T09:37:51,Bilbao,expenses,internet,-42.0,-9802.65
buyer_1,Luis,,ES41209538904585312595,TRX_N-00407-47499386,2023-01-08T11:27:11,Bilbao,expenses,water,-28.21,-9830.86
buyer_1,Luis,,ES41209538904585312595,TRX_N-00408-20951701,2023-01-08T18:31:52,Bilbao,expenses,electricity,-42.48,-9873.34
buyer_1,Luis,,ES41209538904585312595,TRX_N-00409-83821752,2023-01-08T19:55:19,Bilbao,expenses,gas,-76.42,-9949.76
buyer_1,Luis,,ES41209538904585312595,TRX_N-00410-07326843,2023-01-08T09:58:04,Bilbao,expenses,phone,-34.83,-9984.59
buyer_1,Luis,,ES41209538904585312595,TRX_N-00411-19900203,2023-01-09T19:12:44,Bilbao,expenses,gifts,-542.03,-10526.62
buyer_1,Luis,,ES41209538904585312595,TRX_N-00412-98447069,2023-01-10T15:53:31,Bilbao,expenses,repairs,-174.24,-10700.86
buyer_1,Luis,,ES41209538904585312595,TRX_N-00413-70610946,2023-01-11T14:14:04,Hernani,expenses,food,-84.55,-10785.41
buyer_1,Luis,,ES41209538904585312595,TRX_N-00414-46034080,2023-01-11T13:19:53,Bilbao,expenses,appliances,-318.94,-11104.35
buyer_1,Luis,,ES41209538904585312595,TRX_N-00415-67694212,2023-01-12T13:03:54,Bilbao,expenses,repairs,-74.66,-11179.01
buyer_1,Luis,,ES41209538904585312595,TRX_N-00416-16229921,2023-01-13T20:20:11,Bilbao,expenses,clothing,-110.5,-11289.51
buyer_1,Luis,,ES41209538904585312595,TRX_N-00417-14285656,2023-01-13T10:01:15,Bilbao,expenses,cash,-100.0,-11389.51
buyer_1,Luis,,ES41209538904585312595,TRX_N-00418-56656740,2023-01-13T11:57:10,Bilbao,expenses,repairs,-271.12,-11660.63
buyer_1,Luis,,ES41209538904585312595,TRX_N-00419-63393279,2023-01-14T10:10:21,Bilbao,expenses,repairs,-328.48,-11989.11
buyer_1,Luis,,ES41209538904585312595,TRX_N-00420-92813456,2023-01-15T10:55:55,Bilbao,expenses,food,-80.16,-12069.27
buyer_1,Luis,,ES41209538904585312595,TRX_N-00421-68558011,2023-01-15T16:35:35,Bilbao,expenses,cash,-100.0,-12169.27
buyer_1,Luis,,ES41209538904585312595,TRX_N-00422-84839893,2023-01-15T01:56:47,Leioa,expenses,gifts,-209.1,-12378.37
buyer_1,Luis,,ES41209538904585312595,TRX_N-00423-61369500,2023-01-16T10:59:01,Bilbao,expenses,repairs,-72.14,-12450.51
buyer_1,Luis,,ES41209538904585312595,TRX_N-00424-75617451,2023-01-19T02:04:59,Errenteria,expenses,food,-97.38,-12547.89
buyer_1,Luis,,ES41209538904585312595,TRX_N-00425-69712300,2023-01-19T20:35:52,Bilbao,expenses,cash,-100.0,-12647.89
buyer_1,Luis,,ES41209538904585312595,TRX_N-00426-10210042,2023-01-24T23:03:57,Bilbao,expenses,cash,-100.0,-12747.89
buyer_1,Luis,,ES41209538904585312595,TRX_N-00427-97699029,2023-01-25T00:15:19,Bilbao,expenses,clothing,-79.02,-12826.91
buyer_1,Luis,,ES41209538904585312595,TRX_N-00428-04164632,2023-01-26T10:41:33,Bilbao,expenses,cash,-100.0,-12926.91
buyer_1,Luis,,ES41209538904585312595,TRX_N-00429-60167454,2023-01-27T10:59:44,Bilbao,expenses,transport,-40.96,-12967.87
buyer_1,Luis,,ES41209538904585312595,TRX_N-00430-21879490,2023-01-27T21:47:56,Bilbao,expenses,clothing,-118.55,-13086.42
buyer_1,Luis,,ES41209538904585312595,TRX_N-00431-87525062,2023-01-27T19:09:26,Bilbao,expenses,gifts,-566.39,-13652.81
buyer_1,Luis,,ES41209538904585312595,TRX_N-00432-80540398,2023-01-29T07:05:27,Oyón-Oion,expenses,leisure,-35.54,-13688.35
buyer_1,Luis,,ES41209538904585312595,TRX_N-00433-22982933,2023-01-31T19:37:49,Bilbao,expenses,education,-68.69,-13757.04
buyer_1,Luis,,ES41209538904585312595,TRX_N-00434-22417323,2023-01-31T13:43:37,Lasarte-Oria,expenses,gifts,-802.52,-14559.56
buyer_1,Luis,,ES41209538904585312595,TRX_N-00435-61058053,2023-02-01T17:23:27,Bilbao,incomes,salary,3053.37,-11506.19
buyer_1,Luis,,ES41209538904585312595,TRX_N-00436-65598945,2023-02-01T05:58:36,Bilbao,expenses,transport,-75.5,-11581.69
buyer_1,Luis,,ES41209538904585312595,TRX_N-00437-09864901,2023-02-01T17:50:29,Bilbao,expenses,cash,-100.0,-11681.69
buyer_1,Luis,,ES41209538904585312595,TRX_N-00438-16283664,2023-02-01T08:51:39,Bilbao,expenses,appliances,-359.45,-12041.14
buyer_1,Luis,,ES41209538904585312595,TRX_N-00439-94981354,2023-02-02T18:33:23,Bilbao,expenses,transport,-86.51,-12127.65
buyer_1,Luis,,ES41209538904585312595,TRX_N-00440-05726856,2023-02-02T15:46:01,Bilbao,expenses,cash,-100.0,-12227.65
buyer_1,Luis,,ES41209538904585312595,TRX_N-00441-89387869,2023-02-03T10:12:16,Bilbao,expenses,food,-100.25,-12327.9
buyer_1,Luis,,ES41209538904585312595,TRX_N-00442-62468905,2023-02-03T08:20:00,Bilbao,expenses,cash,-100.0,-12427.9
buyer_1,Luis,,ES41209538904585312595,TRX_N-00443-92619547,2023-02-03T04:23:56,Bilbao,expenses,appliances,-182.59,-12610.49
buyer_1,Luis,,ES41209538904585312595,TRX_N-00444-29891759,2023-02-04T15:58:08,Bilbao,expenses,rent,-700.2,-13310.69
buyer_1,Luis,,ES41209538904585312595,TRX_N-00445-45894421,2023-02-04T20:15:26,Bilbao,expenses,cash,-100.0,-13410.69
buyer_1,Luis,,ES41209538904585312595,TRX_N-00446-72995546,2023-02-05T18:49:47,Bilbao,expenses,water,-43.63,-13454.32
buyer_1,Luis,,ES41209538904585312595,TRX_N-00447-75100713,2023-02-05T04:00:40,Bilbao,expenses,internet,-42.0,-13496.32
buyer_1,Luis,,ES41209538904585312595,TRX_N-00448-41228972,2023-02-06T20:28:04,Bilbao,expenses,electricity,-55.16,-13551.48
buyer_1,Luis,,ES41209538904585312595,TRX_N-00449-16588167,2023-02-06T10:25:19,Bilbao,expenses,gas,-81.04,-13632.52
buyer_1,Luis,,ES41209538904585312595,TRX_N-00450-17268138,2023-02-07T09:04:25,Bilbao,expenses,food,-95.97,-13728.49
buyer_1,Luis,,ES41209538904585312595,TRX_N-00451-37860496,2023-02-08T15:16:20,Bilbao,expenses,phone,-35.7,-13764.19
buyer_1,Luis,,ES41209538904585312595,TRX_N-00452-17929566,2023-02-08T14:31:28,Bilbao,expenses,leisure,-78.07,-13842.26
buyer_1,Luis,,ES41209538904585312595,TRX_N-00453-93836475,2023-02-08T13:40:13,Zarautz,expenses,cash,-100.0,-13942.26
buyer_1,Luis,,ES41209538904585312595,TRX_N-00454-97495918,2023-02-10T08:29:20,Bilbao,expenses,cash,-100.0,-14042.26
buyer_1,Luis,,ES41209538904585312595,TRX_N-00455-31593166,2023-02-10T00:03:48,Bilbao,expenses,repairs,-103.13,-14145.39
buyer_1,Luis,,ES41209538904585312595,TRX_N-00456-04109695,2023-02-12T20:29:52,Andoain,expenses,food,-118.58,-14263.97
buyer_1,Luis,,ES41209538904585312595,TRX_N-00457-57175807,2023-02-14T19:51:44,Bilbao,expenses,food,-112.77,-14376.74
buyer_1,Luis,,ES41209538904585312595,TRX_N-00458-27424721,2023-02-15T16:07:59,Basauri,expenses,transport,-82.17,-14458.91
buyer_1,Luis,,ES41209538904585312595,TRX_N-00459-87168080,2023-02-17T18:19:47,Bilbao,expenses,education,-71.55,-14530.46
buyer_1,Luis,,ES41209538904585312595,TRX_N-00460-44726920,2023-02-18T14:14:40,Bilbao,expenses,food,-120.55,-14651.01
buyer_1,Luis,,ES41209538904585312595,TRX_N-00461-39452748,2023-02-18T11:20:46,Bilbao,expenses,leisure,-50.68,-14701.69
buyer_1,Luis,,ES41209538904585312595,TRX_N-00462-47925936,2023-02-19T12:35:34,Bilbao,expenses,healthcare,-90.19,-14791.88
buyer_1,Luis,,ES41209538904585312595,TRX_N-00463-93520460,2023-02-20T09:19:37,Bilbao,expenses,food,-89.53,-14881.41
buyer_1,Luis,,ES41209538904585312595,TRX_N-00464-03591020,2023-02-20T20:27:28,Bilbao,expenses,cash,-100.0,-14981.41
buyer_1,Luis,,ES41209538904585312595,TRX_N-00465-77190304,2023-02-20T13:39:23,Bilbao,expenses,gifts,-570.55,-15551.96
buyer_1,Luis,,ES41209538904585312595,TRX_N-00466-56569917,2023-02-21T02:37:31,Bilbao,expenses,appliances,-286.13,-15838.09
buyer_1,Luis,,ES41209538904585312595,TRX_N-00467-46597269,2023-02-22T12:59:06,Bilbao,expenses,cash,-100.0,-15938.09
buyer_1,Luis,,ES41209538904585312595,TRX_N-00468-56038065,2023-02-23T05:59:09,Bilbao,expenses,food,-114.17,-16052.26
buyer_1,Luis,,ES41209538904585312595,TRX_N-00469-59424212,2023-02-25T16:26:17,Bilbao,expenses,cash,-100.0,-16152.26
buyer_1,Luis,,ES41209538904585312595,TRX_N-00470-30724941,2023-02-25T14:50:32,Galdakao,expenses,repairs,-319.99,-16472.25
buyer_1,Luis,,ES41209538904585312595,TRX_N-00471-03047110,2023-02-26T11:30:37,Bilbao,expenses,clothing,-125.98,-16598.23
buyer_1,Luis,,ES41209538904585312595,TRX_N-00472-94225180,2023-02-28T19:55:28,Bilbao,expenses,healthcare,-136.28,-16734.51
buyer_1,Luis,,ES41209538904585312595,TRX_N-00473-07032156,2023-03-01T20:50:40,Bilbao,incomes,salary,3053.37,-13681.14
buyer_1,Luis,,ES41209538904585312595,TRX_N-00474-36479286,2023-03-01T18:10:17,Bilbao,expenses,cash,-100.0,-13781.14
buyer_1,Luis,,ES41209538904585312595,TRX_N-00475-90294575,2023-03-01T08:19:58,Bilbao,expenses,gifts,-561.92,-14343.06
buyer_1,Luis,,ES41209538904585312595,TRX_N-00476-03712858,2023-03-02T06:19:46,Bilbao,expenses,cash,-100.0,-14443.06
buyer_1,Luis,,ES41209538904585312595,TRX_N-00477-89097231,2023-03-03T13:20:04,Bilbao,expenses,food,-61.22,-14504.28
buyer_1,Luis,,ES41209538904585312595,TRX_N-00478-64716723,2023-03-04T08:30:55,Bilbao,expenses,rent,-700.2,-15204.48
buyer_1,Luis,,ES41209538904585312595,TRX_N-00479-58512201,2023-03-05T00:49:18,Bilbao,expenses,phone,-39.5,-15243.98
buyer_1,Luis,,ES41209538904585312595,TRX_N-00480-87818993,2023-03-05T13:27:35,Bilbao,expenses,cash,-100.0,-15343.98
buyer_1,Luis,,ES41209538904585312595,TRX_N-00481-46347775,2023-03-07T12:59:46,Barakaldo,expenses,leisure,-62.57,-15406.55
buyer_1,Luis,,ES41209538904585312595,TRX_N-00482-01593424,2023-03-08T17:10:17,Bilbao,expenses,water,-26.12,-15432.67
buyer_1,Luis,,ES41209538904585312595,TRX_N-00483-99099244,2023-03-08T20:07:22,Bilbao,expenses,internet,-42.0,-15474.67
buyer_1,Luis,,ES41209538904585312595,TRX_N-00484-89122051,2023-03-08T19:39:24,Bilbao,expenses,electricity,-88.15,-15562.82
buyer_1,Luis,,ES41209538904585312595,TRX_N-00485-38695937,2023-03-08T05:15:20,Bilbao,expenses,gas,-65.41,-15628.23
buyer_1,Luis,,ES41209538904585312595,TRX_N-00486-88855130,2023-03-08T17:36:12,Bilbao,expenses,cash,-100.0,-15728.23
buyer_1,Luis,,ES41209538904585312595,TRX_N-00487-32596748,2023-03-08T08:33:04,Bilbao,expenses,repairs,-82.3,-15810.53
buyer_1,Luis,,ES41209538904585312595,TRX_N-00488-57853857,2023-03-10T01:23:35,Bilbao,expenses,cash,-100.0,-15910.53
buyer_1,Luis,,ES41209538904585312595,TRX_N-00489-05269547,2023-03-11T13:06:51,Barakaldo,expenses,transport,-40.05,-15950.58
buyer_1,Luis,,ES41209538904585312595,TRX_N-00490-24540587,2023-03-11T15:42:13,Sestao,expenses,gifts,-377.53,-16328.11
buyer_1,Luis,,ES41209538904585312595,TRX_N-00491-09135316,2023-03-12T17:16:35,Bilbao,expenses,food,-103.89,-16432.0
buyer_1,Luis,,ES41209538904585312595,TRX_N-00492-32567256,2023-03-15T10:32:19,Getxo,expenses,food,-69.2,-16501.2
buyer_1,Luis,,ES41209538904585312595,TRX_N-00493-28904500,2023-03-15T16:38:32,Bilbao,expenses,cash,-100.0,-16601.2
buyer_1,Luis,,ES41209538904585312595,TRX_N-00494-34793288,2023-03-16T17:52:16,Bilbao,expenses,transport,-66.08,-16667.28
buyer_1,Luis,,ES41209538904585312595,TRX_N-00495-29814331,2023-03-17T10:36:35,Bilbao,expenses,transport,-46.41,-16713.69
buyer_1,Luis,,ES41209538904585312595,TRX_N-00496-49850466,2023-03-20T18:45:38,Leioa,expenses,food,-100.69,-16814.38
buyer_1,Luis,,ES41209538904585312595,TRX_N-00497-46533838,2023-03-20T17:06:03,Bilbao,expenses,cash,-100.0,-16914.38
buyer_1,Luis,,ES41209538904585312595,TRX_N-00498-83143892,2023-03-21T18:21:48,Durango,expenses,food,-119.75,-17034.13
buyer_1,Luis,,ES41209538904585312595,TRX_N-00499-86318399,2023-03-22T13:48:35,Bilbao,expenses,clothing,-94.44,-17128.57
buyer_1,Luis,,ES41209538904585312595,TRX_N-00500-27073261,2023-03-23T18:48:16,Bilbao,expenses,appliances,-412.87,-17541.44
buyer_1,Luis,,ES41209538904585312595,TRX_N-00501-10149548,2023-03-24T10:19:34,Bilbao,expenses,repairs,-57.77,-17599.21
buyer_1,Luis,,ES41209538904585312595,TRX_N-00502-69455037,2023-03-25T12:48:13,Bilbao,expenses,gifts,-678.9,-18278.11
buyer_1,Luis,,ES41209538904585312595,TRX_N-00503-32171042,2023-03-26T10:04:50,Bilbao,expenses,repairs,-151.76,-18429.87
buyer_1,Luis,,ES41209538904585312595,TRX_N-00504-16971821,2023-03-27T19:04:43,Bilbao,expenses,transport,-75.72,-18505.59
buyer_1,Luis,,ES41209538904585312595,TRX_N-00505-63534784,2023-03-27T13:43:47,Bilbao,expenses,gifts,-491.28,-18996.87
buyer_1,Luis,,ES41209538904585312595,TRX_N-00506-70534826,2023-03-29T10:41:15,Galdakao,expenses,repairs,-185.89,-19182.76
buyer_1,Luis,,ES41209538904585312595,TRX_N-00507-99539966,2023-03-31T12:43:37,Irun,expenses,cash,-100.0,-19282.76
buyer_1,Luis,,ES41209538904585312595,TRX_N-00508-83999491,2023-04-01T23:13:56,Bilbao,incomes,salary,3053.37,-16229.39
buyer_1,Luis,,ES41209538904585312595,TRX_N-00509-37367187,2023-04-01T23:13:56,Bilbao,incomes,extra_income,349.57,-15879.82
buyer_1,Luis,,ES41209538904585312595,TRX_N-00510-39222877,2023-04-01T04:35:51,Bilbao,expenses,leisure,-72.98,-15952.8
buyer_1,Luis,,ES41209538904585312595,TRX_N-00511-05592783,2023-04-02T23:42:39,Bilbao,expenses,cash,-100.0,-16052.8
buyer_1,Luis,,ES41209538904585312595,TRX_N-00512-52765681,2023-04-03T20:21:09,Bilbao,expenses,transport,-89.47,-16142.27
buyer_1,Luis,,ES41209538904585312595,TRX_N-00513-68797230,2023-04-04T05:39:35,Bilbao,expenses,rent,-700.2,-16842.47
buyer_1,Luis,,ES41209538904585312595,TRX_N-00514-25016222,2023-04-05T10:12:40,Bilbao,expenses,water,-32.79,-16875.26
buyer_1,Luis,,ES41209538904585312595,TRX_N-00515-21789437,2023-04-06T02:20:56,Bilbao,expenses,internet,-42.0,-16917.26
buyer_1,Luis,,ES41209538904585312595,TRX_N-00516-62004695,2023-04-06T08:03:29,Bilbao,expenses,phone,-41.97,-16959.23
buyer_1,Luis,,ES41209538904585312595,TRX_N-00517-73987854,2023-04-07T10:39:04,Bilbao,expenses,electricity,-39.17,-16998.4
buyer_1,Luis,,ES41209538904585312595,TRX_N-00518-35137775,2023-04-07T16:26:00,Lasarte-Oria,expenses,gifts,-503.06,-17501.46
buyer_1,Luis,,ES41209538904585312595,TRX_N-00519-33860782,2023-04-08T20:55:17,Bilbao,expenses,gas,-101.52,-17602.98
buyer_1,Luis,,ES41209538904585312595,TRX_N-00520-74605512,2023-04-08T22:33:19,Bilbao,expenses,food,-118.8,-17721.78
buyer_1,Luis,,ES41209538904585312595,TRX_N-00521-14145247,2023-04-08T01:59:04,Bilbao,expenses,repairs,-88.29,-17810.07
buyer_1,Luis,,ES41209538904585312595,TRX_N-00522-56278945,2023-04-12T11:15:21,Sestao,expenses,transport,-61.44,-17871.51
buyer_1,Luis,,ES41209538904585312595,TRX_N-00523-95433200,2023-04-13T10:44:46,Bilbao,expenses,clothing,-57.53,-17929.04
buyer_1,Luis,,ES41209538904585312595,TRX_N-00524-29026315,2023-04-14T16:39:08,Bilbao,expenses,food,-77.8,-18006.84
buyer_1,Luis,,ES41209538904585312595,TRX_N-00525-45106100,2023-04-17T11:50:55,Bilbao,expenses,leisure,-38.71,-18045.55
buyer_1,Luis,,ES41209538904585312595,TRX_N-00526-32888662,2023-04-17T09:13:17,Bilbao,expenses,repairs,-48.59,-18094.14
buyer_1,Luis,,ES41209538904585312595,TRX_N-00527-03668815,2023-04-18T14:27:18,Bilbao,expenses,leisure,-34.71,-18128.85
buyer_1,Luis,,ES41209538904585312595,TRX_N-00528-64973218,2023-04-18T06:16:38,Bilbao,expenses,repairs,-81.3,-18210.15
buyer_1,Luis,,ES41209538904585312595,TRX_N-00529-73978944,2023-04-20T12:55:41,Bilbao,expenses,cash,-100.0,-18310.15
buyer_1,Luis,,ES41209538904585312595,TRX_N-00530-14889329,2023-04-21T08:12:47,Basauri,expenses,education,-60.9,-18371.05
buyer_1,Luis,,ES41209538904585312595,TRX_N-00531-07391990,2023-04-22T10:44:22,Bilbao,expenses,education,-45.43,-18416.48
buyer_1,Luis,,ES41209538904585312595,TRX_N-00532-28766563,2023-04-23T19:02:05,Bilbao,expenses,education,-78.31,-18494.79
buyer_1,Luis,,ES41209538904585312595,TRX_N-00533-77691026,2023-04-25T20:50:40,Bilbao,expenses,repairs,-157.87,-18652.66
buyer_1,Luis,,ES41209538904585312595,TRX_N-00534-24914997,2023-04-26T19:32:25,Bilbao,expenses,clothing,-123.63,-18776.29
buyer_1,Luis,,ES41209538904585312595,TRX_N-00535-82076530,2023-04-27T14:15:00,Bilbao,expenses,gifts,-255.64,-19031.93
buyer_1,Luis,,ES41209538904585312595,TRX_N-00536-66721711,2023-04-28T02:41:50,Bilbao,expenses,food,-100.86,-19132.79
buyer_1,Luis,,ES41209538904585312595,TRX_N-00537-96123823,2023-04-28T05:27:56,Bilbao,expenses,transport,-67.67,-19200.46
buyer_1,Luis,,ES41209538904585312595,TRX_N-00538-83902656,2023-04-28T08:30:44,Bilbao,expenses,cash,-100.0,-19300.46
buyer_1,Luis,,ES41209538904585312595,TRX_N-00539-84797090,2023-04-28T14:36:15,Bilbao,expenses,repairs,-278.34,-19578.8
buyer_1,Luis,,ES41209538904585312595,TRX_N-00540-28690939,2023-04-28T22:25:58,Bilbao,expenses,gifts,-685.94,-20264.74
buyer_1,Luis,,ES41209538904585312595,TRX_N-00541-88393423,2023-04-28T17:08:20,Bilbao,expenses,car,-194.58,-20459.32
buyer_1,Luis,,ES41209538904585312595,TRX_N-00542-42311631,2023-04-29T22:18:52,Bilbao,expenses,leisure,-35.68,-20495.0
buyer_1,Luis,,ES41209538904585312595,TRX_N-00543-97100278,2023-04-30T20:59:06,Basauri,expenses,transport,-73.11,-20568.11
buyer_1,Luis,,ES41209538904585312595,TRX_N-00544-30316676,2023-05-01T13:32:02,Bilbao,incomes,salary,3053.37,-17514.74
buyer_1,Luis,,ES41209538904585312595,TRX_N-00545-49781763,2023-05-03T09:49:51,Bilbao,expenses,transport,-71.23,-17585.97
buyer_1,Luis,,ES41209538904585312595,TRX_N-00546-85591696,2023-05-04T04:08:51,Bilbao,expenses,rent,-700.2,-18286.17
buyer_1,Luis,,ES41209538904585312595,TRX_N-00547-20691577,2023-05-05T16:24:26,Bilbao,expenses,clothing,-50.45,-18336.62
buyer_1,Luis,,ES41209538904585312595,TRX_N-00548-21340312,2023-05-06T15:34:14,Bilbao,expenses,gas,-39.94,-18376.56
buyer_1,Luis,,ES41209538904585312595,TRX_N-00549-47235960,2023-05-06T16:51:45,Bilbao,expenses,phone,-41.33,-18417.89
buyer_1,Luis,,ES41209538904585312595,TRX_N-00550-16817150,2023-05-06T13:53:16,Llodio,expenses,transport,-59.87,-18477.76
buyer_1,Luis,,ES41209538904585312595,TRX_N-00551-52322068,2023-05-08T05:53:24,Bilbao,expenses,water,-36.06,-18513.82
buyer_1,Luis,,ES41209538904585312595,TRX_N-00552-50656322,2023-05-08T15:15:28,Bilbao,expenses,electricity,-54.39,-18568.21
buyer_1,Luis,,ES41209538904585312595,TRX_N-00553-65953674,2023-05-08T21:03:44,Bilbao,expenses,internet,-42.0,-18610.21
buyer_1,Luis,,ES41209538904585312595,TRX_N-00554-51915145,2023-05-08T18:16:38,Eibar,expenses,gifts,-165.26,-18775.47
buyer_1,Luis,,ES41209538904585312595,TRX_N-00555-41436835,2023-05-10T20:01:59,Bilbao,expenses,gifts,-479.18,-19254.65
buyer_1,Luis,,ES41209538904585312595,TRX_N-00556-60270742,2023-05-11T16:27:37,Bilbao,expenses,leisure,-44.26,-19298.91
buyer_1,Luis,,ES41209538904585312595,TRX_N-00557-46405494,2023-05-12T03:30:03,Bilbao,expenses,transport,-78.59,-19377.5
buyer_1,Luis,,ES41209538904585312595,TRX_N-00558-96750108,2023-05-13T13:48:58,Bilbao,expenses,cash,-100.0,-19477.5
buyer_1,Luis,,ES41209538904585312595,TRX_N-00559-51896575,2023-05-14T18:02:11,Bilbao,expenses,transport,-46.35,-19523.85
buyer_1,Luis,,ES41209538904585312595,TRX_N-00560-97415232,2023-05-15T17:11:47,Oyón-Oion,expenses,food,-78.13,-19601.98
buyer_1,Luis,,ES41209538904585312595,TRX_N-00561-93209147,2023-05-15T18:22:26,Bilbao,expenses,transport,-78.84,-19680.82
buyer_1,Luis,,ES41209538904585312595,TRX_N-00562-40298367,2023-05-16T11:22:23,Bilbao,expenses,cash,-100.0,-19780.82
buyer_1,Luis,,ES41209538904585312595,TRX_N-00563-23421896,2023-05-18T12:21:24,Bilbao,expenses,repairs,-91.52,-19872.34
buyer_1,Luis,,ES41209538904585312595,TRX_N-00564-16927165,2023-05-19T11:20:11,Bilbao,expenses,leisure,-45.85,-19918.19
buyer_1,Luis,,ES41209538904585312595,TRX_N-00565-04661786,2023-05-20T14:01:43,Bilbao,expenses,appliances,-135.08,-20053.27
buyer_1,Luis,,ES41209538904585312595,TRX_N-00566-46528072,2023-05-21T16:22:03,Bilbao,expenses,leisure,-32.09,-20085.36
buyer_1,Luis,,ES41209538904585312595,TRX_N-00567-73097897,2023-05-21T05:16:42,Bilbao,expenses,cash,-100.0,-20185.36
buyer_1,Luis,,ES41209538904585312595,TRX_N-00568-78757938,2023-05-22T20:26:34,Iruña de Oca,expenses,leisure,-66.8,-20252.16
buyer_1,Luis,,ES41209538904585312595,TRX_N-00569-67970504,2023-05-24T20:22:09,Bilbao,expenses,food,-68.24,-20320.4
buyer_1,Luis,,ES41209538904585312595,TRX_N-00570-95761215,2023-05-24T12:19:37,Bermeo,expenses,clothing,-98.01,-20418.41
buyer_1,Luis,,ES41209538904585312595,TRX_N-00571-22177245,2023-05-26T08:54:09,Bilbao,expenses,transport,-85.55,-20503.96
buyer_1,Luis,,ES41209538904585312595,TRX_N-00572-78110756,2023-05-27T09:23:38,Bilbao,expenses,food,-67.97,-20571.93
buyer_1,Luis,,ES41209538904585312595,TRX_N-00573-38620657,2023-05-29T15:40:32,Bilbao,expenses,food,-88.32,-20660.25
buyer_1,Luis,,ES41209538904585312595,TRX_N-00574-39864069,2023-05-30T10:55:14,Bilbao,expenses,food,-70.09,-20730.34
buyer_1,Luis,,ES41209538904585312595,TRX_N-00575-56362646,2023-05-30T16:14:54,Bilbao,expenses,leisure,-68.87,-20799.21
buyer_1,Luis,,ES41209538904585312595,TRX_N-00576-94623533,2023-06-01T09:37:04,Bilbao,incomes,salary,3053.37,-17745.84
buyer_1,Luis,,ES41209538904585312595,TRX_N-00577-10534327,2023-06-01T09:37:04,Bilbao,incomes,salary_bonus,2177.27,-15568.57
buyer_1,Luis,,ES41209538904585312595,TRX_N-00578-10644131,2023-06-02T10:01:55,Bilbao,expenses,taxes,-1476.97,-17045.54
buyer_1,Luis,,ES41209538904585312595,TRX_N-00579-31153531,2023-06-02T11:10:58,Bilbao,expenses,insurance,-454.75,-17500.29
buyer_1,Luis,,ES41209538904585312595,TRX_N-00580-83758742,2023-06-04T13:25:55,Bilbao,expenses,rent,-700.2,-18200.49
buyer_1,Luis,,ES41209538904585312595,TRX_N-00581-36680368,2023-06-05T14:29:23,Bilbao,expenses,internet,-42.0,-18242.49
buyer_1,Luis,,ES41209538904585312595,TRX_N-00582-86644042,2023-06-05T14:11:42,Bilbao,expenses,phone,-42.24,-18284.73
buyer_1,Luis,,ES41209538904585312595,TRX_N-00583-11777755,2023-06-06T17:41:03,Bilbao,expenses,gas,-106.56,-18391.29
buyer_1,Luis,,ES41209538904585312595,TRX_N-00584-13929826,2023-06-06T18:52:03,Erandio,expenses,leisure,-56.63,-18447.92
buyer_1,Luis,,ES41209538904585312595,TRX_N-00585-34761523,2023-06-07T17:41:16,Bilbao,expenses,leisure,-74.73,-18522.65
buyer_1,Luis,,ES41209538904585312595,TRX_N-00586-40236714,2023-06-07T14:24:55,Bilbao,expenses,repairs,-242.97,-18765.62
buyer_1,Luis,,ES41209538904585312595,TRX_N-00587-12316780,2023-06-08T18:33:10,Bilbao,expenses,water,-33.7,-18799.32
buyer_1,Luis,,ES41209538904585312595,TRX_N-00588-52531494,2023-06-08T01:06:06,Bilbao,expenses,electricity,-77.94,-18877.26
buyer_1,Luis,,ES41209538904585312595,TRX_N-00589-39970799,2023-06-09T11:06:45,Bilbao,expenses,travel,-545.48,-19422.74
buyer_1,Luis,,ES41209538904585312595,TRX_N-00590-67990849,2023-06-09T13:43:43,Bilbao,expenses,appliances,-189.07,-19611.81
buyer_1,Luis,,ES41209538904585312595,TRX_N-00591-96486867,2023-06-10T04:39:43,Bilbao,expenses,transport,-75.36,-19687.17
buyer_1,Luis,,ES41209538904585312595,TRX_N-00592-74047585,2023-06-10T11:01:49,Bilbao,expenses,cash,-100.0,-19787.17
buyer_1,Luis,,ES41209538904585312595,TRX_N-00593-39666409,2023-06-10T13:37:29,Irun,expenses,repairs,-303.59,-20090.76
buyer_1,Luis,,ES41209538904585312595,TRX_N-00594-18259906,2023-06-12T16:55:42,Santurtzi,expenses,cash,-100.0,-20190.76
buyer_1,Luis,,ES41209538904585312595,TRX_N-00595-68324733,2023-06-13T14:42:07,Bilbao,expenses,food,-73.48,-20264.24
buyer_1,Luis,,ES41209538904585312595,TRX_N-00596-19944435,2023-06-13T12:01:06,Bilbao,expenses,repairs,-297.79,-20562.03
buyer_1,Luis,,ES41209538904585312595,TRX_N-00597-75366418,2023-06-14T11:32:37,Sopela,expenses,food,-116.07,-20678.1
buyer_1,Luis,,ES41209538904585312595,TRX_N-00598-12296143,2023-06-14T11:42:51,Bilbao,expenses,leisure,-35.48,-20713.58
buyer_1,Luis,,ES41209538904585312595,TRX_N-00599-62922724,2023-06-15T01:34:37,Bilbao,expenses,cash,-100.0,-20813.58
buyer_1,Luis,,ES41209538904585312595,TRX_N-00600-40147555,2023-06-15T19:35:03,Bilbao,expenses,travel,-1715.39,-22528.97
buyer_1,Luis,,ES41209538904585312595,TRX_N-00601-50176686,2023-06-18T13:20:00,Bilbao,expenses,cash,-100.0,-22628.97
buyer_1,Luis,,ES41209538904585312595,TRX_N-00602-42129673,2023-06-19T08:52:03,Bilbao,expenses,food,-91.87,-22720.84
buyer_1,Luis,,ES41209538904585312595,TRX_N-00603-88759244,2023-06-19T01:04:39,Bilbao,expenses,clothing,-104.53,-22825.37
buyer_1,Luis,,ES41209538904585312595,TRX_N-00604-27002733,2023-06-19T12:59:11,Bilbao,expenses,appliances,-135.47,-22960.84
buyer_1,Luis,,ES41209538904585312595,TRX_N-00605-61757854,2023-06-20T10:19:02,Bilbao,expenses,food,-73.89,-23034.73
buyer_1,Luis,,ES41209538904585312595,TRX_N-00606-93998184,2023-06-22T19:07:34,Bilbao,expenses,leisure,-48.49,-23083.22
buyer_1,Luis,,ES41209538904585312595,TRX_N-00607-57804050,2023-06-22T15:53:15,Bilbao,expenses,repairs,-250.23,-23333.45
buyer_1,Luis,,ES41209538904585312595,TRX_N-00608-62891054,2023-06-23T15:51:21,Bilbao,expenses,food,-115.3,-23448.75
buyer_1,Luis,,ES41209538904585312595,TRX_N-00609-00177772,2023-06-26T11:49:32,Bilbao,expenses,food,-124.07,-23572.82
buyer_1,Luis,,ES41209538904585312595,TRX_N-00610-68374566,2023-06-26T05:22:58,Bilbao,expenses,cash,-100.0,-23672.82
buyer_1,Luis,,ES41209538904585312595,TRX_N-00611-27050670,2023-06-27T14:53:55,Bilbao,expenses,cash,-100.0,-23772.82
buyer_1,Luis,,ES41209538904585312595,TRX_N-00612-71144036,2023-06-29T22:43:34,Bilbao,expenses,leisure,-20.8,-23793.62
buyer_1,Luis,,ES41209538904585312595,TRX_N-00613-91238405,2023-06-29T22:45:45,Bilbao,expenses,repairs,-162.39,-23956.01
buyer_1,Luis,,ES41209538904585312595,TRX_N-00614-25150144,2023-07-01T21:55:17,Bilbao,incomes,salary,3053.37,-20902.64
buyer_1,Luis,,ES41209538904585312595,TRX_N-00615-23240548,2023-07-01T21:55:17,Bilbao,incomes,extra_income,349.57,-20553.07
buyer_1,Luis,,ES41209538904585312595,TRX_N-00616-57946731,2023-07-01T08:27:54,Bilbao,expenses,food,-82.89,-20635.96
buyer_1,Luis,,ES41209538904585312595,TRX_N-00617-35395910,2023-07-01T02:05:07,Santurtzi,expenses,education,-43.09,-20679.05
buyer_1,Luis,,ES41209538904585312595,TRX_N-00618-80132418,2023-07-02T00:41:52,Bilbao,expenses,gifts,-65.56,-20744.61
buyer_1,Luis,,ES41209538904585312595,TRX_N-00619-33460588,2023-07-03T20:34:43,Bilbao,expenses,transport,-46.91,-20791.52
buyer_1,Luis,,ES41209538904585312595,TRX_N-00620-62238155,2023-07-04T13:02:03,Bilbao,expenses,rent,-700.2,-21491.72
buyer_1,Luis,,ES41209538904585312595,TRX_N-00621-22854788,2023-07-04T18:46:53,Bilbao,expenses,food,-80.1,-21571.82
buyer_1,Luis,,ES41209538904585312595,TRX_N-00622-60541915,2023-07-05T16:20:09,Bilbao,expenses,electricity,-85.57,-21657.39
buyer_1,Luis,,ES41209538904585312595,TRX_N-00623-66448787,2023-07-05T17:09:08,Bilbao,expenses,phone,-35.9,-21693.29
buyer_1,Luis,,ES41209538904585312595,TRX_N-00624-26759427,2023-07-05T16:10:31,Bilbao,expenses,healthcare,-62.57,-21755.86
buyer_1,Luis,,ES41209538904585312595,TRX_N-00625-59443485,2023-07-05T12:32:00,Bilbao,expenses,cash,-100.0,-21855.86
buyer_1,Luis,,ES41209538904585312595,TRX_N-00626-94771270,2023-07-06T19:31:32,Bilbao,expenses,water,-43.51,-21899.37
buyer_1,Luis,,ES41209538904585312595,TRX_N-00627-04411736,2023-07-06T18:36:29,Sestao,expenses,clothing,-75.22,-21974.59
buyer_1,Luis,,ES41209538904585312595,TRX_N-00628-95434393,2023-07-08T18:43:15,Bilbao,expenses,gas,-105.63,-22080.22
buyer_1,Luis,,ES41209538904585312595,TRX_N-00629-35920124,2023-07-08T16:54:34,Bilbao,expenses,internet,-42.0,-22122.22
buyer_1,Luis,,ES41209538904585312595,TRX_N-00630-24961185,2023-07-09T11:12:00,Bilbao,expenses,food,-87.16,-22209.38
buyer_1,Luis,,ES41209538904585312595,TRX_N-00631-87422594,2023-07-09T10:17:46,Bilbao,expenses,cash,-100.0,-22309.38
buyer_1,Luis,,ES41209538904585312595,TRX_N-00632-03145670,2023-07-10T20:18:35,Bilbao,expenses,food,-121.28,-22430.66
buyer_1,Luis,,ES41209538904585312595,TRX_N-00633-19648583,2023-07-10T18:48:27,Berango,expenses,clothing,-136.34,-22567.0
buyer_1,Luis,,ES41209538904585312595,TRX_N-00634-02749475,2023-07-12T12:49:16,Bilbao,expenses,cash,-100.0,-22667.0
buyer_1,Luis,,ES41209538904585312595,TRX_N-00635-21875531,2023-07-20T10:43:11,Bilbao,expenses,transport,-66.19,-22733.19
buyer_1,Luis,,ES41209538904585312595,TRX_N-00636-61105411,2023-07-20T14:57:08,Bilbao,expenses,leisure,-62.52,-22795.71
buyer_1,Luis,,ES41209538904585312595,TRX_N-00637-72774741,2023-07-20T20:10:27,Bilbao,expenses,clothing,-126.66,-22922.37
buyer_1,Luis,,ES41209538904585312595,TRX_N-00638-46255696,2023-07-20T20:16:10,Bilbao,expenses,cash,-100.0,-23022.37
buyer_1,Luis,,ES41209538904585312595,TRX_N-00639-50784608,2023-07-21T18:10:59,Bilbao,expenses,healthcare,-142.98,-23165.35
buyer_1,Luis,,ES41209538904585312595,TRX_N-00640-59344042,2023-07-22T17:09:40,Bilbao,expenses,food,-87.66,-23253.01
buyer_1,Luis,,ES41209538904585312595,TRX_N-00641-34112268,2023-07-22T10:11:13,Getxo,expenses,cash,-100.0,-23353.01
buyer_1,Luis,,ES41209538904585312595,TRX_N-00642-21481199,2023-07-24T14:05:19,Zarautz,expenses,food,-103.94,-23456.95
buyer_1,Luis,,ES41209538904585312595,TRX_N-00643-61013999,2023-07-24T18:58:52,Bilbao,expenses,leisure,-61.41,-23518.36
buyer_1,Luis,,ES41209538904585312595,TRX_N-00644-22227041,2023-07-26T17:57:27,Errenteria,expenses,travel,-492.32,-24010.68
buyer_1,Luis,,ES41209538904585312595,TRX_N-00645-28980832,2023-07-27T17:07:00,Bilbao,expenses,leisure,-73.58,-24084.26
buyer_1,Luis,,ES41209538904585312595,TRX_N-00646-92203210,2023-07-28T11:24:14,Bilbao,expenses,repairs,-250.04,-24334.3
buyer_1,Luis,,ES41209538904585312595,TRX_N-00647-55960914,2023-07-29T08:56:25,Bilbao,expenses,transport,-59.05,-24393.35
buyer_1,Luis,,ES41209538904585312595,TRX_N-00648-65739431,2023-07-30T09:41:10,Bilbao,expenses,leisure,-19.35,-24412.7
buyer_1,Luis,,ES41209538904585312595,TRX_N-00649-22216582,2023-08-01T18:51:12,Bilbao,incomes,salary,3053.37,-21359.33
buyer_1,Luis,,ES41209538904585312595,TRX_N-00650-06168501,2023-08-03T14:13:05,Bilbao,expenses,leisure,-24.76,-21384.09
buyer_1,Luis,,ES41209538904585312595,TRX_N-00651-24168061,2023-08-03T15:44:21,Bilbao,expenses,repairs,-193.36,-21577.45
buyer_1,Luis,,ES41209538904585312595,TRX_N-00652-45132813,2023-08-04T12:11:34,Bilbao,expenses,rent,-700.2,-22277.65
buyer_1,Luis,,ES41209538904585312595,TRX_N-00653-15326908,2023-08-05T10:56:28,Bilbao,expenses,travel,-361.32,-22638.97
buyer_1,Luis,,ES41209538904585312595,TRX_N-00654-14475246,2023-08-05T17:50:45,Bilbao,expenses,gifts,-341.93,-22980.9
buyer_1,Luis,,ES41209538904585312595,TRX_N-00655-98518398,2023-08-06T11:26:25,Bilbao,expenses,electricity,-51.23,-23032.13
buyer_1,Luis,,ES41209538904585312595,TRX_N-00656-64918879,2023-08-06T16:32:39,Bilbao,expenses,gas,-36.15,-23068.28
buyer_1,Luis,,ES41209538904585312595,TRX_N-00657-16182789,2023-08-07T19:08:59,Bilbao,expenses,internet,-42.0,-23110.28
buyer_1,Luis,,ES41209538904585312595,TRX_N-00658-84632488,2023-08-08T22:54:11,Bilbao,expenses,phone,-31.8,-23142.08
buyer_1,Luis,,ES41209538904585312595,TRX_N-00659-35178797,2023-08-08T19:09:50,Bilbao,expenses,water,-44.91,-23186.99
buyer_1,Luis,,ES41209538904585312595,TRX_N-00660-13459149,2023-08-11T16:15:34,Portugalete,expenses,travel,-1547.2,-24734.19
buyer_1,Luis,,ES41209538904585312595,TRX_N-00661-87398879,2023-08-13T11:17:55,Hondarribia,expenses,leisure,-45.5,-24779.69
buyer_1,Luis,,ES41209538904585312595,TRX_N-00662-07643537,2023-08-16T11:23:22,Bilbao,expenses,transport,-76.48,-24856.17
buyer_1,Luis,,ES41209538904585312595,TRX_N-00663-94671981,2023-08-16T00:13:16,Bilbao,expenses,cash,-100.0,-24956.17
buyer_1,Luis,,ES41209538904585312595,TRX_N-00664-76620604,2023-08-17T15:33:47,Bilbao,expenses,transport,-67.77,-25023.94
buyer_1,Luis,,ES41209538904585312595,TRX_N-00665-61342016,2023-08-17T16:02:50,Bilbao,expenses,healthcare,-107.14,-25131.08
buyer_1,Luis,,ES41209538904585312595,TRX_N-00666-24815105,2023-08-17T20:15:49,Basauri,expenses,cash,-100.0,-25231.08
buyer_1,Luis,,ES41209538904585312595,TRX_N-00667-30816684,2023-08-18T16:47:49,Errenteria,expenses,transport,-49.88,-25280.96
buyer_1,Luis,,ES41209538904585312595,TRX_N-00668-49361653,2023-08-22T17:39:15,Barakaldo,expenses,travel,-1773.77,-27054.73
buyer_1,Luis,,ES41209538904585312595,TRX_N-00669-34988508,2023-08-23T16:37:21,Amurrio,expenses,repairs,-163.89,-27218.62
buyer_1,Luis,,ES41209538904585312595,TRX_N-00670-72450801,2023-08-25T13:55:51,Bilbao,expenses,repairs,-264.98,-27483.6
buyer_1,Luis,,ES41209538904585312595,TRX_N-00671-10306311,2023-08-26T20:14:31,Bilbao,expenses,food,-94.29,-27577.89
buyer_1,Luis,,ES41209538904585312595,TRX_N-00672-39342790,2023-08-26T19:10:15,Bilbao,expenses,clothing,-75.78,-27653.67
buyer_1,Luis,,ES41209538904585312595,TRX_N-00673-92167582,2023-08-28T13:09:25,Bilbao,expenses,repairs,-263.34,-27917.01
buyer_1,Luis,,ES41209538904585312595,TRX_N-00674-39194632,2023-08-29T20:05:05,Bilbao,expenses,transport,-86.83,-28003.84
buyer_1,Luis,,ES41209538904585312595,TRX_N-00675-80826664,2023-08-30T16:09:31,Bilbao,expenses,food,-94.86,-28098.7
buyer_1,Luis,,ES41209538904585312595,TRX_N-00676-35756844,2023-08-30T22:02:04,Bilbao,expenses,cash,-100.0,-28198.7
buyer_1,Luis,,ES41209538904585312595,TRX_N-00677-78876787,2023-08-31T19:38:10,Bilbao,expenses,education,-59.32,-28258.02
buyer_1,Luis,,ES41209538904585312595,TRX_N-00678-09297388,2023-08-31T15:56:11,Bilbao,expenses,travel,-1039.98,-29298.0
buyer_1,Luis,,ES41209538904585312595,TRX_N-00679-02799695,2023-09-01T13:35:40,Bilbao,incomes,salary,3053.37,-26244.63
buyer_1,Luis,,ES41209538904585312595,TRX_N-00680-21057366,2023-09-02T16:07:40,Bilbao,expenses,transport,-58.34,-26302.97
buyer_1,Luis,,ES41209538904585312595,TRX_N-00681-71905014,2023-09-02T19:03:31,Bilbao,expenses,cash,-100.0,-26402.97
buyer_1,Luis,,ES41209538904585312595,TRX_N-00682-25456406,2023-09-03T01:50:37,Bilbao,expenses,food,-67.74,-26470.71
buyer_1,Luis,,ES41209538904585312595,TRX_N-00683-82185720,2023-09-04T03:20:18,Bilbao,expenses,rent,-700.2,-27170.91
buyer_1,Luis,,ES41209538904585312595,TRX_N-00684-56366048,2023-09-05T18:08:34,Bilbao,expenses,water,-43.16,-27214.07
buyer_1,Luis,,ES41209538904585312595,TRX_N-00685-60118838,2023-09-05T13:47:01,Bilbao,expenses,electricity,-83.94,-27298.01
buyer_1,Luis,,ES41209538904585312595,TRX_N-00686-86645407,2023-09-05T12:57:57,Bilbao,expenses,food,-116.64,-27414.65
buyer_1,Luis,,ES41209538904585312595,TRX_N-00687-00381673,2023-09-05T15:34:14,Bilbao,expenses,healthcare,-183.6,-27598.25
buyer_1,Luis,,ES41209538904585312595,TRX_N-00688-40176923,2023-09-06T13:20:46,Bilbao,expenses,internet,-42.0,-27640.25
buyer_1,Luis,,ES41209538904585312595,TRX_N-00689-24359945,2023-09-06T16:32:47,Bilbao,expenses,cash,-100.0,-27740.25
buyer_1,Luis,,ES41209538904585312595,TRX_N-00690-20017480,2023-09-06T12:02:50,Bilbao,expenses,gifts,-538.78,-28279.03
buyer_1,Luis,,ES41209538904585312595,TRX_N-00691-99410021,2023-09-07T05:11:24,Bilbao,expenses,food,-78.03,-28357.06
buyer_1,Luis,,ES41209538904585312595,TRX_N-00692-74062670,2023-09-07T15:50:04,Eibar,expenses,leisure,-82.9,-28439.96
buyer_1,Luis,,ES41209538904585312595,TRX_N-00693-76914685,2023-09-08T03:56:27,Bilbao,expenses,gas,-90.91,-28530.87
buyer_1,Luis,,ES41209538904585312595,TRX_N-00694-69203943,2023-09-08T16:19:34,Bilbao,expenses,phone,-34.25,-28565.12
buyer_1,Luis,,ES41209538904585312595,TRX_N-00695-81873983,2023-09-08T15:23:11,Vitoria-Gasteiz,expenses,leisure,-31.44,-28596.56
buyer_1,Luis,,ES41209538904585312595,TRX_N-00696-40828220,2023-09-08T00:47:37,Bilbao,expenses,clothing,-67.68,-28664.24
buyer_1,Luis,,ES41209538904585312595,TRX_N-00697-62511509,2023-09-08T08:52:56,Bilbao,expenses,appliances,-339.68,-29003.92
buyer_1,Luis,,ES41209538904585312595,TRX_N-00698-60528602,2023-09-08T09:07:24,Bilbao,expenses,gifts,-721.89,-29725.81
buyer_1,Luis,,ES41209538904585312595,TRX_N-00699-60433569,2023-09-09T05:12:30,Arrasate,expenses,cash,-100.0,-29825.81
buyer_1,Luis,,ES41209538904585312595,TRX_N-00700-13070770,2023-09-10T14:12:45,Bilbao,expenses,clothing,-130.73,-29956.54
buyer_1,Luis,,ES41209538904585312595,TRX_N-00701-63599230,2023-09-10T08:27:42,Bilbao,expenses,appliances,-390.49,-30347.03
buyer_1,Luis,,ES41209538904585312595,TRX_N-00702-74069174,2023-09-12T13:19:10,Barakaldo,expenses,healthcare,-82.17,-30429.2
buyer_1,Luis,,ES41209538904585312595,TRX_N-00703-46829528,2023-09-13T09:30:59,Bilbao,expenses,leisure,-53.24,-30482.44
buyer_1,Luis,,ES41209538904585312595,TRX_N-00704-73614613,2023-09-14T18:02:22,Bilbao,expenses,gifts,-197.89,-30680.33
buyer_1,Luis,,ES41209538904585312595,TRX_N-00705-87110028,2023-09-15T13:07:47,Galdakao,expenses,cash,-100.0,-30780.33
buyer_1,Luis,,ES41209538904585312595,TRX_N-00706-14413637,2023-09-17T08:36:18,Bilbao,expenses,cash,-100.0,-30880.33
buyer_1,Luis,,ES41209538904585312595,TRX_N-00707-35434427,2023-09-19T16:14:18,Bilbao,expenses,food,-90.78,-30971.11
buyer_1,Luis,,ES41209538904585312595,TRX_N-00708-28752960,2023-09-19T14:11:38,Bilbao,expenses,cash,-100.0,-31071.11
buyer_1,Luis,,ES41209538904585312595,TRX_N-00709-86347539,2023-09-20T04:27:09,Bilbao,expenses,food,-85.12,-31156.23
buyer_1,Luis,,ES41209538904585312595,TRX_N-00710-40392428,2023-09-23T03:01:18,Bilbao,expenses,repairs,-283.32,-31439.55
buyer_1,Luis,,ES41209538904585312595,TRX_N-00711-81248060,2023-09-24T16:44:11,Bilbao,expenses,food,-104.55,-31544.1
buyer_1,Luis,,ES41209538904585312595,TRX_N-00712-19989396,2023-09-30T11:59:13,Bilbao,expenses,transport,-82.18,-31626.28
buyer_1,Luis,,ES41209538904585312595,TRX_N-00713-37587509,2023-09-30T19:44:23,Bilbao,expenses,cash,-100.0,-31726.28
buyer_1,Luis,,ES41209538904585312595,TRX_N-00714-62916279,2023-10-01T17:28:17,Bilbao,incomes,salary,3053.37,-28672.91
buyer_1,Luis,,ES41209538904585312595,TRX_N-00715-87018869,2023-10-01T18:37:00,Bilbao,expenses,transport,-58.75,-28731.66
buyer_1,Luis,,ES41209538904585312595,TRX_N-00716-52322699,2023-10-01T13:17:00,Bilbao,expenses,leisure,-52.7,-28784.36
buyer_1,Luis,,ES41209538904585312595,TRX_N-00717-21570557,2023-10-01T11:08:10,Basauri,expenses,clothing,-129.85,-28914.21
buyer_1,Luis,,ES41209538904585312595,TRX_N-00718-50494749,2023-10-01T12:40:10,Bilbao,expenses,healthcare,-89.11,-29003.32
buyer_1,Luis,,ES41209538904585312595,TRX_N-00719-68607379,2023-10-02T17:06:36,Bilbao,expenses,food,-116.75,-29120.07
buyer_1,Luis,,ES41209538904585312595,TRX_N-00720-85678224,2023-10-02T05:11:59,Bilbao,expenses,leisure,-56.05,-29176.12
buyer_1,Luis,,ES41209538904585312595,TRX_N-00721-04729418,2023-10-03T08:43:44,Santurtzi,expenses,food,-89.57,-29265.69
buyer_1,Luis,,ES41209538904585312595,TRX_N-00722-61449253,2023-10-04T19:12:36,Bilbao,expenses,rent,-700.2,-29965.89
buyer_1,Luis,,ES41209538904585312595,TRX_N-00723-45794840,2023-10-04T18:40:40,Bilbao,expenses,gifts,-341.71,-30307.6
buyer_1,Luis,,ES41209538904585312595,TRX_N-00724-29799606,2023-10-05T23:14:56,Bilbao,expenses,internet,-42.0,-30349.6
buyer_1,Luis,,ES41209538904585312595,TRX_N-00725-98644167,2023-10-06T20:52:17,Bilbao,expenses,leisure,-71.07,-30420.67
buyer_1,Luis,,ES41209538904585312595,TRX_N-00726-37814290,2023-10-07T13:11:41,Bilbao,expenses,water,-25.8,-30446.47
buyer_1,Luis,,ES41209538904585312595,TRX_N-00727-93373224,2023-10-07T18:58:32,Bilbao,expenses,cash,-100.0,-30546.47
buyer_1,Luis,,ES41209538904585312595,TRX_N-00728-89570882,2023-10-08T18:08:09,Bilbao,expenses,electricity,-46.4,-30592.87
buyer_1,Luis,,ES41209538904585312595,TRX_N-00729-13977485,2023-10-08T11:59:49,Bilbao,expenses,gas,-48.27,-30641.14
buyer_1,Luis,,ES41209538904585312595,TRX_N-00730-85104434,2023-10-08T11:34:23,Bilbao,expenses,phone,-37.11,-30678.25
buyer_1,Luis,,ES41209538904585312595,TRX_N-00731-99139984,2023-10-09T14:06:38,Bilbao,expenses,gifts,-541.08,-31219.33
buyer_1,Luis,,ES41209538904585312595,TRX_N-00732-87407330,2023-10-10T08:40:04,Zarautz,expenses,leisure,-60.43,-31279.76
buyer_1,Luis,,ES41209538904585312595,TRX_N-00733-77788172,2023-10-12T22:40:14,Bilbao,expenses,appliances,-357.44,-31637.2
buyer_1,Luis,,ES41209538904585312595,TRX_N-00734-60885802,2023-10-15T14:22:41,Bilbao,expenses,leisure,-69.21,-31706.41
buyer_1,Luis,,ES41209538904585312595,TRX_N-00735-44098203,2023-10-18T15:38:44,Llodio,expenses,travel,-1140.15,-32846.56
buyer_1,Luis,,ES41209538904585312595,TRX_N-00736-64656011,2023-10-18T14:53:54,Bilbao,expenses,gifts,-692.48,-33539.04
buyer_1,Luis,,ES41209538904585312595,TRX_N-00737-88302481,2023-10-19T11:23:14,Llodio,expenses,food,-110.79,-33649.83
buyer_1,Luis,,ES41209538904585312595,TRX_N-00738-50187389,2023-10-19T15:13:26,Mungia,expenses,transport,-60.92,-33710.75
buyer_1,Luis,,ES41209538904585312595,TRX_N-00739-75957570,2023-10-19T07:37:28,Bilbao,expenses,clothing,-127.67,-33838.42
buyer_1,Luis,,ES41209538904585312595,TRX_N-00740-16459724,2023-10-22T09:04:02,Errenteria,expenses,transport,-85.38,-33923.8
buyer_1,Luis,,ES41209538904585312595,TRX_N-00741-82787041,2023-10-22T08:29:29,Bilbao,expenses,cash,-100.0,-34023.8
buyer_1,Luis,,ES41209538904585312595,TRX_N-00742-85406099,2023-10-23T12:54:53,Bilbao,expenses,food,-96.15,-34119.95
buyer_1,Luis,,ES41209538904585312595,TRX_N-00743-02394501,2023-10-25T03:39:20,Llodio,expenses,clothing,-65.3,-34185.25
buyer_1,Luis,,ES41209538904585312595,TRX_N-00744-35197273,2023-10-25T18:16:40,Bilbao,expenses,gifts,-80.48,-34265.73
buyer_1,Luis,,ES41209538904585312595,TRX_N-00745-89357009,2023-10-26T18:48:37,Iruña de Oca,expenses,leisure,-60.24,-34325.97
buyer_1,Luis,,ES41209538904585312595,TRX_N-00746-28652548,2023-10-26T17:41:15,Bilbao,expenses,gifts,-372.41,-34698.38
buyer_1,Luis,,ES41209538904585312595,TRX_N-00747-54341250,2023-10-27T04:32:26,Bilbao,expenses,healthcare,-147.47,-34845.85
buyer_1,Luis,,ES41209538904585312595,TRX_N-00748-48313841,2023-10-29T00:09:01,Zarautz,expenses,leisure,-76.11,-34921.96
buyer_1,Luis,,ES41209538904585312595,TRX_N-00749-63188363,2023-11-01T17:15:25,Bilbao,incomes,salary,3053.37,-31868.59
buyer_1,Luis,,ES41209538904585312595,TRX_N-00750-39210094,2023-11-01T17:15:25,Bilbao,incomes,extra_income,349.57,-31519.02
buyer_1,Luis,,ES41209538904585312595,TRX_N-00751-52308791,2023-11-02T09:18:17,Bilbao,expenses,cash,-100.0,-31619.02
buyer_1,Luis,,ES41209538904585312595,TRX_N-00752-00046781,2023-11-04T17:08:17,Bilbao,expenses,rent,-700.2,-32319.22
buyer_1,Luis,,ES41209538904585312595,TRX_N-00753-11616163,2023-11-04T12:20:35,Hernani,expenses,cash,-100.0,-32419.22
buyer_1,Luis,,ES41209538904585312595,TRX_N-00754-16686284,2023-11-05T13:34:43,Bilbao,expenses,electricity,-64.05,-32483.27
buyer_1,Luis,,ES41209538904585312595,TRX_N-00755-99082033,2023-11-05T17:56:56,Bilbao,expenses,phone,-32.38,-32515.65
buyer_1,Luis,,ES41209538904585312595,TRX_N-00756-05857631,2023-11-07T10:42:04,Bilbao,expenses,food,-88.48,-32604.13
buyer_1,Luis,,ES41209538904585312595,TRX_N-00757-63317672,2023-11-08T13:31:35,Bilbao,expenses,internet,-42.0,-32646.13
buyer_1,Luis,,ES41209538904585312595,TRX_N-00758-99735907,2023-11-08T19:08:32,Bilbao,expenses,water,-40.33,-32686.46
buyer_1,Luis,,ES41209538904585312595,TRX_N-00759-45449285,2023-11-08T08:03:53,Bilbao,expenses,gas,-45.21,-32731.67
buyer_1,Luis,,ES41209538904585312595,TRX_N-00760-80556059,2023-11-09T21:04:33,Bilbao,expenses,leisure,-82.45,-32814.12
buyer_1,Luis,,ES41209538904585312595,TRX_N-00761-71125304,2023-11-09T00:30:14,Llodio,expenses,gifts,-734.19,-33548.31
buyer_1,Luis,,ES41209538904585312595,TRX_N-00762-86806561,2023-11-11T22:01:22,Bilbao,expenses,cash,-100.0,-33648.31
buyer_1,Luis,,ES41209538904585312595,TRX_N-00763-37621945,2023-11-12T15:45:15,Bilbao,expenses,gifts,-391.54,-34039.85
buyer_1,Luis,,ES41209538904585312595,TRX_N-00764-99207370,2023-11-13T18:56:31,Bilbao,expenses,food,-111.75,-34151.6
buyer_1,Luis,,ES41209538904585312595,TRX_N-00765-73049048,2023-11-13T12:52:58,Barakaldo,expenses,education,-46.18,-34197.78
buyer_1,Luis,,ES41209538904585312595,TRX_N-00766-08285541,2023-11-13T21:54:17,Bilbao,expenses,cash,-100.0,-34297.78
buyer_1,Luis,,ES41209538904585312595,TRX_N-00767-34956274,2023-11-14T17:51:56,Bilbao,expenses,transport,-73.95,-34371.73
buyer_1,Luis,,ES41209538904585312595,TRX_N-00768-47773556,2023-11-14T09:34:47,Bilbao,expenses,cash,-100.0,-34471.73
buyer_1,Luis,,ES41209538904585312595,TRX_N-00769-22362564,2023-11-14T17:27:46,Bilbao,expenses,gifts,-130.72,-34602.45
buyer_1,Luis,,ES41209538904585312595,TRX_N-00770-11837985,2023-11-15T17:25:55,Bilbao,expenses,clothing,-123.27,-34725.72
buyer_1,Luis,,ES41209538904585312595,TRX_N-00771-64179636,2023-11-18T19:37:39,Bilbao,expenses,transport,-85.08,-34810.8
buyer_1,Luis,,ES41209538904585312595,TRX_N-00772-57583073,2023-11-18T21:06:41,Bilbao,expenses,cash,-100.0,-34910.8
buyer_1,Luis,,ES41209538904585312595,TRX_N-00773-82337438,2023-11-20T20:12:20,Bilbao,expenses,healthcare,-81.88,-34992.68
buyer_1,Luis,,ES41209538904585312595,TRX_N-00774-47866435,2023-11-20T14:00:54,Bilbao,expenses,cash,-100.0,-35092.68
buyer_1,Luis,,ES41209538904585312595,TRX_N-00775-38789367,2023-11-23T16:35:35,Bilbao,expenses,food,-113.47,-35206.15
buyer_1,Luis,,ES41209538904585312595,TRX_N-00776-79519194,2023-11-24T09:12:07,Bilbao,expenses,cash,-100.0,-35306.15
buyer_1,Luis,,ES41209538904585312595,TRX_N-00777-50993460,2023-11-25T22:34:25,Bilbao,expenses,leisure,-25.97,-35332.12
buyer_1,Luis,,ES41209538904585312595,TRX_N-00778-89620708,2023-11-26T14:21:05,Bilbao,expenses,food,-97.31,-35429.43
buyer_1,Luis,,ES41209538904585312595,TRX_N-00779-56196726,2023-11-27T13:24:11,Amurrio,expenses,repairs,-205.57,-35635.0
buyer_1,Luis,,ES41209538904585312595,TRX_N-00780-47651830,2023-11-28T17:01:48,Bilbao,expenses,food,-106.11,-35741.11
buyer_1,Luis,,ES41209538904585312595,TRX_N-00781-32971985,2023-11-28T09:12:01,Bilbao,expenses,leisure,-35.22,-35776.33
buyer_1,Luis,,ES41209538904585312595,TRX_N-00782-65651896,2023-11-29T15:53:36,Bilbao,expenses,leisure,-24.67,-35801.0
buyer_1,Luis,,ES41209538904585312595,TRX_N-00783-47814654,2023-11-30T10:58:04,Bilbao,expenses,clothing,-158.95,-35959.95
buyer_1,Luis,,ES41209538904585312595,TRX_N-00784-38687022,2023-11-30T10:00:41,Bilbao,expenses,education,-75.52,-36035.47
buyer_1,Luis,,ES41209538904585312595,TRX_N-00785-79084717,2023-12-01T16:59:13,Bilbao,incomes,salary,3053.37,-32982.1
buyer_1,Luis,,ES41209538904585312595,TRX_N-00786-91687257,2023-12-01T16:59:13,Bilbao,incomes,salary_bonus,2183.06,-30799.04
buyer_1,Luis,,ES41209538904585312595,TRX_N-00787-25350124,2023-12-01T08:19:32,Bilbao,expenses,clothing,-134.68,-30933.72
buyer_1,Luis,,ES41209538904585312595,TRX_N-00788-89961057,2023-12-01T12:43:31,Bilbao,expenses,education,-50.62,-30984.34
buyer_1,Luis,,ES41209538904585312595,TRX_N-00789-66602079,2023-12-02T22:02:57,Andoain,expenses,leisure,-26.72,-31011.06
buyer_1,Luis,,ES41209538904585312595,TRX_N-00790-60712304,2023-12-04T17:21:36,Bilbao,expenses,rent,-700.2,-31711.26
buyer_1,Luis,,ES41209538904585312595,TRX_N-00791-40806583,2023-12-04T16:46:05,Bilbao,expenses,leisure,-26.87,-31738.13
buyer_1,Luis,,ES41209538904585312595,TRX_N-00792-12984818,2023-12-05T08:46:48,Bilbao,expenses,electricity,-75.72,-31813.85
buyer_1,Luis,,ES41209538904585312595,TRX_N-00793-24451094,2023-12-05T17:50:20,Bilbao,expenses,transport,-58.9,-31872.75
buyer_1,Luis,,ES41209538904585312595,TRX_N-00794-70868659,2023-12-06T08:09:14,Bilbao,expenses,water,-20.38,-31893.13
buyer_1,Luis,,ES41209538904585312595,TRX_N-00795-27000555,2023-12-06T08:07:18,Bilbao,expenses,internet,-42.0,-31935.13
buyer_1,Luis,,ES41209538904585312595,TRX_N-00796-87801839,2023-12-06T17:23:24,Bilbao,expenses,phone,-35.34,-31970.47
buyer_1,Luis,,ES41209538904585312595,TRX_N-00797-36505918,2023-12-08T22:09:30,Bilbao,expenses,gas,-32.89,-32003.36
buyer_1,Luis,,ES41209538904585312595,TRX_N-00798-77267223,2023-12-09T01:22:19,Bilbao,expenses,healthcare,-183.46,-32186.82
buyer_1,Luis,,ES41209538904585312595,TRX_N-00799-87217538,2023-12-11T18:34:08,Bilbao,expenses,transport,-73.84,-32260.66
buyer_1,Luis,,ES41209538904585312595,TRX_N-00800-38484412,2023-12-11T20:03:04,Bilbao,expenses,cash,-100.0,-32360.66
buyer_1,Luis,,ES41209538904585312595,TRX_N-00801-94281167,2023-12-12T19:46:42,Zarautz,expenses,transport,-72.15,-32432.81
buyer_1,Luis,,ES41209538904585312595,TRX_N-00802-15942895,2023-12-13T22:51:32,Bilbao,expenses,food,-67.98,-32500.79
buyer_1,Luis,,ES41209538904585312595,TRX_N-00803-12790752,2023-12-13T10:55:36,Bilbao,expenses,leisure,-60.06,-32560.85
buyer_1,Luis,,ES41209538904585312595,TRX_N-00804-02728627,2023-12-13T08:44:32,Pasaia,expenses,education,-73.8,-32634.65
buyer_1,Luis,,ES41209538904585312595,TRX_N-00805-72493594,2023-12-13T19:38:22,Bilbao,expenses,appliances,-324.81,-32959.46
buyer_1,Luis,,ES41209538904585312595,TRX_N-00806-22860266,2023-12-14T09:16:36,Bilbao,expenses,leisure,-50.54,-33010.0
buyer_1,Luis,,ES41209538904585312595,TRX_N-00807-03190987,2023-12-14T16:12:43,Bilbao,expenses,cash,-100.0,-33110.0
buyer_1,Luis,,ES41209538904585312595,TRX_N-00808-58415429,2023-12-15T10:02:30,Bilbao,expenses,food,-123.88,-33233.88
buyer_1,Luis,,ES41209538904585312595,TRX_N-00809-00959360,2023-12-15T08:16:41,Bilbao,expenses,cash,-100.0,-33333.88
buyer_1,Luis,,ES41209538904585312595,TRX_N-00810-46657008,2023-12-16T09:48:56,Salvatierra/Agurain,expenses,transport,-61.09,-33394.97
buyer_1,Luis,,ES41209538904585312595,TRX_N-00811-62752414,2023-12-16T10:30:03,Bilbao,expenses,leisure,-67.54,-33462.51
buyer_1,Luis,,ES41209538904585312595,TRX_N-00812-43926450,2023-12-16T18:26:27,Bilbao,expenses,cash,-100.0,-33562.51
buyer_1,Luis,,ES41209538904585312595,TRX_N-00813-37368301,2023-12-17T04:03:58,Bilbao,expenses,cash,-100.0,-33662.51
buyer_1,Luis,,ES41209538904585312595,TRX_N-00814-91351475,2023-12-17T11:40:25,Bilbao,expenses,repairs,-87.5,-33750.01
buyer_1,Luis,,ES41209538904585312595,TRX_N-00815-47764911,2023-12-19T08:23:46,Bilbao,expenses,transport,-47.64,-33797.65
buyer_1,Luis,,ES41209538904585312595,TRX_N-00816-03404785,2023-12-22T20:48:00,Bilbao,expenses,travel,-645.96,-34443.61
buyer_1,Luis,,ES41209538904585312595,TRX_N-00817-40428704,2023-12-25T23:50:31,Bilbao,expenses,food,-106.11,-34549.72
buyer_1,Luis,,ES41209538904585312595,TRX_N-00818-20130542,2023-12-31T18:55:08,Bilbao,expenses,cash,-100.0,-34649.72
buyer_1,Luis,,ES41209538904585312595,TRX_N-00819-94574311,2024-01-01T20:16:01,Bilbao,incomes,salary,3139.5,-31510.22
buyer_1,Luis,,ES41209538904585312595,TRX_N-00820-36603637,2024-01-01T11:44:11,Bilbao,expenses,food,-104.52,-31614.74
buyer_1,Luis,,ES41209538904585312595,TRX_N-00821-73226938,2024-01-03T12:15:57,Bilbao,expenses,leisure,-75.43,-31690.17
buyer_1,Luis,,ES41209538904585312595,TRX_N-00822-00071011,2024-01-03T10:29:49,Bilbao,expenses,healthcare,-151.07,-31841.24
buyer_1,Luis,,ES41209538904585312595,TRX_N-00823-51779712,2024-01-03T09:01:42,Bilbao,expenses,repairs,-315.71,-32156.95
buyer_1,Luis,,ES41209538904585312595,TRX_N-00824-70629900,2024-01-04T14:35:07,Bilbao,expenses,rent,-700.2,-32857.15
buyer_1,Luis,,ES41209538904585312595,TRX_N-00825-18841887,2024-01-06T09:52:14,Bilbao,expenses,electricity,-40.99,-32898.14
buyer_1,Luis,,ES41209538904585312595,TRX_N-00826-64666706,2024-01-06T15:15:38,Bilbao,expenses,food,-99.65,-32997.79
buyer_1,Luis,,ES41209538904585312595,TRX_N-00827-25520374,2024-01-06T10:40:42,Iruña de Oca,expenses,leisure,-19.2,-33016.99
buyer_1,Luis,,ES41209538904585312595,TRX_N-00828-52869343,2024-01-07T10:50:11,Bilbao,expenses,internet,-42.0,-33058.99
buyer_1,Luis,,ES41209538904585312595,TRX_N-00829-87630505,2024-01-08T10:20:35,Bilbao,expenses,water,-33.58,-33092.57
buyer_1,Luis,,ES41209538904585312595,TRX_N-00830-05768412,2024-01-08T07:46:09,Bilbao,expenses,gas,-81.2,-33173.77
buyer_1,Luis,,ES41209538904585312595,TRX_N-00831-02665115,2024-01-08T18:07:51,Bilbao,expenses,phone,-37.71,-33211.48
buyer_1,Luis,,ES41209538904585312595,TRX_N-00832-99371835,2024-01-09T20:32:05,Durango,expenses,food,-64.7,-33276.18
buyer_1,Luis,,ES41209538904585312595,TRX_N-00833-81413532,2024-01-12T08:07:49,Bilbao,expenses,food,-96.62,-33372.8
buyer_1,Luis,,ES41209538904585312595,TRX_N-00834-49501861,2024-01-12T19:16:29,Bilbao,expenses,cash,-100.0,-33472.8
buyer_1,Luis,,ES41209538904585312595,TRX_N-00835-91756714,2024-01-12T12:35:53,Bilbao,expenses,repairs,-94.46,-33567.26
buyer_1,Luis,,ES41209538904585312595,TRX_N-00836-89402720,2024-01-13T13:43:08,Bilbao,expenses,gifts,-598.1,-34165.36
buyer_1,Luis,,ES41209538904585312595,TRX_N-00837-17325732,2024-01-16T12:46:23,Bilbao,expenses,cash,-100.0,-34265.36
buyer_1,Luis,,ES41209538904585312595,TRX_N-00838-27107485,2024-01-21T16:08:37,Bilbao,expenses,healthcare,-147.57,-34412.93
buyer_1,Luis,,ES41209538904585312595,TRX_N-00839-73044845,2024-01-21T10:18:50,Bilbao,expenses,gifts,-274.65,-34687.58
buyer_1,Luis,,ES41209538904585312595,TRX_N-00840-34908373,2024-01-22T02:24:35,Bilbao,expenses,cash,-100.0,-34787.58
buyer_1,Luis,,ES41209538904585312595,TRX_N-00841-65953101,2024-01-23T15:51:24,Bilbao,expenses,food,-86.35,-34873.93
buyer_1,Luis,,ES41209538904585312595,TRX_N-00842-08889645,2024-01-24T17:27:27,Bilbao,expenses,food,-80.89,-34954.82
buyer_1,Luis,,ES41209538904585312595,TRX_N-00843-16171181,2024-01-25T13:42:18,Bilbao,expenses,cash,-100.0,-35054.82
buyer_1,Luis,,ES41209538904585312595,TRX_N-00844-34881868,2024-01-28T16:12:40,Bilbao,expenses,food,-80.34,-35135.16
buyer_1,Luis,,ES41209538904585312595,TRX_N-00845-93609825,2024-01-28T16:18:34,Bilbao,expenses,education,-63.57,-35198.73
buyer_1,Luis,,ES41209538904585312595,TRX_N-00846-42289472,2024-01-29T00:31:19,Bilbao,expenses,repairs,-239.74,-35438.47
buyer_1,Luis,,ES41209538904585312595,TRX_N-00847-51854299,2024-01-30T15:58:10,Bilbao,expenses,transport,-74.16,-35512.63
buyer_1,Luis,,ES41209538904585312595,TRX_N-00848-92732752,2024-01-31T21:29:27,Bilbao,expenses,leisure,-29.08,-35541.71
buyer_1,Luis,,ES41209538904585312595,TRX_N-00849-92470139,2024-02-01T09:03:13,Bilbao,incomes,salary,3139.5,-32402.21
buyer_1,Luis,,ES41209538904585312595,TRX_N-00850-33936371,2024-02-01T09:03:13,Bilbao,incomes,extra_income,349.57,-32052.64
buyer_1,Luis,,ES41209538904585312595,TRX_N-00851-08014084,2024-02-01T10:25:04,Bilbao,expenses,food,-73.54,-32126.18
buyer_1,Luis,,ES41209538904585312595,TRX_N-00852-12110800,2024-02-01T21:02:26,Bilbao,expenses,cash,-100.0,-32226.18
buyer_1,Luis,,ES41209538904585312595,TRX_N-00853-46762125,2024-02-02T09:56:25,Salvatierra/Agurain,expenses,food,-111.92,-32338.1
buyer_1,Luis,,ES41209538904585312595,TRX_N-00854-69337499,2024-02-02T07:16:51,Bilbao,expenses,gifts,-719.81,-33057.91
buyer_1,Luis,,ES41209538904585312595,TRX_N-00855-59701743,2024-02-04T14:27:29,Bilbao,expenses,rent,-700.2,-33758.11
buyer_1,Luis,,ES41209538904585312595,TRX_N-00856-57492913,2024-02-05T08:30:32,Bilbao,expenses,electricity,-64.55,-33822.66
buyer_1,Luis,,ES41209538904585312595,TRX_N-00857-46060014,2024-02-05T12:23:43,Bilbao,expenses,food,-79.54,-33902.2
buyer_1,Luis,,ES41209538904585312595,TRX_N-00858-14561488,2024-02-06T14:23:19,Bilbao,expenses,gas,-71.23,-33973.43
buyer_1,Luis,,ES41209538904585312595,TRX_N-00859-16130402,2024-02-06T20:13:02,Bilbao,expenses,phone,-38.6,-34012.03
buyer_1,Luis,,ES41209538904585312595,TRX_N-00860-61236778,2024-02-06T19:51:32,Bilbao,expenses,cash,-100.0,-34112.03
buyer_1,Luis,,ES41209538904585312595,TRX_N-00861-72754083,2024-02-06T17:18:31,Bilbao,expenses,gifts,-348.36,-34460.39
buyer_1,Luis,,ES41209538904585312595,TRX_N-00862-98325211,2024-02-08T16:28:36,Bilbao,expenses,internet,-42.0,-34502.39
buyer_1,Luis,,ES41209538904585312595,TRX_N-00863-81335566,2024-02-08T11:39:12,Bilbao,expenses,water,-20.01,-34522.4
buyer_1,Luis,,ES41209538904585312595,TRX_N-00864-31094113,2024-02-10T11:04:38,Vitoria-Gasteiz,expenses,transport,-43.12,-34565.52
buyer_1,Luis,,ES41209538904585312595,TRX_N-00865-69292143,2024-02-10T10:37:22,Bilbao,expenses,repairs,-152.49,-34718.01
buyer_1,Luis,,ES41209538904585312595,TRX_N-00866-05672873,2024-02-11T00:40:39,Bilbao,expenses,cash,-100.0,-34818.01
buyer_1,Luis,,ES41209538904585312595,TRX_N-00867-91899827,2024-02-15T16:40:51,Sestao,expenses,education,-61.94,-34879.95
buyer_1,Luis,,ES41209538904585312595,TRX_N-00868-53496225,2024-02-16T20:17:21,Bilbao,expenses,leisure,-19.75,-34899.7
buyer_1,Luis,,ES41209538904585312595,TRX_N-00869-62267468,2024-02-16T17:12:39,Bilbao,expenses,healthcare,-102.2,-35001.9
buyer_1,Luis,,ES41209538904585312595,TRX_N-00870-41804323,2024-02-17T15:16:38,Bilbao,expenses,repairs,-144.37,-35146.27
buyer_1,Luis,,ES41209538904585312595,TRX_N-00871-11224540,2024-02-17T16:51:49,Bilbao,expenses,gifts,-497.2,-35643.47
buyer_1,Luis,,ES41209538904585312595,TRX_N-00872-56003162,2024-02-19T12:44:45,Bilbao,expenses,food,-120.41,-35763.88
buyer_1,Luis,,ES41209538904585312595,TRX_N-00873-04390562,2024-02-20T11:33:19,Bilbao,expenses,gifts,-627.81,-36391.69
buyer_1,Luis,,ES41209538904585312595,TRX_N-00874-37179533,2024-02-21T19:47:36,Bilbao,expenses,leisure,-42.19,-36433.88
buyer_1,Luis,,ES41209538904585312595,TRX_N-00875-57443623,2024-02-21T21:20:50,Bilbao,expenses,cash,-100.0,-36533.88
buyer_1,Luis,,ES41209538904585312595,TRX_N-00876-36927031,2024-02-23T15:10:55,Bilbao,expenses,clothing,-139.94,-36673.82
buyer_1,Luis,,ES41209538904585312595,TRX_N-00877-97659956,2024-02-23T22:38:02,Bilbao,expenses,repairs,-97.28,-36771.1
buyer_1,Luis,,ES41209538904585312595,TRX_N-00878-18532971,2024-02-24T18:58:38,Bilbao,expenses,cash,-100.0,-36871.1
buyer_1,Luis,,ES41209538904585312595,TRX_N-00879-72993280,2024-02-24T09:21:15,Bilbao,expenses,appliances,-382.88,-37253.98
buyer_1,Luis,,ES41209538904585312595,TRX_N-00880-74101989,2024-02-29T09:39:27,Salvatierra/Agurain,expenses,leisure,-41.98,-37295.96
buyer_1,Luis,,ES41209538904585312595,TRX_N-00881-89616055,2024-02-29T08:24:35,Bilbao,expenses,healthcare,-129.58,-37425.54
buyer_1,Luis,,ES41209538904585312595,TRX_N-00882-65012959,2024-03-01T01:50:58,Bilbao,incomes,salary,3139.5,-34286.04
buyer_1,Luis,,ES41209538904585312595,TRX_N-00883-59205904,2024-03-01T21:25:28,Bilbao,expenses,clothing,-61.57,-34347.61
buyer_1,Luis,,ES41209538904585312595,TRX_N-00884-98513781,2024-03-01T14:50:35,Bilbao,expenses,repairs,-74.19,-34421.8
buyer_1,Luis,,ES41209538904585312595,TRX_N-00885-10393758,2024-03-02T14:55:49,Salvatierra/Agurain,expenses,cash,-100.0,-34521.8
buyer_1,Luis,,ES41209538904585312595,TRX_N-00886-62037916,2024-03-04T12:28:39,Bilbao,expenses,rent,-700.2,-35222.0
buyer_1,Luis,,ES41209538904585312595,TRX_N-00887-72455189,2024-03-05T08:51:12,Bilbao,expenses,water,-34.36,-35256.36
buyer_1,Luis,,ES41209538904585312595,TRX_N-00888-22110248,2024-03-05T08:56:09,Bilbao,expenses,phone,-34.57,-35290.93
buyer_1,Luis,,ES41209538904585312595,TRX_N-00889-45066007,2024-03-05T18:49:17,Bilbao,expenses,transport,-74.41,-35365.34
buyer_1,Luis,,ES41209538904585312595,TRX_N-00890-80684260,2024-03-05T13:30:55,Bilbao,expenses,leisure,-84.79,-35450.13
buyer_1,Luis,,ES41209538904585312595,TRX_N-00891-80278187,2024-03-06T19:34:21,Bilbao,expenses,gas,-32.35,-35482.48
buyer_1,Luis,,ES41209538904585312595,TRX_N-00892-92255006,2024-03-06T03:09:41,Bilbao,expenses,internet,-42.0,-35524.48
buyer_1,Luis,,ES41209538904585312595,TRX_N-00893-58954398,2024-03-07T14:31:15,Bilbao,expenses,food,-62.66,-35587.14
buyer_1,Luis,,ES41209538904585312595,TRX_N-00894-87622043,2024-03-07T15:42:51,Bilbao,expenses,repairs,-134.05,-35721.19
buyer_1,Luis,,ES41209538904585312595,TRX_N-00895-30621917,2024-03-08T14:28:48,Bilbao,expenses,electricity,-26.72,-35747.91
buyer_1,Luis,,ES41209538904585312595,TRX_N-00896-44853945,2024-03-08T19:38:42,Bilbao,expenses,cash,-100.0,-35847.91
buyer_1,Luis,,ES41209538904585312595,TRX_N-00897-51259922,2024-03-09T12:28:17,Bilbao,expenses,transport,-62.18,-35910.09
buyer_1,Luis,,ES41209538904585312595,TRX_N-00898-42069369,2024-03-11T10:00:06,Bilbao,expenses,cash,-100.0,-36010.09
buyer_1,Luis,,ES41209538904585312595,TRX_N-00899-00368554,2024-03-12T12:47:13,Durango,expenses,clothing,-144.21,-36154.3
buyer_1,Luis,,ES41209538904585312595,TRX_N-00900-94462103,2024-03-13T02:32:01,Bilbao,expenses,food,-100.4,-36254.7
buyer_1,Luis,,ES41209538904585312595,TRX_N-00901-69774166,2024-03-15T11:08:43,Bilbao,expenses,transport,-69.11,-36323.81
buyer_1,Luis,,ES41209538904585312595,TRX_N-00902-34487634,2024-03-16T15:12:37,Durango,expenses,transport,-45.04,-36368.85
buyer_1,Luis,,ES41209538904585312595,TRX_N-00903-84236668,2024-03-18T09:59:00,Berango,expenses,leisure,-28.9,-36397.75
buyer_1,Luis,,ES41209538904585312595,TRX_N-00904-09375915,2024-03-18T20:23:29,Bilbao,expenses,repairs,-223.64,-36621.39
buyer_1,Luis,,ES41209538904585312595,TRX_N-00905-82207275,2024-03-22T06:01:19,Bilbao,expenses,transport,-66.36,-36687.75
buyer_1,Luis,,ES41209538904585312595,TRX_N-00906-82109480,2024-03-22T10:06:56,Bilbao,expenses,healthcare,-50.95,-36738.7
buyer_1,Luis,,ES41209538904585312595,TRX_N-00907-09144374,2024-03-23T13:59:19,Bilbao,expenses,food,-98.19,-36836.89
buyer_1,Luis,,ES41209538904585312595,TRX_N-00908-18199452,2024-03-23T01:27:31,Bilbao,expenses,repairs,-298.95,-37135.84
buyer_1,Luis,,ES41209538904585312595,TRX_N-00909-48885857,2024-03-25T22:01:13,Bilbao,expenses,cash,-100.0,-37235.84
buyer_1,Luis,,ES41209538904585312595,TRX_N-00910-14564389,2024-03-25T23:42:44,Bilbao,expenses,repairs,-30.53,-37266.37
buyer_1,Luis,,ES41209538904585312595,TRX_N-00911-67651377,2024-03-26T12:35:35,Bilbao,expenses,cash,-100.0,-37366.37
buyer_1,Luis,,ES41209538904585312595,TRX_N-00912-26400691,2024-03-29T20:24:07,Bilbao,expenses,cash,-100.0,-37466.37
buyer_1,Luis,,ES41209538904585312595,TRX_N-00913-06421640,2024-03-31T18:48:37,Hernani,expenses,leisure,-79.1,-37545.47
buyer_1,Luis,,ES41209538904585312595,TRX_N-00914-76957550,2024-03-31T10:27:29,Bilbao,expenses,cash,-100.0,-37645.47
buyer_1,Luis,,ES41209538904585312595,TRX_N-00915-68615333,2024-03-31T05:37:45,Bilbao,expenses,gifts,-163.98,-37809.45
buyer_1,Luis,,ES41209538904585312595,TRX_N-00916-93559876,2024-04-01T14:37:24,Bilbao,incomes,salary,3139.5,-34669.95
buyer_1,Luis,,ES41209538904585312595,TRX_N-00917-03489252,2024-04-01T18:16:54,Bilbao,expenses,repairs,-60.5,-34730.45
buyer_1,Luis,,ES41209538904585312595,TRX_N-00918-62941763,2024-04-03T18:26:49,Bilbao,expenses,leisure,-73.3,-34803.75
buyer_1,Luis,,ES41209538904585312595,TRX_N-00919-93763458,2024-04-04T15:03:26,Bilbao,expenses,rent,-700.2,-35503.95
buyer_1,Luis,,ES41209538904585312595,TRX_N-00920-37737115,2024-04-05T17:22:38,Bilbao,expenses,food,-78.3,-35582.25
buyer_1,Luis,,ES41209538904585312595,TRX_N-00921-05078461,2024-04-05T10:30:23,Arrasate,expenses,cash,-100.0,-35682.25
buyer_1,Luis,,ES41209538904585312595,TRX_N-00922-44060200,2024-04-06T10:50:30,Bilbao,expenses,internet,-42.0,-35724.25
buyer_1,Luis,,ES41209538904585312595,TRX_N-00923-50541225,2024-04-06T11:11:17,Vitoria-Gasteiz,expenses,leisure,-81.42,-35805.67
buyer_1,Luis,,ES41209538904585312595,TRX_N-00924-94239473,2024-04-06T18:44:52,Bilbao,expenses,education,-47.49,-35853.16
buyer_1,Luis,,ES41209538904585312595,TRX_N-00925-66260487,2024-04-06T18:52:13,Bilbao,expenses,repairs,-65.61,-35918.77
buyer_1,Luis,,ES41209538904585312595,TRX_N-00926-59656494,2024-04-07T08:56:23,Bilbao,expenses,electricity,-42.1,-35960.87
buyer_1,Luis,,ES41209538904585312595,TRX_N-00927-06572887,2024-04-08T15:04:40,Bilbao,expenses,phone,-32.46,-35993.33
buyer_1,Luis,,ES41209538904585312595,TRX_N-00928-20305774,2024-04-08T16:58:04,Bilbao,expenses,water,-29.0,-36022.33
buyer_1,Luis,,ES41209538904585312595,TRX_N-00929-02914573,2024-04-08T21:54:05,Bilbao,expenses,gas,-47.16,-36069.49
buyer_1,Luis,,ES41209538904585312595,TRX_N-00930-80595992,2024-04-09T10:48:37,Irun,expenses,leisure,-67.72,-36137.21
buyer_1,Luis,,ES41209538904585312595,TRX_N-00931-04273896,2024-04-10T12:51:42,Bilbao,expenses,repairs,-64.2,-36201.41
buyer_1,Luis,,ES41209538904585312595,TRX_N-00932-20502972,2024-04-11T10:13:13,Bilbao,expenses,food,-110.77,-36312.18
buyer_1,Luis,,ES41209538904585312595,TRX_N-00933-76373781,2024-04-12T15:43:48,Bilbao,expenses,leisure,-28.11,-36340.29
buyer_1,Luis,,ES41209538904585312595,TRX_N-00934-99971811,2024-04-14T07:42:19,Bilbao,expenses,food,-61.5,-36401.79
buyer_1,Luis,,ES41209538904585312595,TRX_N-00935-76241430,2024-04-15T22:46:26,Bilbao,expenses,transport,-58.13,-36459.92
buyer_1,Luis,,ES41209538904585312595,TRX_N-00936-10294281,2024-04-15T20:29:27,Lasarte-Oria,expenses,leisure,-40.41,-36500.33
buyer_1,Luis,,ES41209538904585312595,TRX_N-00937-58793672,2024-04-15T18:28:59,Bilbao,expenses,clothing,-73.93,-36574.26
buyer_1,Luis,,ES41209538904585312595,TRX_N-00938-30164538,2024-04-16T21:02:20,Bilbao,expenses,cash,-100.0,-36674.26
buyer_1,Luis,,ES41209538904585312595,TRX_N-00939-39926077,2024-04-17T08:57:02,Bilbao,expenses,transport,-64.98,-36739.24
buyer_1,Luis,,ES41209538904585312595,TRX_N-00940-99196703,2024-04-18T22:05:34,Bilbao,expenses,leisure,-22.14,-36761.38
buyer_1,Luis,,ES41209538904585312595,TRX_N-00941-64883440,2024-04-19T16:36:53,Bilbao,expenses,transport,-88.25,-36849.63
buyer_1,Luis,,ES41209538904585312595,TRX_N-00942-17759023,2024-04-19T15:18:08,Bilbao,expenses,cash,-100.0,-36949.63
buyer_1,Luis,,ES41209538904585312595,TRX_N-00943-48721860,2024-04-20T17:38:18,Salvatierra/Agurain,expenses,cash,-100.0,-37049.63
buyer_1,Luis,,ES41209538904585312595,TRX_N-00944-80193520,2024-04-22T16:51:53,Bilbao,expenses,transport,-80.74,-37130.37
buyer_1,Luis,,ES41209538904585312595,TRX_N-00945-66368705,2024-04-22T13:44:52,Bilbao,expenses,education,-74.07,-37204.44
buyer_1,Luis,,ES41209538904585312595,TRX_N-00946-88714915,2024-04-25T14:16:53,Bilbao,expenses,appliances,-287.22,-37491.66
buyer_1,Luis,,ES41209538904585312595,TRX_N-00947-45573522,2024-04-27T20:19:31,Donostia,expenses,education,-77.14,-37568.8
buyer_1,Luis,,ES41209538904585312595,TRX_N-00948-46801318,2024-04-29T14:13:11,Bilbao,expenses,cash,-100.0,-37668.8
buyer_1,Luis,,ES41209538904585312595,TRX_N-00949-91101437,2024-04-30T15:11:56,Bilbao,expenses,healthcare,-184.66,-37853.46
buyer_1,Luis,,ES41209538904585312595,TRX_N-00950-16818343,2024-05-01T21:11:47,Bilbao,incomes,salary,3139.5,-34713.96
buyer_1,Luis,,ES41209538904585312595,TRX_N-00951-30626343,2024-05-01T21:11:47,Bilbao,incomes,extra_income,349.57,-34364.39
buyer_1,Luis,,ES41209538904585312595,TRX_N-00952-17085009,2024-05-04T12:55:48,Bilbao,expenses,rent,-700.2,-35064.59
buyer_1,Luis,,ES41209538904585312595,TRX_N-00953-56837592,2024-05-05T19:05:35,Bilbao,expenses,phone,-42.89,-35107.48
buyer_1,Luis,,ES41209538904585312595,TRX_N-00954-41316209,2024-05-06T12:24:57,Bilbao,expenses,leisure,-57.43,-35164.91
buyer_1,Luis,,ES41209538904585312595,TRX_N-00955-97451768,2024-05-06T01:40:46,Bilbao,expenses,healthcare,-71.94,-35236.85
buyer_1,Luis,,ES41209538904585312595,TRX_N-00956-51084181,2024-05-06T21:41:19,Bilbao,expenses,cash,-100.0,-35336.85
buyer_1,Luis,,ES41209538904585312595,TRX_N-00957-89348742,2024-05-08T08:48:08,Bilbao,expenses,internet,-42.0,-35378.85
buyer_1,Luis,,ES41209538904585312595,TRX_N-00958-78506553,2024-05-08T07:48:16,Bilbao,expenses,water,-36.56,-35415.41
buyer_1,Luis,,ES41209538904585312595,TRX_N-00959-04876850,2024-05-08T11:19:29,Bilbao,expenses,electricity,-75.99,-35491.4
buyer_1,Luis,,ES41209538904585312595,TRX_N-00960-52228839,2024-05-08T08:06:05,Bilbao,expenses,gas,-49.16,-35540.56
buyer_1,Luis,,ES41209538904585312595,TRX_N-00961-71224216,2024-05-08T12:56:47,Bilbao,expenses,transport,-53.41,-35593.97
buyer_1,Luis,,ES41209538904585312595,TRX_N-00962-07686574,2024-05-09T20:09:20,Bilbao,expenses,cash,-100.0,-35693.97
buyer_1,Luis,,ES41209538904585312595,TRX_N-00963-20270792,2024-05-09T09:44:01,Bilbao,expenses,repairs,-29.76,-35723.73
buyer_1,Luis,,ES41209538904585312595,TRX_N-00964-94553741,2024-05-10T09:30:56,Bilbao,expenses,food,-75.77,-35799.5
buyer_1,Luis,,ES41209538904585312595,TRX_N-00965-06531371,2024-05-10T16:23:15,Bilbao,expenses,clothing,-128.47,-35927.97
buyer_1,Luis,,ES41209538904585312595,TRX_N-00966-62817435,2024-05-11T16:49:48,Bilbao,expenses,healthcare,-121.14,-36049.11
buyer_1,Luis,,ES41209538904585312595,TRX_N-00967-33715076,2024-05-14T16:06:18,Bilbao,expenses,food,-120.45,-36169.56
buyer_1,Luis,,ES41209538904585312595,TRX_N-00968-11741920,2024-05-14T12:32:06,Bilbao,expenses,repairs,-322.12,-36491.68
buyer_1,Luis,,ES41209538904585312595,TRX_N-00969-34366245,2024-05-15T20:08:26,Bilbao,expenses,food,-116.49,-36608.17
buyer_1,Luis,,ES41209538904585312595,TRX_N-00970-83000853,2024-05-16T17:58:24,Bilbao,expenses,food,-117.23,-36725.4
buyer_1,Luis,,ES41209538904585312595,TRX_N-00971-37410356,2024-05-17T14:56:02,Bilbao,expenses,leisure,-54.66,-36780.06
buyer_1,Luis,,ES41209538904585312595,TRX_N-00972-40148709,2024-05-19T13:18:32,Bilbao,expenses,food,-81.9,-36861.96
buyer_1,Luis,,ES41209538904585312595,TRX_N-00973-68615373,2024-05-19T23:26:52,Bilbao,expenses,repairs,-55.95,-36917.91
buyer_1,Luis,,ES41209538904585312595,TRX_N-00974-17795914,2024-05-19T09:20:59,Bilbao,expenses,gifts,-511.21,-37429.12
buyer_1,Luis,,ES41209538904585312595,TRX_N-00975-84090922,2024-05-20T06:43:53,Zarautz,expenses,education,-47.0,-37476.12
buyer_1,Luis,,ES41209538904585312595,TRX_N-00976-38066914,2024-05-21T04:18:23,Bilbao,expenses,food,-93.4,-37569.52
buyer_1,Luis,,ES41209538904585312595,TRX_N-00977-33478311,2024-05-21T20:37:07,Bilbao,expenses,leisure,-27.05,-37596.57
buyer_1,Luis,,ES41209538904585312595,TRX_N-00978-00848020,2024-05-22T15:25:35,Bilbao,expenses,leisure,-46.57,-37643.14
buyer_1,Luis,,ES41209538904585312595,TRX_N-00979-39531126,2024-05-24T11:31:04,Bilbao,expenses,gifts,-433.47,-38076.61
buyer_1,Luis,,ES41209538904585312595,TRX_N-00980-73631246,2024-05-25T10:06:45,Sestao,expenses,healthcare,-174.62,-38251.23
buyer_1,Luis,,ES41209538904585312595,TRX_N-00981-21184299,2024-05-26T17:02:39,Oyón-Oion,expenses,healthcare,-61.0,-38312.23
buyer_1,Luis,,ES41209538904585312595,TRX_N-00982-05673721,2024-05-26T20:30:47,Bilbao,expenses,education,-43.68,-38355.91
buyer_1,Luis,,ES41209538904585312595,TRX_N-00983-54643343,2024-05-29T08:54:17,Bilbao,expenses,transport,-78.45,-38434.36
buyer_1,Luis,,ES41209538904585312595,TRX_N-00984-06069757,2024-05-29T15:25:20,Bilbao,expenses,cash,-100.0,-38534.36
buyer_1,Luis,,ES41209538904585312595,TRX_N-00985-76489362,2024-05-29T12:46:59,Bilbao,expenses,travel,-843.87,-39378.23
buyer_1,Luis,,ES41209538904585312595,TRX_N-00986-01482003,2024-06-01T11:48:35,Bilbao,incomes,salary,3139.5,-36238.73
buyer_1,Luis,,ES41209538904585312595,TRX_N-00987-24787738,2024-06-01T11:48:35,Bilbao,incomes,salary_bonus,2492.0,-33746.73
buyer_1,Luis,,ES41209538904585312595,TRX_N-00988-48181561,2024-06-01T18:34:20,Pasaia,expenses,leisure,-18.9,-33765.63
buyer_1,Luis,,ES41209538904585312595,TRX_N-00989-16356937,2024-06-02T12:18:05,Bilbao,expenses,taxes,-1473.1,-35238.73
buyer_1,Luis,,ES41209538904585312595,TRX_N-00990-00584860,2024-06-02T08:04:02,Bilbao,expenses,insurance,-306.66,-35545.39
buyer_1,Luis,,ES41209538904585312595,TRX_N-00991-00861244,2024-06-02T13:16:20,Bilbao,expenses,food,-80.29,-35625.68
buyer_1,Luis,,ES41209538904585312595,TRX_N-00992-81948885,2024-06-03T17:56:24,Arrasate,expenses,transport,-42.48,-35668.16
buyer_1,Luis,,ES41209538904585312595,TRX_N-00993-90447812,2024-06-03T20:47:13,Berango,expenses,leisure,-33.76,-35701.92
buyer_1,Luis,,ES41209538904585312595,TRX_N-00994-78735925,2024-06-04T20:00:58,Bilbao,expenses,rent,-700.2,-36402.12
buyer_1,Luis,,ES41209538904585312595,TRX_N-00995-68755008,2024-06-04T12:56:52,Bilbao,expenses,education,-65.94,-36468.06
buyer_1,Luis,,ES41209538904585312595,TRX_N-00996-03600563,2024-06-05T15:56:18,Bilbao,expenses,food,-110.22,-36578.28
buyer_1,Luis,,ES41209538904585312595,TRX_N-00997-83221029,2024-06-05T12:55:45,Bilbao,expenses,education,-53.02,-36631.3
buyer_1,Luis,,ES41209538904585312595,TRX_N-00998-24782128,2024-06-05T14:02:09,Bilbao,expenses,cash,-100.0,-36731.3
buyer_1,Luis,,ES41209538904585312595,TRX_N-00999-17863169,2024-06-05T17:57:39,Bilbao,expenses,appliances,-134.88,-36866.18
buyer_1,Luis,,ES41209538904585312595,TRX_N-01000-41551347,2024-06-06T22:53:15,Bilbao,expenses,electricity,-57.55,-36923.73
buyer_1,Luis,,ES41209538904585312595,TRX_N-01001-99799492,2024-06-06T10:38:07,Portugalete,expenses,leisure,-32.79,-36956.52
buyer_1,Luis,,ES41209538904585312595,TRX_N-01002-15557963,2024-06-07T16:49:01,Bilbao,expenses,transport,-40.57,-36997.09
buyer_1,Luis,,ES41209538904585312595,TRX_N-01003-81945542,2024-06-07T18:51:30,Bilbao,expenses,leisure,-18.29,-37015.38
buyer_1,Luis,,ES41209538904585312595,TRX_N-01004-19167327,2024-06-07T18:11:47,Irun,expenses,cash,-100.0,-37115.38
buyer_1,Luis,,ES41209538904585312595,TRX_N-01005-43846742,2024-06-08T11:55:37,Bilbao,expenses,gas,-95.87,-37211.25
buyer_1,Luis,,ES41209538904585312595,TRX_N-01006-42432430,2024-06-08T14:22:29,Bilbao,expenses,internet,-42.0,-37253.25
buyer_1,Luis,,ES41209538904585312595,TRX_N-01007-64675895,2024-06-08T12:43:48,Bilbao,expenses,water,-28.09,-37281.34
buyer_1,Luis,,ES41209538904585312595,TRX_N-01008-82025702,2024-06-08T01:33:12,Bilbao,expenses,phone,-41.05,-37322.39
buyer_1,Luis,,ES41209538904585312595,TRX_N-01009-53749833,2024-06-08T16:41:29,Bilbao,expenses,education,-72.08,-37394.47
buyer_1,Luis,,ES41209538904585312595,TRX_N-01010-42152763,2024-06-08T15:17:23,Bilbao,expenses,gifts,-640.98,-38035.45
buyer_1,Luis,,ES41209538904585312595,TRX_N-01011-17547261,2024-06-09T10:04:45,Bilbao,expenses,food,-98.88,-38134.33
buyer_1,Luis,,ES41209538904585312595,TRX_N-01012-40443468,2024-06-09T02:36:23,Bilbao,expenses,repairs,-165.33,-38299.66
buyer_1,Luis,,ES41209538904585312595,TRX_N-01013-37155388,2024-06-10T14:21:46,Bilbao,expenses,leisure,-28.79,-38328.45
buyer_1,Luis,,ES41209538904585312595,TRX_N-01014-14921719,2024-06-12T18:21:06,Bilbao,expenses,leisure,-63.44,-38391.89
buyer_1,Luis,,ES41209538904585312595,TRX_N-01015-92641593,2024-06-13T08:13:24,Bilbao,expenses,transport,-74.96,-38466.85
buyer_1,Luis,,ES41209538904585312595,TRX_N-01016-39416678,2024-06-14T15:40:47,Bilbao,expenses,food,-111.79,-38578.64
buyer_1,Luis,,ES41209538904585312595,TRX_N-01017-73872202,2024-06-15T13:58:51,Hondarribia,expenses,clothing,-107.84,-38686.48
buyer_1,Luis,,ES41209538904585312595,TRX_N-01018-33034506,2024-06-17T09:35:17,Iruña de Oca,expenses,healthcare,-50.42,-38736.9
buyer_1,Luis,,ES41209538904585312595,TRX_N-01019-09371010,2024-06-17T10:22:28,Bilbao,expenses,education,-55.74,-38792.64
buyer_1,Luis,,ES41209538904585312595,TRX_N-01020-15153663,2024-06-17T12:58:01,Hondarribia,expenses,appliances,-342.94,-39135.58
buyer_1,Luis,,ES41209538904585312595,TRX_N-01021-55133586,2024-06-19T19:06:35,Bilbao,expenses,leisure,-75.61,-39211.19
buyer_1,Luis,,ES41209538904585312595,TRX_N-01022-66035559,2024-06-21T02:21:56,Bilbao,expenses,food,-99.79,-39310.98
buyer_1,Luis,,ES41209538904585312595,TRX_N-01023-78642130,2024-06-22T14:21:29,Bilbao,expenses,food,-112.87,-39423.85
buyer_1,Luis,,ES41209538904585312595,TRX_N-01024-04827166,2024-06-22T12:55:07,Bilbao,expenses,leisure,-51.91,-39475.76
buyer_1,Luis,,ES41209538904585312595,TRX_N-01025-89841207,2024-06-22T10:37:29,Bilbao,expenses,repairs,-148.39,-39624.15
buyer_1,Luis,,ES41209538904585312595,TRX_N-01026-04303812,2024-06-23T23:06:22,Bilbao,expenses,cash,-100.0,-39724.15
buyer_1,Luis,,ES41209538904585312595,TRX_N-01027-69981476,2024-06-24T12:22:45,Bilbao,expenses,food,-94.21,-39818.36
buyer_1,Luis,,ES41209538904585312595,TRX_N-01028-66421130,2024-06-24T09:12:16,Bilbao,expenses,transport,-67.86,-39886.22
buyer_1,Luis,,ES41209538904585312595,TRX_N-01029-30197065,2024-06-24T08:16:18,Bilbao,expenses,leisure,-74.92,-39961.14
buyer_1,Luis,,ES41209538904585312595,TRX_N-01030-87527920,2024-06-25T20:40:18,Bilbao,expenses,cash,-100.0,-40061.14
buyer_1,Luis,,ES41209538904585312595,TRX_N-01031-69867763,2024-07-01T18:49:40,Bilbao,incomes,salary,3139.5,-36921.64
buyer_1,Luis,,ES41209538904585312595,TRX_N-01032-72245030,2024-07-01T19:47:44,Bilbao,expenses,food,-105.41,-37027.05
buyer_1,Luis,,ES41209538904585312595,TRX_N-01033-46504704,2024-07-01T17:23:18,Bilbao,expenses,travel,-1515.91,-38542.96
buyer_1,Luis,,ES41209538904585312595,TRX_N-01034-27241760,2024-07-02T14:48:02,Bilbao,expenses,transport,-80.99,-38623.95
buyer_1,Luis,,ES41209538904585312595,TRX_N-01035-58038716,2024-07-03T05:14:16,Salvatierra/Agurain,expenses,appliances,-211.33,-38835.28
buyer_1,Luis,,ES41209538904585312595,TRX_N-01036-41305019,2024-07-04T09:34:46,Bilbao,expenses,rent,-700.2,-39535.48
buyer_1,Luis,,ES41209538904585312595,TRX_N-01037-84338716,2024-07-04T14:45:03,Bilbao,expenses,clothing,-110.25,-39645.73
buyer_1,Luis,,ES41209538904585312595,TRX_N-01038-84857946,2024-07-06T19:47:52,Bilbao,expenses,gas,-72.12,-39717.85
buyer_1,Luis,,ES41209538904585312595,TRX_N-01039-49662302,2024-07-07T17:11:22,Errenteria,expenses,transport,-67.38,-39785.23
buyer_1,Luis,,ES41209538904585312595,TRX_N-01040-11135085,2024-07-08T09:45:19,Bilbao,expenses,internet,-42.0,-39827.23
buyer_1,Luis,,ES41209538904585312595,TRX_N-01041-68638676,2024-07-08T14:28:46,Bilbao,expenses,water,-20.88,-39848.11
buyer_1,Luis,,ES41209538904585312595,TRX_N-01042-43517578,2024-07-08T21:17:47,Bilbao,expenses,electricity,-82.54,-39930.65
buyer_1,Luis,,ES41209538904585312595,TRX_N-01043-60889469,2024-07-08T10:47:42,Bilbao,expenses,phone,-38.09,-39968.74
buyer_1,Luis,,ES41209538904585312595,TRX_N-01044-71690880,2024-07-08T19:37:48,Bilbao,expenses,repairs,-219.72,-40188.46
buyer_1,Luis,,ES41209538904585312595,TRX_N-01045-46159160,2024-07-09T15:57:02,Hernani,expenses,transport,-47.49,-40235.95
buyer_1,Luis,,ES41209538904585312595,TRX_N-01046-91021852,2024-07-11T16:19:41,Bilbao,expenses,cash,-100.0,-40335.95
buyer_1,Luis,,ES41209538904585312595,TRX_N-01047-70359340,2024-07-12T09:55:44,Leioa,expenses,cash,-100.0,-40435.95
buyer_1,Luis,,ES41209538904585312595,TRX_N-01048-21868493,2024-07-14T12:21:19,Bilbao,expenses,clothing,-81.12,-40517.07
buyer_1,Luis,,ES41209538904585312595,TRX_N-01049-33487380,2024-07-14T12:28:39,Bilbao,expenses,repairs,-108.72,-40625.79
buyer_1,Luis,,ES41209538904585312595,TRX_N-01050-18190188,2024-07-15T09:32:59,Bilbao,expenses,clothing,-157.06,-40782.85
buyer_1,Luis,,ES41209538904585312595,TRX_N-01051-72482921,2024-07-15T10:23:47,Irun,expenses,appliances,-138.64,-40921.49
buyer_1,Luis,,ES41209538904585312595,TRX_N-01052-80962479,2024-07-16T10:31:55,Bilbao,expenses,cash,-100.0,-41021.49
buyer_1,Luis,,ES41209538904585312595,TRX_N-01053-57840806,2024-07-19T10:42:21,Bilbao,expenses,leisure,-39.34,-41060.83
buyer_1,Luis,,ES41209538904585312595,TRX_N-01054-63129431,2024-07-20T04:18:32,Bilbao,expenses,appliances,-276.28,-41337.11
buyer_1,Luis,,ES41209538904585312595,TRX_N-01055-68775334,2024-07-21T20:14:09,Leioa,expenses,education,-55.41,-41392.52
buyer_1,Luis,,ES41209538904585312595,TRX_N-01056-80888456,2024-07-21T16:59:50,Bilbao,expenses,cash,-100.0,-41492.52
buyer_1,Luis,,ES41209538904585312595,TRX_N-01057-64028086,2024-07-22T00:36:53,Bilbao,expenses,cash,-100.0,-41592.52
buyer_1,Luis,,ES41209538904585312595,TRX_N-01058-56363369,2024-07-24T08:48:43,Bilbao,expenses,leisure,-60.06,-41652.58
buyer_1,Luis,,ES41209538904585312595,TRX_N-01059-03418720,2024-07-25T19:34:07,Getxo,expenses,leisure,-82.99,-41735.57
buyer_1,Luis,,ES41209538904585312595,TRX_N-01060-15040693,2024-07-26T15:06:22,Bilbao,expenses,clothing,-114.24,-41849.81
buyer_1,Luis,,ES41209538904585312595,TRX_N-01061-66323128,2024-07-26T16:05:51,Salvatierra/Agurain,expenses,repairs,-61.46,-41911.27
buyer_1,Luis,,ES41209538904585312595,TRX_N-01062-01992581,2024-07-28T17:28:30,Bilbao,expenses,leisure,-70.93,-41982.2
buyer_1,Luis,,ES41209538904585312595,TRX_N-01063-40220071,2024-07-29T18:21:32,Bilbao,expenses,food,-66.36,-42048.56
buyer_1,Luis,,ES41209538904585312595,TRX_N-01064-08381226,2024-07-29T19:00:49,Bilbao,expenses,cash,-100.0,-42148.56
buyer_1,Luis,,ES41209538904585312595,TRX_N-01065-91139424,2024-08-01T10:33:06,Bilbao,incomes,salary,3139.5,-39009.06
buyer_1,Luis,,ES41209538904585312595,TRX_N-01066-24661076,2024-08-01T17:07:39,Bilbao,expenses,healthcare,-110.2,-39119.26
buyer_1,Luis,,ES41209538904585312595,TRX_N-01067-99962291,2024-08-01T19:59:04,Bilbao,expenses,cash,-100.0,-39219.26
buyer_1,Luis,,ES41209538904585312595,TRX_N-01068-79820834,2024-08-02T20:46:31,Bilbao,expenses,transport,-65.91,-39285.17
buyer_1,Luis,,ES41209538904585312595,TRX_N-01069-03549643,2024-08-04T08:29:46,Bilbao,expenses,rent,-700.2,-39985.37
buyer_1,Luis,,ES41209538904585312595,TRX_N-01070-57508020,2024-08-04T20:22:32,Bilbao,expenses,repairs,-75.88,-40061.25
buyer_1,Luis,,ES41209538904585312595,TRX_N-01071-77166816,2024-08-04T14:23:20,Bilbao,expenses,gifts,-704.39,-40765.64
buyer_1,Luis,,ES41209538904585312595,TRX_N-01072-86862886,2024-08-05T20:47:16,Bilbao,expenses,gas,-61.03,-40826.67
buyer_1,Luis,,ES41209538904585312595,TRX_N-01073-57496360,2024-08-05T15:55:18,Basauri,expenses,food,-111.9,-40938.57
buyer_1,Luis,,ES41209538904585312595,TRX_N-01074-23032087,2024-08-05T00:28:49,Bilbao,expenses,transport,-72.94,-41011.51
buyer_1,Luis,,ES41209538904585312595,TRX_N-01075-73077935,2024-08-06T15:44:12,Bilbao,expenses,healthcare,-41.97,-41053.48
buyer_1,Luis,,ES41209538904585312595,TRX_N-01076-72211992,2024-08-07T18:03:32,Bilbao,expenses,gifts,-587.14,-41640.62
buyer_1,Luis,,ES41209538904585312595,TRX_N-01077-56652094,2024-08-08T21:28:07,Bilbao,expenses,water,-21.07,-41661.69
buyer_1,Luis,,ES41209538904585312595,TRX_N-01078-23983168,2024-08-08T12:59:29,Bilbao,expenses,electricity,-64.96,-41726.65
buyer_1,Luis,,ES41209538904585312595,TRX_N-01079-77635443,2024-08-08T08:40:34,Bilbao,expenses,internet,-42.0,-41768.65
buyer_1,Luis,,ES41209538904585312595,TRX_N-01080-50919331,2024-08-08T15:58:46,Bilbao,expenses,phone,-31.63,-41800.28
buyer_1,Luis,,ES41209538904585312595,TRX_N-01081-43489798,2024-08-12T15:56:40,Bilbao,expenses,transport,-50.15,-41850.43
buyer_1,Luis,,ES41209538904585312595,TRX_N-01082-88556816,2024-08-12T15:12:41,Bilbao,expenses,travel,-1328.9,-43179.33
buyer_1,Luis,,ES41209538904585312595,TRX_N-01083-97503816,2024-08-14T11:58:26,Bilbao,expenses,gifts,-396.16,-43575.49
buyer_1,Luis,,ES41209538904585312595,TRX_N-01084-53733501,2024-08-15T19:03:16,Hernani,expenses,leisure,-34.54,-43610.03
buyer_1,Luis,,ES41209538904585312595,TRX_N-01085-77796868,2024-08-17T20:51:05,Hernani,expenses,healthcare,-182.77,-43792.8
buyer_1,Luis,,ES41209538904585312595,TRX_N-01086-99905368,2024-08-18T13:32:15,Bilbao,expenses,cash,-100.0,-43892.8
buyer_1,Luis,,ES41209538904585312595,TRX_N-01087-19325126,2024-08-21T23:09:59,Bilbao,expenses,healthcare,-70.44,-43963.24
buyer_1,Luis,,ES41209538904585312595,TRX_N-01088-04129341,2024-08-21T12:17:27,Bilbao,expenses,repairs,-251.18,-44214.42
buyer_1,Luis,,ES41209538904585312595,TRX_N-01089-95856395,2024-08-22T15:14:48,Bilbao,expenses,cash,-100.0,-44314.42
buyer_1,Luis,,ES41209538904585312595,TRX_N-01090-21433291,2024-08-22T23:07:06,Bilbao,expenses,repairs,-44.82,-44359.24
buyer_1,Luis,,ES41209538904585312595,TRX_N-01091-72107218,2024-08-23T09:22:13,Lasarte-Oria,expenses,food,-71.21,-44430.45
buyer_1,Luis,,ES41209538904585312595,TRX_N-01092-94702314,2024-08-24T22:54:49,Bilbao,expenses,clothing,-52.91,-44483.36
buyer_1,Luis,,ES41209538904585312595,TRX_N-01093-23318888,2024-08-24T23:54:31,Bilbao,expenses,repairs,-181.38,-44664.74
buyer_1,Luis,,ES41209538904585312595,TRX_N-01094-20148975,2024-08-27T11:22:46,Bilbao,expenses,leisure,-43.24,-44707.98
buyer_1,Luis,,ES41209538904585312595,TRX_N-01095-51816684,2024-08-28T12:34:18,Barakaldo,expenses,leisure,-40.03,-44748.01
buyer_1,Luis,,ES41209538904585312595,TRX_N-01096-16683904,2024-08-30T05:39:31,Bilbao,expenses,cash,-100.0,-44848.01
buyer_1,Luis,,ES41209538904585312595,TRX_N-01097-51283852,2024-08-31T18:53:27,Donostia,expenses,appliances,-399.23,-45247.24
buyer_1,Luis,,ES41209538904585312595,TRX_N-01098-94745570,2024-09-01T06:23:02,Bilbao,incomes,salary,3139.5,-42107.74
buyer_1,Luis,,ES41209538904585312595,TRX_N-01099-57146517,2024-09-01T06:23:02,Bilbao,incomes,extra_income,349.57,-41758.17
buyer_1,Luis,,ES41209538904585312595,TRX_N-01100-34763743,2024-09-02T20:35:07,Bilbao,expenses,transport,-63.37,-41821.54
buyer_1,Luis,,ES41209538904585312595,TRX_N-01101-00234235,2024-09-02T10:39:09,Bilbao,expenses,cash,-100.0,-41921.54
buyer_1,Luis,,ES41209538904585312595,TRX_N-01102-67064891,2024-09-03T08:18:40,Bilbao,expenses,food,-121.66,-42043.2
buyer_1,Luis,,ES41209538904585312595,TRX_N-01103-25608989,2024-09-03T09:19:00,Zuia,expenses,education,-56.42,-42099.62
buyer_1,Luis,,ES41209538904585312595,TRX_N-01104-99480705,2024-09-04T08:55:02,Bilbao,expenses,rent,-700.2,-42799.82
buyer_1,Luis,,ES41209538904585312595,TRX_N-01105-95921197,2024-09-04T03:50:35,Bilbao,expenses,healthcare,-70.25,-42870.07
buyer_1,Luis,,ES41209538904585312595,TRX_N-01106-86859557,2024-09-06T21:27:11,Bilbao,expenses,water,-36.11,-42906.18
buyer_1,Luis,,ES41209538904585312595,TRX_N-01107-16733196,2024-09-06T22:09:34,Bilbao,expenses,phone,-35.64,-42941.82
buyer_1,Luis,,ES41209538904585312595,TRX_N-01108-93386548,2024-09-07T09:34:34,Bilbao,expenses,internet,-42.0,-42983.82
buyer_1,Luis,,ES41209538904585312595,TRX_N-01109-68289907,2024-09-07T17:16:29,Bilbao,expenses,food,-103.75,-43087.57
buyer_1,Luis,,ES41209538904585312595,TRX_N-01110-21625160,2024-09-07T12:29:07,Bilbao,expenses,clothing,-56.2,-43143.77
buyer_1,Luis,,ES41209538904585312595,TRX_N-01111-02583619,2024-09-07T21:10:24,Bilbao,expenses,education,-61.43,-43205.2
buyer_1,Luis,,ES41209538904585312595,TRX_N-01112-59423060,2024-09-08T15:42:05,Bilbao,expenses,electricity,-74.04,-43279.24
buyer_1,Luis,,ES41209538904585312595,TRX_N-01113-97354369,2024-09-08T19:54:22,Bilbao,expenses,gas,-104.33,-43383.57
buyer_1,Luis,,ES41209538904585312595,TRX_N-01114-20798729,2024-09-08T23:06:30,Bilbao,expenses,clothing,-124.29,-43507.86
buyer_1,Luis,,ES41209538904585312595,TRX_N-01115-26204386,2024-09-10T18:21:09,Bilbao,expenses,cash,-100.0,-43607.86
buyer_1,Luis,,ES41209538904585312595,TRX_N-01116-10730596,2024-09-10T09:22:15,Bilbao,expenses,gifts,-530.26,-44138.12
buyer_1,Luis,,ES41209538904585312595,TRX_N-01117-95581768,2024-09-13T23:16:11,Bilbao,expenses,food,-122.3,-44260.42
buyer_1,Luis,,ES41209538904585312595,TRX_N-01118-54636583,2024-09-13T20:50:12,Bilbao,expenses,transport,-69.17,-44329.59
buyer_1,Luis,,ES41209538904585312595,TRX_N-01119-52916435,2024-09-13T12:40:29,Bilbao,expenses,healthcare,-178.08,-44507.67
buyer_1,Luis,,ES41209538904585312595,TRX_N-01120-09290082,2024-09-15T09:33:08,Bilbao,expenses,food,-107.32,-44614.99
buyer_1,Luis,,ES41209538904585312595,TRX_N-01121-93232585,2024-09-15T19:23:51,Barakaldo,expenses,cash,-100.0,-44714.99
buyer_1,Luis,,ES41209538904585312595,TRX_N-01122-00754387,2024-09-16T19:48:34,Bilbao,expenses,transport,-86.85,-44801.84
buyer_1,Luis,,ES41209538904585312595,TRX_N-01123-64312375,2024-09-18T19:18:34,Bilbao,expenses,cash,-100.0,-44901.84
buyer_1,Luis,,ES41209538904585312595,TRX_N-01124-79453107,2024-09-19T23:17:31,Llodio,expenses,appliances,-188.41,-45090.25
buyer_1,Luis,,ES41209538904585312595,TRX_N-01125-83176567,2024-09-21T20:06:35,Bilbao,expenses,cash,-100.0,-45190.25
buyer_1,Luis,,ES41209538904585312595,TRX_N-01126-98181976,2024-09-22T23:22:47,Bilbao,expenses,clothing,-62.42,-45252.67
buyer_1,Luis,,ES41209538904585312595,TRX_N-01127-86348904,2024-09-22T09:41:39,Bilbao,expenses,education,-56.82,-45309.49
buyer_1,Luis,,ES41209538904585312595,TRX_N-01128-45077872,2024-09-23T20:05:53,Bilbao,expenses,cash,-100.0,-45409.49
buyer_1,Luis,,ES41209538904585312595,TRX_N-01129-16593108,2024-09-26T14:35:41,Bilbao,expenses,leisure,-18.54,-45428.03
buyer_1,Luis,,ES41209538904585312595,TRX_N-01130-87902288,2024-09-28T06:27:13,Bilbao,expenses,food,-70.49,-45498.52
buyer_1,Luis,,ES41209538904585312595,TRX_N-01131-71489003,2024-09-29T19:33:33,Bilbao,expenses,appliances,-183.13,-45681.65
buyer_1,Luis,,ES41209538904585312595,TRX_N-01132-34469485,2024-10-01T16:49:34,Bilbao,incomes,salary,3139.5,-42542.15
buyer_1,Luis,,ES41209538904585312595,TRX_N-01133-44667030,2024-10-02T19:37:30,Bilbao,expenses,food,-113.11,-42655.26
buyer_1,Luis,,ES41209538904585312595,TRX_N-01134-09368611,2024-10-02T15:51:43,Galdakao,expenses,leisure,-78.39,-42733.65
buyer_1,Luis,,ES41209538904585312595,TRX_N-01135-24439296,2024-10-03T20:52:37,Hondarribia,expenses,cash,-100.0,-42833.65
buyer_1,Luis,,ES41209538904585312595,TRX_N-01136-02655218,2024-10-04T17:23:03,Bilbao,expenses,rent,-700.2,-43533.85
buyer_1,Luis,,ES41209538904585312595,TRX_N-01137-71194648,2024-10-05T10:20:28,Bilbao,expenses,electricity,-56.7,-43590.55
buyer_1,Luis,,ES41209538904585312595,TRX_N-01138-29371935,2024-10-05T18:24:18,Bilbao,expenses,transport,-47.55,-43638.1
buyer_1,Luis,,ES41209538904585312595,TRX_N-01139-99785632,2024-10-05T19:59:28,Bilbao,expenses,cash,-100.0,-43738.1
buyer_1,Luis,,ES41209538904585312595,TRX_N-01140-25795803,2024-10-06T12:36:54,Bilbao,expenses,internet,-42.0,-43780.1
buyer_1,Luis,,ES41209538904585312595,TRX_N-01141-48940481,2024-10-06T13:16:47,Bilbao,expenses,phone,-30.36,-43810.46
buyer_1,Luis,,ES41209538904585312595,TRX_N-01142-84606286,2024-10-06T12:46:21,Bilbao,expenses,leisure,-53.59,-43864.05
buyer_1,Luis,,ES41209538904585312595,TRX_N-01143-04869132,2024-10-07T03:24:16,Bilbao,expenses,cash,-100.0,-43964.05
buyer_1,Luis,,ES41209538904585312595,TRX_N-01144-72242835,2024-10-08T09:13:01,Bilbao,expenses,water,-26.95,-43991.0
buyer_1,Luis,,ES41209538904585312595,TRX_N-01145-39936283,2024-10-08T06:51:32,Bilbao,expenses,gas,-94.7,-44085.7
buyer_1,Luis,,ES41209538904585312595,TRX_N-01146-33245699,2024-10-08T00:42:36,Bilbao,expenses,cash,-100.0,-44185.7
buyer_1,Luis,,ES41209538904585312595,TRX_N-01147-32623854,2024-10-08T16:17:00,Bilbao,expenses,gifts,-696.26,-44881.96
buyer_2,Carmen,,ES84209577803377945929,TRX_N-00001-14595222,2022-01-01T04:45:46,Zarautz,incomes,salary,2001.24,12911.39
buyer_2,Carmen,,ES84209577803377945929,TRX_N-00002-50558520,2022-01-01T12:30:36,Zarautz,expenses,education,-51.71,12859.68
buyer_2,Carmen,,ES84209577803377945929,TRX_N-00003-47881051,2022-01-01T13:47:32,Zarautz,expenses,gifts,-787.95,12071.73
buyer_2,Carmen,,ES84209577803377945929,TRX_N-00004-37667842,2022-01-02T12:32:15,Zarautz,expenses,food,-110.92,11960.81
buyer_2,Carmen,,ES84209577803377945929,TRX_N-00005-08979594,2022-01-03T10:38:48,Zarautz,expenses,cash,-100.0,11860.81
buyer_2,Carmen,,ES84209577803377945929,TRX_N-00006-39153807,2022-01-04T10:44:58,Zarautz,expenses,mortgage,-869.67,10991.14
buyer_2,Carmen,,ES84209577803377945929,TRX_N-00007-85129701,2022-01-04T12:19:16,Zarautz,expenses,food,-82.19,10908.95
buyer_2,Carmen,,ES84209577803377945929,TRX_N-00008-92910777,2022-01-04T19:45:42,Sestao,expenses,clothing,-122.32,10786.63
buyer_2,Carmen,,ES84209577803377945929,TRX_N-00009-39147944,2022-01-04T20:42:46,Zarautz,expenses,cash,-100.0,10686.63
buyer_2,Carmen,,ES84209577803377945929,TRX_N-00010-60149015,2022-01-05T17:27:37,Zarautz,expenses,water,-34.58,10652.05
buyer_2,Carmen,,ES84209577803377945929,TRX_N-00011-83516577,2022-01-05T10:24:58,Zarautz,expenses,electricity,-47.5,10604.55
buyer_2,Carmen,,ES84209577803377945929,TRX_N-00012-22939534,2022-01-05T14:56:40,Zarautz,expenses,gas,-38.22,10566.33
buyer_2,Carmen,,ES84209577803377945929,TRX_N-00013-33082063,2022-01-05T23:22:01,Bermeo,expenses,cash,-100.0,10466.33
buyer_2,Carmen,,ES84209577803377945929,TRX_N-00014-04433799,2022-01-06T14:41:10,Zarautz,expenses,phone,-41.89,10424.44
buyer_2,Carmen,,ES84209577803377945929,TRX_N-00015-25132004,2022-01-06T09:58:54,Zarautz,expenses,food,-100.67,10323.77
buyer_2,Carmen,,ES84209577803377945929,TRX_N-00016-07397676,2022-01-06T17:09:50,Getxo,expenses,cash,-100.0,10223.77
buyer_2,Carmen,,ES84209577803377945929,TRX_N-00017-39764547,2022-01-08T17:36:32,Zarautz,expenses,internet,-42.0,10181.77
buyer_2,Carmen,,ES84209577803377945929,TRX_N-00018-71524884,2022-01-08T16:23:41,Zarautz,expenses,food,-113.36,10068.41
buyer_2,Carmen,,ES84209577803377945929,TRX_N-00019-50808077,2022-01-08T13:31:56,Zarautz,expenses,repairs,-289.02,9779.39
buyer_2,Carmen,,ES84209577803377945929,TRX_N-00020-68134009,2022-01-09T12:43:41,Zarautz,expenses,leisure,-72.17,9707.22
buyer_2,Carmen,,ES84209577803377945929,TRX_N-00021-84979502,2022-01-12T12:08:45,Zarautz,expenses,cash,-100.0,9607.22
buyer_2,Carmen,,ES84209577803377945929,TRX_N-00022-24585280,2022-01-13T17:49:56,Irun,expenses,leisure,-66.77,9540.45
buyer_2,Carmen,,ES84209577803377945929,TRX_N-00023-25846013,2022-01-15T12:06:43,Errenteria,expenses,cash,-100.0,9440.45
buyer_2,Carmen,,ES84209577803377945929,TRX_N-00024-89946379,2022-01-15T19:18:04,Zarautz,expenses,children,-712.09,8728.36
buyer_2,Carmen,,ES84209577803377945929,TRX_N-00025-19379570,2022-01-17T18:47:19,Vitoria-Gasteiz,expenses,cash,-100.0,8628.36
buyer_2,Carmen,,ES84209577803377945929,TRX_N-00026-10784406,2022-01-18T13:35:36,Zarautz,expenses,cash,-100.0,8528.36
buyer_2,Carmen,,ES84209577803377945929,TRX_N-00027-10731081,2022-01-19T13:02:07,Lasarte-Oria,expenses,education,-50.15,8478.21
buyer_2,Carmen,,ES84209577803377945929,TRX_N-00028-70922121,2022-01-19T13:36:26,Zarautz,expenses,repairs,-298.88,8179.33
buyer_2,Carmen,,ES84209577803377945929,TRX_N-00029-18522511,2022-01-20T12:39:11,Zarautz,expenses,clothing,-89.68,8089.65
buyer_2,Carmen,,ES84209577803377945929,TRX_N-00030-95379981,2022-01-21T23:58:10,Zarautz,expenses,food,-100.0,7989.65
buyer_2,Carmen,,ES84209577803377945929,TRX_N-00031-31420264,2022-01-21T14:34:21,Zarautz,expenses,children,-227.19,7762.46
buyer_2,Carmen,,ES84209577803377945929,TRX_N-00032-18873374,2022-01-22T08:10:47,Zarautz,expenses,healthcare,-148.91,7613.55
buyer_2,Carmen,,ES84209577803377945929,TRX_N-00033-83200701,2022-01-22T12:01:58,Leioa,expenses,cash,-100.0,7513.55
buyer_2,Carmen,,ES84209577803377945929,TRX_N-00034-89377637,2022-01-24T12:22:34,Zarautz,expenses,transport,-87.47,7426.08
buyer_2,Carmen,,ES84209577803377945929,TRX_N-00035-24183353,2022-01-24T15:29:08,Zarautz,expenses,leisure,-54.06,7372.02
buyer_2,Carmen,,ES84209577803377945929,TRX_N-00036-17555340,2022-01-25T15:29:55,Irun,expenses,leisure,-25.31,7346.71
buyer_2,Carmen,,ES84209577803377945929,TRX_N-00037-45440269,2022-01-25T00:30:41,Pasaia,expenses,clothing,-59.61,7287.1
buyer_2,Carmen,,ES84209577803377945929,TRX_N-00038-66739230,2022-01-26T17:42:39,Zarautz,expenses,healthcare,-105.2,7181.9
buyer_2,Carmen,,ES84209577803377945929,TRX_N-00039-19691895,2022-01-26T10:07:38,Zarautz,expenses,repairs,-114.49,7067.41
buyer_2,Carmen,,ES84209577803377945929,TRX_N-00040-70044008,2022-01-27T09:41:15,Zarautz,expenses,leisure,-26.67,7040.74
buyer_2,Carmen,,ES84209577803377945929,TRX_N-00041-00855613,2022-01-31T23:56:10,Zarautz,expenses,transport,-79.46,6961.28
buyer_2,Carmen,,ES84209577803377945929,TRX_N-00042-84839074,2022-01-31T19:47:56,Zarautz,expenses,leisure,-20.98,6940.3
buyer_2,Carmen,,ES84209577803377945929,TRX_N-00043-89469687,2022-02-01T19:04:56,Zarautz,incomes,salary,2001.24,8941.54
buyer_2,Carmen,,ES84209577803377945929,TRX_N-00044-03723217,2022-02-01T04:44:20,Zarautz,expenses,repairs,-46.57,8894.97
buyer_2,Carmen,,ES84209577803377945929,TRX_N-00045-86861062,2022-02-01T13:55:03,Zarautz,expenses,children,-682.29,8212.68
buyer_2,Carmen,,ES84209577803377945929,TRX_N-00046-78403786,2022-02-02T12:28:13,Zarautz,expenses,cash,-100.0,8112.68
buyer_2,Carmen,,ES84209577803377945929,TRX_N-00047-96739043,2022-02-02T09:19:12,Zarautz,expenses,gifts,-102.45,8010.23
buyer_2,Carmen,,ES84209577803377945929,TRX_N-00048-15106201,2022-02-04T23:39:46,Zarautz,expenses,mortgage,-869.67,7140.56
buyer_2,Carmen,,ES84209577803377945929,TRX_N-00049-43220044,2022-02-04T21:01:46,Zarautz,expenses,cash,-100.0,7040.56
buyer_2,Carmen,,ES84209577803377945929,TRX_N-00050-35457814,2022-02-05T15:37:53,Zarautz,expenses,gifts,-690.5,6350.06
buyer_2,Carmen,,ES84209577803377945929,TRX_N-00051-17849916,2022-02-06T22:13:02,Zarautz,expenses,electricity,-85.85,6264.21
buyer_2,Carmen,,ES84209577803377945929,TRX_N-00052-03251615,2022-02-08T13:03:57,Zarautz,expenses,gas,-101.61,6162.6
buyer_2,Carmen,,ES84209577803377945929,TRX_N-00053-18053905,2022-02-08T02:31:00,Zarautz,expenses,water,-33.28,6129.32
buyer_2,Carmen,,ES84209577803377945929,TRX_N-00054-79229980,2022-02-08T08:21:42,Zarautz,expenses,internet,-42.0,6087.32
buyer_2,Carmen,,ES84209577803377945929,TRX_N-00055-10874392,2022-02-08T09:56:26,Zarautz,expenses,phone,-31.72,6055.6
buyer_2,Carmen,,ES84209577803377945929,TRX_N-00056-35291882,2022-02-08T16:05:33,Zarautz,expenses,clothing,-146.39,5909.21
buyer_2,Carmen,,ES84209577803377945929,TRX_N-00057-86320648,2022-02-08T08:41:07,Durango,expenses,cash,-100.0,5809.21
buyer_2,Carmen,,ES84209577803377945929,TRX_N-00058-01918840,2022-02-09T10:30:20,Zarautz,expenses,healthcare,-108.8,5700.41
buyer_2,Carmen,,ES84209577803377945929,TRX_N-00059-44997255,2022-02-10T20:07:34,Iruña de Oca,expenses,leisure,-47.22,5653.19
buyer_2,Carmen,,ES84209577803377945929,TRX_N-00060-65391019,2022-02-13T15:33:10,Zarautz,expenses,food,-103.69,5549.5
buyer_2,Carmen,,ES84209577803377945929,TRX_N-00061-97319222,2022-02-13T20:15:25,Zarautz,expenses,clothing,-81.02,5468.48
buyer_2,Carmen,,ES84209577803377945929,TRX_N-00062-48452586,2022-02-15T10:00:42,Zarautz,expenses,repairs,-269.43,5199.05
buyer_2,Carmen,,ES84209577803377945929,TRX_N-00063-56219691,2022-02-17T09:47:16,Zarautz,expenses,clothing,-64.86,5134.19
buyer_2,Carmen,,ES84209577803377945929,TRX_N-00064-43407989,2022-02-17T09:18:30,Zarautz,expenses,cash,-100.0,5034.19
buyer_2,Carmen,,ES84209577803377945929,TRX_N-00065-87325298,2022-02-18T23:44:31,Zarautz,expenses,food,-61.11,4973.08
buyer_2,Carmen,,ES84209577803377945929,TRX_N-00066-22835469,2022-02-18T21:03:58,Zarautz,expenses,clothing,-81.84,4891.24
buyer_2,Carmen,,ES84209577803377945929,TRX_N-00067-91033788,2022-02-19T11:30:30,Zarautz,expenses,transport,-40.72,4850.52
buyer_2,Carmen,,ES84209577803377945929,TRX_N-00068-62524329,2022-02-20T14:13:24,Lasarte-Oria,expenses,clothing,-89.14,4761.38
buyer_2,Carmen,,ES84209577803377945929,TRX_N-00069-92253038,2022-02-21T21:49:08,Donostia,expenses,food,-105.5,4655.88
buyer_2,Carmen,,ES84209577803377945929,TRX_N-00070-76417040,2022-02-21T17:24:57,Labastida,expenses,appliances,-339.73,4316.15
buyer_2,Carmen,,ES84209577803377945929,TRX_N-00071-48841854,2022-02-22T09:56:15,Irun,expenses,leisure,-77.79,4238.36
buyer_2,Carmen,,ES84209577803377945929,TRX_N-00072-21458651,2022-02-22T13:52:46,Zarautz,expenses,cash,-100.0,4138.36
buyer_2,Carmen,,ES84209577803377945929,TRX_N-00073-40572095,2022-02-22T14:17:27,Zarautz,expenses,appliances,-147.14,3991.22
buyer_2,Carmen,,ES84209577803377945929,TRX_N-00074-00142788,2022-02-25T11:42:49,Zarautz,expenses,gifts,-363.09,3628.13
buyer_2,Carmen,,ES84209577803377945929,TRX_N-00075-87271140,2022-02-25T08:09:01,Zarautz,expenses,children,-169.78,3458.35
buyer_2,Carmen,,ES84209577803377945929,TRX_N-00076-38651819,2022-03-01T04:17:55,Zarautz,incomes,salary,2001.24,5459.59
buyer_2,Carmen,,ES84209577803377945929,TRX_N-00077-17044523,2022-03-02T09:45:15,Zarautz,expenses,transport,-45.93,5413.66
buyer_2,Carmen,,ES84209577803377945929,TRX_N-00078-06168716,2022-03-02T16:37:50,Zarautz,expenses,children,-356.88,5056.78
buyer_2,Carmen,,ES84209577803377945929,TRX_N-00079-33216223,2022-03-03T19:43:54,Zarautz,expenses,cash,-100.0,4956.78
buyer_2,Carmen,,ES84209577803377945929,TRX_N-00080-19071448,2022-03-04T12:59:45,Zarautz,expenses,mortgage,-869.67,4087.11
buyer_2,Carmen,,ES84209577803377945929,TRX_N-00081-86439100,2022-03-05T19:53:40,Zarautz,expenses,cash,-100.0,3987.11
buyer_2,Carmen,,ES84209577803377945929,TRX_N-00082-96504339,2022-03-07T23:26:51,Zarautz,expenses,electricity,-77.44,3909.67
buyer_2,Carmen,,ES84209577803377945929,TRX_N-00083-05393487,2022-03-07T21:41:02,Arrasate,expenses,leisure,-80.01,3829.66
buyer_2,Carmen,,ES84209577803377945929,TRX_N-00084-02020483,2022-03-08T20:05:51,Zarautz,expenses,internet,-42.0,3787.66
buyer_2,Carmen,,ES84209577803377945929,TRX_N-00085-04108649,2022-03-08T21:58:35,Zarautz,expenses,water,-27.05,3760.61
buyer_2,Carmen,,ES84209577803377945929,TRX_N-00086-84925466,2022-03-08T10:10:29,Zarautz,expenses,gas,-110.49,3650.12
buyer_2,Carmen,,ES84209577803377945929,TRX_N-00087-63257696,2022-03-08T11:02:04,Zarautz,expenses,phone,-44.73,3605.39
buyer_2,Carmen,,ES84209577803377945929,TRX_N-00088-16699403,2022-03-08T07:00:24,Zarautz,expenses,cash,-100.0,3505.39
buyer_2,Carmen,,ES84209577803377945929,TRX_N-00089-80568314,2022-03-10T11:24:35,Zarautz,expenses,transport,-71.6,3433.79
buyer_2,Carmen,,ES84209577803377945929,TRX_N-00090-90136755,2022-03-10T19:06:33,Zarautz,expenses,education,-67.09,3366.7
buyer_2,Carmen,,ES84209577803377945929,TRX_N-00091-36618963,2022-03-11T05:30:50,Zarautz,expenses,gifts,-569.53,2797.17
buyer_2,Carmen,,ES84209577803377945929,TRX_N-00092-14085086,2022-03-12T16:01:43,Zarautz,expenses,education,-52.03,2745.14
buyer_2,Carmen,,ES84209577803377945929,TRX_N-00093-58437517,2022-03-13T12:18:40,Zarautz,expenses,leisure,-82.21,2662.93
buyer_2,Carmen,,ES84209577803377945929,TRX_N-00094-96888746,2022-03-15T19:41:15,Zarautz,expenses,food,-92.94,2569.99
buyer_2,Carmen,,ES84209577803377945929,TRX_N-00095-75481421,2022-03-16T22:13:50,Zarautz,expenses,leisure,-34.71,2535.28
buyer_2,Carmen,,ES84209577803377945929,TRX_N-00096-55279491,2022-03-16T15:22:23,Zarautz,expenses,gifts,-669.09,1866.19
buyer_2,Carmen,,ES84209577803377945929,TRX_N-00097-39334269,2022-03-17T23:16:14,Zarautz,expenses,gifts,-459.38,1406.81
buyer_2,Carmen,,ES84209577803377945929,TRX_N-00098-52768207,2022-03-19T07:19:01,Zarautz,expenses,food,-104.85,1301.96
buyer_2,Carmen,,ES84209577803377945929,TRX_N-00099-63660305,2022-03-21T09:41:58,Zarautz,expenses,cash,-100.0,1201.96
buyer_2,Carmen,,ES84209577803377945929,TRX_N-00100-02526543,2022-03-21T18:48:52,Zarautz,expenses,repairs,-174.7,1027.26
buyer_2,Carmen,,ES84209577803377945929,TRX_N-00101-12815259,2022-03-22T13:22:39,Zarautz,expenses,cash,-100.0,927.26
buyer_2,Carmen,,ES84209577803377945929,TRX_N-00102-05123104,2022-03-23T14:28:36,Zarautz,expenses,healthcare,-131.4,795.86
buyer_2,Carmen,,ES84209577803377945929,TRX_N-00103-57473925,2022-03-25T13:26:02,Zarautz,expenses,repairs,-111.06,684.8
buyer_2,Carmen,,ES84209577803377945929,TRX_N-00104-19925839,2022-03-31T09:16:06,Zarautz,expenses,clothing,-47.44,637.36
buyer_2,Carmen,,ES84209577803377945929,TRX_N-00105-24636252,2022-03-31T04:26:11,Iruña de Oca,expenses,gifts,-424.14,213.22
buyer_2,Carmen,,ES84209577803377945929,TRX_N-00106-89250668,2022-04-01T16:29:08,Zarautz,incomes,salary,2001.24,2214.46
buyer_2,Carmen,,ES84209577803377945929,TRX_N-00107-68648990,2022-04-01T16:29:08,Zarautz,incomes,extra_income,317.86,2532.32
buyer_2,Carmen,,ES84209577803377945929,TRX_N-00108-44530131,2022-04-01T06:17:53,Zarautz,expenses,cash,-100.0,2432.32
buyer_2,Carmen,,ES84209577803377945929,TRX_N-00109-91661646,2022-04-02T18:22:00,Zarautz,expenses,food,-87.45,2344.87
buyer_2,Carmen,,ES84209577803377945929,TRX_N-00110-96408922,2022-04-02T22:48:35,Zarautz,expenses,children,-488.41,1856.46
buyer_2,Carmen,,ES84209577803377945929,TRX_N-00111-85602807,2022-04-04T20:19:03,Zarautz,expenses,mortgage,-869.67,986.79
buyer_2,Carmen,,ES84209577803377945929,TRX_N-00112-10842208,2022-04-04T13:56:59,Erandio,expenses,food,-79.87,906.92
buyer_2,Carmen,,ES84209577803377945929,TRX_N-00113-89542120,2022-04-04T14:23:47,Zarautz,expenses,leisure,-59.81,847.11
buyer_2,Carmen,,ES84209577803377945929,TRX_N-00114-85828055,2022-04-04T08:42:13,Zarautz,expenses,cash,-100.0,747.11
buyer_2,Carmen,,ES84209577803377945929,TRX_N-00115-90188371,2022-04-05T13:24:41,Zarautz,expenses,phone,-38.7,708.41
buyer_2,Carmen,,ES84209577803377945929,TRX_N-00116-26081969,2022-04-06T17:02:33,Zarautz,expenses,gas,-47.54,660.87
buyer_2,Carmen,,ES84209577803377945929,TRX_N-00117-93388341,2022-04-07T10:10:25,Zarautz,expenses,internet,-42.0,618.87
buyer_2,Carmen,,ES84209577803377945929,TRX_N-00118-42115183,2022-04-07T19:32:09,Durango,expenses,clothing,-71.92,546.95
buyer_2,Carmen,,ES84209577803377945929,TRX_N-00119-56480533,2022-04-07T14:33:51,Zarautz,expenses,appliances,-416.55,130.4
buyer_2,Carmen,,ES84209577803377945929,TRX_N-00120-28432176,2022-04-07T08:56:38,Zarautz,expenses,repairs,-276.18,-145.78
buyer_2,Carmen,,ES84209577803377945929,TRX_N-00121-92685255,2022-04-08T09:04:17,Zarautz,expenses,electricity,-84.63,-230.41
buyer_2,Carmen,,ES84209577803377945929,TRX_N-00122-10876653,2022-04-08T11:19:08,Zarautz,expenses,water,-34.16,-264.57
buyer_2,Carmen,,ES84209577803377945929,TRX_N-00123-00819843,2022-04-10T15:48:30,Zarautz,expenses,food,-82.72,-347.29
buyer_2,Carmen,,ES84209577803377945929,TRX_N-00124-86035869,2022-04-10T15:40:10,Zarautz,expenses,leisure,-33.87,-381.16
buyer_2,Carmen,,ES84209577803377945929,TRX_N-00125-15968180,2022-04-10T20:22:49,Zarautz,expenses,healthcare,-103.05,-484.21
buyer_2,Carmen,,ES84209577803377945929,TRX_N-00126-83162084,2022-04-10T12:48:02,Zarautz,expenses,children,-663.31,-1147.52
buyer_2,Carmen,,ES84209577803377945929,TRX_N-00127-96563054,2022-04-11T05:13:32,Getxo,expenses,clothing,-158.61,-1306.13
buyer_2,Carmen,,ES84209577803377945929,TRX_N-00128-80755426,2022-04-13T12:06:14,Sestao,expenses,clothing,-115.17,-1421.3
buyer_2,Carmen,,ES84209577803377945929,TRX_N-00129-65062489,2022-04-15T14:05:17,Zarautz,expenses,children,-291.8,-1713.1
buyer_2,Carmen,,ES84209577803377945929,TRX_N-00130-59546818,2022-04-16T13:53:06,Zarautz,expenses,children,-412.44,-2125.54
buyer_2,Carmen,,ES84209577803377945929,TRX_N-00131-36434342,2022-04-17T16:47:29,Zarautz,expenses,food,-97.5,-2223.04
buyer_2,Carmen,,ES84209577803377945929,TRX_N-00132-36134063,2022-04-17T12:04:28,Zarautz,expenses,repairs,-154.92,-2377.96
buyer_2,Carmen,,ES84209577803377945929,TRX_N-00133-06422290,2022-04-20T16:37:48,Zarautz,expenses,leisure,-68.84,-2446.8
buyer_2,Carmen,,ES84209577803377945929,TRX_N-00134-09407599,2022-04-20T11:28:41,Andoain,expenses,education,-48.63,-2495.43
buyer_2,Carmen,,ES84209577803377945929,TRX_N-00135-23189090,2022-04-20T10:53:04,Zarautz,expenses,cash,-100.0,-2595.43
buyer_2,Carmen,,ES84209577803377945929,TRX_N-00136-21550547,2022-04-20T09:59:10,Zarautz,expenses,children,-552.97,-3148.4
buyer_2,Carmen,,ES84209577803377945929,TRX_N-00137-04101199,2022-04-22T12:38:53,Zuia,expenses,education,-42.77,-3191.17
buyer_2,Carmen,,ES84209577803377945929,TRX_N-00138-37466365,2022-04-25T17:45:23,Zarautz,expenses,leisure,-61.43,-3252.6
buyer_2,Carmen,,ES84209577803377945929,TRX_N-00139-78657106,2022-04-25T16:23:17,Zarautz,expenses,cash,-100.0,-3352.6
buyer_2,Carmen,,ES84209577803377945929,TRX_N-00140-96143258,2022-04-27T12:26:58,Zarautz,expenses,food,-123.03,-3475.63
buyer_2,Carmen,,ES84209577803377945929,TRX_N-00141-47278731,2022-04-27T20:55:01,Zarautz,expenses,leisure,-42.08,-3517.71
buyer_2,Carmen,,ES84209577803377945929,TRX_N-00142-46933647,2022-04-27T21:51:59,Zarautz,expenses,repairs,-227.61,-3745.32
buyer_2,Carmen,,ES84209577803377945929,TRX_N-00143-66316834,2022-04-30T10:45:23,Zarautz,expenses,transport,-62.66,-3807.98
buyer_2,Carmen,,ES84209577803377945929,TRX_N-00144-82228813,2022-04-30T15:24:19,Zarautz,expenses,clothing,-149.14,-3957.12
buyer_2,Carmen,,ES84209577803377945929,TRX_N-00145-45691723,2022-05-01T14:14:01,Zarautz,incomes,salary,2001.24,-1955.88
buyer_2,Carmen,,ES84209577803377945929,TRX_N-00146-49087406,2022-05-01T17:58:59,Zarautz,expenses,clothing,-97.4,-2053.28
buyer_2,Carmen,,ES84209577803377945929,TRX_N-00147-20300151,2022-05-03T16:57:04,Zarautz,expenses,transport,-60.59,-2113.87
buyer_2,Carmen,,ES84209577803377945929,TRX_N-00148-42228001,2022-05-04T17:00:20,Zarautz,expenses,mortgage,-869.67,-2983.54
buyer_2,Carmen,,ES84209577803377945929,TRX_N-00149-03021349,2022-05-04T11:19:12,Zarautz,expenses,cash,-100.0,-3083.54
buyer_2,Carmen,,ES84209577803377945929,TRX_N-00150-52589100,2022-05-04T08:33:45,Zarautz,expenses,gifts,-288.27,-3371.81
buyer_2,Carmen,,ES84209577803377945929,TRX_N-00151-95135028,2022-05-05T09:59:57,Zarautz,expenses,water,-42.56,-3414.37
buyer_2,Carmen,,ES84209577803377945929,TRX_N-00152-36809450,2022-05-05T23:43:16,Zarautz,expenses,gas,-52.76,-3467.13
buyer_2,Carmen,,ES84209577803377945929,TRX_N-00153-86772063,2022-05-05T16:35:43,Zarautz,expenses,leisure,-38.62,-3505.75
buyer_2,Carmen,,ES84209577803377945929,TRX_N-00154-35446327,2022-05-06T20:51:26,Zarautz,expenses,internet,-42.0,-3547.75
buyer_2,Carmen,,ES84209577803377945929,TRX_N-00155-87406454,2022-05-06T18:13:05,Zarautz,expenses,phone,-41.99,-3589.74
buyer_2,Carmen,,ES84209577803377945929,TRX_N-00156-85939306,2022-05-08T02:50:20,Zarautz,expenses,electricity,-63.24,-3652.98
buyer_2,Carmen,,ES84209577803377945929,TRX_N-00157-97563245,2022-05-08T17:22:15,Zarautz,expenses,cash,-100.0,-3752.98
buyer_2,Carmen,,ES84209577803377945929,TRX_N-00158-41949008,2022-05-11T14:50:57,Zuia,expenses,food,-74.04,-3827.02
buyer_2,Carmen,,ES84209577803377945929,TRX_N-00159-34675500,2022-05-11T18:46:21,Erandio,expenses,transport,-75.55,-3902.57
buyer_2,Carmen,,ES84209577803377945929,TRX_N-00160-27995807,2022-05-11T10:30:04,Zarautz,expenses,repairs,-244.61,-4147.18
buyer_2,Carmen,,ES84209577803377945929,TRX_N-00161-67882826,2022-05-12T10:46:58,Zarautz,expenses,transport,-63.07,-4210.25
buyer_2,Carmen,,ES84209577803377945929,TRX_N-00162-65610866,2022-05-12T15:16:36,Llodio,expenses,leisure,-22.99,-4233.24
buyer_2,Carmen,,ES84209577803377945929,TRX_N-00163-82537317,2022-05-13T21:59:37,Zarautz,expenses,travel,-995.03,-5228.27
buyer_2,Carmen,,ES84209577803377945929,TRX_N-00164-04036423,2022-05-14T22:21:40,Zarautz,expenses,leisure,-74.28,-5302.55
buyer_2,Carmen,,ES84209577803377945929,TRX_N-00165-21688647,2022-05-14T06:30:56,Zarautz,expenses,healthcare,-102.84,-5405.39
buyer_2,Carmen,,ES84209577803377945929,TRX_N-00166-98203397,2022-05-15T03:43:39,Getxo,expenses,food,-87.1,-5492.49
buyer_2,Carmen,,ES84209577803377945929,TRX_N-00167-24728727,2022-05-19T17:13:06,Zarautz,expenses,food,-69.51,-5562.0
buyer_2,Carmen,,ES84209577803377945929,TRX_N-00168-75473591,2022-05-19T20:28:46,Zarautz,expenses,cash,-100.0,-5662.0
buyer_2,Carmen,,ES84209577803377945929,TRX_N-00169-64413981,2022-05-21T09:51:43,Zarautz,expenses,appliances,-281.4,-5943.4
buyer_2,Carmen,,ES84209577803377945929,TRX_N-00170-08052315,2022-05-24T11:00:55,Arrasate,expenses,clothing,-115.23,-6058.63
buyer_2,Carmen,,ES84209577803377945929,TRX_N-00171-70891042,2022-05-25T20:34:09,Arrasate,expenses,cash,-100.0,-6158.63
buyer_2,Carmen,,ES84209577803377945929,TRX_N-00172-55720563,2022-05-26T19:29:12,Zarautz,expenses,food,-61.04,-6219.67
buyer_2,Carmen,,ES84209577803377945929,TRX_N-00173-66531332,2022-05-30T14:56:55,Zarautz,expenses,children,-223.68,-6443.35
buyer_2,Carmen,,ES84209577803377945929,TRX_N-00174-87197943,2022-05-31T16:49:05,Zarautz,expenses,food,-76.53,-6519.88
buyer_2,Carmen,,ES84209577803377945929,TRX_N-00175-41681743,2022-06-01T19:20:02,Zarautz,incomes,salary,2001.24,-4518.64
buyer_2,Carmen,,ES84209577803377945929,TRX_N-00176-42624044,2022-06-01T19:20:02,Zarautz,incomes,salary_bonus,1492.69,-3025.95
buyer_2,Carmen,,ES84209577803377945929,TRX_N-00177-68412338,2022-06-01T08:43:24,Zarautz,expenses,food,-113.46,-3139.41
buyer_2,Carmen,,ES84209577803377945929,TRX_N-00178-17451584,2022-06-01T12:56:47,Zarautz,expenses,children,-541.27,-3680.68
buyer_2,Carmen,,ES84209577803377945929,TRX_N-00179-24713800,2022-06-02T16:33:21,Zarautz,expenses,transport,-42.01,-3722.69
buyer_2,Carmen,,ES84209577803377945929,TRX_N-00180-73497379,2022-06-03T18:48:13,Amurrio,expenses,transport,-46.69,-3769.38
buyer_2,Carmen,,ES84209577803377945929,TRX_N-00181-37351655,2022-06-03T20:40:37,Zarautz,expenses,cash,-100.0,-3869.38
buyer_2,Carmen,,ES84209577803377945929,TRX_N-00182-52700493,2022-06-03T11:20:33,Zarautz,expenses,repairs,-266.18,-4135.56
buyer_2,Carmen,,ES84209577803377945929,TRX_N-00183-24204900,2022-06-04T10:15:30,Zarautz,expenses,mortgage,-869.67,-5005.23
buyer_2,Carmen,,ES84209577803377945929,TRX_N-00184-60882250,2022-06-04T15:16:26,Zarautz,expenses,food,-61.23,-5066.46
buyer_2,Carmen,,ES84209577803377945929,TRX_N-00185-14178872,2022-06-04T23:49:22,Zarautz,expenses,gifts,-733.53,-5799.99
buyer_2,Carmen,,ES84209577803377945929,TRX_N-00186-97689005,2022-06-05T10:32:56,Zarautz,expenses,cash,-100.0,-5899.99
buyer_2,Carmen,,ES84209577803377945929,TRX_N-00187-10759510,2022-06-06T10:06:29,Zarautz,expenses,water,-21.93,-5921.92
buyer_2,Carmen,,ES84209577803377945929,TRX_N-00188-23480610,2022-06-06T12:36:08,Zarautz,expenses,internet,-42.0,-5963.92
buyer_2,Carmen,,ES84209577803377945929,TRX_N-00189-98001949,2022-06-06T12:35:33,Hondarribia,expenses,transport,-75.82,-6039.74
buyer_2,Carmen,,ES84209577803377945929,TRX_N-00190-93450592,2022-06-08T19:34:12,Zarautz,expenses,phone,-40.74,-6080.48
buyer_2,Carmen,,ES84209577803377945929,TRX_N-00191-45574210,2022-06-08T09:43:29,Zarautz,expenses,electricity,-89.35,-6169.83
buyer_2,Carmen,,ES84209577803377945929,TRX_N-00192-07771978,2022-06-08T14:56:23,Zarautz,expenses,gas,-106.13,-6275.96
buyer_2,Carmen,,ES84209577803377945929,TRX_N-00193-30088664,2022-06-09T11:26:48,Zarautz,expenses,clothing,-143.67,-6419.63
buyer_2,Carmen,,ES84209577803377945929,TRX_N-00194-00558048,2022-06-09T08:26:08,Santurtzi,expenses,healthcare,-162.75,-6582.38
buyer_2,Carmen,,ES84209577803377945929,TRX_N-00195-20428559,2022-06-09T08:09:09,Eibar,expenses,education,-59.1,-6641.48
buyer_2,Carmen,,ES84209577803377945929,TRX_N-00196-76096520,2022-06-10T08:34:19,Zarautz,expenses,cash,-100.0,-6741.48
buyer_2,Carmen,,ES84209577803377945929,TRX_N-00197-03032846,2022-06-11T11:10:03,Zarautz,expenses,children,-667.42,-7408.9
buyer_2,Carmen,,ES84209577803377945929,TRX_N-00198-84639950,2022-06-12T15:26:11,Zarautz,expenses,food,-94.72,-7503.62
buyer_2,Carmen,,ES84209577803377945929,TRX_N-00199-20700819,2022-06-12T21:48:34,Zarautz,expenses,leisure,-32.32,-7535.94
buyer_2,Carmen,,ES84209577803377945929,TRX_N-00200-61696589,2022-06-12T18:21:03,Andoain,expenses,repairs,-58.2,-7594.14
buyer_2,Carmen,,ES84209577803377945929,TRX_N-00201-28638466,2022-06-15T15:53:26,Zarautz,expenses,transport,-63.16,-7657.3
buyer_2,Carmen,,ES84209577803377945929,TRX_N-00202-34626880,2022-06-16T11:29:59,Zarautz,expenses,food,-65.7,-7723.0
buyer_2,Carmen,,ES84209577803377945929,TRX_N-00203-93004196,2022-06-17T16:59:49,Zarautz,expenses,food,-73.94,-7796.94
buyer_2,Carmen,,ES84209577803377945929,TRX_N-00204-09526054,2022-06-18T08:39:48,Zarautz,expenses,education,-54.5,-7851.44
buyer_2,Carmen,,ES84209577803377945929,TRX_N-00205-72756766,2022-06-18T10:26:06,Zarautz,expenses,appliances,-189.9,-8041.34
buyer_2,Carmen,,ES84209577803377945929,TRX_N-00206-81259712,2022-06-19T23:58:33,Zarautz,expenses,leisure,-33.63,-8074.97
buyer_2,Carmen,,ES84209577803377945929,TRX_N-00207-38313927,2022-06-20T18:41:43,Zarautz,expenses,food,-120.45,-8195.42
buyer_2,Carmen,,ES84209577803377945929,TRX_N-00208-67692364,2022-06-20T19:23:59,Zarautz,expenses,transport,-53.12,-8248.54
buyer_2,Carmen,,ES84209577803377945929,TRX_N-00209-08716156,2022-06-20T15:42:35,Zarautz,expenses,education,-62.89,-8311.43
buyer_2,Carmen,,ES84209577803377945929,TRX_N-00210-37455310,2022-06-21T11:29:15,Zarautz,expenses,leisure,-37.88,-8349.31
buyer_2,Carmen,,ES84209577803377945929,TRX_N-00211-74631167,2022-06-21T17:01:00,Hernani,expenses,clothing,-75.69,-8425.0
buyer_2,Carmen,,ES84209577803377945929,TRX_N-00212-90107799,2022-06-22T19:58:17,Zarautz,expenses,gifts,-271.78,-8696.78
buyer_2,Carmen,,ES84209577803377945929,TRX_N-00213-37920651,2022-06-22T05:20:12,Zarautz,expenses,children,-145.7,-8842.48
buyer_2,Carmen,,ES84209577803377945929,TRX_N-00214-99305046,2022-06-24T19:53:47,Zarautz,expenses,leisure,-77.56,-8920.04
buyer_2,Carmen,,ES84209577803377945929,TRX_N-00215-84988021,2022-06-29T08:37:45,Zarautz,expenses,food,-74.62,-8994.66
buyer_2,Carmen,,ES84209577803377945929,TRX_N-00216-55981662,2022-06-29T10:59:09,Zarautz,expenses,clothing,-142.83,-9137.49
buyer_2,Carmen,,ES84209577803377945929,TRX_N-00217-89704123,2022-06-29T09:40:26,Zarautz,expenses,cash,-100.0,-9237.49
buyer_2,Carmen,,ES84209577803377945929,TRX_N-00218-78014025,2022-07-01T08:35:26,Zarautz,incomes,salary,2001.24,-7236.25
buyer_2,Carmen,,ES84209577803377945929,TRX_N-00219-95120122,2022-07-03T20:49:35,Zarautz,expenses,cash,-100.0,-7336.25
buyer_2,Carmen,,ES84209577803377945929,TRX_N-00220-42792653,2022-07-04T12:24:58,Zarautz,expenses,mortgage,-869.67,-8205.92
buyer_2,Carmen,,ES84209577803377945929,TRX_N-00221-63917231,2022-07-04T10:15:01,Zarautz,expenses,repairs,-280.47,-8486.39
buyer_2,Carmen,,ES84209577803377945929,TRX_N-00222-96648496,2022-07-05T20:29:26,Zarautz,expenses,water,-41.29,-8527.68
buyer_2,Carmen,,ES84209577803377945929,TRX_N-00223-72421695,2022-07-05T15:07:08,Zarautz,expenses,phone,-41.29,-8568.97
buyer_2,Carmen,,ES84209577803377945929,TRX_N-00224-02981815,2022-07-06T13:23:30,Zarautz,expenses,internet,-42.0,-8610.97
buyer_2,Carmen,,ES84209577803377945929,TRX_N-00225-86542785,2022-07-06T12:23:00,Zarautz,expenses,food,-109.37,-8720.34
buyer_2,Carmen,,ES84209577803377945929,TRX_N-00226-19708137,2022-07-07T18:51:13,Zarautz,expenses,electricity,-49.75,-8770.09
buyer_2,Carmen,,ES84209577803377945929,TRX_N-00227-50891178,2022-07-07T22:16:33,Zarautz,expenses,clothing,-67.04,-8837.13
buyer_2,Carmen,,ES84209577803377945929,TRX_N-00228-98331562,2022-07-07T13:00:50,Zarautz,expenses,repairs,-194.02,-9031.15
buyer_2,Carmen,,ES84209577803377945929,TRX_N-00229-39659715,2022-07-08T19:42:00,Zarautz,expenses,gas,-38.1,-9069.25
buyer_2,Carmen,,ES84209577803377945929,TRX_N-00230-45465558,2022-07-09T05:35:31,Zarautz,expenses,cash,-100.0,-9169.25
buyer_2,Carmen,,ES84209577803377945929,TRX_N-00231-48164344,2022-07-11T17:49:49,Zarautz,expenses,leisure,-21.99,-9191.24
buyer_2,Carmen,,ES84209577803377945929,TRX_N-00232-41940550,2022-07-11T18:20:10,Portugalete,expenses,healthcare,-109.81,-9301.05
buyer_2,Carmen,,ES84209577803377945929,TRX_N-00233-02725242,2022-07-17T14:58:16,Donostia,expenses,food,-117.26,-9418.31
buyer_2,Carmen,,ES84209577803377945929,TRX_N-00234-73881424,2022-07-17T00:10:53,Zarautz,expenses,transport,-73.42,-9491.73
buyer_2,Carmen,,ES84209577803377945929,TRX_N-00235-30026232,2022-07-17T11:32:34,Zarautz,expenses,leisure,-78.7,-9570.43
buyer_2,Carmen,,ES84209577803377945929,TRX_N-00236-78160114,2022-07-18T08:40:04,Zarautz,expenses,cash,-100.0,-9670.43
buyer_2,Carmen,,ES84209577803377945929,TRX_N-00237-38553866,2022-07-20T16:24:33,Zarautz,expenses,leisure,-79.4,-9749.83
buyer_2,Carmen,,ES84209577803377945929,TRX_N-00238-85628611,2022-07-24T10:22:01,Zarautz,expenses,cash,-100.0,-9849.83
buyer_2,Carmen,,ES84209577803377945929,TRX_N-00239-10103817,2022-07-25T17:13:47,Zarautz,expenses,repairs,-290.36,-10140.19
buyer_2,Carmen,,ES84209577803377945929,TRX_N-00240-93043083,2022-07-26T16:38:32,Zarautz,expenses,leisure,-84.92,-10225.11
buyer_2,Carmen,,ES84209577803377945929,TRX_N-00241-78226029,2022-07-26T23:30:56,Zarautz,expenses,gifts,-578.32,-10803.43
buyer_2,Carmen,,ES84209577803377945929,TRX_N-00242-55756349,2022-07-27T09:05:43,Zarautz,expenses,gifts,-468.66,-11272.09
buyer_2,Carmen,,ES84209577803377945929,TRX_N-00243-30617295,2022-07-27T10:51:55,Zarautz,expenses,children,-249.55,-11521.64
buyer_2,Carmen,,ES84209577803377945929,TRX_N-00244-99327963,2022-07-28T21:53:00,Zarautz,expenses,transport,-54.43,-11576.07
buyer_2,Carmen,,ES84209577803377945929,TRX_N-00245-43768779,2022-07-29T14:52:59,Zarautz,expenses,cash,-100.0,-11676.07
buyer_2,Carmen,,ES84209577803377945929,TRX_N-00246-29070367,2022-07-30T12:25:36,Zarautz,expenses,appliances,-269.38,-11945.45
buyer_2,Carmen,,ES84209577803377945929,TRX_N-00247-02196189,2022-08-01T09:05:06,Zarautz,incomes,salary,2001.24,-9944.21
buyer_2,Carmen,,ES84209577803377945929,TRX_N-00248-13601104,2022-08-01T09:05:06,Zarautz,incomes,extra_income,317.86,-9626.35
buyer_2,Carmen,,ES84209577803377945929,TRX_N-00249-03857652,2022-08-01T18:14:38,Zarautz,expenses,cash,-100.0,-9726.35
buyer_2,Carmen,,ES84209577803377945929,TRX_N-00250-03229130,2022-08-03T12:36:33,Zarautz,expenses,children,-529.8,-10256.15
buyer_2,Carmen,,ES84209577803377945929,TRX_N-00251-77301631,2022-08-04T18:59:33,Zarautz,expenses,mortgage,-869.67,-11125.82
buyer_2,Carmen,,ES84209577803377945929,TRX_N-00252-41125828,2022-08-05T12:17:14,Zarautz,expenses,cash,-100.0,-11225.82
buyer_2,Carmen,,ES84209577803377945929,TRX_N-00253-22148226,2022-08-07T07:26:47,Zarautz,expenses,education,-74.72,-11300.54
buyer_2,Carmen,,ES84209577803377945929,TRX_N-00254-79847315,2022-08-08T13:23:16,Zarautz,expenses,water,-40.94,-11341.48
buyer_2,Carmen,,ES84209577803377945929,TRX_N-00255-05988390,2022-08-08T10:42:44,Zarautz,expenses,internet,-42.0,-11383.48
buyer_2,Carmen,,ES84209577803377945929,TRX_N-00256-43490490,2022-08-08T20:08:17,Zarautz,expenses,electricity,-24.09,-11407.57
buyer_2,Carmen,,ES84209577803377945929,TRX_N-00257-41891831,2022-08-08T11:12:23,Zarautz,expenses,gas,-60.24,-11467.81
buyer_2,Carmen,,ES84209577803377945929,TRX_N-00258-50534955,2022-08-08T09:02:55,Zarautz,expenses,phone,-34.58,-11502.39
buyer_2,Carmen,,ES84209577803377945929,TRX_N-00259-59549497,2022-08-08T19:05:27,Llodio,expenses,leisure,-72.27,-11574.66
buyer_2,Carmen,,ES84209577803377945929,TRX_N-00260-93761532,2022-08-09T14:54:12,Zarautz,expenses,leisure,-61.62,-11636.28
buyer_2,Carmen,,ES84209577803377945929,TRX_N-00261-92259825,2022-08-11T16:37:17,Zarautz,expenses,transport,-73.77,-11710.05
buyer_2,Carmen,,ES84209577803377945929,TRX_N-00262-23510440,2022-08-11T08:07:36,Zarautz,expenses,leisure,-61.42,-11771.47
buyer_2,Carmen,,ES84209577803377945929,TRX_N-00263-23621165,2022-08-13T15:14:03,Zarautz,expenses,transport,-88.43,-11859.9
buyer_2,Carmen,,ES84209577803377945929,TRX_N-00264-19873213,2022-08-15T14:18:36,Zarautz,expenses,cash,-100.0,-11959.9
buyer_2,Carmen,,ES84209577803377945929,TRX_N-00265-97101683,2022-08-16T11:44:43,Zarautz,expenses,education,-47.11,-12007.01
buyer_2,Carmen,,ES84209577803377945929,TRX_N-00266-90217742,2022-08-16T18:09:12,Zarautz,expenses,cash,-100.0,-12107.01
buyer_2,Carmen,,ES84209577803377945929,TRX_N-00267-14303494,2022-08-18T08:33:20,Zarautz,expenses,repairs,-176.02,-12283.03
buyer_2,Carmen,,ES84209577803377945929,TRX_N-00268-72420351,2022-08-19T20:30:37,Zarautz,expenses,appliances,-302.45,-12585.48
buyer_2,Carmen,,ES84209577803377945929,TRX_N-00269-38976296,2022-08-20T09:51:04,Zarautz,expenses,clothing,-138.73,-12724.21
buyer_2,Carmen,,ES84209577803377945929,TRX_N-00270-72467242,2022-08-20T15:59:02,Zarautz,expenses,gifts,-804.66,-13528.87
buyer_2,Carmen,,ES84209577803377945929,TRX_N-00271-82722495,2022-08-21T23:25:49,Zarautz,expenses,food,-114.46,-13643.33
buyer_2,Carmen,,ES84209577803377945929,TRX_N-00272-76256349,2022-08-21T18:00:19,Zarautz,expenses,cash,-100.0,-13743.33
buyer_2,Carmen,,ES84209577803377945929,TRX_N-00273-21373754,2022-08-21T18:51:50,Zarautz,expenses,appliances,-271.69,-14015.02
buyer_2,Carmen,,ES84209577803377945929,TRX_N-00274-21151907,2022-08-22T16:09:44,Zarautz,expenses,education,-57.16,-14072.18
buyer_2,Carmen,,ES84209577803377945929,TRX_N-00275-55675275,2022-08-23T18:58:30,Zarautz,expenses,food,-62.1,-14134.28
buyer_2,Carmen,,ES84209577803377945929,TRX_N-00276-36071890,2022-08-23T19:25:49,Zarautz,expenses,cash,-100.0,-14234.28
buyer_2,Carmen,,ES84209577803377945929,TRX_N-00277-41649177,2022-08-24T20:24:53,Zarautz,expenses,repairs,-180.95,-14415.23
buyer_2,Carmen,,ES84209577803377945929,TRX_N-00278-61587681,2022-08-26T07:14:07,Zarautz,expenses,food,-86.04,-14501.27
buyer_2,Carmen,,ES84209577803377945929,TRX_N-00279-93690435,2022-08-26T17:49:25,Zarautz,expenses,appliances,-208.17,-14709.44
buyer_2,Carmen,,ES84209577803377945929,TRX_N-00280-03379621,2022-08-28T15:05:28,Zarautz,expenses,clothing,-159.16,-14868.6
buyer_2,Carmen,,ES84209577803377945929,TRX_N-00281-81735716,2022-08-28T18:04:56,Zarautz,expenses,healthcare,-109.56,-14978.16
buyer_2,Carmen,,ES84209577803377945929,TRX_N-00282-22523006,2022-08-29T15:23:35,Zarautz,expenses,leisure,-43.85,-15022.01
buyer_2,Carmen,,ES84209577803377945929,TRX_N-00283-33812831,2022-09-01T17:24:11,Zarautz,incomes,salary,2001.24,-13020.77
buyer_2,Carmen,,ES84209577803377945929,TRX_N-00284-62431469,2022-09-01T10:49:32,Zarautz,expenses,food,-65.77,-13086.54
buyer_2,Carmen,,ES84209577803377945929,TRX_N-00285-93718367,2022-09-01T13:27:52,Zarautz,expenses,cash,-100.0,-13186.54
buyer_2,Carmen,,ES84209577803377945929,TRX_N-00286-24410069,2022-09-01T15:04:24,Zarautz,expenses,repairs,-229.64,-13416.18
buyer_2,Carmen,,ES84209577803377945929,TRX_N-00287-33771972,2022-09-02T14:14:47,Zarautz,expenses,leisure,-58.99,-13475.17
buyer_2,Carmen,,ES84209577803377945929,TRX_N-00288-34171884,2022-09-02T19:09:54,Zarautz,expenses,repairs,-326.91,-13802.08
buyer_2,Carmen,,ES84209577803377945929,TRX_N-00289-15348537,2022-09-04T18:07:42,Zarautz,expenses,mortgage,-869.67,-14671.75
buyer_2,Carmen,,ES84209577803377945929,TRX_N-00290-62930597,2022-09-04T17:32:53,Zarautz,expenses,transport,-49.07,-14720.82
buyer_2,Carmen,,ES84209577803377945929,TRX_N-00291-47730380,2022-09-07T10:02:50,Zarautz,expenses,repairs,-258.48,-14979.3
buyer_2,Carmen,,ES84209577803377945929,TRX_N-00292-92665815,2022-09-08T12:08:43,Zarautz,expenses,internet,-42.0,-15021.3
buyer_2,Carmen,,ES84209577803377945929,TRX_N-00293-59625806,2022-09-08T12:16:34,Zarautz,expenses,phone,-33.16,-15054.46
buyer_2,Carmen,,ES84209577803377945929,TRX_N-00294-99947890,2022-09-08T17:14:06,Zarautz,expenses,water,-25.18,-15079.64
buyer_2,Carmen,,ES84209577803377945929,TRX_N-00295-58687834,2022-09-08T14:19:28,Zarautz,expenses,electricity,-38.68,-15118.32
buyer_2,Carmen,,ES84209577803377945929,TRX_N-00296-64474275,2022-09-08T00:50:53,Zarautz,expenses,gas,-46.3,-15164.62
buyer_2,Carmen,,ES84209577803377945929,TRX_N-00297-15090410,2022-09-08T14:01:10,Zarautz,expenses,transport,-79.3,-15243.92
buyer_2,Carmen,,ES84209577803377945929,TRX_N-00298-02254843,2022-09-09T06:55:38,Zarautz,expenses,cash,-100.0,-15343.92
buyer_2,Carmen,,ES84209577803377945929,TRX_N-00299-49805359,2022-09-11T23:12:45,Zarautz,expenses,appliances,-394.21,-15738.13
buyer_2,Carmen,,ES84209577803377945929,TRX_N-00300-65999741,2022-09-12T18:02:01,Zarautz,expenses,repairs,-132.77,-15870.9
buyer_2,Carmen,,ES84209577803377945929,TRX_N-00301-21150198,2022-09-13T19:31:38,Zarautz,expenses,leisure,-67.42,-15938.32
buyer_2,Carmen,,ES84209577803377945929,TRX_N-00302-77269630,2022-09-13T20:12:48,Zarautz,expenses,clothing,-122.92,-16061.24
buyer_2,Carmen,,ES84209577803377945929,TRX_N-00303-68714542,2022-09-13T17:09:17,Zarautz,expenses,cash,-100.0,-16161.24
buyer_2,Carmen,,ES84209577803377945929,TRX_N-00304-66414963,2022-09-14T08:32:36,Zarautz,expenses,cash,-100.0,-16261.24
buyer_2,Carmen,,ES84209577803377945929,TRX_N-00305-64222016,2022-09-14T12:33:51,Vitoria-Gasteiz,expenses,gifts,-327.15,-16588.39
buyer_2,Carmen,,ES84209577803377945929,TRX_N-00306-26700649,2022-09-18T17:27:36,Zarautz,expenses,food,-99.9,-16688.29
buyer_2,Carmen,,ES84209577803377945929,TRX_N-00307-47402735,2022-09-19T17:09:17,Zarautz,expenses,gifts,-524.05,-17212.34
buyer_2,Carmen,,ES84209577803377945929,TRX_N-00308-27204154,2022-09-23T15:04:17,Zarautz,expenses,gifts,-392.73,-17605.07
buyer_2,Carmen,,ES84209577803377945929,TRX_N-00309-75998760,2022-09-25T23:27:36,Zarautz,expenses,repairs,-170.83,-17775.9
buyer_2,Carmen,,ES84209577803377945929,TRX_N-00310-93050816,2022-09-25T08:55:07,Zarautz,expenses,gifts,-617.69,-18393.59
buyer_2,Carmen,,ES84209577803377945929,TRX_N-00311-14477639,2022-09-28T14:04:09,Zarautz,expenses,food,-80.63,-18474.22
buyer_2,Carmen,,ES84209577803377945929,TRX_N-00312-06382319,2022-09-30T06:50:25,Zarautz,expenses,food,-114.11,-18588.33
buyer_2,Carmen,,ES84209577803377945929,TRX_N-00313-35758256,2022-09-30T22:30:03,Zarautz,expenses,repairs,-71.76,-18660.09
buyer_2,Carmen,,ES84209577803377945929,TRX_N-00314-28831160,2022-10-01T21:13:39,Zarautz,incomes,salary,2001.24,-16658.85
buyer_2,Carmen,,ES84209577803377945929,TRX_N-00315-92387731,2022-10-02T13:28:56,Getxo,expenses,appliances,-371.75,-17030.6
buyer_2,Carmen,,ES84209577803377945929,TRX_N-00316-10995904,2022-10-04T19:37:10,Zarautz,expenses,mortgage,-869.67,-17900.27
buyer_2,Carmen,,ES84209577803377945929,TRX_N-00317-49767803,2022-10-04T15:43:02,Zarautz,expenses,transport,-69.62,-17969.89
buyer_2,Carmen,,ES84209577803377945929,TRX_N-00318-69149492,2022-10-04T00:50:36,Sopela,expenses,repairs,-224.46,-18194.35
buyer_2,Carmen,,ES84209577803377945929,TRX_N-00319-60481697,2022-10-05T08:12:20,Zarautz,expenses,electricity,-67.57,-18261.92
buyer_2,Carmen,,ES84209577803377945929,TRX_N-00320-76766014,2022-10-05T23:46:27,Zarautz,expenses,food,-105.94,-18367.86
buyer_2,Carmen,,ES84209577803377945929,TRX_N-00321-40404709,2022-10-05T22:52:57,Zarautz,expenses,healthcare,-69.77,-18437.63
buyer_2,Carmen,,ES84209577803377945929,TRX_N-00322-17493162,2022-10-05T09:56:22,Zarautz,expenses,cash,-100.0,-18537.63
buyer_2,Carmen,,ES84209577803377945929,TRX_N-00323-84725575,2022-10-06T23:04:54,Zarautz,expenses,healthcare,-138.43,-18676.06
buyer_2,Carmen,,ES84209577803377945929,TRX_N-00324-61834006,2022-10-07T11:23:48,Zarautz,expenses,gas,-53.8,-18729.86
buyer_2,Carmen,,ES84209577803377945929,TRX_N-00325-65197347,2022-10-07T09:44:05,Zarautz,expenses,internet,-42.0,-18771.86
buyer_2,Carmen,,ES84209577803377945929,TRX_N-00326-45537295,2022-10-07T17:50:15,Bermeo,expenses,transport,-64.54,-18836.4
buyer_2,Carmen,,ES84209577803377945929,TRX_N-00327-15935286,2022-10-08T13:09:06,Zarautz,expenses,phone,-34.8,-18871.2
buyer_2,Carmen,,ES84209577803377945929,TRX_N-00328-67542942,2022-10-08T10:48:54,Zarautz,expenses,water,-25.63,-18896.83
buyer_2,Carmen,,ES84209577803377945929,TRX_N-00329-64980091,2022-10-09T19:10:25,Zarautz,expenses,food,-119.99,-19016.82
buyer_2,Carmen,,ES84209577803377945929,TRX_N-00330-26955281,2022-10-10T21:02:44,Zarautz,expenses,repairs,-208.84,-19225.66
buyer_2,Carmen,,ES84209577803377945929,TRX_N-00331-66118405,2022-10-11T11:49:06,Amurrio,expenses,transport,-65.73,-19291.39
buyer_2,Carmen,,ES84209577803377945929,TRX_N-00332-15515277,2022-10-11T15:28:44,Zarautz,expenses,cash,-100.0,-19391.39
buyer_2,Carmen,,ES84209577803377945929,TRX_N-00333-49719283,2022-10-13T22:30:52,Zarautz,expenses,food,-62.56,-19453.95
buyer_2,Carmen,,ES84209577803377945929,TRX_N-00334-32508661,2022-10-14T14:37:20,Zarautz,expenses,transport,-42.74,-19496.69
buyer_2,Carmen,,ES84209577803377945929,TRX_N-00335-83669793,2022-10-15T12:24:57,Zarautz,expenses,gifts,-151.63,-19648.32
buyer_2,Carmen,,ES84209577803377945929,TRX_N-00336-07378609,2022-10-16T03:30:51,Durango,expenses,leisure,-32.33,-19680.65
buyer_2,Carmen,,ES84209577803377945929,TRX_N-00337-89352699,2022-10-17T11:06:45,Zarautz,expenses,leisure,-22.64,-19703.29
buyer_2,Carmen,,ES84209577803377945929,TRX_N-00338-87943854,2022-10-17T21:49:30,Zarautz,expenses,education,-44.01,-19747.3
buyer_2,Carmen,,ES84209577803377945929,TRX_N-00339-87415265,2022-10-18T14:01:16,Zarautz,expenses,food,-69.03,-19816.33
buyer_2,Carmen,,ES84209577803377945929,TRX_N-00340-75455121,2022-10-18T12:18:36,Zarautz,expenses,children,-195.36,-20011.69
buyer_2,Carmen,,ES84209577803377945929,TRX_N-00341-64490392,2022-10-19T12:33:19,Zarautz,expenses,healthcare,-119.57,-20131.26
buyer_2,Carmen,,ES84209577803377945929,TRX_N-00342-04979317,2022-10-20T13:24:31,Zarautz,expenses,food,-104.47,-20235.73
buyer_2,Carmen,,ES84209577803377945929,TRX_N-00343-22546451,2022-10-21T10:26:26,Zarautz,expenses,clothing,-137.01,-20372.74
buyer_2,Carmen,,ES84209577803377945929,TRX_N-00344-29253019,2022-10-23T01:13:51,Lasarte-Oria,expenses,healthcare,-65.35,-20438.09
buyer_2,Carmen,,ES84209577803377945929,TRX_N-00345-29513243,2022-10-23T21:33:21,Zarautz,expenses,gifts,-467.13,-20905.22
buyer_2,Carmen,,ES84209577803377945929,TRX_N-00346-15319162,2022-10-27T18:58:18,Zarautz,expenses,education,-75.4,-20980.62
buyer_2,Carmen,,ES84209577803377945929,TRX_N-00347-52834249,2022-10-29T00:17:26,Zarautz,expenses,leisure,-49.99,-21030.61
buyer_2,Carmen,,ES84209577803377945929,TRX_N-00348-94715248,2022-10-29T09:00:41,Zarautz,expenses,repairs,-266.13,-21296.74
buyer_2,Carmen,,ES84209577803377945929,TRX_N-00349-35662785,2022-10-30T19:47:30,Zarautz,expenses,transport,-88.18,-21384.92
buyer_2,Carmen,,ES84209577803377945929,TRX_N-00350-92412684,2022-10-31T13:18:29,Oyón-Oion,expenses,education,-51.2,-21436.12
buyer_2,Carmen,,ES84209577803377945929,TRX_N-00351-07594758,2022-10-31T19:47:20,Zarautz,expenses,cash,-100.0,-21536.12
buyer_2,Carmen,,ES84209577803377945929,TRX_N-00352-65301444,2022-11-01T19:50:30,Zarautz,incomes,salary,2001.24,-19534.88
buyer_2,Carmen,,ES84209577803377945929,TRX_N-00353-53558880,2022-11-01T19:50:30,Zarautz,incomes,extra_income,317.86,-19217.02
buyer_2,Carmen,,ES84209577803377945929,TRX_N-00354-61056990,2022-11-01T23:20:19,Labastida,expenses,cash,-100.0,-19317.02
buyer_2,Carmen,,ES84209577803377945929,TRX_N-00355-22440032,2022-11-02T22:17:57,Zarautz,expenses,gifts,-415.51,-19732.53
buyer_2,Carmen,,ES84209577803377945929,TRX_N-00356-75842460,2022-11-03T09:42:43,Zarautz,expenses,food,-102.02,-19834.55
buyer_2,Carmen,,ES84209577803377945929,TRX_N-00357-80685691,2022-11-03T13:49:27,Zarautz,expenses,transport,-64.57,-19899.12
buyer_2,Carmen,,ES84209577803377945929,TRX_N-00358-98409353,2022-11-03T13:50:00,Zarautz,expenses,leisure,-24.27,-19923.39
buyer_2,Carmen,,ES84209577803377945929,TRX_N-00359-33195344,2022-11-03T09:04:18,Zarautz,expenses,cash,-100.0,-20023.39
buyer_2,Carmen,,ES84209577803377945929,TRX_N-00360-95619172,2022-11-04T08:37:16,Zarautz,expenses,mortgage,-869.67,-20893.06
buyer_2,Carmen,,ES84209577803377945929,TRX_N-00361-29158412,2022-11-04T17:44:29,Galdakao,expenses,cash,-100.0,-20993.06
buyer_2,Carmen,,ES84209577803377945929,TRX_N-00362-29614705,2022-11-05T20:39:04,Zarautz,expenses,internet,-42.0,-21035.06
buyer_2,Carmen,,ES84209577803377945929,TRX_N-00363-42023247,2022-11-05T11:12:17,Zarautz,expenses,leisure,-73.59,-21108.65
buyer_2,Carmen,,ES84209577803377945929,TRX_N-00364-57987515,2022-11-06T14:57:05,Zarautz,expenses,water,-26.83,-21135.48
buyer_2,Carmen,,ES84209577803377945929,TRX_N-00365-90326330,2022-11-06T17:23:48,Zarautz,expenses,electricity,-51.23,-21186.71
buyer_2,Carmen,,ES84209577803377945929,TRX_N-00366-28481606,2022-11-06T13:12:42,Zarautz,expenses,cash,-100.0,-21286.71
buyer_2,Carmen,,ES84209577803377945929,TRX_N-00367-48456029,2022-11-07T15:19:43,Zarautz,expenses,phone,-35.93,-21322.64
buyer_2,Carmen,,ES84209577803377945929,TRX_N-00368-50275561,2022-11-07T20:00:08,Zarautz,expenses,children,-715.47,-22038.11
buyer_2,Carmen,,ES84209577803377945929,TRX_N-00369-42620815,2022-11-08T09:50:17,Zarautz,expenses,gas,-64.05,-22102.16
buyer_2,Carmen,,ES84209577803377945929,TRX_N-00370-02126978,2022-11-10T17:43:18,Irun,expenses,cash,-100.0,-22202.16
buyer_2,Carmen,,ES84209577803377945929,TRX_N-00371-43245939,2022-11-10T16:36:23,Zarautz,expenses,gifts,-214.66,-22416.82
buyer_2,Carmen,,ES84209577803377945929,TRX_N-00372-65727128,2022-11-11T16:42:46,Zarautz,expenses,clothing,-107.82,-22524.64
buyer_2,Carmen,,ES84209577803377945929,TRX_N-00373-80685662,2022-11-12T01:49:44,Durango,expenses,leisure,-76.63,-22601.27
buyer_2,Carmen,,ES84209577803377945929,TRX_N-00374-24792869,2022-11-12T17:15:44,Zarautz,expenses,cash,-100.0,-22701.27
buyer_2,Carmen,,ES84209577803377945929,TRX_N-00375-05716142,2022-11-13T12:08:59,Zarautz,expenses,transport,-69.2,-22770.47
buyer_2,Carmen,,ES84209577803377945929,TRX_N-00376-14074915,2022-11-13T08:12:30,Sestao,expenses,cash,-100.0,-22870.47
buyer_2,Carmen,,ES84209577803377945929,TRX_N-00377-74673836,2022-11-13T20:31:43,Zarautz,expenses,gifts,-127.98,-22998.45
buyer_2,Carmen,,ES84209577803377945929,TRX_N-00378-37855994,2022-11-14T23:01:41,Elciego,expenses,food,-118.6,-23117.05
buyer_2,Carmen,,ES84209577803377945929,TRX_N-00379-15206760,2022-11-15T05:50:15,Zarautz,expenses,leisure,-34.74,-23151.79
buyer_2,Carmen,,ES84209577803377945929,TRX_N-00380-23167799,2022-11-16T13:57:11,Zarautz,expenses,repairs,-287.69,-23439.48
buyer_2,Carmen,,ES84209577803377945929,TRX_N-00381-44807941,2022-11-17T10:19:20,Zarautz,expenses,leisure,-39.42,-23478.9
buyer_2,Carmen,,ES84209577803377945929,TRX_N-00382-05046173,2022-11-17T17:44:51,Zarautz,expenses,cash,-100.0,-23578.9
buyer_2,Carmen,,ES84209577803377945929,TRX_N-00383-35671775,2022-11-18T01:48:07,Zarautz,expenses,cash,-100.0,-23678.9
buyer_2,Carmen,,ES84209577803377945929,TRX_N-00384-51641414,2022-11-19T17:54:59,Andoain,expenses,appliances,-352.97,-24031.87
buyer_2,Carmen,,ES84209577803377945929,TRX_N-00385-96153381,2022-11-21T11:28:50,Barakaldo,expenses,travel,-779.05,-24810.92
buyer_2,Carmen,,ES84209577803377945929,TRX_N-00386-43837374,2022-11-27T11:26:46,Zarautz,expenses,leisure,-45.41,-24856.33
buyer_2,Carmen,,ES84209577803377945929,TRX_N-00387-88861489,2022-11-28T09:18:05,Zarautz,expenses,transport,-64.61,-24920.94
buyer_2,Carmen,,ES84209577803377945929,TRX_N-00388-86618828,2022-11-29T20:51:42,Zarautz,expenses,leisure,-37.94,-24958.88
buyer_2,Carmen,,ES84209577803377945929,TRX_N-00389-69770657,2022-11-29T18:25:54,Andoain,expenses,cash,-100.0,-25058.88
buyer_2,Carmen,,ES84209577803377945929,TRX_N-00390-04451754,2022-11-30T09:37:26,Zarautz,expenses,leisure,-35.16,-25094.04
buyer_2,Carmen,,ES84209577803377945929,TRX_N-00391-67471743,2022-11-30T07:21:06,Zarautz,expenses,healthcare,-167.38,-25261.42
buyer_2,Carmen,,ES84209577803377945929,TRX_N-00392-75710891,2022-11-30T13:44:48,Zarautz,expenses,children,-665.6,-25927.02
buyer_2,Carmen,,ES84209577803377945929,TRX_N-00393-68552210,2022-12-01T06:43:43,Zarautz,incomes,salary,2001.24,-23925.78
buyer_2,Carmen,,ES84209577803377945929,TRX_N-00394-99547058,2022-12-01T06:43:43,Zarautz,incomes,salary_bonus,1577.08,-22348.7
buyer_2,Carmen,,ES84209577803377945929,TRX_N-00395-57855206,2022-12-04T21:25:49,Zarautz,expenses,mortgage,-869.67,-23218.37
buyer_2,Carmen,,ES84209577803377945929,TRX_N-00396-45739940,2022-12-04T11:53:19,Zarautz,expenses,children,-370.5,-23588.87
buyer_2,Carmen,,ES84209577803377945929,TRX_N-00397-78379228,2022-12-05T13:38:56,Zarautz,expenses,internet,-42.0,-23630.87
buyer_2,Carmen,,ES84209577803377945929,TRX_N-00398-45915977,2022-12-06T11:59:22,Zarautz,expenses,electricity,-64.71,-23695.58
buyer_2,Carmen,,ES84209577803377945929,TRX_N-00399-77298007,2022-12-06T20:33:53,Zarautz,expenses,gas,-80.67,-23776.25
buyer_2,Carmen,,ES84209577803377945929,TRX_N-00400-44131008,2022-12-06T12:58:09,Zarautz,expenses,food,-104.2,-23880.45
buyer_2,Carmen,,ES84209577803377945929,TRX_N-00401-06024906,2022-12-08T12:33:59,Zarautz,expenses,water,-22.99,-23903.44
buyer_2,Carmen,,ES84209577803377945929,TRX_N-00402-79544905,2022-12-08T15:23:03,Zarautz,expenses,phone,-32.36,-23935.8
buyer_2,Carmen,,ES84209577803377945929,TRX_N-00403-70604892,2022-12-09T11:49:12,Zarautz,expenses,food,-106.43,-24042.23
buyer_2,Carmen,,ES84209577803377945929,TRX_N-00404-91179004,2022-12-10T15:25:56,Zarautz,expenses,food,-107.79,-24150.02
buyer_2,Carmen,,ES84209577803377945929,TRX_N-00405-75841975,2022-12-10T12:53:18,Donostia,expenses,transport,-63.27,-24213.29
buyer_2,Carmen,,ES84209577803377945929,TRX_N-00406-54339328,2022-12-12T12:41:08,Zarautz,expenses,food,-112.61,-24325.9
buyer_2,Carmen,,ES84209577803377945929,TRX_N-00407-14576695,2022-12-14T16:01:49,Zarautz,expenses,food,-70.37,-24396.27
buyer_2,Carmen,,ES84209577803377945929,TRX_N-00408-34301352,2022-12-14T12:49:17,Zarautz,expenses,transport,-59.46,-24455.73
buyer_2,Carmen,,ES84209577803377945929,TRX_N-00409-15604681,2022-12-14T10:13:48,Zarautz,expenses,leisure,-67.43,-24523.16
buyer_2,Carmen,,ES84209577803377945929,TRX_N-00410-50632918,2022-12-15T12:09:19,Bermeo,expenses,leisure,-58.04,-24581.2
buyer_2,Carmen,,ES84209577803377945929,TRX_N-00411-25827238,2022-12-15T01:14:32,Zarautz,expenses,repairs,-260.88,-24842.08
buyer_2,Carmen,,ES84209577803377945929,TRX_N-00412-57988112,2022-12-16T19:28:46,Zarautz,expenses,cash,-100.0,-24942.08
buyer_2,Carmen,,ES84209577803377945929,TRX_N-00413-38539712,2022-12-16T12:24:11,Zarautz,expenses,children,-531.52,-25473.6
buyer_2,Carmen,,ES84209577803377945929,TRX_N-00414-73717967,2022-12-17T10:59:26,Zarautz,expenses,leisure,-18.56,-25492.16
buyer_2,Carmen,,ES84209577803377945929,TRX_N-00415-52222793,2022-12-17T11:55:17,Zarautz,expenses,clothing,-48.95,-25541.11
buyer_2,Carmen,,ES84209577803377945929,TRX_N-00416-96419328,2022-12-18T19:05:51,Zarautz,expenses,leisure,-71.37,-25612.48
buyer_2,Carmen,,ES84209577803377945929,TRX_N-00417-14608380,2022-12-18T17:45:56,Zarautz,expenses,clothing,-90.14,-25702.62
buyer_2,Carmen,,ES84209577803377945929,TRX_N-00418-95306031,2022-12-19T16:29:43,Zarautz,expenses,transport,-71.08,-25773.7
buyer_2,Carmen,,ES84209577803377945929,TRX_N-00419-07451752,2022-12-19T19:04:23,Zarautz,expenses,cash,-100.0,-25873.7
buyer_2,Carmen,,ES84209577803377945929,TRX_N-00420-32238147,2022-12-20T17:42:30,Zarautz,expenses,cash,-100.0,-25973.7
buyer_2,Carmen,,ES84209577803377945929,TRX_N-00421-93481205,2022-12-20T13:35:56,Zarautz,expenses,gifts,-824.96,-26798.66
buyer_2,Carmen,,ES84209577803377945929,TRX_N-00422-35433544,2022-12-21T14:13:49,Sopela,expenses,leisure,-43.79,-26842.45
buyer_2,Carmen,,ES84209577803377945929,TRX_N-00423-36952715,2022-12-21T16:16:06,Zarautz,expenses,cash,-100.0,-26942.45
buyer_2,Carmen,,ES84209577803377945929,TRX_N-00424-97404652,2022-12-22T14:12:43,Zarautz,expenses,appliances,-246.23,-27188.68
buyer_2,Carmen,,ES84209577803377945929,TRX_N-00425-93487002,2022-12-23T17:50:01,Zarautz,expenses,food,-75.69,-27264.37
buyer_2,Carmen,,ES84209577803377945929,TRX_N-00426-41753889,2022-12-23T08:33:54,Zarautz,expenses,cash,-100.0,-27364.37
buyer_2,Carmen,,ES84209577803377945929,TRX_N-00427-58206811,2022-12-24T22:30:01,Lasarte-Oria,expenses,clothing,-119.24,-27483.61
buyer_2,Carmen,,ES84209577803377945929,TRX_N-00428-89539266,2022-12-24T10:23:59,Zarautz,expenses,children,-461.58,-27945.19
buyer_2,Carmen,,ES84209577803377945929,TRX_N-00429-22712875,2022-12-25T23:02:27,Zarautz,expenses,transport,-66.85,-28012.04
buyer_2,Carmen,,ES84209577803377945929,TRX_N-00430-90367352,2022-12-26T09:56:37,Hernani,expenses,appliances,-394.4,-28406.44
buyer_2,Carmen,,ES84209577803377945929,TRX_N-00431-05310897,2022-12-27T00:50:40,Zarautz,expenses,repairs,-186.64,-28593.08
buyer_2,Carmen,,ES84209577803377945929,TRX_N-00432-68790358,2022-12-28T19:42:44,Barakaldo,expenses,clothing,-151.93,-28745.01
buyer_2,Carmen,,ES84209577803377945929,TRX_N-00433-86566929,2022-12-28T12:54:52,Bermeo,expenses,gifts,-101.7,-28846.71
buyer_2,Carmen,,ES84209577803377945929,TRX_N-00434-06156757,2022-12-29T10:48:01,Zarautz,expenses,cash,-100.0,-28946.71
buyer_2,Carmen,,ES84209577803377945929,TRX_N-00435-61367817,2022-12-29T21:39:26,Zarautz,expenses,gifts,-462.95,-29409.66
buyer_2,Carmen,,ES84209577803377945929,TRX_N-00436-98703457,2022-12-31T18:35:06,Zarautz,expenses,education,-77.9,-29487.56
buyer_2,Carmen,,ES84209577803377945929,TRX_N-00437-24266699,2023-01-01T20:17:36,Zarautz,incomes,salary,2048.46,-27439.1
buyer_2,Carmen,,ES84209577803377945929,TRX_N-00438-06935851,2023-01-01T05:00:35,Zarautz,expenses,cash,-100.0,-27539.1
buyer_2,Carmen,,ES84209577803377945929,TRX_N-00439-95550144,2023-01-03T20:48:29,Zarautz,expenses,food,-92.73,-27631.83
buyer_2,Carmen,,ES84209577803377945929,TRX_N-00440-99480049,2023-01-03T13:12:48,Zarautz,expenses,repairs,-325.55,-27957.38
buyer_2,Carmen,,ES84209577803377945929,TRX_N-00441-44386012,2023-01-03T18:43:20,Zarautz,expenses,gifts,-844.61,-28801.99
buyer_2,Carmen,,ES84209577803377945929,TRX_N-00442-97790150,2023-01-04T16:34:22,Zarautz,expenses,mortgage,-869.67,-29671.66
buyer_2,Carmen,,ES84209577803377945929,TRX_N-00443-95549044,2023-01-05T08:04:35,Zarautz,expenses,water,-22.38,-29694.04
buyer_2,Carmen,,ES84209577803377945929,TRX_N-00444-41575521,2023-01-05T13:34:04,Zarautz,expenses,electricity,-36.99,-29731.03
buyer_2,Carmen,,ES84209577803377945929,TRX_N-00445-61803955,2023-01-05T08:49:25,Zarautz,expenses,gas,-61.23,-29792.26
buyer_2,Carmen,,ES84209577803377945929,TRX_N-00446-08495819,2023-01-06T09:49:08,Zarautz,expenses,phone,-33.21,-29825.47
buyer_2,Carmen,,ES84209577803377945929,TRX_N-00447-78985208,2023-01-06T21:28:10,Zarautz,expenses,clothing,-132.39,-29957.86
buyer_2,Carmen,,ES84209577803377945929,TRX_N-00448-44332529,2023-01-06T14:39:27,Zarautz,expenses,appliances,-98.27,-30056.13
buyer_2,Carmen,,ES84209577803377945929,TRX_N-00449-00394082,2023-01-07T09:26:48,Zarautz,expenses,food,-75.76,-30131.89
buyer_2,Carmen,,ES84209577803377945929,TRX_N-00450-97145516,2023-01-08T13:55:59,Zarautz,expenses,internet,-42.0,-30173.89
buyer_2,Carmen,,ES84209577803377945929,TRX_N-00451-76856249,2023-01-08T21:05:57,Zarautz,expenses,appliances,-393.9,-30567.79
buyer_2,Carmen,,ES84209577803377945929,TRX_N-00452-36914319,2023-01-09T12:49:11,Zarautz,expenses,food,-79.8,-30647.59
buyer_2,Carmen,,ES84209577803377945929,TRX_N-00453-77044299,2023-01-10T17:11:42,Zarautz,expenses,transport,-47.63,-30695.22
buyer_2,Carmen,,ES84209577803377945929,TRX_N-00454-62687046,2023-01-11T08:52:52,Zarautz,expenses,children,-402.3,-31097.52
buyer_2,Carmen,,ES84209577803377945929,TRX_N-00455-87985260,2023-01-15T13:24:50,Zarautz,expenses,children,-260.18,-31357.7
buyer_2,Carmen,,ES84209577803377945929,TRX_N-00456-87442171,2023-01-16T08:05:15,Zarautz,expenses,food,-67.21,-31424.91
buyer_2,Carmen,,ES84209577803377945929,TRX_N-00457-07060519,2023-01-16T09:38:52,Zarautz,expenses,transport,-56.38,-31481.29
buyer_2,Carmen,,ES84209577803377945929,TRX_N-00458-60487268,2023-01-16T13:54:00,Zarautz,expenses,cash,-100.0,-31581.29
buyer_2,Carmen,,ES84209577803377945929,TRX_N-00459-72611888,2023-01-17T14:06:44,Zarautz,expenses,repairs,-104.61,-31685.9
buyer_2,Carmen,,ES84209577803377945929,TRX_N-00460-21894357,2023-01-18T13:54:04,Zarautz,expenses,education,-66.36,-31752.26
buyer_2,Carmen,,ES84209577803377945929,TRX_N-00461-11212077,2023-01-19T20:06:43,Zarautz,expenses,leisure,-58.9,-31811.16
buyer_2,Carmen,,ES84209577803377945929,TRX_N-00462-92433545,2023-01-19T18:14:56,Zarautz,expenses,cash,-100.0,-31911.16
buyer_2,Carmen,,ES84209577803377945929,TRX_N-00463-42866000,2023-01-21T14:39:10,Donostia,expenses,leisure,-55.54,-31966.7
buyer_2,Carmen,,ES84209577803377945929,TRX_N-00464-31408462,2023-01-21T15:52:17,Zarautz,expenses,cash,-100.0,-32066.7
buyer_2,Carmen,,ES84209577803377945929,TRX_N-00465-62401572,2023-01-22T10:33:07,Zarautz,expenses,travel,-772.64,-32839.34
buyer_2,Carmen,,ES84209577803377945929,TRX_N-00466-42498346,2023-01-22T23:25:17,Zarautz,expenses,repairs,-285.44,-33124.78
buyer_2,Carmen,,ES84209577803377945929,TRX_N-00467-45256595,2023-01-24T10:37:55,Zarautz,expenses,cash,-100.0,-33224.78
buyer_2,Carmen,,ES84209577803377945929,TRX_N-00468-49110252,2023-01-25T18:04:34,Zarautz,expenses,cash,-100.0,-33324.78
buyer_2,Carmen,,ES84209577803377945929,TRX_N-00469-19757895,2023-01-29T11:38:38,Zarautz,expenses,cash,-100.0,-33424.78
buyer_2,Carmen,,ES84209577803377945929,TRX_N-00470-71320426,2023-02-01T14:06:36,Zarautz,incomes,salary,2048.46,-31376.32
buyer_2,Carmen,,ES84209577803377945929,TRX_N-00471-12583328,2023-02-01T09:30:44,Zarautz,expenses,food,-112.35,-31488.67
buyer_2,Carmen,,ES84209577803377945929,TRX_N-00472-41085814,2023-02-02T12:02:06,Zarautz,expenses,appliances,-269.43,-31758.1
buyer_2,Carmen,,ES84209577803377945929,TRX_N-00473-33341929,2023-02-03T08:22:23,Lasarte-Oria,expenses,transport,-42.43,-31800.53
buyer_2,Carmen,,ES84209577803377945929,TRX_N-00474-81881345,2023-02-04T13:18:16,Zarautz,expenses,mortgage,-869.67,-32670.2
buyer_2,Carmen,,ES84209577803377945929,TRX_N-00475-76533219,2023-02-05T20:17:53,Zarautz,expenses,water,-21.32,-32691.52
buyer_2,Carmen,,ES84209577803377945929,TRX_N-00476-32453047,2023-02-05T20:17:47,Zarautz,expenses,gas,-56.53,-32748.05
buyer_2,Carmen,,ES84209577803377945929,TRX_N-00477-94779370,2023-02-05T20:02:39,Zarautz,expenses,internet,-42.0,-32790.05
buyer_2,Carmen,,ES84209577803377945929,TRX_N-00478-48511437,2023-02-05T12:17:01,Zarautz,expenses,phone,-41.54,-32831.59
buyer_2,Carmen,,ES84209577803377945929,TRX_N-00479-31959708,2023-02-06T16:12:46,Leioa,expenses,food,-72.89,-32904.48
buyer_2,Carmen,,ES84209577803377945929,TRX_N-00480-76696446,2023-02-07T17:40:13,Zarautz,expenses,electricity,-67.11,-32971.59
buyer_2,Carmen,,ES84209577803377945929,TRX_N-00481-68850946,2023-02-08T19:35:33,Zarautz,expenses,clothing,-136.3,-33107.89
buyer_2,Carmen,,ES84209577803377945929,TRX_N-00482-36010032,2023-02-09T19:49:48,Zarautz,expenses,children,-342.47,-33450.36
buyer_2,Carmen,,ES84209577803377945929,TRX_N-00483-79343299,2023-02-13T21:59:44,Getxo,expenses,cash,-100.0,-33550.36
buyer_2,Carmen,,ES84209577803377945929,TRX_N-00484-36279155,2023-02-15T16:07:30,Zarautz,expenses,food,-82.02,-33632.38
buyer_2,Carmen,,ES84209577803377945929,TRX_N-00485-60891588,2023-02-15T20:25:44,Zarautz,expenses,leisure,-29.06,-33661.44
buyer_2,Carmen,,ES84209577803377945929,TRX_N-00486-71143801,2023-02-15T20:14:07,Zarautz,expenses,children,-310.93,-33972.37
buyer_2,Carmen,,ES84209577803377945929,TRX_N-00487-27285667,2023-02-21T15:36:49,Zarautz,expenses,cash,-100.0,-34072.37
buyer_2,Carmen,,ES84209577803377945929,TRX_N-00488-72538340,2023-02-24T08:06:22,Zarautz,expenses,cash,-100.0,-34172.37
buyer_2,Carmen,,ES84209577803377945929,TRX_N-00489-15491855,2023-02-25T19:06:25,Zarautz,expenses,education,-65.81,-34238.18
buyer_2,Carmen,,ES84209577803377945929,TRX_N-00490-25129828,2023-02-26T08:32:46,Zarautz,expenses,cash,-100.0,-34338.18
buyer_2,Carmen,,ES84209577803377945929,TRX_N-00491-94305094,2023-02-27T23:53:04,Zarautz,expenses,travel,-1633.92,-35972.1
buyer_2,Carmen,,ES84209577803377945929,TRX_N-00492-00143974,2023-03-01T19:03:52,Zarautz,incomes,salary,2048.46,-33923.64
buyer_2,Carmen,,ES84209577803377945929,TRX_N-00493-83223255,2023-03-01T19:03:52,Zarautz,incomes,extra_income,317.86,-33605.78
buyer_2,Carmen,,ES84209577803377945929,TRX_N-00494-73123389,2023-03-01T07:50:35,Zarautz,expenses,food,-109.54,-33715.32
buyer_2,Carmen,,ES84209577803377945929,TRX_N-00495-60417660,2023-03-03T11:54:36,Alegría-Dulantzi,expenses,leisure,-72.11,-33787.43
buyer_2,Carmen,,ES84209577803377945929,TRX_N-00496-35329746,2023-03-03T15:31:51,Mungia,expenses,healthcare,-91.33,-33878.76
buyer_2,Carmen,,ES84209577803377945929,TRX_N-00497-04996218,2023-03-03T13:52:47,Zarautz,expenses,education,-42.97,-33921.73
buyer_2,Carmen,,ES84209577803377945929,TRX_N-00498-38138890,2023-03-03T20:15:23,Zarautz,expenses,gifts,-822.88,-34744.61
buyer_2,Carmen,,ES84209577803377945929,TRX_N-00499-97445912,2023-03-04T14:41:17,Zarautz,expenses,mortgage,-869.67,-35614.28
buyer_2,Carmen,,ES84209577803377945929,TRX_N-00500-18204900,2023-03-05T09:28:42,Zarautz,expenses,water,-40.75,-35655.03
buyer_2,Carmen,,ES84209577803377945929,TRX_N-00501-30047288,2023-03-05T20:24:01,Zarautz,expenses,electricity,-37.72,-35692.75
buyer_2,Carmen,,ES84209577803377945929,TRX_N-00502-01655114,2023-03-07T12:33:30,Zarautz,expenses,internet,-42.0,-35734.75
buyer_2,Carmen,,ES84209577803377945929,TRX_N-00503-85357718,2023-03-08T03:00:03,Zarautz,expenses,gas,-49.56,-35784.31
buyer_2,Carmen,,ES84209577803377945929,TRX_N-00504-04039213,2023-03-08T22:39:45,Zarautz,expenses,phone,-40.21,-35824.52
buyer_2,Carmen,,ES84209577803377945929,TRX_N-00505-38566227,2023-03-09T15:48:17,Basauri,expenses,appliances,-226.67,-36051.19
buyer_2,Carmen,,ES84209577803377945929,TRX_N-00506-65587422,2023-03-10T19:37:12,Galdakao,expenses,cash,-100.0,-36151.19
buyer_2,Carmen,,ES84209577803377945929,TRX_N-00507-93422228,2023-03-11T19:19:26,Erandio,expenses,leisure,-22.62,-36173.81
buyer_2,Carmen,,ES84209577803377945929,TRX_N-00508-36810116,2023-03-13T15:12:39,Zarautz,expenses,leisure,-59.02,-36232.83
buyer_2,Carmen,,ES84209577803377945929,TRX_N-00509-81495016,2023-03-14T17:50:24,Zarautz,expenses,transport,-54.57,-36287.4
buyer_2,Carmen,,ES84209577803377945929,TRX_N-00510-09940314,2023-03-14T19:08:19,Zarautz,expenses,leisure,-57.92,-36345.32
buyer_2,Carmen,,ES84209577803377945929,TRX_N-00511-40344283,2023-03-14T09:45:01,Zarautz,expenses,clothing,-76.21,-36421.53
buyer_2,Carmen,,ES84209577803377945929,TRX_N-00512-07353384,2023-03-15T11:28:19,Zarautz,expenses,transport,-62.71,-36484.24
buyer_2,Carmen,,ES84209577803377945929,TRX_N-00513-08075873,2023-03-15T09:48:21,Zarautz,expenses,healthcare,-96.26,-36580.5
buyer_2,Carmen,,ES84209577803377945929,TRX_N-00514-24618482,2023-03-15T09:13:05,Zarautz,expenses,cash,-100.0,-36680.5
buyer_2,Carmen,,ES84209577803377945929,TRX_N-00515-00310465,2023-03-15T17:01:48,Zarautz,expenses,repairs,-31.03,-36711.53
buyer_2,Carmen,,ES84209577803377945929,TRX_N-00516-04337045,2023-03-16T15:53:39,Zarautz,expenses,education,-43.48,-36755.01
buyer_2,Carmen,,ES84209577803377945929,TRX_N-00517-04954515,2023-03-16T16:48:57,Zarautz,expenses,cash,-100.0,-36855.01
buyer_2,Carmen,,ES84209577803377945929,TRX_N-00518-26637471,2023-03-17T08:10:34,Sopela,expenses,transport,-44.17,-36899.18
buyer_2,Carmen,,ES84209577803377945929,TRX_N-00519-55936253,2023-03-17T15:56:05,Zarautz,expenses,leisure,-42.99,-36942.17
buyer_2,Carmen,,ES84209577803377945929,TRX_N-00520-53727100,2023-03-20T12:39:31,Zarautz,expenses,education,-44.0,-36986.17
buyer_2,Carmen,,ES84209577803377945929,TRX_N-00521-53177957,2023-03-20T14:21:24,Hondarribia,expenses,cash,-100.0,-37086.17
buyer_2,Carmen,,ES84209577803377945929,TRX_N-00522-87205392,2023-03-21T08:27:13,Sopela,expenses,transport,-43.17,-37129.34
buyer_2,Carmen,,ES84209577803377945929,TRX_N-00523-37709897,2023-03-23T19:57:20,Zarautz,expenses,education,-63.49,-37192.83
buyer_2,Carmen,,ES84209577803377945929,TRX_N-00524-81543831,2023-03-23T12:20:16,Zarautz,expenses,cash,-100.0,-37292.83
buyer_2,Carmen,,ES84209577803377945929,TRX_N-00525-58662796,2023-03-27T18:45:44,Zarautz,expenses,transport,-58.61,-37351.44
buyer_2,Carmen,,ES84209577803377945929,TRX_N-00526-46585739,2023-03-27T19:38:36,Zarautz,expenses,cash,-100.0,-37451.44
buyer_2,Carmen,,ES84209577803377945929,TRX_N-00527-25660852,2023-03-28T15:29:05,Zarautz,expenses,cash,-100.0,-37551.44
buyer_2,Carmen,,ES84209577803377945929,TRX_N-00528-67083331,2023-03-29T14:25:17,Zarautz,expenses,cash,-100.0,-37651.44
buyer_2,Carmen,,ES84209577803377945929,TRX_N-00529-22710751,2023-03-31T19:31:11,Zarautz,expenses,leisure,-82.62,-37734.06
buyer_2,Carmen,,ES84209577803377945929,TRX_N-00530-57084032,2023-03-31T08:23:41,Arrasate,expenses,gifts,-429.11,-38163.17
buyer_2,Carmen,,ES84209577803377945929,TRX_N-00531-66042508,2023-04-01T18:25:50,Zarautz,incomes,salary,2048.46,-36114.71
buyer_2,Carmen,,ES84209577803377945929,TRX_N-00532-43758974,2023-04-03T18:25:55,Zarautz,expenses,appliances,-366.53,-36481.24
buyer_2,Carmen,,ES84209577803377945929,TRX_N-00533-72098435,2023-04-04T19:52:05,Zarautz,expenses,mortgage,-869.67,-37350.91
buyer_2,Carmen,,ES84209577803377945929,TRX_N-00534-06290411,2023-04-04T13:08:34,Zarautz,expenses,food,-110.44,-37461.35
buyer_2,Carmen,,ES84209577803377945929,TRX_N-00535-89759567,2023-04-04T18:05:57,Zarautz,expenses,appliances,-356.85,-37818.2
buyer_2,Carmen,,ES84209577803377945929,TRX_N-00536-30070692,2023-04-05T10:16:49,Zarautz,expenses,food,-122.55,-37940.75
buyer_2,Carmen,,ES84209577803377945929,TRX_N-00537-57082771,2023-04-06T08:51:49,Zarautz,expenses,gas,-72.55,-38013.3
buyer_2,Carmen,,ES84209577803377945929,TRX_N-00538-78253235,2023-04-06T15:11:58,Zarautz,expenses,internet,-42.0,-38055.3
buyer_2,Carmen,,ES84209577803377945929,TRX_N-00539-25567490,2023-04-06T16:36:29,Zarautz,expenses,appliances,-373.21,-38428.51
buyer_2,Carmen,,ES84209577803377945929,TRX_N-00540-91256646,2023-04-07T09:29:59,Zarautz,expenses,phone,-43.96,-38472.47
buyer_2,Carmen,,ES84209577803377945929,TRX_N-00541-15251992,2023-04-08T12:01:15,Zarautz,expenses,water,-20.06,-38492.53
buyer_2,Carmen,,ES84209577803377945929,TRX_N-00542-29942704,2023-04-08T06:17:15,Zarautz,expenses,electricity,-78.0,-38570.53
buyer_2,Carmen,,ES84209577803377945929,TRX_N-00543-83870077,2023-04-08T13:27:48,Bermeo,expenses,cash,-100.0,-38670.53
buyer_2,Carmen,,ES84209577803377945929,TRX_N-00544-11696233,2023-04-08T20:38:41,Zarautz,expenses,appliances,-242.2,-38912.73
buyer_2,Carmen,,ES84209577803377945929,TRX_N-00545-62023587,2023-04-08T20:32:25,Zarautz,expenses,children,-526.29,-39439.02
buyer_2,Carmen,,ES84209577803377945929,TRX_N-00546-00787530,2023-04-09T08:40:23,Sopela,expenses,food,-81.52,-39520.54
buyer_2,Carmen,,ES84209577803377945929,TRX_N-00547-15709866,2023-04-12T13:37:35,Zarautz,expenses,transport,-51.82,-39572.36
buyer_2,Carmen,,ES84209577803377945929,TRX_N-00548-54464860,2023-04-12T18:54:01,Zarautz,expenses,leisure,-33.46,-39605.82
buyer_2,Carmen,,ES84209577803377945929,TRX_N-00549-82898545,2023-04-12T11:53:42,Zarautz,expenses,gifts,-261.65,-39867.47
buyer_2,Carmen,,ES84209577803377945929,TRX_N-00550-91413513,2023-04-13T14:51:17,Zarautz,expenses,cash,-100.0,-39967.47
buyer_2,Carmen,,ES84209577803377945929,TRX_N-00551-87320083,2023-04-15T17:02:12,Errenteria,expenses,transport,-59.08,-40026.55
buyer_2,Carmen,,ES84209577803377945929,TRX_N-00552-23896381,2023-04-16T20:20:11,Zarautz,expenses,food,-116.08,-40142.63
buyer_2,Carmen,,ES84209577803377945929,TRX_N-00553-14789104,2023-04-16T17:21:13,Zarautz,expenses,leisure,-84.47,-40227.1
buyer_2,Carmen,,ES84209577803377945929,TRX_N-00554-54769536,2023-04-16T21:08:43,Zarautz,expenses,gifts,-677.67,-40904.77
buyer_2,Carmen,,ES84209577803377945929,TRX_N-00555-90160074,2023-04-17T11:48:32,Zarautz,expenses,food,-121.89,-41026.66
buyer_2,Carmen,,ES84209577803377945929,TRX_N-00556-96660951,2023-04-17T13:10:22,Zarautz,expenses,repairs,-141.78,-41168.44
buyer_2,Carmen,,ES84209577803377945929,TRX_N-00557-53319529,2023-04-17T19:06:07,Zarautz,expenses,gifts,-515.53,-41683.97
buyer_2,Carmen,,ES84209577803377945929,TRX_N-00558-35500989,2023-04-18T14:47:10,Zarautz,expenses,healthcare,-41.23,-41725.2
buyer_2,Carmen,,ES84209577803377945929,TRX_N-00559-59082920,2023-04-18T10:20:52,Zarautz,expenses,repairs,-61.26,-41786.46
buyer_2,Carmen,,ES84209577803377945929,TRX_N-00560-33004123,2023-04-19T12:30:00,Zarautz,expenses,travel,-1553.5,-43339.96
buyer_2,Carmen,,ES84209577803377945929,TRX_N-00561-92575558,2023-04-21T14:03:48,Andoain,expenses,food,-73.35,-43413.31
buyer_2,Carmen,,ES84209577803377945929,TRX_N-00562-95318158,2023-04-21T08:11:28,Zarautz,expenses,leisure,-40.93,-43454.24
buyer_2,Carmen,,ES84209577803377945929,TRX_N-00563-65844814,2023-04-23T11:27:57,Zarautz,expenses,cash,-100.0,-43554.24
buyer_2,Carmen,,ES84209577803377945929,TRX_N-00564-69119418,2023-04-26T14:59:28,Irun,expenses,leisure,-72.76,-43627.0
buyer_2,Carmen,,ES84209577803377945929,TRX_N-00565-54059595,2023-04-27T18:39:45,Bilbao,expenses,food,-80.11,-43707.11
buyer_2,Carmen,,ES84209577803377945929,TRX_N-00566-06208804,2023-04-27T12:36:59,Zarautz,expenses,repairs,-28.94,-43736.05
buyer_2,Carmen,,ES84209577803377945929,TRX_N-00567-76690112,2023-04-28T08:31:40,Zarautz,expenses,food,-94.64,-43830.69
buyer_2,Carmen,,ES84209577803377945929,TRX_N-00568-93540146,2023-04-28T14:24:17,Zarautz,expenses,healthcare,-111.34,-43942.03
buyer_2,Carmen,,ES84209577803377945929,TRX_N-00569-70258045,2023-04-28T08:35:44,Zarautz,expenses,repairs,-301.97,-44244.0
buyer_2,Carmen,,ES84209577803377945929,TRX_N-00570-87259238,2023-04-29T11:25:33,Zarautz,expenses,food,-77.16,-44321.16
buyer_2,Carmen,,ES84209577803377945929,TRX_N-00571-78527820,2023-04-30T18:26:08,Zarautz,expenses,leisure,-74.0,-44395.16
buyer_2,Carmen,,ES84209577803377945929,TRX_N-00572-23141056,2023-04-30T15:01:01,Zarautz,expenses,cash,-100.0,-44495.16
buyer_2,Carmen,,ES84209577803377945929,TRX_N-00573-61274496,2023-05-01T19:51:36,Zarautz,incomes,salary,2048.46,-42446.7
buyer_2,Carmen,,ES84209577803377945929,TRX_N-00574-53109529,2023-05-01T23:42:12,Zarautz,expenses,appliances,-273.56,-42720.26
buyer_2,Carmen,,ES84209577803377945929,TRX_N-00575-94686303,2023-05-03T09:52:54,Zarautz,expenses,food,-61.83,-42782.09
buyer_2,Carmen,,ES84209577803377945929,TRX_N-00576-11747475,2023-05-03T09:32:17,Zarautz,expenses,transport,-87.06,-42869.15
buyer_2,Carmen,,ES84209577803377945929,TRX_N-00577-82311026,2023-05-04T12:14:50,Zarautz,expenses,mortgage,-869.67,-43738.82
buyer_2,Carmen,,ES84209577803377945929,TRX_N-00578-85453175,2023-05-04T08:15:14,Zarautz,expenses,children,-238.6,-43977.42
buyer_2,Carmen,,ES84209577803377945929,TRX_N-00579-01505540,2023-05-05T09:31:28,Zarautz,expenses,gas,-69.27,-44046.69
buyer_2,Carmen,,ES84209577803377945929,TRX_N-00580-78410114,2023-05-05T13:12:04,Eibar,expenses,cash,-100.0,-44146.69
buyer_2,Carmen,,ES84209577803377945929,TRX_N-00581-31218100,2023-05-06T12:09:14,Zarautz,expenses,gifts,-736.67,-44883.36
buyer_2,Carmen,,ES84209577803377945929,TRX_N-00582-40796176,2023-05-07T23:20:41,Zarautz,expenses,water,-29.19,-44912.55
buyer_2,Carmen,,ES84209577803377945929,TRX_N-00583-36783861,2023-05-07T10:26:02,Zarautz,expenses,internet,-42.0,-44954.55
buyer_2,Carmen,,ES84209577803377945929,TRX_N-00584-24842749,2023-05-07T23:02:50,Barakaldo,expenses,cash,-100.0,-45054.55
buyer_2,Carmen,,ES84209577803377945929,TRX_N-00585-26530146,2023-05-08T20:35:08,Zarautz,expenses,electricity,-33.39,-45087.94
buyer_2,Carmen,,ES84209577803377945929,TRX_N-00586-41646765,2023-05-08T10:08:14,Zarautz,expenses,phone,-43.65,-45131.59
buyer_2,Carmen,,ES84209577803377945929,TRX_N-00587-66949013,2023-05-10T12:08:36,Zarautz,expenses,cash,-100.0,-45231.59
buyer_2,Carmen,,ES84209577803377945929,TRX_N-00588-74569693,2023-05-13T16:23:26,Zarautz,expenses,clothing,-152.78,-45384.37
buyer_2,Carmen,,ES84209577803377945929,TRX_N-00589-66793466,2023-05-14T11:15:57,Zarautz,expenses,leisure,-19.85,-45404.22
buyer_2,Carmen,,ES84209577803377945929,TRX_N-00590-51202502,2023-05-15T19:17:57,Zarautz,expenses,children,-189.36,-45593.58
buyer_2,Carmen,,ES84209577803377945929,TRX_N-00591-46552127,2023-05-16T17:51:32,Zarautz,expenses,food,-79.39,-45672.97
buyer_2,Carmen,,ES84209577803377945929,TRX_N-00592-55993962,2023-05-16T10:27:13,Zarautz,expenses,leisure,-59.7,-45732.67
buyer_2,Carmen,,ES84209577803377945929,TRX_N-00593-81920509,2023-05-17T13:47:59,Amurrio,expenses,cash,-100.0,-45832.67
buyer_2,Carmen,,ES84209577803377945929,TRX_N-00594-02910953,2023-05-17T16:57:40,Zarautz,expenses,children,-455.21,-46287.88
buyer_2,Carmen,,ES84209577803377945929,TRX_N-00595-95564249,2023-05-19T08:03:18,Zarautz,expenses,food,-83.6,-46371.48
buyer_2,Carmen,,ES84209577803377945929,TRX_N-00596-93292574,2023-05-20T23:40:27,Zarautz,expenses,food,-115.33,-46486.81
buyer_2,Carmen,,ES84209577803377945929,TRX_N-00597-67563550,2023-05-20T20:45:48,Berango,expenses,transport,-89.88,-46576.69
buyer_2,Carmen,,ES84209577803377945929,TRX_N-00598-99654372,2023-05-24T09:31:20,Zarautz,expenses,food,-75.52,-46652.21
buyer_2,Carmen,,ES84209577803377945929,TRX_N-00599-41228496,2023-05-25T02:03:16,Zarautz,expenses,transport,-42.43,-46694.64
buyer_2,Carmen,,ES84209577803377945929,TRX_N-00600-98286467,2023-05-25T09:00:23,Zarautz,expenses,repairs,-208.86,-46903.5
buyer_2,Carmen,,ES84209577803377945929,TRX_N-00601-03723031,2023-05-26T17:17:23,Hondarribia,expenses,clothing,-76.54,-46980.04
buyer_2,Carmen,,ES84209577803377945929,TRX_N-00602-08811338,2023-05-27T16:36:19,Zarautz,expenses,clothing,-103.19,-47083.23
buyer_2,Carmen,,ES84209577803377945929,TRX_N-00603-05011219,2023-05-28T08:48:35,Zarautz,expenses,food,-120.08,-47203.31
buyer_2,Carmen,,ES84209577803377945929,TRX_N-00604-74385699,2023-05-28T19:45:05,Zarautz,expenses,children,-476.48,-47679.79
buyer_2,Carmen,,ES84209577803377945929,TRX_N-00605-47857562,2023-05-29T18:19:22,Zarautz,expenses,children,-329.76,-48009.55
buyer_2,Carmen,,ES84209577803377945929,TRX_N-00606-20653978,2023-06-01T19:46:34,Zarautz,incomes,salary,2048.46,-45961.09
buyer_2,Carmen,,ES84209577803377945929,TRX_N-00607-22541737,2023-06-01T19:46:34,Zarautz,incomes,extra_income,317.86,-45643.23
buyer_2,Carmen,,ES84209577803377945929,TRX_N-00608-82989695,2023-06-01T19:46:34,Zarautz,incomes,salary_bonus,1535.7,-44107.53
buyer_2,Carmen,,ES84209577803377945929,TRX_N-00609-35760731,2023-06-04T16:20:25,Zarautz,expenses,mortgage,-869.67,-44977.2
buyer_2,Carmen,,ES84209577803377945929,TRX_N-00610-53577596,2023-06-05T12:08:49,Zarautz,expenses,electricity,-78.43,-45055.63
buyer_2,Carmen,,ES84209577803377945929,TRX_N-00611-62297276,2023-06-05T18:04:55,Zarautz,expenses,healthcare,-146.18,-45201.81
buyer_2,Carmen,,ES84209577803377945929,TRX_N-00612-72186984,2023-06-06T10:38:26,Zarautz,expenses,water,-32.04,-45233.85
buyer_2,Carmen,,ES84209577803377945929,TRX_N-00613-32213330,2023-06-06T17:25:18,Zarautz,expenses,gas,-97.03,-45330.88
buyer_2,Carmen,,ES84209577803377945929,TRX_N-00614-12366661,2023-06-06T23:18:42,Zarautz,expenses,phone,-43.01,-45373.89
buyer_2,Carmen,,ES84209577803377945929,TRX_N-00615-47459314,2023-06-06T16:14:41,Zarautz,expenses,leisure,-44.62,-45418.51
buyer_2,Carmen,,ES84209577803377945929,TRX_N-00616-20944205,2023-06-06T14:26:14,Zarautz,expenses,healthcare,-112.16,-45530.67
buyer_2,Carmen,,ES84209577803377945929,TRX_N-00617-91163839,2023-06-07T12:34:55,Zarautz,expenses,internet,-42.0,-45572.67
buyer_2,Carmen,,ES84209577803377945929,TRX_N-00618-39261859,2023-06-08T14:44:22,Zarautz,expenses,cash,-100.0,-45672.67
buyer_2,Carmen,,ES84209577803377945929,TRX_N-00619-45088040,2023-06-09T14:32:45,Zarautz,expenses,leisure,-58.09,-45730.76
buyer_2,Carmen,,ES84209577803377945929,TRX_N-00620-67500931,2023-06-09T15:25:19,Zarautz,expenses,gifts,-351.27,-46082.03
buyer_2,Carmen,,ES84209577803377945929,TRX_N-00621-10620854,2023-06-10T17:20:32,Berango,expenses,gifts,-773.6,-46855.63
buyer_2,Carmen,,ES84209577803377945929,TRX_N-00622-77898983,2023-06-11T12:11:16,Zarautz,expenses,repairs,-155.51,-47011.14
buyer_2,Carmen,,ES84209577803377945929,TRX_N-00623-37925939,2023-06-12T11:22:25,Zarautz,expenses,food,-112.02,-47123.16
buyer_2,Carmen,,ES84209577803377945929,TRX_N-00624-98651392,2023-06-12T15:36:20,Zarautz,expenses,healthcare,-174.1,-47297.26
buyer_2,Carmen,,ES84209577803377945929,TRX_N-00625-65441515,2023-06-12T04:28:08,Zarautz,expenses,children,-388.44,-47685.7
buyer_2,Carmen,,ES84209577803377945929,TRX_N-00626-93492544,2023-06-13T15:41:50,Zarautz,expenses,food,-81.68,-47767.38
buyer_2,Carmen,,ES84209577803377945929,TRX_N-00627-40760561,2023-06-13T19:49:52,Zarautz,expenses,healthcare,-107.36,-47874.74
buyer_2,Carmen,,ES84209577803377945929,TRX_N-00628-58626006,2023-06-14T14:26:07,Zarautz,expenses,transport,-52.15,-47926.89
buyer_2,Carmen,,ES84209577803377945929,TRX_N-00629-00735301,2023-06-14T14:51:00,Mungia,expenses,leisure,-44.22,-47971.11
buyer_2,Carmen,,ES84209577803377945929,TRX_N-00630-79421338,2023-06-15T11:50:52,Zarautz,expenses,cash,-100.0,-48071.11
buyer_2,Carmen,,ES84209577803377945929,TRX_N-00631-78902997,2023-06-16T11:14:05,Zarautz,expenses,cash,-100.0,-48171.11
buyer_2,Carmen,,ES84209577803377945929,TRX_N-00632-68563663,2023-06-17T05:29:28,Lasarte-Oria,expenses,transport,-56.57,-48227.68
buyer_2,Carmen,,ES84209577803377945929,TRX_N-00633-06686266,2023-06-17T15:28:45,Zarautz,expenses,leisure,-60.93,-48288.61
buyer_2,Carmen,,ES84209577803377945929,TRX_N-00634-69845985,2023-06-18T19:01:11,Zarautz,expenses,food,-114.38,-48402.99
buyer_2,Carmen,,ES84209577803377945929,TRX_N-00635-42577481,2023-06-20T09:11:51,Zarautz,expenses,transport,-57.94,-48460.93
buyer_2,Carmen,,ES84209577803377945929,TRX_N-00636-74530483,2023-06-20T09:00:50,Zarautz,expenses,cash,-100.0,-48560.93
buyer_2,Carmen,,ES84209577803377945929,TRX_N-00637-78744357,2023-06-21T14:57:41,Zarautz,expenses,cash,-100.0,-48660.93
buyer_2,Carmen,,ES84209577803377945929,TRX_N-00638-65692524,2023-06-22T15:07:40,Zarautz,expenses,food,-66.19,-48727.12
buyer_2,Carmen,,ES84209577803377945929,TRX_N-00639-52924434,2023-06-29T08:23:36,Zarautz,expenses,healthcare,-65.94,-48793.06
buyer_2,Carmen,,ES84209577803377945929,TRX_N-00640-13932686,2023-06-30T11:11:13,Zarautz,expenses,food,-66.43,-48859.49
buyer_2,Carmen,,ES84209577803377945929,TRX_N-00641-18483525,2023-06-30T10:04:52,Zarautz,expenses,clothing,-64.46,-48923.95
buyer_2,Carmen,,ES84209577803377945929,TRX_N-00642-41079668,2023-07-01T23:23:09,Zarautz,incomes,salary,2048.46,-46875.49
buyer_2,Carmen,,ES84209577803377945929,TRX_N-00643-35871132,2023-07-03T20:35:47,Zarautz,expenses,children,-355.21,-47230.7
buyer_2,Carmen,,ES84209577803377945929,TRX_N-00644-49219126,2023-07-04T08:54:07,Zarautz,expenses,mortgage,-869.67,-48100.37
buyer_2,Carmen,,ES84209577803377945929,TRX_N-00645-53442584,2023-07-04T11:01:58,Basauri,expenses,food,-83.24,-48183.61
buyer_2,Carmen,,ES84209577803377945929,TRX_N-00646-79174669,2023-07-04T15:53:13,Zarautz,expenses,cash,-100.0,-48283.61
buyer_2,Carmen,,ES84209577803377945929,TRX_N-00647-82550693,2023-07-06T16:21:02,Zarautz,expenses,electricity,-85.71,-48369.32
buyer_2,Carmen,,ES84209577803377945929,TRX_N-00648-54622972,2023-07-06T14:13:15,Zarautz,expenses,gas,-80.25,-48449.57
buyer_2,Carmen,,ES84209577803377945929,TRX_N-00649-64848459,2023-07-06T21:50:27,Zarautz,expenses,food,-104.14,-48553.71
buyer_2,Carmen,,ES84209577803377945929,TRX_N-00650-43008428,2023-07-07T13:36:47,Zarautz,expenses,phone,-42.24,-48595.95
buyer_2,Carmen,,ES84209577803377945929,TRX_N-00651-45930979,2023-07-07T13:01:24,Zarautz,expenses,leisure,-76.74,-48672.69
buyer_2,Carmen,,ES84209577803377945929,TRX_N-00652-16150068,2023-07-07T14:18:02,Zarautz,expenses,healthcare,-181.23,-48853.92
buyer_2,Carmen,,ES84209577803377945929,TRX_N-00653-79292214,2023-07-07T02:06:08,Elciego,expenses,cash,-100.0,-48953.92
buyer_2,Carmen,,ES84209577803377945929,TRX_N-00654-06302471,2023-07-08T17:51:54,Zarautz,expenses,water,-29.66,-48983.58
buyer_2,Carmen,,ES84209577803377945929,TRX_N-00655-91140190,2023-07-08T08:38:22,Zarautz,expenses,internet,-42.0,-49025.58
buyer_2,Carmen,,ES84209577803377945929,TRX_N-00656-23192618,2023-07-08T15:18:16,Zarautz,expenses,food,-76.06,-49101.64
buyer_2,Carmen,,ES84209577803377945929,TRX_N-00657-76640150,2023-07-08T17:47:38,Zarautz,expenses,leisure,-57.46,-49159.1
buyer_2,Carmen,,ES84209577803377945929,TRX_N-00658-88111124,2023-07-14T03:05:32,Zarautz,expenses,cash,-100.0,-49259.1
buyer_2,Carmen,,ES84209577803377945929,TRX_N-00659-43637650,2023-07-15T08:09:55,Andoain,expenses,food,-69.46,-49328.56
buyer_2,Carmen,,ES84209577803377945929,TRX_N-00660-75737858,2023-07-18T08:06:16,Zarautz,expenses,transport,-55.66,-49384.22
buyer_2,Carmen,,ES84209577803377945929,TRX_N-00661-50547108,2023-07-19T18:04:50,Zarautz,expenses,food,-100.47,-49484.69
buyer_2,Carmen,,ES84209577803377945929,TRX_N-00662-89667179,2023-07-19T09:23:38,Zarautz,expenses,cash,-100.0,-49584.69
buyer_2,Carmen,,ES84209577803377945929,TRX_N-00663-40636333,2023-07-21T12:37:50,Zarautz,expenses,clothing,-119.04,-49703.73
buyer_2,Carmen,,ES84209577803377945929,TRX_N-00664-16875676,2023-07-21T15:33:48,Zarautz,expenses,repairs,-308.62,-50012.35
buyer_2,Carmen,,ES84209577803377945929,TRX_N-00665-15333893,2023-07-22T09:15:48,Zarautz,expenses,cash,-100.0,-50112.35
buyer_2,Carmen,,ES84209577803377945929,TRX_N-00666-11721189,2023-07-23T14:58:42,Zarautz,expenses,transport,-63.68,-50176.03
buyer_2,Carmen,,ES84209577803377945929,TRX_N-00667-16878475,2023-07-23T18:29:17,Zarautz,expenses,leisure,-31.55,-50207.58
buyer_2,Carmen,,ES84209577803377945929,TRX_N-00668-39077232,2023-07-24T17:11:03,Sopela,expenses,transport,-87.38,-50294.96
buyer_2,Carmen,,ES84209577803377945929,TRX_N-00669-58799827,2023-07-24T04:44:44,Zarautz,expenses,children,-347.75,-50642.71
buyer_2,Carmen,,ES84209577803377945929,TRX_N-00670-76762059,2023-07-25T12:16:11,Zarautz,expenses,gifts,-299.73,-50942.44
buyer_2,Carmen,,ES84209577803377945929,TRX_N-00671-24380188,2023-07-27T09:40:11,Zarautz,expenses,transport,-41.68,-50984.12
buyer_2,Carmen,,ES84209577803377945929,TRX_N-00672-11396957,2023-07-27T14:31:46,Zarautz,expenses,education,-67.94,-51052.06
buyer_2,Carmen,,ES84209577803377945929,TRX_N-00673-44673313,2023-07-29T19:58:31,Berango,expenses,food,-100.48,-51152.54
buyer_2,Carmen,,ES84209577803377945929,TRX_N-00674-56257755,2023-07-29T20:27:37,Zarautz,expenses,healthcare,-92.73,-51245.27
buyer_2,Carmen,,ES84209577803377945929,TRX_N-00675-60637399,2023-07-29T21:02:33,Zarautz,expenses,cash,-100.0,-51345.27
buyer_2,Carmen,,ES84209577803377945929,TRX_N-00676-89870624,2023-08-01T18:48:40,Zarautz,incomes,salary,2048.46,-49296.81
buyer_2,Carmen,,ES84209577803377945929,TRX_N-00677-28413204,2023-08-02T23:04:49,Zarautz,expenses,leisure,-60.52,-49357.33
buyer_2,Carmen,,ES84209577803377945929,TRX_N-00678-54143046,2023-08-03T11:40:16,Zarautz,expenses,leisure,-52.07,-49409.4
buyer_2,Carmen,,ES84209577803377945929,TRX_N-00679-89856743,2023-08-03T23:29:24,Zarautz,expenses,travel,-448.35,-49857.75
buyer_2,Carmen,,ES84209577803377945929,TRX_N-00680-19289310,2023-08-04T23:12:06,Zarautz,expenses,mortgage,-869.67,-50727.42
buyer_2,Carmen,,ES84209577803377945929,TRX_N-00681-09652537,2023-08-05T11:46:35,Zarautz,expenses,clothing,-58.36,-50785.78
buyer_2,Carmen,,ES84209577803377945929,TRX_N-00682-21309650,2023-08-05T09:24:39,Zarautz,expenses,gifts,-175.95,-50961.73
buyer_2,Carmen,,ES84209577803377945929,TRX_N-00683-25303189,2023-08-06T18:24:54,Zarautz,expenses,electricity,-70.4,-51032.13
buyer_2,Carmen,,ES84209577803377945929,TRX_N-00684-18912549,2023-08-06T17:01:42,Zarautz,expenses,phone,-34.86,-51066.99
buyer_2,Carmen,,ES84209577803377945929,TRX_N-00685-07208441,2023-08-07T20:21:44,Zarautz,expenses,water,-40.42,-51107.41
buyer_2,Carmen,,ES84209577803377945929,TRX_N-00686-71208280,2023-08-07T00:36:36,Zarautz,expenses,healthcare,-97.93,-51205.34
buyer_2,Carmen,,ES84209577803377945929,TRX_N-00687-71828876,2023-08-08T02:11:46,Zarautz,expenses,gas,-81.63,-51286.97
buyer_2,Carmen,,ES84209577803377945929,TRX_N-00688-02372251,2023-08-08T14:58:55,Zarautz,expenses,internet,-42.0,-51328.97
buyer_2,Carmen,,ES84209577803377945929,TRX_N-00689-50159266,2023-08-09T20:15:09,Zarautz,expenses,food,-99.15,-51428.12
buyer_2,Carmen,,ES84209577803377945929,TRX_N-00690-17958060,2023-08-09T16:20:55,Zarautz,expenses,transport,-87.1,-51515.22
buyer_2,Carmen,,ES84209577803377945929,TRX_N-00691-43711626,2023-08-09T16:03:22,Zarautz,expenses,gifts,-324.02,-51839.24
buyer_2,Carmen,,ES84209577803377945929,TRX_N-00692-14967586,2023-08-10T17:43:23,Zarautz,expenses,transport,-69.26,-51908.5
buyer_2,Carmen,,ES84209577803377945929,TRX_N-00693-66373647,2023-08-12T05:55:38,Zarautz,expenses,cash,-100.0,-52008.5
buyer_2,Carmen,,ES84209577803377945929,TRX_N-00694-64117825,2023-08-15T10:55:35,Basauri,expenses,transport,-62.73,-52071.23
buyer_2,Carmen,,ES84209577803377945929,TRX_N-00695-10474657,2023-08-15T09:30:15,Elciego,expenses,leisure,-58.73,-52129.96
buyer_2,Carmen,,ES84209577803377945929,TRX_N-00696-09252619,2023-08-15T14:03:38,Zarautz,expenses,education,-71.72,-52201.68
buyer_2,Carmen,,ES84209577803377945929,TRX_N-00697-45709604,2023-08-16T11:37:12,Zarautz,expenses,leisure,-81.72,-52283.4
buyer_2,Carmen,,ES84209577803377945929,TRX_N-00698-64177774,2023-08-17T20:15:46,Zarautz,expenses,gifts,-802.43,-53085.83
buyer_2,Carmen,,ES84209577803377945929,TRX_N-00699-08527759,2023-08-18T17:29:04,Zarautz,expenses,clothing,-155.55,-53241.38
buyer_2,Carmen,,ES84209577803377945929,TRX_N-00700-50764445,2023-08-19T10:32:13,Sopela,expenses,cash,-100.0,-53341.38
buyer_2,Carmen,,ES84209577803377945929,TRX_N-00701-21925670,2023-08-19T05:48:48,Zarautz,expenses,repairs,-174.98,-53516.36
buyer_2,Carmen,,ES84209577803377945929,TRX_N-00702-44645708,2023-08-20T06:17:34,Llodio,expenses,cash,-100.0,-53616.36
buyer_2,Carmen,,ES84209577803377945929,TRX_N-00703-15416881,2023-08-21T15:33:50,Zarautz,expenses,food,-69.21,-53685.57
buyer_2,Carmen,,ES84209577803377945929,TRX_N-00704-10514439,2023-08-21T00:32:44,Zarautz,expenses,cash,-100.0,-53785.57
buyer_2,Carmen,,ES84209577803377945929,TRX_N-00705-07265731,2023-08-22T18:00:29,Mungia,expenses,transport,-64.74,-53850.31
buyer_2,Carmen,,ES84209577803377945929,TRX_N-00706-48187308,2023-08-22T09:23:07,Zarautz,expenses,leisure,-30.57,-53880.88
buyer_2,Carmen,,ES84209577803377945929,TRX_N-00707-74853878,2023-08-23T08:22:30,Zarautz,expenses,gifts,-515.96,-54396.84
buyer_2,Carmen,,ES84209577803377945929,TRX_N-00708-72349663,2023-08-24T13:24:34,Erandio,expenses,gifts,-497.25,-54894.09
buyer_2,Carmen,,ES84209577803377945929,TRX_N-00709-29384169,2023-08-25T18:01:18,Zarautz,expenses,transport,-42.98,-54937.07
buyer_2,Carmen,,ES84209577803377945929,TRX_N-00710-69955593,2023-08-26T14:42:24,Hondarribia,expenses,leisure,-45.0,-54982.07
buyer_2,Carmen,,ES84209577803377945929,TRX_N-00711-86155067,2023-08-27T18:31:46,Zarautz,expenses,cash,-100.0,-55082.07
buyer_2,Carmen,,ES84209577803377945929,TRX_N-00712-63184876,2023-08-28T18:40:59,Zarautz,expenses,food,-91.89,-55173.96
buyer_2,Carmen,,ES84209577803377945929,TRX_N-00713-58000119,2023-08-29T11:09:05,Zarautz,expenses,gifts,-378.28,-55552.24
buyer_2,Carmen,,ES84209577803377945929,TRX_N-00714-10562750,2023-09-01T16:18:03,Zarautz,incomes,salary,2048.46,-53503.78
buyer_2,Carmen,,ES84209577803377945929,TRX_N-00715-27076108,2023-09-01T16:18:03,Zarautz,incomes,extra_income,317.86,-53185.92
buyer_2,Carmen,,ES84209577803377945929,TRX_N-00716-15662152,2023-09-01T08:03:49,Zarautz,expenses,children,-714.64,-53900.56
buyer_2,Carmen,,ES84209577803377945929,TRX_N-00717-76094760,2023-09-04T22:51:51,Zarautz,expenses,mortgage,-869.67,-54770.23
buyer_2,Carmen,,ES84209577803377945929,TRX_N-00718-54386579,2023-09-04T08:36:06,Zarautz,expenses,repairs,-164.93,-54935.16
buyer_2,Carmen,,ES84209577803377945929,TRX_N-00719-88894493,2023-09-05T02:27:21,Zarautz,expenses,electricity,-66.96,-55002.12
buyer_2,Carmen,,ES84209577803377945929,TRX_N-00720-92793966,2023-09-06T18:35:59,Andoain,expenses,leisure,-72.81,-55074.93
buyer_2,Carmen,,ES84209577803377945929,TRX_N-00721-00888339,2023-09-06T11:34:36,Zarautz,expenses,education,-45.45,-55120.38
buyer_2,Carmen,,ES84209577803377945929,TRX_N-00722-18065990,2023-09-07T19:01:35,Zarautz,expenses,water,-25.85,-55146.23
buyer_2,Carmen,,ES84209577803377945929,TRX_N-00723-91149769,2023-09-07T20:17:41,Zarautz,expenses,food,-95.72,-55241.95
buyer_2,Carmen,,ES84209577803377945929,TRX_N-00724-97306893,2023-09-07T23:12:54,Zarautz,expenses,clothing,-82.84,-55324.79
buyer_2,Carmen,,ES84209577803377945929,TRX_N-00725-89106297,2023-09-08T11:34:01,Zarautz,expenses,gas,-47.78,-55372.57
buyer_2,Carmen,,ES84209577803377945929,TRX_N-00726-04438245,2023-09-08T19:42:26,Zarautz,expenses,internet,-42.0,-55414.57
buyer_2,Carmen,,ES84209577803377945929,TRX_N-00727-16576236,2023-09-08T20:33:55,Zarautz,expenses,phone,-37.04,-55451.61
buyer_2,Carmen,,ES84209577803377945929,TRX_N-00728-34906316,2023-09-08T10:50:56,Zarautz,expenses,transport,-86.77,-55538.38
buyer_2,Carmen,,ES84209577803377945929,TRX_N-00729-37259417,2023-09-08T21:56:18,Irun,expenses,clothing,-55.02,-55593.4
buyer_2,Carmen,,ES84209577803377945929,TRX_N-00730-94609306,2023-09-11T20:52:21,Zarautz,expenses,food,-88.0,-55681.4
buyer_2,Carmen,,ES84209577803377945929,TRX_N-00731-41311397,2023-09-11T13:38:05,Zarautz,expenses,leisure,-18.21,-55699.61
buyer_2,Carmen,,ES84209577803377945929,TRX_N-00732-04246870,2023-09-12T10:31:27,Zarautz,expenses,cash,-100.0,-55799.61
buyer_2,Carmen,,ES84209577803377945929,TRX_N-00733-70460042,2023-09-13T10:17:08,Zarautz,expenses,cash,-100.0,-55899.61
buyer_2,Carmen,,ES84209577803377945929,TRX_N-00734-52558986,2023-09-14T18:20:00,Zarautz,expenses,healthcare,-113.08,-56012.69
buyer_2,Carmen,,ES84209577803377945929,TRX_N-00735-64463588,2023-09-14T10:48:04,Leioa,expenses,cash,-100.0,-56112.69
buyer_2,Carmen,,ES84209577803377945929,TRX_N-00736-06108942,2023-09-16T15:21:06,Zarautz,expenses,cash,-100.0,-56212.69
buyer_2,Carmen,,ES84209577803377945929,TRX_N-00737-45846927,2023-09-19T01:27:57,Zarautz,expenses,transport,-41.63,-56254.32
buyer_2,Carmen,,ES84209577803377945929,TRX_N-00738-26236958,2023-09-19T13:25:18,Zarautz,expenses,clothing,-148.96,-56403.28
buyer_2,Carmen,,ES84209577803377945929,TRX_N-00739-66209037,2023-09-20T16:50:22,Zarautz,expenses,leisure,-65.76,-56469.04
buyer_2,Carmen,,ES84209577803377945929,TRX_N-00740-21675418,2023-09-20T09:58:41,Hernani,expenses,clothing,-109.19,-56578.23
buyer_2,Carmen,,ES84209577803377945929,TRX_N-00741-72647092,2023-09-20T13:00:39,Zarautz,expenses,education,-64.82,-56643.05
buyer_2,Carmen,,ES84209577803377945929,TRX_N-00742-92300971,2023-09-21T09:18:46,Zarautz,expenses,travel,-439.82,-57082.87
buyer_2,Carmen,,ES84209577803377945929,TRX_N-00743-13975589,2023-09-22T10:53:30,Salvatierra/Agurain,expenses,cash,-100.0,-57182.87
buyer_2,Carmen,,ES84209577803377945929,TRX_N-00744-49251961,2023-09-23T17:03:54,Zarautz,expenses,clothing,-72.22,-57255.09
buyer_2,Carmen,,ES84209577803377945929,TRX_N-00745-12221048,2023-09-25T18:32:26,Zuia,expenses,food,-80.5,-57335.59
buyer_2,Carmen,,ES84209577803377945929,TRX_N-00746-28629888,2023-09-27T06:49:00,Zarautz,expenses,cash,-100.0,-57435.59
buyer_2,Carmen,,ES84209577803377945929,TRX_N-00747-84478841,2023-10-01T12:08:05,Zarautz,incomes,salary,2048.46,-55387.13
buyer_2,Carmen,,ES84209577803377945929,TRX_N-00748-80319967,2023-10-01T18:23:30,Zarautz,expenses,food,-81.0,-55468.13
buyer_2,Carmen,,ES84209577803377945929,TRX_N-00749-60303406,2023-10-02T19:05:04,Zarautz,expenses,transport,-66.62,-55534.75
buyer_2,Carmen,,ES84209577803377945929,TRX_N-00750-40423294,2023-10-02T16:18:59,Zarautz,expenses,appliances,-303.44,-55838.19
buyer_2,Carmen,,ES84209577803377945929,TRX_N-00751-90668139,2023-10-03T17:47:30,Zarautz,expenses,cash,-100.0,-55938.19
buyer_2,Carmen,,ES84209577803377945929,TRX_N-00752-85907750,2023-10-04T13:09:01,Zarautz,expenses,mortgage,-869.67,-56807.86
buyer_2,Carmen,,ES84209577803377945929,TRX_N-00753-30195229,2023-10-04T12:50:07,Zarautz,expenses,cash,-100.0,-56907.86
buyer_2,Carmen,,ES84209577803377945929,TRX_N-00754-24875980,2023-10-04T12:31:54,Zarautz,expenses,travel,-859.63,-57767.49
buyer_2,Carmen,,ES84209577803377945929,TRX_N-00755-66157136,2023-10-05T22:57:58,Zarautz,expenses,food,-107.63,-57875.12
buyer_2,Carmen,,ES84209577803377945929,TRX_N-00756-44054018,2023-10-05T00:53:02,Zarautz,expenses,cash,-100.0,-57975.12
buyer_2,Carmen,,ES84209577803377945929,TRX_N-00757-79900893,2023-10-06T12:56:25,Zarautz,expenses,clothing,-121.57,-58096.69
buyer_2,Carmen,,ES84209577803377945929,TRX_N-00758-68353943,2023-10-07T10:54:07,Zarautz,expenses,water,-22.2,-58118.89
buyer_2,Carmen,,ES84209577803377945929,TRX_N-00759-90984477,2023-10-07T18:12:29,Zarautz,expenses,education,-69.87,-58188.76
buyer_2,Carmen,,ES84209577803377945929,TRX_N-00760-56286374,2023-10-08T07:54:46,Zarautz,expenses,electricity,-27.62,-58216.38
buyer_2,Carmen,,ES84209577803377945929,TRX_N-00761-54506770,2023-10-08T14:49:38,Zarautz,expenses,gas,-43.57,-58259.95
buyer_2,Carmen,,ES84209577803377945929,TRX_N-00762-20628041,2023-10-08T02:50:49,Zarautz,expenses,internet,-42.0,-58301.95
buyer_2,Carmen,,ES84209577803377945929,TRX_N-00763-98140211,2023-10-08T12:22:35,Zarautz,expenses,phone,-37.39,-58339.34
buyer_2,Carmen,,ES84209577803377945929,TRX_N-00764-92475872,2023-10-09T23:49:20,Zarautz,expenses,transport,-68.23,-58407.57
buyer_2,Carmen,,ES84209577803377945929,TRX_N-00765-97673516,2023-10-12T18:23:08,Zarautz,expenses,transport,-66.51,-58474.08
buyer_2,Carmen,,ES84209577803377945929,TRX_N-00766-00265984,2023-10-12T02:36:07,Zarautz,expenses,clothing,-92.16,-58566.24
buyer_2,Carmen,,ES84209577803377945929,TRX_N-00767-42013238,2023-10-13T13:18:42,Zarautz,expenses,clothing,-158.85,-58725.09
buyer_2,Carmen,,ES84209577803377945929,TRX_N-00768-43807437,2023-10-13T20:45:29,Zarautz,expenses,children,-678.55,-59403.64
buyer_2,Carmen,,ES84209577803377945929,TRX_N-00769-71660114,2023-10-14T11:43:17,Hernani,expenses,transport,-52.73,-59456.37
buyer_2,Carmen,,ES84209577803377945929,TRX_N-00770-73401100,2023-10-14T09:27:16,Zarautz,expenses,children,-202.96,-59659.33
buyer_2,Carmen,,ES84209577803377945929,TRX_N-00771-03837809,2023-10-19T13:04:43,Zarautz,expenses,leisure,-56.26,-59715.59
buyer_2,Carmen,,ES84209577803377945929,TRX_N-00772-78093103,2023-10-19T13:20:50,Zarautz,expenses,appliances,-135.35,-59850.94
buyer_2,Carmen,,ES84209577803377945929,TRX_N-00773-51043451,2023-10-20T16:16:01,Zarautz,expenses,cash,-100.0,-59950.94
buyer_2,Carmen,,ES84209577803377945929,TRX_N-00774-44667579,2023-10-22T08:11:18,Zarautz,expenses,food,-106.95,-60057.89
buyer_2,Carmen,,ES84209577803377945929,TRX_N-00775-00276888,2023-10-24T00:17:29,Zarautz,expenses,repairs,-35.7,-60093.59
buyer_2,Carmen,,ES84209577803377945929,TRX_N-00776-95315888,2023-10-27T17:12:25,Zarautz,expenses,food,-81.36,-60174.95
buyer_2,Carmen,,ES84209577803377945929,TRX_N-00777-19393380,2023-10-29T17:20:43,Zarautz,expenses,food,-63.18,-60238.13
buyer_2,Carmen,,ES84209577803377945929,TRX_N-00778-39480496,2023-10-30T10:20:41,Zarautz,expenses,transport,-57.89,-60296.02
buyer_2,Carmen,,ES84209577803377945929,TRX_N-00779-52830728,2023-10-31T13:49:45,Zarautz,expenses,cash,-100.0,-60396.02
buyer_2,Carmen,,ES84209577803377945929,TRX_N-00780-80066140,2023-11-01T17:43:46,Zarautz,incomes,salary,2048.46,-58347.56
buyer_2,Carmen,,ES84209577803377945929,TRX_N-00781-05030258,2023-11-03T15:21:29,Zarautz,expenses,clothing,-77.63,-58425.19
buyer_2,Carmen,,ES84209577803377945929,TRX_N-00782-51094360,2023-11-04T12:20:14,Zarautz,expenses,mortgage,-869.67,-59294.86
buyer_2,Carmen,,ES84209577803377945929,TRX_N-00783-57915630,2023-11-05T20:29:49,Zarautz,expenses,water,-20.54,-59315.4
buyer_2,Carmen,,ES84209577803377945929,TRX_N-00784-65169653,2023-11-05T11:04:20,Zarautz,expenses,clothing,-159.91,-59475.31
buyer_2,Carmen,,ES84209577803377945929,TRX_N-00785-99800230,2023-11-05T15:01:30,Zarautz,expenses,cash,-100.0,-59575.31
buyer_2,Carmen,,ES84209577803377945929,TRX_N-00786-61815067,2023-11-07T14:47:19,Zarautz,expenses,phone,-37.89,-59613.2
buyer_2,Carmen,,ES84209577803377945929,TRX_N-00787-04375842,2023-11-08T17:10:18,Zarautz,expenses,electricity,-85.29,-59698.49
buyer_2,Carmen,,ES84209577803377945929,TRX_N-00788-64627582,2023-11-08T17:04:55,Zarautz,expenses,gas,-55.88,-59754.37
buyer_2,Carmen,,ES84209577803377945929,TRX_N-00789-88438849,2023-11-08T05:36:48,Zarautz,expenses,internet,-42.0,-59796.37
buyer_2,Carmen,,ES84209577803377945929,TRX_N-00790-09628886,2023-11-08T13:06:13,Zarautz,expenses,appliances,-246.62,-60042.99
buyer_2,Carmen,,ES84209577803377945929,TRX_N-00791-04231125,2023-11-09T09:42:13,Zarautz,expenses,food,-88.1,-60131.09
buyer_2,Carmen,,ES84209577803377945929,TRX_N-00792-45158337,2023-11-10T13:49:19,Zarautz,expenses,transport,-54.18,-60185.27
buyer_2,Carmen,,ES84209577803377945929,TRX_N-00793-65179315,2023-11-11T18:12:17,Zarautz,expenses,leisure,-61.13,-60246.4
buyer_2,Carmen,,ES84209577803377945929,TRX_N-00794-29884328,2023-11-11T14:23:12,Zarautz,expenses,cash,-100.0,-60346.4
buyer_2,Carmen,,ES84209577803377945929,TRX_N-00795-22496967,2023-11-12T09:10:29,Zarautz,expenses,children,-172.43,-60518.83
buyer_2,Carmen,,ES84209577803377945929,TRX_N-00796-98133075,2023-11-13T16:17:47,Zarautz,expenses,leisure,-27.77,-60546.6
buyer_2,Carmen,,ES84209577803377945929,TRX_N-00797-19060066,2023-11-15T12:46:16,Zarautz,expenses,clothing,-56.53,-60603.13
buyer_2,Carmen,,ES84209577803377945929,TRX_N-00798-46647261,2023-11-16T19:51:51,Zarautz,expenses,food,-119.17,-60722.3
buyer_2,Carmen,,ES84209577803377945929,TRX_N-00799-82159692,2023-11-16T09:06:21,Zarautz,expenses,leisure,-34.39,-60756.69
buyer_2,Carmen,,ES84209577803377945929,TRX_N-00800-17376207,2023-11-17T21:37:28,Zarautz,expenses,healthcare,-142.22,-60898.91
buyer_2,Carmen,,ES84209577803377945929,TRX_N-00801-09100827,2023-11-17T19:48:28,Zarautz,expenses,cash,-100.0,-60998.91
buyer_2,Carmen,,ES84209577803377945929,TRX_N-00802-36592592,2023-11-18T10:05:23,Zarautz,expenses,leisure,-64.78,-61063.69
buyer_2,Carmen,,ES84209577803377945929,TRX_N-00803-90182885,2023-11-18T13:29:46,Zarautz,expenses,gifts,-400.83,-61464.52
buyer_2,Carmen,,ES84209577803377945929,TRX_N-00804-77980125,2023-11-19T07:39:38,Zarautz,expenses,education,-77.06,-61541.58
buyer_2,Carmen,,ES84209577803377945929,TRX_N-00805-36795877,2023-11-20T19:38:21,Zarautz,expenses,leisure,-25.61,-61567.19
buyer_2,Carmen,,ES84209577803377945929,TRX_N-00806-55114046,2023-11-20T08:50:31,Zarautz,expenses,travel,-1508.39,-63075.58
buyer_2,Carmen,,ES84209577803377945929,TRX_N-00807-53552471,2023-11-20T10:20:50,Zarautz,expenses,repairs,-224.89,-63300.47
buyer_2,Carmen,,ES84209577803377945929,TRX_N-00808-97978492,2023-11-21T08:38:42,Zarautz,expenses,leisure,-48.69,-63349.16
buyer_2,Carmen,,ES84209577803377945929,TRX_N-00809-84206233,2023-11-21T10:50:48,Errenteria,expenses,cash,-100.0,-63449.16
buyer_2,Carmen,,ES84209577803377945929,TRX_N-00810-87404321,2023-11-21T01:01:57,Zarautz,expenses,gifts,-724.11,-64173.27
buyer_2,Carmen,,ES84209577803377945929,TRX_N-00811-34304511,2023-11-23T17:00:44,Errenteria,expenses,cash,-100.0,-64273.27
buyer_2,Carmen,,ES84209577803377945929,TRX_N-00812-96957273,2023-11-25T10:35:56,Zarautz,expenses,repairs,-35.09,-64308.36
buyer_2,Carmen,,ES84209577803377945929,TRX_N-00813-21610866,2023-11-26T11:23:01,Zarautz,expenses,cash,-100.0,-64408.36
buyer_2,Carmen,,ES84209577803377945929,TRX_N-00814-00830250,2023-11-28T03:51:01,Zarautz,expenses,cash,-100.0,-64508.36
buyer_2,Carmen,,ES84209577803377945929,TRX_N-00815-66757832,2023-11-30T03:42:35,Zarautz,expenses,children,-398.4,-64906.76
buyer_2,Carmen,,ES84209577803377945929,TRX_N-00816-32024932,2023-12-01T19:57:15,Zarautz,incomes,salary,2048.46,-62858.3
buyer_2,Carmen,,ES84209577803377945929,TRX_N-00817-03993284,2023-12-01T19:57:15,Zarautz,incomes,salary_bonus,1541.01,-61317.29
buyer_2,Carmen,,ES84209577803377945929,TRX_N-00818-27332445,2023-12-01T04:30:10,Zarautz,expenses,cash,-100.0,-61417.29
buyer_2,Carmen,,ES84209577803377945929,TRX_N-00819-65911070,2023-12-04T12:19:09,Zarautz,expenses,mortgage,-869.67,-62286.96
buyer_2,Carmen,,ES84209577803377945929,TRX_N-00820-83233018,2023-12-04T20:00:59,Zarautz,expenses,clothing,-92.01,-62378.97
buyer_2,Carmen,,ES84209577803377945929,TRX_N-00821-64550215,2023-12-05T18:18:20,Zarautz,expenses,electricity,-36.07,-62415.04
buyer_2,Carmen,,ES84209577803377945929,TRX_N-00822-87693237,2023-12-05T08:11:19,Zarautz,expenses,gas,-50.9,-62465.94
buyer_2,Carmen,,ES84209577803377945929,TRX_N-00823-07076282,2023-12-05T17:20:59,Zarautz,expenses,clothing,-132.3,-62598.24
buyer_2,Carmen,,ES84209577803377945929,TRX_N-00824-20721861,2023-12-07T10:23:16,Zarautz,expenses,internet,-42.0,-62640.24
buyer_2,Carmen,,ES84209577803377945929,TRX_N-00825-27765528,2023-12-07T09:25:12,Zarautz,expenses,phone,-43.83,-62684.07
buyer_2,Carmen,,ES84209577803377945929,TRX_N-00826-00502737,2023-12-08T20:23:19,Zarautz,expenses,water,-33.81,-62717.88
buyer_2,Carmen,,ES84209577803377945929,TRX_N-00827-93356620,2023-12-09T16:09:21,Zarautz,expenses,transport,-81.43,-62799.31
buyer_2,Carmen,,ES84209577803377945929,TRX_N-00828-61939997,2023-12-09T18:32:36,Zarautz,expenses,appliances,-108.57,-62907.88
buyer_2,Carmen,,ES84209577803377945929,TRX_N-00829-67013151,2023-12-10T11:21:59,Zarautz,expenses,healthcare,-171.69,-63079.57
buyer_2,Carmen,,ES84209577803377945929,TRX_N-00830-47433360,2023-12-11T11:14:02,Zarautz,expenses,education,-57.88,-63137.45
buyer_2,Carmen,,ES84209577803377945929,TRX_N-00831-38118973,2023-12-12T14:33:48,Zarautz,expenses,cash,-100.0,-63237.45
buyer_2,Carmen,,ES84209577803377945929,TRX_N-00832-86245767,2023-12-17T11:32:52,Zarautz,expenses,food,-91.25,-63328.7
buyer_2,Carmen,,ES84209577803377945929,TRX_N-00833-36998058,2023-12-17T17:55:02,Zarautz,expenses,leisure,-44.86,-63373.56
buyer_2,Carmen,,ES84209577803377945929,TRX_N-00834-02153702,2023-12-17T12:01:28,Berango,expenses,repairs,-170.23,-63543.79
buyer_2,Carmen,,ES84209577803377945929,TRX_N-00835-14466611,2023-12-18T16:13:05,Zarautz,expenses,food,-110.81,-63654.6
buyer_2,Carmen,,ES84209577803377945929,TRX_N-00836-25054384,2023-12-19T17:01:44,Zarautz,expenses,leisure,-63.06,-63717.66
buyer_2,Carmen,,ES84209577803377945929,TRX_N-00837-13762451,2023-12-19T11:02:52,Zarautz,expenses,cash,-100.0,-63817.66
buyer_2,Carmen,,ES84209577803377945929,TRX_N-00838-84779797,2023-12-19T09:18:37,Zarautz,expenses,repairs,-124.15,-63941.81
buyer_2,Carmen,,ES84209577803377945929,TRX_N-00839-07696223,2023-12-20T20:26:40,Zarautz,expenses,healthcare,-68.07,-64009.88
buyer_2,Carmen,,ES84209577803377945929,TRX_N-00840-47524319,2023-12-21T17:02:01,Zarautz,expenses,leisure,-54.28,-64064.16
buyer_2,Carmen,,ES84209577803377945929,TRX_N-00841-50204255,2023-12-22T18:52:45,Leioa,expenses,food,-63.09,-64127.25
buyer_2,Carmen,,ES84209577803377945929,TRX_N-00842-97183587,2023-12-23T11:31:20,Portugalete,expenses,food,-115.53,-64242.78
buyer_2,Carmen,,ES84209577803377945929,TRX_N-00843-25553036,2023-12-23T18:52:49,Zarautz,expenses,gifts,-789.41,-65032.19
buyer_2,Carmen,,ES84209577803377945929,TRX_N-00844-04105761,2023-12-25T17:29:51,Zarautz,expenses,transport,-59.15,-65091.34
buyer_2,Carmen,,ES84209577803377945929,TRX_N-00845-98348890,2023-12-27T23:48:04,Zarautz,expenses,leisure,-66.28,-65157.62
buyer_2,Carmen,,ES84209577803377945929,TRX_N-00846-04858438,2023-12-27T08:27:59,Zarautz,expenses,repairs,-218.66,-65376.28
buyer_2,Carmen,,ES84209577803377945929,TRX_N-00847-18924404,2023-12-28T02:59:19,Zarautz,expenses,cash,-100.0,-65476.28
buyer_2,Carmen,,ES84209577803377945929,TRX_N-00848-82346569,2023-12-29T20:49:53,Durango,expenses,transport,-67.85,-65544.13
buyer_2,Carmen,,ES84209577803377945929,TRX_N-00849-56693194,2023-12-29T12:19:28,Zarautz,expenses,cash,-100.0,-65644.13
buyer_2,Carmen,,ES84209577803377945929,TRX_N-00850-79516511,2023-12-30T12:15:27,Zarautz,expenses,leisure,-58.83,-65702.96
buyer_2,Carmen,,ES84209577803377945929,TRX_N-00851-00364008,2024-01-01T10:56:22,Zarautz,incomes,salary,2127.77,-63575.19
buyer_2,Carmen,,ES84209577803377945929,TRX_N-00852-83006022,2024-01-01T10:56:22,Zarautz,incomes,extra_income,317.86,-63257.33
buyer_2,Carmen,,ES84209577803377945929,TRX_N-00853-52261528,2024-01-02T10:21:41,Zarautz,expenses,leisure,-80.79,-63338.12
buyer_2,Carmen,,ES84209577803377945929,TRX_N-00854-05423845,2024-01-04T18:14:37,Zarautz,expenses,mortgage,-869.67,-64207.79
buyer_2,Carmen,,ES84209577803377945929,TRX_N-00855-48179999,2024-01-04T09:07:17,Bermeo,expenses,leisure,-36.91,-64244.7
buyer_2,Carmen,,ES84209577803377945929,TRX_N-00856-60264702,2024-01-05T23:29:40,Zarautz,expenses,education,-74.62,-64319.32
buyer_2,Carmen,,ES84209577803377945929,TRX_N-00857-23755143,2024-01-06T03:27:38,Zarautz,expenses,phone,-32.92,-64352.24
buyer_2,Carmen,,ES84209577803377945929,TRX_N-00858-19386292,2024-01-06T14:28:56,Zarautz,expenses,transport,-54.04,-64406.28
buyer_2,Carmen,,ES84209577803377945929,TRX_N-00859-53390137,2024-01-06T17:51:55,Zarautz,expenses,travel,-673.12,-65079.4
buyer_2,Carmen,,ES84209577803377945929,TRX_N-00860-86819552,2024-01-07T17:50:08,Zarautz,expenses,water,-27.11,-65106.51
buyer_2,Carmen,,ES84209577803377945929,TRX_N-00861-34374604,2024-01-07T17:42:52,Zarautz,expenses,gas,-59.58,-65166.09
buyer_2,Carmen,,ES84209577803377945929,TRX_N-00862-75818960,2024-01-08T11:11:45,Zarautz,expenses,electricity,-85.51,-65251.6
buyer_2,Carmen,,ES84209577803377945929,TRX_N-00863-02100991,2024-01-08T12:20:31,Zarautz,expenses,internet,-42.0,-65293.6
buyer_2,Carmen,,ES84209577803377945929,TRX_N-00864-08188847,2024-01-08T08:50:37,Zarautz,expenses,food,-118.73,-65412.33
buyer_2,Carmen,,ES84209577803377945929,TRX_N-00865-43958293,2024-01-09T01:52:08,Zarautz,expenses,leisure,-18.08,-65430.41
buyer_2,Carmen,,ES84209577803377945929,TRX_N-00866-20130162,2024-01-12T18:35:26,Zarautz,expenses,leisure,-23.09,-65453.5
buyer_2,Carmen,,ES84209577803377945929,TRX_N-00867-21648769,2024-01-13T14:17:42,Zarautz,expenses,leisure,-57.81,-65511.31
buyer_2,Carmen,,ES84209577803377945929,TRX_N-00868-35067144,2024-01-14T11:46:17,Zarautz,expenses,transport,-75.56,-65586.87
buyer_2,Carmen,,ES84209577803377945929,TRX_N-00869-66386923,2024-01-16T09:39:26,Zarautz,expenses,food,-115.05,-65701.92
buyer_2,Carmen,,ES84209577803377945929,TRX_N-00870-59480180,2024-01-20T18:02:50,Zarautz,expenses,repairs,-320.87,-66022.79
buyer_2,Carmen,,ES84209577803377945929,TRX_N-00871-65177181,2024-01-22T23:49:11,Zarautz,expenses,children,-177.48,-66200.27
buyer_2,Carmen,,ES84209577803377945929,TRX_N-00872-79528999,2024-01-23T17:24:32,Zarautz,expenses,transport,-53.88,-66254.15
buyer_2,Carmen,,ES84209577803377945929,TRX_N-00873-01003068,2024-01-23T13:18:58,Zarautz,expenses,healthcare,-159.32,-66413.47
buyer_2,Carmen,,ES84209577803377945929,TRX_N-00874-65794303,2024-01-24T02:16:12,Zarautz,expenses,transport,-60.68,-66474.15
buyer_2,Carmen,,ES84209577803377945929,TRX_N-00875-84065974,2024-01-24T10:48:40,Zarautz,expenses,leisure,-50.82,-66524.97
buyer_2,Carmen,,ES84209577803377945929,TRX_N-00876-21694287,2024-01-25T16:18:08,Zarautz,expenses,cash,-100.0,-66624.97
buyer_2,Carmen,,ES84209577803377945929,TRX_N-00877-34204928,2024-01-26T08:02:17,Errenteria,expenses,clothing,-136.06,-66761.03
buyer_2,Carmen,,ES84209577803377945929,TRX_N-00878-03442721,2024-01-26T21:23:43,Zarautz,expenses,education,-50.59,-66811.62
buyer_2,Carmen,,ES84209577803377945929,TRX_N-00879-71005986,2024-01-26T15:12:15,Zarautz,expenses,repairs,-327.41,-67139.03
buyer_2,Carmen,,ES84209577803377945929,TRX_N-00880-08414244,2024-01-27T09:32:12,Zarautz,expenses,transport,-49.31,-67188.34
buyer_2,Carmen,,ES84209577803377945929,TRX_N-00881-43455963,2024-01-28T15:19:02,Zarautz,expenses,cash,-100.0,-67288.34
buyer_2,Carmen,,ES84209577803377945929,TRX_N-00882-50741334,2024-01-29T13:02:24,Zarautz,expenses,clothing,-56.83,-67345.17
buyer_2,Carmen,,ES84209577803377945929,TRX_N-00883-76922575,2024-01-30T18:27:44,Zarautz,expenses,repairs,-57.2,-67402.37
buyer_2,Carmen,,ES84209577803377945929,TRX_N-00884-70568856,2024-02-01T14:00:18,Zarautz,incomes,salary,2127.77,-65274.6
buyer_2,Carmen,,ES84209577803377945929,TRX_N-00885-12911902,2024-02-02T20:08:08,Zarautz,expenses,food,-85.69,-65360.29
buyer_2,Carmen,,ES84209577803377945929,TRX_N-00886-62329586,2024-02-02T20:30:54,Pasaia,expenses,cash,-100.0,-65460.29
buyer_2,Carmen,,ES84209577803377945929,TRX_N-00887-95570683,2024-02-03T09:32:55,Zarautz,expenses,food,-88.89,-65549.18
buyer_2,Carmen,,ES84209577803377945929,TRX_N-00888-57506027,2024-02-03T19:31:14,Zarautz,expenses,cash,-100.0,-65649.18
buyer_2,Carmen,,ES84209577803377945929,TRX_N-00889-77793598,2024-02-03T13:53:31,Zarautz,expenses,repairs,-228.92,-65878.1
buyer_2,Carmen,,ES84209577803377945929,TRX_N-00890-90071669,2024-02-04T14:26:31,Zarautz,expenses,mortgage,-869.67,-66747.77
buyer_2,Carmen,,ES84209577803377945929,TRX_N-00891-52192834,2024-02-04T14:31:54,Labastida,expenses,food,-98.76,-66846.53
buyer_2,Carmen,,ES84209577803377945929,TRX_N-00892-32782451,2024-02-04T14:52:07,Zarautz,expenses,education,-42.63,-66889.16
buyer_2,Carmen,,ES84209577803377945929,TRX_N-00893-31919462,2024-02-05T17:58:06,Zarautz,expenses,electricity,-57.7,-66946.86
buyer_2,Carmen,,ES84209577803377945929,TRX_N-00894-64127293,2024-02-05T17:45:25,Zarautz,expenses,internet,-42.0,-66988.86
buyer_2,Carmen,,ES84209577803377945929,TRX_N-00895-75360635,2024-02-05T16:00:54,Zarautz,expenses,transport,-67.88,-67056.74
buyer_2,Carmen,,ES84209577803377945929,TRX_N-00896-74190766,2024-02-05T18:01:28,Zarautz,expenses,cash,-100.0,-67156.74
buyer_2,Carmen,,ES84209577803377945929,TRX_N-00897-47914760,2024-02-05T07:01:36,Zarautz,expenses,repairs,-160.7,-67317.44
buyer_2,Carmen,,ES84209577803377945929,TRX_N-00898-20043263,2024-02-06T08:19:56,Zarautz,expenses,phone,-44.57,-67362.01
buyer_2,Carmen,,ES84209577803377945929,TRX_N-00899-90414747,2024-02-06T11:05:17,Zarautz,expenses,healthcare,-151.73,-67513.74
buyer_2,Carmen,,ES84209577803377945929,TRX_N-00900-54874371,2024-02-07T00:03:58,Zarautz,expenses,cash,-100.0,-67613.74
buyer_2,Carmen,,ES84209577803377945929,TRX_N-00901-17607179,2024-02-08T11:14:59,Zarautz,expenses,water,-35.18,-67648.92
buyer_2,Carmen,,ES84209577803377945929,TRX_N-00902-66838447,2024-02-08T16:49:53,Zarautz,expenses,gas,-104.02,-67752.94
buyer_2,Carmen,,ES84209577803377945929,TRX_N-00903-32819959,2024-02-10T18:50:30,Zarautz,expenses,gifts,-803.18,-68556.12
buyer_2,Carmen,,ES84209577803377945929,TRX_N-00904-50301105,2024-02-11T10:45:05,Zarautz,expenses,education,-60.22,-68616.34
buyer_2,Carmen,,ES84209577803377945929,TRX_N-00905-76510955,2024-02-13T15:36:10,Zarautz,expenses,food,-121.26,-68737.6
buyer_2,Carmen,,ES84209577803377945929,TRX_N-00906-22589856,2024-02-13T16:44:42,Zarautz,expenses,clothing,-47.48,-68785.08
buyer_2,Carmen,,ES84209577803377945929,TRX_N-00907-48460530,2024-02-14T21:22:50,Zarautz,expenses,transport,-44.64,-68829.72
buyer_2,Carmen,,ES84209577803377945929,TRX_N-00908-52080687,2024-02-15T15:39:32,Zarautz,expenses,appliances,-115.43,-68945.15
buyer_2,Carmen,,ES84209577803377945929,TRX_N-00909-70880675,2024-02-16T16:18:18,Zarautz,expenses,food,-113.99,-69059.14
buyer_2,Carmen,,ES84209577803377945929,TRX_N-00910-54913260,2024-02-16T11:59:46,Zarautz,expenses,clothing,-123.62,-69182.76
buyer_2,Carmen,,ES84209577803377945929,TRX_N-00911-72587250,2024-02-17T08:22:10,Zarautz,expenses,food,-92.13,-69274.89
buyer_2,Carmen,,ES84209577803377945929,TRX_N-00912-73317468,2024-02-17T15:38:47,Llodio,expenses,cash,-100.0,-69374.89
buyer_2,Carmen,,ES84209577803377945929,TRX_N-00913-67437756,2024-02-18T17:39:37,Barakaldo,expenses,food,-105.75,-69480.64
buyer_2,Carmen,,ES84209577803377945929,TRX_N-00914-96273719,2024-02-18T03:25:26,Zarautz,expenses,cash,-100.0,-69580.64
buyer_2,Carmen,,ES84209577803377945929,TRX_N-00915-69490921,2024-02-20T13:00:53,Zarautz,expenses,clothing,-108.28,-69688.92
buyer_2,Carmen,,ES84209577803377945929,TRX_N-00916-12086975,2024-02-21T18:07:09,Zarautz,expenses,food,-119.91,-69808.83
buyer_2,Carmen,,ES84209577803377945929,TRX_N-00917-74180636,2024-02-21T13:24:53,Zarautz,expenses,cash,-100.0,-69908.83
buyer_2,Carmen,,ES84209577803377945929,TRX_N-00918-43601360,2024-02-22T23:06:44,Zarautz,expenses,leisure,-41.03,-69949.86
buyer_2,Carmen,,ES84209577803377945929,TRX_N-00919-01820720,2024-02-22T11:27:29,Zarautz,expenses,cash,-100.0,-70049.86
buyer_2,Carmen,,ES84209577803377945929,TRX_N-00920-16899817,2024-02-24T11:01:56,Zarautz,expenses,clothing,-70.51,-70120.37
buyer_2,Carmen,,ES84209577803377945929,TRX_N-00921-77113404,2024-02-25T09:58:10,Zarautz,expenses,leisure,-64.57,-70184.94
buyer_2,Carmen,,ES84209577803377945929,TRX_N-00922-00175803,2024-02-26T14:40:10,Irun,expenses,cash,-100.0,-70284.94
buyer_2,Carmen,,ES84209577803377945929,TRX_N-00923-30786693,2024-02-28T13:36:13,Zarautz,expenses,repairs,-184.56,-70469.5
buyer_2,Carmen,,ES84209577803377945929,TRX_N-00924-38909249,2024-02-28T04:33:37,Zarautz,expenses,children,-190.27,-70659.77
buyer_2,Carmen,,ES84209577803377945929,TRX_N-00925-02562922,2024-02-29T08:05:18,Zarautz,expenses,leisure,-22.63,-70682.4
buyer_2,Carmen,,ES84209577803377945929,TRX_N-00926-52110771,2024-03-01T11:21:06,Zarautz,incomes,salary,2127.77,-68554.63
buyer_2,Carmen,,ES84209577803377945929,TRX_N-00927-11735626,2024-03-01T21:46:21,Zarautz,expenses,cash,-100.0,-68654.63
buyer_2,Carmen,,ES84209577803377945929,TRX_N-00928-04421192,2024-03-02T20:33:00,Zarautz,expenses,clothing,-54.58,-68709.21
buyer_2,Carmen,,ES84209577803377945929,TRX_N-00929-11131977,2024-03-03T11:20:17,Iruña de Oca,expenses,travel,-1356.62,-70065.83
buyer_2,Carmen,,ES84209577803377945929,TRX_N-00930-80822014,2024-03-04T22:31:18,Zarautz,expenses,mortgage,-869.67,-70935.5
buyer_2,Carmen,,ES84209577803377945929,TRX_N-00931-95392686,2024-03-05T08:11:51,Zarautz,expenses,leisure,-20.16,-70955.66
buyer_2,Carmen,,ES84209577803377945929,TRX_N-00932-07718659,2024-03-06T10:08:41,Zarautz,expenses,electricity,-83.53,-71039.19
buyer_2,Carmen,,ES84209577803377945929,TRX_N-00933-45061057,2024-03-06T18:18:00,Pasaia,expenses,cash,-100.0,-71139.19
buyer_2,Carmen,,ES84209577803377945929,TRX_N-00934-38430651,2024-03-07T09:20:44,Zarautz,expenses,water,-31.68,-71170.87
buyer_2,Carmen,,ES84209577803377945929,TRX_N-00935-96992856,2024-03-07T16:47:51,Zarautz,expenses,phone,-40.0,-71210.87
buyer_2,Carmen,,ES84209577803377945929,TRX_N-00936-27632600,2024-03-07T13:11:08,Zarautz,expenses,leisure,-29.07,-71239.94
buyer_2,Carmen,,ES84209577803377945929,TRX_N-00937-97861093,2024-03-08T21:58:20,Zarautz,expenses,gas,-100.43,-71340.37
buyer_2,Carmen,,ES84209577803377945929,TRX_N-00938-45302097,2024-03-08T18:27:02,Zarautz,expenses,internet,-42.0,-71382.37
buyer_2,Carmen,,ES84209577803377945929,TRX_N-00939-67834291,2024-03-09T20:54:28,Zarautz,expenses,transport,-52.88,-71435.25
buyer_2,Carmen,,ES84209577803377945929,TRX_N-00940-14082838,2024-03-09T20:01:03,Hondarribia,expenses,leisure,-21.16,-71456.41
buyer_2,Carmen,,ES84209577803377945929,TRX_N-00941-15815769,2024-03-10T16:06:08,Zarautz,expenses,food,-79.13,-71535.54
buyer_2,Carmen,,ES84209577803377945929,TRX_N-00942-89085471,2024-03-12T17:14:03,Zarautz,expenses,food,-76.81,-71612.35
buyer_2,Carmen,,ES84209577803377945929,TRX_N-00943-22503003,2024-03-13T12:07:53,Zarautz,expenses,food,-66.06,-71678.41
buyer_2,Carmen,,ES84209577803377945929,TRX_N-00944-20208846,2024-03-14T17:21:12,Zarautz,expenses,food,-114.27,-71792.68
buyer_2,Carmen,,ES84209577803377945929,TRX_N-00945-44348654,2024-03-14T19:42:43,Salvatierra/Agurain,expenses,gifts,-798.49,-72591.17
buyer_2,Carmen,,ES84209577803377945929,TRX_N-00946-61335186,2024-03-16T12:43:00,Zarautz,expenses,food,-104.46,-72695.63
buyer_2,Carmen,,ES84209577803377945929,TRX_N-00947-28502598,2024-03-19T09:43:34,Zarautz,expenses,cash,-100.0,-72795.63
buyer_2,Carmen,,ES84209577803377945929,TRX_N-00948-90350656,2024-03-19T15:47:29,Zarautz,expenses,repairs,-239.71,-73035.34
buyer_2,Carmen,,ES84209577803377945929,TRX_N-00949-32996410,2024-03-20T10:02:45,Getxo,expenses,food,-68.99,-73104.33
buyer_2,Carmen,,ES84209577803377945929,TRX_N-00950-61444108,2024-03-21T23:26:18,Zarautz,expenses,transport,-63.32,-73167.65
buyer_2,Carmen,,ES84209577803377945929,TRX_N-00951-84884208,2024-03-21T16:33:14,Sestao,expenses,gifts,-237.95,-73405.6
buyer_2,Carmen,,ES84209577803377945929,TRX_N-00952-49149987,2024-03-22T14:48:09,Zarautz,expenses,repairs,-44.25,-73449.85
buyer_2,Carmen,,ES84209577803377945929,TRX_N-00953-72186161,2024-03-23T11:29:30,Zarautz,expenses,transport,-79.23,-73529.08
buyer_2,Carmen,,ES84209577803377945929,TRX_N-00954-31365032,2024-03-23T09:29:07,Zarautz,expenses,cash,-100.0,-73629.08
buyer_2,Carmen,,ES84209577803377945929,TRX_N-00955-20704240,2024-03-24T20:48:23,Zarautz,expenses,leisure,-47.41,-73676.49
buyer_2,Carmen,,ES84209577803377945929,TRX_N-00956-75858307,2024-03-24T18:10:43,Zarautz,expenses,clothing,-58.66,-73735.15
buyer_2,Carmen,,ES84209577803377945929,TRX_N-00957-32607864,2024-03-28T14:58:27,Zarautz,expenses,repairs,-285.68,-74020.83
buyer_2,Carmen,,ES84209577803377945929,TRX_N-00958-84941140,2024-03-31T17:20:34,Zarautz,expenses,food,-97.6,-74118.43
buyer_2,Carmen,,ES84209577803377945929,TRX_N-00959-45858589,2024-03-31T17:49:21,Zarautz,expenses,travel,-892.19,-75010.62
buyer_2,Carmen,,ES84209577803377945929,TRX_N-00960-36487780,2024-04-01T18:21:08,Zarautz,incomes,salary,2127.77,-72882.85
buyer_2,Carmen,,ES84209577803377945929,TRX_N-00961-32361336,2024-04-01T16:02:18,Zarautz,expenses,gifts,-649.41,-73532.26
buyer_2,Carmen,,ES84209577803377945929,TRX_N-00962-44640279,2024-04-02T15:24:32,Zarautz,expenses,leisure,-41.53,-73573.79
buyer_2,Carmen,,ES84209577803377945929,TRX_N-00963-98273084,2024-04-04T15:23:37,Zarautz,expenses,mortgage,-869.67,-74443.46
buyer_2,Carmen,,ES84209577803377945929,TRX_N-00964-11134007,2024-04-06T14:26:36,Zarautz,expenses,water,-22.63,-74466.09
buyer_2,Carmen,,ES84209577803377945929,TRX_N-00965-53229421,2024-04-07T17:20:34,Getxo,expenses,education,-69.31,-74535.4
buyer_2,Carmen,,ES84209577803377945929,TRX_N-00966-88762401,2024-04-07T09:57:30,Zarautz,expenses,repairs,-211.51,-74746.91
buyer_2,Carmen,,ES84209577803377945929,TRX_N-00967-62924535,2024-04-08T17:17:44,Zarautz,expenses,electricity,-66.11,-74813.02
buyer_2,Carmen,,ES84209577803377945929,TRX_N-00968-47466401,2024-04-08T09:02:41,Zarautz,expenses,phone,-43.43,-74856.45
buyer_2,Carmen,,ES84209577803377945929,TRX_N-00969-99198744,2024-04-08T15:43:31,Zarautz,expenses,gas,-56.7,-74913.15
buyer_2,Carmen,,ES84209577803377945929,TRX_N-00970-73933923,2024-04-08T21:27:54,Zarautz,expenses,internet,-42.0,-74955.15
buyer_2,Carmen,,ES84209577803377945929,TRX_N-00971-38528854,2024-04-09T10:12:24,Zarautz,expenses,repairs,-237.53,-75192.68
buyer_2,Carmen,,ES84209577803377945929,TRX_N-00972-14433260,2024-04-12T21:52:43,Zarautz,expenses,food,-67.72,-75260.4
buyer_2,Carmen,,ES84209577803377945929,TRX_N-00973-96505728,2024-04-12T12:39:08,Getxo,expenses,cash,-100.0,-75360.4
buyer_2,Carmen,,ES84209577803377945929,TRX_N-00974-13344807,2024-04-15T10:40:37,Zarautz,expenses,cash,-100.0,-75460.4
buyer_2,Carmen,,ES84209577803377945929,TRX_N-00975-26815156,2024-04-16T14:33:18,Zarautz,expenses,cash,-100.0,-75560.4
buyer_2,Carmen,,ES84209577803377945929,TRX_N-00976-41808442,2024-04-18T15:29:17,Zarautz,expenses,cash,-100.0,-75660.4
buyer_2,Carmen,,ES84209577803377945929,TRX_N-00977-16612048,2024-04-18T23:42:02,Zarautz,expenses,repairs,-130.67,-75791.07
buyer_2,Carmen,,ES84209577803377945929,TRX_N-00978-84136038,2024-04-19T21:11:42,Zarautz,expenses,food,-76.46,-75867.53
buyer_2,Carmen,,ES84209577803377945929,TRX_N-00979-01367910,2024-04-21T09:01:20,Zarautz,expenses,leisure,-41.78,-75909.31
buyer_2,Carmen,,ES84209577803377945929,TRX_N-00980-47090636,2024-04-22T11:16:15,Zarautz,expenses,healthcare,-92.13,-76001.44
buyer_2,Carmen,,ES84209577803377945929,TRX_N-00981-29980634,2024-04-23T15:28:03,Lasarte-Oria,expenses,repairs,-225.93,-76227.37
buyer_2,Carmen,,ES84209577803377945929,TRX_N-00982-99311615,2024-04-26T20:19:39,Zarautz,expenses,cash,-100.0,-76327.37
buyer_2,Carmen,,ES84209577803377945929,TRX_N-00983-46929915,2024-04-27T09:35:45,Zarautz,expenses,leisure,-41.52,-76368.89
buyer_2,Carmen,,ES84209577803377945929,TRX_N-00984-50070878,2024-04-29T13:54:30,Zarautz,expenses,repairs,-141.15,-76510.04
buyer_2,Carmen,,ES84209577803377945929,TRX_N-00985-91334364,2024-04-30T16:34:01,Zarautz,expenses,leisure,-47.81,-76557.85
buyer_2,Carmen,,ES84209577803377945929,TRX_N-00986-74328235,2024-04-30T10:19:46,Galdakao,expenses,clothing,-52.69,-76610.54
buyer_2,Carmen,,ES84209577803377945929,TRX_N-00987-53107205,2024-04-30T09:32:27,Zarautz,expenses,education,-47.71,-76658.25
buyer_2,Carmen,,ES84209577803377945929,TRX_N-00988-23672636,2024-05-01T16:56:25,Zarautz,incomes,salary,2127.77,-74530.48
buyer_2,Carmen,,ES84209577803377945929,TRX_N-00989-85705539,2024-05-01T16:56:25,Zarautz,incomes,extra_income,317.86,-74212.62
buyer_2,Carmen,,ES84209577803377945929,TRX_N-00990-24454185,2024-05-01T18:11:37,Zarautz,expenses,food,-81.97,-74294.59
buyer_2,Carmen,,ES84209577803377945929,TRX_N-00991-59684117,2024-05-01T10:04:24,Zarautz,expenses,transport,-62.75,-74357.34
buyer_2,Carmen,,ES84209577803377945929,TRX_N-00992-61179539,2024-05-01T14:06:46,Eibar,expenses,cash,-100.0,-74457.34
buyer_2,Carmen,,ES84209577803377945929,TRX_N-00993-35640647,2024-05-04T08:41:38,Zarautz,expenses,mortgage,-869.67,-75327.01
buyer_2,Carmen,,ES84209577803377945929,TRX_N-00994-14289650,2024-05-04T12:45:32,Zarautz,expenses,cash,-100.0,-75427.01
buyer_2,Carmen,,ES84209577803377945929,TRX_N-00995-08373631,2024-05-05T14:16:36,Zarautz,expenses,water,-25.28,-75452.29
buyer_2,Carmen,,ES84209577803377945929,TRX_N-00996-58600780,2024-05-05T19:22:28,Zarautz,expenses,transport,-68.21,-75520.5
buyer_2,Carmen,,ES84209577803377945929,TRX_N-00997-59444884,2024-05-06T15:42:55,Zarautz,expenses,electricity,-35.99,-75556.49
buyer_2,Carmen,,ES84209577803377945929,TRX_N-00998-96337877,2024-05-06T03:23:14,Zarautz,expenses,gas,-103.04,-75659.53
buyer_2,Carmen,,ES84209577803377945929,TRX_N-00999-69491735,2024-05-07T13:11:00,Zarautz,expenses,food,-99.61,-75759.14
buyer_2,Carmen,,ES84209577803377945929,TRX_N-01000-13839406,2024-05-07T21:24:01,Zarautz,expenses,transport,-40.28,-75799.42
buyer_2,Carmen,,ES84209577803377945929,TRX_N-01001-24211584,2024-05-07T11:24:29,Zarautz,expenses,leisure,-36.2,-75835.62
buyer_2,Carmen,,ES84209577803377945929,TRX_N-01002-22785617,2024-05-07T11:34:13,Zarautz,expenses,clothing,-122.09,-75957.71
buyer_2,Carmen,,ES84209577803377945929,TRX_N-01003-68793837,2024-05-07T08:25:03,Zarautz,expenses,cash,-100.0,-76057.71
buyer_2,Carmen,,ES84209577803377945929,TRX_N-01004-30058705,2024-05-07T09:46:29,Zarautz,expenses,travel,-1133.72,-77191.43
buyer_2,Carmen,,ES84209577803377945929,TRX_N-01005-44426550,2024-05-08T14:07:42,Zarautz,expenses,internet,-42.0,-77233.43
buyer_2,Carmen,,ES84209577803377945929,TRX_N-01006-46033324,2024-05-08T12:41:12,Zarautz,expenses,phone,-36.74,-77270.17
buyer_2,Carmen,,ES84209577803377945929,TRX_N-01007-59848411,2024-05-09T15:52:07,Arrasate,expenses,appliances,-410.47,-77680.64
buyer_2,Carmen,,ES84209577803377945929,TRX_N-01008-71642759,2024-05-09T08:08:23,Alegría-Dulantzi,expenses,repairs,-255.92,-77936.56
buyer_2,Carmen,,ES84209577803377945929,TRX_N-01009-41528360,2024-05-10T20:17:04,Zarautz,expenses,healthcare,-124.41,-78060.97
buyer_2,Carmen,,ES84209577803377945929,TRX_N-01010-23277564,2024-05-11T16:34:37,Lasarte-Oria,expenses,transport,-73.84,-78134.81
buyer_2,Carmen,,ES84209577803377945929,TRX_N-01011-51247798,2024-05-12T18:46:28,Zarautz,expenses,leisure,-49.08,-78183.89
buyer_2,Carmen,,ES84209577803377945929,TRX_N-01012-75729345,2024-05-14T19:42:52,Zarautz,expenses,cash,-100.0,-78283.89
buyer_2,Carmen,,ES84209577803377945929,TRX_N-01013-74190691,2024-05-14T15:34:32,Zarautz,expenses,appliances,-252.32,-78536.21
buyer_2,Carmen,,ES84209577803377945929,TRX_N-01014-01586439,2024-05-15T17:22:52,Zarautz,expenses,cash,-100.0,-78636.21
buyer_2,Carmen,,ES84209577803377945929,TRX_N-01015-55917596,2024-05-18T12:19:37,Zarautz,expenses,food,-64.0,-78700.21
buyer_2,Carmen,,ES84209577803377945929,TRX_N-01016-66348728,2024-05-18T08:41:23,Zarautz,expenses,leisure,-82.4,-78782.61
buyer_2,Carmen,,ES84209577803377945929,TRX_N-01017-76445778,2024-05-19T08:15:47,Zarautz,expenses,repairs,-300.07,-79082.68
buyer_2,Carmen,,ES84209577803377945929,TRX_N-01018-73018873,2024-05-21T20:46:41,Zarautz,expenses,repairs,-194.92,-79277.6
buyer_2,Carmen,,ES84209577803377945929,TRX_N-01019-18654687,2024-05-24T13:58:22,Zarautz,expenses,cash,-100.0,-79377.6
buyer_2,Carmen,,ES84209577803377945929,TRX_N-01020-33190554,2024-05-26T19:36:02,Sopela,expenses,cash,-100.0,-79477.6
buyer_2,Carmen,,ES84209577803377945929,TRX_N-01021-95816613,2024-05-27T13:20:56,Zarautz,expenses,food,-92.19,-79569.79
buyer_2,Carmen,,ES84209577803377945929,TRX_N-01022-45396325,2024-05-30T13:25:26,Zarautz,expenses,cash,-100.0,-79669.79
buyer_2,Carmen,,ES84209577803377945929,TRX_N-01023-39209753,2024-05-31T17:55:55,Zarautz,expenses,food,-81.38,-79751.17
buyer_2,Carmen,,ES84209577803377945929,TRX_N-01024-84052373,2024-06-01T08:11:03,Zarautz,incomes,salary,2127.77,-77623.4
buyer_2,Carmen,,ES84209577803377945929,TRX_N-01025-08342183,2024-06-01T08:11:03,Zarautz,incomes,salary_bonus,1634.26,-75989.14
buyer_2,Carmen,,ES84209577803377945929,TRX_N-01026-36340663,2024-06-01T16:20:36,Vitoria-Gasteiz,expenses,cash,-100.0,-76089.14
buyer_2,Carmen,,ES84209577803377945929,TRX_N-01027-42231667,2024-06-02T17:59:02,Zarautz,expenses,cash,-100.0,-76189.14
buyer_2,Carmen,,ES84209577803377945929,TRX_N-01028-30718741,2024-06-03T08:39:48,Zarautz,expenses,cash,-100.0,-76289.14
buyer_2,Carmen,,ES84209577803377945929,TRX_N-01029-02448844,2024-06-04T08:04:06,Zarautz,expenses,mortgage,-869.67,-77158.81
buyer_2,Carmen,,ES84209577803377945929,TRX_N-01030-37409450,2024-06-04T09:02:12,Zarautz,expenses,children,-210.63,-77369.44
buyer_2,Carmen,,ES84209577803377945929,TRX_N-01031-23180051,2024-06-05T00:57:39,Zarautz,expenses,water,-41.65,-77411.09
buyer_2,Carmen,,ES84209577803377945929,TRX_N-01032-15144634,2024-06-05T18:31:45,Zarautz,expenses,phone,-34.56,-77445.65
buyer_2,Carmen,,ES84209577803377945929,TRX_N-01033-61676310,2024-06-06T12:29:23,Zarautz,expenses,electricity,-62.65,-77508.3
buyer_2,Carmen,,ES84209577803377945929,TRX_N-01034-06163565,2024-06-06T15:31:18,Zarautz,expenses,gas,-93.63,-77601.93
buyer_2,Carmen,,ES84209577803377945929,TRX_N-01035-64444573,2024-06-07T07:59:04,Zarautz,expenses,cash,-100.0,-77701.93
buyer_2,Carmen,,ES84209577803377945929,TRX_N-01036-88270864,2024-06-08T17:04:51,Zarautz,expenses,internet,-42.0,-77743.93
buyer_2,Carmen,,ES84209577803377945929,TRX_N-01037-86914632,2024-06-09T14:50:58,Zarautz,expenses,cash,-100.0,-77843.93
buyer_2,Carmen,,ES84209577803377945929,TRX_N-01038-30060025,2024-06-11T15:43:33,Zarautz,expenses,food,-83.87,-77927.8
buyer_2,Carmen,,ES84209577803377945929,TRX_N-01039-07388629,2024-06-11T16:48:08,Zarautz,expenses,healthcare,-82.5,-78010.3
buyer_2,Carmen,,ES84209577803377945929,TRX_N-01040-41996075,2024-06-11T08:58:29,Zarautz,expenses,cash,-100.0,-78110.3
buyer_2,Carmen,,ES84209577803377945929,TRX_N-01041-16467334,2024-06-13T16:55:56,Zarautz,expenses,transport,-87.08,-78197.38
buyer_2,Carmen,,ES84209577803377945929,TRX_N-01042-46939365,2024-06-13T21:29:14,Mungia,expenses,cash,-100.0,-78297.38
buyer_2,Carmen,,ES84209577803377945929,TRX_N-01043-64292799,2024-06-14T09:01:42,Zarautz,expenses,food,-100.72,-78398.1
buyer_2,Carmen,,ES84209577803377945929,TRX_N-01044-39262574,2024-06-14T11:53:06,Galdakao,expenses,transport,-85.09,-78483.19
buyer_2,Carmen,,ES84209577803377945929,TRX_N-01045-53699016,2024-06-14T04:53:35,Zarautz,expenses,children,-498.91,-78982.1
buyer_2,Carmen,,ES84209577803377945929,TRX_N-01046-40810405,2024-06-16T19:17:16,Zarautz,expenses,cash,-100.0,-79082.1
buyer_2,Carmen,,ES84209577803377945929,TRX_N-01047-32824184,2024-06-17T16:55:54,Zarautz,expenses,appliances,-292.67,-79374.77
buyer_2,Carmen,,ES84209577803377945929,TRX_N-01048-41664785,2024-06-18T18:29:17,Zarautz,expenses,healthcare,-76.81,-79451.58
buyer_2,Carmen,,ES84209577803377945929,TRX_N-01049-32101755,2024-06-18T22:51:12,Zarautz,expenses,cash,-100.0,-79551.58
buyer_2,Carmen,,ES84209577803377945929,TRX_N-01050-59545508,2024-06-19T02:00:28,Lasarte-Oria,expenses,cash,-100.0,-79651.58
buyer_2,Carmen,,ES84209577803377945929,TRX_N-01051-27507450,2024-06-19T19:13:24,Zarautz,expenses,children,-617.37,-80268.95
buyer_2,Carmen,,ES84209577803377945929,TRX_N-01052-74759576,2024-06-20T08:23:16,Zarautz,expenses,gifts,-352.27,-80621.22
buyer_2,Carmen,,ES84209577803377945929,TRX_N-01053-43152035,2024-06-23T20:59:15,Zarautz,expenses,transport,-55.64,-80676.86
buyer_2,Carmen,,ES84209577803377945929,TRX_N-01054-44453131,2024-06-23T06:35:08,Zarautz,expenses,leisure,-71.92,-80748.78
buyer_2,Carmen,,ES84209577803377945929,TRX_N-01055-22620602,2024-06-24T14:50:29,Zarautz,expenses,food,-116.75,-80865.53
buyer_2,Carmen,,ES84209577803377945929,TRX_N-01056-24864767,2024-06-26T16:52:35,Zarautz,expenses,repairs,-238.67,-81104.2
buyer_2,Carmen,,ES84209577803377945929,TRX_N-01057-89277285,2024-06-27T09:09:27,Salvatierra/Agurain,expenses,transport,-52.68,-81156.88
buyer_2,Carmen,,ES84209577803377945929,TRX_N-01058-18106048,2024-06-27T08:07:46,Zarautz,expenses,appliances,-339.75,-81496.63
buyer_2,Carmen,,ES84209577803377945929,TRX_N-01059-98517248,2024-06-28T12:44:59,Vitoria-Gasteiz,expenses,clothing,-111.63,-81608.26
buyer_2,Carmen,,ES84209577803377945929,TRX_N-01060-46661097,2024-06-28T15:44:52,Labastida,expenses,healthcare,-174.41,-81782.67
buyer_2,Carmen,,ES84209577803377945929,TRX_N-01061-28833509,2024-06-29T10:55:32,Zarautz,expenses,cash,-100.0,-81882.67
buyer_2,Carmen,,ES84209577803377945929,TRX_N-01062-70812792,2024-06-30T13:12:00,Zarautz,expenses,transport,-80.85,-81963.52
buyer_2,Carmen,,ES84209577803377945929,TRX_N-01063-87945841,2024-06-30T14:57:26,Zarautz,expenses,travel,-510.03,-82473.55
buyer_2,Carmen,,ES84209577803377945929,TRX_N-01064-66603961,2024-07-01T22:51:26,Zarautz,incomes,salary,2127.77,-80345.78
buyer_2,Carmen,,ES84209577803377945929,TRX_N-01065-33351126,2024-07-01T12:47:56,Zarautz,expenses,education,-70.54,-80416.32
buyer_2,Carmen,,ES84209577803377945929,TRX_N-01066-08990039,2024-07-04T09:40:05,Zarautz,expenses,mortgage,-869.67,-81285.99
buyer_2,Carmen,,ES84209577803377945929,TRX_N-01067-98663876,2024-07-05T08:48:38,Zarautz,expenses,water,-36.78,-81322.77
buyer_2,Carmen,,ES84209577803377945929,TRX_N-01068-33564847,2024-07-05T15:36:05,Iruña de Oca,expenses,leisure,-20.7,-81343.47
buyer_2,Carmen,,ES84209577803377945929,TRX_N-01069-34302139,2024-07-07T09:53:26,Zarautz,expenses,electricity,-50.53,-81394.0
buyer_2,Carmen,,ES84209577803377945929,TRX_N-01070-50853021,2024-07-08T18:34:35,Zarautz,expenses,gas,-90.27,-81484.27
buyer_2,Carmen,,ES84209577803377945929,TRX_N-01071-31286133,2024-07-08T16:11:32,Zarautz,expenses,internet,-42.0,-81526.27
buyer_2,Carmen,,ES84209577803377945929,TRX_N-01072-22913646,2024-07-08T14:57:15,Zarautz,expenses,phone,-30.21,-81556.48
buyer_2,Carmen,,ES84209577803377945929,TRX_N-01073-51395642,2024-07-10T23:01:51,Zarautz,expenses,transport,-40.3,-81596.78
buyer_2,Carmen,,ES84209577803377945929,TRX_N-01074-65067339,2024-07-10T20:45:17,Zarautz,expenses,gifts,-83.56,-81680.34
buyer_2,Carmen,,ES84209577803377945929,TRX_N-01075-17563870,2024-07-11T20:45:31,Zarautz,expenses,healthcare,-105.14,-81785.48
buyer_2,Carmen,,ES84209577803377945929,TRX_N-01076-65271376,2024-07-12T13:09:55,Zarautz,expenses,leisure,-70.92,-81856.4
buyer_2,Carmen,,ES84209577803377945929,TRX_N-01077-24136236,2024-07-14T09:45:59,Zarautz,expenses,leisure,-24.47,-81880.87
buyer_2,Carmen,,ES84209577803377945929,TRX_N-01078-99484157,2024-07-15T08:34:10,Zuia,expenses,leisure,-80.67,-81961.54
buyer_2,Carmen,,ES84209577803377945929,TRX_N-01079-83485575,2024-07-18T22:32:20,Zarautz,expenses,leisure,-64.7,-82026.24
buyer_2,Carmen,,ES84209577803377945929,TRX_N-01080-94304703,2024-07-19T20:14:48,Zarautz,expenses,food,-117.91,-82144.15
buyer_2,Carmen,,ES84209577803377945929,TRX_N-01081-85080846,2024-07-20T09:32:49,Zarautz,expenses,food,-109.14,-82253.29
buyer_2,Carmen,,ES84209577803377945929,TRX_N-01082-66714998,2024-07-21T10:29:57,Zarautz,expenses,food,-85.71,-82339.0
buyer_2,Carmen,,ES84209577803377945929,TRX_N-01083-71846635,2024-07-21T10:09:51,Zarautz,expenses,education,-71.71,-82410.71
buyer_2,Carmen,,ES84209577803377945929,TRX_N-01084-99980544,2024-07-23T12:09:25,Pasaia,expenses,leisure,-54.87,-82465.58
buyer_2,Carmen,,ES84209577803377945929,TRX_N-01085-02704679,2024-07-26T10:26:33,Zarautz,expenses,leisure,-44.97,-82510.55
buyer_2,Carmen,,ES84209577803377945929,TRX_N-01086-59003639,2024-07-27T08:39:51,Zarautz,expenses,clothing,-158.64,-82669.19
buyer_2,Carmen,,ES84209577803377945929,TRX_N-01087-96378188,2024-07-27T18:13:22,Zarautz,expenses,cash,-100.0,-82769.19
buyer_2,Carmen,,ES84209577803377945929,TRX_N-01088-45878024,2024-07-27T15:39:45,Zarautz,expenses,gifts,-703.76,-83472.95
buyer_2,Carmen,,ES84209577803377945929,TRX_N-01089-98669713,2024-07-30T10:55:54,Getxo,expenses,clothing,-133.01,-83605.96
buyer_2,Carmen,,ES84209577803377945929,TRX_N-01090-60826783,2024-07-30T19:43:15,Zarautz,expenses,appliances,-111.7,-83717.66
buyer_2,Carmen,,ES84209577803377945929,TRX_N-01091-12886447,2024-08-01T15:44:42,Zarautz,incomes,salary,2127.77,-81589.89
buyer_2,Carmen,,ES84209577803377945929,TRX_N-01092-98794893,2024-08-01T15:44:42,Zarautz,incomes,extra_income,317.86,-81272.03
buyer_2,Carmen,,ES84209577803377945929,TRX_N-01093-79238996,2024-08-01T11:16:01,Zarautz,expenses,leisure,-60.15,-81332.18
buyer_2,Carmen,,ES84209577803377945929,TRX_N-01094-40557689,2024-08-03T14:05:03,Zuia,expenses,transport,-72.96,-81405.14
buyer_2,Carmen,,ES84209577803377945929,TRX_N-01095-54364196,2024-08-04T23:25:19,Zarautz,expenses,mortgage,-869.67,-82274.81
buyer_2,Carmen,,ES84209577803377945929,TRX_N-01096-08521528,2024-08-04T19:15:32,Zarautz,expenses,cash,-100.0,-82374.81
buyer_2,Carmen,,ES84209577803377945929,TRX_N-01097-39558475,2024-08-05T12:49:49,Zarautz,expenses,internet,-42.0,-82416.81
buyer_2,Carmen,,ES84209577803377945929,TRX_N-01098-15635720,2024-08-05T13:39:16,Zarautz,expenses,children,-462.7,-82879.51
buyer_2,Carmen,,ES84209577803377945929,TRX_N-01099-68549927,2024-08-06T14:30:13,Zarautz,expenses,phone,-38.5,-82918.01
buyer_2,Carmen,,ES84209577803377945929,TRX_N-01100-16776635,2024-08-06T19:13:03,Basauri,expenses,healthcare,-47.46,-82965.47
buyer_2,Carmen,,ES84209577803377945929,TRX_N-01101-21676191,2024-08-07T09:14:38,Zarautz,expenses,water,-34.99,-83000.46
buyer_2,Carmen,,ES84209577803377945929,TRX_N-01102-30367331,2024-08-07T18:27:01,Zarautz,expenses,gas,-83.78,-83084.24
buyer_2,Carmen,,ES84209577803377945929,TRX_N-01103-32383430,2024-08-07T19:38:03,Zarautz,expenses,leisure,-37.79,-83122.03
buyer_2,Carmen,,ES84209577803377945929,TRX_N-01104-97991955,2024-08-08T08:19:25,Zarautz,expenses,electricity,-25.04,-83147.07
buyer_2,Carmen,,ES84209577803377945929,TRX_N-01105-30274168,2024-08-10T09:23:38,Zarautz,expenses,repairs,-188.01,-83335.08
buyer_2,Carmen,,ES84209577803377945929,TRX_N-01106-72485451,2024-08-12T22:59:01,Zarautz,expenses,clothing,-145.83,-83480.91
buyer_2,Carmen,,ES84209577803377945929,TRX_N-01107-57134249,2024-08-13T09:05:53,Zarautz,expenses,gifts,-225.77,-83706.68
buyer_2,Carmen,,ES84209577803377945929,TRX_N-01108-54639097,2024-08-14T06:30:54,Zarautz,expenses,food,-96.05,-83802.73
buyer_2,Carmen,,ES84209577803377945929,TRX_N-01109-95918262,2024-08-14T16:57:35,Zarautz,expenses,children,-330.1,-84132.83
buyer_2,Carmen,,ES84209577803377945929,TRX_N-01110-08678412,2024-08-17T09:25:36,Zarautz,expenses,appliances,-328.74,-84461.57
buyer_2,Carmen,,ES84209577803377945929,TRX_N-01111-04357102,2024-08-19T15:36:38,Zarautz,expenses,transport,-47.61,-84509.18
buyer_2,Carmen,,ES84209577803377945929,TRX_N-01112-05661200,2024-08-21T03:31:28,Zarautz,expenses,clothing,-123.01,-84632.19
buyer_2,Carmen,,ES84209577803377945929,TRX_N-01113-50740025,2024-08-21T18:56:01,Zarautz,expenses,children,-292.6,-84924.79
buyer_2,Carmen,,ES84209577803377945929,TRX_N-01114-14443401,2024-08-22T09:34:55,Zarautz,expenses,cash,-100.0,-85024.79
buyer_2,Carmen,,ES84209577803377945929,TRX_N-01115-38044169,2024-08-22T12:37:48,Zarautz,expenses,appliances,-110.48,-85135.27
buyer_2,Carmen,,ES84209577803377945929,TRX_N-01116-24795507,2024-08-23T09:40:28,Zarautz,expenses,food,-123.46,-85258.73
buyer_2,Carmen,,ES84209577803377945929,TRX_N-01117-96954306,2024-08-24T19:05:30,Zarautz,expenses,leisure,-60.6,-85319.33
buyer_2,Carmen,,ES84209577803377945929,TRX_N-01118-94210803,2024-08-25T09:33:42,Zarautz,expenses,food,-86.82,-85406.15
buyer_2,Carmen,,ES84209577803377945929,TRX_N-01119-08564934,2024-08-25T08:23:49,Zarautz,expenses,transport,-61.51,-85467.66
buyer_2,Carmen,,ES84209577803377945929,TRX_N-01120-39686081,2024-08-26T18:36:10,Zarautz,expenses,appliances,-164.51,-85632.17
buyer_2,Carmen,,ES84209577803377945929,TRX_N-01121-90557776,2024-08-26T14:38:04,Irun,expenses,gifts,-46.58,-85678.75
buyer_2,Carmen,,ES84209577803377945929,TRX_N-01122-32738160,2024-08-27T13:42:32,Zarautz,expenses,transport,-61.96,-85740.71
buyer_2,Carmen,,ES84209577803377945929,TRX_N-01123-73573261,2024-08-27T06:48:45,Zarautz,expenses,leisure,-71.66,-85812.37
buyer_2,Carmen,,ES84209577803377945929,TRX_N-01124-90930982,2024-08-27T17:26:58,Zarautz,expenses,education,-55.42,-85867.79
buyer_2,Carmen,,ES84209577803377945929,TRX_N-01125-09446638,2024-08-27T10:38:14,Zarautz,expenses,cash,-100.0,-85967.79
buyer_2,Carmen,,ES84209577803377945929,TRX_N-01126-81697055,2024-08-28T21:22:43,Zarautz,expenses,healthcare,-186.6,-86154.39
buyer_2,Carmen,,ES84209577803377945929,TRX_N-01127-41512888,2024-08-29T21:44:23,Zarautz,expenses,clothing,-64.26,-86218.65
buyer_2,Carmen,,ES84209577803377945929,TRX_N-01128-70349957,2024-08-29T17:14:41,Zarautz,expenses,appliances,-396.7,-86615.35
buyer_2,Carmen,,ES84209577803377945929,TRX_N-01129-81408267,2024-08-30T17:46:32,Zarautz,expenses,gifts,-344.44,-86959.79
buyer_2,Carmen,,ES84209577803377945929,TRX_N-01130-92984788,2024-09-01T12:37:31,Zarautz,incomes,salary,2127.77,-84832.02
buyer_2,Carmen,,ES84209577803377945929,TRX_N-01131-83617970,2024-09-01T15:02:38,Zarautz,expenses,gifts,-767.63,-85599.65
buyer_2,Carmen,,ES84209577803377945929,TRX_N-01132-08081570,2024-09-02T09:20:35,Zarautz,expenses,leisure,-30.27,-85629.92
buyer_2,Carmen,,ES84209577803377945929,TRX_N-01133-70137113,2024-09-02T12:03:46,Zarautz,expenses,cash,-100.0,-85729.92
buyer_2,Carmen,,ES84209577803377945929,TRX_N-01134-03497725,2024-09-03T12:00:18,Zarautz,expenses,children,-586.22,-86316.14
buyer_2,Carmen,,ES84209577803377945929,TRX_N-01135-09140727,2024-09-04T08:34:02,Zarautz,expenses,mortgage,-869.67,-87185.81
buyer_2,Carmen,,ES84209577803377945929,TRX_N-01136-44669136,2024-09-05T12:50:50,Zarautz,expenses,electricity,-72.84,-87258.65
buyer_2,Carmen,,ES84209577803377945929,TRX_N-01137-57338858,2024-09-05T14:24:38,Zarautz,expenses,leisure,-59.66,-87318.31
buyer_2,Carmen,,ES84209577803377945929,TRX_N-01138-65956688,2024-09-05T13:52:53,Zarautz,expenses,clothing,-136.71,-87455.02
buyer_2,Carmen,,ES84209577803377945929,TRX_N-01139-68174805,2024-09-05T13:39:28,Zarautz,expenses,appliances,-277.83,-87732.85
buyer_2,Carmen,,ES84209577803377945929,TRX_N-01140-19147017,2024-09-06T11:06:51,Zarautz,expenses,phone,-31.04,-87763.89
buyer_2,Carmen,,ES84209577803377945929,TRX_N-01141-57638614,2024-09-07T20:08:50,Zarautz,expenses,gifts,-497.22,-88261.11
buyer_2,Carmen,,ES84209577803377945929,TRX_N-01142-07007117,2024-09-08T16:00:26,Zarautz,expenses,water,-20.29,-88281.4
buyer_2,Carmen,,ES84209577803377945929,TRX_N-01143-05944936,2024-09-08T20:10:47,Zarautz,expenses,gas,-55.89,-88337.29
buyer_2,Carmen,,ES84209577803377945929,TRX_N-01144-87618715,2024-09-08T11:38:33,Zarautz,expenses,internet,-42.0,-88379.29
buyer_2,Carmen,,ES84209577803377945929,TRX_N-01145-14468474,2024-09-09T16:07:21,Zarautz,expenses,cash,-100.0,-88479.29
buyer_2,Carmen,,ES84209577803377945929,TRX_N-01146-94064014,2024-09-14T08:19:10,Santurtzi,expenses,transport,-54.44,-88533.73
buyer_2,Carmen,,ES84209577803377945929,TRX_N-01147-38775970,2024-09-15T12:25:42,Zarautz,expenses,leisure,-49.62,-88583.35
buyer_2,Carmen,,ES84209577803377945929,TRX_N-01148-79667692,2024-09-18T16:13:33,Lasarte-Oria,expenses,leisure,-83.3,-88666.65
buyer_2,Carmen,,ES84209577803377945929,TRX_N-01149-10721849,2024-09-18T16:40:27,Zarautz,expenses,cash,-100.0,-88766.65
buyer_2,Carmen,,ES84209577803377945929,TRX_N-01150-23901480,2024-09-19T22:45:09,Zarautz,expenses,appliances,-90.28,-88856.93
buyer_2,Carmen,,ES84209577803377945929,TRX_N-01151-09256989,2024-09-20T20:38:43,Zarautz,expenses,leisure,-73.54,-88930.47
buyer_2,Carmen,,ES84209577803377945929,TRX_N-01152-42112367,2024-09-21T20:41:26,Zarautz,expenses,transport,-81.52,-89011.99
buyer_2,Carmen,,ES84209577803377945929,TRX_N-01153-90004825,2024-09-22T02:00:05,Zarautz,expenses,food,-84.01,-89096.0
buyer_2,Carmen,,ES84209577803377945929,TRX_N-01154-11212228,2024-09-23T19:26:55,Zarautz,expenses,transport,-88.42,-89184.42
buyer_2,Carmen,,ES84209577803377945929,TRX_N-01155-09826086,2024-09-23T16:30:40,Zarautz,expenses,leisure,-65.85,-89250.27
buyer_2,Carmen,,ES84209577803377945929,TRX_N-01156-36688917,2024-09-23T14:50:43,Zarautz,expenses,cash,-100.0,-89350.27
buyer_2,Carmen,,ES84209577803377945929,TRX_N-01157-14422891,2024-09-25T10:38:52,Zarautz,expenses,food,-78.45,-89428.72
buyer_2,Carmen,,ES84209577803377945929,TRX_N-01158-96404808,2024-09-26T08:58:05,Zarautz,expenses,healthcare,-163.19,-89591.91
buyer_2,Carmen,,ES84209577803377945929,TRX_N-01159-91169898,2024-09-29T12:57:22,Leioa,expenses,repairs,-286.7,-89878.61
buyer_2,Carmen,,ES84209577803377945929,TRX_N-01160-96641323,2024-10-01T16:50:48,Zarautz,incomes,salary,2127.77,-87750.84
buyer_2,Carmen,,ES84209577803377945929,TRX_N-01161-35592928,2024-10-04T13:57:25,Zarautz,expenses,mortgage,-869.67,-88620.51
buyer_2,Carmen,,ES84209577803377945929,TRX_N-01162-47320568,2024-10-04T18:02:13,Zarautz,expenses,transport,-56.05,-88676.56
buyer_2,Carmen,,ES84209577803377945929,TRX_N-01163-15694855,2024-10-05T22:35:07,Zarautz,expenses,food,-94.74,-88771.3
buyer_2,Carmen,,ES84209577803377945929,TRX_N-01164-39202097,2024-10-06T00:44:39,Zarautz,expenses,electricity,-57.65,-88828.95
buyer_2,Carmen,,ES84209577803377945929,TRX_N-01165-90446509,2024-10-06T13:46:52,Zarautz,expenses,gas,-32.09,-88861.04
buyer_2,Carmen,,ES84209577803377945929,TRX_N-01166-09003726,2024-10-06T14:59:29,Zarautz,expenses,phone,-44.42,-88905.46
buyer_2,Carmen,,ES84209577803377945929,TRX_N-01167-57786354,2024-10-06T08:08:26,Zarautz,expenses,food,-83.71,-88989.17
buyer_2,Carmen,,ES84209577803377945929,TRX_N-01168-36503179,2024-10-07T21:10:10,Zarautz,expenses,water,-32.28,-89021.45
buyer_2,Carmen,,ES84209577803377945929,TRX_N-01169-77173029,2024-10-08T11:03:06,Zarautz,expenses,internet,-42.0,-89063.45
buyer_2,Carmen,,ES84209577803377945929,TRX_N-01170-26742482,2024-10-09T20:10:05,Zarautz,expenses,food,-91.53,-89154.98
buyer_3,Ana,,ES28209566637786783299,TRX_N-00001-13535991,2022-01-01T19:36:13,Amurrio,incomes,salary,3573.12,10160.75
buyer_3,Ana,,ES28209566637786783299,TRX_N-00002-45009187,2022-01-01T19:36:13,Amurrio,incomes,salary_partner,3757.1,13917.85
buyer_3,Ana,,ES28209566637786783299,TRX_N-00003-66521052,2022-01-03T12:24:38,Amurrio,expenses,leisure,-28.6,13889.25
buyer_3,Ana,,ES28209566637786783299,TRX_N-00004-44210944,2022-01-03T19:02:03,Amurrio,expenses,cash,-100.0,13789.25
buyer_3,Ana,,ES28209566637786783299,TRX_N-00005-64856675,2022-01-04T13:31:50,Amurrio,expenses,mortgage,-853.26,12935.99
buyer_3,Ana,,ES28209566637786783299,TRX_N-00006-63110480,2022-01-06T16:58:49,Amurrio,expenses,internet,-42.0,12893.99
buyer_3,Ana,,ES28209566637786783299,TRX_N-00007-57836431,2022-01-06T03:15:33,Amurrio,expenses,phone,-33.78,12860.21
buyer_3,Ana,,ES28209566637786783299,TRX_N-00008-80904241,2022-01-06T12:42:41,Mungia,expenses,transport,-46.84,12813.37
buyer_3,Ana,,ES28209566637786783299,TRX_N-00009-19842063,2022-01-07T11:03:25,Amurrio,expenses,clothing,-147.71,12665.66
buyer_3,Ana,,ES28209566637786783299,TRX_N-00010-72360783,2022-01-08T23:39:44,Amurrio,expenses,water,-41.94,12623.72
buyer_3,Ana,,ES28209566637786783299,TRX_N-00011-05216917,2022-01-08T19:46:54,Amurrio,expenses,electricity,-26.99,12596.73
buyer_3,Ana,,ES28209566637786783299,TRX_N-00012-86027565,2022-01-08T12:48:15,Amurrio,expenses,gas,-93.21,12503.52
buyer_3,Ana,,ES28209566637786783299,TRX_N-00013-90014079,2022-01-08T17:50:10,Amurrio,expenses,appliances,-403.96,12099.56
buyer_3,Ana,,ES28209566637786783299,TRX_N-00014-63253123,2022-01-08T10:17:20,Leioa,expenses,repairs,-244.23,11855.33
buyer_3,Ana,,ES28209566637786783299,TRX_N-00015-31820907,2022-01-11T14:57:19,Durango,expenses,food,-85.18,11770.15
buyer_3,Ana,,ES28209566637786783299,TRX_N-00016-29992527,2022-01-12T13:07:55,Amurrio,expenses,cash,-100.0,11670.15
buyer_3,Ana,,ES28209566637786783299,TRX_N-00017-40387508,2022-01-13T08:16:15,Amurrio,expenses,food,-76.67,11593.48
buyer_3,Ana,,ES28209566637786783299,TRX_N-00018-26490159,2022-01-13T01:36:25,Amurrio,expenses,leisure,-30.59,11562.89
buyer_3,Ana,,ES28209566637786783299,TRX_N-00019-79074957,2022-01-13T15:49:52,Amurrio,expenses,clothing,-80.43,11482.46
buyer_3,Ana,,ES28209566637786783299,TRX_N-00020-99973277,2022-01-17T20:19:23,Amurrio,expenses,gifts,-675.24,10807.22
buyer_3,Ana,,ES28209566637786783299,TRX_N-00021-87649858,2022-01-20T13:24:03,Lasarte-Oria,expenses,transport,-76.68,10730.54
buyer_3,Ana,,ES28209566637786783299,TRX_N-00022-32066091,2022-01-20T00:11:04,Amurrio,expenses,cash,-100.0,10630.54
buyer_3,Ana,,ES28209566637786783299,TRX_N-00023-76016810,2022-01-21T15:49:19,Alegría-Dulantzi,expenses,education,-77.42,10553.12
buyer_3,Ana,,ES28209566637786783299,TRX_N-00024-41064843,2022-01-21T22:02:52,Arrasate,expenses,cash,-100.0,10453.12
buyer_3,Ana,,ES28209566637786783299,TRX_N-00025-69694664,2022-01-22T12:07:15,Amurrio,expenses,car,-146.65,10306.47
buyer_3,Ana,,ES28209566637786783299,TRX_N-00026-28474494,2022-01-23T20:37:38,Amurrio,expenses,transport,-61.49,10244.98
buyer_3,Ana,,ES28209566637786783299,TRX_N-00027-01850918,2022-01-26T14:38:23,Amurrio,expenses,transport,-80.08,10164.9
buyer_3,Ana,,ES28209566637786783299,TRX_N-00028-93657760,2022-01-28T10:44:55,Amurrio,expenses,cash,-100.0,10064.9
buyer_3,Ana,,ES28209566637786783299,TRX_N-00029-14524565,2022-01-29T12:30:32,Amurrio,expenses,cash,-100.0,9964.9
buyer_3,Ana,,ES28209566637786783299,TRX_N-00030-33196108,2022-01-30T13:11:31,Amurrio,expenses,leisure,-75.72,9889.18
buyer_3,Ana,,ES28209566637786783299,TRX_N-00031-16793680,2022-01-31T20:55:47,Amurrio,expenses,education,-53.26,9835.92
buyer_3,Ana,,ES28209566637786783299,TRX_N-00032-26764674,2022-02-01T23:29:33,Amurrio,incomes,salary,3573.12,13409.04
buyer_3,Ana,,ES28209566637786783299,TRX_N-00033-10842733,2022-02-01T23:29:33,Amurrio,incomes,salary_partner,3757.1,17166.14
buyer_3,Ana,,ES28209566637786783299,TRX_N-00034-45607452,2022-02-02T10:44:03,Santurtzi,expenses,transport,-52.25,17113.89
buyer_3,Ana,,ES28209566637786783299,TRX_N-00035-12540732,2022-02-02T10:50:01,Amurrio,expenses,clothing,-112.33,17001.56
buyer_3,Ana,,ES28209566637786783299,TRX_N-00036-84136885,2022-02-04T18:54:51,Amurrio,expenses,mortgage,-853.26,16148.3
buyer_3,Ana,,ES28209566637786783299,TRX_N-00037-52119064,2022-02-04T20:02:57,Donostia,expenses,transport,-62.31,16085.99
buyer_3,Ana,,ES28209566637786783299,TRX_N-00038-38595415,2022-02-04T20:14:26,Amurrio,expenses,cash,-100.0,15985.99
buyer_3,Ana,,ES28209566637786783299,TRX_N-00039-45392631,2022-02-05T14:27:12,Amurrio,expenses,phone,-36.61,15949.38
buyer_3,Ana,,ES28209566637786783299,TRX_N-00040-38181108,2022-02-05T13:07:19,Amurrio,expenses,leisure,-31.97,15917.41
buyer_3,Ana,,ES28209566637786783299,TRX_N-00041-06333427,2022-02-05T11:50:16,Amurrio,expenses,cash,-100.0,15817.41
buyer_3,Ana,,ES28209566637786783299,TRX_N-00042-19352341,2022-02-06T18:29:15,Amurrio,expenses,repairs,-221.34,15596.07
buyer_3,Ana,,ES28209566637786783299,TRX_N-00043-11532857,2022-02-07T02:43:17,Amurrio,expenses,leisure,-46.96,15549.11
buyer_3,Ana,,ES28209566637786783299,TRX_N-00044-38899252,2022-02-08T10:23:11,Amurrio,expenses,internet,-42.0,15507.11
buyer_3,Ana,,ES28209566637786783299,TRX_N-00045-75891679,2022-02-08T15:08:23,Amurrio,expenses,water,-23.89,15483.22
buyer_3,Ana,,ES28209566637786783299,TRX_N-00046-68027954,2022-02-08T19:15:06,Amurrio,expenses,electricity,-58.73,15424.49
buyer_3,Ana,,ES28209566637786783299,TRX_N-00047-26760152,2022-02-08T12:14:47,Amurrio,expenses,gas,-34.31,15390.18
buyer_3,Ana,,ES28209566637786783299,TRX_N-00048-23802229,2022-02-08T08:07:00,Amurrio,expenses,education,-56.54,15333.64
buyer_3,Ana,,ES28209566637786783299,TRX_N-00049-50049175,2022-02-08T17:29:10,Amurrio,expenses,cash,-100.0,15233.64
buyer_3,Ana,,ES28209566637786783299,TRX_N-00050-04242742,2022-02-10T00:47:13,Amurrio,expenses,gifts,-848.89,14384.75
buyer_3,Ana,,ES28209566637786783299,TRX_N-00051-86924195,2022-02-11T12:05:50,Amurrio,expenses,repairs,-155.73,14229.02
buyer_3,Ana,,ES28209566637786783299,TRX_N-00052-45872123,2022-02-12T11:23:57,Errenteria,expenses,cash,-100.0,14129.02
buyer_3,Ana,,ES28209566637786783299,TRX_N-00053-12664355,2022-02-12T17:49:35,Amurrio,expenses,repairs,-54.29,14074.73
buyer_3,Ana,,ES28209566637786783299,TRX_N-00054-96884183,2022-02-17T09:28:08,Amurrio,expenses,cash,-100.0,13974.73
buyer_3,Ana,,ES28209566637786783299,TRX_N-00055-01250988,2022-02-17T04:32:46,Amurrio,expenses,travel,-351.08,13623.65
buyer_3,Ana,,ES28209566637786783299,TRX_N-00056-50582934,2022-02-20T17:21:29,Oyón-Oion,expenses,leisure,-84.32,13539.33
buyer_3,Ana,,ES28209566637786783299,TRX_N-00057-56077624,2022-02-21T16:03:45,Amurrio,expenses,transport,-45.1,13494.23
buyer_3,Ana,,ES28209566637786783299,TRX_N-00058-73814594,2022-02-22T15:56:57,Amurrio,expenses,transport,-54.74,13439.49
buyer_3,Ana,,ES28209566637786783299,TRX_N-00059-51003820,2022-02-22T16:22:26,Amurrio,expenses,cash,-100.0,13339.49
buyer_3,Ana,,ES28209566637786783299,TRX_N-00060-86273255,2022-02-23T10:36:09,Amurrio,expenses,cash,-100.0,13239.49
buyer_3,Ana,,ES28209566637786783299,TRX_N-00061-61841322,2022-02-25T14:39:57,Amurrio,expenses,food,-74.21,13165.28
buyer_3,Ana,,ES28209566637786783299,TRX_N-00062-94024708,2022-02-25T11:46:13,Bilbao,expenses,cash,-100.0,13065.28
buyer_3,Ana,,ES28209566637786783299,TRX_N-00063-10885982,2022-02-26T22:54:25,Leioa,expenses,cash,-100.0,12965.28
buyer_3,Ana,,ES28209566637786783299,TRX_N-00064-65976889,2022-03-01T05:51:03,Amurrio,incomes,salary,3573.12,16538.4
buyer_3,Ana,,ES28209566637786783299,TRX_N-00065-05970194,2022-03-01T05:51:03,Amurrio,incomes,salary_partner,3757.1,20295.5
buyer_3,Ana,,ES28209566637786783299,TRX_N-00066-07118498,2022-03-01T05:51:03,Amurrio,incomes,extra_income,361.07,20656.57
buyer_3,Ana,,ES28209566637786783299,TRX_N-00067-70861672,2022-03-01T17:59:25,Arrasate,expenses,repairs,-151.15,20505.42
buyer_3,Ana,,ES28209566637786783299,TRX_N-00068-28646662,2022-03-02T18:03:38,Amurrio,expenses,cash,-100.0,20405.42
buyer_3,Ana,,ES28209566637786783299,TRX_N-00069-86643800,2022-03-03T15:56:42,Amurrio,expenses,repairs,-85.97,20319.45
buyer_3,Ana,,ES28209566637786783299,TRX_N-00070-11469961,2022-03-04T17:14:54,Amurrio,expenses,mortgage,-853.26,19466.19
buyer_3,Ana,,ES28209566637786783299,TRX_N-00071-25628471,2022-03-04T13:48:38,Amurrio,expenses,food,-99.96,19366.23
buyer_3,Ana,,ES28209566637786783299,TRX_N-00072-96833862,2022-03-05T13:16:58,Amurrio,expenses,food,-114.3,19251.93
buyer_3,Ana,,ES28209566637786783299,TRX_N-00073-56560202,2022-03-05T08:29:24,Amurrio,expenses,cash,-100.0,19151.93
buyer_3,Ana,,ES28209566637786783299,TRX_N-00074-55576855,2022-03-06T10:41:15,Amurrio,expenses,phone,-35.08,19116.85
buyer_3,Ana,,ES28209566637786783299,TRX_N-00075-43115462,2022-03-08T14:07:54,Amurrio,expenses,water,-20.71,19096.14
buyer_3,Ana,,ES28209566637786783299,TRX_N-00076-70367166,2022-03-08T20:11:17,Amurrio,expenses,electricity,-53.54,19042.6
buyer_3,Ana,,ES28209566637786783299,TRX_N-00077-55801451,2022-03-08T19:09:08,Amurrio,expenses,gas,-34.88,19007.72
buyer_3,Ana,,ES28209566637786783299,TRX_N-00078-26359525,2022-03-08T22:25:09,Amurrio,expenses,internet,-42.0,18965.72
buyer_3,Ana,,ES28209566637786783299,TRX_N-00079-32355113,2022-03-10T12:53:03,Amurrio,expenses,food,-107.36,18858.36
buyer_3,Ana,,ES28209566637786783299,TRX_N-00080-64964720,2022-03-12T03:18:12,Amurrio,expenses,healthcare,-144.69,18713.67
buyer_3,Ana,,ES28209566637786783299,TRX_N-00081-08192059,2022-03-12T08:49:58,Durango,expenses,gifts,-510.64,18203.03
buyer_3,Ana,,ES28209566637786783299,TRX_N-00082-12252926,2022-03-15T19:54:25,Amurrio,expenses,transport,-50.04,18152.99
buyer_3,Ana,,ES28209566637786783299,TRX_N-00083-00001187,2022-03-16T18:00:25,Zuia,expenses,gifts,-277.79,17875.2
buyer_3,Ana,,ES28209566637786783299,TRX_N-00084-21617798,2022-03-18T20:40:35,Amurrio,expenses,transport,-58.33,17816.87
buyer_3,Ana,,ES28209566637786783299,TRX_N-00085-66582510,2022-03-18T19:07:15,Amurrio,expenses,leisure,-32.66,17784.21
buyer_3,Ana,,ES28209566637786783299,TRX_N-00086-18400921,2022-03-19T23:50:30,Mungia,expenses,repairs,-162.6,17621.61
buyer_3,Ana,,ES28209566637786783299,TRX_N-00087-32498079,2022-03-22T03:00:18,Amurrio,expenses,gifts,-600.89,17020.72
buyer_3,Ana,,ES28209566637786783299,TRX_N-00088-85401686,2022-03-25T19:40:30,Zarautz,expenses,leisure,-47.01,16973.71
buyer_3,Ana,,ES28209566637786783299,TRX_N-00089-71386962,2022-03-26T12:59:20,Amurrio,expenses,transport,-41.96,16931.75
buyer_3,Ana,,ES28209566637786783299,TRX_N-00090-32025565,2022-03-26T18:12:50,Llodio,expenses,healthcare,-178.86,16752.89
buyer_3,Ana,,ES28209566637786783299,TRX_N-00091-65269470,2022-03-28T12:13:22,Amurrio,expenses,leisure,-41.81,16711.08
buyer_3,Ana,,ES28209566637786783299,TRX_N-00092-16740476,2022-03-31T10:11:22,Amurrio,expenses,gifts,-140.18,16570.9
buyer_3,Ana,,ES28209566637786783299,TRX_N-00093-74049073,2022-04-01T16:16:36,Amurrio,incomes,salary,3573.12,20144.02
buyer_3,Ana,,ES28209566637786783299,TRX_N-00094-13657489,2022-04-01T16:16:36,Amurrio,incomes,salary_partner,3757.1,23901.12
buyer_3,Ana,,ES28209566637786783299,TRX_N-00095-22715619,2022-04-01T02:29:29,Amurrio,expenses,food,-66.86,23834.26
buyer_3,Ana,,ES28209566637786783299,TRX_N-00096-41260348,2022-04-02T23:16:47,Amurrio,expenses,clothing,-132.02,23702.24
buyer_3,Ana,,ES28209566637786783299,TRX_N-00097-68243734,2022-04-02T14:11:39,Amurrio,expenses,cash,-100.0,23602.24
buyer_3,Ana,,ES28209566637786783299,TRX_N-00098-93949590,2022-04-04T18:37:10,Amurrio,expenses,mortgage,-853.26,22748.98
buyer_3,Ana,,ES28209566637786783299,TRX_N-00099-96309254,2022-04-04T06:09:46,Amurrio,expenses,transport,-54.99,22693.99
buyer_3,Ana,,ES28209566637786783299,TRX_N-00100-16046927,2022-04-05T00:00:52,Amurrio,expenses,water,-44.58,22649.41
buyer_3,Ana,,ES28209566637786783299,TRX_N-00101-13503141,2022-04-05T17:20:38,Amurrio,expenses,internet,-42.0,22607.41
buyer_3,Ana,,ES28209566637786783299,TRX_N-00102-08868475,2022-04-06T19:14:51,Amurrio,expenses,electricity,-22.23,22585.18
buyer_3,Ana,,ES28209566637786783299,TRX_N-00103-06570453,2022-04-06T20:03:44,Amurrio,expenses,repairs,-203.07,22382.11
buyer_3,Ana,,ES28209566637786783299,TRX_N-00104-57487212,2022-04-07T09:37:17,Amurrio,expenses,gas,-34.76,22347.35
buyer_3,Ana,,ES28209566637786783299,TRX_N-00105-77617489,2022-04-07T01:24:04,Amurrio,expenses,phone,-36.9,22310.45
buyer_3,Ana,,ES28209566637786783299,TRX_N-00106-76091268,2022-04-08T18:26:33,Amurrio,expenses,cash,-100.0,22210.45
buyer_3,Ana,,ES28209566637786783299,TRX_N-00107-29646758,2022-04-08T08:32:35,Oyón-Oion,expenses,gifts,-675.28,21535.17
buyer_3,Ana,,ES28209566637786783299,TRX_N-00108-88310198,2022-04-09T08:41:56,Irun,expenses,leisure,-24.72,21510.45
buyer_3,Ana,,ES28209566637786783299,TRX_N-00109-22434873,2022-04-09T12:13:24,Lasarte-Oria,expenses,cash,-100.0,21410.45
buyer_3,Ana,,ES28209566637786783299,TRX_N-00110-48393335,2022-04-09T12:07:46,Amurrio,expenses,repairs,-216.81,21193.64
buyer_3,Ana,,ES28209566637786783299,TRX_N-00111-18342607,2022-04-10T05:01:10,Amurrio,expenses,leisure,-51.0,21142.64
buyer_3,Ana,,ES28209566637786783299,TRX_N-00112-92226961,2022-04-10T09:17:47,Amurrio,expenses,cash,-100.0,21042.64
buyer_3,Ana,,ES28209566637786783299,TRX_N-00113-27447306,2022-04-11T15:50:44,Basauri,expenses,food,-121.15,20921.49
buyer_3,Ana,,ES28209566637786783299,TRX_N-00114-10645568,2022-04-13T10:40:11,Amurrio,expenses,repairs,-192.58,20728.91
buyer_3,Ana,,ES28209566637786783299,TRX_N-00115-26697644,2022-04-14T20:37:47,Amurrio,expenses,food,-90.73,20638.18
buyer_3,Ana,,ES28209566637786783299,TRX_N-00116-68640692,2022-04-14T19:22:57,Amurrio,expenses,leisure,-83.55,20554.63
buyer_3,Ana,,ES28209566637786783299,TRX_N-00117-76070248,2022-04-17T18:34:41,Amurrio,expenses,healthcare,-64.27,20490.36
buyer_3,Ana,,ES28209566637786783299,TRX_N-00118-79189140,2022-04-19T14:47:58,Amurrio,expenses,leisure,-49.3,20441.06
buyer_3,Ana,,ES28209566637786783299,TRX_N-00119-27198372,2022-04-21T15:15:22,Santurtzi,expenses,education,-61.59,20379.47
buyer_3,Ana,,ES28209566637786783299,TRX_N-00120-23356187,2022-04-22T19:16:16,Amurrio,expenses,education,-67.67,20311.8
buyer_3,Ana,,ES28209566637786783299,TRX_N-00121-26995803,2022-04-23T17:27:25,Amurrio,expenses,leisure,-76.0,20235.8
buyer_3,Ana,,ES28209566637786783299,TRX_N-00122-29916067,2022-04-24T13:26:55,Amurrio,expenses,cash,-100.0,20135.8
buyer_3,Ana,,ES28209566637786783299,TRX_N-00123-40396451,2022-04-27T17:56:38,Amurrio,expenses,cash,-100.0,20035.8
buyer_3,Ana,,ES28209566637786783299,TRX_N-00124-45279133,2022-04-28T18:18:24,Amurrio,expenses,travel,-1777.22,18258.58
buyer_3,Ana,,ES28209566637786783299,TRX_N-00125-44553780,2022-04-29T15:16:08,Amurrio,expenses,gifts,-389.26,17869.32
buyer_3,Ana,,ES28209566637786783299,TRX_N-00126-55093093,2022-04-30T18:28:14,Amurrio,expenses,repairs,-160.99,17708.33
buyer_3,Ana,,ES28209566637786783299,TRX_N-00127-89238733,2022-05-01T21:26:39,Amurrio,incomes,salary,3573.12,21281.45
buyer_3,Ana,,ES28209566637786783299,TRX_N-00128-93897076,2022-05-01T21:26:39,Amurrio,incomes,salary_partner,3757.1,25038.55
buyer_3,Ana,,ES28209566637786783299,TRX_N-00129-32390653,2022-05-01T15:27:40,Amurrio,expenses,leisure,-45.34,24993.21
buyer_3,Ana,,ES28209566637786783299,TRX_N-00130-33683877,2022-05-01T09:54:32,Amurrio,expenses,cash,-100.0,24893.21
buyer_3,Ana,,ES28209566637786783299,TRX_N-00131-62320101,2022-05-02T18:23:21,Amurrio,expenses,leisure,-19.42,24873.79
buyer_3,Ana,,ES28209566637786783299,TRX_N-00132-57604062,2022-05-03T09:06:12,Amurrio,expenses,cash,-100.0,24773.79
buyer_3,Ana,,ES28209566637786783299,TRX_N-00133-31962067,2022-05-04T19:57:24,Amurrio,expenses,mortgage,-853.26,23920.53
buyer_3,Ana,,ES28209566637786783299,TRX_N-00134-98480960,2022-05-05T10:24:43,Amurrio,expenses,internet,-42.0,23878.53
buyer_3,Ana,,ES28209566637786783299,TRX_N-00135-37273201,2022-05-05T01:29:29,Amurrio,expenses,phone,-35.17,23843.36
buyer_3,Ana,,ES28209566637786783299,TRX_N-00136-64501443,2022-05-05T09:07:46,Amurrio,expenses,gifts,-831.96,23011.4
buyer_3,Ana,,ES28209566637786783299,TRX_N-00137-08825844,2022-05-06T19:03:20,Amurrio,expenses,water,-35.93,22975.47
buyer_3,Ana,,ES28209566637786783299,TRX_N-00138-17536274,2022-05-06T08:59:41,Amurrio,expenses,cash,-100.0,22875.47
buyer_3,Ana,,ES28209566637786783299,TRX_N-00139-73526891,2022-05-07T02:40:03,Amurrio,expenses,repairs,-203.68,22671.79
buyer_3,Ana,,ES28209566637786783299,TRX_N-00140-33991271,2022-05-08T17:55:05,Amurrio,expenses,electricity,-44.1,22627.69
buyer_3,Ana,,ES28209566637786783299,TRX_N-00141-70521710,2022-05-08T09:53:57,Amurrio,expenses,gas,-57.24,22570.45
buyer_3,Ana,,ES28209566637786783299,TRX_N-00142-61208638,2022-05-09T20:17:10,Amurrio,expenses,clothing,-78.98,22491.47
buyer_3,Ana,,ES28209566637786783299,TRX_N-00143-50380945,2022-05-11T13:58:10,Amurrio,expenses,food,-103.84,22387.63
buyer_3,Ana,,ES28209566637786783299,TRX_N-00144-91256874,2022-05-11T13:29:49,Amurrio,expenses,clothing,-99.2,22288.43
buyer_3,Ana,,ES28209566637786783299,TRX_N-00145-62665687,2022-05-16T10:41:17,Portugalete,expenses,leisure,-44.88,22243.55
buyer_3,Ana,,ES28209566637786783299,TRX_N-00146-36433122,2022-05-16T16:48:53,Amurrio,expenses,cash,-100.0,22143.55
buyer_3,Ana,,ES28209566637786783299,TRX_N-00147-87807329,2022-05-17T23:51:08,Mungia,expenses,transport,-47.33,22096.22
buyer_3,Ana,,ES28209566637786783299,TRX_N-00148-55811137,2022-05-17T18:48:34,Bilbao,expenses,leisure,-73.37,22022.85
buyer_3,Ana,,ES28209566637786783299,TRX_N-00149-70050792,2022-05-17T17:05:35,Amurrio,expenses,appliances,-122.83,21900.02
buyer_3,Ana,,ES28209566637786783299,TRX_N-00150-64561242,2022-05-23T19:05:28,Amurrio,expenses,cash,-100.0,21800.02
buyer_3,Ana,,ES28209566637786783299,TRX_N-00151-82760700,2022-05-24T18:01:22,Bilbao,expenses,food,-76.38,21723.64
buyer_3,Ana,,ES28209566637786783299,TRX_N-00152-72160152,2022-05-25T20:56:18,Amurrio,expenses,appliances,-137.0,21586.64
buyer_3,Ana,,ES28209566637786783299,TRX_N-00153-26601722,2022-05-27T15:49:05,Amurrio,expenses,leisure,-73.36,21513.28
buyer_3,Ana,,ES28209566637786783299,TRX_N-00154-91232605,2022-05-27T10:39:28,Leioa,expenses,clothing,-56.1,21457.18
buyer_3,Ana,,ES28209566637786783299,TRX_N-00155-54300967,2022-05-28T08:07:32,Amurrio,expenses,clothing,-141.65,21315.53
buyer_3,Ana,,ES28209566637786783299,TRX_N-00156-61078885,2022-05-28T15:21:28,Amurrio,expenses,repairs,-213.82,21101.71
buyer_3,Ana,,ES28209566637786783299,TRX_N-00157-73807289,2022-05-30T18:32:53,Amurrio,expenses,leisure,-58.11,21043.6
buyer_3,Ana,,ES28209566637786783299,TRX_N-00158-90018944,2022-05-31T13:48:56,Amurrio,expenses,food,-70.74,20972.86
buyer_3,Ana,,ES28209566637786783299,TRX_N-00159-25370220,2022-05-31T15:39:43,Amurrio,expenses,cash,-100.0,20872.86
buyer_3,Ana,,ES28209566637786783299,TRX_N-00160-41956634,2022-06-01T10:44:32,Amurrio,incomes,salary,3573.12,24445.98
buyer_3,Ana,,ES28209566637786783299,TRX_N-00161-62623815,2022-06-01T10:44:32,Amurrio,incomes,salary_partner,3757.1,28203.08
buyer_3,Ana,,ES28209566637786783299,TRX_N-00162-35068263,2022-06-01T10:44:32,Amurrio,incomes,salary_bonus,2511.57,30714.65
buyer_3,Ana,,ES28209566637786783299,TRX_N-00163-75719285,2022-06-01T10:44:32,Amurrio,incomes,salary_partner_bonus,2857.23,33571.88
buyer_3,Ana,,ES28209566637786783299,TRX_N-00164-07118401,2022-06-01T09:28:41,Amurrio,expenses,leisure,-48.29,33523.59
buyer_3,Ana,,ES28209566637786783299,TRX_N-00165-78589217,2022-06-02T17:24:35,Berango,expenses,food,-101.72,33421.87
buyer_3,Ana,,ES28209566637786783299,TRX_N-00166-41153519,2022-06-02T06:44:00,Amurrio,expenses,appliances,-141.44,33280.43
buyer_3,Ana,,ES28209566637786783299,TRX_N-00167-67311701,2022-06-04T13:48:32,Amurrio,expenses,mortgage,-853.26,32427.17
buyer_3,Ana,,ES28209566637786783299,TRX_N-00168-69355073,2022-06-04T19:04:57,Amurrio,expenses,cash,-100.0,32327.17
buyer_3,Ana,,ES28209566637786783299,TRX_N-00169-15281704,2022-06-05T16:41:07,Amurrio,expenses,internet,-42.0,32285.17
buyer_3,Ana,,ES28209566637786783299,TRX_N-00170-88712319,2022-06-06T16:10:30,Amurrio,expenses,water,-33.12,32252.05
buyer_3,Ana,,ES28209566637786783299,TRX_N-00171-99937866,2022-06-06T08:27:42,Amurrio,expenses,electricity,-67.6,32184.45
buyer_3,Ana,,ES28209566637786783299,TRX_N-00172-42780597,2022-06-06T08:06:30,Amurrio,expenses,gas,-111.75,32072.7
buyer_3,Ana,,ES28209566637786783299,TRX_N-00173-13686128,2022-06-07T09:07:01,Amurrio,expenses,repairs,-49.38,32023.32
buyer_3,Ana,,ES28209566637786783299,TRX_N-00174-08484488,2022-06-08T16:46:45,Amurrio,expenses,phone,-34.31,31989.01
buyer_3,Ana,,ES28209566637786783299,TRX_N-00175-66169158,2022-06-09T23:31:42,Amurrio,expenses,leisure,-65.05,31923.96
buyer_3,Ana,,ES28209566637786783299,TRX_N-00176-21275376,2022-06-09T13:43:12,Mungia,expenses,clothing,-59.85,31864.11
buyer_3,Ana,,ES28209566637786783299,TRX_N-00177-35274829,2022-06-10T09:10:03,Amurrio,expenses,leisure,-57.01,31807.1
buyer_3,Ana,,ES28209566637786783299,TRX_N-00178-16578795,2022-06-11T10:23:55,Amurrio,expenses,food,-61.36,31745.74
buyer_3,Ana,,ES28209566637786783299,TRX_N-00179-23205225,2022-06-12T17:43:58,Amurrio,expenses,transport,-69.93,31675.81
buyer_3,Ana,,ES28209566637786783299,TRX_N-00180-00221578,2022-06-12T13:43:09,Amurrio,expenses,gifts,-25.68,31650.13
buyer_3,Ana,,ES28209566637786783299,TRX_N-00181-56365611,2022-06-14T10:43:22,Amurrio,expenses,food,-116.9,31533.23
buyer_3,Ana,,ES28209566637786783299,TRX_N-00182-37189255,2022-06-16T17:41:32,Amurrio,expenses,food,-82.94,31450.29
buyer_3,Ana,,ES28209566637786783299,TRX_N-00183-01424105,2022-06-17T21:59:01,Amurrio,expenses,cash,-100.0,31350.29
buyer_3,Ana,,ES28209566637786783299,TRX_N-00184-09235816,2022-06-19T16:58:01,Amurrio,expenses,food,-95.43,31254.86
buyer_3,Ana,,ES28209566637786783299,TRX_N-00185-66500199,2022-06-19T12:45:11,Amurrio,expenses,education,-64.93,31189.93
buyer_3,Ana,,ES28209566637786783299,TRX_N-00186-23905104,2022-06-21T19:01:33,Amurrio,expenses,food,-105.76,31084.17
buyer_3,Ana,,ES28209566637786783299,TRX_N-00187-27311090,2022-06-21T23:23:59,Amurrio,expenses,gifts,-109.78,30974.39
buyer_3,Ana,,ES28209566637786783299,TRX_N-00188-14378056,2022-06-22T08:48:00,Amurrio,expenses,cash,-100.0,30874.39
buyer_3,Ana,,ES28209566637786783299,TRX_N-00189-34129927,2022-06-24T08:16:48,Amurrio,expenses,cash,-100.0,30774.39
buyer_3,Ana,,ES28209566637786783299,TRX_N-00190-67454991,2022-06-26T18:15:08,Amurrio,expenses,transport,-49.33,30725.06
buyer_3,Ana,,ES28209566637786783299,TRX_N-00191-40064261,2022-06-26T10:59:39,Amurrio,expenses,repairs,-275.21,30449.85
buyer_3,Ana,,ES28209566637786783299,TRX_N-00192-96380980,2022-06-27T23:19:28,Amurrio,expenses,transport,-77.31,30372.54
buyer_3,Ana,,ES28209566637786783299,TRX_N-00193-61586827,2022-06-29T15:03:49,Amurrio,expenses,repairs,-195.06,30177.48
buyer_3,Ana,,ES28209566637786783299,TRX_N-00194-34623979,2022-07-01T09:01:17,Amurrio,incomes,salary,3573.12,33750.6
buyer_3,Ana,,ES28209566637786783299,TRX_N-00195-48948054,2022-07-01T09:01:17,Amurrio,incomes,salary_partner,3757.1,37507.7
buyer_3,Ana,,ES28209566637786783299,TRX_N-00196-35865358,2022-07-01T09:01:17,Amurrio,incomes,extra_income,361.07,37868.77
buyer_3,Ana,,ES28209566637786783299,TRX_N-00197-36238289,2022-07-01T15:09:11,Amurrio,expenses,cash,-100.0,37768.77
buyer_3,Ana,,ES28209566637786783299,TRX_N-00198-07505384,2022-07-01T18:01:29,Amurrio,expenses,appliances,-293.4,37475.37
buyer_3,Ana,,ES28209566637786783299,TRX_N-00199-47798091,2022-07-03T11:48:08,Amurrio,expenses,cash,-100.0,37375.37
buyer_3,Ana,,ES28209566637786783299,TRX_N-00200-09946224,2022-07-04T14:10:27,Amurrio,expenses,mortgage,-853.26,36522.11
buyer_3,Ana,,ES28209566637786783299,TRX_N-00201-58376942,2022-07-05T17:01:12,Amurrio,expenses,phone,-33.67,36488.44
buyer_3,Ana,,ES28209566637786783299,TRX_N-00202-77298831,2022-07-05T12:30:38,Amurrio,expenses,food,-116.34,36372.1
buyer_3,Ana,,ES28209566637786783299,TRX_N-00203-80343003,2022-07-06T12:37:37,Amurrio,expenses,electricity,-29.65,36342.45
buyer_3,Ana,,ES28209566637786783299,TRX_N-00204-69352317,2022-07-06T17:45:33,Amurrio,expenses,gas,-40.87,36301.58
buyer_3,Ana,,ES28209566637786783299,TRX_N-00205-15934561,2022-07-06T14:25:00,Amurrio,expenses,cash,-100.0,36201.58
buyer_3,Ana,,ES28209566637786783299,TRX_N-00206-57444439,2022-07-08T18:18:13,Amurrio,expenses,internet,-42.0,36159.58
buyer_3,Ana,,ES28209566637786783299,TRX_N-00207-30210444,2022-07-08T18:50:50,Amurrio,expenses,water,-36.84,36122.74
buyer_3,Ana,,ES28209566637786783299,TRX_N-00208-87528258,2022-07-09T18:41:35,Amurrio,expenses,cash,-100.0,36022.74
buyer_3,Ana,,ES28209566637786783299,TRX_N-00209-52869140,2022-07-10T14:44:27,Amurrio,expenses,cash,-100.0,35922.74
buyer_3,Ana,,ES28209566637786783299,TRX_N-00210-21626061,2022-07-12T09:19:56,Amurrio,expenses,cash,-100.0,35822.74
buyer_3,Ana,,ES28209566637786783299,TRX_N-00211-49993080,2022-07-13T16:40:12,Amurrio,expenses,cash,-100.0,35722.74
buyer_3,Ana,,ES28209566637786783299,TRX_N-00212-30219148,2022-07-16T14:04:11,Amurrio,expenses,repairs,-101.85,35620.89
buyer_3,Ana,,ES28209566637786783299,TRX_N-00213-11906894,2022-07-17T17:06:00,Amurrio,expenses,cash,-100.0,35520.89
buyer_3,Ana,,ES28209566637786783299,TRX_N-00214-71882752,2022-07-17T12:05:27,Amurrio,expenses,repairs,-41.95,35478.94
buyer_3,Ana,,ES28209566637786783299,TRX_N-00215-92012627,2022-07-18T23:19:11,Amurrio,expenses,cash,-100.0,35378.94
buyer_3,Ana,,ES28209566637786783299,TRX_N-00216-18210626,2022-07-19T19:25:42,Andoain,expenses,cash,-100.0,35278.94
buyer_3,Ana,,ES28209566637786783299,TRX_N-00217-05061598,2022-07-22T19:47:12,Amurrio,expenses,cash,-100.0,35178.94
buyer_3,Ana,,ES28209566637786783299,TRX_N-00218-91611124,2022-07-23T18:24:26,Amurrio,expenses,cash,-100.0,35078.94
buyer_3,Ana,,ES28209566637786783299,TRX_N-00219-24818781,2022-07-23T20:47:49,Amurrio,expenses,gifts,-740.83,34338.11
buyer_3,Ana,,ES28209566637786783299,TRX_N-00220-59573527,2022-07-25T22:43:02,Amurrio,expenses,healthcare,-73.45,34264.66
buyer_3,Ana,,ES28209566637786783299,TRX_N-00221-20881291,2022-07-26T00:21:33,Amurrio,expenses,cash,-100.0,34164.66
buyer_3,Ana,,ES28209566637786783299,TRX_N-00222-89864247,2022-07-28T20:24:55,Amurrio,expenses,cash,-100.0,34064.66
buyer_3,Ana,,ES28209566637786783299,TRX_N-00223-39370958,2022-07-29T08:15:16,Amurrio,expenses,repairs,-88.98,33975.68
buyer_3,Ana,,ES28209566637786783299,TRX_N-00224-54043428,2022-07-30T11:10:33,Amurrio,expenses,food,-87.22,33888.46
buyer_3,Ana,,ES28209566637786783299,TRX_N-00225-87672192,2022-07-31T14:18:42,Amurrio,expenses,leisure,-50.43,33838.03
buyer_3,Ana,,ES28209566637786783299,TRX_N-00226-73821488,2022-08-01T17:17:47,Amurrio,incomes,salary,3573.12,37411.15
buyer_3,Ana,,ES28209566637786783299,TRX_N-00227-58916495,2022-08-01T17:17:47,Amurrio,incomes,salary_partner,3757.1,41168.25
buyer_3,Ana,,ES28209566637786783299,TRX_N-00228-28683187,2022-08-02T23:29:57,Amurrio,expenses,transport,-46.03,41122.22
buyer_3,Ana,,ES28209566637786783299,TRX_N-00229-39812931,2022-08-02T09:30:11,Amurrio,expenses,clothing,-142.34,40979.88
buyer_3,Ana,,ES28209566637786783299,TRX_N-00230-57380033,2022-08-04T15:51:48,Amurrio,expenses,mortgage,-853.26,40126.62
buyer_3,Ana,,ES28209566637786783299,TRX_N-00231-37200121,2022-08-05T14:24:00,Amurrio,expenses,water,-33.95,40092.67
buyer_3,Ana,,ES28209566637786783299,TRX_N-00232-62113032,2022-08-05T05:20:00,Amurrio,expenses,gas,-86.49,40006.18
buyer_3,Ana,,ES28209566637786783299,TRX_N-00233-07491190,2022-08-05T10:37:28,Amurrio,expenses,transport,-68.99,39937.19
buyer_3,Ana,,ES28209566637786783299,TRX_N-00234-64985628,2022-08-06T20:54:17,Amurrio,expenses,phone,-38.17,39899.02
buyer_3,Ana,,ES28209566637786783299,TRX_N-00235-96160683,2022-08-06T08:13:03,Amurrio,expenses,food,-88.94,39810.08
buyer_3,Ana,,ES28209566637786783299,TRX_N-00236-30432056,2022-08-06T22:22:05,Amurrio,expenses,gifts,-624.95,39185.13
buyer_3,Ana,,ES28209566637786783299,TRX_N-00237-03826684,2022-08-07T19:55:44,Amurrio,expenses,internet,-42.0,39143.13
buyer_3,Ana,,ES28209566637786783299,TRX_N-00238-31011645,2022-08-07T13:55:08,Amurrio,expenses,clothing,-95.69,39047.44
buyer_3,Ana,,ES28209566637786783299,TRX_N-00239-47157669,2022-08-07T16:13:18,Amurrio,expenses,cash,-100.0,38947.44
buyer_3,Ana,,ES28209566637786783299,TRX_N-00240-55684732,2022-08-08T11:05:51,Amurrio,expenses,electricity,-54.43,38893.01
buyer_3,Ana,,ES28209566637786783299,TRX_N-00241-93277669,2022-08-08T11:42:00,Amurrio,expenses,healthcare,-93.13,38799.88
buyer_3,Ana,,ES28209566637786783299,TRX_N-00242-65511023,2022-08-08T21:25:48,Sopela,expenses,cash,-100.0,38699.88
buyer_3,Ana,,ES28209566637786783299,TRX_N-00243-96857651,2022-08-09T08:44:38,Amurrio,expenses,gifts,-110.36,38589.52
buyer_3,Ana,,ES28209566637786783299,TRX_N-00244-84517122,2022-08-12T17:18:43,Amurrio,expenses,travel,-1897.37,36692.15
buyer_3,Ana,,ES28209566637786783299,TRX_N-00245-86835622,2022-08-13T20:16:21,Amurrio,expenses,leisure,-39.5,36652.65
buyer_3,Ana,,ES28209566637786783299,TRX_N-00246-23322182,2022-08-13T08:16:08,Amurrio,expenses,cash,-100.0,36552.65
buyer_3,Ana,,ES28209566637786783299,TRX_N-00247-50448034,2022-08-15T09:32:42,Amurrio,expenses,cash,-100.0,36452.65
buyer_3,Ana,,ES28209566637786783299,TRX_N-00248-38868237,2022-08-18T16:36:20,Santurtzi,expenses,education,-67.2,36385.45
buyer_3,Ana,,ES28209566637786783299,TRX_N-00249-77350658,2022-08-19T13:25:07,Amurrio,expenses,food,-65.03,36320.42
buyer_3,Ana,,ES28209566637786783299,TRX_N-00250-76906967,2022-08-19T19:32:36,Amurrio,expenses,healthcare,-149.35,36171.07
buyer_3,Ana,,ES28209566637786783299,TRX_N-00251-78501811,2022-08-20T08:00:10,Amurrio,expenses,food,-90.4,36080.67
buyer_3,Ana,,ES28209566637786783299,TRX_N-00252-28719766,2022-08-20T18:51:04,Amurrio,expenses,clothing,-128.87,35951.8
buyer_3,Ana,,ES28209566637786783299,TRX_N-00253-22270907,2022-08-20T11:52:56,Amurrio,expenses,cash,-100.0,35851.8
buyer_3,Ana,,ES28209566637786783299,TRX_N-00254-83938649,2022-08-22T23:38:50,Amurrio,expenses,education,-55.83,35795.97
buyer_3,Ana,,ES28209566637786783299,TRX_N-00255-49784288,2022-08-23T15:41:50,Amurrio,expenses,education,-71.52,35724.45
buyer_3,Ana,,ES28209566637786783299,TRX_N-00256-52536402,2022-08-24T14:09:28,Amurrio,expenses,repairs,-53.11,35671.34
buyer_3,Ana,,ES28209566637786783299,TRX_N-00257-27351946,2022-08-25T12:42:30,Elciego,expenses,food,-122.85,35548.49
buyer_3,Ana,,ES28209566637786783299,TRX_N-00258-70102112,2022-08-26T22:26:08,Amurrio,expenses,appliances,-105.07,35443.42
buyer_3,Ana,,ES28209566637786783299,TRX_N-00259-09467162,2022-08-29T03:38:23,Amurrio,expenses,food,-99.2,35344.22
buyer_3,Ana,,ES28209566637786783299,TRX_N-00260-14195196,2022-08-30T16:35:14,Salvatierra/Agurain,expenses,cash,-100.0,35244.22
buyer_3,Ana,,ES28209566637786783299,TRX_N-00261-65820054,2022-09-01T14:12:02,Amurrio,incomes,salary,3573.12,38817.34
buyer_3,Ana,,ES28209566637786783299,TRX_N-00262-84351739,2022-09-01T14:12:02,Amurrio,incomes,salary_partner,3757.1,42574.44
buyer_3,Ana,,ES28209566637786783299,TRX_N-00263-31176586,2022-09-01T17:32:51,Amurrio,expenses,food,-82.9,42491.54
buyer_3,Ana,,ES28209566637786783299,TRX_N-00264-79967389,2022-09-01T01:34:37,Amurrio,expenses,education,-75.66,42415.88
buyer_3,Ana,,ES28209566637786783299,TRX_N-00265-24087126,2022-09-01T21:26:40,Amurrio,expenses,travel,-1861.6,40554.28
buyer_3,Ana,,ES28209566637786783299,TRX_N-00266-41573951,2022-09-02T19:18:37,Amurrio,expenses,cash,-100.0,40454.28
buyer_3,Ana,,ES28209566637786783299,TRX_N-00267-59122006,2022-09-03T16:08:50,Amurrio,expenses,leisure,-28.22,40426.06
buyer_3,Ana,,ES28209566637786783299,TRX_N-00268-64506528,2022-09-03T17:35:15,Amurrio,expenses,cash,-100.0,40326.06
buyer_3,Ana,,ES28209566637786783299,TRX_N-00269-10089656,2022-09-04T17:20:57,Amurrio,expenses,mortgage,-853.26,39472.8
buyer_3,Ana,,ES28209566637786783299,TRX_N-00270-50458960,2022-09-05T09:57:37,Amurrio,expenses,internet,-42.0,39430.8
buyer_3,Ana,,ES28209566637786783299,TRX_N-00271-94973208,2022-09-05T10:27:16,Leioa,expenses,leisure,-77.96,39352.84
buyer_3,Ana,,ES28209566637786783299,TRX_N-00272-41131794,2022-09-06T02:49:46,Amurrio,expenses,phone,-32.7,39320.14
buyer_3,Ana,,ES28209566637786783299,TRX_N-00273-52015117,2022-09-06T20:10:41,Amurrio,expenses,clothing,-90.53,39229.61
buyer_3,Ana,,ES28209566637786783299,TRX_N-00274-09616908,2022-09-07T20:16:45,Amurrio,expenses,gas,-49.34,39180.27
buyer_3,Ana,,ES28209566637786783299,TRX_N-00275-65846790,2022-09-07T12:15:33,Amurrio,expenses,food,-118.28,39061.99
buyer_3,Ana,,ES28209566637786783299,TRX_N-00276-49826010,2022-09-07T09:11:36,Amurrio,expenses,cash,-100.0,38961.99
buyer_3,Ana,,ES28209566637786783299,TRX_N-00277-31318163,2022-09-08T16:52:06,Amurrio,expenses,water,-29.03,38932.96
buyer_3,Ana,,ES28209566637786783299,TRX_N-00278-98085032,2022-09-08T18:33:27,Amurrio,expenses,electricity,-30.17,38902.79
buyer_3,Ana,,ES28209566637786783299,TRX_N-00279-84079891,2022-09-09T09:21:47,Amurrio,expenses,transport,-54.62,38848.17
buyer_3,Ana,,ES28209566637786783299,TRX_N-00280-48037111,2022-09-09T12:48:56,Amurrio,expenses,cash,-100.0,38748.17
buyer_3,Ana,,ES28209566637786783299,TRX_N-00281-58682450,2022-09-10T09:46:43,Amurrio,expenses,leisure,-77.91,38670.26
buyer_3,Ana,,ES28209566637786783299,TRX_N-00282-26971333,2022-09-10T16:45:23,Amurrio,expenses,education,-55.41,38614.85
buyer_3,Ana,,ES28209566637786783299,TRX_N-00283-99610163,2022-09-10T20:39:44,Amurrio,expenses,cash,-100.0,38514.85
buyer_3,Ana,,ES28209566637786783299,TRX_N-00284-43717260,2022-09-11T10:42:48,Amurrio,expenses,transport,-45.8,38469.05
buyer_3,Ana,,ES28209566637786783299,TRX_N-00285-65930768,2022-09-11T16:44:34,Bilbao,expenses,leisure,-47.9,38421.15
buyer_3,Ana,,ES28209566637786783299,TRX_N-00286-03194163,2022-09-12T16:09:52,Amurrio,expenses,transport,-60.76,38360.39
buyer_3,Ana,,ES28209566637786783299,TRX_N-00287-95053813,2022-09-14T17:56:45,Amurrio,expenses,food,-88.17,38272.22
buyer_3,Ana,,ES28209566637786783299,TRX_N-00288-39800602,2022-09-14T23:19:51,Hondarribia,expenses,repairs,-80.7,38191.52
buyer_3,Ana,,ES28209566637786783299,TRX_N-00289-85359876,2022-09-15T20:13:45,Amurrio,expenses,transport,-63.23,38128.29
buyer_3,Ana,,ES28209566637786783299,TRX_N-00290-99171480,2022-09-16T08:06:31,Amurrio,expenses,clothing,-49.26,38079.03
buyer_3,Ana,,ES28209566637786783299,TRX_N-00291-87127117,2022-09-17T23:34:24,Amurrio,expenses,healthcare,-146.95,37932.08
buyer_3,Ana,,ES28209566637786783299,TRX_N-00292-55136403,2022-09-17T08:32:10,Amurrio,expenses,cash,-100.0,37832.08
buyer_3,Ana,,ES28209566637786783299,TRX_N-00293-61063219,2022-09-18T15:16:57,Amurrio,expenses,transport,-49.68,37782.4
buyer_3,Ana,,ES28209566637786783299,TRX_N-00294-07480890,2022-09-18T19:29:02,Amurrio,expenses,repairs,-173.31,37609.09
buyer_3,Ana,,ES28209566637786783299,TRX_N-00295-16812952,2022-09-19T14:54:56,Salvatierra/Agurain,expenses,transport,-52.17,37556.92
buyer_3,Ana,,ES28209566637786783299,TRX_N-00296-59751345,2022-09-19T13:13:19,Amurrio,expenses,cash,-100.0,37456.92
buyer_3,Ana,,ES28209566637786783299,TRX_N-00297-39714769,2022-09-22T19:36:04,Amurrio,expenses,gifts,-781.58,36675.34
buyer_3,Ana,,ES28209566637786783299,TRX_N-00298-45954895,2022-09-23T08:57:09,Elciego,expenses,food,-95.51,36579.83
buyer_3,Ana,,ES28209566637786783299,TRX_N-00299-41225680,2022-09-23T09:17:34,Amurrio,expenses,repairs,-152.7,36427.13
buyer_3,Ana,,ES28209566637786783299,TRX_N-00300-50211952,2022-09-24T11:26:06,Amurrio,expenses,cash,-100.0,36327.13
buyer_3,Ana,,ES28209566637786783299,TRX_N-00301-34161862,2022-09-25T20:41:59,Amurrio,expenses,leisure,-22.06,36305.07
buyer_3,Ana,,ES28209566637786783299,TRX_N-00302-86485247,2022-09-27T09:21:22,Amurrio,expenses,transport,-72.61,36232.46
buyer_3,Ana,,ES28209566637786783299,TRX_N-00303-27043184,2022-09-30T11:01:39,Amurrio,expenses,food,-80.25,36152.21
buyer_3,Ana,,ES28209566637786783299,TRX_N-00304-96976561,2022-09-30T10:00:26,Amurrio,expenses,gifts,-193.8,35958.41
buyer_3,Ana,,ES28209566637786783299,TRX_N-00305-70616198,2022-10-01T13:07:32,Amurrio,incomes,salary,3573.12,39531.53
buyer_3,Ana,,ES28209566637786783299,TRX_N-00306-70234343,2022-10-01T13:07:32,Amurrio,incomes,salary_partner,3757.1,43288.63
buyer_3,Ana,,ES28209566637786783299,TRX_N-00307-12157289,2022-10-01T16:30:13,Amurrio,expenses,cash,-100.0,43188.63
buyer_3,Ana,,ES28209566637786783299,TRX_N-00308-37703262,2022-10-04T17:31:10,Amurrio,expenses,mortgage,-853.26,42335.37
buyer_3,Ana,,ES28209566637786783299,TRX_N-00309-84301041,2022-10-04T19:00:11,Amurrio,expenses,food,-61.3,42274.07
buyer_3,Ana,,ES28209566637786783299,TRX_N-00310-75509929,2022-10-04T13:12:03,Amurrio,expenses,leisure,-28.87,42245.2
buyer_3,Ana,,ES28209566637786783299,TRX_N-00311-08211622,2022-10-05T13:53:18,Amurrio,expenses,electricity,-54.83,42190.37
buyer_3,Ana,,ES28209566637786783299,TRX_N-00312-14769954,2022-10-05T12:37:31,Amurrio,expenses,internet,-42.0,42148.37
buyer_3,Ana,,ES28209566637786783299,TRX_N-00313-89309234,2022-10-06T14:11:56,Amurrio,expenses,repairs,-304.29,41844.08
buyer_3,Ana,,ES28209566637786783299,TRX_N-00314-48737036,2022-10-07T11:43:05,Amurrio,expenses,food,-96.38,41747.7
buyer_3,Ana,,ES28209566637786783299,TRX_N-00315-44008706,2022-10-07T20:06:24,Amurrio,expenses,leisure,-44.19,41703.51
buyer_3,Ana,,ES28209566637786783299,TRX_N-00316-19987614,2022-10-08T13:12:06,Amurrio,expenses,water,-33.83,41669.68
buyer_3,Ana,,ES28209566637786783299,TRX_N-00317-90533344,2022-10-08T13:16:33,Amurrio,expenses,gas,-90.12,41579.56
buyer_3,Ana,,ES28209566637786783299,TRX_N-00318-58413194,2022-10-08T13:57:13,Amurrio,expenses,phone,-33.56,41546.0
buyer_3,Ana,,ES28209566637786783299,TRX_N-00319-79890352,2022-10-08T15:40:46,Amurrio,expenses,leisure,-38.13,41507.87
buyer_3,Ana,,ES28209566637786783299,TRX_N-00320-81244891,2022-10-08T12:58:12,Amurrio,expenses,cash,-100.0,41407.87
buyer_3,Ana,,ES28209566637786783299,TRX_N-00321-58059620,2022-10-09T02:56:55,Amurrio,expenses,food,-70.54,41337.33
buyer_3,Ana,,ES28209566637786783299,TRX_N-00322-92792211,2022-10-10T10:23:08,Amurrio,expenses,food,-110.52,41226.81
buyer_3,Ana,,ES28209566637786783299,TRX_N-00323-18085123,2022-10-11T19:39:23,Amurrio,expenses,transport,-54.49,41172.32
buyer_3,Ana,,ES28209566637786783299,TRX_N-00324-58138762,2022-10-11T18:11:52,Alegría-Dulantzi,expenses,appliances,-155.63,41016.69
buyer_3,Ana,,ES28209566637786783299,TRX_N-00325-62885735,2022-10-12T10:34:26,Amurrio,expenses,food,-112.52,40904.17
buyer_3,Ana,,ES28209566637786783299,TRX_N-00326-16400831,2022-10-12T13:08:35,Amurrio,expenses,clothing,-71.04,40833.13
buyer_3,Ana,,ES28209566637786783299,TRX_N-00327-69742563,2022-10-13T16:39:15,Amurrio,expenses,food,-94.37,40738.76
buyer_3,Ana,,ES28209566637786783299,TRX_N-00328-52074295,2022-10-16T16:35:30,Amurrio,expenses,education,-75.3,40663.46
buyer_3,Ana,,ES28209566637786783299,TRX_N-00329-70276405,2022-10-18T08:48:56,Amurrio,expenses,healthcare,-69.97,40593.49
buyer_3,Ana,,ES28209566637786783299,TRX_N-00330-81676280,2022-10-19T13:00:17,Pasaia,expenses,food,-65.93,40527.56
buyer_3,Ana,,ES28209566637786783299,TRX_N-00331-93044641,2022-10-22T18:40:08,Amurrio,expenses,food,-64.05,40463.51
buyer_3,Ana,,ES28209566637786783299,TRX_N-00332-18087151,2022-10-22T10:26:54,Amurrio,expenses,cash,-100.0,40363.51
buyer_3,Ana,,ES28209566637786783299,TRX_N-00333-15245504,2022-10-26T13:19:31,Amurrio,expenses,food,-103.02,40260.49
buyer_3,Ana,,ES28209566637786783299,TRX_N-00334-57334825,2022-11-01T07:37:57,Amurrio,incomes,salary,3573.12,43833.61
buyer_3,Ana,,ES28209566637786783299,TRX_N-00335-66307627,2022-11-01T07:37:57,Amurrio,incomes,salary_partner,3757.1,47590.71
buyer_3,Ana,,ES28209566637786783299,TRX_N-00336-61388423,2022-11-01T07:37:57,Amurrio,incomes,extra_income,361.07,47951.78
buyer_3,Ana,,ES28209566637786783299,TRX_N-00337-96259735,2022-11-01T08:26:14,Mungia,expenses,gifts,-614.1,47337.68
buyer_3,Ana,,ES28209566637786783299,TRX_N-00338-90302038,2022-11-04T21:36:29,Amurrio,expenses,mortgage,-853.26,46484.42
buyer_3,Ana,,ES28209566637786783299,TRX_N-00339-44489744,2022-11-04T19:59:32,Amurrio,expenses,food,-91.67,46392.75
buyer_3,Ana,,ES28209566637786783299,TRX_N-00340-00399928,2022-11-04T19:42:51,Amurrio,expenses,appliances,-303.65,46089.1
buyer_3,Ana,,ES28209566637786783299,TRX_N-00341-45726268,2022-11-05T23:50:53,Amurrio,expenses,water,-42.37,46046.73
buyer_3,Ana,,ES28209566637786783299,TRX_N-00342-95827763,2022-11-05T17:05:21,Amurrio,expenses,gas,-77.41,45969.32
buyer_3,Ana,,ES28209566637786783299,TRX_N-00343-42721228,2022-11-05T13:19:14,Amurrio,expenses,internet,-42.0,45927.32
buyer_3,Ana,,ES28209566637786783299,TRX_N-00344-10298459,2022-11-06T00:03:32,Amurrio,expenses,electricity,-36.37,45890.95
buyer_3,Ana,,ES28209566637786783299,TRX_N-00345-02685240,2022-11-06T17:04:39,Amurrio,expenses,phone,-42.95,45848.0
buyer_3,Ana,,ES28209566637786783299,TRX_N-00346-13913486,2022-11-07T16:49:17,Amurrio,expenses,clothing,-151.62,45696.38
buyer_3,Ana,,ES28209566637786783299,TRX_N-00347-29774091,2022-11-08T16:53:00,Amurrio,expenses,gifts,-163.77,45532.61
buyer_3,Ana,,ES28209566637786783299,TRX_N-00348-51715053,2022-11-09T21:43:47,Amurrio,expenses,leisure,-64.82,45467.79
buyer_3,Ana,,ES28209566637786783299,TRX_N-00349-03781973,2022-11-10T16:32:17,Salvatierra/Agurain,expenses,transport,-80.38,45387.41
buyer_3,Ana,,ES28209566637786783299,TRX_N-00350-40528023,2022-11-10T15:55:34,Amurrio,expenses,appliances,-280.9,45106.51
buyer_3,Ana,,ES28209566637786783299,TRX_N-00351-33485294,2022-11-11T16:19:28,Zuia,expenses,education,-49.74,45056.77
buyer_3,Ana,,ES28209566637786783299,TRX_N-00352-31848853,2022-11-11T13:30:07,Amurrio,expenses,repairs,-197.77,44859.0
buyer_3,Ana,,ES28209566637786783299,TRX_N-00353-21545774,2022-11-12T10:16:40,Amurrio,expenses,education,-48.36,44810.64
buyer_3,Ana,,ES28209566637786783299,TRX_N-00354-37347316,2022-11-14T17:58:21,Amurrio,expenses,food,-112.76,44697.88
buyer_3,Ana,,ES28209566637786783299,TRX_N-00355-13201349,2022-11-15T11:02:32,Amurrio,expenses,travel,-380.61,44317.27
buyer_3,Ana,,ES28209566637786783299,TRX_N-00356-15533009,2022-11-17T15:00:47,Santurtzi,expenses,leisure,-53.41,44263.86
buyer_3,Ana,,ES28209566637786783299,TRX_N-00357-66340828,2022-11-19T17:40:33,Zuia,expenses,transport,-60.46,44203.4
buyer_3,Ana,,ES28209566637786783299,TRX_N-00358-23861499,2022-11-21T01:51:59,Amurrio,expenses,cash,-100.0,44103.4
buyer_3,Ana,,ES28209566637786783299,TRX_N-00359-59574129,2022-11-25T08:30:35,Amurrio,expenses,cash,-100.0,44003.4
buyer_3,Ana,,ES28209566637786783299,TRX_N-00360-13413123,2022-11-26T10:42:06,Amurrio,expenses,cash,-100.0,43903.4
buyer_3,Ana,,ES28209566637786783299,TRX_N-00361-06549385,2022-11-26T17:07:33,Amurrio,expenses,repairs,-286.3,43617.1
buyer_3,Ana,,ES28209566637786783299,TRX_N-00362-51476505,2022-11-28T16:02:55,Amurrio,expenses,transport,-57.24,43559.86
buyer_3,Ana,,ES28209566637786783299,TRX_N-00363-09956091,2022-11-29T18:30:44,Amurrio,expenses,food,-96.58,43463.28
buyer_3,Ana,,ES28209566637786783299,TRX_N-00364-09456480,2022-11-29T08:56:51,Amurrio,expenses,education,-50.22,43413.06
buyer_3,Ana,,ES28209566637786783299,TRX_N-00365-49152519,2022-11-30T20:48:08,Amurrio,expenses,food,-103.7,43309.36
buyer_3,Ana,,ES28209566637786783299,TRX_N-00366-51331551,2022-11-30T19:34:47,Amurrio,expenses,transport,-40.5,43268.86
buyer_3,Ana,,ES28209566637786783299,TRX_N-00367-97710338,2022-11-30T12:20:36,Amurrio,expenses,leisure,-84.48,43184.38
buyer_3,Ana,,ES28209566637786783299,TRX_N-00368-79449540,2022-12-01T06:22:46,Amurrio,incomes,salary,3573.12,46757.5
buyer_3,Ana,,ES28209566637786783299,TRX_N-00369-55302475,2022-12-01T06:22:46,Amurrio,incomes,salary_partner,3757.1,50514.6
buyer_3,Ana,,ES28209566637786783299,TRX_N-00370-68829387,2022-12-01T06:22:46,Amurrio,incomes,salary_bonus,2840.07,53354.67
buyer_3,Ana,,ES28209566637786783299,TRX_N-00371-61977093,2022-12-01T06:22:46,Amurrio,incomes,salary_partner_bonus,2681.61,56036.28
buyer_3,Ana,,ES28209566637786783299,TRX_N-00372-14603722,2022-12-01T12:32:09,Amurrio,expenses,leisure,-47.54,55988.74
buyer_3,Ana,,ES28209566637786783299,TRX_N-00373-36341743,2022-12-01T16:30:09,Amurrio,expenses,cash,-100.0,55888.74
buyer_3,Ana,,ES28209566637786783299,TRX_N-00374-80837213,2022-12-01T23:16:27,Amurrio,expenses,repairs,-88.0,55800.74
buyer_3,Ana,,ES28209566637786783299,TRX_N-00375-88336464,2022-12-04T16:20:31,Amurrio,expenses,mortgage,-853.26,54947.48
buyer_3,Ana,,ES28209566637786783299,TRX_N-00376-09383318,2022-12-05T17:49:00,Amurrio,expenses,gas,-47.38,54900.1
buyer_3,Ana,,ES28209566637786783299,TRX_N-00377-26628893,2022-12-05T19:31:16,Amurrio,expenses,internet,-42.0,54858.1
buyer_3,Ana,,ES28209566637786783299,TRX_N-00378-80702780,2022-12-05T17:31:04,Amurrio,expenses,appliances,-175.22,54682.88
buyer_3,Ana,,ES28209566637786783299,TRX_N-00379-31948882,2022-12-06T17:23:06,Amurrio,expenses,water,-44.18,54638.7
buyer_3,Ana,,ES28209566637786783299,TRX_N-00380-75967105,2022-12-06T10:28:36,Amurrio,expenses,phone,-43.83,54594.87
buyer_3,Ana,,ES28209566637786783299,TRX_N-00381-90596691,2022-12-08T12:03:45,Amurrio,expenses,electricity,-45.21,54549.66
buyer_3,Ana,,ES28209566637786783299,TRX_N-00382-62937936,2022-12-08T11:46:55,Amurrio,expenses,repairs,-132.26,54417.4
buyer_3,Ana,,ES28209566637786783299,TRX_N-00383-02900069,2022-12-10T09:49:30,Amurrio,expenses,clothing,-56.82,54360.58
buyer_3,Ana,,ES28209566637786783299,TRX_N-00384-36444449,2022-12-12T17:24:56,Amurrio,expenses,transport,-47.87,54312.71
buyer_3,Ana,,ES28209566637786783299,TRX_N-00385-11779068,2022-12-18T15:28:03,Irun,expenses,transport,-64.05,54248.66
buyer_3,Ana,,ES28209566637786783299,TRX_N-00386-06971156,2022-12-23T14:11:17,Amurrio,expenses,cash,-100.0,54148.66
buyer_3,Ana,,ES28209566637786783299,TRX_N-00387-95270289,2022-12-24T19:55:13,Amurrio,expenses,cash,-100.0,54048.66
buyer_3,Ana,,ES28209566637786783299,TRX_N-00388-82085306,2022-12-25T12:22:14,Amurrio,expenses,appliances,-230.45,53818.21
buyer_3,Ana,,ES28209566637786783299,TRX_N-00389-62219389,2022-12-26T17:05:52,Amurrio,expenses,healthcare,-189.83,53628.38
buyer_3,Ana,,ES28209566637786783299,TRX_N-00390-32518467,2022-12-26T15:11:16,Amurrio,expenses,repairs,-172.64,53455.74
buyer_3,Ana,,ES28209566637786783299,TRX_N-00391-32828167,2022-12-29T09:52:38,Amurrio,expenses,transport,-47.01,53408.73
buyer_3,Ana,,ES28209566637786783299,TRX_N-00392-29652174,2022-12-30T18:37:49,Amurrio,expenses,leisure,-53.9,53354.83
buyer_3,Ana,,ES28209566637786783299,TRX_N-00393-18671511,2022-12-31T09:41:27,Amurrio,expenses,education,-55.53,53299.3
buyer_3,Ana,,ES28209566637786783299,TRX_N-00394-50361414,2023-01-01T00:55:11,Amurrio,incomes,salary,3710.27,57009.57
buyer_3,Ana,,ES28209566637786783299,TRX_N-00395-22645012,2023-01-01T00:55:11,Amurrio,incomes,salary_partner,3901.31,60910.88
buyer_3,Ana,,ES28209566637786783299,TRX_N-00396-38557695,2023-01-03T11:02:44,Amurrio,expenses,gifts,-258.09,60652.79
buyer_3,Ana,,ES28209566637786783299,TRX_N-00397-29467698,2023-01-04T08:41:58,Amurrio,expenses,mortgage,-853.26,59799.53
buyer_3,Ana,,ES28209566637786783299,TRX_N-00398-38387524,2023-01-04T21:15:51,Vitoria-Gasteiz,expenses,transport,-52.26,59747.27
buyer_3,Ana,,ES28209566637786783299,TRX_N-00399-93070980,2023-01-05T15:33:25,Amurrio,expenses,food,-101.14,59646.13
buyer_3,Ana,,ES28209566637786783299,TRX_N-00400-76624632,2023-01-06T13:14:23,Amurrio,expenses,gas,-72.28,59573.85
buyer_3,Ana,,ES28209566637786783299,TRX_N-00401-92174901,2023-01-07T13:08:13,Amurrio,expenses,water,-41.63,59532.22
buyer_3,Ana,,ES28209566637786783299,TRX_N-00402-18447486,2023-01-07T13:31:44,Amurrio,expenses,electricity,-83.36,59448.86
buyer_3,Ana,,ES28209566637786783299,TRX_N-00403-63114050,2023-01-07T16:17:10,Amurrio,expenses,transport,-59.18,59389.68
buyer_3,Ana,,ES28209566637786783299,TRX_N-00404-73202990,2023-01-08T13:14:28,Amurrio,expenses,internet,-42.0,59347.68
buyer_3,Ana,,ES28209566637786783299,TRX_N-00405-29615066,2023-01-08T15:46:41,Amurrio,expenses,phone,-40.92,59306.76
buyer_3,Ana,,ES28209566637786783299,TRX_N-00406-53214016,2023-01-10T14:26:30,Santurtzi,expenses,leisure,-50.42,59256.34
buyer_3,Ana,,ES28209566637786783299,TRX_N-00407-12369981,2023-01-11T10:17:28,Amurrio,expenses,leisure,-70.8,59185.54
buyer_3,Ana,,ES28209566637786783299,TRX_N-00408-37036736,2023-01-11T22:25:54,Lasarte-Oria,expenses,gifts,-330.14,58855.4
buyer_3,Ana,,ES28209566637786783299,TRX_N-00409-63515922,2023-01-12T13:56:50,Amurrio,expenses,food,-60.56,58794.84
buyer_3,Ana,,ES28209566637786783299,TRX_N-00410-22356976,2023-01-16T12:13:32,Amurrio,expenses,food,-111.39,58683.45
buyer_3,Ana,,ES28209566637786783299,TRX_N-00411-19925250,2023-01-16T10:38:31,Amurrio,expenses,cash,-100.0,58583.45
buyer_3,Ana,,ES28209566637786783299,TRX_N-00412-97177095,2023-01-17T11:12:50,Amurrio,expenses,gifts,-435.27,58148.18
buyer_3,Ana,,ES28209566637786783299,TRX_N-00413-73689659,2023-01-18T22:51:51,Amurrio,expenses,clothing,-122.83,58025.35
buyer_3,Ana,,ES28209566637786783299,TRX_N-00414-99571729,2023-01-19T08:49:52,Llodio,expenses,clothing,-157.27,57868.08
buyer_3,Ana,,ES28209566637786783299,TRX_N-00415-97292048,2023-01-19T14:20:42,Amurrio,expenses,cash,-100.0,57768.08
buyer_3,Ana,,ES28209566637786783299,TRX_N-00416-00506293,2023-01-21T17:45:56,Amurrio,expenses,gifts,-522.42,57245.66
buyer_3,Ana,,ES28209566637786783299,TRX_N-00417-57153631,2023-01-22T19:04:27,Amurrio,expenses,gifts,-685.6,56560.06
buyer_3,Ana,,ES28209566637786783299,TRX_N-00418-22417329,2023-01-23T16:12:04,Amurrio,expenses,appliances,-269.89,56290.17
buyer_3,Ana,,ES28209566637786783299,TRX_N-00419-07708220,2023-01-24T09:00:26,Amurrio,expenses,food,-82.78,56207.39
buyer_3,Ana,,ES28209566637786783299,TRX_N-00420-15806934,2023-01-24T18:42:56,Amurrio,expenses,cash,-100.0,56107.39
buyer_3,Ana,,ES28209566637786783299,TRX_N-00421-59121666,2023-01-24T18:44:08,Amurrio,expenses,repairs,-208.96,55898.43
buyer_3,Ana,,ES28209566637786783299,TRX_N-00422-74340443,2023-01-25T15:12:01,Amurrio,expenses,leisure,-63.07,55835.36
buyer_3,Ana,,ES28209566637786783299,TRX_N-00423-99341281,2023-01-25T12:22:58,Lasarte-Oria,expenses,clothing,-108.38,55726.98
buyer_3,Ana,,ES28209566637786783299,TRX_N-00424-02746342,2023-01-27T23:09:00,Amurrio,expenses,healthcare,-180.17,55546.81
buyer_3,Ana,,ES28209566637786783299,TRX_N-00425-43507524,2023-01-29T10:40:07,Amurrio,expenses,clothing,-158.78,55388.03
buyer_3,Ana,,ES28209566637786783299,TRX_N-00426-17024315,2023-02-01T14:04:24,Amurrio,incomes,salary,3710.27,59098.3
buyer_3,Ana,,ES28209566637786783299,TRX_N-00427-53873155,2023-02-01T14:04:24,Amurrio,incomes,salary_partner,3901.31,62999.61
buyer_3,Ana,,ES28209566637786783299,TRX_N-00428-55176820,2023-02-02T12:02:40,Amurrio,expenses,leisure,-69.02,62930.59
buyer_3,Ana,,ES28209566637786783299,TRX_N-00429-87314881,2023-02-04T21:59:47,Amurrio,expenses,mortgage,-853.26,62077.33
buyer_3,Ana,,ES28209566637786783299,TRX_N-00430-39177781,2023-02-05T08:44:05,Amurrio,expenses,electricity,-21.2,62056.13
buyer_3,Ana,,ES28209566637786783299,TRX_N-00431-68905621,2023-02-06T13:55:37,Amurrio,expenses,phone,-30.98,62025.15
buyer_3,Ana,,ES28209566637786783299,TRX_N-00432-84293706,2023-02-07T18:10:58,Amurrio,expenses,repairs,-125.58,61899.57
buyer_3,Ana,,ES28209566637786783299,TRX_N-00433-16104123,2023-02-08T08:52:20,Amurrio,expenses,gas,-100.98,61798.59
buyer_3,Ana,,ES28209566637786783299,TRX_N-00434-50992510,2023-02-08T20:14:03,Amurrio,expenses,water,-20.99,61777.6
buyer_3,Ana,,ES28209566637786783299,TRX_N-00435-14675997,2023-02-08T17:04:36,Amurrio,expenses,internet,-42.0,61735.6
buyer_3,Ana,,ES28209566637786783299,TRX_N-00436-95224834,2023-02-08T18:22:15,Sopela,expenses,leisure,-70.78,61664.82
buyer_3,Ana,,ES28209566637786783299,TRX_N-00437-26632260,2023-02-09T13:12:30,Amurrio,expenses,transport,-54.6,61610.22
buyer_3,Ana,,ES28209566637786783299,TRX_N-00438-69566336,2023-02-09T22:28:01,Amurrio,expenses,leisure,-18.74,61591.48
buyer_3,Ana,,ES28209566637786783299,TRX_N-00439-21731804,2023-02-10T20:00:54,Amurrio,expenses,transport,-77.19,61514.29
buyer_3,Ana,,ES28209566637786783299,TRX_N-00440-95724995,2023-02-12T16:16:45,Amurrio,expenses,cash,-100.0,61414.29
buyer_3,Ana,,ES28209566637786783299,TRX_N-00441-88490726,2023-02-13T18:36:52,Amurrio,expenses,cash,-100.0,61314.29
buyer_3,Ana,,ES28209566637786783299,TRX_N-00442-09722055,2023-02-14T08:32:46,Amurrio,expenses,leisure,-66.21,61248.08
buyer_3,Ana,,ES28209566637786783299,TRX_N-00443-72060741,2023-02-14T22:07:51,Amurrio,expenses,clothing,-93.42,61154.66
buyer_3,Ana,,ES28209566637786783299,TRX_N-00444-07884992,2023-02-15T20:40:50,Amurrio,expenses,leisure,-75.35,61079.31
buyer_3,Ana,,ES28209566637786783299,TRX_N-00445-39916301,2023-02-15T16:18:47,Amurrio,expenses,education,-60.83,61018.48
buyer_3,Ana,,ES28209566637786783299,TRX_N-00446-76451173,2023-02-16T15:52:31,Amurrio,expenses,leisure,-19.7,60998.78
buyer_3,Ana,,ES28209566637786783299,TRX_N-00447-17526102,2023-02-17T19:04:08,Amurrio,expenses,clothing,-98.31,60900.47
buyer_3,Ana,,ES28209566637786783299,TRX_N-00448-23848607,2023-02-18T20:13:02,Zarautz,expenses,leisure,-60.91,60839.56
buyer_3,Ana,,ES28209566637786783299,TRX_N-00449-60426342,2023-02-21T10:10:56,Amurrio,expenses,food,-111.32,60728.24
buyer_3,Ana,,ES28209566637786783299,TRX_N-00450-53979710,2023-02-23T15:32:24,Donostia,expenses,leisure,-21.79,60706.45
buyer_3,Ana,,ES28209566637786783299,TRX_N-00451-05416345,2023-02-23T09:09:54,Amurrio,expenses,appliances,-147.92,60558.53
buyer_3,Ana,,ES28209566637786783299,TRX_N-00452-97165756,2023-02-23T15:46:31,Amurrio,expenses,repairs,-248.02,60310.51
buyer_3,Ana,,ES28209566637786783299,TRX_N-00453-14181669,2023-02-24T15:31:14,Amurrio,expenses,food,-77.64,60232.87
buyer_3,Ana,,ES28209566637786783299,TRX_N-00454-96144099,2023-02-24T11:34:03,Amurrio,expenses,clothing,-91.92,60140.95
buyer_3,Ana,,ES28209566637786783299,TRX_N-00455-82292379,2023-02-26T17:21:33,Amurrio,expenses,food,-79.0,60061.95
buyer_3,Ana,,ES28209566637786783299,TRX_N-00456-53678455,2023-02-26T00:45:25,Amurrio,expenses,transport,-87.16,59974.79
buyer_3,Ana,,ES28209566637786783299,TRX_N-00457-29057003,2023-02-26T09:53:29,Amurrio,expenses,education,-50.83,59923.96
buyer_3,Ana,,ES28209566637786783299,TRX_N-00458-33880766,2023-03-01T19:18:09,Amurrio,incomes,salary,3710.27,63634.23
buyer_3,Ana,,ES28209566637786783299,TRX_N-00459-84933805,2023-03-01T19:18:09,Amurrio,incomes,salary_partner,3901.31,67535.54
buyer_3,Ana,,ES28209566637786783299,TRX_N-00460-04883047,2023-03-01T19:18:09,Amurrio,incomes,extra_income,361.07,67896.61
buyer_3,Ana,,ES28209566637786783299,TRX_N-00461-94826502,2023-03-01T11:42:07,Amurrio,expenses,cash,-100.0,67796.61
buyer_3,Ana,,ES28209566637786783299,TRX_N-00462-33717156,2023-03-02T19:40:54,Amurrio,expenses,transport,-66.9,67729.71
buyer_3,Ana,,ES28209566637786783299,TRX_N-00463-45562139,2023-03-03T16:46:33,Amurrio,expenses,leisure,-56.04,67673.67
buyer_3,Ana,,ES28209566637786783299,TRX_N-00464-76765194,2023-03-03T19:29:26,Amurrio,expenses,travel,-829.39,66844.28
buyer_3,Ana,,ES28209566637786783299,TRX_N-00465-12918697,2023-03-04T09:53:32,Amurrio,expenses,mortgage,-853.26,65991.02
buyer_3,Ana,,ES28209566637786783299,TRX_N-00466-22153823,2023-03-04T11:19:48,Amurrio,expenses,cash,-100.0,65891.02
buyer_3,Ana,,ES28209566637786783299,TRX_N-00467-68276503,2023-03-05T17:11:06,Amurrio,expenses,internet,-42.0,65849.02
buyer_3,Ana,,ES28209566637786783299,TRX_N-00468-84263838,2023-03-05T17:28:58,Amurrio,expenses,phone,-34.2,65814.82
buyer_3,Ana,,ES28209566637786783299,TRX_N-00469-51433352,2023-03-05T08:35:12,Amurrio,expenses,cash,-100.0,65714.82
buyer_3,Ana,,ES28209566637786783299,TRX_N-00470-94225052,2023-03-06T09:06:20,Amurrio,expenses,electricity,-85.24,65629.58
buyer_3,Ana,,ES28209566637786783299,TRX_N-00471-32936629,2023-03-06T16:42:25,Amurrio,expenses,gas,-112.15,65517.43
buyer_3,Ana,,ES28209566637786783299,TRX_N-00472-96340418,2023-03-07T10:09:14,Amurrio,expenses,water,-26.1,65491.33
buyer_3,Ana,,ES28209566637786783299,TRX_N-00473-56975316,2023-03-07T13:18:16,Amurrio,expenses,appliances,-349.25,65142.08
buyer_3,Ana,,ES28209566637786783299,TRX_N-00474-36618049,2023-03-08T10:56:29,Getxo,expenses,food,-98.04,65044.04
buyer_3,Ana,,ES28209566637786783299,TRX_N-00475-97856879,2023-03-10T08:53:05,Amurrio,expenses,cash,-100.0,64944.04
buyer_3,Ana,,ES28209566637786783299,TRX_N-00476-64936320,2023-03-13T01:34:17,Alegría-Dulantzi,expenses,leisure,-71.91,64872.13
buyer_3,Ana,,ES28209566637786783299,TRX_N-00477-31166171,2023-03-14T13:05:13,Amurrio,expenses,food,-94.83,64777.3
buyer_3,Ana,,ES28209566637786783299,TRX_N-00478-66696051,2023-03-14T10:24:37,Zarautz,expenses,leisure,-81.72,64695.58
buyer_3,Ana,,ES28209566637786783299,TRX_N-00479-32051101,2023-03-17T19:19:27,Amurrio,expenses,transport,-44.14,64651.44
buyer_3,Ana,,ES28209566637786783299,TRX_N-00480-83991437,2023-03-17T13:20:49,Amurrio,expenses,cash,-100.0,64551.44
buyer_3,Ana,,ES28209566637786783299,TRX_N-00481-25178902,2023-03-17T03:38:49,Amurrio,expenses,appliances,-243.5,64307.94
buyer_3,Ana,,ES28209566637786783299,TRX_N-00482-54997627,2023-03-18T12:04:56,Amurrio,expenses,transport,-44.13,64263.81
buyer_3,Ana,,ES28209566637786783299,TRX_N-00483-10164854,2023-03-18T20:28:04,Amurrio,expenses,car,-271.24,63992.57
buyer_3,Ana,,ES28209566637786783299,TRX_N-00484-53941225,2023-03-19T20:43:24,Amurrio,expenses,transport,-75.21,63917.36
buyer_3,Ana,,ES28209566637786783299,TRX_N-00485-58669299,2023-03-22T14:58:42,Amurrio,expenses,leisure,-63.34,63854.02
buyer_3,Ana,,ES28209566637786783299,TRX_N-00486-89759812,2023-03-24T11:47:15,Amurrio,expenses,food,-113.88,63740.14
buyer_3,Ana,,ES28209566637786783299,TRX_N-00487-22484548,2023-03-24T08:50:50,Amurrio,expenses,cash,-100.0,63640.14
buyer_3,Ana,,ES28209566637786783299,TRX_N-00488-06500429,2023-03-24T08:14:04,Amurrio,expenses,repairs,-48.82,63591.32
buyer_3,Ana,,ES28209566637786783299,TRX_N-00489-95554624,2023-03-28T20:20:01,Amurrio,expenses,transport,-89.77,63501.55
buyer_3,Ana,,ES28209566637786783299,TRX_N-00490-77431159,2023-03-28T17:29:42,Sestao,expenses,cash,-100.0,63401.55
buyer_3,Ana,,ES28209566637786783299,TRX_N-00491-60732132,2023-03-31T21:51:20,Amurrio,expenses,clothing,-67.62,63333.93
buyer_3,Ana,,ES28209566637786783299,TRX_N-00492-26876664,2023-04-01T05:15:16,Amurrio,incomes,salary,3710.27,67044.2
buyer_3,Ana,,ES28209566637786783299,TRX_N-00493-54904524,2023-04-01T05:15:16,Amurrio,incomes,salary_partner,3901.31,70945.51
buyer_3,Ana,,ES28209566637786783299,TRX_N-00494-97178138,2023-04-01T18:48:21,Amurrio,expenses,food,-68.99,70876.52
buyer_3,Ana,,ES28209566637786783299,TRX_N-00495-71700175,2023-04-01T16:50:59,Amurrio,expenses,cash,-100.0,70776.52
buyer_3,Ana,,ES28209566637786783299,TRX_N-00496-92942373,2023-04-04T10:58:44,Amurrio,expenses,mortgage,-853.26,69923.26
buyer_3,Ana,,ES28209566637786783299,TRX_N-00497-70621122,2023-04-04T08:52:36,Amurrio,expenses,leisure,-69.0,69854.26
buyer_3,Ana,,ES28209566637786783299,TRX_N-00498-58596442,2023-04-04T12:55:26,Amurrio,expenses,cash,-100.0,69754.26
buyer_3,Ana,,ES28209566637786783299,TRX_N-00499-59995172,2023-04-04T18:40:04,Amurrio,expenses,repairs,-67.11,69687.15
buyer_3,Ana,,ES28209566637786783299,TRX_N-00500-87623326,2023-04-05T13:42:54,Amurrio,expenses,internet,-42.0,69645.15
buyer_3,Ana,,ES28209566637786783299,TRX_N-00501-06569221,2023-04-05T16:19:55,Amurrio,expenses,gifts,-215.32,69429.83
buyer_3,Ana,,ES28209566637786783299,TRX_N-00502-24434538,2023-04-06T10:21:50,Amurrio,expenses,water,-34.57,69395.26
buyer_3,Ana,,ES28209566637786783299,TRX_N-00503-70906158,2023-04-06T00:55:46,Amurrio,expenses,electricity,-38.51,69356.75
buyer_3,Ana,,ES28209566637786783299,TRX_N-00504-72599177,2023-04-06T10:41:13,Amurrio,expenses,gas,-58.4,69298.35
buyer_3,Ana,,ES28209566637786783299,TRX_N-00505-82545152,2023-04-06T22:45:03,Amurrio,expenses,gifts,-715.68,68582.67
buyer_3,Ana,,ES28209566637786783299,TRX_N-00506-30162825,2023-04-07T13:17:05,Sopela,expenses,cash,-100.0,68482.67
buyer_3,Ana,,ES28209566637786783299,TRX_N-00507-34443910,2023-04-08T00:38:55,Amurrio,expenses,phone,-34.97,68447.7
buyer_3,Ana,,ES28209566637786783299,TRX_N-00508-22813517,2023-04-08T08:00:53,Amurrio,expenses,cash,-100.0,68347.7
buyer_3,Ana,,ES28209566637786783299,TRX_N-00509-49704711,2023-04-10T20:50:26,Amurrio,expenses,leisure,-82.16,68265.54
buyer_3,Ana,,ES28209566637786783299,TRX_N-00510-40511292,2023-04-11T11:44:25,Amurrio,expenses,food,-61.89,68203.65
buyer_3,Ana,,ES28209566637786783299,TRX_N-00511-37591605,2023-04-11T16:22:25,Zarautz,expenses,cash,-100.0,68103.65
buyer_3,Ana,,ES28209566637786783299,TRX_N-00512-39443907,2023-04-12T22:46:19,Amurrio,expenses,food,-107.95,67995.7
buyer_3,Ana,,ES28209566637786783299,TRX_N-00513-16043911,2023-04-14T02:10:06,Amurrio,expenses,car,-218.43,67777.27
buyer_3,Ana,,ES28209566637786783299,TRX_N-00514-02135371,2023-04-15T14:14:16,Amurrio,expenses,repairs,-270.22,67507.05
buyer_3,Ana,,ES28209566637786783299,TRX_N-00515-13614654,2023-04-16T20:18:00,Bilbao,expenses,food,-95.86,67411.19
buyer_3,Ana,,ES28209566637786783299,TRX_N-00516-15505510,2023-04-16T13:57:31,Amurrio,expenses,healthcare,-134.1,67277.09
buyer_3,Ana,,ES28209566637786783299,TRX_N-00517-92374852,2023-04-16T13:06:39,Amurrio,expenses,cash,-100.0,67177.09
buyer_3,Ana,,ES28209566637786783299,TRX_N-00518-51904894,2023-04-20T15:49:54,Donostia,expenses,education,-60.5,67116.59
buyer_3,Ana,,ES28209566637786783299,TRX_N-00519-04656880,2023-04-20T15:15:54,Amurrio,expenses,cash,-100.0,67016.59
buyer_3,Ana,,ES28209566637786783299,TRX_N-00520-38236025,2023-04-21T13:13:16,Amurrio,expenses,transport,-79.49,66937.1
buyer_3,Ana,,ES28209566637786783299,TRX_N-00521-23903661,2023-04-21T22:55:50,Portugalete,expenses,leisure,-21.07,66916.03
buyer_3,Ana,,ES28209566637786783299,TRX_N-00522-65196070,2023-04-22T15:32:22,Amurrio,expenses,transport,-80.5,66835.53
buyer_3,Ana,,ES28209566637786783299,TRX_N-00523-76128462,2023-04-23T11:54:24,Amurrio,expenses,food,-73.22,66762.31
buyer_3,Ana,,ES28209566637786783299,TRX_N-00524-99839662,2023-04-24T16:10:11,Amurrio,expenses,education,-68.82,66693.49
buyer_3,Ana,,ES28209566637786783299,TRX_N-00525-54591065,2023-04-26T10:17:11,Amurrio,expenses,clothing,-71.31,66622.18
buyer_3,Ana,,ES28209566637786783299,TRX_N-00526-78085069,2023-04-27T12:30:53,Amurrio,expenses,transport,-41.48,66580.7
buyer_3,Ana,,ES28209566637786783299,TRX_N-00527-12238106,2023-05-01T21:13:20,Amurrio,incomes,salary,3710.27,70290.97
buyer_3,Ana,,ES28209566637786783299,TRX_N-00528-07408067,2023-05-01T21:13:20,Amurrio,incomes,salary_partner,3901.31,74192.28
buyer_3,Ana,,ES28209566637786783299,TRX_N-00529-79851482,2023-05-03T18:05:29,Amurrio,expenses,food,-83.15,74109.13
buyer_3,Ana,,ES28209566637786783299,TRX_N-00530-44284076,2023-05-03T16:51:18,Amurrio,expenses,education,-61.61,74047.52
buyer_3,Ana,,ES28209566637786783299,TRX_N-00531-07592370,2023-05-04T14:12:57,Amurrio,expenses,mortgage,-853.26,73194.26
buyer_3,Ana,,ES28209566637786783299,TRX_N-00532-81734512,2023-05-04T06:45:08,Amurrio,expenses,leisure,-63.33,73130.93
buyer_3,Ana,,ES28209566637786783299,TRX_N-00533-62048877,2023-05-05T10:30:43,Amurrio,expenses,internet,-42.0,73088.93
buyer_3,Ana,,ES28209566637786783299,TRX_N-00534-40183539,2023-05-06T17:45:20,Amurrio,expenses,phone,-44.39,73044.54
buyer_3,Ana,,ES28209566637786783299,TRX_N-00535-60066115,2023-05-06T15:28:12,Amurrio,expenses,food,-63.04,72981.5
buyer_3,Ana,,ES28209566637786783299,TRX_N-00536-57867169,2023-05-07T08:45:17,Amurrio,expenses,food,-115.52,72865.98
buyer_3,Ana,,ES28209566637786783299,TRX_N-00537-69011123,2023-05-07T18:38:07,Amurrio,expenses,transport,-65.25,72800.73
buyer_3,Ana,,ES28209566637786783299,TRX_N-00538-17628630,2023-05-07T15:19:12,Vitoria-Gasteiz,expenses,healthcare,-62.85,72737.88
buyer_3,Ana,,ES28209566637786783299,TRX_N-00539-25759116,2023-05-07T15:29:44,Amurrio,expenses,cash,-100.0,72637.88
buyer_3,Ana,,ES28209566637786783299,TRX_N-00540-82539793,2023-05-07T08:38:33,Amurrio,expenses,gifts,-670.91,71966.97
buyer_3,Ana,,ES28209566637786783299,TRX_N-00541-64650584,2023-05-08T01:00:53,Amurrio,expenses,water,-26.99,71939.98
buyer_3,Ana,,ES28209566637786783299,TRX_N-00542-74585936,2023-05-08T23:34:29,Amurrio,expenses,electricity,-24.82,71915.16
buyer_3,Ana,,ES28209566637786783299,TRX_N-00543-25251382,2023-05-08T11:03:47,Amurrio,expenses,gas,-38.71,71876.45
buyer_3,Ana,,ES28209566637786783299,TRX_N-00544-45733829,2023-05-08T22:32:39,Amurrio,expenses,appliances,-371.71,71504.74
buyer_3,Ana,,ES28209566637786783299,TRX_N-00545-13094296,2023-05-09T11:18:23,Amurrio,expenses,cash,-100.0,71404.74
buyer_3,Ana,,ES28209566637786783299,TRX_N-00546-82429614,2023-05-09T20:52:43,Amurrio,expenses,gifts,-53.49,71351.25
buyer_3,Ana,,ES28209566637786783299,TRX_N-00547-30232407,2023-05-11T21:42:43,Bilbao,expenses,cash,-100.0,71251.25
buyer_3,Ana,,ES28209566637786783299,TRX_N-00548-12028566,2023-05-13T10:10:00,Amurrio,expenses,food,-65.0,71186.25
buyer_3,Ana,,ES28209566637786783299,TRX_N-00549-69952126,2023-05-13T18:49:38,Alegría-Dulantzi,expenses,transport,-83.61,71102.64
buyer_3,Ana,,ES28209566637786783299,TRX_N-00550-26783918,2023-05-17T11:20:34,Amurrio,expenses,cash,-100.0,71002.64
buyer_3,Ana,,ES28209566637786783299,TRX_N-00551-95646775,2023-05-19T10:17:24,Amurrio,expenses,cash,-100.0,70902.64
buyer_3,Ana,,ES28209566637786783299,TRX_N-00552-99766296,2023-05-20T15:57:40,Amurrio,expenses,clothing,-138.99,70763.65
buyer_3,Ana,,ES28209566637786783299,TRX_N-00553-28763436,2023-05-20T15:29:45,Amurrio,expenses,cash,-100.0,70663.65
buyer_3,Ana,,ES28209566637786783299,TRX_N-00554-27409759,2023-05-21T09:50:28,Amurrio,expenses,leisure,-52.59,70611.06
buyer_3,Ana,,ES28209566637786783299,TRX_N-00555-64997266,2023-05-22T12:57:12,Amurrio,expenses,food,-97.84,70513.22
buyer_3,Ana,,ES28209566637786783299,TRX_N-00556-90080149,2023-05-22T20:13:35,Amurrio,expenses,clothing,-99.37,70413.85
buyer_3,Ana,,ES28209566637786783299,TRX_N-00557-77028538,2023-05-24T21:13:42,Amurrio,expenses,cash,-100.0,70313.85
buyer_3,Ana,,ES28209566637786783299,TRX_N-00558-68133198,2023-05-26T13:47:33,Amurrio,expenses,transport,-50.13,70263.72
buyer_3,Ana,,ES28209566637786783299,TRX_N-00559-47857007,2023-05-26T15:58:07,Amurrio,expenses,leisure,-45.09,70218.63
buyer_3,Ana,,ES28209566637786783299,TRX_N-00560-25578332,2023-05-26T19:13:49,Amurrio,expenses,education,-75.47,70143.16
buyer_3,Ana,,ES28209566637786783299,TRX_N-00561-09127436,2023-05-26T10:41:56,Amurrio,expenses,cash,-100.0,70043.16
buyer_3,Ana,,ES28209566637786783299,TRX_N-00562-52520105,2023-05-27T14:24:55,Mungia,expenses,cash,-100.0,69943.16
buyer_3,Ana,,ES28209566637786783299,TRX_N-00563-22501604,2023-05-28T20:14:21,Amurrio,expenses,clothing,-152.54,69790.62
buyer_3,Ana,,ES28209566637786783299,TRX_N-00564-96544659,2023-05-30T19:38:08,Arrasate,expenses,food,-94.4,69696.22
buyer_3,Ana,,ES28209566637786783299,TRX_N-00565-32876785,2023-05-31T21:51:08,Elciego,expenses,food,-112.98,69583.24
buyer_3,Ana,,ES28209566637786783299,TRX_N-00566-47485066,2023-05-31T08:08:08,Amurrio,expenses,leisure,-75.89,69507.35
buyer_3,Ana,,ES28209566637786783299,TRX_N-00567-99135041,2023-06-01T10:42:30,Amurrio,incomes,salary,3710.27,73217.62
buyer_3,Ana,,ES28209566637786783299,TRX_N-00568-16117859,2023-06-01T10:42:30,Amurrio,incomes,salary_partner,3901.31,77118.93
buyer_3,Ana,,ES28209566637786783299,TRX_N-00569-72207430,2023-06-01T10:42:30,Amurrio,incomes,extra_income,361.07,77480.0
buyer_3,Ana,,ES28209566637786783299,TRX_N-00570-41098195,2023-06-01T10:42:30,Amurrio,incomes,salary_bonus,2794.71,80274.71
buyer_3,Ana,,ES28209566637786783299,TRX_N-00571-06599748,2023-06-01T10:42:30,Amurrio,incomes,salary_partner_bonus,2976.2,83250.91
buyer_3,Ana,,ES28209566637786783299,TRX_N-00572-85286548,2023-06-03T15:51:28,Amurrio,expenses,leisure,-74.23,83176.68
buyer_3,Ana,,ES28209566637786783299,TRX_N-00573-77874553,2023-06-03T11:03:45,Errenteria,expenses,repairs,-289.02,82887.66
buyer_3,Ana,,ES28209566637786783299,TRX_N-00574-29664164,2023-06-04T09:58:47,Amurrio,expenses,mortgage,-853.26,82034.4
buyer_3,Ana,,ES28209566637786783299,TRX_N-00575-26703622,2023-06-05T13:37:37,Amurrio,expenses,food,-78.74,81955.66
buyer_3,Ana,,ES28209566637786783299,TRX_N-00576-10438807,2023-06-06T06:35:03,Amurrio,expenses,electricity,-45.05,81910.61
buyer_3,Ana,,ES28209566637786783299,TRX_N-00577-64286497,2023-06-06T09:10:33,Amurrio,expenses,cash,-100.0,81810.61
buyer_3,Ana,,ES28209566637786783299,TRX_N-00578-44645512,2023-06-07T17:26:19,Portugalete,expenses,leisure,-29.46,81781.15
buyer_3,Ana,,ES28209566637786783299,TRX_N-00579-28013374,2023-06-08T16:39:14,Amurrio,expenses,water,-29.57,81751.58
buyer_3,Ana,,ES28209566637786783299,TRX_N-00580-55367832,2023-06-08T11:07:08,Amurrio,expenses,gas,-82.01,81669.57
buyer_3,Ana,,ES28209566637786783299,TRX_N-00581-73467471,2023-06-08T12:24:26,Amurrio,expenses,internet,-42.0,81627.57
buyer_3,Ana,,ES28209566637786783299,TRX_N-00582-21374837,2023-06-08T11:57:58,Amurrio,expenses,phone,-44.79,81582.78
buyer_3,Ana,,ES28209566637786783299,TRX_N-00583-35424259,2023-06-10T19:31:29,Amurrio,expenses,food,-85.86,81496.92
buyer_3,Ana,,ES28209566637786783299,TRX_N-00584-35880254,2023-06-12T08:33:16,Amurrio,expenses,repairs,-236.21,81260.71
buyer_3,Ana,,ES28209566637786783299,TRX_N-00585-84455091,2023-06-13T15:14:05,Amurrio,expenses,leisure,-36.85,81223.86
buyer_3,Ana,,ES28209566637786783299,TRX_N-00586-71194484,2023-06-13T20:49:39,Amurrio,expenses,appliances,-246.07,80977.79
buyer_3,Ana,,ES28209566637786783299,TRX_N-00587-63437610,2023-06-15T17:47:10,Amurrio,expenses,food,-122.54,80855.25
buyer_3,Ana,,ES28209566637786783299,TRX_N-00588-95669616,2023-06-17T10:51:37,Amurrio,expenses,transport,-41.36,80813.89
buyer_3,Ana,,ES28209566637786783299,TRX_N-00589-02188261,2023-06-17T21:40:16,Amurrio,expenses,clothing,-105.14,80708.75
buyer_3,Ana,,ES28209566637786783299,TRX_N-00590-93176769,2023-06-18T16:37:54,Amurrio,expenses,food,-60.43,80648.32
buyer_3,Ana,,ES28209566637786783299,TRX_N-00591-81047210,2023-06-19T15:34:47,Amurrio,expenses,transport,-49.07,80599.25
buyer_3,Ana,,ES28209566637786783299,TRX_N-00592-60495407,2023-06-20T08:32:17,Amurrio,expenses,food,-124.95,80474.3
buyer_3,Ana,,ES28209566637786783299,TRX_N-00593-73766711,2023-06-20T21:55:34,Amurrio,expenses,transport,-53.72,80420.58
buyer_3,Ana,,ES28209566637786783299,TRX_N-00594-34629637,2023-06-20T20:39:12,Amurrio,expenses,leisure,-77.58,80343.0
buyer_3,Ana,,ES28209566637786783299,TRX_N-00595-17253005,2023-06-20T18:05:41,Amurrio,expenses,appliances,-336.01,80006.99
buyer_3,Ana,,ES28209566637786783299,TRX_N-00596-15975298,2023-06-22T08:16:37,Amurrio,expenses,leisure,-68.78,79938.21
buyer_3,Ana,,ES28209566637786783299,TRX_N-00597-87315440,2023-06-22T09:06:44,Amurrio,expenses,education,-62.1,79876.11
buyer_3,Ana,,ES28209566637786783299,TRX_N-00598-62872630,2023-06-22T20:54:22,Amurrio,expenses,cash,-100.0,79776.11
buyer_3,Ana,,ES28209566637786783299,TRX_N-00599-11687113,2023-06-24T11:14:38,Amurrio,expenses,cash,-100.0,79676.11
buyer_3,Ana,,ES28209566637786783299,TRX_N-00600-46552242,2023-06-27T12:27:37,Bermeo,expenses,clothing,-138.9,79537.21
buyer_3,Ana,,ES28209566637786783299,TRX_N-00601-77409699,2023-06-28T15:02:25,Amurrio,expenses,food,-86.88,79450.33
buyer_3,Ana,,ES28209566637786783299,TRX_N-00602-85826584,2023-06-29T08:50:25,Amurrio,expenses,leisure,-51.44,79398.89
buyer_3,Ana,,ES28209566637786783299,TRX_N-00603-40230638,2023-07-01T16:32:37,Amurrio,incomes,salary,3710.27,83109.16
buyer_3,Ana,,ES28209566637786783299,TRX_N-00604-60231785,2023-07-01T16:32:37,Amurrio,incomes,salary_partner,3901.31,87010.47
buyer_3,Ana,,ES28209566637786783299,TRX_N-00605-28715469,2023-07-01T23:22:30,Amurrio,expenses,food,-86.72,86923.75
buyer_3,Ana,,ES28209566637786783299,TRX_N-00606-28742882,2023-07-01T22:34:59,Amurrio,expenses,cash,-100.0,86823.75
buyer_3,Ana,,ES28209566637786783299,TRX_N-00607-42420387,2023-07-02T06:32:15,Amurrio,expenses,leisure,-67.02,86756.73
buyer_3,Ana,,ES28209566637786783299,TRX_N-00608-49258190,2023-07-03T07:06:37,Amurrio,expenses,transport,-50.6,86706.13
buyer_3,Ana,,ES28209566637786783299,TRX_N-00609-96214494,2023-07-04T20:40:49,Amurrio,expenses,mortgage,-853.26,85852.87
buyer_3,Ana,,ES28209566637786783299,TRX_N-00610-37171511,2023-07-05T17:31:29,Amurrio,expenses,gas,-38.79,85814.08
buyer_3,Ana,,ES28209566637786783299,TRX_N-00611-98791711,2023-07-05T18:16:41,Amurrio,expenses,phone,-37.27,85776.81
buyer_3,Ana,,ES28209566637786783299,TRX_N-00612-74347338,2023-07-07T22:48:29,Amurrio,expenses,transport,-79.58,85697.23
buyer_3,Ana,,ES28209566637786783299,TRX_N-00613-76750828,2023-07-08T08:25:33,Amurrio,expenses,water,-44.31,85652.92
buyer_3,Ana,,ES28209566637786783299,TRX_N-00614-68367890,2023-07-08T16:44:03,Amurrio,expenses,electricity,-81.97,85570.95
buyer_3,Ana,,ES28209566637786783299,TRX_N-00615-85354169,2023-07-08T15:32:19,Amurrio,expenses,internet,-42.0,85528.95
buyer_3,Ana,,ES28209566637786783299,TRX_N-00616-00509236,2023-07-08T08:58:59,Amurrio,expenses,food,-64.84,85464.11
buyer_3,Ana,,ES28209566637786783299,TRX_N-00617-35193488,2023-07-09T22:21:18,Amurrio,expenses,repairs,-210.77,85253.34
buyer_3,Ana,,ES28209566637786783299,TRX_N-00618-61253183,2023-07-11T17:09:26,Amurrio,expenses,food,-85.5,85167.84
buyer_3,Ana,,ES28209566637786783299,TRX_N-00619-69847694,2023-07-12T15:35:15,Amurrio,expenses,clothing,-93.29,85074.55
buyer_3,Ana,,ES28209566637786783299,TRX_N-00620-84806671,2023-07-13T20:07:49,Amurrio,expenses,repairs,-142.28,84932.27
buyer_3,Ana,,ES28209566637786783299,TRX_N-00621-50968845,2023-07-15T06:01:10,Amurrio,expenses,cash,-100.0,84832.27
buyer_3,Ana,,ES28209566637786783299,TRX_N-00622-00297326,2023-07-17T08:35:14,Sopela,expenses,cash,-100.0,84732.27
buyer_3,Ana,,ES28209566637786783299,TRX_N-00623-27510206,2023-07-18T18:12:49,Amurrio,expenses,leisure,-47.8,84684.47
buyer_3,Ana,,ES28209566637786783299,TRX_N-00624-91866921,2023-07-19T11:37:25,Andoain,expenses,education,-54.36,84630.11
buyer_3,Ana,,ES28209566637786783299,TRX_N-00625-50923671,2023-07-20T14:11:09,Berango,expenses,leisure,-21.98,84608.13
buyer_3,Ana,,ES28209566637786783299,TRX_N-00626-57482021,2023-07-20T18:11:08,Amurrio,expenses,cash,-100.0,84508.13
buyer_3,Ana,,ES28209566637786783299,TRX_N-00627-27547895,2023-07-21T09:30:27,Amurrio,expenses,cash,-100.0,84408.13
buyer_3,Ana,,ES28209566637786783299,TRX_N-00628-79995362,2023-07-23T13:52:25,Amurrio,expenses,leisure,-48.93,84359.2
buyer_3,Ana,,ES28209566637786783299,TRX_N-00629-79793984,2023-07-24T13:26:33,Amurrio,expenses,leisure,-83.6,84275.6
buyer_3,Ana,,ES28209566637786783299,TRX_N-00630-62589393,2023-07-26T23:32:01,Amurrio,expenses,leisure,-26.15,84249.45
buyer_3,Ana,,ES28209566637786783299,TRX_N-00631-26902638,2023-07-26T09:53:17,Amurrio,expenses,gifts,-357.9,83891.55
buyer_3,Ana,,ES28209566637786783299,TRX_N-00632-16220563,2023-07-28T20:07:22,Amurrio,expenses,repairs,-197.28,83694.27
buyer_3,Ana,,ES28209566637786783299,TRX_N-00633-71209196,2023-07-29T01:50:36,Amurrio,expenses,leisure,-33.84,83660.43
buyer_3,Ana,,ES28209566637786783299,TRX_N-00634-24709808,2023-07-30T19:48:51,Amurrio,expenses,gifts,-426.67,83233.76
buyer_3,Ana,,ES28209566637786783299,TRX_N-00635-67902996,2023-08-01T22:22:53,Amurrio,incomes,salary,3710.27,86944.03
buyer_3,Ana,,ES28209566637786783299,TRX_N-00636-35498065,2023-08-01T22:22:53,Amurrio,incomes,salary_partner,3901.31,90845.34
buyer_3,Ana,,ES28209566637786783299,TRX_N-00637-92363039,2023-08-02T23:26:26,Bilbao,expenses,cash,-100.0,90745.34
buyer_3,Ana,,ES28209566637786783299,TRX_N-00638-60193891,2023-08-03T09:21:17,Amurrio,expenses,transport,-74.85,90670.49
buyer_3,Ana,,ES28209566637786783299,TRX_N-00639-02913978,2023-08-03T09:41:00,Amurrio,expenses,cash,-100.0,90570.49
buyer_3,Ana,,ES28209566637786783299,TRX_N-00640-83916399,2023-08-04T21:23:41,Amurrio,expenses,mortgage,-853.26,89717.23
buyer_3,Ana,,ES28209566637786783299,TRX_N-00641-01975944,2023-08-05T11:23:37,Amurrio,expenses,water,-20.1,89697.13
buyer_3,Ana,,ES28209566637786783299,TRX_N-00642-40743039,2023-08-05T13:13:32,Amurrio,expenses,electricity,-37.64,89659.49
buyer_3,Ana,,ES28209566637786783299,TRX_N-00643-72147913,2023-08-05T10:46:25,Amurrio,expenses,gas,-80.21,89579.28
buyer_3,Ana,,ES28209566637786783299,TRX_N-00644-89106715,2023-08-05T09:15:19,Amurrio,expenses,internet,-42.0,89537.28
buyer_3,Ana,,ES28209566637786783299,TRX_N-00645-94058527,2023-08-06T23:52:27,Amurrio,expenses,phone,-34.93,89502.35
buyer_3,Ana,,ES28209566637786783299,TRX_N-00646-88552659,2023-08-08T10:49:49,Amurrio,expenses,food,-65.72,89436.63
buyer_3,Ana,,ES28209566637786783299,TRX_N-00647-21360030,2023-08-08T13:39:10,Amurrio,expenses,clothing,-92.01,89344.62
buyer_3,Ana,,ES28209566637786783299,TRX_N-00648-47154144,2023-08-10T21:10:01,Amurrio,expenses,cash,-100.0,89244.62
buyer_3,Ana,,ES28209566637786783299,TRX_N-00649-95937992,2023-08-10T10:26:48,Amurrio,expenses,travel,-1000.66,88243.96
buyer_3,Ana,,ES28209566637786783299,TRX_N-00650-43278505,2023-08-13T17:00:47,Amurrio,expenses,leisure,-73.87,88170.09
buyer_3,Ana,,ES28209566637786783299,TRX_N-00651-39204577,2023-08-14T20:25:12,Amurrio,expenses,cash,-100.0,88070.09
buyer_3,Ana,,ES28209566637786783299,TRX_N-00652-06899515,2023-08-16T18:48:54,Iruña de Oca,expenses,food,-119.95,87950.14
buyer_3,Ana,,ES28209566637786783299,TRX_N-00653-44960581,2023-08-16T13:42:08,Amurrio,expenses,leisure,-27.92,87922.22
buyer_3,Ana,,ES28209566637786783299,TRX_N-00654-70818826,2023-08-16T16:18:45,Elciego,expenses,repairs,-119.43,87802.79
buyer_3,Ana,,ES28209566637786783299,TRX_N-00655-36524335,2023-08-18T23:38:06,Amurrio,expenses,transport,-68.09,87734.7
buyer_3,Ana,,ES28209566637786783299,TRX_N-00656-37400307,2023-08-19T09:38:39,Amurrio,expenses,food,-85.8,87648.9
buyer_3,Ana,,ES28209566637786783299,TRX_N-00657-76413632,2023-08-20T13:25:49,Amurrio,expenses,cash,-100.0,87548.9
buyer_3,Ana,,ES28209566637786783299,TRX_N-00658-96172731,2023-08-22T10:16:09,Amurrio,expenses,cash,-100.0,87448.9
buyer_3,Ana,,ES28209566637786783299,TRX_N-00659-52699591,2023-08-23T18:27:03,Hernani,expenses,food,-62.04,87386.86
buyer_3,Ana,,ES28209566637786783299,TRX_N-00660-91283337,2023-08-23T10:03:51,Amurrio,expenses,leisure,-46.75,87340.11
buyer_3,Ana,,ES28209566637786783299,TRX_N-00661-57188987,2023-08-26T17:13:47,Amurrio,expenses,healthcare,-121.86,87218.25
buyer_3,Ana,,ES28209566637786783299,TRX_N-00662-18274118,2023-08-27T19:45:55,Amurrio,expenses,food,-65.76,87152.49
buyer_3,Ana,,ES28209566637786783299,TRX_N-00663-18986087,2023-08-28T13:37:39,Elciego,expenses,cash,-100.0,87052.49
buyer_3,Ana,,ES28209566637786783299,TRX_N-00664-13900870,2023-08-31T15:15:27,Amurrio,expenses,cash,-100.0,86952.49
buyer_3,Ana,,ES28209566637786783299,TRX_N-00665-18512281,2023-09-01T14:51:57,Amurrio,incomes,salary,3710.27,90662.76
buyer_3,Ana,,ES28209566637786783299,TRX_N-00666-37718971,2023-09-01T14:51:57,Amurrio,incomes,salary_partner,3901.31,94564.07
buyer_3,Ana,,ES28209566637786783299,TRX_N-00667-90230899,2023-09-01T14:51:57,Amurrio,incomes,extra_income,361.07,94925.14
buyer_3,Ana,,ES28209566637786783299,TRX_N-00668-65225302,2023-09-04T08:12:46,Amurrio,expenses,mortgage,-853.26,94071.88
buyer_3,Ana,,ES28209566637786783299,TRX_N-00669-76975622,2023-09-04T23:58:43,Amurrio,expenses,food,-84.71,93987.17
buyer_3,Ana,,ES28209566637786783299,TRX_N-00670-26751813,2023-09-04T09:07:36,Vitoria-Gasteiz,expenses,leisure,-21.92,93965.25
buyer_3,Ana,,ES28209566637786783299,TRX_N-00671-46881805,2023-09-04T16:10:54,Amurrio,expenses,clothing,-52.81,93912.44
buyer_3,Ana,,ES28209566637786783299,TRX_N-00672-00606552,2023-09-04T16:47:40,Amurrio,expenses,appliances,-210.77,93701.67
buyer_3,Ana,,ES28209566637786783299,TRX_N-00673-44574454,2023-09-05T16:14:39,Amurrio,expenses,food,-114.31,93587.36
buyer_3,Ana,,ES28209566637786783299,TRX_N-00674-08357561,2023-09-06T20:53:38,Amurrio,expenses,internet,-42.0,93545.36
buyer_3,Ana,,ES28209566637786783299,TRX_N-00675-37637444,2023-09-06T02:12:09,Amurrio,expenses,phone,-41.77,93503.59
buyer_3,Ana,,ES28209566637786783299,TRX_N-00676-26254901,2023-09-06T19:21:58,Amurrio,expenses,cash,-100.0,93403.59
buyer_3,Ana,,ES28209566637786783299,TRX_N-00677-74871452,2023-09-07T10:26:59,Amurrio,expenses,gas,-50.84,93352.75
buyer_3,Ana,,ES28209566637786783299,TRX_N-00678-91655112,2023-09-08T13:52:17,Amurrio,expenses,water,-26.69,93326.06
buyer_3,Ana,,ES28209566637786783299,TRX_N-00679-50756581,2023-09-08T20:22:27,Amurrio,expenses,electricity,-46.28,93279.78
buyer_3,Ana,,ES28209566637786783299,TRX_N-00680-30555498,2023-09-08T19:58:48,Amurrio,expenses,repairs,-171.91,93107.87
buyer_3,Ana,,ES28209566637786783299,TRX_N-00681-26540926,2023-09-10T17:48:04,Vitoria-Gasteiz,expenses,food,-116.16,92991.71
buyer_3,Ana,,ES28209566637786783299,TRX_N-00682-49228508,2023-09-11T14:47:05,Amurrio,expenses,healthcare,-127.61,92864.1
buyer_3,Ana,,ES28209566637786783299,TRX_N-00683-96942540,2023-09-11T13:40:18,Arrasate,expenses,repairs,-254.97,92609.13
buyer_3,Ana,,ES28209566637786783299,TRX_N-00684-84289728,2023-09-12T17:04:53,Amurrio,expenses,cash,-100.0,92509.13
buyer_3,Ana,,ES28209566637786783299,TRX_N-00685-91233217,2023-09-13T13:24:20,Amurrio,expenses,food,-82.88,92426.25
buyer_3,Ana,,ES28209566637786783299,TRX_N-00686-51517142,2023-09-13T14:26:16,Lasarte-Oria,expenses,cash,-100.0,92326.25
buyer_3,Ana,,ES28209566637786783299,TRX_N-00687-13177606,2023-09-14T19:56:27,Amurrio,expenses,appliances,-171.84,92154.41
buyer_3,Ana,,ES28209566637786783299,TRX_N-00688-64834834,2023-09-15T14:40:11,Amurrio,expenses,leisure,-23.44,92130.97
buyer_3,Ana,,ES28209566637786783299,TRX_N-00689-28698241,2023-09-16T14:29:17,Amurrio,expenses,healthcare,-167.7,91963.27
buyer_3,Ana,,ES28209566637786783299,TRX_N-00690-95246228,2023-09-16T08:27:17,Amurrio,expenses,cash,-100.0,91863.27
buyer_3,Ana,,ES28209566637786783299,TRX_N-00691-33920057,2023-09-16T22:38:58,Amurrio,expenses,repairs,-118.25,91745.02
buyer_3,Ana,,ES28209566637786783299,TRX_N-00692-77628197,2023-09-17T11:25:38,Amurrio,expenses,gifts,-488.34,91256.68
buyer_3,Ana,,ES28209566637786783299,TRX_N-00693-44887408,2023-09-18T10:38:48,Amurrio,expenses,clothing,-142.08,91114.6
buyer_3,Ana,,ES28209566637786783299,TRX_N-00694-55662023,2023-09-18T13:01:39,Amurrio,expenses,healthcare,-144.33,90970.27
buyer_3,Ana,,ES28209566637786783299,TRX_N-00695-68437741,2023-09-18T18:10:01,Amurrio,expenses,gifts,-410.87,90559.4
buyer_3,Ana,,ES28209566637786783299,TRX_N-00696-67404349,2023-09-21T23:40:59,Amurrio,expenses,food,-90.99,90468.41
buyer_3,Ana,,ES28209566637786783299,TRX_N-00697-01426440,2023-09-22T14:27:09,Amurrio,expenses,leisure,-33.33,90435.08
buyer_3,Ana,,ES28209566637786783299,TRX_N-00698-51060117,2023-09-23T03:41:49,Amurrio,expenses,food,-89.42,90345.66
buyer_3,Ana,,ES28209566637786783299,TRX_N-00699-96795328,2023-09-23T15:11:15,Amurrio,expenses,transport,-53.01,90292.65
buyer_3,Ana,,ES28209566637786783299,TRX_N-00700-94139247,2023-09-23T09:37:22,Amurrio,expenses,repairs,-72.99,90219.66
buyer_3,Ana,,ES28209566637786783299,TRX_N-00701-30759556,2023-09-25T20:44:24,Amurrio,expenses,cash,-100.0,90119.66
buyer_3,Ana,,ES28209566637786783299,TRX_N-00702-04617545,2023-09-26T08:46:42,Amurrio,expenses,repairs,-185.28,89934.38
buyer_3,Ana,,ES28209566637786783299,TRX_N-00703-26034770,2023-09-28T00:38:52,Amurrio,expenses,cash,-100.0,89834.38
buyer_3,Ana,,ES28209566637786783299,TRX_N-00704-71299875,2023-09-29T16:36:08,Amurrio,expenses,cash,-100.0,89734.38
buyer_3,Ana,,ES28209566637786783299,TRX_N-00705-93715385,2023-10-01T17:42:40,Amurrio,incomes,salary,3710.27,93444.65
buyer_3,Ana,,ES28209566637786783299,TRX_N-00706-13441139,2023-10-01T17:42:40,Amurrio,incomes,salary_partner,3901.31,97345.96
buyer_3,Ana,,ES28209566637786783299,TRX_N-00707-60638744,2023-10-01T21:22:56,Amurrio,expenses,food,-91.09,97254.87
buyer_3,Ana,,ES28209566637786783299,TRX_N-00708-15171097,2023-10-03T05:50:58,Amurrio,expenses,gifts,-119.08,97135.79
buyer_3,Ana,,ES28209566637786783299,TRX_N-00709-03515535,2023-10-04T08:06:42,Amurrio,expenses,mortgage,-853.26,96282.53
buyer_3,Ana,,ES28209566637786783299,TRX_N-00710-76866631,2023-10-04T15:02:33,Mungia,expenses,food,-98.78,96183.75
buyer_3,Ana,,ES28209566637786783299,TRX_N-00711-88560482,2023-10-05T15:25:46,Amurrio,expenses,electricity,-49.48,96134.27
buyer_3,Ana,,ES28209566637786783299,TRX_N-00712-80790206,2023-10-05T14:01:32,Amurrio,expenses,phone,-33.99,96100.28
buyer_3,Ana,,ES28209566637786783299,TRX_N-00713-94391806,2023-10-05T11:24:15,Amurrio,expenses,transport,-85.06,96015.22
buyer_3,Ana,,ES28209566637786783299,TRX_N-00714-05190665,2023-10-05T09:59:58,Amurrio,expenses,clothing,-113.62,95901.6
buyer_3,Ana,,ES28209566637786783299,TRX_N-00715-90576526,2023-10-05T09:59:40,Amurrio,expenses,cash,-100.0,95801.6
buyer_3,Ana,,ES28209566637786783299,TRX_N-00716-88790519,2023-10-06T10:16:00,Getxo,expenses,leisure,-49.05,95752.55
buyer_3,Ana,,ES28209566637786783299,TRX_N-00717-44612234,2023-10-07T12:13:51,Amurrio,expenses,gas,-39.87,95712.68
buyer_3,Ana,,ES28209566637786783299,TRX_N-00718-91581455,2023-10-07T18:25:32,Amurrio,expenses,food,-119.14,95593.54
buyer_3,Ana,,ES28209566637786783299,TRX_N-00719-51551665,2023-10-07T16:54:48,Amurrio,expenses,leisure,-32.31,95561.23
buyer_3,Ana,,ES28209566637786783299,TRX_N-00720-83879133,2023-10-08T12:42:25,Amurrio,expenses,internet,-42.0,95519.23
buyer_3,Ana,,ES28209566637786783299,TRX_N-00721-57096612,2023-10-08T17:43:07,Amurrio,expenses,water,-28.66,95490.57
buyer_3,Ana,,ES28209566637786783299,TRX_N-00722-03436137,2023-10-09T12:17:29,Llodio,expenses,leisure,-54.66,95435.91
buyer_3,Ana,,ES28209566637786783299,TRX_N-00723-27900392,2023-10-10T13:34:25,Amurrio,expenses,leisure,-24.88,95411.03
buyer_3,Ana,,ES28209566637786783299,TRX_N-00724-66946043,2023-10-12T20:59:00,Amurrio,expenses,leisure,-39.03,95372.0
buyer_3,Ana,,ES28209566637786783299,TRX_N-00725-67497761,2023-10-13T21:34:55,Amurrio,expenses,gifts,-495.88,94876.12
buyer_3,Ana,,ES28209566637786783299,TRX_N-00726-87555055,2023-10-14T18:34:52,Vitoria-Gasteiz,expenses,cash,-100.0,94776.12
buyer_3,Ana,,ES28209566637786783299,TRX_N-00727-35532309,2023-10-15T12:19:31,Amurrio,expenses,food,-123.77,94652.35
buyer_3,Ana,,ES28209566637786783299,TRX_N-00728-12406855,2023-10-15T09:21:34,Zarautz,expenses,education,-56.56,94595.79
buyer_3,Ana,,ES28209566637786783299,TRX_N-00729-36435962,2023-10-16T11:21:30,Amurrio,expenses,leisure,-53.81,94541.98
buyer_3,Ana,,ES28209566637786783299,TRX_N-00730-70532236,2023-10-19T18:21:33,Amurrio,expenses,leisure,-18.79,94523.19
buyer_3,Ana,,ES28209566637786783299,TRX_N-00731-84483316,2023-10-22T14:13:21,Amurrio,expenses,repairs,-161.12,94362.07
buyer_3,Ana,,ES28209566637786783299,TRX_N-00732-73942534,2023-10-22T09:25:01,Amurrio,expenses,gifts,-139.29,94222.78
buyer_3,Ana,,ES28209566637786783299,TRX_N-00733-95031132,2023-10-25T20:23:35,Amurrio,expenses,leisure,-54.79,94167.99
buyer_3,Ana,,ES28209566637786783299,TRX_N-00734-41178761,2023-10-27T08:17:26,Amurrio,expenses,gifts,-618.07,93549.92
buyer_3,Ana,,ES28209566637786783299,TRX_N-00735-05610563,2023-10-28T09:42:18,Amurrio,expenses,cash,-100.0,93449.92
buyer_3,Ana,,ES28209566637786783299,TRX_N-00736-06339775,2023-10-30T16:41:35,Amurrio,expenses,gifts,-586.8,92863.12
buyer_3,Ana,,ES28209566637786783299,TRX_N-00737-44553894,2023-10-31T16:39:15,Amurrio,expenses,appliances,-398.87,92464.25
buyer_3,Ana,,ES28209566637786783299,TRX_N-00738-70508252,2023-11-01T09:17:15,Amurrio,incomes,salary,3710.27,96174.52
buyer_3,Ana,,ES28209566637786783299,TRX_N-00739-66099100,2023-11-01T09:17:15,Amurrio,incomes,salary_partner,3901.31,100075.83
buyer_3,Ana,,ES28209566637786783299,TRX_N-00740-59336451,2023-11-02T08:36:08,Amurrio,expenses,education,-64.77,100011.06
buyer_3,Ana,,ES28209566637786783299,TRX_N-00741-16004930,2023-11-03T10:02:52,Amurrio,expenses,travel,-368.17,99642.89
buyer_3,Ana,,ES28209566637786783299,TRX_N-00742-38209544,2023-11-04T20:15:12,Amurrio,expenses,mortgage,-853.26,98789.63
buyer_3,Ana,,ES28209566637786783299,TRX_N-00743-79491392,2023-11-04T06:42:23,Amurrio,expenses,cash,-100.0,98689.63
buyer_3,Ana,,ES28209566637786783299,TRX_N-00744-19941916,2023-11-05T19:33:59,Amurrio,expenses,electricity,-78.54,98611.09
buyer_3,Ana,,ES28209566637786783299,TRX_N-00745-94943026,2023-11-05T08:08:09,Amurrio,expenses,gas,-94.76,98516.33
buyer_3,Ana,,ES28209566637786783299,TRX_N-00746-95677411,2023-11-05T22:57:53,Pasaia,expenses,leisure,-78.0,98438.33
buyer_3,Ana,,ES28209566637786783299,TRX_N-00747-65182602,2023-11-06T11:57:03,Amurrio,expenses,food,-111.75,98326.58
buyer_3,Ana,,ES28209566637786783299,TRX_N-00748-36103209,2023-11-07T20:42:49,Amurrio,expenses,water,-41.96,98284.62
buyer_3,Ana,,ES28209566637786783299,TRX_N-00749-53393118,2023-11-08T17:26:02,Amurrio,expenses,phone,-38.19,98246.43
buyer_3,Ana,,ES28209566637786783299,TRX_N-00750-90519707,2023-11-08T14:16:24,Amurrio,expenses,internet,-42.0,98204.43
buyer_3,Ana,,ES28209566637786783299,TRX_N-00751-12992531,2023-11-08T14:56:34,Amurrio,expenses,leisure,-67.74,98136.69
buyer_3,Ana,,ES28209566637786783299,TRX_N-00752-65083513,2023-11-08T08:32:16,Amurrio,expenses,cash,-100.0,98036.69
buyer_3,Ana,,ES28209566637786783299,TRX_N-00753-22439628,2023-11-09T04:46:57,Amurrio,expenses,food,-88.64,97948.05
buyer_3,Ana,,ES28209566637786783299,TRX_N-00754-73078621,2023-11-09T12:31:29,Sopela,expenses,appliances,-235.62,97712.43
buyer_3,Ana,,ES28209566637786783299,TRX_N-00755-96990734,2023-11-10T20:07:28,Amurrio,expenses,food,-92.05,97620.38
buyer_3,Ana,,ES28209566637786783299,TRX_N-00756-63269794,2023-11-11T09:43:00,Bermeo,expenses,clothing,-59.65,97560.73
buyer_3,Ana,,ES28209566637786783299,TRX_N-00757-42854877,2023-11-12T11:46:58,Amurrio,expenses,transport,-48.48,97512.25
buyer_3,Ana,,ES28209566637786783299,TRX_N-00758-31176169,2023-11-13T18:26:54,Erandio,expenses,education,-77.46,97434.79
buyer_3,Ana,,ES28209566637786783299,TRX_N-00759-42925156,2023-11-14T13:43:07,Amurrio,expenses,food,-115.83,97318.96
buyer_3,Ana,,ES28209566637786783299,TRX_N-00760-10547954,2023-11-16T06:52:20,Amurrio,expenses,cash,-100.0,97218.96
buyer_3,Ana,,ES28209566637786783299,TRX_N-00761-11290593,2023-11-17T11:43:35,Iruña de Oca,expenses,transport,-80.24,97138.72
buyer_3,Ana,,ES28209566637786783299,TRX_N-00762-42000893,2023-11-19T11:46:25,Amurrio,expenses,transport,-67.9,97070.82
buyer_3,Ana,,ES28209566637786783299,TRX_N-00763-88705174,2023-11-20T17:59:10,Amurrio,expenses,food,-101.27,96969.55
buyer_3,Ana,,ES28209566637786783299,TRX_N-00764-20385275,2023-11-22T17:36:57,Amurrio,expenses,cash,-100.0,96869.55
buyer_3,Ana,,ES28209566637786783299,TRX_N-00765-08197177,2023-11-24T12:16:59,Amurrio,expenses,transport,-60.79,96808.76
buyer_3,Ana,,ES28209566637786783299,TRX_N-00766-83269678,2023-11-25T13:14:39,Amurrio,expenses,gifts,-354.96,96453.8
buyer_3,Ana,,ES28209566637786783299,TRX_N-00767-69522594,2023-11-27T19:21:42,Amurrio,expenses,leisure,-34.25,96419.55
buyer_3,Ana,,ES28209566637786783299,TRX_N-00768-44791353,2023-11-27T18:33:45,Amurrio,expenses,gifts,-30.51,96389.04
buyer_3,Ana,,ES28209566637786783299,TRX_N-00769-77541699,2023-11-29T01:24:19,Amurrio,expenses,leisure,-58.45,96330.59
buyer_3,Ana,,ES28209566637786783299,TRX_N-00770-30263599,2023-12-01T11:09:20,Amurrio,incomes,salary,3710.27,100040.86
buyer_3,Ana,,ES28209566637786783299,TRX_N-00771-56335149,2023-12-01T11:09:20,Amurrio,incomes,salary_partner,3901.31,103942.17
buyer_3,Ana,,ES28209566637786783299,TRX_N-00772-68897354,2023-12-01T11:09:20,Amurrio,incomes,salary_bonus,2929.15,106871.32
buyer_3,Ana,,ES28209566637786783299,TRX_N-00773-11240217,2023-12-01T11:09:20,Amurrio,incomes,salary_partner_bonus,3039.68,109911.0
buyer_3,Ana,,ES28209566637786783299,TRX_N-00774-05578674,2023-12-02T10:53:12,Amurrio,expenses,repairs,-194.27,109716.73
buyer_3,Ana,,ES28209566637786783299,TRX_N-00775-90626505,2023-12-03T15:01:55,Amurrio,expenses,leisure,-33.67,109683.06
buyer_3,Ana,,ES28209566637786783299,TRX_N-00776-47679662,2023-12-04T13:03:00,Amurrio,expenses,mortgage,-853.26,108829.8
buyer_3,Ana,,ES28209566637786783299,TRX_N-00777-58589659,2023-12-05T20:21:55,Leioa,expenses,cash,-100.0,108729.8
buyer_3,Ana,,ES28209566637786783299,TRX_N-00778-41817380,2023-12-05T09:43:14,Amurrio,expenses,repairs,-323.24,108406.56
buyer_3,Ana,,ES28209566637786783299,TRX_N-00779-35109852,2023-12-06T16:47:04,Amurrio,expenses,gas,-42.42,108364.14
buyer_3,Ana,,ES28209566637786783299,TRX_N-00780-25159546,2023-12-06T15:10:33,Amurrio,expenses,internet,-42.0,108322.14
buyer_3,Ana,,ES28209566637786783299,TRX_N-00781-88844455,2023-12-06T14:16:25,Amurrio,expenses,food,-115.51,108206.63
buyer_3,Ana,,ES28209566637786783299,TRX_N-00782-55801599,2023-12-08T11:50:28,Amurrio,expenses,water,-41.61,108165.02
buyer_3,Ana,,ES28209566637786783299,TRX_N-00783-40617027,2023-12-08T14:57:04,Amurrio,expenses,electricity,-31.49,108133.53
buyer_3,Ana,,ES28209566637786783299,TRX_N-00784-38205882,2023-12-08T11:24:18,Amurrio,expenses,phone,-41.63,108091.9
buyer_3,Ana,,ES28209566637786783299,TRX_N-00785-73194901,2023-12-08T18:58:14,Amurrio,expenses,cash,-100.0,107991.9
buyer_3,Ana,,ES28209566637786783299,TRX_N-00786-94067097,2023-12-09T20:46:56,Amurrio,expenses,cash,-100.0,107891.9
buyer_3,Ana,,ES28209566637786783299,TRX_N-00787-36263525,2023-12-09T08:23:18,Amurrio,expenses,gifts,-815.12,107076.78
buyer_3,Ana,,ES28209566637786783299,TRX_N-00788-33468689,2023-12-10T19:05:25,Elciego,expenses,transport,-40.52,107036.26
buyer_3,Ana,,ES28209566637786783299,TRX_N-00789-02304373,2023-12-10T15:31:15,Amurrio,expenses,leisure,-70.77,106965.49
buyer_3,Ana,,ES28209566637786783299,TRX_N-00790-40200405,2023-12-11T16:16:05,Amurrio,expenses,leisure,-43.15,106922.34
buyer_3,Ana,,ES28209566637786783299,TRX_N-00791-59659081,2023-12-16T14:00:40,Amurrio,expenses,food,-115.26,106807.08
buyer_3,Ana,,ES28209566637786783299,TRX_N-00792-85270645,2023-12-16T23:34:46,Amurrio,expenses,cash,-100.0,106707.08
buyer_3,Ana,,ES28209566637786783299,TRX_N-00793-09959520,2023-12-17T09:58:48,Amurrio,expenses,transport,-82.56,106624.52
buyer_3,Ana,,ES28209566637786783299,TRX_N-00794-93777225,2023-12-18T18:36:56,Amurrio,expenses,food,-111.73,106512.79
buyer_3,Ana,,ES28209566637786783299,TRX_N-00795-57283663,2023-12-18T14:20:52,Amurrio,expenses,gifts,-798.12,105714.67
buyer_3,Ana,,ES28209566637786783299,TRX_N-00796-21839272,2023-12-20T16:03:29,Amurrio,expenses,repairs,-252.38,105462.29
buyer_3,Ana,,ES28209566637786783299,TRX_N-00797-28816920,2023-12-21T11:25:31,Amurrio,expenses,leisure,-20.74,105441.55
buyer_3,Ana,,ES28209566637786783299,TRX_N-00798-16569740,2023-12-22T23:02:33,Amurrio,expenses,cash,-100.0,105341.55
buyer_3,Ana,,ES28209566637786783299,TRX_N-00799-70735068,2023-12-23T15:28:51,Amurrio,expenses,leisure,-30.65,105310.9
buyer_3,Ana,,ES28209566637786783299,TRX_N-00800-45658232,2023-12-27T15:15:56,Hernani,expenses,transport,-75.27,105235.63
buyer_3,Ana,,ES28209566637786783299,TRX_N-00801-90911589,2023-12-28T04:33:08,Amurrio,expenses,cash,-100.0,105135.63
buyer_3,Ana,,ES28209566637786783299,TRX_N-00802-20778193,2023-12-29T07:34:17,Llodio,expenses,cash,-100.0,105035.63
buyer_3,Ana,,ES28209566637786783299,TRX_N-00803-29743716,2023-12-31T13:06:12,Amurrio,expenses,leisure,-80.91,104954.72
buyer_3,Ana,,ES28209566637786783299,TRX_N-00804-37852591,2023-12-31T17:39:26,Iruña de Oca,expenses,gifts,-817.99,104136.73
buyer_3,Ana,,ES28209566637786783299,TRX_N-00805-15113212,2024-01-01T19:40:40,Amurrio,incomes,salary,3794.42,107931.15
buyer_3,Ana,,ES28209566637786783299,TRX_N-00806-90125955,2024-01-01T19:40:40,Amurrio,incomes,salary_partner,3989.8,111920.95
buyer_3,Ana,,ES28209566637786783299,TRX_N-00807-64831851,2024-01-01T19:40:40,Amurrio,incomes,extra_income,361.07,112282.02
buyer_3,Ana,,ES28209566637786783299,TRX_N-00808-62449016,2024-01-03T10:47:23,Bermeo,expenses,food,-68.17,112213.85
buyer_3,Ana,,ES28209566637786783299,TRX_N-00809-85910848,2024-01-03T14:40:11,Erandio,expenses,gifts,-684.83,111529.02
buyer_3,Ana,,ES28209566637786783299,TRX_N-00810-59748327,2024-01-04T19:00:52,Amurrio,expenses,mortgage,-853.26,110675.76
buyer_3,Ana,,ES28209566637786783299,TRX_N-00811-29828291,2024-01-05T10:41:01,Amurrio,expenses,water,-24.46,110651.3
buyer_3,Ana,,ES28209566637786783299,TRX_N-00812-04745899,2024-01-06T22:02:01,Amurrio,expenses,gas,-93.19,110558.11
buyer_3,Ana,,ES28209566637786783299,TRX_N-00813-56138375,2024-01-06T09:51:48,Amurrio,expenses,cash,-100.0,110458.11
buyer_3,Ana,,ES28209566637786783299,TRX_N-00814-40697075,2024-01-07T20:41:36,Amurrio,expenses,leisure,-76.93,110381.18
buyer_3,Ana,,ES28209566637786783299,TRX_N-00815-91696766,2024-01-08T20:27:44,Amurrio,expenses,electricity,-27.16,110354.02
buyer_3,Ana,,ES28209566637786783299,TRX_N-00816-82895695,2024-01-08T10:59:13,Amurrio,expenses,internet,-42.0,110312.02
buyer_3,Ana,,ES28209566637786783299,TRX_N-00817-81927256,2024-01-08T20:31:34,Amurrio,expenses,phone,-33.9,110278.12
buyer_3,Ana,,ES28209566637786783299,TRX_N-00818-41876250,2024-01-08T08:08:24,Amurrio,expenses,gifts,-143.13,110134.99
buyer_3,Ana,,ES28209566637786783299,TRX_N-00819-19085914,2024-01-09T08:01:07,Amurrio,expenses,leisure,-40.36,110094.63
buyer_3,Ana,,ES28209566637786783299,TRX_N-00820-82783144,2024-01-09T20:18:33,Elciego,expenses,cash,-100.0,109994.63
buyer_3,Ana,,ES28209566637786783299,TRX_N-00821-86634565,2024-01-10T16:00:44,Amurrio,expenses,transport,-60.94,109933.69
buyer_3,Ana,,ES28209566637786783299,TRX_N-00822-13900492,2024-01-10T16:13:32,Amurrio,expenses,healthcare,-162.02,109771.67
buyer_3,Ana,,ES28209566637786783299,TRX_N-00823-48071408,2024-01-11T17:27:24,Amurrio,expenses,food,-121.93,109649.74
buyer_3,Ana,,ES28209566637786783299,TRX_N-00824-63151686,2024-01-13T17:26:49,Amurrio,expenses,cash,-100.0,109549.74
buyer_3,Ana,,ES28209566637786783299,TRX_N-00825-16856728,2024-01-15T09:49:47,Amurrio,expenses,cash,-100.0,109449.74
buyer_3,Ana,,ES28209566637786783299,TRX_N-00826-18968523,2024-01-16T12:05:33,Alegría-Dulantzi,expenses,appliances,-223.63,109226.11
buyer_3,Ana,,ES28209566637786783299,TRX_N-00827-21039648,2024-01-18T20:19:05,Amurrio,expenses,food,-62.31,109163.8
buyer_3,Ana,,ES28209566637786783299,TRX_N-00828-48934597,2024-01-19T04:53:45,Amurrio,expenses,travel,-792.61,108371.19
buyer_3,Ana,,ES28209566637786783299,TRX_N-00829-98089432,2024-01-20T14:18:03,Amurrio,expenses,transport,-88.6,108282.59
buyer_3,Ana,,ES28209566637786783299,TRX_N-00830-24950779,2024-01-21T13:18:15,Erandio,expenses,clothing,-53.17,108229.42
buyer_3,Ana,,ES28209566637786783299,TRX_N-00831-19831439,2024-01-25T09:40:04,Amurrio,expenses,repairs,-162.96,108066.46
buyer_3,Ana,,ES28209566637786783299,TRX_N-00832-15561407,2024-01-27T17:09:27,Amurrio,expenses,transport,-78.75,107987.71
buyer_3,Ana,,ES28209566637786783299,TRX_N-00833-65731979,2024-01-27T16:02:46,Amurrio,expenses,gifts,-304.74,107682.97
buyer_3,Ana,,ES28209566637786783299,TRX_N-00834-64329552,2024-01-31T10:13:16,Amurrio,expenses,transport,-64.44,107618.53
buyer_3,Ana,,ES28209566637786783299,TRX_N-00835-64088372,2024-02-01T22:29:53,Amurrio,incomes,salary,3794.42,111412.95
buyer_3,Ana,,ES28209566637786783299,TRX_N-00836-67256226,2024-02-01T22:29:53,Amurrio,incomes,salary_partner,3989.8,115402.75
buyer_3,Ana,,ES28209566637786783299,TRX_N-00837-79069597,2024-02-02T12:12:33,Amurrio,expenses,clothing,-151.37,115251.38
buyer_3,Ana,,ES28209566637786783299,TRX_N-00838-96848441,2024-02-03T11:11:37,Amurrio,expenses,transport,-48.01,115203.37
buyer_3,Ana,,ES28209566637786783299,TRX_N-00839-76473765,2024-02-04T19:58:39,Amurrio,expenses,mortgage,-853.26,114350.11
buyer_3,Ana,,ES28209566637786783299,TRX_N-00840-40710832,2024-02-05T15:53:49,Amurrio,expenses,leisure,-77.85,114272.26
buyer_3,Ana,,ES28209566637786783299,TRX_N-00841-02442013,2024-02-05T10:22:10,Amurrio,expenses,cash,-100.0,114172.26
buyer_3,Ana,,ES28209566637786783299,TRX_N-00842-21173519,2024-02-07T21:49:53,Amurrio,expenses,food,-106.97,114065.29
buyer_3,Ana,,ES28209566637786783299,TRX_N-00843-00397094,2024-02-08T19:45:11,Amurrio,expenses,water,-20.68,114044.61
buyer_3,Ana,,ES28209566637786783299,TRX_N-00844-81779638,2024-02-08T08:00:13,Amurrio,expenses,internet,-42.0,114002.61
buyer_3,Ana,,ES28209566637786783299,TRX_N-00845-35804273,2024-02-08T12:03:13,Amurrio,expenses,phone,-30.47,113972.14
buyer_3,Ana,,ES28209566637786783299,TRX_N-00846-72482912,2024-02-08T19:25:01,Amurrio,expenses,electricity,-40.88,113931.26
buyer_3,Ana,,ES28209566637786783299,TRX_N-00847-19332621,2024-02-08T21:11:18,Amurrio,expenses,gas,-67.87,113863.39
buyer_3,Ana,,ES28209566637786783299,TRX_N-00848-06374407,2024-02-08T09:29:54,Amurrio,expenses,repairs,-306.71,113556.68
buyer_3,Ana,,ES28209566637786783299,TRX_N-00849-98448723,2024-02-10T10:02:17,Amurrio,expenses,cash,-100.0,113456.68
buyer_3,Ana,,ES28209566637786783299,TRX_N-00850-61538913,2024-02-11T13:53:48,Amurrio,expenses,clothing,-103.62,113353.06
buyer_3,Ana,,ES28209566637786783299,TRX_N-00851-61348490,2024-02-12T18:54:41,Amurrio,expenses,transport,-48.36,113304.7
buyer_3,Ana,,ES28209566637786783299,TRX_N-00852-99403779,2024-02-12T19:20:48,Amurrio,expenses,repairs,-63.93,113240.77
buyer_3,Ana,,ES28209566637786783299,TRX_N-00853-63042033,2024-02-13T13:43:56,Amurrio,expenses,food,-99.67,113141.1
buyer_3,Ana,,ES28209566637786783299,TRX_N-00854-26522927,2024-02-15T21:35:01,Amurrio,expenses,cash,-100.0,113041.1
buyer_3,Ana,,ES28209566637786783299,TRX_N-00855-19689536,2024-02-16T17:51:00,Amurrio,expenses,clothing,-80.43,112960.67
buyer_3,Ana,,ES28209566637786783299,TRX_N-00856-26895228,2024-02-18T06:36:51,Amurrio,expenses,transport,-69.07,112891.6
buyer_3,Ana,,ES28209566637786783299,TRX_N-00857-11348061,2024-02-18T03:56:07,Irun,expenses,cash,-100.0,112791.6
buyer_3,Ana,,ES28209566637786783299,TRX_N-00858-58429678,2024-02-20T10:03:58,Amurrio,expenses,clothing,-117.63,112673.97
buyer_3,Ana,,ES28209566637786783299,TRX_N-00859-81209866,2024-02-23T15:13:01,Portugalete,expenses,food,-116.93,112557.04
buyer_3,Ana,,ES28209566637786783299,TRX_N-00860-16694987,2024-02-23T09:48:36,Sestao,expenses,leisure,-64.45,112492.59
buyer_3,Ana,,ES28209566637786783299,TRX_N-00861-57404536,2024-02-23T20:54:53,Amurrio,expenses,education,-44.01,112448.58
buyer_3,Ana,,ES28209566637786783299,TRX_N-00862-53771124,2024-02-23T00:25:17,Amurrio,expenses,cash,-100.0,112348.58
buyer_3,Ana,,ES28209566637786783299,TRX_N-00863-03975097,2024-02-25T12:23:59,Amurrio,expenses,cash,-100.0,112248.58
buyer_3,Ana,,ES28209566637786783299,TRX_N-00864-60663955,2024-02-26T19:46:15,Amurrio,expenses,food,-85.77,112162.81
buyer_3,Ana,,ES28209566637786783299,TRX_N-00865-93289398,2024-02-26T22:10:00,Amurrio,expenses,appliances,-288.23,111874.58
buyer_3,Ana,,ES28209566637786783299,TRX_N-00866-50217058,2024-03-01T23:54:23,Amurrio,incomes,salary,3794.42,115669.0
buyer_3,Ana,,ES28209566637786783299,TRX_N-00867-22279828,2024-03-01T23:54:23,Amurrio,incomes,salary_partner,3989.8,119658.8
buyer_3,Ana,,ES28209566637786783299,TRX_N-00868-29373295,2024-03-04T20:51:09,Amurrio,expenses,mortgage,-853.26,118805.54
buyer_3,Ana,,ES28209566637786783299,TRX_N-00869-75821115,2024-03-05T13:16:27,Amurrio,expenses,gas,-104.44,118701.1
buyer_3,Ana,,ES28209566637786783299,TRX_N-00870-20977399,2024-03-05T18:32:58,Amurrio,expenses,gifts,-624.03,118077.07
buyer_3,Ana,,ES28209566637786783299,TRX_N-00871-37114826,2024-03-06T20:51:35,Amurrio,expenses,water,-41.26,118035.81
buyer_3,Ana,,ES28209566637786783299,TRX_N-00872-88502319,2024-03-06T12:22:33,Amurrio,expenses,internet,-42.0,117993.81
buyer_3,Ana,,ES28209566637786783299,TRX_N-00873-32886937,2024-03-06T10:02:27,Amurrio,expenses,cash,-100.0,117893.81
buyer_3,Ana,,ES28209566637786783299,TRX_N-00874-56734506,2024-03-08T10:33:42,Amurrio,expenses,electricity,-81.66,117812.15
buyer_3,Ana,,ES28209566637786783299,TRX_N-00875-34238055,2024-03-08T12:54:07,Amurrio,expenses,phone,-44.88,117767.27
buyer_3,Ana,,ES28209566637786783299,TRX_N-00876-44552166,2024-03-08T17:13:21,Amurrio,expenses,leisure,-27.22,117740.05
buyer_3,Ana,,ES28209566637786783299,TRX_N-00877-63107706,2024-03-08T11:01:32,Amurrio,expenses,travel,-1550.28,116189.77
buyer_3,Ana,,ES28209566637786783299,TRX_N-00878-69027978,2024-03-09T12:29:57,Basauri,expenses,food,-70.84,116118.93
buyer_3,Ana,,ES28209566637786783299,TRX_N-00879-97697598,2024-03-09T14:12:18,Amurrio,expenses,clothing,-104.83,116014.1
buyer_3,Ana,,ES28209566637786783299,TRX_N-00880-74129835,2024-03-09T14:06:40,Getxo,expenses,appliances,-289.07,115725.03
buyer_3,Ana,,ES28209566637786783299,TRX_N-00881-89079370,2024-03-10T13:30:09,Arrasate,expenses,repairs,-214.27,115510.76
buyer_3,Ana,,ES28209566637786783299,TRX_N-00882-98993445,2024-03-11T21:34:17,Amurrio,expenses,leisure,-49.32,115461.44
buyer_3,Ana,,ES28209566637786783299,TRX_N-00883-25523579,2024-03-12T08:28:07,Amurrio,expenses,cash,-100.0,115361.44
buyer_3,Ana,,ES28209566637786783299,TRX_N-00884-17135113,2024-03-13T15:46:06,Amurrio,expenses,leisure,-66.46,115294.98
buyer_3,Ana,,ES28209566637786783299,TRX_N-00885-65092668,2024-03-14T18:29:55,Amurrio,expenses,cash,-100.0,115194.98
buyer_3,Ana,,ES28209566637786783299,TRX_N-00886-26609458,2024-03-14T12:00:36,Amurrio,expenses,repairs,-136.63,115058.35
buyer_3,Ana,,ES28209566637786783299,TRX_N-00887-55194332,2024-03-15T12:07:15,Amurrio,expenses,leisure,-19.55,115038.8
buyer_3,Ana,,ES28209566637786783299,TRX_N-00888-61585338,2024-03-16T14:53:06,Amurrio,expenses,cash,-100.0,114938.8
buyer_3,Ana,,ES28209566637786783299,TRX_N-00889-13524796,2024-03-19T16:51:42,Amurrio,expenses,clothing,-107.41,114831.39
buyer_3,Ana,,ES28209566637786783299,TRX_N-00890-60781182,2024-03-20T19:49:16,Amurrio,expenses,food,-73.64,114757.75
buyer_3,Ana,,ES28209566637786783299,TRX_N-00891-02754355,2024-03-23T08:19:39,Amurrio,expenses,cash,-100.0,114657.75
buyer_3,Ana,,ES28209566637786783299,TRX_N-00892-65648099,2024-03-25T14:25:10,Santurtzi,expenses,transport,-61.19,114596.56
buyer_3,Ana,,ES28209566637786783299,TRX_N-00893-65243379,2024-03-26T08:30:57,Amurrio,expenses,repairs,-194.83,114401.73
buyer_3,Ana,,ES28209566637786783299,TRX_N-00894-70870345,2024-03-28T17:45:11,Amurrio,expenses,food,-78.51,114323.22
buyer_3,Ana,,ES28209566637786783299,TRX_N-00895-85751143,2024-03-29T11:18:37,Amurrio,expenses,leisure,-82.7,114240.52
buyer_3,Ana,,ES28209566637786783299,TRX_N-00896-42486069,2024-03-29T21:27:48,Amurrio,expenses,travel,-696.15,113544.37
buyer_3,Ana,,ES28209566637786783299,TRX_N-00897-21831371,2024-03-30T00:14:03,Amurrio,expenses,transport,-44.14,113500.23
buyer_3,Ana,,ES28209566637786783299,TRX_N-00898-19397081,2024-03-30T20:03:04,Amurrio,expenses,cash,-100.0,113400.23
buyer_3,Ana,,ES28209566637786783299,TRX_N-00899-20565267,2024-04-01T15:16:57,Amurrio,incomes,salary,3794.42,117194.65
buyer_3,Ana,,ES28209566637786783299,TRX_N-00900-02911757,2024-04-01T15:16:57,Amurrio,incomes,salary_partner,3989.8,121184.45
buyer_3,Ana,,ES28209566637786783299,TRX_N-00901-07877393,2024-04-04T08:35:47,Amurrio,expenses,mortgage,-853.26,120331.19
buyer_3,Ana,,ES28209566637786783299,TRX_N-00902-41122536,2024-04-04T15:02:27,Amurrio,expenses,repairs,-151.92,120179.27
buyer_3,Ana,,ES28209566637786783299,TRX_N-00903-16543413,2024-04-05T13:20:34,Amurrio,expenses,electricity,-32.27,120147.0
buyer_3,Ana,,ES28209566637786783299,TRX_N-00904-36504809,2024-04-05T17:58:58,Amurrio,expenses,leisure,-34.49,120112.51
buyer_3,Ana,,ES28209566637786783299,TRX_N-00905-72672125,2024-04-05T16:34:47,Amurrio,expenses,education,-53.47,120059.04
buyer_3,Ana,,ES28209566637786783299,TRX_N-00906-49244888,2024-04-07T07:17:44,Amurrio,expenses,gas,-92.26,119966.78
buyer_3,Ana,,ES28209566637786783299,TRX_N-00907-61804907,2024-04-08T17:45:40,Amurrio,expenses,phone,-38.49,119928.29
buyer_3,Ana,,ES28209566637786783299,TRX_N-00908-45026549,2024-04-08T18:16:53,Amurrio,expenses,water,-25.74,119902.55
buyer_3,Ana,,ES28209566637786783299,TRX_N-00909-60676635,2024-04-08T17:01:39,Amurrio,expenses,internet,-42.0,119860.55
buyer_3,Ana,,ES28209566637786783299,TRX_N-00910-00787369,2024-04-09T13:20:10,Amurrio,expenses,leisure,-59.56,119800.99
buyer_3,Ana,,ES28209566637786783299,TRX_N-00911-46816948,2024-04-10T15:21:00,Amurrio,expenses,transport,-70.55,119730.44
buyer_3,Ana,,ES28209566637786783299,TRX_N-00912-11514164,2024-04-10T09:52:15,Llodio,expenses,leisure,-50.6,119679.84
buyer_3,Ana,,ES28209566637786783299,TRX_N-00913-40784804,2024-04-10T09:55:14,Amurrio,expenses,clothing,-74.68,119605.16
buyer_3,Ana,,ES28209566637786783299,TRX_N-00914-19983607,2024-04-11T18:24:29,Berango,expenses,cash,-100.0,119505.16
buyer_3,Ana,,ES28209566637786783299,TRX_N-00915-89070015,2024-04-14T08:15:42,Amurrio,expenses,leisure,-66.44,119438.72
buyer_3,Ana,,ES28209566637786783299,TRX_N-00916-52229885,2024-04-16T11:27:00,Amurrio,expenses,clothing,-72.61,119366.11
buyer_3,Ana,,ES28209566637786783299,TRX_N-00917-47876154,2024-04-17T10:57:08,Amurrio,expenses,food,-84.87,119281.24
buyer_3,Ana,,ES28209566637786783299,TRX_N-00918-00031393,2024-04-19T14:39:46,Amurrio,expenses,food,-67.3,119213.94
buyer_3,Ana,,ES28209566637786783299,TRX_N-00919-20620171,2024-04-23T09:01:28,Amurrio,expenses,cash,-100.0,119113.94
buyer_3,Ana,,ES28209566637786783299,TRX_N-00920-27495160,2024-04-23T18:58:59,Amurrio,expenses,travel,-603.79,118510.15
buyer_3,Ana,,ES28209566637786783299,TRX_N-00921-33569161,2024-04-24T08:01:54,Amurrio,expenses,repairs,-176.03,118334.12
buyer_3,Ana,,ES28209566637786783299,TRX_N-00922-80973442,2024-04-26T09:15:33,Galdakao,expenses,food,-122.1,118212.02
buyer_3,Ana,,ES28209566637786783299,TRX_N-00923-73629646,2024-04-26T14:06:44,Alegría-Dulantzi,expenses,repairs,-314.26,117897.76
buyer_3,Ana,,ES28209566637786783299,TRX_N-00924-56223218,2024-04-28T08:12:41,Amurrio,expenses,cash,-100.0,117797.76
buyer_3,Ana,,ES28209566637786783299,TRX_N-00925-48319424,2024-04-29T15:59:41,Amurrio,expenses,leisure,-45.74,117752.02
buyer_3,Ana,,ES28209566637786783299,TRX_N-00926-28443182,2024-04-30T08:07:18,Amurrio,expenses,food,-87.97,117664.05
buyer_3,Ana,,ES28209566637786783299,TRX_N-00927-08471336,2024-04-30T19:05:24,Amurrio,expenses,cash,-100.0,117564.05
buyer_3,Ana,,ES28209566637786783299,TRX_N-00928-79572073,2024-05-01T12:03:48,Amurrio,incomes,salary,3794.42,121358.47
buyer_3,Ana,,ES28209566637786783299,TRX_N-00929-06814417,2024-05-01T12:03:48,Amurrio,incomes,salary_partner,3989.8,125348.27
buyer_3,Ana,,ES28209566637786783299,TRX_N-00930-02296622,2024-05-01T12:03:48,Amurrio,incomes,extra_income,361.07,125709.34
buyer_3,Ana,,ES28209566637786783299,TRX_N-00931-26199987,2024-05-01T13:51:57,Zarautz,expenses,cash,-100.0,125609.34
buyer_3,Ana,,ES28209566637786783299,TRX_N-00932-16567482,2024-05-04T16:46:30,Amurrio,expenses,mortgage,-853.26,124756.08
buyer_3,Ana,,ES28209566637786783299,TRX_N-00933-91467549,2024-05-05T11:46:10,Amurrio,expenses,water,-39.44,124716.64
buyer_3,Ana,,ES28209566637786783299,TRX_N-00934-85008488,2024-05-05T13:42:23,Amurrio,expenses,gas,-52.55,124664.09
buyer_3,Ana,,ES28209566637786783299,TRX_N-00935-63799106,2024-05-05T19:07:16,Oyón-Oion,expenses,cash,-100.0,124564.09
buyer_3,Ana,,ES28209566637786783299,TRX_N-00936-67184148,2024-05-08T12:14:06,Amurrio,expenses,internet,-42.0,124522.09
buyer_3,Ana,,ES28209566637786783299,TRX_N-00937-08199947,2024-05-08T08:14:27,Amurrio,expenses,phone,-44.98,124477.11
buyer_3,Ana,,ES28209566637786783299,TRX_N-00938-41194325,2024-05-08T13:11:34,Amurrio,expenses,electricity,-22.78,124454.33
buyer_3,Ana,,ES28209566637786783299,TRX_N-00939-79488027,2024-05-08T16:46:38,Amurrio,expenses,cash,-100.0,124354.33
buyer_3,Ana,,ES28209566637786783299,TRX_N-00940-27740675,2024-05-11T12:00:06,Amurrio,expenses,leisure,-71.03,124283.3
buyer_3,Ana,,ES28209566637786783299,TRX_N-00941-57448031,2024-05-13T01:22:08,Amurrio,expenses,food,-124.0,124159.3
buyer_3,Ana,,ES28209566637786783299,TRX_N-00942-18975126,2024-05-13T19:33:59,Amurrio,expenses,leisure,-53.98,124105.32
buyer_3,Ana,,ES28209566637786783299,TRX_N-00943-30018593,2024-05-14T11:52:19,Amurrio,expenses,clothing,-126.8,123978.52
buyer_3,Ana,,ES28209566637786783299,TRX_N-00944-90327818,2024-05-15T20:33:54,Amurrio,expenses,food,-85.12,123893.4
buyer_3,Ana,,ES28209566637786783299,TRX_N-00945-66674330,2024-05-18T17:40:52,Amurrio,expenses,healthcare,-126.61,123766.79
buyer_3,Ana,,ES28209566637786783299,TRX_N-00946-36884264,2024-05-20T09:56:02,Amurrio,expenses,clothing,-83.82,123682.97
buyer_3,Ana,,ES28209566637786783299,TRX_N-00947-12016992,2024-05-20T14:45:42,Santurtzi,expenses,appliances,-386.64,123296.33
buyer_3,Ana,,ES28209566637786783299,TRX_N-00948-05213986,2024-05-22T12:10:45,Amurrio,expenses,healthcare,-179.66,123116.67
buyer_3,Ana,,ES28209566637786783299,TRX_N-00949-06734569,2024-05-22T08:39:06,Amurrio,expenses,cash,-100.0,123016.67
buyer_3,Ana,,ES28209566637786783299,TRX_N-00950-49245673,2024-05-24T14:04:53,Amurrio,expenses,cash,-100.0,122916.67
buyer_3,Ana,,ES28209566637786783299,TRX_N-00951-83874994,2024-05-25T04:14:59,Amurrio,expenses,healthcare,-146.11,122770.56
buyer_3,Ana,,ES28209566637786783299,TRX_N-00952-51501508,2024-05-26T19:10:51,Santurtzi,expenses,gifts,-550.76,122219.8
buyer_3,Ana,,ES28209566637786783299,TRX_N-00953-81258804,2024-05-28T06:46:48,Amurrio,expenses,clothing,-83.21,122136.59
buyer_3,Ana,,ES28209566637786783299,TRX_N-00954-64894020,2024-05-28T13:26:40,Amurrio,expenses,cash,-100.0,122036.59
buyer_3,Ana,,ES28209566637786783299,TRX_N-00955-70558968,2024-05-28T13:07:20,Amurrio,expenses,repairs,-332.05,121704.54
buyer_3,Ana,,ES28209566637786783299,TRX_N-00956-68543390,2024-05-29T11:50:42,Amurrio,expenses,transport,-52.58,121651.96
buyer_3,Ana,,ES28209566637786783299,TRX_N-00957-43225492,2024-05-30T12:27:35,Amurrio,expenses,cash,-100.0,121551.96
buyer_3,Ana,,ES28209566637786783299,TRX_N-00958-64229502,2024-05-31T09:07:59,Amurrio,expenses,food,-113.3,121438.66
buyer_3,Ana,,ES28209566637786783299,TRX_N-00959-26688202,2024-06-01T08:38:00,Amurrio,incomes,salary,3794.42,125233.08
buyer_3,Ana,,ES28209566637786783299,TRX_N-00960-16117872,2024-06-01T08:38:00,Amurrio,incomes,salary_partner,3989.8,129222.88
buyer_3,Ana,,ES28209566637786783299,TRX_N-00961-23950862,2024-06-01T08:38:00,Amurrio,incomes,salary_bonus,2682.11,131904.99
buyer_3,Ana,,ES28209566637786783299,TRX_N-00962-71934262,2024-06-01T08:38:00,Amurrio,incomes,salary_partner_bonus,2944.14,134849.13
buyer_3,Ana,,ES28209566637786783299,TRX_N-00963-01029663,2024-06-01T09:43:41,Amurrio,expenses,repairs,-121.39,134727.74
buyer_3,Ana,,ES28209566637786783299,TRX_N-00964-33321896,2024-06-04T10:55:21,Amurrio,expenses,mortgage,-853.26,133874.48
buyer_3,Ana,,ES28209566637786783299,TRX_N-00965-07290669,2024-06-05T01:30:40,Amurrio,expenses,gas,-54.35,133820.13
buyer_3,Ana,,ES28209566637786783299,TRX_N-00966-04825372,2024-06-05T09:47:41,Amurrio,expenses,repairs,-156.49,133663.64
buyer_3,Ana,,ES28209566637786783299,TRX_N-00967-06297264,2024-06-05T09:11:41,Donostia,expenses,gifts,-106.94,133556.7
buyer_3,Ana,,ES28209566637786783299,TRX_N-00968-32357876,2024-06-06T17:32:01,Amurrio,expenses,electricity,-80.63,133476.07
buyer_3,Ana,,ES28209566637786783299,TRX_N-00969-81198567,2024-06-06T09:29:14,Amurrio,expenses,food,-99.86,133376.21
buyer_3,Ana,,ES28209566637786783299,TRX_N-00970-88071995,2024-06-06T16:05:15,Amurrio,expenses,clothing,-75.71,133300.5
buyer_3,Ana,,ES28209566637786783299,TRX_N-00971-05466626,2024-06-06T20:43:58,Amurrio,expenses,cash,-100.0,133200.5
buyer_3,Ana,,ES28209566637786783299,TRX_N-00972-31044083,2024-06-06T19:31:31,Amurrio,expenses,appliances,-412.21,132788.29
buyer_3,Ana,,ES28209566637786783299,TRX_N-00973-29427340,2024-06-06T16:35:19,Santurtzi,expenses,gifts,-393.59,132394.7
buyer_3,Ana,,ES28209566637786783299,TRX_N-00974-24607436,2024-06-07T07:24:42,Zuia,expenses,cash,-100.0,132294.7
buyer_3,Ana,,ES28209566637786783299,TRX_N-00975-10559847,2024-06-08T08:02:56,Amurrio,expenses,water,-31.3,132263.4
buyer_3,Ana,,ES28209566637786783299,TRX_N-00976-72051769,2024-06-08T00:48:51,Amurrio,expenses,internet,-42.0,132221.4
buyer_3,Ana,,ES28209566637786783299,TRX_N-00977-80948735,2024-06-08T14:11:18,Amurrio,expenses,phone,-36.15,132185.25
buyer_3,Ana,,ES28209566637786783299,TRX_N-00978-10882506,2024-06-08T20:34:19,Amurrio,expenses,transport,-61.96,132123.29
buyer_3,Ana,,ES28209566637786783299,TRX_N-00979-45204566,2024-06-11T11:30:33,Donostia,expenses,cash,-100.0,132023.29
buyer_3,Ana,,ES28209566637786783299,TRX_N-00980-03416847,2024-06-13T18:26:13,Amurrio,expenses,cash,-100.0,131923.29
buyer_3,Ana,,ES28209566637786783299,TRX_N-00981-79185006,2024-06-14T13:20:37,Amurrio,expenses,healthcare,-55.39,131867.9
buyer_3,Ana,,ES28209566637786783299,TRX_N-00982-12816636,2024-06-14T12:39:12,Amurrio,expenses,cash,-100.0,131767.9
buyer_3,Ana,,ES28209566637786783299,TRX_N-00983-38111787,2024-06-16T11:48:43,Lasarte-Oria,expenses,gifts,-553.54,131214.36
buyer_3,Ana,,ES28209566637786783299,TRX_N-00984-36073407,2024-06-18T14:27:38,Portugalete,expenses,leisure,-58.31,131156.05
buyer_3,Ana,,ES28209566637786783299,TRX_N-00985-02645020,2024-06-20T20:27:02,Amurrio,expenses,transport,-86.33,131069.72
buyer_3,Ana,,ES28209566637786783299,TRX_N-00986-63536885,2024-06-20T15:56:40,Amurrio,expenses,cash,-100.0,130969.72
buyer_3,Ana,,ES28209566637786783299,TRX_N-00987-56950652,2024-06-22T06:52:03,Amurrio,expenses,leisure,-23.7,130946.02
buyer_3,Ana,,ES28209566637786783299,TRX_N-00988-93262138,2024-06-22T14:11:57,Llodio,expenses,cash,-100.0,130846.02
buyer_3,Ana,,ES28209566637786783299,TRX_N-00989-07450086,2024-06-23T09:53:46,Amurrio,expenses,food,-102.49,130743.53
buyer_3,Ana,,ES28209566637786783299,TRX_N-00990-85056715,2024-06-26T08:38:19,Amurrio,expenses,appliances,-81.41,130662.12
buyer_3,Ana,,ES28209566637786783299,TRX_N-00991-01362204,2024-06-29T21:04:50,Amurrio,expenses,cash,-100.0,130562.12
buyer_3,Ana,,ES28209566637786783299,TRX_N-00992-37054176,2024-06-30T16:48:00,Amurrio,expenses,leisure,-64.77,130497.35
buyer_3,Ana,,ES28209566637786783299,TRX_N-00993-70974966,2024-07-01T22:30:59,Amurrio,incomes,salary,3794.42,134291.77
buyer_3,Ana,,ES28209566637786783299,TRX_N-00994-91122321,2024-07-01T22:30:59,Amurrio,incomes,salary_partner,3989.8,138281.57
buyer_3,Ana,,ES28209566637786783299,TRX_N-00995-04332519,2024-07-01T22:00:39,Amurrio,expenses,transport,-84.77,138196.8
buyer_3,Ana,,ES28209566637786783299,TRX_N-00996-43750716,2024-07-01T11:18:11,Errenteria,expenses,leisure,-70.95,138125.85
buyer_3,Ana,,ES28209566637786783299,TRX_N-00997-88984830,2024-07-02T17:14:51,Sestao,expenses,transport,-79.26,138046.59
buyer_3,Ana,,ES28209566637786783299,TRX_N-00998-82608500,2024-07-03T15:54:04,Salvatierra/Agurain,expenses,leisure,-46.0,138000.59
buyer_3,Ana,,ES28209566637786783299,TRX_N-00999-16526558,2024-07-03T08:24:56,Amurrio,expenses,education,-51.28,137949.31
buyer_3,Ana,,ES28209566637786783299,TRX_N-01000-41741807,2024-07-04T11:57:09,Amurrio,expenses,mortgage,-853.26,137096.05
buyer_3,Ana,,ES28209566637786783299,TRX_N-01001-90072890,2024-07-04T19:44:03,Amurrio,expenses,leisure,-36.11,137059.94
buyer_3,Ana,,ES28209566637786783299,TRX_N-01002-81902026,2024-07-04T13:16:03,Amurrio,expenses,repairs,-145.24,136914.7
buyer_3,Ana,,ES28209566637786783299,TRX_N-01003-87325193,2024-07-05T08:05:38,Amurrio,expenses,gas,-99.35,136815.35
buyer_3,Ana,,ES28209566637786783299,TRX_N-01004-93847385,2024-07-06T12:58:53,Amurrio,expenses,leisure,-65.82,136749.53
buyer_3,Ana,,ES28209566637786783299,TRX_N-01005-76740173,2024-07-07T15:48:18,Amurrio,expenses,phone,-36.64,136712.89
buyer_3,Ana,,ES28209566637786783299,TRX_N-01006-02535239,2024-07-08T14:39:01,Amurrio,expenses,electricity,-63.42,136649.47
buyer_3,Ana,,ES28209566637786783299,TRX_N-01007-25777139,2024-07-08T09:40:37,Amurrio,expenses,water,-20.58,136628.89
buyer_3,Ana,,ES28209566637786783299,TRX_N-01008-15221220,2024-07-08T18:26:50,Amurrio,expenses,internet,-42.0,136586.89
buyer_3,Ana,,ES28209566637786783299,TRX_N-01009-12656919,2024-07-08T13:20:08,Amurrio,expenses,leisure,-76.92,136509.97
buyer_3,Ana,,ES28209566637786783299,TRX_N-01010-21359371,2024-07-08T04:10:56,Amurrio,expenses,cash,-100.0,136409.97
buyer_3,Ana,,ES28209566637786783299,TRX_N-01011-83085490,2024-07-10T11:23:06,Amurrio,expenses,education,-67.24,136342.73
buyer_3,Ana,,ES28209566637786783299,TRX_N-01012-76407938,2024-07-11T10:14:54,Amurrio,expenses,repairs,-219.45,136123.28
buyer_3,Ana,,ES28209566637786783299,TRX_N-01013-19834908,2024-07-12T11:44:13,Amurrio,expenses,food,-85.54,136037.74
buyer_3,Ana,,ES28209566637786783299,TRX_N-01014-08293641,2024-07-12T14:16:17,Amurrio,expenses,clothing,-154.77,135882.97
buyer_3,Ana,,ES28209566637786783299,TRX_N-01015-11711560,2024-07-15T08:31:19,Llodio,expenses,cash,-100.0,135782.97
buyer_3,Ana,,ES28209566637786783299,TRX_N-01016-98072254,2024-07-16T19:20:51,Vitoria-Gasteiz,expenses,repairs,-304.91,135478.06
buyer_3,Ana,,ES28209566637786783299,TRX_N-01017-40572619,2024-07-18T16:39:28,Amurrio,expenses,cash,-100.0,135378.06
buyer_3,Ana,,ES28209566637786783299,TRX_N-01018-90145312,2024-07-20T06:45:28,Amurrio,expenses,food,-107.28,135270.78
buyer_3,Ana,,ES28209566637786783299,TRX_N-01019-20860257,2024-07-21T19:40:34,Amurrio,expenses,gifts,-89.54,135181.24
buyer_3,Ana,,ES28209566637786783299,TRX_N-01020-70132529,2024-07-27T06:43:07,Amurrio,expenses,food,-95.3,135085.94
buyer_3,Ana,,ES28209566637786783299,TRX_N-01021-22744766,2024-07-28T20:53:39,Amurrio,expenses,transport,-62.15,135023.79
buyer_3,Ana,,ES28209566637786783299,TRX_N-01022-46985953,2024-07-28T04:19:56,Santurtzi,expenses,clothing,-136.73,134887.06
buyer_3,Ana,,ES28209566637786783299,TRX_N-01023-94144994,2024-07-29T11:47:16,Amurrio,expenses,clothing,-110.69,134776.37
buyer_3,Ana,,ES28209566637786783299,TRX_N-01024-06718461,2024-07-30T22:53:51,Amurrio,expenses,leisure,-58.3,134718.07
buyer_3,Ana,,ES28209566637786783299,TRX_N-01025-31378701,2024-07-31T16:44:23,Santurtzi,expenses,cash,-100.0,134618.07
buyer_3,Ana,,ES28209566637786783299,TRX_N-01026-00680798,2024-08-01T17:43:13,Amurrio,incomes,salary,3794.42,138412.49
buyer_3,Ana,,ES28209566637786783299,TRX_N-01027-31503989,2024-08-01T17:43:13,Amurrio,incomes,salary_partner,3989.8,142402.29
buyer_3,Ana,,ES28209566637786783299,TRX_N-01028-02292181,2024-08-01T10:24:20,Amurrio,expenses,repairs,-331.71,142070.58
buyer_3,Ana,,ES28209566637786783299,TRX_N-01029-35864850,2024-08-02T10:15:12,Amurrio,expenses,cash,-100.0,141970.58
buyer_3,Ana,,ES28209566637786783299,TRX_N-01030-94762986,2024-08-04T10:14:49,Amurrio,expenses,mortgage,-853.26,141117.32
buyer_3,Ana,,ES28209566637786783299,TRX_N-01031-02307656,2024-08-06T17:18:10,Amurrio,expenses,gas,-100.67,141016.65
buyer_3,Ana,,ES28209566637786783299,TRX_N-01032-03840588,2024-08-06T16:44:00,Amurrio,expenses,internet,-42.0,140974.65
buyer_3,Ana,,ES28209566637786783299,TRX_N-01033-55823857,2024-08-07T14:06:30,Amurrio,expenses,electricity,-84.26,140890.39
buyer_3,Ana,,ES28209566637786783299,TRX_N-01034-17658380,2024-08-08T19:55:13,Amurrio,expenses,water,-25.79,140864.6
buyer_3,Ana,,ES28209566637786783299,TRX_N-01035-28581028,2024-08-08T22:41:47,Amurrio,expenses,phone,-33.38,140831.22
buyer_3,Ana,,ES28209566637786783299,TRX_N-01036-63067901,2024-08-08T11:22:21,Amurrio,expenses,cash,-100.0,140731.22
buyer_3,Ana,,ES28209566637786783299,TRX_N-01037-25139884,2024-08-10T20:39:50,Zuia,expenses,leisure,-19.52,140711.7
buyer_3,Ana,,ES28209566637786783299,TRX_N-01038-96847130,2024-08-15T12:17:32,Amurrio,expenses,transport,-40.56,140671.14
buyer_3,Ana,,ES28209566637786783299,TRX_N-01039-16409751,2024-08-17T11:43:00,Amurrio,expenses,cash,-100.0,140571.14
buyer_3,Ana,,ES28209566637786783299,TRX_N-01040-07188596,2024-08-20T20:52:17,Amurrio,expenses,cash,-100.0,140471.14
buyer_3,Ana,,ES28209566637786783299,TRX_N-01041-49052894,2024-08-22T09:58:55,Amurrio,expenses,food,-84.95,140386.19
buyer_3,Ana,,ES28209566637786783299,TRX_N-01042-76293646,2024-08-22T11:40:43,Amurrio,expenses,cash,-100.0,140286.19
buyer_3,Ana,,ES28209566637786783299,TRX_N-01043-09847050,2024-08-24T16:09:17,Vitoria-Gasteiz,expenses,leisure,-43.07,140243.12
buyer_3,Ana,,ES28209566637786783299,TRX_N-01044-47366667,2024-08-24T10:50:18,Amurrio,expenses,cash,-100.0,140143.12
buyer_3,Ana,,ES28209566637786783299,TRX_N-01045-05101789,2024-08-26T13:00:23,Amurrio,expenses,food,-88.58,140054.54
buyer_3,Ana,,ES28209566637786783299,TRX_N-01046-42893611,2024-08-26T13:35:59,Amurrio,expenses,repairs,-191.12,139863.42
buyer_3,Ana,,ES28209566637786783299,TRX_N-01047-68211548,2024-08-31T20:55:04,Zuia,expenses,transport,-81.62,139781.8
buyer_3,Ana,,ES28209566637786783299,TRX_N-01048-34777177,2024-09-01T10:25:45,Amurrio,incomes,salary,3794.42,143576.22
buyer_3,Ana,,ES28209566637786783299,TRX_N-01049-35237972,2024-09-01T10:25:45,Amurrio,incomes,salary_partner,3989.8,147566.02
buyer_3,Ana,,ES28209566637786783299,TRX_N-01050-38830636,2024-09-01T10:25:45,Amurrio,incomes,extra_income,361.07,147927.09
buyer_3,Ana,,ES28209566637786783299,TRX_N-01051-92362599,2024-09-02T11:40:24,Irun,expenses,food,-75.44,147851.65
buyer_3,Ana,,ES28209566637786783299,TRX_N-01052-56579003,2024-09-02T18:59:56,Sestao,expenses,transport,-82.84,147768.81
buyer_3,Ana,,ES28209566637786783299,TRX_N-01053-71901758,2024-09-02T18:59:27,Salvatierra/Agurain,expenses,leisure,-51.5,147717.31
buyer_3,Ana,,ES28209566637786783299,TRX_N-01054-54770429,2024-09-03T16:24:59,Amurrio,expenses,cash,-100.0,147617.31
buyer_3,Ana,,ES28209566637786783299,TRX_N-01055-45089341,2024-09-03T17:48:47,Elciego,expenses,travel,-1042.1,146575.21
buyer_3,Ana,,ES28209566637786783299,TRX_N-01056-05386371,2024-09-04T20:17:19,Amurrio,expenses,mortgage,-853.26,145721.95
buyer_3,Ana,,ES28209566637786783299,TRX_N-01057-35715953,2024-09-04T16:27:57,Amurrio,expenses,appliances,-263.42,145458.53
buyer_3,Ana,,ES28209566637786783299,TRX_N-01058-88465681,2024-09-04T13:51:51,Amurrio,expenses,repairs,-246.28,145212.25
buyer_3,Ana,,ES28209566637786783299,TRX_N-01059-03245971,2024-09-05T20:01:15,Amurrio,expenses,gas,-30.72,145181.53
buyer_3,Ana,,ES28209566637786783299,TRX_N-01060-32502151,2024-09-06T13:45:41,Amurrio,expenses,gifts,-154.59,145026.94
buyer_3,Ana,,ES28209566637786783299,TRX_N-01061-24988525,2024-09-07T16:53:31,Amurrio,expenses,electricity,-84.12,144942.82
buyer_3,Ana,,ES28209566637786783299,TRX_N-01062-18848897,2024-09-07T09:18:12,Amurrio,expenses,transport,-69.73,144873.09
buyer_3,Ana,,ES28209566637786783299,TRX_N-01063-08376342,2024-09-07T18:48:06,Amurrio,expenses,cash,-100.0,144773.09
buyer_3,Ana,,ES28209566637786783299,TRX_N-01064-37053414,2024-09-08T14:40:00,Amurrio,expenses,water,-24.45,144748.64
buyer_3,Ana,,ES28209566637786783299,TRX_N-01065-68795685,2024-09-08T18:55:10,Amurrio,expenses,internet,-42.0,144706.64
buyer_3,Ana,,ES28209566637786783299,TRX_N-01066-05326501,2024-09-08T15:46:00,Amurrio,expenses,phone,-32.81,144673.83
buyer_3,Ana,,ES28209566637786783299,TRX_N-01067-48403102,2024-09-08T17:02:27,Amurrio,expenses,cash,-100.0,144573.83
buyer_3,Ana,,ES28209566637786783299,TRX_N-01068-14779568,2024-09-09T15:00:42,Amurrio,expenses,leisure,-81.89,144491.94
buyer_3,Ana,,ES28209566637786783299,TRX_N-01069-94111301,2024-09-10T10:59:24,Amurrio,expenses,food,-62.73,144429.21
buyer_3,Ana,,ES28209566637786783299,TRX_N-01070-30734194,2024-09-10T10:58:16,Andoain,expenses,clothing,-140.96,144288.25
buyer_3,Ana,,ES28209566637786783299,TRX_N-01071-35640119,2024-09-11T15:38:04,Amurrio,expenses,transport,-45.91,144242.34
buyer_3,Ana,,ES28209566637786783299,TRX_N-01072-05764121,2024-09-11T22:52:55,Amurrio,expenses,cash,-100.0,144142.34
buyer_3,Ana,,ES28209566637786783299,TRX_N-01073-14501257,2024-09-12T09:09:28,Amurrio,expenses,transport,-40.87,144101.47
buyer_3,Ana,,ES28209566637786783299,TRX_N-01074-87288570,2024-09-16T15:27:00,Amurrio,expenses,cash,-100.0,144001.47
buyer_3,Ana,,ES28209566637786783299,TRX_N-01075-83423996,2024-09-16T19:13:12,Amurrio,expenses,appliances,-252.84,143748.63
buyer_3,Ana,,ES28209566637786783299,TRX_N-01076-37312928,2024-09-17T18:57:02,Amurrio,expenses,leisure,-67.94,143680.69
buyer_3,Ana,,ES28209566637786783299,TRX_N-01077-62555797,2024-09-20T08:32:11,Amurrio,expenses,cash,-100.0,143580.69
buyer_3,Ana,,ES28209566637786783299,TRX_N-01078-89905500,2024-09-21T04:54:36,Amurrio,expenses,cash,-100.0,143480.69
buyer_3,Ana,,ES28209566637786783299,TRX_N-01079-68089879,2024-09-25T16:38:11,Salvatierra/Agurain,expenses,cash,-100.0,143380.69
buyer_3,Ana,,ES28209566637786783299,TRX_N-01080-99326587,2024-09-26T23:41:37,Labastida,expenses,food,-82.57,143298.12
buyer_3,Ana,,ES28209566637786783299,TRX_N-01081-77156824,2024-09-26T19:16:53,Amurrio,expenses,education,-68.48,143229.64
buyer_3,Ana,,ES28209566637786783299,TRX_N-01082-27099502,2024-09-27T12:33:27,Amurrio,expenses,food,-64.78,143164.86
buyer_3,Ana,,ES28209566637786783299,TRX_N-01083-41885690,2024-09-27T10:34:05,Amurrio,expenses,repairs,-85.22,143079.64
buyer_3,Ana,,ES28209566637786783299,TRX_N-01084-53583917,2024-09-28T10:29:17,Amurrio,expenses,transport,-61.06,143018.58
buyer_3,Ana,,ES28209566637786783299,TRX_N-01085-75412232,2024-10-01T06:34:50,Amurrio,incomes,salary,3794.42,146813.0
buyer_3,Ana,,ES28209566637786783299,TRX_N-01086-12420110,2024-10-01T06:34:50,Amurrio,incomes,salary_partner,3989.8,150802.8
buyer_3,Ana,,ES28209566637786783299,TRX_N-01087-75291001,2024-10-02T18:03:51,Amurrio,expenses,transport,-64.68,150738.12
buyer_3,Ana,,ES28209566637786783299,TRX_N-01088-60613188,2024-10-04T06:59:10,Amurrio,expenses,mortgage,-853.26,149884.86
buyer_3,Ana,,ES28209566637786783299,TRX_N-01089-22671336,2024-10-04T12:12:17,Oyón-Oion,expenses,food,-115.68,149769.18
buyer_3,Ana,,ES28209566637786783299,TRX_N-01090-39867121,2024-10-05T16:05:10,Amurrio,expenses,water,-43.05,149726.13
buyer_3,Ana,,ES28209566637786783299,TRX_N-01091-26403257,2024-10-05T20:55:31,Amurrio,expenses,electricity,-45.19,149680.94
buyer_3,Ana,,ES28209566637786783299,TRX_N-01092-02802484,2024-10-05T12:02:31,Amurrio,expenses,phone,-33.25,149647.69
buyer_3,Ana,,ES28209566637786783299,TRX_N-01093-40142537,2024-10-06T19:13:04,Amurrio,expenses,gas,-84.55,149563.14
buyer_3,Ana,,ES28209566637786783299,TRX_N-01094-29661129,2024-10-06T10:45:54,Amurrio,expenses,internet,-42.0,149521.14
buyer_3,Ana,,ES28209566637786783299,TRX_N-01095-57895049,2024-10-06T20:04:40,Amurrio,expenses,repairs,-52.73,149468.41
buyer_3,Ana,,ES28209566637786783299,TRX_N-01096-94091567,2024-10-08T11:22:59,Lasarte-Oria,expenses,leisure,-73.4,149395.01
buyer_3,Ana,,ES28209566637786783299,TRX_N-01097-40368040,2024-10-08T13:54:28,Amurrio,expenses,education,-53.49,149341.52
buyer_4,Jorge,,ES96209506732557392462,TRX_N-00001-93346031,2022-01-01T14:24:24,Galdakao,incomes,salary,2219.21,7325.47
buyer_4,Jorge,,ES96209506732557392462,TRX_N-00002-30297284,2022-01-01T19:54:18,Galdakao,expenses,transport,-71.67,7253.8
buyer_4,Jorge,,ES96209506732557392462,TRX_N-00003-19551937,2022-01-02T08:45:02,Galdakao,expenses,leisure,-39.65,7214.15
buyer_4,Jorge,,ES96209506732557392462,TRX_N-00004-93473348,2022-01-02T08:09:35,Galdakao,expenses,repairs,-319.38,6894.77
buyer_4,Jorge,,ES96209506732557392462,TRX_N-00005-90491601,2022-01-04T08:23:28,Galdakao,expenses,mortgage,-706.56,6188.21
buyer_4,Jorge,,ES96209506732557392462,TRX_N-00006-89634799,2022-01-04T05:56:49,Galdakao,expenses,appliances,-147.48,6040.73
buyer_4,Jorge,,ES96209506732557392462,TRX_N-00007-28833935,2022-01-05T20:04:54,Galdakao,expenses,water,-31.37,6009.36
buyer_4,Jorge,,ES96209506732557392462,TRX_N-00008-79031058,2022-01-05T14:47:08,Galdakao,expenses,cash,-100.0,5909.36
buyer_4,Jorge,,ES96209506732557392462,TRX_N-00009-08582219,2022-01-05T08:42:35,Galdakao,expenses,repairs,-296.84,5612.52
buyer_4,Jorge,,ES96209506732557392462,TRX_N-00010-06065480,2022-01-05T10:39:48,Errenteria,expenses,gifts,-732.79,4879.73
buyer_4,Jorge,,ES96209506732557392462,TRX_N-00011-91730851,2022-01-06T14:50:12,Galdakao,expenses,transport,-67.87,4811.86
buyer_4,Jorge,,ES96209506732557392462,TRX_N-00012-83608465,2022-01-07T20:35:28,Galdakao,expenses,internet,-42.0,4769.86
buyer_4,Jorge,,ES96209506732557392462,TRX_N-00013-10268329,2022-01-07T20:39:16,Galdakao,expenses,transport,-62.0,4707.86
buyer_4,Jorge,,ES96209506732557392462,TRX_N-00014-36427522,2022-01-08T23:38:18,Galdakao,expenses,electricity,-86.95,4620.91
buyer_4,Jorge,,ES96209506732557392462,TRX_N-00015-43777332,2022-01-08T09:03:27,Galdakao,expenses,gas,-31.35,4589.56
buyer_4,Jorge,,ES96209506732557392462,TRX_N-00016-19526643,2022-01-08T17:21:41,Galdakao,expenses,phone,-30.67,4558.89
buyer_4,Jorge,,ES96209506732557392462,TRX_N-00017-55448114,2022-01-09T12:07:05,Galdakao,expenses,cash,-100.0,4458.89
buyer_4,Jorge,,ES96209506732557392462,TRX_N-00018-99265150,2022-01-11T19:22:17,Galdakao,expenses,clothing,-137.92,4320.97
buyer_4,Jorge,,ES96209506732557392462,TRX_N-00019-23216965,2022-01-12T23:17:23,Galdakao,expenses,gifts,-311.93,4009.04
buyer_4,Jorge,,ES96209506732557392462,TRX_N-00020-76853869,2022-01-14T10:23:07,Galdakao,expenses,cash,-100.0,3909.04
buyer_4,Jorge,,ES96209506732557392462,TRX_N-00021-82105695,2022-01-14T04:49:25,Galdakao,expenses,repairs,-267.55,3641.49
buyer_4,Jorge,,ES96209506732557392462,TRX_N-00022-01038848,2022-01-15T18:12:49,Galdakao,expenses,children,-568.66,3072.83
buyer_4,Jorge,,ES96209506732557392462,TRX_N-00023-23877652,2022-01-16T19:32:41,Galdakao,expenses,leisure,-44.08,3028.75
buyer_4,Jorge,,ES96209506732557392462,TRX_N-00024-95380452,2022-01-18T19:47:40,Galdakao,expenses,transport,-60.82,2967.93
buyer_4,Jorge,,ES96209506732557392462,TRX_N-00025-30686550,2022-01-18T16:04:34,Galdakao,expenses,clothing,-51.68,2916.25
buyer_4,Jorge,,ES96209506732557392462,TRX_N-00026-71317042,2022-01-20T10:04:38,Arrasate,expenses,gifts,-448.05,2468.2
buyer_4,Jorge,,ES96209506732557392462,TRX_N-00027-47488685,2022-01-22T12:27:30,Galdakao,expenses,leisure,-64.58,2403.62
buyer_4,Jorge,,ES96209506732557392462,TRX_N-00028-62079914,2022-01-23T17:53:22,Lasarte-Oria,expenses,healthcare,-138.77,2264.85
buyer_4,Jorge,,ES96209506732557392462,TRX_N-00029-66978775,2022-01-25T08:15:08,Galdakao,expenses,cash,-100.0,2164.85
buyer_4,Jorge,,ES96209506732557392462,TRX_N-00030-64715536,2022-01-25T23:57:13,Andoain,expenses,gifts,-108.27,2056.58
buyer_4,Jorge,,ES96209506732557392462,TRX_N-00031-17643563,2022-01-27T09:30:17,Galdakao,expenses,cash,-100.0,1956.58
buyer_4,Jorge,,ES96209506732557392462,TRX_N-00032-59054062,2022-01-28T23:09:39,Galdakao,expenses,clothing,-115.61,1840.97
buyer_4,Jorge,,ES96209506732557392462,TRX_N-00033-80643506,2022-01-28T17:10:15,Arrasate,expenses,gifts,-402.11,1438.86
buyer_4,Jorge,,ES96209506732557392462,TRX_N-00034-29691584,2022-01-29T09:53:21,Galdakao,expenses,appliances,-322.95,1115.91
buyer_4,Jorge,,ES96209506732557392462,TRX_N-00035-79766047,2022-01-29T06:50:39,Galdakao,expenses,repairs,-247.45,868.46
buyer_4,Jorge,,ES96209506732557392462,TRX_N-00036-21904125,2022-01-29T20:27:53,Galdakao,expenses,children,-1213.44,-344.98
buyer_4,Jorge,,ES96209506732557392462,TRX_N-00037-94502629,2022-02-01T15:09:32,Galdakao,incomes,salary,2219.21,1874.23
buyer_4,Jorge,,ES96209506732557392462,TRX_N-00038-07709871,2022-02-01T13:22:21,Galdakao,expenses,transport,-53.38,1820.85
buyer_4,Jorge,,ES96209506732557392462,TRX_N-00039-24323463,2022-02-02T15:18:17,Galdakao,expenses,cash,-100.0,1720.85
buyer_4,Jorge,,ES96209506732557392462,TRX_N-00040-99140667,2022-02-03T15:19:15,Galdakao,expenses,transport,-89.03,1631.82
buyer_4,Jorge,,ES96209506732557392462,TRX_N-00041-35328619,2022-02-04T17:03:05,Galdakao,expenses,mortgage,-706.56,925.26
buyer_4,Jorge,,ES96209506732557392462,TRX_N-00042-11157161,2022-02-04T22:41:01,Galdakao,expenses,education,-52.38,872.88
buyer_4,Jorge,,ES96209506732557392462,TRX_N-00043-75489402,2022-02-05T10:28:41,Galdakao,expenses,water,-21.71,851.17
buyer_4,Jorge,,ES96209506732557392462,TRX_N-00044-78407906,2022-02-05T18:50:08,Galdakao,expenses,food,-84.18,766.99
buyer_4,Jorge,,ES96209506732557392462,TRX_N-00045-01281996,2022-02-05T15:17:51,Hondarribia,expenses,cash,-100.0,666.99
buyer_4,Jorge,,ES96209506732557392462,TRX_N-00046-30137947,2022-02-06T02:07:00,Galdakao,expenses,internet,-42.0,624.99
buyer_4,Jorge,,ES96209506732557392462,TRX_N-00047-63321061,2022-02-06T13:17:04,Galdakao,expenses,phone,-39.47,585.52
buyer_4,Jorge,,ES96209506732557392462,TRX_N-00048-78130384,2022-02-07T09:29:25,Hernani,expenses,food,-77.04,508.48
buyer_4,Jorge,,ES96209506732557392462,TRX_N-00049-77614190,2022-02-07T08:12:37,Galdakao,expenses,healthcare,-115.81,392.67
buyer_4,Jorge,,ES96209506732557392462,TRX_N-00050-52859113,2022-02-07T13:01:28,Galdakao,expenses,cash,-100.0,292.67
buyer_4,Jorge,,ES96209506732557392462,TRX_N-00051-93030751,2022-02-08T09:33:52,Galdakao,expenses,electricity,-86.35,206.32
buyer_4,Jorge,,ES96209506732557392462,TRX_N-00052-81254666,2022-02-08T13:47:40,Galdakao,expenses,gas,-66.21,140.11
buyer_4,Jorge,,ES96209506732557392462,TRX_N-00053-53218123,2022-02-08T19:13:59,Galdakao,expenses,appliances,-140.4,-0.29
buyer_4,Jorge,,ES96209506732557392462,TRX_N-00054-61970645,2022-02-09T19:12:14,Galdakao,expenses,transport,-51.27,-51.56
buyer_4,Jorge,,ES96209506732557392462,TRX_N-00055-42337002,2022-02-09T10:58:54,Galdakao,expenses,repairs,-100.95,-152.51
buyer_4,Jorge,,ES96209506732557392462,TRX_N-00056-70428895,2022-02-09T12:40:12,Galdakao,expenses,children,-1067.81,-1220.32
buyer_4,Jorge,,ES96209506732557392462,TRX_N-00057-24227792,2022-02-10T20:56:40,Galdakao,expenses,clothing,-127.58,-1347.9
buyer_4,Jorge,,ES96209506732557392462,TRX_N-00058-65363902,2022-02-10T11:47:15,Galdakao,expenses,healthcare,-143.31,-1491.21
buyer_4,Jorge,,ES96209506732557392462,TRX_N-00059-54011556,2022-02-10T14:54:52,Galdakao,expenses,education,-55.26,-1546.47
buyer_4,Jorge,,ES96209506732557392462,TRX_N-00060-42556749,2022-02-10T08:24:23,Galdakao,expenses,children,-597.07,-2143.54
buyer_4,Jorge,,ES96209506732557392462,TRX_N-00061-74539468,2022-02-13T08:56:34,Bilbao,expenses,repairs,-36.71,-2180.25
buyer_4,Jorge,,ES96209506732557392462,TRX_N-00062-33659761,2022-02-15T11:37:25,Galdakao,expenses,repairs,-151.71,-2331.96
buyer_4,Jorge,,ES96209506732557392462,TRX_N-00063-23613358,2022-02-18T12:18:32,Galdakao,expenses,gifts,-370.66,-2702.62
buyer_4,Jorge,,ES96209506732557392462,TRX_N-00064-43771303,2022-02-19T08:02:30,Oyón-Oion,expenses,gifts,-832.11,-3534.73
buyer_4,Jorge,,ES96209506732557392462,TRX_N-00065-78178353,2022-02-21T13:36:41,Portugalete,expenses,education,-73.77,-3608.5
buyer_4,Jorge,,ES96209506732557392462,TRX_N-00066-54967822,2022-02-26T11:37:14,Galdakao,expenses,leisure,-29.59,-3638.09
buyer_4,Jorge,,ES96209506732557392462,TRX_N-00067-28377974,2022-02-28T10:09:34,Galdakao,expenses,food,-102.04,-3740.13
buyer_4,Jorge,,ES96209506732557392462,TRX_N-00068-14183673,2022-03-01T15:26:56,Galdakao,incomes,salary,2219.21,-1520.92
buyer_4,Jorge,,ES96209506732557392462,TRX_N-00069-44168090,2022-03-01T18:21:57,Galdakao,expenses,cash,-100.0,-1620.92
buyer_4,Jorge,,ES96209506732557392462,TRX_N-00070-51142922,2022-03-02T20:23:54,Galdakao,expenses,education,-55.77,-1676.69
buyer_4,Jorge,,ES96209506732557392462,TRX_N-00071-69787996,2022-03-03T16:16:57,Galdakao,expenses,leisure,-62.0,-1738.69
buyer_4,Jorge,,ES96209506732557392462,TRX_N-00072-35136033,2022-03-04T19:03:29,Galdakao,expenses,mortgage,-706.56,-2445.25
buyer_4,Jorge,,ES96209506732557392462,TRX_N-00073-28917844,2022-03-04T11:05:49,Galdakao,expenses,cash,-100.0,-2545.25
buyer_4,Jorge,,ES96209506732557392462,TRX_N-00074-62269674,2022-03-05T10:46:35,Galdakao,expenses,food,-83.82,-2629.07
buyer_4,Jorge,,ES96209506732557392462,TRX_N-00075-34632483,2022-03-06T08:38:38,Galdakao,expenses,electricity,-59.41,-2688.48
buyer_4,Jorge,,ES96209506732557392462,TRX_N-00076-95501372,2022-03-06T08:29:41,Galdakao,expenses,repairs,-143.14,-2831.62
buyer_4,Jorge,,ES96209506732557392462,TRX_N-00077-84828794,2022-03-07T12:03:41,Galdakao,expenses,gas,-39.11,-2870.73
buyer_4,Jorge,,ES96209506732557392462,TRX_N-00078-40878684,2022-03-07T12:47:46,Galdakao,expenses,internet,-42.0,-2912.73
buyer_4,Jorge,,ES96209506732557392462,TRX_N-00079-83671861,2022-03-07T10:01:33,Galdakao,expenses,cash,-100.0,-3012.73
buyer_4,Jorge,,ES96209506732557392462,TRX_N-00080-31082616,2022-03-08T17:34:34,Galdakao,expenses,phone,-41.59,-3054.32
buyer_4,Jorge,,ES96209506732557392462,TRX_N-00081-37588577,2022-03-08T22:11:14,Galdakao,expenses,water,-38.77,-3093.09
buyer_4,Jorge,,ES96209506732557392462,TRX_N-00082-54608186,2022-03-10T23:05:52,Galdakao,expenses,children,-1005.55,-4098.64
buyer_4,Jorge,,ES96209506732557392462,TRX_N-00083-24582259,2022-03-11T15:28:28,Galdakao,expenses,food,-97.09,-4195.73
buyer_4,Jorge,,ES96209506732557392462,TRX_N-00084-44593101,2022-03-12T10:10:50,Llodio,expenses,gifts,-54.08,-4249.81
buyer_4,Jorge,,ES96209506732557392462,TRX_N-00085-52793820,2022-03-13T19:40:35,Galdakao,expenses,food,-101.67,-4351.48
buyer_4,Jorge,,ES96209506732557392462,TRX_N-00086-75116433,2022-03-15T19:15:57,Galdakao,expenses,transport,-51.24,-4402.72
buyer_4,Jorge,,ES96209506732557392462,TRX_N-00087-38365184,2022-03-15T14:42:57,Galdakao,expenses,children,-448.42,-4851.14
buyer_4,Jorge,,ES96209506732557392462,TRX_N-00088-40561243,2022-03-16T21:23:45,Galdakao,expenses,leisure,-37.77,-4888.91
buyer_4,Jorge,,ES96209506732557392462,TRX_N-00089-67388001,2022-03-16T11:20:56,Sestao,expenses,healthcare,-39.79,-4928.7
buyer_4,Jorge,,ES96209506732557392462,TRX_N-00090-95654830,2022-03-16T17:16:06,Leioa,expenses,cash,-100.0,-5028.7
buyer_4,Jorge,,ES96209506732557392462,TRX_N-00091-70118548,2022-03-17T08:18:41,Galdakao,expenses,gifts,-26.81,-5055.51
buyer_4,Jorge,,ES96209506732557392462,TRX_N-00092-47978370,2022-03-19T10:46:17,Galdakao,expenses,food,-122.03,-5177.54
buyer_4,Jorge,,ES96209506732557392462,TRX_N-00093-80393958,2022-03-20T11:13:55,Galdakao,expenses,leisure,-61.92,-5239.46
buyer_4,Jorge,,ES96209506732557392462,TRX_N-00094-28021652,2022-03-21T18:30:13,Galdakao,expenses,food,-107.61,-5347.07
buyer_4,Jorge,,ES96209506732557392462,TRX_N-00095-01223937,2022-03-23T11:52:32,Portugalete,expenses,transport,-63.72,-5410.79
buyer_4,Jorge,,ES96209506732557392462,TRX_N-00096-21626967,2022-03-24T12:25:23,Galdakao,expenses,children,-768.91,-6179.7
buyer_4,Jorge,,ES96209506732557392462,TRX_N-00097-59585174,2022-03-25T11:47:07,Galdakao,expenses,transport,-57.43,-6237.13
buyer_4,Jorge,,ES96209506732557392462,TRX_N-00098-68373420,2022-03-25T18:07:01,Galdakao,expenses,healthcare,-114.59,-6351.72
buyer_4,Jorge,,ES96209506732557392462,TRX_N-00099-76111021,2022-03-26T17:58:30,Galdakao,expenses,transport,-76.61,-6428.33
buyer_4,Jorge,,ES96209506732557392462,TRX_N-00100-46283117,2022-03-28T16:06:33,Galdakao,expenses,food,-61.37,-6489.7
buyer_4,Jorge,,ES96209506732557392462,TRX_N-00101-84065029,2022-03-28T12:23:59,Galdakao,expenses,leisure,-57.8,-6547.5
buyer_4,Jorge,,ES96209506732557392462,TRX_N-00102-61330269,2022-03-28T08:02:02,Galdakao,expenses,gifts,-820.57,-7368.07
buyer_4,Jorge,,ES96209506732557392462,TRX_N-00103-03560584,2022-03-30T10:12:58,Galdakao,expenses,children,-441.41,-7809.48
buyer_4,Jorge,,ES96209506732557392462,TRX_N-00104-82144674,2022-03-31T19:15:23,Galdakao,expenses,children,-677.62,-8487.1
buyer_4,Jorge,,ES96209506732557392462,TRX_N-00105-40382679,2022-04-01T16:19:43,Galdakao,incomes,salary,2219.21,-6267.89
buyer_4,Jorge,,ES96209506732557392462,TRX_N-00106-55966565,2022-04-01T16:19:43,Galdakao,incomes,extra_income,415.36,-5852.53
buyer_4,Jorge,,ES96209506732557392462,TRX_N-00107-27274734,2022-04-03T16:43:25,Elciego,expenses,cash,-100.0,-5952.53
buyer_4,Jorge,,ES96209506732557392462,TRX_N-00108-62407754,2022-04-04T12:47:12,Galdakao,expenses,mortgage,-706.56,-6659.09
buyer_4,Jorge,,ES96209506732557392462,TRX_N-00109-09265492,2022-04-04T15:35:18,Galdakao,expenses,cash,-100.0,-6759.09
buyer_4,Jorge,,ES96209506732557392462,TRX_N-00110-12224193,2022-04-05T09:06:38,Galdakao,expenses,internet,-42.0,-6801.09
buyer_4,Jorge,,ES96209506732557392462,TRX_N-00111-19561254,2022-04-05T08:58:56,Galdakao,expenses,phone,-40.87,-6841.96
buyer_4,Jorge,,ES96209506732557392462,TRX_N-00112-12976242,2022-04-05T10:09:28,Galdakao,expenses,leisure,-48.02,-6889.98
buyer_4,Jorge,,ES96209506732557392462,TRX_N-00113-68235663,2022-04-06T15:11:10,Galdakao,expenses,water,-31.2,-6921.18
buyer_4,Jorge,,ES96209506732557392462,TRX_N-00114-86988485,2022-04-06T17:05:31,Galdakao,expenses,electricity,-84.09,-7005.27
buyer_4,Jorge,,ES96209506732557392462,TRX_N-00115-71429183,2022-04-06T19:44:11,Galdakao,expenses,repairs,-326.3,-7331.57
buyer_4,Jorge,,ES96209506732557392462,TRX_N-00116-14830926,2022-04-07T08:17:36,Galdakao,expenses,gas,-45.08,-7376.65
buyer_4,Jorge,,ES96209506732557392462,TRX_N-00117-80578941,2022-04-08T12:21:25,Donostia,expenses,food,-91.88,-7468.53
buyer_4,Jorge,,ES96209506732557392462,TRX_N-00118-52509972,2022-04-12T14:51:37,Galdakao,expenses,cash,-100.0,-7568.53
buyer_4,Jorge,,ES96209506732557392462,TRX_N-00119-76448953,2022-04-12T15:34:31,Galdakao,expenses,repairs,-58.95,-7627.48
buyer_4,Jorge,,ES96209506732557392462,TRX_N-00120-57962032,2022-04-12T17:56:39,Galdakao,expenses,children,-485.52,-8113.0
buyer_4,Jorge,,ES96209506732557392462,TRX_N-00121-40341505,2022-04-13T23:40:00,Galdakao,expenses,cash,-100.0,-8213.0
buyer_4,Jorge,,ES96209506732557392462,TRX_N-00122-72015236,2022-04-14T16:43:26,Alegría-Dulantzi,expenses,gifts,-638.26,-8851.26
buyer_4,Jorge,,ES96209506732557392462,TRX_N-00123-57487086,2022-04-16T12:30:26,Galdakao,expenses,food,-63.28,-8914.54
buyer_4,Jorge,,ES96209506732557392462,TRX_N-00124-36283840,2022-04-17T16:55:01,Galdakao,expenses,repairs,-84.24,-8998.78
buyer_4,Jorge,,ES96209506732557392462,TRX_N-00125-12696144,2022-04-18T09:13:34,Galdakao,expenses,repairs,-79.47,-9078.25
buyer_4,Jorge,,ES96209506732557392462,TRX_N-00126-72745698,2022-04-20T01:28:03,Galdakao,expenses,food,-95.35,-9173.6
buyer_4,Jorge,,ES96209506732557392462,TRX_N-00127-61254601,2022-04-21T11:24:34,Galdakao,expenses,cash,-100.0,-9273.6
buyer_4,Jorge,,ES96209506732557392462,TRX_N-00128-30938535,2022-04-23T16:54:55,Galdakao,expenses,transport,-83.79,-9357.39
buyer_4,Jorge,,ES96209506732557392462,TRX_N-00129-82144214,2022-04-25T20:50:27,Galdakao,expenses,repairs,-27.93,-9385.32
buyer_4,Jorge,,ES96209506732557392462,TRX_N-00130-58856847,2022-04-26T17:03:54,Galdakao,expenses,cash,-100.0,-9485.32
buyer_4,Jorge,,ES96209506732557392462,TRX_N-00131-79088610,2022-04-27T08:40:59,Galdakao,expenses,cash,-100.0,-9585.32
buyer_4,Jorge,,ES96209506732557392462,TRX_N-00132-18680647,2022-04-28T19:13:56,Galdakao,expenses,food,-70.63,-9655.95
buyer_4,Jorge,,ES96209506732557392462,TRX_N-00133-80560013,2022-04-28T02:38:00,Galdakao,expenses,clothing,-100.53,-9756.48
buyer_4,Jorge,,ES96209506732557392462,TRX_N-00134-12284936,2022-05-01T10:12:15,Galdakao,incomes,salary,2219.21,-7537.27
buyer_4,Jorge,,ES96209506732557392462,TRX_N-00135-27438857,2022-05-04T09:54:08,Galdakao,expenses,mortgage,-706.56,-8243.83
buyer_4,Jorge,,ES96209506732557392462,TRX_N-00136-47319684,2022-05-04T09:19:11,Galdakao,expenses,cash,-100.0,-8343.83
buyer_4,Jorge,,ES96209506732557392462,TRX_N-00137-13984622,2022-05-06T17:07:20,Galdakao,expenses,electricity,-75.34,-8419.17
buyer_4,Jorge,,ES96209506732557392462,TRX_N-00138-85951045,2022-05-06T10:16:21,Galdakao,expenses,gas,-106.32,-8525.49
buyer_4,Jorge,,ES96209506732557392462,TRX_N-00139-32576635,2022-05-06T11:01:52,Galdakao,expenses,internet,-42.0,-8567.49
buyer_4,Jorge,,ES96209506732557392462,TRX_N-00140-88754848,2022-05-06T20:58:19,Galdakao,expenses,phone,-30.64,-8598.13
buyer_4,Jorge,,ES96209506732557392462,TRX_N-00141-29871090,2022-05-08T18:27:47,Galdakao,expenses,water,-39.92,-8638.05
buyer_4,Jorge,,ES96209506732557392462,TRX_N-00142-32431341,2022-05-08T16:08:25,Galdakao,expenses,clothing,-120.58,-8758.63
buyer_4,Jorge,,ES96209506732557392462,TRX_N-00143-28382784,2022-05-08T15:29:24,Galdakao,expenses,education,-51.61,-8810.24
buyer_4,Jorge,,ES96209506732557392462,TRX_N-00144-80043645,2022-05-09T10:15:54,Galdakao,expenses,gifts,-238.61,-9048.85
buyer_4,Jorge,,ES96209506732557392462,TRX_N-00145-11149754,2022-05-09T09:22:13,Galdakao,expenses,car,-251.97,-9300.82
buyer_4,Jorge,,ES96209506732557392462,TRX_N-00146-06325002,2022-05-11T08:56:38,Leioa,expenses,food,-88.49,-9389.31
buyer_4,Jorge,,ES96209506732557392462,TRX_N-00147-67810030,2022-05-12T18:05:28,Galdakao,expenses,children,-771.79,-10161.1
buyer_4,Jorge,,ES96209506732557392462,TRX_N-00148-85093503,2022-05-15T10:29:13,Galdakao,expenses,transport,-80.59,-10241.69
buyer_4,Jorge,,ES96209506732557392462,TRX_N-00149-05139409,2022-05-15T20:40:31,Galdakao,expenses,cash,-100.0,-10341.69
buyer_4,Jorge,,ES96209506732557392462,TRX_N-00150-94905273,2022-05-16T16:59:32,Galdakao,expenses,food,-71.87,-10413.56
buyer_4,Jorge,,ES96209506732557392462,TRX_N-00151-20789603,2022-05-16T10:44:15,Galdakao,expenses,cash,-100.0,-10513.56
buyer_4,Jorge,,ES96209506732557392462,TRX_N-00152-51576323,2022-05-17T20:30:51,Galdakao,expenses,food,-93.0,-10606.56
buyer_4,Jorge,,ES96209506732557392462,TRX_N-00153-28774045,2022-05-17T18:12:49,Galdakao,expenses,cash,-100.0,-10706.56
buyer_4,Jorge,,ES96209506732557392462,TRX_N-00154-82551774,2022-05-17T19:48:13,Galdakao,expenses,children,-1136.02,-11842.58
buyer_4,Jorge,,ES96209506732557392462,TRX_N-00155-50305368,2022-05-18T15:22:27,Galdakao,expenses,cash,-100.0,-11942.58
buyer_4,Jorge,,ES96209506732557392462,TRX_N-00156-50660033,2022-05-19T13:22:11,Erandio,expenses,leisure,-37.9,-11980.48
buyer_4,Jorge,,ES96209506732557392462,TRX_N-00157-20287960,2022-05-19T18:03:37,Galdakao,expenses,gifts,-428.9,-12409.38
buyer_4,Jorge,,ES96209506732557392462,TRX_N-00158-55691036,2022-05-23T08:24:57,Pasaia,expenses,food,-95.59,-12504.97
buyer_4,Jorge,,ES96209506732557392462,TRX_N-00159-27915741,2022-05-23T16:54:38,Galdakao,expenses,children,-1301.81,-13806.78
buyer_4,Jorge,,ES96209506732557392462,TRX_N-00160-29516979,2022-05-24T10:15:04,Galdakao,expenses,appliances,-276.63,-14083.41
buyer_4,Jorge,,ES96209506732557392462,TRX_N-00161-13314289,2022-05-25T12:45:33,Sestao,expenses,leisure,-58.59,-14142.0
buyer_4,Jorge,,ES96209506732557392462,TRX_N-00162-58469843,2022-05-25T16:10:00,Galdakao,expenses,cash,-100.0,-14242.0
buyer_4,Jorge,,ES96209506732557392462,TRX_N-00163-91734311,2022-05-26T15:02:08,Galdakao,expenses,food,-114.44,-14356.44
buyer_4,Jorge,,ES96209506732557392462,TRX_N-00164-31324949,2022-05-27T10:06:10,Galdakao,expenses,education,-43.38,-14399.82
buyer_4,Jorge,,ES96209506732557392462,TRX_N-00165-96059016,2022-05-28T22:59:55,Galdakao,expenses,transport,-43.62,-14443.44
buyer_4,Jorge,,ES96209506732557392462,TRX_N-00166-43789208,2022-05-28T11:45:23,Labastida,expenses,leisure,-81.39,-14524.83
buyer_4,Jorge,,ES96209506732557392462,TRX_N-00167-94895304,2022-05-29T21:18:15,Galdakao,expenses,repairs,-236.48,-14761.31
buyer_4,Jorge,,ES96209506732557392462,TRX_N-00168-44383883,2022-06-01T20:37:51,Galdakao,incomes,salary,2219.21,-12542.1
buyer_4,Jorge,,ES96209506732557392462,TRX_N-00169-86840441,2022-06-01T20:37:51,Galdakao,incomes,salary_bonus,1670.15,-10871.95
buyer_4,Jorge,,ES96209506732557392462,TRX_N-00170-82781507,2022-06-01T20:57:12,Galdakao,expenses,food,-121.65,-10993.6
buyer_4,Jorge,,ES96209506732557392462,TRX_N-00171-12264301,2022-06-01T22:00:49,Galdakao,expenses,clothing,-130.3,-11123.9
buyer_4,Jorge,,ES96209506732557392462,TRX_N-00172-85357303,2022-06-01T13:47:26,Galdakao,expenses,cash,-100.0,-11223.9
buyer_4,Jorge,,ES96209506732557392462,TRX_N-00173-52039183,2022-06-04T14:28:58,Galdakao,expenses,mortgage,-706.56,-11930.46
buyer_4,Jorge,,ES96209506732557392462,TRX_N-00174-59006833,2022-06-05T10:57:09,Galdakao,expenses,phone,-44.86,-11975.32
buyer_4,Jorge,,ES96209506732557392462,TRX_N-00175-82070032,2022-06-05T15:02:43,Galdakao,expenses,clothing,-55.94,-12031.26
buyer_4,Jorge,,ES96209506732557392462,TRX_N-00176-70479570,2022-06-06T14:41:05,Galdakao,expenses,electricity,-39.01,-12070.27
buyer_4,Jorge,,ES96209506732557392462,TRX_N-00177-22334719,2022-06-06T06:29:46,Galdakao,expenses,food,-90.23,-12160.5
buyer_4,Jorge,,ES96209506732557392462,TRX_N-00178-46431129,2022-06-06T13:07:12,Galdakao,expenses,cash,-100.0,-12260.5
buyer_4,Jorge,,ES96209506732557392462,TRX_N-00179-61571965,2022-06-08T15:18:00,Galdakao,expenses,water,-36.84,-12297.34
buyer_4,Jorge,,ES96209506732557392462,TRX_N-00180-91675481,2022-06-08T21:57:12,Galdakao,expenses,gas,-51.31,-12348.65
buyer_4,Jorge,,ES96209506732557392462,TRX_N-00181-49196727,2022-06-08T08:14:21,Galdakao,expenses,internet,-42.0,-12390.65
buyer_4,Jorge,,ES96209506732557392462,TRX_N-00182-66196603,2022-06-08T22:10:18,Galdakao,expenses,cash,-100.0,-12490.65
buyer_4,Jorge,,ES96209506732557392462,TRX_N-00183-47322156,2022-06-09T21:25:23,Galdakao,expenses,food,-86.93,-12577.58
buyer_4,Jorge,,ES96209506732557392462,TRX_N-00184-75225652,2022-06-11T16:51:51,Vitoria-Gasteiz,expenses,food,-108.58,-12686.16
buyer_4,Jorge,,ES96209506732557392462,TRX_N-00185-85187427,2022-06-11T09:38:21,Galdakao,expenses,education,-65.34,-12751.5
buyer_4,Jorge,,ES96209506732557392462,TRX_N-00186-31828382,2022-06-13T23:08:57,Bilbao,expenses,appliances,-253.46,-13004.96
buyer_4,Jorge,,ES96209506732557392462,TRX_N-00187-13671372,2022-06-15T17:37:35,Galdakao,expenses,clothing,-115.84,-13120.8
buyer_4,Jorge,,ES96209506732557392462,TRX_N-00188-38665029,2022-06-15T20:00:18,Galdakao,expenses,cash,-100.0,-13220.8
buyer_4,Jorge,,ES96209506732557392462,TRX_N-00189-72698662,2022-06-18T22:22:34,Galdakao,expenses,cash,-100.0,-13320.8
buyer_4,Jorge,,ES96209506732557392462,TRX_N-00190-99170276,2022-06-22T22:03:52,Galdakao,expenses,education,-48.6,-13369.4
buyer_4,Jorge,,ES96209506732557392462,TRX_N-00191-28358525,2022-06-22T08:21:19,Galdakao,expenses,cash,-100.0,-13469.4
buyer_4,Jorge,,ES96209506732557392462,TRX_N-00192-31061484,2022-06-23T19:50:34,Bilbao,expenses,leisure,-68.38,-13537.78
buyer_4,Jorge,,ES96209506732557392462,TRX_N-00193-42212575,2022-06-24T09:06:53,Sestao,expenses,leisure,-26.32,-13564.1
buyer_4,Jorge,,ES96209506732557392462,TRX_N-00194-05768777,2022-06-24T12:24:13,Basauri,expenses,repairs,-172.22,-13736.32
buyer_4,Jorge,,ES96209506732557392462,TRX_N-00195-91673095,2022-06-25T19:34:33,Galdakao,expenses,education,-48.76,-13785.08
buyer_4,Jorge,,ES96209506732557392462,TRX_N-00196-15478255,2022-06-27T08:00:04,Galdakao,expenses,cash,-100.0,-13885.08
buyer_4,Jorge,,ES96209506732557392462,TRX_N-00197-96167580,2022-06-27T06:02:54,Galdakao,expenses,gifts,-650.49,-14535.57
buyer_4,Jorge,,ES96209506732557392462,TRX_N-00198-64564836,2022-06-27T06:19:41,Galdakao,expenses,children,-811.15,-15346.72
buyer_4,Jorge,,ES96209506732557392462,TRX_N-00199-22226667,2022-06-28T14:46:31,Durango,expenses,clothing,-103.91,-15450.63
buyer_4,Jorge,,ES96209506732557392462,TRX_N-00200-98581607,2022-06-28T17:55:14,Galdakao,expenses,healthcare,-166.22,-15616.85
buyer_4,Jorge,,ES96209506732557392462,TRX_N-00201-68468337,2022-06-28T15:17:30,Berango,expenses,repairs,-111.59,-15728.44
buyer_4,Jorge,,ES96209506732557392462,TRX_N-00202-41048069,2022-06-29T20:41:07,Galdakao,expenses,food,-85.59,-15814.03
buyer_4,Jorge,,ES96209506732557392462,TRX_N-00203-51993000,2022-06-29T08:22:19,Galdakao,expenses,transport,-89.73,-15903.76
buyer_4,Jorge,,ES96209506732557392462,TRX_N-00204-70652240,2022-06-29T14:14:25,Galdakao,expenses,cash,-100.0,-16003.76
buyer_4,Jorge,,ES96209506732557392462,TRX_N-00205-99442086,2022-07-01T10:40:47,Galdakao,incomes,salary,2219.21,-13784.55
buyer_4,Jorge,,ES96209506732557392462,TRX_N-00206-32529320,2022-07-01T20:42:32,Galdakao,expenses,cash,-100.0,-13884.55
buyer_4,Jorge,,ES96209506732557392462,TRX_N-00207-38828462,2022-07-04T18:01:27,Galdakao,expenses,mortgage,-706.56,-14591.11
buyer_4,Jorge,,ES96209506732557392462,TRX_N-00208-71154957,2022-07-05T17:47:40,Galdakao,expenses,phone,-40.41,-14631.52
buyer_4,Jorge,,ES96209506732557392462,TRX_N-00209-44217855,2022-07-06T11:02:35,Galdakao,expenses,internet,-42.0,-14673.52
buyer_4,Jorge,,ES96209506732557392462,TRX_N-00210-43524276,2022-07-07T18:24:11,Galdakao,expenses,transport,-46.75,-14720.27
buyer_4,Jorge,,ES96209506732557392462,TRX_N-00211-01613181,2022-07-08T08:52:08,Galdakao,expenses,water,-24.41,-14744.68
buyer_4,Jorge,,ES96209506732557392462,TRX_N-00212-85237562,2022-07-08T11:01:16,Galdakao,expenses,electricity,-48.57,-14793.25
buyer_4,Jorge,,ES96209506732557392462,TRX_N-00213-25177797,2022-07-08T14:39:02,Galdakao,expenses,gas,-80.96,-14874.21
buyer_4,Jorge,,ES96209506732557392462,TRX_N-00214-70365486,2022-07-09T11:33:17,Galdakao,expenses,transport,-82.12,-14956.33
buyer_4,Jorge,,ES96209506732557392462,TRX_N-00215-81382341,2022-07-10T17:22:59,Galdakao,expenses,cash,-100.0,-15056.33
buyer_4,Jorge,,ES96209506732557392462,TRX_N-00216-93681939,2022-07-12T08:33:10,Galdakao,expenses,clothing,-64.14,-15120.47
buyer_4,Jorge,,ES96209506732557392462,TRX_N-00217-78193015,2022-07-13T12:59:57,Galdakao,expenses,food,-62.23,-15182.7
buyer_4,Jorge,,ES96209506732557392462,TRX_N-00218-99169835,2022-07-13T14:41:01,Vitoria-Gasteiz,expenses,cash,-100.0,-15282.7
buyer_4,Jorge,,ES96209506732557392462,TRX_N-00219-69195837,2022-07-14T15:15:59,Galdakao,expenses,food,-102.8,-15385.5
buyer_4,Jorge,,ES96209506732557392462,TRX_N-00220-73163831,2022-07-14T19:54:28,Zuia,expenses,cash,-100.0,-15485.5
buyer_4,Jorge,,ES96209506732557392462,TRX_N-00221-38648059,2022-07-16T11:01:29,Errenteria,expenses,food,-102.39,-15587.89
buyer_4,Jorge,,ES96209506732557392462,TRX_N-00222-17660454,2022-07-16T18:33:55,Galdakao,expenses,clothing,-109.32,-15697.21
buyer_4,Jorge,,ES96209506732557392462,TRX_N-00223-58462464,2022-07-16T08:49:55,Galdakao,expenses,cash,-100.0,-15797.21
buyer_4,Jorge,,ES96209506732557392462,TRX_N-00224-37106187,2022-07-18T12:05:53,Galdakao,expenses,food,-93.93,-15891.14
buyer_4,Jorge,,ES96209506732557392462,TRX_N-00225-11816530,2022-07-18T08:10:22,Galdakao,expenses,travel,-1346.77,-17237.91
buyer_4,Jorge,,ES96209506732557392462,TRX_N-00226-73189061,2022-07-19T14:18:43,Hondarribia,expenses,education,-58.09,-17296.0
buyer_4,Jorge,,ES96209506732557392462,TRX_N-00227-83719084,2022-07-21T11:42:53,Galdakao,expenses,leisure,-30.66,-17326.66
buyer_4,Jorge,,ES96209506732557392462,TRX_N-00228-18997889,2022-07-23T07:34:42,Labastida,expenses,appliances,-352.99,-17679.65
buyer_4,Jorge,,ES96209506732557392462,TRX_N-00229-27573236,2022-07-24T12:15:38,Galdakao,expenses,healthcare,-61.33,-17740.98
buyer_4,Jorge,,ES96209506732557392462,TRX_N-00230-08511088,2022-07-25T12:46:43,Galdakao,expenses,appliances,-291.66,-18032.64
buyer_4,Jorge,,ES96209506732557392462,TRX_N-00231-16921449,2022-07-26T20:28:11,Galdakao,expenses,education,-65.44,-18098.08
buyer_4,Jorge,,ES96209506732557392462,TRX_N-00232-49112262,2022-07-29T10:30:30,Galdakao,expenses,children,-639.5,-18737.58
buyer_4,Jorge,,ES96209506732557392462,TRX_N-00233-42556001,2022-07-30T11:56:16,Galdakao,expenses,leisure,-69.01,-18806.59
buyer_4,Jorge,,ES96209506732557392462,TRX_N-00234-10828824,2022-07-30T07:23:36,Galdakao,expenses,repairs,-113.82,-18920.41
buyer_4,Jorge,,ES96209506732557392462,TRX_N-00235-92692485,2022-07-31T23:10:39,Galdakao,expenses,food,-82.15,-19002.56
buyer_4,Jorge,,ES96209506732557392462,TRX_N-00236-83433685,2022-08-01T14:06:23,Galdakao,incomes,salary,2219.21,-16783.35
buyer_4,Jorge,,ES96209506732557392462,TRX_N-00237-57824899,2022-08-01T14:06:23,Galdakao,incomes,extra_income,415.36,-16367.99
buyer_4,Jorge,,ES96209506732557392462,TRX_N-00238-38108849,2022-08-01T18:06:09,Galdakao,expenses,food,-96.6,-16464.59
buyer_4,Jorge,,ES96209506732557392462,TRX_N-00239-42101438,2022-08-01T13:16:34,Galdakao,expenses,transport,-46.28,-16510.87
buyer_4,Jorge,,ES96209506732557392462,TRX_N-00240-14000722,2022-08-03T10:37:52,Salvatierra/Agurain,expenses,education,-60.1,-16570.97
buyer_4,Jorge,,ES96209506732557392462,TRX_N-00241-56113369,2022-08-04T11:55:48,Galdakao,expenses,mortgage,-706.56,-17277.53
buyer_4,Jorge,,ES96209506732557392462,TRX_N-00242-54773304,2022-08-04T18:59:04,Galdakao,expenses,leisure,-32.37,-17309.9
buyer_4,Jorge,,ES96209506732557392462,TRX_N-00243-99139351,2022-08-05T17:07:26,Galdakao,expenses,water,-28.43,-17338.33
buyer_4,Jorge,,ES96209506732557392462,TRX_N-00244-27527163,2022-08-05T22:37:15,Galdakao,expenses,gas,-32.83,-17371.16
buyer_4,Jorge,,ES96209506732557392462,TRX_N-00245-20427748,2022-08-05T13:55:06,Galdakao,expenses,internet,-42.0,-17413.16
buyer_4,Jorge,,ES96209506732557392462,TRX_N-00246-75730652,2022-08-06T13:15:52,Barakaldo,expenses,clothing,-94.97,-17508.13
buyer_4,Jorge,,ES96209506732557392462,TRX_N-00247-01962091,2022-08-06T16:58:18,Labastida,expenses,education,-45.23,-17553.36
buyer_4,Jorge,,ES96209506732557392462,TRX_N-00248-31423410,2022-08-06T13:21:45,Galdakao,expenses,appliances,-384.77,-17938.13
buyer_4,Jorge,,ES96209506732557392462,TRX_N-00249-14423283,2022-08-07T08:58:09,Galdakao,expenses,electricity,-46.85,-17984.98
buyer_4,Jorge,,ES96209506732557392462,TRX_N-00250-68108339,2022-08-07T18:29:08,Galdakao,expenses,transport,-82.04,-18067.02
buyer_4,Jorge,,ES96209506732557392462,TRX_N-00251-18631699,2022-08-07T18:30:49,Galdakao,expenses,cash,-100.0,-18167.02
buyer_4,Jorge,,ES96209506732557392462,TRX_N-00252-23428985,2022-08-08T09:12:56,Galdakao,expenses,phone,-39.81,-18206.83
buyer_4,Jorge,,ES96209506732557392462,TRX_N-00253-49348071,2022-08-09T16:09:16,Galdakao,expenses,children,-772.75,-18979.58
buyer_4,Jorge,,ES96209506732557392462,TRX_N-00254-85924927,2022-08-14T16:48:21,Galdakao,expenses,transport,-72.48,-19052.06
buyer_4,Jorge,,ES96209506732557392462,TRX_N-00255-99222454,2022-08-14T17:28:44,Galdakao,expenses,cash,-100.0,-19152.06
buyer_4,Jorge,,ES96209506732557392462,TRX_N-00256-42591754,2022-08-14T19:29:17,Zarautz,expenses,appliances,-194.06,-19346.12
buyer_4,Jorge,,ES96209506732557392462,TRX_N-00257-23869040,2022-08-15T13:53:24,Galdakao,expenses,food,-124.0,-19470.12
buyer_4,Jorge,,ES96209506732557392462,TRX_N-00258-71671358,2022-08-18T09:23:41,Galdakao,expenses,food,-122.7,-19592.82
buyer_4,Jorge,,ES96209506732557392462,TRX_N-00259-07376819,2022-08-18T11:07:45,Barakaldo,expenses,transport,-75.26,-19668.08
buyer_4,Jorge,,ES96209506732557392462,TRX_N-00260-41137023,2022-08-19T18:44:12,Galdakao,expenses,leisure,-64.71,-19732.79
buyer_4,Jorge,,ES96209506732557392462,TRX_N-00261-03256772,2022-08-19T09:48:51,Galdakao,expenses,cash,-100.0,-19832.79
buyer_4,Jorge,,ES96209506732557392462,TRX_N-00262-17662143,2022-08-21T10:38:49,Galdakao,expenses,cash,-100.0,-19932.79
buyer_4,Jorge,,ES96209506732557392462,TRX_N-00263-39412089,2022-08-22T19:44:30,Galdakao,expenses,transport,-58.35,-19991.14
buyer_4,Jorge,,ES96209506732557392462,TRX_N-00264-33694567,2022-08-22T19:07:39,Galdakao,expenses,children,-607.06,-20598.2
buyer_4,Jorge,,ES96209506732557392462,TRX_N-00265-27186230,2022-08-23T18:15:31,Galdakao,expenses,cash,-100.0,-20698.2
buyer_4,Jorge,,ES96209506732557392462,TRX_N-00266-13859419,2022-08-23T22:03:08,Bermeo,expenses,gifts,-64.6,-20762.8
buyer_4,Jorge,,ES96209506732557392462,TRX_N-00267-49481880,2022-08-25T16:52:08,Galdakao,expenses,repairs,-182.79,-20945.59
buyer_4,Jorge,,ES96209506732557392462,TRX_N-00268-53371095,2022-08-27T14:15:52,Galdakao,expenses,transport,-44.58,-20990.17
buyer_4,Jorge,,ES96209506732557392462,TRX_N-00269-68030674,2022-08-27T10:17:39,Galdakao,expenses,leisure,-71.73,-21061.9
buyer_4,Jorge,,ES96209506732557392462,TRX_N-00270-41108786,2022-08-29T20:01:37,Galdakao,expenses,cash,-100.0,-21161.9
buyer_4,Jorge,,ES96209506732557392462,TRX_N-00271-47848100,2022-08-29T02:29:38,Galdakao,expenses,repairs,-98.7,-21260.6
buyer_4,Jorge,,ES96209506732557392462,TRX_N-00272-03954906,2022-09-01T23:34:47,Galdakao,incomes,salary,2219.21,-19041.39
buyer_4,Jorge,,ES96209506732557392462,TRX_N-00273-81633840,2022-09-01T10:26:01,Galdakao,expenses,repairs,-89.8,-19131.19
buyer_4,Jorge,,ES96209506732557392462,TRX_N-00274-58995903,2022-09-03T10:55:46,Sestao,expenses,cash,-100.0,-19231.19
buyer_4,Jorge,,ES96209506732557392462,TRX_N-00275-01066259,2022-09-04T12:17:31,Galdakao,expenses,mortgage,-706.56,-19937.75
buyer_4,Jorge,,ES96209506732557392462,TRX_N-00276-38973782,2022-09-04T08:01:08,Galdakao,expenses,healthcare,-117.27,-20055.02
buyer_4,Jorge,,ES96209506732557392462,TRX_N-00277-75019329,2022-09-05T18:29:25,Galdakao,expenses,gas,-74.81,-20129.83
buyer_4,Jorge,,ES96209506732557392462,TRX_N-00278-94080993,2022-09-05T01:38:58,Amurrio,expenses,leisure,-24.74,-20154.57
buyer_4,Jorge,,ES96209506732557392462,TRX_N-00279-08879819,2022-09-06T11:42:24,Galdakao,expenses,water,-36.82,-20191.39
buyer_4,Jorge,,ES96209506732557392462,TRX_N-00280-78957539,2022-09-06T14:07:09,Galdakao,expenses,phone,-34.94,-20226.33
buyer_4,Jorge,,ES96209506732557392462,TRX_N-00281-66388945,2022-09-06T12:51:24,Galdakao,expenses,food,-88.01,-20314.34
buyer_4,Jorge,,ES96209506732557392462,TRX_N-00282-78862200,2022-09-06T08:16:59,Galdakao,expenses,leisure,-54.17,-20368.51
buyer_4,Jorge,,ES96209506732557392462,TRX_N-00283-82938511,2022-09-06T22:59:11,Galdakao,expenses,healthcare,-157.33,-20525.84
buyer_4,Jorge,,ES96209506732557392462,TRX_N-00284-13839537,2022-09-07T17:12:53,Galdakao,expenses,food,-72.7,-20598.54
buyer_4,Jorge,,ES96209506732557392462,TRX_N-00285-17218192,2022-09-08T16:33:08,Galdakao,expenses,electricity,-81.42,-20679.96
buyer_4,Jorge,,ES96209506732557392462,TRX_N-00286-33415761,2022-09-08T14:45:31,Galdakao,expenses,internet,-42.0,-20721.96
buyer_4,Jorge,,ES96209506732557392462,TRX_N-00287-45463083,2022-09-08T19:47:56,Galdakao,expenses,food,-65.32,-20787.28
buyer_4,Jorge,,ES96209506732557392462,TRX_N-00288-29182456,2022-09-09T16:26:30,Galdakao,expenses,food,-93.37,-20880.65
buyer_4,Jorge,,ES96209506732557392462,TRX_N-00289-84730704,2022-09-10T07:01:44,Galdakao,expenses,food,-77.4,-20958.05
buyer_4,Jorge,,ES96209506732557392462,TRX_N-00290-57198066,2022-09-10T01:58:14,Galdakao,expenses,cash,-100.0,-21058.05
buyer_4,Jorge,,ES96209506732557392462,TRX_N-00291-40531968,2022-09-11T14:00:52,Galdakao,expenses,healthcare,-47.82,-21105.87
buyer_4,Jorge,,ES96209506732557392462,TRX_N-00292-13448874,2022-09-12T13:35:19,Galdakao,expenses,children,-669.36,-21775.23
buyer_4,Jorge,,ES96209506732557392462,TRX_N-00293-75077185,2022-09-13T14:09:43,Galdakao,expenses,food,-112.35,-21887.58
buyer_4,Jorge,,ES96209506732557392462,TRX_N-00294-97144733,2022-09-13T16:22:41,Galdakao,expenses,leisure,-65.78,-21953.36
buyer_4,Jorge,,ES96209506732557392462,TRX_N-00295-42029996,2022-09-13T15:39:32,Galdakao,expenses,clothing,-148.09,-22101.45
buyer_4,Jorge,,ES96209506732557392462,TRX_N-00296-70217625,2022-09-14T18:51:31,Galdakao,expenses,children,-492.67,-22594.12
buyer_4,Jorge,,ES96209506732557392462,TRX_N-00297-33548039,2022-09-16T12:04:01,Galdakao,expenses,cash,-100.0,-22694.12
buyer_4,Jorge,,ES96209506732557392462,TRX_N-00298-24168740,2022-09-17T14:08:24,Galdakao,expenses,education,-43.39,-22737.51
buyer_4,Jorge,,ES96209506732557392462,TRX_N-00299-36193054,2022-09-18T15:56:17,Galdakao,expenses,education,-50.27,-22787.78
buyer_4,Jorge,,ES96209506732557392462,TRX_N-00300-55591477,2022-09-20T15:52:47,Galdakao,expenses,travel,-988.68,-23776.46
buyer_4,Jorge,,ES96209506732557392462,TRX_N-00301-30583409,2022-09-21T19:47:32,Galdakao,expenses,transport,-52.98,-23829.44
buyer_4,Jorge,,ES96209506732557392462,TRX_N-00302-31513229,2022-09-25T18:02:19,Irun,expenses,gifts,-273.81,-24103.25
buyer_4,Jorge,,ES96209506732557392462,TRX_N-00303-46727392,2022-09-27T11:48:27,Sopela,expenses,food,-100.77,-24204.02
buyer_4,Jorge,,ES96209506732557392462,TRX_N-00304-83923160,2022-09-27T20:39:05,Durango,expenses,leisure,-30.54,-24234.56
buyer_4,Jorge,,ES96209506732557392462,TRX_N-00305-62287247,2022-09-27T09:32:50,Galdakao,expenses,clothing,-116.69,-24351.25
buyer_4,Jorge,,ES96209506732557392462,TRX_N-00306-90612833,2022-09-28T08:23:46,Galdakao,expenses,repairs,-60.58,-24411.83
buyer_4,Jorge,,ES96209506732557392462,TRX_N-00307-87545101,2022-09-30T17:02:52,Galdakao,expenses,food,-97.31,-24509.14
buyer_4,Jorge,,ES96209506732557392462,TRX_N-00308-28968117,2022-09-30T13:38:25,Galdakao,expenses,leisure,-36.96,-24546.1
buyer_4,Jorge,,ES96209506732557392462,TRX_N-00309-49019786,2022-09-30T03:40:48,Galdakao,expenses,repairs,-326.89,-24872.99
buyer_4,Jorge,,ES96209506732557392462,TRX_N-00310-26710368,2022-10-01T10:51:49,Galdakao,incomes,salary,2219.21,-22653.78
buyer_4,Jorge,,ES96209506732557392462,TRX_N-00311-59123231,2022-10-01T00:58:15,Galdakao,expenses,cash,-100.0,-22753.78
buyer_4,Jorge,,ES96209506732557392462,TRX_N-00312-88598162,2022-10-02T18:23:17,Galdakao,expenses,food,-92.03,-22845.81
buyer_4,Jorge,,ES96209506732557392462,TRX_N-00313-78526142,2022-10-03T20:03:11,Galdakao,expenses,gifts,-350.86,-23196.67
buyer_4,Jorge,,ES96209506732557392462,TRX_N-00314-84589519,2022-10-04T11:08:53,Galdakao,expenses,mortgage,-706.56,-23903.23
buyer_4,Jorge,,ES96209506732557392462,TRX_N-00315-89117319,2022-10-05T18:10:56,Galdakao,expenses,gas,-96.53,-23999.76
buyer_4,Jorge,,ES96209506732557392462,TRX_N-00316-46806876,2022-10-07T08:52:06,Galdakao,expenses,electricity,-79.66,-24079.42
buyer_4,Jorge,,ES96209506732557392462,TRX_N-00317-82900211,2022-10-07T16:11:52,Galdakao,expenses,leisure,-18.44,-24097.86
buyer_4,Jorge,,ES96209506732557392462,TRX_N-00318-22280840,2022-10-08T19:25:11,Galdakao,expenses,water,-31.65,-24129.51
buyer_4,Jorge,,ES96209506732557392462,TRX_N-00319-96315240,2022-10-08T13:50:41,Galdakao,expenses,internet,-42.0,-24171.51
buyer_4,Jorge,,ES96209506732557392462,TRX_N-00320-21422534,2022-10-08T11:09:09,Galdakao,expenses,phone,-31.31,-24202.82
buyer_4,Jorge,,ES96209506732557392462,TRX_N-00321-29535985,2022-10-08T15:59:34,Galdakao,expenses,leisure,-59.95,-24262.77
buyer_4,Jorge,,ES96209506732557392462,TRX_N-00322-98684875,2022-10-12T19:58:12,Galdakao,expenses,cash,-100.0,-24362.77
buyer_4,Jorge,,ES96209506732557392462,TRX_N-00323-84217512,2022-10-13T14:13:03,Galdakao,expenses,cash,-100.0,-24462.77
buyer_4,Jorge,,ES96209506732557392462,TRX_N-00324-25317162,2022-10-16T17:16:02,Galdakao,expenses,clothing,-147.45,-24610.22
buyer_4,Jorge,,ES96209506732557392462,TRX_N-00325-21820186,2022-10-16T12:54:55,Galdakao,expenses,children,-924.82,-25535.04
buyer_4,Jorge,,ES96209506732557392462,TRX_N-00326-14949914,2022-10-17T12:49:24,Barakaldo,expenses,food,-66.69,-25601.73
buyer_4,Jorge,,ES96209506732557392462,TRX_N-00327-89543740,2022-10-17T12:16:14,Galdakao,expenses,education,-57.77,-25659.5
buyer_4,Jorge,,ES96209506732557392462,TRX_N-00328-41615348,2022-10-18T18:32:45,Pasaia,expenses,repairs,-193.19,-25852.69
buyer_4,Jorge,,ES96209506732557392462,TRX_N-00329-94016999,2022-10-21T20:30:01,Galdakao,expenses,gifts,-387.65,-26240.34
buyer_4,Jorge,,ES96209506732557392462,TRX_N-00330-42915732,2022-10-22T23:42:32,Bilbao,expenses,appliances,-287.12,-26527.46
buyer_4,Jorge,,ES96209506732557392462,TRX_N-00331-72189142,2022-10-26T19:39:54,Galdakao,expenses,cash,-100.0,-26627.46
buyer_4,Jorge,,ES96209506732557392462,TRX_N-00332-54075356,2022-10-27T15:45:00,Galdakao,expenses,food,-96.24,-26723.7
buyer_4,Jorge,,ES96209506732557392462,TRX_N-00333-85190666,2022-10-28T07:09:44,Elciego,expenses,gifts,-80.16,-26803.86
buyer_4,Jorge,,ES96209506732557392462,TRX_N-00334-83406537,2022-10-30T15:13:07,Zarautz,expenses,transport,-81.6,-26885.46
buyer_4,Jorge,,ES96209506732557392462,TRX_N-00335-96772456,2022-10-31T17:44:23,Galdakao,expenses,transport,-41.06,-26926.52
buyer_4,Jorge,,ES96209506732557392462,TRX_N-00336-30812439,2022-10-31T10:15:22,Galdakao,expenses,cash,-100.0,-27026.52
buyer_4,Jorge,,ES96209506732557392462,TRX_N-00337-77018595,2022-10-31T14:53:55,Galdakao,expenses,gifts,-145.92,-27172.44
buyer_4,Jorge,,ES96209506732557392462,TRX_N-00338-73482172,2022-11-01T00:09:56,Galdakao,incomes,salary,2219.21,-24953.23
buyer_4,Jorge,,ES96209506732557392462,TRX_N-00339-20738291,2022-11-01T09:48:51,Galdakao,expenses,appliances,-233.99,-25187.22
buyer_4,Jorge,,ES96209506732557392462,TRX_N-00340-28890064,2022-11-03T14:47:32,Galdakao,expenses,food,-72.28,-25259.5
buyer_4,Jorge,,ES96209506732557392462,TRX_N-00341-90287170,2022-11-03T17:26:45,Sopela,expenses,cash,-100.0,-25359.5
buyer_4,Jorge,,ES96209506732557392462,TRX_N-00342-65799578,2022-11-03T09:04:13,Galdakao,expenses,repairs,-27.35,-25386.85
buyer_4,Jorge,,ES96209506732557392462,TRX_N-00343-07497606,2022-11-04T19:29:37,Galdakao,expenses,mortgage,-706.56,-26093.41
buyer_4,Jorge,,ES96209506732557392462,TRX_N-00344-86950511,2022-11-04T19:10:00,Mungia,expenses,cash,-100.0,-26193.41
buyer_4,Jorge,,ES96209506732557392462,TRX_N-00345-52429198,2022-11-04T14:03:05,Galdakao,expenses,travel,-1053.31,-27246.72
buyer_4,Jorge,,ES96209506732557392462,TRX_N-00346-58826323,2022-11-05T21:56:11,Galdakao,expenses,internet,-42.0,-27288.72
buyer_4,Jorge,,ES96209506732557392462,TRX_N-00347-93113056,2022-11-05T11:57:41,Galdakao,expenses,transport,-64.57,-27353.29
buyer_4,Jorge,,ES96209506732557392462,TRX_N-00348-74414733,2022-11-06T14:53:55,Galdakao,expenses,water,-27.31,-27380.6
buyer_4,Jorge,,ES96209506732557392462,TRX_N-00349-04563544,2022-11-06T20:03:51,Galdakao,expenses,phone,-44.78,-27425.38
buyer_4,Jorge,,ES96209506732557392462,TRX_N-00350-72422398,2022-11-08T14:58:30,Galdakao,expenses,electricity,-35.26,-27460.64
buyer_4,Jorge,,ES96209506732557392462,TRX_N-00351-94952088,2022-11-08T10:04:43,Galdakao,expenses,gas,-71.24,-27531.88
buyer_4,Jorge,,ES96209506732557392462,TRX_N-00352-48721895,2022-11-08T10:42:39,Pasaia,expenses,education,-57.52,-27589.4
buyer_4,Jorge,,ES96209506732557392462,TRX_N-00353-29821757,2022-11-10T13:55:55,Durango,expenses,gifts,-61.04,-27650.44
buyer_4,Jorge,,ES96209506732557392462,TRX_N-00354-43209539,2022-11-11T16:25:42,Galdakao,expenses,gifts,-777.92,-28428.36
buyer_4,Jorge,,ES96209506732557392462,TRX_N-00355-17455760,2022-11-12T14:22:25,Galdakao,expenses,cash,-100.0,-28528.36
buyer_4,Jorge,,ES96209506732557392462,TRX_N-00356-56954352,2022-11-13T16:40:33,Amurrio,expenses,transport,-42.37,-28570.73
buyer_4,Jorge,,ES96209506732557392462,TRX_N-00357-07419289,2022-11-13T22:03:25,Galdakao,expenses,repairs,-98.5,-28669.23
buyer_4,Jorge,,ES96209506732557392462,TRX_N-00358-85347197,2022-11-17T21:54:38,Galdakao,expenses,repairs,-300.03,-28969.26
buyer_4,Jorge,,ES96209506732557392462,TRX_N-00359-87656177,2022-11-18T14:00:03,Galdakao,expenses,food,-86.2,-29055.46
buyer_4,Jorge,,ES96209506732557392462,TRX_N-00360-41387998,2022-11-18T22:39:21,Galdakao,expenses,transport,-57.9,-29113.36
buyer_4,Jorge,,ES96209506732557392462,TRX_N-00361-88345573,2022-11-18T09:29:27,Galdakao,expenses,education,-60.46,-29173.82
buyer_4,Jorge,,ES96209506732557392462,TRX_N-00362-70150704,2022-11-19T16:25:22,Vitoria-Gasteiz,expenses,cash,-100.0,-29273.82
buyer_4,Jorge,,ES96209506732557392462,TRX_N-00363-66282699,2022-11-19T06:49:35,Galdakao,expenses,gifts,-206.49,-29480.31
buyer_4,Jorge,,ES96209506732557392462,TRX_N-00364-25905677,2022-11-20T19:34:57,Bilbao,expenses,clothing,-54.08,-29534.39
buyer_4,Jorge,,ES96209506732557392462,TRX_N-00365-68485018,2022-11-21T15:41:38,Galdakao,expenses,cash,-100.0,-29634.39
buyer_4,Jorge,,ES96209506732557392462,TRX_N-00366-40405319,2022-11-21T18:29:38,Galdakao,expenses,repairs,-153.44,-29787.83
buyer_4,Jorge,,ES96209506732557392462,TRX_N-00367-15252933,2022-11-22T15:39:57,Galdakao,expenses,food,-118.68,-29906.51
buyer_4,Jorge,,ES96209506732557392462,TRX_N-00368-41803881,2022-11-22T13:11:30,Galdakao,expenses,clothing,-129.79,-30036.3
buyer_4,Jorge,,ES96209506732557392462,TRX_N-00369-62502120,2022-11-23T07:17:34,Galdakao,expenses,transport,-77.39,-30113.69
buyer_4,Jorge,,ES96209506732557392462,TRX_N-00370-86494722,2022-11-23T12:57:19,Galdakao,expenses,education,-75.0,-30188.69
buyer_4,Jorge,,ES96209506732557392462,TRX_N-00371-78074705,2022-11-25T04:15:46,Hondarribia,expenses,food,-88.94,-30277.63
buyer_4,Jorge,,ES96209506732557392462,TRX_N-00372-98545655,2022-11-26T16:01:14,Galdakao,expenses,food,-91.67,-30369.3
buyer_4,Jorge,,ES96209506732557392462,TRX_N-00373-05142002,2022-11-26T10:59:06,Galdakao,expenses,cash,-100.0,-30469.3
buyer_4,Jorge,,ES96209506732557392462,TRX_N-00374-86213166,2022-11-27T20:32:49,Lasarte-Oria,expenses,leisure,-20.16,-30489.46
buyer_4,Jorge,,ES96209506732557392462,TRX_N-00375-83212947,2022-11-29T09:14:20,Galdakao,expenses,transport,-53.29,-30542.75
buyer_4,Jorge,,ES96209506732557392462,TRX_N-00376-54418822,2022-12-01T13:14:21,Galdakao,incomes,salary,2219.21,-28323.54
buyer_4,Jorge,,ES96209506732557392462,TRX_N-00377-50371286,2022-12-01T13:14:21,Galdakao,incomes,extra_income,415.36,-27908.18
buyer_4,Jorge,,ES96209506732557392462,TRX_N-00378-81903621,2022-12-01T13:14:21,Galdakao,incomes,salary_bonus,1728.55,-26179.63
buyer_4,Jorge,,ES96209506732557392462,TRX_N-00379-28947676,2022-12-01T08:08:22,Galdakao,expenses,food,-93.98,-26273.61
buyer_4,Jorge,,ES96209506732557392462,TRX_N-00380-06317261,2022-12-01T10:58:22,Galdakao,expenses,cash,-100.0,-26373.61
buyer_4,Jorge,,ES96209506732557392462,TRX_N-00381-54075268,2022-12-03T18:53:43,Galdakao,expenses,cash,-100.0,-26473.61
buyer_4,Jorge,,ES96209506732557392462,TRX_N-00382-17113618,2022-12-04T18:32:44,Galdakao,expenses,mortgage,-706.56,-27180.17
buyer_4,Jorge,,ES96209506732557392462,TRX_N-00383-05568817,2022-12-04T15:42:38,Galdakao,expenses,transport,-53.87,-27234.04
buyer_4,Jorge,,ES96209506732557392462,TRX_N-00384-59337158,2022-12-05T14:58:27,Galdakao,expenses,gifts,-540.32,-27774.36
buyer_4,Jorge,,ES96209506732557392462,TRX_N-00385-59802063,2022-12-06T14:48:52,Galdakao,expenses,electricity,-50.2,-27824.56
buyer_4,Jorge,,ES96209506732557392462,TRX_N-00386-32469743,2022-12-06T09:48:57,Galdakao,expenses,cash,-100.0,-27924.56
buyer_4,Jorge,,ES96209506732557392462,TRX_N-00387-70977549,2022-12-06T08:33:05,Galdakao,expenses,children,-1178.26,-29102.82
buyer_4,Jorge,,ES96209506732557392462,TRX_N-00388-11160953,2022-12-07T17:44:03,Galdakao,expenses,repairs,-67.49,-29170.31
buyer_4,Jorge,,ES96209506732557392462,TRX_N-00389-46164569,2022-12-08T20:26:47,Galdakao,expenses,gas,-112.52,-29282.83
buyer_4,Jorge,,ES96209506732557392462,TRX_N-00390-72412848,2022-12-08T07:07:24,Galdakao,expenses,water,-41.65,-29324.48
buyer_4,Jorge,,ES96209506732557392462,TRX_N-00391-14950386,2022-12-08T08:16:25,Galdakao,expenses,internet,-42.0,-29366.48
buyer_4,Jorge,,ES96209506732557392462,TRX_N-00392-56078073,2022-12-08T10:17:31,Galdakao,expenses,phone,-42.03,-29408.51
buyer_4,Jorge,,ES96209506732557392462,TRX_N-00393-54052677,2022-12-08T20:09:19,Galdakao,expenses,food,-73.42,-29481.93
buyer_4,Jorge,,ES96209506732557392462,TRX_N-00394-23479664,2022-12-11T14:53:12,Galdakao,expenses,healthcare,-142.54,-29624.47
buyer_4,Jorge,,ES96209506732557392462,TRX_N-00395-42056949,2022-12-12T10:35:47,Galdakao,expenses,cash,-100.0,-29724.47
buyer_4,Jorge,,ES96209506732557392462,TRX_N-00396-98649662,2022-12-12T15:34:43,Galdakao,expenses,repairs,-86.69,-29811.16
buyer_4,Jorge,,ES96209506732557392462,TRX_N-00397-77517201,2022-12-12T09:16:07,Galdakao,expenses,children,-642.24,-30453.4
buyer_4,Jorge,,ES96209506732557392462,TRX_N-00398-47992103,2022-12-13T11:18:01,Galdakao,expenses,gifts,-603.85,-31057.25
buyer_4,Jorge,,ES96209506732557392462,TRX_N-00399-99786777,2022-12-18T11:46:56,Galdakao,expenses,clothing,-133.03,-31190.28
buyer_4,Jorge,,ES96209506732557392462,TRX_N-00400-26457912,2022-12-18T22:47:57,Galdakao,expenses,cash,-100.0,-31290.28
buyer_4,Jorge,,ES96209506732557392462,TRX_N-00401-12763754,2022-12-20T02:47:30,Galdakao,expenses,leisure,-59.16,-31349.44
buyer_4,Jorge,,ES96209506732557392462,TRX_N-00402-66979285,2022-12-21T22:10:24,Galdakao,expenses,gifts,-372.09,-31721.53
buyer_4,Jorge,,ES96209506732557392462,TRX_N-00403-64907983,2022-12-23T13:22:18,Galdakao,expenses,clothing,-87.55,-31809.08
buyer_4,Jorge,,ES96209506732557392462,TRX_N-00404-39208015,2022-12-25T20:14:02,Sopela,expenses,gifts,-139.13,-31948.21
buyer_4,Jorge,,ES96209506732557392462,TRX_N-00405-15985201,2022-12-26T10:49:00,Galdakao,expenses,food,-120.45,-32068.66
buyer_4,Jorge,,ES96209506732557392462,TRX_N-00406-33760264,2022-12-26T10:13:06,Iruña de Oca,expenses,gifts,-131.49,-32200.15
buyer_4,Jorge,,ES96209506732557392462,TRX_N-00407-63113098,2022-12-28T18:36:01,Galdakao,expenses,transport,-56.54,-32256.69
buyer_4,Jorge,,ES96209506732557392462,TRX_N-00408-92198879,2022-12-28T08:29:23,Galdakao,expenses,cash,-100.0,-32356.69
buyer_4,Jorge,,ES96209506732557392462,TRX_N-00409-83835460,2022-12-29T11:53:31,Galdakao,expenses,cash,-100.0,-32456.69
buyer_4,Jorge,,ES96209506732557392462,TRX_N-00410-35663459,2022-12-29T16:57:22,Galdakao,expenses,repairs,-83.59,-32540.28
buyer_4,Jorge,,ES96209506732557392462,TRX_N-00411-60611473,2022-12-30T20:57:43,Galdakao,expenses,transport,-50.92,-32591.2
buyer_4,Jorge,,ES96209506732557392462,TRX_N-00412-93137155,2022-12-30T20:05:39,Galdakao,expenses,leisure,-42.87,-32634.07
buyer_4,Jorge,,ES96209506732557392462,TRX_N-00413-06425572,2022-12-31T08:17:52,Galdakao,expenses,repairs,-163.34,-32797.41
buyer_4,Jorge,,ES96209506732557392462,TRX_N-00414-98102995,2023-01-01T16:57:48,Galdakao,incomes,salary,2287.48,-30509.93
buyer_4,Jorge,,ES96209506732557392462,TRX_N-00415-37288977,2023-01-04T00:38:38,Galdakao,expenses,mortgage,-706.56,-31216.49
buyer_4,Jorge,,ES96209506732557392462,TRX_N-00416-46576394,2023-01-04T12:53:07,Galdakao,expenses,food,-88.42,-31304.91
buyer_4,Jorge,,ES96209506732557392462,TRX_N-00417-80535294,2023-01-04T19:13:37,Galdakao,expenses,appliances,-146.02,-31450.93
buyer_4,Jorge,,ES96209506732557392462,TRX_N-00418-17433772,2023-01-05T20:52:34,Galdakao,expenses,internet,-42.0,-31492.93
buyer_4,Jorge,,ES96209506732557392462,TRX_N-00419-89759463,2023-01-05T15:43:30,Galdakao,expenses,phone,-35.74,-31528.67
buyer_4,Jorge,,ES96209506732557392462,TRX_N-00420-02336674,2023-01-05T11:08:58,Galdakao,expenses,transport,-49.86,-31578.53
buyer_4,Jorge,,ES96209506732557392462,TRX_N-00421-28977348,2023-01-06T14:43:18,Galdakao,expenses,electricity,-87.29,-31665.82
buyer_4,Jorge,,ES96209506732557392462,TRX_N-00422-69813117,2023-01-06T15:41:02,Galdakao,expenses,transport,-75.73,-31741.55
buyer_4,Jorge,,ES96209506732557392462,TRX_N-00423-44161225,2023-01-07T16:27:57,Galdakao,expenses,water,-40.51,-31782.06
buyer_4,Jorge,,ES96209506732557392462,TRX_N-00424-58533429,2023-01-07T11:23:11,Galdakao,expenses,leisure,-64.24,-31846.3
buyer_4,Jorge,,ES96209506732557392462,TRX_N-00425-90123584,2023-01-07T00:56:14,Galdakao,expenses,appliances,-417.26,-32263.56
buyer_4,Jorge,,ES96209506732557392462,TRX_N-00426-55842544,2023-01-08T18:27:58,Galdakao,expenses,gas,-93.98,-32357.54
buyer_4,Jorge,,ES96209506732557392462,TRX_N-00427-44785781,2023-01-08T08:25:01,Galdakao,expenses,food,-70.97,-32428.51
buyer_4,Jorge,,ES96209506732557392462,TRX_N-00428-23626596,2023-01-08T14:46:04,Galdakao,expenses,appliances,-329.33,-32757.84
buyer_4,Jorge,,ES96209506732557392462,TRX_N-00429-19385952,2023-01-09T19:52:08,Galdakao,expenses,leisure,-63.28,-32821.12
buyer_4,Jorge,,ES96209506732557392462,TRX_N-00430-99835440,2023-01-09T12:03:29,Galdakao,expenses,children,-743.23,-33564.35
buyer_4,Jorge,,ES96209506732557392462,TRX_N-00431-29603578,2023-01-10T08:56:05,Hernani,expenses,cash,-100.0,-33664.35
buyer_4,Jorge,,ES96209506732557392462,TRX_N-00432-62433304,2023-01-11T14:28:03,Galdakao,expenses,transport,-61.75,-33726.1
buyer_4,Jorge,,ES96209506732557392462,TRX_N-00433-32837351,2023-01-11T13:16:58,Galdakao,expenses,cash,-100.0,-33826.1
buyer_4,Jorge,,ES96209506732557392462,TRX_N-00434-93703996,2023-01-14T19:34:24,Galdakao,expenses,repairs,-217.65,-34043.75
buyer_4,Jorge,,ES96209506732557392462,TRX_N-00435-03150425,2023-01-16T09:09:25,Galdakao,expenses,leisure,-80.75,-34124.5
buyer_4,Jorge,,ES96209506732557392462,TRX_N-00436-59723189,2023-01-19T20:37:45,Galdakao,expenses,leisure,-29.11,-34153.61
buyer_4,Jorge,,ES96209506732557392462,TRX_N-00437-19073229,2023-01-20T22:11:52,Arrasate,expenses,leisure,-38.98,-34192.59
buyer_4,Jorge,,ES96209506732557392462,TRX_N-00438-07876428,2023-01-21T13:13:54,Vitoria-Gasteiz,expenses,transport,-54.84,-34247.43
buyer_4,Jorge,,ES96209506732557392462,TRX_N-00439-19919067,2023-01-22T13:17:09,Alegría-Dulantzi,expenses,leisure,-79.31,-34326.74
buyer_4,Jorge,,ES96209506732557392462,TRX_N-00440-45003874,2023-01-26T14:10:49,Galdakao,expenses,cash,-100.0,-34426.74
buyer_4,Jorge,,ES96209506732557392462,TRX_N-00441-60402253,2023-01-27T15:40:40,Galdakao,expenses,clothing,-45.67,-34472.41
buyer_4,Jorge,,ES96209506732557392462,TRX_N-00442-61670378,2023-01-29T17:56:57,Galdakao,expenses,food,-112.27,-34584.68
buyer_4,Jorge,,ES96209506732557392462,TRX_N-00443-75694209,2023-01-29T12:02:01,Donostia,expenses,leisure,-42.78,-34627.46
buyer_4,Jorge,,ES96209506732557392462,TRX_N-00444-51706072,2023-01-29T16:30:07,Zuia,expenses,cash,-100.0,-34727.46
buyer_4,Jorge,,ES96209506732557392462,TRX_N-00445-82405760,2023-01-31T08:17:28,Galdakao,expenses,food,-93.33,-34820.79
buyer_4,Jorge,,ES96209506732557392462,TRX_N-00446-77272311,2023-02-01T20:15:40,Galdakao,incomes,salary,2287.48,-32533.31
buyer_4,Jorge,,ES96209506732557392462,TRX_N-00447-76411374,2023-02-01T10:21:47,Berango,expenses,healthcare,-168.94,-32702.25
buyer_4,Jorge,,ES96209506732557392462,TRX_N-00448-06510157,2023-02-02T10:36:55,Galdakao,expenses,transport,-53.72,-32755.97
buyer_4,Jorge,,ES96209506732557392462,TRX_N-00449-99687162,2023-02-02T15:48:11,Galdakao,expenses,cash,-100.0,-32855.97
buyer_4,Jorge,,ES96209506732557392462,TRX_N-00450-34076478,2023-02-04T10:53:52,Galdakao,expenses,mortgage,-706.56,-33562.53
buyer_4,Jorge,,ES96209506732557392462,TRX_N-00451-30630737,2023-02-04T12:05:22,Galdakao,expenses,leisure,-49.67,-33612.2
buyer_4,Jorge,,ES96209506732557392462,TRX_N-00452-82023163,2023-02-04T17:26:52,Galdakao,expenses,cash,-100.0,-33712.2
buyer_4,Jorge,,ES96209506732557392462,TRX_N-00453-91248603,2023-02-04T09:04:10,Galdakao,expenses,repairs,-51.43,-33763.63
buyer_4,Jorge,,ES96209506732557392462,TRX_N-00454-30475136,2023-02-05T10:26:49,Galdakao,expenses,gas,-41.13,-33804.76
buyer_4,Jorge,,ES96209506732557392462,TRX_N-00455-08881736,2023-02-05T13:36:34,Galdakao,expenses,internet,-42.0,-33846.76
buyer_4,Jorge,,ES96209506732557392462,TRX_N-00456-54494242,2023-02-05T18:01:58,Elciego,expenses,food,-109.27,-33956.03
buyer_4,Jorge,,ES96209506732557392462,TRX_N-00457-50639743,2023-02-07T10:34:57,Galdakao,expenses,phone,-38.59,-33994.62
buyer_4,Jorge,,ES96209506732557392462,TRX_N-00458-01801533,2023-02-08T17:38:27,Galdakao,expenses,water,-42.42,-34037.04
buyer_4,Jorge,,ES96209506732557392462,TRX_N-00459-75444104,2023-02-08T17:57:10,Galdakao,expenses,electricity,-53.24,-34090.28
buyer_4,Jorge,,ES96209506732557392462,TRX_N-00460-86418688,2023-02-11T12:00:24,Galdakao,expenses,leisure,-30.15,-34120.43
buyer_4,Jorge,,ES96209506732557392462,TRX_N-00461-58635896,2023-02-11T09:46:00,Galdakao,expenses,car,-328.52,-34448.95
buyer_4,Jorge,,ES96209506732557392462,TRX_N-00462-97111259,2023-02-16T15:25:26,Galdakao,expenses,cash,-100.0,-34548.95
buyer_4,Jorge,,ES96209506732557392462,TRX_N-00463-98743933,2023-02-18T06:22:58,Hondarribia,expenses,food,-123.49,-34672.44
buyer_4,Jorge,,ES96209506732557392462,TRX_N-00464-85858316,2023-02-19T17:24:45,Galdakao,expenses,leisure,-22.1,-34694.54
buyer_4,Jorge,,ES96209506732557392462,TRX_N-00465-86024045,2023-02-19T11:31:12,Galdakao,expenses,gifts,-78.67,-34773.21
buyer_4,Jorge,,ES96209506732557392462,TRX_N-00466-74096705,2023-02-20T06:02:30,Galdakao,expenses,education,-52.33,-34825.54
buyer_4,Jorge,,ES96209506732557392462,TRX_N-00467-37487007,2023-02-21T16:40:39,Galdakao,expenses,transport,-58.63,-34884.17
buyer_4,Jorge,,ES96209506732557392462,TRX_N-00468-06047873,2023-02-25T09:59:00,Galdakao,expenses,leisure,-76.39,-34960.56
buyer_4,Jorge,,ES96209506732557392462,TRX_N-00469-00949344,2023-02-26T08:24:11,Santurtzi,expenses,education,-76.35,-35036.91
buyer_4,Jorge,,ES96209506732557392462,TRX_N-00470-58572356,2023-02-27T19:15:45,Galdakao,expenses,food,-102.57,-35139.48
buyer_4,Jorge,,ES96209506732557392462,TRX_N-00471-96105305,2023-03-01T15:58:17,Galdakao,incomes,salary,2287.48,-32852.0
buyer_4,Jorge,,ES96209506732557392462,TRX_N-00472-61797731,2023-03-02T02:15:23,Galdakao,expenses,repairs,-53.33,-32905.33
buyer_4,Jorge,,ES96209506732557392462,TRX_N-00473-80748302,2023-03-02T07:39:59,Galdakao,expenses,children,-1215.22,-34120.55
buyer_4,Jorge,,ES96209506732557392462,TRX_N-00474-88772808,2023-03-04T15:30:53,Galdakao,expenses,mortgage,-706.56,-34827.11
buyer_4,Jorge,,ES96209506732557392462,TRX_N-00475-66821224,2023-03-04T14:08:06,Galdakao,expenses,food,-112.64,-34939.75
buyer_4,Jorge,,ES96209506732557392462,TRX_N-00476-45340230,2023-03-05T16:39:36,Galdakao,expenses,water,-31.44,-34971.19
buyer_4,Jorge,,ES96209506732557392462,TRX_N-00477-14862580,2023-03-06T22:59:34,Galdakao,expenses,gas,-76.19,-35047.38
buyer_4,Jorge,,ES96209506732557392462,TRX_N-00478-02859650,2023-03-07T12:54:42,Galdakao,expenses,phone,-43.75,-35091.13
buyer_4,Jorge,,ES96209506732557392462,TRX_N-00479-49148298,2023-03-08T20:28:23,Galdakao,expenses,electricity,-41.07,-35132.2
buyer_4,Jorge,,ES96209506732557392462,TRX_N-00480-75142319,2023-03-08T11:17:59,Galdakao,expenses,internet,-42.0,-35174.2
buyer_4,Jorge,,ES96209506732557392462,TRX_N-00481-58442469,2023-03-09T14:29:25,Mungia,expenses,clothing,-108.81,-35283.01
buyer_4,Jorge,,ES96209506732557392462,TRX_N-00482-99106220,2023-03-09T10:10:35,Galdakao,expenses,cash,-100.0,-35383.01
buyer_4,Jorge,,ES96209506732557392462,TRX_N-00483-95931472,2023-03-10T19:08:34,Galdakao,expenses,clothing,-58.2,-35441.21
buyer_4,Jorge,,ES96209506732557392462,TRX_N-00484-84990669,2023-03-12T13:26:25,Galdakao,expenses,leisure,-82.37,-35523.58
buyer_4,Jorge,,ES96209506732557392462,TRX_N-00485-98294827,2023-03-12T18:42:46,Galdakao,expenses,children,-332.98,-35856.56
buyer_4,Jorge,,ES96209506732557392462,TRX_N-00486-68479180,2023-03-13T17:07:56,Galdakao,expenses,leisure,-77.8,-35934.36
buyer_4,Jorge,,ES96209506732557392462,TRX_N-00487-79113562,2023-03-13T12:11:32,Galdakao,expenses,education,-50.54,-35984.9
buyer_4,Jorge,,ES96209506732557392462,TRX_N-00488-19512259,2023-03-13T10:05:10,Galdakao,expenses,cash,-100.0,-36084.9
buyer_4,Jorge,,ES96209506732557392462,TRX_N-00489-62014045,2023-03-14T09:01:00,Galdakao,expenses,food,-118.01,-36202.91
buyer_4,Jorge,,ES96209506732557392462,TRX_N-00490-38742841,2023-03-14T17:57:33,Galdakao,expenses,transport,-89.81,-36292.72
buyer_4,Jorge,,ES96209506732557392462,TRX_N-00491-40319375,2023-03-15T20:27:50,Galdakao,expenses,children,-539.71,-36832.43
buyer_4,Jorge,,ES96209506732557392462,TRX_N-00492-02006596,2023-03-16T15:41:46,Galdakao,expenses,clothing,-92.62,-36925.05
buyer_4,Jorge,,ES96209506732557392462,TRX_N-00493-84203532,2023-03-18T13:11:58,Zuia,expenses,leisure,-81.34,-37006.39
buyer_4,Jorge,,ES96209506732557392462,TRX_N-00494-65865927,2023-03-19T20:19:07,Galdakao,expenses,transport,-53.43,-37059.82
buyer_4,Jorge,,ES96209506732557392462,TRX_N-00495-97839183,2023-03-19T14:33:46,Galdakao,expenses,education,-52.85,-37112.67
buyer_4,Jorge,,ES96209506732557392462,TRX_N-00496-25215648,2023-03-20T12:57:55,Galdakao,expenses,leisure,-64.84,-37177.51
buyer_4,Jorge,,ES96209506732557392462,TRX_N-00497-48487643,2023-03-21T14:11:00,Galdakao,expenses,transport,-87.62,-37265.13
buyer_4,Jorge,,ES96209506732557392462,TRX_N-00498-03980132,2023-03-21T19:58:52,Galdakao,expenses,leisure,-38.7,-37303.83
buyer_4,Jorge,,ES96209506732557392462,TRX_N-00499-13932548,2023-03-21T20:46:02,Errenteria,expenses,repairs,-320.49,-37624.32
buyer_4,Jorge,,ES96209506732557392462,TRX_N-00500-81708577,2023-03-25T19:47:58,Galdakao,expenses,cash,-100.0,-37724.32
buyer_4,Jorge,,ES96209506732557392462,TRX_N-00501-29363353,2023-03-26T08:12:11,Galdakao,expenses,transport,-88.45,-37812.77
buyer_4,Jorge,,ES96209506732557392462,TRX_N-00502-07414466,2023-03-26T09:25:22,Galdakao,expenses,gifts,-628.43,-38441.2
buyer_4,Jorge,,ES96209506732557392462,TRX_N-00503-81486448,2023-03-27T16:08:49,Galdakao,expenses,cash,-100.0,-38541.2
buyer_4,Jorge,,ES96209506732557392462,TRX_N-00504-53391320,2023-03-28T20:04:53,Galdakao,expenses,children,-1019.9,-39561.1
buyer_4,Jorge,,ES96209506732557392462,TRX_N-00505-55128573,2023-03-30T18:11:53,Galdakao,expenses,leisure,-46.93,-39608.03
buyer_4,Jorge,,ES96209506732557392462,TRX_N-00506-61519154,2023-04-01T07:42:52,Galdakao,incomes,salary,2287.48,-37320.55
buyer_4,Jorge,,ES96209506732557392462,TRX_N-00507-05844588,2023-04-01T07:42:52,Galdakao,incomes,extra_income,415.36,-36905.19
buyer_4,Jorge,,ES96209506732557392462,TRX_N-00508-68487675,2023-04-01T17:08:16,Galdakao,expenses,leisure,-71.09,-36976.28
buyer_4,Jorge,,ES96209506732557392462,TRX_N-00509-87599699,2023-04-01T09:27:39,Galdakao,expenses,cash,-100.0,-37076.28
buyer_4,Jorge,,ES96209506732557392462,TRX_N-00510-28689330,2023-04-03T18:00:20,Galdakao,expenses,food,-76.72,-37153.0
buyer_4,Jorge,,ES96209506732557392462,TRX_N-00511-79898199,2023-04-04T04:45:38,Galdakao,expenses,mortgage,-706.56,-37859.56
buyer_4,Jorge,,ES96209506732557392462,TRX_N-00512-50451146,2023-04-04T08:03:27,Salvatierra/Agurain,expenses,leisure,-52.3,-37911.86
buyer_4,Jorge,,ES96209506732557392462,TRX_N-00513-73712460,2023-04-04T14:03:04,Galdakao,expenses,cash,-100.0,-38011.86
buyer_4,Jorge,,ES96209506732557392462,TRX_N-00514-07045985,2023-04-05T09:09:16,Galdakao,expenses,internet,-42.0,-38053.86
buyer_4,Jorge,,ES96209506732557392462,TRX_N-00515-96348935,2023-04-05T04:46:46,Galdakao,expenses,leisure,-81.16,-38135.02
buyer_4,Jorge,,ES96209506732557392462,TRX_N-00516-41085192,2023-04-05T15:13:04,Galdakao,expenses,repairs,-96.47,-38231.49
buyer_4,Jorge,,ES96209506732557392462,TRX_N-00517-86349077,2023-04-07T08:40:06,Galdakao,expenses,electricity,-65.24,-38296.73
buyer_4,Jorge,,ES96209506732557392462,TRX_N-00518-28516027,2023-04-08T16:44:07,Galdakao,expenses,phone,-34.06,-38330.79
buyer_4,Jorge,,ES96209506732557392462,TRX_N-00519-76492095,2023-04-08T08:34:32,Galdakao,expenses,water,-43.72,-38374.51
buyer_4,Jorge,,ES96209506732557392462,TRX_N-00520-81973526,2023-04-08T23:29:42,Galdakao,expenses,gas,-42.37,-38416.88
buyer_4,Jorge,,ES96209506732557392462,TRX_N-00521-07580643,2023-04-12T05:06:27,Galdakao,expenses,food,-94.16,-38511.04
buyer_4,Jorge,,ES96209506732557392462,TRX_N-00522-70990870,2023-04-14T09:52:22,Galdakao,expenses,leisure,-26.39,-38537.43
buyer_4,Jorge,,ES96209506732557392462,TRX_N-00523-53174790,2023-04-17T18:32:53,Galdakao,expenses,cash,-100.0,-38637.43
buyer_4,Jorge,,ES96209506732557392462,TRX_N-00524-04867294,2023-04-17T02:05:20,Galdakao,expenses,gifts,-29.89,-38667.32
buyer_4,Jorge,,ES96209506732557392462,TRX_N-00525-54605629,2023-04-19T08:57:45,Eibar,expenses,food,-88.54,-38755.86
buyer_4,Jorge,,ES96209506732557392462,TRX_N-00526-83607774,2023-04-19T19:02:28,Galdakao,expenses,cash,-100.0,-38855.86
buyer_4,Jorge,,ES96209506732557392462,TRX_N-00527-85466401,2023-04-20T15:07:26,Galdakao,expenses,food,-87.28,-38943.14
buyer_4,Jorge,,ES96209506732557392462,TRX_N-00528-52840418,2023-04-20T13:02:33,Arrasate,expenses,gifts,-635.99,-39579.13
buyer_4,Jorge,,ES96209506732557392462,TRX_N-00529-26865389,2023-04-22T09:47:57,Basauri,expenses,travel,-936.31,-40515.44
buyer_4,Jorge,,ES96209506732557392462,TRX_N-00530-25516669,2023-04-23T22:15:30,Lasarte-Oria,expenses,leisure,-39.57,-40555.01
buyer_4,Jorge,,ES96209506732557392462,TRX_N-00531-65782593,2023-04-24T09:36:49,Galdakao,expenses,leisure,-42.65,-40597.66
buyer_4,Jorge,,ES96209506732557392462,TRX_N-00532-05127697,2023-04-24T10:33:31,Galdakao,expenses,gifts,-795.42,-41393.08
buyer_4,Jorge,,ES96209506732557392462,TRX_N-00533-68631379,2023-04-26T11:25:06,Galdakao,expenses,leisure,-53.78,-41446.86
buyer_4,Jorge,,ES96209506732557392462,TRX_N-00534-17215865,2023-04-26T09:14:29,Galdakao,expenses,gifts,-619.69,-42066.55
buyer_4,Jorge,,ES96209506732557392462,TRX_N-00535-43740223,2023-04-27T20:22:22,Galdakao,expenses,food,-101.21,-42167.76
buyer_4,Jorge,,ES96209506732557392462,TRX_N-00536-02391752,2023-04-27T14:17:58,Galdakao,expenses,leisure,-21.32,-42189.08
buyer_4,Jorge,,ES96209506732557392462,TRX_N-00537-08346613,2023-04-27T17:49:48,Galdakao,expenses,appliances,-379.01,-42568.09
buyer_4,Jorge,,ES96209506732557392462,TRX_N-00538-09984656,2023-04-28T08:13:26,Galdakao,expenses,food,-90.27,-42658.36
buyer_4,Jorge,,ES96209506732557392462,TRX_N-00539-33955243,2023-04-29T22:38:04,Irun,expenses,food,-112.29,-42770.65
buyer_4,Jorge,,ES96209506732557392462,TRX_N-00540-74832344,2023-04-30T18:28:52,Galdakao,expenses,food,-108.24,-42878.89
buyer_4,Jorge,,ES96209506732557392462,TRX_N-00541-86904612,2023-04-30T13:41:02,Galdakao,expenses,education,-70.61,-42949.5
buyer_4,Jorge,,ES96209506732557392462,TRX_N-00542-28444544,2023-04-30T20:38:39,Galdakao,expenses,repairs,-247.93,-43197.43
buyer_4,Jorge,,ES96209506732557392462,TRX_N-00543-59802154,2023-05-01T16:19:31,Galdakao,incomes,salary,2287.48,-40909.95
buyer_4,Jorge,,ES96209506732557392462,TRX_N-00544-54462288,2023-05-02T09:01:50,Bilbao,expenses,repairs,-111.1,-41021.05
buyer_4,Jorge,,ES96209506732557392462,TRX_N-00545-38632396,2023-05-03T15:44:48,Galdakao,expenses,leisure,-45.88,-41066.93
buyer_4,Jorge,,ES96209506732557392462,TRX_N-00546-97303631,2023-05-04T20:29:50,Galdakao,expenses,mortgage,-706.56,-41773.49
buyer_4,Jorge,,ES96209506732557392462,TRX_N-00547-48027474,2023-05-05T13:25:53,Galdakao,expenses,internet,-42.0,-41815.49
buyer_4,Jorge,,ES96209506732557392462,TRX_N-00548-39488461,2023-05-05T12:06:30,Galdakao,expenses,phone,-30.85,-41846.34
buyer_4,Jorge,,ES96209506732557392462,TRX_N-00549-59870348,2023-05-05T12:53:52,Galdakao,expenses,repairs,-303.45,-42149.79
buyer_4,Jorge,,ES96209506732557392462,TRX_N-00550-87108171,2023-05-05T05:30:01,Galdakao,expenses,gifts,-587.97,-42737.76
buyer_4,Jorge,,ES96209506732557392462,TRX_N-00551-04822117,2023-05-06T21:34:45,Galdakao,expenses,gas,-110.82,-42848.58
buyer_4,Jorge,,ES96209506732557392462,TRX_N-00552-42543646,2023-05-07T18:15:19,Galdakao,expenses,electricity,-80.47,-42929.05
buyer_4,Jorge,,ES96209506732557392462,TRX_N-00553-11753326,2023-05-08T09:04:38,Galdakao,expenses,water,-26.14,-42955.19
buyer_4,Jorge,,ES96209506732557392462,TRX_N-00554-37471102,2023-05-09T08:20:47,Galdakao,expenses,leisure,-28.81,-42984.0
buyer_4,Jorge,,ES96209506732557392462,TRX_N-00555-00861933,2023-05-09T17:43:25,Basauri,expenses,healthcare,-69.7,-43053.7
buyer_4,Jorge,,ES96209506732557392462,TRX_N-00556-79927034,2023-05-13T14:08:06,Galdakao,expenses,gifts,-338.34,-43392.04
buyer_4,Jorge,,ES96209506732557392462,TRX_N-00557-93306110,2023-05-15T18:29:31,Galdakao,expenses,clothing,-127.01,-43519.05
buyer_4,Jorge,,ES96209506732557392462,TRX_N-00558-07416169,2023-05-16T04:45:18,Galdakao,expenses,transport,-61.53,-43580.58
buyer_4,Jorge,,ES96209506732557392462,TRX_N-00559-63563248,2023-05-17T15:58:48,Galdakao,expenses,leisure,-47.73,-43628.31
buyer_4,Jorge,,ES96209506732557392462,TRX_N-00560-23616553,2023-05-18T09:42:01,Galdakao,expenses,clothing,-79.65,-43707.96
buyer_4,Jorge,,ES96209506732557392462,TRX_N-00561-29745346,2023-05-19T10:43:56,Galdakao,expenses,repairs,-314.62,-44022.58
buyer_4,Jorge,,ES96209506732557392462,TRX_N-00562-01217975,2023-05-21T09:59:33,Galdakao,expenses,transport,-80.03,-44102.61
buyer_4,Jorge,,ES96209506732557392462,TRX_N-00563-78118125,2023-05-21T13:43:54,Galdakao,expenses,gifts,-234.2,-44336.81
buyer_4,Jorge,,ES96209506732557392462,TRX_N-00564-68187082,2023-05-22T12:46:38,Galdakao,expenses,clothing,-85.43,-44422.24
buyer_4,Jorge,,ES96209506732557392462,TRX_N-00565-27444627,2023-05-24T11:03:38,Galdakao,expenses,food,-98.88,-44521.12
buyer_4,Jorge,,ES96209506732557392462,TRX_N-00566-81939928,2023-05-24T17:53:39,Galdakao,expenses,children,-1283.71,-45804.83
buyer_4,Jorge,,ES96209506732557392462,TRX_N-00567-98957140,2023-05-25T11:30:30,Barakaldo,expenses,repairs,-155.35,-45960.18
buyer_4,Jorge,,ES96209506732557392462,TRX_N-00568-45301977,2023-05-26T12:01:04,Galdakao,expenses,leisure,-77.34,-46037.52
buyer_4,Jorge,,ES96209506732557392462,TRX_N-00569-63897260,2023-05-28T18:50:37,Barakaldo,expenses,food,-113.97,-46151.49
buyer_4,Jorge,,ES96209506732557392462,TRX_N-00570-84099139,2023-05-28T22:15:41,Galdakao,expenses,transport,-84.06,-46235.55
buyer_4,Jorge,,ES96209506732557392462,TRX_N-00571-63823515,2023-05-28T19:45:47,Galdakao,expenses,leisure,-45.14,-46280.69
buyer_4,Jorge,,ES96209506732557392462,TRX_N-00572-37715446,2023-05-28T18:16:15,Galdakao,expenses,clothing,-116.59,-46397.28
buyer_4,Jorge,,ES96209506732557392462,TRX_N-00573-90075626,2023-05-30T20:04:37,Galdakao,expenses,cash,-100.0,-46497.28
buyer_4,Jorge,,ES96209506732557392462,TRX_N-00574-89926124,2023-05-31T19:03:00,Iruña de Oca,expenses,clothing,-125.57,-46622.85
buyer_4,Jorge,,ES96209506732557392462,TRX_N-00575-07261095,2023-06-01T08:25:52,Galdakao,incomes,salary,2287.48,-44335.37
buyer_4,Jorge,,ES96209506732557392462,TRX_N-00576-90191699,2023-06-01T08:25:52,Galdakao,incomes,salary_bonus,1666.07,-42669.3
buyer_4,Jorge,,ES96209506732557392462,TRX_N-00577-93680242,2023-06-04T15:31:22,Galdakao,expenses,mortgage,-706.56,-43375.86
buyer_4,Jorge,,ES96209506732557392462,TRX_N-00578-57207584,2023-06-05T10:53:49,Galdakao,expenses,food,-77.83,-43453.69
buyer_4,Jorge,,ES96209506732557392462,TRX_N-00579-70273084,2023-06-07T13:25:41,Galdakao,expenses,electricity,-68.99,-43522.68
buyer_4,Jorge,,ES96209506732557392462,TRX_N-00580-98931707,2023-06-07T17:38:52,Galdakao,expenses,phone,-34.7,-43557.38
buyer_4,Jorge,,ES96209506732557392462,TRX_N-00581-89220479,2023-06-07T19:36:51,Galdakao,expenses,food,-64.36,-43621.74
buyer_4,Jorge,,ES96209506732557392462,TRX_N-00582-91254961,2023-06-07T09:19:01,Galdakao,expenses,leisure,-53.12,-43674.86
buyer_4,Jorge,,ES96209506732557392462,TRX_N-00583-50838826,2023-06-08T16:46:20,Galdakao,expenses,internet,-42.0,-43716.86
buyer_4,Jorge,,ES96209506732557392462,TRX_N-00584-76366476,2023-06-08T10:12:37,Galdakao,expenses,water,-23.85,-43740.71
buyer_4,Jorge,,ES96209506732557392462,TRX_N-00585-17510978,2023-06-08T15:29:19,Galdakao,expenses,gas,-30.37,-43771.08
buyer_4,Jorge,,ES96209506732557392462,TRX_N-00586-95673834,2023-06-08T22:01:19,Galdakao,expenses,leisure,-62.19,-43833.27
buyer_4,Jorge,,ES96209506732557392462,TRX_N-00587-12222188,2023-06-13T16:17:32,Donostia,expenses,food,-93.6,-43926.87
buyer_4,Jorge,,ES96209506732557392462,TRX_N-00588-64106199,2023-06-14T21:44:56,Galdakao,expenses,gifts,-639.44,-44566.31
buyer_4,Jorge,,ES96209506732557392462,TRX_N-00589-11973515,2023-06-16T13:45:09,Galdakao,expenses,cash,-100.0,-44666.31
buyer_4,Jorge,,ES96209506732557392462,TRX_N-00590-11618394,2023-06-20T20:11:01,Galdakao,expenses,food,-107.09,-44773.4
buyer_4,Jorge,,ES96209506732557392462,TRX_N-00591-86839895,2023-06-20T14:13:07,Galdakao,expenses,cash,-100.0,-44873.4
buyer_4,Jorge,,ES96209506732557392462,TRX_N-00592-99846476,2023-06-22T23:04:04,Galdakao,expenses,cash,-100.0,-44973.4
buyer_4,Jorge,,ES96209506732557392462,TRX_N-00593-34877643,2023-06-23T17:20:54,Galdakao,expenses,children,-1138.37,-46111.77
buyer_4,Jorge,,ES96209506732557392462,TRX_N-00594-09239983,2023-06-24T20:11:08,Galdakao,expenses,transport,-47.51,-46159.28
buyer_4,Jorge,,ES96209506732557392462,TRX_N-00595-59749061,2023-06-25T14:33:04,Galdakao,expenses,cash,-100.0,-46259.28
buyer_4,Jorge,,ES96209506732557392462,TRX_N-00596-75718475,2023-06-26T15:11:57,Galdakao,expenses,gifts,-267.27,-46526.55
buyer_4,Jorge,,ES96209506732557392462,TRX_N-00597-39614211,2023-06-27T20:17:20,Galdakao,expenses,education,-71.74,-46598.29
buyer_4,Jorge,,ES96209506732557392462,TRX_N-00598-78339650,2023-06-29T10:37:10,Labastida,expenses,appliances,-329.88,-46928.17
buyer_4,Jorge,,ES96209506732557392462,TRX_N-00599-68315000,2023-07-01T17:57:55,Galdakao,incomes,salary,2287.48,-44640.69
buyer_4,Jorge,,ES96209506732557392462,TRX_N-00600-92016179,2023-07-02T08:05:46,Iruña de Oca,expenses,education,-51.2,-44691.89
buyer_4,Jorge,,ES96209506732557392462,TRX_N-00601-17312189,2023-07-02T20:48:28,Galdakao,expenses,children,-1175.9,-45867.79
buyer_4,Jorge,,ES96209506732557392462,TRX_N-00602-33288884,2023-07-03T17:31:32,Galdakao,expenses,food,-78.23,-45946.02
buyer_4,Jorge,,ES96209506732557392462,TRX_N-00603-12604113,2023-07-04T23:30:32,Galdakao,expenses,mortgage,-706.56,-46652.58
buyer_4,Jorge,,ES96209506732557392462,TRX_N-00604-69205563,2023-07-04T14:07:24,Galdakao,expenses,leisure,-36.43,-46689.01
buyer_4,Jorge,,ES96209506732557392462,TRX_N-00605-23570878,2023-07-04T05:17:52,Leioa,expenses,education,-73.05,-46762.06
buyer_4,Jorge,,ES96209506732557392462,TRX_N-00606-13548509,2023-07-05T23:52:49,Galdakao,expenses,electricity,-52.54,-46814.6
buyer_4,Jorge,,ES96209506732557392462,TRX_N-00607-25727202,2023-07-05T09:17:25,Galdakao,expenses,gas,-110.36,-46924.96
buyer_4,Jorge,,ES96209506732557392462,TRX_N-00608-08935468,2023-07-05T15:23:57,Galdakao,expenses,internet,-42.0,-46966.96
buyer_4,Jorge,,ES96209506732557392462,TRX_N-00609-84786198,2023-07-05T22:36:05,Galdakao,expenses,phone,-43.74,-47010.7
buyer_4,Jorge,,ES96209506732557392462,TRX_N-00610-36462925,2023-07-05T19:55:29,Galdakao,expenses,cash,-100.0,-47110.7
buyer_4,Jorge,,ES96209506732557392462,TRX_N-00611-02258347,2023-07-08T00:55:24,Galdakao,expenses,water,-44.95,-47155.65
buyer_4,Jorge,,ES96209506732557392462,TRX_N-00612-28363866,2023-07-08T22:52:43,Galdakao,expenses,children,-1160.98,-48316.63
buyer_4,Jorge,,ES96209506732557392462,TRX_N-00613-83577633,2023-07-11T15:02:20,Galdakao,expenses,healthcare,-153.11,-48469.74
buyer_4,Jorge,,ES96209506732557392462,TRX_N-00614-96808139,2023-07-11T13:49:34,Sopela,expenses,education,-71.46,-48541.2
buyer_4,Jorge,,ES96209506732557392462,TRX_N-00615-70083578,2023-07-13T08:50:37,Galdakao,expenses,cash,-100.0,-48641.2
buyer_4,Jorge,,ES96209506732557392462,TRX_N-00616-76605467,2023-07-14T13:46:32,Galdakao,expenses,food,-109.91,-48751.11
buyer_4,Jorge,,ES96209506732557392462,TRX_N-00617-56302818,2023-07-14T15:36:25,Galdakao,expenses,leisure,-20.09,-48771.2
buyer_4,Jorge,,ES96209506732557392462,TRX_N-00618-70464660,2023-07-14T16:59:30,Galdakao,expenses,education,-54.93,-48826.13
buyer_4,Jorge,,ES96209506732557392462,TRX_N-00619-84770973,2023-07-15T16:06:00,Erandio,expenses,transport,-76.65,-48902.78
buyer_4,Jorge,,ES96209506732557392462,TRX_N-00620-64707561,2023-07-16T08:16:33,Hondarribia,expenses,education,-55.42,-48958.2
buyer_4,Jorge,,ES96209506732557392462,TRX_N-00621-26294768,2023-07-17T09:43:06,Barakaldo,expenses,food,-103.1,-49061.3
buyer_4,Jorge,,ES96209506732557392462,TRX_N-00622-06708348,2023-07-17T11:24:27,Galdakao,expenses,transport,-73.4,-49134.7
buyer_4,Jorge,,ES96209506732557392462,TRX_N-00623-63060772,2023-07-17T16:14:05,Galdakao,expenses,leisure,-24.41,-49159.11
buyer_4,Jorge,,ES96209506732557392462,TRX_N-00624-14896357,2023-07-17T10:15:52,Galdakao,expenses,cash,-100.0,-49259.11
buyer_4,Jorge,,ES96209506732557392462,TRX_N-00625-58448429,2023-07-18T12:43:33,Galdakao,expenses,food,-94.79,-49353.9
buyer_4,Jorge,,ES96209506732557392462,TRX_N-00626-79835482,2023-07-18T11:37:25,Galdakao,expenses,education,-53.69,-49407.59
buyer_4,Jorge,,ES96209506732557392462,TRX_N-00627-23536864,2023-07-18T14:05:39,Galdakao,expenses,children,-792.05,-50199.64
buyer_4,Jorge,,ES96209506732557392462,TRX_N-00628-07031367,2023-07-19T05:33:09,Galdakao,expenses,food,-62.93,-50262.57
buyer_4,Jorge,,ES96209506732557392462,TRX_N-00629-95784073,2023-07-19T04:12:12,Zarautz,expenses,cash,-100.0,-50362.57
buyer_4,Jorge,,ES96209506732557392462,TRX_N-00630-13972899,2023-07-21T18:53:22,Galdakao,expenses,food,-91.16,-50453.73
buyer_4,Jorge,,ES96209506732557392462,TRX_N-00631-68324089,2023-07-21T08:40:56,Galdakao,expenses,cash,-100.0,-50553.73
buyer_4,Jorge,,ES96209506732557392462,TRX_N-00632-25161780,2023-07-22T16:42:42,Galdakao,expenses,children,-1258.99,-51812.72
buyer_4,Jorge,,ES96209506732557392462,TRX_N-00633-82591700,2023-07-24T17:59:42,Lasarte-Oria,expenses,appliances,-113.34,-51926.06
buyer_4,Jorge,,ES96209506732557392462,TRX_N-00634-09294899,2023-07-25T12:22:42,Galdakao,expenses,cash,-100.0,-52026.06
buyer_4,Jorge,,ES96209506732557392462,TRX_N-00635-14614286,2023-07-25T09:31:02,Galdakao,expenses,repairs,-229.7,-52255.76
buyer_4,Jorge,,ES96209506732557392462,TRX_N-00636-65947422,2023-07-26T06:56:00,Galdakao,expenses,appliances,-222.0,-52477.76
buyer_4,Jorge,,ES96209506732557392462,TRX_N-00637-38583690,2023-07-27T12:11:09,Galdakao,expenses,leisure,-49.79,-52527.55
buyer_4,Jorge,,ES96209506732557392462,TRX_N-00638-30139982,2023-07-27T18:31:04,Galdakao,expenses,healthcare,-108.62,-52636.17
buyer_4,Jorge,,ES96209506732557392462,TRX_N-00639-95232271,2023-07-27T13:03:16,Galdakao,expenses,cash,-100.0,-52736.17
buyer_4,Jorge,,ES96209506732557392462,TRX_N-00640-46814872,2023-07-28T15:28:26,Galdakao,expenses,leisure,-50.42,-52786.59
buyer_4,Jorge,,ES96209506732557392462,TRX_N-00641-65687977,2023-07-29T22:14:29,Basauri,expenses,transport,-70.4,-52856.99
buyer_4,Jorge,,ES96209506732557392462,TRX_N-00642-55967890,2023-07-29T12:32:11,Galdakao,expenses,leisure,-82.02,-52939.01
buyer_4,Jorge,,ES96209506732557392462,TRX_N-00643-89321589,2023-07-29T14:09:38,Galdakao,expenses,cash,-100.0,-53039.01
buyer_4,Jorge,,ES96209506732557392462,TRX_N-00644-76465068,2023-07-29T11:05:52,Galdakao,expenses,appliances,-125.17,-53164.18
buyer_4,Jorge,,ES96209506732557392462,TRX_N-00645-04847535,2023-07-30T16:44:35,Galdakao,expenses,education,-61.48,-53225.66
buyer_4,Jorge,,ES96209506732557392462,TRX_N-00646-66694534,2023-07-31T20:15:37,Errenteria,expenses,appliances,-171.64,-53397.3
buyer_4,Jorge,,ES96209506732557392462,TRX_N-00647-59898035,2023-08-01T18:26:36,Galdakao,incomes,salary,2287.48,-51109.82
buyer_4,Jorge,,ES96209506732557392462,TRX_N-00648-14002382,2023-08-01T18:26:36,Galdakao,incomes,extra_income,415.36,-50694.46
buyer_4,Jorge,,ES96209506732557392462,TRX_N-00649-77491779,2023-08-01T14:59:42,Galdakao,expenses,education,-58.69,-50753.15
buyer_4,Jorge,,ES96209506732557392462,TRX_N-00650-89929968,2023-08-02T10:03:57,Galdakao,expenses,leisure,-81.87,-50835.02
buyer_4,Jorge,,ES96209506732557392462,TRX_N-00651-51423160,2023-08-03T23:29:14,Galdakao,expenses,repairs,-246.48,-51081.5
buyer_4,Jorge,,ES96209506732557392462,TRX_N-00652-18361258,2023-08-04T00:25:07,Galdakao,expenses,mortgage,-706.56,-51788.06
buyer_4,Jorge,,ES96209506732557392462,TRX_N-00653-49868613,2023-08-05T13:28:44,Galdakao,expenses,electricity,-55.41,-51843.47
buyer_4,Jorge,,ES96209506732557392462,TRX_N-00654-68365154,2023-08-05T11:04:13,Galdakao,expenses,gas,-39.55,-51883.02
buyer_4,Jorge,,ES96209506732557392462,TRX_N-00655-86599013,2023-08-05T13:50:11,Galdakao,expenses,internet,-42.0,-51925.02
buyer_4,Jorge,,ES96209506732557392462,TRX_N-00656-45019021,2023-08-05T12:48:35,Andoain,expenses,cash,-100.0,-52025.02
buyer_4,Jorge,,ES96209506732557392462,TRX_N-00657-02241455,2023-08-06T19:59:01,Galdakao,expenses,cash,-100.0,-52125.02
buyer_4,Jorge,,ES96209506732557392462,TRX_N-00658-86394842,2023-08-07T23:38:14,Galdakao,expenses,water,-30.22,-52155.24
buyer_4,Jorge,,ES96209506732557392462,TRX_N-00659-54683543,2023-08-07T18:29:41,Galdakao,expenses,phone,-44.98,-52200.22
buyer_4,Jorge,,ES96209506732557392462,TRX_N-00660-24711608,2023-08-07T17:39:05,Galdakao,expenses,food,-110.79,-52311.01
buyer_4,Jorge,,ES96209506732557392462,TRX_N-00661-51203315,2023-08-09T12:14:33,Galdakao,expenses,transport,-53.74,-52364.75
buyer_4,Jorge,,ES96209506732557392462,TRX_N-00662-90553468,2023-08-10T19:42:48,Galdakao,expenses,education,-66.74,-52431.49
buyer_4,Jorge,,ES96209506732557392462,TRX_N-00663-39749788,2023-08-10T14:22:38,Galdakao,expenses,cash,-100.0,-52531.49
buyer_4,Jorge,,ES96209506732557392462,TRX_N-00664-03500452,2023-08-10T08:32:30,Galdakao,expenses,repairs,-207.63,-52739.12
buyer_4,Jorge,,ES96209506732557392462,TRX_N-00665-26681334,2023-08-14T20:57:28,Galdakao,expenses,leisure,-42.66,-52781.78
buyer_4,Jorge,,ES96209506732557392462,TRX_N-00666-49799224,2023-08-17T09:08:50,Galdakao,expenses,food,-98.77,-52880.55
buyer_4,Jorge,,ES96209506732557392462,TRX_N-00667-32892091,2023-08-17T14:58:10,Iruña de Oca,expenses,leisure,-28.05,-52908.6
buyer_4,Jorge,,ES96209506732557392462,TRX_N-00668-17641055,2023-08-17T13:08:16,Galdakao,expenses,repairs,-280.79,-53189.39
buyer_4,Jorge,,ES96209506732557392462,TRX_N-00669-49191933,2023-08-18T09:08:55,Galdakao,expenses,cash,-100.0,-53289.39
buyer_4,Jorge,,ES96209506732557392462,TRX_N-00670-40946540,2023-08-18T19:48:47,Galdakao,expenses,children,-301.3,-53590.69
buyer_4,Jorge,,ES96209506732557392462,TRX_N-00671-66783361,2023-08-20T23:31:51,Galdakao,expenses,cash,-100.0,-53690.69
buyer_4,Jorge,,ES96209506732557392462,TRX_N-00672-18886954,2023-08-21T16:27:50,Galdakao,expenses,appliances,-134.01,-53824.7
buyer_4,Jorge,,ES96209506732557392462,TRX_N-00673-42889958,2023-08-22T18:25:20,Durango,expenses,food,-64.32,-53889.02
buyer_4,Jorge,,ES96209506732557392462,TRX_N-00674-03904197,2023-08-23T19:54:27,Galdakao,expenses,transport,-88.82,-53977.84
buyer_4,Jorge,,ES96209506732557392462,TRX_N-00675-58850031,2023-08-24T13:44:22,Galdakao,expenses,children,-242.45,-54220.29
buyer_4,Jorge,,ES96209506732557392462,TRX_N-00676-37104517,2023-08-26T08:16:10,Galdakao,expenses,clothing,-64.75,-54285.04
buyer_4,Jorge,,ES96209506732557392462,TRX_N-00677-54692907,2023-08-27T12:08:16,Galdakao,expenses,cash,-100.0,-54385.04
buyer_4,Jorge,,ES96209506732557392462,TRX_N-00678-56510337,2023-08-27T08:33:25,Alegría-Dulantzi,expenses,repairs,-272.07,-54657.11
buyer_4,Jorge,,ES96209506732557392462,TRX_N-00679-59838343,2023-08-28T20:20:41,Galdakao,expenses,healthcare,-183.8,-54840.91
buyer_4,Jorge,,ES96209506732557392462,TRX_N-00680-25581713,2023-08-31T19:11:43,Bermeo,expenses,food,-82.36,-54923.27
buyer_4,Jorge,,ES96209506732557392462,TRX_N-00681-99588134,2023-08-31T02:32:10,Galdakao,expenses,leisure,-40.8,-54964.07
buyer_4,Jorge,,ES96209506732557392462,TRX_N-00682-47962720,2023-08-31T20:08:49,Galdakao,expenses,gifts,-287.45,-55251.52
buyer_4,Jorge,,ES96209506732557392462,TRX_N-00683-63856636,2023-09-01T17:19:42,Galdakao,incomes,salary,2287.48,-52964.04
buyer_4,Jorge,,ES96209506732557392462,TRX_N-00684-79435025,2023-09-01T13:35:00,Galdakao,expenses,travel,-1505.27,-54469.31
buyer_4,Jorge,,ES96209506732557392462,TRX_N-00685-09055186,2023-09-02T12:40:23,Galdakao,expenses,transport,-89.95,-54559.26
buyer_4,Jorge,,ES96209506732557392462,TRX_N-00686-22841478,2023-09-02T15:12:12,Bilbao,expenses,leisure,-29.52,-54588.78
buyer_4,Jorge,,ES96209506732557392462,TRX_N-00687-45492719,2023-09-04T16:42:13,Galdakao,expenses,mortgage,-706.56,-55295.34
buyer_4,Jorge,,ES96209506732557392462,TRX_N-00688-99127170,2023-09-04T18:52:35,Galdakao,expenses,cash,-100.0,-55395.34
buyer_4,Jorge,,ES96209506732557392462,TRX_N-00689-06736757,2023-09-04T16:25:48,Irun,expenses,appliances,-262.62,-55657.96
buyer_4,Jorge,,ES96209506732557392462,TRX_N-00690-87055027,2023-09-04T08:07:58,Galdakao,expenses,children,-681.5,-56339.46
buyer_4,Jorge,,ES96209506732557392462,TRX_N-00691-26346144,2023-09-05T17:14:14,Galdakao,expenses,water,-28.78,-56368.24
buyer_4,Jorge,,ES96209506732557392462,TRX_N-00692-18859931,2023-09-05T17:02:39,Galdakao,expenses,internet,-42.0,-56410.24
buyer_4,Jorge,,ES96209506732557392462,TRX_N-00693-02782071,2023-09-05T11:45:15,Vitoria-Gasteiz,expenses,food,-104.61,-56514.85
buyer_4,Jorge,,ES96209506732557392462,TRX_N-00694-56752667,2023-09-05T13:42:22,Sopela,expenses,leisure,-80.85,-56595.7
buyer_4,Jorge,,ES96209506732557392462,TRX_N-00695-28062235,2023-09-06T13:52:42,Galdakao,expenses,electricity,-76.73,-56672.43
buyer_4,Jorge,,ES96209506732557392462,TRX_N-00696-60466805,2023-09-06T09:57:32,Galdakao,expenses,phone,-40.59,-56713.02
buyer_4,Jorge,,ES96209506732557392462,TRX_N-00697-01546767,2023-09-06T17:54:25,Durango,expenses,food,-103.36,-56816.38
buyer_4,Jorge,,ES96209506732557392462,TRX_N-00698-96299602,2023-09-06T09:54:28,Amurrio,expenses,transport,-83.23,-56899.61
buyer_4,Jorge,,ES96209506732557392462,TRX_N-00699-66328585,2023-09-08T12:37:46,Galdakao,expenses,gas,-85.41,-56985.02
buyer_4,Jorge,,ES96209506732557392462,TRX_N-00700-17438465,2023-09-09T08:24:31,Galdakao,expenses,children,-851.57,-57836.59
buyer_4,Jorge,,ES96209506732557392462,TRX_N-00701-79191572,2023-09-11T19:02:59,Galdakao,expenses,cash,-100.0,-57936.59
buyer_4,Jorge,,ES96209506732557392462,TRX_N-00702-84973700,2023-09-12T17:35:42,Galdakao,expenses,leisure,-26.56,-57963.15
buyer_4,Jorge,,ES96209506732557392462,TRX_N-00703-57915470,2023-09-13T08:39:36,Galdakao,expenses,food,-115.11,-58078.26
buyer_4,Jorge,,ES96209506732557392462,TRX_N-00704-79010899,2023-09-13T13:40:56,Galdakao,expenses,repairs,-217.89,-58296.15
buyer_4,Jorge,,ES96209506732557392462,TRX_N-00705-51042723,2023-09-14T14:08:16,Getxo,expenses,food,-105.87,-58402.02
buyer_4,Jorge,,ES96209506732557392462,TRX_N-00706-00066427,2023-09-14T20:43:14,Errenteria,expenses,travel,-509.61,-58911.63
buyer_4,Jorge,,ES96209506732557392462,TRX_N-00707-41557121,2023-09-14T14:17:58,Galdakao,expenses,gifts,-559.78,-59471.41
buyer_4,Jorge,,ES96209506732557392462,TRX_N-00708-40708471,2023-09-15T10:27:47,Galdakao,expenses,cash,-100.0,-59571.41
buyer_4,Jorge,,ES96209506732557392462,TRX_N-00709-03285345,2023-09-16T03:56:52,Galdakao,expenses,cash,-100.0,-59671.41
buyer_4,Jorge,,ES96209506732557392462,TRX_N-00710-59971771,2023-09-17T18:46:57,Hondarribia,expenses,food,-90.14,-59761.55
buyer_4,Jorge,,ES96209506732557392462,TRX_N-00711-89003278,2023-09-18T15:54:17,Galdakao,expenses,clothing,-93.08,-59854.63
buyer_4,Jorge,,ES96209506732557392462,TRX_N-00712-66869932,2023-09-19T07:56:30,Galdakao,expenses,cash,-100.0,-59954.63
buyer_4,Jorge,,ES96209506732557392462,TRX_N-00713-81163071,2023-09-20T17:15:32,Galdakao,expenses,transport,-86.84,-60041.47
buyer_4,Jorge,,ES96209506732557392462,TRX_N-00714-28133286,2023-09-20T13:32:31,Galdakao,expenses,gifts,-47.86,-60089.33
buyer_4,Jorge,,ES96209506732557392462,TRX_N-00715-52523520,2023-09-22T20:19:53,Galdakao,expenses,cash,-100.0,-60189.33
buyer_4,Jorge,,ES96209506732557392462,TRX_N-00716-59411383,2023-09-23T20:13:53,Galdakao,expenses,leisure,-24.5,-60213.83
buyer_4,Jorge,,ES96209506732557392462,TRX_N-00717-11054060,2023-09-24T09:12:19,Galdakao,expenses,food,-77.23,-60291.06
buyer_4,Jorge,,ES96209506732557392462,TRX_N-00718-58974090,2023-09-24T15:52:51,Galdakao,expenses,transport,-43.43,-60334.49
buyer_4,Jorge,,ES96209506732557392462,TRX_N-00719-16669589,2023-09-24T20:49:26,Getxo,expenses,cash,-100.0,-60434.49
buyer_4,Jorge,,ES96209506732557392462,TRX_N-00720-12051848,2023-09-25T11:39:08,Zarautz,expenses,transport,-79.68,-60514.17
buyer_4,Jorge,,ES96209506732557392462,TRX_N-00721-41544462,2023-09-25T21:08:56,Galdakao,expenses,leisure,-67.42,-60581.59
buyer_4,Jorge,,ES96209506732557392462,TRX_N-00722-84863861,2023-09-28T02:22:17,Galdakao,expenses,cash,-100.0,-60681.59
buyer_4,Jorge,,ES96209506732557392462,TRX_N-00723-20981498,2023-09-28T19:43:41,Galdakao,expenses,gifts,-712.17,-61393.76
buyer_4,Jorge,,ES96209506732557392462,TRX_N-00724-52115087,2023-09-28T13:36:33,Galdakao,expenses,children,-352.03,-61745.79
buyer_4,Jorge,,ES96209506732557392462,TRX_N-00725-84504987,2023-09-29T04:59:23,Galdakao,expenses,clothing,-129.95,-61875.74
buyer_4,Jorge,,ES96209506732557392462,TRX_N-00726-44867357,2023-10-01T19:41:52,Galdakao,incomes,salary,2287.48,-59588.26
buyer_4,Jorge,,ES96209506732557392462,TRX_N-00727-14424276,2023-10-04T16:44:18,Galdakao,expenses,mortgage,-706.56,-60294.82
buyer_4,Jorge,,ES96209506732557392462,TRX_N-00728-64482908,2023-10-05T12:30:26,Galdakao,expenses,phone,-30.0,-60324.82
buyer_4,Jorge,,ES96209506732557392462,TRX_N-00729-57259688,2023-10-05T09:49:24,Berango,expenses,food,-76.29,-60401.11
buyer_4,Jorge,,ES96209506732557392462,TRX_N-00730-57578693,2023-10-06T08:58:43,Galdakao,expenses,water,-42.0,-60443.11
buyer_4,Jorge,,ES96209506732557392462,TRX_N-00731-62480457,2023-10-06T07:32:56,Galdakao,expenses,gas,-110.22,-60553.33
buyer_4,Jorge,,ES96209506732557392462,TRX_N-00732-32277549,2023-10-06T14:34:45,Galdakao,expenses,internet,-42.0,-60595.33
buyer_4,Jorge,,ES96209506732557392462,TRX_N-00733-04730224,2023-10-06T11:13:19,Galdakao,expenses,food,-106.29,-60701.62
buyer_4,Jorge,,ES96209506732557392462,TRX_N-00734-90564416,2023-10-06T10:15:18,Galdakao,expenses,cash,-100.0,-60801.62
buyer_4,Jorge,,ES96209506732557392462,TRX_N-00735-30599686,2023-10-07T13:39:17,Galdakao,expenses,food,-94.42,-60896.04
buyer_4,Jorge,,ES96209506732557392462,TRX_N-00736-67850485,2023-10-07T08:29:42,Galdakao,expenses,cash,-100.0,-60996.04
buyer_4,Jorge,,ES96209506732557392462,TRX_N-00737-10061426,2023-10-08T12:30:45,Galdakao,expenses,electricity,-45.1,-61041.14
buyer_4,Jorge,,ES96209506732557392462,TRX_N-00738-40555166,2023-10-08T11:31:45,Galdakao,expenses,leisure,-54.27,-61095.41
buyer_4,Jorge,,ES96209506732557392462,TRX_N-00739-72139472,2023-10-08T16:00:49,Galdakao,expenses,education,-53.3,-61148.71
buyer_4,Jorge,,ES96209506732557392462,TRX_N-00740-15998863,2023-10-09T10:25:17,Galdakao,expenses,cash,-100.0,-61248.71
buyer_4,Jorge,,ES96209506732557392462,TRX_N-00741-80693910,2023-10-09T23:01:33,Galdakao,expenses,repairs,-127.41,-61376.12
buyer_4,Jorge,,ES96209506732557392462,TRX_N-00742-39123792,2023-10-12T13:24:58,Galdakao,expenses,leisure,-83.12,-61459.24
buyer_4,Jorge,,ES96209506732557392462,TRX_N-00743-89239314,2023-10-12T13:14:10,Galdakao,expenses,cash,-100.0,-61559.24
buyer_4,Jorge,,ES96209506732557392462,TRX_N-00744-15900560,2023-10-13T17:16:32,Galdakao,expenses,leisure,-67.47,-61626.71
buyer_4,Jorge,,ES96209506732557392462,TRX_N-00745-65940215,2023-10-13T12:56:25,Labastida,expenses,cash,-100.0,-61726.71
buyer_4,Jorge,,ES96209506732557392462,TRX_N-00746-73773950,2023-10-14T08:29:33,Galdakao,expenses,food,-104.14,-61830.85
buyer_4,Jorge,,ES96209506732557392462,TRX_N-00747-68941191,2023-10-15T16:53:32,Errenteria,expenses,leisure,-24.37,-61855.22
buyer_4,Jorge,,ES96209506732557392462,TRX_N-00748-17723978,2023-10-15T09:53:58,Galdakao,expenses,clothing,-142.14,-61997.36
buyer_4,Jorge,,ES96209506732557392462,TRX_N-00749-82033121,2023-10-15T14:31:38,Galdakao,expenses,education,-62.23,-62059.59
buyer_4,Jorge,,ES96209506732557392462,TRX_N-00750-62728856,2023-10-16T20:47:26,Galdakao,expenses,food,-90.96,-62150.55
buyer_4,Jorge,,ES96209506732557392462,TRX_N-00751-19681958,2023-10-17T16:26:59,Mungia,expenses,food,-119.64,-62270.19
buyer_4,Jorge,,ES96209506732557392462,TRX_N-00752-51502030,2023-10-17T18:59:59,Galdakao,expenses,education,-73.45,-62343.64
buyer_4,Jorge,,ES96209506732557392462,TRX_N-00753-48764742,2023-10-19T10:55:04,Galdakao,expenses,leisure,-25.66,-62369.3
buyer_4,Jorge,,ES96209506732557392462,TRX_N-00754-79988959,2023-10-20T17:53:22,Galdakao,expenses,leisure,-30.49,-62399.79
buyer_4,Jorge,,ES96209506732557392462,TRX_N-00755-14484994,2023-10-21T07:16:04,Galdakao,expenses,leisure,-52.63,-62452.42
buyer_4,Jorge,,ES96209506732557392462,TRX_N-00756-90760388,2023-10-21T20:47:12,Alegría-Dulantzi,expenses,clothing,-102.07,-62554.49
buyer_4,Jorge,,ES96209506732557392462,TRX_N-00757-09746845,2023-10-23T18:48:21,Galdakao,expenses,transport,-86.59,-62641.08
buyer_4,Jorge,,ES96209506732557392462,TRX_N-00758-79772983,2023-10-25T17:33:19,Galdakao,expenses,appliances,-147.63,-62788.71
buyer_4,Jorge,,ES96209506732557392462,TRX_N-00759-47036841,2023-10-26T08:26:53,Galdakao,expenses,cash,-100.0,-62888.71
buyer_4,Jorge,,ES96209506732557392462,TRX_N-00760-31150339,2023-10-28T20:22:17,Galdakao,expenses,transport,-42.2,-62930.91
buyer_4,Jorge,,ES96209506732557392462,TRX_N-00761-08627381,2023-10-28T15:51:28,Galdakao,expenses,cash,-100.0,-63030.91
buyer_4,Jorge,,ES96209506732557392462,TRX_N-00762-71235541,2023-10-29T04:55:47,Galdakao,expenses,food,-61.7,-63092.61
buyer_4,Jorge,,ES96209506732557392462,TRX_N-00763-38893749,2023-10-29T06:50:53,Bermeo,expenses,transport,-81.85,-63174.46
buyer_4,Jorge,,ES96209506732557392462,TRX_N-00764-09575391,2023-10-29T11:35:42,Galdakao,expenses,cash,-100.0,-63274.46
buyer_4,Jorge,,ES96209506732557392462,TRX_N-00765-10293453,2023-11-01T20:57:46,Galdakao,incomes,salary,2287.48,-60986.98
buyer_4,Jorge,,ES96209506732557392462,TRX_N-00766-45119294,2023-11-01T20:57:46,Galdakao,incomes,extra_income,415.36,-60571.62
buyer_4,Jorge,,ES96209506732557392462,TRX_N-00767-58321861,2023-11-04T15:41:27,Galdakao,expenses,mortgage,-706.56,-61278.18
buyer_4,Jorge,,ES96209506732557392462,TRX_N-00768-14101138,2023-11-05T09:33:10,Galdakao,expenses,internet,-42.0,-61320.18
buyer_4,Jorge,,ES96209506732557392462,TRX_N-00769-34765739,2023-11-07T18:32:28,Galdakao,expenses,transport,-82.04,-61402.22
buyer_4,Jorge,,ES96209506732557392462,TRX_N-00770-56273848,2023-11-07T23:30:42,Galdakao,expenses,repairs,-98.88,-61501.1
buyer_4,Jorge,,ES96209506732557392462,TRX_N-00771-64738305,2023-11-08T09:41:15,Galdakao,expenses,electricity,-49.25,-61550.35
buyer_4,Jorge,,ES96209506732557392462,TRX_N-00772-94147504,2023-11-08T16:45:24,Galdakao,expenses,phone,-32.66,-61583.01
buyer_4,Jorge,,ES96209506732557392462,TRX_N-00773-21119779,2023-11-08T16:29:05,Galdakao,expenses,water,-33.29,-61616.3
buyer_4,Jorge,,ES96209506732557392462,TRX_N-00774-85408723,2023-11-08T12:04:23,Galdakao,expenses,gas,-55.22,-61671.52
buyer_4,Jorge,,ES96209506732557392462,TRX_N-00775-64302474,2023-11-08T20:44:56,Galdakao,expenses,transport,-79.93,-61751.45
buyer_4,Jorge,,ES96209506732557392462,TRX_N-00776-11701571,2023-11-09T05:55:50,Galdakao,expenses,food,-69.64,-61821.09
buyer_4,Jorge,,ES96209506732557392462,TRX_N-00777-51973021,2023-11-11T10:26:28,Pasaia,expenses,education,-55.54,-61876.63
buyer_4,Jorge,,ES96209506732557392462,TRX_N-00778-79415172,2023-11-12T08:46:38,Sestao,expenses,education,-52.97,-61929.6
buyer_4,Jorge,,ES96209506732557392462,TRX_N-00779-94634302,2023-11-13T11:19:24,Galdakao,expenses,leisure,-63.92,-61993.52
buyer_4,Jorge,,ES96209506732557392462,TRX_N-00780-35520406,2023-11-13T14:02:24,Galdakao,expenses,cash,-100.0,-62093.52
buyer_4,Jorge,,ES96209506732557392462,TRX_N-00781-74245288,2023-11-14T12:51:48,Galdakao,expenses,cash,-100.0,-62193.52
buyer_4,Jorge,,ES96209506732557392462,TRX_N-00782-15104804,2023-11-15T12:57:15,Portugalete,expenses,food,-111.85,-62305.37
buyer_4,Jorge,,ES96209506732557392462,TRX_N-00783-88326448,2023-11-15T20:48:15,Galdakao,expenses,cash,-100.0,-62405.37
buyer_4,Jorge,,ES96209506732557392462,TRX_N-00784-84106101,2023-11-16T16:54:34,Galdakao,expenses,leisure,-45.39,-62450.76
buyer_4,Jorge,,ES96209506732557392462,TRX_N-00785-62060421,2023-11-16T18:48:47,Galdakao,expenses,clothing,-126.86,-62577.62
buyer_4,Jorge,,ES96209506732557392462,TRX_N-00786-01963000,2023-11-19T10:55:23,Amurrio,expenses,cash,-100.0,-62677.62
buyer_4,Jorge,,ES96209506732557392462,TRX_N-00787-16086331,2023-11-20T14:43:34,Galdakao,expenses,leisure,-54.69,-62732.31
buyer_4,Jorge,,ES96209506732557392462,TRX_N-00788-59857141,2023-11-20T16:19:46,Galdakao,expenses,education,-62.54,-62794.85
buyer_4,Jorge,,ES96209506732557392462,TRX_N-00789-11956618,2023-11-21T12:48:50,Andoain,expenses,cash,-100.0,-62894.85
buyer_4,Jorge,,ES96209506732557392462,TRX_N-00790-98768864,2023-11-22T23:12:58,Galdakao,expenses,clothing,-56.64,-62951.49
buyer_4,Jorge,,ES96209506732557392462,TRX_N-00791-65873004,2023-11-24T11:22:28,Galdakao,expenses,cash,-100.0,-63051.49
buyer_4,Jorge,,ES96209506732557392462,TRX_N-00792-12083435,2023-11-26T09:00:19,Errenteria,expenses,food,-117.94,-63169.43
buyer_4,Jorge,,ES96209506732557392462,TRX_N-00793-23423849,2023-11-27T17:32:20,Galdakao,expenses,repairs,-155.0,-63324.43
buyer_4,Jorge,,ES96209506732557392462,TRX_N-00794-74028301,2023-11-28T16:55:11,Galdakao,expenses,education,-76.5,-63400.93
buyer_4,Jorge,,ES96209506732557392462,TRX_N-00795-91024429,2023-11-28T15:17:27,Barakaldo,expenses,cash,-100.0,-63500.93
buyer_4,Jorge,,ES96209506732557392462,TRX_N-00796-33235112,2023-11-28T18:40:06,Galdakao,expenses,children,-1015.06,-64515.99
buyer_4,Jorge,,ES96209506732557392462,TRX_N-00797-46576243,2023-12-01T14:47:20,Galdakao,incomes,salary,2287.48,-62228.51
buyer_4,Jorge,,ES96209506732557392462,TRX_N-00798-67070836,2023-12-01T14:47:20,Galdakao,incomes,salary_bonus,1745.36,-60483.15
buyer_4,Jorge,,ES96209506732557392462,TRX_N-00799-12340189,2023-12-01T20:06:37,Galdakao,expenses,cash,-100.0,-60583.15
buyer_4,Jorge,,ES96209506732557392462,TRX_N-00800-79100900,2023-12-04T21:16:29,Galdakao,expenses,mortgage,-706.56,-61289.71
buyer_4,Jorge,,ES96209506732557392462,TRX_N-00801-19578421,2023-12-05T20:47:55,Vitoria-Gasteiz,expenses,food,-119.43,-61409.14
buyer_4,Jorge,,ES96209506732557392462,TRX_N-00802-43769497,2023-12-05T17:44:04,Alegría-Dulantzi,expenses,leisure,-36.64,-61445.78
buyer_4,Jorge,,ES96209506732557392462,TRX_N-00803-20870133,2023-12-05T12:46:53,Galdakao,expenses,education,-52.34,-61498.12
buyer_4,Jorge,,ES96209506732557392462,TRX_N-00804-88263828,2023-12-06T20:03:51,Galdakao,expenses,leisure,-45.61,-61543.73
buyer_4,Jorge,,ES96209506732557392462,TRX_N-00805-62533173,2023-12-06T08:26:33,Galdakao,expenses,education,-76.95,-61620.68
buyer_4,Jorge,,ES96209506732557392462,TRX_N-00806-70538271,2023-12-07T08:56:15,Galdakao,expenses,electricity,-85.03,-61705.71
buyer_4,Jorge,,ES96209506732557392462,TRX_N-00807-38185783,2023-12-07T08:46:11,Galdakao,expenses,children,-359.81,-62065.52
buyer_4,Jorge,,ES96209506732557392462,TRX_N-00808-95794194,2023-12-08T16:48:32,Galdakao,expenses,gas,-39.77,-62105.29
buyer_4,Jorge,,ES96209506732557392462,TRX_N-00809-67642230,2023-12-08T18:44:27,Galdakao,expenses,water,-20.71,-62126.0
buyer_4,Jorge,,ES96209506732557392462,TRX_N-00810-81853188,2023-12-08T19:05:26,Galdakao,expenses,internet,-42.0,-62168.0
buyer_4,Jorge,,ES96209506732557392462,TRX_N-00811-40347212,2023-12-08T15:35:16,Galdakao,expenses,phone,-37.77,-62205.77
buyer_4,Jorge,,ES96209506732557392462,TRX_N-00812-95619352,2023-12-11T15:19:39,Galdakao,expenses,food,-81.97,-62287.74
buyer_4,Jorge,,ES96209506732557392462,TRX_N-00813-99381137,2023-12-13T15:11:10,Galdakao,expenses,education,-74.97,-62362.71
buyer_4,Jorge,,ES96209506732557392462,TRX_N-00814-03447495,2023-12-14T08:56:31,Galdakao,expenses,repairs,-93.33,-62456.04
buyer_4,Jorge,,ES96209506732557392462,TRX_N-00815-98226916,2023-12-15T10:42:11,Galdakao,expenses,children,-564.91,-63020.95
buyer_4,Jorge,,ES96209506732557392462,TRX_N-00816-42948757,2023-12-16T17:03:22,Galdakao,expenses,food,-118.42,-63139.37
buyer_4,Jorge,,ES96209506732557392462,TRX_N-00817-25274768,2023-12-16T00:24:51,Galdakao,expenses,gifts,-417.62,-63556.99
buyer_4,Jorge,,ES96209506732557392462,TRX_N-00818-19247969,2023-12-18T04:16:14,Durango,expenses,food,-73.69,-63630.68
buyer_4,Jorge,,ES96209506732557392462,TRX_N-00819-97719342,2023-12-18T09:07:14,Galdakao,expenses,leisure,-29.12,-63659.8
buyer_4,Jorge,,ES96209506732557392462,TRX_N-00820-58899325,2023-12-18T19:27:52,Galdakao,expenses,gifts,-666.72,-64326.52
buyer_4,Jorge,,ES96209506732557392462,TRX_N-00821-61631996,2023-12-19T15:55:48,Galdakao,expenses,clothing,-138.37,-64464.89
buyer_4,Jorge,,ES96209506732557392462,TRX_N-00822-65785996,2023-12-20T20:01:09,Galdakao,expenses,food,-123.8,-64588.69
buyer_4,Jorge,,ES96209506732557392462,TRX_N-00823-81023915,2023-12-20T14:53:38,Galdakao,expenses,leisure,-65.72,-64654.41
buyer_4,Jorge,,ES96209506732557392462,TRX_N-00824-93776896,2023-12-22T19:32:53,Bermeo,expenses,food,-105.98,-64760.39
buyer_4,Jorge,,ES96209506732557392462,TRX_N-00825-08797991,2023-12-24T13:20:04,Galdakao,expenses,food,-77.13,-64837.52
buyer_4,Jorge,,ES96209506732557392462,TRX_N-00826-27699295,2023-12-25T19:29:36,Galdakao,expenses,leisure,-24.38,-64861.9
buyer_4,Jorge,,ES96209506732557392462,TRX_N-00827-63048925,2023-12-25T17:01:58,Oyón-Oion,expenses,education,-68.14,-64930.04
buyer_4,Jorge,,ES96209506732557392462,TRX_N-00828-53762579,2023-12-26T18:44:49,Galdakao,expenses,leisure,-61.31,-64991.35
buyer_4,Jorge,,ES96209506732557392462,TRX_N-00829-36669756,2023-12-28T05:19:31,Galdakao,expenses,gifts,-57.55,-65048.9
buyer_4,Jorge,,ES96209506732557392462,TRX_N-00830-03439636,2023-12-29T16:39:58,Galdakao,expenses,transport,-52.61,-65101.51
buyer_4,Jorge,,ES96209506732557392462,TRX_N-00831-72309080,2023-12-30T16:43:49,Galdakao,expenses,gifts,-133.35,-65234.86
buyer_4,Jorge,,ES96209506732557392462,TRX_N-00832-22244678,2024-01-01T13:40:58,Galdakao,incomes,salary,2341.5,-62893.36
buyer_4,Jorge,,ES96209506732557392462,TRX_N-00833-36216728,2024-01-01T18:24:41,Sestao,expenses,food,-88.19,-62981.55
buyer_4,Jorge,,ES96209506732557392462,TRX_N-00834-62413353,2024-01-01T17:18:08,Getxo,expenses,leisure,-19.59,-63001.14
buyer_4,Jorge,,ES96209506732557392462,TRX_N-00835-20555638,2024-01-01T12:52:38,Galdakao,expenses,cash,-100.0,-63101.14
buyer_4,Jorge,,ES96209506732557392462,TRX_N-00836-12708423,2024-01-02T18:29:08,Arrasate,expenses,leisure,-41.12,-63142.26
buyer_4,Jorge,,ES96209506732557392462,TRX_N-00837-60590108,2024-01-04T14:21:00,Galdakao,expenses,mortgage,-706.56,-63848.82
buyer_4,Jorge,,ES96209506732557392462,TRX_N-00838-56707269,2024-01-04T20:16:26,Leioa,expenses,transport,-73.59,-63922.41
buyer_4,Jorge,,ES96209506732557392462,TRX_N-00839-79614639,2024-01-05T18:06:49,Galdakao,expenses,internet,-42.0,-63964.41
buyer_4,Jorge,,ES96209506732557392462,TRX_N-00840-56189194,2024-01-05T16:38:54,Galdakao,expenses,food,-86.11,-64050.52
buyer_4,Jorge,,ES96209506732557392462,TRX_N-00841-79703133,2024-01-06T17:12:27,Galdakao,expenses,gas,-59.03,-64109.55
buyer_4,Jorge,,ES96209506732557392462,TRX_N-00842-90575327,2024-01-06T19:49:56,Galdakao,expenses,leisure,-22.74,-64132.29
buyer_4,Jorge,,ES96209506732557392462,TRX_N-00843-67973401,2024-01-07T10:31:29,Galdakao,expenses,water,-24.4,-64156.69
buyer_4,Jorge,,ES96209506732557392462,TRX_N-00844-34838393,2024-01-07T20:16:11,Galdakao,expenses,electricity,-43.96,-64200.65
buyer_4,Jorge,,ES96209506732557392462,TRX_N-00845-14487724,2024-01-07T10:56:13,Galdakao,expenses,cash,-100.0,-64300.65
buyer_4,Jorge,,ES96209506732557392462,TRX_N-00846-97608655,2024-01-07T23:55:52,Galdakao,expenses,gifts,-513.01,-64813.66
buyer_4,Jorge,,ES96209506732557392462,TRX_N-00847-99134780,2024-01-08T20:24:22,Galdakao,expenses,phone,-39.69,-64853.35
buyer_4,Jorge,,ES96209506732557392462,TRX_N-00848-20071032,2024-01-08T08:22:12,Galdakao,expenses,gifts,-394.77,-65248.12
buyer_4,Jorge,,ES96209506732557392462,TRX_N-00849-33479055,2024-01-09T18:35:18,Galdakao,expenses,leisure,-32.13,-65280.25
buyer_4,Jorge,,ES96209506732557392462,TRX_N-00850-49509594,2024-01-11T10:09:12,Galdakao,expenses,leisure,-69.43,-65349.68
buyer_4,Jorge,,ES96209506732557392462,TRX_N-00851-83730019,2024-01-12T17:10:32,Galdakao,expenses,leisure,-59.93,-65409.61
buyer_4,Jorge,,ES96209506732557392462,TRX_N-00852-18693015,2024-01-15T13:38:22,Galdakao,expenses,cash,-100.0,-65509.61
buyer_4,Jorge,,ES96209506732557392462,TRX_N-00853-02370630,2024-01-16T19:20:35,Labastida,expenses,food,-101.38,-65610.99
buyer_4,Jorge,,ES96209506732557392462,TRX_N-00854-72038144,2024-01-17T08:29:27,Durango,expenses,food,-89.5,-65700.49
buyer_4,Jorge,,ES96209506732557392462,TRX_N-00855-40173512,2024-01-20T22:14:15,Galdakao,expenses,cash,-100.0,-65800.49
buyer_4,Jorge,,ES96209506732557392462,TRX_N-00856-80991522,2024-01-20T13:59:01,Galdakao,expenses,children,-829.39,-66629.88
buyer_4,Jorge,,ES96209506732557392462,TRX_N-00857-53441212,2024-01-21T14:45:24,Irun,expenses,food,-63.39,-66693.27
buyer_4,Jorge,,ES96209506732557392462,TRX_N-00858-39610902,2024-01-22T19:07:38,Galdakao,expenses,transport,-67.72,-66760.99
buyer_4,Jorge,,ES96209506732557392462,TRX_N-00859-63664277,2024-01-23T11:36:18,Galdakao,expenses,leisure,-25.34,-66786.33
buyer_4,Jorge,,ES96209506732557392462,TRX_N-00860-97113101,2024-01-23T22:19:02,Galdakao,expenses,healthcare,-47.41,-66833.74
buyer_4,Jorge,,ES96209506732557392462,TRX_N-00861-80543017,2024-01-24T16:10:29,Galdakao,expenses,food,-69.62,-66903.36
buyer_4,Jorge,,ES96209506732557392462,TRX_N-00862-42514019,2024-01-24T08:24:34,Galdakao,expenses,transport,-69.08,-66972.44
buyer_4,Jorge,,ES96209506732557392462,TRX_N-00863-66368646,2024-01-24T11:09:05,Galdakao,expenses,education,-56.48,-67028.92
buyer_4,Jorge,,ES96209506732557392462,TRX_N-00864-69698058,2024-01-24T18:04:46,Galdakao,expenses,cash,-100.0,-67128.92
buyer_4,Jorge,,ES96209506732557392462,TRX_N-00865-90711311,2024-01-25T23:11:25,Galdakao,expenses,food,-67.69,-67196.61
buyer_4,Jorge,,ES96209506732557392462,TRX_N-00866-88673211,2024-01-25T13:30:02,Galdakao,expenses,transport,-68.52,-67265.13
buyer_4,Jorge,,ES96209506732557392462,TRX_N-00867-08207213,2024-01-25T08:43:36,Galdakao,expenses,leisure,-72.31,-67337.44
buyer_4,Jorge,,ES96209506732557392462,TRX_N-00868-33211980,2024-01-25T21:12:08,Basauri,expenses,healthcare,-187.34,-67524.78
buyer_4,Jorge,,ES96209506732557392462,TRX_N-00869-80786878,2024-01-26T09:30:55,Galdakao,expenses,education,-57.03,-67581.81
buyer_4,Jorge,,ES96209506732557392462,TRX_N-00870-60568057,2024-01-27T20:00:17,Galdakao,expenses,food,-84.24,-67666.05
buyer_4,Jorge,,ES96209506732557392462,TRX_N-00871-17243012,2024-01-27T23:51:35,Elciego,expenses,education,-67.64,-67733.69
buyer_4,Jorge,,ES96209506732557392462,TRX_N-00872-29609349,2024-01-27T17:41:34,Galdakao,expenses,cash,-100.0,-67833.69
buyer_4,Jorge,,ES96209506732557392462,TRX_N-00873-68985265,2024-01-28T09:12:51,Galdakao,expenses,food,-99.64,-67933.33
buyer_4,Jorge,,ES96209506732557392462,TRX_N-00874-83500983,2024-01-28T11:11:36,Galdakao,expenses,cash,-100.0,-68033.33
buyer_4,Jorge,,ES96209506732557392462,TRX_N-00875-03816069,2024-01-29T13:24:58,Galdakao,expenses,cash,-100.0,-68133.33
buyer_4,Jorge,,ES96209506732557392462,TRX_N-00876-21670166,2024-01-29T04:59:28,Galdakao,expenses,travel,-660.08,-68793.41
buyer_4,Jorge,,ES96209506732557392462,TRX_N-00877-35899488,2024-01-30T08:48:42,Galdakao,expenses,food,-111.07,-68904.48
buyer_4,Jorge,,ES96209506732557392462,TRX_N-00878-01310245,2024-01-30T12:35:17,Galdakao,expenses,leisure,-60.56,-68965.04
buyer_4,Jorge,,ES96209506732557392462,TRX_N-00879-53319069,2024-02-01T16:56:54,Galdakao,incomes,salary,2341.5,-66623.54
buyer_4,Jorge,,ES96209506732557392462,TRX_N-00880-49565857,2024-02-04T23:19:02,Galdakao,expenses,mortgage,-706.56,-67330.1
buyer_4,Jorge,,ES96209506732557392462,TRX_N-00881-44868193,2024-02-05T15:48:00,Galdakao,expenses,water,-22.12,-67352.22
buyer_4,Jorge,,ES96209506732557392462,TRX_N-00882-56806333,2024-02-05T12:16:48,Galdakao,expenses,phone,-37.36,-67389.58
buyer_4,Jorge,,ES96209506732557392462,TRX_N-00883-59924666,2024-02-07T12:17:01,Galdakao,expenses,cash,-100.0,-67489.58
buyer_4,Jorge,,ES96209506732557392462,TRX_N-00884-73487820,2024-02-07T03:50:48,Galdakao,expenses,children,-1075.34,-68564.92
buyer_4,Jorge,,ES96209506732557392462,TRX_N-00885-41261871,2024-02-08T10:40:03,Galdakao,expenses,internet,-42.0,-68606.92
buyer_4,Jorge,,ES96209506732557392462,TRX_N-00886-94453944,2024-02-08T19:03:33,Galdakao,expenses,electricity,-86.99,-68693.91
buyer_4,Jorge,,ES96209506732557392462,TRX_N-00887-55422054,2024-02-08T20:58:28,Galdakao,expenses,gas,-85.2,-68779.11
buyer_4,Jorge,,ES96209506732557392462,TRX_N-00888-47124940,2024-02-08T16:01:53,Galdakao,expenses,repairs,-148.52,-68927.63
buyer_4,Jorge,,ES96209506732557392462,TRX_N-00889-42950300,2024-02-09T15:25:28,Sestao,expenses,food,-102.47,-69030.1
buyer_4,Jorge,,ES96209506732557392462,TRX_N-00890-95445797,2024-02-09T09:26:53,Galdakao,expenses,repairs,-175.86,-69205.96
buyer_4,Jorge,,ES96209506732557392462,TRX_N-00891-55623802,2024-02-09T22:15:42,Galdakao,expenses,children,-334.51,-69540.47
buyer_4,Jorge,,ES96209506732557392462,TRX_N-00892-77388187,2024-02-11T14:00:22,Galdakao,expenses,transport,-56.81,-69597.28
buyer_4,Jorge,,ES96209506732557392462,TRX_N-00893-89200669,2024-02-11T08:33:08,Galdakao,expenses,clothing,-125.97,-69723.25
buyer_4,Jorge,,ES96209506732557392462,TRX_N-00894-65215928,2024-02-12T18:30:30,Iruña de Oca,expenses,leisure,-60.91,-69784.16
buyer_4,Jorge,,ES96209506732557392462,TRX_N-00895-97861957,2024-02-12T10:27:35,Hondarribia,expenses,cash,-100.0,-69884.16
buyer_4,Jorge,,ES96209506732557392462,TRX_N-00896-08628633,2024-02-14T12:07:48,Galdakao,expenses,leisure,-52.64,-69936.8
buyer_4,Jorge,,ES96209506732557392462,TRX_N-00897-44451795,2024-02-15T17:12:07,Galdakao,expenses,clothing,-115.36,-70052.16
buyer_4,Jorge,,ES96209506732557392462,TRX_N-00898-43183114,2024-02-15T18:51:31,Galdakao,expenses,cash,-100.0,-70152.16
buyer_4,Jorge,,ES96209506732557392462,TRX_N-00899-35805181,2024-02-16T13:22:09,Galdakao,expenses,clothing,-88.23,-70240.39
buyer_4,Jorge,,ES96209506732557392462,TRX_N-00900-55105170,2024-02-17T08:14:08,Galdakao,expenses,cash,-100.0,-70340.39
buyer_4,Jorge,,ES96209506732557392462,TRX_N-00901-30539317,2024-02-17T08:35:47,Galdakao,expenses,repairs,-287.97,-70628.36
buyer_4,Jorge,,ES96209506732557392462,TRX_N-00902-80125504,2024-02-18T03:46:12,Galdakao,expenses,leisure,-58.22,-70686.58
buyer_4,Jorge,,ES96209506732557392462,TRX_N-00903-45504776,2024-02-18T00:28:58,Galdakao,expenses,repairs,-169.02,-70855.6
buyer_4,Jorge,,ES96209506732557392462,TRX_N-00904-73200522,2024-02-19T11:48:45,Galdakao,expenses,education,-62.1,-70917.7
buyer_4,Jorge,,ES96209506732557392462,TRX_N-00905-06730606,2024-02-20T15:51:49,Galdakao,expenses,food,-111.36,-71029.06
buyer_4,Jorge,,ES96209506732557392462,TRX_N-00906-13284619,2024-02-20T15:53:35,Santurtzi,expenses,cash,-100.0,-71129.06
buyer_4,Jorge,,ES96209506732557392462,TRX_N-00907-33314337,2024-02-21T18:19:50,Galdakao,expenses,cash,-100.0,-71229.06
buyer_4,Jorge,,ES96209506732557392462,TRX_N-00908-64471623,2024-02-26T17:53:32,Galdakao,expenses,car,-221.78,-71450.84
buyer_4,Jorge,,ES96209506732557392462,TRX_N-00909-39335968,2024-02-29T10:47:04,Galdakao,expenses,food,-94.66,-71545.5
buyer_4,Jorge,,ES96209506732557392462,TRX_N-00910-89930295,2024-02-29T08:17:16,Zuia,expenses,leisure,-23.95,-71569.45
buyer_4,Jorge,,ES96209506732557392462,TRX_N-00911-84530567,2024-03-01T12:13:47,Galdakao,incomes,salary,2341.5,-69227.95
buyer_4,Jorge,,ES96209506732557392462,TRX_N-00912-26441586,2024-03-01T12:13:47,Galdakao,incomes,extra_income,415.36,-68812.59
buyer_4,Jorge,,ES96209506732557392462,TRX_N-00913-14932923,2024-03-01T18:36:39,Galdakao,expenses,food,-79.63,-68892.22
buyer_4,Jorge,,ES96209506732557392462,TRX_N-00914-30112602,2024-03-01T19:32:31,Galdakao,expenses,children,-1039.01,-69931.23
buyer_4,Jorge,,ES96209506732557392462,TRX_N-00915-25523227,2024-03-02T11:56:29,Galdakao,expenses,leisure,-52.72,-69983.95
buyer_4,Jorge,,ES96209506732557392462,TRX_N-00916-74973678,2024-03-04T14:59:47,Galdakao,expenses,mortgage,-706.56,-70690.51
buyer_4,Jorge,,ES96209506732557392462,TRX_N-00917-02338095,2024-03-05T12:40:12,Galdakao,expenses,electricity,-70.05,-70760.56
buyer_4,Jorge,,ES96209506732557392462,TRX_N-00918-69034447,2024-03-05T20:41:16,Galdakao,expenses,gas,-55.73,-70816.29
buyer_4,Jorge,,ES96209506732557392462,TRX_N-00919-51638495,2024-03-05T10:01:38,Galdakao,expenses,phone,-43.79,-70860.08
buyer_4,Jorge,,ES96209506732557392462,TRX_N-00920-72784387,2024-03-06T09:17:41,Galdakao,expenses,water,-33.58,-70893.66
buyer_4,Jorge,,ES96209506732557392462,TRX_N-00921-58625600,2024-03-06T00:25:24,Galdakao,expenses,repairs,-78.72,-70972.38
buyer_4,Jorge,,ES96209506732557392462,TRX_N-00922-71239604,2024-03-07T20:56:33,Galdakao,expenses,repairs,-73.06,-71045.44
buyer_4,Jorge,,ES96209506732557392462,TRX_N-00923-32510718,2024-03-08T13:25:45,Galdakao,expenses,internet,-42.0,-71087.44
buyer_4,Jorge,,ES96209506732557392462,TRX_N-00924-30113660,2024-03-08T19:42:37,Galdakao,expenses,cash,-100.0,-71187.44
buyer_4,Jorge,,ES96209506732557392462,TRX_N-00925-58757038,2024-03-09T14:34:32,Sopela,expenses,cash,-100.0,-71287.44
buyer_4,Jorge,,ES96209506732557392462,TRX_N-00926-32964517,2024-03-12T20:04:38,Galdakao,expenses,transport,-58.39,-71345.83
buyer_4,Jorge,,ES96209506732557392462,TRX_N-00927-30329631,2024-03-13T19:34:59,Galdakao,expenses,transport,-61.18,-71407.01
buyer_4,Jorge,,ES96209506732557392462,TRX_N-00928-20314461,2024-03-13T14:19:26,Galdakao,expenses,leisure,-32.47,-71439.48
buyer_4,Jorge,,ES96209506732557392462,TRX_N-00929-35363820,2024-03-13T13:03:20,Galdakao,expenses,repairs,-70.53,-71510.01
buyer_4,Jorge,,ES96209506732557392462,TRX_N-00930-25501684,2024-03-14T10:30:24,Galdakao,expenses,children,-1110.24,-72620.25
buyer_4,Jorge,,ES96209506732557392462,TRX_N-00931-02677029,2024-03-16T19:04:56,Galdakao,expenses,healthcare,-123.98,-72744.23
buyer_4,Jorge,,ES96209506732557392462,TRX_N-00932-20188108,2024-03-16T14:12:26,Galdakao,expenses,travel,-792.45,-73536.68
buyer_4,Jorge,,ES96209506732557392462,TRX_N-00933-47358807,2024-03-18T19:24:16,Galdakao,expenses,cash,-100.0,-73636.68
buyer_4,Jorge,,ES96209506732557392462,TRX_N-00934-66441363,2024-03-19T15:09:48,Galdakao,expenses,leisure,-53.03,-73689.71
buyer_4,Jorge,,ES96209506732557392462,TRX_N-00935-79538266,2024-03-19T15:01:24,Sopela,expenses,repairs,-68.27,-73757.98
buyer_4,Jorge,,ES96209506732557392462,TRX_N-00936-74688884,2024-03-20T08:29:37,Galdakao,expenses,cash,-100.0,-73857.98
buyer_4,Jorge,,ES96209506732557392462,TRX_N-00937-79147984,2024-03-20T13:34:05,Galdakao,expenses,appliances,-118.56,-73976.54
buyer_4,Jorge,,ES96209506732557392462,TRX_N-00938-05315409,2024-03-21T09:56:29,Errenteria,expenses,leisure,-33.87,-74010.41
buyer_4,Jorge,,ES96209506732557392462,TRX_N-00939-25881538,2024-03-21T08:48:00,Hondarribia,expenses,repairs,-187.69,-74198.1
buyer_4,Jorge,,ES96209506732557392462,TRX_N-00940-27506248,2024-03-24T19:48:57,Galdakao,expenses,food,-107.35,-74305.45
buyer_4,Jorge,,ES96209506732557392462,TRX_N-00941-28530492,2024-03-25T19:07:13,Galdakao,expenses,food,-82.94,-74388.39
buyer_4,Jorge,,ES96209506732557392462,TRX_N-00942-87176630,2024-03-27T02:46:02,Galdakao,expenses,leisure,-44.49,-74432.88
buyer_4,Jorge,,ES96209506732557392462,TRX_N-00943-17373852,2024-03-27T19:11:10,Galdakao,expenses,education,-58.39,-74491.27
buyer_4,Jorge,,ES96209506732557392462,TRX_N-00944-39906458,2024-03-27T06:55:08,Galdakao,expenses,travel,-452.43,-74943.7
buyer_4,Jorge,,ES96209506732557392462,TRX_N-00945-60323706,2024-03-28T09:17:33,Galdakao,expenses,education,-58.86,-75002.56
buyer_4,Jorge,,ES96209506732557392462,TRX_N-00946-66555339,2024-03-29T13:04:57,Galdakao,expenses,travel,-859.01,-75861.57
buyer_4,Jorge,,ES96209506732557392462,TRX_N-00947-14348053,2024-04-01T18:49:53,Galdakao,incomes,salary,2341.5,-73520.07
buyer_4,Jorge,,ES96209506732557392462,TRX_N-00948-18097598,2024-04-03T19:31:10,Eibar,expenses,transport,-86.6,-73606.67
buyer_4,Jorge,,ES96209506732557392462,TRX_N-00949-33261698,2024-04-04T08:45:12,Galdakao,expenses,mortgage,-706.56,-74313.23
buyer_4,Jorge,,ES96209506732557392462,TRX_N-00950-24072348,2024-04-04T23:08:19,Galdakao,expenses,cash,-100.0,-74413.23
buyer_4,Jorge,,ES96209506732557392462,TRX_N-00951-37572305,2024-04-05T16:55:48,Galdakao,expenses,gas,-43.78,-74457.01
buyer_4,Jorge,,ES96209506732557392462,TRX_N-00952-24078946,2024-04-05T23:37:03,Galdakao,expenses,internet,-42.0,-74499.01
buyer_4,Jorge,,ES96209506732557392462,TRX_N-00953-68092159,2024-04-05T16:12:04,Galdakao,expenses,cash,-100.0,-74599.01
buyer_4,Jorge,,ES96209506732557392462,TRX_N-00954-58211550,2024-04-06T18:00:57,Galdakao,expenses,phone,-44.02,-74643.03
buyer_4,Jorge,,ES96209506732557392462,TRX_N-00955-46105820,2024-04-06T08:02:07,Galdakao,expenses,cash,-100.0,-74743.03
buyer_4,Jorge,,ES96209506732557392462,TRX_N-00956-90702393,2024-04-06T18:30:56,Galdakao,expenses,gifts,-434.88,-75177.91
buyer_4,Jorge,,ES96209506732557392462,TRX_N-00957-94120596,2024-04-08T15:07:38,Galdakao,expenses,water,-44.1,-75222.01
buyer_4,Jorge,,ES96209506732557392462,TRX_N-00958-56997117,2024-04-08T08:35:55,Galdakao,expenses,electricity,-70.98,-75292.99
buyer_4,Jorge,,ES96209506732557392462,TRX_N-00959-59573180,2024-04-08T12:47:40,Galdakao,expenses,cash,-100.0,-75392.99
buyer_4,Jorge,,ES96209506732557392462,TRX_N-00960-63109015,2024-04-09T18:19:46,Galdakao,expenses,education,-62.94,-75455.93
buyer_4,Jorge,,ES96209506732557392462,TRX_N-00961-20673980,2024-04-09T16:39:38,Galdakao,expenses,cash,-100.0,-75555.93
buyer_4,Jorge,,ES96209506732557392462,TRX_N-00962-90425497,2024-04-10T17:20:19,Galdakao,expenses,food,-72.43,-75628.36
buyer_4,Jorge,,ES96209506732557392462,TRX_N-00963-51008794,2024-04-10T17:05:17,Galdakao,expenses,cash,-100.0,-75728.36
buyer_4,Jorge,,ES96209506732557392462,TRX_N-00964-66493727,2024-04-11T16:18:10,Galdakao,expenses,cash,-100.0,-75828.36
buyer_4,Jorge,,ES96209506732557392462,TRX_N-00965-65764902,2024-04-14T08:21:38,Elciego,expenses,repairs,-38.51,-75866.87
buyer_4,Jorge,,ES96209506732557392462,TRX_N-00966-66592145,2024-04-15T10:39:33,Santurtzi,expenses,cash,-100.0,-75966.87
buyer_4,Jorge,,ES96209506732557392462,TRX_N-00967-84327605,2024-04-16T09:19:11,Galdakao,expenses,transport,-54.01,-76020.88
buyer_4,Jorge,,ES96209506732557392462,TRX_N-00968-24234659,2024-04-17T22:36:33,Mungia,expenses,food,-67.97,-76088.85
buyer_4,Jorge,,ES96209506732557392462,TRX_N-00969-42699966,2024-04-17T16:23:06,Galdakao,expenses,healthcare,-157.93,-76246.78
buyer_4,Jorge,,ES96209506732557392462,TRX_N-00970-25383045,2024-04-18T19:05:04,Galdakao,expenses,food,-112.25,-76359.03
buyer_4,Jorge,,ES96209506732557392462,TRX_N-00971-20840000,2024-04-18T20:01:19,Galdakao,expenses,repairs,-99.08,-76458.11
buyer_4,Jorge,,ES96209506732557392462,TRX_N-00972-15655910,2024-04-19T08:18:25,Sopela,expenses,food,-67.98,-76526.09
buyer_4,Jorge,,ES96209506732557392462,TRX_N-00973-02177748,2024-04-20T08:33:28,Galdakao,expenses,gifts,-168.05,-76694.14
buyer_4,Jorge,,ES96209506732557392462,TRX_N-00974-07137274,2024-04-21T18:40:12,Bilbao,expenses,transport,-76.01,-76770.15
buyer_4,Jorge,,ES96209506732557392462,TRX_N-00975-46198617,2024-04-21T19:19:58,Eibar,expenses,healthcare,-53.43,-76823.58
buyer_4,Jorge,,ES96209506732557392462,TRX_N-00976-02344587,2024-04-22T20:21:53,Galdakao,expenses,food,-76.58,-76900.16
buyer_4,Jorge,,ES96209506732557392462,TRX_N-00977-83507428,2024-04-22T12:13:51,Galdakao,expenses,gifts,-669.77,-77569.93
buyer_4,Jorge,,ES96209506732557392462,TRX_N-00978-18949747,2024-04-23T21:39:08,Galdakao,expenses,food,-84.21,-77654.14
buyer_4,Jorge,,ES96209506732557392462,TRX_N-00979-60751182,2024-04-23T17:07:34,Galdakao,expenses,cash,-100.0,-77754.14
buyer_4,Jorge,,ES96209506732557392462,TRX_N-00980-22212549,2024-04-27T12:36:10,Galdakao,expenses,education,-74.9,-77829.04
buyer_4,Jorge,,ES96209506732557392462,TRX_N-00981-42099081,2024-04-27T12:38:19,Galdakao,expenses,gifts,-394.94,-78223.98
buyer_4,Jorge,,ES96209506732557392462,TRX_N-00982-53253149,2024-04-28T09:49:16,Galdakao,expenses,leisure,-78.77,-78302.75
buyer_4,Jorge,,ES96209506732557392462,TRX_N-00983-62265752,2024-04-29T17:45:25,Donostia,expenses,transport,-41.27,-78344.02
buyer_4,Jorge,,ES96209506732557392462,TRX_N-00984-78797928,2024-05-01T06:16:10,Galdakao,incomes,salary,2341.5,-76002.52
buyer_4,Jorge,,ES96209506732557392462,TRX_N-00985-99897604,2024-05-02T09:45:37,Galdakao,expenses,leisure,-49.22,-76051.74
buyer_4,Jorge,,ES96209506732557392462,TRX_N-00986-59756674,2024-05-02T16:59:00,Galdakao,expenses,repairs,-243.83,-76295.57
buyer_4,Jorge,,ES96209506732557392462,TRX_N-00987-30803583,2024-05-03T10:25:33,Sestao,expenses,food,-82.75,-76378.32
buyer_4,Jorge,,ES96209506732557392462,TRX_N-00988-57502278,2024-05-03T10:58:28,Galdakao,expenses,transport,-78.66,-76456.98
buyer_4,Jorge,,ES96209506732557392462,TRX_N-00989-94445079,2024-05-04T18:05:06,Galdakao,expenses,mortgage,-706.56,-77163.54
buyer_4,Jorge,,ES96209506732557392462,TRX_N-00990-13438636,2024-05-04T17:28:53,Galdakao,expenses,food,-74.69,-77238.23
buyer_4,Jorge,,ES96209506732557392462,TRX_N-00991-27748314,2024-05-04T16:13:42,Galdakao,expenses,transport,-61.03,-77299.26
buyer_4,Jorge,,ES96209506732557392462,TRX_N-00992-80591699,2024-05-04T14:12:21,Galdakao,expenses,leisure,-49.04,-77348.3
buyer_4,Jorge,,ES96209506732557392462,TRX_N-00993-74560133,2024-05-05T13:29:37,Galdakao,expenses,food,-111.59,-77459.89
buyer_4,Jorge,,ES96209506732557392462,TRX_N-00994-53254462,2024-05-05T10:56:43,Bermeo,expenses,transport,-73.94,-77533.83
buyer_4,Jorge,,ES96209506732557392462,TRX_N-00995-04400029,2024-05-05T16:08:50,Galdakao,expenses,leisure,-45.76,-77579.59
buyer_4,Jorge,,ES96209506732557392462,TRX_N-00996-27469541,2024-05-05T23:05:30,Bilbao,expenses,cash,-100.0,-77679.59
buyer_4,Jorge,,ES96209506732557392462,TRX_N-00997-05357823,2024-05-05T20:00:46,Galdakao,expenses,children,-468.96,-78148.55
buyer_4,Jorge,,ES96209506732557392462,TRX_N-00998-49231413,2024-05-06T11:50:51,Galdakao,expenses,water,-31.74,-78180.29
buyer_4,Jorge,,ES96209506732557392462,TRX_N-00999-20442287,2024-05-06T10:24:50,Galdakao,expenses,phone,-40.45,-78220.74
buyer_4,Jorge,,ES96209506732557392462,TRX_N-01000-74192479,2024-05-06T18:36:13,Galdakao,expenses,food,-103.47,-78324.21
buyer_4,Jorge,,ES96209506732557392462,TRX_N-01001-11601947,2024-05-06T20:19:54,Zarautz,expenses,leisure,-63.33,-78387.54
buyer_4,Jorge,,ES96209506732557392462,TRX_N-01002-41388159,2024-05-07T15:57:07,Galdakao,expenses,leisure,-62.68,-78450.22
buyer_4,Jorge,,ES96209506732557392462,TRX_N-01003-34475972,2024-05-08T08:34:34,Galdakao,expenses,electricity,-40.0,-78490.22
buyer_4,Jorge,,ES96209506732557392462,TRX_N-01004-93670415,2024-05-08T15:51:34,Galdakao,expenses,gas,-50.4,-78540.62
buyer_4,Jorge,,ES96209506732557392462,TRX_N-01005-89213187,2024-05-08T19:30:53,Galdakao,expenses,internet,-42.0,-78582.62
buyer_4,Jorge,,ES96209506732557392462,TRX_N-01006-07867967,2024-05-08T19:07:41,Alegría-Dulantzi,expenses,food,-109.82,-78692.44
buyer_4,Jorge,,ES96209506732557392462,TRX_N-01007-75707468,2024-05-11T11:04:32,Bilbao,expenses,leisure,-45.71,-78738.15
buyer_4,Jorge,,ES96209506732557392462,TRX_N-01008-32961880,2024-05-12T12:53:56,Galdakao,expenses,leisure,-27.99,-78766.14
buyer_4,Jorge,,ES96209506732557392462,TRX_N-01009-31796784,2024-05-12T10:19:54,Galdakao,expenses,cash,-100.0,-78866.14
buyer_4,Jorge,,ES96209506732557392462,TRX_N-01010-88660074,2024-05-13T12:52:20,Iruña de Oca,expenses,education,-64.45,-78930.59
buyer_4,Jorge,,ES96209506732557392462,TRX_N-01011-04346182,2024-05-16T12:00:15,Galdakao,expenses,cash,-100.0,-79030.59
buyer_4,Jorge,,ES96209506732557392462,TRX_N-01012-00341731,2024-05-17T12:47:06,Galdakao,expenses,cash,-100.0,-79130.59
buyer_4,Jorge,,ES96209506732557392462,TRX_N-01013-33706684,2024-05-24T07:20:29,Eibar,expenses,leisure,-73.94,-79204.53
buyer_4,Jorge,,ES96209506732557392462,TRX_N-01014-19932692,2024-05-25T21:20:03,Galdakao,expenses,children,-426.86,-79631.39
buyer_4,Jorge,,ES96209506732557392462,TRX_N-01015-13785857,2024-05-28T16:30:51,Galdakao,expenses,food,-110.06,-79741.45
buyer_4,Jorge,,ES96209506732557392462,TRX_N-01016-53337669,2024-06-01T08:16:56,Galdakao,incomes,salary,2341.5,-77399.95
buyer_4,Jorge,,ES96209506732557392462,TRX_N-01017-13514537,2024-06-01T08:16:56,Galdakao,incomes,salary_bonus,1868.8,-75531.15
buyer_4,Jorge,,ES96209506732557392462,TRX_N-01018-44757388,2024-06-01T14:12:25,Galdakao,expenses,leisure,-48.99,-75580.14
buyer_4,Jorge,,ES96209506732557392462,TRX_N-01019-93999091,2024-06-03T08:31:42,Galdakao,expenses,cash,-100.0,-75680.14
buyer_4,Jorge,,ES96209506732557392462,TRX_N-01020-67927094,2024-06-04T09:11:58,Galdakao,expenses,mortgage,-706.56,-76386.7
buyer_4,Jorge,,ES96209506732557392462,TRX_N-01021-43903453,2024-06-04T12:17:19,Erandio,expenses,gifts,-752.42,-77139.12
buyer_4,Jorge,,ES96209506732557392462,TRX_N-01022-67081514,2024-06-05T17:46:37,Galdakao,expenses,electricity,-33.69,-77172.81
buyer_4,Jorge,,ES96209506732557392462,TRX_N-01023-72866831,2024-06-05T04:07:41,Galdakao,expenses,gas,-81.48,-77254.29
buyer_4,Jorge,,ES96209506732557392462,TRX_N-01024-82083485,2024-06-06T15:53:54,Galdakao,expenses,water,-39.92,-77294.21
buyer_4,Jorge,,ES96209506732557392462,TRX_N-01025-44594690,2024-06-06T09:12:57,Galdakao,expenses,phone,-43.72,-77337.93
buyer_4,Jorge,,ES96209506732557392462,TRX_N-01026-00049334,2024-06-06T09:09:21,Galdakao,expenses,food,-97.24,-77435.17
buyer_4,Jorge,,ES96209506732557392462,TRX_N-01027-22896750,2024-06-06T08:44:46,Galdakao,expenses,travel,-823.37,-78258.54
buyer_4,Jorge,,ES96209506732557392462,TRX_N-01028-89779587,2024-06-07T20:05:33,Galdakao,expenses,car,-169.34,-78427.88
buyer_4,Jorge,,ES96209506732557392462,TRX_N-01029-03140447,2024-06-08T16:11:43,Galdakao,expenses,internet,-42.0,-78469.88
buyer_4,Jorge,,ES96209506732557392462,TRX_N-01030-90515764,2024-06-09T10:38:14,Galdakao,expenses,gifts,-231.04,-78700.92
buyer_4,Jorge,,ES96209506732557392462,TRX_N-01031-80565803,2024-06-10T05:31:34,Galdakao,expenses,repairs,-185.02,-78885.94
buyer_4,Jorge,,ES96209506732557392462,TRX_N-01032-06036746,2024-06-11T17:00:06,Galdakao,expenses,food,-113.37,-78999.31
buyer_4,Jorge,,ES96209506732557392462,TRX_N-01033-89505928,2024-06-13T10:39:05,Galdakao,expenses,leisure,-84.04,-79083.35
buyer_4,Jorge,,ES96209506732557392462,TRX_N-01034-17188006,2024-06-14T16:15:48,Galdakao,expenses,gifts,-28.44,-79111.79
buyer_4,Jorge,,ES96209506732557392462,TRX_N-01035-29559786,2024-06-16T12:46:14,Galdakao,expenses,cash,-100.0,-79211.79
buyer_4,Jorge,,ES96209506732557392462,TRX_N-01036-40365369,2024-06-17T14:43:22,Galdakao,expenses,food,-114.45,-79326.24
buyer_4,Jorge,,ES96209506732557392462,TRX_N-01037-10168807,2024-06-18T19:08:45,Galdakao,expenses,food,-73.01,-79399.25
buyer_4,Jorge,,ES96209506732557392462,TRX_N-01038-30436765,2024-06-18T15:43:46,Galdakao,expenses,healthcare,-137.56,-79536.81
buyer_4,Jorge,,ES96209506732557392462,TRX_N-01039-05788129,2024-06-18T08:23:02,Galdakao,expenses,repairs,-137.32,-79674.13
buyer_4,Jorge,,ES96209506732557392462,TRX_N-01040-49123869,2024-06-18T08:24:47,Galdakao,expenses,children,-582.96,-80257.09
buyer_4,Jorge,,ES96209506732557392462,TRX_N-01041-40316423,2024-06-19T17:19:42,Leioa,expenses,food,-76.13,-80333.22
buyer_4,Jorge,,ES96209506732557392462,TRX_N-01042-18170803,2024-06-19T15:49:02,Galdakao,expenses,appliances,-156.01,-80489.23
buyer_4,Jorge,,ES96209506732557392462,TRX_N-01043-77502200,2024-06-20T09:16:50,Bilbao,expenses,gifts,-845.08,-81334.31
buyer_4,Jorge,,ES96209506732557392462,TRX_N-01044-77588038,2024-06-23T04:09:18,Galdakao,expenses,gifts,-412.37,-81746.68
buyer_4,Jorge,,ES96209506732557392462,TRX_N-01045-70527420,2024-06-27T04:14:38,Galdakao,expenses,transport,-80.08,-81826.76
buyer_4,Jorge,,ES96209506732557392462,TRX_N-01046-51547571,2024-06-27T18:29:49,Errenteria,expenses,repairs,-115.0,-81941.76
buyer_4,Jorge,,ES96209506732557392462,TRX_N-01047-91553388,2024-06-28T09:35:16,Galdakao,expenses,travel,-1191.45,-83133.21
buyer_4,Jorge,,ES96209506732557392462,TRX_N-01048-71821882,2024-06-29T09:16:47,Galdakao,expenses,cash,-100.0,-83233.21
buyer_4,Jorge,,ES96209506732557392462,TRX_N-01049-47176194,2024-07-01T10:26:40,Galdakao,incomes,salary,2341.5,-80891.71
buyer_4,Jorge,,ES96209506732557392462,TRX_N-01050-93438890,2024-07-01T10:26:40,Galdakao,incomes,extra_income,415.36,-80476.35
buyer_4,Jorge,,ES96209506732557392462,TRX_N-01051-92264473,2024-07-02T16:27:38,Galdakao,expenses,leisure,-19.03,-80495.38
buyer_4,Jorge,,ES96209506732557392462,TRX_N-01052-38730895,2024-07-02T19:23:40,Galdakao,expenses,healthcare,-162.2,-80657.58
buyer_4,Jorge,,ES96209506732557392462,TRX_N-01053-88195064,2024-07-02T19:26:19,Galdakao,expenses,cash,-100.0,-80757.58
buyer_4,Jorge,,ES96209506732557392462,TRX_N-01054-19064810,2024-07-02T20:01:28,Galdakao,expenses,gifts,-488.2,-81245.78
buyer_4,Jorge,,ES96209506732557392462,TRX_N-01055-05159618,2024-07-04T15:06:36,Galdakao,expenses,mortgage,-706.56,-81952.34
buyer_4,Jorge,,ES96209506732557392462,TRX_N-01056-17017925,2024-07-04T12:12:41,Galdakao,expenses,appliances,-371.49,-82323.83
buyer_4,Jorge,,ES96209506732557392462,TRX_N-01057-32209827,2024-07-05T16:19:01,Galdakao,expenses,internet,-42.0,-82365.83
buyer_4,Jorge,,ES96209506732557392462,TRX_N-01058-02236451,2024-07-05T23:49:27,Galdakao,expenses,food,-62.37,-82428.2
buyer_4,Jorge,,ES96209506732557392462,TRX_N-01059-86075178,2024-07-05T17:14:30,Galdakao,expenses,clothing,-46.92,-82475.12
buyer_4,Jorge,,ES96209506732557392462,TRX_N-01060-22422051,2024-07-05T22:40:36,Galdakao,expenses,repairs,-220.37,-82695.49
buyer_4,Jorge,,ES96209506732557392462,TRX_N-01061-46887020,2024-07-06T20:03:15,Galdakao,expenses,electricity,-68.47,-82763.96
buyer_4,Jorge,,ES96209506732557392462,TRX_N-01062-42200107,2024-07-06T14:55:30,Galdakao,expenses,clothing,-105.17,-82869.13
buyer_4,Jorge,,ES96209506732557392462,TRX_N-01063-19673485,2024-07-07T10:42:01,Galdakao,expenses,water,-22.69,-82891.82
buyer_4,Jorge,,ES96209506732557392462,TRX_N-01064-31470404,2024-07-07T16:15:37,Galdakao,expenses,phone,-37.63,-82929.45
buyer_4,Jorge,,ES96209506732557392462,TRX_N-01065-00865967,2024-07-07T11:02:57,Galdakao,expenses,leisure,-73.08,-83002.53
buyer_4,Jorge,,ES96209506732557392462,TRX_N-01066-70361180,2024-07-08T08:03:18,Galdakao,expenses,gas,-36.46,-83038.99
buyer_4,Jorge,,ES96209506732557392462,TRX_N-01067-06383173,2024-07-08T11:13:27,Galdakao,expenses,cash,-100.0,-83138.99
buyer_4,Jorge,,ES96209506732557392462,TRX_N-01068-93688810,2024-07-09T14:30:30,Galdakao,expenses,clothing,-157.3,-83296.29
buyer_4,Jorge,,ES96209506732557392462,TRX_N-01069-41042072,2024-07-10T14:02:02,Galdakao,expenses,leisure,-23.04,-83319.33
buyer_4,Jorge,,ES96209506732557392462,TRX_N-01070-79438364,2024-07-10T12:27:19,Galdakao,expenses,cash,-100.0,-83419.33
buyer_4,Jorge,,ES96209506732557392462,TRX_N-01071-02113058,2024-07-11T08:52:05,Bermeo,expenses,food,-96.05,-83515.38
buyer_4,Jorge,,ES96209506732557392462,TRX_N-01072-36025788,2024-07-11T22:10:30,Galdakao,expenses,children,-638.4,-84153.78
buyer_4,Jorge,,ES96209506732557392462,TRX_N-01073-88250470,2024-07-14T13:46:51,Galdakao,expenses,appliances,-287.6,-84441.38
buyer_4,Jorge,,ES96209506732557392462,TRX_N-01074-26373931,2024-07-15T12:39:17,Galdakao,expenses,leisure,-49.02,-84490.4
buyer_4,Jorge,,ES96209506732557392462,TRX_N-01075-26803250,2024-07-15T09:30:47,Basauri,expenses,gifts,-189.41,-84679.81
buyer_4,Jorge,,ES96209506732557392462,TRX_N-01076-16834915,2024-07-17T14:26:32,Eibar,expenses,food,-107.2,-84787.01
buyer_4,Jorge,,ES96209506732557392462,TRX_N-01077-64452699,2024-07-17T15:27:46,Galdakao,expenses,clothing,-75.24,-84862.25
buyer_4,Jorge,,ES96209506732557392462,TRX_N-01078-69460984,2024-07-20T20:36:56,Amurrio,expenses,transport,-49.56,-84911.81
buyer_4,Jorge,,ES96209506732557392462,TRX_N-01079-04024050,2024-07-20T11:50:24,Errenteria,expenses,repairs,-91.0,-85002.81
buyer_4,Jorge,,ES96209506732557392462,TRX_N-01080-65437051,2024-07-21T20:01:33,Galdakao,expenses,appliances,-316.05,-85318.86
buyer_4,Jorge,,ES96209506732557392462,TRX_N-01081-64547675,2024-07-23T13:57:56,Bermeo,expenses,appliances,-89.64,-85408.5
buyer_4,Jorge,,ES96209506732557392462,TRX_N-01082-22716804,2024-07-25T18:10:19,Galdakao,expenses,leisure,-42.07,-85450.57
buyer_4,Jorge,,ES96209506732557392462,TRX_N-01083-14373094,2024-07-25T00:18:50,Galdakao,expenses,cash,-100.0,-85550.57
buyer_4,Jorge,,ES96209506732557392462,TRX_N-01084-31565099,2024-07-28T15:11:29,Galdakao,expenses,food,-113.77,-85664.34
buyer_4,Jorge,,ES96209506732557392462,TRX_N-01085-81815936,2024-07-28T11:19:15,Galdakao,expenses,healthcare,-43.49,-85707.83
buyer_4,Jorge,,ES96209506732557392462,TRX_N-01086-61332652,2024-07-31T23:23:32,Galdakao,expenses,healthcare,-46.81,-85754.64
buyer_4,Jorge,,ES96209506732557392462,TRX_N-01087-04485136,2024-07-31T17:47:01,Galdakao,expenses,cash,-100.0,-85854.64
buyer_4,Jorge,,ES96209506732557392462,TRX_N-01088-57504237,2024-07-31T18:43:21,Irun,expenses,appliances,-167.85,-86022.49
buyer_4,Jorge,,ES96209506732557392462,TRX_N-01089-05707013,2024-07-31T19:15:31,Durango,expenses,gifts,-669.63,-86692.12
buyer_4,Jorge,,ES96209506732557392462,TRX_N-01090-84379927,2024-08-01T17:59:16,Galdakao,incomes,salary,2341.5,-84350.62
buyer_4,Jorge,,ES96209506732557392462,TRX_N-01091-85352281,2024-08-01T11:00:06,Vitoria-Gasteiz,expenses,cash,-100.0,-84450.62
buyer_4,Jorge,,ES96209506732557392462,TRX_N-01092-42970437,2024-08-03T12:48:41,Galdakao,expenses,healthcare,-111.91,-84562.53
buyer_4,Jorge,,ES96209506732557392462,TRX_N-01093-18321762,2024-08-03T14:49:44,Galdakao,expenses,repairs,-34.09,-84596.62
buyer_4,Jorge,,ES96209506732557392462,TRX_N-01094-86722823,2024-08-04T09:18:09,Galdakao,expenses,mortgage,-706.56,-85303.18
buyer_4,Jorge,,ES96209506732557392462,TRX_N-01095-40070096,2024-08-04T17:50:16,Galdakao,expenses,leisure,-24.66,-85327.84
buyer_4,Jorge,,ES96209506732557392462,TRX_N-01096-91898408,2024-08-05T11:58:38,Galdakao,expenses,water,-36.85,-85364.69
buyer_4,Jorge,,ES96209506732557392462,TRX_N-01097-25447401,2024-08-05T16:57:57,Galdakao,expenses,electricity,-72.6,-85437.29
buyer_4,Jorge,,ES96209506732557392462,TRX_N-01098-20265626,2024-08-06T10:02:30,Galdakao,expenses,phone,-35.38,-85472.67
buyer_4,Jorge,,ES96209506732557392462,TRX_N-01099-98810124,2024-08-06T11:06:59,Galdakao,expenses,food,-123.99,-85596.66
buyer_4,Jorge,,ES96209506732557392462,TRX_N-01100-24438907,2024-08-06T14:06:27,Berango,expenses,repairs,-241.21,-85837.87
buyer_4,Jorge,,ES96209506732557392462,TRX_N-01101-85774618,2024-08-07T09:17:10,Galdakao,expenses,gas,-58.25,-85896.12
buyer_4,Jorge,,ES96209506732557392462,TRX_N-01102-62299794,2024-08-08T14:24:34,Galdakao,expenses,internet,-42.0,-85938.12
buyer_4,Jorge,,ES96209506732557392462,TRX_N-01103-01819328,2024-08-09T12:35:54,Galdakao,expenses,clothing,-158.85,-86096.97
buyer_4,Jorge,,ES96209506732557392462,TRX_N-01104-77295840,2024-08-10T06:34:24,Andoain,expenses,food,-80.09,-86177.06
buyer_4,Jorge,,ES96209506732557392462,TRX_N-01105-05673198,2024-08-10T18:48:53,Galdakao,expenses,cash,-100.0,-86277.06
buyer_4,Jorge,,ES96209506732557392462,TRX_N-01106-32885245,2024-08-11T15:06:00,Galdakao,expenses,leisure,-57.43,-86334.49
buyer_4,Jorge,,ES96209506732557392462,TRX_N-01107-29733708,2024-08-12T08:57:24,Galdakao,expenses,food,-100.66,-86435.15
buyer_4,Jorge,,ES96209506732557392462,TRX_N-01108-11428386,2024-08-12T17:25:05,Galdakao,expenses,leisure,-54.25,-86489.4
buyer_4,Jorge,,ES96209506732557392462,TRX_N-01109-41523364,2024-08-12T17:35:02,Galdakao,expenses,education,-65.91,-86555.31
buyer_4,Jorge,,ES96209506732557392462,TRX_N-01110-57391090,2024-08-12T15:04:06,Hondarribia,expenses,cash,-100.0,-86655.31
buyer_4,Jorge,,ES96209506732557392462,TRX_N-01111-96740529,2024-08-13T15:10:17,Hernani,expenses,healthcare,-73.01,-86728.32
buyer_4,Jorge,,ES96209506732557392462,TRX_N-01112-62583788,2024-08-13T19:37:11,Galdakao,expenses,cash,-100.0,-86828.32
buyer_4,Jorge,,ES96209506732557392462,TRX_N-01113-73312122,2024-08-14T10:07:41,Galdakao,expenses,gifts,-85.36,-86913.68
buyer_4,Jorge,,ES96209506732557392462,TRX_N-01114-21934719,2024-08-16T14:13:24,Galdakao,expenses,repairs,-240.39,-87154.07
buyer_4,Jorge,,ES96209506732557392462,TRX_N-01115-06884014,2024-08-17T15:09:19,Hernani,expenses,appliances,-132.08,-87286.15
buyer_4,Jorge,,ES96209506732557392462,TRX_N-01116-21246500,2024-08-18T08:33:10,Galdakao,expenses,children,-1146.05,-88432.2
buyer_4,Jorge,,ES96209506732557392462,TRX_N-01117-01776719,2024-08-19T12:32:10,Getxo,expenses,education,-55.05,-88487.25
buyer_4,Jorge,,ES96209506732557392462,TRX_N-01118-52989367,2024-08-19T16:21:24,Galdakao,expenses,repairs,-190.06,-88677.31
buyer_4,Jorge,,ES96209506732557392462,TRX_N-01119-47161031,2024-08-19T08:53:48,Galdakao,expenses,children,-1087.97,-89765.28
buyer_4,Jorge,,ES96209506732557392462,TRX_N-01120-06287453,2024-08-23T17:42:38,Galdakao,expenses,gifts,-790.82,-90556.1
buyer_4,Jorge,,ES96209506732557392462,TRX_N-01121-20677218,2024-08-24T14:31:41,Galdakao,expenses,food,-82.79,-90638.89
buyer_4,Jorge,,ES96209506732557392462,TRX_N-01122-47203253,2024-08-25T17:52:22,Donostia,expenses,education,-63.79,-90702.68
buyer_4,Jorge,,ES96209506732557392462,TRX_N-01123-85796843,2024-08-26T20:47:38,Hondarribia,expenses,food,-62.77,-90765.45
buyer_4,Jorge,,ES96209506732557392462,TRX_N-01124-40532172,2024-08-28T08:37:12,Galdakao,expenses,transport,-52.11,-90817.56
buyer_4,Jorge,,ES96209506732557392462,TRX_N-01125-47284712,2024-08-28T15:49:15,Galdakao,expenses,cash,-100.0,-90917.56
buyer_4,Jorge,,ES96209506732557392462,TRX_N-01126-62229883,2024-08-28T23:57:20,Galdakao,expenses,repairs,-143.81,-91061.37
buyer_4,Jorge,,ES96209506732557392462,TRX_N-01127-65815982,2024-08-28T14:42:50,Galdakao,expenses,gifts,-370.38,-91431.75
buyer_4,Jorge,,ES96209506732557392462,TRX_N-01128-47137401,2024-08-30T18:39:48,Portugalete,expenses,cash,-100.0,-91531.75
buyer_4,Jorge,,ES96209506732557392462,TRX_N-01129-50219894,2024-08-31T15:40:09,Getxo,expenses,cash,-100.0,-91631.75
buyer_4,Jorge,,ES96209506732557392462,TRX_N-01130-56739029,2024-09-01T08:04:40,Galdakao,incomes,salary,2341.5,-89290.25
buyer_4,Jorge,,ES96209506732557392462,TRX_N-01131-13899529,2024-09-01T09:12:28,Galdakao,expenses,car,-253.4,-89543.65
buyer_4,Jorge,,ES96209506732557392462,TRX_N-01132-95961533,2024-09-02T23:30:04,Galdakao,expenses,food,-79.56,-89623.21
buyer_4,Jorge,,ES96209506732557392462,TRX_N-01133-71178890,2024-09-02T23:19:42,Galdakao,expenses,cash,-100.0,-89723.21
buyer_4,Jorge,,ES96209506732557392462,TRX_N-01134-72868992,2024-09-02T08:47:21,Galdakao,expenses,children,-1256.3,-90979.51
buyer_4,Jorge,,ES96209506732557392462,TRX_N-01135-66734188,2024-09-04T08:45:43,Galdakao,expenses,mortgage,-706.56,-91686.07
buyer_4,Jorge,,ES96209506732557392462,TRX_N-01136-18875138,2024-09-04T09:29:06,Errenteria,expenses,food,-117.03,-91803.1
buyer_4,Jorge,,ES96209506732557392462,TRX_N-01137-72427317,2024-09-04T13:07:13,Pasaia,expenses,leisure,-29.41,-91832.51
buyer_4,Jorge,,ES96209506732557392462,TRX_N-01138-09885170,2024-09-04T17:27:57,Galdakao,expenses,healthcare,-113.15,-91945.66
buyer_4,Jorge,,ES96209506732557392462,TRX_N-01139-42520048,2024-09-05T14:05:54,Galdakao,expenses,gas,-41.64,-91987.3
buyer_4,Jorge,,ES96209506732557392462,TRX_N-01140-69889010,2024-09-05T14:16:46,Galdakao,expenses,leisure,-67.2,-92054.5
buyer_4,Jorge,,ES96209506732557392462,TRX_N-01141-10703266,2024-09-05T14:41:24,Galdakao,expenses,repairs,-311.71,-92366.21
buyer_4,Jorge,,ES96209506732557392462,TRX_N-01142-95587725,2024-09-06T19:40:53,Galdakao,expenses,internet,-42.0,-92408.21
buyer_4,Jorge,,ES96209506732557392462,TRX_N-01143-23027027,2024-09-06T18:28:18,Galdakao,expenses,phone,-38.3,-92446.51
buyer_4,Jorge,,ES96209506732557392462,TRX_N-01144-39648344,2024-09-06T08:27:50,Galdakao,expenses,leisure,-63.12,-92509.63
buyer_4,Jorge,,ES96209506732557392462,TRX_N-01145-45114477,2024-09-07T12:15:49,Galdakao,expenses,water,-33.49,-92543.12
buyer_4,Jorge,,ES96209506732557392462,TRX_N-01146-50640516,2024-09-07T19:26:43,Galdakao,expenses,electricity,-42.61,-92585.73
buyer_4,Jorge,,ES96209506732557392462,TRX_N-01147-43917782,2024-09-07T12:12:13,Galdakao,expenses,food,-124.77,-92710.5
buyer_4,Jorge,,ES96209506732557392462,TRX_N-01148-35842866,2024-09-08T11:20:28,Galdakao,expenses,leisure,-81.16,-92791.66
buyer_4,Jorge,,ES96209506732557392462,TRX_N-01149-84492001,2024-09-08T18:12:45,Galdakao,expenses,gifts,-108.81,-92900.47
buyer_4,Jorge,,ES96209506732557392462,TRX_N-01150-51488245,2024-09-09T20:18:50,Galdakao,expenses,leisure,-47.76,-92948.23
buyer_4,Jorge,,ES96209506732557392462,TRX_N-01151-44879816,2024-09-09T23:32:29,Galdakao,expenses,children,-815.52,-93763.75
buyer_4,Jorge,,ES96209506732557392462,TRX_N-01152-33666264,2024-09-10T15:05:55,Galdakao,expenses,cash,-100.0,-93863.75
buyer_4,Jorge,,ES96209506732557392462,TRX_N-01153-79167577,2024-09-11T10:36:59,Galdakao,expenses,food,-103.65,-93967.4
buyer_4,Jorge,,ES96209506732557392462,TRX_N-01154-78082653,2024-09-11T15:26:00,Erandio,expenses,leisure,-62.03,-94029.43
buyer_4,Jorge,,ES96209506732557392462,TRX_N-01155-66619413,2024-09-11T14:59:34,Galdakao,expenses,cash,-100.0,-94129.43
buyer_4,Jorge,,ES96209506732557392462,TRX_N-01156-86138449,2024-09-12T12:19:33,Galdakao,expenses,transport,-50.05,-94179.48
buyer_4,Jorge,,ES96209506732557392462,TRX_N-01157-68931700,2024-09-12T13:41:30,Galdakao,expenses,cash,-100.0,-94279.48
buyer_4,Jorge,,ES96209506732557392462,TRX_N-01158-40498141,2024-09-13T19:29:33,Galdakao,expenses,cash,-100.0,-94379.48
buyer_4,Jorge,,ES96209506732557392462,TRX_N-01159-81777800,2024-09-13T10:13:07,Galdakao,expenses,gifts,-220.39,-94599.87
buyer_4,Jorge,,ES96209506732557392462,TRX_N-01160-37205099,2024-09-14T15:50:49,Galdakao,expenses,gifts,-546.25,-95146.12
buyer_4,Jorge,,ES96209506732557392462,TRX_N-01161-82738274,2024-09-17T14:36:44,Galdakao,expenses,cash,-100.0,-95246.12
buyer_4,Jorge,,ES96209506732557392462,TRX_N-01162-85594782,2024-09-19T11:42:56,Galdakao,expenses,transport,-80.74,-95326.86
buyer_4,Jorge,,ES96209506732557392462,TRX_N-01163-76152057,2024-09-22T07:22:09,Mungia,expenses,education,-53.96,-95380.82
buyer_4,Jorge,,ES96209506732557392462,TRX_N-01164-29487235,2024-09-22T09:54:11,Barakaldo,expenses,cash,-100.0,-95480.82
buyer_4,Jorge,,ES96209506732557392462,TRX_N-01165-74976599,2024-09-24T23:22:35,Galdakao,expenses,cash,-100.0,-95580.82
buyer_4,Jorge,,ES96209506732557392462,TRX_N-01166-83122267,2024-09-24T12:58:56,Galdakao,expenses,gifts,-828.17,-96408.99
buyer_4,Jorge,,ES96209506732557392462,TRX_N-01167-58498234,2024-09-26T11:49:02,Vitoria-Gasteiz,expenses,transport,-78.09,-96487.08
buyer_4,Jorge,,ES96209506732557392462,TRX_N-01168-06778194,2024-09-30T18:46:05,Galdakao,expenses,cash,-100.0,-96587.08
buyer_4,Jorge,,ES96209506732557392462,TRX_N-01169-62714786,2024-10-01T18:11:14,Galdakao,incomes,salary,2341.5,-94245.58
buyer_4,Jorge,,ES96209506732557392462,TRX_N-01170-51099030,2024-10-01T18:11:14,Galdakao,incomes,extra_income,415.36,-93830.22
buyer_4,Jorge,,ES96209506732557392462,TRX_N-01171-76368547,2024-10-02T09:25:21,Galdakao,expenses,food,-84.61,-93914.83
buyer_4,Jorge,,ES96209506732557392462,TRX_N-01172-19260498,2024-10-04T10:41:34,Galdakao,expenses,mortgage,-706.56,-94621.39
buyer_4,Jorge,,ES96209506732557392462,TRX_N-01173-48969931,2024-10-05T10:09:10,Galdakao,expenses,electricity,-85.25,-94706.64
buyer_4,Jorge,,ES96209506732557392462,TRX_N-01174-87341684,2024-10-05T20:08:32,Galdakao,expenses,gas,-111.58,-94818.22
buyer_4,Jorge,,ES96209506732557392462,TRX_N-01175-14108251,2024-10-05T23:45:47,Galdakao,expenses,transport,-80.64,-94898.86
buyer_4,Jorge,,ES96209506732557392462,TRX_N-01176-68618591,2024-10-06T11:35:26,Galdakao,expenses,gifts,-727.29,-95626.15
buyer_4,Jorge,,ES96209506732557392462,TRX_N-01177-63593646,2024-10-08T23:58:23,Galdakao,expenses,water,-24.51,-95650.66
buyer_4,Jorge,,ES96209506732557392462,TRX_N-01178-11223323,2024-10-08T15:46:47,Galdakao,expenses,internet,-42.0,-95692.66
buyer_4,Jorge,,ES96209506732557392462,TRX_N-01179-43503653,2024-10-08T18:36:03,Galdakao,expenses,phone,-44.36,-95737.02
buyer_4,Jorge,,ES96209506732557392462,TRX_N-01180-13319773,2024-10-09T13:10:16,Galdakao,expenses,transport,-81.97,-95818.99
buyer_5,Sara,,ES72209574622661518175,TRX_N-00001-40678880,2022-01-01T17:10:58,Donostia,incomes,salary,2736.26,3932.4
buyer_5,Sara,,ES72209574622661518175,TRX_N-00002-64966523,2022-01-01T17:10:58,Donostia,incomes,salary_partner,2331.09,6263.49
buyer_5,Sara,,ES72209574622661518175,TRX_N-00003-01118000,2022-01-01T14:48:13,Donostia,expenses,cash,-100.0,6163.49
buyer_5,Sara,,ES72209574622661518175,TRX_N-00004-21764085,2022-01-02T10:48:12,Donostia,expenses,transport,-74.98,6088.51
buyer_5,Sara,,ES72209574622661518175,TRX_N-00005-51589251,2022-01-03T09:21:21,Donostia,expenses,cash,-100.0,5988.51
buyer_5,Sara,,ES72209574622661518175,TRX_N-00006-97224153,2022-01-04T10:30:48,Donostia,expenses,mortgage,-814.56,5173.95
buyer_5,Sara,,ES72209574622661518175,TRX_N-00007-62955275,2022-01-05T15:09:26,Donostia,expenses,education,-61.57,5112.38
buyer_5,Sara,,ES72209574622661518175,TRX_N-00008-84507441,2022-01-06T18:43:50,Donostia,expenses,water,-23.92,5088.46
buyer_5,Sara,,ES72209574622661518175,TRX_N-00009-15746215,2022-01-06T13:50:17,Donostia,expenses,repairs,-129.93,4958.53
buyer_5,Sara,,ES72209574622661518175,TRX_N-00010-14238355,2022-01-07T18:55:22,Donostia,expenses,gas,-45.15,4913.38
buyer_5,Sara,,ES72209574622661518175,TRX_N-00011-95892317,2022-01-07T13:05:14,Alegría-Dulantzi,expenses,leisure,-70.58,4842.8
buyer_5,Sara,,ES72209574622661518175,TRX_N-00012-06551282,2022-01-07T09:48:59,Donostia,expenses,cash,-100.0,4742.8
buyer_5,Sara,,ES72209574622661518175,TRX_N-00013-27002475,2022-01-08T19:47:23,Donostia,expenses,electricity,-46.25,4696.55
buyer_5,Sara,,ES72209574622661518175,TRX_N-00014-22859423,2022-01-08T23:53:30,Donostia,expenses,internet,-42.0,4654.55
buyer_5,Sara,,ES72209574622661518175,TRX_N-00015-35971581,2022-01-08T08:20:30,Donostia,expenses,phone,-43.63,4610.92
buyer_5,Sara,,ES72209574622661518175,TRX_N-00016-86237054,2022-01-08T10:58:44,Getxo,expenses,transport,-42.67,4568.25
buyer_5,Sara,,ES72209574622661518175,TRX_N-00017-95684592,2022-01-09T12:16:35,Donostia,expenses,leisure,-80.59,4487.66
buyer_5,Sara,,ES72209574622661518175,TRX_N-00018-38364381,2022-01-10T02:48:34,Donostia,expenses,leisure,-71.72,4415.94
buyer_5,Sara,,ES72209574622661518175,TRX_N-00019-42017489,2022-01-11T08:07:45,Donostia,expenses,clothing,-103.49,4312.45
buyer_5,Sara,,ES72209574622661518175,TRX_N-00020-17456600,2022-01-11T15:36:15,Donostia,expenses,repairs,-41.16,4271.29
buyer_5,Sara,,ES72209574622661518175,TRX_N-00021-24567041,2022-01-12T22:27:22,Donostia,expenses,food,-90.46,4180.83
buyer_5,Sara,,ES72209574622661518175,TRX_N-00022-96763715,2022-01-12T00:07:34,Donostia,expenses,clothing,-84.76,4096.07
buyer_5,Sara,,ES72209574622661518175,TRX_N-00023-05188738,2022-01-12T12:57:22,Donostia,expenses,cash,-100.0,3996.07
buyer_5,Sara,,ES72209574622661518175,TRX_N-00024-08346205,2022-01-13T15:55:12,Donostia,expenses,food,-122.23,3873.84
buyer_5,Sara,,ES72209574622661518175,TRX_N-00025-04783375,2022-01-13T23:39:12,Donostia,expenses,transport,-47.71,3826.13
buyer_5,Sara,,ES72209574622661518175,TRX_N-00026-21352621,2022-01-13T03:14:58,Donostia,expenses,education,-45.26,3780.87
buyer_5,Sara,,ES72209574622661518175,TRX_N-00027-18015814,2022-01-15T16:37:26,Donostia,expenses,leisure,-41.0,3739.87
buyer_5,Sara,,ES72209574622661518175,TRX_N-00028-88319827,2022-01-15T11:40:24,Donostia,expenses,clothing,-84.05,3655.82
buyer_5,Sara,,ES72209574622661518175,TRX_N-00029-70565947,2022-01-17T06:02:08,Donostia,expenses,appliances,-362.77,3293.05
buyer_5,Sara,,ES72209574622661518175,TRX_N-00030-60933908,2022-01-18T17:35:01,Amurrio,expenses,gifts,-134.21,3158.84
buyer_5,Sara,,ES72209574622661518175,TRX_N-00031-06847287,2022-01-19T10:39:41,Donostia,expenses,repairs,-120.93,3037.91
buyer_5,Sara,,ES72209574622661518175,TRX_N-00032-80891177,2022-01-20T18:57:54,Donostia,expenses,leisure,-55.59,2982.32
buyer_5,Sara,,ES72209574622661518175,TRX_N-00033-77136965,2022-01-26T20:03:58,Lasarte-Oria,expenses,cash,-100.0,2882.32
buyer_5,Sara,,ES72209574622661518175,TRX_N-00034-59290700,2022-01-28T18:47:47,Portugalete,expenses,cash,-100.0,2782.32
buyer_5,Sara,,ES72209574622661518175,TRX_N-00035-45012355,2022-01-29T19:40:52,Mungia,expenses,leisure,-55.38,2726.94
buyer_5,Sara,,ES72209574622661518175,TRX_N-00036-59812740,2022-01-31T14:20:05,Donostia,expenses,transport,-52.74,2674.2
buyer_5,Sara,,ES72209574622661518175,TRX_N-00037-78700691,2022-01-31T16:58:02,Portugalete,expenses,gifts,-314.14,2360.06
buyer_5,Sara,,ES72209574622661518175,TRX_N-00038-45315337,2022-02-01T11:52:30,Donostia,incomes,salary,2736.26,5096.32
buyer_5,Sara,,ES72209574622661518175,TRX_N-00039-77241106,2022-02-01T11:52:30,Donostia,incomes,salary_partner,2331.09,7427.41
buyer_5,Sara,,ES72209574622661518175,TRX_N-00040-41895176,2022-02-01T11:30:23,Donostia,expenses,cash,-100.0,7327.41
buyer_5,Sara,,ES72209574622661518175,TRX_N-00041-32279808,2022-02-03T06:02:26,Donostia,expenses,repairs,-211.15,7116.26
buyer_5,Sara,,ES72209574622661518175,TRX_N-00042-18470461,2022-02-04T23:57:22,Donostia,expenses,mortgage,-814.56,6301.7
buyer_5,Sara,,ES72209574622661518175,TRX_N-00043-53237750,2022-02-04T10:33:59,Donostia,expenses,leisure,-62.21,6239.49
buyer_5,Sara,,ES72209574622661518175,TRX_N-00044-20809360,2022-02-06T18:41:29,Donostia,expenses,electricity,-88.41,6151.08
buyer_5,Sara,,ES72209574622661518175,TRX_N-00045-39206137,2022-02-06T12:16:20,Donostia,expenses,repairs,-86.74,6064.34
buyer_5,Sara,,ES72209574622661518175,TRX_N-00046-35892425,2022-02-07T19:10:59,Donostia,expenses,water,-41.26,6023.08
buyer_5,Sara,,ES72209574622661518175,TRX_N-00047-67592492,2022-02-07T08:41:36,Donostia,expenses,internet,-42.0,5981.08
buyer_5,Sara,,ES72209574622661518175,TRX_N-00048-66733282,2022-02-07T18:53:54,Donostia,expenses,phone,-39.71,5941.37
buyer_5,Sara,,ES72209574622661518175,TRX_N-00049-31259920,2022-02-07T17:24:16,Donostia,expenses,transport,-58.15,5883.22
buyer_5,Sara,,ES72209574622661518175,TRX_N-00050-18455647,2022-02-07T16:09:15,Donostia,expenses,leisure,-45.58,5837.64
buyer_5,Sara,,ES72209574622661518175,TRX_N-00051-40665482,2022-02-08T21:22:27,Donostia,expenses,gas,-102.13,5735.51
buyer_5,Sara,,ES72209574622661518175,TRX_N-00052-27035487,2022-02-09T13:09:33,Donostia,expenses,transport,-65.55,5669.96
buyer_5,Sara,,ES72209574622661518175,TRX_N-00053-51189875,2022-02-09T18:32:10,Donostia,expenses,leisure,-26.99,5642.97
buyer_5,Sara,,ES72209574622661518175,TRX_N-00054-44973533,2022-02-10T15:55:42,Donostia,expenses,transport,-63.03,5579.94
buyer_5,Sara,,ES72209574622661518175,TRX_N-00055-36060138,2022-02-10T22:40:42,Donostia,expenses,leisure,-77.68,5502.26
buyer_5,Sara,,ES72209574622661518175,TRX_N-00056-76492529,2022-02-10T17:57:17,Donostia,expenses,clothing,-115.02,5387.24
buyer_5,Sara,,ES72209574622661518175,TRX_N-00057-95953652,2022-02-11T23:41:52,Salvatierra/Agurain,expenses,transport,-55.05,5332.19
buyer_5,Sara,,ES72209574622661518175,TRX_N-00058-57386171,2022-02-12T19:43:01,Donostia,expenses,clothing,-120.02,5212.17
buyer_5,Sara,,ES72209574622661518175,TRX_N-00059-29520361,2022-02-13T16:41:43,Donostia,expenses,transport,-48.76,5163.41
buyer_5,Sara,,ES72209574622661518175,TRX_N-00060-57035573,2022-02-13T22:33:23,Donostia,expenses,repairs,-228.17,4935.24
buyer_5,Sara,,ES72209574622661518175,TRX_N-00061-57324985,2022-02-15T18:40:36,Donostia,expenses,transport,-86.75,4848.49
buyer_5,Sara,,ES72209574622661518175,TRX_N-00062-95210134,2022-02-15T10:47:19,Donostia,expenses,cash,-100.0,4748.49
buyer_5,Sara,,ES72209574622661518175,TRX_N-00063-70248865,2022-02-17T21:08:40,Donostia,expenses,leisure,-19.93,4728.56
buyer_5,Sara,,ES72209574622661518175,TRX_N-00064-73206020,2022-02-17T11:34:14,Donostia,expenses,cash,-100.0,4628.56
buyer_5,Sara,,ES72209574622661518175,TRX_N-00065-00429818,2022-02-18T11:48:19,Portugalete,expenses,transport,-69.14,4559.42
buyer_5,Sara,,ES72209574622661518175,TRX_N-00066-70285776,2022-02-20T14:28:53,Donostia,expenses,transport,-50.9,4508.52
buyer_5,Sara,,ES72209574622661518175,TRX_N-00067-44023581,2022-02-20T15:38:46,Donostia,expenses,leisure,-55.0,4453.52
buyer_5,Sara,,ES72209574622661518175,TRX_N-00068-02285082,2022-02-21T10:04:06,Mungia,expenses,food,-101.28,4352.24
buyer_5,Sara,,ES72209574622661518175,TRX_N-00069-17086600,2022-02-21T11:41:40,Donostia,expenses,transport,-72.63,4279.61
buyer_5,Sara,,ES72209574622661518175,TRX_N-00070-61236320,2022-02-21T13:45:41,Donostia,expenses,cash,-100.0,4179.61
buyer_5,Sara,,ES72209574622661518175,TRX_N-00071-12534856,2022-02-25T15:39:08,Donostia,expenses,leisure,-68.9,4110.71
buyer_5,Sara,,ES72209574622661518175,TRX_N-00072-26389698,2022-02-25T17:28:37,Donostia,expenses,cash,-100.0,4010.71
buyer_5,Sara,,ES72209574622661518175,TRX_N-00073-62360845,2022-02-28T17:55:52,Donostia,expenses,food,-113.33,3897.38
buyer_5,Sara,,ES72209574622661518175,TRX_N-00074-52174914,2022-02-28T11:03:33,Donostia,expenses,gifts,-511.45,3385.93
buyer_5,Sara,,ES72209574622661518175,TRX_N-00075-81404897,2022-03-01T15:38:03,Donostia,incomes,salary,2736.26,6122.19
buyer_5,Sara,,ES72209574622661518175,TRX_N-00076-20097589,2022-03-01T15:38:03,Donostia,incomes,salary_partner,2331.09,8453.28
buyer_5,Sara,,ES72209574622661518175,TRX_N-00077-90020382,2022-03-01T15:38:03,Donostia,incomes,extra_income,303.94,8757.22
buyer_5,Sara,,ES72209574622661518175,TRX_N-00078-31258616,2022-03-01T14:29:49,Donostia,expenses,leisure,-47.15,8710.07
buyer_5,Sara,,ES72209574622661518175,TRX_N-00079-00479176,2022-03-01T11:53:27,Errenteria,expenses,gifts,-113.78,8596.29
buyer_5,Sara,,ES72209574622661518175,TRX_N-00080-98796451,2022-03-02T14:38:33,Donostia,expenses,food,-83.67,8512.62
buyer_5,Sara,,ES72209574622661518175,TRX_N-00081-52240797,2022-03-02T18:43:17,Donostia,expenses,clothing,-69.03,8443.59
buyer_5,Sara,,ES72209574622661518175,TRX_N-00082-24983129,2022-03-03T14:13:55,Donostia,expenses,transport,-44.84,8398.75
buyer_5,Sara,,ES72209574622661518175,TRX_N-00083-84191172,2022-03-04T18:22:09,Donostia,expenses,mortgage,-814.56,7584.19
buyer_5,Sara,,ES72209574622661518175,TRX_N-00084-91682317,2022-03-05T10:38:06,Donostia,expenses,repairs,-319.25,7264.94
buyer_5,Sara,,ES72209574622661518175,TRX_N-00085-83217674,2022-03-05T09:03:27,Donostia,expenses,gifts,-208.57,7056.37
buyer_5,Sara,,ES72209574622661518175,TRX_N-00086-92141464,2022-03-06T12:56:39,Donostia,expenses,gas,-44.69,7011.68
buyer_5,Sara,,ES72209574622661518175,TRX_N-00087-53868307,2022-03-07T22:10:44,Donostia,expenses,internet,-42.0,6969.68
buyer_5,Sara,,ES72209574622661518175,TRX_N-00088-36089133,2022-03-08T18:40:37,Donostia,expenses,water,-42.64,6927.04
buyer_5,Sara,,ES72209574622661518175,TRX_N-00089-68950620,2022-03-08T23:19:36,Donostia,expenses,electricity,-50.97,6876.07
buyer_5,Sara,,ES72209574622661518175,TRX_N-00090-83763981,2022-03-08T14:09:28,Donostia,expenses,phone,-33.27,6842.8
buyer_5,Sara,,ES72209574622661518175,TRX_N-00091-66789497,2022-03-08T20:42:32,Errenteria,expenses,cash,-100.0,6742.8
buyer_5,Sara,,ES72209574622661518175,TRX_N-00092-03466964,2022-03-09T23:41:40,Donostia,expenses,leisure,-52.7,6690.1
buyer_5,Sara,,ES72209574622661518175,TRX_N-00093-95138895,2022-03-10T16:24:19,Donostia,expenses,food,-107.2,6582.9
buyer_5,Sara,,ES72209574622661518175,TRX_N-00094-58041812,2022-03-10T08:43:33,Donostia,expenses,gifts,-255.27,6327.63
buyer_5,Sara,,ES72209574622661518175,TRX_N-00095-54019224,2022-03-14T20:15:12,Donostia,expenses,food,-92.31,6235.32
buyer_5,Sara,,ES72209574622661518175,TRX_N-00096-48936587,2022-03-15T13:09:34,Donostia,expenses,transport,-77.31,6158.01
buyer_5,Sara,,ES72209574622661518175,TRX_N-00097-05439279,2022-03-15T11:51:45,Donostia,expenses,leisure,-67.98,6090.03
buyer_5,Sara,,ES72209574622661518175,TRX_N-00098-60690212,2022-03-18T17:18:04,Amurrio,expenses,food,-102.62,5987.41
buyer_5,Sara,,ES72209574622661518175,TRX_N-00099-15235787,2022-03-18T16:59:07,Donostia,expenses,healthcare,-188.6,5798.81
buyer_5,Sara,,ES72209574622661518175,TRX_N-00100-59906735,2022-03-19T09:46:50,Galdakao,expenses,travel,-715.48,5083.33
buyer_5,Sara,,ES72209574622661518175,TRX_N-00101-93177330,2022-03-22T07:19:50,Donostia,expenses,transport,-55.63,5027.7
buyer_5,Sara,,ES72209574622661518175,TRX_N-00102-15446022,2022-03-22T12:00:20,Donostia,expenses,cash,-100.0,4927.7
buyer_5,Sara,,ES72209574622661518175,TRX_N-00103-53583303,2022-03-24T14:43:12,Donostia,expenses,cash,-100.0,4827.7
buyer_5,Sara,,ES72209574622661518175,TRX_N-00104-78109349,2022-03-29T20:04:30,Donostia,expenses,gifts,-32.07,4795.63
buyer_5,Sara,,ES72209574622661518175,TRX_N-00105-19539503,2022-03-30T16:30:34,Donostia,expenses,gifts,-734.05,4061.58
buyer_5,Sara,,ES72209574622661518175,TRX_N-00106-21013587,2022-03-31T21:38:16,Donostia,expenses,travel,-1846.9,2214.68
buyer_5,Sara,,ES72209574622661518175,TRX_N-00107-33554464,2022-04-01T09:25:51,Donostia,incomes,salary,2736.26,4950.94
buyer_5,Sara,,ES72209574622661518175,TRX_N-00108-97963903,2022-04-01T09:25:51,Donostia,incomes,salary_partner,2331.09,7282.03
buyer_5,Sara,,ES72209574622661518175,TRX_N-00109-84703707,2022-04-02T23:36:30,Donostia,expenses,leisure,-66.32,7215.71
buyer_5,Sara,,ES72209574622661518175,TRX_N-00110-73989058,2022-04-02T08:50:59,Donostia,expenses,cash,-100.0,7115.71
buyer_5,Sara,,ES72209574622661518175,TRX_N-00111-29158096,2022-04-04T10:11:23,Donostia,expenses,mortgage,-814.56,6301.15
buyer_5,Sara,,ES72209574622661518175,TRX_N-00112-88052091,2022-04-04T14:20:59,Donostia,expenses,healthcare,-142.59,6158.56
buyer_5,Sara,,ES72209574622661518175,TRX_N-00113-58769387,2022-04-05T22:29:29,Donostia,expenses,internet,-42.0,6116.56
buyer_5,Sara,,ES72209574622661518175,TRX_N-00114-94869802,2022-04-05T14:09:22,Donostia,expenses,phone,-36.33,6080.23
buyer_5,Sara,,ES72209574622661518175,TRX_N-00115-73476078,2022-04-06T03:53:35,Donostia,expenses,electricity,-33.88,6046.35
buyer_5,Sara,,ES72209574622661518175,TRX_N-00116-27194874,2022-04-07T10:35:45,Donostia,expenses,food,-110.44,5935.91
buyer_5,Sara,,ES72209574622661518175,TRX_N-00117-70943543,2022-04-08T22:17:54,Donostia,expenses,water,-41.23,5894.68
buyer_5,Sara,,ES72209574622661518175,TRX_N-00118-84856553,2022-04-08T14:21:02,Donostia,expenses,gas,-42.21,5852.47
buyer_5,Sara,,ES72209574622661518175,TRX_N-00119-64166853,2022-04-08T17:38:00,Amurrio,expenses,cash,-100.0,5752.47
buyer_5,Sara,,ES72209574622661518175,TRX_N-00120-97745876,2022-04-10T21:05:50,Donostia,expenses,transport,-53.77,5698.7
buyer_5,Sara,,ES72209574622661518175,TRX_N-00121-30942309,2022-04-12T12:58:59,Alegría-Dulantzi,expenses,clothing,-159.05,5539.65
buyer_5,Sara,,ES72209574622661518175,TRX_N-00122-48229020,2022-04-14T11:03:04,Donostia,expenses,clothing,-73.01,5466.64
buyer_5,Sara,,ES72209574622661518175,TRX_N-00123-20396643,2022-04-15T19:56:24,Donostia,expenses,leisure,-19.1,5447.54
buyer_5,Sara,,ES72209574622661518175,TRX_N-00124-10926121,2022-04-21T21:01:42,Amurrio,expenses,cash,-100.0,5347.54
buyer_5,Sara,,ES72209574622661518175,TRX_N-00125-23085644,2022-04-23T14:43:33,Donostia,expenses,leisure,-52.95,5294.59
buyer_5,Sara,,ES72209574622661518175,TRX_N-00126-21420640,2022-04-24T18:57:25,Donostia,expenses,clothing,-65.64,5228.95
buyer_5,Sara,,ES72209574622661518175,TRX_N-00127-64708109,2022-04-25T09:25:01,Donostia,expenses,healthcare,-72.62,5156.33
buyer_5,Sara,,ES72209574622661518175,TRX_N-00128-79029774,2022-04-26T15:24:31,Galdakao,expenses,appliances,-308.05,4848.28
buyer_5,Sara,,ES72209574622661518175,TRX_N-00129-21406781,2022-04-27T14:20:15,Donostia,expenses,cash,-100.0,4748.28
buyer_5,Sara,,ES72209574622661518175,TRX_N-00130-49861262,2022-04-29T08:10:09,Pasaia,expenses,food,-108.48,4639.8
buyer_5,Sara,,ES72209574622661518175,TRX_N-00131-08202239,2022-05-01T18:22:23,Donostia,incomes,salary,2736.26,7376.06
buyer_5,Sara,,ES72209574622661518175,TRX_N-00132-15594580,2022-05-01T18:22:23,Donostia,incomes,salary_partner,2331.09,9707.15
buyer_5,Sara,,ES72209574622661518175,TRX_N-00133-93231805,2022-05-01T16:08:57,Donostia,expenses,food,-73.37,9633.78
buyer_5,Sara,,ES72209574622661518175,TRX_N-00134-83841758,2022-05-01T18:42:09,Donostia,expenses,cash,-100.0,9533.78
buyer_5,Sara,,ES72209574622661518175,TRX_N-00135-74244791,2022-05-02T09:50:45,Donostia,expenses,cash,-100.0,9433.78
buyer_5,Sara,,ES72209574622661518175,TRX_N-00136-70246546,2022-05-04T14:38:30,Donostia,expenses,mortgage,-814.56,8619.22
buyer_5,Sara,,ES72209574622661518175,TRX_N-00137-82193580,2022-05-05T21:43:08,Donostia,expenses,phone,-32.22,8587.0
buyer_5,Sara,,ES72209574622661518175,TRX_N-00138-30034856,2022-05-06T07:10:23,Donostia,expenses,electricity,-36.11,8550.89
buyer_5,Sara,,ES72209574622661518175,TRX_N-00139-47250345,2022-05-06T08:25:22,Donostia,expenses,gas,-97.9,8452.99
buyer_5,Sara,,ES72209574622661518175,TRX_N-00140-02796711,2022-05-07T13:44:48,Donostia,expenses,food,-96.19,8356.8
buyer_5,Sara,,ES72209574622661518175,TRX_N-00141-17312561,2022-05-07T04:01:35,Donostia,expenses,cash,-100.0,8256.8
buyer_5,Sara,,ES72209574622661518175,TRX_N-00142-35852964,2022-05-08T18:56:48,Donostia,expenses,water,-33.61,8223.19
buyer_5,Sara,,ES72209574622661518175,TRX_N-00143-21591561,2022-05-08T12:22:31,Donostia,expenses,internet,-42.0,8181.19
buyer_5,Sara,,ES72209574622661518175,TRX_N-00144-51561458,2022-05-08T03:53:42,Donostia,expenses,cash,-100.0,8081.19
buyer_5,Sara,,ES72209574622661518175,TRX_N-00145-82810493,2022-05-09T09:55:59,Donostia,expenses,education,-56.08,8025.11
buyer_5,Sara,,ES72209574622661518175,TRX_N-00146-45024401,2022-05-11T13:29:39,Donostia,expenses,transport,-80.7,7944.41
buyer_5,Sara,,ES72209574622661518175,TRX_N-00147-21615914,2022-05-14T18:20:29,Donostia,expenses,healthcare,-90.59,7853.82
buyer_5,Sara,,ES72209574622661518175,TRX_N-00148-35363217,2022-05-15T09:41:47,Donostia,expenses,transport,-71.64,7782.18
buyer_5,Sara,,ES72209574622661518175,TRX_N-00149-22707564,2022-05-17T09:16:06,Donostia,expenses,leisure,-58.12,7724.06
buyer_5,Sara,,ES72209574622661518175,TRX_N-00150-63596172,2022-05-17T18:35:57,Donostia,expenses,gifts,-691.55,7032.51
buyer_5,Sara,,ES72209574622661518175,TRX_N-00151-67055911,2022-05-18T10:43:10,Barakaldo,expenses,food,-60.36,6972.15
buyer_5,Sara,,ES72209574622661518175,TRX_N-00152-36689007,2022-05-18T08:50:16,Donostia,expenses,transport,-49.97,6922.18
buyer_5,Sara,,ES72209574622661518175,TRX_N-00153-47868739,2022-05-20T10:40:23,Donostia,expenses,clothing,-130.69,6791.49
buyer_5,Sara,,ES72209574622661518175,TRX_N-00154-90147530,2022-05-20T10:19:56,Basauri,expenses,cash,-100.0,6691.49
buyer_5,Sara,,ES72209574622661518175,TRX_N-00155-73804177,2022-05-21T08:52:24,Donostia,expenses,transport,-55.03,6636.46
buyer_5,Sara,,ES72209574622661518175,TRX_N-00156-50482637,2022-05-22T08:40:39,Donostia,expenses,food,-88.46,6548.0
buyer_5,Sara,,ES72209574622661518175,TRX_N-00157-08630930,2022-05-22T08:17:21,Donostia,expenses,transport,-46.57,6501.43
buyer_5,Sara,,ES72209574622661518175,TRX_N-00158-47511990,2022-05-24T14:29:08,Hernani,expenses,leisure,-66.48,6434.95
buyer_5,Sara,,ES72209574622661518175,TRX_N-00159-56678237,2022-05-25T13:45:16,Donostia,expenses,food,-84.54,6350.41
buyer_5,Sara,,ES72209574622661518175,TRX_N-00160-75660148,2022-05-27T16:19:46,Basauri,expenses,food,-114.69,6235.72
buyer_5,Sara,,ES72209574622661518175,TRX_N-00161-20048318,2022-05-28T08:12:09,Donostia,expenses,food,-90.43,6145.29
buyer_5,Sara,,ES72209574622661518175,TRX_N-00162-39236349,2022-05-28T20:20:10,Donostia,expenses,clothing,-48.4,6096.89
buyer_5,Sara,,ES72209574622661518175,TRX_N-00163-92370422,2022-06-01T11:38:12,Donostia,incomes,salary,2736.26,8833.15
buyer_5,Sara,,ES72209574622661518175,TRX_N-00164-66867910,2022-06-01T11:38:12,Donostia,incomes,salary_partner,2331.09,11164.24
buyer_5,Sara,,ES72209574622661518175,TRX_N-00165-30011780,2022-06-01T11:38:12,Donostia,incomes,salary_bonus,2092.78,13257.02
buyer_5,Sara,,ES72209574622661518175,TRX_N-00166-88536939,2022-06-01T11:38:12,Donostia,incomes,salary_partner_bonus,1858.41,15115.43
buyer_5,Sara,,ES72209574622661518175,TRX_N-00167-07732217,2022-06-02T17:58:44,Donostia,expenses,transport,-41.56,15073.87
buyer_5,Sara,,ES72209574622661518175,TRX_N-00168-87111537,2022-06-02T18:20:40,Leioa,expenses,education,-45.29,15028.58
buyer_5,Sara,,ES72209574622661518175,TRX_N-00169-16824854,2022-06-02T12:10:48,Donostia,expenses,cash,-100.0,14928.58
buyer_5,Sara,,ES72209574622661518175,TRX_N-00170-21882658,2022-06-03T14:28:14,Donostia,expenses,cash,-100.0,14828.58
buyer_5,Sara,,ES72209574622661518175,TRX_N-00171-02657089,2022-06-04T10:56:06,Donostia,expenses,mortgage,-814.56,14014.02
buyer_5,Sara,,ES72209574622661518175,TRX_N-00172-14199395,2022-06-04T15:49:32,Donostia,expenses,leisure,-83.43,13930.59
buyer_5,Sara,,ES72209574622661518175,TRX_N-00173-78847889,2022-06-04T10:37:56,Donostia,expenses,education,-44.49,13886.1
buyer_5,Sara,,ES72209574622661518175,TRX_N-00174-20084252,2022-06-04T11:58:04,Donostia,expenses,cash,-100.0,13786.1
buyer_5,Sara,,ES72209574622661518175,TRX_N-00175-32980731,2022-06-05T21:34:24,Donostia,expenses,leisure,-23.87,13762.23
buyer_5,Sara,,ES72209574622661518175,TRX_N-00176-48204649,2022-06-06T16:46:43,Donostia,expenses,food,-60.51,13701.72
buyer_5,Sara,,ES72209574622661518175,TRX_N-00177-83524370,2022-06-07T18:16:28,Donostia,expenses,internet,-42.0,13659.72
buyer_5,Sara,,ES72209574622661518175,TRX_N-00178-65777636,2022-06-07T17:09:08,Donostia,expenses,phone,-35.39,13624.33
buyer_5,Sara,,ES72209574622661518175,TRX_N-00179-79136245,2022-06-07T17:43:08,Donostia,expenses,education,-64.86,13559.47
buyer_5,Sara,,ES72209574622661518175,TRX_N-00180-38797304,2022-06-08T10:50:51,Donostia,expenses,water,-43.8,13515.67
buyer_5,Sara,,ES72209574622661518175,TRX_N-00181-74832535,2022-06-08T08:05:00,Donostia,expenses,electricity,-69.89,13445.78
buyer_5,Sara,,ES72209574622661518175,TRX_N-00182-23189433,2022-06-08T11:09:10,Donostia,expenses,gas,-66.97,13378.81
buyer_5,Sara,,ES72209574622661518175,TRX_N-00183-18117311,2022-06-10T13:44:30,Errenteria,expenses,repairs,-230.77,13148.04
buyer_5,Sara,,ES72209574622661518175,TRX_N-00184-57037442,2022-06-12T12:57:17,Donostia,expenses,food,-91.59,13056.45
buyer_5,Sara,,ES72209574622661518175,TRX_N-00185-58181471,2022-06-13T22:00:45,Leioa,expenses,food,-73.87,12982.58
buyer_5,Sara,,ES72209574622661518175,TRX_N-00186-36986871,2022-06-13T17:31:53,Donostia,expenses,transport,-67.14,12915.44
buyer_5,Sara,,ES72209574622661518175,TRX_N-00187-74669907,2022-06-14T13:31:36,Labastida,expenses,repairs,-269.93,12645.51
buyer_5,Sara,,ES72209574622661518175,TRX_N-00188-83703653,2022-06-16T11:49:01,Donostia,expenses,education,-51.27,12594.24
buyer_5,Sara,,ES72209574622661518175,TRX_N-00189-61624698,2022-06-17T09:41:21,Donostia,expenses,leisure,-39.27,12554.97
buyer_5,Sara,,ES72209574622661518175,TRX_N-00190-52662551,2022-06-18T19:21:21,Donostia,expenses,leisure,-42.48,12512.49
buyer_5,Sara,,ES72209574622661518175,TRX_N-00191-17437924,2022-06-19T15:57:09,Donostia,expenses,food,-62.86,12449.63
buyer_5,Sara,,ES72209574622661518175,TRX_N-00192-51730285,2022-06-20T17:53:19,Donostia,expenses,cash,-100.0,12349.63
buyer_5,Sara,,ES72209574622661518175,TRX_N-00193-82875768,2022-06-22T16:11:17,Donostia,expenses,transport,-79.72,12269.91
buyer_5,Sara,,ES72209574622661518175,TRX_N-00194-13230905,2022-06-23T08:19:24,Donostia,expenses,cash,-100.0,12169.91
buyer_5,Sara,,ES72209574622661518175,TRX_N-00195-71052788,2022-06-26T20:22:38,Donostia,expenses,transport,-69.29,12100.62
buyer_5,Sara,,ES72209574622661518175,TRX_N-00196-25201116,2022-06-27T13:43:57,Zarautz,expenses,clothing,-53.21,12047.41
buyer_5,Sara,,ES72209574622661518175,TRX_N-00197-23779853,2022-06-29T16:04:08,Donostia,expenses,food,-121.58,11925.83
buyer_5,Sara,,ES72209574622661518175,TRX_N-00198-11876457,2022-07-01T18:15:07,Donostia,incomes,salary,2736.26,14662.09
buyer_5,Sara,,ES72209574622661518175,TRX_N-00199-12511146,2022-07-01T18:15:07,Donostia,incomes,salary_partner,2331.09,16993.18
buyer_5,Sara,,ES72209574622661518175,TRX_N-00200-78664562,2022-07-01T18:15:07,Donostia,incomes,extra_income,303.94,17297.12
buyer_5,Sara,,ES72209574622661518175,TRX_N-00201-24873212,2022-07-01T17:13:41,Donostia,expenses,education,-70.06,17227.06
buyer_5,Sara,,ES72209574622661518175,TRX_N-00202-98403332,2022-07-01T20:45:12,Donostia,expenses,travel,-327.82,16899.24
buyer_5,Sara,,ES72209574622661518175,TRX_N-00203-49698841,2022-07-03T12:36:06,Donostia,expenses,leisure,-56.44,16842.8
buyer_5,Sara,,ES72209574622661518175,TRX_N-00204-86840498,2022-07-04T11:57:40,Donostia,expenses,mortgage,-814.56,16028.24
buyer_5,Sara,,ES72209574622661518175,TRX_N-00205-00282750,2022-07-04T20:19:13,Basauri,expenses,food,-101.07,15927.17
buyer_5,Sara,,ES72209574622661518175,TRX_N-00206-14115741,2022-07-05T12:12:24,Donostia,expenses,food,-112.48,15814.69
buyer_5,Sara,,ES72209574622661518175,TRX_N-00207-74922002,2022-07-06T19:11:23,Donostia,expenses,electricity,-52.8,15761.89
buyer_5,Sara,,ES72209574622661518175,TRX_N-00208-95724484,2022-07-06T06:20:21,Donostia,expenses,gas,-94.87,15667.02
buyer_5,Sara,,ES72209574622661518175,TRX_N-00209-70185864,2022-07-06T17:37:07,Donostia,expenses,internet,-42.0,15625.02
buyer_5,Sara,,ES72209574622661518175,TRX_N-00210-74949606,2022-07-06T10:35:27,Donostia,expenses,leisure,-18.25,15606.77
buyer_5,Sara,,ES72209574622661518175,TRX_N-00211-28619492,2022-07-07T10:34:37,Donostia,expenses,repairs,-234.2,15372.57
buyer_5,Sara,,ES72209574622661518175,TRX_N-00212-99085261,2022-07-08T09:43:34,Donostia,expenses,water,-38.2,15334.37
buyer_5,Sara,,ES72209574622661518175,TRX_N-00213-53438982,2022-07-08T09:33:18,Donostia,expenses,phone,-31.33,15303.04
buyer_5,Sara,,ES72209574622661518175,TRX_N-00214-36913688,2022-07-08T13:13:42,Donostia,expenses,transport,-48.65,15254.39
buyer_5,Sara,,ES72209574622661518175,TRX_N-00215-44945734,2022-07-08T17:46:06,Donostia,expenses,education,-50.43,15203.96
buyer_5,Sara,,ES72209574622661518175,TRX_N-00216-21797730,2022-07-08T12:51:38,Donostia,expenses,gifts,-327.89,14876.07
buyer_5,Sara,,ES72209574622661518175,TRX_N-00217-14867962,2022-07-10T09:07:35,Donostia,expenses,cash,-100.0,14776.07
buyer_5,Sara,,ES72209574622661518175,TRX_N-00218-42653975,2022-07-12T17:49:40,Getxo,expenses,clothing,-118.57,14657.5
buyer_5,Sara,,ES72209574622661518175,TRX_N-00219-65430871,2022-07-13T08:14:45,Donostia,expenses,food,-109.48,14548.02
buyer_5,Sara,,ES72209574622661518175,TRX_N-00220-27478928,2022-07-13T17:28:26,Donostia,expenses,healthcare,-136.44,14411.58
buyer_5,Sara,,ES72209574622661518175,TRX_N-00221-18046373,2022-07-14T12:29:55,Donostia,expenses,transport,-84.33,14327.25
buyer_5,Sara,,ES72209574622661518175,TRX_N-00222-62458134,2022-07-15T15:34:10,Sestao,expenses,transport,-52.93,14274.32
buyer_5,Sara,,ES72209574622661518175,TRX_N-00223-89538252,2022-07-15T08:50:11,Donostia,expenses,education,-68.2,14206.12
buyer_5,Sara,,ES72209574622661518175,TRX_N-00224-48369969,2022-07-15T07:26:20,Donostia,expenses,travel,-422.52,13783.6
buyer_5,Sara,,ES72209574622661518175,TRX_N-00225-86826770,2022-07-18T20:44:06,Donostia,expenses,gifts,-188.03,13595.57
buyer_5,Sara,,ES72209574622661518175,TRX_N-00226-27895167,2022-07-20T14:00:33,Donostia,expenses,transport,-73.18,13522.39
buyer_5,Sara,,ES72209574622661518175,TRX_N-00227-52902462,2022-07-20T17:43:41,Donostia,expenses,cash,-100.0,13422.39
buyer_5,Sara,,ES72209574622661518175,TRX_N-00228-49730043,2022-07-21T15:11:54,Donostia,expenses,food,-86.36,13336.03
buyer_5,Sara,,ES72209574622661518175,TRX_N-00229-20504298,2022-07-21T09:49:49,Donostia,expenses,transport,-60.25,13275.78
buyer_5,Sara,,ES72209574622661518175,TRX_N-00230-56965123,2022-07-22T12:41:44,Donostia,expenses,healthcare,-170.7,13105.08
buyer_5,Sara,,ES72209574622661518175,TRX_N-00231-42824821,2022-07-23T16:44:09,Donostia,expenses,cash,-100.0,13005.08
buyer_5,Sara,,ES72209574622661518175,TRX_N-00232-78226108,2022-07-23T12:50:46,Donostia,expenses,repairs,-121.06,12884.02
buyer_5,Sara,,ES72209574622661518175,TRX_N-00233-38929042,2022-07-24T01:24:14,Donostia,expenses,food,-71.88,12812.14
buyer_5,Sara,,ES72209574622661518175,TRX_N-00234-77663765,2022-07-26T02:23:50,Donostia,expenses,transport,-88.39,12723.75
buyer_5,Sara,,ES72209574622661518175,TRX_N-00235-18833255,2022-07-27T11:33:10,Donostia,expenses,cash,-100.0,12623.75
buyer_5,Sara,,ES72209574622661518175,TRX_N-00236-29588767,2022-07-28T13:07:48,Donostia,expenses,cash,-100.0,12523.75
buyer_5,Sara,,ES72209574622661518175,TRX_N-00237-94502026,2022-07-29T19:04:40,Donostia,expenses,transport,-81.53,12442.22
buyer_5,Sara,,ES72209574622661518175,TRX_N-00238-07821926,2022-07-30T08:47:07,Donostia,expenses,transport,-89.36,12352.86
buyer_5,Sara,,ES72209574622661518175,TRX_N-00239-69810486,2022-07-30T21:03:25,Donostia,expenses,gifts,-46.21,12306.65
buyer_5,Sara,,ES72209574622661518175,TRX_N-00240-44716455,2022-07-31T20:49:17,Mungia,expenses,food,-112.36,12194.29
buyer_5,Sara,,ES72209574622661518175,TRX_N-00241-05992118,2022-08-01T04:13:44,Donostia,incomes,salary,2736.26,14930.55
buyer_5,Sara,,ES72209574622661518175,TRX_N-00242-19451152,2022-08-01T04:13:44,Donostia,incomes,salary_partner,2331.09,17261.64
buyer_5,Sara,,ES72209574622661518175,TRX_N-00243-34980925,2022-08-01T12:57:03,Donostia,expenses,leisure,-42.82,17218.82
buyer_5,Sara,,ES72209574622661518175,TRX_N-00244-20023078,2022-08-02T22:04:42,Donostia,expenses,repairs,-135.5,17083.32
buyer_5,Sara,,ES72209574622661518175,TRX_N-00245-46745671,2022-08-04T09:40:25,Donostia,expenses,mortgage,-814.56,16268.76
buyer_5,Sara,,ES72209574622661518175,TRX_N-00246-71686955,2022-08-05T19:23:46,Donostia,expenses,water,-29.6,16239.16
buyer_5,Sara,,ES72209574622661518175,TRX_N-00247-79718517,2022-08-06T15:21:38,Donostia,expenses,education,-76.6,16162.56
buyer_5,Sara,,ES72209574622661518175,TRX_N-00248-38092857,2022-08-07T01:14:52,Donostia,expenses,healthcare,-183.85,15978.71
buyer_5,Sara,,ES72209574622661518175,TRX_N-00249-08101558,2022-08-08T16:47:33,Donostia,expenses,electricity,-82.57,15896.14
buyer_5,Sara,,ES72209574622661518175,TRX_N-00250-38662326,2022-08-08T13:25:07,Donostia,expenses,gas,-51.25,15844.89
buyer_5,Sara,,ES72209574622661518175,TRX_N-00251-17845439,2022-08-08T08:11:48,Donostia,expenses,internet,-42.0,15802.89
buyer_5,Sara,,ES72209574622661518175,TRX_N-00252-67472207,2022-08-08T11:52:08,Donostia,expenses,phone,-41.98,15760.91
buyer_5,Sara,,ES72209574622661518175,TRX_N-00253-63051569,2022-08-10T11:31:48,Donostia,expenses,gifts,-643.0,15117.91
buyer_5,Sara,,ES72209574622661518175,TRX_N-00254-81986932,2022-08-12T14:17:31,Amurrio,expenses,transport,-89.91,15028.0
buyer_5,Sara,,ES72209574622661518175,TRX_N-00255-49710087,2022-08-14T12:53:38,Donostia,expenses,food,-71.76,14956.24
buyer_5,Sara,,ES72209574622661518175,TRX_N-00256-11070516,2022-08-15T20:32:36,Donostia,expenses,leisure,-21.88,14934.36
buyer_5,Sara,,ES72209574622661518175,TRX_N-00257-61078050,2022-08-15T08:16:31,Pasaia,expenses,cash,-100.0,14834.36
buyer_5,Sara,,ES72209574622661518175,TRX_N-00258-75316369,2022-08-16T18:29:34,Llodio,expenses,cash,-100.0,14734.36
buyer_5,Sara,,ES72209574622661518175,TRX_N-00259-12980002,2022-08-17T19:05:00,Pasaia,expenses,cash,-100.0,14634.36
buyer_5,Sara,,ES72209574622661518175,TRX_N-00260-24101827,2022-08-18T14:12:45,Donostia,expenses,transport,-55.91,14578.45
buyer_5,Sara,,ES72209574622661518175,TRX_N-00261-68246030,2022-08-18T19:43:36,Donostia,expenses,education,-62.86,14515.59
buyer_5,Sara,,ES72209574622661518175,TRX_N-00262-70190095,2022-08-18T19:47:27,Donostia,expenses,repairs,-174.02,14341.57
buyer_5,Sara,,ES72209574622661518175,TRX_N-00263-79292940,2022-08-19T13:13:20,Donostia,expenses,leisure,-59.07,14282.5
buyer_5,Sara,,ES72209574622661518175,TRX_N-00264-71275590,2022-08-19T15:23:27,Donostia,expenses,cash,-100.0,14182.5
buyer_5,Sara,,ES72209574622661518175,TRX_N-00265-40012074,2022-08-22T08:52:33,Donostia,expenses,cash,-100.0,14082.5
buyer_5,Sara,,ES72209574622661518175,TRX_N-00266-70761168,2022-08-23T12:17:34,Salvatierra/Agurain,expenses,food,-74.95,14007.55
buyer_5,Sara,,ES72209574622661518175,TRX_N-00267-76759045,2022-08-24T13:41:22,Donostia,expenses,cash,-100.0,13907.55
buyer_5,Sara,,ES72209574622661518175,TRX_N-00268-98337467,2022-08-26T09:08:12,Donostia,expenses,cash,-100.0,13807.55
buyer_5,Sara,,ES72209574622661518175,TRX_N-00269-03720210,2022-08-27T16:33:42,Salvatierra/Agurain,expenses,cash,-100.0,13707.55
buyer_5,Sara,,ES72209574622661518175,TRX_N-00270-36325890,2022-08-28T19:36:02,Donostia,expenses,food,-91.33,13616.22
buyer_5,Sara,,ES72209574622661518175,TRX_N-00271-08409865,2022-08-29T18:23:08,Donostia,expenses,repairs,-79.22,13537.0
buyer_5,Sara,,ES72209574622661518175,TRX_N-00272-93743746,2022-08-31T12:51:09,Donostia,expenses,food,-85.57,13451.43
buyer_5,Sara,,ES72209574622661518175,TRX_N-00273-20839846,2022-08-31T13:03:33,Bermeo,expenses,gifts,-25.03,13426.4
buyer_5,Sara,,ES72209574622661518175,TRX_N-00274-18606316,2022-09-01T19:48:37,Donostia,incomes,salary,2736.26,16162.66
buyer_5,Sara,,ES72209574622661518175,TRX_N-00275-05345254,2022-09-01T19:48:37,Donostia,incomes,salary_partner,2331.09,18493.75
buyer_5,Sara,,ES72209574622661518175,TRX_N-00276-37500918,2022-09-01T20:59:20,Donostia,expenses,repairs,-29.2,18464.55
buyer_5,Sara,,ES72209574622661518175,TRX_N-00277-12841632,2022-09-02T05:50:20,Donostia,expenses,appliances,-146.86,18317.69
buyer_5,Sara,,ES72209574622661518175,TRX_N-00278-19505326,2022-09-04T15:08:10,Donostia,expenses,mortgage,-814.56,17503.13
buyer_5,Sara,,ES72209574622661518175,TRX_N-00279-43456119,2022-09-04T09:38:48,Donostia,expenses,cash,-100.0,17403.13
buyer_5,Sara,,ES72209574622661518175,TRX_N-00280-04164409,2022-09-05T10:23:41,Donostia,expenses,phone,-32.2,17370.93
buyer_5,Sara,,ES72209574622661518175,TRX_N-00281-22895123,2022-09-05T09:12:50,Zuia,expenses,food,-93.08,17277.85
buyer_5,Sara,,ES72209574622661518175,TRX_N-00282-12930768,2022-09-05T12:08:02,Donostia,expenses,leisure,-33.56,17244.29
buyer_5,Sara,,ES72209574622661518175,TRX_N-00283-58862366,2022-09-07T20:56:19,Donostia,expenses,electricity,-76.31,17167.98
buyer_5,Sara,,ES72209574622661518175,TRX_N-00284-38121574,2022-09-08T22:01:13,Donostia,expenses,water,-42.11,17125.87
buyer_5,Sara,,ES72209574622661518175,TRX_N-00285-46026131,2022-09-08T20:48:30,Donostia,expenses,gas,-75.81,17050.06
buyer_5,Sara,,ES72209574622661518175,TRX_N-00286-25057682,2022-09-08T22:10:17,Donostia,expenses,internet,-42.0,17008.06
buyer_5,Sara,,ES72209574622661518175,TRX_N-00287-16119182,2022-09-08T17:29:08,Donostia,expenses,repairs,-49.86,16958.2
buyer_5,Sara,,ES72209574622661518175,TRX_N-00288-78719883,2022-09-09T11:13:40,Donostia,expenses,transport,-59.08,16899.12
buyer_5,Sara,,ES72209574622661518175,TRX_N-00289-79221798,2022-09-11T13:51:41,Donostia,expenses,clothing,-63.42,16835.7
buyer_5,Sara,,ES72209574622661518175,TRX_N-00290-50640088,2022-09-11T12:38:56,Donostia,expenses,cash,-100.0,16735.7
buyer_5,Sara,,ES72209574622661518175,TRX_N-00291-43803439,2022-09-13T09:45:40,Donostia,expenses,food,-110.09,16625.61
buyer_5,Sara,,ES72209574622661518175,TRX_N-00292-27840818,2022-09-14T16:19:25,Berango,expenses,appliances,-170.73,16454.88
buyer_5,Sara,,ES72209574622661518175,TRX_N-00293-68145392,2022-09-15T11:47:53,Donostia,expenses,leisure,-80.88,16374.0
buyer_5,Sara,,ES72209574622661518175,TRX_N-00294-15125139,2022-09-16T13:46:58,Donostia,expenses,leisure,-63.7,16310.3
buyer_5,Sara,,ES72209574622661518175,TRX_N-00295-90647160,2022-09-17T13:37:08,Bermeo,expenses,transport,-69.18,16241.12
buyer_5,Sara,,ES72209574622661518175,TRX_N-00296-90941461,2022-09-18T13:04:41,Donostia,expenses,leisure,-50.15,16190.97
buyer_5,Sara,,ES72209574622661518175,TRX_N-00297-04768833,2022-09-19T16:46:50,Donostia,expenses,food,-99.7,16091.27
buyer_5,Sara,,ES72209574622661518175,TRX_N-00298-26829502,2022-09-20T14:22:44,Donostia,expenses,leisure,-29.06,16062.21
buyer_5,Sara,,ES72209574622661518175,TRX_N-00299-61832691,2022-09-20T20:16:24,Donostia,expenses,gifts,-467.51,15594.7
buyer_5,Sara,,ES72209574622661518175,TRX_N-00300-98223066,2022-09-24T13:05:54,Erandio,expenses,transport,-54.17,15540.53
buyer_5,Sara,,ES72209574622661518175,TRX_N-00301-43891759,2022-09-24T11:17:33,Donostia,expenses,clothing,-57.87,15482.66
buyer_5,Sara,,ES72209574622661518175,TRX_N-00302-19169531,2022-09-26T16:46:11,Donostia,expenses,transport,-46.13,15436.53
buyer_5,Sara,,ES72209574622661518175,TRX_N-00303-36799249,2022-09-26T11:22:12,Donostia,expenses,leisure,-51.59,15384.94
buyer_5,Sara,,ES72209574622661518175,TRX_N-00304-52602676,2022-10-01T11:28:58,Donostia,incomes,salary,2736.26,18121.2
buyer_5,Sara,,ES72209574622661518175,TRX_N-00305-66169070,2022-10-01T11:28:58,Donostia,incomes,salary_partner,2331.09,20452.29
buyer_5,Sara,,ES72209574622661518175,TRX_N-00306-48766539,2022-10-03T10:18:50,Zuia,expenses,leisure,-81.65,20370.64
buyer_5,Sara,,ES72209574622661518175,TRX_N-00307-10686576,2022-10-03T08:44:41,Donostia,expenses,cash,-100.0,20270.64
buyer_5,Sara,,ES72209574622661518175,TRX_N-00308-68921482,2022-10-04T10:44:13,Donostia,expenses,mortgage,-814.56,19456.08
buyer_5,Sara,,ES72209574622661518175,TRX_N-00309-78963866,2022-10-04T16:04:02,Sestao,expenses,leisure,-76.76,19379.32
buyer_5,Sara,,ES72209574622661518175,TRX_N-00310-30376412,2022-10-04T10:34:58,Donostia,expenses,healthcare,-72.26,19307.06
buyer_5,Sara,,ES72209574622661518175,TRX_N-00311-66852554,2022-10-04T10:49:23,Basauri,expenses,repairs,-54.4,19252.66
buyer_5,Sara,,ES72209574622661518175,TRX_N-00312-86286893,2022-10-05T19:57:05,Donostia,expenses,water,-40.2,19212.46
buyer_5,Sara,,ES72209574622661518175,TRX_N-00313-37901174,2022-10-05T16:40:58,Donostia,expenses,phone,-40.96,19171.5
buyer_5,Sara,,ES72209574622661518175,TRX_N-00314-83393016,2022-10-05T20:05:32,Zuia,expenses,transport,-73.38,19098.12
buyer_5,Sara,,ES72209574622661518175,TRX_N-00315-59555123,2022-10-05T12:02:44,Donostia,expenses,leisure,-49.24,19048.88
buyer_5,Sara,,ES72209574622661518175,TRX_N-00316-58089305,2022-10-06T21:08:04,Donostia,expenses,gas,-87.74,18961.14
buyer_5,Sara,,ES72209574622661518175,TRX_N-00317-95242792,2022-10-07T13:37:04,Donostia,expenses,internet,-42.0,18919.14
buyer_5,Sara,,ES72209574622661518175,TRX_N-00318-72411926,2022-10-07T10:48:49,Donostia,expenses,food,-88.64,18830.5
buyer_5,Sara,,ES72209574622661518175,TRX_N-00319-58224689,2022-10-07T08:07:32,Donostia,expenses,education,-70.48,18760.02
buyer_5,Sara,,ES72209574622661518175,TRX_N-00320-37255911,2022-10-08T17:09:14,Donostia,expenses,electricity,-77.86,18682.16
buyer_5,Sara,,ES72209574622661518175,TRX_N-00321-14551094,2022-10-08T19:43:03,Donostia,expenses,food,-101.83,18580.33
buyer_5,Sara,,ES72209574622661518175,TRX_N-00322-77179139,2022-10-10T07:50:58,Donostia,expenses,food,-74.03,18506.3
buyer_5,Sara,,ES72209574622661518175,TRX_N-00323-99610021,2022-10-12T09:27:55,Oyón-Oion,expenses,gifts,-594.93,17911.37
buyer_5,Sara,,ES72209574622661518175,TRX_N-00324-26095006,2022-10-13T13:04:12,Donostia,expenses,food,-85.33,17826.04
buyer_5,Sara,,ES72209574622661518175,TRX_N-00325-97857614,2022-10-13T08:09:26,Donostia,expenses,appliances,-187.07,17638.97
buyer_5,Sara,,ES72209574622661518175,TRX_N-00326-71267342,2022-10-13T20:36:57,Basauri,expenses,repairs,-317.26,17321.71
buyer_5,Sara,,ES72209574622661518175,TRX_N-00327-70964788,2022-10-14T21:13:34,Donostia,expenses,repairs,-99.12,17222.59
buyer_5,Sara,,ES72209574622661518175,TRX_N-00328-96660058,2022-10-21T10:51:13,Donostia,expenses,cash,-100.0,17122.59
buyer_5,Sara,,ES72209574622661518175,TRX_N-00329-98956458,2022-10-22T09:16:17,Donostia,expenses,leisure,-57.9,17064.69
buyer_5,Sara,,ES72209574622661518175,TRX_N-00330-38754303,2022-10-23T10:18:05,Donostia,expenses,cash,-100.0,16964.69
buyer_5,Sara,,ES72209574622661518175,TRX_N-00331-46537929,2022-10-24T10:00:04,Donostia,expenses,food,-73.36,16891.33
buyer_5,Sara,,ES72209574622661518175,TRX_N-00332-92867415,2022-10-26T00:20:06,Elciego,expenses,leisure,-74.22,16817.11
buyer_5,Sara,,ES72209574622661518175,TRX_N-00333-36334247,2022-10-28T01:44:45,Getxo,expenses,leisure,-25.07,16792.04
buyer_5,Sara,,ES72209574622661518175,TRX_N-00334-83585567,2022-10-31T14:18:08,Donostia,expenses,leisure,-75.51,16716.53
buyer_5,Sara,,ES72209574622661518175,TRX_N-00335-35486430,2022-11-01T00:55:07,Donostia,incomes,salary,2736.26,19452.79
buyer_5,Sara,,ES72209574622661518175,TRX_N-00336-93938428,2022-11-01T00:55:07,Donostia,incomes,salary_partner,2331.09,21783.88
buyer_5,Sara,,ES72209574622661518175,TRX_N-00337-76198433,2022-11-01T00:55:07,Donostia,incomes,extra_income,303.94,22087.82
buyer_5,Sara,,ES72209574622661518175,TRX_N-00338-55537879,2022-11-02T14:44:16,Donostia,expenses,transport,-56.29,22031.53
buyer_5,Sara,,ES72209574622661518175,TRX_N-00339-01090306,2022-11-02T09:03:23,Donostia,expenses,leisure,-68.51,21963.02
buyer_5,Sara,,ES72209574622661518175,TRX_N-00340-15213600,2022-11-02T10:28:59,Donostia,expenses,clothing,-95.32,21867.7
buyer_5,Sara,,ES72209574622661518175,TRX_N-00341-25386055,2022-11-03T03:28:40,Donostia,expenses,leisure,-56.65,21811.05
buyer_5,Sara,,ES72209574622661518175,TRX_N-00342-44578257,2022-11-03T17:00:17,Sestao,expenses,healthcare,-109.33,21701.72
buyer_5,Sara,,ES72209574622661518175,TRX_N-00343-88701388,2022-11-04T11:51:59,Donostia,expenses,mortgage,-814.56,20887.16
buyer_5,Sara,,ES72209574622661518175,TRX_N-00344-46537776,2022-11-06T09:59:29,Donostia,expenses,water,-32.69,20854.47
buyer_5,Sara,,ES72209574622661518175,TRX_N-00345-39771262,2022-11-06T14:42:40,Donostia,expenses,phone,-36.96,20817.51
buyer_5,Sara,,ES72209574622661518175,TRX_N-00346-07868473,2022-11-06T19:12:55,Donostia,expenses,food,-65.07,20752.44
buyer_5,Sara,,ES72209574622661518175,TRX_N-00347-18086542,2022-11-06T16:04:26,Donostia,expenses,transport,-45.7,20706.74
buyer_5,Sara,,ES72209574622661518175,TRX_N-00348-00184493,2022-11-07T15:23:58,Donostia,expenses,internet,-42.0,20664.74
buyer_5,Sara,,ES72209574622661518175,TRX_N-00349-97304044,2022-11-07T08:57:26,Donostia,expenses,transport,-43.86,20620.88
buyer_5,Sara,,ES72209574622661518175,TRX_N-00350-44597671,2022-11-07T10:17:06,Donostia,expenses,cash,-100.0,20520.88
buyer_5,Sara,,ES72209574622661518175,TRX_N-00351-48398609,2022-11-08T19:43:12,Donostia,expenses,electricity,-62.45,20458.43
buyer_5,Sara,,ES72209574622661518175,TRX_N-00352-52638186,2022-11-08T17:17:18,Donostia,expenses,gas,-88.89,20369.54
buyer_5,Sara,,ES72209574622661518175,TRX_N-00353-86526810,2022-11-08T16:08:35,Donostia,expenses,food,-69.69,20299.85
buyer_5,Sara,,ES72209574622661518175,TRX_N-00354-71688692,2022-11-08T12:53:13,Donostia,expenses,cash,-100.0,20199.85
buyer_5,Sara,,ES72209574622661518175,TRX_N-00355-18568220,2022-11-09T19:53:29,Donostia,expenses,repairs,-255.78,19944.07
buyer_5,Sara,,ES72209574622661518175,TRX_N-00356-17142712,2022-11-13T11:17:34,Donostia,expenses,leisure,-80.09,19863.98
buyer_5,Sara,,ES72209574622661518175,TRX_N-00357-58244687,2022-11-14T08:26:57,Donostia,expenses,appliances,-367.45,19496.53
buyer_5,Sara,,ES72209574622661518175,TRX_N-00358-03575807,2022-11-16T21:05:52,Donostia,expenses,food,-74.44,19422.09
buyer_5,Sara,,ES72209574622661518175,TRX_N-00359-56632171,2022-11-16T08:45:00,Donostia,expenses,healthcare,-167.96,19254.13
buyer_5,Sara,,ES72209574622661518175,TRX_N-00360-63542877,2022-11-16T18:39:58,Donostia,expenses,cash,-100.0,19154.13
buyer_5,Sara,,ES72209574622661518175,TRX_N-00361-83812851,2022-11-18T08:04:08,Donostia,expenses,leisure,-73.42,19080.71
buyer_5,Sara,,ES72209574622661518175,TRX_N-00362-13366970,2022-11-21T02:43:25,Donostia,expenses,transport,-50.67,19030.04
buyer_5,Sara,,ES72209574622661518175,TRX_N-00363-73064700,2022-11-24T13:00:20,Donostia,expenses,education,-45.31,18984.73
buyer_5,Sara,,ES72209574622661518175,TRX_N-00364-56904637,2022-11-25T17:07:51,Donostia,expenses,transport,-89.8,18894.93
buyer_5,Sara,,ES72209574622661518175,TRX_N-00365-53279057,2022-11-26T17:00:32,Donostia,expenses,gifts,-421.35,18473.58
buyer_5,Sara,,ES72209574622661518175,TRX_N-00366-65645616,2022-11-27T12:05:12,Donostia,expenses,transport,-74.02,18399.56
buyer_5,Sara,,ES72209574622661518175,TRX_N-00367-38073609,2022-11-27T13:35:39,Donostia,expenses,leisure,-35.77,18363.79
buyer_5,Sara,,ES72209574622661518175,TRX_N-00368-58695443,2022-11-27T12:54:27,Donostia,expenses,healthcare,-137.99,18225.8
buyer_5,Sara,,ES72209574622661518175,TRX_N-00369-59659255,2022-11-28T20:17:17,Donostia,expenses,repairs,-159.31,18066.49
buyer_5,Sara,,ES72209574622661518175,TRX_N-00370-81363536,2022-11-29T06:54:05,Donostia,expenses,leisure,-76.59,17989.9
buyer_5,Sara,,ES72209574622661518175,TRX_N-00371-24961613,2022-12-01T09:58:05,Donostia,incomes,salary,2736.26,20726.16
buyer_5,Sara,,ES72209574622661518175,TRX_N-00372-25208549,2022-12-01T09:58:05,Donostia,incomes,salary_partner,2331.09,23057.25
buyer_5,Sara,,ES72209574622661518175,TRX_N-00373-40883942,2022-12-01T09:58:05,Donostia,incomes,salary_bonus,2072.13,25129.38
buyer_5,Sara,,ES72209574622661518175,TRX_N-00374-48228888,2022-12-01T09:58:05,Donostia,incomes,salary_partner_bonus,1684.41,26813.79
buyer_5,Sara,,ES72209574622661518175,TRX_N-00375-37444017,2022-12-01T17:02:45,Donostia,expenses,transport,-60.41,26753.38
buyer_5,Sara,,ES72209574622661518175,TRX_N-00376-80482142,2022-12-01T23:23:08,Donostia,expenses,cash,-100.0,26653.38
buyer_5,Sara,,ES72209574622661518175,TRX_N-00377-17153217,2022-12-03T16:09:22,Donostia,expenses,leisure,-47.17,26606.21
buyer_5,Sara,,ES72209574622661518175,TRX_N-00378-23108759,2022-12-03T18:06:09,Donostia,expenses,clothing,-111.67,26494.54
buyer_5,Sara,,ES72209574622661518175,TRX_N-00379-07032664,2022-12-04T17:35:17,Donostia,expenses,mortgage,-814.56,25679.98
buyer_5,Sara,,ES72209574622661518175,TRX_N-00380-10409950,2022-12-04T18:41:31,Donostia,expenses,leisure,-18.98,25661.0
buyer_5,Sara,,ES72209574622661518175,TRX_N-00381-39002841,2022-12-05T13:32:04,Donostia,expenses,gas,-48.8,25612.2
buyer_5,Sara,,ES72209574622661518175,TRX_N-00382-19770206,2022-12-05T06:32:32,Donostia,expenses,phone,-32.66,25579.54
buyer_5,Sara,,ES72209574622661518175,TRX_N-00383-84183220,2022-12-05T17:15:52,Arrasate,expenses,travel,-410.79,25168.75
buyer_5,Sara,,ES72209574622661518175,TRX_N-00384-56582073,2022-12-06T23:40:46,Donostia,expenses,water,-30.51,25138.24
buyer_5,Sara,,ES72209574622661518175,TRX_N-00385-01551993,2022-12-06T22:05:17,Zuia,expenses,food,-123.19,25015.05
buyer_5,Sara,,ES72209574622661518175,TRX_N-00386-76772925,2022-12-07T16:47:23,Donostia,expenses,internet,-42.0,24973.05
buyer_5,Sara,,ES72209574622661518175,TRX_N-00387-20132307,2022-12-08T08:12:06,Donostia,expenses,electricity,-72.84,24900.21
buyer_5,Sara,,ES72209574622661518175,TRX_N-00388-03377529,2022-12-09T09:17:15,Donostia,expenses,clothing,-73.2,24827.01
buyer_5,Sara,,ES72209574622661518175,TRX_N-00389-00060024,2022-12-09T13:28:22,Mungia,expenses,education,-59.31,24767.7
buyer_5,Sara,,ES72209574622661518175,TRX_N-00390-64433565,2022-12-09T20:05:14,Donostia,expenses,gifts,-290.26,24477.44
buyer_5,Sara,,ES72209574622661518175,TRX_N-00391-19693007,2022-12-13T14:16:52,Donostia,expenses,clothing,-97.0,24380.44
buyer_5,Sara,,ES72209574622661518175,TRX_N-00392-33444523,2022-12-13T19:14:16,Errenteria,expenses,education,-47.18,24333.26
buyer_5,Sara,,ES72209574622661518175,TRX_N-00393-66932008,2022-12-14T08:12:48,Donostia,expenses,education,-52.6,24280.66
buyer_5,Sara,,ES72209574622661518175,TRX_N-00394-07492551,2022-12-16T15:45:48,Bermeo,expenses,cash,-100.0,24180.66
buyer_5,Sara,,ES72209574622661518175,TRX_N-00395-55765989,2022-12-16T03:38:27,Donostia,expenses,repairs,-184.79,23995.87
buyer_5,Sara,,ES72209574622661518175,TRX_N-00396-66576122,2022-12-19T17:19:25,Sestao,expenses,transport,-78.55,23917.32
buyer_5,Sara,,ES72209574622661518175,TRX_N-00397-97542851,2022-12-19T16:12:52,Donostia,expenses,cash,-100.0,23817.32
buyer_5,Sara,,ES72209574622661518175,TRX_N-00398-81713848,2022-12-21T02:45:38,Donostia,expenses,food,-65.46,23751.86
buyer_5,Sara,,ES72209574622661518175,TRX_N-00399-74174506,2022-12-21T17:30:29,Donostia,expenses,repairs,-67.3,23684.56
buyer_5,Sara,,ES72209574622661518175,TRX_N-00400-54793617,2022-12-22T11:01:29,Donostia,expenses,cash,-100.0,23584.56
buyer_5,Sara,,ES72209574622661518175,TRX_N-00401-86240360,2022-12-23T16:56:35,Donostia,expenses,cash,-100.0,23484.56
buyer_5,Sara,,ES72209574622661518175,TRX_N-00402-54946623,2022-12-24T15:28:57,Donostia,expenses,transport,-65.95,23418.61
buyer_5,Sara,,ES72209574622661518175,TRX_N-00403-23601477,2022-12-24T14:05:40,Bilbao,expenses,healthcare,-135.05,23283.56
buyer_5,Sara,,ES72209574622661518175,TRX_N-00404-92055907,2022-12-26T09:23:02,Donostia,expenses,repairs,-299.25,22984.31
buyer_5,Sara,,ES72209574622661518175,TRX_N-00405-35522533,2022-12-27T08:08:22,Donostia,expenses,clothing,-133.48,22850.83
buyer_5,Sara,,ES72209574622661518175,TRX_N-00406-44633822,2022-12-27T15:58:36,Donostia,expenses,repairs,-165.15,22685.68
buyer_5,Sara,,ES72209574622661518175,TRX_N-00407-22375999,2023-01-01T10:42:53,Donostia,incomes,salary,2811.01,25496.69
buyer_5,Sara,,ES72209574622661518175,TRX_N-00408-86277769,2023-01-01T10:42:53,Donostia,incomes,salary_partner,2394.77,27891.46
buyer_5,Sara,,ES72209574622661518175,TRX_N-00409-49160518,2023-01-04T11:14:07,Donostia,expenses,mortgage,-814.56,27076.9
buyer_5,Sara,,ES72209574622661518175,TRX_N-00410-92002670,2023-01-05T18:13:34,Donostia,expenses,water,-32.37,27044.53
buyer_5,Sara,,ES72209574622661518175,TRX_N-00411-36156974,2023-01-05T13:05:44,Donostia,expenses,electricity,-66.5,26978.03
buyer_5,Sara,,ES72209574622661518175,TRX_N-00412-30943554,2023-01-05T09:13:03,Donostia,expenses,gas,-90.68,26887.35
buyer_5,Sara,,ES72209574622661518175,TRX_N-00413-82540266,2023-01-05T09:08:47,Donostia,expenses,internet,-42.0,26845.35
buyer_5,Sara,,ES72209574622661518175,TRX_N-00414-49849269,2023-01-05T15:29:03,Donostia,expenses,phone,-43.38,26801.97
buyer_5,Sara,,ES72209574622661518175,TRX_N-00415-97962372,2023-01-05T11:04:43,Donostia,expenses,cash,-100.0,26701.97
buyer_5,Sara,,ES72209574622661518175,TRX_N-00416-20525249,2023-01-06T20:17:11,Donostia,expenses,repairs,-28.97,26673.0
buyer_5,Sara,,ES72209574622661518175,TRX_N-00417-81602791,2023-01-08T16:22:39,Donostia,expenses,appliances,-81.56,26591.44
buyer_5,Sara,,ES72209574622661518175,TRX_N-00418-85444162,2023-01-10T12:33:38,Donostia,expenses,education,-44.76,26546.68
buyer_5,Sara,,ES72209574622661518175,TRX_N-00419-67592394,2023-01-11T15:49:07,Donostia,expenses,leisure,-29.33,26517.35
buyer_5,Sara,,ES72209574622661518175,TRX_N-00420-97825095,2023-01-12T13:06:50,Donostia,expenses,leisure,-44.55,26472.8
buyer_5,Sara,,ES72209574622661518175,TRX_N-00421-62513312,2023-01-13T10:33:47,Donostia,expenses,cash,-100.0,26372.8
buyer_5,Sara,,ES72209574622661518175,TRX_N-00422-51609971,2023-01-14T16:03:20,Donostia,expenses,food,-103.7,26269.1
buyer_5,Sara,,ES72209574622661518175,TRX_N-00423-56662570,2023-01-15T12:35:01,Donostia,expenses,food,-76.87,26192.23
buyer_5,Sara,,ES72209574622661518175,TRX_N-00424-89326604,2023-01-17T13:25:11,Donostia,expenses,food,-85.59,26106.64
buyer_5,Sara,,ES72209574622661518175,TRX_N-00425-17809358,2023-01-18T15:46:15,Bermeo,expenses,appliances,-293.71,25812.93
buyer_5,Sara,,ES72209574622661518175,TRX_N-00426-86351968,2023-01-19T14:05:05,Salvatierra/Agurain,expenses,leisure,-43.86,25769.07
buyer_5,Sara,,ES72209574622661518175,TRX_N-00427-58765376,2023-01-19T10:02:49,Donostia,expenses,healthcare,-131.57,25637.5
buyer_5,Sara,,ES72209574622661518175,TRX_N-00428-27864876,2023-01-19T17:11:16,Zuia,expenses,repairs,-120.77,25516.73
buyer_5,Sara,,ES72209574622661518175,TRX_N-00429-78324858,2023-01-19T16:47:19,Donostia,expenses,gifts,-232.77,25283.96
buyer_5,Sara,,ES72209574622661518175,TRX_N-00430-27434453,2023-01-21T08:16:32,Donostia,expenses,transport,-71.62,25212.34
buyer_5,Sara,,ES72209574622661518175,TRX_N-00431-10774141,2023-01-21T12:59:43,Donostia,expenses,gifts,-576.84,24635.5
buyer_5,Sara,,ES72209574622661518175,TRX_N-00432-28696588,2023-01-23T16:27:41,Portugalete,expenses,food,-63.1,24572.4
buyer_5,Sara,,ES72209574622661518175,TRX_N-00433-36605039,2023-01-23T09:23:22,Donostia,expenses,leisure,-30.55,24541.85
buyer_5,Sara,,ES72209574622661518175,TRX_N-00434-09759856,2023-01-23T04:35:42,Donostia,expenses,cash,-100.0,24441.85
buyer_5,Sara,,ES72209574622661518175,TRX_N-00435-44863614,2023-01-25T18:35:33,Donostia,expenses,food,-115.91,24325.94
buyer_5,Sara,,ES72209574622661518175,TRX_N-00436-39554598,2023-01-25T16:54:39,Donostia,expenses,education,-72.99,24252.95
buyer_5,Sara,,ES72209574622661518175,TRX_N-00437-70356387,2023-01-25T20:54:08,Donostia,expenses,gifts,-639.03,23613.92
buyer_5,Sara,,ES72209574622661518175,TRX_N-00438-41383126,2023-01-26T15:28:31,Donostia,expenses,gifts,-337.24,23276.68
buyer_5,Sara,,ES72209574622661518175,TRX_N-00439-47134192,2023-01-27T10:26:51,Donostia,expenses,cash,-100.0,23176.68
buyer_5,Sara,,ES72209574622661518175,TRX_N-00440-58350901,2023-01-27T13:36:07,Donostia,expenses,gifts,-622.75,22553.93
buyer_5,Sara,,ES72209574622661518175,TRX_N-00441-36679327,2023-01-28T10:58:10,Donostia,expenses,gifts,-241.33,22312.6
buyer_5,Sara,,ES72209574622661518175,TRX_N-00442-91697893,2023-01-29T13:13:01,Donostia,expenses,leisure,-27.86,22284.74
buyer_5,Sara,,ES72209574622661518175,TRX_N-00443-94974212,2023-01-30T16:44:29,Donostia,expenses,healthcare,-168.5,22116.24
buyer_5,Sara,,ES72209574622661518175,TRX_N-00444-64121554,2023-01-31T00:10:22,Iruña de Oca,expenses,cash,-100.0,22016.24
buyer_5,Sara,,ES72209574622661518175,TRX_N-00445-07514501,2023-02-01T16:25:42,Donostia,incomes,salary,2811.01,24827.25
buyer_5,Sara,,ES72209574622661518175,TRX_N-00446-81400757,2023-02-01T16:25:42,Donostia,incomes,salary_partner,2394.77,27222.02
buyer_5,Sara,,ES72209574622661518175,TRX_N-00447-48483289,2023-02-01T16:25:42,Donostia,incomes,extra_income,303.94,27525.96
buyer_5,Sara,,ES72209574622661518175,TRX_N-00448-67891739,2023-02-01T15:00:28,Donostia,expenses,food,-85.78,27440.18
buyer_5,Sara,,ES72209574622661518175,TRX_N-00449-15318136,2023-02-04T16:06:13,Donostia,expenses,mortgage,-814.56,26625.62
buyer_5,Sara,,ES72209574622661518175,TRX_N-00450-51971006,2023-02-04T17:55:46,Donostia,expenses,leisure,-70.07,26555.55
buyer_5,Sara,,ES72209574622661518175,TRX_N-00451-39115949,2023-02-05T19:12:39,Donostia,expenses,internet,-42.0,26513.55
buyer_5,Sara,,ES72209574622661518175,TRX_N-00452-15744561,2023-02-05T21:54:48,Eibar,expenses,clothing,-158.85,26354.7
buyer_5,Sara,,ES72209574622661518175,TRX_N-00453-37744117,2023-02-06T17:37:23,Donostia,expenses,water,-20.91,26333.79
buyer_5,Sara,,ES72209574622661518175,TRX_N-00454-96833766,2023-02-06T18:21:08,Donostia,expenses,electricity,-78.97,26254.82
buyer_5,Sara,,ES72209574622661518175,TRX_N-00455-99930478,2023-02-06T09:57:42,Donostia,expenses,gifts,-428.92,25825.9
buyer_5,Sara,,ES72209574622661518175,TRX_N-00456-83137312,2023-02-07T14:55:50,Donostia,expenses,phone,-30.58,25795.32
buyer_5,Sara,,ES72209574622661518175,TRX_N-00457-23039947,2023-02-07T09:23:04,Donostia,expenses,cash,-100.0,25695.32
buyer_5,Sara,,ES72209574622661518175,TRX_N-00458-00789422,2023-02-08T10:29:00,Donostia,expenses,gas,-64.94,25630.38
buyer_5,Sara,,ES72209574622661518175,TRX_N-00459-84742565,2023-02-10T16:02:06,Donostia,expenses,food,-85.92,25544.46
buyer_5,Sara,,ES72209574622661518175,TRX_N-00460-07544288,2023-02-11T09:39:20,Donostia,expenses,food,-97.72,25446.74
buyer_5,Sara,,ES72209574622661518175,TRX_N-00461-07536595,2023-02-11T15:50:37,Donostia,expenses,repairs,-158.67,25288.07
buyer_5,Sara,,ES72209574622661518175,TRX_N-00462-98548740,2023-02-12T10:22:39,Amurrio,expenses,food,-106.45,25181.62
buyer_5,Sara,,ES72209574622661518175,TRX_N-00463-81551055,2023-02-13T15:32:20,Donostia,expenses,food,-98.37,25083.25
buyer_5,Sara,,ES72209574622661518175,TRX_N-00464-67075329,2023-02-13T13:11:14,Donostia,expenses,healthcare,-134.75,24948.5
buyer_5,Sara,,ES72209574622661518175,TRX_N-00465-74813739,2023-02-13T11:53:48,Donostia,expenses,gifts,-675.35,24273.15
buyer_5,Sara,,ES72209574622661518175,TRX_N-00466-06413105,2023-02-14T09:35:27,Donostia,expenses,transport,-71.56,24201.59
buyer_5,Sara,,ES72209574622661518175,TRX_N-00467-77905513,2023-02-16T18:52:26,Donostia,expenses,food,-98.18,24103.41
buyer_5,Sara,,ES72209574622661518175,TRX_N-00468-24643654,2023-02-16T15:22:50,Santurtzi,expenses,clothing,-151.22,23952.19
buyer_5,Sara,,ES72209574622661518175,TRX_N-00469-39274536,2023-02-18T16:41:11,Donostia,expenses,cash,-100.0,23852.19
buyer_5,Sara,,ES72209574622661518175,TRX_N-00470-32195870,2023-02-20T13:17:20,Donostia,expenses,cash,-100.0,23752.19
buyer_5,Sara,,ES72209574622661518175,TRX_N-00471-37346084,2023-02-21T11:35:52,Donostia,expenses,healthcare,-122.4,23629.79
buyer_5,Sara,,ES72209574622661518175,TRX_N-00472-03564136,2023-02-27T19:22:06,Donostia,expenses,leisure,-83.41,23546.38
buyer_5,Sara,,ES72209574622661518175,TRX_N-00473-62815900,2023-02-27T10:35:48,Donostia,expenses,repairs,-159.16,23387.22
buyer_5,Sara,,ES72209574622661518175,TRX_N-00474-65536903,2023-02-27T22:40:52,Donostia,expenses,gifts,-78.2,23309.02
buyer_5,Sara,,ES72209574622661518175,TRX_N-00475-28111942,2023-02-28T08:57:48,Donostia,expenses,leisure,-83.98,23225.04
buyer_5,Sara,,ES72209574622661518175,TRX_N-00476-65345335,2023-03-01T11:19:17,Donostia,incomes,salary,2811.01,26036.05
buyer_5,Sara,,ES72209574622661518175,TRX_N-00477-23342978,2023-03-01T11:19:17,Donostia,incomes,salary_partner,2394.77,28430.82
buyer_5,Sara,,ES72209574622661518175,TRX_N-00478-96725664,2023-03-01T13:04:21,Amurrio,expenses,clothing,-58.55,28372.27
buyer_5,Sara,,ES72209574622661518175,TRX_N-00479-24504328,2023-03-04T20:01:33,Donostia,expenses,mortgage,-814.56,27557.71
buyer_5,Sara,,ES72209574622661518175,TRX_N-00480-84692323,2023-03-04T08:45:05,Donostia,expenses,food,-88.87,27468.84
buyer_5,Sara,,ES72209574622661518175,TRX_N-00481-16331658,2023-03-04T22:08:18,Donostia,expenses,clothing,-119.64,27349.2
buyer_5,Sara,,ES72209574622661518175,TRX_N-00482-86942470,2023-03-05T16:39:59,Donostia,expenses,healthcare,-71.15,27278.05
buyer_5,Sara,,ES72209574622661518175,TRX_N-00483-63015123,2023-03-05T14:05:11,Donostia,expenses,appliances,-247.64,27030.41
buyer_5,Sara,,ES72209574622661518175,TRX_N-00484-51398261,2023-03-06T20:20:48,Barakaldo,expenses,cash,-100.0,26930.41
buyer_5,Sara,,ES72209574622661518175,TRX_N-00485-33329809,2023-03-06T20:08:44,Donostia,expenses,gifts,-444.13,26486.28
buyer_5,Sara,,ES72209574622661518175,TRX_N-00486-36496882,2023-03-07T20:19:58,Donostia,expenses,transport,-40.78,26445.5
buyer_5,Sara,,ES72209574622661518175,TRX_N-00487-55771740,2023-03-08T11:20:06,Donostia,expenses,water,-29.68,26415.82
buyer_5,Sara,,ES72209574622661518175,TRX_N-00488-71440886,2023-03-08T20:17:23,Donostia,expenses,gas,-44.32,26371.5
buyer_5,Sara,,ES72209574622661518175,TRX_N-00489-98126080,2023-03-08T17:27:26,Donostia,expenses,electricity,-55.34,26316.16
buyer_5,Sara,,ES72209574622661518175,TRX_N-00490-08096056,2023-03-08T08:11:38,Donostia,expenses,internet,-42.0,26274.16
buyer_5,Sara,,ES72209574622661518175,TRX_N-00491-38757420,2023-03-08T20:34:55,Donostia,expenses,phone,-44.01,26230.15
buyer_5,Sara,,ES72209574622661518175,TRX_N-00492-04210491,2023-03-08T05:52:07,Donostia,expenses,food,-119.93,26110.22
buyer_5,Sara,,ES72209574622661518175,TRX_N-00493-55941256,2023-03-09T13:41:26,Salvatierra/Agurain,expenses,healthcare,-40.65,26069.57
buyer_5,Sara,,ES72209574622661518175,TRX_N-00494-31056866,2023-03-10T13:38:07,Donostia,expenses,education,-67.04,26002.53
buyer_5,Sara,,ES72209574622661518175,TRX_N-00495-16449458,2023-03-11T20:59:14,Donostia,expenses,transport,-50.35,25952.18
buyer_5,Sara,,ES72209574622661518175,TRX_N-00496-71168550,2023-03-13T13:36:26,Donostia,expenses,cash,-100.0,25852.18
buyer_5,Sara,,ES72209574622661518175,TRX_N-00497-80459086,2023-03-14T22:04:53,Donostia,expenses,education,-51.15,25801.03
buyer_5,Sara,,ES72209574622661518175,TRX_N-00498-10231095,2023-03-14T15:56:02,Elciego,expenses,travel,-744.16,25056.87
buyer_5,Sara,,ES72209574622661518175,TRX_N-00499-45238088,2023-03-15T09:06:04,Donostia,expenses,clothing,-54.91,25001.96
buyer_5,Sara,,ES72209574622661518175,TRX_N-00500-98595326,2023-03-18T15:03:02,Donostia,expenses,appliances,-128.15,24873.81
buyer_5,Sara,,ES72209574622661518175,TRX_N-00501-44240588,2023-03-20T11:38:27,Donostia,expenses,travel,-479.43,24394.38
buyer_5,Sara,,ES72209574622661518175,TRX_N-00502-79982000,2023-03-21T16:54:48,Donostia,expenses,gifts,-274.22,24120.16
buyer_5,Sara,,ES72209574622661518175,TRX_N-00503-13630488,2023-03-22T18:17:25,Durango,expenses,cash,-100.0,24020.16
buyer_5,Sara,,ES72209574622661518175,TRX_N-00504-48126344,2023-03-25T09:40:55,Donostia,expenses,transport,-75.48,23944.68
buyer_5,Sara,,ES72209574622661518175,TRX_N-00505-83916888,2023-03-25T13:57:49,Donostia,expenses,cash,-100.0,23844.68
buyer_5,Sara,,ES72209574622661518175,TRX_N-00506-35124074,2023-03-26T16:40:20,Donostia,expenses,healthcare,-109.14,23735.54
buyer_5,Sara,,ES72209574622661518175,TRX_N-00507-42424453,2023-03-31T18:40:12,Donostia,expenses,food,-97.54,23638.0
buyer_5,Sara,,ES72209574622661518175,TRX_N-00508-38905660,2023-03-31T17:25:32,Barakaldo,expenses,clothing,-76.48,23561.52
buyer_5,Sara,,ES72209574622661518175,TRX_N-00509-88519598,2023-03-31T13:42:10,Donostia,expenses,healthcare,-57.65,23503.87
buyer_5,Sara,,ES72209574622661518175,TRX_N-00510-24859563,2023-03-31T22:04:59,Donostia,expenses,cash,-100.0,23403.87
buyer_5,Sara,,ES72209574622661518175,TRX_N-00511-68338890,2023-04-01T10:03:22,Donostia,incomes,salary,2811.01,26214.88
buyer_5,Sara,,ES72209574622661518175,TRX_N-00512-52669267,2023-04-01T10:03:22,Donostia,incomes,salary_partner,2394.77,28609.65
buyer_5,Sara,,ES72209574622661518175,TRX_N-00513-41911323,2023-04-01T11:07:39,Donostia,expenses,transport,-57.75,28551.9
buyer_5,Sara,,ES72209574622661518175,TRX_N-00514-65045069,2023-04-03T06:19:20,Donostia,expenses,clothing,-151.75,28400.15
buyer_5,Sara,,ES72209574622661518175,TRX_N-00515-12021314,2023-04-03T13:53:45,Elciego,expenses,appliances,-323.29,28076.86
buyer_5,Sara,,ES72209574622661518175,TRX_N-00516-97631933,2023-04-04T22:57:53,Donostia,expenses,mortgage,-814.56,27262.3
buyer_5,Sara,,ES72209574622661518175,TRX_N-00517-92935526,2023-04-04T18:17:21,Donostia,expenses,transport,-53.62,27208.68
buyer_5,Sara,,ES72209574622661518175,TRX_N-00518-42409206,2023-04-04T21:39:56,Donostia,expenses,education,-47.45,27161.23
buyer_5,Sara,,ES72209574622661518175,TRX_N-00519-98109848,2023-04-05T11:58:23,Donostia,expenses,water,-43.64,27117.59
buyer_5,Sara,,ES72209574622661518175,TRX_N-00520-72692166,2023-04-06T09:06:34,Donostia,expenses,internet,-42.0,27075.59
buyer_5,Sara,,ES72209574622661518175,TRX_N-00521-65962302,2023-04-06T18:25:13,Donostia,expenses,transport,-42.92,27032.67
buyer_5,Sara,,ES72209574622661518175,TRX_N-00522-02185149,2023-04-08T16:23:35,Donostia,expenses,electricity,-49.32,26983.35
buyer_5,Sara,,ES72209574622661518175,TRX_N-00523-22391471,2023-04-08T10:45:25,Donostia,expenses,gas,-114.23,26869.12
buyer_5,Sara,,ES72209574622661518175,TRX_N-00524-61307752,2023-04-08T07:24:44,Donostia,expenses,phone,-31.33,26837.79
buyer_5,Sara,,ES72209574622661518175,TRX_N-00525-79059737,2023-04-13T13:16:52,Basauri,expenses,healthcare,-149.09,26688.7
buyer_5,Sara,,ES72209574622661518175,TRX_N-00526-77541420,2023-04-14T12:34:41,Donostia,expenses,leisure,-60.18,26628.52
buyer_5,Sara,,ES72209574622661518175,TRX_N-00527-32501065,2023-04-16T09:52:23,Donostia,expenses,food,-111.35,26517.17
buyer_5,Sara,,ES72209574622661518175,TRX_N-00528-14765120,2023-04-16T11:13:25,Donostia,expenses,transport,-59.71,26457.46
buyer_5,Sara,,ES72209574622661518175,TRX_N-00529-47230224,2023-04-16T11:32:01,Vitoria-Gasteiz,expenses,appliances,-245.25,26212.21
buyer_5,Sara,,ES72209574622661518175,TRX_N-00530-95137523,2023-04-17T17:52:30,Donostia,expenses,transport,-83.07,26129.14
buyer_5,Sara,,ES72209574622661518175,TRX_N-00531-75315136,2023-04-17T09:50:03,Donostia,expenses,clothing,-120.88,26008.26
buyer_5,Sara,,ES72209574622661518175,TRX_N-00532-99999265,2023-04-19T14:20:15,Donostia,expenses,repairs,-248.03,25760.23
buyer_5,Sara,,ES72209574622661518175,TRX_N-00533-42685497,2023-04-20T21:55:46,Donostia,expenses,food,-69.12,25691.11
buyer_5,Sara,,ES72209574622661518175,TRX_N-00534-21501229,2023-04-24T23:03:51,Donostia,expenses,food,-89.64,25601.47
buyer_5,Sara,,ES72209574622661518175,TRX_N-00535-91189164,2023-04-25T16:34:13,Salvatierra/Agurain,expenses,gifts,-825.41,24776.06
buyer_5,Sara,,ES72209574622661518175,TRX_N-00536-35125056,2023-04-26T11:56:59,Donostia,expenses,clothing,-107.62,24668.44
buyer_5,Sara,,ES72209574622661518175,TRX_N-00537-65482511,2023-04-26T03:56:42,Galdakao,expenses,cash,-100.0,24568.44
buyer_5,Sara,,ES72209574622661518175,TRX_N-00538-63909175,2023-05-01T18:03:15,Donostia,incomes,salary,2811.01,27379.45
buyer_5,Sara,,ES72209574622661518175,TRX_N-00539-80929143,2023-05-01T18:03:15,Donostia,incomes,salary_partner,2394.77,29774.22
buyer_5,Sara,,ES72209574622661518175,TRX_N-00540-54762137,2023-05-01T18:03:15,Donostia,incomes,extra_income,303.94,30078.16
buyer_5,Sara,,ES72209574622661518175,TRX_N-00541-19141329,2023-05-02T21:50:26,Donostia,expenses,cash,-100.0,29978.16
buyer_5,Sara,,ES72209574622661518175,TRX_N-00542-33044441,2023-05-03T05:07:46,Zuia,expenses,cash,-100.0,29878.16
buyer_5,Sara,,ES72209574622661518175,TRX_N-00543-62392886,2023-05-03T09:49:35,Donostia,expenses,repairs,-286.9,29591.26
buyer_5,Sara,,ES72209574622661518175,TRX_N-00544-21016043,2023-05-04T18:04:13,Donostia,expenses,mortgage,-814.56,28776.7
buyer_5,Sara,,ES72209574622661518175,TRX_N-00545-21002732,2023-05-04T17:28:17,Barakaldo,expenses,food,-108.74,28667.96
buyer_5,Sara,,ES72209574622661518175,TRX_N-00546-05080272,2023-05-04T09:18:34,Donostia,expenses,leisure,-82.59,28585.37
buyer_5,Sara,,ES72209574622661518175,TRX_N-00547-54112649,2023-05-05T17:35:36,Donostia,expenses,water,-35.25,28550.12
buyer_5,Sara,,ES72209574622661518175,TRX_N-00548-73972880,2023-05-05T06:46:15,Donostia,expenses,gas,-67.04,28483.08
buyer_5,Sara,,ES72209574622661518175,TRX_N-00549-21690464,2023-05-05T11:28:23,Donostia,expenses,food,-74.84,28408.24
buyer_5,Sara,,ES72209574622661518175,TRX_N-00550-59646450,2023-05-06T17:51:43,Donostia,expenses,phone,-43.82,28364.42
buyer_5,Sara,,ES72209574622661518175,TRX_N-00551-35675671,2023-05-08T11:37:04,Donostia,expenses,electricity,-59.91,28304.51
buyer_5,Sara,,ES72209574622661518175,TRX_N-00552-29083999,2023-05-08T20:13:51,Donostia,expenses,internet,-42.0,28262.51
buyer_5,Sara,,ES72209574622661518175,TRX_N-00553-11383387,2023-05-09T05:21:50,Donostia,expenses,leisure,-38.98,28223.53
buyer_5,Sara,,ES72209574622661518175,TRX_N-00554-78838704,2023-05-09T14:34:30,Donostia,expenses,gifts,-147.08,28076.45
buyer_5,Sara,,ES72209574622661518175,TRX_N-00555-23280486,2023-05-10T12:57:25,Barakaldo,expenses,transport,-40.48,28035.97
buyer_5,Sara,,ES72209574622661518175,TRX_N-00556-70061307,2023-05-10T10:58:29,Donostia,expenses,healthcare,-152.82,27883.15
buyer_5,Sara,,ES72209574622661518175,TRX_N-00557-41787513,2023-05-11T10:20:45,Donostia,expenses,clothing,-79.7,27803.45
buyer_5,Sara,,ES72209574622661518175,TRX_N-00558-51737747,2023-05-15T17:40:13,Donostia,expenses,cash,-100.0,27703.45
buyer_5,Sara,,ES72209574622661518175,TRX_N-00559-56823324,2023-05-15T17:28:26,Donostia,expenses,repairs,-208.73,27494.72
buyer_5,Sara,,ES72209574622661518175,TRX_N-00560-20547355,2023-05-17T12:30:39,Donostia,expenses,education,-62.05,27432.67
buyer_5,Sara,,ES72209574622661518175,TRX_N-00561-00928372,2023-05-19T11:36:00,Donostia,expenses,repairs,-129.44,27303.23
buyer_5,Sara,,ES72209574622661518175,TRX_N-00562-57946962,2023-05-22T08:06:25,Donostia,expenses,transport,-70.18,27233.05
buyer_5,Sara,,ES72209574622661518175,TRX_N-00563-94069784,2023-05-25T09:51:50,Donostia,expenses,repairs,-179.12,27053.93
buyer_5,Sara,,ES72209574622661518175,TRX_N-00564-86548723,2023-05-26T01:13:29,Donostia,expenses,food,-76.57,26977.36
buyer_5,Sara,,ES72209574622661518175,TRX_N-00565-24616142,2023-05-30T08:03:28,Pasaia,expenses,cash,-100.0,26877.36
buyer_5,Sara,,ES72209574622661518175,TRX_N-00566-31614794,2023-05-31T09:21:51,Donostia,expenses,transport,-41.62,26835.74
buyer_5,Sara,,ES72209574622661518175,TRX_N-00567-43894014,2023-06-01T15:35:00,Donostia,incomes,salary,2811.01,29646.75
buyer_5,Sara,,ES72209574622661518175,TRX_N-00568-14573531,2023-06-01T15:35:00,Donostia,incomes,salary_partner,2394.77,32041.52
buyer_5,Sara,,ES72209574622661518175,TRX_N-00569-22962044,2023-06-01T15:35:00,Donostia,incomes,salary_bonus,1981.69,34023.21
buyer_5,Sara,,ES72209574622661518175,TRX_N-00570-54004832,2023-06-01T15:35:00,Donostia,incomes,salary_partner_bonus,1895.46,35918.67
buyer_5,Sara,,ES72209574622661518175,TRX_N-00571-54402636,2023-06-01T20:37:00,Donostia,expenses,food,-81.61,35837.06
buyer_5,Sara,,ES72209574622661518175,TRX_N-00572-42579364,2023-06-01T20:45:48,Lasarte-Oria,expenses,leisure,-71.65,35765.41
buyer_5,Sara,,ES72209574622661518175,TRX_N-00573-01547556,2023-06-02T12:01:15,Donostia,expenses,food,-89.86,35675.55
buyer_5,Sara,,ES72209574622661518175,TRX_N-00574-53218477,2023-06-03T12:20:38,Donostia,expenses,food,-82.56,35592.99
buyer_5,Sara,,ES72209574622661518175,TRX_N-00575-02759215,2023-06-04T10:21:32,Donostia,expenses,mortgage,-814.56,34778.43
buyer_5,Sara,,ES72209574622661518175,TRX_N-00576-35486582,2023-06-05T16:43:12,Donostia,expenses,electricity,-89.93,34688.5
buyer_5,Sara,,ES72209574622661518175,TRX_N-00577-95471848,2023-06-05T18:42:20,Donostia,expenses,internet,-42.0,34646.5
buyer_5,Sara,,ES72209574622661518175,TRX_N-00578-35909074,2023-06-06T12:32:19,Donostia,expenses,water,-28.15,34618.35
buyer_5,Sara,,ES72209574622661518175,TRX_N-00579-85628202,2023-06-06T17:56:41,Donostia,expenses,gas,-77.33,34541.02
buyer_5,Sara,,ES72209574622661518175,TRX_N-00580-92609696,2023-06-07T18:54:33,Donostia,expenses,food,-79.25,34461.77
buyer_5,Sara,,ES72209574622661518175,TRX_N-00581-38102691,2023-06-07T16:52:10,Donostia,expenses,leisure,-39.6,34422.17
buyer_5,Sara,,ES72209574622661518175,TRX_N-00582-76427852,2023-06-07T05:40:11,Salvatierra/Agurain,expenses,education,-59.12,34363.05
buyer_5,Sara,,ES72209574622661518175,TRX_N-00583-09969727,2023-06-08T13:41:14,Donostia,expenses,phone,-43.15,34319.9
buyer_5,Sara,,ES72209574622661518175,TRX_N-00584-57376971,2023-06-08T12:46:05,Donostia,expenses,leisure,-70.51,34249.39
buyer_5,Sara,,ES72209574622661518175,TRX_N-00585-98611193,2023-06-11T16:20:50,Donostia,expenses,leisure,-81.58,34167.81
buyer_5,Sara,,ES72209574622661518175,TRX_N-00586-12933111,2023-06-12T16:52:50,Donostia,expenses,food,-75.77,34092.04
buyer_5,Sara,,ES72209574622661518175,TRX_N-00587-77485221,2023-06-12T19:35:23,Donostia,expenses,cash,-100.0,33992.04
buyer_5,Sara,,ES72209574622661518175,TRX_N-00588-64809771,2023-06-13T15:42:30,Donostia,expenses,food,-79.79,33912.25
buyer_5,Sara,,ES72209574622661518175,TRX_N-00589-93680037,2023-06-15T12:31:28,Donostia,expenses,food,-72.95,33839.3
buyer_5,Sara,,ES72209574622661518175,TRX_N-00590-46060758,2023-06-17T17:32:16,Donostia,expenses,leisure,-26.16,33813.14
buyer_5,Sara,,ES72209574622661518175,TRX_N-00591-56580719,2023-06-18T00:30:16,Donostia,expenses,transport,-53.06,33760.08
buyer_5,Sara,,ES72209574622661518175,TRX_N-00592-16448755,2023-06-19T16:58:33,Donostia,expenses,food,-117.65,33642.43
buyer_5,Sara,,ES72209574622661518175,TRX_N-00593-86287729,2023-06-19T21:47:46,Donostia,expenses,cash,-100.0,33542.43
buyer_5,Sara,,ES72209574622661518175,TRX_N-00594-41163550,2023-06-19T02:30:24,Donostia,expenses,travel,-1029.35,32513.08
buyer_5,Sara,,ES72209574622661518175,TRX_N-00595-67932652,2023-06-21T08:28:22,Iruña de Oca,expenses,transport,-73.41,32439.67
buyer_5,Sara,,ES72209574622661518175,TRX_N-00596-92436333,2023-06-21T02:56:51,Donostia,expenses,leisure,-74.93,32364.74
buyer_5,Sara,,ES72209574622661518175,TRX_N-00597-46951466,2023-06-22T14:36:43,Donostia,expenses,repairs,-217.92,32146.82
buyer_5,Sara,,ES72209574622661518175,TRX_N-00598-15009800,2023-06-23T23:10:11,Zarautz,expenses,travel,-988.46,31158.36
buyer_5,Sara,,ES72209574622661518175,TRX_N-00599-24990249,2023-06-24T19:47:15,Donostia,expenses,education,-59.92,31098.44
buyer_5,Sara,,ES72209574622661518175,TRX_N-00600-97645377,2023-06-25T19:53:54,Donostia,expenses,food,-101.68,30996.76
buyer_5,Sara,,ES72209574622661518175,TRX_N-00601-70637289,2023-06-25T09:02:09,Donostia,expenses,cash,-100.0,30896.76
buyer_5,Sara,,ES72209574622661518175,TRX_N-00602-57893008,2023-06-26T15:39:17,Donostia,expenses,leisure,-83.8,30812.96
buyer_5,Sara,,ES72209574622661518175,TRX_N-00603-87450968,2023-06-26T13:51:00,Donostia,expenses,cash,-100.0,30712.96
buyer_5,Sara,,ES72209574622661518175,TRX_N-00604-29605662,2023-06-26T11:44:06,Donostia,expenses,repairs,-253.44,30459.52
buyer_5,Sara,,ES72209574622661518175,TRX_N-00605-81703079,2023-06-28T20:29:22,Donostia,expenses,transport,-83.66,30375.86
buyer_5,Sara,,ES72209574622661518175,TRX_N-00606-54620203,2023-06-28T06:17:56,Donostia,expenses,repairs,-157.81,30218.05
buyer_5,Sara,,ES72209574622661518175,TRX_N-00607-86443985,2023-07-01T19:17:23,Donostia,incomes,salary,2811.01,33029.06
buyer_5,Sara,,ES72209574622661518175,TRX_N-00608-70819872,2023-07-01T19:17:23,Donostia,incomes,salary_partner,2394.77,35423.83
buyer_5,Sara,,ES72209574622661518175,TRX_N-00609-23544836,2023-07-03T10:53:07,Donostia,expenses,transport,-41.7,35382.13
buyer_5,Sara,,ES72209574622661518175,TRX_N-00610-16829149,2023-07-04T09:54:41,Donostia,expenses,mortgage,-814.56,34567.57
buyer_5,Sara,,ES72209574622661518175,TRX_N-00611-00468386,2023-07-04T13:48:32,Donostia,expenses,food,-69.88,34497.69
buyer_5,Sara,,ES72209574622661518175,TRX_N-00612-94265139,2023-07-04T10:18:03,Elciego,expenses,cash,-100.0,34397.69
buyer_5,Sara,,ES72209574622661518175,TRX_N-00613-83848301,2023-07-05T08:37:39,Donostia,expenses,water,-26.78,34370.91
buyer_5,Sara,,ES72209574622661518175,TRX_N-00614-99796680,2023-07-05T13:04:10,Donostia,expenses,gas,-91.25,34279.66
buyer_5,Sara,,ES72209574622661518175,TRX_N-00615-05259374,2023-07-05T11:17:24,Donostia,expenses,internet,-42.0,34237.66
buyer_5,Sara,,ES72209574622661518175,TRX_N-00616-80995336,2023-07-06T22:42:03,Donostia,expenses,appliances,-232.78,34004.88
buyer_5,Sara,,ES72209574622661518175,TRX_N-00617-34623833,2023-07-07T09:36:36,Donostia,expenses,cash,-100.0,33904.88
buyer_5,Sara,,ES72209574622661518175,TRX_N-00618-91865981,2023-07-08T21:31:54,Donostia,expenses,phone,-33.81,33871.07
buyer_5,Sara,,ES72209574622661518175,TRX_N-00619-64489152,2023-07-08T05:51:07,Donostia,expenses,electricity,-69.89,33801.18
buyer_5,Sara,,ES72209574622661518175,TRX_N-00620-62495380,2023-07-08T12:27:02,Salvatierra/Agurain,expenses,cash,-100.0,33701.18
buyer_5,Sara,,ES72209574622661518175,TRX_N-00621-24373527,2023-07-09T14:50:36,Donostia,expenses,leisure,-33.24,33667.94
buyer_5,Sara,,ES72209574622661518175,TRX_N-00622-52576212,2023-07-12T14:42:40,Lasarte-Oria,expenses,food,-109.94,33558.0
buyer_5,Sara,,ES72209574622661518175,TRX_N-00623-35069764,2023-07-12T11:13:52,Irun,expenses,cash,-100.0,33458.0
buyer_5,Sara,,ES72209574622661518175,TRX_N-00624-98690740,2023-07-15T16:48:54,Donostia,expenses,leisure,-28.82,33429.18
buyer_5,Sara,,ES72209574622661518175,TRX_N-00625-58902164,2023-07-15T08:57:51,Donostia,expenses,repairs,-249.21,33179.97
buyer_5,Sara,,ES72209574622661518175,TRX_N-00626-89084655,2023-07-17T11:15:29,Donostia,expenses,clothing,-121.43,33058.54
buyer_5,Sara,,ES72209574622661518175,TRX_N-00627-84725862,2023-07-17T18:29:56,Donostia,expenses,cash,-100.0,32958.54
buyer_5,Sara,,ES72209574622661518175,TRX_N-00628-38488739,2023-07-19T10:38:36,Oyón-Oion,expenses,transport,-59.89,32898.65
buyer_5,Sara,,ES72209574622661518175,TRX_N-00629-33989031,2023-07-21T17:38:41,Hernani,expenses,repairs,-270.38,32628.27
buyer_5,Sara,,ES72209574622661518175,TRX_N-00630-94032638,2023-07-22T17:59:55,Donostia,expenses,leisure,-29.17,32599.1
buyer_5,Sara,,ES72209574622661518175,TRX_N-00631-26893032,2023-07-25T19:00:52,Donostia,expenses,leisure,-78.62,32520.48
buyer_5,Sara,,ES72209574622661518175,TRX_N-00632-05464479,2023-07-26T19:27:14,Donostia,expenses,education,-51.33,32469.15
buyer_5,Sara,,ES72209574622661518175,TRX_N-00633-82604504,2023-07-27T10:01:22,Basauri,expenses,repairs,-147.47,32321.68
buyer_5,Sara,,ES72209574622661518175,TRX_N-00634-73808470,2023-08-01T10:52:47,Donostia,incomes,salary,2811.01,35132.69
buyer_5,Sara,,ES72209574622661518175,TRX_N-00635-38306685,2023-08-01T10:52:47,Donostia,incomes,salary_partner,2394.77,37527.46
buyer_5,Sara,,ES72209574622661518175,TRX_N-00636-94458501,2023-08-01T19:36:25,Erandio,expenses,education,-51.97,37475.49
buyer_5,Sara,,ES72209574622661518175,TRX_N-00637-26723370,2023-08-02T18:39:03,Sopela,expenses,repairs,-231.51,37243.98
buyer_5,Sara,,ES72209574622661518175,TRX_N-00638-86346639,2023-08-03T19:36:03,Salvatierra/Agurain,expenses,food,-94.84,37149.14
buyer_5,Sara,,ES72209574622661518175,TRX_N-00639-94737595,2023-08-03T13:23:28,Donostia,expenses,cash,-100.0,37049.14
buyer_5,Sara,,ES72209574622661518175,TRX_N-00640-14480373,2023-08-04T16:28:24,Donostia,expenses,mortgage,-814.56,36234.58
buyer_5,Sara,,ES72209574622661518175,TRX_N-00641-07446588,2023-08-05T16:41:32,Donostia,expenses,internet,-42.0,36192.58
buyer_5,Sara,,ES72209574622661518175,TRX_N-00642-91709787,2023-08-06T15:12:01,Donostia,expenses,water,-25.86,36166.72
buyer_5,Sara,,ES72209574622661518175,TRX_N-00643-28980332,2023-08-06T09:02:08,Donostia,expenses,phone,-39.63,36127.09
buyer_5,Sara,,ES72209574622661518175,TRX_N-00644-01719268,2023-08-06T16:32:52,Donostia,expenses,food,-84.98,36042.11
buyer_5,Sara,,ES72209574622661518175,TRX_N-00645-01409906,2023-08-07T20:21:22,Donostia,expenses,transport,-73.65,35968.46
buyer_5,Sara,,ES72209574622661518175,TRX_N-00646-30537787,2023-08-08T23:08:48,Donostia,expenses,electricity,-28.27,35940.19
buyer_5,Sara,,ES72209574622661518175,TRX_N-00647-59821406,2023-08-08T14:28:25,Donostia,expenses,gas,-60.03,35880.16
buyer_5,Sara,,ES72209574622661518175,TRX_N-00648-30583129,2023-08-08T14:55:58,Donostia,expenses,gifts,-623.03,35257.13
buyer_5,Sara,,ES72209574622661518175,TRX_N-00649-19816831,2023-08-09T13:00:53,Donostia,expenses,education,-45.27,35211.86
buyer_5,Sara,,ES72209574622661518175,TRX_N-00650-48354527,2023-08-10T15:03:45,Portugalete,expenses,clothing,-111.82,35100.04
buyer_5,Sara,,ES72209574622661518175,TRX_N-00651-82888370,2023-08-13T08:46:43,Santurtzi,expenses,food,-121.55,34978.49
buyer_5,Sara,,ES72209574622661518175,TRX_N-00652-45401910,2023-08-13T19:25:46,Donostia,expenses,leisure,-41.8,34936.69
buyer_5,Sara,,ES72209574622661518175,TRX_N-00653-85144702,2023-08-14T21:34:44,Donostia,expenses,repairs,-195.14,34741.55
buyer_5,Sara,,ES72209574622661518175,TRX_N-00654-45945337,2023-08-15T12:17:32,Donostia,expenses,education,-52.61,34688.94
buyer_5,Sara,,ES72209574622661518175,TRX_N-00655-64441054,2023-08-17T15:40:31,Donostia,expenses,food,-116.34,34572.6
buyer_5,Sara,,ES72209574622661518175,TRX_N-00656-95422053,2023-08-20T20:36:07,Donostia,expenses,appliances,-248.48,34324.12
buyer_5,Sara,,ES72209574622661518175,TRX_N-00657-43786222,2023-08-21T13:50:28,Donostia,expenses,transport,-75.8,34248.32
buyer_5,Sara,,ES72209574622661518175,TRX_N-00658-67479272,2023-08-21T18:46:45,Donostia,expenses,cash,-100.0,34148.32
buyer_5,Sara,,ES72209574622661518175,TRX_N-00659-15555388,2023-08-22T13:58:36,Donostia,expenses,food,-123.35,34024.97
buyer_5,Sara,,ES72209574622661518175,TRX_N-00660-76465767,2023-08-22T00:32:01,Donostia,expenses,cash,-100.0,33924.97
buyer_5,Sara,,ES72209574622661518175,TRX_N-00661-91929307,2023-08-23T11:16:33,Donostia,expenses,food,-113.68,33811.29
buyer_5,Sara,,ES72209574622661518175,TRX_N-00662-18763928,2023-08-23T09:18:57,Iruña de Oca,expenses,cash,-100.0,33711.29
buyer_5,Sara,,ES72209574622661518175,TRX_N-00663-71740963,2023-08-24T15:47:00,Donostia,expenses,transport,-71.24,33640.05
buyer_5,Sara,,ES72209574622661518175,TRX_N-00664-40594733,2023-08-24T10:29:20,Donostia,expenses,education,-57.98,33582.07
buyer_5,Sara,,ES72209574622661518175,TRX_N-00665-87350416,2023-08-26T12:24:01,Santurtzi,expenses,food,-76.79,33505.28
buyer_5,Sara,,ES72209574622661518175,TRX_N-00666-49156151,2023-08-26T10:41:03,Andoain,expenses,leisure,-62.23,33443.05
buyer_5,Sara,,ES72209574622661518175,TRX_N-00667-57114348,2023-08-27T09:56:12,Getxo,expenses,food,-102.23,33340.82
buyer_5,Sara,,ES72209574622661518175,TRX_N-00668-57490520,2023-09-01T16:13:20,Donostia,incomes,salary,2811.01,36151.83
buyer_5,Sara,,ES72209574622661518175,TRX_N-00669-61545896,2023-09-01T16:13:20,Donostia,incomes,salary_partner,2394.77,38546.6
buyer_5,Sara,,ES72209574622661518175,TRX_N-00670-97323309,2023-09-01T16:13:20,Donostia,incomes,extra_income,303.94,38850.54
buyer_5,Sara,,ES72209574622661518175,TRX_N-00671-04681412,2023-09-01T17:37:05,Donostia,expenses,transport,-60.31,38790.23
buyer_5,Sara,,ES72209574622661518175,TRX_N-00672-77180502,2023-09-01T04:27:32,Donostia,expenses,leisure,-37.77,38752.46
buyer_5,Sara,,ES72209574622661518175,TRX_N-00673-26329126,2023-09-03T22:53:37,Donostia,expenses,transport,-48.34,38704.12
buyer_5,Sara,,ES72209574622661518175,TRX_N-00674-39493056,2023-09-04T09:28:44,Donostia,expenses,mortgage,-814.56,37889.56
buyer_5,Sara,,ES72209574622661518175,TRX_N-00675-10071885,2023-09-04T23:47:24,Elciego,expenses,transport,-87.09,37802.47
buyer_5,Sara,,ES72209574622661518175,TRX_N-00676-18792602,2023-09-04T10:11:30,Donostia,expenses,healthcare,-59.19,37743.28
buyer_5,Sara,,ES72209574622661518175,TRX_N-00677-66566072,2023-09-04T08:18:51,Donostia,expenses,travel,-1625.59,36117.69
buyer_5,Sara,,ES72209574622661518175,TRX_N-00678-05897563,2023-09-05T11:57:08,Donostia,expenses,gas,-87.31,36030.38
buyer_5,Sara,,ES72209574622661518175,TRX_N-00679-82747902,2023-09-05T10:18:52,Donostia,expenses,internet,-42.0,35988.38
buyer_5,Sara,,ES72209574622661518175,TRX_N-00680-53397494,2023-09-05T13:30:22,Donostia,expenses,food,-69.95,35918.43
buyer_5,Sara,,ES72209574622661518175,TRX_N-00681-24792687,2023-09-05T23:18:03,Bilbao,expenses,transport,-50.99,35867.44
buyer_5,Sara,,ES72209574622661518175,TRX_N-00682-86384284,2023-09-06T15:19:58,Donostia,expenses,phone,-44.65,35822.79
buyer_5,Sara,,ES72209574622661518175,TRX_N-00683-57191561,2023-09-07T02:49:20,Donostia,expenses,water,-40.92,35781.87
buyer_5,Sara,,ES72209574622661518175,TRX_N-00684-33875701,2023-09-07T12:44:41,Donostia,expenses,electricity,-52.82,35729.05
buyer_5,Sara,,ES72209574622661518175,TRX_N-00685-59446500,2023-09-07T16:34:27,Amurrio,expenses,gifts,-633.66,35095.39
buyer_5,Sara,,ES72209574622661518175,TRX_N-00686-59756814,2023-09-08T08:36:03,Donostia,expenses,repairs,-40.43,35054.96
buyer_5,Sara,,ES72209574622661518175,TRX_N-00687-19593715,2023-09-10T16:33:26,Donostia,expenses,transport,-83.43,34971.53
buyer_5,Sara,,ES72209574622661518175,TRX_N-00688-75942034,2023-09-10T16:31:20,Donostia,expenses,cash,-100.0,34871.53
buyer_5,Sara,,ES72209574622661518175,TRX_N-00689-99549768,2023-09-12T16:03:28,Donostia,expenses,transport,-76.46,34795.07
buyer_5,Sara,,ES72209574622661518175,TRX_N-00690-42000496,2023-09-12T05:28:12,Donostia,expenses,cash,-100.0,34695.07
buyer_5,Sara,,ES72209574622661518175,TRX_N-00691-15057063,2023-09-16T08:43:12,Elciego,expenses,food,-82.58,34612.49
buyer_5,Sara,,ES72209574622661518175,TRX_N-00692-22366779,2023-09-17T13:42:30,Donostia,expenses,food,-61.54,34550.95
buyer_5,Sara,,ES72209574622661518175,TRX_N-00693-30489679,2023-09-20T22:43:11,Donostia,expenses,food,-95.16,34455.79
buyer_5,Sara,,ES72209574622661518175,TRX_N-00694-89294619,2023-09-21T10:10:51,Donostia,expenses,food,-78.4,34377.39
buyer_5,Sara,,ES72209574622661518175,TRX_N-00695-77154921,2023-09-22T11:21:55,Donostia,expenses,transport,-55.33,34322.06
buyer_5,Sara,,ES72209574622661518175,TRX_N-00696-41668516,2023-09-23T00:53:00,Donostia,expenses,gifts,-778.49,33543.57
buyer_5,Sara,,ES72209574622661518175,TRX_N-00697-30645602,2023-09-25T08:13:38,Donostia,expenses,food,-70.31,33473.26
buyer_5,Sara,,ES72209574622661518175,TRX_N-00698-74140485,2023-09-26T14:57:32,Arrasate,expenses,gifts,-189.84,33283.42
buyer_5,Sara,,ES72209574622661518175,TRX_N-00699-48457462,2023-09-27T14:52:38,Donostia,expenses,food,-116.73,33166.69
buyer_5,Sara,,ES72209574622661518175,TRX_N-00700-99364825,2023-09-30T11:02:11,Donostia,expenses,leisure,-43.93,33122.76
buyer_5,Sara,,ES72209574622661518175,TRX_N-00701-73430861,2023-10-01T14:53:01,Donostia,incomes,salary,2811.01,35933.77
buyer_5,Sara,,ES72209574622661518175,TRX_N-00702-68650897,2023-10-01T14:53:01,Donostia,incomes,salary_partner,2394.77,38328.54
buyer_5,Sara,,ES72209574622661518175,TRX_N-00703-66189692,2023-10-03T18:27:42,Donostia,expenses,leisure,-44.95,38283.59
buyer_5,Sara,,ES72209574622661518175,TRX_N-00704-61771648,2023-10-04T16:44:10,Donostia,expenses,mortgage,-814.56,37469.03
buyer_5,Sara,,ES72209574622661518175,TRX_N-00705-13314049,2023-10-04T08:13:33,Donostia,expenses,transport,-45.29,37423.74
buyer_5,Sara,,ES72209574622661518175,TRX_N-00706-51722479,2023-10-04T21:18:37,Donostia,expenses,appliances,-137.66,37286.08
buyer_5,Sara,,ES72209574622661518175,TRX_N-00707-03020849,2023-10-05T10:30:25,Donostia,expenses,water,-27.71,37258.37
buyer_5,Sara,,ES72209574622661518175,TRX_N-00708-80971862,2023-10-05T12:44:15,Zarautz,expenses,food,-99.48,37158.89
buyer_5,Sara,,ES72209574622661518175,TRX_N-00709-08498179,2023-10-05T15:09:44,Donostia,expenses,transport,-64.73,37094.16
buyer_5,Sara,,ES72209574622661518175,TRX_N-00710-57508388,2023-10-06T15:22:29,Donostia,expenses,gas,-45.54,37048.62
buyer_5,Sara,,ES72209574622661518175,TRX_N-00711-94771489,2023-10-06T21:26:20,Donostia,expenses,repairs,-271.51,36777.11
buyer_5,Sara,,ES72209574622661518175,TRX_N-00712-93625873,2023-10-07T15:43:37,Donostia,expenses,internet,-42.0,36735.11
buyer_5,Sara,,ES72209574622661518175,TRX_N-00713-89047451,2023-10-07T08:12:17,Donostia,expenses,leisure,-35.85,36699.26
buyer_5,Sara,,ES72209574622661518175,TRX_N-00714-68019918,2023-10-08T13:01:39,Donostia,expenses,electricity,-74.27,36624.99
buyer_5,Sara,,ES72209574622661518175,TRX_N-00715-50654745,2023-10-08T18:25:15,Donostia,expenses,phone,-32.32,36592.67
buyer_5,Sara,,ES72209574622661518175,TRX_N-00716-19345020,2023-10-08T18:53:05,Donostia,expenses,transport,-68.8,36523.87
buyer_5,Sara,,ES72209574622661518175,TRX_N-00717-06235573,2023-10-09T18:52:06,Donostia,expenses,clothing,-45.46,36478.41
buyer_5,Sara,,ES72209574622661518175,TRX_N-00718-39442850,2023-10-09T20:28:27,Donostia,expenses,repairs,-274.27,36204.14
buyer_5,Sara,,ES72209574622661518175,TRX_N-00719-26290841,2023-10-10T05:32:39,Donostia,expenses,food,-79.66,36124.48
buyer_5,Sara,,ES72209574622661518175,TRX_N-00720-72289794,2023-10-12T19:16:53,Donostia,expenses,transport,-44.6,36079.88
buyer_5,Sara,,ES72209574622661518175,TRX_N-00721-17262672,2023-10-13T06:03:36,Donostia,expenses,food,-74.32,36005.56
buyer_5,Sara,,ES72209574622661518175,TRX_N-00722-59766219,2023-10-17T12:11:20,Donostia,expenses,transport,-68.14,35937.42
buyer_5,Sara,,ES72209574622661518175,TRX_N-00723-60671975,2023-10-18T14:33:48,Donostia,expenses,cash,-100.0,35837.42
buyer_5,Sara,,ES72209574622661518175,TRX_N-00724-25037788,2023-10-19T10:09:29,Donostia,expenses,transport,-59.48,35777.94
buyer_5,Sara,,ES72209574622661518175,TRX_N-00725-94311833,2023-10-20T22:12:44,Donostia,expenses,cash,-100.0,35677.94
buyer_5,Sara,,ES72209574622661518175,TRX_N-00726-12714346,2023-10-21T17:04:57,Donostia,expenses,food,-82.84,35595.1
buyer_5,Sara,,ES72209574622661518175,TRX_N-00727-24273058,2023-10-21T11:35:50,Hondarribia,expenses,transport,-55.13,35539.97
buyer_5,Sara,,ES72209574622661518175,TRX_N-00728-16628706,2023-10-22T10:47:14,Donostia,expenses,leisure,-45.42,35494.55
buyer_5,Sara,,ES72209574622661518175,TRX_N-00729-76319415,2023-10-23T09:27:23,Donostia,expenses,transport,-84.67,35409.88
buyer_5,Sara,,ES72209574622661518175,TRX_N-00730-15151167,2023-10-23T19:06:57,Arrasate,expenses,leisure,-28.35,35381.53
buyer_5,Sara,,ES72209574622661518175,TRX_N-00731-31474956,2023-10-23T08:40:13,Donostia,expenses,clothing,-71.58,35309.95
buyer_5,Sara,,ES72209574622661518175,TRX_N-00732-66369634,2023-10-25T10:24:15,Oyón-Oion,expenses,clothing,-127.59,35182.36
buyer_5,Sara,,ES72209574622661518175,TRX_N-00733-58025898,2023-10-26T09:34:28,Donostia,expenses,leisure,-31.89,35150.47
buyer_5,Sara,,ES72209574622661518175,TRX_N-00734-94892888,2023-10-29T16:09:13,Donostia,expenses,food,-113.89,35036.58
buyer_5,Sara,,ES72209574622661518175,TRX_N-00735-22513340,2023-10-29T15:05:52,Donostia,expenses,cash,-100.0,34936.58
buyer_5,Sara,,ES72209574622661518175,TRX_N-00736-48021798,2023-10-30T18:34:51,Donostia,expenses,transport,-62.08,34874.5
buyer_5,Sara,,ES72209574622661518175,TRX_N-00737-56197544,2023-10-30T17:03:18,Donostia,expenses,gifts,-812.7,34061.8
buyer_5,Sara,,ES72209574622661518175,TRX_N-00738-74740777,2023-11-01T16:34:20,Donostia,incomes,salary,2811.01,36872.81
buyer_5,Sara,,ES72209574622661518175,TRX_N-00739-11447832,2023-11-01T16:34:20,Donostia,incomes,salary_partner,2394.77,39267.58
buyer_5,Sara,,ES72209574622661518175,TRX_N-00740-04228719,2023-11-02T18:26:58,Getxo,expenses,gifts,-815.89,38451.69
buyer_5,Sara,,ES72209574622661518175,TRX_N-00741-37668013,2023-11-04T14:41:09,Donostia,expenses,mortgage,-814.56,37637.13
buyer_5,Sara,,ES72209574622661518175,TRX_N-00742-95304406,2023-11-05T20:50:13,Donostia,expenses,gas,-40.69,37596.44
buyer_5,Sara,,ES72209574622661518175,TRX_N-00743-70774970,2023-11-05T03:03:32,Donostia,expenses,food,-111.48,37484.96
buyer_5,Sara,,ES72209574622661518175,TRX_N-00744-16854784,2023-11-05T11:46:48,Donostia,expenses,clothing,-119.03,37365.93
buyer_5,Sara,,ES72209574622661518175,TRX_N-00745-69592631,2023-11-06T17:01:04,Donostia,expenses,water,-31.13,37334.8
buyer_5,Sara,,ES72209574622661518175,TRX_N-00746-49861314,2023-11-06T09:35:16,Donostia,expenses,internet,-42.0,37292.8
buyer_5,Sara,,ES72209574622661518175,TRX_N-00747-88345175,2023-11-07T18:03:09,Donostia,expenses,food,-90.62,37202.18
buyer_5,Sara,,ES72209574622661518175,TRX_N-00748-47362140,2023-11-08T11:00:21,Donostia,expenses,electricity,-23.96,37178.22
buyer_5,Sara,,ES72209574622661518175,TRX_N-00749-81359463,2023-11-08T15:55:36,Donostia,expenses,phone,-30.28,37147.94
buyer_5,Sara,,ES72209574622661518175,TRX_N-00750-03756031,2023-11-08T19:35:11,Donostia,expenses,gifts,-91.02,37056.92
buyer_5,Sara,,ES72209574622661518175,TRX_N-00751-25201014,2023-11-09T10:30:29,Donostia,expenses,healthcare,-186.11,36870.81
buyer_5,Sara,,ES72209574622661518175,TRX_N-00752-45488198,2023-11-09T00:22:11,Donostia,expenses,appliances,-230.25,36640.56
buyer_5,Sara,,ES72209574622661518175,TRX_N-00753-66372050,2023-11-10T00:58:12,Donostia,expenses,cash,-100.0,36540.56
buyer_5,Sara,,ES72209574622661518175,TRX_N-00754-36151878,2023-11-11T22:25:00,Donostia,expenses,clothing,-148.92,36391.64
buyer_5,Sara,,ES72209574622661518175,TRX_N-00755-06348094,2023-11-11T11:05:41,Iruña de Oca,expenses,cash,-100.0,36291.64
buyer_5,Sara,,ES72209574622661518175,TRX_N-00756-07932722,2023-11-16T08:42:45,Donostia,expenses,food,-85.92,36205.72
buyer_5,Sara,,ES72209574622661518175,TRX_N-00757-50438841,2023-11-16T11:15:23,Donostia,expenses,gifts,-202.01,36003.71
buyer_5,Sara,,ES72209574622661518175,TRX_N-00758-02998963,2023-11-17T04:37:20,Donostia,expenses,clothing,-62.23,35941.48
buyer_5,Sara,,ES72209574622661518175,TRX_N-00759-39598584,2023-11-17T08:04:34,Donostia,expenses,repairs,-250.94,35690.54
buyer_5,Sara,,ES72209574622661518175,TRX_N-00760-44046819,2023-11-19T00:41:56,Eibar,expenses,appliances,-104.26,35586.28
buyer_5,Sara,,ES72209574622661518175,TRX_N-00761-48203664,2023-11-20T17:53:06,Donostia,expenses,food,-104.87,35481.41
buyer_5,Sara,,ES72209574622661518175,TRX_N-00762-19540866,2023-11-20T15:53:42,Donostia,expenses,appliances,-146.43,35334.98
buyer_5,Sara,,ES72209574622661518175,TRX_N-00763-51611806,2023-11-21T16:00:38,Donostia,expenses,clothing,-147.01,35187.97
buyer_5,Sara,,ES72209574622661518175,TRX_N-00764-38035855,2023-11-28T09:04:46,Donostia,expenses,repairs,-41.0,35146.97
buyer_5,Sara,,ES72209574622661518175,TRX_N-00765-92032106,2023-11-30T17:22:22,Donostia,expenses,cash,-100.0,35046.97
buyer_5,Sara,,ES72209574622661518175,TRX_N-00766-24541464,2023-12-01T20:48:18,Donostia,incomes,salary,2811.01,37857.98
buyer_5,Sara,,ES72209574622661518175,TRX_N-00767-94745884,2023-12-01T20:48:18,Donostia,incomes,salary_partner,2394.77,40252.75
buyer_5,Sara,,ES72209574622661518175,TRX_N-00768-26278664,2023-12-01T20:48:18,Donostia,incomes,salary_bonus,2084.96,42337.71
buyer_5,Sara,,ES72209574622661518175,TRX_N-00769-58305394,2023-12-01T20:48:18,Donostia,incomes,salary_partner_bonus,1714.63,44052.34
buyer_5,Sara,,ES72209574622661518175,TRX_N-00770-90806751,2023-12-01T13:01:56,Donostia,expenses,food,-89.15,43963.19
buyer_5,Sara,,ES72209574622661518175,TRX_N-00771-90639295,2023-12-01T15:57:36,Donostia,expenses,transport,-72.37,43890.82
buyer_5,Sara,,ES72209574622661518175,TRX_N-00772-88616246,2023-12-01T03:44:10,Donostia,expenses,gifts,-704.72,43186.1
buyer_5,Sara,,ES72209574622661518175,TRX_N-00773-94407184,2023-12-03T09:38:54,Donostia,expenses,cash,-100.0,43086.1
buyer_5,Sara,,ES72209574622661518175,TRX_N-00774-75693076,2023-12-04T17:34:29,Donostia,expenses,mortgage,-814.56,42271.54
buyer_5,Sara,,ES72209574622661518175,TRX_N-00775-66690414,2023-12-04T06:47:19,Donostia,expenses,food,-102.76,42168.78
buyer_5,Sara,,ES72209574622661518175,TRX_N-00776-73934157,2023-12-05T08:06:21,Donostia,expenses,water,-31.44,42137.34
buyer_5,Sara,,ES72209574622661518175,TRX_N-00777-36654633,2023-12-06T21:05:46,Donostia,expenses,electricity,-39.0,42098.34
buyer_5,Sara,,ES72209574622661518175,TRX_N-00778-83002692,2023-12-06T11:26:44,Donostia,expenses,gas,-68.41,42029.93
buyer_5,Sara,,ES72209574622661518175,TRX_N-00779-19950040,2023-12-07T13:07:58,Donostia,expenses,leisure,-70.23,41959.7
buyer_5,Sara,,ES72209574622661518175,TRX_N-00780-44332897,2023-12-08T19:06:38,Donostia,expenses,internet,-42.0,41917.7
buyer_5,Sara,,ES72209574622661518175,TRX_N-00781-56412967,2023-12-08T08:36:22,Donostia,expenses,phone,-33.5,41884.2
buyer_5,Sara,,ES72209574622661518175,TRX_N-00782-67216484,2023-12-13T09:04:06,Donostia,expenses,clothing,-103.01,41781.19
buyer_5,Sara,,ES72209574622661518175,TRX_N-00783-40666104,2023-12-13T18:13:11,Donostia,expenses,cash,-100.0,41681.19
buyer_5,Sara,,ES72209574622661518175,TRX_N-00784-78623478,2023-12-13T17:20:42,Donostia,expenses,appliances,-188.65,41492.54
buyer_5,Sara,,ES72209574622661518175,TRX_N-00785-23495756,2023-12-14T04:12:16,Sestao,expenses,food,-82.13,41410.41
buyer_5,Sara,,ES72209574622661518175,TRX_N-00786-89322734,2023-12-14T14:53:47,Donostia,expenses,cash,-100.0,41310.41
buyer_5,Sara,,ES72209574622661518175,TRX_N-00787-75436692,2023-12-15T16:16:01,Donostia,expenses,food,-94.93,41215.48
buyer_5,Sara,,ES72209574622661518175,TRX_N-00788-14795325,2023-12-15T20:21:56,Donostia,expenses,education,-52.08,41163.4
buyer_5,Sara,,ES72209574622661518175,TRX_N-00789-89919469,2023-12-16T12:45:45,Donostia,expenses,education,-69.99,41093.41
buyer_5,Sara,,ES72209574622661518175,TRX_N-00790-90845705,2023-12-17T20:38:16,Donostia,expenses,cash,-100.0,40993.41
buyer_5,Sara,,ES72209574622661518175,TRX_N-00791-03337244,2023-12-19T17:46:59,Donostia,expenses,clothing,-107.48,40885.93
buyer_5,Sara,,ES72209574622661518175,TRX_N-00792-82552111,2023-12-19T08:56:32,Erandio,expenses,healthcare,-189.24,40696.69
buyer_5,Sara,,ES72209574622661518175,TRX_N-00793-13409562,2023-12-20T12:29:41,Donostia,expenses,leisure,-35.17,40661.52
buyer_5,Sara,,ES72209574622661518175,TRX_N-00794-63518716,2023-12-21T09:31:32,Donostia,expenses,healthcare,-82.96,40578.56
buyer_5,Sara,,ES72209574622661518175,TRX_N-00795-22652409,2023-12-22T12:02:01,Santurtzi,expenses,cash,-100.0,40478.56
buyer_5,Sara,,ES72209574622661518175,TRX_N-00796-13005169,2023-12-22T17:43:48,Donostia,expenses,repairs,-280.0,40198.56
buyer_5,Sara,,ES72209574622661518175,TRX_N-00797-04205298,2023-12-23T08:34:00,Donostia,expenses,education,-68.44,40130.12
buyer_5,Sara,,ES72209574622661518175,TRX_N-00798-37846120,2023-12-24T22:12:31,Donostia,expenses,food,-111.08,40019.04
buyer_5,Sara,,ES72209574622661518175,TRX_N-00799-60672886,2023-12-25T18:32:48,Donostia,expenses,cash,-100.0,39919.04
buyer_5,Sara,,ES72209574622661518175,TRX_N-00800-32688439,2023-12-28T15:44:54,Donostia,expenses,transport,-62.86,39856.18
buyer_5,Sara,,ES72209574622661518175,TRX_N-00801-38196157,2023-12-28T20:35:33,Donostia,expenses,repairs,-44.74,39811.44
buyer_5,Sara,,ES72209574622661518175,TRX_N-00802-05266551,2023-12-28T08:55:54,Donostia,expenses,gifts,-786.64,39024.8
buyer_5,Sara,,ES72209574622661518175,TRX_N-00803-09393788,2024-01-01T16:11:16,Donostia,incomes,salary,2875.5,41900.3
buyer_5,Sara,,ES72209574622661518175,TRX_N-00804-23186479,2024-01-01T16:11:16,Donostia,incomes,salary_partner,2449.71,44350.01
buyer_5,Sara,,ES72209574622661518175,TRX_N-00805-41911328,2024-01-01T16:11:16,Donostia,incomes,extra_income,303.94,44653.95
buyer_5,Sara,,ES72209574622661518175,TRX_N-00806-66834221,2024-01-01T17:30:01,Donostia,expenses,cash,-100.0,44553.95
buyer_5,Sara,,ES72209574622661518175,TRX_N-00807-91773018,2024-01-02T19:42:54,Barakaldo,expenses,food,-81.62,44472.33
buyer_5,Sara,,ES72209574622661518175,TRX_N-00808-54323943,2024-01-02T11:06:08,Donostia,expenses,cash,-100.0,44372.33
buyer_5,Sara,,ES72209574622661518175,TRX_N-00809-80502976,2024-01-03T11:11:19,Berango,expenses,cash,-100.0,44272.33
buyer_5,Sara,,ES72209574622661518175,TRX_N-00810-07585078,2024-01-04T11:38:34,Donostia,expenses,mortgage,-814.56,43457.77
buyer_5,Sara,,ES72209574622661518175,TRX_N-00811-69268436,2024-01-04T18:01:41,Donostia,expenses,transport,-65.63,43392.14
buyer_5,Sara,,ES72209574622661518175,TRX_N-00812-15616657,2024-01-05T15:42:20,Donostia,expenses,electricity,-53.12,43339.02
buyer_5,Sara,,ES72209574622661518175,TRX_N-00813-40717898,2024-01-05T17:39:54,Donostia,expenses,phone,-40.96,43298.06
buyer_5,Sara,,ES72209574622661518175,TRX_N-00814-59478218,2024-01-05T20:37:49,Donostia,expenses,food,-76.65,43221.41
buyer_5,Sara,,ES72209574622661518175,TRX_N-00815-26891465,2024-01-05T20:20:44,Donostia,expenses,leisure,-49.65,43171.76
buyer_5,Sara,,ES72209574622661518175,TRX_N-00816-44025480,2024-01-07T16:06:56,Donostia,expenses,leisure,-50.05,43121.71
buyer_5,Sara,,ES72209574622661518175,TRX_N-00817-47559595,2024-01-07T18:31:45,Lasarte-Oria,expenses,clothing,-114.62,43007.09
buyer_5,Sara,,ES72209574622661518175,TRX_N-00818-47468961,2024-01-08T18:50:14,Donostia,expenses,water,-30.54,42976.55
buyer_5,Sara,,ES72209574622661518175,TRX_N-00819-70378918,2024-01-08T04:51:20,Donostia,expenses,gas,-96.2,42880.35
buyer_5,Sara,,ES72209574622661518175,TRX_N-00820-60832908,2024-01-08T10:44:04,Donostia,expenses,internet,-42.0,42838.35
buyer_5,Sara,,ES72209574622661518175,TRX_N-00821-07826783,2024-01-10T19:18:10,Oyón-Oion,expenses,food,-61.3,42777.05
buyer_5,Sara,,ES72209574622661518175,TRX_N-00822-03910277,2024-01-15T11:24:01,Donostia,expenses,food,-71.16,42705.89
buyer_5,Sara,,ES72209574622661518175,TRX_N-00823-54266894,2024-01-15T14:24:12,Donostia,expenses,clothing,-111.6,42594.29
buyer_5,Sara,,ES72209574622661518175,TRX_N-00824-86895146,2024-01-16T17:08:41,Donostia,expenses,transport,-48.32,42545.97
buyer_5,Sara,,ES72209574622661518175,TRX_N-00825-01277598,2024-01-17T10:30:18,Donostia,expenses,leisure,-42.86,42503.11
buyer_5,Sara,,ES72209574622661518175,TRX_N-00826-24029127,2024-01-17T08:23:43,Donostia,expenses,clothing,-63.96,42439.15
buyer_5,Sara,,ES72209574622661518175,TRX_N-00827-03579305,2024-01-23T23:37:21,Donostia,expenses,leisure,-32.15,42407.0
buyer_5,Sara,,ES72209574622661518175,TRX_N-00828-90326308,2024-01-23T09:21:18,Donostia,expenses,healthcare,-113.27,42293.73
buyer_5,Sara,,ES72209574622661518175,TRX_N-00829-67553925,2024-01-24T14:42:52,Donostia,expenses,food,-79.0,42214.73
buyer_5,Sara,,ES72209574622661518175,TRX_N-00830-32769844,2024-01-24T18:45:23,Vitoria-Gasteiz,expenses,cash,-100.0,42114.73
buyer_5,Sara,,ES72209574622661518175,TRX_N-00831-74400934,2024-01-26T11:41:41,Donostia,expenses,food,-74.1,42040.63
buyer_5,Sara,,ES72209574622661518175,TRX_N-00832-36257488,2024-01-26T17:05:23,Leioa,expenses,transport,-66.33,41974.3
buyer_5,Sara,,ES72209574622661518175,TRX_N-00833-49586397,2024-01-27T17:53:36,Donostia,expenses,food,-107.63,41866.67
buyer_5,Sara,,ES72209574622661518175,TRX_N-00834-67444513,2024-01-27T13:40:45,Donostia,expenses,leisure,-27.23,41839.44
buyer_5,Sara,,ES72209574622661518175,TRX_N-00835-75197849,2024-01-31T17:26:08,Llodio,expenses,food,-60.61,41778.83
buyer_5,Sara,,ES72209574622661518175,TRX_N-00836-97475972,2024-02-01T08:55:06,Donostia,incomes,salary,2875.5,44654.33
buyer_5,Sara,,ES72209574622661518175,TRX_N-00837-21629970,2024-02-01T08:55:06,Donostia,incomes,salary_partner,2449.71,47104.04
buyer_5,Sara,,ES72209574622661518175,TRX_N-00838-90226719,2024-02-01T10:03:40,Donostia,expenses,food,-98.04,47006.0
buyer_5,Sara,,ES72209574622661518175,TRX_N-00839-39264761,2024-02-01T17:06:34,Labastida,expenses,leisure,-50.45,46955.55
buyer_5,Sara,,ES72209574622661518175,TRX_N-00840-85058114,2024-02-02T12:46:28,Donostia,expenses,cash,-100.0,46855.55
buyer_5,Sara,,ES72209574622661518175,TRX_N-00841-53305632,2024-02-04T12:49:26,Donostia,expenses,mortgage,-814.56,46040.99
buyer_5,Sara,,ES72209574622661518175,TRX_N-00842-99966481,2024-02-04T18:29:19,Donostia,expenses,travel,-488.42,45552.57
buyer_5,Sara,,ES72209574622661518175,TRX_N-00843-23498127,2024-02-05T13:56:56,Donostia,expenses,water,-43.67,45508.9
buyer_5,Sara,,ES72209574622661518175,TRX_N-00844-56734361,2024-02-05T09:59:45,Donostia,expenses,internet,-42.0,45466.9
buyer_5,Sara,,ES72209574622661518175,TRX_N-00845-13332377,2024-02-06T15:25:27,Donostia,expenses,phone,-44.01,45422.89
buyer_5,Sara,,ES72209574622661518175,TRX_N-00846-58398712,2024-02-06T00:08:19,Donostia,expenses,cash,-100.0,45322.89
buyer_5,Sara,,ES72209574622661518175,TRX_N-00847-11966972,2024-02-06T20:57:49,Donostia,expenses,appliances,-392.87,44930.02
buyer_5,Sara,,ES72209574622661518175,TRX_N-00848-77239580,2024-02-07T09:24:05,Donostia,expenses,gas,-43.93,44886.09
buyer_5,Sara,,ES72209574622661518175,TRX_N-00849-20617863,2024-02-07T14:03:23,Donostia,expenses,food,-83.64,44802.45
buyer_5,Sara,,ES72209574622661518175,TRX_N-00850-99921117,2024-02-08T08:07:56,Donostia,expenses,electricity,-52.63,44749.82
buyer_5,Sara,,ES72209574622661518175,TRX_N-00851-60589095,2024-02-08T18:16:19,Portugalete,expenses,food,-69.47,44680.35
buyer_5,Sara,,ES72209574622661518175,TRX_N-00852-45899756,2024-02-08T09:25:16,Donostia,expenses,gifts,-702.3,43978.05
buyer_5,Sara,,ES72209574622661518175,TRX_N-00853-06066351,2024-02-14T22:44:30,Donostia,expenses,repairs,-218.58,43759.47
buyer_5,Sara,,ES72209574622661518175,TRX_N-00854-00891597,2024-02-15T20:30:05,Alegría-Dulantzi,expenses,transport,-73.27,43686.2
buyer_5,Sara,,ES72209574622661518175,TRX_N-00855-50854283,2024-02-16T12:55:15,Donostia,expenses,cash,-100.0,43586.2
buyer_5,Sara,,ES72209574622661518175,TRX_N-00856-85509292,2024-02-17T16:57:49,Donostia,expenses,food,-64.03,43522.17
buyer_5,Sara,,ES72209574622661518175,TRX_N-00857-14979862,2024-02-17T13:48:28,Donostia,expenses,cash,-100.0,43422.17
buyer_5,Sara,,ES72209574622661518175,TRX_N-00858-36613558,2024-02-17T02:59:11,Donostia,expenses,repairs,-227.64,43194.53
buyer_5,Sara,,ES72209574622661518175,TRX_N-00859-35613869,2024-02-17T14:46:54,Donostia,expenses,gifts,-216.15,42978.38
buyer_5,Sara,,ES72209574622661518175,TRX_N-00860-18585647,2024-02-18T10:45:54,Donostia,expenses,healthcare,-69.95,42908.43
buyer_5,Sara,,ES72209574622661518175,TRX_N-00861-60367000,2024-02-20T13:19:47,Donostia,expenses,food,-105.19,42803.24
buyer_5,Sara,,ES72209574622661518175,TRX_N-00862-76460124,2024-02-21T11:25:44,Donostia,expenses,cash,-100.0,42703.24
buyer_5,Sara,,ES72209574622661518175,TRX_N-00863-65055063,2024-02-26T13:05:29,Donostia,expenses,clothing,-100.36,42602.88
buyer_5,Sara,,ES72209574622661518175,TRX_N-00864-71073827,2024-02-28T12:13:16,Bermeo,expenses,leisure,-39.7,42563.18
buyer_5,Sara,,ES72209574622661518175,TRX_N-00865-22973971,2024-02-28T16:57:49,Donostia,expenses,gifts,-786.41,41776.77
buyer_5,Sara,,ES72209574622661518175,TRX_N-00866-25895911,2024-02-29T10:38:02,Donostia,expenses,cash,-100.0,41676.77
buyer_5,Sara,,ES72209574622661518175,TRX_N-00867-75108248,2024-03-01T09:21:52,Donostia,incomes,salary,2875.5,44552.27
buyer_5,Sara,,ES72209574622661518175,TRX_N-00868-58653149,2024-03-01T09:21:52,Donostia,incomes,salary_partner,2449.71,47001.98
buyer_5,Sara,,ES72209574622661518175,TRX_N-00869-15019582,2024-03-03T15:00:10,Sopela,expenses,repairs,-261.36,46740.62
buyer_5,Sara,,ES72209574622661518175,TRX_N-00870-47562576,2024-03-04T14:38:55,Donostia,expenses,mortgage,-814.56,45926.06
buyer_5,Sara,,ES72209574622661518175,TRX_N-00871-59218109,2024-03-04T19:42:24,Oyón-Oion,expenses,gifts,-281.41,45644.65
buyer_5,Sara,,ES72209574622661518175,TRX_N-00872-35478750,2024-03-06T17:00:16,Donostia,expenses,electricity,-28.4,45616.25
buyer_5,Sara,,ES72209574622661518175,TRX_N-00873-69616231,2024-03-06T17:25:34,Donostia,expenses,internet,-42.0,45574.25
buyer_5,Sara,,ES72209574622661518175,TRX_N-00874-25235665,2024-03-06T14:54:55,Donostia,expenses,food,-91.86,45482.39
buyer_5,Sara,,ES72209574622661518175,TRX_N-00875-67535527,2024-03-06T15:39:16,Hondarribia,expenses,leisure,-60.08,45422.31
buyer_5,Sara,,ES72209574622661518175,TRX_N-00876-96501231,2024-03-06T18:33:22,Donostia,expenses,cash,-100.0,45322.31
buyer_5,Sara,,ES72209574622661518175,TRX_N-00877-74835266,2024-03-06T14:12:37,Donostia,expenses,travel,-1371.95,43950.36
buyer_5,Sara,,ES72209574622661518175,TRX_N-00878-84374842,2024-03-07T17:41:28,Donostia,expenses,gas,-113.31,43837.05
buyer_5,Sara,,ES72209574622661518175,TRX_N-00879-56665679,2024-03-08T22:58:29,Donostia,expenses,water,-36.71,43800.34
buyer_5,Sara,,ES72209574622661518175,TRX_N-00880-43177426,2024-03-08T19:09:26,Donostia,expenses,phone,-35.78,43764.56
buyer_5,Sara,,ES72209574622661518175,TRX_N-00881-63046069,2024-03-08T12:13:27,Getxo,expenses,cash,-100.0,43664.56
buyer_5,Sara,,ES72209574622661518175,TRX_N-00882-09592624,2024-03-09T22:14:33,Donostia,expenses,appliances,-109.4,43555.16
buyer_5,Sara,,ES72209574622661518175,TRX_N-00883-76358815,2024-03-11T08:00:14,Salvatierra/Agurain,expenses,cash,-100.0,43455.16
buyer_5,Sara,,ES72209574622661518175,TRX_N-00884-23038071,2024-03-12T22:24:40,Donostia,expenses,healthcare,-186.93,43268.23
buyer_5,Sara,,ES72209574622661518175,TRX_N-00885-95077205,2024-03-13T15:58:49,Donostia,expenses,food,-74.47,43193.76
buyer_5,Sara,,ES72209574622661518175,TRX_N-00886-52487937,2024-03-13T20:58:27,Mungia,expenses,clothing,-129.72,43064.04
buyer_5,Sara,,ES72209574622661518175,TRX_N-00887-41523680,2024-03-14T19:16:26,Donostia,expenses,cash,-100.0,42964.04
buyer_5,Sara,,ES72209574622661518175,TRX_N-00888-92976902,2024-03-15T07:44:15,Donostia,expenses,transport,-51.21,42912.83
buyer_5,Sara,,ES72209574622661518175,TRX_N-00889-73612254,2024-03-15T18:41:50,Donostia,expenses,cash,-100.0,42812.83
buyer_5,Sara,,ES72209574622661518175,TRX_N-00890-99742732,2024-03-16T17:33:54,Errenteria,expenses,food,-88.77,42724.06
buyer_5,Sara,,ES72209574622661518175,TRX_N-00891-18436641,2024-03-16T14:49:47,Donostia,expenses,transport,-63.67,42660.39
buyer_5,Sara,,ES72209574622661518175,TRX_N-00892-26137012,2024-03-16T17:30:33,Donostia,expenses,repairs,-309.65,42350.74
buyer_5,Sara,,ES72209574622661518175,TRX_N-00893-76057729,2024-03-18T17:27:59,Donostia,expenses,transport,-53.5,42297.24
buyer_5,Sara,,ES72209574622661518175,TRX_N-00894-02343054,2024-03-20T20:04:35,Donostia,expenses,appliances,-355.42,41941.82
buyer_5,Sara,,ES72209574622661518175,TRX_N-00895-58033803,2024-03-21T21:05:00,Donostia,expenses,cash,-100.0,41841.82
buyer_5,Sara,,ES72209574622661518175,TRX_N-00896-96406296,2024-03-22T16:56:47,Donostia,expenses,food,-109.89,41731.93
buyer_5,Sara,,ES72209574622661518175,TRX_N-00897-68468043,2024-03-22T10:05:27,Elciego,expenses,cash,-100.0,41631.93
buyer_5,Sara,,ES72209574622661518175,TRX_N-00898-60488342,2024-03-23T16:58:29,Labastida,expenses,leisure,-73.51,41558.42
buyer_5,Sara,,ES72209574622661518175,TRX_N-00899-00585894,2024-03-24T06:36:09,Getxo,expenses,cash,-100.0,41458.42
buyer_5,Sara,,ES72209574622661518175,TRX_N-00900-20054882,2024-03-30T18:50:09,Donostia,expenses,healthcare,-133.91,41324.51
buyer_5,Sara,,ES72209574622661518175,TRX_N-00901-47926946,2024-03-30T22:56:10,Donostia,expenses,cash,-100.0,41224.51
buyer_5,Sara,,ES72209574622661518175,TRX_N-00902-94988004,2024-04-01T03:31:43,Donostia,incomes,salary,2875.5,44100.01
buyer_5,Sara,,ES72209574622661518175,TRX_N-00903-83974903,2024-04-01T03:31:43,Donostia,incomes,salary_partner,2449.71,46549.72
buyer_5,Sara,,ES72209574622661518175,TRX_N-00904-70778503,2024-04-01T03:31:43,Donostia,incomes,extra_income,303.94,46853.66
buyer_5,Sara,,ES72209574622661518175,TRX_N-00905-35815846,2024-04-02T10:22:53,Donostia,expenses,transport,-61.88,46791.78
buyer_5,Sara,,ES72209574622661518175,TRX_N-00906-86020812,2024-04-04T15:11:24,Donostia,expenses,mortgage,-814.56,45977.22
buyer_5,Sara,,ES72209574622661518175,TRX_N-00907-82341850,2024-04-05T20:35:20,Donostia,expenses,gas,-106.35,45870.87
buyer_5,Sara,,ES72209574622661518175,TRX_N-00908-65387664,2024-04-05T13:24:54,Donostia,expenses,internet,-42.0,45828.87
buyer_5,Sara,,ES72209574622661518175,TRX_N-00909-31674103,2024-04-06T17:31:41,Donostia,expenses,water,-34.58,45794.29
buyer_5,Sara,,ES72209574622661518175,TRX_N-00910-90953578,2024-04-06T12:03:44,Donostia,expenses,phone,-34.3,45759.99
buyer_5,Sara,,ES72209574622661518175,TRX_N-00911-05510849,2024-04-06T17:57:24,Donostia,expenses,healthcare,-132.93,45627.06
buyer_5,Sara,,ES72209574622661518175,TRX_N-00912-35918920,2024-04-07T12:50:22,Donostia,expenses,electricity,-44.49,45582.57
buyer_5,Sara,,ES72209574622661518175,TRX_N-00913-28796119,2024-04-07T15:26:13,Donostia,expenses,food,-79.89,45502.68
buyer_5,Sara,,ES72209574622661518175,TRX_N-00914-09719495,2024-04-08T13:32:14,Donostia,expenses,transport,-75.87,45426.81
buyer_5,Sara,,ES72209574622661518175,TRX_N-00915-16963532,2024-04-10T15:40:55,Donostia,expenses,food,-90.87,45335.94
buyer_5,Sara,,ES72209574622661518175,TRX_N-00916-59526909,2024-04-10T14:29:44,Donostia,expenses,transport,-42.29,45293.65
buyer_5,Sara,,ES72209574622661518175,TRX_N-00917-93671136,2024-04-10T11:39:12,Donostia,expenses,leisure,-45.26,45248.39
buyer_5,Sara,,ES72209574622661518175,TRX_N-00918-43606125,2024-04-10T12:55:20,Donostia,expenses,clothing,-62.38,45186.01
buyer_5,Sara,,ES72209574622661518175,TRX_N-00919-56247436,2024-04-11T15:59:57,Irun,expenses,leisure,-54.54,45131.47
buyer_5,Sara,,ES72209574622661518175,TRX_N-00920-95893503,2024-04-12T14:02:36,Leioa,expenses,cash,-100.0,45031.47
buyer_5,Sara,,ES72209574622661518175,TRX_N-00921-19788367,2024-04-12T17:39:13,Donostia,expenses,appliances,-109.59,44921.88
buyer_5,Sara,,ES72209574622661518175,TRX_N-00922-27005465,2024-04-13T16:55:53,Donostia,expenses,leisure,-35.17,44886.71
buyer_5,Sara,,ES72209574622661518175,TRX_N-00923-60248327,2024-04-14T08:38:24,Donostia,expenses,transport,-73.21,44813.5
buyer_5,Sara,,ES72209574622661518175,TRX_N-00924-18849231,2024-04-15T10:42:53,Bilbao,expenses,appliances,-132.7,44680.8
buyer_5,Sara,,ES72209574622661518175,TRX_N-00925-04476082,2024-04-17T07:02:07,Donostia,expenses,food,-107.32,44573.48
buyer_5,Sara,,ES72209574622661518175,TRX_N-00926-82356148,2024-04-19T09:46:36,Donostia,expenses,repairs,-117.48,44456.0
buyer_5,Sara,,ES72209574622661518175,TRX_N-00927-26528850,2024-04-19T16:01:17,Donostia,expenses,gifts,-377.92,44078.08
buyer_5,Sara,,ES72209574622661518175,TRX_N-00928-72610114,2024-04-25T18:10:16,Portugalete,expenses,food,-75.95,44002.13
buyer_5,Sara,,ES72209574622661518175,TRX_N-00929-34770523,2024-04-25T14:25:56,Donostia,expenses,transport,-54.96,43947.17
buyer_5,Sara,,ES72209574622661518175,TRX_N-00930-67143931,2024-04-25T17:50:51,Elciego,expenses,cash,-100.0,43847.17
buyer_5,Sara,,ES72209574622661518175,TRX_N-00931-69397894,2024-04-30T23:39:44,Donostia,expenses,leisure,-48.65,43798.52
buyer_5,Sara,,ES72209574622661518175,TRX_N-00932-27622367,2024-05-01T08:45:32,Donostia,incomes,salary,2875.5,46674.02
buyer_5,Sara,,ES72209574622661518175,TRX_N-00933-96235910,2024-05-01T08:45:32,Donostia,incomes,salary_partner,2449.71,49123.73
buyer_5,Sara,,ES72209574622661518175,TRX_N-00934-79031488,2024-05-01T13:25:22,Donostia,expenses,cash,-100.0,49023.73
buyer_5,Sara,,ES72209574622661518175,TRX_N-00935-83144974,2024-05-02T14:35:09,Labastida,expenses,transport,-46.45,48977.28
buyer_5,Sara,,ES72209574622661518175,TRX_N-00936-13027627,2024-05-02T18:54:39,Donostia,expenses,leisure,-21.03,48956.25
buyer_5,Sara,,ES72209574622661518175,TRX_N-00937-77907379,2024-05-02T09:27:49,Donostia,expenses,repairs,-183.58,48772.67
buyer_5,Sara,,ES72209574622661518175,TRX_N-00938-85344484,2024-05-03T17:59:15,Labastida,expenses,repairs,-148.61,48624.06
buyer_5,Sara,,ES72209574622661518175,TRX_N-00939-96797944,2024-05-04T06:26:06,Donostia,expenses,mortgage,-814.56,47809.5
buyer_5,Sara,,ES72209574622661518175,TRX_N-00940-78842524,2024-05-05T17:06:45,Donostia,expenses,water,-23.51,47785.99
buyer_5,Sara,,ES72209574622661518175,TRX_N-00941-76892668,2024-05-05T22:34:14,Donostia,expenses,electricity,-33.94,47752.05
buyer_5,Sara,,ES72209574622661518175,TRX_N-00942-78813301,2024-05-05T14:12:41,Donostia,expenses,phone,-37.53,47714.52
buyer_5,Sara,,ES72209574622661518175,TRX_N-00943-07143693,2024-05-05T08:27:50,Donostia,expenses,education,-57.41,47657.11
buyer_5,Sara,,ES72209574622661518175,TRX_N-00944-25978405,2024-05-05T16:37:49,Donostia,expenses,repairs,-72.64,47584.47
buyer_5,Sara,,ES72209574622661518175,TRX_N-00945-89325723,2024-05-05T19:05:17,Donostia,expenses,gifts,-546.4,47038.07
buyer_5,Sara,,ES72209574622661518175,TRX_N-00946-13337286,2024-05-06T14:02:25,Donostia,expenses,gas,-60.92,46977.15
buyer_5,Sara,,ES72209574622661518175,TRX_N-00947-44354933,2024-05-07T20:21:42,Donostia,expenses,internet,-42.0,46935.15
buyer_5,Sara,,ES72209574622661518175,TRX_N-00948-86925242,2024-05-08T10:52:01,Donostia,expenses,cash,-100.0,46835.15
buyer_5,Sara,,ES72209574622661518175,TRX_N-00949-46218436,2024-05-08T09:26:41,Erandio,expenses,repairs,-117.68,46717.47
buyer_5,Sara,,ES72209574622661518175,TRX_N-00950-91280741,2024-05-09T17:00:52,Donostia,expenses,gifts,-364.05,46353.42
buyer_5,Sara,,ES72209574622661518175,TRX_N-00951-61337657,2024-05-11T04:04:02,Donostia,expenses,travel,-873.59,45479.83
buyer_5,Sara,,ES72209574622661518175,TRX_N-00952-20731759,2024-05-12T19:10:23,Salvatierra/Agurain,expenses,food,-106.93,45372.9
buyer_5,Sara,,ES72209574622661518175,TRX_N-00953-50063019,2024-05-12T10:02:09,Donostia,expenses,transport,-68.41,45304.49
buyer_5,Sara,,ES72209574622661518175,TRX_N-00954-64236648,2024-05-13T08:06:56,Donostia,expenses,food,-73.2,45231.29
buyer_5,Sara,,ES72209574622661518175,TRX_N-00955-73179655,2024-05-17T20:43:35,Donostia,expenses,leisure,-68.03,45163.26
buyer_5,Sara,,ES72209574622661518175,TRX_N-00956-85420108,2024-05-19T01:56:00,Donostia,expenses,leisure,-38.49,45124.77
buyer_5,Sara,,ES72209574622661518175,TRX_N-00957-08742593,2024-05-22T12:21:49,Donostia,expenses,transport,-80.73,45044.04
buyer_5,Sara,,ES72209574622661518175,TRX_N-00958-38205681,2024-05-22T10:47:26,Donostia,expenses,leisure,-77.96,44966.08
buyer_5,Sara,,ES72209574622661518175,TRX_N-00959-08495200,2024-05-26T11:26:55,Donostia,expenses,cash,-100.0,44866.08
buyer_5,Sara,,ES72209574622661518175,TRX_N-00960-03796542,2024-05-27T12:38:44,Donostia,expenses,transport,-45.11,44820.97
buyer_5,Sara,,ES72209574622661518175,TRX_N-00961-11371697,2024-05-27T07:44:25,Donostia,expenses,leisure,-23.06,44797.91
buyer_5,Sara,,ES72209574622661518175,TRX_N-00962-31361060,2024-05-28T17:14:50,Donostia,expenses,transport,-88.84,44709.07
buyer_5,Sara,,ES72209574622661518175,TRX_N-00963-49378709,2024-05-28T09:07:01,Barakaldo,expenses,gifts,-771.54,43937.53
buyer_5,Sara,,ES72209574622661518175,TRX_N-00964-73073192,2024-05-29T13:15:13,Donostia,expenses,repairs,-270.88,43666.65
buyer_5,Sara,,ES72209574622661518175,TRX_N-00965-08156890,2024-05-30T08:46:59,Donostia,expenses,education,-66.87,43599.78
buyer_5,Sara,,ES72209574622661518175,TRX_N-00966-86117296,2024-05-31T10:04:32,Donostia,expenses,gifts,-380.54,43219.24
buyer_5,Sara,,ES72209574622661518175,TRX_N-00967-47269794,2024-06-01T09:24:55,Donostia,incomes,salary,2875.5,46094.74
buyer_5,Sara,,ES72209574622661518175,TRX_N-00968-49833490,2024-06-01T09:24:55,Donostia,incomes,salary_partner,2449.71,48544.45
buyer_5,Sara,,ES72209574622661518175,TRX_N-00969-55165570,2024-06-01T09:24:55,Donostia,incomes,salary_bonus,2226.72,50771.17
buyer_5,Sara,,ES72209574622661518175,TRX_N-00970-34441274,2024-06-01T09:24:55,Donostia,incomes,salary_partner_bonus,1831.36,52602.53
buyer_5,Sara,,ES72209574622661518175,TRX_N-00971-04022431,2024-06-03T18:57:21,Donostia,expenses,food,-108.37,52494.16
buyer_5,Sara,,ES72209574622661518175,TRX_N-00972-79413232,2024-06-03T11:20:31,Donostia,expenses,gifts,-510.71,51983.45
buyer_5,Sara,,ES72209574622661518175,TRX_N-00973-01080182,2024-06-04T17:42:09,Donostia,expenses,mortgage,-814.56,51168.89
buyer_5,Sara,,ES72209574622661518175,TRX_N-00974-50314517,2024-06-04T17:59:15,Labastida,expenses,food,-78.69,51090.2
buyer_5,Sara,,ES72209574622661518175,TRX_N-00975-86807572,2024-06-04T11:00:07,Donostia,expenses,clothing,-48.57,51041.63
buyer_5,Sara,,ES72209574622661518175,TRX_N-00976-37590880,2024-06-05T17:41:35,Donostia,expenses,food,-65.91,50975.72
buyer_5,Sara,,ES72209574622661518175,TRX_N-00977-28826487,2024-06-05T12:07:45,Donostia,expenses,education,-61.4,50914.32
buyer_5,Sara,,ES72209574622661518175,TRX_N-00978-62801001,2024-06-05T16:56:17,Donostia,expenses,cash,-100.0,50814.32
buyer_5,Sara,,ES72209574622661518175,TRX_N-00979-03311542,2024-06-06T17:16:16,Donostia,expenses,gas,-68.53,50745.79
buyer_5,Sara,,ES72209574622661518175,TRX_N-00980-74890336,2024-06-06T13:52:47,Donostia,expenses,internet,-42.0,50703.79
buyer_5,Sara,,ES72209574622661518175,TRX_N-00981-02554705,2024-06-07T12:18:02,Donostia,expenses,water,-31.08,50672.71
buyer_5,Sara,,ES72209574622661518175,TRX_N-00982-43279707,2024-06-08T13:58:49,Donostia,expenses,phone,-39.09,50633.62
buyer_5,Sara,,ES72209574622661518175,TRX_N-00983-86558434,2024-06-08T13:29:41,Donostia,expenses,electricity,-60.41,50573.21
buyer_5,Sara,,ES72209574622661518175,TRX_N-00984-45617749,2024-06-09T14:32:23,Donostia,expenses,appliances,-153.4,50419.81
buyer_5,Sara,,ES72209574622661518175,TRX_N-00985-91256187,2024-06-11T16:51:46,Donostia,expenses,repairs,-182.04,50237.77
buyer_5,Sara,,ES72209574622661518175,TRX_N-00986-09002780,2024-06-14T13:15:58,Donostia,expenses,cash,-100.0,50137.77
buyer_5,Sara,,ES72209574622661518175,TRX_N-00987-53465816,2024-06-16T12:23:58,Donostia,expenses,transport,-78.39,50059.38
buyer_5,Sara,,ES72209574622661518175,TRX_N-00988-63383219,2024-06-16T14:08:14,Donostia,expenses,gifts,-573.64,49485.74
buyer_5,Sara,,ES72209574622661518175,TRX_N-00989-84325335,2024-06-17T12:31:28,Donostia,expenses,food,-122.05,49363.69
buyer_5,Sara,,ES72209574622661518175,TRX_N-00990-67242871,2024-06-18T09:13:11,Donostia,expenses,transport,-46.92,49316.77
buyer_5,Sara,,ES72209574622661518175,TRX_N-00991-10293271,2024-06-18T15:47:46,Donostia,expenses,leisure,-54.79,49261.98
buyer_5,Sara,,ES72209574622661518175,TRX_N-00992-94171376,2024-06-20T17:39:09,Donostia,expenses,gifts,-791.7,48470.28
buyer_5,Sara,,ES72209574622661518175,TRX_N-00993-94214773,2024-06-23T20:56:51,Donostia,expenses,food,-77.74,48392.54
buyer_5,Sara,,ES72209574622661518175,TRX_N-00994-57295473,2024-06-26T14:44:44,Donostia,expenses,food,-98.16,48294.38
buyer_5,Sara,,ES72209574622661518175,TRX_N-00995-49031928,2024-06-26T13:41:57,Donostia,expenses,cash,-100.0,48194.38
buyer_5,Sara,,ES72209574622661518175,TRX_N-00996-75606673,2024-06-28T14:23:49,Sopela,expenses,leisure,-42.43,48151.95
buyer_5,Sara,,ES72209574622661518175,TRX_N-00997-61534836,2024-06-28T21:23:06,Durango,expenses,cash,-100.0,48051.95
buyer_5,Sara,,ES72209574622661518175,TRX_N-00998-20910222,2024-06-29T22:13:24,Donostia,expenses,food,-120.43,47931.52
buyer_5,Sara,,ES72209574622661518175,TRX_N-00999-37979462,2024-07-01T23:04:19,Donostia,incomes,salary,2875.5,50807.02
buyer_5,Sara,,ES72209574622661518175,TRX_N-01000-39169688,2024-07-01T23:04:19,Donostia,incomes,salary_partner,2449.71,53256.73
buyer_5,Sara,,ES72209574622661518175,TRX_N-01001-38449004,2024-07-01T23:04:19,Donostia,incomes,extra_income,303.94,53560.67
buyer_5,Sara,,ES72209574622661518175,TRX_N-01002-70496721,2024-07-01T14:26:41,Donostia,expenses,transport,-45.58,53515.09
buyer_5,Sara,,ES72209574622661518175,TRX_N-01003-43625034,2024-07-02T13:46:13,Donostia,expenses,food,-104.56,53410.53
buyer_5,Sara,,ES72209574622661518175,TRX_N-01004-38571939,2024-07-02T08:39:34,Leioa,expenses,transport,-80.98,53329.55
buyer_5,Sara,,ES72209574622661518175,TRX_N-01005-52053971,2024-07-03T23:54:28,Pasaia,expenses,food,-67.19,53262.36
buyer_5,Sara,,ES72209574622661518175,TRX_N-01006-62308218,2024-07-04T18:15:57,Donostia,expenses,mortgage,-814.56,52447.8
buyer_5,Sara,,ES72209574622661518175,TRX_N-01007-06398926,2024-07-05T20:35:25,Donostia,expenses,electricity,-86.58,52361.22
buyer_5,Sara,,ES72209574622661518175,TRX_N-01008-85026486,2024-07-05T19:19:36,Donostia,expenses,gas,-51.66,52309.56
buyer_5,Sara,,ES72209574622661518175,TRX_N-01009-04565261,2024-07-05T23:16:10,Donostia,expenses,food,-80.86,52228.7
buyer_5,Sara,,ES72209574622661518175,TRX_N-01010-73534619,2024-07-05T19:30:47,Donostia,expenses,clothing,-102.6,52126.1
buyer_5,Sara,,ES72209574622661518175,TRX_N-01011-08657513,2024-07-07T17:50:35,Donostia,expenses,water,-30.77,52095.33
buyer_5,Sara,,ES72209574622661518175,TRX_N-01012-20068190,2024-07-07T11:39:38,Donostia,expenses,clothing,-127.77,51967.56
buyer_5,Sara,,ES72209574622661518175,TRX_N-01013-72815000,2024-07-07T13:46:24,Donostia,expenses,cash,-100.0,51867.56
buyer_5,Sara,,ES72209574622661518175,TRX_N-01014-66966418,2024-07-07T20:01:57,Donostia,expenses,gifts,-707.1,51160.46
buyer_5,Sara,,ES72209574622661518175,TRX_N-01015-37100003,2024-07-08T16:42:35,Donostia,expenses,internet,-42.0,51118.46
buyer_5,Sara,,ES72209574622661518175,TRX_N-01016-19767057,2024-07-08T08:50:40,Donostia,expenses,phone,-33.39,51085.07
buyer_5,Sara,,ES72209574622661518175,TRX_N-01017-24823716,2024-07-11T14:37:43,Donostia,expenses,transport,-54.3,51030.77
buyer_5,Sara,,ES72209574622661518175,TRX_N-01018-58432341,2024-07-13T18:02:19,Durango,expenses,transport,-87.64,50943.13
buyer_5,Sara,,ES72209574622661518175,TRX_N-01019-51575987,2024-07-13T00:52:33,Donostia,expenses,clothing,-153.46,50789.67
buyer_5,Sara,,ES72209574622661518175,TRX_N-01020-95680509,2024-07-19T19:38:29,Donostia,expenses,transport,-47.48,50742.19
buyer_5,Sara,,ES72209574622661518175,TRX_N-01021-79397731,2024-07-19T19:02:47,Donostia,expenses,clothing,-74.96,50667.23
buyer_5,Sara,,ES72209574622661518175,TRX_N-01022-72800347,2024-07-20T15:51:27,Donostia,expenses,clothing,-148.36,50518.87
buyer_5,Sara,,ES72209574622661518175,TRX_N-01023-97909469,2024-07-21T11:20:08,Donostia,expenses,cash,-100.0,50418.87
buyer_5,Sara,,ES72209574622661518175,TRX_N-01024-73571234,2024-07-23T19:12:40,Donostia,expenses,cash,-100.0,50318.87
buyer_5,Sara,,ES72209574622661518175,TRX_N-01025-86857082,2024-07-24T18:31:08,Donostia,expenses,cash,-100.0,50218.87
buyer_5,Sara,,ES72209574622661518175,TRX_N-01026-70673522,2024-07-30T11:55:04,Donostia,expenses,transport,-56.79,50162.08
buyer_5,Sara,,ES72209574622661518175,TRX_N-01027-51369149,2024-07-30T12:40:41,Donostia,expenses,repairs,-131.55,50030.53
buyer_5,Sara,,ES72209574622661518175,TRX_N-01028-41991200,2024-07-30T23:24:50,Donostia,expenses,gifts,-678.94,49351.59
buyer_5,Sara,,ES72209574622661518175,TRX_N-01029-81198643,2024-08-01T17:05:38,Donostia,incomes,salary,2875.5,52227.09
buyer_5,Sara,,ES72209574622661518175,TRX_N-01030-30291533,2024-08-01T17:05:38,Donostia,incomes,salary_partner,2449.71,54676.8
buyer_5,Sara,,ES72209574622661518175,TRX_N-01031-21371206,2024-08-02T17:26:46,Donostia,expenses,gifts,-131.45,54545.35
buyer_5,Sara,,ES72209574622661518175,TRX_N-01032-56392386,2024-08-04T02:59:35,Donostia,expenses,mortgage,-814.56,53730.79
buyer_5,Sara,,ES72209574622661518175,TRX_N-01033-37422255,2024-08-04T09:11:02,Donostia,expenses,healthcare,-51.46,53679.33
buyer_5,Sara,,ES72209574622661518175,TRX_N-01034-00666763,2024-08-04T16:41:10,Galdakao,expenses,repairs,-299.22,53380.11
buyer_5,Sara,,ES72209574622661518175,TRX_N-01035-41352871,2024-08-05T13:20:43,Donostia,expenses,water,-21.29,53358.82
buyer_5,Sara,,ES72209574622661518175,TRX_N-01036-68982698,2024-08-05T22:44:51,Donostia,expenses,leisure,-82.86,53275.96
buyer_5,Sara,,ES72209574622661518175,TRX_N-01037-18636063,2024-08-06T16:33:02,Donostia,expenses,gas,-83.22,53192.74
buyer_5,Sara,,ES72209574622661518175,TRX_N-01038-91366208,2024-08-08T18:38:11,Donostia,expenses,electricity,-88.79,53103.95
buyer_5,Sara,,ES72209574622661518175,TRX_N-01039-93537568,2024-08-08T15:19:02,Donostia,expenses,internet,-42.0,53061.95
buyer_5,Sara,,ES72209574622661518175,TRX_N-01040-83920574,2024-08-08T08:00:04,Donostia,expenses,phone,-40.02,53021.93
buyer_5,Sara,,ES72209574622661518175,TRX_N-01041-99511995,2024-08-08T07:36:51,Donostia,expenses,gifts,-767.14,52254.79
buyer_5,Sara,,ES72209574622661518175,TRX_N-01042-02668473,2024-08-09T18:48:50,Donostia,expenses,transport,-63.91,52190.88
buyer_5,Sara,,ES72209574622661518175,TRX_N-01043-10892915,2024-08-10T17:39:46,Donostia,expenses,healthcare,-173.7,52017.18
buyer_5,Sara,,ES72209574622661518175,TRX_N-01044-70006585,2024-08-10T13:21:53,Donostia,expenses,repairs,-119.23,51897.95
buyer_5,Sara,,ES72209574622661518175,TRX_N-01045-81206468,2024-08-11T23:11:52,Donostia,expenses,leisure,-20.03,51877.92
buyer_5,Sara,,ES72209574622661518175,TRX_N-01046-94916457,2024-08-11T18:52:05,Donostia,expenses,appliances,-122.88,51755.04
buyer_5,Sara,,ES72209574622661518175,TRX_N-01047-42654833,2024-08-12T21:25:34,Donostia,expenses,food,-83.6,51671.44
buyer_5,Sara,,ES72209574622661518175,TRX_N-01048-52327451,2024-08-12T13:52:28,Donostia,expenses,transport,-49.04,51622.4
buyer_5,Sara,,ES72209574622661518175,TRX_N-01049-19453877,2024-08-12T11:28:39,Donostia,expenses,gifts,-569.28,51053.12
buyer_5,Sara,,ES72209574622661518175,TRX_N-01050-66172773,2024-08-13T05:17:51,Donostia,expenses,cash,-100.0,50953.12
buyer_5,Sara,,ES72209574622661518175,TRX_N-01051-83614459,2024-08-14T09:26:45,Donostia,expenses,cash,-100.0,50853.12
buyer_5,Sara,,ES72209574622661518175,TRX_N-01052-62193417,2024-08-15T10:41:15,Donostia,expenses,transport,-73.06,50780.06
buyer_5,Sara,,ES72209574622661518175,TRX_N-01053-91983457,2024-08-16T09:00:45,Donostia,expenses,gifts,-661.45,50118.61
buyer_5,Sara,,ES72209574622661518175,TRX_N-01054-44085642,2024-08-18T11:39:14,Donostia,expenses,leisure,-54.77,50063.84
buyer_5,Sara,,ES72209574622661518175,TRX_N-01055-77340560,2024-08-19T10:01:55,Donostia,expenses,transport,-79.97,49983.87
buyer_5,Sara,,ES72209574622661518175,TRX_N-01056-21576051,2024-08-19T11:40:43,Amurrio,expenses,gifts,-846.82,49137.05
buyer_5,Sara,,ES72209574622661518175,TRX_N-01057-83070727,2024-08-24T18:25:04,Donostia,expenses,food,-98.22,49038.83
buyer_5,Sara,,ES72209574622661518175,TRX_N-01058-85370290,2024-08-24T18:38:09,Alegría-Dulantzi,expenses,cash,-100.0,48938.83
buyer_5,Sara,,ES72209574622661518175,TRX_N-01059-32461828,2024-08-25T18:44:03,Sestao,expenses,transport,-72.41,48866.42
buyer_5,Sara,,ES72209574622661518175,TRX_N-01060-96108603,2024-08-27T18:28:02,Donostia,expenses,education,-56.26,48810.16
buyer_5,Sara,,ES72209574622661518175,TRX_N-01061-99713197,2024-08-28T11:51:56,Donostia,expenses,food,-110.51,48699.65
buyer_5,Sara,,ES72209574622661518175,TRX_N-01062-43401071,2024-08-28T12:07:26,Donostia,expenses,repairs,-329.59,48370.06
buyer_5,Sara,,ES72209574622661518175,TRX_N-01063-12079585,2024-08-29T05:21:21,Donostia,expenses,clothing,-146.99,48223.07
buyer_5,Sara,,ES72209574622661518175,TRX_N-01064-68777343,2024-09-01T15:10:33,Donostia,incomes,salary,2875.5,51098.57
buyer_5,Sara,,ES72209574622661518175,TRX_N-01065-97313138,2024-09-01T15:10:33,Donostia,incomes,salary_partner,2449.71,53548.28
buyer_5,Sara,,ES72209574622661518175,TRX_N-01066-92099673,2024-09-02T10:18:56,Donostia,expenses,food,-91.91,53456.37
buyer_5,Sara,,ES72209574622661518175,TRX_N-01067-31333699,2024-09-02T09:33:45,Donostia,expenses,gifts,-492.24,52964.13
buyer_5,Sara,,ES72209574622661518175,TRX_N-01068-13635450,2024-09-03T10:57:29,Donostia,expenses,food,-120.38,52843.75
buyer_5,Sara,,ES72209574622661518175,TRX_N-01069-07589246,2024-09-03T13:22:19,Donostia,expenses,cash,-100.0,52743.75
buyer_5,Sara,,ES72209574622661518175,TRX_N-01070-45603187,2024-09-04T15:29:48,Donostia,expenses,mortgage,-814.56,51929.19
buyer_5,Sara,,ES72209574622661518175,TRX_N-01071-98198377,2024-09-04T22:05:06,Donostia,expenses,education,-62.02,51867.17
buyer_5,Sara,,ES72209574622661518175,TRX_N-01072-50596030,2024-09-05T10:33:17,Donostia,expenses,internet,-42.0,51825.17
buyer_5,Sara,,ES72209574622661518175,TRX_N-01073-04029660,2024-09-05T01:15:18,Donostia,expenses,food,-78.25,51746.92
buyer_5,Sara,,ES72209574622661518175,TRX_N-01074-45075478,2024-09-06T11:12:55,Donostia,expenses,water,-40.51,51706.41
buyer_5,Sara,,ES72209574622661518175,TRX_N-01075-73996084,2024-09-07T08:38:21,Donostia,expenses,electricity,-45.27,51661.14
buyer_5,Sara,,ES72209574622661518175,TRX_N-01076-64771454,2024-09-08T10:17:21,Donostia,expenses,gas,-113.07,51548.07
buyer_5,Sara,,ES72209574622661518175,TRX_N-01077-52353871,2024-09-08T15:47:51,Donostia,expenses,phone,-31.3,51516.77
buyer_5,Sara,,ES72209574622661518175,TRX_N-01078-94419991,2024-09-11T14:06:51,Donostia,expenses,food,-111.36,51405.41
buyer_5,Sara,,ES72209574622661518175,TRX_N-01079-16567752,2024-09-13T11:03:27,Donostia,expenses,transport,-79.99,51325.42
buyer_5,Sara,,ES72209574622661518175,TRX_N-01080-20709372,2024-09-15T17:03:15,Santurtzi,expenses,food,-73.65,51251.77
buyer_5,Sara,,ES72209574622661518175,TRX_N-01081-80172184,2024-09-15T11:19:04,Donostia,expenses,transport,-68.94,51182.83
buyer_5,Sara,,ES72209574622661518175,TRX_N-01082-00303703,2024-09-15T20:35:08,Pasaia,expenses,travel,-1299.04,49883.79
buyer_5,Sara,,ES72209574622661518175,TRX_N-01083-45323302,2024-09-16T19:55:07,Donostia,expenses,food,-63.12,49820.67
buyer_5,Sara,,ES72209574622661518175,TRX_N-01084-18228827,2024-09-17T17:13:39,Donostia,expenses,transport,-58.12,49762.55
buyer_5,Sara,,ES72209574622661518175,TRX_N-01085-34580460,2024-09-19T17:35:54,Donostia,expenses,repairs,-314.04,49448.51
buyer_5,Sara,,ES72209574622661518175,TRX_N-01086-60033928,2024-09-20T13:17:45,Donostia,expenses,transport,-47.81,49400.7
buyer_5,Sara,,ES72209574622661518175,TRX_N-01087-02752356,2024-09-21T08:20:36,Donostia,expenses,cash,-100.0,49300.7
buyer_5,Sara,,ES72209574622661518175,TRX_N-01088-53207850,2024-09-23T17:47:26,Donostia,expenses,cash,-100.0,49200.7
buyer_5,Sara,,ES72209574622661518175,TRX_N-01089-01195638,2024-09-24T20:04:17,Donostia,expenses,food,-65.05,49135.65
buyer_5,Sara,,ES72209574622661518175,TRX_N-01090-53430834,2024-09-25T08:01:17,Donostia,expenses,food,-61.51,49074.14
buyer_5,Sara,,ES72209574622661518175,TRX_N-01091-00928494,2024-09-25T10:14:02,Donostia,expenses,education,-74.53,48999.61
buyer_5,Sara,,ES72209574622661518175,TRX_N-01092-77218789,2024-09-27T09:38:28,Donostia,expenses,leisure,-26.41,48973.2
buyer_5,Sara,,ES72209574622661518175,TRX_N-01093-62575198,2024-09-27T18:02:24,Donostia,expenses,appliances,-175.08,48798.12
buyer_5,Sara,,ES72209574622661518175,TRX_N-01094-55322940,2024-09-29T21:07:48,Donostia,expenses,appliances,-405.35,48392.77
buyer_5,Sara,,ES72209574622661518175,TRX_N-01095-61060804,2024-09-30T19:03:16,Donostia,expenses,cash,-100.0,48292.77
buyer_5,Sara,,ES72209574622661518175,TRX_N-01096-33407963,2024-10-01T14:30:18,Donostia,incomes,salary,2875.5,51168.27
buyer_5,Sara,,ES72209574622661518175,TRX_N-01097-93392982,2024-10-01T14:30:18,Donostia,incomes,salary_partner,2449.71,53617.98
buyer_5,Sara,,ES72209574622661518175,TRX_N-01098-81484159,2024-10-01T14:30:18,Donostia,incomes,extra_income,303.94,53921.92
buyer_5,Sara,,ES72209574622661518175,TRX_N-01099-44974078,2024-10-02T11:43:46,Donostia,expenses,gifts,-498.12,53423.8
buyer_5,Sara,,ES72209574622661518175,TRX_N-01100-78794278,2024-10-03T23:03:07,Donostia,expenses,leisure,-38.82,53384.98
buyer_5,Sara,,ES72209574622661518175,TRX_N-01101-22233605,2024-10-03T15:52:50,Zuia,expenses,cash,-100.0,53284.98
buyer_5,Sara,,ES72209574622661518175,TRX_N-01102-13001613,2024-10-03T13:48:27,Donostia,expenses,travel,-670.17,52614.81
buyer_5,Sara,,ES72209574622661518175,TRX_N-01103-18502498,2024-10-04T09:06:43,Donostia,expenses,mortgage,-814.56,51800.25
buyer_5,Sara,,ES72209574622661518175,TRX_N-01104-64975161,2024-10-04T14:04:14,Donostia,expenses,food,-103.72,51696.53
buyer_5,Sara,,ES72209574622661518175,TRX_N-01105-63076836,2024-10-05T11:04:56,Donostia,expenses,electricity,-66.48,51630.05
buyer_5,Sara,,ES72209574622661518175,TRX_N-01106-60437486,2024-10-05T19:02:21,Donostia,expenses,cash,-100.0,51530.05
buyer_5,Sara,,ES72209574622661518175,TRX_N-01107-36413440,2024-10-05T15:47:59,Donostia,expenses,repairs,-213.52,51316.53
buyer_5,Sara,,ES72209574622661518175,TRX_N-01108-83306150,2024-10-06T08:08:13,Donostia,expenses,phone,-32.66,51283.87
buyer_5,Sara,,ES72209574622661518175,TRX_N-01109-30554319,2024-10-07T12:29:24,Donostia,expenses,cash,-100.0,51183.87
buyer_5,Sara,,ES72209574622661518175,TRX_N-01110-28891848,2024-10-08T07:39:08,Donostia,expenses,gas,-74.5,51109.37
buyer_5,Sara,,ES72209574622661518175,TRX_N-01111-78201961,2024-10-08T08:40:25,Donostia,expenses,water,-31.61,51077.76
buyer_5,Sara,,ES72209574622661518175,TRX_N-01112-43261770,2024-10-08T15:06:57,Donostia,expenses,internet,-42.0,51035.76
buyer_5,Sara,,ES72209574622661518175,TRX_N-01113-50262240,2024-10-08T10:06:35,Oyón-Oion,expenses,food,-72.03,50963.73
buyer_5,Sara,,ES72209574622661518175,TRX_N-01114-26144020,2024-10-09T10:47:57,Hernani,expenses,transport,-77.43,50886.3
buyer_6,Manuel,,ES74209567901087476583,TRX_N-00001-36630056,2022-01-01T15:33:54,Vitoria-Gasteiz,incomes,salary,1370.54,3128.26
buyer_6,Manuel,,ES74209567901087476583,TRX_N-00002-21769861,2022-01-01T18:17:22,Vitoria-Gasteiz,expenses,transport,-83.3,3044.96
buyer_6,Manuel,,ES74209567901087476583,TRX_N-00003-76530981,2022-01-01T12:09:10,Vitoria-Gasteiz,expenses,travel,-846.51,2198.45
buyer_6,Manuel,,ES74209567901087476583,TRX_N-00004-34526340,2022-01-02T09:33:17,Vitoria-Gasteiz,expenses,education,-54.37,2144.08
buyer_6,Manuel,,ES74209567901087476583,TRX_N-00005-76612363,2022-01-02T16:29:49,Vitoria-Gasteiz,expenses,repairs,-233.05,1911.03
buyer_6,Manuel,,ES74209567901087476583,TRX_N-00006-53546908,2022-01-03T04:44:55,Vitoria-Gasteiz,expenses,education,-72.58,1838.45
buyer_6,Manuel,,ES74209567901087476583,TRX_N-00007-59548174,2022-01-03T22:37:55,Vitoria-Gasteiz,expenses,repairs,-85.62,1752.83
buyer_6,Manuel,,ES74209567901087476583,TRX_N-00008-20304729,2022-01-04T00:33:16,Vitoria-Gasteiz,expenses,mortgage,-879.67,873.16
buyer_6,Manuel,,ES74209567901087476583,TRX_N-00009-69308708,2022-01-05T14:53:04,Vitoria-Gasteiz,expenses,electricity,-49.73,823.43
buyer_6,Manuel,,ES74209567901087476583,TRX_N-00010-27212441,2022-01-06T20:20:02,Vitoria-Gasteiz,expenses,water,-34.16,789.27
buyer_6,Manuel,,ES74209567901087476583,TRX_N-00011-52597407,2022-01-06T21:12:43,Vitoria-Gasteiz,expenses,internet,-42.0,747.27
buyer_6,Manuel,,ES74209567901087476583,TRX_N-00012-42607889,2022-01-06T02:58:02,Vitoria-Gasteiz,expenses,phone,-39.89,707.38
buyer_6,Manuel,,ES74209567901087476583,TRX_N-00013-90516803,2022-01-06T03:15:08,Vitoria-Gasteiz,expenses,transport,-69.58,637.8
buyer_6,Manuel,,ES74209567901087476583,TRX_N-00014-16763073,2022-01-06T00:28:23,Vitoria-Gasteiz,expenses,leisure,-31.75,606.05
buyer_6,Manuel,,ES74209567901087476583,TRX_N-00015-36833205,2022-01-07T16:00:19,Vitoria-Gasteiz,expenses,appliances,-320.95,285.1
buyer_6,Manuel,,ES74209567901087476583,TRX_N-00016-51704030,2022-01-07T11:14:35,Bermeo,expenses,repairs,-74.38,210.72
buyer_6,Manuel,,ES74209567901087476583,TRX_N-00017-13672708,2022-01-08T05:30:23,Vitoria-Gasteiz,expenses,gas,-111.88,98.84
buyer_6,Manuel,,ES74209567901087476583,TRX_N-00018-36500460,2022-01-10T10:07:33,Vitoria-Gasteiz,expenses,cash,-100.0,-1.16
buyer_6,Manuel,,ES74209567901087476583,TRX_N-00019-51736659,2022-01-11T11:01:08,Amurrio,expenses,repairs,-113.39,-114.55
buyer_6,Manuel,,ES74209567901087476583,TRX_N-00020-81366774,2022-01-16T06:50:38,Vitoria-Gasteiz,expenses,cash,-100.0,-214.55
buyer_6,Manuel,,ES74209567901087476583,TRX_N-00021-56688011,2022-01-17T18:53:18,Vitoria-Gasteiz,expenses,repairs,-128.7,-343.25
buyer_6,Manuel,,ES74209567901087476583,TRX_N-00022-50462541,2022-01-18T16:00:43,Vitoria-Gasteiz,expenses,food,-94.43,-437.68
buyer_6,Manuel,,ES74209567901087476583,TRX_N-00023-44806427,2022-01-18T14:46:21,Vitoria-Gasteiz,expenses,transport,-86.45,-524.13
buyer_6,Manuel,,ES74209567901087476583,TRX_N-00024-13268854,2022-01-18T20:29:30,Vitoria-Gasteiz,expenses,cash,-100.0,-624.13
buyer_6,Manuel,,ES74209567901087476583,TRX_N-00025-42047782,2022-01-19T08:08:41,Vitoria-Gasteiz,expenses,food,-80.42,-704.55
buyer_6,Manuel,,ES74209567901087476583,TRX_N-00026-70225313,2022-01-20T18:51:15,Irun,expenses,transport,-54.68,-759.23
buyer_6,Manuel,,ES74209567901087476583,TRX_N-00027-35731325,2022-01-22T14:13:38,Pasaia,expenses,food,-124.62,-883.85
buyer_6,Manuel,,ES74209567901087476583,TRX_N-00028-43051075,2022-01-24T11:54:02,Vitoria-Gasteiz,expenses,cash,-100.0,-983.85
buyer_6,Manuel,,ES74209567901087476583,TRX_N-00029-63096890,2022-01-26T12:58:08,Vitoria-Gasteiz,expenses,clothing,-129.91,-1113.76
buyer_6,Manuel,,ES74209567901087476583,TRX_N-00030-05459982,2022-01-28T23:29:47,Vitoria-Gasteiz,expenses,food,-88.07,-1201.83
buyer_6,Manuel,,ES74209567901087476583,TRX_N-00031-38661481,2022-01-28T12:01:06,Vitoria-Gasteiz,expenses,leisure,-65.09,-1266.92
buyer_6,Manuel,,ES74209567901087476583,TRX_N-00032-07709685,2022-01-29T12:22:26,Vitoria-Gasteiz,expenses,gifts,-486.69,-1753.61
buyer_6,Manuel,,ES74209567901087476583,TRX_N-00033-48397949,2022-01-30T20:05:07,Vitoria-Gasteiz,expenses,food,-76.95,-1830.56
buyer_6,Manuel,,ES74209567901087476583,TRX_N-00034-53694457,2022-01-30T18:23:04,Vitoria-Gasteiz,expenses,transport,-82.56,-1913.12
buyer_6,Manuel,,ES74209567901087476583,TRX_N-00035-97752844,2022-01-31T22:29:26,Vitoria-Gasteiz,expenses,education,-68.19,-1981.31
buyer_6,Manuel,,ES74209567901087476583,TRX_N-00036-09686786,2022-02-01T19:50:06,Vitoria-Gasteiz,incomes,salary,1370.54,-610.77
buyer_6,Manuel,,ES74209567901087476583,TRX_N-00037-61891564,2022-02-03T12:35:01,Vitoria-Gasteiz,expenses,food,-60.01,-670.78
buyer_6,Manuel,,ES74209567901087476583,TRX_N-00038-97685005,2022-02-03T09:56:43,Vitoria-Gasteiz,expenses,leisure,-39.83,-710.61
buyer_6,Manuel,,ES74209567901087476583,TRX_N-00039-78333769,2022-02-04T16:24:40,Vitoria-Gasteiz,expenses,mortgage,-879.67,-1590.28
buyer_6,Manuel,,ES74209567901087476583,TRX_N-00040-89903820,2022-02-06T15:38:39,Vitoria-Gasteiz,expenses,food,-81.11,-1671.39
buyer_6,Manuel,,ES74209567901087476583,TRX_N-00041-20558399,2022-02-06T19:41:22,Vitoria-Gasteiz,expenses,repairs,-224.35,-1895.74
buyer_6,Manuel,,ES74209567901087476583,TRX_N-00042-90300388,2022-02-07T08:06:28,Vitoria-Gasteiz,expenses,internet,-42.0,-1937.74
buyer_6,Manuel,,ES74209567901087476583,TRX_N-00043-93037732,2022-02-07T04:10:29,Vitoria-Gasteiz,expenses,phone,-36.42,-1974.16
buyer_6,Manuel,,ES74209567901087476583,TRX_N-00044-90311606,2022-02-08T19:13:36,Vitoria-Gasteiz,expenses,water,-26.71,-2000.87
buyer_6,Manuel,,ES74209567901087476583,TRX_N-00045-21563209,2022-02-08T08:17:43,Vitoria-Gasteiz,expenses,electricity,-59.46,-2060.33
buyer_6,Manuel,,ES74209567901087476583,TRX_N-00046-14493663,2022-02-08T13:09:42,Vitoria-Gasteiz,expenses,gas,-68.68,-2129.01
buyer_6,Manuel,,ES74209567901087476583,TRX_N-00047-07043801,2022-02-10T22:52:19,Vitoria-Gasteiz,expenses,leisure,-59.75,-2188.76
buyer_6,Manuel,,ES74209567901087476583,TRX_N-00048-83494566,2022-02-12T21:09:38,Vitoria-Gasteiz,expenses,food,-83.61,-2272.37
buyer_6,Manuel,,ES74209567901087476583,TRX_N-00049-36652482,2022-02-19T08:50:09,Vitoria-Gasteiz,expenses,transport,-85.54,-2357.91
buyer_6,Manuel,,ES74209567901087476583,TRX_N-00050-23618905,2022-02-20T03:11:59,Eibar,expenses,repairs,-189.09,-2547.0
buyer_6,Manuel,,ES74209567901087476583,TRX_N-00051-22057718,2022-02-20T08:43:09,Vitoria-Gasteiz,expenses,gifts,-759.99,-3306.99
buyer_6,Manuel,,ES74209567901087476583,TRX_N-00052-79250931,2022-02-21T21:18:37,Vitoria-Gasteiz,expenses,transport,-87.32,-3394.31
buyer_6,Manuel,,ES74209567901087476583,TRX_N-00053-90572668,2022-02-21T09:58:45,Vitoria-Gasteiz,expenses,travel,-1536.48,-4930.79
buyer_6,Manuel,,ES74209567901087476583,TRX_N-00054-19259203,2022-02-22T20:02:08,Vitoria-Gasteiz,expenses,cash,-100.0,-5030.79
buyer_6,Manuel,,ES74209567901087476583,TRX_N-00055-09911481,2022-02-24T17:55:50,Vitoria-Gasteiz,expenses,leisure,-33.42,-5064.21
buyer_6,Manuel,,ES74209567901087476583,TRX_N-00056-14630043,2022-02-24T11:02:44,Vitoria-Gasteiz,expenses,clothing,-137.36,-5201.57
buyer_6,Manuel,,ES74209567901087476583,TRX_N-00057-74051974,2022-02-28T18:15:51,Arrasate,expenses,cash,-100.0,-5301.57
buyer_6,Manuel,,ES74209567901087476583,TRX_N-00058-40654718,2022-03-01T11:04:17,Vitoria-Gasteiz,incomes,salary,1370.54,-3931.03
buyer_6,Manuel,,ES74209567901087476583,TRX_N-00059-76527155,2022-03-02T20:10:10,Vitoria-Gasteiz,expenses,cash,-100.0,-4031.03
buyer_6,Manuel,,ES74209567901087476583,TRX_N-00060-97584412,2022-03-04T20:25:26,Vitoria-Gasteiz,expenses,mortgage,-879.67,-4910.7
buyer_6,Manuel,,ES74209567901087476583,TRX_N-00061-68026984,2022-03-04T08:28:12,Vitoria-Gasteiz,expenses,repairs,-112.82,-5023.52
buyer_6,Manuel,,ES74209567901087476583,TRX_N-00062-22887197,2022-03-05T17:31:02,Vitoria-Gasteiz,expenses,gas,-44.19,-5067.71
buyer_6,Manuel,,ES74209567901087476583,TRX_N-00063-87888112,2022-03-06T19:15:22,Vitoria-Gasteiz,expenses,water,-33.51,-5101.22
buyer_6,Manuel,,ES74209567901087476583,TRX_N-00064-87867338,2022-03-06T10:42:43,Vitoria-Gasteiz,expenses,phone,-33.52,-5134.74
buyer_6,Manuel,,ES74209567901087476583,TRX_N-00065-79595339,2022-03-06T09:47:53,Llodio,expenses,food,-119.85,-5254.59
buyer_6,Manuel,,ES74209567901087476583,TRX_N-00066-46487370,2022-03-07T11:30:34,Vitoria-Gasteiz,expenses,travel,-952.18,-6206.77
buyer_6,Manuel,,ES74209567901087476583,TRX_N-00067-16266898,2022-03-08T20:20:12,Vitoria-Gasteiz,expenses,electricity,-81.89,-6288.66
buyer_6,Manuel,,ES74209567901087476583,TRX_N-00068-97295826,2022-03-08T05:49:29,Vitoria-Gasteiz,expenses,internet,-42.0,-6330.66
buyer_6,Manuel,,ES74209567901087476583,TRX_N-00069-31827261,2022-03-11T17:34:28,Zuia,expenses,food,-122.78,-6453.44
buyer_6,Manuel,,ES74209567901087476583,TRX_N-00070-48658176,2022-03-11T06:14:55,Vitoria-Gasteiz,expenses,gifts,-475.31,-6928.75
buyer_6,Manuel,,ES74209567901087476583,TRX_N-00071-16608400,2022-03-13T11:00:12,Vitoria-Gasteiz,expenses,repairs,-269.27,-7198.02
buyer_6,Manuel,,ES74209567901087476583,TRX_N-00072-55118750,2022-03-17T20:33:32,Vitoria-Gasteiz,expenses,transport,-57.7,-7255.72
buyer_6,Manuel,,ES74209567901087476583,TRX_N-00073-01818000,2022-03-21T11:52:33,Vitoria-Gasteiz,expenses,clothing,-139.38,-7395.1
buyer_6,Manuel,,ES74209567901087476583,TRX_N-00074-23066985,2022-03-22T16:15:32,Vitoria-Gasteiz,expenses,transport,-56.43,-7451.53
buyer_6,Manuel,,ES74209567901087476583,TRX_N-00075-26890324,2022-03-22T16:40:06,Pasaia,expenses,cash,-100.0,-7551.53
buyer_6,Manuel,,ES74209567901087476583,TRX_N-00076-79564200,2022-03-24T14:31:59,Vitoria-Gasteiz,expenses,food,-66.25,-7617.78
buyer_6,Manuel,,ES74209567901087476583,TRX_N-00077-30378246,2022-03-24T19:40:12,Bilbao,expenses,clothing,-154.14,-7771.92
buyer_6,Manuel,,ES74209567901087476583,TRX_N-00078-19846584,2022-03-24T04:29:01,Vitoria-Gasteiz,expenses,appliances,-258.99,-8030.91
buyer_6,Manuel,,ES74209567901087476583,TRX_N-00079-34542893,2022-03-26T10:05:29,Vitoria-Gasteiz,expenses,transport,-51.46,-8082.37
buyer_6,Manuel,,ES74209567901087476583,TRX_N-00080-78643737,2022-03-26T15:20:05,Vitoria-Gasteiz,expenses,clothing,-125.11,-8207.48
buyer_6,Manuel,,ES74209567901087476583,TRX_N-00081-63204299,2022-03-27T09:52:34,Vitoria-Gasteiz,expenses,leisure,-53.54,-8261.02
buyer_6,Manuel,,ES74209567901087476583,TRX_N-00082-27653982,2022-03-29T23:07:29,Vitoria-Gasteiz,expenses,food,-116.42,-8377.44
buyer_6,Manuel,,ES74209567901087476583,TRX_N-00083-35309038,2022-03-31T14:34:37,Labastida,expenses,food,-67.15,-8444.59
buyer_6,Manuel,,ES74209567901087476583,TRX_N-00084-79054153,2022-03-31T10:00:49,Arrasate,expenses,education,-66.06,-8510.65
buyer_6,Manuel,,ES74209567901087476583,TRX_N-00085-25302384,2022-03-31T13:09:54,Durango,expenses,cash,-100.0,-8610.65
buyer_6,Manuel,,ES74209567901087476583,TRX_N-00086-12282230,2022-04-01T17:33:01,Vitoria-Gasteiz,incomes,salary,1370.54,-7240.11
buyer_6,Manuel,,ES74209567901087476583,TRX_N-00087-72268570,2022-04-01T17:33:01,Vitoria-Gasteiz,incomes,extra_income,151.06,-7089.05
buyer_6,Manuel,,ES74209567901087476583,TRX_N-00088-08675130,2022-04-01T19:00:18,Erandio,expenses,education,-70.09,-7159.14
buyer_6,Manuel,,ES74209567901087476583,TRX_N-00089-46251114,2022-04-01T00:54:55,Berango,expenses,cash,-100.0,-7259.14
buyer_6,Manuel,,ES74209567901087476583,TRX_N-00090-11969088,2022-04-02T00:19:42,Vitoria-Gasteiz,expenses,leisure,-53.71,-7312.85
buyer_6,Manuel,,ES74209567901087476583,TRX_N-00091-31478332,2022-04-03T14:51:11,Vitoria-Gasteiz,expenses,leisure,-21.2,-7334.05
buyer_6,Manuel,,ES74209567901087476583,TRX_N-00092-65804374,2022-04-04T09:43:10,Vitoria-Gasteiz,expenses,mortgage,-879.67,-8213.72
buyer_6,Manuel,,ES74209567901087476583,TRX_N-00093-91934093,2022-04-05T17:48:34,Vitoria-Gasteiz,expenses,gas,-93.62,-8307.34
buyer_6,Manuel,,ES74209567901087476583,TRX_N-00094-82300843,2022-04-05T16:52:42,Vitoria-Gasteiz,expenses,healthcare,-70.44,-8377.78
buyer_6,Manuel,,ES74209567901087476583,TRX_N-00095-38056663,2022-04-06T17:32:21,Vitoria-Gasteiz,expenses,water,-27.34,-8405.12
buyer_6,Manuel,,ES74209567901087476583,TRX_N-00096-76748870,2022-04-06T11:42:40,Vitoria-Gasteiz,expenses,internet,-42.0,-8447.12
buyer_6,Manuel,,ES74209567901087476583,TRX_N-00097-28304557,2022-04-06T11:02:29,Vitoria-Gasteiz,expenses,cash,-100.0,-8547.12
buyer_6,Manuel,,ES74209567901087476583,TRX_N-00098-14746032,2022-04-08T15:27:51,Vitoria-Gasteiz,expenses,electricity,-28.11,-8575.23
buyer_6,Manuel,,ES74209567901087476583,TRX_N-00099-79678773,2022-04-08T16:20:14,Vitoria-Gasteiz,expenses,phone,-31.04,-8606.27
buyer_6,Manuel,,ES74209567901087476583,TRX_N-00100-99127111,2022-04-08T13:35:06,Vitoria-Gasteiz,expenses,leisure,-71.73,-8678.0
buyer_6,Manuel,,ES74209567901087476583,TRX_N-00101-22088590,2022-04-09T13:06:38,Vitoria-Gasteiz,expenses,food,-103.22,-8781.22
buyer_6,Manuel,,ES74209567901087476583,TRX_N-00102-67552934,2022-04-09T17:33:43,Salvatierra/Agurain,expenses,transport,-78.8,-8860.02
buyer_6,Manuel,,ES74209567901087476583,TRX_N-00103-19248380,2022-04-09T16:48:47,Salvatierra/Agurain,expenses,education,-71.8,-8931.82
buyer_6,Manuel,,ES74209567901087476583,TRX_N-00104-07276423,2022-04-10T10:23:10,Vitoria-Gasteiz,expenses,education,-49.85,-8981.67
buyer_6,Manuel,,ES74209567901087476583,TRX_N-00105-83843973,2022-04-11T14:53:08,Alegría-Dulantzi,expenses,transport,-55.97,-9037.64
buyer_6,Manuel,,ES74209567901087476583,TRX_N-00106-19335217,2022-04-11T21:08:29,Lasarte-Oria,expenses,cash,-100.0,-9137.64
buyer_6,Manuel,,ES74209567901087476583,TRX_N-00107-07663795,2022-04-13T18:57:45,Vitoria-Gasteiz,expenses,repairs,-161.11,-9298.75
buyer_6,Manuel,,ES74209567901087476583,TRX_N-00108-33997648,2022-04-14T17:06:55,Vitoria-Gasteiz,expenses,food,-61.81,-9360.56
buyer_6,Manuel,,ES74209567901087476583,TRX_N-00109-57332476,2022-04-14T15:31:48,Amurrio,expenses,gifts,-238.0,-9598.56
buyer_6,Manuel,,ES74209567901087476583,TRX_N-00110-85700647,2022-04-17T17:22:26,Vitoria-Gasteiz,expenses,healthcare,-109.47,-9708.03
buyer_6,Manuel,,ES74209567901087476583,TRX_N-00111-35532205,2022-04-17T06:00:30,Vitoria-Gasteiz,expenses,education,-63.0,-9771.03
buyer_6,Manuel,,ES74209567901087476583,TRX_N-00112-89157896,2022-04-17T20:49:55,Vitoria-Gasteiz,expenses,repairs,-212.9,-9983.93
buyer_6,Manuel,,ES74209567901087476583,TRX_N-00113-04705067,2022-04-18T14:29:07,Irun,expenses,leisure,-36.6,-10020.53
buyer_6,Manuel,,ES74209567901087476583,TRX_N-00114-79643822,2022-04-19T16:03:39,Vitoria-Gasteiz,expenses,clothing,-154.62,-10175.15
buyer_6,Manuel,,ES74209567901087476583,TRX_N-00115-90199638,2022-04-20T14:56:16,Llodio,expenses,healthcare,-159.12,-10334.27
buyer_6,Manuel,,ES74209567901087476583,TRX_N-00116-99334755,2022-04-21T10:52:21,Vitoria-Gasteiz,expenses,food,-119.37,-10453.64
buyer_6,Manuel,,ES74209567901087476583,TRX_N-00117-42531432,2022-04-21T14:20:19,Vitoria-Gasteiz,expenses,repairs,-86.29,-10539.93
buyer_6,Manuel,,ES74209567901087476583,TRX_N-00118-25551828,2022-04-24T13:12:00,Oyón-Oion,expenses,cash,-100.0,-10639.93
buyer_6,Manuel,,ES74209567901087476583,TRX_N-00119-52902969,2022-04-24T09:46:06,Vitoria-Gasteiz,expenses,appliances,-371.79,-11011.72
buyer_6,Manuel,,ES74209567901087476583,TRX_N-00120-94557291,2022-04-26T11:32:42,Vitoria-Gasteiz,expenses,cash,-100.0,-11111.72
buyer_6,Manuel,,ES74209567901087476583,TRX_N-00121-03524117,2022-04-29T08:48:05,Vitoria-Gasteiz,expenses,transport,-63.94,-11175.66
buyer_6,Manuel,,ES74209567901087476583,TRX_N-00122-25090464,2022-04-29T05:29:28,Vitoria-Gasteiz,expenses,healthcare,-92.89,-11268.55
buyer_6,Manuel,,ES74209567901087476583,TRX_N-00123-13246371,2022-04-30T20:56:18,Vitoria-Gasteiz,expenses,gifts,-396.08,-11664.63
buyer_6,Manuel,,ES74209567901087476583,TRX_N-00124-96498251,2022-05-01T20:36:32,Vitoria-Gasteiz,incomes,salary,1370.54,-10294.09
buyer_6,Manuel,,ES74209567901087476583,TRX_N-00125-84927768,2022-05-01T15:58:45,Vitoria-Gasteiz,expenses,clothing,-81.54,-10375.63
buyer_6,Manuel,,ES74209567901087476583,TRX_N-00126-40829329,2022-05-01T03:56:11,Erandio,expenses,cash,-100.0,-10475.63
buyer_6,Manuel,,ES74209567901087476583,TRX_N-00127-10764298,2022-05-02T22:30:26,Vitoria-Gasteiz,expenses,cash,-100.0,-10575.63
buyer_6,Manuel,,ES74209567901087476583,TRX_N-00128-29217376,2022-05-02T16:38:20,Vitoria-Gasteiz,expenses,travel,-1849.65,-12425.28
buyer_6,Manuel,,ES74209567901087476583,TRX_N-00129-45068566,2022-05-04T19:34:44,Vitoria-Gasteiz,expenses,mortgage,-879.67,-13304.95
buyer_6,Manuel,,ES74209567901087476583,TRX_N-00130-99844931,2022-05-04T17:13:07,Vitoria-Gasteiz,expenses,cash,-100.0,-13404.95
buyer_6,Manuel,,ES74209567901087476583,TRX_N-00131-56185689,2022-05-04T14:45:30,Vitoria-Gasteiz,expenses,repairs,-163.38,-13568.33
buyer_6,Manuel,,ES74209567901087476583,TRX_N-00132-73678265,2022-05-05T22:55:50,Vitoria-Gasteiz,expenses,gas,-91.53,-13659.86
buyer_6,Manuel,,ES74209567901087476583,TRX_N-00133-49016628,2022-05-06T17:33:23,Vitoria-Gasteiz,expenses,internet,-42.0,-13701.86
buyer_6,Manuel,,ES74209567901087476583,TRX_N-00134-00672796,2022-05-07T15:20:13,Vitoria-Gasteiz,expenses,phone,-30.64,-13732.5
buyer_6,Manuel,,ES74209567901087476583,TRX_N-00135-91906873,2022-05-08T18:53:45,Vitoria-Gasteiz,expenses,water,-36.53,-13769.03
buyer_6,Manuel,,ES74209567901087476583,TRX_N-00136-89977672,2022-05-08T13:56:42,Vitoria-Gasteiz,expenses,electricity,-28.59,-13797.62
buyer_6,Manuel,,ES74209567901087476583,TRX_N-00137-60706808,2022-05-08T10:33:44,Basauri,expenses,food,-93.41,-13891.03
buyer_6,Manuel,,ES74209567901087476583,TRX_N-00138-66441133,2022-05-08T10:13:45,Vitoria-Gasteiz,expenses,leisure,-27.45,-13918.48
buyer_6,Manuel,,ES74209567901087476583,TRX_N-00139-80202131,2022-05-08T13:30:38,Vitoria-Gasteiz,expenses,cash,-100.0,-14018.48
buyer_6,Manuel,,ES74209567901087476583,TRX_N-00140-59120791,2022-05-10T07:06:07,Vitoria-Gasteiz,expenses,clothing,-99.78,-14118.26
buyer_6,Manuel,,ES74209567901087476583,TRX_N-00141-39672498,2022-05-10T09:50:43,Vitoria-Gasteiz,expenses,repairs,-78.79,-14197.05
buyer_6,Manuel,,ES74209567901087476583,TRX_N-00142-18860128,2022-05-11T12:34:00,Vitoria-Gasteiz,expenses,education,-58.93,-14255.98
buyer_6,Manuel,,ES74209567901087476583,TRX_N-00143-79761537,2022-05-12T02:32:36,Vitoria-Gasteiz,expenses,transport,-76.43,-14332.41
buyer_6,Manuel,,ES74209567901087476583,TRX_N-00144-38828994,2022-05-12T09:07:20,Vitoria-Gasteiz,expenses,clothing,-103.35,-14435.76
buyer_6,Manuel,,ES74209567901087476583,TRX_N-00145-74491303,2022-05-12T15:44:56,Vitoria-Gasteiz,expenses,travel,-1811.31,-16247.07
buyer_6,Manuel,,ES74209567901087476583,TRX_N-00146-90571464,2022-05-13T16:55:05,Vitoria-Gasteiz,expenses,leisure,-72.69,-16319.76
buyer_6,Manuel,,ES74209567901087476583,TRX_N-00147-89516685,2022-05-16T21:22:31,Vitoria-Gasteiz,expenses,repairs,-279.85,-16599.61
buyer_6,Manuel,,ES74209567901087476583,TRX_N-00148-16989478,2022-05-19T20:49:36,Labastida,expenses,cash,-100.0,-16699.61
buyer_6,Manuel,,ES74209567901087476583,TRX_N-00149-36951798,2022-05-19T20:59:29,Vitoria-Gasteiz,expenses,gifts,-216.32,-16915.93
buyer_6,Manuel,,ES74209567901087476583,TRX_N-00150-88906798,2022-05-20T18:49:28,Vitoria-Gasteiz,expenses,food,-64.34,-16980.27
buyer_6,Manuel,,ES74209567901087476583,TRX_N-00151-91032828,2022-05-20T08:47:41,Durango,expenses,leisure,-68.89,-17049.16
buyer_6,Manuel,,ES74209567901087476583,TRX_N-00152-39460272,2022-05-20T14:14:26,Leioa,expenses,cash,-100.0,-17149.16
buyer_6,Manuel,,ES74209567901087476583,TRX_N-00153-51809383,2022-05-21T18:38:07,Vitoria-Gasteiz,expenses,cash,-100.0,-17249.16
buyer_6,Manuel,,ES74209567901087476583,TRX_N-00154-36202880,2022-05-21T10:37:27,Vitoria-Gasteiz,expenses,gifts,-447.93,-17697.09
buyer_6,Manuel,,ES74209567901087476583,TRX_N-00155-10673040,2022-05-23T09:43:56,Sestao,expenses,food,-109.25,-17806.34
buyer_6,Manuel,,ES74209567901087476583,TRX_N-00156-85711990,2022-05-23T22:26:12,Andoain,expenses,gifts,-588.99,-18395.33
buyer_6,Manuel,,ES74209567901087476583,TRX_N-00157-21321008,2022-05-25T17:28:00,Vitoria-Gasteiz,expenses,cash,-100.0,-18495.33
buyer_6,Manuel,,ES74209567901087476583,TRX_N-00158-73991737,2022-05-28T12:22:37,Vitoria-Gasteiz,expenses,food,-107.07,-18602.4
buyer_6,Manuel,,ES74209567901087476583,TRX_N-00159-86700190,2022-05-29T14:42:35,Vitoria-Gasteiz,expenses,transport,-65.82,-18668.22
buyer_6,Manuel,,ES74209567901087476583,TRX_N-00160-36513959,2022-05-30T14:11:03,Vitoria-Gasteiz,expenses,cash,-100.0,-18768.22
buyer_6,Manuel,,ES74209567901087476583,TRX_N-00161-12641827,2022-05-31T09:43:22,Oyón-Oion,expenses,gifts,-267.52,-19035.74
buyer_6,Manuel,,ES74209567901087476583,TRX_N-00162-81940166,2022-06-01T15:49:11,Vitoria-Gasteiz,incomes,salary,1370.54,-17665.2
buyer_6,Manuel,,ES74209567901087476583,TRX_N-00163-45584553,2022-06-01T15:49:11,Vitoria-Gasteiz,incomes,salary_bonus,1065.33,-16599.87
buyer_6,Manuel,,ES74209567901087476583,TRX_N-00164-83444037,2022-06-02T18:51:24,Vitoria-Gasteiz,expenses,food,-93.89,-16693.76
buyer_6,Manuel,,ES74209567901087476583,TRX_N-00165-83749270,2022-06-03T20:21:07,Vitoria-Gasteiz,expenses,gifts,-153.46,-16847.22
buyer_6,Manuel,,ES74209567901087476583,TRX_N-00166-81983051,2022-06-04T11:05:23,Vitoria-Gasteiz,expenses,mortgage,-879.67,-17726.89
buyer_6,Manuel,,ES74209567901087476583,TRX_N-00167-66737525,2022-06-05T21:11:45,Vitoria-Gasteiz,expenses,education,-48.49,-17775.38
buyer_6,Manuel,,ES74209567901087476583,TRX_N-00168-39393601,2022-06-05T10:42:11,Vitoria-Gasteiz,expenses,repairs,-282.34,-18057.72
buyer_6,Manuel,,ES74209567901087476583,TRX_N-00169-36562587,2022-06-06T03:08:46,Vitoria-Gasteiz,expenses,water,-28.22,-18085.94
buyer_6,Manuel,,ES74209567901087476583,TRX_N-00170-80515663,2022-06-06T20:50:27,Vitoria-Gasteiz,expenses,gas,-66.81,-18152.75
buyer_6,Manuel,,ES74209567901087476583,TRX_N-00171-04255436,2022-06-06T12:35:22,Vitoria-Gasteiz,expenses,phone,-39.79,-18192.54
buyer_6,Manuel,,ES74209567901087476583,TRX_N-00172-59598400,2022-06-06T00:56:24,Vitoria-Gasteiz,expenses,food,-65.46,-18258.0
buyer_6,Manuel,,ES74209567901087476583,TRX_N-00173-40589200,2022-06-07T10:01:32,Vitoria-Gasteiz,expenses,electricity,-78.63,-18336.63
buyer_6,Manuel,,ES74209567901087476583,TRX_N-00174-45503235,2022-06-08T16:34:56,Vitoria-Gasteiz,expenses,internet,-42.0,-18378.63
buyer_6,Manuel,,ES74209567901087476583,TRX_N-00175-32053853,2022-06-08T17:30:16,Vitoria-Gasteiz,expenses,food,-70.36,-18448.99
buyer_6,Manuel,,ES74209567901087476583,TRX_N-00176-30201399,2022-06-08T08:58:31,Vitoria-Gasteiz,expenses,transport,-49.49,-18498.48
buyer_6,Manuel,,ES74209567901087476583,TRX_N-00177-02564650,2022-06-09T17:22:50,Vitoria-Gasteiz,expenses,cash,-100.0,-18598.48
buyer_6,Manuel,,ES74209567901087476583,TRX_N-00178-10845445,2022-06-12T14:26:49,Vitoria-Gasteiz,expenses,food,-114.28,-18712.76
buyer_6,Manuel,,ES74209567901087476583,TRX_N-00179-07375326,2022-06-13T16:04:58,Vitoria-Gasteiz,expenses,leisure,-68.34,-18781.1
buyer_6,Manuel,,ES74209567901087476583,TRX_N-00180-47179374,2022-06-13T10:11:35,Vitoria-Gasteiz,expenses,repairs,-211.42,-18992.52
buyer_6,Manuel,,ES74209567901087476583,TRX_N-00181-53750095,2022-06-14T22:48:24,Vitoria-Gasteiz,expenses,cash,-100.0,-19092.52
buyer_6,Manuel,,ES74209567901087476583,TRX_N-00182-40116067,2022-06-18T14:03:56,Oyón-Oion,expenses,food,-121.81,-19214.33
buyer_6,Manuel,,ES74209567901087476583,TRX_N-00183-28316178,2022-06-18T04:04:59,Vitoria-Gasteiz,expenses,travel,-322.31,-19536.64
buyer_6,Manuel,,ES74209567901087476583,TRX_N-00184-34712093,2022-06-19T11:49:21,Vitoria-Gasteiz,expenses,food,-95.08,-19631.72
buyer_6,Manuel,,ES74209567901087476583,TRX_N-00185-01007723,2022-06-19T13:31:14,Vitoria-Gasteiz,expenses,clothing,-136.66,-19768.38
buyer_6,Manuel,,ES74209567901087476583,TRX_N-00186-02524851,2022-06-20T09:23:06,Vitoria-Gasteiz,expenses,cash,-100.0,-19868.38
buyer_6,Manuel,,ES74209567901087476583,TRX_N-00187-99744720,2022-06-21T14:50:16,Vitoria-Gasteiz,expenses,food,-98.53,-19966.91
buyer_6,Manuel,,ES74209567901087476583,TRX_N-00188-07915504,2022-06-21T12:50:04,Vitoria-Gasteiz,expenses,cash,-100.0,-20066.91
buyer_6,Manuel,,ES74209567901087476583,TRX_N-00189-81326800,2022-06-22T18:37:22,Vitoria-Gasteiz,expenses,cash,-100.0,-20166.91
buyer_6,Manuel,,ES74209567901087476583,TRX_N-00190-24628857,2022-06-26T09:53:40,Vitoria-Gasteiz,expenses,transport,-85.49,-20252.4
buyer_6,Manuel,,ES74209567901087476583,TRX_N-00191-60899528,2022-06-28T16:47:51,Vitoria-Gasteiz,expenses,repairs,-179.8,-20432.2
buyer_6,Manuel,,ES74209567901087476583,TRX_N-00192-68468762,2022-06-30T20:52:10,Vitoria-Gasteiz,expenses,leisure,-48.72,-20480.92
buyer_6,Manuel,,ES74209567901087476583,TRX_N-00193-05881508,2022-07-01T06:50:16,Vitoria-Gasteiz,incomes,salary,1370.54,-19110.38
buyer_6,Manuel,,ES74209567901087476583,TRX_N-00194-77089572,2022-07-01T19:48:37,Vitoria-Gasteiz,expenses,clothing,-70.77,-19181.15
buyer_6,Manuel,,ES74209567901087476583,TRX_N-00195-10470665,2022-07-02T15:59:48,Sestao,expenses,education,-49.59,-19230.74
buyer_6,Manuel,,ES74209567901087476583,TRX_N-00196-32979777,2022-07-03T13:33:21,Vitoria-Gasteiz,expenses,food,-112.7,-19343.44
buyer_6,Manuel,,ES74209567901087476583,TRX_N-00197-08121523,2022-07-03T14:39:01,Vitoria-Gasteiz,expenses,leisure,-41.6,-19385.04
buyer_6,Manuel,,ES74209567901087476583,TRX_N-00198-00414294,2022-07-04T16:31:46,Vitoria-Gasteiz,expenses,mortgage,-879.67,-20264.71
buyer_6,Manuel,,ES74209567901087476583,TRX_N-00199-70516607,2022-07-04T13:03:47,Vitoria-Gasteiz,expenses,gifts,-788.96,-21053.67
buyer_6,Manuel,,ES74209567901087476583,TRX_N-00200-08994360,2022-07-05T14:08:43,Eibar,expenses,cash,-100.0,-21153.67
buyer_6,Manuel,,ES74209567901087476583,TRX_N-00201-83128356,2022-07-06T14:12:39,Vitoria-Gasteiz,expenses,water,-40.17,-21193.84
buyer_6,Manuel,,ES74209567901087476583,TRX_N-00202-69290439,2022-07-06T14:11:49,Vitoria-Gasteiz,expenses,internet,-42.0,-21235.84
buyer_6,Manuel,,ES74209567901087476583,TRX_N-00203-25750229,2022-07-06T09:11:14,Alegría-Dulantzi,expenses,transport,-69.12,-21304.96
buyer_6,Manuel,,ES74209567901087476583,TRX_N-00204-86135000,2022-07-06T09:14:29,Vitoria-Gasteiz,expenses,leisure,-80.0,-21384.96
buyer_6,Manuel,,ES74209567901087476583,TRX_N-00205-98396056,2022-07-06T12:34:46,Vitoria-Gasteiz,expenses,education,-53.95,-21438.91
buyer_6,Manuel,,ES74209567901087476583,TRX_N-00206-35173999,2022-07-07T15:37:06,Vitoria-Gasteiz,expenses,electricity,-27.27,-21466.18
buyer_6,Manuel,,ES74209567901087476583,TRX_N-00207-79177559,2022-07-07T15:37:41,Vitoria-Gasteiz,expenses,transport,-83.42,-21549.6
buyer_6,Manuel,,ES74209567901087476583,TRX_N-00208-33566888,2022-07-07T13:38:13,Hernani,expenses,clothing,-133.9,-21683.5
buyer_6,Manuel,,ES74209567901087476583,TRX_N-00209-67904121,2022-07-08T09:56:59,Vitoria-Gasteiz,expenses,gas,-53.75,-21737.25
buyer_6,Manuel,,ES74209567901087476583,TRX_N-00210-81285680,2022-07-08T02:29:34,Vitoria-Gasteiz,expenses,phone,-39.36,-21776.61
buyer_6,Manuel,,ES74209567901087476583,TRX_N-00211-15241477,2022-07-09T20:10:05,Vitoria-Gasteiz,expenses,leisure,-53.81,-21830.42
buyer_6,Manuel,,ES74209567901087476583,TRX_N-00212-27997822,2022-07-10T15:14:50,Galdakao,expenses,gifts,-679.3,-22509.72
buyer_6,Manuel,,ES74209567901087476583,TRX_N-00213-32832711,2022-07-12T16:44:19,Portugalete,expenses,food,-63.58,-22573.3
buyer_6,Manuel,,ES74209567901087476583,TRX_N-00214-72251287,2022-07-12T14:02:51,Vitoria-Gasteiz,expenses,cash,-100.0,-22673.3
buyer_6,Manuel,,ES74209567901087476583,TRX_N-00215-42456660,2022-07-13T19:05:20,Vitoria-Gasteiz,expenses,food,-96.62,-22769.92
buyer_6,Manuel,,ES74209567901087476583,TRX_N-00216-76489307,2022-07-14T20:22:57,Vitoria-Gasteiz,expenses,cash,-100.0,-22869.92
buyer_6,Manuel,,ES74209567901087476583,TRX_N-00217-14036685,2022-07-15T16:55:55,Vitoria-Gasteiz,expenses,education,-55.96,-22925.88
buyer_6,Manuel,,ES74209567901087476583,TRX_N-00218-75100045,2022-07-16T15:42:38,Vitoria-Gasteiz,expenses,appliances,-193.21,-23119.09
buyer_6,Manuel,,ES74209567901087476583,TRX_N-00219-20073802,2022-07-16T19:02:55,Oyón-Oion,expenses,repairs,-62.2,-23181.29
buyer_6,Manuel,,ES74209567901087476583,TRX_N-00220-46452775,2022-07-18T23:05:41,Vitoria-Gasteiz,expenses,food,-67.33,-23248.62
buyer_6,Manuel,,ES74209567901087476583,TRX_N-00221-31588410,2022-07-19T11:23:30,Vitoria-Gasteiz,expenses,food,-97.89,-23346.51
buyer_6,Manuel,,ES74209567901087476583,TRX_N-00222-34336185,2022-07-19T11:20:02,Vitoria-Gasteiz,expenses,education,-72.0,-23418.51
buyer_6,Manuel,,ES74209567901087476583,TRX_N-00223-73404123,2022-07-20T20:26:11,Salvatierra/Agurain,expenses,education,-45.99,-23464.5
buyer_6,Manuel,,ES74209567901087476583,TRX_N-00224-87652494,2022-07-22T19:13:55,Vitoria-Gasteiz,expenses,transport,-47.78,-23512.28
buyer_6,Manuel,,ES74209567901087476583,TRX_N-00225-96601223,2022-07-22T15:38:05,Vitoria-Gasteiz,expenses,repairs,-139.45,-23651.73
buyer_6,Manuel,,ES74209567901087476583,TRX_N-00226-79684063,2022-07-23T15:35:46,Vitoria-Gasteiz,expenses,clothing,-128.14,-23779.87
buyer_6,Manuel,,ES74209567901087476583,TRX_N-00227-49564518,2022-07-26T19:37:05,Vitoria-Gasteiz,expenses,cash,-100.0,-23879.87
buyer_6,Manuel,,ES74209567901087476583,TRX_N-00228-68694205,2022-07-28T09:58:39,Vitoria-Gasteiz,expenses,clothing,-136.98,-24016.85
buyer_6,Manuel,,ES74209567901087476583,TRX_N-00229-01075857,2022-07-29T18:33:50,Vitoria-Gasteiz,expenses,food,-115.44,-24132.29
buyer_6,Manuel,,ES74209567901087476583,TRX_N-00230-75281636,2022-08-01T10:26:21,Vitoria-Gasteiz,incomes,salary,1370.54,-22761.75
buyer_6,Manuel,,ES74209567901087476583,TRX_N-00231-30820212,2022-08-01T10:26:21,Vitoria-Gasteiz,incomes,extra_income,151.06,-22610.69
buyer_6,Manuel,,ES74209567901087476583,TRX_N-00232-99413829,2022-08-01T19:39:52,Vitoria-Gasteiz,expenses,repairs,-322.54,-22933.23
buyer_6,Manuel,,ES74209567901087476583,TRX_N-00233-73399691,2022-08-03T13:56:17,Vitoria-Gasteiz,expenses,food,-111.44,-23044.67
buyer_6,Manuel,,ES74209567901087476583,TRX_N-00234-99954852,2022-08-04T21:03:10,Vitoria-Gasteiz,expenses,mortgage,-879.67,-23924.34
buyer_6,Manuel,,ES74209567901087476583,TRX_N-00235-96284506,2022-08-05T12:32:26,Vitoria-Gasteiz,expenses,water,-20.14,-23944.48
buyer_6,Manuel,,ES74209567901087476583,TRX_N-00236-45624895,2022-08-05T15:44:31,Vitoria-Gasteiz,expenses,electricity,-55.58,-24000.06
buyer_6,Manuel,,ES74209567901087476583,TRX_N-00237-29625607,2022-08-05T08:11:00,Vitoria-Gasteiz,expenses,gas,-64.15,-24064.21
buyer_6,Manuel,,ES74209567901087476583,TRX_N-00238-56159165,2022-08-05T15:08:14,Vitoria-Gasteiz,expenses,phone,-43.4,-24107.61
buyer_6,Manuel,,ES74209567901087476583,TRX_N-00239-34878400,2022-08-05T11:12:03,Vitoria-Gasteiz,expenses,gifts,-695.28,-24802.89
buyer_6,Manuel,,ES74209567901087476583,TRX_N-00240-90947149,2022-08-06T19:08:25,Vitoria-Gasteiz,expenses,transport,-89.02,-24891.91
buyer_6,Manuel,,ES74209567901087476583,TRX_N-00241-40345191,2022-08-07T17:57:13,Vitoria-Gasteiz,expenses,food,-98.56,-24990.47
buyer_6,Manuel,,ES74209567901087476583,TRX_N-00242-40743274,2022-08-08T00:23:35,Vitoria-Gasteiz,expenses,internet,-42.0,-25032.47
buyer_6,Manuel,,ES74209567901087476583,TRX_N-00243-54896300,2022-08-09T20:48:56,Galdakao,expenses,transport,-78.62,-25111.09
buyer_6,Manuel,,ES74209567901087476583,TRX_N-00244-81874696,2022-08-09T18:49:09,Vitoria-Gasteiz,expenses,appliances,-195.27,-25306.36
buyer_6,Manuel,,ES74209567901087476583,TRX_N-00245-21181513,2022-08-10T13:39:14,Eibar,expenses,cash,-100.0,-25406.36
buyer_6,Manuel,,ES74209567901087476583,TRX_N-00246-95833258,2022-08-11T07:13:54,Vitoria-Gasteiz,expenses,cash,-100.0,-25506.36
buyer_6,Manuel,,ES74209567901087476583,TRX_N-00247-90540533,2022-08-12T19:22:42,Vitoria-Gasteiz,expenses,cash,-100.0,-25606.36
buyer_6,Manuel,,ES74209567901087476583,TRX_N-00248-11253269,2022-08-13T15:44:00,Vitoria-Gasteiz,expenses,cash,-100.0,-25706.36
buyer_6,Manuel,,ES74209567901087476583,TRX_N-00249-57455098,2022-08-14T14:38:36,Vitoria-Gasteiz,expenses,food,-76.69,-25783.05
buyer_6,Manuel,,ES74209567901087476583,TRX_N-00250-17475394,2022-08-15T06:30:33,Vitoria-Gasteiz,expenses,food,-61.02,-25844.07
buyer_6,Manuel,,ES74209567901087476583,TRX_N-00251-48513451,2022-08-19T19:46:02,Vitoria-Gasteiz,expenses,appliances,-238.59,-26082.66
buyer_6,Manuel,,ES74209567901087476583,TRX_N-00252-29119559,2022-08-20T17:33:13,Vitoria-Gasteiz,expenses,transport,-47.32,-26129.98
buyer_6,Manuel,,ES74209567901087476583,TRX_N-00253-36126947,2022-08-20T18:44:24,Vitoria-Gasteiz,expenses,appliances,-360.05,-26490.03
buyer_6,Manuel,,ES74209567901087476583,TRX_N-00254-58077162,2022-08-21T17:02:45,Vitoria-Gasteiz,expenses,cash,-100.0,-26590.03
buyer_6,Manuel,,ES74209567901087476583,TRX_N-00255-23438976,2022-08-22T08:48:00,Vitoria-Gasteiz,expenses,leisure,-20.79,-26610.82
buyer_6,Manuel,,ES74209567901087476583,TRX_N-00256-87869886,2022-08-23T14:23:36,Vitoria-Gasteiz,expenses,repairs,-70.74,-26681.56
buyer_6,Manuel,,ES74209567901087476583,TRX_N-00257-22025867,2022-08-24T14:52:33,Vitoria-Gasteiz,expenses,education,-45.61,-26727.17
buyer_6,Manuel,,ES74209567901087476583,TRX_N-00258-10325583,2022-08-25T02:24:29,Vitoria-Gasteiz,expenses,transport,-63.73,-26790.9
buyer_6,Manuel,,ES74209567901087476583,TRX_N-00259-88953149,2022-08-25T12:51:46,Vitoria-Gasteiz,expenses,clothing,-142.28,-26933.18
buyer_6,Manuel,,ES74209567901087476583,TRX_N-00260-29019569,2022-08-25T20:23:49,Vitoria-Gasteiz,expenses,education,-75.81,-27008.99
buyer_6,Manuel,,ES74209567901087476583,TRX_N-00261-83538882,2022-08-25T19:23:33,Vitoria-Gasteiz,expenses,repairs,-253.52,-27262.51
buyer_6,Manuel,,ES74209567901087476583,TRX_N-00262-75145593,2022-08-30T09:35:39,Vitoria-Gasteiz,expenses,education,-43.73,-27306.24
buyer_6,Manuel,,ES74209567901087476583,TRX_N-00263-41786154,2022-08-30T12:16:53,Arrasate,expenses,cash,-100.0,-27406.24
buyer_6,Manuel,,ES74209567901087476583,TRX_N-00264-90909788,2022-08-31T17:11:16,Vitoria-Gasteiz,expenses,repairs,-287.03,-27693.27
buyer_6,Manuel,,ES74209567901087476583,TRX_N-00265-32172845,2022-09-01T02:48:40,Vitoria-Gasteiz,incomes,salary,1370.54,-26322.73
buyer_6,Manuel,,ES74209567901087476583,TRX_N-00266-15437103,2022-09-03T19:50:16,Vitoria-Gasteiz,expenses,leisure,-44.05,-26366.78
buyer_6,Manuel,,ES74209567901087476583,TRX_N-00267-68862953,2022-09-03T15:14:41,Vitoria-Gasteiz,expenses,gifts,-161.48,-26528.26
buyer_6,Manuel,,ES74209567901087476583,TRX_N-00268-00371584,2022-09-04T22:13:02,Vitoria-Gasteiz,expenses,mortgage,-879.67,-27407.93
buyer_6,Manuel,,ES74209567901087476583,TRX_N-00269-22210451,2022-09-05T15:50:42,Vitoria-Gasteiz,expenses,internet,-42.0,-27449.93
buyer_6,Manuel,,ES74209567901087476583,TRX_N-00270-59664355,2022-09-07T12:36:29,Vitoria-Gasteiz,expenses,water,-30.74,-27480.67
buyer_6,Manuel,,ES74209567901087476583,TRX_N-00271-05371058,2022-09-07T20:31:12,Vitoria-Gasteiz,expenses,electricity,-54.08,-27534.75
buyer_6,Manuel,,ES74209567901087476583,TRX_N-00272-15596757,2022-09-07T15:54:22,Vitoria-Gasteiz,expenses,leisure,-59.8,-27594.55
buyer_6,Manuel,,ES74209567901087476583,TRX_N-00273-78971219,2022-09-08T19:57:34,Vitoria-Gasteiz,expenses,phone,-31.99,-27626.54
buyer_6,Manuel,,ES74209567901087476583,TRX_N-00274-96578091,2022-09-08T11:31:53,Vitoria-Gasteiz,expenses,gas,-81.94,-27708.48
buyer_6,Manuel,,ES74209567901087476583,TRX_N-00275-52252230,2022-09-09T10:02:33,Vitoria-Gasteiz,expenses,cash,-100.0,-27808.48
buyer_6,Manuel,,ES74209567901087476583,TRX_N-00276-68170027,2022-09-14T19:06:48,Vitoria-Gasteiz,expenses,gifts,-768.16,-28576.64
buyer_6,Manuel,,ES74209567901087476583,TRX_N-00277-39475753,2022-09-15T14:38:08,Vitoria-Gasteiz,expenses,leisure,-56.05,-28632.69
buyer_6,Manuel,,ES74209567901087476583,TRX_N-00278-03126039,2022-09-17T19:54:22,Barakaldo,expenses,cash,-100.0,-28732.69
buyer_6,Manuel,,ES74209567901087476583,TRX_N-00279-67849931,2022-09-18T21:10:09,Vitoria-Gasteiz,expenses,cash,-100.0,-28832.69
buyer_6,Manuel,,ES74209567901087476583,TRX_N-00280-28059863,2022-09-19T17:01:00,Vitoria-Gasteiz,expenses,food,-95.91,-28928.6
buyer_6,Manuel,,ES74209567901087476583,TRX_N-00281-96721575,2022-09-20T17:47:36,Vitoria-Gasteiz,expenses,transport,-45.84,-28974.44
buyer_6,Manuel,,ES74209567901087476583,TRX_N-00282-97245343,2022-09-20T10:02:26,Vitoria-Gasteiz,expenses,clothing,-50.52,-29024.96
buyer_6,Manuel,,ES74209567901087476583,TRX_N-00283-38427395,2022-09-20T08:23:35,Vitoria-Gasteiz,expenses,appliances,-117.99,-29142.95
buyer_6,Manuel,,ES74209567901087476583,TRX_N-00284-38511781,2022-09-23T12:19:20,Vitoria-Gasteiz,expenses,transport,-79.67,-29222.62
buyer_6,Manuel,,ES74209567901087476583,TRX_N-00285-72616990,2022-09-23T20:16:11,Vitoria-Gasteiz,expenses,travel,-1839.24,-31061.86
buyer_6,Manuel,,ES74209567901087476583,TRX_N-00286-82820056,2022-09-23T18:10:19,Vitoria-Gasteiz,expenses,repairs,-71.0,-31132.86
buyer_6,Manuel,,ES74209567901087476583,TRX_N-00287-57485643,2022-09-24T08:35:38,Vitoria-Gasteiz,expenses,healthcare,-178.48,-31311.34
buyer_6,Manuel,,ES74209567901087476583,TRX_N-00288-85574233,2022-09-25T13:57:48,Sestao,expenses,clothing,-99.75,-31411.09
buyer_6,Manuel,,ES74209567901087476583,TRX_N-00289-34739339,2022-09-26T13:12:44,Sestao,expenses,repairs,-330.19,-31741.28
buyer_6,Manuel,,ES74209567901087476583,TRX_N-00290-60488731,2022-09-27T10:55:59,Vitoria-Gasteiz,expenses,transport,-80.5,-31821.78
buyer_6,Manuel,,ES74209567901087476583,TRX_N-00291-91838021,2022-09-30T09:43:45,Vitoria-Gasteiz,expenses,leisure,-39.69,-31861.47
buyer_6,Manuel,,ES74209567901087476583,TRX_N-00292-35939916,2022-10-01T12:55:53,Vitoria-Gasteiz,incomes,salary,1370.54,-30490.93
buyer_6,Manuel,,ES74209567901087476583,TRX_N-00293-79721180,2022-10-01T11:13:26,Irun,expenses,transport,-70.45,-30561.38
buyer_6,Manuel,,ES74209567901087476583,TRX_N-00294-22062203,2022-10-01T14:27:49,Vitoria-Gasteiz,expenses,repairs,-42.63,-30604.01
buyer_6,Manuel,,ES74209567901087476583,TRX_N-00295-85843330,2022-10-02T04:03:36,Durango,expenses,healthcare,-168.21,-30772.22
buyer_6,Manuel,,ES74209567901087476583,TRX_N-00296-02496247,2022-10-04T09:19:00,Vitoria-Gasteiz,expenses,mortgage,-879.67,-31651.89
buyer_6,Manuel,,ES74209567901087476583,TRX_N-00297-68665038,2022-10-05T19:49:15,Vitoria-Gasteiz,expenses,phone,-31.69,-31683.58
buyer_6,Manuel,,ES74209567901087476583,TRX_N-00298-58204627,2022-10-06T00:55:09,Vitoria-Gasteiz,expenses,cash,-100.0,-31783.58
buyer_6,Manuel,,ES74209567901087476583,TRX_N-00299-44886374,2022-10-08T13:05:05,Vitoria-Gasteiz,expenses,water,-40.14,-31823.72
buyer_6,Manuel,,ES74209567901087476583,TRX_N-00300-62038373,2022-10-08T18:15:43,Vitoria-Gasteiz,expenses,electricity,-26.2,-31849.92
buyer_6,Manuel,,ES74209567901087476583,TRX_N-00301-36829105,2022-10-08T09:23:59,Vitoria-Gasteiz,expenses,gas,-114.58,-31964.5
buyer_6,Manuel,,ES74209567901087476583,TRX_N-00302-79605224,2022-10-08T15:18:22,Vitoria-Gasteiz,expenses,internet,-42.0,-32006.5
buyer_6,Manuel,,ES74209567901087476583,TRX_N-00303-65348344,2022-10-09T08:04:34,Vitoria-Gasteiz,expenses,food,-120.75,-32127.25
buyer_6,Manuel,,ES74209567901087476583,TRX_N-00304-61157536,2022-10-11T16:08:08,Vitoria-Gasteiz,expenses,leisure,-65.22,-32192.47
buyer_6,Manuel,,ES74209567901087476583,TRX_N-00305-02827041,2022-10-11T19:35:02,Vitoria-Gasteiz,expenses,cash,-100.0,-32292.47
buyer_6,Manuel,,ES74209567901087476583,TRX_N-00306-76876650,2022-10-12T12:22:30,Vitoria-Gasteiz,expenses,repairs,-37.55,-32330.02
buyer_6,Manuel,,ES74209567901087476583,TRX_N-00307-28814100,2022-10-14T20:20:22,Vitoria-Gasteiz,expenses,food,-77.49,-32407.51
buyer_6,Manuel,,ES74209567901087476583,TRX_N-00308-36325982,2022-10-15T19:55:36,Vitoria-Gasteiz,expenses,cash,-100.0,-32507.51
buyer_6,Manuel,,ES74209567901087476583,TRX_N-00309-87438332,2022-10-15T07:53:23,Vitoria-Gasteiz,expenses,gifts,-520.33,-33027.84
buyer_6,Manuel,,ES74209567901087476583,TRX_N-00310-21157447,2022-10-17T13:03:43,Sestao,expenses,leisure,-71.73,-33099.57
buyer_6,Manuel,,ES74209567901087476583,TRX_N-00311-33096412,2022-10-18T11:00:18,Vitoria-Gasteiz,expenses,leisure,-72.45,-33172.02
buyer_6,Manuel,,ES74209567901087476583,TRX_N-00312-68694050,2022-10-19T06:59:39,Vitoria-Gasteiz,expenses,leisure,-67.64,-33239.66
buyer_6,Manuel,,ES74209567901087476583,TRX_N-00313-91621578,2022-10-23T16:36:26,Vitoria-Gasteiz,expenses,repairs,-208.98,-33448.64
buyer_6,Manuel,,ES74209567901087476583,TRX_N-00314-20081516,2022-10-27T11:45:50,Vitoria-Gasteiz,expenses,education,-44.04,-33492.68
buyer_6,Manuel,,ES74209567901087476583,TRX_N-00315-87360537,2022-10-31T17:37:06,Vitoria-Gasteiz,expenses,gifts,-188.21,-33680.89
buyer_6,Manuel,,ES74209567901087476583,TRX_N-00316-39671704,2022-11-01T16:03:19,Vitoria-Gasteiz,incomes,salary,1370.54,-32310.35
buyer_6,Manuel,,ES74209567901087476583,TRX_N-00317-57156570,2022-11-01T18:12:59,Vitoria-Gasteiz,expenses,repairs,-252.33,-32562.68
buyer_6,Manuel,,ES74209567901087476583,TRX_N-00318-44575814,2022-11-02T16:30:15,Vitoria-Gasteiz,expenses,transport,-56.97,-32619.65
buyer_6,Manuel,,ES74209567901087476583,TRX_N-00319-17403738,2022-11-04T20:29:55,Vitoria-Gasteiz,expenses,mortgage,-879.67,-33499.32
buyer_6,Manuel,,ES74209567901087476583,TRX_N-00320-93972994,2022-11-04T12:26:38,Elciego,expenses,food,-60.72,-33560.04
buyer_6,Manuel,,ES74209567901087476583,TRX_N-00321-32104699,2022-11-05T20:56:51,Vitoria-Gasteiz,expenses,leisure,-51.24,-33611.28
buyer_6,Manuel,,ES74209567901087476583,TRX_N-00322-51272794,2022-11-06T14:22:50,Vitoria-Gasteiz,expenses,water,-35.97,-33647.25
buyer_6,Manuel,,ES74209567901087476583,TRX_N-00323-51558095,2022-11-07T12:21:17,Vitoria-Gasteiz,expenses,gas,-37.89,-33685.14
buyer_6,Manuel,,ES74209567901087476583,TRX_N-00324-99374169,2022-11-08T19:33:09,Vitoria-Gasteiz,expenses,phone,-36.46,-33721.6
buyer_6,Manuel,,ES74209567901087476583,TRX_N-00325-13191137,2022-11-08T10:33:30,Vitoria-Gasteiz,expenses,electricity,-40.65,-33762.25
buyer_6,Manuel,,ES74209567901087476583,TRX_N-00326-32367288,2022-11-08T17:31:47,Vitoria-Gasteiz,expenses,internet,-42.0,-33804.25
buyer_6,Manuel,,ES74209567901087476583,TRX_N-00327-19316308,2022-11-10T07:09:41,Vitoria-Gasteiz,expenses,cash,-100.0,-33904.25
buyer_6,Manuel,,ES74209567901087476583,TRX_N-00328-77301594,2022-11-11T11:17:19,Vitoria-Gasteiz,expenses,transport,-64.81,-33969.06
buyer_6,Manuel,,ES74209567901087476583,TRX_N-00329-11893430,2022-11-11T11:19:34,Vitoria-Gasteiz,expenses,cash,-100.0,-34069.06
buyer_6,Manuel,,ES74209567901087476583,TRX_N-00330-95048998,2022-11-12T15:21:43,Vitoria-Gasteiz,expenses,cash,-100.0,-34169.06
buyer_6,Manuel,,ES74209567901087476583,TRX_N-00331-00633099,2022-11-14T16:44:16,Vitoria-Gasteiz,expenses,appliances,-321.34,-34490.4
buyer_6,Manuel,,ES74209567901087476583,TRX_N-00332-86612771,2022-11-15T10:28:58,Vitoria-Gasteiz,expenses,food,-100.89,-34591.29
buyer_6,Manuel,,ES74209567901087476583,TRX_N-00333-12540577,2022-11-15T14:43:38,Vitoria-Gasteiz,expenses,clothing,-103.1,-34694.39
buyer_6,Manuel,,ES74209567901087476583,TRX_N-00334-86601521,2022-11-17T22:24:01,Vitoria-Gasteiz,expenses,clothing,-62.46,-34756.85
buyer_6,Manuel,,ES74209567901087476583,TRX_N-00335-28151255,2022-11-18T16:14:26,Vitoria-Gasteiz,expenses,leisure,-78.64,-34835.49
buyer_6,Manuel,,ES74209567901087476583,TRX_N-00336-14501903,2022-11-19T18:08:53,Vitoria-Gasteiz,expenses,leisure,-19.24,-34854.73
buyer_6,Manuel,,ES74209567901087476583,TRX_N-00337-09167847,2022-11-19T13:19:32,Vitoria-Gasteiz,expenses,cash,-100.0,-34954.73
buyer_6,Manuel,,ES74209567901087476583,TRX_N-00338-99816194,2022-11-20T13:34:00,Vitoria-Gasteiz,expenses,food,-77.29,-35032.02
buyer_6,Manuel,,ES74209567901087476583,TRX_N-00339-28734754,2022-11-20T18:59:50,Vitoria-Gasteiz,expenses,gifts,-451.83,-35483.85
buyer_6,Manuel,,ES74209567901087476583,TRX_N-00340-77835766,2022-11-24T09:47:56,Vitoria-Gasteiz,expenses,food,-65.35,-35549.2
buyer_6,Manuel,,ES74209567901087476583,TRX_N-00341-33581454,2022-11-28T11:24:14,Vitoria-Gasteiz,expenses,healthcare,-90.03,-35639.23
buyer_6,Manuel,,ES74209567901087476583,TRX_N-00342-96814330,2022-11-29T15:27:13,Vitoria-Gasteiz,expenses,transport,-55.99,-35695.22
buyer_6,Manuel,,ES74209567901087476583,TRX_N-00343-59068020,2022-11-30T09:05:28,Vitoria-Gasteiz,expenses,food,-86.77,-35781.99
buyer_6,Manuel,,ES74209567901087476583,TRX_N-00344-43851568,2022-11-30T20:39:53,Vitoria-Gasteiz,expenses,cash,-100.0,-35881.99
buyer_6,Manuel,,ES74209567901087476583,TRX_N-00345-76506852,2022-12-01T17:56:00,Vitoria-Gasteiz,incomes,salary,1370.54,-34511.45
buyer_6,Manuel,,ES74209567901087476583,TRX_N-00346-36307870,2022-12-01T17:56:00,Vitoria-Gasteiz,incomes,extra_income,151.06,-34360.39
buyer_6,Manuel,,ES74209567901087476583,TRX_N-00347-13374553,2022-12-01T17:56:00,Vitoria-Gasteiz,incomes,salary_bonus,1063.84,-33296.55
buyer_6,Manuel,,ES74209567901087476583,TRX_N-00348-08360780,2022-12-03T20:51:24,Vitoria-Gasteiz,expenses,appliances,-256.7,-33553.25
buyer_6,Manuel,,ES74209567901087476583,TRX_N-00349-58468621,2022-12-04T09:56:48,Vitoria-Gasteiz,expenses,mortgage,-879.67,-34432.92
buyer_6,Manuel,,ES74209567901087476583,TRX_N-00350-10675002,2022-12-04T12:27:19,Galdakao,expenses,food,-103.27,-34536.19
buyer_6,Manuel,,ES74209567901087476583,TRX_N-00351-80299744,2022-12-05T15:45:07,Vitoria-Gasteiz,expenses,water,-34.61,-34570.8
buyer_6,Manuel,,ES74209567901087476583,TRX_N-00352-19683110,2022-12-05T10:29:44,Vitoria-Gasteiz,expenses,electricity,-41.94,-34612.74
buyer_6,Manuel,,ES74209567901087476583,TRX_N-00353-19697071,2022-12-05T10:22:39,Vitoria-Gasteiz,expenses,repairs,-67.09,-34679.83
buyer_6,Manuel,,ES74209567901087476583,TRX_N-00354-96722263,2022-12-06T16:23:09,Vitoria-Gasteiz,expenses,internet,-42.0,-34721.83
buyer_6,Manuel,,ES74209567901087476583,TRX_N-00355-22919472,2022-12-06T09:26:33,Vitoria-Gasteiz,expenses,phone,-31.15,-34752.98
buyer_6,Manuel,,ES74209567901087476583,TRX_N-00356-30869319,2022-12-06T18:33:32,Vitoria-Gasteiz,expenses,cash,-100.0,-34852.98
buyer_6,Manuel,,ES74209567901087476583,TRX_N-00357-24202257,2022-12-07T14:14:52,Vitoria-Gasteiz,expenses,transport,-87.7,-34940.68
buyer_6,Manuel,,ES74209567901087476583,TRX_N-00358-43730220,2022-12-07T08:47:55,Vitoria-Gasteiz,expenses,repairs,-149.04,-35089.72
buyer_6,Manuel,,ES74209567901087476583,TRX_N-00359-74434750,2022-12-08T08:43:29,Vitoria-Gasteiz,expenses,gas,-107.17,-35196.89
buyer_6,Manuel,,ES74209567901087476583,TRX_N-00360-49742670,2022-12-08T03:30:51,Vitoria-Gasteiz,expenses,healthcare,-80.3,-35277.19
buyer_6,Manuel,,ES74209567901087476583,TRX_N-00361-51167002,2022-12-11T15:16:47,Vitoria-Gasteiz,expenses,leisure,-18.26,-35295.45
buyer_6,Manuel,,ES74209567901087476583,TRX_N-00362-43741412,2022-12-11T08:03:19,Vitoria-Gasteiz,expenses,education,-55.78,-35351.23
buyer_6,Manuel,,ES74209567901087476583,TRX_N-00363-91188257,2022-12-15T08:10:36,Vitoria-Gasteiz,expenses,food,-85.16,-35436.39
buyer_6,Manuel,,ES74209567901087476583,TRX_N-00364-00397493,2022-12-19T20:04:16,Berango,expenses,repairs,-218.05,-35654.44
buyer_6,Manuel,,ES74209567901087476583,TRX_N-00365-40544274,2022-12-20T18:40:26,Berango,expenses,travel,-1445.96,-37100.4
buyer_6,Manuel,,ES74209567901087476583,TRX_N-00366-85666589,2022-12-21T09:50:44,Vitoria-Gasteiz,expenses,leisure,-69.38,-37169.78
buyer_6,Manuel,,ES74209567901087476583,TRX_N-00367-86851164,2022-12-21T14:35:12,Vitoria-Gasteiz,expenses,gifts,-154.88,-37324.66
buyer_6,Manuel,,ES74209567901087476583,TRX_N-00368-99026736,2022-12-23T18:03:25,Labastida,expenses,repairs,-245.78,-37570.44
buyer_6,Manuel,,ES74209567901087476583,TRX_N-00369-43967410,2022-12-24T12:10:27,Vitoria-Gasteiz,expenses,appliances,-157.04,-37727.48
buyer_6,Manuel,,ES74209567901087476583,TRX_N-00370-62615203,2022-12-26T12:07:07,Vitoria-Gasteiz,expenses,food,-81.78,-37809.26
buyer_6,Manuel,,ES74209567901087476583,TRX_N-00371-44732091,2022-12-26T14:51:11,Vitoria-Gasteiz,expenses,leisure,-69.65,-37878.91
buyer_6,Manuel,,ES74209567901087476583,TRX_N-00372-65887600,2022-12-27T13:34:49,Vitoria-Gasteiz,expenses,leisure,-23.03,-37901.94
buyer_6,Manuel,,ES74209567901087476583,TRX_N-00373-55842953,2022-12-27T20:34:28,Vitoria-Gasteiz,expenses,education,-58.99,-37960.93
buyer_6,Manuel,,ES74209567901087476583,TRX_N-00374-72684631,2022-12-28T17:17:44,Vitoria-Gasteiz,expenses,education,-78.28,-38039.21
buyer_6,Manuel,,ES74209567901087476583,TRX_N-00375-18367495,2023-01-01T08:17:46,Vitoria-Gasteiz,incomes,salary,1419.19,-36620.02
buyer_6,Manuel,,ES74209567901087476583,TRX_N-00376-53001672,2023-01-01T09:02:20,Vitoria-Gasteiz,expenses,food,-73.84,-36693.86
buyer_6,Manuel,,ES74209567901087476583,TRX_N-00377-02280167,2023-01-01T07:36:23,Vitoria-Gasteiz,expenses,leisure,-71.72,-36765.58
buyer_6,Manuel,,ES74209567901087476583,TRX_N-00378-31676140,2023-01-02T20:58:24,Vitoria-Gasteiz,expenses,food,-108.16,-36873.74
buyer_6,Manuel,,ES74209567901087476583,TRX_N-00379-78658090,2023-01-02T13:05:06,Vitoria-Gasteiz,expenses,clothing,-118.95,-36992.69
buyer_6,Manuel,,ES74209567901087476583,TRX_N-00380-39657093,2023-01-04T14:45:47,Vitoria-Gasteiz,expenses,mortgage,-879.67,-37872.36
buyer_6,Manuel,,ES74209567901087476583,TRX_N-00381-60859924,2023-01-04T15:45:36,Vitoria-Gasteiz,expenses,repairs,-54.36,-37926.72
buyer_6,Manuel,,ES74209567901087476583,TRX_N-00382-98948655,2023-01-05T22:01:18,Vitoria-Gasteiz,expenses,gas,-36.11,-37962.83
buyer_6,Manuel,,ES74209567901087476583,TRX_N-00383-33283766,2023-01-05T08:39:36,Vitoria-Gasteiz,expenses,phone,-35.67,-37998.5
buyer_6,Manuel,,ES74209567901087476583,TRX_N-00384-62704169,2023-01-06T15:06:11,Vitoria-Gasteiz,expenses,appliances,-274.6,-38273.1
buyer_6,Manuel,,ES74209567901087476583,TRX_N-00385-85499689,2023-01-08T09:23:04,Vitoria-Gasteiz,expenses,water,-31.89,-38304.99
buyer_6,Manuel,,ES74209567901087476583,TRX_N-00386-61704119,2023-01-08T13:54:45,Vitoria-Gasteiz,expenses,electricity,-56.41,-38361.4
buyer_6,Manuel,,ES74209567901087476583,TRX_N-00387-90945015,2023-01-08T13:29:28,Vitoria-Gasteiz,expenses,internet,-42.0,-38403.4
buyer_6,Manuel,,ES74209567901087476583,TRX_N-00388-04332398,2023-01-08T13:10:46,Vitoria-Gasteiz,expenses,transport,-67.41,-38470.81
buyer_6,Manuel,,ES74209567901087476583,TRX_N-00389-14106075,2023-01-09T17:35:24,Vitoria-Gasteiz,expenses,education,-46.39,-38517.2
buyer_6,Manuel,,ES74209567901087476583,TRX_N-00390-39834398,2023-01-09T17:17:57,Vitoria-Gasteiz,expenses,cash,-100.0,-38617.2
buyer_6,Manuel,,ES74209567901087476583,TRX_N-00391-67447094,2023-01-09T04:49:35,Hondarribia,expenses,gifts,-195.12,-38812.32
buyer_6,Manuel,,ES74209567901087476583,TRX_N-00392-22806754,2023-01-10T19:19:52,Sestao,expenses,transport,-64.5,-38876.82
buyer_6,Manuel,,ES74209567901087476583,TRX_N-00393-31128415,2023-01-13T08:44:45,Vitoria-Gasteiz,expenses,food,-63.52,-38940.34
buyer_6,Manuel,,ES74209567901087476583,TRX_N-00394-47301614,2023-01-16T14:07:58,Vitoria-Gasteiz,expenses,gifts,-407.19,-39347.53
buyer_6,Manuel,,ES74209567901087476583,TRX_N-00395-26830051,2023-01-19T10:06:53,Vitoria-Gasteiz,expenses,food,-73.86,-39421.39
buyer_6,Manuel,,ES74209567901087476583,TRX_N-00396-81517467,2023-01-20T20:27:00,Pasaia,expenses,gifts,-571.97,-39993.36
buyer_6,Manuel,,ES74209567901087476583,TRX_N-00397-44941929,2023-01-22T15:35:09,Vitoria-Gasteiz,expenses,repairs,-33.73,-40027.09
buyer_6,Manuel,,ES74209567901087476583,TRX_N-00398-07065703,2023-01-23T15:56:15,Vitoria-Gasteiz,expenses,leisure,-44.47,-40071.56
buyer_6,Manuel,,ES74209567901087476583,TRX_N-00399-38827698,2023-01-23T11:30:27,Vitoria-Gasteiz,expenses,cash,-100.0,-40171.56
buyer_6,Manuel,,ES74209567901087476583,TRX_N-00400-34621306,2023-01-27T19:36:30,Vitoria-Gasteiz,expenses,food,-107.96,-40279.52
buyer_6,Manuel,,ES74209567901087476583,TRX_N-00401-37616054,2023-01-27T12:24:21,Vitoria-Gasteiz,expenses,leisure,-59.92,-40339.44
buyer_6,Manuel,,ES74209567901087476583,TRX_N-00402-00408015,2023-01-30T15:02:21,Vitoria-Gasteiz,expenses,transport,-56.24,-40395.68
buyer_6,Manuel,,ES74209567901087476583,TRX_N-00403-02323383,2023-02-01T13:23:40,Vitoria-Gasteiz,incomes,salary,1419.19,-38976.49
buyer_6,Manuel,,ES74209567901087476583,TRX_N-00404-75550255,2023-02-03T09:34:11,Vitoria-Gasteiz,expenses,cash,-100.0,-39076.49
buyer_6,Manuel,,ES74209567901087476583,TRX_N-00405-59965626,2023-02-04T20:50:03,Vitoria-Gasteiz,expenses,mortgage,-879.67,-39956.16
buyer_6,Manuel,,ES74209567901087476583,TRX_N-00406-62988556,2023-02-04T14:46:51,Sopela,expenses,healthcare,-86.45,-40042.61
buyer_6,Manuel,,ES74209567901087476583,TRX_N-00407-18389227,2023-02-05T15:22:04,Vitoria-Gasteiz,expenses,electricity,-87.51,-40130.12
buyer_6,Manuel,,ES74209567901087476583,TRX_N-00408-71077164,2023-02-05T19:57:37,Vitoria-Gasteiz,expenses,clothing,-116.32,-40246.44
buyer_6,Manuel,,ES74209567901087476583,TRX_N-00409-14555607,2023-02-07T08:06:56,Vitoria-Gasteiz,expenses,transport,-68.75,-40315.19
buyer_6,Manuel,,ES74209567901087476583,TRX_N-00410-39060165,2023-02-08T14:18:01,Vitoria-Gasteiz,expenses,water,-33.4,-40348.59
buyer_6,Manuel,,ES74209567901087476583,TRX_N-00411-51638982,2023-02-08T14:10:58,Vitoria-Gasteiz,expenses,gas,-72.23,-40420.82
buyer_6,Manuel,,ES74209567901087476583,TRX_N-00412-69867926,2023-02-08T08:55:40,Vitoria-Gasteiz,expenses,internet,-42.0,-40462.82
buyer_6,Manuel,,ES74209567901087476583,TRX_N-00413-72745484,2023-02-08T00:47:00,Vitoria-Gasteiz,expenses,phone,-42.07,-40504.89
buyer_6,Manuel,,ES74209567901087476583,TRX_N-00414-49042012,2023-02-08T07:02:00,Vitoria-Gasteiz,expenses,food,-108.77,-40613.66
buyer_6,Manuel,,ES74209567901087476583,TRX_N-00415-09486175,2023-02-12T13:45:56,Vitoria-Gasteiz,expenses,transport,-71.19,-40684.85
buyer_6,Manuel,,ES74209567901087476583,TRX_N-00416-38076204,2023-02-12T17:20:32,Vitoria-Gasteiz,expenses,leisure,-27.43,-40712.28
buyer_6,Manuel,,ES74209567901087476583,TRX_N-00417-52781173,2023-02-13T10:10:25,Vitoria-Gasteiz,expenses,transport,-75.07,-40787.35
buyer_6,Manuel,,ES74209567901087476583,TRX_N-00418-50979215,2023-02-13T15:39:13,Vitoria-Gasteiz,expenses,cash,-100.0,-40887.35
buyer_6,Manuel,,ES74209567901087476583,TRX_N-00419-76403552,2023-02-14T16:42:37,Vitoria-Gasteiz,expenses,food,-104.05,-40991.4
buyer_6,Manuel,,ES74209567901087476583,TRX_N-00420-18756360,2023-02-14T09:03:39,Vitoria-Gasteiz,expenses,repairs,-137.13,-41128.53
buyer_6,Manuel,,ES74209567901087476583,TRX_N-00421-99817231,2023-02-14T14:30:31,Vitoria-Gasteiz,expenses,gifts,-640.67,-41769.2
buyer_6,Manuel,,ES74209567901087476583,TRX_N-00422-09658548,2023-02-16T21:19:57,Vitoria-Gasteiz,expenses,education,-44.96,-41814.16
buyer_6,Manuel,,ES74209567901087476583,TRX_N-00423-15411888,2023-02-17T17:41:16,Vitoria-Gasteiz,expenses,food,-63.41,-41877.57
buyer_6,Manuel,,ES74209567901087476583,TRX_N-00424-47962239,2023-02-17T13:09:02,Vitoria-Gasteiz,expenses,cash,-100.0,-41977.57
buyer_6,Manuel,,ES74209567901087476583,TRX_N-00425-41408608,2023-02-18T10:38:18,Oyón-Oion,expenses,food,-95.75,-42073.32
buyer_6,Manuel,,ES74209567901087476583,TRX_N-00426-61191064,2023-02-18T08:18:11,Vitoria-Gasteiz,expenses,leisure,-29.92,-42103.24
buyer_6,Manuel,,ES74209567901087476583,TRX_N-00427-53134190,2023-02-18T11:47:44,Vitoria-Gasteiz,expenses,gifts,-454.33,-42557.57
buyer_6,Manuel,,ES74209567901087476583,TRX_N-00428-90626615,2023-02-19T14:08:11,Santurtzi,expenses,food,-97.59,-42655.16
buyer_6,Manuel,,ES74209567901087476583,TRX_N-00429-59889131,2023-02-20T19:02:48,Vitoria-Gasteiz,expenses,food,-60.57,-42715.73
buyer_6,Manuel,,ES74209567901087476583,TRX_N-00430-33995711,2023-02-20T11:54:16,Vitoria-Gasteiz,expenses,appliances,-221.16,-42936.89
buyer_6,Manuel,,ES74209567901087476583,TRX_N-00431-12748477,2023-02-21T12:09:07,Hernani,expenses,appliances,-255.25,-43192.14
buyer_6,Manuel,,ES74209567901087476583,TRX_N-00432-00621391,2023-02-23T02:04:17,Vitoria-Gasteiz,expenses,food,-97.75,-43289.89
buyer_6,Manuel,,ES74209567901087476583,TRX_N-00433-35882251,2023-02-23T09:39:19,Vitoria-Gasteiz,expenses,repairs,-315.68,-43605.57
buyer_6,Manuel,,ES74209567901087476583,TRX_N-00434-82204737,2023-02-25T09:08:37,Vitoria-Gasteiz,expenses,cash,-100.0,-43705.57
buyer_6,Manuel,,ES74209567901087476583,TRX_N-00435-35444094,2023-02-25T15:26:04,Errenteria,expenses,gifts,-620.84,-44326.41
buyer_6,Manuel,,ES74209567901087476583,TRX_N-00436-87177690,2023-02-28T16:52:14,Vitoria-Gasteiz,expenses,repairs,-128.25,-44454.66
buyer_6,Manuel,,ES74209567901087476583,TRX_N-00437-28045338,2023-03-01T14:25:29,Vitoria-Gasteiz,incomes,salary,1419.19,-43035.47
buyer_6,Manuel,,ES74209567901087476583,TRX_N-00438-71414467,2023-03-01T09:04:57,Vitoria-Gasteiz,expenses,transport,-74.69,-43110.16
buyer_6,Manuel,,ES74209567901087476583,TRX_N-00439-83996198,2023-03-01T04:49:34,Vitoria-Gasteiz,expenses,clothing,-128.32,-43238.48
buyer_6,Manuel,,ES74209567901087476583,TRX_N-00440-95698459,2023-03-02T09:12:57,Portugalete,expenses,food,-86.94,-43325.42
buyer_6,Manuel,,ES74209567901087476583,TRX_N-00441-31730705,2023-03-03T11:28:26,Vitoria-Gasteiz,expenses,transport,-81.58,-43407.0
buyer_6,Manuel,,ES74209567901087476583,TRX_N-00442-15239667,2023-03-04T09:27:48,Vitoria-Gasteiz,expenses,mortgage,-879.67,-44286.67
buyer_6,Manuel,,ES74209567901087476583,TRX_N-00443-40001304,2023-03-05T19:13:54,Vitoria-Gasteiz,expenses,water,-22.0,-44308.67
buyer_6,Manuel,,ES74209567901087476583,TRX_N-00444-87494120,2023-03-05T11:52:30,Vitoria-Gasteiz,expenses,electricity,-77.47,-44386.14
buyer_6,Manuel,,ES74209567901087476583,TRX_N-00445-68069166,2023-03-05T08:09:04,Vitoria-Gasteiz,expenses,phone,-30.38,-44416.52
buyer_6,Manuel,,ES74209567901087476583,TRX_N-00446-12057363,2023-03-06T16:42:48,Vitoria-Gasteiz,expenses,cash,-100.0,-44516.52
buyer_6,Manuel,,ES74209567901087476583,TRX_N-00447-05884677,2023-03-07T18:25:35,Vitoria-Gasteiz,expenses,food,-87.31,-44603.83
buyer_6,Manuel,,ES74209567901087476583,TRX_N-00448-14416264,2023-03-08T20:21:26,Vitoria-Gasteiz,expenses,gas,-113.29,-44717.12
buyer_6,Manuel,,ES74209567901087476583,TRX_N-00449-77488337,2023-03-08T15:46:32,Vitoria-Gasteiz,expenses,internet,-42.0,-44759.12
buyer_6,Manuel,,ES74209567901087476583,TRX_N-00450-66922506,2023-03-08T14:47:05,Basauri,expenses,cash,-100.0,-44859.12
buyer_6,Manuel,,ES74209567901087476583,TRX_N-00451-10399553,2023-03-08T16:01:09,Vitoria-Gasteiz,expenses,repairs,-316.41,-45175.53
buyer_6,Manuel,,ES74209567901087476583,TRX_N-00452-43454540,2023-03-09T12:50:05,Vitoria-Gasteiz,expenses,cash,-100.0,-45275.53
buyer_6,Manuel,,ES74209567901087476583,TRX_N-00453-54841829,2023-03-12T19:53:49,Vitoria-Gasteiz,expenses,clothing,-121.74,-45397.27
buyer_6,Manuel,,ES74209567901087476583,TRX_N-00454-95256191,2023-03-13T18:31:05,Vitoria-Gasteiz,expenses,clothing,-128.43,-45525.7
buyer_6,Manuel,,ES74209567901087476583,TRX_N-00455-44609999,2023-03-14T11:10:07,Vitoria-Gasteiz,expenses,transport,-74.54,-45600.24
buyer_6,Manuel,,ES74209567901087476583,TRX_N-00456-23895741,2023-03-15T12:14:59,Vitoria-Gasteiz,expenses,transport,-44.84,-45645.08
buyer_6,Manuel,,ES74209567901087476583,TRX_N-00457-08221607,2023-03-15T19:25:17,Vitoria-Gasteiz,expenses,gifts,-793.71,-46438.79
buyer_6,Manuel,,ES74209567901087476583,TRX_N-00458-70794871,2023-03-19T11:01:05,Vitoria-Gasteiz,expenses,appliances,-302.97,-46741.76
buyer_6,Manuel,,ES74209567901087476583,TRX_N-00459-73977270,2023-03-20T14:24:22,Vitoria-Gasteiz,expenses,transport,-53.75,-46795.51
buyer_6,Manuel,,ES74209567901087476583,TRX_N-00460-63285153,2023-03-23T21:02:30,Santurtzi,expenses,transport,-72.03,-46867.54
buyer_6,Manuel,,ES74209567901087476583,TRX_N-00461-93165907,2023-03-25T17:24:44,Bilbao,expenses,transport,-63.5,-46931.04
buyer_6,Manuel,,ES74209567901087476583,TRX_N-00462-16412285,2023-03-25T20:46:50,Vitoria-Gasteiz,expenses,cash,-100.0,-47031.04
buyer_6,Manuel,,ES74209567901087476583,TRX_N-00463-20324693,2023-03-27T19:18:01,Vitoria-Gasteiz,expenses,cash,-100.0,-47131.04
buyer_6,Manuel,,ES74209567901087476583,TRX_N-00464-89134017,2023-03-28T19:20:17,Errenteria,expenses,leisure,-60.4,-47191.44
buyer_6,Manuel,,ES74209567901087476583,TRX_N-00465-52065942,2023-03-28T22:24:54,Vitoria-Gasteiz,expenses,clothing,-86.33,-47277.77
buyer_6,Manuel,,ES74209567901087476583,TRX_N-00466-82102266,2023-03-29T07:04:58,Labastida,expenses,food,-86.99,-47364.76
buyer_6,Manuel,,ES74209567901087476583,TRX_N-00467-14043396,2023-03-29T08:19:34,Vitoria-Gasteiz,expenses,healthcare,-57.29,-47422.05
buyer_6,Manuel,,ES74209567901087476583,TRX_N-00468-01992657,2023-03-29T22:59:07,Lasarte-Oria,expenses,appliances,-225.33,-47647.38
buyer_6,Manuel,,ES74209567901087476583,TRX_N-00469-72415932,2023-03-30T17:42:49,Vitoria-Gasteiz,expenses,food,-69.94,-47717.32
buyer_6,Manuel,,ES74209567901087476583,TRX_N-00470-66817407,2023-03-30T20:15:19,Vitoria-Gasteiz,expenses,healthcare,-120.87,-47838.19
buyer_6,Manuel,,ES74209567901087476583,TRX_N-00471-37812210,2023-03-31T08:23:49,Vitoria-Gasteiz,expenses,cash,-100.0,-47938.19
buyer_6,Manuel,,ES74209567901087476583,TRX_N-00472-63122524,2023-04-01T02:06:54,Vitoria-Gasteiz,incomes,salary,1419.19,-46519.0
buyer_6,Manuel,,ES74209567901087476583,TRX_N-00473-98904172,2023-04-01T02:06:54,Vitoria-Gasteiz,incomes,extra_income,151.06,-46367.94
buyer_6,Manuel,,ES74209567901087476583,TRX_N-00474-24845040,2023-04-01T14:33:14,Vitoria-Gasteiz,expenses,clothing,-64.53,-46432.47
buyer_6,Manuel,,ES74209567901087476583,TRX_N-00475-16849157,2023-04-01T08:02:46,Labastida,expenses,repairs,-197.96,-46630.43
buyer_6,Manuel,,ES74209567901087476583,TRX_N-00476-05839813,2023-04-02T19:25:43,Vitoria-Gasteiz,expenses,education,-66.51,-46696.94
buyer_6,Manuel,,ES74209567901087476583,TRX_N-00477-37680705,2023-04-02T12:13:42,Durango,expenses,repairs,-153.17,-46850.11
buyer_6,Manuel,,ES74209567901087476583,TRX_N-00478-07086664,2023-04-03T08:26:38,Vitoria-Gasteiz,expenses,healthcare,-142.25,-46992.36
buyer_6,Manuel,,ES74209567901087476583,TRX_N-00479-57176898,2023-04-04T18:53:47,Vitoria-Gasteiz,expenses,mortgage,-879.67,-47872.03
buyer_6,Manuel,,ES74209567901087476583,TRX_N-00480-41751428,2023-04-04T18:11:45,Santurtzi,expenses,leisure,-52.19,-47924.22
buyer_6,Manuel,,ES74209567901087476583,TRX_N-00481-54853198,2023-04-04T16:41:11,Vitoria-Gasteiz,expenses,cash,-100.0,-48024.22
buyer_6,Manuel,,ES74209567901087476583,TRX_N-00482-39806540,2023-04-05T10:01:56,Vitoria-Gasteiz,expenses,water,-30.78,-48055.0
buyer_6,Manuel,,ES74209567901087476583,TRX_N-00483-32003061,2023-04-05T07:54:32,Vitoria-Gasteiz,expenses,phone,-44.91,-48099.91
buyer_6,Manuel,,ES74209567901087476583,TRX_N-00484-80841649,2023-04-05T13:02:24,Vitoria-Gasteiz,expenses,transport,-53.51,-48153.42
buyer_6,Manuel,,ES74209567901087476583,TRX_N-00485-11363596,2023-04-05T12:07:12,Vitoria-Gasteiz,expenses,cash,-100.0,-48253.42
buyer_6,Manuel,,ES74209567901087476583,TRX_N-00486-40829624,2023-04-06T17:56:43,Vitoria-Gasteiz,expenses,gas,-93.27,-48346.69
buyer_6,Manuel,,ES74209567901087476583,TRX_N-00487-33525400,2023-04-06T19:58:40,Vitoria-Gasteiz,expenses,internet,-42.0,-48388.69
buyer_6,Manuel,,ES74209567901087476583,TRX_N-00488-20802151,2023-04-07T20:12:49,Zuia,expenses,food,-97.77,-48486.46
buyer_6,Manuel,,ES74209567901087476583,TRX_N-00489-08980603,2023-04-07T09:29:06,Vitoria-Gasteiz,expenses,leisure,-61.58,-48548.04
buyer_6,Manuel,,ES74209567901087476583,TRX_N-00490-85771787,2023-04-07T15:37:31,Vitoria-Gasteiz,expenses,education,-77.86,-48625.9
buyer_6,Manuel,,ES74209567901087476583,TRX_N-00491-62397253,2023-04-08T20:44:22,Vitoria-Gasteiz,expenses,electricity,-85.79,-48711.69
buyer_6,Manuel,,ES74209567901087476583,TRX_N-00492-00552715,2023-04-08T14:45:32,Leioa,expenses,repairs,-107.88,-48819.57
buyer_6,Manuel,,ES74209567901087476583,TRX_N-00493-26046800,2023-04-14T16:07:47,Oyón-Oion,expenses,cash,-100.0,-48919.57
buyer_6,Manuel,,ES74209567901087476583,TRX_N-00494-63138575,2023-04-17T13:23:12,Vitoria-Gasteiz,expenses,food,-69.47,-48989.04
buyer_6,Manuel,,ES74209567901087476583,TRX_N-00495-84421507,2023-04-19T00:12:10,Vitoria-Gasteiz,expenses,education,-73.66,-49062.7
buyer_6,Manuel,,ES74209567901087476583,TRX_N-00496-65326276,2023-04-19T09:44:46,Vitoria-Gasteiz,expenses,cash,-100.0,-49162.7
buyer_6,Manuel,,ES74209567901087476583,TRX_N-00497-40943669,2023-04-20T22:56:13,Vitoria-Gasteiz,expenses,food,-65.65,-49228.35
buyer_6,Manuel,,ES74209567901087476583,TRX_N-00498-63093087,2023-04-20T14:54:05,Vitoria-Gasteiz,expenses,transport,-71.56,-49299.91
buyer_6,Manuel,,ES74209567901087476583,TRX_N-00499-40176976,2023-04-22T12:53:16,Vitoria-Gasteiz,expenses,cash,-100.0,-49399.91
buyer_6,Manuel,,ES74209567901087476583,TRX_N-00500-40603408,2023-04-23T10:36:59,Vitoria-Gasteiz,expenses,education,-54.73,-49454.64
buyer_6,Manuel,,ES74209567901087476583,TRX_N-00501-74834971,2023-04-24T19:24:49,Vitoria-Gasteiz,expenses,food,-109.99,-49564.63
buyer_6,Manuel,,ES74209567901087476583,TRX_N-00502-80912207,2023-04-24T14:07:29,Vitoria-Gasteiz,expenses,clothing,-133.68,-49698.31
buyer_6,Manuel,,ES74209567901087476583,TRX_N-00503-40006510,2023-04-24T03:57:00,Vitoria-Gasteiz,expenses,cash,-100.0,-49798.31
buyer_6,Manuel,,ES74209567901087476583,TRX_N-00504-50523910,2023-04-25T15:02:32,Zarautz,expenses,leisure,-20.26,-49818.57
buyer_6,Manuel,,ES74209567901087476583,TRX_N-00505-25106236,2023-04-26T16:30:19,Vitoria-Gasteiz,expenses,clothing,-91.48,-49910.05
buyer_6,Manuel,,ES74209567901087476583,TRX_N-00506-86084900,2023-04-30T13:05:21,Vitoria-Gasteiz,expenses,gifts,-114.69,-50024.74
buyer_6,Manuel,,ES74209567901087476583,TRX_N-00507-83633013,2023-05-01T13:36:05,Vitoria-Gasteiz,incomes,salary,1419.19,-48605.55
buyer_6,Manuel,,ES74209567901087476583,TRX_N-00508-58382379,2023-05-02T16:16:32,Vitoria-Gasteiz,expenses,food,-100.17,-48705.72
buyer_6,Manuel,,ES74209567901087476583,TRX_N-00509-19794841,2023-05-02T23:45:56,Vitoria-Gasteiz,expenses,healthcare,-149.57,-48855.29
buyer_6,Manuel,,ES74209567901087476583,TRX_N-00510-64943097,2023-05-02T14:58:08,Vitoria-Gasteiz,expenses,cash,-100.0,-48955.29
buyer_6,Manuel,,ES74209567901087476583,TRX_N-00511-51181141,2023-05-04T09:50:04,Vitoria-Gasteiz,expenses,mortgage,-879.67,-49834.96
buyer_6,Manuel,,ES74209567901087476583,TRX_N-00512-50391243,2023-05-05T20:44:40,Vitoria-Gasteiz,expenses,gas,-31.74,-49866.7
buyer_6,Manuel,,ES74209567901087476583,TRX_N-00513-02742016,2023-05-05T14:18:06,Vitoria-Gasteiz,expenses,food,-107.08,-49973.78
buyer_6,Manuel,,ES74209567901087476583,TRX_N-00514-60989688,2023-05-06T18:09:45,Vitoria-Gasteiz,expenses,food,-120.18,-50093.96
buyer_6,Manuel,,ES74209567901087476583,TRX_N-00515-85399742,2023-05-07T15:48:25,Vitoria-Gasteiz,expenses,water,-22.55,-50116.51
buyer_6,Manuel,,ES74209567901087476583,TRX_N-00516-08818754,2023-05-07T18:18:31,Vitoria-Gasteiz,expenses,electricity,-53.83,-50170.34
buyer_6,Manuel,,ES74209567901087476583,TRX_N-00517-59535955,2023-05-07T22:26:34,Vitoria-Gasteiz,expenses,phone,-30.37,-50200.71
buyer_6,Manuel,,ES74209567901087476583,TRX_N-00518-42036422,2023-05-07T19:47:19,Vitoria-Gasteiz,expenses,appliances,-393.56,-50594.27
buyer_6,Manuel,,ES74209567901087476583,TRX_N-00519-74614801,2023-05-07T16:38:38,Vitoria-Gasteiz,expenses,repairs,-90.67,-50684.94
buyer_6,Manuel,,ES74209567901087476583,TRX_N-00520-43927993,2023-05-08T08:39:10,Vitoria-Gasteiz,expenses,internet,-42.0,-50726.94
buyer_6,Manuel,,ES74209567901087476583,TRX_N-00521-17597864,2023-05-08T14:17:27,Vitoria-Gasteiz,expenses,transport,-48.8,-50775.74
buyer_6,Manuel,,ES74209567901087476583,TRX_N-00522-17025814,2023-05-09T12:24:16,Vitoria-Gasteiz,expenses,leisure,-20.91,-50796.65
buyer_6,Manuel,,ES74209567901087476583,TRX_N-00523-52590654,2023-05-11T20:25:04,Llodio,expenses,appliances,-348.58,-51145.23
buyer_6,Manuel,,ES74209567901087476583,TRX_N-00524-61014024,2023-05-11T20:23:15,Vitoria-Gasteiz,expenses,repairs,-259.41,-51404.64
buyer_6,Manuel,,ES74209567901087476583,TRX_N-00525-82758672,2023-05-12T08:31:17,Errenteria,expenses,transport,-79.9,-51484.54
buyer_6,Manuel,,ES74209567901087476583,TRX_N-00526-63017913,2023-05-13T19:54:45,Vitoria-Gasteiz,expenses,food,-81.51,-51566.05
buyer_6,Manuel,,ES74209567901087476583,TRX_N-00527-08395711,2023-05-13T17:46:13,Vitoria-Gasteiz,expenses,appliances,-218.16,-51784.21
buyer_6,Manuel,,ES74209567901087476583,TRX_N-00528-16476015,2023-05-14T17:51:42,Vitoria-Gasteiz,expenses,food,-111.96,-51896.17
buyer_6,Manuel,,ES74209567901087476583,TRX_N-00529-30046773,2023-05-15T18:58:15,Vitoria-Gasteiz,expenses,leisure,-50.59,-51946.76
buyer_6,Manuel,,ES74209567901087476583,TRX_N-00530-31945581,2023-05-17T08:57:37,Vitoria-Gasteiz,expenses,education,-48.33,-51995.09
buyer_6,Manuel,,ES74209567901087476583,TRX_N-00531-94666911,2023-05-17T09:30:32,Zuia,expenses,cash,-100.0,-52095.09
buyer_6,Manuel,,ES74209567901087476583,TRX_N-00532-12404979,2023-05-21T13:03:28,Vitoria-Gasteiz,expenses,cash,-100.0,-52195.09
buyer_6,Manuel,,ES74209567901087476583,TRX_N-00533-05262300,2023-05-23T19:47:43,Vitoria-Gasteiz,expenses,gifts,-664.78,-52859.87
buyer_6,Manuel,,ES74209567901087476583,TRX_N-00534-65569630,2023-05-27T15:20:15,Vitoria-Gasteiz,expenses,leisure,-50.28,-52910.15
buyer_6,Manuel,,ES74209567901087476583,TRX_N-00535-31904940,2023-05-28T20:48:50,Vitoria-Gasteiz,expenses,leisure,-42.49,-52952.64
buyer_6,Manuel,,ES74209567901087476583,TRX_N-00536-16320448,2023-05-28T19:57:04,Vitoria-Gasteiz,expenses,gifts,-114.56,-53067.2
buyer_6,Manuel,,ES74209567901087476583,TRX_N-00537-14711380,2023-05-29T11:17:51,Vitoria-Gasteiz,expenses,food,-66.05,-53133.25
buyer_6,Manuel,,ES74209567901087476583,TRX_N-00538-18438551,2023-05-29T09:55:33,Vitoria-Gasteiz,expenses,cash,-100.0,-53233.25
buyer_6,Manuel,,ES74209567901087476583,TRX_N-00539-96870680,2023-05-31T15:37:31,Donostia,expenses,cash,-100.0,-53333.25
buyer_6,Manuel,,ES74209567901087476583,TRX_N-00540-64218976,2023-05-31T12:19:22,Vitoria-Gasteiz,expenses,gifts,-592.27,-53925.52
buyer_6,Manuel,,ES74209567901087476583,TRX_N-00541-14627873,2023-06-01T19:07:15,Vitoria-Gasteiz,incomes,salary,1419.19,-52506.33
buyer_6,Manuel,,ES74209567901087476583,TRX_N-00542-63538403,2023-06-01T19:07:15,Vitoria-Gasteiz,incomes,salary_bonus,1033.08,-51473.25
buyer_6,Manuel,,ES74209567901087476583,TRX_N-00543-44668169,2023-06-01T14:51:37,Vitoria-Gasteiz,expenses,food,-81.79,-51555.04
buyer_6,Manuel,,ES74209567901087476583,TRX_N-00544-90936065,2023-06-03T15:26:51,Labastida,expenses,leisure,-28.0,-51583.04
buyer_6,Manuel,,ES74209567901087476583,TRX_N-00545-54874590,2023-06-04T13:13:27,Vitoria-Gasteiz,expenses,mortgage,-879.67,-52462.71
buyer_6,Manuel,,ES74209567901087476583,TRX_N-00546-60345332,2023-06-05T17:08:40,Vitoria-Gasteiz,expenses,gas,-84.45,-52547.16
buyer_6,Manuel,,ES74209567901087476583,TRX_N-00547-78439923,2023-06-05T22:08:57,Vitoria-Gasteiz,expenses,phone,-39.5,-52586.66
buyer_6,Manuel,,ES74209567901087476583,TRX_N-00548-73717337,2023-06-05T08:06:55,Vitoria-Gasteiz,expenses,transport,-82.66,-52669.32
buyer_6,Manuel,,ES74209567901087476583,TRX_N-00549-00702992,2023-06-05T17:16:06,Sestao,expenses,leisure,-81.25,-52750.57
buyer_6,Manuel,,ES74209567901087476583,TRX_N-00550-62015070,2023-06-06T17:53:29,Vitoria-Gasteiz,expenses,internet,-42.0,-52792.57
buyer_6,Manuel,,ES74209567901087476583,TRX_N-00551-72768029,2023-06-06T10:45:17,Vitoria-Gasteiz,expenses,cash,-100.0,-52892.57
buyer_6,Manuel,,ES74209567901087476583,TRX_N-00552-25775638,2023-06-07T22:50:14,Vitoria-Gasteiz,expenses,electricity,-52.76,-52945.33
buyer_6,Manuel,,ES74209567901087476583,TRX_N-00553-14846138,2023-06-07T11:04:40,Vitoria-Gasteiz,expenses,clothing,-79.14,-53024.47
buyer_6,Manuel,,ES74209567901087476583,TRX_N-00554-28252232,2023-06-07T03:40:46,Sopela,expenses,cash,-100.0,-53124.47
buyer_6,Manuel,,ES74209567901087476583,TRX_N-00555-06311536,2023-06-08T21:38:53,Vitoria-Gasteiz,expenses,water,-40.46,-53164.93
buyer_6,Manuel,,ES74209567901087476583,TRX_N-00556-81820679,2023-06-09T10:07:19,Vitoria-Gasteiz,expenses,leisure,-41.45,-53206.38
buyer_6,Manuel,,ES74209567901087476583,TRX_N-00557-91012759,2023-06-10T19:33:51,Vitoria-Gasteiz,expenses,leisure,-68.77,-53275.15
buyer_6,Manuel,,ES74209567901087476583,TRX_N-00558-19842441,2023-06-10T10:07:55,Vitoria-Gasteiz,expenses,education,-73.76,-53348.91
buyer_6,Manuel,,ES74209567901087476583,TRX_N-00559-68020086,2023-06-11T21:45:05,Vitoria-Gasteiz,expenses,cash,-100.0,-53448.91
buyer_6,Manuel,,ES74209567901087476583,TRX_N-00560-48827631,2023-06-12T16:42:45,Vitoria-Gasteiz,expenses,travel,-446.99,-53895.9
buyer_6,Manuel,,ES74209567901087476583,TRX_N-00561-83041693,2023-06-13T16:44:03,Vitoria-Gasteiz,expenses,cash,-100.0,-53995.9
buyer_6,Manuel,,ES74209567901087476583,TRX_N-00562-10577601,2023-06-15T11:57:03,Vitoria-Gasteiz,expenses,transport,-40.7,-54036.6
buyer_6,Manuel,,ES74209567901087476583,TRX_N-00563-41384581,2023-06-16T19:19:20,Vitoria-Gasteiz,expenses,repairs,-49.75,-54086.35
buyer_6,Manuel,,ES74209567901087476583,TRX_N-00564-55876276,2023-06-17T16:24:44,Vitoria-Gasteiz,expenses,clothing,-122.68,-54209.03
buyer_6,Manuel,,ES74209567901087476583,TRX_N-00565-73116757,2023-06-18T14:00:41,Vitoria-Gasteiz,expenses,repairs,-176.08,-54385.11
buyer_6,Manuel,,ES74209567901087476583,TRX_N-00566-82251891,2023-06-20T12:29:29,Vitoria-Gasteiz,expenses,education,-56.0,-54441.11
buyer_6,Manuel,,ES74209567901087476583,TRX_N-00567-76767301,2023-06-21T08:45:06,Vitoria-Gasteiz,expenses,leisure,-44.12,-54485.23
buyer_6,Manuel,,ES74209567901087476583,TRX_N-00568-45802204,2023-06-21T18:52:05,Amurrio,expenses,repairs,-254.1,-54739.33
buyer_6,Manuel,,ES74209567901087476583,TRX_N-00569-63458403,2023-06-21T08:17:28,Vitoria-Gasteiz,expenses,gifts,-45.9,-54785.23
buyer_6,Manuel,,ES74209567901087476583,TRX_N-00570-56275145,2023-06-22T20:22:01,Vitoria-Gasteiz,expenses,leisure,-61.4,-54846.63
buyer_6,Manuel,,ES74209567901087476583,TRX_N-00571-72381640,2023-06-22T15:31:32,Vitoria-Gasteiz,expenses,gifts,-53.24,-54899.87
buyer_6,Manuel,,ES74209567901087476583,TRX_N-00572-79929953,2023-06-23T14:20:11,Vitoria-Gasteiz,expenses,food,-93.05,-54992.92
buyer_6,Manuel,,ES74209567901087476583,TRX_N-00573-65811929,2023-06-25T11:51:38,Vitoria-Gasteiz,expenses,transport,-74.27,-55067.19
buyer_6,Manuel,,ES74209567901087476583,TRX_N-00574-10530033,2023-06-29T14:31:46,Vitoria-Gasteiz,expenses,food,-114.63,-55181.82
buyer_6,Manuel,,ES74209567901087476583,TRX_N-00575-29302614,2023-06-30T13:56:26,Vitoria-Gasteiz,expenses,transport,-70.66,-55252.48
buyer_6,Manuel,,ES74209567901087476583,TRX_N-00576-20409245,2023-06-30T14:52:24,Vitoria-Gasteiz,expenses,repairs,-275.99,-55528.47
buyer_6,Manuel,,ES74209567901087476583,TRX_N-00577-60604541,2023-07-01T11:22:35,Vitoria-Gasteiz,incomes,salary,1419.19,-54109.28
buyer_6,Manuel,,ES74209567901087476583,TRX_N-00578-53387739,2023-07-01T11:51:25,Llodio,expenses,education,-55.93,-54165.21
buyer_6,Manuel,,ES74209567901087476583,TRX_N-00579-46731273,2023-07-01T21:17:21,Vitoria-Gasteiz,expenses,cash,-100.0,-54265.21
buyer_6,Manuel,,ES74209567901087476583,TRX_N-00580-95708750,2023-07-01T10:49:33,Vitoria-Gasteiz,expenses,repairs,-217.09,-54482.3
buyer_6,Manuel,,ES74209567901087476583,TRX_N-00581-78426799,2023-07-02T14:35:12,Vitoria-Gasteiz,expenses,transport,-67.95,-54550.25
buyer_6,Manuel,,ES74209567901087476583,TRX_N-00582-72828713,2023-07-03T16:08:07,Arrasate,expenses,gifts,-205.62,-54755.87
buyer_6,Manuel,,ES74209567901087476583,TRX_N-00583-97260671,2023-07-04T08:48:08,Vitoria-Gasteiz,expenses,mortgage,-879.67,-55635.54
buyer_6,Manuel,,ES74209567901087476583,TRX_N-00584-30250829,2023-07-04T13:14:44,Vitoria-Gasteiz,expenses,repairs,-101.82,-55737.36
buyer_6,Manuel,,ES74209567901087476583,TRX_N-00585-65844585,2023-07-06T18:13:26,Vitoria-Gasteiz,expenses,phone,-41.07,-55778.43
buyer_6,Manuel,,ES74209567901087476583,TRX_N-00586-83255749,2023-07-06T15:05:10,Vitoria-Gasteiz,expenses,cash,-100.0,-55878.43
buyer_6,Manuel,,ES74209567901087476583,TRX_N-00587-94391039,2023-07-06T19:54:24,Vitoria-Gasteiz,expenses,repairs,-237.81,-56116.24
buyer_6,Manuel,,ES74209567901087476583,TRX_N-00588-51095926,2023-07-07T13:43:09,Vitoria-Gasteiz,expenses,electricity,-49.88,-56166.12
buyer_6,Manuel,,ES74209567901087476583,TRX_N-00589-79859478,2023-07-07T11:13:20,Vitoria-Gasteiz,expenses,gas,-97.6,-56263.72
buyer_6,Manuel,,ES74209567901087476583,TRX_N-00590-53356574,2023-07-08T22:36:26,Vitoria-Gasteiz,expenses,water,-21.81,-56285.53
buyer_6,Manuel,,ES74209567901087476583,TRX_N-00591-85836399,2023-07-08T18:23:25,Vitoria-Gasteiz,expenses,internet,-42.0,-56327.53
buyer_6,Manuel,,ES74209567901087476583,TRX_N-00592-66919001,2023-07-08T16:29:50,Vitoria-Gasteiz,expenses,food,-83.29,-56410.82
buyer_6,Manuel,,ES74209567901087476583,TRX_N-00593-38281529,2023-07-08T18:14:30,Vitoria-Gasteiz,expenses,cash,-100.0,-56510.82
buyer_6,Manuel,,ES74209567901087476583,TRX_N-00594-07791815,2023-07-09T18:32:58,Vitoria-Gasteiz,expenses,transport,-63.93,-56574.75
buyer_6,Manuel,,ES74209567901087476583,TRX_N-00595-25604456,2023-07-09T19:16:14,Vitoria-Gasteiz,expenses,leisure,-68.04,-56642.79
buyer_6,Manuel,,ES74209567901087476583,TRX_N-00596-94076101,2023-07-09T18:22:07,Vitoria-Gasteiz,expenses,education,-78.92,-56721.71
buyer_6,Manuel,,ES74209567901087476583,TRX_N-00597-16235508,2023-07-10T10:38:49,Vitoria-Gasteiz,expenses,appliances,-239.15,-56960.86
buyer_6,Manuel,,ES74209567901087476583,TRX_N-00598-97353093,2023-07-12T14:24:19,Vitoria-Gasteiz,expenses,food,-64.32,-57025.18
buyer_6,Manuel,,ES74209567901087476583,TRX_N-00599-36395005,2023-07-12T04:10:53,Vitoria-Gasteiz,expenses,cash,-100.0,-57125.18
buyer_6,Manuel,,ES74209567901087476583,TRX_N-00600-00470954,2023-07-13T20:14:49,Vitoria-Gasteiz,expenses,transport,-72.66,-57197.84
buyer_6,Manuel,,ES74209567901087476583,TRX_N-00601-22421859,2023-07-18T03:09:27,Vitoria-Gasteiz,expenses,cash,-100.0,-57297.84
buyer_6,Manuel,,ES74209567901087476583,TRX_N-00602-78026545,2023-07-20T13:46:53,Vitoria-Gasteiz,expenses,education,-43.86,-57341.7
buyer_6,Manuel,,ES74209567901087476583,TRX_N-00603-80269526,2023-07-22T08:38:27,Vitoria-Gasteiz,expenses,transport,-61.15,-57402.85
buyer_6,Manuel,,ES74209567901087476583,TRX_N-00604-65620939,2023-07-24T22:47:48,Vitoria-Gasteiz,expenses,transport,-68.16,-57471.01
buyer_6,Manuel,,ES74209567901087476583,TRX_N-00605-23562197,2023-07-24T11:50:47,Vitoria-Gasteiz,expenses,repairs,-114.63,-57585.64
buyer_6,Manuel,,ES74209567901087476583,TRX_N-00606-10616969,2023-07-25T17:44:55,Vitoria-Gasteiz,expenses,leisure,-75.51,-57661.15
buyer_6,Manuel,,ES74209567901087476583,TRX_N-00607-49034577,2023-07-25T12:07:32,Vitoria-Gasteiz,expenses,clothing,-138.47,-57799.62
buyer_6,Manuel,,ES74209567901087476583,TRX_N-00608-61779859,2023-07-25T19:55:52,Vitoria-Gasteiz,expenses,cash,-100.0,-57899.62
buyer_6,Manuel,,ES74209567901087476583,TRX_N-00609-99226699,2023-07-26T14:24:21,Vitoria-Gasteiz,expenses,food,-82.17,-57981.79
buyer_6,Manuel,,ES74209567901087476583,TRX_N-00610-48082893,2023-07-26T17:10:45,Getxo,expenses,repairs,-324.58,-58306.37
buyer_6,Manuel,,ES74209567901087476583,TRX_N-00611-32995492,2023-07-26T11:24:33,Zuia,expenses,gifts,-194.3,-58500.67
buyer_6,Manuel,,ES74209567901087476583,TRX_N-00612-68222649,2023-07-27T19:10:06,Santurtzi,expenses,transport,-72.87,-58573.54
buyer_6,Manuel,,ES74209567901087476583,TRX_N-00613-38027835,2023-07-28T17:48:28,Vitoria-Gasteiz,expenses,food,-114.82,-58688.36
buyer_6,Manuel,,ES74209567901087476583,TRX_N-00614-59514082,2023-07-31T19:24:47,Elciego,expenses,clothing,-68.05,-58756.41
buyer_6,Manuel,,ES74209567901087476583,TRX_N-00615-06813238,2023-08-01T15:56:13,Vitoria-Gasteiz,incomes,salary,1419.19,-57337.22
buyer_6,Manuel,,ES74209567901087476583,TRX_N-00616-73931865,2023-08-01T15:56:13,Vitoria-Gasteiz,incomes,extra_income,151.06,-57186.16
buyer_6,Manuel,,ES74209567901087476583,TRX_N-00617-71668783,2023-08-01T09:04:56,Vitoria-Gasteiz,expenses,education,-45.04,-57231.2
buyer_6,Manuel,,ES74209567901087476583,TRX_N-00618-83634047,2023-08-03T09:56:23,Vitoria-Gasteiz,expenses,food,-66.13,-57297.33
buyer_6,Manuel,,ES74209567901087476583,TRX_N-00619-50344931,2023-08-03T08:05:33,Sopela,expenses,gifts,-352.42,-57649.75
buyer_6,Manuel,,ES74209567901087476583,TRX_N-00620-66954473,2023-08-04T12:08:27,Vitoria-Gasteiz,expenses,mortgage,-879.67,-58529.42
buyer_6,Manuel,,ES74209567901087476583,TRX_N-00621-01727414,2023-08-04T06:48:38,Vitoria-Gasteiz,expenses,cash,-100.0,-58629.42
buyer_6,Manuel,,ES74209567901087476583,TRX_N-00622-38307558,2023-08-05T20:42:32,Vitoria-Gasteiz,expenses,water,-40.5,-58669.92
buyer_6,Manuel,,ES74209567901087476583,TRX_N-00623-85388732,2023-08-05T14:52:50,Vitoria-Gasteiz,expenses,gas,-43.97,-58713.89
buyer_6,Manuel,,ES74209567901087476583,TRX_N-00624-97920385,2023-08-05T21:17:51,Vitoria-Gasteiz,expenses,food,-107.89,-58821.78
buyer_6,Manuel,,ES74209567901087476583,TRX_N-00625-20701190,2023-08-06T15:45:58,Vitoria-Gasteiz,expenses,phone,-31.79,-58853.57
buyer_6,Manuel,,ES74209567901087476583,TRX_N-00626-05936392,2023-08-06T17:11:56,Vitoria-Gasteiz,expenses,gifts,-439.9,-59293.47
buyer_6,Manuel,,ES74209567901087476583,TRX_N-00627-91751515,2023-08-07T22:24:04,Vitoria-Gasteiz,expenses,transport,-78.4,-59371.87
buyer_6,Manuel,,ES74209567901087476583,TRX_N-00628-29601131,2023-08-08T11:35:37,Vitoria-Gasteiz,expenses,internet,-42.0,-59413.87
buyer_6,Manuel,,ES74209567901087476583,TRX_N-00629-56229608,2023-08-08T08:12:40,Vitoria-Gasteiz,expenses,electricity,-21.57,-59435.44
buyer_6,Manuel,,ES74209567901087476583,TRX_N-00630-97324580,2023-08-08T01:11:19,Vitoria-Gasteiz,expenses,transport,-74.6,-59510.04
buyer_6,Manuel,,ES74209567901087476583,TRX_N-00631-24228415,2023-08-09T21:50:55,Vitoria-Gasteiz,expenses,food,-102.98,-59613.02
buyer_6,Manuel,,ES74209567901087476583,TRX_N-00632-61465993,2023-08-10T14:08:26,Vitoria-Gasteiz,expenses,repairs,-50.4,-59663.42
buyer_6,Manuel,,ES74209567901087476583,TRX_N-00633-68695367,2023-08-11T19:50:25,Lasarte-Oria,expenses,leisure,-41.97,-59705.39
buyer_6,Manuel,,ES74209567901087476583,TRX_N-00634-74270070,2023-08-12T10:32:54,Vitoria-Gasteiz,expenses,transport,-73.69,-59779.08
buyer_6,Manuel,,ES74209567901087476583,TRX_N-00635-44236032,2023-08-12T18:17:16,Vitoria-Gasteiz,expenses,cash,-100.0,-59879.08
buyer_6,Manuel,,ES74209567901087476583,TRX_N-00636-55625506,2023-08-13T18:01:11,Vitoria-Gasteiz,expenses,leisure,-49.15,-59928.23
buyer_6,Manuel,,ES74209567901087476583,TRX_N-00637-09454300,2023-08-14T17:49:29,Vitoria-Gasteiz,expenses,appliances,-228.08,-60156.31
buyer_6,Manuel,,ES74209567901087476583,TRX_N-00638-89148458,2023-08-14T19:50:21,Vitoria-Gasteiz,expenses,gifts,-220.36,-60376.67
buyer_6,Manuel,,ES74209567901087476583,TRX_N-00639-56183396,2023-08-16T10:43:03,Berango,expenses,cash,-100.0,-60476.67
buyer_6,Manuel,,ES74209567901087476583,TRX_N-00640-25875924,2023-08-17T11:17:00,Alegría-Dulantzi,expenses,clothing,-83.34,-60560.01
buyer_6,Manuel,,ES74209567901087476583,TRX_N-00641-27872492,2023-08-19T12:26:05,Vitoria-Gasteiz,expenses,gifts,-178.58,-60738.59
buyer_6,Manuel,,ES74209567901087476583,TRX_N-00642-10111033,2023-08-20T18:31:34,Vitoria-Gasteiz,expenses,gifts,-85.37,-60823.96
buyer_6,Manuel,,ES74209567901087476583,TRX_N-00643-83666372,2023-08-21T23:05:46,Vitoria-Gasteiz,expenses,clothing,-103.02,-60926.98
buyer_6,Manuel,,ES74209567901087476583,TRX_N-00644-31517985,2023-08-23T20:39:10,Vitoria-Gasteiz,expenses,food,-121.77,-61048.75
buyer_6,Manuel,,ES74209567901087476583,TRX_N-00645-44085277,2023-08-23T13:57:28,Vitoria-Gasteiz,expenses,gifts,-546.0,-61594.75
buyer_6,Manuel,,ES74209567901087476583,TRX_N-00646-60951615,2023-08-26T16:04:58,Vitoria-Gasteiz,expenses,repairs,-222.44,-61817.19
buyer_6,Manuel,,ES74209567901087476583,TRX_N-00647-70973865,2023-08-26T08:48:24,Vitoria-Gasteiz,expenses,gifts,-99.93,-61917.12
buyer_6,Manuel,,ES74209567901087476583,TRX_N-00648-09032368,2023-08-27T12:54:32,Vitoria-Gasteiz,expenses,repairs,-102.82,-62019.94
buyer_6,Manuel,,ES74209567901087476583,TRX_N-00649-66533506,2023-08-28T11:02:48,Vitoria-Gasteiz,expenses,transport,-55.68,-62075.62
buyer_6,Manuel,,ES74209567901087476583,TRX_N-00650-68562715,2023-08-29T03:28:02,Vitoria-Gasteiz,expenses,food,-104.97,-62180.59
buyer_6,Manuel,,ES74209567901087476583,TRX_N-00651-47030696,2023-08-29T20:04:17,Vitoria-Gasteiz,expenses,healthcare,-136.55,-62317.14
buyer_6,Manuel,,ES74209567901087476583,TRX_N-00652-32956008,2023-08-31T13:37:35,Hernani,expenses,leisure,-83.04,-62400.18
buyer_6,Manuel,,ES74209567901087476583,TRX_N-00653-82603195,2023-09-01T10:08:36,Vitoria-Gasteiz,incomes,salary,1419.19,-60980.99
buyer_6,Manuel,,ES74209567901087476583,TRX_N-00654-90679759,2023-09-01T10:41:49,Amurrio,expenses,cash,-100.0,-61080.99
buyer_6,Manuel,,ES74209567901087476583,TRX_N-00655-88784502,2023-09-02T15:33:52,Vitoria-Gasteiz,expenses,cash,-100.0,-61180.99
buyer_6,Manuel,,ES74209567901087476583,TRX_N-00656-06645846,2023-09-03T14:03:25,Getxo,expenses,cash,-100.0,-61280.99
buyer_6,Manuel,,ES74209567901087476583,TRX_N-00657-12823185,2023-09-04T14:06:34,Vitoria-Gasteiz,expenses,mortgage,-879.67,-62160.66
buyer_6,Manuel,,ES74209567901087476583,TRX_N-00658-52456167,2023-09-04T08:56:14,Vitoria-Gasteiz,expenses,clothing,-101.81,-62262.47
buyer_6,Manuel,,ES74209567901087476583,TRX_N-00659-29239049,2023-09-04T18:41:05,Vitoria-Gasteiz,expenses,travel,-717.0,-62979.47
buyer_6,Manuel,,ES74209567901087476583,TRX_N-00660-13647399,2023-09-05T18:20:42,Vitoria-Gasteiz,expenses,water,-31.15,-63010.62
buyer_6,Manuel,,ES74209567901087476583,TRX_N-00661-24203002,2023-09-05T11:30:29,Vitoria-Gasteiz,expenses,food,-78.02,-63088.64
buyer_6,Manuel,,ES74209567901087476583,TRX_N-00662-53237997,2023-09-06T20:15:19,Vitoria-Gasteiz,expenses,internet,-42.0,-63130.64
buyer_6,Manuel,,ES74209567901087476583,TRX_N-00663-59984871,2023-09-07T12:15:48,Vitoria-Gasteiz,expenses,gas,-44.48,-63175.12
buyer_6,Manuel,,ES74209567901087476583,TRX_N-00664-54712018,2023-09-08T20:49:43,Vitoria-Gasteiz,expenses,electricity,-72.88,-63248.0
buyer_6,Manuel,,ES74209567901087476583,TRX_N-00665-20987690,2023-09-08T10:34:14,Vitoria-Gasteiz,expenses,phone,-32.53,-63280.53
buyer_6,Manuel,,ES74209567901087476583,TRX_N-00666-19770071,2023-09-09T18:20:01,Vitoria-Gasteiz,expenses,food,-123.22,-63403.75
buyer_6,Manuel,,ES74209567901087476583,TRX_N-00667-33365623,2023-09-10T18:20:30,Vitoria-Gasteiz,expenses,food,-67.51,-63471.26
buyer_6,Manuel,,ES74209567901087476583,TRX_N-00668-40140551,2023-09-10T18:26:06,Vitoria-Gasteiz,expenses,leisure,-72.78,-63544.04
buyer_6,Manuel,,ES74209567901087476583,TRX_N-00669-32998447,2023-09-11T15:41:37,Vitoria-Gasteiz,expenses,food,-83.77,-63627.81
buyer_6,Manuel,,ES74209567901087476583,TRX_N-00670-79874664,2023-09-14T14:17:52,Vitoria-Gasteiz,expenses,transport,-68.13,-63695.94
buyer_6,Manuel,,ES74209567901087476583,TRX_N-00671-96365634,2023-09-15T14:03:56,Vitoria-Gasteiz,expenses,cash,-100.0,-63795.94
buyer_6,Manuel,,ES74209567901087476583,TRX_N-00672-98565939,2023-09-16T19:10:46,Vitoria-Gasteiz,expenses,repairs,-238.25,-64034.19
buyer_6,Manuel,,ES74209567901087476583,TRX_N-00673-75214123,2023-09-17T19:08:25,Vitoria-Gasteiz,expenses,clothing,-133.48,-64167.67
buyer_6,Manuel,,ES74209567901087476583,TRX_N-00674-59713545,2023-09-18T08:58:02,Vitoria-Gasteiz,expenses,gifts,-27.93,-64195.6
buyer_6,Manuel,,ES74209567901087476583,TRX_N-00675-61158617,2023-09-19T10:11:46,Vitoria-Gasteiz,expenses,transport,-77.21,-64272.81
buyer_6,Manuel,,ES74209567901087476583,TRX_N-00676-81073150,2023-09-19T16:08:04,Vitoria-Gasteiz,expenses,education,-71.53,-64344.34
buyer_6,Manuel,,ES74209567901087476583,TRX_N-00677-30328305,2023-09-19T18:44:17,Vitoria-Gasteiz,expenses,repairs,-172.92,-64517.26
buyer_6,Manuel,,ES74209567901087476583,TRX_N-00678-62741786,2023-09-20T09:29:37,Vitoria-Gasteiz,expenses,food,-111.55,-64628.81
buyer_6,Manuel,,ES74209567901087476583,TRX_N-00679-79068079,2023-09-23T18:11:39,Vitoria-Gasteiz,expenses,cash,-100.0,-64728.81
buyer_6,Manuel,,ES74209567901087476583,TRX_N-00680-30511726,2023-09-25T22:55:03,Vitoria-Gasteiz,expenses,food,-68.66,-64797.47
buyer_6,Manuel,,ES74209567901087476583,TRX_N-00681-27234259,2023-09-26T09:42:27,Vitoria-Gasteiz,expenses,leisure,-61.21,-64858.68
buyer_6,Manuel,,ES74209567901087476583,TRX_N-00682-11533316,2023-09-26T08:23:51,Vitoria-Gasteiz,expenses,healthcare,-108.69,-64967.37
buyer_6,Manuel,,ES74209567901087476583,TRX_N-00683-64648358,2023-09-27T13:36:36,Vitoria-Gasteiz,expenses,repairs,-170.8,-65138.17
buyer_6,Manuel,,ES74209567901087476583,TRX_N-00684-21497002,2023-09-28T13:08:46,Vitoria-Gasteiz,expenses,cash,-100.0,-65238.17
buyer_6,Manuel,,ES74209567901087476583,TRX_N-00685-92241611,2023-09-28T17:49:03,Donostia,expenses,repairs,-301.71,-65539.88
buyer_6,Manuel,,ES74209567901087476583,TRX_N-00686-17398341,2023-09-29T23:43:48,Vitoria-Gasteiz,expenses,education,-49.41,-65589.29
buyer_6,Manuel,,ES74209567901087476583,TRX_N-00687-62614708,2023-09-30T08:35:19,Eibar,expenses,transport,-83.4,-65672.69
buyer_6,Manuel,,ES74209567901087476583,TRX_N-00688-16215377,2023-10-01T19:28:58,Vitoria-Gasteiz,incomes,salary,1419.19,-64253.5
buyer_6,Manuel,,ES74209567901087476583,TRX_N-00689-60222595,2023-10-02T10:50:14,Vitoria-Gasteiz,expenses,cash,-100.0,-64353.5
buyer_6,Manuel,,ES74209567901087476583,TRX_N-00690-27684830,2023-10-04T11:02:40,Vitoria-Gasteiz,expenses,mortgage,-879.67,-65233.17
buyer_6,Manuel,,ES74209567901087476583,TRX_N-00691-97248638,2023-10-04T12:00:01,Getxo,expenses,appliances,-87.8,-65320.97
buyer_6,Manuel,,ES74209567901087476583,TRX_N-00692-51077206,2023-10-06T13:20:57,Vitoria-Gasteiz,expenses,electricity,-29.62,-65350.59
buyer_6,Manuel,,ES74209567901087476583,TRX_N-00693-88333659,2023-10-06T15:38:41,Vitoria-Gasteiz,expenses,internet,-42.0,-65392.59
buyer_6,Manuel,,ES74209567901087476583,TRX_N-00694-34239938,2023-10-06T14:31:09,Vitoria-Gasteiz,expenses,phone,-41.19,-65433.78
buyer_6,Manuel,,ES74209567901087476583,TRX_N-00695-02168554,2023-10-07T12:01:35,Vitoria-Gasteiz,expenses,food,-116.4,-65550.18
buyer_6,Manuel,,ES74209567901087476583,TRX_N-00696-26676852,2023-10-08T20:37:13,Vitoria-Gasteiz,expenses,water,-42.15,-65592.33
buyer_6,Manuel,,ES74209567901087476583,TRX_N-00697-52466796,2023-10-08T08:29:27,Vitoria-Gasteiz,expenses,gas,-32.9,-65625.23
buyer_6,Manuel,,ES74209567901087476583,TRX_N-00698-15579919,2023-10-08T12:32:29,Barakaldo,expenses,leisure,-80.17,-65705.4
buyer_6,Manuel,,ES74209567901087476583,TRX_N-00699-53959163,2023-10-09T12:11:43,Vitoria-Gasteiz,expenses,appliances,-309.84,-66015.24
buyer_6,Manuel,,ES74209567901087476583,TRX_N-00700-68542968,2023-10-11T19:18:04,Labastida,expenses,gifts,-786.39,-66801.63
buyer_6,Manuel,,ES74209567901087476583,TRX_N-00701-24565463,2023-10-13T13:08:54,Vitoria-Gasteiz,expenses,cash,-100.0,-66901.63
buyer_6,Manuel,,ES74209567901087476583,TRX_N-00702-65677263,2023-10-14T08:35:08,Galdakao,expenses,transport,-88.16,-66989.79
buyer_6,Manuel,,ES74209567901087476583,TRX_N-00703-14926478,2023-10-15T22:07:23,Pasaia,expenses,food,-115.94,-67105.73
buyer_6,Manuel,,ES74209567901087476583,TRX_N-00704-24286659,2023-10-16T07:28:29,Vitoria-Gasteiz,expenses,cash,-100.0,-67205.73
buyer_6,Manuel,,ES74209567901087476583,TRX_N-00705-59785258,2023-10-17T18:04:58,Vitoria-Gasteiz,expenses,food,-112.86,-67318.59
buyer_6,Manuel,,ES74209567901087476583,TRX_N-00706-58871860,2023-10-17T10:06:19,Vitoria-Gasteiz,expenses,repairs,-179.35,-67497.94
buyer_6,Manuel,,ES74209567901087476583,TRX_N-00707-08456984,2023-10-19T08:00:48,Vitoria-Gasteiz,expenses,transport,-63.49,-67561.43
buyer_6,Manuel,,ES74209567901087476583,TRX_N-00708-70283466,2023-10-20T03:37:19,Vitoria-Gasteiz,expenses,gifts,-691.48,-68252.91
buyer_6,Manuel,,ES74209567901087476583,TRX_N-00709-57628775,2023-10-21T09:35:29,Vitoria-Gasteiz,expenses,repairs,-273.96,-68526.87
buyer_6,Manuel,,ES74209567901087476583,TRX_N-00710-60790556,2023-10-22T21:33:32,Eibar,expenses,transport,-88.71,-68615.58
buyer_6,Manuel,,ES74209567901087476583,TRX_N-00711-26445156,2023-10-22T13:27:52,Vitoria-Gasteiz,expenses,leisure,-44.19,-68659.77
buyer_6,Manuel,,ES74209567901087476583,TRX_N-00712-11265899,2023-10-25T16:35:47,Eibar,expenses,education,-69.92,-68729.69
buyer_6,Manuel,,ES74209567901087476583,TRX_N-00713-00629949,2023-10-25T20:57:05,Llodio,expenses,cash,-100.0,-68829.69
buyer_6,Manuel,,ES74209567901087476583,TRX_N-00714-84443919,2023-10-27T18:38:32,Vitoria-Gasteiz,expenses,education,-51.77,-68881.46
buyer_6,Manuel,,ES74209567901087476583,TRX_N-00715-70019838,2023-10-28T12:08:44,Vitoria-Gasteiz,expenses,food,-123.73,-69005.19
buyer_6,Manuel,,ES74209567901087476583,TRX_N-00716-77444958,2023-10-30T15:22:16,Vitoria-Gasteiz,expenses,cash,-100.0,-69105.19
buyer_6,Manuel,,ES74209567901087476583,TRX_N-00717-22609793,2023-10-31T20:50:05,Labastida,expenses,food,-119.4,-69224.59
buyer_6,Manuel,,ES74209567901087476583,TRX_N-00718-79983786,2023-11-01T10:30:22,Vitoria-Gasteiz,incomes,salary,1419.19,-67805.4
buyer_6,Manuel,,ES74209567901087476583,TRX_N-00719-51045148,2023-11-01T13:21:52,Vitoria-Gasteiz,expenses,food,-70.23,-67875.63
buyer_6,Manuel,,ES74209567901087476583,TRX_N-00720-48983816,2023-11-01T09:55:58,Vitoria-Gasteiz,expenses,leisure,-48.15,-67923.78
buyer_6,Manuel,,ES74209567901087476583,TRX_N-00721-92253911,2023-11-01T18:04:25,Vitoria-Gasteiz,expenses,clothing,-63.86,-67987.64
buyer_6,Manuel,,ES74209567901087476583,TRX_N-00722-26033367,2023-11-02T15:59:41,Vitoria-Gasteiz,expenses,transport,-72.48,-68060.12
buyer_6,Manuel,,ES74209567901087476583,TRX_N-00723-45107848,2023-11-03T19:26:32,Vitoria-Gasteiz,expenses,transport,-48.89,-68109.01
buyer_6,Manuel,,ES74209567901087476583,TRX_N-00724-13740116,2023-11-04T14:03:45,Vitoria-Gasteiz,expenses,mortgage,-879.67,-68988.68
buyer_6,Manuel,,ES74209567901087476583,TRX_N-00725-65353328,2023-11-04T10:27:49,Vitoria-Gasteiz,expenses,clothing,-150.98,-69139.66
buyer_6,Manuel,,ES74209567901087476583,TRX_N-00726-46211967,2023-11-05T13:37:19,Vitoria-Gasteiz,expenses,leisure,-60.11,-69199.77
buyer_6,Manuel,,ES74209567901087476583,TRX_N-00727-71375909,2023-11-05T12:24:44,Vitoria-Gasteiz,expenses,clothing,-77.01,-69276.78
buyer_6,Manuel,,ES74209567901087476583,TRX_N-00728-25168120,2023-11-05T01:34:58,Vitoria-Gasteiz,expenses,gifts,-478.94,-69755.72
buyer_6,Manuel,,ES74209567901087476583,TRX_N-00729-52868580,2023-11-06T08:34:43,Vitoria-Gasteiz,expenses,gas,-34.51,-69790.23
buyer_6,Manuel,,ES74209567901087476583,TRX_N-00730-62652067,2023-11-06T09:16:33,Vitoria-Gasteiz,expenses,clothing,-102.02,-69892.25
buyer_6,Manuel,,ES74209567901087476583,TRX_N-00731-60757528,2023-11-07T17:11:47,Vitoria-Gasteiz,expenses,water,-34.03,-69926.28
buyer_6,Manuel,,ES74209567901087476583,TRX_N-00732-03027862,2023-11-07T17:10:26,Vitoria-Gasteiz,expenses,electricity,-20.74,-69947.02
buyer_6,Manuel,,ES74209567901087476583,TRX_N-00733-82266760,2023-11-08T15:14:47,Vitoria-Gasteiz,expenses,internet,-42.0,-69989.02
buyer_6,Manuel,,ES74209567901087476583,TRX_N-00734-42097639,2023-11-08T15:35:29,Vitoria-Gasteiz,expenses,phone,-34.92,-70023.94
buyer_6,Manuel,,ES74209567901087476583,TRX_N-00735-30921432,2023-11-08T09:42:21,Vitoria-Gasteiz,expenses,food,-61.82,-70085.76
buyer_6,Manuel,,ES74209567901087476583,TRX_N-00736-55111014,2023-11-08T17:36:57,Llodio,expenses,transport,-46.85,-70132.61
buyer_6,Manuel,,ES74209567901087476583,TRX_N-00737-63682303,2023-11-09T18:17:57,Vitoria-Gasteiz,expenses,education,-42.31,-70174.92
buyer_6,Manuel,,ES74209567901087476583,TRX_N-00738-48762156,2023-11-10T10:45:34,Vitoria-Gasteiz,expenses,education,-60.74,-70235.66
buyer_6,Manuel,,ES74209567901087476583,TRX_N-00739-43953627,2023-11-11T18:21:18,Vitoria-Gasteiz,expenses,food,-94.51,-70330.17
buyer_6,Manuel,,ES74209567901087476583,TRX_N-00740-21093123,2023-11-13T14:20:03,Vitoria-Gasteiz,expenses,leisure,-73.09,-70403.26
buyer_6,Manuel,,ES74209567901087476583,TRX_N-00741-48864187,2023-11-13T18:42:39,Vitoria-Gasteiz,expenses,education,-69.3,-70472.56
buyer_6,Manuel,,ES74209567901087476583,TRX_N-00742-81001199,2023-11-13T20:36:51,Vitoria-Gasteiz,expenses,cash,-100.0,-70572.56
buyer_6,Manuel,,ES74209567901087476583,TRX_N-00743-54048276,2023-11-14T12:54:09,Vitoria-Gasteiz,expenses,cash,-100.0,-70672.56
buyer_6,Manuel,,ES74209567901087476583,TRX_N-00744-25929854,2023-11-17T17:38:51,Vitoria-Gasteiz,expenses,leisure,-60.44,-70733.0
buyer_6,Manuel,,ES74209567901087476583,TRX_N-00745-26750950,2023-11-17T20:30:08,Vitoria-Gasteiz,expenses,clothing,-85.91,-70818.91
buyer_6,Manuel,,ES74209567901087476583,TRX_N-00746-07845340,2023-11-19T18:21:40,Vitoria-Gasteiz,expenses,leisure,-27.45,-70846.36
buyer_6,Manuel,,ES74209567901087476583,TRX_N-00747-96747322,2023-11-21T12:58:49,Vitoria-Gasteiz,expenses,transport,-81.72,-70928.08
buyer_6,Manuel,,ES74209567901087476583,TRX_N-00748-54299303,2023-11-23T11:20:01,Vitoria-Gasteiz,expenses,clothing,-158.69,-71086.77
buyer_6,Manuel,,ES74209567901087476583,TRX_N-00749-09209156,2023-11-25T12:11:29,Vitoria-Gasteiz,expenses,leisure,-24.7,-71111.47
buyer_6,Manuel,,ES74209567901087476583,TRX_N-00750-20586552,2023-11-26T13:39:19,Vitoria-Gasteiz,expenses,leisure,-23.83,-71135.3
buyer_6,Manuel,,ES74209567901087476583,TRX_N-00751-31716205,2023-11-27T14:34:27,Vitoria-Gasteiz,expenses,cash,-100.0,-71235.3
buyer_6,Manuel,,ES74209567901087476583,TRX_N-00752-43992350,2023-11-27T07:50:11,Vitoria-Gasteiz,expenses,appliances,-283.75,-71519.05
buyer_6,Manuel,,ES74209567901087476583,TRX_N-00753-66452422,2023-11-28T13:20:17,Vitoria-Gasteiz,expenses,food,-70.17,-71589.22
buyer_6,Manuel,,ES74209567901087476583,TRX_N-00754-61832329,2023-12-01T08:18:33,Vitoria-Gasteiz,incomes,salary,1419.19,-70170.03
buyer_6,Manuel,,ES74209567901087476583,TRX_N-00755-87292137,2023-12-01T08:18:33,Vitoria-Gasteiz,incomes,extra_income,151.06,-70018.97
buyer_6,Manuel,,ES74209567901087476583,TRX_N-00756-07290703,2023-12-01T08:18:33,Vitoria-Gasteiz,incomes,salary_bonus,1111.58,-68907.39
buyer_6,Manuel,,ES74209567901087476583,TRX_N-00757-45476626,2023-12-01T17:36:39,Vitoria-Gasteiz,expenses,food,-99.67,-69007.06
buyer_6,Manuel,,ES74209567901087476583,TRX_N-00758-54835459,2023-12-02T14:08:58,Vitoria-Gasteiz,expenses,clothing,-138.83,-69145.89
buyer_6,Manuel,,ES74209567901087476583,TRX_N-00759-14857564,2023-12-03T18:29:52,Vitoria-Gasteiz,expenses,education,-72.84,-69218.73
buyer_6,Manuel,,ES74209567901087476583,TRX_N-00760-77417653,2023-12-03T21:44:29,Galdakao,expenses,cash,-100.0,-69318.73
buyer_6,Manuel,,ES74209567901087476583,TRX_N-00761-98484436,2023-12-03T22:26:54,Vitoria-Gasteiz,expenses,repairs,-268.92,-69587.65
buyer_6,Manuel,,ES74209567901087476583,TRX_N-00762-81973200,2023-12-04T13:42:33,Vitoria-Gasteiz,expenses,mortgage,-879.67,-70467.32
buyer_6,Manuel,,ES74209567901087476583,TRX_N-00763-82251743,2023-12-04T20:58:07,Vitoria-Gasteiz,expenses,gifts,-412.79,-70880.11
buyer_6,Manuel,,ES74209567901087476583,TRX_N-00764-63314183,2023-12-05T17:00:11,Vitoria-Gasteiz,expenses,phone,-38.77,-70918.88
buyer_6,Manuel,,ES74209567901087476583,TRX_N-00765-52289543,2023-12-06T13:50:45,Vitoria-Gasteiz,expenses,water,-25.89,-70944.77
buyer_6,Manuel,,ES74209567901087476583,TRX_N-00766-17820432,2023-12-06T13:49:59,Vitoria-Gasteiz,expenses,food,-100.87,-71045.64
buyer_6,Manuel,,ES74209567901087476583,TRX_N-00767-41500678,2023-12-06T08:01:22,Irun,expenses,gifts,-458.85,-71504.49
buyer_6,Manuel,,ES74209567901087476583,TRX_N-00768-76758551,2023-12-07T19:05:38,Vitoria-Gasteiz,expenses,electricity,-52.13,-71556.62
buyer_6,Manuel,,ES74209567901087476583,TRX_N-00769-92603565,2023-12-08T07:03:18,Vitoria-Gasteiz,expenses,internet,-42.0,-71598.62
buyer_6,Manuel,,ES74209567901087476583,TRX_N-00770-59676663,2023-12-08T13:28:10,Vitoria-Gasteiz,expenses,gas,-63.45,-71662.07
buyer_6,Manuel,,ES74209567901087476583,TRX_N-00771-02255368,2023-12-08T10:17:37,Vitoria-Gasteiz,expenses,food,-73.18,-71735.25
buyer_6,Manuel,,ES74209567901087476583,TRX_N-00772-96517379,2023-12-08T04:18:31,Vitoria-Gasteiz,expenses,transport,-50.29,-71785.54
buyer_6,Manuel,,ES74209567901087476583,TRX_N-00773-86492153,2023-12-08T18:01:38,Vitoria-Gasteiz,expenses,leisure,-80.04,-71865.58
buyer_6,Manuel,,ES74209567901087476583,TRX_N-00774-99271185,2023-12-08T08:05:06,Bilbao,expenses,appliances,-230.9,-72096.48
buyer_6,Manuel,,ES74209567901087476583,TRX_N-00775-93309355,2023-12-10T16:42:12,Vitoria-Gasteiz,expenses,leisure,-27.29,-72123.77
buyer_6,Manuel,,ES74209567901087476583,TRX_N-00776-55745517,2023-12-10T14:07:28,Vitoria-Gasteiz,expenses,cash,-100.0,-72223.77
buyer_6,Manuel,,ES74209567901087476583,TRX_N-00777-30234071,2023-12-14T10:16:57,Iruña de Oca,expenses,leisure,-67.79,-72291.56
buyer_6,Manuel,,ES74209567901087476583,TRX_N-00778-90964898,2023-12-14T14:41:08,Vitoria-Gasteiz,expenses,cash,-100.0,-72391.56
buyer_6,Manuel,,ES74209567901087476583,TRX_N-00779-88364241,2023-12-15T11:55:16,Vitoria-Gasteiz,expenses,repairs,-127.59,-72519.15
buyer_6,Manuel,,ES74209567901087476583,TRX_N-00780-47450606,2023-12-18T08:21:32,Vitoria-Gasteiz,expenses,cash,-100.0,-72619.15
buyer_6,Manuel,,ES74209567901087476583,TRX_N-00781-43293444,2023-12-19T09:58:29,Vitoria-Gasteiz,expenses,cash,-100.0,-72719.15
buyer_6,Manuel,,ES74209567901087476583,TRX_N-00782-28525761,2023-12-21T16:49:50,Vitoria-Gasteiz,expenses,travel,-1598.92,-74318.07
buyer_6,Manuel,,ES74209567901087476583,TRX_N-00783-55196410,2023-12-22T20:08:32,Vitoria-Gasteiz,expenses,transport,-40.17,-74358.24
buyer_6,Manuel,,ES74209567901087476583,TRX_N-00784-43947936,2023-12-22T09:35:23,Vitoria-Gasteiz,expenses,cash,-100.0,-74458.24
buyer_6,Manuel,,ES74209567901087476583,TRX_N-00785-80259061,2023-12-24T08:56:53,Iruña de Oca,expenses,leisure,-69.48,-74527.72
buyer_6,Manuel,,ES74209567901087476583,TRX_N-00786-87410563,2023-12-26T20:26:25,Vitoria-Gasteiz,expenses,clothing,-79.53,-74607.25
buyer_6,Manuel,,ES74209567901087476583,TRX_N-00787-09007138,2023-12-27T09:16:01,Sestao,expenses,food,-80.76,-74688.01
buyer_6,Manuel,,ES74209567901087476583,TRX_N-00788-81649126,2023-12-28T20:28:29,Vitoria-Gasteiz,expenses,food,-99.64,-74787.65
buyer_6,Manuel,,ES74209567901087476583,TRX_N-00789-35540218,2023-12-31T09:57:51,Vitoria-Gasteiz,expenses,cash,-100.0,-74887.65
buyer_6,Manuel,,ES74209567901087476583,TRX_N-00790-16421820,2024-01-01T18:59:25,Vitoria-Gasteiz,incomes,salary,1449.28,-73438.37
buyer_6,Manuel,,ES74209567901087476583,TRX_N-00791-22015176,2024-01-01T19:31:08,Vitoria-Gasteiz,expenses,transport,-44.47,-73482.84
buyer_6,Manuel,,ES74209567901087476583,TRX_N-00792-24858133,2024-01-03T10:10:07,Vitoria-Gasteiz,expenses,repairs,-207.16,-73690.0
buyer_6,Manuel,,ES74209567901087476583,TRX_N-00793-12028117,2024-01-04T16:56:28,Vitoria-Gasteiz,expenses,mortgage,-879.67,-74569.67
buyer_6,Manuel,,ES74209567901087476583,TRX_N-00794-89111403,2024-01-04T12:04:58,Vitoria-Gasteiz,expenses,food,-71.11,-74640.78
buyer_6,Manuel,,ES74209567901087476583,TRX_N-00795-23523615,2024-01-04T13:52:29,Vitoria-Gasteiz,expenses,leisure,-59.58,-74700.36
buyer_6,Manuel,,ES74209567901087476583,TRX_N-00796-16041936,2024-01-05T02:45:34,Vitoria-Gasteiz,expenses,internet,-42.0,-74742.36
buyer_6,Manuel,,ES74209567901087476583,TRX_N-00797-70692447,2024-01-05T17:44:00,Getxo,expenses,repairs,-176.44,-74918.8
buyer_6,Manuel,,ES74209567901087476583,TRX_N-00798-62127734,2024-01-06T19:36:34,Vitoria-Gasteiz,expenses,food,-121.27,-75040.07
buyer_6,Manuel,,ES74209567901087476583,TRX_N-00799-51873395,2024-01-06T20:20:10,Vitoria-Gasteiz,expenses,healthcare,-56.38,-75096.45
buyer_6,Manuel,,ES74209567901087476583,TRX_N-00800-86460973,2024-01-07T17:33:37,Vitoria-Gasteiz,expenses,water,-29.71,-75126.16
buyer_6,Manuel,,ES74209567901087476583,TRX_N-00801-95649897,2024-01-07T17:14:32,Hernani,expenses,food,-80.91,-75207.07
buyer_6,Manuel,,ES74209567901087476583,TRX_N-00802-36134558,2024-01-07T20:30:17,Vitoria-Gasteiz,expenses,cash,-100.0,-75307.07
buyer_6,Manuel,,ES74209567901087476583,TRX_N-00803-59598266,2024-01-07T20:12:54,Durango,expenses,repairs,-328.42,-75635.49
buyer_6,Manuel,,ES74209567901087476583,TRX_N-00804-58674382,2024-01-08T09:30:45,Vitoria-Gasteiz,expenses,electricity,-85.18,-75720.67
buyer_6,Manuel,,ES74209567901087476583,TRX_N-00805-47499428,2024-01-08T18:37:06,Vitoria-Gasteiz,expenses,gas,-33.28,-75753.95
buyer_6,Manuel,,ES74209567901087476583,TRX_N-00806-93276369,2024-01-08T12:59:01,Vitoria-Gasteiz,expenses,phone,-42.46,-75796.41
buyer_6,Manuel,,ES74209567901087476583,TRX_N-00807-79556586,2024-01-08T17:29:26,Vitoria-Gasteiz,expenses,clothing,-94.65,-75891.06
buyer_6,Manuel,,ES74209567901087476583,TRX_N-00808-58378593,2024-01-12T11:13:37,Vitoria-Gasteiz,expenses,education,-67.98,-75959.04
buyer_6,Manuel,,ES74209567901087476583,TRX_N-00809-75477859,2024-01-12T19:27:12,Vitoria-Gasteiz,expenses,cash,-100.0,-76059.04
buyer_6,Manuel,,ES74209567901087476583,TRX_N-00810-94596451,2024-01-13T17:11:44,Andoain,expenses,leisure,-53.84,-76112.88
buyer_6,Manuel,,ES74209567901087476583,TRX_N-00811-21961338,2024-01-15T14:47:19,Vitoria-Gasteiz,expenses,food,-65.67,-76178.55
buyer_6,Manuel,,ES74209567901087476583,TRX_N-00812-95556795,2024-01-18T20:43:25,Vitoria-Gasteiz,expenses,food,-103.99,-76282.54
buyer_6,Manuel,,ES74209567901087476583,TRX_N-00813-88662333,2024-01-18T08:44:46,Vitoria-Gasteiz,expenses,travel,-1897.06,-78179.6
buyer_6,Manuel,,ES74209567901087476583,TRX_N-00814-03728515,2024-01-20T19:29:25,Vitoria-Gasteiz,expenses,food,-109.45,-78289.05
buyer_6,Manuel,,ES74209567901087476583,TRX_N-00815-88711554,2024-01-21T11:37:15,Vitoria-Gasteiz,expenses,gifts,-107.87,-78396.92
buyer_6,Manuel,,ES74209567901087476583,TRX_N-00816-43571019,2024-01-23T08:58:08,Llodio,expenses,food,-63.48,-78460.4
buyer_6,Manuel,,ES74209567901087476583,TRX_N-00817-79791356,2024-01-23T09:43:07,Oyón-Oion,expenses,cash,-100.0,-78560.4
buyer_6,Manuel,,ES74209567901087476583,TRX_N-00818-86790719,2024-01-25T23:58:48,Barakaldo,expenses,healthcare,-138.98,-78699.38
buyer_6,Manuel,,ES74209567901087476583,TRX_N-00819-92634874,2024-01-27T10:02:05,Basauri,expenses,cash,-100.0,-78799.38
buyer_6,Manuel,,ES74209567901087476583,TRX_N-00820-38192314,2024-01-28T12:11:46,Vitoria-Gasteiz,expenses,food,-99.18,-78898.56
buyer_6,Manuel,,ES74209567901087476583,TRX_N-00821-59724914,2024-01-29T00:24:22,Vitoria-Gasteiz,expenses,cash,-100.0,-78998.56
buyer_6,Manuel,,ES74209567901087476583,TRX_N-00822-53907848,2024-01-30T19:07:53,Vitoria-Gasteiz,expenses,leisure,-56.58,-79055.14
buyer_6,Manuel,,ES74209567901087476583,TRX_N-00823-63032239,2024-01-31T14:21:14,Vitoria-Gasteiz,expenses,clothing,-47.96,-79103.1
buyer_6,Manuel,,ES74209567901087476583,TRX_N-00824-60451931,2024-01-31T14:16:14,Vitoria-Gasteiz,expenses,gifts,-504.62,-79607.72
buyer_6,Manuel,,ES74209567901087476583,TRX_N-00825-70518886,2024-02-01T12:16:47,Vitoria-Gasteiz,incomes,salary,1449.28,-78158.44
buyer_6,Manuel,,ES74209567901087476583,TRX_N-00826-19301677,2024-02-01T19:45:35,Irun,expenses,clothing,-64.3,-78222.74
buyer_6,Manuel,,ES74209567901087476583,TRX_N-00827-08129237,2024-02-04T11:06:16,Vitoria-Gasteiz,expenses,mortgage,-879.67,-79102.41
buyer_6,Manuel,,ES74209567901087476583,TRX_N-00828-79045055,2024-02-05T14:54:34,Vitoria-Gasteiz,expenses,phone,-42.2,-79144.61
buyer_6,Manuel,,ES74209567901087476583,TRX_N-00829-55404725,2024-02-05T16:51:39,Vitoria-Gasteiz,expenses,transport,-70.72,-79215.33
buyer_6,Manuel,,ES74209567901087476583,TRX_N-00830-51685622,2024-02-05T09:47:06,Vitoria-Gasteiz,expenses,repairs,-84.65,-79299.98
buyer_6,Manuel,,ES74209567901087476583,TRX_N-00831-23139499,2024-02-07T14:17:23,Vitoria-Gasteiz,expenses,gas,-108.55,-79408.53
buyer_6,Manuel,,ES74209567901087476583,TRX_N-00832-14790819,2024-02-07T10:32:10,Vitoria-Gasteiz,expenses,leisure,-60.57,-79469.1
buyer_6,Manuel,,ES74209567901087476583,TRX_N-00833-76366297,2024-02-08T14:08:46,Vitoria-Gasteiz,expenses,water,-29.6,-79498.7
buyer_6,Manuel,,ES74209567901087476583,TRX_N-00834-80332272,2024-02-08T17:23:17,Vitoria-Gasteiz,expenses,internet,-42.0,-79540.7
buyer_6,Manuel,,ES74209567901087476583,TRX_N-00835-66195048,2024-02-08T20:51:25,Vitoria-Gasteiz,expenses,electricity,-76.49,-79617.19
buyer_6,Manuel,,ES74209567901087476583,TRX_N-00836-66481740,2024-02-08T20:21:01,Vitoria-Gasteiz,expenses,cash,-100.0,-79717.19
buyer_6,Manuel,,ES74209567901087476583,TRX_N-00837-26047322,2024-02-09T09:00:29,Vitoria-Gasteiz,expenses,travel,-837.05,-80554.24
buyer_6,Manuel,,ES74209567901087476583,TRX_N-00838-58228706,2024-02-10T08:38:05,Mungia,expenses,cash,-100.0,-80654.24
buyer_6,Manuel,,ES74209567901087476583,TRX_N-00839-63978618,2024-02-13T16:43:19,Vitoria-Gasteiz,expenses,transport,-80.66,-80734.9
buyer_6,Manuel,,ES74209567901087476583,TRX_N-00840-68110296,2024-02-14T15:01:13,Galdakao,expenses,food,-116.07,-80850.97
buyer_6,Manuel,,ES74209567901087476583,TRX_N-00841-77564918,2024-02-14T18:01:19,Vitoria-Gasteiz,expenses,leisure,-42.26,-80893.23
buyer_6,Manuel,,ES74209567901087476583,TRX_N-00842-05129117,2024-02-14T04:12:20,Vitoria-Gasteiz,expenses,education,-75.73,-80968.96
buyer_6,Manuel,,ES74209567901087476583,TRX_N-00843-64507502,2024-02-15T13:53:51,Vitoria-Gasteiz,expenses,cash,-100.0,-81068.96
buyer_6,Manuel,,ES74209567901087476583,TRX_N-00844-26218663,2024-02-16T01:30:36,Vitoria-Gasteiz,expenses,food,-104.99,-81173.95
buyer_6,Manuel,,ES74209567901087476583,TRX_N-00845-80733499,2024-02-16T06:58:14,Labastida,expenses,clothing,-99.76,-81273.71
buyer_6,Manuel,,ES74209567901087476583,TRX_N-00846-09425328,2024-02-16T15:55:51,Errenteria,expenses,healthcare,-130.48,-81404.19
buyer_6,Manuel,,ES74209567901087476583,TRX_N-00847-51885780,2024-02-19T17:53:55,Vitoria-Gasteiz,expenses,cash,-100.0,-81504.19
buyer_6,Manuel,,ES74209567901087476583,TRX_N-00848-46356744,2024-02-20T08:09:48,Labastida,expenses,leisure,-26.05,-81530.24
buyer_6,Manuel,,ES74209567901087476583,TRX_N-00849-02300191,2024-02-21T21:11:33,Vitoria-Gasteiz,expenses,food,-104.13,-81634.37
buyer_6,Manuel,,ES74209567901087476583,TRX_N-00850-50315859,2024-02-21T10:45:32,Labastida,expenses,cash,-100.0,-81734.37
buyer_6,Manuel,,ES74209567901087476583,TRX_N-00851-25177602,2024-02-24T23:54:55,Mungia,expenses,appliances,-378.25,-82112.62
buyer_6,Manuel,,ES74209567901087476583,TRX_N-00852-85410545,2024-02-25T16:02:12,Vitoria-Gasteiz,expenses,education,-77.03,-82189.65
buyer_6,Manuel,,ES74209567901087476583,TRX_N-00853-08211768,2024-02-26T12:24:59,Vitoria-Gasteiz,expenses,food,-73.79,-82263.44
buyer_6,Manuel,,ES74209567901087476583,TRX_N-00854-39897714,2024-02-26T19:12:58,Vitoria-Gasteiz,expenses,transport,-87.88,-82351.32
buyer_6,Manuel,,ES74209567901087476583,TRX_N-00855-03111521,2024-02-26T13:05:41,Vitoria-Gasteiz,expenses,gifts,-501.54,-82852.86
buyer_6,Manuel,,ES74209567901087476583,TRX_N-00856-18921556,2024-02-27T17:40:17,Hondarribia,expenses,food,-116.82,-82969.68
buyer_6,Manuel,,ES74209567901087476583,TRX_N-00857-12142857,2024-02-28T20:51:22,Vitoria-Gasteiz,expenses,appliances,-234.69,-83204.37
buyer_6,Manuel,,ES74209567901087476583,TRX_N-00858-48248404,2024-02-29T12:28:13,Vitoria-Gasteiz,expenses,repairs,-41.27,-83245.64
buyer_6,Manuel,,ES74209567901087476583,TRX_N-00859-16813619,2024-03-01T11:27:15,Vitoria-Gasteiz,incomes,salary,1449.28,-81796.36
buyer_6,Manuel,,ES74209567901087476583,TRX_N-00860-04598821,2024-03-01T11:27:15,Vitoria-Gasteiz,incomes,extra_income,151.06,-81645.3
buyer_6,Manuel,,ES74209567901087476583,TRX_N-00861-09093856,2024-03-04T20:35:08,Vitoria-Gasteiz,expenses,mortgage,-879.67,-82524.97
buyer_6,Manuel,,ES74209567901087476583,TRX_N-00862-61045276,2024-03-04T11:29:02,Vitoria-Gasteiz,expenses,cash,-100.0,-82624.97
buyer_6,Manuel,,ES74209567901087476583,TRX_N-00863-69152754,2024-03-05T19:00:50,Vitoria-Gasteiz,expenses,water,-39.71,-82664.68
buyer_6,Manuel,,ES74209567901087476583,TRX_N-00864-13594159,2024-03-05T19:11:09,Vitoria-Gasteiz,expenses,healthcare,-116.12,-82780.8
buyer_6,Manuel,,ES74209567901087476583,TRX_N-00865-88718077,2024-03-07T12:17:10,Vitoria-Gasteiz,expenses,gas,-88.12,-82868.92
buyer_6,Manuel,,ES74209567901087476583,TRX_N-00866-14918444,2024-03-07T11:05:11,Vitoria-Gasteiz,expenses,phone,-42.53,-82911.45
buyer_6,Manuel,,ES74209567901087476583,TRX_N-00867-23302649,2024-03-07T19:04:52,Vitoria-Gasteiz,expenses,food,-101.22,-83012.67
buyer_6,Manuel,,ES74209567901087476583,TRX_N-00868-83808601,2024-03-08T13:50:28,Vitoria-Gasteiz,expenses,electricity,-41.24,-83053.91
buyer_6,Manuel,,ES74209567901087476583,TRX_N-00869-92297477,2024-03-08T20:23:08,Vitoria-Gasteiz,expenses,internet,-42.0,-83095.91
buyer_6,Manuel,,ES74209567901087476583,TRX_N-00870-27237329,2024-03-08T08:09:43,Alegría-Dulantzi,expenses,healthcare,-85.31,-83181.22
buyer_6,Manuel,,ES74209567901087476583,TRX_N-00871-24599028,2024-03-09T09:42:04,Barakaldo,expenses,leisure,-63.88,-83245.1
buyer_6,Manuel,,ES74209567901087476583,TRX_N-00872-53278524,2024-03-10T15:19:24,Vitoria-Gasteiz,expenses,education,-43.07,-83288.17
buyer_6,Manuel,,ES74209567901087476583,TRX_N-00873-07790569,2024-03-10T20:40:14,Vitoria-Gasteiz,expenses,repairs,-296.79,-83584.96
buyer_6,Manuel,,ES74209567901087476583,TRX_N-00874-44591348,2024-03-11T11:44:34,Amurrio,expenses,cash,-100.0,-83684.96
buyer_6,Manuel,,ES74209567901087476583,TRX_N-00875-89581874,2024-03-11T22:27:25,Vitoria-Gasteiz,expenses,repairs,-327.26,-84012.22
buyer_6,Manuel,,ES74209567901087476583,TRX_N-00876-27398646,2024-03-15T18:40:57,Vitoria-Gasteiz,expenses,leisure,-34.78,-84047.0
buyer_6,Manuel,,ES74209567901087476583,TRX_N-00877-01084146,2024-03-16T13:46:23,Vitoria-Gasteiz,expenses,food,-81.53,-84128.53
buyer_6,Manuel,,ES74209567901087476583,TRX_N-00878-19562256,2024-03-17T10:01:16,Vitoria-Gasteiz,expenses,food,-109.65,-84238.18
buyer_6,Manuel,,ES74209567901087476583,TRX_N-00879-12110095,2024-03-18T22:50:15,Vitoria-Gasteiz,expenses,cash,-100.0,-84338.18
buyer_6,Manuel,,ES74209567901087476583,TRX_N-00880-55348814,2024-03-20T12:02:23,Vitoria-Gasteiz,expenses,leisure,-21.91,-84360.09
buyer_6,Manuel,,ES74209567901087476583,TRX_N-00881-62279176,2024-03-21T08:08:26,Vitoria-Gasteiz,expenses,food,-81.11,-84441.2
buyer_6,Manuel,,ES74209567901087476583,TRX_N-00882-11934862,2024-03-21T13:30:34,Vitoria-Gasteiz,expenses,clothing,-136.41,-84577.61
buyer_6,Manuel,,ES74209567901087476583,TRX_N-00883-07689949,2024-03-25T09:56:21,Vitoria-Gasteiz,expenses,clothing,-46.07,-84623.68
buyer_6,Manuel,,ES74209567901087476583,TRX_N-00884-16252972,2024-03-26T10:19:06,Donostia,expenses,leisure,-29.6,-84653.28
buyer_6,Manuel,,ES74209567901087476583,TRX_N-00885-94797165,2024-03-27T02:03:06,Sopela,expenses,transport,-50.98,-84704.26
buyer_6,Manuel,,ES74209567901087476583,TRX_N-00886-71126092,2024-03-28T13:03:32,Vitoria-Gasteiz,expenses,food,-114.76,-84819.02
buyer_6,Manuel,,ES74209567901087476583,TRX_N-00887-86648566,2024-03-28T12:06:33,Vitoria-Gasteiz,expenses,cash,-100.0,-84919.02
buyer_6,Manuel,,ES74209567901087476583,TRX_N-00888-76566277,2024-03-29T21:03:39,Vitoria-Gasteiz,expenses,leisure,-81.16,-85000.18
buyer_6,Manuel,,ES74209567901087476583,TRX_N-00889-47162416,2024-04-01T08:56:58,Vitoria-Gasteiz,incomes,salary,1449.28,-83550.9
buyer_6,Manuel,,ES74209567901087476583,TRX_N-00890-35711361,2024-04-04T08:32:01,Vitoria-Gasteiz,expenses,mortgage,-879.67,-84430.57
buyer_6,Manuel,,ES74209567901087476583,TRX_N-00891-77121654,2024-04-05T11:32:21,Vitoria-Gasteiz,expenses,electricity,-51.81,-84482.38
buyer_6,Manuel,,ES74209567901087476583,TRX_N-00892-74103181,2024-04-05T17:56:30,Vitoria-Gasteiz,expenses,gas,-40.05,-84522.43
buyer_6,Manuel,,ES74209567901087476583,TRX_N-00893-44034382,2024-04-05T09:59:48,Vitoria-Gasteiz,expenses,phone,-41.69,-84564.12
buyer_6,Manuel,,ES74209567901087476583,TRX_N-00894-86727048,2024-04-06T12:24:51,Vitoria-Gasteiz,expenses,food,-66.04,-84630.16
buyer_6,Manuel,,ES74209567901087476583,TRX_N-00895-32604412,2024-04-08T08:07:27,Vitoria-Gasteiz,expenses,water,-30.06,-84660.22
buyer_6,Manuel,,ES74209567901087476583,TRX_N-00896-42164155,2024-04-08T15:30:00,Vitoria-Gasteiz,expenses,internet,-42.0,-84702.22
buyer_6,Manuel,,ES74209567901087476583,TRX_N-00897-96211541,2024-04-08T08:53:10,Lasarte-Oria,expenses,cash,-100.0,-84802.22
buyer_6,Manuel,,ES74209567901087476583,TRX_N-00898-42184538,2024-04-09T15:15:08,Vitoria-Gasteiz,expenses,food,-86.8,-84889.02
buyer_6,Manuel,,ES74209567901087476583,TRX_N-00899-02933513,2024-04-11T16:18:05,Berango,expenses,food,-76.82,-84965.84
buyer_6,Manuel,,ES74209567901087476583,TRX_N-00900-64863828,2024-04-11T17:37:39,Basauri,expenses,gifts,-310.76,-85276.6
buyer_6,Manuel,,ES74209567901087476583,TRX_N-00901-95099942,2024-04-13T10:35:56,Vitoria-Gasteiz,expenses,cash,-100.0,-85376.6
buyer_6,Manuel,,ES74209567901087476583,TRX_N-00902-21154335,2024-04-14T10:07:50,Vitoria-Gasteiz,expenses,leisure,-33.75,-85410.35
buyer_6,Manuel,,ES74209567901087476583,TRX_N-00903-28185047,2024-04-17T16:50:01,Vitoria-Gasteiz,expenses,food,-123.81,-85534.16
buyer_6,Manuel,,ES74209567901087476583,TRX_N-00904-93408255,2024-04-20T11:45:33,Vitoria-Gasteiz,expenses,repairs,-113.5,-85647.66
buyer_6,Manuel,,ES74209567901087476583,TRX_N-00905-26302035,2024-04-23T03:34:01,Santurtzi,expenses,education,-61.01,-85708.67
buyer_6,Manuel,,ES74209567901087476583,TRX_N-00906-44668053,2024-04-24T08:27:50,Vitoria-Gasteiz,expenses,clothing,-92.47,-85801.14
buyer_6,Manuel,,ES74209567901087476583,TRX_N-00907-90745261,2024-04-24T18:33:36,Arrasate,expenses,education,-52.8,-85853.94
buyer_6,Manuel,,ES74209567901087476583,TRX_N-00908-91746873,2024-04-25T12:38:47,Bilbao,expenses,education,-65.33,-85919.27
buyer_6,Manuel,,ES74209567901087476583,TRX_N-00909-05008722,2024-04-25T17:15:09,Andoain,expenses,cash,-100.0,-86019.27
buyer_6,Manuel,,ES74209567901087476583,TRX_N-00910-67508599,2024-04-27T05:43:30,Zarautz,expenses,leisure,-60.43,-86079.7
buyer_6,Manuel,,ES74209567901087476583,TRX_N-00911-31713338,2024-04-28T17:33:20,Vitoria-Gasteiz,expenses,healthcare,-175.14,-86254.84
buyer_6,Manuel,,ES74209567901087476583,TRX_N-00912-29244461,2024-04-30T12:42:39,Vitoria-Gasteiz,expenses,transport,-70.11,-86324.95
buyer_6,Manuel,,ES74209567901087476583,TRX_N-00913-34343354,2024-04-30T22:53:29,Irun,expenses,cash,-100.0,-86424.95
buyer_6,Manuel,,ES74209567901087476583,TRX_N-00914-95744526,2024-05-01T17:58:11,Vitoria-Gasteiz,incomes,salary,1449.28,-84975.67
buyer_6,Manuel,,ES74209567901087476583,TRX_N-00915-92910546,2024-05-03T08:45:33,Donostia,expenses,cash,-100.0,-85075.67
buyer_6,Manuel,,ES74209567901087476583,TRX_N-00916-44533317,2024-05-04T16:47:42,Vitoria-Gasteiz,expenses,mortgage,-879.67,-85955.34
buyer_6,Manuel,,ES74209567901087476583,TRX_N-00917-73135730,2024-05-05T18:54:56,Vitoria-Gasteiz,expenses,appliances,-274.84,-86230.18
buyer_6,Manuel,,ES74209567901087476583,TRX_N-00918-93541733,2024-05-06T11:56:32,Vitoria-Gasteiz,expenses,internet,-42.0,-86272.18
buyer_6,Manuel,,ES74209567901087476583,TRX_N-00919-26725706,2024-05-06T18:51:34,Vitoria-Gasteiz,expenses,food,-77.16,-86349.34
buyer_6,Manuel,,ES74209567901087476583,TRX_N-00920-87915075,2024-05-07T13:06:35,Vitoria-Gasteiz,expenses,cash,-100.0,-86449.34
buyer_6,Manuel,,ES74209567901087476583,TRX_N-00921-23357722,2024-05-08T15:31:20,Vitoria-Gasteiz,expenses,water,-41.84,-86491.18
buyer_6,Manuel,,ES74209567901087476583,TRX_N-00922-94478733,2024-05-08T14:39:40,Vitoria-Gasteiz,expenses,electricity,-32.03,-86523.21
buyer_6,Manuel,,ES74209567901087476583,TRX_N-00923-23487494,2024-05-08T08:33:19,Vitoria-Gasteiz,expenses,gas,-101.09,-86624.3
buyer_6,Manuel,,ES74209567901087476583,TRX_N-00924-22891262,2024-05-08T18:23:17,Vitoria-Gasteiz,expenses,phone,-31.92,-86656.22
buyer_6,Manuel,,ES74209567901087476583,TRX_N-00925-78559215,2024-05-09T04:55:40,Vitoria-Gasteiz,expenses,repairs,-71.45,-86727.67
buyer_6,Manuel,,ES74209567901087476583,TRX_N-00926-04155966,2024-05-10T03:28:08,Vitoria-Gasteiz,expenses,food,-101.99,-86829.66
buyer_6,Manuel,,ES74209567901087476583,TRX_N-00927-78867798,2024-05-11T22:26:21,Vitoria-Gasteiz,expenses,cash,-100.0,-86929.66
buyer_6,Manuel,,ES74209567901087476583,TRX_N-00928-71865065,2024-05-13T15:56:31,Vitoria-Gasteiz,expenses,leisure,-83.69,-87013.35
buyer_6,Manuel,,ES74209567901087476583,TRX_N-00929-02556541,2024-05-13T11:17:35,Vitoria-Gasteiz,expenses,gifts,-140.88,-87154.23
buyer_6,Manuel,,ES74209567901087476583,TRX_N-00930-74265979,2024-05-18T12:20:25,Vitoria-Gasteiz,expenses,leisure,-19.79,-87174.02
buyer_6,Manuel,,ES74209567901087476583,TRX_N-00931-86878193,2024-05-19T09:45:31,Vitoria-Gasteiz,expenses,transport,-68.56,-87242.58
buyer_6,Manuel,,ES74209567901087476583,TRX_N-00932-74346409,2024-05-20T10:14:15,Vitoria-Gasteiz,expenses,food,-80.11,-87322.69
buyer_6,Manuel,,ES74209567901087476583,TRX_N-00933-43744083,2024-05-22T11:47:47,Vitoria-Gasteiz,expenses,food,-123.98,-87446.67
buyer_6,Manuel,,ES74209567901087476583,TRX_N-00934-21589329,2024-05-22T10:07:46,Hondarribia,expenses,leisure,-23.31,-87469.98
buyer_6,Manuel,,ES74209567901087476583,TRX_N-00935-73348233,2024-05-23T09:38:13,Vitoria-Gasteiz,expenses,repairs,-132.43,-87602.41
buyer_6,Manuel,,ES74209567901087476583,TRX_N-00936-54015694,2024-05-25T20:23:47,Amurrio,expenses,healthcare,-91.46,-87693.87
buyer_6,Manuel,,ES74209567901087476583,TRX_N-00937-27410526,2024-05-27T00:47:59,Portugalete,expenses,transport,-81.38,-87775.25
buyer_6,Manuel,,ES74209567901087476583,TRX_N-00938-91607456,2024-05-29T08:58:48,Vitoria-Gasteiz,expenses,repairs,-219.66,-87994.91
buyer_6,Manuel,,ES74209567901087476583,TRX_N-00939-29548977,2024-05-30T10:05:17,Vitoria-Gasteiz,expenses,clothing,-115.48,-88110.39
buyer_6,Manuel,,ES74209567901087476583,TRX_N-00940-72995622,2024-05-31T15:49:49,Vitoria-Gasteiz,expenses,food,-82.69,-88193.08
buyer_6,Manuel,,ES74209567901087476583,TRX_N-00941-76583350,2024-06-01T16:53:44,Vitoria-Gasteiz,incomes,salary,1449.28,-86743.8
buyer_6,Manuel,,ES74209567901087476583,TRX_N-00942-08114219,2024-06-01T16:53:44,Vitoria-Gasteiz,incomes,salary_bonus,1038.29,-85705.51
buyer_6,Manuel,,ES74209567901087476583,TRX_N-00943-80838246,2024-06-01T18:47:35,Vitoria-Gasteiz,expenses,leisure,-25.66,-85731.17
buyer_6,Manuel,,ES74209567901087476583,TRX_N-00944-33095913,2024-06-01T19:25:20,Eibar,expenses,cash,-100.0,-85831.17
buyer_6,Manuel,,ES74209567901087476583,TRX_N-00945-60137064,2024-06-04T17:15:56,Vitoria-Gasteiz,expenses,mortgage,-879.67,-86710.84
buyer_6,Manuel,,ES74209567901087476583,TRX_N-00946-12165566,2024-06-04T18:48:53,Vitoria-Gasteiz,expenses,cash,-100.0,-86810.84
buyer_6,Manuel,,ES74209567901087476583,TRX_N-00947-89028086,2024-06-04T21:55:28,Sopela,expenses,appliances,-263.55,-87074.39
buyer_6,Manuel,,ES74209567901087476583,TRX_N-00948-24879185,2024-06-05T17:41:31,Vitoria-Gasteiz,expenses,leisure,-58.29,-87132.68
buyer_6,Manuel,,ES74209567901087476583,TRX_N-00949-47087566,2024-06-05T15:20:03,Portugalete,expenses,cash,-100.0,-87232.68
buyer_6,Manuel,,ES74209567901087476583,TRX_N-00950-77660237,2024-06-06T11:32:10,Vitoria-Gasteiz,expenses,phone,-43.92,-87276.6
buyer_6,Manuel,,ES74209567901087476583,TRX_N-00951-65315596,2024-06-07T06:16:33,Vitoria-Gasteiz,expenses,water,-35.53,-87312.13
buyer_6,Manuel,,ES74209567901087476583,TRX_N-00952-15614902,2024-06-07T17:09:26,Vitoria-Gasteiz,expenses,leisure,-39.1,-87351.23
buyer_6,Manuel,,ES74209567901087476583,TRX_N-00953-47299938,2024-06-08T13:54:57,Vitoria-Gasteiz,expenses,electricity,-30.54,-87381.77
buyer_6,Manuel,,ES74209567901087476583,TRX_N-00954-57146921,2024-06-08T16:54:51,Vitoria-Gasteiz,expenses,gas,-45.25,-87427.02
buyer_6,Manuel,,ES74209567901087476583,TRX_N-00955-34583156,2024-06-08T16:51:59,Vitoria-Gasteiz,expenses,internet,-42.0,-87469.02
buyer_6,Manuel,,ES74209567901087476583,TRX_N-00956-55023587,2024-06-09T17:01:18,Berango,expenses,food,-114.43,-87583.45
buyer_6,Manuel,,ES74209567901087476583,TRX_N-00957-13279048,2024-06-09T10:54:57,Iruña de Oca,expenses,transport,-63.68,-87647.13
buyer_6,Manuel,,ES74209567901087476583,TRX_N-00958-20169488,2024-06-12T15:06:46,Vitoria-Gasteiz,expenses,leisure,-73.11,-87720.24
buyer_6,Manuel,,ES74209567901087476583,TRX_N-00959-12140117,2024-06-13T21:21:04,Vitoria-Gasteiz,expenses,food,-116.41,-87836.65
buyer_6,Manuel,,ES74209567901087476583,TRX_N-00960-76725068,2024-06-13T13:54:55,Vitoria-Gasteiz,expenses,education,-60.42,-87897.07
buyer_6,Manuel,,ES74209567901087476583,TRX_N-00961-73140502,2024-06-14T10:47:07,Vitoria-Gasteiz,expenses,food,-72.29,-87969.36
buyer_6,Manuel,,ES74209567901087476583,TRX_N-00962-98819354,2024-06-14T08:59:03,Vitoria-Gasteiz,expenses,repairs,-266.49,-88235.85
buyer_6,Manuel,,ES74209567901087476583,TRX_N-00963-01681226,2024-06-15T19:37:33,Vitoria-Gasteiz,expenses,transport,-49.96,-88285.81
buyer_6,Manuel,,ES74209567901087476583,TRX_N-00964-86823006,2024-06-16T16:47:45,Mungia,expenses,cash,-100.0,-88385.81
buyer_6,Manuel,,ES74209567901087476583,TRX_N-00965-32711945,2024-06-19T16:37:57,Errenteria,expenses,cash,-100.0,-88485.81
buyer_6,Manuel,,ES74209567901087476583,TRX_N-00966-92942803,2024-06-19T18:03:50,Mungia,expenses,appliances,-293.11,-88778.92
buyer_6,Manuel,,ES74209567901087476583,TRX_N-00967-87361914,2024-06-21T10:48:21,Elciego,expenses,cash,-100.0,-88878.92
buyer_6,Manuel,,ES74209567901087476583,TRX_N-00968-38874879,2024-06-22T13:25:32,Vitoria-Gasteiz,expenses,education,-45.38,-88924.3
buyer_6,Manuel,,ES74209567901087476583,TRX_N-00969-14531156,2024-06-25T12:09:52,Vitoria-Gasteiz,expenses,cash,-100.0,-89024.3
buyer_6,Manuel,,ES74209567901087476583,TRX_N-00970-89555549,2024-06-27T20:33:05,Vitoria-Gasteiz,expenses,leisure,-76.61,-89100.91
buyer_6,Manuel,,ES74209567901087476583,TRX_N-00971-00361379,2024-06-29T09:52:58,Vitoria-Gasteiz,expenses,leisure,-51.24,-89152.15
buyer_6,Manuel,,ES74209567901087476583,TRX_N-00972-38870295,2024-07-01T09:13:05,Vitoria-Gasteiz,incomes,salary,1449.28,-87702.87
buyer_6,Manuel,,ES74209567901087476583,TRX_N-00973-56800743,2024-07-01T09:13:05,Vitoria-Gasteiz,incomes,extra_income,151.06,-87551.81
buyer_6,Manuel,,ES74209567901087476583,TRX_N-00974-35211356,2024-07-01T17:39:30,Vitoria-Gasteiz,expenses,healthcare,-169.78,-87721.59
buyer_6,Manuel,,ES74209567901087476583,TRX_N-00975-79673075,2024-07-04T10:25:36,Vitoria-Gasteiz,expenses,mortgage,-879.67,-88601.26
buyer_6,Manuel,,ES74209567901087476583,TRX_N-00976-96501772,2024-07-04T16:24:57,Leioa,expenses,transport,-69.42,-88670.68
buyer_6,Manuel,,ES74209567901087476583,TRX_N-00977-97140301,2024-07-04T13:43:19,Vitoria-Gasteiz,expenses,education,-48.91,-88719.59
buyer_6,Manuel,,ES74209567901087476583,TRX_N-00978-36331721,2024-07-05T05:44:42,Vitoria-Gasteiz,expenses,water,-24.63,-88744.22
buyer_6,Manuel,,ES74209567901087476583,TRX_N-00979-94252771,2024-07-05T20:22:05,Vitoria-Gasteiz,expenses,gas,-48.97,-88793.19
buyer_6,Manuel,,ES74209567901087476583,TRX_N-00980-20382565,2024-07-05T15:03:42,Vitoria-Gasteiz,expenses,transport,-46.13,-88839.32
buyer_6,Manuel,,ES74209567901087476583,TRX_N-00981-31415375,2024-07-08T06:39:40,Vitoria-Gasteiz,expenses,internet,-42.0,-88881.32
buyer_6,Manuel,,ES74209567901087476583,TRX_N-00982-32211485,2024-07-08T20:43:15,Vitoria-Gasteiz,expenses,electricity,-25.65,-88906.97
buyer_6,Manuel,,ES74209567901087476583,TRX_N-00983-14094669,2024-07-08T23:17:14,Vitoria-Gasteiz,expenses,phone,-39.75,-88946.72
buyer_6,Manuel,,ES74209567901087476583,TRX_N-00984-69392544,2024-07-08T16:46:59,Vitoria-Gasteiz,expenses,repairs,-315.53,-89262.25
buyer_6,Manuel,,ES74209567901087476583,TRX_N-00985-75869480,2024-07-08T17:32:59,Vitoria-Gasteiz,expenses,gifts,-716.43,-89978.68
buyer_6,Manuel,,ES74209567901087476583,TRX_N-00986-17760504,2024-07-10T14:04:18,Vitoria-Gasteiz,expenses,leisure,-33.65,-90012.33
buyer_6,Manuel,,ES74209567901087476583,TRX_N-00987-56491758,2024-07-10T12:30:16,Vitoria-Gasteiz,expenses,cash,-100.0,-90112.33
buyer_6,Manuel,,ES74209567901087476583,TRX_N-00988-74639071,2024-07-13T08:24:56,Vitoria-Gasteiz,expenses,transport,-66.51,-90178.84
buyer_6,Manuel,,ES74209567901087476583,TRX_N-00989-38897224,2024-07-14T12:48:41,Vitoria-Gasteiz,expenses,leisure,-78.57,-90257.41
buyer_6,Manuel,,ES74209567901087476583,TRX_N-00990-67871442,2024-07-14T15:08:12,Andoain,expenses,cash,-100.0,-90357.41
buyer_6,Manuel,,ES74209567901087476583,TRX_N-00991-45309726,2024-07-15T08:55:07,Iruña de Oca,expenses,appliances,-353.6,-90711.01
buyer_6,Manuel,,ES74209567901087476583,TRX_N-00992-35633577,2024-07-16T10:50:38,Vitoria-Gasteiz,expenses,leisure,-18.01,-90729.02
buyer_6,Manuel,,ES74209567901087476583,TRX_N-00993-79256888,2024-07-17T18:22:20,Vitoria-Gasteiz,expenses,food,-61.37,-90790.39
buyer_6,Manuel,,ES74209567901087476583,TRX_N-00994-04712522,2024-07-17T16:20:44,Zarautz,expenses,transport,-63.8,-90854.19
buyer_6,Manuel,,ES74209567901087476583,TRX_N-00995-92905969,2024-07-18T14:48:46,Vitoria-Gasteiz,expenses,repairs,-166.11,-91020.3
buyer_6,Manuel,,ES74209567901087476583,TRX_N-00996-40670125,2024-07-19T15:27:31,Vitoria-Gasteiz,expenses,clothing,-57.74,-91078.04
buyer_6,Manuel,,ES74209567901087476583,TRX_N-00997-47969406,2024-07-19T17:10:54,Vitoria-Gasteiz,expenses,gifts,-358.55,-91436.59
buyer_6,Manuel,,ES74209567901087476583,TRX_N-00998-64927050,2024-07-20T09:43:22,Vitoria-Gasteiz,expenses,cash,-100.0,-91536.59
buyer_6,Manuel,,ES74209567901087476583,TRX_N-00999-98714413,2024-07-21T20:14:13,Vitoria-Gasteiz,expenses,clothing,-70.08,-91606.67
buyer_6,Manuel,,ES74209567901087476583,TRX_N-01000-22570123,2024-07-22T13:49:13,Vitoria-Gasteiz,expenses,cash,-100.0,-91706.67
buyer_6,Manuel,,ES74209567901087476583,TRX_N-01001-52301377,2024-07-23T19:28:36,Vitoria-Gasteiz,expenses,transport,-63.07,-91769.74
buyer_6,Manuel,,ES74209567901087476583,TRX_N-01002-57119708,2024-07-24T20:40:49,Vitoria-Gasteiz,expenses,cash,-100.0,-91869.74
buyer_6,Manuel,,ES74209567901087476583,TRX_N-01003-87023839,2024-07-25T15:14:25,Getxo,expenses,cash,-100.0,-91969.74
buyer_6,Manuel,,ES74209567901087476583,TRX_N-01004-34070227,2024-07-25T20:01:14,Bermeo,expenses,appliances,-315.69,-92285.43
buyer_6,Manuel,,ES74209567901087476583,TRX_N-01005-19869263,2024-07-26T20:11:37,Berango,expenses,cash,-100.0,-92385.43
buyer_6,Manuel,,ES74209567901087476583,TRX_N-01006-55663746,2024-07-27T21:13:20,Vitoria-Gasteiz,expenses,cash,-100.0,-92485.43
buyer_6,Manuel,,ES74209567901087476583,TRX_N-01007-46986957,2024-07-28T08:11:50,Vitoria-Gasteiz,expenses,cash,-100.0,-92585.43
buyer_6,Manuel,,ES74209567901087476583,TRX_N-01008-84493410,2024-07-28T10:44:31,Vitoria-Gasteiz,expenses,repairs,-57.75,-92643.18
buyer_6,Manuel,,ES74209567901087476583,TRX_N-01009-64963983,2024-07-31T16:30:06,Vitoria-Gasteiz,expenses,cash,-100.0,-92743.18
buyer_6,Manuel,,ES74209567901087476583,TRX_N-01010-23916202,2024-08-01T21:42:35,Vitoria-Gasteiz,incomes,salary,1449.28,-91293.9
buyer_6,Manuel,,ES74209567901087476583,TRX_N-01011-37480960,2024-08-01T16:38:54,Bermeo,expenses,leisure,-64.21,-91358.11
buyer_6,Manuel,,ES74209567901087476583,TRX_N-01012-12683333,2024-08-03T08:57:05,Vitoria-Gasteiz,expenses,gifts,-252.86,-91610.97
buyer_6,Manuel,,ES74209567901087476583,TRX_N-01013-87404196,2024-08-04T11:48:06,Vitoria-Gasteiz,expenses,mortgage,-879.67,-92490.64
buyer_6,Manuel,,ES74209567901087476583,TRX_N-01014-53386029,2024-08-04T13:05:59,Llodio,expenses,gifts,-847.89,-93338.53
buyer_6,Manuel,,ES74209567901087476583,TRX_N-01015-02048621,2024-08-05T16:45:50,Vitoria-Gasteiz,expenses,transport,-51.07,-93389.6
buyer_6,Manuel,,ES74209567901087476583,TRX_N-01016-46224113,2024-08-05T19:47:11,Vitoria-Gasteiz,expenses,leisure,-47.89,-93437.49
buyer_6,Manuel,,ES74209567901087476583,TRX_N-01017-99841193,2024-08-05T13:44:50,Vitoria-Gasteiz,expenses,repairs,-96.94,-93534.43
buyer_6,Manuel,,ES74209567901087476583,TRX_N-01018-87010890,2024-08-05T09:21:51,Vitoria-Gasteiz,expenses,gifts,-782.87,-94317.3
buyer_6,Manuel,,ES74209567901087476583,TRX_N-01019-11849181,2024-08-06T18:46:08,Vitoria-Gasteiz,expenses,electricity,-54.81,-94372.11
buyer_6,Manuel,,ES74209567901087476583,TRX_N-01020-85266760,2024-08-07T08:46:35,Vitoria-Gasteiz,expenses,leisure,-59.09,-94431.2
buyer_6,Manuel,,ES74209567901087476583,TRX_N-01021-45922178,2024-08-08T14:04:24,Vitoria-Gasteiz,expenses,water,-33.31,-94464.51
buyer_6,Manuel,,ES74209567901087476583,TRX_N-01022-42290371,2024-08-08T19:36:34,Vitoria-Gasteiz,expenses,gas,-66.07,-94530.58
buyer_6,Manuel,,ES74209567901087476583,TRX_N-01023-27430685,2024-08-08T13:20:31,Vitoria-Gasteiz,expenses,internet,-42.0,-94572.58
buyer_6,Manuel,,ES74209567901087476583,TRX_N-01024-20122514,2024-08-08T15:35:14,Vitoria-Gasteiz,expenses,phone,-31.65,-94604.23
buyer_6,Manuel,,ES74209567901087476583,TRX_N-01025-12057088,2024-08-08T00:49:22,Vitoria-Gasteiz,expenses,cash,-100.0,-94704.23
buyer_6,Manuel,,ES74209567901087476583,TRX_N-01026-21349567,2024-08-09T12:48:16,Vitoria-Gasteiz,expenses,leisure,-22.35,-94726.58
buyer_6,Manuel,,ES74209567901087476583,TRX_N-01027-63400933,2024-08-09T19:55:18,Arrasate,expenses,repairs,-295.6,-95022.18
buyer_6,Manuel,,ES74209567901087476583,TRX_N-01028-92488687,2024-08-12T14:13:04,Vitoria-Gasteiz,expenses,leisure,-49.25,-95071.43
buyer_6,Manuel,,ES74209567901087476583,TRX_N-01029-19182851,2024-08-13T12:51:56,Vitoria-Gasteiz,expenses,cash,-100.0,-95171.43
buyer_6,Manuel,,ES74209567901087476583,TRX_N-01030-59574880,2024-08-14T11:52:33,Vitoria-Gasteiz,expenses,clothing,-47.96,-95219.39
buyer_6,Manuel,,ES74209567901087476583,TRX_N-01031-71647386,2024-08-15T20:09:18,Vitoria-Gasteiz,expenses,cash,-100.0,-95319.39
buyer_6,Manuel,,ES74209567901087476583,TRX_N-01032-07364857,2024-08-15T10:15:32,Barakaldo,expenses,gifts,-676.65,-95996.04
buyer_6,Manuel,,ES74209567901087476583,TRX_N-01033-13854446,2024-08-16T14:32:18,Vitoria-Gasteiz,expenses,cash,-100.0,-96096.04
buyer_6,Manuel,,ES74209567901087476583,TRX_N-01034-23505020,2024-08-16T05:52:23,Vitoria-Gasteiz,expenses,appliances,-177.91,-96273.95
buyer_6,Manuel,,ES74209567901087476583,TRX_N-01035-34608444,2024-08-17T11:02:28,Bilbao,expenses,repairs,-189.64,-96463.59
buyer_6,Manuel,,ES74209567901087476583,TRX_N-01036-96371936,2024-08-18T10:21:51,Vitoria-Gasteiz,expenses,gifts,-669.72,-97133.31
buyer_6,Manuel,,ES74209567901087476583,TRX_N-01037-35537064,2024-08-19T19:11:18,Amurrio,expenses,cash,-100.0,-97233.31
buyer_6,Manuel,,ES74209567901087476583,TRX_N-01038-53093785,2024-08-20T15:36:26,Vitoria-Gasteiz,expenses,food,-123.85,-97357.16
buyer_6,Manuel,,ES74209567901087476583,TRX_N-01039-26431084,2024-08-20T09:17:01,Vitoria-Gasteiz,expenses,leisure,-37.28,-97394.44
buyer_6,Manuel,,ES74209567901087476583,TRX_N-01040-80700995,2024-08-21T16:32:38,Vitoria-Gasteiz,expenses,education,-57.52,-97451.96
buyer_6,Manuel,,ES74209567901087476583,TRX_N-01041-26479131,2024-08-21T17:15:12,Zarautz,expenses,repairs,-142.86,-97594.82
buyer_6,Manuel,,ES74209567901087476583,TRX_N-01042-73055254,2024-08-21T18:01:48,Vitoria-Gasteiz,expenses,gifts,-629.12,-98223.94
buyer_6,Manuel,,ES74209567901087476583,TRX_N-01043-00900877,2024-08-22T10:09:38,Vitoria-Gasteiz,expenses,food,-121.77,-98345.71
buyer_6,Manuel,,ES74209567901087476583,TRX_N-01044-10909700,2024-08-22T08:11:02,Vitoria-Gasteiz,expenses,clothing,-114.86,-98460.57
buyer_6,Manuel,,ES74209567901087476583,TRX_N-01045-94308793,2024-08-22T22:40:41,Vitoria-Gasteiz,expenses,cash,-100.0,-98560.57
buyer_6,Manuel,,ES74209567901087476583,TRX_N-01046-17013892,2024-08-24T22:28:14,Vitoria-Gasteiz,expenses,transport,-76.5,-98637.07
buyer_6,Manuel,,ES74209567901087476583,TRX_N-01047-09054680,2024-08-24T08:10:19,Vitoria-Gasteiz,expenses,cash,-100.0,-98737.07
buyer_6,Manuel,,ES74209567901087476583,TRX_N-01048-07235103,2024-08-25T14:02:31,Vitoria-Gasteiz,expenses,repairs,-53.16,-98790.23
buyer_6,Manuel,,ES74209567901087476583,TRX_N-01049-84424054,2024-08-28T10:33:43,Vitoria-Gasteiz,expenses,transport,-55.33,-98845.56
buyer_6,Manuel,,ES74209567901087476583,TRX_N-01050-43806311,2024-08-29T12:03:18,Vitoria-Gasteiz,expenses,food,-64.11,-98909.67
buyer_6,Manuel,,ES74209567901087476583,TRX_N-01051-82863833,2024-08-29T17:54:32,Vitoria-Gasteiz,expenses,clothing,-80.43,-98990.1
buyer_6,Manuel,,ES74209567901087476583,TRX_N-01052-70600308,2024-09-01T15:03:20,Vitoria-Gasteiz,incomes,salary,1449.28,-97540.82
buyer_6,Manuel,,ES74209567901087476583,TRX_N-01053-77282197,2024-09-02T15:30:39,Vitoria-Gasteiz,expenses,gifts,-509.68,-98050.5
buyer_6,Manuel,,ES74209567901087476583,TRX_N-01054-64259326,2024-09-03T18:42:35,Donostia,expenses,leisure,-27.34,-98077.84
buyer_6,Manuel,,ES74209567901087476583,TRX_N-01055-02799384,2024-09-04T13:55:15,Vitoria-Gasteiz,expenses,mortgage,-879.67,-98957.51
buyer_6,Manuel,,ES74209567901087476583,TRX_N-01056-50052226,2024-09-04T19:54:25,Vitoria-Gasteiz,expenses,transport,-56.65,-99014.16
buyer_6,Manuel,,ES74209567901087476583,TRX_N-01057-76724131,2024-09-05T08:28:37,Vitoria-Gasteiz,expenses,electricity,-75.23,-99089.39
buyer_6,Manuel,,ES74209567901087476583,TRX_N-01058-03373218,2024-09-06T23:07:44,Vitoria-Gasteiz,expenses,leisure,-49.17,-99138.56
buyer_6,Manuel,,ES74209567901087476583,TRX_N-01059-08369030,2024-09-07T15:47:45,Vitoria-Gasteiz,expenses,water,-26.51,-99165.07
buyer_6,Manuel,,ES74209567901087476583,TRX_N-01060-66754862,2024-09-07T19:25:32,Vitoria-Gasteiz,expenses,gas,-102.84,-99267.91
buyer_6,Manuel,,ES74209567901087476583,TRX_N-01061-85764227,2024-09-07T20:24:14,Vitoria-Gasteiz,expenses,travel,-1074.98,-100342.89
buyer_6,Manuel,,ES74209567901087476583,TRX_N-01062-30102293,2024-09-08T16:51:24,Vitoria-Gasteiz,expenses,internet,-42.0,-100384.89
buyer_6,Manuel,,ES74209567901087476583,TRX_N-01063-63657240,2024-09-08T10:57:48,Vitoria-Gasteiz,expenses,phone,-35.19,-100420.08
buyer_6,Manuel,,ES74209567901087476583,TRX_N-01064-26459866,2024-09-09T14:42:27,Getxo,expenses,leisure,-68.41,-100488.49
buyer_6,Manuel,,ES74209567901087476583,TRX_N-01065-94185279,2024-09-10T08:06:00,Vitoria-Gasteiz,expenses,cash,-100.0,-100588.49
buyer_6,Manuel,,ES74209567901087476583,TRX_N-01066-17147985,2024-09-12T10:11:33,Vitoria-Gasteiz,expenses,gifts,-841.21,-101429.7
buyer_6,Manuel,,ES74209567901087476583,TRX_N-01067-20344702,2024-09-14T21:48:47,Vitoria-Gasteiz,expenses,repairs,-183.29,-101612.99
buyer_6,Manuel,,ES74209567901087476583,TRX_N-01068-24242454,2024-09-15T08:34:33,Oyón-Oion,expenses,food,-115.22,-101728.21
buyer_6,Manuel,,ES74209567901087476583,TRX_N-01069-82511429,2024-09-15T18:36:48,Vitoria-Gasteiz,expenses,leisure,-29.86,-101758.07
buyer_6,Manuel,,ES74209567901087476583,TRX_N-01070-21541377,2024-09-16T20:51:18,Vitoria-Gasteiz,expenses,leisure,-41.63,-101799.7
buyer_6,Manuel,,ES74209567901087476583,TRX_N-01071-55557401,2024-09-16T22:12:42,Vitoria-Gasteiz,expenses,cash,-100.0,-101899.7
buyer_6,Manuel,,ES74209567901087476583,TRX_N-01072-20931770,2024-09-17T10:58:35,Alegría-Dulantzi,expenses,cash,-100.0,-101999.7
buyer_6,Manuel,,ES74209567901087476583,TRX_N-01073-53839218,2024-09-19T10:23:16,Vitoria-Gasteiz,expenses,food,-99.41,-102099.11
buyer_6,Manuel,,ES74209567901087476583,TRX_N-01074-46758598,2024-09-22T08:54:22,Vitoria-Gasteiz,expenses,transport,-67.15,-102166.26
buyer_6,Manuel,,ES74209567901087476583,TRX_N-01075-60914307,2024-09-26T17:56:16,Vitoria-Gasteiz,expenses,cash,-100.0,-102266.26
buyer_6,Manuel,,ES74209567901087476583,TRX_N-01076-77645913,2024-09-27T17:36:08,Vitoria-Gasteiz,expenses,gifts,-374.24,-102640.5
buyer_6,Manuel,,ES74209567901087476583,TRX_N-01077-18910964,2024-09-28T13:26:04,Vitoria-Gasteiz,expenses,cash,-100.0,-102740.5
buyer_6,Manuel,,ES74209567901087476583,TRX_N-01078-27755165,2024-09-29T15:16:02,Vitoria-Gasteiz,expenses,gifts,-257.47,-102997.97
buyer_6,Manuel,,ES74209567901087476583,TRX_N-01079-58795369,2024-09-30T10:09:08,Vitoria-Gasteiz,expenses,food,-60.54,-103058.51
buyer_6,Manuel,,ES74209567901087476583,TRX_N-01080-29438465,2024-10-01T17:57:11,Vitoria-Gasteiz,incomes,salary,1449.28,-101609.23
buyer_6,Manuel,,ES74209567901087476583,TRX_N-01081-50772951,2024-10-01T17:57:11,Vitoria-Gasteiz,incomes,extra_income,151.06,-101458.17
buyer_6,Manuel,,ES74209567901087476583,TRX_N-01082-32027650,2024-10-02T16:23:21,Vitoria-Gasteiz,expenses,repairs,-66.0,-101524.17
buyer_6,Manuel,,ES74209567901087476583,TRX_N-01083-00232596,2024-10-02T08:34:29,Vitoria-Gasteiz,expenses,gifts,-82.5,-101606.67
buyer_6,Manuel,,ES74209567901087476583,TRX_N-01084-24747302,2024-10-03T18:46:13,Vitoria-Gasteiz,expenses,food,-75.64,-101682.31
buyer_6,Manuel,,ES74209567901087476583,TRX_N-01085-37607106,2024-10-03T14:25:56,Vitoria-Gasteiz,expenses,leisure,-47.26,-101729.57
buyer_6,Manuel,,ES74209567901087476583,TRX_N-01086-25583458,2024-10-03T13:52:25,Vitoria-Gasteiz,expenses,clothing,-99.88,-101829.45
buyer_6,Manuel,,ES74209567901087476583,TRX_N-01087-62782881,2024-10-04T18:07:03,Vitoria-Gasteiz,expenses,mortgage,-879.67,-102709.12
buyer_6,Manuel,,ES74209567901087476583,TRX_N-01088-44325335,2024-10-04T13:09:33,Vitoria-Gasteiz,expenses,transport,-67.24,-102776.36
buyer_6,Manuel,,ES74209567901087476583,TRX_N-01089-30843640,2024-10-04T14:57:31,Salvatierra/Agurain,expenses,gifts,-245.66,-103022.02
buyer_6,Manuel,,ES74209567901087476583,TRX_N-01090-89629055,2024-10-05T13:06:38,Vitoria-Gasteiz,expenses,phone,-33.61,-103055.63
buyer_6,Manuel,,ES74209567901087476583,TRX_N-01091-45097566,2024-10-06T12:24:33,Vitoria-Gasteiz,expenses,water,-20.56,-103076.19
buyer_6,Manuel,,ES74209567901087476583,TRX_N-01092-45279423,2024-10-06T20:09:49,Vitoria-Gasteiz,expenses,gifts,-604.5,-103680.69
buyer_6,Manuel,,ES74209567901087476583,TRX_N-01093-56699255,2024-10-07T16:15:24,Vitoria-Gasteiz,expenses,internet,-42.0,-103722.69
buyer_6,Manuel,,ES74209567901087476583,TRX_N-01094-12405228,2024-10-08T15:28:02,Vitoria-Gasteiz,expenses,electricity,-53.64,-103776.33
buyer_6,Manuel,,ES74209567901087476583,TRX_N-01095-12996528,2024-10-08T17:46:35,Vitoria-Gasteiz,expenses,gas,-109.91,-103886.24
buyer_7,María,,ES51209558104632098726,TRX_N-00001-93260285,2022-01-01T08:32:22,Portugalete,incomes,salary,1392.56,3456.83
buyer_7,María,,ES51209558104632098726,TRX_N-00002-02512196,2022-01-01T23:21:52,Portugalete,expenses,healthcare,-50.85,3405.98
buyer_7,María,,ES51209558104632098726,TRX_N-00003-42618021,2022-01-04T10:34:22,Portugalete,expenses,mortgage,-1094.46,2311.52
buyer_7,María,,ES51209558104632098726,TRX_N-00004-16989488,2022-01-04T09:39:18,Portugalete,expenses,travel,-1836.94,474.58
buyer_7,María,,ES51209558104632098726,TRX_N-00005-62187748,2022-01-04T17:53:38,Portugalete,expenses,repairs,-286.03,188.55
buyer_7,María,,ES51209558104632098726,TRX_N-00006-78913398,2022-01-05T19:54:02,Portugalete,expenses,gifts,-738.79,-550.24
buyer_7,María,,ES51209558104632098726,TRX_N-00007-25285964,2022-01-07T10:30:11,Portugalete,expenses,gas,-55.57,-605.81
buyer_7,María,,ES51209558104632098726,TRX_N-00008-51468998,2022-01-08T19:16:20,Portugalete,expenses,internet,-42.0,-647.81
buyer_7,María,,ES51209558104632098726,TRX_N-00009-17897528,2022-01-08T18:13:33,Portugalete,expenses,water,-31.73,-679.54
buyer_7,María,,ES51209558104632098726,TRX_N-00010-57187817,2022-01-08T04:35:15,Portugalete,expenses,electricity,-64.83,-744.37
buyer_7,María,,ES51209558104632098726,TRX_N-00011-85518254,2022-01-08T10:12:57,Portugalete,expenses,phone,-43.56,-787.93
buyer_7,María,,ES51209558104632098726,TRX_N-00012-15786409,2022-01-10T20:30:26,Portugalete,expenses,cash,-100.0,-887.93
buyer_7,María,,ES51209558104632098726,TRX_N-00013-10711355,2022-01-11T14:51:20,Portugalete,expenses,food,-66.38,-954.31
buyer_7,María,,ES51209558104632098726,TRX_N-00014-32113080,2022-01-12T16:58:12,Portugalete,expenses,food,-67.9,-1022.21
buyer_7,María,,ES51209558104632098726,TRX_N-00015-77496592,2022-01-12T11:54:34,Erandio,expenses,transport,-46.58,-1068.79
buyer_7,María,,ES51209558104632098726,TRX_N-00016-89180107,2022-01-13T16:17:32,Portugalete,expenses,food,-108.36,-1177.15
buyer_7,María,,ES51209558104632098726,TRX_N-00017-95693478,2022-01-14T08:22:16,Portugalete,expenses,food,-72.28,-1249.43
buyer_7,María,,ES51209558104632098726,TRX_N-00018-53148364,2022-01-14T19:03:17,Portugalete,expenses,gifts,-571.08,-1820.51
buyer_7,María,,ES51209558104632098726,TRX_N-00019-29790074,2022-01-16T03:39:06,Portugalete,expenses,gifts,-349.53,-2170.04
buyer_7,María,,ES51209558104632098726,TRX_N-00020-95858988,2022-01-17T12:36:49,Portugalete,expenses,education,-50.88,-2220.92
buyer_7,María,,ES51209558104632098726,TRX_N-00021-40908107,2022-01-19T11:20:45,Labastida,expenses,food,-92.56,-2313.48
buyer_7,María,,ES51209558104632098726,TRX_N-00022-32932022,2022-01-19T20:29:54,Vitoria-Gasteiz,expenses,gifts,-726.55,-3040.03
buyer_7,María,,ES51209558104632098726,TRX_N-00023-18126823,2022-01-21T14:30:55,Portugalete,expenses,transport,-40.92,-3080.95
buyer_7,María,,ES51209558104632098726,TRX_N-00024-51410659,2022-01-21T20:57:00,Portugalete,expenses,repairs,-200.69,-3281.64
buyer_7,María,,ES51209558104632098726,TRX_N-00025-42531308,2022-01-22T12:51:27,Portugalete,expenses,repairs,-172.71,-3454.35
buyer_7,María,,ES51209558104632098726,TRX_N-00026-32581073,2022-01-22T23:31:12,Portugalete,expenses,children,-181.32,-3635.67
buyer_7,María,,ES51209558104632098726,TRX_N-00027-89443302,2022-01-23T19:28:11,Portugalete,expenses,appliances,-398.44,-4034.11
buyer_7,María,,ES51209558104632098726,TRX_N-00028-76274212,2022-02-01T21:25:15,Portugalete,incomes,salary,1392.56,-2641.55
buyer_7,María,,ES51209558104632098726,TRX_N-00029-61516065,2022-02-01T03:09:08,Portugalete,expenses,transport,-49.16,-2690.71
buyer_7,María,,ES51209558104632098726,TRX_N-00030-90174560,2022-02-02T22:30:47,Portugalete,expenses,leisure,-68.96,-2759.67
buyer_7,María,,ES51209558104632098726,TRX_N-00031-58803373,2022-02-03T17:25:23,Portugalete,expenses,leisure,-48.34,-2808.01
buyer_7,María,,ES51209558104632098726,TRX_N-00032-24407505,2022-02-04T19:07:19,Portugalete,expenses,mortgage,-1094.46,-3902.47
buyer_7,María,,ES51209558104632098726,TRX_N-00033-13179752,2022-02-04T18:01:30,Portugalete,expenses,leisure,-84.15,-3986.62
buyer_7,María,,ES51209558104632098726,TRX_N-00034-19424543,2022-02-04T23:45:19,Portugalete,expenses,appliances,-290.25,-4276.87
buyer_7,María,,ES51209558104632098726,TRX_N-00035-04448662,2022-02-05T13:35:34,Portugalete,expenses,water,-32.67,-4309.54
buyer_7,María,,ES51209558104632098726,TRX_N-00036-61037037,2022-02-05T21:46:42,Portugalete,expenses,internet,-42.0,-4351.54
buyer_7,María,,ES51209558104632098726,TRX_N-00037-31172918,2022-02-05T15:49:22,Portugalete,expenses,phone,-31.75,-4383.29
buyer_7,María,,ES51209558104632098726,TRX_N-00038-08037047,2022-02-05T22:43:02,Barakaldo,expenses,transport,-71.18,-4454.47
buyer_7,María,,ES51209558104632098726,TRX_N-00039-48961356,2022-02-06T23:49:56,Portugalete,expenses,electricity,-82.23,-4536.7
buyer_7,María,,ES51209558104632098726,TRX_N-00040-89964008,2022-02-06T23:27:29,Portugalete,expenses,healthcare,-101.51,-4638.21
buyer_7,María,,ES51209558104632098726,TRX_N-00041-92420684,2022-02-07T18:37:41,Portugalete,expenses,children,-481.1,-5119.31
buyer_7,María,,ES51209558104632098726,TRX_N-00042-48069361,2022-02-08T00:07:02,Portugalete,expenses,gas,-85.29,-5204.6
buyer_7,María,,ES51209558104632098726,TRX_N-00043-93375037,2022-02-09T11:54:40,Bilbao,expenses,cash,-100.0,-5304.6
buyer_7,María,,ES51209558104632098726,TRX_N-00044-60352719,2022-02-12T11:38:25,Portugalete,expenses,transport,-42.59,-5347.19
buyer_7,María,,ES51209558104632098726,TRX_N-00045-13406785,2022-02-12T15:11:49,Portugalete,expenses,cash,-100.0,-5447.19
buyer_7,María,,ES51209558104632098726,TRX_N-00046-51481904,2022-02-12T22:26:49,Portugalete,expenses,repairs,-296.96,-5744.15
buyer_7,María,,ES51209558104632098726,TRX_N-00047-63117585,2022-02-15T19:59:12,Sopela,expenses,food,-99.97,-5844.12
buyer_7,María,,ES51209558104632098726,TRX_N-00048-37953920,2022-02-16T22:07:11,Amurrio,expenses,food,-121.46,-5965.58
buyer_7,María,,ES51209558104632098726,TRX_N-00049-82723808,2022-02-19T18:54:02,Erandio,expenses,leisure,-36.07,-6001.65
buyer_7,María,,ES51209558104632098726,TRX_N-00050-74248136,2022-02-20T19:58:44,Portugalete,expenses,transport,-66.34,-6067.99
buyer_7,María,,ES51209558104632098726,TRX_N-00051-34734678,2022-02-24T06:45:01,Portugalete,expenses,appliances,-237.46,-6305.45
buyer_7,María,,ES51209558104632098726,TRX_N-00052-12735139,2022-02-27T13:51:11,Portugalete,expenses,healthcare,-99.08,-6404.53
buyer_7,María,,ES51209558104632098726,TRX_N-00053-03339903,2022-03-01T17:41:11,Portugalete,incomes,salary,1392.56,-5011.97
buyer_7,María,,ES51209558104632098726,TRX_N-00054-53522400,2022-03-01T14:48:37,Portugalete,expenses,cash,-100.0,-5111.97
buyer_7,María,,ES51209558104632098726,TRX_N-00055-99979053,2022-03-03T10:18:26,Portugalete,expenses,gifts,-619.48,-5731.45
buyer_7,María,,ES51209558104632098726,TRX_N-00056-05500198,2022-03-04T18:09:37,Portugalete,expenses,mortgage,-1094.46,-6825.91
buyer_7,María,,ES51209558104632098726,TRX_N-00057-32315938,2022-03-05T14:37:47,Portugalete,expenses,water,-40.87,-6866.78
buyer_7,María,,ES51209558104632098726,TRX_N-00058-03402794,2022-03-05T08:12:29,Portugalete,expenses,gas,-78.78,-6945.56
buyer_7,María,,ES51209558104632098726,TRX_N-00059-87912457,2022-03-05T20:40:21,Portugalete,expenses,phone,-35.49,-6981.05
buyer_7,María,,ES51209558104632098726,TRX_N-00060-95937689,2022-03-05T16:40:12,Eibar,expenses,education,-64.77,-7045.82
buyer_7,María,,ES51209558104632098726,TRX_N-00061-89885557,2022-03-06T11:35:53,Portugalete,expenses,clothing,-139.17,-7184.99
buyer_7,María,,ES51209558104632098726,TRX_N-00062-75426708,2022-03-06T02:10:06,Portugalete,expenses,children,-366.52,-7551.51
buyer_7,María,,ES51209558104632098726,TRX_N-00063-69222892,2022-03-07T00:43:53,Portugalete,expenses,electricity,-58.42,-7609.93
buyer_7,María,,ES51209558104632098726,TRX_N-00064-35954984,2022-03-08T20:39:16,Portugalete,expenses,internet,-42.0,-7651.93
buyer_7,María,,ES51209558104632098726,TRX_N-00065-09021359,2022-03-08T20:45:43,Portugalete,expenses,cash,-100.0,-7751.93
buyer_7,María,,ES51209558104632098726,TRX_N-00066-43819249,2022-03-09T15:52:15,Portugalete,expenses,clothing,-119.77,-7871.7
buyer_7,María,,ES51209558104632098726,TRX_N-00067-29179487,2022-03-10T15:14:32,Portugalete,expenses,gifts,-481.05,-8352.75
buyer_7,María,,ES51209558104632098726,TRX_N-00068-34119160,2022-03-11T16:56:12,Portugalete,expenses,leisure,-27.06,-8379.81
buyer_7,María,,ES51209558104632098726,TRX_N-00069-53437622,2022-03-11T15:31:13,Portugalete,expenses,repairs,-260.21,-8640.02
buyer_7,María,,ES51209558104632098726,TRX_N-00070-09360653,2022-03-12T23:25:29,Portugalete,expenses,cash,-100.0,-8740.02
buyer_7,María,,ES51209558104632098726,TRX_N-00071-19881145,2022-03-14T19:03:47,Portugalete,expenses,cash,-100.0,-8840.02
buyer_7,María,,ES51209558104632098726,TRX_N-00072-20204995,2022-03-16T11:40:57,Portugalete,expenses,appliances,-288.78,-9128.8
buyer_7,María,,ES51209558104632098726,TRX_N-00073-37127734,2022-03-18T18:00:43,Portugalete,expenses,repairs,-191.42,-9320.22
buyer_7,María,,ES51209558104632098726,TRX_N-00074-29697242,2022-03-19T15:17:28,Portugalete,expenses,food,-84.11,-9404.33
buyer_7,María,,ES51209558104632098726,TRX_N-00075-09815561,2022-03-20T11:57:31,Portugalete,expenses,transport,-53.8,-9458.13
buyer_7,María,,ES51209558104632098726,TRX_N-00076-24915984,2022-03-21T05:40:32,Hernani,expenses,travel,-573.26,-10031.39
buyer_7,María,,ES51209558104632098726,TRX_N-00077-97204850,2022-03-22T19:13:42,Portugalete,expenses,transport,-73.72,-10105.11
buyer_7,María,,ES51209558104632098726,TRX_N-00078-63107131,2022-03-22T20:17:19,Portugalete,expenses,repairs,-158.82,-10263.93
buyer_7,María,,ES51209558104632098726,TRX_N-00079-03179617,2022-03-23T20:23:44,Portugalete,expenses,clothing,-135.86,-10399.79
buyer_7,María,,ES51209558104632098726,TRX_N-00080-19222177,2022-03-25T14:38:39,Portugalete,expenses,food,-72.93,-10472.72
buyer_7,María,,ES51209558104632098726,TRX_N-00081-15998906,2022-03-29T13:35:29,Portugalete,expenses,leisure,-25.68,-10498.4
buyer_7,María,,ES51209558104632098726,TRX_N-00082-04300378,2022-03-29T17:31:49,Portugalete,expenses,repairs,-43.64,-10542.04
buyer_7,María,,ES51209558104632098726,TRX_N-00083-27761710,2022-03-30T17:49:10,Portugalete,expenses,food,-124.5,-10666.54
buyer_7,María,,ES51209558104632098726,TRX_N-00084-73519778,2022-03-31T02:23:33,Portugalete,expenses,education,-42.08,-10708.62
buyer_7,María,,ES51209558104632098726,TRX_N-00085-00632376,2022-04-01T16:25:06,Portugalete,incomes,salary,1392.56,-9316.06
buyer_7,María,,ES51209558104632098726,TRX_N-00086-28462213,2022-04-01T16:25:06,Portugalete,incomes,extra_income,214.51,-9101.55
buyer_7,María,,ES51209558104632098726,TRX_N-00087-99317289,2022-04-01T09:55:57,Portugalete,expenses,leisure,-48.39,-9149.94
buyer_7,María,,ES51209558104632098726,TRX_N-00088-92204278,2022-04-03T02:46:50,Portugalete,expenses,clothing,-159.53,-9309.47
buyer_7,María,,ES51209558104632098726,TRX_N-00089-38803777,2022-04-04T17:53:51,Portugalete,expenses,mortgage,-1094.46,-10403.93
buyer_7,María,,ES51209558104632098726,TRX_N-00090-33858307,2022-04-04T21:48:31,Eibar,expenses,cash,-100.0,-10503.93
buyer_7,María,,ES51209558104632098726,TRX_N-00091-77469749,2022-04-05T12:37:29,Portugalete,expenses,water,-24.01,-10527.94
buyer_7,María,,ES51209558104632098726,TRX_N-00092-67719938,2022-04-05T17:33:40,Portugalete,expenses,gas,-105.1,-10633.04
buyer_7,María,,ES51209558104632098726,TRX_N-00093-22513882,2022-04-05T09:46:13,Portugalete,expenses,phone,-32.55,-10665.59
buyer_7,María,,ES51209558104632098726,TRX_N-00094-09461756,2022-04-06T11:56:33,Portugalete,expenses,internet,-42.0,-10707.59
buyer_7,María,,ES51209558104632098726,TRX_N-00095-23545784,2022-04-06T19:37:38,Portugalete,expenses,transport,-87.27,-10794.86
buyer_7,María,,ES51209558104632098726,TRX_N-00096-62756573,2022-04-06T17:05:31,Portugalete,expenses,repairs,-178.53,-10973.39
buyer_7,María,,ES51209558104632098726,TRX_N-00097-99992922,2022-04-06T22:39:43,Portugalete,expenses,gifts,-69.04,-11042.43
buyer_7,María,,ES51209558104632098726,TRX_N-00098-90562065,2022-04-08T15:56:15,Portugalete,expenses,electricity,-25.76,-11068.19
buyer_7,María,,ES51209558104632098726,TRX_N-00099-69231031,2022-04-09T10:17:22,Portugalete,expenses,food,-117.51,-11185.7
buyer_7,María,,ES51209558104632098726,TRX_N-00100-65959570,2022-04-09T11:12:33,Portugalete,expenses,cash,-100.0,-11285.7
buyer_7,María,,ES51209558104632098726,TRX_N-00101-62035377,2022-04-09T17:04:13,Portugalete,expenses,appliances,-384.51,-11670.21
buyer_7,María,,ES51209558104632098726,TRX_N-00102-14736111,2022-04-10T12:25:20,Vitoria-Gasteiz,expenses,clothing,-100.2,-11770.41
buyer_7,María,,ES51209558104632098726,TRX_N-00103-68491277,2022-04-13T12:43:55,Alegría-Dulantzi,expenses,food,-103.59,-11874.0
buyer_7,María,,ES51209558104632098726,TRX_N-00104-05115479,2022-04-14T10:38:02,Elciego,expenses,cash,-100.0,-11974.0
buyer_7,María,,ES51209558104632098726,TRX_N-00105-94776486,2022-04-15T16:33:43,Portugalete,expenses,cash,-100.0,-12074.0
buyer_7,María,,ES51209558104632098726,TRX_N-00106-39799529,2022-04-16T09:47:36,Portugalete,expenses,food,-111.72,-12185.72
buyer_7,María,,ES51209558104632098726,TRX_N-00107-31614655,2022-04-17T20:31:44,Portugalete,expenses,cash,-100.0,-12285.72
buyer_7,María,,ES51209558104632098726,TRX_N-00108-17379758,2022-04-18T16:49:03,Portugalete,expenses,cash,-100.0,-12385.72
buyer_7,María,,ES51209558104632098726,TRX_N-00109-58725692,2022-04-20T10:51:04,Portugalete,expenses,healthcare,-101.63,-12487.35
buyer_7,María,,ES51209558104632098726,TRX_N-00110-21344694,2022-04-23T11:51:59,Portugalete,expenses,cash,-100.0,-12587.35
buyer_7,María,,ES51209558104632098726,TRX_N-00111-24955071,2022-04-24T15:11:16,Donostia,expenses,transport,-64.19,-12651.54
buyer_7,María,,ES51209558104632098726,TRX_N-00112-42989607,2022-04-25T15:04:54,Portugalete,expenses,food,-61.46,-12713.0
buyer_7,María,,ES51209558104632098726,TRX_N-00113-50069261,2022-04-25T13:20:54,Portugalete,expenses,appliances,-184.8,-12897.8
buyer_7,María,,ES51209558104632098726,TRX_N-00114-15102331,2022-04-26T08:57:20,Portugalete,expenses,leisure,-47.62,-12945.42
buyer_7,María,,ES51209558104632098726,TRX_N-00115-16314960,2022-04-27T19:00:33,Hondarribia,expenses,food,-118.99,-13064.41
buyer_7,María,,ES51209558104632098726,TRX_N-00116-05092693,2022-04-27T08:49:56,Portugalete,expenses,gifts,-772.81,-13837.22
buyer_7,María,,ES51209558104632098726,TRX_N-00117-47666777,2022-04-28T13:00:35,Portugalete,expenses,gifts,-716.36,-14553.58
buyer_7,María,,ES51209558104632098726,TRX_N-00118-15294386,2022-04-29T22:50:55,Portugalete,expenses,transport,-57.3,-14610.88
buyer_7,María,,ES51209558104632098726,TRX_N-00119-69303157,2022-04-29T15:17:42,Errenteria,expenses,repairs,-324.74,-14935.62
buyer_7,María,,ES51209558104632098726,TRX_N-00120-92799630,2022-05-01T13:40:09,Portugalete,incomes,salary,1392.56,-13543.06
buyer_7,María,,ES51209558104632098726,TRX_N-00121-24721018,2022-05-03T20:22:19,Hernani,expenses,transport,-84.36,-13627.42
buyer_7,María,,ES51209558104632098726,TRX_N-00122-22662666,2022-05-04T16:14:18,Portugalete,expenses,mortgage,-1094.46,-14721.88
buyer_7,María,,ES51209558104632098726,TRX_N-00123-82583978,2022-05-05T19:02:15,Portugalete,expenses,electricity,-31.36,-14753.24
buyer_7,María,,ES51209558104632098726,TRX_N-00124-11975026,2022-05-05T22:46:44,Portugalete,expenses,food,-64.58,-14817.82
buyer_7,María,,ES51209558104632098726,TRX_N-00125-54802646,2022-05-06T08:23:17,Portugalete,expenses,water,-40.56,-14858.38
buyer_7,María,,ES51209558104632098726,TRX_N-00126-47493949,2022-05-06T12:56:44,Portugalete,expenses,gas,-107.27,-14965.65
buyer_7,María,,ES51209558104632098726,TRX_N-00127-45505022,2022-05-06T09:02:00,Salvatierra/Agurain,expenses,leisure,-19.34,-14984.99
buyer_7,María,,ES51209558104632098726,TRX_N-00128-77849039,2022-05-06T17:07:38,Portugalete,expenses,cash,-100.0,-15084.99
buyer_7,María,,ES51209558104632098726,TRX_N-00129-04887101,2022-05-08T15:05:20,Portugalete,expenses,phone,-42.63,-15127.62
buyer_7,María,,ES51209558104632098726,TRX_N-00130-57537965,2022-05-08T11:05:57,Portugalete,expenses,internet,-42.0,-15169.62
buyer_7,María,,ES51209558104632098726,TRX_N-00131-31714362,2022-05-09T15:41:31,Bermeo,expenses,cash,-100.0,-15269.62
buyer_7,María,,ES51209558104632098726,TRX_N-00132-17949373,2022-05-10T09:46:04,Portugalete,expenses,children,-408.3,-15677.92
buyer_7,María,,ES51209558104632098726,TRX_N-00133-43636089,2022-05-11T19:09:18,Pasaia,expenses,cash,-100.0,-15777.92
buyer_7,María,,ES51209558104632098726,TRX_N-00134-86848160,2022-05-12T08:03:01,Portugalete,expenses,transport,-59.0,-15836.92
buyer_7,María,,ES51209558104632098726,TRX_N-00135-98263497,2022-05-14T10:09:11,Portugalete,expenses,food,-87.71,-15924.63
buyer_7,María,,ES51209558104632098726,TRX_N-00136-70224174,2022-05-14T10:28:00,Bermeo,expenses,cash,-100.0,-16024.63
buyer_7,María,,ES51209558104632098726,TRX_N-00137-79603094,2022-05-17T12:54:43,Portugalete,expenses,food,-109.36,-16133.99
buyer_7,María,,ES51209558104632098726,TRX_N-00138-63478209,2022-05-18T19:37:58,Portugalete,expenses,appliances,-175.16,-16309.15
buyer_7,María,,ES51209558104632098726,TRX_N-00139-86673860,2022-05-19T14:09:40,Portugalete,expenses,leisure,-79.61,-16388.76
buyer_7,María,,ES51209558104632098726,TRX_N-00140-76627286,2022-05-19T17:21:15,Portugalete,expenses,repairs,-61.01,-16449.77
buyer_7,María,,ES51209558104632098726,TRX_N-00141-77768392,2022-05-20T11:59:15,Portugalete,expenses,food,-74.25,-16524.02
buyer_7,María,,ES51209558104632098726,TRX_N-00142-27327051,2022-05-20T15:54:02,Portugalete,expenses,leisure,-27.25,-16551.27
buyer_7,María,,ES51209558104632098726,TRX_N-00143-59681601,2022-05-21T04:04:18,Portugalete,expenses,cash,-100.0,-16651.27
buyer_7,María,,ES51209558104632098726,TRX_N-00144-78248210,2022-05-23T23:59:56,Portugalete,expenses,leisure,-67.18,-16718.45
buyer_7,María,,ES51209558104632098726,TRX_N-00145-02683986,2022-05-24T17:52:07,Amurrio,expenses,gifts,-341.2,-17059.65
buyer_7,María,,ES51209558104632098726,TRX_N-00146-83101603,2022-05-25T11:33:38,Portugalete,expenses,repairs,-143.0,-17202.65
buyer_7,María,,ES51209558104632098726,TRX_N-00147-15038702,2022-05-26T01:44:51,Errenteria,expenses,cash,-100.0,-17302.65
buyer_7,María,,ES51209558104632098726,TRX_N-00148-07098740,2022-05-27T19:22:00,Portugalete,expenses,repairs,-238.23,-17540.88
buyer_7,María,,ES51209558104632098726,TRX_N-00149-93623500,2022-05-27T19:05:45,Portugalete,expenses,children,-496.52,-18037.4
buyer_7,María,,ES51209558104632098726,TRX_N-00150-91240416,2022-05-29T21:18:58,Portugalete,expenses,leisure,-40.6,-18078.0
buyer_7,María,,ES51209558104632098726,TRX_N-00151-63741197,2022-05-30T00:54:03,Portugalete,expenses,food,-108.86,-18186.86
buyer_7,María,,ES51209558104632098726,TRX_N-00152-88317830,2022-05-30T18:59:27,Amurrio,expenses,healthcare,-142.7,-18329.56
buyer_7,María,,ES51209558104632098726,TRX_N-00153-83608454,2022-05-31T12:53:18,Eibar,expenses,repairs,-219.88,-18549.44
buyer_7,María,,ES51209558104632098726,TRX_N-00154-92304218,2022-06-01T16:22:27,Portugalete,incomes,salary,1392.56,-17156.88
buyer_7,María,,ES51209558104632098726,TRX_N-00155-33343681,2022-06-01T16:22:27,Portugalete,incomes,salary_bonus,1048.63,-16108.25
buyer_7,María,,ES51209558104632098726,TRX_N-00156-11977178,2022-06-04T15:52:26,Portugalete,expenses,mortgage,-1094.46,-17202.71
buyer_7,María,,ES51209558104632098726,TRX_N-00157-72739948,2022-06-05T18:21:07,Portugalete,expenses,water,-27.35,-17230.06
buyer_7,María,,ES51209558104632098726,TRX_N-00158-07845901,2022-06-05T19:12:26,Portugalete,expenses,gas,-107.67,-17337.73
buyer_7,María,,ES51209558104632098726,TRX_N-00159-53995062,2022-06-05T19:29:58,Portugalete,expenses,internet,-42.0,-17379.73
buyer_7,María,,ES51209558104632098726,TRX_N-00160-75157168,2022-06-05T17:20:44,Portugalete,expenses,phone,-30.5,-17410.23
buyer_7,María,,ES51209558104632098726,TRX_N-00161-06816235,2022-06-06T18:07:27,Portugalete,expenses,electricity,-74.93,-17485.16
buyer_7,María,,ES51209558104632098726,TRX_N-00162-01631671,2022-06-07T19:56:30,Andoain,expenses,food,-73.54,-17558.7
buyer_7,María,,ES51209558104632098726,TRX_N-00163-63638813,2022-06-08T21:24:34,Portugalete,expenses,travel,-522.97,-18081.67
buyer_7,María,,ES51209558104632098726,TRX_N-00164-39356451,2022-06-09T12:03:23,Basauri,expenses,cash,-100.0,-18181.67
buyer_7,María,,ES51209558104632098726,TRX_N-00165-30925213,2022-06-10T23:11:49,Portugalete,expenses,cash,-100.0,-18281.67
buyer_7,María,,ES51209558104632098726,TRX_N-00166-70820306,2022-06-11T15:13:06,Bilbao,expenses,leisure,-82.43,-18364.1
buyer_7,María,,ES51209558104632098726,TRX_N-00167-89811293,2022-06-11T18:13:35,Portugalete,expenses,clothing,-147.39,-18511.49
buyer_7,María,,ES51209558104632098726,TRX_N-00168-67477716,2022-06-11T16:30:14,Portugalete,expenses,cash,-100.0,-18611.49
buyer_7,María,,ES51209558104632098726,TRX_N-00169-94599213,2022-06-11T00:50:55,Portugalete,expenses,gifts,-128.1,-18739.59
buyer_7,María,,ES51209558104632098726,TRX_N-00170-82283245,2022-06-12T02:52:50,Portugalete,expenses,cash,-100.0,-18839.59
buyer_7,María,,ES51209558104632098726,TRX_N-00171-41959964,2022-06-14T17:05:07,Portugalete,expenses,repairs,-164.69,-19004.28
buyer_7,María,,ES51209558104632098726,TRX_N-00172-18214952,2022-06-15T13:54:52,Portugalete,expenses,cash,-100.0,-19104.28
buyer_7,María,,ES51209558104632098726,TRX_N-00173-05505131,2022-06-15T15:56:45,Portugalete,expenses,children,-471.51,-19575.79
buyer_7,María,,ES51209558104632098726,TRX_N-00174-51332692,2022-06-16T16:34:43,Portugalete,expenses,leisure,-48.71,-19624.5
buyer_7,María,,ES51209558104632098726,TRX_N-00175-84298211,2022-06-17T16:55:36,Llodio,expenses,repairs,-242.58,-19867.08
buyer_7,María,,ES51209558104632098726,TRX_N-00176-52019863,2022-06-19T18:20:40,Portugalete,expenses,leisure,-31.81,-19898.89
buyer_7,María,,ES51209558104632098726,TRX_N-00177-84961043,2022-06-21T16:10:48,Portugalete,expenses,cash,-100.0,-19998.89
buyer_7,María,,ES51209558104632098726,TRX_N-00178-46375762,2022-06-25T20:50:32,Portugalete,expenses,leisure,-64.51,-20063.4
buyer_7,María,,ES51209558104632098726,TRX_N-00179-09128380,2022-06-25T12:05:26,Portugalete,expenses,repairs,-49.85,-20113.25
buyer_7,María,,ES51209558104632098726,TRX_N-00180-14723063,2022-06-25T09:53:46,Portugalete,expenses,gifts,-615.75,-20729.0
buyer_7,María,,ES51209558104632098726,TRX_N-00181-71551496,2022-06-26T14:12:21,Portugalete,expenses,transport,-57.07,-20786.07
buyer_7,María,,ES51209558104632098726,TRX_N-00182-29355783,2022-06-27T08:52:24,Iruña de Oca,expenses,food,-123.72,-20909.79
buyer_7,María,,ES51209558104632098726,TRX_N-00183-42684829,2022-06-27T08:10:26,Hondarribia,expenses,transport,-82.71,-20992.5
buyer_7,María,,ES51209558104632098726,TRX_N-00184-31582263,2022-06-27T08:45:28,Portugalete,expenses,leisure,-65.17,-21057.67
buyer_7,María,,ES51209558104632098726,TRX_N-00185-72135941,2022-06-28T12:39:35,Portugalete,expenses,leisure,-43.78,-21101.45
buyer_7,María,,ES51209558104632098726,TRX_N-00186-85661336,2022-06-28T14:55:54,Portugalete,expenses,cash,-100.0,-21201.45
buyer_7,María,,ES51209558104632098726,TRX_N-00187-78953877,2022-07-01T14:58:05,Portugalete,incomes,salary,1392.56,-19808.89
buyer_7,María,,ES51209558104632098726,TRX_N-00188-42398838,2022-07-01T14:58:05,Portugalete,incomes,extra_income,214.51,-19594.38
buyer_7,María,,ES51209558104632098726,TRX_N-00189-46754301,2022-07-01T17:12:26,Portugalete,expenses,cash,-100.0,-19694.38
buyer_7,María,,ES51209558104632098726,TRX_N-00190-42713654,2022-07-01T09:54:54,Portugalete,expenses,children,-595.17,-20289.55
buyer_7,María,,ES51209558104632098726,TRX_N-00191-75400611,2022-07-02T17:42:14,Portugalete,expenses,cash,-100.0,-20389.55
buyer_7,María,,ES51209558104632098726,TRX_N-00192-54889133,2022-07-02T19:07:57,Elciego,expenses,appliances,-346.12,-20735.67
buyer_7,María,,ES51209558104632098726,TRX_N-00193-87877115,2022-07-03T17:26:02,Portugalete,expenses,food,-73.72,-20809.39
buyer_7,María,,ES51209558104632098726,TRX_N-00194-49124186,2022-07-03T15:50:15,Portugalete,expenses,leisure,-31.67,-20841.06
buyer_7,María,,ES51209558104632098726,TRX_N-00195-36372977,2022-07-03T11:32:27,Portugalete,expenses,repairs,-233.8,-21074.86
buyer_7,María,,ES51209558104632098726,TRX_N-00196-59439149,2022-07-03T10:42:03,Portugalete,expenses,gifts,-686.2,-21761.06
buyer_7,María,,ES51209558104632098726,TRX_N-00197-81483599,2022-07-04T17:25:01,Portugalete,expenses,mortgage,-1094.46,-22855.52
buyer_7,María,,ES51209558104632098726,TRX_N-00198-61085670,2022-07-06T11:54:15,Portugalete,expenses,internet,-42.0,-22897.52
buyer_7,María,,ES51209558104632098726,TRX_N-00199-91328795,2022-07-07T12:59:01,Portugalete,expenses,phone,-41.81,-22939.33
buyer_7,María,,ES51209558104632098726,TRX_N-00200-22673423,2022-07-08T12:42:05,Portugalete,expenses,electricity,-76.74,-23016.07
buyer_7,María,,ES51209558104632098726,TRX_N-00201-40314420,2022-07-08T18:50:53,Portugalete,expenses,water,-37.51,-23053.58
buyer_7,María,,ES51209558104632098726,TRX_N-00202-72694983,2022-07-08T11:46:49,Portugalete,expenses,gas,-53.02,-23106.6
buyer_7,María,,ES51209558104632098726,TRX_N-00203-32950608,2022-07-08T20:18:17,Portugalete,expenses,education,-47.42,-23154.02
buyer_7,María,,ES51209558104632098726,TRX_N-00204-65083670,2022-07-09T22:45:36,Portugalete,expenses,food,-82.2,-23236.22
buyer_7,María,,ES51209558104632098726,TRX_N-00205-56519677,2022-07-12T03:13:56,Bermeo,expenses,leisure,-52.44,-23288.66
buyer_7,María,,ES51209558104632098726,TRX_N-00206-81331447,2022-07-15T14:28:42,Irun,expenses,travel,-1134.59,-24423.25
buyer_7,María,,ES51209558104632098726,TRX_N-00207-97879467,2022-07-15T10:00:23,Portugalete,expenses,repairs,-116.77,-24540.02
buyer_7,María,,ES51209558104632098726,TRX_N-00208-51648058,2022-07-16T00:20:04,Portugalete,expenses,leisure,-82.62,-24622.64
buyer_7,María,,ES51209558104632098726,TRX_N-00209-57198215,2022-07-18T11:38:03,Portugalete,expenses,cash,-100.0,-24722.64
buyer_7,María,,ES51209558104632098726,TRX_N-00210-80769109,2022-07-19T13:49:32,Portugalete,expenses,food,-73.61,-24796.25
buyer_7,María,,ES51209558104632098726,TRX_N-00211-25564009,2022-07-19T17:19:23,Portugalete,expenses,education,-69.16,-24865.41
buyer_7,María,,ES51209558104632098726,TRX_N-00212-46013172,2022-07-20T18:03:36,Portugalete,expenses,cash,-100.0,-24965.41
buyer_7,María,,ES51209558104632098726,TRX_N-00213-29103512,2022-07-20T13:42:19,Portugalete,expenses,appliances,-211.21,-25176.62
buyer_7,María,,ES51209558104632098726,TRX_N-00214-79690838,2022-07-21T10:30:45,Bermeo,expenses,cash,-100.0,-25276.62
buyer_7,María,,ES51209558104632098726,TRX_N-00215-44260180,2022-07-22T20:49:23,Portugalete,expenses,leisure,-52.64,-25329.26
buyer_7,María,,ES51209558104632098726,TRX_N-00216-76016867,2022-07-22T22:24:16,Portugalete,expenses,cash,-100.0,-25429.26
buyer_7,María,,ES51209558104632098726,TRX_N-00217-45863592,2022-07-23T10:56:24,Portugalete,expenses,food,-119.5,-25548.76
buyer_7,María,,ES51209558104632098726,TRX_N-00218-82153266,2022-07-23T20:46:22,Portugalete,expenses,gifts,-580.15,-26128.91
buyer_7,María,,ES51209558104632098726,TRX_N-00219-40935102,2022-07-26T13:36:09,Portugalete,expenses,leisure,-27.17,-26156.08
buyer_7,María,,ES51209558104632098726,TRX_N-00220-87025137,2022-07-26T13:42:40,Portugalete,expenses,repairs,-311.31,-26467.39
buyer_7,María,,ES51209558104632098726,TRX_N-00221-52303947,2022-07-27T16:27:24,Portugalete,expenses,cash,-100.0,-26567.39
buyer_7,María,,ES51209558104632098726,TRX_N-00222-41022557,2022-07-29T18:30:56,Portugalete,expenses,food,-112.71,-26680.1
buyer_7,María,,ES51209558104632098726,TRX_N-00223-87563132,2022-07-31T08:21:26,Portugalete,expenses,cash,-100.0,-26780.1
buyer_7,María,,ES51209558104632098726,TRX_N-00224-38008618,2022-08-01T16:50:30,Portugalete,incomes,salary,1392.56,-25387.54
buyer_7,María,,ES51209558104632098726,TRX_N-00225-45122783,2022-08-02T18:17:04,Portugalete,expenses,repairs,-145.94,-25533.48
buyer_7,María,,ES51209558104632098726,TRX_N-00226-81851314,2022-08-02T19:30:14,Portugalete,expenses,gifts,-692.09,-26225.57
buyer_7,María,,ES51209558104632098726,TRX_N-00227-32414092,2022-08-03T15:36:08,Portugalete,expenses,healthcare,-170.13,-26395.7
buyer_7,María,,ES51209558104632098726,TRX_N-00228-48253454,2022-08-03T12:08:35,Portugalete,expenses,appliances,-129.59,-26525.29
buyer_7,María,,ES51209558104632098726,TRX_N-00229-21516713,2022-08-04T13:10:35,Portugalete,expenses,mortgage,-1094.46,-27619.75
buyer_7,María,,ES51209558104632098726,TRX_N-00230-47385186,2022-08-05T10:45:29,Portugalete,expenses,electricity,-21.67,-27641.42
buyer_7,María,,ES51209558104632098726,TRX_N-00231-15986526,2022-08-07T21:15:10,Portugalete,expenses,gas,-68.5,-27709.92
buyer_7,María,,ES51209558104632098726,TRX_N-00232-35451323,2022-08-08T08:33:59,Portugalete,expenses,phone,-33.87,-27743.79
buyer_7,María,,ES51209558104632098726,TRX_N-00233-46946892,2022-08-08T23:57:13,Portugalete,expenses,water,-21.36,-27765.15
buyer_7,María,,ES51209558104632098726,TRX_N-00234-45207020,2022-08-08T15:41:17,Portugalete,expenses,internet,-42.0,-27807.15
buyer_7,María,,ES51209558104632098726,TRX_N-00235-24213946,2022-08-08T20:48:06,Portugalete,expenses,transport,-81.29,-27888.44
buyer_7,María,,ES51209558104632098726,TRX_N-00236-32704698,2022-08-08T15:18:49,Portugalete,expenses,clothing,-103.91,-27992.35
buyer_7,María,,ES51209558104632098726,TRX_N-00237-33763079,2022-08-08T19:43:20,Andoain,expenses,gifts,-511.22,-28503.57
buyer_7,María,,ES51209558104632098726,TRX_N-00238-94713478,2022-08-09T09:14:31,Portugalete,expenses,cash,-100.0,-28603.57
buyer_7,María,,ES51209558104632098726,TRX_N-00239-18686798,2022-08-13T21:59:36,Portugalete,expenses,repairs,-105.1,-28708.67
buyer_7,María,,ES51209558104632098726,TRX_N-00240-90328369,2022-08-14T19:58:08,Pasaia,expenses,clothing,-90.5,-28799.17
buyer_7,María,,ES51209558104632098726,TRX_N-00241-79075215,2022-08-15T20:15:23,Portugalete,expenses,leisure,-30.73,-28829.9
buyer_7,María,,ES51209558104632098726,TRX_N-00242-46584229,2022-08-17T19:27:31,Portugalete,expenses,repairs,-163.27,-28993.17
buyer_7,María,,ES51209558104632098726,TRX_N-00243-40679751,2022-08-18T10:18:35,Portugalete,expenses,transport,-47.03,-29040.2
buyer_7,María,,ES51209558104632098726,TRX_N-00244-85392295,2022-08-19T10:00:12,Portugalete,expenses,transport,-52.13,-29092.33
buyer_7,María,,ES51209558104632098726,TRX_N-00245-51656390,2022-08-19T10:42:58,Portugalete,expenses,repairs,-304.16,-29396.49
buyer_7,María,,ES51209558104632098726,TRX_N-00246-41391698,2022-08-20T16:21:42,Portugalete,expenses,food,-80.82,-29477.31
buyer_7,María,,ES51209558104632098726,TRX_N-00247-21523231,2022-08-22T12:57:23,Portugalete,expenses,food,-118.8,-29596.11
buyer_7,María,,ES51209558104632098726,TRX_N-00248-63605018,2022-08-22T18:29:56,Portugalete,expenses,repairs,-301.28,-29897.39
buyer_7,María,,ES51209558104632098726,TRX_N-00249-87468549,2022-08-23T12:18:21,Vitoria-Gasteiz,expenses,leisure,-40.05,-29937.44
buyer_7,María,,ES51209558104632098726,TRX_N-00250-48234962,2022-08-23T16:24:04,Portugalete,expenses,children,-341.61,-30279.05
buyer_7,María,,ES51209558104632098726,TRX_N-00251-24447037,2022-08-25T18:40:14,Portugalete,expenses,clothing,-151.04,-30430.09
buyer_7,María,,ES51209558104632098726,TRX_N-00252-33828136,2022-08-26T17:20:00,Portugalete,expenses,gifts,-339.55,-30769.64
buyer_7,María,,ES51209558104632098726,TRX_N-00253-65921574,2022-08-27T19:29:21,Portugalete,expenses,transport,-54.64,-30824.28
buyer_7,María,,ES51209558104632098726,TRX_N-00254-56434220,2022-08-27T17:47:04,Portugalete,expenses,clothing,-57.89,-30882.17
buyer_7,María,,ES51209558104632098726,TRX_N-00255-77701174,2022-08-29T03:56:11,Portugalete,expenses,food,-96.67,-30978.84
buyer_7,María,,ES51209558104632098726,TRX_N-00256-67740726,2022-08-29T00:04:03,Portugalete,expenses,leisure,-42.68,-31021.52
buyer_7,María,,ES51209558104632098726,TRX_N-00257-05374534,2022-08-29T12:27:11,Berango,expenses,cash,-100.0,-31121.52
buyer_7,María,,ES51209558104632098726,TRX_N-00258-95295778,2022-08-30T14:36:32,Portugalete,expenses,food,-124.44,-31245.96
buyer_7,María,,ES51209558104632098726,TRX_N-00259-97233772,2022-08-31T17:08:45,Donostia,expenses,transport,-68.87,-31314.83
buyer_7,María,,ES51209558104632098726,TRX_N-00260-47062236,2022-08-31T14:18:45,Portugalete,expenses,appliances,-217.5,-31532.33
buyer_7,María,,ES51209558104632098726,TRX_N-00261-78623274,2022-09-01T20:44:06,Portugalete,incomes,salary,1392.56,-30139.77
buyer_7,María,,ES51209558104632098726,TRX_N-00262-07126829,2022-09-01T18:05:47,Portugalete,expenses,food,-122.85,-30262.62
buyer_7,María,,ES51209558104632098726,TRX_N-00263-13588330,2022-09-02T20:38:28,Hondarribia,expenses,gifts,-538.61,-30801.23
buyer_7,María,,ES51209558104632098726,TRX_N-00264-66701150,2022-09-02T22:45:29,Portugalete,expenses,children,-249.21,-31050.44
buyer_7,María,,ES51209558104632098726,TRX_N-00265-86683984,2022-09-03T20:22:37,Portugalete,expenses,food,-88.85,-31139.29
buyer_7,María,,ES51209558104632098726,TRX_N-00266-78713651,2022-09-03T15:04:51,Portugalete,expenses,transport,-54.95,-31194.24
buyer_7,María,,ES51209558104632098726,TRX_N-00267-13493145,2022-09-04T04:40:58,Portugalete,expenses,mortgage,-1094.46,-32288.7
buyer_7,María,,ES51209558104632098726,TRX_N-00268-65778799,2022-09-04T13:55:21,Portugalete,expenses,food,-105.67,-32394.37
buyer_7,María,,ES51209558104632098726,TRX_N-00269-10125416,2022-09-04T08:01:59,Portugalete,expenses,gifts,-491.29,-32885.66
buyer_7,María,,ES51209558104632098726,TRX_N-00270-26868664,2022-09-05T06:09:39,Portugalete,expenses,gas,-81.17,-32966.83
buyer_7,María,,ES51209558104632098726,TRX_N-00271-20017318,2022-09-06T15:46:47,Portugalete,expenses,water,-40.24,-33007.07
buyer_7,María,,ES51209558104632098726,TRX_N-00272-31241362,2022-09-06T20:53:05,Portugalete,expenses,electricity,-21.76,-33028.83
buyer_7,María,,ES51209558104632098726,TRX_N-00273-24686996,2022-09-06T18:29:36,Portugalete,expenses,internet,-42.0,-33070.83
buyer_7,María,,ES51209558104632098726,TRX_N-00274-00955782,2022-09-06T15:35:00,Portugalete,expenses,cash,-100.0,-33170.83
buyer_7,María,,ES51209558104632098726,TRX_N-00275-68031932,2022-09-07T09:00:59,Portugalete,expenses,leisure,-22.67,-33193.5
buyer_7,María,,ES51209558104632098726,TRX_N-00276-66395480,2022-09-07T13:55:36,Portugalete,expenses,repairs,-166.64,-33360.14
buyer_7,María,,ES51209558104632098726,TRX_N-00277-94009073,2022-09-08T21:42:49,Portugalete,expenses,phone,-37.43,-33397.57
buyer_7,María,,ES51209558104632098726,TRX_N-00278-63412805,2022-09-08T12:07:34,Portugalete,expenses,leisure,-76.68,-33474.25
buyer_7,María,,ES51209558104632098726,TRX_N-00279-21981471,2022-09-08T00:54:48,Portugalete,expenses,cash,-100.0,-33574.25
buyer_7,María,,ES51209558104632098726,TRX_N-00280-65044405,2022-09-11T09:58:08,Erandio,expenses,transport,-83.55,-33657.8
buyer_7,María,,ES51209558104632098726,TRX_N-00281-83945823,2022-09-11T21:46:36,Basauri,expenses,gifts,-639.68,-34297.48
buyer_7,María,,ES51209558104632098726,TRX_N-00282-62571339,2022-09-12T15:11:53,Portugalete,expenses,food,-96.46,-34393.94
buyer_7,María,,ES51209558104632098726,TRX_N-00283-94280900,2022-09-14T16:37:18,Portugalete,expenses,food,-60.8,-34454.74
buyer_7,María,,ES51209558104632098726,TRX_N-00284-02166576,2022-09-14T18:57:28,Portugalete,expenses,gifts,-257.57,-34712.31
buyer_7,María,,ES51209558104632098726,TRX_N-00285-98800616,2022-09-15T18:52:19,Portugalete,expenses,food,-86.02,-34798.33
buyer_7,María,,ES51209558104632098726,TRX_N-00286-48827003,2022-09-17T18:17:31,Llodio,expenses,education,-73.69,-34872.02
buyer_7,María,,ES51209558104632098726,TRX_N-00287-77073448,2022-09-17T04:47:14,Portugalete,expenses,cash,-100.0,-34972.02
buyer_7,María,,ES51209558104632098726,TRX_N-00288-92041617,2022-09-18T10:30:16,Iruña de Oca,expenses,clothing,-61.42,-35033.44
buyer_7,María,,ES51209558104632098726,TRX_N-00289-66115717,2022-09-18T10:03:02,Portugalete,expenses,cash,-100.0,-35133.44
buyer_7,María,,ES51209558104632098726,TRX_N-00290-17843860,2022-09-18T14:22:54,Portugalete,expenses,repairs,-194.93,-35328.37
buyer_7,María,,ES51209558104632098726,TRX_N-00291-68412958,2022-09-22T18:44:20,Llodio,expenses,leisure,-65.16,-35393.53
buyer_7,María,,ES51209558104632098726,TRX_N-00292-58888548,2022-09-23T05:34:11,Bilbao,expenses,cash,-100.0,-35493.53
buyer_7,María,,ES51209558104632098726,TRX_N-00293-99181811,2022-09-24T08:51:23,Portugalete,expenses,food,-65.98,-35559.51
buyer_7,María,,ES51209558104632098726,TRX_N-00294-16184768,2022-09-24T19:58:55,Portugalete,expenses,clothing,-112.99,-35672.5
buyer_7,María,,ES51209558104632098726,TRX_N-00295-66569110,2022-09-24T19:10:09,Portugalete,expenses,cash,-100.0,-35772.5
buyer_7,María,,ES51209558104632098726,TRX_N-00296-85015142,2022-09-25T18:29:43,Portugalete,expenses,transport,-62.15,-35834.65
buyer_7,María,,ES51209558104632098726,TRX_N-00297-70195046,2022-09-25T23:43:13,Leioa,expenses,gifts,-742.43,-36577.08
buyer_7,María,,ES51209558104632098726,TRX_N-00298-75167780,2022-09-26T10:58:48,Zuia,expenses,healthcare,-44.12,-36621.2
buyer_7,María,,ES51209558104632098726,TRX_N-00299-48608727,2022-09-27T08:16:43,Portugalete,expenses,leisure,-20.0,-36641.2
buyer_7,María,,ES51209558104632098726,TRX_N-00300-82348673,2022-09-27T19:47:47,Portugalete,expenses,children,-522.73,-37163.93
buyer_7,María,,ES51209558104632098726,TRX_N-00301-05180451,2022-09-28T17:18:10,Portugalete,expenses,cash,-100.0,-37263.93
buyer_7,María,,ES51209558104632098726,TRX_N-00302-35201714,2022-09-29T14:00:07,Portugalete,expenses,education,-46.39,-37310.32
buyer_7,María,,ES51209558104632098726,TRX_N-00303-83002318,2022-09-30T18:57:07,Portugalete,expenses,healthcare,-66.11,-37376.43
buyer_7,María,,ES51209558104632098726,TRX_N-00304-68271001,2022-09-30T14:39:14,Portugalete,expenses,repairs,-114.62,-37491.05
buyer_7,María,,ES51209558104632098726,TRX_N-00305-64929399,2022-10-01T10:40:02,Portugalete,incomes,salary,1392.56,-36098.49
buyer_7,María,,ES51209558104632098726,TRX_N-00306-55967630,2022-10-01T14:45:59,Portugalete,expenses,transport,-60.34,-36158.83
buyer_7,María,,ES51209558104632098726,TRX_N-00307-81297240,2022-10-02T18:16:40,Portugalete,expenses,appliances,-237.97,-36396.8
buyer_7,María,,ES51209558104632098726,TRX_N-00308-44348288,2022-10-04T12:30:38,Portugalete,expenses,mortgage,-1094.46,-37491.26
buyer_7,María,,ES51209558104632098726,TRX_N-00309-89304689,2022-10-04T05:57:26,Portugalete,expenses,repairs,-331.8,-37823.06
buyer_7,María,,ES51209558104632098726,TRX_N-00310-94082471,2022-10-05T19:30:48,Portugalete,expenses,internet,-42.0,-37865.06
buyer_7,María,,ES51209558104632098726,TRX_N-00311-74867916,2022-10-05T16:29:53,Portugalete,expenses,phone,-39.54,-37904.6
buyer_7,María,,ES51209558104632098726,TRX_N-00312-79795325,2022-10-05T00:19:40,Portugalete,expenses,transport,-81.66,-37986.26
buyer_7,María,,ES51209558104632098726,TRX_N-00313-03004835,2022-10-06T09:48:28,Portugalete,expenses,gas,-109.14,-38095.4
buyer_7,María,,ES51209558104632098726,TRX_N-00314-21730876,2022-10-08T08:10:57,Portugalete,expenses,electricity,-80.36,-38175.76
buyer_7,María,,ES51209558104632098726,TRX_N-00315-18825185,2022-10-08T23:19:00,Portugalete,expenses,water,-33.9,-38209.66
buyer_7,María,,ES51209558104632098726,TRX_N-00316-17916865,2022-10-08T19:55:58,Portugalete,expenses,leisure,-76.25,-38285.91
buyer_7,María,,ES51209558104632098726,TRX_N-00317-17859960,2022-10-09T06:54:19,Portugalete,expenses,healthcare,-157.26,-38443.17
buyer_7,María,,ES51209558104632098726,TRX_N-00318-16744748,2022-10-10T14:12:32,Portugalete,expenses,gifts,-137.37,-38580.54
buyer_7,María,,ES51209558104632098726,TRX_N-00319-16182705,2022-10-11T13:45:16,Portugalete,expenses,food,-103.05,-38683.59
buyer_7,María,,ES51209558104632098726,TRX_N-00320-77457055,2022-10-11T18:50:40,Portugalete,expenses,leisure,-20.52,-38704.11
buyer_7,María,,ES51209558104632098726,TRX_N-00321-94937898,2022-10-11T00:54:58,Portugalete,expenses,appliances,-381.98,-39086.09
buyer_7,María,,ES51209558104632098726,TRX_N-00322-00400462,2022-10-11T19:32:22,Portugalete,expenses,gifts,-206.31,-39292.4
buyer_7,María,,ES51209558104632098726,TRX_N-00323-08973925,2022-10-12T20:16:30,Portugalete,expenses,food,-104.34,-39396.74
buyer_7,María,,ES51209558104632098726,TRX_N-00324-39653524,2022-10-12T11:34:39,Portugalete,expenses,clothing,-116.09,-39512.83
buyer_7,María,,ES51209558104632098726,TRX_N-00325-91111321,2022-10-13T11:56:23,Portugalete,expenses,repairs,-305.95,-39818.78
buyer_7,María,,ES51209558104632098726,TRX_N-00326-03789820,2022-10-14T19:39:14,Mungia,expenses,cash,-100.0,-39918.78
buyer_7,María,,ES51209558104632098726,TRX_N-00327-55437410,2022-10-16T17:17:13,Portugalete,expenses,food,-107.67,-40026.45
buyer_7,María,,ES51209558104632098726,TRX_N-00328-49885675,2022-10-16T15:01:07,Portugalete,expenses,gifts,-710.88,-40737.33
buyer_7,María,,ES51209558104632098726,TRX_N-00329-36826708,2022-10-17T14:40:17,Portugalete,expenses,cash,-100.0,-40837.33
buyer_7,María,,ES51209558104632098726,TRX_N-00330-69235105,2022-10-19T10:20:54,Portugalete,expenses,cash,-100.0,-40937.33
buyer_7,María,,ES51209558104632098726,TRX_N-00331-32079545,2022-10-20T20:46:35,Portugalete,expenses,cash,-100.0,-41037.33
buyer_7,María,,ES51209558104632098726,TRX_N-00332-19302209,2022-10-21T19:25:51,Portugalete,expenses,children,-245.96,-41283.29
buyer_7,María,,ES51209558104632098726,TRX_N-00333-36650036,2022-10-24T20:02:31,Portugalete,expenses,food,-78.78,-41362.07
buyer_7,María,,ES51209558104632098726,TRX_N-00334-79980228,2022-10-24T09:12:08,Portugalete,expenses,repairs,-227.67,-41589.74
buyer_7,María,,ES51209558104632098726,TRX_N-00335-70844310,2022-10-26T19:40:53,Eibar,expenses,food,-85.65,-41675.39
buyer_7,María,,ES51209558104632098726,TRX_N-00336-82937116,2022-10-27T12:09:06,Portugalete,expenses,food,-101.58,-41776.97
buyer_7,María,,ES51209558104632098726,TRX_N-00337-55505329,2022-10-28T01:53:03,Portugalete,expenses,food,-82.45,-41859.42
buyer_7,María,,ES51209558104632098726,TRX_N-00338-87293801,2022-10-29T08:00:29,Leioa,expenses,repairs,-273.19,-42132.61
buyer_7,María,,ES51209558104632098726,TRX_N-00339-28473294,2022-10-30T22:17:42,Portugalete,expenses,education,-77.11,-42209.72
buyer_7,María,,ES51209558104632098726,TRX_N-00340-67263621,2022-10-31T15:11:34,Portugalete,expenses,education,-57.65,-42267.37
buyer_7,María,,ES51209558104632098726,TRX_N-00341-80830566,2022-11-01T15:31:01,Portugalete,incomes,salary,1392.56,-40874.81
buyer_7,María,,ES51209558104632098726,TRX_N-00342-97605540,2022-11-01T15:31:01,Portugalete,incomes,extra_income,214.51,-40660.3
buyer_7,María,,ES51209558104632098726,TRX_N-00343-71483224,2022-11-01T07:18:03,Barakaldo,expenses,food,-124.01,-40784.31
buyer_7,María,,ES51209558104632098726,TRX_N-00344-59581574,2022-11-01T13:59:15,Arrasate,expenses,clothing,-147.09,-40931.4
buyer_7,María,,ES51209558104632098726,TRX_N-00345-97947056,2022-11-01T09:16:06,Portugalete,expenses,cash,-100.0,-41031.4
buyer_7,María,,ES51209558104632098726,TRX_N-00346-82590144,2022-11-03T02:53:03,Portugalete,expenses,food,-60.39,-41091.79
buyer_7,María,,ES51209558104632098726,TRX_N-00347-89723074,2022-11-04T18:14:51,Portugalete,expenses,mortgage,-1094.46,-42186.25
buyer_7,María,,ES51209558104632098726,TRX_N-00348-40299416,2022-11-07T22:05:29,Portugalete,expenses,gas,-64.04,-42250.29
buyer_7,María,,ES51209558104632098726,TRX_N-00349-12183722,2022-11-08T18:32:05,Portugalete,expenses,water,-25.92,-42276.21
buyer_7,María,,ES51209558104632098726,TRX_N-00350-64957703,2022-11-08T17:34:06,Portugalete,expenses,electricity,-85.84,-42362.05
buyer_7,María,,ES51209558104632098726,TRX_N-00351-28783322,2022-11-08T21:20:54,Portugalete,expenses,internet,-42.0,-42404.05
buyer_7,María,,ES51209558104632098726,TRX_N-00352-19622604,2022-11-08T16:30:20,Portugalete,expenses,phone,-30.43,-42434.48
buyer_7,María,,ES51209558104632098726,TRX_N-00353-54626259,2022-11-10T22:24:21,Portugalete,expenses,transport,-74.09,-42508.57
buyer_7,María,,ES51209558104632098726,TRX_N-00354-12668036,2022-11-10T12:26:29,Portugalete,expenses,repairs,-278.86,-42787.43
buyer_7,María,,ES51209558104632098726,TRX_N-00355-72647603,2022-11-11T19:29:14,Portugalete,expenses,leisure,-66.35,-42853.78
buyer_7,María,,ES51209558104632098726,TRX_N-00356-72815378,2022-11-11T03:00:17,Portugalete,expenses,repairs,-56.25,-42910.03
buyer_7,María,,ES51209558104632098726,TRX_N-00357-01067800,2022-11-12T09:41:21,Portugalete,expenses,gifts,-510.77,-43420.8
buyer_7,María,,ES51209558104632098726,TRX_N-00358-70198972,2022-11-13T10:50:29,Portugalete,expenses,food,-79.64,-43500.44
buyer_7,María,,ES51209558104632098726,TRX_N-00359-87965289,2022-11-15T20:37:42,Portugalete,expenses,cash,-100.0,-43600.44
buyer_7,María,,ES51209558104632098726,TRX_N-00360-56520378,2022-11-16T11:23:39,Portugalete,expenses,cash,-100.0,-43700.44
buyer_7,María,,ES51209558104632098726,TRX_N-00361-40300752,2022-11-21T09:46:36,Irun,expenses,gifts,-259.28,-43959.72
buyer_7,María,,ES51209558104632098726,TRX_N-00362-21614768,2022-11-22T18:25:35,Iruña de Oca,expenses,healthcare,-56.63,-44016.35
buyer_7,María,,ES51209558104632098726,TRX_N-00363-59502794,2022-11-24T13:59:19,Portugalete,expenses,gifts,-181.88,-44198.23
buyer_7,María,,ES51209558104632098726,TRX_N-00364-33844880,2022-11-25T19:18:13,Portugalete,expenses,repairs,-117.56,-44315.79
buyer_7,María,,ES51209558104632098726,TRX_N-00365-63846191,2022-11-26T18:49:21,Eibar,expenses,transport,-64.11,-44379.9
buyer_7,María,,ES51209558104632098726,TRX_N-00366-92445837,2022-11-27T11:13:32,Amurrio,expenses,repairs,-271.87,-44651.77
buyer_7,María,,ES51209558104632098726,TRX_N-00367-95207777,2022-11-29T13:03:56,Portugalete,expenses,repairs,-101.21,-44752.98
buyer_7,María,,ES51209558104632098726,TRX_N-00368-27298067,2022-11-30T16:49:34,Sopela,expenses,food,-103.27,-44856.25
buyer_7,María,,ES51209558104632098726,TRX_N-00369-07878128,2022-12-01T20:02:41,Portugalete,incomes,salary,1392.56,-43463.69
buyer_7,María,,ES51209558104632098726,TRX_N-00370-89571742,2022-12-01T20:02:41,Portugalete,incomes,salary_bonus,1084.23,-42379.46
buyer_7,María,,ES51209558104632098726,TRX_N-00371-47228449,2022-12-01T16:36:05,Barakaldo,expenses,clothing,-134.74,-42514.2
buyer_7,María,,ES51209558104632098726,TRX_N-00372-89804789,2022-12-01T09:18:43,Portugalete,expenses,children,-409.94,-42924.14
buyer_7,María,,ES51209558104632098726,TRX_N-00373-57420314,2022-12-02T17:32:44,Portugalete,expenses,children,-209.27,-43133.41
buyer_7,María,,ES51209558104632098726,TRX_N-00374-56869805,2022-12-03T13:54:46,Portugalete,expenses,transport,-64.76,-43198.17
buyer_7,María,,ES51209558104632098726,TRX_N-00375-61332515,2022-12-04T08:45:07,Portugalete,expenses,mortgage,-1094.46,-44292.63
buyer_7,María,,ES51209558104632098726,TRX_N-00376-92001107,2022-12-04T09:33:18,Portugalete,expenses,leisure,-49.52,-44342.15
buyer_7,María,,ES51209558104632098726,TRX_N-00377-79296177,2022-12-05T22:39:43,Portugalete,expenses,internet,-42.0,-44384.15
buyer_7,María,,ES51209558104632098726,TRX_N-00378-11635422,2022-12-06T00:05:23,Portugalete,expenses,gas,-101.9,-44486.05
buyer_7,María,,ES51209558104632098726,TRX_N-00379-45329064,2022-12-06T18:59:48,Portugalete,expenses,phone,-39.85,-44525.9
buyer_7,María,,ES51209558104632098726,TRX_N-00380-92834697,2022-12-07T11:02:40,Portugalete,expenses,water,-36.34,-44562.24
buyer_7,María,,ES51209558104632098726,TRX_N-00381-99175755,2022-12-07T12:39:00,Portugalete,expenses,electricity,-32.94,-44595.18
buyer_7,María,,ES51209558104632098726,TRX_N-00382-42626420,2022-12-07T08:01:13,Portugalete,expenses,transport,-72.27,-44667.45
buyer_7,María,,ES51209558104632098726,TRX_N-00383-94877904,2022-12-08T09:05:28,Portugalete,expenses,transport,-83.02,-44750.47
buyer_7,María,,ES51209558104632098726,TRX_N-00384-04210664,2022-12-09T15:57:19,Portugalete,expenses,education,-71.63,-44822.1
buyer_7,María,,ES51209558104632098726,TRX_N-00385-04560220,2022-12-10T18:58:30,Portugalete,expenses,leisure,-24.46,-44846.56
buyer_7,María,,ES51209558104632098726,TRX_N-00386-02550795,2022-12-12T09:58:44,Lasarte-Oria,expenses,food,-106.1,-44952.66
buyer_7,María,,ES51209558104632098726,TRX_N-00387-11887051,2022-12-12T09:44:34,Portugalete,expenses,transport,-43.42,-44996.08
buyer_7,María,,ES51209558104632098726,TRX_N-00388-71656023,2022-12-12T18:36:56,Portugalete,expenses,children,-571.87,-45567.95
buyer_7,María,,ES51209558104632098726,TRX_N-00389-96610108,2022-12-14T11:52:24,Portugalete,expenses,children,-398.16,-45966.11
buyer_7,María,,ES51209558104632098726,TRX_N-00390-44803349,2022-12-15T14:41:38,Portugalete,expenses,cash,-100.0,-46066.11
buyer_7,María,,ES51209558104632098726,TRX_N-00391-28853820,2022-12-15T19:44:36,Portugalete,expenses,gifts,-663.92,-46730.03
buyer_7,María,,ES51209558104632098726,TRX_N-00392-94332283,2022-12-18T09:37:32,Portugalete,expenses,cash,-100.0,-46830.03
buyer_7,María,,ES51209558104632098726,TRX_N-00393-07072799,2022-12-20T21:48:48,Portugalete,expenses,leisure,-30.88,-46860.91
buyer_7,María,,ES51209558104632098726,TRX_N-00394-18747265,2022-12-20T18:19:48,Portugalete,expenses,cash,-100.0,-46960.91
buyer_7,María,,ES51209558104632098726,TRX_N-00395-55613638,2022-12-22T12:53:49,Portugalete,expenses,leisure,-54.64,-47015.55
buyer_7,María,,ES51209558104632098726,TRX_N-00396-74606851,2022-12-23T12:34:36,Portugalete,expenses,food,-124.27,-47139.82
buyer_7,María,,ES51209558104632098726,TRX_N-00397-68938663,2022-12-23T10:31:57,Basauri,expenses,cash,-100.0,-47239.82
buyer_7,María,,ES51209558104632098726,TRX_N-00398-80914505,2022-12-23T20:05:50,Portugalete,expenses,travel,-1600.28,-48840.1
buyer_7,María,,ES51209558104632098726,TRX_N-00399-33094462,2022-12-24T10:35:05,Zuia,expenses,leisure,-72.76,-48912.86
buyer_7,María,,ES51209558104632098726,TRX_N-00400-60288660,2022-12-27T09:35:50,Portugalete,expenses,cash,-100.0,-49012.86
buyer_7,María,,ES51209558104632098726,TRX_N-00401-95949394,2022-12-28T21:01:15,Portugalete,expenses,food,-109.06,-49121.92
buyer_7,María,,ES51209558104632098726,TRX_N-00402-46634145,2022-12-28T10:15:14,Portugalete,expenses,cash,-100.0,-49221.92
buyer_7,María,,ES51209558104632098726,TRX_N-00403-06237577,2022-12-30T11:26:19,Portugalete,expenses,transport,-48.06,-49269.98
buyer_7,María,,ES51209558104632098726,TRX_N-00404-67499353,2022-12-30T13:49:58,Portugalete,expenses,cash,-100.0,-49369.98
buyer_7,María,,ES51209558104632098726,TRX_N-00405-12300487,2022-12-30T21:22:18,Andoain,expenses,gifts,-219.8,-49589.78
buyer_7,María,,ES51209558104632098726,TRX_N-00406-82045345,2022-12-31T21:42:56,Zarautz,expenses,repairs,-240.67,-49830.45
buyer_7,María,,ES51209558104632098726,TRX_N-00407-19342529,2023-01-01T18:49:49,Portugalete,incomes,salary,1437.1,-48393.35
buyer_7,María,,ES51209558104632098726,TRX_N-00408-87697709,2023-01-02T20:23:33,Portugalete,expenses,clothing,-119.51,-48512.86
buyer_7,María,,ES51209558104632098726,TRX_N-00409-29124971,2023-01-04T13:06:44,Portugalete,expenses,mortgage,-1094.46,-49607.32
buyer_7,María,,ES51209558104632098726,TRX_N-00410-36557956,2023-01-04T13:22:31,Portugalete,expenses,repairs,-101.35,-49708.67
buyer_7,María,,ES51209558104632098726,TRX_N-00411-52937926,2023-01-05T21:11:38,Portugalete,expenses,water,-40.1,-49748.77
buyer_7,María,,ES51209558104632098726,TRX_N-00412-49007460,2023-01-05T08:35:48,Portugalete,expenses,cash,-100.0,-49848.77
buyer_7,María,,ES51209558104632098726,TRX_N-00413-32270710,2023-01-06T03:31:31,Portugalete,expenses,electricity,-72.82,-49921.59
buyer_7,María,,ES51209558104632098726,TRX_N-00414-85337426,2023-01-06T08:56:33,Portugalete,expenses,gas,-64.46,-49986.05
buyer_7,María,,ES51209558104632098726,TRX_N-00415-93758150,2023-01-06T14:09:04,Portugalete,expenses,internet,-42.0,-50028.05
buyer_7,María,,ES51209558104632098726,TRX_N-00416-94603965,2023-01-06T09:16:45,Portugalete,expenses,phone,-30.52,-50058.57
buyer_7,María,,ES51209558104632098726,TRX_N-00417-42728241,2023-01-07T14:28:51,Portugalete,expenses,food,-95.53,-50154.1
buyer_7,María,,ES51209558104632098726,TRX_N-00418-31530247,2023-01-08T08:29:49,Portugalete,expenses,food,-124.53,-50278.63
buyer_7,María,,ES51209558104632098726,TRX_N-00419-41524403,2023-01-09T16:37:30,Portugalete,expenses,food,-111.02,-50389.65
buyer_7,María,,ES51209558104632098726,TRX_N-00420-98154687,2023-01-10T13:14:39,Portugalete,expenses,children,-383.37,-50773.02
buyer_7,María,,ES51209558104632098726,TRX_N-00421-50932448,2023-01-11T17:53:33,Donostia,expenses,clothing,-142.28,-50915.3
buyer_7,María,,ES51209558104632098726,TRX_N-00422-54797901,2023-01-12T15:02:23,Portugalete,expenses,clothing,-103.33,-51018.63
buyer_7,María,,ES51209558104632098726,TRX_N-00423-96525444,2023-01-12T10:51:17,Portugalete,expenses,gifts,-131.07,-51149.7
buyer_7,María,,ES51209558104632098726,TRX_N-00424-71780663,2023-01-13T14:32:05,Irun,expenses,healthcare,-88.02,-51237.72
buyer_7,María,,ES51209558104632098726,TRX_N-00425-85514426,2023-01-13T20:16:44,Portugalete,expenses,appliances,-193.77,-51431.49
buyer_7,María,,ES51209558104632098726,TRX_N-00426-13327109,2023-01-14T11:49:54,Portugalete,expenses,education,-61.79,-51493.28
buyer_7,María,,ES51209558104632098726,TRX_N-00427-70763306,2023-01-16T10:09:19,Mungia,expenses,leisure,-71.88,-51565.16
buyer_7,María,,ES51209558104632098726,TRX_N-00428-60029859,2023-01-17T17:31:31,Hondarribia,expenses,leisure,-41.41,-51606.57
buyer_7,María,,ES51209558104632098726,TRX_N-00429-78572857,2023-01-17T10:53:37,Portugalete,expenses,appliances,-272.18,-51878.75
buyer_7,María,,ES51209558104632098726,TRX_N-00430-51471119,2023-01-19T15:18:00,Portugalete,expenses,food,-103.0,-51981.75
buyer_7,María,,ES51209558104632098726,TRX_N-00431-31349095,2023-01-20T09:16:57,Portugalete,expenses,food,-116.17,-52097.92
buyer_7,María,,ES51209558104632098726,TRX_N-00432-78942989,2023-01-21T14:15:50,Portugalete,expenses,transport,-60.5,-52158.42
buyer_7,María,,ES51209558104632098726,TRX_N-00433-59772126,2023-01-21T16:34:26,Portugalete,expenses,education,-64.9,-52223.32
buyer_7,María,,ES51209558104632098726,TRX_N-00434-90555860,2023-01-22T17:50:06,Portugalete,expenses,cash,-100.0,-52323.32
buyer_7,María,,ES51209558104632098726,TRX_N-00435-02002375,2023-01-23T19:22:58,Portugalete,expenses,transport,-65.21,-52388.53
buyer_7,María,,ES51209558104632098726,TRX_N-00436-60661625,2023-01-23T16:00:58,Portugalete,expenses,leisure,-83.92,-52472.45
buyer_7,María,,ES51209558104632098726,TRX_N-00437-82700848,2023-01-25T19:56:15,Hondarribia,expenses,healthcare,-38.76,-52511.21
buyer_7,María,,ES51209558104632098726,TRX_N-00438-24319617,2023-01-28T18:16:59,Elciego,expenses,repairs,-106.86,-52618.07
buyer_7,María,,ES51209558104632098726,TRX_N-00439-15051150,2023-01-30T08:11:06,Portugalete,expenses,food,-102.02,-52720.09
buyer_7,María,,ES51209558104632098726,TRX_N-00440-67310844,2023-01-30T20:26:04,Portugalete,expenses,leisure,-54.63,-52774.72
buyer_7,María,,ES51209558104632098726,TRX_N-00441-50372452,2023-01-30T19:06:14,Portugalete,expenses,clothing,-73.75,-52848.47
buyer_7,María,,ES51209558104632098726,TRX_N-00442-29656469,2023-01-30T07:53:56,Portugalete,expenses,repairs,-269.13,-53117.6
buyer_7,María,,ES51209558104632098726,TRX_N-00443-63924523,2023-02-01T09:57:11,Portugalete,incomes,salary,1437.1,-51680.5
buyer_7,María,,ES51209558104632098726,TRX_N-00444-46110914,2023-02-01T22:45:32,Portugalete,expenses,leisure,-29.41,-51709.91
buyer_7,María,,ES51209558104632098726,TRX_N-00445-53229152,2023-02-01T18:52:57,Sestao,expenses,education,-72.44,-51782.35
buyer_7,María,,ES51209558104632098726,TRX_N-00446-37139457,2023-02-01T15:25:14,Portugalete,expenses,gifts,-26.27,-51808.62
buyer_7,María,,ES51209558104632098726,TRX_N-00447-84093007,2023-02-03T09:56:23,Portugalete,expenses,clothing,-141.37,-51949.99
buyer_7,María,,ES51209558104632098726,TRX_N-00448-87309727,2023-02-04T09:45:25,Portugalete,expenses,mortgage,-1094.46,-53044.45
buyer_7,María,,ES51209558104632098726,TRX_N-00449-04755676,2023-02-05T16:00:21,Portugalete,expenses,gas,-82.32,-53126.77
buyer_7,María,,ES51209558104632098726,TRX_N-00450-74840670,2023-02-06T09:31:17,Portugalete,expenses,food,-66.79,-53193.56
buyer_7,María,,ES51209558104632098726,TRX_N-00451-09214305,2023-02-07T20:43:56,Portugalete,expenses,electricity,-63.58,-53257.14
buyer_7,María,,ES51209558104632098726,TRX_N-00452-17301127,2023-02-08T11:47:34,Portugalete,expenses,water,-31.85,-53288.99
buyer_7,María,,ES51209558104632098726,TRX_N-00453-64430019,2023-02-08T05:46:04,Portugalete,expenses,internet,-42.0,-53330.99
buyer_7,María,,ES51209558104632098726,TRX_N-00454-70368862,2023-02-08T15:20:34,Portugalete,expenses,phone,-35.9,-53366.89
buyer_7,María,,ES51209558104632098726,TRX_N-00455-68258837,2023-02-08T20:08:28,Portugalete,expenses,food,-104.81,-53471.7
buyer_7,María,,ES51209558104632098726,TRX_N-00456-51122146,2023-02-08T18:28:44,Bilbao,expenses,gifts,-581.92,-54053.62
buyer_7,María,,ES51209558104632098726,TRX_N-00457-98711128,2023-02-08T13:13:36,Portugalete,expenses,children,-135.15,-54188.77
buyer_7,María,,ES51209558104632098726,TRX_N-00458-22908132,2023-02-09T18:47:17,Portugalete,expenses,leisure,-68.67,-54257.44
buyer_7,María,,ES51209558104632098726,TRX_N-00459-44662575,2023-02-13T16:28:14,Portugalete,expenses,cash,-100.0,-54357.44
buyer_7,María,,ES51209558104632098726,TRX_N-00460-38914585,2023-02-15T11:32:19,Portugalete,expenses,food,-117.6,-54475.04
buyer_7,María,,ES51209558104632098726,TRX_N-00461-04802364,2023-02-16T09:25:18,Portugalete,expenses,cash,-100.0,-54575.04
buyer_7,María,,ES51209558104632098726,TRX_N-00462-17878712,2023-02-16T17:06:46,Portugalete,expenses,repairs,-193.0,-54768.04
buyer_7,María,,ES51209558104632098726,TRX_N-00463-55665543,2023-02-17T08:16:08,Llodio,expenses,leisure,-42.28,-54810.32
buyer_7,María,,ES51209558104632098726,TRX_N-00464-44353182,2023-02-17T16:06:01,Portugalete,expenses,repairs,-117.64,-54927.96
buyer_7,María,,ES51209558104632098726,TRX_N-00465-38130176,2023-02-20T18:31:40,Portugalete,expenses,transport,-49.26,-54977.22
buyer_7,María,,ES51209558104632098726,TRX_N-00466-45345466,2023-02-20T17:29:57,Portugalete,expenses,gifts,-275.61,-55252.83
buyer_7,María,,ES51209558104632098726,TRX_N-00467-14508062,2023-02-23T22:34:23,Portugalete,expenses,cash,-100.0,-55352.83
buyer_7,María,,ES51209558104632098726,TRX_N-00468-90058969,2023-02-26T20:41:47,Portugalete,expenses,cash,-100.0,-55452.83
buyer_7,María,,ES51209558104632098726,TRX_N-00469-58980395,2023-02-26T17:18:32,Portugalete,expenses,children,-646.57,-56099.4
buyer_7,María,,ES51209558104632098726,TRX_N-00470-01155873,2023-02-27T05:34:49,Portugalete,expenses,transport,-42.61,-56142.01
buyer_7,María,,ES51209558104632098726,TRX_N-00471-36200479,2023-02-27T12:59:46,Portugalete,expenses,cash,-100.0,-56242.01
buyer_7,María,,ES51209558104632098726,TRX_N-00472-87043475,2023-02-28T15:06:35,Portugalete,expenses,leisure,-28.52,-56270.53
buyer_7,María,,ES51209558104632098726,TRX_N-00473-57449077,2023-03-01T20:02:11,Portugalete,incomes,salary,1437.1,-54833.43
buyer_7,María,,ES51209558104632098726,TRX_N-00474-28166375,2023-03-01T20:02:11,Portugalete,incomes,extra_income,214.51,-54618.92
buyer_7,María,,ES51209558104632098726,TRX_N-00475-73896016,2023-03-02T12:07:30,Alegría-Dulantzi,expenses,food,-113.09,-54732.01
buyer_7,María,,ES51209558104632098726,TRX_N-00476-59738714,2023-03-02T16:35:29,Portugalete,expenses,gifts,-687.71,-55419.72
buyer_7,María,,ES51209558104632098726,TRX_N-00477-86964869,2023-03-03T23:46:16,Portugalete,expenses,education,-54.89,-55474.61
buyer_7,María,,ES51209558104632098726,TRX_N-00478-53542671,2023-03-04T13:58:10,Portugalete,expenses,mortgage,-1094.46,-56569.07
buyer_7,María,,ES51209558104632098726,TRX_N-00479-56419481,2023-03-04T20:33:34,Portugalete,expenses,transport,-72.8,-56641.87
buyer_7,María,,ES51209558104632098726,TRX_N-00480-88679391,2023-03-05T16:11:07,Portugalete,expenses,electricity,-88.74,-56730.61
buyer_7,María,,ES51209558104632098726,TRX_N-00481-98471257,2023-03-05T09:08:24,Portugalete,expenses,internet,-42.0,-56772.61
buyer_7,María,,ES51209558104632098726,TRX_N-00482-78078704,2023-03-06T17:14:35,Portugalete,expenses,gas,-50.13,-56822.74
buyer_7,María,,ES51209558104632098726,TRX_N-00483-32652873,2023-03-06T16:04:32,Portugalete,expenses,phone,-35.46,-56858.2
buyer_7,María,,ES51209558104632098726,TRX_N-00484-79382732,2023-03-07T08:35:13,Portugalete,expenses,water,-30.22,-56888.42
buyer_7,María,,ES51209558104632098726,TRX_N-00485-80233948,2023-03-08T04:46:06,Portugalete,expenses,clothing,-84.14,-56972.56
buyer_7,María,,ES51209558104632098726,TRX_N-00486-53664791,2023-03-08T05:18:01,Portugalete,expenses,gifts,-310.69,-57283.25
buyer_7,María,,ES51209558104632098726,TRX_N-00487-63252560,2023-03-12T19:35:28,Portugalete,expenses,healthcare,-142.01,-57425.26
buyer_7,María,,ES51209558104632098726,TRX_N-00488-36492193,2023-03-13T23:28:02,Portugalete,expenses,food,-100.11,-57525.37
buyer_7,María,,ES51209558104632098726,TRX_N-00489-83051670,2023-03-14T17:06:38,Portugalete,expenses,leisure,-81.97,-57607.34
buyer_7,María,,ES51209558104632098726,TRX_N-00490-10595205,2023-03-14T19:54:49,Portugalete,expenses,clothing,-151.43,-57758.77
buyer_7,María,,ES51209558104632098726,TRX_N-00491-83748744,2023-03-14T15:58:56,Portugalete,expenses,cash,-100.0,-57858.77
buyer_7,María,,ES51209558104632098726,TRX_N-00492-79703989,2023-03-15T20:02:19,Portugalete,expenses,transport,-48.04,-57906.81
buyer_7,María,,ES51209558104632098726,TRX_N-00493-80918073,2023-03-15T11:06:05,Erandio,expenses,cash,-100.0,-58006.81
buyer_7,María,,ES51209558104632098726,TRX_N-00494-75784986,2023-03-16T12:43:35,Portugalete,expenses,leisure,-44.89,-58051.7
buyer_7,María,,ES51209558104632098726,TRX_N-00495-12353766,2023-03-16T21:29:39,Portugalete,expenses,cash,-100.0,-58151.7
buyer_7,María,,ES51209558104632098726,TRX_N-00496-25858893,2023-03-18T15:38:52,Portugalete,expenses,children,-607.59,-58759.29
buyer_7,María,,ES51209558104632098726,TRX_N-00497-01172149,2023-03-19T18:17:23,Portugalete,expenses,transport,-81.64,-58840.93
buyer_7,María,,ES51209558104632098726,TRX_N-00498-12709227,2023-03-20T06:59:23,Portugalete,expenses,food,-119.72,-58960.65
buyer_7,María,,ES51209558104632098726,TRX_N-00499-47095146,2023-03-21T14:13:52,Portugalete,expenses,cash,-100.0,-59060.65
buyer_7,María,,ES51209558104632098726,TRX_N-00500-49859536,2023-03-22T07:04:07,Portugalete,expenses,transport,-89.64,-59150.29
buyer_7,María,,ES51209558104632098726,TRX_N-00501-63528185,2023-03-23T12:52:34,Portugalete,expenses,healthcare,-144.29,-59294.58
buyer_7,María,,ES51209558104632098726,TRX_N-00502-88042302,2023-03-23T20:10:50,Portugalete,expenses,children,-628.24,-59922.82
buyer_7,María,,ES51209558104632098726,TRX_N-00503-66875126,2023-03-24T11:10:53,Portugalete,expenses,food,-60.52,-59983.34
buyer_7,María,,ES51209558104632098726,TRX_N-00504-09612815,2023-03-28T20:56:37,Portugalete,expenses,gifts,-661.34,-60644.68
buyer_7,María,,ES51209558104632098726,TRX_N-00505-59857237,2023-03-29T11:55:04,Portugalete,expenses,cash,-100.0,-60744.68
buyer_7,María,,ES51209558104632098726,TRX_N-00506-04688967,2023-03-30T12:31:13,Lasarte-Oria,expenses,cash,-100.0,-60844.68
buyer_7,María,,ES51209558104632098726,TRX_N-00507-05967332,2023-04-01T01:32:06,Portugalete,incomes,salary,1437.1,-59407.58
buyer_7,María,,ES51209558104632098726,TRX_N-00508-83029651,2023-04-03T07:28:56,Portugalete,expenses,transport,-65.76,-59473.34
buyer_7,María,,ES51209558104632098726,TRX_N-00509-46122148,2023-04-03T13:18:35,Portugalete,expenses,repairs,-259.99,-59733.33
buyer_7,María,,ES51209558104632098726,TRX_N-00510-77064418,2023-04-04T10:30:12,Portugalete,expenses,mortgage,-1094.46,-60827.79
buyer_7,María,,ES51209558104632098726,TRX_N-00511-08764393,2023-04-04T16:38:13,Portugalete,expenses,leisure,-58.05,-60885.84
buyer_7,María,,ES51209558104632098726,TRX_N-00512-83632334,2023-04-05T15:24:16,Portugalete,expenses,internet,-42.0,-60927.84
buyer_7,María,,ES51209558104632098726,TRX_N-00513-05474969,2023-04-05T14:01:07,Portugalete,expenses,leisure,-19.89,-60947.73
buyer_7,María,,ES51209558104632098726,TRX_N-00514-97825598,2023-04-06T17:43:23,Portugalete,expenses,water,-35.76,-60983.49
buyer_7,María,,ES51209558104632098726,TRX_N-00515-57607395,2023-04-06T15:32:33,Portugalete,expenses,electricity,-58.82,-61042.31
buyer_7,María,,ES51209558104632098726,TRX_N-00516-04597725,2023-04-06T10:31:54,Portugalete,expenses,clothing,-69.2,-61111.51
buyer_7,María,,ES51209558104632098726,TRX_N-00517-03788784,2023-04-07T13:53:21,Portugalete,expenses,gas,-96.48,-61207.99
buyer_7,María,,ES51209558104632098726,TRX_N-00518-64203718,2023-04-08T15:12:00,Portugalete,expenses,phone,-43.37,-61251.36
buyer_7,María,,ES51209558104632098726,TRX_N-00519-54834898,2023-04-08T09:57:39,Portugalete,expenses,leisure,-48.5,-61299.86
buyer_7,María,,ES51209558104632098726,TRX_N-00520-05402944,2023-04-08T12:03:27,Portugalete,expenses,clothing,-90.34,-61390.2
buyer_7,María,,ES51209558104632098726,TRX_N-00521-61327095,2023-04-09T13:29:36,Portugalete,expenses,transport,-44.53,-61434.73
buyer_7,María,,ES51209558104632098726,TRX_N-00522-52492149,2023-04-12T18:06:21,Portugalete,expenses,education,-49.66,-61484.39
buyer_7,María,,ES51209558104632098726,TRX_N-00523-64253830,2023-04-12T22:32:05,Eibar,expenses,cash,-100.0,-61584.39
buyer_7,María,,ES51209558104632098726,TRX_N-00524-71605022,2023-04-13T14:20:14,Portugalete,expenses,food,-82.68,-61667.07
buyer_7,María,,ES51209558104632098726,TRX_N-00525-68115245,2023-04-13T11:36:47,Portugalete,expenses,transport,-58.71,-61725.78
buyer_7,María,,ES51209558104632098726,TRX_N-00526-62939939,2023-04-13T18:04:03,Portugalete,expenses,children,-406.07,-62131.85
buyer_7,María,,ES51209558104632098726,TRX_N-00527-99338772,2023-04-14T15:45:43,Portugalete,expenses,food,-109.28,-62241.13
buyer_7,María,,ES51209558104632098726,TRX_N-00528-58150514,2023-04-15T21:07:46,Portugalete,expenses,clothing,-150.05,-62391.18
buyer_7,María,,ES51209558104632098726,TRX_N-00529-87308937,2023-04-16T13:39:44,Portugalete,expenses,education,-68.05,-62459.23
buyer_7,María,,ES51209558104632098726,TRX_N-00530-98818910,2023-04-17T15:24:22,Portugalete,expenses,education,-56.66,-62515.89
buyer_7,María,,ES51209558104632098726,TRX_N-00531-53547947,2023-04-17T16:17:29,Portugalete,expenses,cash,-100.0,-62615.89
buyer_7,María,,ES51209558104632098726,TRX_N-00532-36381140,2023-04-18T08:40:51,Pasaia,expenses,leisure,-45.81,-62661.7
buyer_7,María,,ES51209558104632098726,TRX_N-00533-74808749,2023-04-19T22:49:20,Portugalete,expenses,healthcare,-47.15,-62708.85
buyer_7,María,,ES51209558104632098726,TRX_N-00534-94966207,2023-04-19T20:00:53,Sestao,expenses,cash,-100.0,-62808.85
buyer_7,María,,ES51209558104632098726,TRX_N-00535-56698731,2023-04-20T11:56:21,Portugalete,expenses,food,-113.8,-62922.65
buyer_7,María,,ES51209558104632098726,TRX_N-00536-37638156,2023-04-20T18:24:32,Galdakao,expenses,repairs,-170.8,-63093.45
buyer_7,María,,ES51209558104632098726,TRX_N-00537-28002874,2023-04-20T18:03:43,Portugalete,expenses,gifts,-329.88,-63423.33
buyer_7,María,,ES51209558104632098726,TRX_N-00538-18994411,2023-04-21T20:51:45,Portugalete,expenses,food,-116.48,-63539.81
buyer_7,María,,ES51209558104632098726,TRX_N-00539-58484293,2023-04-21T12:08:03,Portugalete,expenses,clothing,-96.9,-63636.71
buyer_7,María,,ES51209558104632098726,TRX_N-00540-54971677,2023-04-23T21:26:44,Portugalete,expenses,leisure,-81.49,-63718.2
buyer_7,María,,ES51209558104632098726,TRX_N-00541-23800004,2023-04-23T18:13:46,Portugalete,expenses,repairs,-151.44,-63869.64
buyer_7,María,,ES51209558104632098726,TRX_N-00542-29728948,2023-04-23T11:11:54,Portugalete,expenses,gifts,-135.41,-64005.05
buyer_7,María,,ES51209558104632098726,TRX_N-00543-56622972,2023-04-25T16:04:59,Durango,expenses,food,-101.79,-64106.84
buyer_7,María,,ES51209558104632098726,TRX_N-00544-30173082,2023-04-27T20:04:35,Portugalete,expenses,transport,-64.19,-64171.03
buyer_7,María,,ES51209558104632098726,TRX_N-00545-63922103,2023-04-28T23:25:05,Portugalete,expenses,food,-86.16,-64257.19
buyer_7,María,,ES51209558104632098726,TRX_N-00546-76040480,2023-04-28T19:48:30,Portugalete,expenses,leisure,-39.23,-64296.42
buyer_7,María,,ES51209558104632098726,TRX_N-00547-24039265,2023-04-29T19:24:07,Portugalete,expenses,cash,-100.0,-64396.42
buyer_7,María,,ES51209558104632098726,TRX_N-00548-59630143,2023-04-29T16:28:25,Portugalete,expenses,children,-692.98,-65089.4
buyer_7,María,,ES51209558104632098726,TRX_N-00549-15700334,2023-04-30T02:13:41,Santurtzi,expenses,transport,-44.85,-65134.25
buyer_7,María,,ES51209558104632098726,TRX_N-00550-54366322,2023-04-30T13:16:53,Portugalete,expenses,leisure,-34.77,-65169.02
buyer_7,María,,ES51209558104632098726,TRX_N-00551-27406367,2023-04-30T22:13:35,Donostia,expenses,clothing,-115.26,-65284.28
buyer_7,María,,ES51209558104632098726,TRX_N-00552-67942184,2023-04-30T16:38:55,Portugalete,expenses,cash,-100.0,-65384.28
buyer_7,María,,ES51209558104632098726,TRX_N-00553-04684399,2023-05-01T08:26:04,Portugalete,incomes,salary,1437.1,-63947.18
buyer_7,María,,ES51209558104632098726,TRX_N-00554-43338335,2023-05-01T11:50:08,Portugalete,expenses,cash,-100.0,-64047.18
buyer_7,María,,ES51209558104632098726,TRX_N-00555-94382149,2023-05-01T16:21:58,Portugalete,expenses,children,-553.36,-64600.54
buyer_7,María,,ES51209558104632098726,TRX_N-00556-76745817,2023-05-04T18:43:34,Portugalete,expenses,mortgage,-1094.46,-65695.0
buyer_7,María,,ES51209558104632098726,TRX_N-00557-83972617,2023-05-04T09:44:45,Portugalete,expenses,food,-86.84,-65781.84
buyer_7,María,,ES51209558104632098726,TRX_N-00558-84642265,2023-05-04T09:51:04,Portugalete,expenses,cash,-100.0,-65881.84
buyer_7,María,,ES51209558104632098726,TRX_N-00559-96661488,2023-05-05T22:30:18,Portugalete,expenses,water,-43.95,-65925.79
buyer_7,María,,ES51209558104632098726,TRX_N-00560-36344802,2023-05-05T12:22:20,Zarautz,expenses,food,-72.91,-65998.7
buyer_7,María,,ES51209558104632098726,TRX_N-00561-18699543,2023-05-05T20:16:30,Portugalete,expenses,transport,-88.93,-66087.63
buyer_7,María,,ES51209558104632098726,TRX_N-00562-42282219,2023-05-05T10:30:03,Portugalete,expenses,cash,-100.0,-66187.63
buyer_7,María,,ES51209558104632098726,TRX_N-00563-97517912,2023-05-06T09:29:38,Portugalete,expenses,gas,-98.01,-66285.64
buyer_7,María,,ES51209558104632098726,TRX_N-00564-77598498,2023-05-07T19:08:35,Portugalete,expenses,phone,-44.71,-66330.35
buyer_7,María,,ES51209558104632098726,TRX_N-00565-83589584,2023-05-08T10:27:03,Portugalete,expenses,electricity,-48.18,-66378.53
buyer_7,María,,ES51209558104632098726,TRX_N-00566-49349966,2023-05-08T21:27:02,Portugalete,expenses,internet,-42.0,-66420.53
buyer_7,María,,ES51209558104632098726,TRX_N-00567-47237443,2023-05-10T18:59:28,Portugalete,expenses,cash,-100.0,-66520.53
buyer_7,María,,ES51209558104632098726,TRX_N-00568-71260285,2023-05-12T13:17:48,Portugalete,expenses,food,-123.83,-66644.36
buyer_7,María,,ES51209558104632098726,TRX_N-00569-10934665,2023-05-14T04:14:17,Portugalete,expenses,leisure,-20.92,-66665.28
buyer_7,María,,ES51209558104632098726,TRX_N-00570-74135861,2023-05-19T20:20:49,Portugalete,expenses,children,-273.44,-66938.72
buyer_7,María,,ES51209558104632098726,TRX_N-00571-30505756,2023-05-20T12:24:30,Portugalete,expenses,food,-113.16,-67051.88
buyer_7,María,,ES51209558104632098726,TRX_N-00572-81536206,2023-05-23T08:10:15,Portugalete,expenses,food,-113.63,-67165.51
buyer_7,María,,ES51209558104632098726,TRX_N-00573-92061730,2023-05-24T01:10:18,Arrasate,expenses,transport,-80.43,-67245.94
buyer_7,María,,ES51209558104632098726,TRX_N-00574-74682834,2023-05-24T10:59:46,Portugalete,expenses,cash,-100.0,-67345.94
buyer_7,María,,ES51209558104632098726,TRX_N-00575-58908062,2023-05-25T09:53:51,Portugalete,expenses,leisure,-35.11,-67381.05
buyer_7,María,,ES51209558104632098726,TRX_N-00576-95047751,2023-05-28T20:48:18,Portugalete,expenses,cash,-100.0,-67481.05
buyer_7,María,,ES51209558104632098726,TRX_N-00577-99896352,2023-05-29T18:01:59,Bilbao,expenses,cash,-100.0,-67581.05
buyer_7,María,,ES51209558104632098726,TRX_N-00578-36231280,2023-05-29T12:24:38,Portugalete,expenses,repairs,-45.91,-67626.96
buyer_7,María,,ES51209558104632098726,TRX_N-00579-45322647,2023-05-30T14:32:35,Portugalete,expenses,leisure,-44.99,-67671.95
buyer_7,María,,ES51209558104632098726,TRX_N-00580-27566121,2023-05-31T16:50:03,Portugalete,expenses,food,-113.66,-67785.61
buyer_7,María,,ES51209558104632098726,TRX_N-00581-86820147,2023-06-01T22:11:47,Portugalete,incomes,salary,1437.1,-66348.51
buyer_7,María,,ES51209558104632098726,TRX_N-00582-68380725,2023-06-01T22:11:47,Portugalete,incomes,extra_income,214.51,-66134.0
buyer_7,María,,ES51209558104632098726,TRX_N-00583-12185989,2023-06-01T22:11:47,Portugalete,incomes,salary_bonus,1019.06,-65114.94
buyer_7,María,,ES51209558104632098726,TRX_N-00584-36077272,2023-06-02T14:30:05,Labastida,expenses,cash,-100.0,-65214.94
buyer_7,María,,ES51209558104632098726,TRX_N-00585-26399554,2023-06-02T06:51:21,Iruña de Oca,expenses,appliances,-309.16,-65524.1
buyer_7,María,,ES51209558104632098726,TRX_N-00586-50117612,2023-06-03T18:32:05,Hernani,expenses,education,-44.6,-65568.7
buyer_7,María,,ES51209558104632098726,TRX_N-00587-56085192,2023-06-04T18:31:51,Portugalete,expenses,mortgage,-1094.46,-66663.16
buyer_7,María,,ES51209558104632098726,TRX_N-00588-09880170,2023-06-04T12:24:11,Portugalete,expenses,children,-161.77,-66824.93
buyer_7,María,,ES51209558104632098726,TRX_N-00589-48699088,2023-06-05T11:33:34,Portugalete,expenses,electricity,-31.87,-66856.8
buyer_7,María,,ES51209558104632098726,TRX_N-00590-55052096,2023-06-05T18:45:47,Portugalete,expenses,leisure,-83.98,-66940.78
buyer_7,María,,ES51209558104632098726,TRX_N-00591-72174849,2023-06-06T08:15:11,Portugalete,expenses,water,-34.7,-66975.48
buyer_7,María,,ES51209558104632098726,TRX_N-00592-02976012,2023-06-06T02:58:26,Portugalete,expenses,gas,-38.62,-67014.1
buyer_7,María,,ES51209558104632098726,TRX_N-00593-79042801,2023-06-07T16:07:25,Portugalete,expenses,cash,-100.0,-67114.1
buyer_7,María,,ES51209558104632098726,TRX_N-00594-87949283,2023-06-08T08:41:40,Portugalete,expenses,internet,-42.0,-67156.1
buyer_7,María,,ES51209558104632098726,TRX_N-00595-70621340,2023-06-08T11:27:30,Portugalete,expenses,phone,-44.65,-67200.75
buyer_7,María,,ES51209558104632098726,TRX_N-00596-78699006,2023-06-11T19:58:47,Portugalete,expenses,cash,-100.0,-67300.75
buyer_7,María,,ES51209558104632098726,TRX_N-00597-41944280,2023-06-12T18:04:52,Portugalete,expenses,transport,-43.38,-67344.13
buyer_7,María,,ES51209558104632098726,TRX_N-00598-59094169,2023-06-14T19:41:06,Portugalete,expenses,transport,-48.13,-67392.26
buyer_7,María,,ES51209558104632098726,TRX_N-00599-02457232,2023-06-15T15:20:28,Portugalete,expenses,cash,-100.0,-67492.26
buyer_7,María,,ES51209558104632098726,TRX_N-00600-66331384,2023-06-15T20:30:53,Portugalete,expenses,repairs,-168.01,-67660.27
buyer_7,María,,ES51209558104632098726,TRX_N-00601-26945626,2023-06-18T11:23:20,Portugalete,expenses,leisure,-54.95,-67715.22
buyer_7,María,,ES51209558104632098726,TRX_N-00602-10360916,2023-06-18T19:48:55,Portugalete,expenses,gifts,-748.03,-68463.25
buyer_7,María,,ES51209558104632098726,TRX_N-00603-75714011,2023-06-21T17:47:23,Portugalete,expenses,appliances,-197.05,-68660.3
buyer_7,María,,ES51209558104632098726,TRX_N-00604-90868878,2023-06-22T09:22:28,Portugalete,expenses,cash,-100.0,-68760.3
buyer_7,María,,ES51209558104632098726,TRX_N-00605-16356268,2023-06-24T18:37:28,Portugalete,expenses,food,-78.42,-68838.72
buyer_7,María,,ES51209558104632098726,TRX_N-00606-12008577,2023-06-26T11:01:39,Portugalete,expenses,food,-69.17,-68907.89
buyer_7,María,,ES51209558104632098726,TRX_N-00607-62792560,2023-06-27T12:57:09,Oyón-Oion,expenses,clothing,-111.28,-69019.17
buyer_7,María,,ES51209558104632098726,TRX_N-00608-88623846,2023-06-27T17:08:06,Errenteria,expenses,cash,-100.0,-69119.17
buyer_7,María,,ES51209558104632098726,TRX_N-00609-71160729,2023-06-28T12:48:45,Portugalete,expenses,gifts,-731.56,-69850.73
buyer_7,María,,ES51209558104632098726,TRX_N-00610-70613323,2023-06-29T16:06:05,Portugalete,expenses,travel,-601.58,-70452.31
buyer_7,María,,ES51209558104632098726,TRX_N-00611-35390730,2023-06-29T15:39:56,Portugalete,expenses,children,-681.9,-71134.21
buyer_7,María,,ES51209558104632098726,TRX_N-00612-79697517,2023-06-30T13:51:46,Portugalete,expenses,gifts,-684.31,-71818.52
buyer_7,María,,ES51209558104632098726,TRX_N-00613-71964505,2023-07-01T17:56:36,Portugalete,incomes,salary,1437.1,-70381.42
buyer_7,María,,ES51209558104632098726,TRX_N-00614-41859971,2023-07-02T08:23:26,Portugalete,expenses,food,-62.83,-70444.25
buyer_7,María,,ES51209558104632098726,TRX_N-00615-75783317,2023-07-02T15:32:16,Portugalete,expenses,cash,-100.0,-70544.25
buyer_7,María,,ES51209558104632098726,TRX_N-00616-72207802,2023-07-02T13:54:10,Portugalete,expenses,repairs,-227.71,-70771.96
buyer_7,María,,ES51209558104632098726,TRX_N-00617-56186857,2023-07-03T21:48:08,Portugalete,expenses,children,-658.97,-71430.93
buyer_7,María,,ES51209558104632098726,TRX_N-00618-63165416,2023-07-04T09:14:03,Portugalete,expenses,mortgage,-1094.46,-72525.39
buyer_7,María,,ES51209558104632098726,TRX_N-00619-05708549,2023-07-04T16:36:03,Portugalete,expenses,repairs,-152.6,-72677.99
buyer_7,María,,ES51209558104632098726,TRX_N-00620-51230708,2023-07-05T08:31:09,Portugalete,expenses,internet,-42.0,-72719.99
buyer_7,María,,ES51209558104632098726,TRX_N-00621-54486918,2023-07-05T14:37:41,Portugalete,expenses,car,-226.09,-72946.08
buyer_7,María,,ES51209558104632098726,TRX_N-00622-59567582,2023-07-06T17:58:20,Portugalete,expenses,water,-22.28,-72968.36
buyer_7,María,,ES51209558104632098726,TRX_N-00623-70251082,2023-07-06T19:45:35,Portugalete,expenses,phone,-38.89,-73007.25
buyer_7,María,,ES51209558104632098726,TRX_N-00624-48316172,2023-07-06T15:18:41,Portugalete,expenses,healthcare,-119.81,-73127.06
buyer_7,María,,ES51209558104632098726,TRX_N-00625-34095483,2023-07-06T19:42:46,Bermeo,expenses,education,-65.13,-73192.19
buyer_7,María,,ES51209558104632098726,TRX_N-00626-23340045,2023-07-07T17:57:47,Portugalete,expenses,electricity,-68.05,-73260.24
buyer_7,María,,ES51209558104632098726,TRX_N-00627-51341856,2023-07-07T03:01:51,Portugalete,expenses,cash,-100.0,-73360.24
buyer_7,María,,ES51209558104632098726,TRX_N-00628-37544307,2023-07-08T10:39:29,Portugalete,expenses,gas,-110.28,-73470.52
buyer_7,María,,ES51209558104632098726,TRX_N-00629-34769870,2023-07-08T08:50:47,Portugalete,expenses,food,-111.88,-73582.4
buyer_7,María,,ES51209558104632098726,TRX_N-00630-78159700,2023-07-08T18:56:00,Portugalete,expenses,transport,-84.03,-73666.43
buyer_7,María,,ES51209558104632098726,TRX_N-00631-51301160,2023-07-10T19:01:31,Portugalete,expenses,leisure,-63.93,-73730.36
buyer_7,María,,ES51209558104632098726,TRX_N-00632-23832165,2023-07-11T11:08:16,Portugalete,expenses,cash,-100.0,-73830.36
buyer_7,María,,ES51209558104632098726,TRX_N-00633-75917418,2023-07-12T06:17:24,Portugalete,expenses,cash,-100.0,-73930.36
buyer_7,María,,ES51209558104632098726,TRX_N-00634-25265429,2023-07-12T12:39:16,Portugalete,expenses,appliances,-124.33,-74054.69
buyer_7,María,,ES51209558104632098726,TRX_N-00635-64848644,2023-07-13T23:39:19,Portugalete,expenses,transport,-75.77,-74130.46
buyer_7,María,,ES51209558104632098726,TRX_N-00636-24902714,2023-07-13T20:52:25,Portugalete,expenses,repairs,-150.75,-74281.21
buyer_7,María,,ES51209558104632098726,TRX_N-00637-11318235,2023-07-13T16:14:43,Portugalete,expenses,gifts,-802.53,-75083.74
buyer_7,María,,ES51209558104632098726,TRX_N-00638-36232728,2023-07-14T18:50:36,Portugalete,expenses,appliances,-310.07,-75393.81
buyer_7,María,,ES51209558104632098726,TRX_N-00639-88442071,2023-07-15T19:59:18,Portugalete,expenses,education,-62.55,-75456.36
buyer_7,María,,ES51209558104632098726,TRX_N-00640-08265451,2023-07-15T17:47:21,Portugalete,expenses,cash,-100.0,-75556.36
buyer_7,María,,ES51209558104632098726,TRX_N-00641-17250611,2023-07-16T22:48:25,Portugalete,expenses,transport,-77.87,-75634.23
buyer_7,María,,ES51209558104632098726,TRX_N-00642-17625942,2023-07-16T19:09:41,Portugalete,expenses,cash,-100.0,-75734.23
buyer_7,María,,ES51209558104632098726,TRX_N-00643-65628712,2023-07-17T09:13:53,Portugalete,expenses,healthcare,-183.21,-75917.44
buyer_7,María,,ES51209558104632098726,TRX_N-00644-59737523,2023-07-17T13:43:44,Portugalete,expenses,cash,-100.0,-76017.44
buyer_7,María,,ES51209558104632098726,TRX_N-00645-08820098,2023-07-18T15:01:55,Portugalete,expenses,education,-47.57,-76065.01
buyer_7,María,,ES51209558104632098726,TRX_N-00646-08795001,2023-07-18T13:16:11,Portugalete,expenses,cash,-100.0,-76165.01
buyer_7,María,,ES51209558104632098726,TRX_N-00647-38288493,2023-07-19T18:44:55,Portugalete,expenses,cash,-100.0,-76265.01
buyer_7,María,,ES51209558104632098726,TRX_N-00648-68637681,2023-07-19T15:21:06,Portugalete,expenses,gifts,-133.68,-76398.69
buyer_7,María,,ES51209558104632098726,TRX_N-00649-28754709,2023-07-21T23:43:27,Santurtzi,expenses,gifts,-718.38,-77117.07
buyer_7,María,,ES51209558104632098726,TRX_N-00650-87111462,2023-07-23T09:50:12,Portugalete,expenses,leisure,-57.5,-77174.57
buyer_7,María,,ES51209558104632098726,TRX_N-00651-44306426,2023-07-25T20:51:42,Portugalete,expenses,clothing,-49.56,-77224.13
buyer_7,María,,ES51209558104632098726,TRX_N-00652-13208738,2023-07-26T13:20:55,Portugalete,expenses,transport,-40.56,-77264.69
buyer_7,María,,ES51209558104632098726,TRX_N-00653-71775932,2023-07-26T15:43:23,Portugalete,expenses,repairs,-78.02,-77342.71
buyer_7,María,,ES51209558104632098726,TRX_N-00654-55954486,2023-07-27T21:10:02,Portugalete,expenses,transport,-46.79,-77389.5
buyer_7,María,,ES51209558104632098726,TRX_N-00655-07932024,2023-07-29T19:50:45,Portugalete,expenses,transport,-46.54,-77436.04
buyer_7,María,,ES51209558104632098726,TRX_N-00656-17431312,2023-07-29T15:25:47,Portugalete,expenses,repairs,-291.92,-77727.96
buyer_7,María,,ES51209558104632098726,TRX_N-00657-96723732,2023-08-01T18:35:08,Portugalete,incomes,salary,1437.1,-76290.86
buyer_7,María,,ES51209558104632098726,TRX_N-00658-81219299,2023-08-01T20:42:37,Portugalete,expenses,repairs,-66.94,-76357.8
buyer_7,María,,ES51209558104632098726,TRX_N-00659-29019338,2023-08-02T09:25:23,Portugalete,expenses,cash,-100.0,-76457.8
buyer_7,María,,ES51209558104632098726,TRX_N-00660-40532903,2023-08-04T14:18:17,Portugalete,expenses,mortgage,-1094.46,-77552.26
buyer_7,María,,ES51209558104632098726,TRX_N-00661-13183598,2023-08-05T13:52:08,Portugalete,expenses,water,-39.72,-77591.98
buyer_7,María,,ES51209558104632098726,TRX_N-00662-62623702,2023-08-05T09:17:47,Portugalete,expenses,gas,-35.39,-77627.37
buyer_7,María,,ES51209558104632098726,TRX_N-00663-46114310,2023-08-05T13:21:30,Iruña de Oca,expenses,transport,-78.7,-77706.07
buyer_7,María,,ES51209558104632098726,TRX_N-00664-58339599,2023-08-06T11:24:49,Portugalete,expenses,internet,-42.0,-77748.07
buyer_7,María,,ES51209558104632098726,TRX_N-00665-73007440,2023-08-06T16:50:22,Portugalete,expenses,cash,-100.0,-77848.07
buyer_7,María,,ES51209558104632098726,TRX_N-00666-34288599,2023-08-08T17:27:10,Portugalete,expenses,phone,-41.14,-77889.21
buyer_7,María,,ES51209558104632098726,TRX_N-00667-22881517,2023-08-08T11:33:47,Portugalete,expenses,electricity,-43.92,-77933.13
buyer_7,María,,ES51209558104632098726,TRX_N-00668-13997401,2023-08-08T13:34:36,Portugalete,expenses,food,-121.67,-78054.8
buyer_7,María,,ES51209558104632098726,TRX_N-00669-49878820,2023-08-10T08:15:23,Portugalete,expenses,leisure,-45.06,-78099.86
buyer_7,María,,ES51209558104632098726,TRX_N-00670-29490604,2023-08-11T08:17:24,Portugalete,expenses,food,-89.44,-78189.3
buyer_7,María,,ES51209558104632098726,TRX_N-00671-30480733,2023-08-12T13:04:32,Vitoria-Gasteiz,expenses,food,-70.1,-78259.4
buyer_7,María,,ES51209558104632098726,TRX_N-00672-91804318,2023-08-12T07:05:22,Portugalete,expenses,clothing,-51.12,-78310.52
buyer_7,María,,ES51209558104632098726,TRX_N-00673-64522538,2023-08-12T15:13:15,Portugalete,expenses,gifts,-226.0,-78536.52
buyer_7,María,,ES51209558104632098726,TRX_N-00674-89687377,2023-08-13T19:45:03,Portugalete,expenses,clothing,-59.1,-78595.62
buyer_7,María,,ES51209558104632098726,TRX_N-00675-80674983,2023-08-13T13:02:28,Portugalete,expenses,children,-217.36,-78812.98
buyer_7,María,,ES51209558104632098726,TRX_N-00676-20423722,2023-08-16T09:49:01,Portugalete,expenses,gifts,-573.28,-79386.26
buyer_7,María,,ES51209558104632098726,TRX_N-00677-19812648,2023-08-18T23:46:10,Portugalete,expenses,food,-75.23,-79461.49
buyer_7,María,,ES51209558104632098726,TRX_N-00678-85070836,2023-08-19T11:37:53,Portugalete,expenses,cash,-100.0,-79561.49
buyer_7,María,,ES51209558104632098726,TRX_N-00679-32525549,2023-08-20T22:59:17,Portugalete,expenses,transport,-56.95,-79618.44
buyer_7,María,,ES51209558104632098726,TRX_N-00680-61080081,2023-08-21T09:54:34,Portugalete,expenses,cash,-100.0,-79718.44
buyer_7,María,,ES51209558104632098726,TRX_N-00681-85219103,2023-08-21T17:37:34,Leioa,expenses,repairs,-253.39,-79971.83
buyer_7,María,,ES51209558104632098726,TRX_N-00682-94963609,2023-08-22T18:50:52,Portugalete,expenses,food,-72.75,-80044.58
buyer_7,María,,ES51209558104632098726,TRX_N-00683-73158375,2023-08-24T23:08:01,Amurrio,expenses,food,-66.08,-80110.66
buyer_7,María,,ES51209558104632098726,TRX_N-00684-23333461,2023-08-24T12:44:02,Portugalete,expenses,leisure,-63.82,-80174.48
buyer_7,María,,ES51209558104632098726,TRX_N-00685-84662536,2023-08-25T14:36:14,Andoain,expenses,repairs,-242.67,-80417.15
buyer_7,María,,ES51209558104632098726,TRX_N-00686-68919613,2023-08-31T13:30:38,Portugalete,expenses,food,-91.32,-80508.47
buyer_7,María,,ES51209558104632098726,TRX_N-00687-12794208,2023-08-31T15:38:43,Portugalete,expenses,clothing,-56.52,-80564.99
buyer_7,María,,ES51209558104632098726,TRX_N-00688-22149439,2023-09-01T18:01:25,Portugalete,incomes,salary,1437.1,-79127.89
buyer_7,María,,ES51209558104632098726,TRX_N-00689-32577706,2023-09-01T18:01:25,Portugalete,incomes,extra_income,214.51,-78913.38
buyer_7,María,,ES51209558104632098726,TRX_N-00690-66396734,2023-09-03T15:29:26,Portugalete,expenses,cash,-100.0,-79013.38
buyer_7,María,,ES51209558104632098726,TRX_N-00691-69994163,2023-09-04T10:13:54,Portugalete,expenses,mortgage,-1094.46,-80107.84
buyer_7,María,,ES51209558104632098726,TRX_N-00692-71036503,2023-09-04T20:24:14,Portugalete,expenses,healthcare,-181.61,-80289.45
buyer_7,María,,ES51209558104632098726,TRX_N-00693-31565081,2023-09-05T12:56:08,Portugalete,expenses,leisure,-54.25,-80343.7
buyer_7,María,,ES51209558104632098726,TRX_N-00694-47789065,2023-09-05T12:46:07,Portugalete,expenses,repairs,-251.34,-80595.04
buyer_7,María,,ES51209558104632098726,TRX_N-00695-10916695,2023-09-06T14:05:07,Llodio,expenses,food,-77.41,-80672.45
buyer_7,María,,ES51209558104632098726,TRX_N-00696-07278886,2023-09-07T19:57:45,Salvatierra/Agurain,expenses,cash,-100.0,-80772.45
buyer_7,María,,ES51209558104632098726,TRX_N-00697-37027067,2023-09-08T14:17:07,Portugalete,expenses,water,-28.97,-80801.42
buyer_7,María,,ES51209558104632098726,TRX_N-00698-28354841,2023-09-08T13:42:06,Portugalete,expenses,electricity,-89.43,-80890.85
buyer_7,María,,ES51209558104632098726,TRX_N-00699-48542460,2023-09-08T22:57:30,Portugalete,expenses,phone,-42.9,-80933.75
buyer_7,María,,ES51209558104632098726,TRX_N-00700-90274960,2023-09-08T08:39:15,Portugalete,expenses,gas,-37.27,-80971.02
buyer_7,María,,ES51209558104632098726,TRX_N-00701-51106627,2023-09-08T10:19:18,Portugalete,expenses,internet,-42.0,-81013.02
buyer_7,María,,ES51209558104632098726,TRX_N-00702-08031207,2023-09-08T21:18:24,Portugalete,expenses,transport,-69.96,-81082.98
buyer_7,María,,ES51209558104632098726,TRX_N-00703-40643262,2023-09-09T11:49:48,Hernani,expenses,food,-76.46,-81159.44
buyer_7,María,,ES51209558104632098726,TRX_N-00704-07248517,2023-09-09T11:39:20,Portugalete,expenses,cash,-100.0,-81259.44
buyer_7,María,,ES51209558104632098726,TRX_N-00705-84601466,2023-09-11T23:49:02,Portugalete,expenses,food,-78.97,-81338.41
buyer_7,María,,ES51209558104632098726,TRX_N-00706-31524774,2023-09-13T12:21:10,Portugalete,expenses,leisure,-45.93,-81384.34
buyer_7,María,,ES51209558104632098726,TRX_N-00707-81335846,2023-09-14T15:34:46,Portugalete,expenses,food,-62.96,-81447.3
buyer_7,María,,ES51209558104632098726,TRX_N-00708-48772969,2023-09-16T09:38:41,Portugalete,expenses,transport,-50.6,-81497.9
buyer_7,María,,ES51209558104632098726,TRX_N-00709-48945405,2023-09-16T18:56:09,Portugalete,expenses,repairs,-273.52,-81771.42
buyer_7,María,,ES51209558104632098726,TRX_N-00710-55102858,2023-09-21T18:41:16,Portugalete,expenses,transport,-88.03,-81859.45
buyer_7,María,,ES51209558104632098726,TRX_N-00711-91771132,2023-09-22T10:12:39,Zuia,expenses,leisure,-28.63,-81888.08
buyer_7,María,,ES51209558104632098726,TRX_N-00712-43723541,2023-09-23T20:20:16,Portugalete,expenses,transport,-58.54,-81946.62
buyer_7,María,,ES51209558104632098726,TRX_N-00713-52330777,2023-09-24T20:01:34,Portugalete,expenses,transport,-77.32,-82023.94
buyer_7,María,,ES51209558104632098726,TRX_N-00714-77002167,2023-09-25T14:01:55,Portugalete,expenses,healthcare,-64.77,-82088.71
buyer_7,María,,ES51209558104632098726,TRX_N-00715-65879079,2023-09-27T16:28:05,Portugalete,expenses,food,-103.49,-82192.2
buyer_7,María,,ES51209558104632098726,TRX_N-00716-72908537,2023-09-28T14:57:16,Portugalete,expenses,leisure,-53.17,-82245.37
buyer_7,María,,ES51209558104632098726,TRX_N-00717-30701215,2023-09-28T10:37:56,Portugalete,expenses,education,-46.34,-82291.71
buyer_7,María,,ES51209558104632098726,TRX_N-00718-23431167,2023-09-29T15:36:02,Portugalete,expenses,transport,-74.43,-82366.14
buyer_7,María,,ES51209558104632098726,TRX_N-00719-94612440,2023-09-29T12:22:26,Amurrio,expenses,cash,-100.0,-82466.14
buyer_7,María,,ES51209558104632098726,TRX_N-00720-61364047,2023-09-29T08:04:04,Portugalete,expenses,travel,-1750.37,-84216.51
buyer_7,María,,ES51209558104632098726,TRX_N-00721-88568266,2023-10-01T08:26:24,Portugalete,incomes,salary,1437.1,-82779.41
buyer_7,María,,ES51209558104632098726,TRX_N-00722-24383270,2023-10-01T13:01:49,Hernani,expenses,transport,-61.15,-82840.56
buyer_7,María,,ES51209558104632098726,TRX_N-00723-29458500,2023-10-03T15:01:03,Portugalete,expenses,repairs,-223.76,-83064.32
buyer_7,María,,ES51209558104632098726,TRX_N-00724-62936508,2023-10-04T17:34:03,Portugalete,expenses,mortgage,-1094.46,-84158.78
buyer_7,María,,ES51209558104632098726,TRX_N-00725-79959998,2023-10-05T10:16:00,Barakaldo,expenses,gifts,-786.67,-84945.45
buyer_7,María,,ES51209558104632098726,TRX_N-00726-18340534,2023-10-06T16:52:44,Portugalete,expenses,electricity,-28.5,-84973.95
buyer_7,María,,ES51209558104632098726,TRX_N-00727-10871179,2023-10-06T13:19:21,Portugalete,expenses,gas,-66.59,-85040.54
buyer_7,María,,ES51209558104632098726,TRX_N-00728-27852288,2023-10-06T10:31:53,Portugalete,expenses,education,-63.65,-85104.19
buyer_7,María,,ES51209558104632098726,TRX_N-00729-45625501,2023-10-08T23:43:52,Portugalete,expenses,water,-31.85,-85136.04
buyer_7,María,,ES51209558104632098726,TRX_N-00730-85641536,2023-10-08T20:01:26,Portugalete,expenses,internet,-42.0,-85178.04
buyer_7,María,,ES51209558104632098726,TRX_N-00731-44488803,2023-10-08T14:56:15,Portugalete,expenses,phone,-34.72,-85212.76
buyer_7,María,,ES51209558104632098726,TRX_N-00732-74826688,2023-10-10T11:53:05,Portugalete,expenses,cash,-100.0,-85312.76
buyer_7,María,,ES51209558104632098726,TRX_N-00733-63332745,2023-10-10T04:48:29,Arrasate,expenses,travel,-912.23,-86224.99
buyer_7,María,,ES51209558104632098726,TRX_N-00734-63060453,2023-10-11T23:22:27,Oyón-Oion,expenses,transport,-80.68,-86305.67
buyer_7,María,,ES51209558104632098726,TRX_N-00735-68526909,2023-10-11T20:09:21,Portugalete,expenses,appliances,-143.52,-86449.19
buyer_7,María,,ES51209558104632098726,TRX_N-00736-04614509,2023-10-12T14:28:05,Portugalete,expenses,leisure,-81.52,-86530.71
buyer_7,María,,ES51209558104632098726,TRX_N-00737-38032829,2023-10-13T11:45:29,Portugalete,expenses,leisure,-25.85,-86556.56
buyer_7,María,,ES51209558104632098726,TRX_N-00738-62860900,2023-10-15T10:10:28,Portugalete,expenses,healthcare,-43.39,-86599.95
buyer_7,María,,ES51209558104632098726,TRX_N-00739-59270389,2023-10-16T12:08:18,Portugalete,expenses,cash,-100.0,-86699.95
buyer_7,María,,ES51209558104632098726,TRX_N-00740-00238236,2023-10-17T20:55:19,Portugalete,expenses,food,-81.41,-86781.36
buyer_7,María,,ES51209558104632098726,TRX_N-00741-40134938,2023-10-17T15:06:16,Portugalete,expenses,children,-460.38,-87241.74
buyer_7,María,,ES51209558104632098726,TRX_N-00742-41565352,2023-10-18T15:59:45,Portugalete,expenses,cash,-100.0,-87341.74
buyer_7,María,,ES51209558104632098726,TRX_N-00743-96185974,2023-10-18T10:25:01,Portugalete,expenses,children,-553.77,-87895.51
buyer_7,María,,ES51209558104632098726,TRX_N-00744-91541540,2023-10-19T18:57:07,Portugalete,expenses,transport,-84.27,-87979.78
buyer_7,María,,ES51209558104632098726,TRX_N-00745-90819936,2023-10-21T16:05:40,Portugalete,expenses,food,-104.19,-88083.97
buyer_7,María,,ES51209558104632098726,TRX_N-00746-18324346,2023-10-21T13:36:59,Portugalete,expenses,cash,-100.0,-88183.97
buyer_7,María,,ES51209558104632098726,TRX_N-00747-75064634,2023-10-21T13:15:33,Portugalete,expenses,children,-318.11,-88502.08
buyer_7,María,,ES51209558104632098726,TRX_N-00748-47960087,2023-10-22T06:33:35,Portugalete,expenses,food,-80.54,-88582.62
buyer_7,María,,ES51209558104632098726,TRX_N-00749-92224953,2023-10-22T14:18:00,Portugalete,expenses,leisure,-37.67,-88620.29
buyer_7,María,,ES51209558104632098726,TRX_N-00750-77205080,2023-10-26T23:28:59,Portugalete,expenses,travel,-769.98,-89390.27
buyer_7,María,,ES51209558104632098726,TRX_N-00751-53041005,2023-10-27T21:34:46,Portugalete,expenses,repairs,-61.77,-89452.04
buyer_7,María,,ES51209558104632098726,TRX_N-00752-15952660,2023-11-01T18:57:45,Portugalete,incomes,salary,1437.1,-88014.94
buyer_7,María,,ES51209558104632098726,TRX_N-00753-20410198,2023-11-01T23:50:02,Portugalete,expenses,transport,-45.7,-88060.64
buyer_7,María,,ES51209558104632098726,TRX_N-00754-39786459,2023-11-02T17:11:14,Portugalete,expenses,cash,-100.0,-88160.64
buyer_7,María,,ES51209558104632098726,TRX_N-00755-80654346,2023-11-04T14:36:43,Portugalete,expenses,mortgage,-1094.46,-89255.1
buyer_7,María,,ES51209558104632098726,TRX_N-00756-24309476,2023-11-04T20:03:06,Portugalete,expenses,cash,-100.0,-89355.1
buyer_7,María,,ES51209558104632098726,TRX_N-00757-76521788,2023-11-05T16:40:07,Portugalete,expenses,water,-22.69,-89377.79
buyer_7,María,,ES51209558104632098726,TRX_N-00758-71053351,2023-11-07T11:54:40,Portugalete,expenses,phone,-35.43,-89413.22
buyer_7,María,,ES51209558104632098726,TRX_N-00759-53943023,2023-11-08T20:15:23,Portugalete,expenses,gas,-98.42,-89511.64
buyer_7,María,,ES51209558104632098726,TRX_N-00760-34487702,2023-11-08T08:06:40,Portugalete,expenses,electricity,-59.33,-89570.97
buyer_7,María,,ES51209558104632098726,TRX_N-00761-53179302,2023-11-08T10:24:18,Portugalete,expenses,internet,-42.0,-89612.97
buyer_7,María,,ES51209558104632098726,TRX_N-00762-97523638,2023-11-10T14:41:46,Portugalete,expenses,food,-80.99,-89693.96
buyer_7,María,,ES51209558104632098726,TRX_N-00763-19051963,2023-11-11T17:05:36,Alegría-Dulantzi,expenses,cash,-100.0,-89793.96
buyer_7,María,,ES51209558104632098726,TRX_N-00764-47894859,2023-11-14T07:51:39,Sopela,expenses,food,-77.36,-89871.32
buyer_7,María,,ES51209558104632098726,TRX_N-00765-75760505,2023-11-15T15:08:38,Portugalete,expenses,transport,-63.54,-89934.86
buyer_7,María,,ES51209558104632098726,TRX_N-00766-01816884,2023-11-15T20:05:11,Portugalete,expenses,education,-59.84,-89994.7
buyer_7,María,,ES51209558104632098726,TRX_N-00767-15563517,2023-11-17T11:38:38,Portugalete,expenses,cash,-100.0,-90094.7
buyer_7,María,,ES51209558104632098726,TRX_N-00768-83141726,2023-11-19T13:24:08,Portugalete,expenses,food,-99.82,-90194.52
buyer_7,María,,ES51209558104632098726,TRX_N-00769-79580713,2023-11-19T09:46:56,Portugalete,expenses,cash,-100.0,-90294.52
buyer_7,María,,ES51209558104632098726,TRX_N-00770-90307731,2023-11-20T13:37:33,Portugalete,expenses,repairs,-87.09,-90381.61
buyer_7,María,,ES51209558104632098726,TRX_N-00771-51405216,2023-11-21T09:57:57,Portugalete,expenses,healthcare,-58.2,-90439.81
buyer_7,María,,ES51209558104632098726,TRX_N-00772-56466133,2023-11-21T22:23:10,Portugalete,expenses,cash,-100.0,-90539.81
buyer_7,María,,ES51209558104632098726,TRX_N-00773-46274973,2023-11-22T08:12:47,Leioa,expenses,food,-70.98,-90610.79
buyer_7,María,,ES51209558104632098726,TRX_N-00774-84275470,2023-11-27T15:52:50,Portugalete,expenses,gifts,-577.89,-91188.68
buyer_7,María,,ES51209558104632098726,TRX_N-00775-29501873,2023-11-29T13:32:04,Bilbao,expenses,food,-109.24,-91297.92
buyer_7,María,,ES51209558104632098726,TRX_N-00776-10630003,2023-11-30T16:52:17,Portugalete,expenses,children,-517.92,-91815.84
buyer_7,María,,ES51209558104632098726,TRX_N-00777-95098688,2023-12-01T13:42:08,Portugalete,incomes,salary,1437.1,-90378.74
buyer_7,María,,ES51209558104632098726,TRX_N-00778-26543569,2023-12-01T13:42:08,Portugalete,incomes,salary_bonus,1147.1,-89231.64
buyer_7,María,,ES51209558104632098726,TRX_N-00779-78100899,2023-12-01T14:59:54,Portugalete,expenses,cash,-100.0,-89331.64
buyer_7,María,,ES51209558104632098726,TRX_N-00780-39831489,2023-12-01T19:46:15,Portugalete,expenses,children,-404.98,-89736.62
buyer_7,María,,ES51209558104632098726,TRX_N-00781-84211387,2023-12-03T15:10:15,Hondarribia,expenses,cash,-100.0,-89836.62
buyer_7,María,,ES51209558104632098726,TRX_N-00782-49662970,2023-12-04T19:29:47,Portugalete,expenses,mortgage,-1094.46,-90931.08
buyer_7,María,,ES51209558104632098726,TRX_N-00783-70046651,2023-12-05T08:20:25,Portugalete,expenses,cash,-100.0,-91031.08
buyer_7,María,,ES51209558104632098726,TRX_N-00784-24168737,2023-12-05T08:56:49,Portugalete,expenses,gifts,-827.53,-91858.61
buyer_7,María,,ES51209558104632098726,TRX_N-00785-95322700,2023-12-08T15:15:23,Portugalete,expenses,water,-34.6,-91893.21
buyer_7,María,,ES51209558104632098726,TRX_N-00786-34566856,2023-12-08T02:50:01,Portugalete,expenses,phone,-40.75,-91933.96
buyer_7,María,,ES51209558104632098726,TRX_N-00787-36284376,2023-12-08T16:11:24,Portugalete,expenses,electricity,-24.53,-91958.49
buyer_7,María,,ES51209558104632098726,TRX_N-00788-57832334,2023-12-08T05:55:18,Portugalete,expenses,gas,-51.55,-92010.04
buyer_7,María,,ES51209558104632098726,TRX_N-00789-27614275,2023-12-08T09:17:52,Portugalete,expenses,internet,-42.0,-92052.04
buyer_7,María,,ES51209558104632098726,TRX_N-00790-97739300,2023-12-08T12:11:59,Portugalete,expenses,clothing,-47.43,-92099.47
buyer_7,María,,ES51209558104632098726,TRX_N-00791-26173113,2023-12-09T13:13:48,Portugalete,expenses,leisure,-60.53,-92160.0
buyer_7,María,,ES51209558104632098726,TRX_N-00792-50474014,2023-12-11T16:30:53,Portugalete,expenses,travel,-1453.52,-93613.52
buyer_7,María,,ES51209558104632098726,TRX_N-00793-27516431,2023-12-12T20:00:08,Portugalete,expenses,education,-58.75,-93672.27
buyer_7,María,,ES51209558104632098726,TRX_N-00794-72134859,2023-12-12T11:02:37,Errenteria,expenses,cash,-100.0,-93772.27
buyer_7,María,,ES51209558104632098726,TRX_N-00795-46866998,2023-12-14T14:03:20,Irun,expenses,transport,-64.27,-93836.54
buyer_7,María,,ES51209558104632098726,TRX_N-00796-61968539,2023-12-15T17:30:53,Portugalete,expenses,repairs,-53.69,-93890.23
buyer_7,María,,ES51209558104632098726,TRX_N-00797-17974144,2023-12-15T14:44:25,Portugalete,expenses,gifts,-788.67,-94678.9
buyer_7,María,,ES51209558104632098726,TRX_N-00798-89451409,2023-12-19T09:04:33,Portugalete,expenses,cash,-100.0,-94778.9
buyer_7,María,,ES51209558104632098726,TRX_N-00799-72313352,2023-12-20T19:30:41,Iruña de Oca,expenses,clothing,-88.67,-94867.57
buyer_7,María,,ES51209558104632098726,TRX_N-00800-02497940,2023-12-22T13:44:56,Portugalete,expenses,leisure,-50.94,-94918.51
buyer_7,María,,ES51209558104632098726,TRX_N-00801-16084053,2023-12-23T13:00:33,Portugalete,expenses,children,-498.81,-95417.32
buyer_7,María,,ES51209558104632098726,TRX_N-00802-96902428,2023-12-25T15:51:36,Vitoria-Gasteiz,expenses,food,-63.92,-95481.24
buyer_7,María,,ES51209558104632098726,TRX_N-00803-73074338,2023-12-25T19:28:52,Erandio,expenses,transport,-71.42,-95552.66
buyer_7,María,,ES51209558104632098726,TRX_N-00804-20418605,2023-12-26T15:14:24,Portugalete,expenses,cash,-100.0,-95652.66
buyer_7,María,,ES51209558104632098726,TRX_N-00805-92911621,2023-12-29T10:07:46,Portugalete,expenses,cash,-100.0,-95752.66
buyer_7,María,,ES51209558104632098726,TRX_N-00806-13828650,2023-12-30T18:25:35,Portugalete,expenses,repairs,-210.06,-95962.72
buyer_7,María,,ES51209558104632098726,TRX_N-00807-71773642,2024-01-01T08:05:59,Portugalete,incomes,salary,1483.56,-94479.16
buyer_7,María,,ES51209558104632098726,TRX_N-00808-60644373,2024-01-01T08:05:59,Portugalete,incomes,extra_income,214.51,-94264.65
buyer_7,María,,ES51209558104632098726,TRX_N-00809-29360403,2024-01-02T16:19:38,Leioa,expenses,clothing,-88.43,-94353.08
buyer_7,María,,ES51209558104632098726,TRX_N-00810-12147850,2024-01-04T01:20:03,Portugalete,expenses,mortgage,-1094.46,-95447.54
buyer_7,María,,ES51209558104632098726,TRX_N-00811-89768344,2024-01-05T14:07:35,Portugalete,expenses,electricity,-43.98,-95491.52
buyer_7,María,,ES51209558104632098726,TRX_N-00812-49399040,2024-01-05T12:37:48,Portugalete,expenses,gas,-44.22,-95535.74
buyer_7,María,,ES51209558104632098726,TRX_N-00813-09246861,2024-01-05T15:11:33,Portugalete,expenses,phone,-36.92,-95572.66
buyer_7,María,,ES51209558104632098726,TRX_N-00814-19269201,2024-01-06T10:00:48,Portugalete,expenses,internet,-42.0,-95614.66
buyer_7,María,,ES51209558104632098726,TRX_N-00815-67830925,2024-01-06T12:10:37,Portugalete,expenses,children,-614.02,-96228.68
buyer_7,María,,ES51209558104632098726,TRX_N-00816-40753428,2024-01-08T23:13:18,Portugalete,expenses,water,-30.53,-96259.21
buyer_7,María,,ES51209558104632098726,TRX_N-00817-11557020,2024-01-09T11:00:54,Portugalete,expenses,leisure,-71.55,-96330.76
buyer_7,María,,ES51209558104632098726,TRX_N-00818-58128982,2024-01-09T13:37:07,Portugalete,expenses,appliances,-101.4,-96432.16
buyer_7,María,,ES51209558104632098726,TRX_N-00819-67462298,2024-01-09T10:06:49,Portugalete,expenses,repairs,-119.5,-96551.66
buyer_7,María,,ES51209558104632098726,TRX_N-00820-00072451,2024-01-10T06:47:54,Portugalete,expenses,gifts,-53.61,-96605.27
buyer_7,María,,ES51209558104632098726,TRX_N-00821-18192506,2024-01-11T09:40:33,Portugalete,expenses,clothing,-141.34,-96746.61
buyer_7,María,,ES51209558104632098726,TRX_N-00822-16403786,2024-01-12T04:43:58,Bermeo,expenses,repairs,-263.06,-97009.67
buyer_7,María,,ES51209558104632098726,TRX_N-00823-59597395,2024-01-13T17:57:14,Portugalete,expenses,leisure,-71.86,-97081.53
buyer_7,María,,ES51209558104632098726,TRX_N-00824-01518209,2024-01-13T19:56:39,Portugalete,expenses,cash,-100.0,-97181.53
buyer_7,María,,ES51209558104632098726,TRX_N-00825-79125173,2024-01-14T13:18:29,Portugalete,expenses,food,-64.42,-97245.95
buyer_7,María,,ES51209558104632098726,TRX_N-00826-32606565,2024-01-14T11:44:00,Portugalete,expenses,leisure,-47.91,-97293.86
buyer_7,María,,ES51209558104632098726,TRX_N-00827-93257524,2024-01-14T20:46:42,Portugalete,expenses,cash,-100.0,-97393.86
buyer_7,María,,ES51209558104632098726,TRX_N-00828-10580288,2024-01-15T08:38:33,Hernani,expenses,food,-106.39,-97500.25
buyer_7,María,,ES51209558104632098726,TRX_N-00829-65369648,2024-01-15T18:34:57,Portugalete,expenses,appliances,-92.29,-97592.54
buyer_7,María,,ES51209558104632098726,TRX_N-00830-68281287,2024-01-16T13:03:00,Portugalete,expenses,gifts,-34.39,-97626.93
buyer_7,María,,ES51209558104632098726,TRX_N-00831-25900010,2024-01-20T16:41:07,Portugalete,expenses,food,-89.65,-97716.58
buyer_7,María,,ES51209558104632098726,TRX_N-00832-14800425,2024-01-22T09:02:48,Alegría-Dulantzi,expenses,food,-103.5,-97820.08
buyer_7,María,,ES51209558104632098726,TRX_N-00833-67574651,2024-01-26T15:25:04,Portugalete,expenses,transport,-49.65,-97869.73
buyer_7,María,,ES51209558104632098726,TRX_N-00834-44704251,2024-01-26T18:23:53,Vitoria-Gasteiz,expenses,leisure,-47.28,-97917.01
buyer_7,María,,ES51209558104632098726,TRX_N-00835-82502126,2024-01-26T11:38:50,Portugalete,expenses,clothing,-72.89,-97989.9
buyer_7,María,,ES51209558104632098726,TRX_N-00836-54810089,2024-01-28T12:37:29,Durango,expenses,food,-94.98,-98084.88
buyer_7,María,,ES51209558104632098726,TRX_N-00837-50584737,2024-01-29T14:00:08,Portugalete,expenses,cash,-100.0,-98184.88
buyer_7,María,,ES51209558104632098726,TRX_N-00838-85881359,2024-01-29T15:09:09,Portugalete,expenses,repairs,-50.31,-98235.19
buyer_7,María,,ES51209558104632098726,TRX_N-00839-80187443,2024-01-30T22:36:22,Sopela,expenses,food,-91.92,-98327.11
buyer_7,María,,ES51209558104632098726,TRX_N-00840-23712231,2024-01-31T14:15:09,Portugalete,expenses,food,-122.5,-98449.61
buyer_7,María,,ES51209558104632098726,TRX_N-00841-58284817,2024-01-31T13:19:04,Portugalete,expenses,healthcare,-160.59,-98610.2
buyer_7,María,,ES51209558104632098726,TRX_N-00842-92231211,2024-01-31T13:20:57,Portugalete,expenses,cash,-100.0,-98710.2
buyer_7,María,,ES51209558104632098726,TRX_N-00843-14262926,2024-02-01T17:53:53,Portugalete,incomes,salary,1483.56,-97226.64
buyer_7,María,,ES51209558104632098726,TRX_N-00844-20710612,2024-02-01T23:51:48,Portugalete,expenses,leisure,-70.65,-97297.29
buyer_7,María,,ES51209558104632098726,TRX_N-00845-54439448,2024-02-02T21:50:46,Portugalete,expenses,food,-115.63,-97412.92
buyer_7,María,,ES51209558104632098726,TRX_N-00846-37561804,2024-02-03T20:55:32,Portugalete,expenses,cash,-100.0,-97512.92
buyer_7,María,,ES51209558104632098726,TRX_N-00847-55664810,2024-02-04T19:14:39,Portugalete,expenses,mortgage,-1094.46,-98607.38
buyer_7,María,,ES51209558104632098726,TRX_N-00848-08007243,2024-02-05T16:35:48,Portugalete,expenses,water,-31.55,-98638.93
buyer_7,María,,ES51209558104632098726,TRX_N-00849-74746016,2024-02-05T17:34:29,Portugalete,expenses,phone,-40.78,-98679.71
buyer_7,María,,ES51209558104632098726,TRX_N-00850-55304034,2024-02-05T18:03:55,Portugalete,expenses,repairs,-319.31,-98999.02
buyer_7,María,,ES51209558104632098726,TRX_N-00851-07605485,2024-02-07T16:53:48,Portugalete,expenses,gas,-71.67,-99070.69
buyer_7,María,,ES51209558104632098726,TRX_N-00852-87807366,2024-02-07T12:21:35,Portugalete,expenses,food,-99.67,-99170.36
buyer_7,María,,ES51209558104632098726,TRX_N-00853-42630707,2024-02-08T12:46:13,Portugalete,expenses,internet,-42.0,-99212.36
buyer_7,María,,ES51209558104632098726,TRX_N-00854-69710318,2024-02-08T18:12:53,Portugalete,expenses,electricity,-75.87,-99288.23
buyer_7,María,,ES51209558104632098726,TRX_N-00855-71868582,2024-02-09T22:39:59,Portugalete,expenses,leisure,-74.44,-99362.67
buyer_7,María,,ES51209558104632098726,TRX_N-00856-53443229,2024-02-10T00:52:04,Labastida,expenses,food,-118.46,-99481.13
buyer_7,María,,ES51209558104632098726,TRX_N-00857-87821450,2024-02-10T11:08:26,Portugalete,expenses,gifts,-125.43,-99606.56
buyer_7,María,,ES51209558104632098726,TRX_N-00858-10673951,2024-02-11T14:58:07,Portugalete,expenses,cash,-100.0,-99706.56
buyer_7,María,,ES51209558104632098726,TRX_N-00859-34265708,2024-02-13T16:44:48,Portugalete,expenses,cash,-100.0,-99806.56
buyer_7,María,,ES51209558104632098726,TRX_N-00860-11161958,2024-02-14T23:45:34,Portugalete,expenses,cash,-100.0,-99906.56
buyer_7,María,,ES51209558104632098726,TRX_N-00861-95083874,2024-02-19T08:14:38,Portugalete,expenses,leisure,-77.3,-99983.86
buyer_7,María,,ES51209558104632098726,TRX_N-00862-06415099,2024-02-20T18:49:19,Portugalete,expenses,transport,-72.48,-100056.34
buyer_7,María,,ES51209558104632098726,TRX_N-00863-01062232,2024-02-20T03:15:17,Portugalete,expenses,cash,-100.0,-100156.34
buyer_7,María,,ES51209558104632098726,TRX_N-00864-29275132,2024-02-21T18:14:11,Portugalete,expenses,children,-208.21,-100364.55
buyer_7,María,,ES51209558104632098726,TRX_N-00865-59874997,2024-02-22T11:57:33,Portugalete,expenses,food,-79.73,-100444.28
buyer_7,María,,ES51209558104632098726,TRX_N-00866-44568951,2024-02-22T17:38:31,Portugalete,expenses,children,-698.65,-101142.93
buyer_7,María,,ES51209558104632098726,TRX_N-00867-05329362,2024-02-23T09:34:39,Portugalete,expenses,food,-103.63,-101246.56
buyer_7,María,,ES51209558104632098726,TRX_N-00868-99302383,2024-02-23T19:11:19,Portugalete,expenses,repairs,-106.41,-101352.97
buyer_7,María,,ES51209558104632098726,TRX_N-00869-36693651,2024-02-25T12:36:24,Portugalete,expenses,leisure,-38.2,-101391.17
buyer_7,María,,ES51209558104632098726,TRX_N-00870-12244395,2024-02-25T15:58:40,Portugalete,expenses,clothing,-122.12,-101513.29
buyer_7,María,,ES51209558104632098726,TRX_N-00871-93075075,2024-02-28T14:49:33,Portugalete,expenses,leisure,-48.36,-101561.65
buyer_7,María,,ES51209558104632098726,TRX_N-00872-08229731,2024-02-29T00:18:26,Portugalete,expenses,healthcare,-111.58,-101673.23
buyer_7,María,,ES51209558104632098726,TRX_N-00873-31031782,2024-02-29T22:46:40,Llodio,expenses,cash,-100.0,-101773.23
buyer_7,María,,ES51209558104632098726,TRX_N-00874-59234216,2024-03-01T13:06:22,Portugalete,incomes,salary,1483.56,-100289.67
buyer_7,María,,ES51209558104632098726,TRX_N-00875-16341746,2024-03-01T17:14:50,Portugalete,expenses,cash,-100.0,-100389.67
buyer_7,María,,ES51209558104632098726,TRX_N-00876-90256495,2024-03-02T19:35:19,Portugalete,expenses,food,-121.96,-100511.63
buyer_7,María,,ES51209558104632098726,TRX_N-00877-41265162,2024-03-02T11:08:59,Portugalete,expenses,cash,-100.0,-100611.63
buyer_7,María,,ES51209558104632098726,TRX_N-00878-01230872,2024-03-04T15:51:09,Portugalete,expenses,mortgage,-1094.46,-101706.09
buyer_7,María,,ES51209558104632098726,TRX_N-00879-13178335,2024-03-05T04:15:36,Zuia,expenses,gifts,-556.53,-102262.62
buyer_7,María,,ES51209558104632098726,TRX_N-00880-71856894,2024-03-06T14:36:26,Portugalete,expenses,electricity,-89.39,-102352.01
buyer_7,María,,ES51209558104632098726,TRX_N-00881-08189314,2024-03-06T17:19:56,Portugalete,expenses,transport,-47.73,-102399.74
buyer_7,María,,ES51209558104632098726,TRX_N-00882-10218082,2024-03-06T11:54:08,Portugalete,expenses,leisure,-48.01,-102447.75
buyer_7,María,,ES51209558104632098726,TRX_N-00883-87963927,2024-03-07T13:48:52,Portugalete,expenses,gas,-60.27,-102508.02
buyer_7,María,,ES51209558104632098726,TRX_N-00884-32038732,2024-03-07T08:51:23,Galdakao,expenses,repairs,-302.86,-102810.88
buyer_7,María,,ES51209558104632098726,TRX_N-00885-65873301,2024-03-08T17:42:50,Portugalete,expenses,water,-29.87,-102840.75
buyer_7,María,,ES51209558104632098726,TRX_N-00886-58894003,2024-03-08T14:49:10,Portugalete,expenses,internet,-42.0,-102882.75
buyer_7,María,,ES51209558104632098726,TRX_N-00887-01133465,2024-03-08T20:16:01,Portugalete,expenses,phone,-39.78,-102922.53
buyer_7,María,,ES51209558104632098726,TRX_N-00888-16506213,2024-03-08T09:19:58,Portugalete,expenses,food,-91.52,-103014.05
buyer_7,María,,ES51209558104632098726,TRX_N-00889-69367422,2024-03-08T08:04:44,Portugalete,expenses,transport,-41.1,-103055.15
buyer_7,María,,ES51209558104632098726,TRX_N-00890-38620639,2024-03-08T20:35:08,Portugalete,expenses,leisure,-81.11,-103136.26
buyer_7,María,,ES51209558104632098726,TRX_N-00891-06772122,2024-03-09T11:28:12,Berango,expenses,appliances,-406.2,-103542.46
buyer_7,María,,ES51209558104632098726,TRX_N-00892-77831661,2024-03-09T18:04:08,Portugalete,expenses,gifts,-818.35,-104360.81
buyer_7,María,,ES51209558104632098726,TRX_N-00893-49174522,2024-03-10T09:52:37,Portugalete,expenses,transport,-57.68,-104418.49
buyer_7,María,,ES51209558104632098726,TRX_N-00894-47584807,2024-03-10T17:22:46,Oyón-Oion,expenses,leisure,-45.54,-104464.03
buyer_7,María,,ES51209558104632098726,TRX_N-00895-22820513,2024-03-11T22:39:32,Portugalete,expenses,leisure,-38.58,-104502.61
buyer_7,María,,ES51209558104632098726,TRX_N-00896-60351474,2024-03-13T06:28:36,Portugalete,expenses,transport,-82.2,-104584.81
buyer_7,María,,ES51209558104632098726,TRX_N-00897-79531569,2024-03-13T23:18:52,Portugalete,expenses,leisure,-56.3,-104641.11
buyer_7,María,,ES51209558104632098726,TRX_N-00898-78611607,2024-03-13T22:13:28,Portugalete,expenses,education,-74.27,-104715.38
buyer_7,María,,ES51209558104632098726,TRX_N-00899-59144488,2024-03-14T19:52:47,Zarautz,expenses,transport,-77.56,-104792.94
buyer_7,María,,ES51209558104632098726,TRX_N-00900-99570490,2024-03-15T12:26:59,Portugalete,expenses,food,-84.59,-104877.53
buyer_7,María,,ES51209558104632098726,TRX_N-00901-56861440,2024-03-18T16:48:52,Portugalete,expenses,clothing,-74.46,-104951.99
buyer_7,María,,ES51209558104632098726,TRX_N-00902-07114954,2024-03-18T08:42:30,Portugalete,expenses,education,-74.01,-105026.0
buyer_7,María,,ES51209558104632098726,TRX_N-00903-53111852,2024-03-19T12:07:54,Portugalete,expenses,repairs,-57.16,-105083.16
buyer_7,María,,ES51209558104632098726,TRX_N-00904-76517848,2024-03-20T17:33:45,Portugalete,expenses,repairs,-274.72,-105357.88
buyer_7,María,,ES51209558104632098726,TRX_N-00905-57471712,2024-03-21T15:16:14,Arrasate,expenses,cash,-100.0,-105457.88
buyer_7,María,,ES51209558104632098726,TRX_N-00906-83228689,2024-03-25T11:37:18,Portugalete,expenses,leisure,-18.33,-105476.21
buyer_7,María,,ES51209558104632098726,TRX_N-00907-81798830,2024-03-28T10:44:50,Basauri,expenses,food,-60.71,-105536.92
buyer_7,María,,ES51209558104632098726,TRX_N-00908-14566422,2024-03-29T08:20:11,Portugalete,expenses,cash,-100.0,-105636.92
buyer_7,María,,ES51209558104632098726,TRX_N-00909-10619303,2024-03-31T19:21:18,Santurtzi,expenses,leisure,-30.84,-105667.76
buyer_7,María,,ES51209558104632098726,TRX_N-00910-15638498,2024-04-01T20:18:43,Portugalete,incomes,salary,1483.56,-104184.2
buyer_7,María,,ES51209558104632098726,TRX_N-00911-57636329,2024-04-01T20:18:43,Portugalete,incomes,extra_income,214.51,-103969.69
buyer_7,María,,ES51209558104632098726,TRX_N-00912-78269321,2024-04-01T13:10:03,Portugalete,expenses,education,-66.91,-104036.6
buyer_7,María,,ES51209558104632098726,TRX_N-00913-35361768,2024-04-03T09:44:40,Portugalete,expenses,transport,-83.16,-104119.76
buyer_7,María,,ES51209558104632098726,TRX_N-00914-37730927,2024-04-04T15:24:30,Portugalete,expenses,mortgage,-1094.46,-105214.22
buyer_7,María,,ES51209558104632098726,TRX_N-00915-72235963,2024-04-04T14:45:28,Portugalete,expenses,food,-82.19,-105296.41
buyer_7,María,,ES51209558104632098726,TRX_N-00916-66440895,2024-04-04T20:16:25,Portugalete,expenses,leisure,-20.83,-105317.24
buyer_7,María,,ES51209558104632098726,TRX_N-00917-49488699,2024-04-04T15:25:43,Sestao,expenses,gifts,-358.45,-105675.69
buyer_7,María,,ES51209558104632098726,TRX_N-00918-96417672,2024-04-04T17:31:12,Portugalete,expenses,children,-567.22,-106242.91
buyer_7,María,,ES51209558104632098726,TRX_N-00919-45661682,2024-04-05T13:52:35,Portugalete,expenses,phone,-43.25,-106286.16
buyer_7,María,,ES51209558104632098726,TRX_N-00920-44522699,2024-04-06T16:07:23,Portugalete,expenses,internet,-42.0,-106328.16
buyer_7,María,,ES51209558104632098726,TRX_N-00921-55104149,2024-04-06T13:17:23,Portugalete,expenses,children,-423.85,-106752.01
buyer_7,María,,ES51209558104632098726,TRX_N-00922-81862546,2024-04-07T11:04:04,Portugalete,expenses,electricity,-60.0,-106812.01
buyer_7,María,,ES51209558104632098726,TRX_N-00923-65129751,2024-04-07T14:58:57,Arrasate,expenses,gifts,-553.34,-107365.35
buyer_7,María,,ES51209558104632098726,TRX_N-00924-62950891,2024-04-08T17:50:17,Portugalete,expenses,water,-44.82,-107410.17
buyer_7,María,,ES51209558104632098726,TRX_N-00925-13741435,2024-04-08T14:10:53,Portugalete,expenses,gas,-73.47,-107483.64
buyer_7,María,,ES51209558104632098726,TRX_N-00926-30247135,2024-04-09T06:49:28,Portugalete,expenses,cash,-100.0,-107583.64
buyer_7,María,,ES51209558104632098726,TRX_N-00927-53262362,2024-04-10T13:30:24,Portugalete,expenses,cash,-100.0,-107683.64
buyer_7,María,,ES51209558104632098726,TRX_N-00928-05475978,2024-04-11T21:45:46,Portugalete,expenses,gifts,-494.36,-108178.0
buyer_7,María,,ES51209558104632098726,TRX_N-00929-08723541,2024-04-12T09:50:11,Portugalete,expenses,food,-122.42,-108300.42
buyer_7,María,,ES51209558104632098726,TRX_N-00930-18808362,2024-04-13T09:26:21,Portugalete,expenses,repairs,-244.36,-108544.78
buyer_7,María,,ES51209558104632098726,TRX_N-00931-64775026,2024-04-14T17:38:15,Portugalete,expenses,clothing,-153.32,-108698.1
buyer_7,María,,ES51209558104632098726,TRX_N-00932-04764808,2024-04-14T14:21:46,Portugalete,expenses,healthcare,-163.38,-108861.48
buyer_7,María,,ES51209558104632098726,TRX_N-00933-23607222,2024-04-14T10:11:32,Portugalete,expenses,education,-70.66,-108932.14
buyer_7,María,,ES51209558104632098726,TRX_N-00934-64987404,2024-04-15T09:53:09,Iruña de Oca,expenses,cash,-100.0,-109032.14
buyer_7,María,,ES51209558104632098726,TRX_N-00935-23720017,2024-04-16T14:46:03,Portugalete,expenses,repairs,-283.53,-109315.67
buyer_7,María,,ES51209558104632098726,TRX_N-00936-35293949,2024-04-17T13:43:12,Portugalete,expenses,food,-100.69,-109416.36
buyer_7,María,,ES51209558104632098726,TRX_N-00937-23821582,2024-04-22T21:52:31,Bilbao,expenses,food,-121.1,-109537.46
buyer_7,María,,ES51209558104632098726,TRX_N-00938-99414116,2024-04-22T11:00:45,Portugalete,expenses,leisure,-75.05,-109612.51
buyer_7,María,,ES51209558104632098726,TRX_N-00939-81893342,2024-04-23T16:00:24,Arrasate,expenses,leisure,-75.54,-109688.05
buyer_7,María,,ES51209558104632098726,TRX_N-00940-12639592,2024-04-23T02:28:48,Portugalete,expenses,clothing,-79.61,-109767.66
buyer_7,María,,ES51209558104632098726,TRX_N-00941-50916108,2024-04-25T12:26:34,Portugalete,expenses,food,-95.29,-109862.95
buyer_7,María,,ES51209558104632098726,TRX_N-00942-66511787,2024-04-25T11:53:58,Portugalete,expenses,transport,-73.83,-109936.78
buyer_7,María,,ES51209558104632098726,TRX_N-00943-51388173,2024-04-27T11:04:42,Portugalete,expenses,leisure,-75.81,-110012.59
buyer_7,María,,ES51209558104632098726,TRX_N-00944-67720531,2024-04-27T08:38:19,Portugalete,expenses,education,-78.51,-110091.1
buyer_7,María,,ES51209558104632098726,TRX_N-00945-02541558,2024-04-28T18:31:07,Portugalete,expenses,clothing,-70.54,-110161.64
buyer_7,María,,ES51209558104632098726,TRX_N-00946-48042981,2024-04-30T03:23:32,Portugalete,expenses,leisure,-21.49,-110183.13
buyer_7,María,,ES51209558104632098726,TRX_N-00947-69223640,2024-05-01T09:35:44,Portugalete,incomes,salary,1483.56,-108699.57
buyer_7,María,,ES51209558104632098726,TRX_N-00948-50035875,2024-05-03T16:21:59,Portugalete,expenses,food,-75.25,-108774.82
buyer_7,María,,ES51209558104632098726,TRX_N-00949-29950633,2024-05-04T09:34:34,Portugalete,expenses,mortgage,-1094.46,-109869.28
buyer_7,María,,ES51209558104632098726,TRX_N-00950-54356920,2024-05-04T08:27:20,Portugalete,expenses,cash,-100.0,-109969.28
buyer_7,María,,ES51209558104632098726,TRX_N-00951-80020161,2024-05-04T12:15:17,Portugalete,expenses,children,-626.78,-110596.06
buyer_7,María,,ES51209558104632098726,TRX_N-00952-60482247,2024-05-05T09:40:23,Portugalete,expenses,electricity,-81.9,-110677.96
buyer_7,María,,ES51209558104632098726,TRX_N-00953-27504051,2024-05-05T12:01:05,Portugalete,expenses,leisure,-74.84,-110752.8
buyer_7,María,,ES51209558104632098726,TRX_N-00954-09685079,2024-05-05T23:45:28,Erandio,expenses,education,-69.76,-110822.56
buyer_7,María,,ES51209558104632098726,TRX_N-00955-66706882,2024-05-07T17:15:28,Portugalete,expenses,gas,-101.92,-110924.48
buyer_7,María,,ES51209558104632098726,TRX_N-00956-45933182,2024-05-07T19:52:22,Portugalete,expenses,gifts,-648.18,-111572.66
buyer_7,María,,ES51209558104632098726,TRX_N-00957-94725072,2024-05-08T21:39:18,Portugalete,expenses,internet,-42.0,-111614.66
buyer_7,María,,ES51209558104632098726,TRX_N-00958-04252746,2024-05-08T12:57:42,Portugalete,expenses,phone,-40.62,-111655.28
buyer_7,María,,ES51209558104632098726,TRX_N-00959-20829465,2024-05-08T10:57:51,Portugalete,expenses,water,-27.21,-111682.49
buyer_7,María,,ES51209558104632098726,TRX_N-00960-71141660,2024-05-09T16:04:27,Portugalete,expenses,leisure,-42.44,-111724.93
buyer_7,María,,ES51209558104632098726,TRX_N-00961-32715352,2024-05-09T15:50:33,Portugalete,expenses,clothing,-130.75,-111855.68
buyer_7,María,,ES51209558104632098726,TRX_N-00962-62218607,2024-05-09T13:27:14,Portugalete,expenses,travel,-906.13,-112761.81
buyer_7,María,,ES51209558104632098726,TRX_N-00963-45566036,2024-05-10T15:19:28,Portugalete,expenses,leisure,-61.98,-112823.79
buyer_7,María,,ES51209558104632098726,TRX_N-00964-99918118,2024-05-10T16:50:50,Portugalete,expenses,healthcare,-90.77,-112914.56
buyer_7,María,,ES51209558104632098726,TRX_N-00965-37841657,2024-05-11T13:38:22,Portugalete,expenses,food,-63.62,-112978.18
buyer_7,María,,ES51209558104632098726,TRX_N-00966-53954771,2024-05-11T11:39:02,Portugalete,expenses,transport,-60.72,-113038.9
buyer_7,María,,ES51209558104632098726,TRX_N-00967-05188476,2024-05-11T18:58:56,Portugalete,expenses,repairs,-151.12,-113190.02
buyer_7,María,,ES51209558104632098726,TRX_N-00968-54563450,2024-05-12T09:08:52,Portugalete,expenses,food,-109.84,-113299.86
buyer_7,María,,ES51209558104632098726,TRX_N-00969-22151938,2024-05-12T04:40:46,Erandio,expenses,repairs,-287.73,-113587.59
buyer_7,María,,ES51209558104632098726,TRX_N-00970-36917001,2024-05-15T20:08:16,Portugalete,expenses,transport,-50.01,-113637.6
buyer_7,María,,ES51209558104632098726,TRX_N-00971-50225044,2024-05-17T13:42:10,Portugalete,expenses,gifts,-156.03,-113793.63
buyer_7,María,,ES51209558104632098726,TRX_N-00972-14858804,2024-05-18T13:38:24,Portugalete,expenses,healthcare,-147.25,-113940.88
buyer_7,María,,ES51209558104632098726,TRX_N-00973-14696454,2024-05-18T10:54:48,Leioa,expenses,cash,-100.0,-114040.88
buyer_7,María,,ES51209558104632098726,TRX_N-00974-44769637,2024-05-19T13:42:53,Portugalete,expenses,leisure,-30.59,-114071.47
buyer_7,María,,ES51209558104632098726,TRX_N-00975-78469289,2024-05-21T19:03:35,Portugalete,expenses,food,-63.36,-114134.83
buyer_7,María,,ES51209558104632098726,TRX_N-00976-00231694,2024-05-22T21:04:53,Portugalete,expenses,food,-94.25,-114229.08
buyer_7,María,,ES51209558104632098726,TRX_N-00977-40406547,2024-05-24T12:05:25,Portugalete,expenses,gifts,-759.52,-114988.6
buyer_7,María,,ES51209558104632098726,TRX_N-00978-74118954,2024-05-27T13:19:41,Vitoria-Gasteiz,expenses,clothing,-105.64,-115094.24
buyer_7,María,,ES51209558104632098726,TRX_N-00979-27340708,2024-05-28T16:34:11,Portugalete,expenses,appliances,-388.48,-115482.72
buyer_7,María,,ES51209558104632098726,TRX_N-00980-34647113,2024-05-29T05:15:58,Portugalete,expenses,food,-91.54,-115574.26
buyer_7,María,,ES51209558104632098726,TRX_N-00981-09651797,2024-05-30T15:03:47,Portugalete,expenses,transport,-49.15,-115623.41
buyer_7,María,,ES51209558104632098726,TRX_N-00982-29066717,2024-05-30T17:08:22,Portugalete,expenses,repairs,-248.69,-115872.1
buyer_7,María,,ES51209558104632098726,TRX_N-00983-29452259,2024-05-31T16:43:40,Portugalete,expenses,repairs,-166.98,-116039.08
buyer_7,María,,ES51209558104632098726,TRX_N-00984-39002258,2024-06-01T02:52:49,Portugalete,incomes,salary,1483.56,-114555.52
buyer_7,María,,ES51209558104632098726,TRX_N-00985-61094545,2024-06-01T02:52:49,Portugalete,incomes,salary_bonus,1060.3,-113495.22
buyer_7,María,,ES51209558104632098726,TRX_N-00986-18342391,2024-06-01T08:31:00,Portugalete,expenses,cash,-100.0,-113595.22
buyer_7,María,,ES51209558104632098726,TRX_N-00987-95366139,2024-06-02T09:01:00,Portugalete,expenses,food,-63.82,-113659.04
buyer_7,María,,ES51209558104632098726,TRX_N-00988-53340192,2024-06-03T10:45:59,Portugalete,expenses,transport,-77.39,-113736.43
buyer_7,María,,ES51209558104632098726,TRX_N-00989-54830071,2024-06-03T16:32:49,Portugalete,expenses,children,-677.46,-114413.89
buyer_7,María,,ES51209558104632098726,TRX_N-00990-99455341,2024-06-04T16:51:14,Portugalete,expenses,mortgage,-1094.46,-115508.35
buyer_7,María,,ES51209558104632098726,TRX_N-00991-68076664,2024-06-04T19:44:20,Portugalete,expenses,transport,-63.43,-115571.78
buyer_7,María,,ES51209558104632098726,TRX_N-00992-78623182,2024-06-05T19:25:08,Portugalete,expenses,phone,-38.03,-115609.81
buyer_7,María,,ES51209558104632098726,TRX_N-00993-42866982,2024-06-05T05:18:51,Portugalete,expenses,leisure,-29.81,-115639.62
buyer_7,María,,ES51209558104632098726,TRX_N-00994-37409805,2024-06-05T18:24:08,Portugalete,expenses,gifts,-32.37,-115671.99
buyer_7,María,,ES51209558104632098726,TRX_N-00995-59003389,2024-06-06T20:20:27,Portugalete,expenses,gas,-94.23,-115766.22
buyer_7,María,,ES51209558104632098726,TRX_N-00996-32075712,2024-06-07T13:28:46,Portugalete,expenses,transport,-52.6,-115818.82
buyer_7,María,,ES51209558104632098726,TRX_N-00997-94124871,2024-06-08T11:31:57,Portugalete,expenses,electricity,-63.82,-115882.64
buyer_7,María,,ES51209558104632098726,TRX_N-00998-30226165,2024-06-08T19:09:02,Portugalete,expenses,water,-35.13,-115917.77
buyer_7,María,,ES51209558104632098726,TRX_N-00999-60250004,2024-06-08T13:50:13,Portugalete,expenses,internet,-42.0,-115959.77
buyer_7,María,,ES51209558104632098726,TRX_N-01000-87759082,2024-06-08T19:31:41,Portugalete,expenses,repairs,-65.02,-116024.79
buyer_7,María,,ES51209558104632098726,TRX_N-01001-34866575,2024-06-09T21:07:09,Portugalete,expenses,repairs,-192.48,-116217.27
buyer_7,María,,ES51209558104632098726,TRX_N-01002-13319542,2024-06-10T05:41:23,Portugalete,expenses,leisure,-19.63,-116236.9
buyer_7,María,,ES51209558104632098726,TRX_N-01003-06970783,2024-06-11T10:23:52,Portugalete,expenses,cash,-100.0,-116336.9
buyer_7,María,,ES51209558104632098726,TRX_N-01004-20735381,2024-06-16T05:55:10,Portugalete,expenses,food,-106.34,-116443.24
buyer_7,María,,ES51209558104632098726,TRX_N-01005-42379739,2024-06-16T13:35:13,Portugalete,expenses,transport,-70.48,-116513.72
buyer_7,María,,ES51209558104632098726,TRX_N-01006-86262791,2024-06-16T19:34:02,Portugalete,expenses,healthcare,-128.23,-116641.95
buyer_7,María,,ES51209558104632098726,TRX_N-01007-08426108,2024-06-19T11:32:26,Hernani,expenses,education,-45.3,-116687.25
buyer_7,María,,ES51209558104632098726,TRX_N-01008-91045646,2024-06-19T17:39:15,Portugalete,expenses,appliances,-273.8,-116961.05
buyer_7,María,,ES51209558104632098726,TRX_N-01009-69563975,2024-06-20T09:09:59,Erandio,expenses,cash,-100.0,-117061.05
buyer_7,María,,ES51209558104632098726,TRX_N-01010-96107231,2024-06-21T12:04:16,Portugalete,expenses,food,-78.79,-117139.84
buyer_7,María,,ES51209558104632098726,TRX_N-01011-01964723,2024-06-22T10:46:06,Portugalete,expenses,gifts,-130.89,-117270.73
buyer_7,María,,ES51209558104632098726,TRX_N-01012-00757834,2024-06-23T19:18:38,Portugalete,expenses,gifts,-336.77,-117607.5
buyer_7,María,,ES51209558104632098726,TRX_N-01013-81054160,2024-06-24T19:44:02,Portugalete,expenses,education,-45.17,-117652.67
buyer_7,María,,ES51209558104632098726,TRX_N-01014-34590888,2024-06-25T19:11:54,Portugalete,expenses,food,-61.12,-117713.79
buyer_7,María,,ES51209558104632098726,TRX_N-01015-16494141,2024-06-25T11:21:51,Portugalete,expenses,education,-57.23,-117771.02
buyer_7,María,,ES51209558104632098726,TRX_N-01016-82312506,2024-06-26T10:49:35,Portugalete,expenses,gifts,-209.32,-117980.34
buyer_7,María,,ES51209558104632098726,TRX_N-01017-14237203,2024-06-27T09:57:37,Portugalete,expenses,cash,-100.0,-118080.34
buyer_7,María,,ES51209558104632098726,TRX_N-01018-58670622,2024-07-01T05:57:22,Portugalete,incomes,salary,1483.56,-116596.78
buyer_7,María,,ES51209558104632098726,TRX_N-01019-90668999,2024-07-01T05:57:22,Portugalete,incomes,extra_income,214.51,-116382.27
buyer_7,María,,ES51209558104632098726,TRX_N-01020-78696975,2024-07-01T10:05:02,Portugalete,expenses,leisure,-41.78,-116424.05
buyer_7,María,,ES51209558104632098726,TRX_N-01021-79650397,2024-07-04T07:53:46,Portugalete,expenses,mortgage,-1094.46,-117518.51
buyer_7,María,,ES51209558104632098726,TRX_N-01022-40921714,2024-07-05T14:18:17,Portugalete,expenses,electricity,-28.95,-117547.46
buyer_7,María,,ES51209558104632098726,TRX_N-01023-11303114,2024-07-05T10:16:42,Portugalete,expenses,internet,-42.0,-117589.46
buyer_7,María,,ES51209558104632098726,TRX_N-01024-56132697,2024-07-05T13:46:23,Portugalete,expenses,phone,-43.74,-117633.2
buyer_7,María,,ES51209558104632098726,TRX_N-01025-67944574,2024-07-06T19:27:14,Portugalete,expenses,food,-110.49,-117743.69
buyer_7,María,,ES51209558104632098726,TRX_N-01026-88961028,2024-07-06T12:33:16,Portugalete,expenses,appliances,-181.81,-117925.5
buyer_7,María,,ES51209558104632098726,TRX_N-01027-79206616,2024-07-08T12:59:29,Portugalete,expenses,gas,-101.89,-118027.39
buyer_7,María,,ES51209558104632098726,TRX_N-01028-01948825,2024-07-08T12:39:29,Portugalete,expenses,water,-26.79,-118054.18
buyer_7,María,,ES51209558104632098726,TRX_N-01029-50743350,2024-07-08T19:25:59,Portugalete,expenses,cash,-100.0,-118154.18
buyer_7,María,,ES51209558104632098726,TRX_N-01030-25159389,2024-07-10T17:17:35,Llodio,expenses,food,-113.01,-118267.19
buyer_7,María,,ES51209558104632098726,TRX_N-01031-85866425,2024-07-11T15:30:09,Portugalete,expenses,repairs,-73.83,-118341.02
buyer_7,María,,ES51209558104632098726,TRX_N-01032-23913015,2024-07-12T16:35:07,Portugalete,expenses,education,-49.71,-118390.73
buyer_7,María,,ES51209558104632098726,TRX_N-01033-81116157,2024-07-13T11:28:38,Portugalete,expenses,leisure,-54.3,-118445.03
buyer_7,María,,ES51209558104632098726,TRX_N-01034-03137571,2024-07-15T20:53:13,Bermeo,expenses,leisure,-27.98,-118473.01
buyer_7,María,,ES51209558104632098726,TRX_N-01035-28668749,2024-07-15T11:24:23,Portugalete,expenses,healthcare,-49.14,-118522.15
buyer_7,María,,ES51209558104632098726,TRX_N-01036-16680478,2024-07-18T11:15:20,Portugalete,expenses,transport,-43.74,-118565.89
buyer_7,María,,ES51209558104632098726,TRX_N-01037-52850947,2024-07-21T14:47:56,Portugalete,expenses,transport,-45.61,-118611.5
buyer_7,María,,ES51209558104632098726,TRX_N-01038-50276225,2024-07-22T16:56:11,Portugalete,expenses,food,-60.1,-118671.6
buyer_7,María,,ES51209558104632098726,TRX_N-01039-58682057,2024-07-25T23:11:21,Portugalete,expenses,cash,-100.0,-118771.6
buyer_7,María,,ES51209558104632098726,TRX_N-01040-13067969,2024-07-25T15:13:21,Portugalete,expenses,appliances,-324.53,-119096.13
buyer_7,María,,ES51209558104632098726,TRX_N-01041-58417907,2024-07-26T11:47:32,Portugalete,expenses,transport,-69.6,-119165.73
buyer_7,María,,ES51209558104632098726,TRX_N-01042-28437742,2024-07-26T14:32:37,Portugalete,expenses,cash,-100.0,-119265.73
buyer_7,María,,ES51209558104632098726,TRX_N-01043-41823787,2024-07-28T08:00:22,Portugalete,expenses,food,-86.03,-119351.76
buyer_7,María,,ES51209558104632098726,TRX_N-01044-50960360,2024-07-29T18:38:08,Portugalete,expenses,food,-60.05,-119411.81
buyer_7,María,,ES51209558104632098726,TRX_N-01045-98864287,2024-07-29T12:14:06,Portugalete,expenses,gifts,-439.57,-119851.38
buyer_7,María,,ES51209558104632098726,TRX_N-01046-61932902,2024-08-01T04:30:27,Portugalete,incomes,salary,1483.56,-118367.82
buyer_7,María,,ES51209558104632098726,TRX_N-01047-75319202,2024-08-02T16:16:33,Oyón-Oion,expenses,cash,-100.0,-118467.82
buyer_7,María,,ES51209558104632098726,TRX_N-01048-73844893,2024-08-03T03:16:07,Portugalete,expenses,cash,-100.0,-118567.82
buyer_7,María,,ES51209558104632098726,TRX_N-01049-56818692,2024-08-04T10:11:53,Portugalete,expenses,mortgage,-1094.46,-119662.28
buyer_7,María,,ES51209558104632098726,TRX_N-01050-05980654,2024-08-05T19:13:28,Portugalete,expenses,internet,-42.0,-119704.28
buyer_7,María,,ES51209558104632098726,TRX_N-01051-80507631,2024-08-05T12:55:56,Portugalete,expenses,phone,-39.88,-119744.16
buyer_7,María,,ES51209558104632098726,TRX_N-01052-11064443,2024-08-05T11:46:08,Portugalete,expenses,food,-63.09,-119807.25
buyer_7,María,,ES51209558104632098726,TRX_N-01053-43215663,2024-08-07T22:08:11,Portugalete,expenses,leisure,-20.72,-119827.97
buyer_7,María,,ES51209558104632098726,TRX_N-01054-35751633,2024-08-07T16:49:44,Portugalete,expenses,clothing,-57.76,-119885.73
buyer_7,María,,ES51209558104632098726,TRX_N-01055-58487824,2024-08-07T21:03:01,Portugalete,expenses,cash,-100.0,-119985.73
buyer_7,María,,ES51209558104632098726,TRX_N-01056-41155896,2024-08-08T15:41:30,Portugalete,expenses,water,-31.26,-120016.99
buyer_7,María,,ES51209558104632098726,TRX_N-01057-77211039,2024-08-08T10:50:12,Portugalete,expenses,electricity,-75.97,-120092.96
buyer_7,María,,ES51209558104632098726,TRX_N-01058-81886909,2024-08-08T21:36:46,Portugalete,expenses,gas,-93.08,-120186.04
buyer_7,María,,ES51209558104632098726,TRX_N-01059-28542104,2024-08-10T15:57:22,Iruña de Oca,expenses,food,-63.36,-120249.4
buyer_7,María,,ES51209558104632098726,TRX_N-01060-19336050,2024-08-12T09:19:51,Portugalete,expenses,clothing,-88.67,-120338.07
buyer_7,María,,ES51209558104632098726,TRX_N-01061-66137360,2024-08-12T13:19:50,Portugalete,expenses,gifts,-608.28,-120946.35
buyer_7,María,,ES51209558104632098726,TRX_N-01062-49603776,2024-08-13T20:12:34,Portugalete,expenses,food,-70.4,-121016.75
buyer_7,María,,ES51209558104632098726,TRX_N-01063-58182949,2024-08-13T08:14:40,Sestao,expenses,travel,-718.74,-121735.49
buyer_7,María,,ES51209558104632098726,TRX_N-01064-15474769,2024-08-16T19:12:20,Portugalete,expenses,leisure,-50.31,-121785.8
buyer_7,María,,ES51209558104632098726,TRX_N-01065-93315643,2024-08-17T11:43:25,Iruña de Oca,expenses,food,-75.13,-121860.93
buyer_7,María,,ES51209558104632098726,TRX_N-01066-21252986,2024-08-18T18:23:36,Portugalete,expenses,cash,-100.0,-121960.93
buyer_7,María,,ES51209558104632098726,TRX_N-01067-60726511,2024-08-19T17:09:23,Elciego,expenses,clothing,-159.32,-122120.25
buyer_7,María,,ES51209558104632098726,TRX_N-01068-42249946,2024-08-21T17:04:51,Pasaia,expenses,transport,-77.03,-122197.28
buyer_7,María,,ES51209558104632098726,TRX_N-01069-29106801,2024-08-22T09:08:52,Portugalete,expenses,leisure,-19.52,-122216.8
buyer_7,María,,ES51209558104632098726,TRX_N-01070-33971453,2024-08-22T19:40:41,Portugalete,expenses,healthcare,-150.66,-122367.46
buyer_7,María,,ES51209558104632098726,TRX_N-01071-18458332,2024-08-23T09:04:04,Portugalete,expenses,transport,-43.52,-122410.98
buyer_7,María,,ES51209558104632098726,TRX_N-01072-50092694,2024-08-23T12:04:36,Portugalete,expenses,cash,-100.0,-122510.98
buyer_7,María,,ES51209558104632098726,TRX_N-01073-29807387,2024-08-25T17:58:25,Portugalete,expenses,cash,-100.0,-122610.98
buyer_7,María,,ES51209558104632098726,TRX_N-01074-60171491,2024-08-27T14:39:53,Portugalete,expenses,transport,-88.86,-122699.84
buyer_7,María,,ES51209558104632098726,TRX_N-01075-76409403,2024-08-28T09:10:19,Portugalete,expenses,repairs,-304.85,-123004.69
buyer_7,María,,ES51209558104632098726,TRX_N-01076-56124491,2024-08-29T20:51:46,Portugalete,expenses,food,-104.92,-123109.61
buyer_7,María,,ES51209558104632098726,TRX_N-01077-51566280,2024-08-29T09:09:22,Portugalete,expenses,leisure,-63.71,-123173.32
buyer_7,María,,ES51209558104632098726,TRX_N-01078-83521991,2024-08-29T09:28:57,Santurtzi,expenses,gifts,-293.52,-123466.84
buyer_7,María,,ES51209558104632098726,TRX_N-01079-19341194,2024-08-31T15:56:36,Portugalete,expenses,repairs,-221.89,-123688.73
buyer_7,María,,ES51209558104632098726,TRX_N-01080-34510594,2024-09-01T09:56:00,Portugalete,incomes,salary,1483.56,-122205.17
buyer_7,María,,ES51209558104632098726,TRX_N-01081-16226617,2024-09-01T15:18:21,Portugalete,expenses,cash,-100.0,-122305.17
buyer_7,María,,ES51209558104632098726,TRX_N-01082-34769399,2024-09-02T16:25:21,Arrasate,expenses,appliances,-315.09,-122620.26
buyer_7,María,,ES51209558104632098726,TRX_N-01083-85862389,2024-09-03T16:48:15,Portugalete,expenses,cash,-100.0,-122720.26
buyer_7,María,,ES51209558104632098726,TRX_N-01084-86382766,2024-09-03T13:37:10,Portugalete,expenses,children,-430.38,-123150.64
buyer_7,María,,ES51209558104632098726,TRX_N-01085-63190068,2024-09-04T08:44:38,Portugalete,expenses,mortgage,-1094.46,-124245.1
buyer_7,María,,ES51209558104632098726,TRX_N-01086-85028921,2024-09-04T10:12:09,Portugalete,expenses,cash,-100.0,-124345.1
buyer_7,María,,ES51209558104632098726,TRX_N-01087-54752512,2024-09-04T17:11:42,Alegría-Dulantzi,expenses,repairs,-126.19,-124471.29
buyer_7,María,,ES51209558104632098726,TRX_N-01088-84565143,2024-09-04T06:18:42,Portugalete,expenses,children,-555.91,-125027.2
buyer_7,María,,ES51209558104632098726,TRX_N-01089-97319758,2024-09-05T06:44:15,Portugalete,expenses,internet,-42.0,-125069.2
buyer_7,María,,ES51209558104632098726,TRX_N-01090-47431415,2024-09-05T09:07:23,Llodio,expenses,transport,-66.24,-125135.44
buyer_7,María,,ES51209558104632098726,TRX_N-01091-52322774,2024-09-06T08:58:43,Portugalete,expenses,water,-26.78,-125162.22
buyer_7,María,,ES51209558104632098726,TRX_N-01092-23211057,2024-09-06T18:29:29,Portugalete,expenses,phone,-31.72,-125193.94
buyer_7,María,,ES51209558104632098726,TRX_N-01093-98537147,2024-09-07T22:01:36,Portugalete,expenses,electricity,-76.37,-125270.31
buyer_7,María,,ES51209558104632098726,TRX_N-01094-46988349,2024-09-07T16:18:35,Portugalete,expenses,food,-81.37,-125351.68
buyer_7,María,,ES51209558104632098726,TRX_N-01095-71028188,2024-09-07T22:22:17,Portugalete,expenses,cash,-100.0,-125451.68
buyer_7,María,,ES51209558104632098726,TRX_N-01096-73822771,2024-09-08T06:33:29,Portugalete,expenses,gas,-89.62,-125541.3
buyer_7,María,,ES51209558104632098726,TRX_N-01097-97182898,2024-09-09T20:03:14,Getxo,expenses,appliances,-203.41,-125744.71
buyer_7,María,,ES51209558104632098726,TRX_N-01098-43900411,2024-09-11T19:00:39,Portugalete,expenses,food,-72.28,-125816.99
buyer_7,María,,ES51209558104632098726,TRX_N-01099-60586506,2024-09-11T10:58:26,Portugalete,expenses,cash,-100.0,-125916.99
buyer_7,María,,ES51209558104632098726,TRX_N-01100-06125867,2024-09-13T08:22:47,Portugalete,expenses,food,-110.09,-126027.08
buyer_7,María,,ES51209558104632098726,TRX_N-01101-77619862,2024-09-13T08:29:53,Portugalete,expenses,appliances,-241.54,-126268.62
buyer_7,María,,ES51209558104632098726,TRX_N-01102-58782072,2024-09-15T12:25:28,Portugalete,expenses,clothing,-144.6,-126413.22
buyer_7,María,,ES51209558104632098726,TRX_N-01103-28463596,2024-09-17T08:28:03,Barakaldo,expenses,cash,-100.0,-126513.22
buyer_7,María,,ES51209558104632098726,TRX_N-01104-88252137,2024-09-18T20:27:28,Portugalete,expenses,food,-65.18,-126578.4
buyer_7,María,,ES51209558104632098726,TRX_N-01105-29634313,2024-09-18T14:30:24,Portugalete,expenses,clothing,-109.54,-126687.94
buyer_7,María,,ES51209558104632098726,TRX_N-01106-86859281,2024-09-18T14:39:31,Zarautz,expenses,appliances,-173.96,-126861.9
buyer_7,María,,ES51209558104632098726,TRX_N-01107-52824835,2024-09-18T21:04:00,Portugalete,expenses,repairs,-27.09,-126888.99
buyer_7,María,,ES51209558104632098726,TRX_N-01108-56926678,2024-09-24T18:22:37,Portugalete,expenses,transport,-84.91,-126973.9
buyer_7,María,,ES51209558104632098726,TRX_N-01109-91146653,2024-09-28T18:24:53,Labastida,expenses,repairs,-88.22,-127062.12
buyer_7,María,,ES51209558104632098726,TRX_N-01110-99950017,2024-10-01T08:46:37,Portugalete,incomes,salary,1483.56,-125578.56
buyer_7,María,,ES51209558104632098726,TRX_N-01111-80499949,2024-10-01T08:46:37,Portugalete,incomes,extra_income,214.51,-125364.05
buyer_7,María,,ES51209558104632098726,TRX_N-01112-60195954,2024-10-02T11:00:34,Portugalete,expenses,healthcare,-143.91,-125507.96
buyer_7,María,,ES51209558104632098726,TRX_N-01113-83321382,2024-10-04T15:29:19,Portugalete,expenses,mortgage,-1094.46,-126602.42
buyer_7,María,,ES51209558104632098726,TRX_N-01114-48796543,2024-10-04T13:12:38,Portugalete,expenses,cash,-100.0,-126702.42
buyer_7,María,,ES51209558104632098726,TRX_N-01115-78743826,2024-10-05T15:08:21,Portugalete,expenses,internet,-42.0,-126744.42
buyer_7,María,,ES51209558104632098726,TRX_N-01116-05709421,2024-10-05T18:15:15,Portugalete,expenses,phone,-32.07,-126776.49
buyer_7,María,,ES51209558104632098726,TRX_N-01117-81512533,2024-10-06T15:14:16,Portugalete,expenses,leisure,-46.6,-126823.09
buyer_7,María,,ES51209558104632098726,TRX_N-01118-14677259,2024-10-07T19:07:53,Portugalete,expenses,water,-33.61,-126856.7
buyer_7,María,,ES51209558104632098726,TRX_N-01119-19675685,2024-10-08T06:06:51,Portugalete,expenses,electricity,-87.71,-126944.41
buyer_7,María,,ES51209558104632098726,TRX_N-01120-71750930,2024-10-08T22:55:22,Portugalete,expenses,gas,-84.42,-127028.83
buyer_8,Antonio,,ES08209544318428491961,TRX_N-00001-52755414,2022-01-01T11:39:52,Labastida,incomes,salary,3197.7,4257.72
buyer_8,Antonio,,ES08209544318428491961,TRX_N-00002-86149910,2022-01-01T19:39:43,Oyón-Oion,expenses,food,-108.52,4149.2
buyer_8,Antonio,,ES08209544318428491961,TRX_N-00003-01891697,2022-01-04T20:49:31,Labastida,expenses,mortgage,-1053.21,3095.99
buyer_8,Antonio,,ES08209544318428491961,TRX_N-00004-08996007,2022-01-05T13:42:58,Labastida,expenses,internet,-42.0,3053.99
buyer_8,Antonio,,ES08209544318428491961,TRX_N-00005-28287581,2022-01-06T15:01:25,Berango,expenses,cash,-100.0,2953.99
buyer_8,Antonio,,ES08209544318428491961,TRX_N-00006-54025796,2022-01-07T11:57:36,Labastida,expenses,water,-40.89,2913.1
buyer_8,Antonio,,ES08209544318428491961,TRX_N-00007-84356793,2022-01-07T05:36:36,Labastida,expenses,gas,-65.65,2847.45
buyer_8,Antonio,,ES08209544318428491961,TRX_N-00008-30593248,2022-01-07T23:07:59,Labastida,expenses,phone,-44.06,2803.39
buyer_8,Antonio,,ES08209544318428491961,TRX_N-00009-65208015,2022-01-08T05:54:42,Labastida,expenses,electricity,-74.68,2728.71
buyer_8,Antonio,,ES08209544318428491961,TRX_N-00010-07908654,2022-01-09T20:48:53,Labastida,expenses,transport,-67.35,2661.36
buyer_8,Antonio,,ES08209544318428491961,TRX_N-00011-75591848,2022-01-10T11:20:18,Labastida,expenses,food,-105.0,2556.36
buyer_8,Antonio,,ES08209544318428491961,TRX_N-00012-75960352,2022-01-10T11:41:40,Labastida,expenses,transport,-84.95,2471.41
buyer_8,Antonio,,ES08209544318428491961,TRX_N-00013-53635105,2022-01-10T09:07:46,Erandio,expenses,gifts,-380.24,2091.17
buyer_8,Antonio,,ES08209544318428491961,TRX_N-00014-97562299,2022-01-11T11:35:20,Labastida,expenses,leisure,-63.95,2027.22
buyer_8,Antonio,,ES08209544318428491961,TRX_N-00015-22290963,2022-01-11T19:05:02,Labastida,expenses,clothing,-61.05,1966.17
buyer_8,Antonio,,ES08209544318428491961,TRX_N-00016-85344221,2022-01-12T19:26:42,Barakaldo,expenses,cash,-100.0,1866.17
buyer_8,Antonio,,ES08209544318428491961,TRX_N-00017-99671141,2022-01-13T12:35:13,Eibar,expenses,repairs,-257.2,1608.97
buyer_8,Antonio,,ES08209544318428491961,TRX_N-00018-45031339,2022-01-14T09:05:49,Labastida,expenses,leisure,-41.32,1567.65
buyer_8,Antonio,,ES08209544318428491961,TRX_N-00019-02904931,2022-01-15T14:43:37,Basauri,expenses,transport,-43.18,1524.47
buyer_8,Antonio,,ES08209544318428491961,TRX_N-00020-75350704,2022-01-16T08:54:50,Bermeo,expenses,food,-73.79,1450.68
buyer_8,Antonio,,ES08209544318428491961,TRX_N-00021-94937006,2022-01-16T10:37:11,Labastida,expenses,healthcare,-158.78,1291.9
buyer_8,Antonio,,ES08209544318428491961,TRX_N-00022-29289058,2022-01-16T11:25:31,Labastida,expenses,education,-67.87,1224.03
buyer_8,Antonio,,ES08209544318428491961,TRX_N-00023-97931289,2022-01-17T16:28:01,Labastida,expenses,food,-101.84,1122.19
buyer_8,Antonio,,ES08209544318428491961,TRX_N-00024-78852647,2022-01-17T20:54:11,Labastida,expenses,cash,-100.0,1022.19
buyer_8,Antonio,,ES08209544318428491961,TRX_N-00025-28970592,2022-01-18T12:43:33,Portugalete,expenses,cash,-100.0,922.19
buyer_8,Antonio,,ES08209544318428491961,TRX_N-00026-30816012,2022-01-20T20:52:24,Labastida,expenses,cash,-100.0,822.19
buyer_8,Antonio,,ES08209544318428491961,TRX_N-00027-43329736,2022-01-20T00:27:49,Labastida,expenses,repairs,-267.82,554.37
buyer_8,Antonio,,ES08209544318428491961,TRX_N-00028-16348852,2022-01-21T09:34:53,Labastida,expenses,cash,-100.0,454.37
buyer_8,Antonio,,ES08209544318428491961,TRX_N-00029-01000490,2022-01-22T18:08:19,Vitoria-Gasteiz,expenses,cash,-100.0,354.37
buyer_8,Antonio,,ES08209544318428491961,TRX_N-00030-09400116,2022-01-23T15:19:53,Labastida,expenses,gifts,-411.88,-57.51
buyer_8,Antonio,,ES08209544318428491961,TRX_N-00031-04480472,2022-01-24T23:05:11,Labastida,expenses,gifts,-331.89,-389.4
buyer_8,Antonio,,ES08209544318428491961,TRX_N-00032-56804779,2022-01-25T23:30:46,Labastida,expenses,cash,-100.0,-489.4
buyer_8,Antonio,,ES08209544318428491961,TRX_N-00033-52330277,2022-01-26T15:12:54,Labastida,expenses,healthcare,-122.3,-611.7
buyer_8,Antonio,,ES08209544318428491961,TRX_N-00034-73448833,2022-01-27T12:49:11,Barakaldo,expenses,food,-72.86,-684.56
buyer_8,Antonio,,ES08209544318428491961,TRX_N-00035-20652673,2022-01-27T20:46:13,Labastida,expenses,leisure,-55.09,-739.65
buyer_8,Antonio,,ES08209544318428491961,TRX_N-00036-90505690,2022-01-28T04:03:58,Labastida,expenses,leisure,-37.62,-777.27
buyer_8,Antonio,,ES08209544318428491961,TRX_N-00037-36979011,2022-01-28T09:54:47,Labastida,expenses,cash,-100.0,-877.27
buyer_8,Antonio,,ES08209544318428491961,TRX_N-00038-02540234,2022-01-29T15:30:37,Labastida,expenses,food,-108.03,-985.3
buyer_8,Antonio,,ES08209544318428491961,TRX_N-00039-43676608,2022-01-29T14:16:37,Eibar,expenses,transport,-66.1,-1051.4
buyer_8,Antonio,,ES08209544318428491961,TRX_N-00040-43212958,2022-01-29T16:40:37,Labastida,expenses,leisure,-65.51,-1116.91
buyer_8,Antonio,,ES08209544318428491961,TRX_N-00041-71502554,2022-01-29T23:38:58,Labastida,expenses,healthcare,-156.83,-1273.74
buyer_8,Antonio,,ES08209544318428491961,TRX_N-00042-41808094,2022-01-29T04:45:23,Labastida,expenses,cash,-100.0,-1373.74
buyer_8,Antonio,,ES08209544318428491961,TRX_N-00043-71376606,2022-01-29T19:38:43,Labastida,expenses,gifts,-489.81,-1863.55
buyer_8,Antonio,,ES08209544318428491961,TRX_N-00044-69648169,2022-01-30T23:55:47,Labastida,expenses,leisure,-26.45,-1890.0
buyer_8,Antonio,,ES08209544318428491961,TRX_N-00045-54337207,2022-02-01T00:41:44,Labastida,incomes,salary,3197.7,1307.7
buyer_8,Antonio,,ES08209544318428491961,TRX_N-00046-36498201,2022-02-01T16:43:06,Labastida,expenses,healthcare,-86.55,1221.15
buyer_8,Antonio,,ES08209544318428491961,TRX_N-00047-35756346,2022-02-03T13:53:20,Labastida,expenses,transport,-73.66,1147.49
buyer_8,Antonio,,ES08209544318428491961,TRX_N-00048-95732444,2022-02-04T15:56:50,Labastida,expenses,mortgage,-1053.21,94.28
buyer_8,Antonio,,ES08209544318428491961,TRX_N-00049-27324978,2022-02-05T12:32:50,Labastida,expenses,phone,-32.55,61.73
buyer_8,Antonio,,ES08209544318428491961,TRX_N-00050-42530975,2022-02-05T09:28:39,Labastida,expenses,food,-79.88,-18.15
buyer_8,Antonio,,ES08209544318428491961,TRX_N-00051-84018239,2022-02-05T20:36:21,Labastida,expenses,cash,-100.0,-118.15
buyer_8,Antonio,,ES08209544318428491961,TRX_N-00052-75914398,2022-02-07T05:06:05,Labastida,expenses,internet,-42.0,-160.15
buyer_8,Antonio,,ES08209544318428491961,TRX_N-00053-63339808,2022-02-08T17:43:48,Labastida,expenses,water,-43.55,-203.7
buyer_8,Antonio,,ES08209544318428491961,TRX_N-00054-66862490,2022-02-08T12:16:47,Labastida,expenses,electricity,-83.89,-287.59
buyer_8,Antonio,,ES08209544318428491961,TRX_N-00055-94711169,2022-02-08T15:43:06,Labastida,expenses,gas,-113.18,-400.77
buyer_8,Antonio,,ES08209544318428491961,TRX_N-00056-90615460,2022-02-08T18:15:58,Hondarribia,expenses,cash,-100.0,-500.77
buyer_8,Antonio,,ES08209544318428491961,TRX_N-00057-51925948,2022-02-10T07:29:14,Labastida,expenses,cash,-100.0,-600.77
buyer_8,Antonio,,ES08209544318428491961,TRX_N-00058-23346945,2022-02-12T22:24:17,Labastida,expenses,leisure,-70.95,-671.72
buyer_8,Antonio,,ES08209544318428491961,TRX_N-00059-81447338,2022-02-13T13:39:52,Labastida,expenses,transport,-69.26,-740.98
buyer_8,Antonio,,ES08209544318428491961,TRX_N-00060-59543023,2022-02-14T13:29:47,Labastida,expenses,food,-99.82,-840.8
buyer_8,Antonio,,ES08209544318428491961,TRX_N-00061-41092843,2022-02-15T19:39:38,Labastida,expenses,gifts,-276.58,-1117.38
buyer_8,Antonio,,ES08209544318428491961,TRX_N-00062-92000159,2022-02-16T17:03:54,Elciego,expenses,food,-92.12,-1209.5
buyer_8,Antonio,,ES08209544318428491961,TRX_N-00063-25586171,2022-02-17T02:52:10,Labastida,expenses,clothing,-124.59,-1334.09
buyer_8,Antonio,,ES08209544318428491961,TRX_N-00064-26274092,2022-02-23T16:01:52,Labastida,expenses,food,-111.04,-1445.13
buyer_8,Antonio,,ES08209544318428491961,TRX_N-00065-75711654,2022-02-24T08:42:51,Labastida,expenses,food,-107.22,-1552.35
buyer_8,Antonio,,ES08209544318428491961,TRX_N-00066-03776262,2022-02-24T09:39:30,Andoain,expenses,cash,-100.0,-1652.35
buyer_8,Antonio,,ES08209544318428491961,TRX_N-00067-66154540,2022-02-25T18:59:45,Zuia,expenses,transport,-69.6,-1721.95
buyer_8,Antonio,,ES08209544318428491961,TRX_N-00068-77934582,2022-02-26T18:42:30,Durango,expenses,repairs,-88.66,-1810.61
buyer_8,Antonio,,ES08209544318428491961,TRX_N-00069-00571565,2022-02-27T08:45:33,Zuia,expenses,food,-124.12,-1934.73
buyer_8,Antonio,,ES08209544318428491961,TRX_N-00070-69949721,2022-02-27T04:55:10,Labastida,expenses,leisure,-40.51,-1975.24
buyer_8,Antonio,,ES08209544318428491961,TRX_N-00071-30708406,2022-02-27T08:09:17,Llodio,expenses,appliances,-95.93,-2071.17
buyer_8,Antonio,,ES08209544318428491961,TRX_N-00072-87578036,2022-03-01T22:25:15,Labastida,incomes,salary,3197.7,1126.53
buyer_8,Antonio,,ES08209544318428491961,TRX_N-00073-51225857,2022-03-01T16:40:18,Lasarte-Oria,expenses,cash,-100.0,1026.53
buyer_8,Antonio,,ES08209544318428491961,TRX_N-00074-07109742,2022-03-02T19:20:07,Labastida,expenses,leisure,-47.06,979.47
buyer_8,Antonio,,ES08209544318428491961,TRX_N-00075-77759315,2022-03-03T16:05:20,Errenteria,expenses,gifts,-828.35,151.12
buyer_8,Antonio,,ES08209544318428491961,TRX_N-00076-82337807,2022-03-04T19:23:37,Labastida,expenses,mortgage,-1053.21,-902.09
buyer_8,Antonio,,ES08209544318428491961,TRX_N-00077-53813902,2022-03-05T21:33:56,Labastida,expenses,water,-31.13,-933.22
buyer_8,Antonio,,ES08209544318428491961,TRX_N-00078-80387973,2022-03-05T20:29:33,Labastida,expenses,leisure,-59.35,-992.57
buyer_8,Antonio,,ES08209544318428491961,TRX_N-00079-53732054,2022-03-06T14:36:42,Labastida,expenses,electricity,-44.64,-1037.21
buyer_8,Antonio,,ES08209544318428491961,TRX_N-00080-36105329,2022-03-06T16:44:56,Labastida,expenses,internet,-42.0,-1079.21
buyer_8,Antonio,,ES08209544318428491961,TRX_N-00081-10058881,2022-03-06T15:16:21,Labastida,expenses,leisure,-72.32,-1151.53
buyer_8,Antonio,,ES08209544318428491961,TRX_N-00082-59501365,2022-03-08T11:50:02,Labastida,expenses,gas,-66.8,-1218.33
buyer_8,Antonio,,ES08209544318428491961,TRX_N-00083-36046150,2022-03-08T23:35:19,Labastida,expenses,phone,-31.85,-1250.18
buyer_8,Antonio,,ES08209544318428491961,TRX_N-00084-08085263,2022-03-08T15:00:23,Labastida,expenses,cash,-100.0,-1350.18
buyer_8,Antonio,,ES08209544318428491961,TRX_N-00085-29235489,2022-03-09T08:09:18,Labastida,expenses,cash,-100.0,-1450.18
buyer_8,Antonio,,ES08209544318428491961,TRX_N-00086-05458738,2022-03-11T00:18:29,Berango,expenses,gifts,-138.25,-1588.43
buyer_8,Antonio,,ES08209544318428491961,TRX_N-00087-14390918,2022-03-12T19:18:48,Basauri,expenses,food,-93.39,-1681.82
buyer_8,Antonio,,ES08209544318428491961,TRX_N-00088-80587677,2022-03-12T06:15:45,Labastida,expenses,leisure,-27.52,-1709.34
buyer_8,Antonio,,ES08209544318428491961,TRX_N-00089-57194950,2022-03-13T11:43:30,Labastida,expenses,clothing,-60.02,-1769.36
buyer_8,Antonio,,ES08209544318428491961,TRX_N-00090-36459486,2022-03-13T19:24:42,Labastida,expenses,cash,-100.0,-1869.36
buyer_8,Antonio,,ES08209544318428491961,TRX_N-00091-72699467,2022-03-16T21:47:03,Sestao,expenses,food,-82.48,-1951.84
buyer_8,Antonio,,ES08209544318428491961,TRX_N-00092-82398998,2022-03-16T14:31:03,Leioa,expenses,leisure,-51.69,-2003.53
buyer_8,Antonio,,ES08209544318428491961,TRX_N-00093-49985162,2022-03-17T11:08:32,Labastida,expenses,transport,-44.15,-2047.68
buyer_8,Antonio,,ES08209544318428491961,TRX_N-00094-02707673,2022-03-18T18:30:17,Labastida,expenses,food,-61.2,-2108.88
buyer_8,Antonio,,ES08209544318428491961,TRX_N-00095-67717041,2022-03-21T07:53:40,Labastida,expenses,food,-74.22,-2183.1
buyer_8,Antonio,,ES08209544318428491961,TRX_N-00096-45657869,2022-03-22T20:55:28,Labastida,expenses,cash,-100.0,-2283.1
buyer_8,Antonio,,ES08209544318428491961,TRX_N-00097-36777315,2022-03-22T11:11:16,Hondarribia,expenses,travel,-1803.48,-4086.58
buyer_8,Antonio,,ES08209544318428491961,TRX_N-00098-90812308,2022-03-25T13:57:24,Alegría-Dulantzi,expenses,healthcare,-38.06,-4124.64
buyer_8,Antonio,,ES08209544318428491961,TRX_N-00099-68102957,2022-03-26T21:14:13,Labastida,expenses,leisure,-65.12,-4189.76
buyer_8,Antonio,,ES08209544318428491961,TRX_N-00100-58262165,2022-03-27T02:44:14,Labastida,expenses,leisure,-25.81,-4215.57
buyer_8,Antonio,,ES08209544318428491961,TRX_N-00101-94248999,2022-03-28T23:17:44,Labastida,expenses,repairs,-50.93,-4266.5
buyer_8,Antonio,,ES08209544318428491961,TRX_N-00102-23548618,2022-03-30T19:56:30,Labastida,expenses,leisure,-68.46,-4334.96
buyer_8,Antonio,,ES08209544318428491961,TRX_N-00103-52881576,2022-04-01T18:40:05,Labastida,incomes,salary,3197.7,-1137.26
buyer_8,Antonio,,ES08209544318428491961,TRX_N-00104-87079366,2022-04-01T18:40:05,Labastida,incomes,extra_income,377.3,-759.96
buyer_8,Antonio,,ES08209544318428491961,TRX_N-00105-23803496,2022-04-02T21:38:11,Labastida,expenses,transport,-89.83,-849.79
buyer_8,Antonio,,ES08209544318428491961,TRX_N-00106-00251081,2022-04-04T03:42:30,Labastida,expenses,mortgage,-1053.21,-1903.0
buyer_8,Antonio,,ES08209544318428491961,TRX_N-00107-19701592,2022-04-04T12:55:59,Labastida,expenses,leisure,-32.04,-1935.04
buyer_8,Antonio,,ES08209544318428491961,TRX_N-00108-61507134,2022-04-04T17:09:01,Salvatierra/Agurain,expenses,cash,-100.0,-2035.04
buyer_8,Antonio,,ES08209544318428491961,TRX_N-00109-35420453,2022-04-05T09:59:41,Labastida,expenses,electricity,-66.82,-2101.86
buyer_8,Antonio,,ES08209544318428491961,TRX_N-00110-81267804,2022-04-07T13:46:21,Labastida,expenses,phone,-30.75,-2132.61
buyer_8,Antonio,,ES08209544318428491961,TRX_N-00111-80074291,2022-04-08T17:21:16,Labastida,expenses,gas,-74.92,-2207.53
buyer_8,Antonio,,ES08209544318428491961,TRX_N-00112-73963338,2022-04-08T09:52:53,Labastida,expenses,water,-23.69,-2231.22
buyer_8,Antonio,,ES08209544318428491961,TRX_N-00113-19699799,2022-04-08T08:39:35,Labastida,expenses,internet,-42.0,-2273.22
buyer_8,Antonio,,ES08209544318428491961,TRX_N-00114-47073416,2022-04-08T05:25:45,Alegría-Dulantzi,expenses,clothing,-148.22,-2421.44
buyer_8,Antonio,,ES08209544318428491961,TRX_N-00115-60282957,2022-04-10T08:06:10,Irun,expenses,food,-86.36,-2507.8
buyer_8,Antonio,,ES08209544318428491961,TRX_N-00116-80141356,2022-04-13T02:06:55,Sopela,expenses,food,-92.4,-2600.2
buyer_8,Antonio,,ES08209544318428491961,TRX_N-00117-48722811,2022-04-13T23:54:26,Labastida,expenses,repairs,-34.47,-2634.67
buyer_8,Antonio,,ES08209544318428491961,TRX_N-00118-23801244,2022-04-16T17:09:10,Labastida,expenses,healthcare,-172.8,-2807.47
buyer_8,Antonio,,ES08209544318428491961,TRX_N-00119-08596605,2022-04-18T16:00:40,Irun,expenses,cash,-100.0,-2907.47
buyer_8,Antonio,,ES08209544318428491961,TRX_N-00120-30826254,2022-04-21T15:01:05,Labastida,expenses,education,-45.02,-2952.49
buyer_8,Antonio,,ES08209544318428491961,TRX_N-00121-48711820,2022-04-21T02:48:47,Labastida,expenses,repairs,-259.25,-3211.74
buyer_8,Antonio,,ES08209544318428491961,TRX_N-00122-69442151,2022-04-22T13:20:48,Labastida,expenses,repairs,-68.33,-3280.07
buyer_8,Antonio,,ES08209544318428491961,TRX_N-00123-23920172,2022-04-23T06:13:37,Labastida,expenses,transport,-85.67,-3365.74
buyer_8,Antonio,,ES08209544318428491961,TRX_N-00124-53383947,2022-04-23T17:21:17,Berango,expenses,cash,-100.0,-3465.74
buyer_8,Antonio,,ES08209544318428491961,TRX_N-00125-39179481,2022-04-23T20:25:16,Labastida,expenses,gifts,-673.35,-4139.09
buyer_8,Antonio,,ES08209544318428491961,TRX_N-00126-78931374,2022-04-24T17:43:06,Labastida,expenses,food,-63.89,-4202.98
buyer_8,Antonio,,ES08209544318428491961,TRX_N-00127-48455604,2022-04-25T13:19:12,Labastida,expenses,transport,-78.52,-4281.5
buyer_8,Antonio,,ES08209544318428491961,TRX_N-00128-62918163,2022-04-30T19:50:57,Labastida,expenses,transport,-53.49,-4334.99
buyer_8,Antonio,,ES08209544318428491961,TRX_N-00129-76149840,2022-05-01T19:26:22,Labastida,incomes,salary,3197.7,-1137.29
buyer_8,Antonio,,ES08209544318428491961,TRX_N-00130-10177223,2022-05-01T17:53:22,Labastida,expenses,food,-100.54,-1237.83
buyer_8,Antonio,,ES08209544318428491961,TRX_N-00131-04082227,2022-05-01T13:19:20,Labastida,expenses,healthcare,-85.83,-1323.66
buyer_8,Antonio,,ES08209544318428491961,TRX_N-00132-88367964,2022-05-02T00:10:28,Labastida,expenses,food,-81.84,-1405.5
buyer_8,Antonio,,ES08209544318428491961,TRX_N-00133-99892354,2022-05-02T18:02:46,Labastida,expenses,leisure,-51.83,-1457.33
buyer_8,Antonio,,ES08209544318428491961,TRX_N-00134-69374224,2022-05-03T20:29:56,Labastida,expenses,food,-109.46,-1566.79
buyer_8,Antonio,,ES08209544318428491961,TRX_N-00135-43700191,2022-05-04T18:43:14,Labastida,expenses,mortgage,-1053.21,-2620.0
buyer_8,Antonio,,ES08209544318428491961,TRX_N-00136-67182608,2022-05-04T19:57:04,Labastida,expenses,food,-115.7,-2735.7
buyer_8,Antonio,,ES08209544318428491961,TRX_N-00137-75458463,2022-05-04T08:32:16,Labastida,expenses,cash,-100.0,-2835.7
buyer_8,Antonio,,ES08209544318428491961,TRX_N-00138-24208754,2022-05-05T09:09:00,Labastida,expenses,gas,-94.33,-2930.03
buyer_8,Antonio,,ES08209544318428491961,TRX_N-00139-49093351,2022-05-05T23:37:48,Labastida,expenses,food,-79.71,-3009.74
buyer_8,Antonio,,ES08209544318428491961,TRX_N-00140-98300639,2022-05-06T11:02:23,Labastida,expenses,water,-36.87,-3046.61
buyer_8,Antonio,,ES08209544318428491961,TRX_N-00141-75629644,2022-05-06T18:54:55,Labastida,expenses,repairs,-100.02,-3146.63
buyer_8,Antonio,,ES08209544318428491961,TRX_N-00142-25345779,2022-05-07T23:06:54,Labastida,expenses,electricity,-89.77,-3236.4
buyer_8,Antonio,,ES08209544318428491961,TRX_N-00143-35750336,2022-05-08T19:03:51,Labastida,expenses,phone,-33.11,-3269.51
buyer_8,Antonio,,ES08209544318428491961,TRX_N-00144-02128227,2022-05-08T15:21:10,Labastida,expenses,internet,-42.0,-3311.51
buyer_8,Antonio,,ES08209544318428491961,TRX_N-00145-14686668,2022-05-08T09:03:27,Labastida,expenses,food,-120.07,-3431.58
buyer_8,Antonio,,ES08209544318428491961,TRX_N-00146-70992370,2022-05-08T00:42:48,Labastida,expenses,clothing,-134.33,-3565.91
buyer_8,Antonio,,ES08209544318428491961,TRX_N-00147-83159138,2022-05-08T08:53:46,Salvatierra/Agurain,expenses,gifts,-627.54,-4193.45
buyer_8,Antonio,,ES08209544318428491961,TRX_N-00148-24510512,2022-05-09T08:17:29,Labastida,expenses,leisure,-49.67,-4243.12
buyer_8,Antonio,,ES08209544318428491961,TRX_N-00149-52019813,2022-05-10T19:58:24,Labastida,expenses,appliances,-159.88,-4403.0
buyer_8,Antonio,,ES08209544318428491961,TRX_N-00150-14583499,2022-05-11T13:05:02,Arrasate,expenses,transport,-51.78,-4454.78
buyer_8,Antonio,,ES08209544318428491961,TRX_N-00151-87361441,2022-05-15T01:28:28,Llodio,expenses,education,-73.57,-4528.35
buyer_8,Antonio,,ES08209544318428491961,TRX_N-00152-95734524,2022-05-15T16:12:52,Labastida,expenses,cash,-100.0,-4628.35
buyer_8,Antonio,,ES08209544318428491961,TRX_N-00153-81463141,2022-05-16T08:41:15,Labastida,expenses,food,-69.75,-4698.1
buyer_8,Antonio,,ES08209544318428491961,TRX_N-00154-32897238,2022-05-16T19:40:35,Labastida,expenses,travel,-458.9,-5157.0
buyer_8,Antonio,,ES08209544318428491961,TRX_N-00155-41297549,2022-05-16T23:14:30,Labastida,expenses,appliances,-193.17,-5350.17
buyer_8,Antonio,,ES08209544318428491961,TRX_N-00156-73031381,2022-05-18T08:06:01,Zuia,expenses,cash,-100.0,-5450.17
buyer_8,Antonio,,ES08209544318428491961,TRX_N-00157-84986899,2022-05-19T18:32:03,Labastida,expenses,cash,-100.0,-5550.17
buyer_8,Antonio,,ES08209544318428491961,TRX_N-00158-40757586,2022-05-20T12:02:10,Labastida,expenses,healthcare,-145.11,-5695.28
buyer_8,Antonio,,ES08209544318428491961,TRX_N-00159-78828551,2022-05-21T08:28:23,Lasarte-Oria,expenses,leisure,-61.66,-5756.94
buyer_8,Antonio,,ES08209544318428491961,TRX_N-00160-97373310,2022-05-23T17:31:36,Hondarribia,expenses,education,-53.06,-5810.0
buyer_8,Antonio,,ES08209544318428491961,TRX_N-00161-02334069,2022-05-24T15:31:36,Zarautz,expenses,cash,-100.0,-5910.0
buyer_8,Antonio,,ES08209544318428491961,TRX_N-00162-23356139,2022-05-24T10:12:00,Labastida,expenses,repairs,-132.06,-6042.06
buyer_8,Antonio,,ES08209544318428491961,TRX_N-00163-65450520,2022-05-26T18:13:14,Labastida,expenses,gifts,-646.36,-6688.42
buyer_8,Antonio,,ES08209544318428491961,TRX_N-00164-34960009,2022-05-27T13:46:46,Pasaia,expenses,food,-99.02,-6787.44
buyer_8,Antonio,,ES08209544318428491961,TRX_N-00165-90396453,2022-05-28T13:36:06,Berango,expenses,leisure,-25.58,-6813.02
buyer_8,Antonio,,ES08209544318428491961,TRX_N-00166-91754232,2022-05-29T15:38:26,Labastida,expenses,gifts,-711.4,-7524.42
buyer_8,Antonio,,ES08209544318428491961,TRX_N-00167-98099379,2022-05-31T08:39:40,Vitoria-Gasteiz,expenses,cash,-100.0,-7624.42
buyer_8,Antonio,,ES08209544318428491961,TRX_N-00168-20236902,2022-06-01T15:10:28,Labastida,incomes,salary,3197.7,-4426.72
buyer_8,Antonio,,ES08209544318428491961,TRX_N-00169-50858945,2022-06-01T15:10:28,Labastida,incomes,salary_bonus,2445.64,-1981.08
buyer_8,Antonio,,ES08209544318428491961,TRX_N-00170-55341135,2022-06-01T17:28:32,Bermeo,expenses,food,-61.35,-2042.43
buyer_8,Antonio,,ES08209544318428491961,TRX_N-00171-38963144,2022-06-03T12:33:43,Labastida,expenses,gifts,-475.05,-2517.48
buyer_8,Antonio,,ES08209544318428491961,TRX_N-00172-83068955,2022-06-04T08:55:33,Labastida,expenses,mortgage,-1053.21,-3570.69
buyer_8,Antonio,,ES08209544318428491961,TRX_N-00173-31405674,2022-06-04T10:21:54,Labastida,expenses,cash,-100.0,-3670.69
buyer_8,Antonio,,ES08209544318428491961,TRX_N-00174-42291115,2022-06-05T14:14:57,Labastida,expenses,phone,-34.88,-3705.57
buyer_8,Antonio,,ES08209544318428491961,TRX_N-00175-60869634,2022-06-05T11:50:11,Labastida,expenses,food,-88.11,-3793.68
buyer_8,Antonio,,ES08209544318428491961,TRX_N-00176-56921328,2022-06-05T12:54:11,Labastida,expenses,education,-51.34,-3845.02
buyer_8,Antonio,,ES08209544318428491961,TRX_N-00177-73108335,2022-06-05T16:12:55,Labastida,expenses,cash,-100.0,-3945.02
buyer_8,Antonio,,ES08209544318428491961,TRX_N-00178-61457789,2022-06-06T14:27:15,Labastida,expenses,electricity,-54.77,-3999.79
buyer_8,Antonio,,ES08209544318428491961,TRX_N-00179-21784265,2022-06-07T06:17:22,Labastida,expenses,water,-44.23,-4044.02
buyer_8,Antonio,,ES08209544318428491961,TRX_N-00180-17639894,2022-06-07T19:14:01,Salvatierra/Agurain,expenses,transport,-60.38,-4104.4
buyer_8,Antonio,,ES08209544318428491961,TRX_N-00181-28845327,2022-06-07T14:29:39,Erandio,expenses,education,-74.87,-4179.27
buyer_8,Antonio,,ES08209544318428491961,TRX_N-00182-24487251,2022-06-08T09:11:08,Labastida,expenses,gas,-102.6,-4281.87
buyer_8,Antonio,,ES08209544318428491961,TRX_N-00183-31419889,2022-06-08T14:22:10,Labastida,expenses,internet,-42.0,-4323.87
buyer_8,Antonio,,ES08209544318428491961,TRX_N-00184-46486136,2022-06-08T20:27:13,Labastida,expenses,transport,-48.36,-4372.23
buyer_8,Antonio,,ES08209544318428491961,TRX_N-00185-04014039,2022-06-08T20:49:54,Oyón-Oion,expenses,clothing,-145.34,-4517.57
buyer_8,Antonio,,ES08209544318428491961,TRX_N-00186-26405358,2022-06-08T04:07:14,Labastida,expenses,cash,-100.0,-4617.57
buyer_8,Antonio,,ES08209544318428491961,TRX_N-00187-87274210,2022-06-09T10:38:49,Labastida,expenses,food,-74.56,-4692.13
buyer_8,Antonio,,ES08209544318428491961,TRX_N-00188-11403600,2022-06-09T08:07:52,Labastida,expenses,healthcare,-169.41,-4861.54
buyer_8,Antonio,,ES08209544318428491961,TRX_N-00189-33190358,2022-06-09T14:53:27,Labastida,expenses,education,-66.12,-4927.66
buyer_8,Antonio,,ES08209544318428491961,TRX_N-00190-44009895,2022-06-12T13:26:13,Labastida,expenses,cash,-100.0,-5027.66
buyer_8,Antonio,,ES08209544318428491961,TRX_N-00191-89398551,2022-06-13T19:42:23,Labastida,expenses,leisure,-76.91,-5104.57
buyer_8,Antonio,,ES08209544318428491961,TRX_N-00192-09216543,2022-06-15T20:43:58,Labastida,expenses,leisure,-31.67,-5136.24
buyer_8,Antonio,,ES08209544318428491961,TRX_N-00193-46089935,2022-06-16T19:55:20,Labastida,expenses,clothing,-124.74,-5260.98
buyer_8,Antonio,,ES08209544318428491961,TRX_N-00194-72539875,2022-06-17T10:25:09,Labastida,expenses,clothing,-69.94,-5330.92
buyer_8,Antonio,,ES08209544318428491961,TRX_N-00195-27888188,2022-06-19T13:12:09,Labastida,expenses,food,-60.14,-5391.06
buyer_8,Antonio,,ES08209544318428491961,TRX_N-00196-65137320,2022-06-20T20:25:48,Labastida,expenses,leisure,-31.05,-5422.11
buyer_8,Antonio,,ES08209544318428491961,TRX_N-00197-49625436,2022-06-20T18:31:10,Sopela,expenses,gifts,-51.59,-5473.7
buyer_8,Antonio,,ES08209544318428491961,TRX_N-00198-12124255,2022-06-21T14:13:50,Berango,expenses,food,-84.73,-5558.43
buyer_8,Antonio,,ES08209544318428491961,TRX_N-00199-34784888,2022-06-22T16:19:50,Labastida,expenses,food,-65.23,-5623.66
buyer_8,Antonio,,ES08209544318428491961,TRX_N-00200-24229004,2022-06-24T10:47:14,Labastida,expenses,food,-114.37,-5738.03
buyer_8,Antonio,,ES08209544318428491961,TRX_N-00201-35828500,2022-06-24T09:17:32,Labastida,expenses,clothing,-145.3,-5883.33
buyer_8,Antonio,,ES08209544318428491961,TRX_N-00202-53095915,2022-06-24T09:04:15,Labastida,expenses,gifts,-371.79,-6255.12
buyer_8,Antonio,,ES08209544318428491961,TRX_N-00203-39176057,2022-06-29T13:38:04,Labastida,expenses,cash,-100.0,-6355.12
buyer_8,Antonio,,ES08209544318428491961,TRX_N-00204-89784970,2022-07-01T14:47:21,Labastida,incomes,salary,3197.7,-3157.42
buyer_8,Antonio,,ES08209544318428491961,TRX_N-00205-36700296,2022-07-01T14:47:21,Labastida,incomes,extra_income,377.3,-2780.12
buyer_8,Antonio,,ES08209544318428491961,TRX_N-00206-55789090,2022-07-02T08:36:21,Labastida,expenses,leisure,-70.97,-2851.09
buyer_8,Antonio,,ES08209544318428491961,TRX_N-00207-67529623,2022-07-02T08:12:26,Labastida,expenses,education,-75.35,-2926.44
buyer_8,Antonio,,ES08209544318428491961,TRX_N-00208-46830724,2022-07-03T09:16:41,Labastida,expenses,cash,-100.0,-3026.44
buyer_8,Antonio,,ES08209544318428491961,TRX_N-00209-09141047,2022-07-04T18:45:48,Labastida,expenses,mortgage,-1053.21,-4079.65
buyer_8,Antonio,,ES08209544318428491961,TRX_N-00210-69032148,2022-07-04T14:04:04,Labastida,expenses,cash,-100.0,-4179.65
buyer_8,Antonio,,ES08209544318428491961,TRX_N-00211-75472748,2022-07-05T17:55:38,Labastida,expenses,gas,-41.09,-4220.74
buyer_8,Antonio,,ES08209544318428491961,TRX_N-00212-03531101,2022-07-05T14:27:09,Labastida,expenses,internet,-42.0,-4262.74
buyer_8,Antonio,,ES08209544318428491961,TRX_N-00213-62233396,2022-07-05T19:37:03,Labastida,expenses,transport,-67.89,-4330.63
buyer_8,Antonio,,ES08209544318428491961,TRX_N-00214-89904444,2022-07-06T21:27:23,Labastida,expenses,leisure,-60.19,-4390.82
buyer_8,Antonio,,ES08209544318428491961,TRX_N-00215-24910055,2022-07-07T18:21:30,Labastida,expenses,electricity,-76.43,-4467.25
buyer_8,Antonio,,ES08209544318428491961,TRX_N-00216-67221597,2022-07-08T20:17:03,Labastida,expenses,water,-30.01,-4497.26
buyer_8,Antonio,,ES08209544318428491961,TRX_N-00217-36317532,2022-07-08T19:21:15,Labastida,expenses,phone,-35.9,-4533.16
buyer_8,Antonio,,ES08209544318428491961,TRX_N-00218-25364148,2022-07-11T12:13:18,Labastida,expenses,transport,-49.92,-4583.08
buyer_8,Antonio,,ES08209544318428491961,TRX_N-00219-64341192,2022-07-11T11:08:49,Labastida,expenses,cash,-100.0,-4683.08
buyer_8,Antonio,,ES08209544318428491961,TRX_N-00220-44070205,2022-07-13T15:14:59,Mungia,expenses,leisure,-25.39,-4708.47
buyer_8,Antonio,,ES08209544318428491961,TRX_N-00221-67454529,2022-07-16T09:08:37,Labastida,expenses,food,-120.54,-4829.01
buyer_8,Antonio,,ES08209544318428491961,TRX_N-00222-35250439,2022-07-16T20:45:27,Labastida,expenses,cash,-100.0,-4929.01
buyer_8,Antonio,,ES08209544318428491961,TRX_N-00223-95996693,2022-07-17T08:09:33,Labastida,expenses,food,-63.13,-4992.14
buyer_8,Antonio,,ES08209544318428491961,TRX_N-00224-10412405,2022-07-18T14:12:44,Bilbao,expenses,food,-108.24,-5100.38
buyer_8,Antonio,,ES08209544318428491961,TRX_N-00225-68102026,2022-07-20T19:24:00,Labastida,expenses,clothing,-158.11,-5258.49
buyer_8,Antonio,,ES08209544318428491961,TRX_N-00226-26885858,2022-07-21T12:19:26,Leioa,expenses,clothing,-79.22,-5337.71
buyer_8,Antonio,,ES08209544318428491961,TRX_N-00227-96025286,2022-07-21T18:18:42,Labastida,expenses,repairs,-298.05,-5635.76
buyer_8,Antonio,,ES08209544318428491961,TRX_N-00228-60593036,2022-07-22T15:54:35,Labastida,expenses,food,-86.67,-5722.43
buyer_8,Antonio,,ES08209544318428491961,TRX_N-00229-84994725,2022-07-23T11:51:13,Labastida,expenses,food,-91.47,-5813.9
buyer_8,Antonio,,ES08209544318428491961,TRX_N-00230-28052429,2022-07-23T16:35:12,Labastida,expenses,travel,-1151.96,-6965.86
buyer_8,Antonio,,ES08209544318428491961,TRX_N-00231-82047493,2022-07-27T18:57:36,Labastida,expenses,leisure,-81.87,-7047.73
buyer_8,Antonio,,ES08209544318428491961,TRX_N-00232-48442726,2022-07-30T12:00:22,Labastida,expenses,food,-89.76,-7137.49
buyer_8,Antonio,,ES08209544318428491961,TRX_N-00233-31913203,2022-07-30T15:09:10,Labastida,expenses,cash,-100.0,-7237.49
buyer_8,Antonio,,ES08209544318428491961,TRX_N-00234-82803296,2022-07-31T10:26:32,Labastida,expenses,gifts,-425.13,-7662.62
buyer_8,Antonio,,ES08209544318428491961,TRX_N-00235-85894864,2022-08-01T17:36:11,Labastida,incomes,salary,3197.7,-4464.92
buyer_8,Antonio,,ES08209544318428491961,TRX_N-00236-50671445,2022-08-01T03:04:34,Labastida,expenses,food,-90.03,-4554.95
buyer_8,Antonio,,ES08209544318428491961,TRX_N-00237-21139214,2022-08-01T11:48:50,Labastida,expenses,cash,-100.0,-4654.95
buyer_8,Antonio,,ES08209544318428491961,TRX_N-00238-32776871,2022-08-01T20:55:45,Basauri,expenses,repairs,-228.25,-4883.2
buyer_8,Antonio,,ES08209544318428491961,TRX_N-00239-52195243,2022-08-02T10:59:18,Labastida,expenses,food,-77.49,-4960.69
buyer_8,Antonio,,ES08209544318428491961,TRX_N-00240-46926154,2022-08-02T08:52:02,Labastida,expenses,cash,-100.0,-5060.69
buyer_8,Antonio,,ES08209544318428491961,TRX_N-00241-73344223,2022-08-02T11:38:33,Labastida,expenses,repairs,-99.57,-5160.26
buyer_8,Antonio,,ES08209544318428491961,TRX_N-00242-39930241,2022-08-03T11:52:06,Labastida,expenses,cash,-100.0,-5260.26
buyer_8,Antonio,,ES08209544318428491961,TRX_N-00243-22554986,2022-08-04T11:48:27,Labastida,expenses,mortgage,-1053.21,-6313.47
buyer_8,Antonio,,ES08209544318428491961,TRX_N-00244-85218146,2022-08-05T12:16:58,Labastida,expenses,phone,-39.34,-6352.81
buyer_8,Antonio,,ES08209544318428491961,TRX_N-00245-33000567,2022-08-05T10:07:28,Labastida,expenses,cash,-100.0,-6452.81
buyer_8,Antonio,,ES08209544318428491961,TRX_N-00246-79672374,2022-08-06T09:36:16,Labastida,expenses,internet,-42.0,-6494.81
buyer_8,Antonio,,ES08209544318428491961,TRX_N-00247-91257985,2022-08-07T12:52:15,Basauri,expenses,repairs,-229.01,-6723.82
buyer_8,Antonio,,ES08209544318428491961,TRX_N-00248-74739372,2022-08-08T09:44:05,Labastida,expenses,water,-20.51,-6744.33
buyer_8,Antonio,,ES08209544318428491961,TRX_N-00249-38380859,2022-08-08T21:23:12,Labastida,expenses,electricity,-27.27,-6771.6
buyer_8,Antonio,,ES08209544318428491961,TRX_N-00250-13936741,2022-08-08T13:45:57,Labastida,expenses,gas,-94.84,-6866.44
buyer_8,Antonio,,ES08209544318428491961,TRX_N-00251-01616754,2022-08-08T10:18:17,Alegría-Dulantzi,expenses,cash,-100.0,-6966.44
buyer_8,Antonio,,ES08209544318428491961,TRX_N-00252-41892048,2022-08-09T10:00:29,Labastida,expenses,cash,-100.0,-7066.44
buyer_8,Antonio,,ES08209544318428491961,TRX_N-00253-32386204,2022-08-10T11:49:09,Labastida,expenses,food,-112.92,-7179.36
buyer_8,Antonio,,ES08209544318428491961,TRX_N-00254-74870234,2022-08-10T20:06:27,Labastida,expenses,transport,-89.33,-7268.69
buyer_8,Antonio,,ES08209544318428491961,TRX_N-00255-39422748,2022-08-11T11:39:32,Sestao,expenses,food,-66.72,-7335.41
buyer_8,Antonio,,ES08209544318428491961,TRX_N-00256-78149127,2022-08-12T08:04:38,Labastida,expenses,clothing,-92.56,-7427.97
buyer_8,Antonio,,ES08209544318428491961,TRX_N-00257-26508611,2022-08-16T15:07:25,Erandio,expenses,cash,-100.0,-7527.97
buyer_8,Antonio,,ES08209544318428491961,TRX_N-00258-04813718,2022-08-17T15:22:39,Labastida,expenses,clothing,-99.01,-7626.98
buyer_8,Antonio,,ES08209544318428491961,TRX_N-00259-39570268,2022-08-18T13:25:31,Labastida,expenses,clothing,-105.6,-7732.58
buyer_8,Antonio,,ES08209544318428491961,TRX_N-00260-54846310,2022-08-19T08:11:38,Labastida,expenses,transport,-56.47,-7789.05
buyer_8,Antonio,,ES08209544318428491961,TRX_N-00261-80964312,2022-08-23T13:36:42,Labastida,expenses,cash,-100.0,-7889.05
buyer_8,Antonio,,ES08209544318428491961,TRX_N-00262-15432994,2022-08-24T20:41:37,Labastida,expenses,leisure,-70.34,-7959.39
buyer_8,Antonio,,ES08209544318428491961,TRX_N-00263-35324897,2022-08-24T08:13:05,Amurrio,expenses,appliances,-364.13,-8323.52
buyer_8,Antonio,,ES08209544318428491961,TRX_N-00264-57260878,2022-08-26T11:40:18,Labastida,expenses,healthcare,-181.46,-8504.98
buyer_8,Antonio,,ES08209544318428491961,TRX_N-00265-96178310,2022-08-29T16:51:26,Labastida,expenses,repairs,-130.62,-8635.6
buyer_8,Antonio,,ES08209544318428491961,TRX_N-00266-35939067,2022-08-30T16:51:36,Labastida,expenses,gifts,-61.2,-8696.8
buyer_8,Antonio,,ES08209544318428491961,TRX_N-00267-47095844,2022-08-31T20:13:58,Hondarribia,expenses,cash,-100.0,-8796.8
buyer_8,Antonio,,ES08209544318428491961,TRX_N-00268-83591858,2022-08-31T21:19:21,Labastida,expenses,gifts,-106.74,-8903.54
buyer_8,Antonio,,ES08209544318428491961,TRX_N-00269-83020447,2022-09-01T11:55:31,Labastida,incomes,salary,3197.7,-5705.84
buyer_8,Antonio,,ES08209544318428491961,TRX_N-00270-47419784,2022-09-02T18:30:32,Santurtzi,expenses,clothing,-103.98,-5809.82
buyer_8,Antonio,,ES08209544318428491961,TRX_N-00271-87018102,2022-09-04T19:58:22,Labastida,expenses,mortgage,-1053.21,-6863.03
buyer_8,Antonio,,ES08209544318428491961,TRX_N-00272-80472752,2022-09-05T14:27:25,Labastida,expenses,water,-43.23,-6906.26
buyer_8,Antonio,,ES08209544318428491961,TRX_N-00273-23419449,2022-09-05T10:40:55,Santurtzi,expenses,food,-112.11,-7018.37
buyer_8,Antonio,,ES08209544318428491961,TRX_N-00274-32354495,2022-09-05T13:18:52,Labastida,expenses,healthcare,-60.08,-7078.45
buyer_8,Antonio,,ES08209544318428491961,TRX_N-00275-10080162,2022-09-06T14:30:25,Labastida,expenses,electricity,-20.92,-7099.37
buyer_8,Antonio,,ES08209544318428491961,TRX_N-00276-99667293,2022-09-06T15:13:24,Labastida,expenses,leisure,-62.1,-7161.47
buyer_8,Antonio,,ES08209544318428491961,TRX_N-00277-22745596,2022-09-07T23:41:22,Labastida,expenses,gas,-32.41,-7193.88
buyer_8,Antonio,,ES08209544318428491961,TRX_N-00278-49342220,2022-09-08T08:56:37,Labastida,expenses,internet,-42.0,-7235.88
buyer_8,Antonio,,ES08209544318428491961,TRX_N-00279-64359319,2022-09-08T10:29:02,Labastida,expenses,phone,-31.82,-7267.7
buyer_8,Antonio,,ES08209544318428491961,TRX_N-00280-89031402,2022-09-09T23:13:55,Labastida,expenses,repairs,-189.29,-7456.99
buyer_8,Antonio,,ES08209544318428491961,TRX_N-00281-56496403,2022-09-10T13:04:49,Labastida,expenses,food,-121.93,-7578.92
buyer_8,Antonio,,ES08209544318428491961,TRX_N-00282-32534071,2022-09-10T14:02:46,Donostia,expenses,leisure,-22.75,-7601.67
buyer_8,Antonio,,ES08209544318428491961,TRX_N-00283-50380509,2022-09-10T22:09:26,Galdakao,expenses,clothing,-67.15,-7668.82
buyer_8,Antonio,,ES08209544318428491961,TRX_N-00284-51210238,2022-09-12T08:01:55,Labastida,expenses,food,-107.87,-7776.69
buyer_8,Antonio,,ES08209544318428491961,TRX_N-00285-90461530,2022-09-12T13:23:14,Labastida,expenses,healthcare,-88.33,-7865.02
buyer_8,Antonio,,ES08209544318428491961,TRX_N-00286-45939677,2022-09-13T18:48:37,Labastida,expenses,cash,-100.0,-7965.02
buyer_8,Antonio,,ES08209544318428491961,TRX_N-00287-60345230,2022-09-14T19:46:12,Labastida,expenses,leisure,-19.63,-7984.65
buyer_8,Antonio,,ES08209544318428491961,TRX_N-00288-13188987,2022-09-14T12:57:59,Labastida,expenses,cash,-100.0,-8084.65
buyer_8,Antonio,,ES08209544318428491961,TRX_N-00289-22444690,2022-09-15T09:54:01,Labastida,expenses,gifts,-677.44,-8762.09
buyer_8,Antonio,,ES08209544318428491961,TRX_N-00290-14343152,2022-09-16T09:57:46,Leioa,expenses,food,-74.18,-8836.27
buyer_8,Antonio,,ES08209544318428491961,TRX_N-00291-41731534,2022-09-16T18:30:42,Bermeo,expenses,leisure,-79.2,-8915.47
buyer_8,Antonio,,ES08209544318428491961,TRX_N-00292-20845960,2022-09-17T19:59:36,Hondarribia,expenses,food,-92.64,-9008.11
buyer_8,Antonio,,ES08209544318428491961,TRX_N-00293-22560882,2022-09-17T08:33:12,Labastida,expenses,healthcare,-111.02,-9119.13
buyer_8,Antonio,,ES08209544318428491961,TRX_N-00294-71475269,2022-09-17T04:10:37,Labastida,expenses,travel,-1351.16,-10470.29
buyer_8,Antonio,,ES08209544318428491961,TRX_N-00295-61217839,2022-09-18T19:15:39,Labastida,expenses,transport,-72.4,-10542.69
buyer_8,Antonio,,ES08209544318428491961,TRX_N-00296-32823984,2022-09-19T12:15:23,Sestao,expenses,leisure,-19.97,-10562.66
buyer_8,Antonio,,ES08209544318428491961,TRX_N-00297-03864807,2022-09-20T15:48:59,Labastida,expenses,cash,-100.0,-10662.66
buyer_8,Antonio,,ES08209544318428491961,TRX_N-00298-44483787,2022-09-21T18:17:49,Labastida,expenses,food,-73.1,-10735.76
buyer_8,Antonio,,ES08209544318428491961,TRX_N-00299-04198934,2022-09-21T15:01:36,Sestao,expenses,leisure,-51.33,-10787.09
buyer_8,Antonio,,ES08209544318428491961,TRX_N-00300-67333624,2022-09-21T15:43:23,Labastida,expenses,cash,-100.0,-10887.09
buyer_8,Antonio,,ES08209544318428491961,TRX_N-00301-94127169,2022-09-22T17:01:05,Getxo,expenses,food,-98.04,-10985.13
buyer_8,Antonio,,ES08209544318428491961,TRX_N-00302-38731390,2022-09-24T11:58:10,Labastida,expenses,transport,-45.17,-11030.3
buyer_8,Antonio,,ES08209544318428491961,TRX_N-00303-86661742,2022-09-25T20:02:24,Labastida,expenses,leisure,-52.93,-11083.23
buyer_8,Antonio,,ES08209544318428491961,TRX_N-00304-98553570,2022-09-25T03:33:38,Labastida,expenses,cash,-100.0,-11183.23
buyer_8,Antonio,,ES08209544318428491961,TRX_N-00305-22831655,2022-09-28T09:04:00,Donostia,expenses,travel,-1567.6,-12750.83
buyer_8,Antonio,,ES08209544318428491961,TRX_N-00306-22104629,2022-09-28T21:34:11,Labastida,expenses,appliances,-152.48,-12903.31
buyer_8,Antonio,,ES08209544318428491961,TRX_N-00307-66834321,2022-09-29T14:32:50,Labastida,expenses,transport,-83.77,-12987.08
buyer_8,Antonio,,ES08209544318428491961,TRX_N-00308-49765227,2022-09-29T09:42:16,Galdakao,expenses,clothing,-68.97,-13056.05
buyer_8,Antonio,,ES08209544318428491961,TRX_N-00309-88810583,2022-10-01T15:35:47,Labastida,incomes,salary,3197.7,-9858.35
buyer_8,Antonio,,ES08209544318428491961,TRX_N-00310-00689829,2022-10-01T15:59:23,Labastida,expenses,food,-78.42,-9936.77
buyer_8,Antonio,,ES08209544318428491961,TRX_N-00311-41491252,2022-10-03T10:24:51,Labastida,expenses,repairs,-65.74,-10002.51
buyer_8,Antonio,,ES08209544318428491961,TRX_N-00312-66506011,2022-10-04T17:10:52,Labastida,expenses,mortgage,-1053.21,-11055.72
buyer_8,Antonio,,ES08209544318428491961,TRX_N-00313-73562971,2022-10-05T12:19:29,Labastida,expenses,gifts,-664.1,-11719.82
buyer_8,Antonio,,ES08209544318428491961,TRX_N-00314-77522175,2022-10-06T14:37:23,Labastida,expenses,gas,-76.18,-11796.0
buyer_8,Antonio,,ES08209544318428491961,TRX_N-00315-81171060,2022-10-07T22:26:23,Labastida,expenses,internet,-42.0,-11838.0
buyer_8,Antonio,,ES08209544318428491961,TRX_N-00316-48137276,2022-10-07T07:05:44,Labastida,expenses,phone,-30.55,-11868.55
buyer_8,Antonio,,ES08209544318428491961,TRX_N-00317-03984737,2022-10-07T19:30:42,Labastida,expenses,food,-87.9,-11956.45
buyer_8,Antonio,,ES08209544318428491961,TRX_N-00318-78614364,2022-10-07T18:00:58,Sestao,expenses,transport,-79.87,-12036.32
buyer_8,Antonio,,ES08209544318428491961,TRX_N-00319-43705697,2022-10-07T14:23:43,Leioa,expenses,leisure,-39.5,-12075.82
buyer_8,Antonio,,ES08209544318428491961,TRX_N-00320-25058710,2022-10-07T12:25:05,Labastida,expenses,cash,-100.0,-12175.82
buyer_8,Antonio,,ES08209544318428491961,TRX_N-00321-50376050,2022-10-08T14:02:44,Labastida,expenses,electricity,-42.04,-12217.86
buyer_8,Antonio,,ES08209544318428491961,TRX_N-00322-39278554,2022-10-08T10:52:08,Labastida,expenses,water,-39.22,-12257.08
buyer_8,Antonio,,ES08209544318428491961,TRX_N-00323-09429894,2022-10-08T16:40:56,Labastida,expenses,leisure,-47.82,-12304.9
buyer_8,Antonio,,ES08209544318428491961,TRX_N-00324-34651616,2022-10-09T14:25:48,Labastida,expenses,transport,-81.99,-12386.89
buyer_8,Antonio,,ES08209544318428491961,TRX_N-00325-49869416,2022-10-10T12:37:41,Labastida,expenses,healthcare,-95.41,-12482.3
buyer_8,Antonio,,ES08209544318428491961,TRX_N-00326-18694096,2022-10-10T21:21:06,Labastida,expenses,cash,-100.0,-12582.3
buyer_8,Antonio,,ES08209544318428491961,TRX_N-00327-02567570,2022-10-11T17:10:09,Basauri,expenses,leisure,-19.45,-12601.75
buyer_8,Antonio,,ES08209544318428491961,TRX_N-00328-39105309,2022-10-11T18:31:07,Labastida,expenses,cash,-100.0,-12701.75
buyer_8,Antonio,,ES08209544318428491961,TRX_N-00329-38118303,2022-10-13T08:55:48,Labastida,expenses,clothing,-135.79,-12837.54
buyer_8,Antonio,,ES08209544318428491961,TRX_N-00330-71385469,2022-10-14T11:46:59,Labastida,expenses,leisure,-73.88,-12911.42
buyer_8,Antonio,,ES08209544318428491961,TRX_N-00331-97810434,2022-10-14T20:31:06,Labastida,expenses,healthcare,-153.19,-13064.61
buyer_8,Antonio,,ES08209544318428491961,TRX_N-00332-27580152,2022-10-19T17:23:55,Labastida,expenses,food,-60.18,-13124.79
buyer_8,Antonio,,ES08209544318428491961,TRX_N-00333-78399707,2022-10-19T10:19:21,Berango,expenses,gifts,-329.49,-13454.28
buyer_8,Antonio,,ES08209544318428491961,TRX_N-00334-97887330,2022-10-23T14:26:15,Portugalete,expenses,food,-124.05,-13578.33
buyer_8,Antonio,,ES08209544318428491961,TRX_N-00335-37714030,2022-10-23T20:01:35,Labastida,expenses,cash,-100.0,-13678.33
buyer_8,Antonio,,ES08209544318428491961,TRX_N-00336-70617418,2022-10-25T18:56:32,Labastida,expenses,food,-106.14,-13784.47
buyer_8,Antonio,,ES08209544318428491961,TRX_N-00337-09134958,2022-10-27T13:16:43,Labastida,expenses,cash,-100.0,-13884.47
buyer_8,Antonio,,ES08209544318428491961,TRX_N-00338-01405591,2022-10-28T16:21:16,Sopela,expenses,transport,-58.01,-13942.48
buyer_8,Antonio,,ES08209544318428491961,TRX_N-00339-27825749,2022-10-30T22:33:34,Labastida,expenses,appliances,-366.75,-14309.23
buyer_8,Antonio,,ES08209544318428491961,TRX_N-00340-23857760,2022-11-01T12:11:12,Labastida,incomes,salary,3197.7,-11111.53
buyer_8,Antonio,,ES08209544318428491961,TRX_N-00341-40412215,2022-11-01T12:11:12,Labastida,incomes,extra_income,377.3,-10734.23
buyer_8,Antonio,,ES08209544318428491961,TRX_N-00342-53985659,2022-11-02T11:23:38,Labastida,expenses,food,-73.99,-10808.22
buyer_8,Antonio,,ES08209544318428491961,TRX_N-00343-31691353,2022-11-02T10:40:36,Labastida,expenses,cash,-100.0,-10908.22
buyer_8,Antonio,,ES08209544318428491961,TRX_N-00344-85945865,2022-11-03T21:22:11,Labastida,expenses,leisure,-68.62,-10976.84
buyer_8,Antonio,,ES08209544318428491961,TRX_N-00345-36185845,2022-11-04T09:59:44,Labastida,expenses,mortgage,-1053.21,-12030.05
buyer_8,Antonio,,ES08209544318428491961,TRX_N-00346-20487455,2022-11-05T17:36:23,Labastida,expenses,internet,-42.0,-12072.05
buyer_8,Antonio,,ES08209544318428491961,TRX_N-00347-31175315,2022-11-07T18:24:35,Labastida,expenses,phone,-32.22,-12104.27
buyer_8,Antonio,,ES08209544318428491961,TRX_N-00348-95325819,2022-11-07T17:35:10,Bermeo,expenses,food,-97.57,-12201.84
buyer_8,Antonio,,ES08209544318428491961,TRX_N-00349-21286544,2022-11-08T13:04:41,Labastida,expenses,water,-44.03,-12245.87
buyer_8,Antonio,,ES08209544318428491961,TRX_N-00350-91174475,2022-11-08T18:48:05,Labastida,expenses,electricity,-50.74,-12296.61
buyer_8,Antonio,,ES08209544318428491961,TRX_N-00351-45165955,2022-11-08T18:55:46,Labastida,expenses,gas,-106.13,-12402.74
buyer_8,Antonio,,ES08209544318428491961,TRX_N-00352-67473640,2022-11-08T09:17:43,Mungia,expenses,cash,-100.0,-12502.74
buyer_8,Antonio,,ES08209544318428491961,TRX_N-00353-82618236,2022-11-09T14:55:41,Labastida,expenses,transport,-77.42,-12580.16
buyer_8,Antonio,,ES08209544318428491961,TRX_N-00354-26756039,2022-11-13T17:24:21,Labastida,expenses,repairs,-27.84,-12608.0
buyer_8,Antonio,,ES08209544318428491961,TRX_N-00355-06744871,2022-11-14T21:30:46,Hondarribia,expenses,food,-77.85,-12685.85
buyer_8,Antonio,,ES08209544318428491961,TRX_N-00356-44173158,2022-11-15T10:00:03,Labastida,expenses,gifts,-251.44,-12937.29
buyer_8,Antonio,,ES08209544318428491961,TRX_N-00357-32060137,2022-11-16T18:21:17,Labastida,expenses,clothing,-82.76,-13020.05
buyer_8,Antonio,,ES08209544318428491961,TRX_N-00358-56644995,2022-11-16T18:09:05,Labastida,expenses,repairs,-52.12,-13072.17
buyer_8,Antonio,,ES08209544318428491961,TRX_N-00359-78350014,2022-11-17T10:21:08,Labastida,expenses,leisure,-38.64,-13110.81
buyer_8,Antonio,,ES08209544318428491961,TRX_N-00360-76401264,2022-11-18T16:32:06,Labastida,expenses,transport,-51.71,-13162.52
buyer_8,Antonio,,ES08209544318428491961,TRX_N-00361-62424185,2022-11-18T02:40:35,Andoain,expenses,leisure,-71.27,-13233.79
buyer_8,Antonio,,ES08209544318428491961,TRX_N-00362-95969908,2022-11-20T19:02:09,Labastida,expenses,leisure,-52.01,-13285.8
buyer_8,Antonio,,ES08209544318428491961,TRX_N-00363-93270612,2022-11-21T16:20:49,Labastida,expenses,food,-124.18,-13409.98
buyer_8,Antonio,,ES08209544318428491961,TRX_N-00364-73226708,2022-11-21T19:37:24,Labastida,expenses,transport,-49.84,-13459.82
buyer_8,Antonio,,ES08209544318428491961,TRX_N-00365-10203314,2022-11-24T18:58:18,Labastida,expenses,food,-124.89,-13584.71
buyer_8,Antonio,,ES08209544318428491961,TRX_N-00366-62073986,2022-11-24T12:19:27,Labastida,expenses,travel,-1575.1,-15159.81
buyer_8,Antonio,,ES08209544318428491961,TRX_N-00367-04763522,2022-11-29T18:18:28,Labastida,expenses,food,-112.09,-15271.9
buyer_8,Antonio,,ES08209544318428491961,TRX_N-00368-52429311,2022-12-01T19:49:14,Labastida,incomes,salary,3197.7,-12074.2
buyer_8,Antonio,,ES08209544318428491961,TRX_N-00369-28171689,2022-12-01T19:49:14,Labastida,incomes,salary_bonus,2465.63,-9608.57
buyer_8,Antonio,,ES08209544318428491961,TRX_N-00370-90147863,2022-12-01T20:57:46,Sopela,expenses,transport,-56.44,-9665.01
buyer_8,Antonio,,ES08209544318428491961,TRX_N-00371-60991138,2022-12-03T10:07:03,Labastida,expenses,transport,-45.3,-9710.31
buyer_8,Antonio,,ES08209544318428491961,TRX_N-00372-22610339,2022-12-03T17:33:15,Labastida,expenses,leisure,-72.89,-9783.2
buyer_8,Antonio,,ES08209544318428491961,TRX_N-00373-02237958,2022-12-04T22:21:28,Labastida,expenses,mortgage,-1053.21,-10836.41
buyer_8,Antonio,,ES08209544318428491961,TRX_N-00374-79183601,2022-12-04T14:34:41,Erandio,expenses,food,-65.56,-10901.97
buyer_8,Antonio,,ES08209544318428491961,TRX_N-00375-70368330,2022-12-04T10:01:14,Santurtzi,expenses,clothing,-83.93,-10985.9
buyer_8,Antonio,,ES08209544318428491961,TRX_N-00376-88290463,2022-12-04T09:21:43,Labastida,expenses,education,-54.1,-11040.0
buyer_8,Antonio,,ES08209544318428491961,TRX_N-00377-15574017,2022-12-05T20:11:29,Labastida,expenses,gas,-93.67,-11133.67
buyer_8,Antonio,,ES08209544318428491961,TRX_N-00378-80565021,2022-12-05T22:15:44,Labastida,expenses,cash,-100.0,-11233.67
buyer_8,Antonio,,ES08209544318428491961,TRX_N-00379-05335791,2022-12-06T08:17:27,Labastida,expenses,water,-43.23,-11276.9
buyer_8,Antonio,,ES08209544318428491961,TRX_N-00380-81802239,2022-12-06T15:41:50,Labastida,expenses,internet,-42.0,-11318.9
buyer_8,Antonio,,ES08209544318428491961,TRX_N-00381-62771854,2022-12-06T16:35:27,Labastida,expenses,food,-62.79,-11381.69
buyer_8,Antonio,,ES08209544318428491961,TRX_N-00382-44901418,2022-12-07T16:24:17,Getxo,expenses,education,-50.83,-11432.52
buyer_8,Antonio,,ES08209544318428491961,TRX_N-00383-73840223,2022-12-07T09:05:48,Labastida,expenses,gifts,-270.95,-11703.47
buyer_8,Antonio,,ES08209544318428491961,TRX_N-00384-57653586,2022-12-08T20:40:19,Labastida,expenses,electricity,-81.14,-11784.61
buyer_8,Antonio,,ES08209544318428491961,TRX_N-00385-28928449,2022-12-08T08:07:44,Labastida,expenses,phone,-32.04,-11816.65
buyer_8,Antonio,,ES08209544318428491961,TRX_N-00386-55841601,2022-12-08T19:00:39,Labastida,expenses,repairs,-332.83,-12149.48
buyer_8,Antonio,,ES08209544318428491961,TRX_N-00387-40738245,2022-12-09T19:16:07,Labastida,expenses,transport,-78.3,-12227.78
buyer_8,Antonio,,ES08209544318428491961,TRX_N-00388-83526636,2022-12-10T19:57:43,Labastida,expenses,food,-82.27,-12310.05
buyer_8,Antonio,,ES08209544318428491961,TRX_N-00389-20973886,2022-12-12T09:00:10,Labastida,expenses,food,-87.85,-12397.9
buyer_8,Antonio,,ES08209544318428491961,TRX_N-00390-81296394,2022-12-12T16:17:34,Labastida,expenses,leisure,-52.52,-12450.42
buyer_8,Antonio,,ES08209544318428491961,TRX_N-00391-19279335,2022-12-12T10:58:25,Labastida,expenses,cash,-100.0,-12550.42
buyer_8,Antonio,,ES08209544318428491961,TRX_N-00392-67214598,2022-12-13T08:44:50,Labastida,expenses,food,-112.06,-12662.48
buyer_8,Antonio,,ES08209544318428491961,TRX_N-00393-40829956,2022-12-15T16:52:13,Labastida,expenses,transport,-79.62,-12742.1
buyer_8,Antonio,,ES08209544318428491961,TRX_N-00394-53730741,2022-12-16T17:11:29,Labastida,expenses,food,-68.6,-12810.7
buyer_8,Antonio,,ES08209544318428491961,TRX_N-00395-67054687,2022-12-20T18:16:52,Labastida,expenses,cash,-100.0,-12910.7
buyer_8,Antonio,,ES08209544318428491961,TRX_N-00396-95533538,2022-12-21T09:04:43,Donostia,expenses,food,-84.65,-12995.35
buyer_8,Antonio,,ES08209544318428491961,TRX_N-00397-15665509,2022-12-21T13:08:08,Labastida,expenses,transport,-68.76,-13064.11
buyer_8,Antonio,,ES08209544318428491961,TRX_N-00398-29180999,2022-12-24T18:26:57,Labastida,expenses,food,-66.47,-13130.58
buyer_8,Antonio,,ES08209544318428491961,TRX_N-00399-37231619,2022-12-24T13:46:38,Labastida,expenses,transport,-57.07,-13187.65
buyer_8,Antonio,,ES08209544318428491961,TRX_N-00400-44109106,2022-12-27T08:08:25,Labastida,expenses,food,-123.32,-13310.97
buyer_8,Antonio,,ES08209544318428491961,TRX_N-00401-71307464,2022-12-30T15:17:40,Labastida,expenses,cash,-100.0,-13410.97
buyer_8,Antonio,,ES08209544318428491961,TRX_N-00402-51079468,2022-12-31T19:45:23,Alegría-Dulantzi,expenses,food,-68.55,-13479.52
buyer_8,Antonio,,ES08209544318428491961,TRX_N-00403-37481252,2022-12-31T10:32:14,Labastida,expenses,leisure,-24.15,-13503.67
buyer_8,Antonio,,ES08209544318428491961,TRX_N-00404-17480663,2022-12-31T18:10:26,Labastida,expenses,gifts,-50.57,-13554.24
buyer_8,Antonio,,ES08209544318428491961,TRX_N-00405-79232307,2023-01-01T19:33:46,Labastida,incomes,salary,3290.72,-10263.52
buyer_8,Antonio,,ES08209544318428491961,TRX_N-00406-57529241,2023-01-01T07:06:38,Hernani,expenses,cash,-100.0,-10363.52
buyer_8,Antonio,,ES08209544318428491961,TRX_N-00407-45702033,2023-01-02T17:55:09,Labastida,expenses,leisure,-21.48,-10385.0
buyer_8,Antonio,,ES08209544318428491961,TRX_N-00408-66889963,2023-01-04T13:23:27,Labastida,expenses,mortgage,-1053.21,-11438.21
buyer_8,Antonio,,ES08209544318428491961,TRX_N-00409-50975274,2023-01-05T12:22:22,Labastida,expenses,internet,-42.0,-11480.21
buyer_8,Antonio,,ES08209544318428491961,TRX_N-00410-54557044,2023-01-05T18:09:18,Labastida,expenses,phone,-41.57,-11521.78
buyer_8,Antonio,,ES08209544318428491961,TRX_N-00411-53478087,2023-01-06T17:04:46,Basauri,expenses,leisure,-21.12,-11542.9
buyer_8,Antonio,,ES08209544318428491961,TRX_N-00412-98626936,2023-01-06T13:01:36,Labastida,expenses,education,-68.39,-11611.29
buyer_8,Antonio,,ES08209544318428491961,TRX_N-00413-67223859,2023-01-07T15:39:37,Labastida,expenses,repairs,-149.01,-11760.3
buyer_8,Antonio,,ES08209544318428491961,TRX_N-00414-12210137,2023-01-08T10:11:40,Labastida,expenses,water,-33.66,-11793.96
buyer_8,Antonio,,ES08209544318428491961,TRX_N-00415-26422315,2023-01-08T11:36:34,Labastida,expenses,electricity,-79.71,-11873.67
buyer_8,Antonio,,ES08209544318428491961,TRX_N-00416-03332775,2023-01-08T14:33:43,Labastida,expenses,gas,-98.08,-11971.75
buyer_8,Antonio,,ES08209544318428491961,TRX_N-00417-11851596,2023-01-09T20:58:12,Salvatierra/Agurain,expenses,gifts,-781.74,-12753.49
buyer_8,Antonio,,ES08209544318428491961,TRX_N-00418-17554179,2023-01-12T12:07:51,Labastida,expenses,transport,-41.3,-12794.79
buyer_8,Antonio,,ES08209544318428491961,TRX_N-00419-22989529,2023-01-12T19:22:21,Andoain,expenses,repairs,-51.67,-12846.46
buyer_8,Antonio,,ES08209544318428491961,TRX_N-00420-85826095,2023-01-14T03:24:30,Labastida,expenses,food,-89.86,-12936.32
buyer_8,Antonio,,ES08209544318428491961,TRX_N-00421-55273719,2023-01-15T20:52:27,Labastida,expenses,leisure,-35.64,-12971.96
buyer_8,Antonio,,ES08209544318428491961,TRX_N-00422-45853156,2023-01-15T16:04:36,Labastida,expenses,clothing,-71.01,-13042.97
buyer_8,Antonio,,ES08209544318428491961,TRX_N-00423-82144283,2023-01-15T19:18:55,Labastida,expenses,education,-58.53,-13101.5
buyer_8,Antonio,,ES08209544318428491961,TRX_N-00424-41159243,2023-01-15T10:39:35,Labastida,expenses,repairs,-163.94,-13265.44
buyer_8,Antonio,,ES08209544318428491961,TRX_N-00425-36557149,2023-01-18T13:41:45,Labastida,expenses,transport,-77.51,-13342.95
buyer_8,Antonio,,ES08209544318428491961,TRX_N-00426-82253513,2023-01-19T08:51:28,Labastida,expenses,food,-118.18,-13461.13
buyer_8,Antonio,,ES08209544318428491961,TRX_N-00427-64079562,2023-01-20T17:47:58,Labastida,expenses,cash,-100.0,-13561.13
buyer_8,Antonio,,ES08209544318428491961,TRX_N-00428-82645847,2023-01-21T22:13:10,Labastida,expenses,leisure,-77.44,-13638.57
buyer_8,Antonio,,ES08209544318428491961,TRX_N-00429-85662338,2023-01-26T08:21:15,Labastida,expenses,education,-75.26,-13713.83
buyer_8,Antonio,,ES08209544318428491961,TRX_N-00430-07285760,2023-01-27T11:40:18,Labastida,expenses,leisure,-51.29,-13765.12
buyer_8,Antonio,,ES08209544318428491961,TRX_N-00431-20585850,2023-01-28T15:55:21,Labastida,expenses,food,-97.12,-13862.24
buyer_8,Antonio,,ES08209544318428491961,TRX_N-00432-73093760,2023-01-29T09:42:04,Labastida,expenses,appliances,-228.72,-14090.96
buyer_8,Antonio,,ES08209544318428491961,TRX_N-00433-56011300,2023-01-30T15:00:49,Labastida,expenses,food,-88.46,-14179.42
buyer_8,Antonio,,ES08209544318428491961,TRX_N-00434-16012408,2023-01-31T21:04:09,Labastida,expenses,education,-48.33,-14227.75
buyer_8,Antonio,,ES08209544318428491961,TRX_N-00435-77945314,2023-02-01T22:16:09,Labastida,incomes,salary,3290.72,-10937.03
buyer_8,Antonio,,ES08209544318428491961,TRX_N-00436-57185112,2023-02-01T22:16:09,Labastida,incomes,extra_income,377.3,-10559.73
buyer_8,Antonio,,ES08209544318428491961,TRX_N-00437-70489466,2023-02-01T20:28:05,Labastida,expenses,transport,-67.46,-10627.19
buyer_8,Antonio,,ES08209544318428491961,TRX_N-00438-83223725,2023-02-02T08:22:58,Labastida,expenses,food,-79.27,-10706.46
buyer_8,Antonio,,ES08209544318428491961,TRX_N-00439-59950038,2023-02-04T16:38:57,Labastida,expenses,mortgage,-1053.21,-11759.67
buyer_8,Antonio,,ES08209544318428491961,TRX_N-00440-98024839,2023-02-04T11:20:06,Labastida,expenses,leisure,-35.59,-11795.26
buyer_8,Antonio,,ES08209544318428491961,TRX_N-00441-90782266,2023-02-04T20:12:23,Labastida,expenses,cash,-100.0,-11895.26
buyer_8,Antonio,,ES08209544318428491961,TRX_N-00442-30963037,2023-02-05T03:08:58,Labastida,expenses,leisure,-47.32,-11942.58
buyer_8,Antonio,,ES08209544318428491961,TRX_N-00443-77487428,2023-02-06T17:54:14,Labastida,expenses,water,-33.46,-11976.04
buyer_8,Antonio,,ES08209544318428491961,TRX_N-00444-66626571,2023-02-06T17:39:26,Labastida,expenses,cash,-100.0,-12076.04
buyer_8,Antonio,,ES08209544318428491961,TRX_N-00445-72571168,2023-02-07T07:07:11,Labastida,expenses,electricity,-31.16,-12107.2
buyer_8,Antonio,,ES08209544318428491961,TRX_N-00446-42744437,2023-02-07T19:06:19,Labastida,expenses,internet,-42.0,-12149.2
buyer_8,Antonio,,ES08209544318428491961,TRX_N-00447-85050507,2023-02-07T01:03:28,Labastida,expenses,phone,-34.17,-12183.37
buyer_8,Antonio,,ES08209544318428491961,TRX_N-00448-69322647,2023-02-08T11:35:45,Labastida,expenses,gas,-65.34,-12248.71
buyer_8,Antonio,,ES08209544318428491961,TRX_N-00449-26434072,2023-02-08T14:35:38,Labastida,expenses,transport,-87.58,-12336.29
buyer_8,Antonio,,ES08209544318428491961,TRX_N-00450-07666143,2023-02-09T09:24:56,Labastida,expenses,cash,-100.0,-12436.29
buyer_8,Antonio,,ES08209544318428491961,TRX_N-00451-78332319,2023-02-11T21:13:34,Labastida,expenses,transport,-62.41,-12498.7
buyer_8,Antonio,,ES08209544318428491961,TRX_N-00452-63073807,2023-02-12T08:21:25,Labastida,expenses,education,-43.04,-12541.74
buyer_8,Antonio,,ES08209544318428491961,TRX_N-00453-88287916,2023-02-13T06:46:29,Labastida,expenses,repairs,-158.74,-12700.48
buyer_8,Antonio,,ES08209544318428491961,TRX_N-00454-98567901,2023-02-16T11:58:30,Labastida,expenses,cash,-100.0,-12800.48
buyer_8,Antonio,,ES08209544318428491961,TRX_N-00455-84749531,2023-02-18T03:27:25,Labastida,expenses,repairs,-124.66,-12925.14
buyer_8,Antonio,,ES08209544318428491961,TRX_N-00456-95067272,2023-02-19T20:53:28,Labastida,expenses,travel,-793.67,-13718.81
buyer_8,Antonio,,ES08209544318428491961,TRX_N-00457-05132793,2023-02-21T04:31:39,Labastida,expenses,car,-191.83,-13910.64
buyer_8,Antonio,,ES08209544318428491961,TRX_N-00458-71710735,2023-02-23T17:58:22,Salvatierra/Agurain,expenses,repairs,-101.23,-14011.87
buyer_8,Antonio,,ES08209544318428491961,TRX_N-00459-54031177,2023-02-23T11:17:28,Labastida,expenses,gifts,-482.27,-14494.14
buyer_8,Antonio,,ES08209544318428491961,TRX_N-00460-83490976,2023-02-24T12:14:17,Labastida,expenses,food,-84.35,-14578.49
buyer_8,Antonio,,ES08209544318428491961,TRX_N-00461-87936057,2023-02-26T11:10:39,Labastida,expenses,food,-63.69,-14642.18
buyer_8,Antonio,,ES08209544318428491961,TRX_N-00462-78315116,2023-02-26T08:32:37,Irun,expenses,leisure,-53.17,-14695.35
buyer_8,Antonio,,ES08209544318428491961,TRX_N-00463-03089445,2023-03-01T17:19:17,Labastida,incomes,salary,3290.72,-11404.63
buyer_8,Antonio,,ES08209544318428491961,TRX_N-00464-28841298,2023-03-01T13:34:17,Labastida,expenses,food,-110.39,-11515.02
buyer_8,Antonio,,ES08209544318428491961,TRX_N-00465-99205087,2023-03-02T16:43:25,Labastida,expenses,clothing,-62.49,-11577.51
buyer_8,Antonio,,ES08209544318428491961,TRX_N-00466-07552327,2023-03-02T17:44:31,Labastida,expenses,cash,-100.0,-11677.51
buyer_8,Antonio,,ES08209544318428491961,TRX_N-00467-47011480,2023-03-04T22:24:22,Labastida,expenses,mortgage,-1053.21,-12730.72
buyer_8,Antonio,,ES08209544318428491961,TRX_N-00468-07783326,2023-03-05T10:00:14,Labastida,expenses,internet,-42.0,-12772.72
buyer_8,Antonio,,ES08209544318428491961,TRX_N-00469-96850981,2023-03-05T13:38:35,Labastida,expenses,gifts,-697.61,-13470.33
buyer_8,Antonio,,ES08209544318428491961,TRX_N-00470-52946303,2023-03-06T15:19:27,Labastida,expenses,phone,-40.44,-13510.77
buyer_8,Antonio,,ES08209544318428491961,TRX_N-00471-91139455,2023-03-06T23:30:26,Labastida,expenses,cash,-100.0,-13610.77
buyer_8,Antonio,,ES08209544318428491961,TRX_N-00472-02766681,2023-03-07T08:03:06,Labastida,expenses,electricity,-76.47,-13687.24
buyer_8,Antonio,,ES08209544318428491961,TRX_N-00473-30197312,2023-03-07T20:24:30,Labastida,expenses,gas,-55.62,-13742.86
buyer_8,Antonio,,ES08209544318428491961,TRX_N-00474-30389401,2023-03-07T14:15:58,Labastida,expenses,cash,-100.0,-13842.86
buyer_8,Antonio,,ES08209544318428491961,TRX_N-00475-86600862,2023-03-08T14:17:10,Labastida,expenses,water,-39.57,-13882.43
buyer_8,Antonio,,ES08209544318428491961,TRX_N-00476-52587752,2023-03-09T11:00:22,Labastida,expenses,travel,-1059.84,-14942.27
buyer_8,Antonio,,ES08209544318428491961,TRX_N-00477-64921555,2023-03-10T08:14:40,Labastida,expenses,leisure,-61.81,-15004.08
buyer_8,Antonio,,ES08209544318428491961,TRX_N-00478-95233368,2023-03-10T08:24:36,Labastida,expenses,gifts,-632.54,-15636.62
buyer_8,Antonio,,ES08209544318428491961,TRX_N-00479-19127760,2023-03-11T17:42:05,Labastida,expenses,leisure,-66.44,-15703.06
buyer_8,Antonio,,ES08209544318428491961,TRX_N-00480-49850496,2023-03-12T14:00:28,Labastida,expenses,leisure,-37.45,-15740.51
buyer_8,Antonio,,ES08209544318428491961,TRX_N-00481-39845009,2023-03-14T22:59:02,Labastida,expenses,clothing,-149.53,-15890.04
buyer_8,Antonio,,ES08209544318428491961,TRX_N-00482-52886178,2023-03-15T15:06:30,Labastida,expenses,cash,-100.0,-15990.04
buyer_8,Antonio,,ES08209544318428491961,TRX_N-00483-10743020,2023-03-16T19:45:21,Elciego,expenses,food,-116.81,-16106.85
buyer_8,Antonio,,ES08209544318428491961,TRX_N-00484-67882648,2023-03-16T15:29:15,Labastida,expenses,transport,-80.19,-16187.04
buyer_8,Antonio,,ES08209544318428491961,TRX_N-00485-84401050,2023-03-18T08:41:07,Labastida,expenses,appliances,-388.81,-16575.85
buyer_8,Antonio,,ES08209544318428491961,TRX_N-00486-49929854,2023-03-22T22:09:37,Labastida,expenses,leisure,-53.74,-16629.59
buyer_8,Antonio,,ES08209544318428491961,TRX_N-00487-37192724,2023-03-23T08:00:52,Labastida,expenses,food,-76.6,-16706.19
buyer_8,Antonio,,ES08209544318428491961,TRX_N-00488-39545103,2023-03-23T15:18:53,Labastida,expenses,transport,-82.55,-16788.74
buyer_8,Antonio,,ES08209544318428491961,TRX_N-00489-78680214,2023-03-23T20:50:27,Oyón-Oion,expenses,clothing,-145.67,-16934.41
buyer_8,Antonio,,ES08209544318428491961,TRX_N-00490-35380132,2023-03-24T02:00:27,Labastida,expenses,food,-95.87,-17030.28
buyer_8,Antonio,,ES08209544318428491961,TRX_N-00491-78613181,2023-03-27T22:29:46,Irun,expenses,transport,-58.96,-17089.24
buyer_8,Antonio,,ES08209544318428491961,TRX_N-00492-78154473,2023-03-28T12:56:17,Labastida,expenses,leisure,-66.29,-17155.53
buyer_8,Antonio,,ES08209544318428491961,TRX_N-00493-70005226,2023-03-30T21:55:39,Labastida,expenses,food,-97.57,-17253.1
buyer_8,Antonio,,ES08209544318428491961,TRX_N-00494-75177009,2023-03-30T19:52:56,Labastida,expenses,cash,-100.0,-17353.1
buyer_8,Antonio,,ES08209544318428491961,TRX_N-00495-44537270,2023-03-31T05:36:38,Labastida,expenses,gifts,-94.46,-17447.56
buyer_8,Antonio,,ES08209544318428491961,TRX_N-00496-47391222,2023-04-01T14:31:07,Labastida,incomes,salary,3290.72,-14156.84
buyer_8,Antonio,,ES08209544318428491961,TRX_N-00497-99731341,2023-04-01T11:49:26,Labastida,expenses,repairs,-214.6,-14371.44
buyer_8,Antonio,,ES08209544318428491961,TRX_N-00498-85699490,2023-04-03T00:25:38,Labastida,expenses,cash,-100.0,-14471.44
buyer_8,Antonio,,ES08209544318428491961,TRX_N-00499-04826356,2023-04-04T02:46:30,Labastida,expenses,mortgage,-1053.21,-15524.65
buyer_8,Antonio,,ES08209544318428491961,TRX_N-00500-19036962,2023-04-04T21:02:48,Labastida,expenses,transport,-84.31,-15608.96
buyer_8,Antonio,,ES08209544318428491961,TRX_N-00501-99086495,2023-04-04T14:29:30,Labastida,expenses,cash,-100.0,-15708.96
buyer_8,Antonio,,ES08209544318428491961,TRX_N-00502-20115325,2023-04-05T18:36:48,Labastida,expenses,electricity,-63.69,-15772.65
buyer_8,Antonio,,ES08209544318428491961,TRX_N-00503-52864207,2023-04-06T20:51:33,Labastida,expenses,internet,-42.0,-15814.65
buyer_8,Antonio,,ES08209544318428491961,TRX_N-00504-70993984,2023-04-07T15:45:09,Labastida,expenses,gas,-81.44,-15896.09
buyer_8,Antonio,,ES08209544318428491961,TRX_N-00505-69449186,2023-04-07T20:52:55,Labastida,expenses,phone,-41.51,-15937.6
buyer_8,Antonio,,ES08209544318428491961,TRX_N-00506-58899862,2023-04-07T15:22:38,Amurrio,expenses,repairs,-118.89,-16056.49
buyer_8,Antonio,,ES08209544318428491961,TRX_N-00507-07771501,2023-04-08T10:20:07,Labastida,expenses,water,-37.85,-16094.34
buyer_8,Antonio,,ES08209544318428491961,TRX_N-00508-41824908,2023-04-08T12:14:06,Labastida,expenses,leisure,-22.09,-16116.43
buyer_8,Antonio,,ES08209544318428491961,TRX_N-00509-03075980,2023-04-08T15:04:53,Labastida,expenses,cash,-100.0,-16216.43
buyer_8,Antonio,,ES08209544318428491961,TRX_N-00510-72055808,2023-04-09T14:13:01,Labastida,expenses,food,-122.82,-16339.25
buyer_8,Antonio,,ES08209544318428491961,TRX_N-00511-18436776,2023-04-11T13:26:26,Labastida,expenses,education,-51.84,-16391.09
buyer_8,Antonio,,ES08209544318428491961,TRX_N-00512-45341409,2023-04-11T13:36:43,Labastida,expenses,repairs,-161.18,-16552.27
buyer_8,Antonio,,ES08209544318428491961,TRX_N-00513-62380181,2023-04-12T02:37:16,Labastida,expenses,food,-78.41,-16630.68
buyer_8,Antonio,,ES08209544318428491961,TRX_N-00514-16207950,2023-04-13T17:50:12,Labastida,expenses,cash,-100.0,-16730.68
buyer_8,Antonio,,ES08209544318428491961,TRX_N-00515-52461740,2023-04-14T07:31:28,Labastida,expenses,gifts,-363.82,-17094.5
buyer_8,Antonio,,ES08209544318428491961,TRX_N-00516-52570200,2023-04-15T19:00:31,Mungia,expenses,cash,-100.0,-17194.5
buyer_8,Antonio,,ES08209544318428491961,TRX_N-00517-42604175,2023-04-18T01:44:39,Labastida,expenses,food,-94.8,-17289.3
buyer_8,Antonio,,ES08209544318428491961,TRX_N-00518-25554249,2023-04-21T14:45:28,Labastida,expenses,healthcare,-146.18,-17435.48
buyer_8,Antonio,,ES08209544318428491961,TRX_N-00519-43017775,2023-04-22T10:59:02,Labastida,expenses,leisure,-39.15,-17474.63
buyer_8,Antonio,,ES08209544318428491961,TRX_N-00520-73485113,2023-04-24T16:52:05,Labastida,expenses,transport,-60.5,-17535.13
buyer_8,Antonio,,ES08209544318428491961,TRX_N-00521-67728574,2023-04-24T13:56:53,Labastida,expenses,clothing,-60.18,-17595.31
buyer_8,Antonio,,ES08209544318428491961,TRX_N-00522-77180290,2023-04-25T16:23:22,Labastida,expenses,leisure,-72.75,-17668.06
buyer_8,Antonio,,ES08209544318428491961,TRX_N-00523-19898541,2023-04-25T04:50:00,Labastida,expenses,cash,-100.0,-17768.06
buyer_8,Antonio,,ES08209544318428491961,TRX_N-00524-13384794,2023-04-26T11:48:56,Bilbao,expenses,transport,-83.12,-17851.18
buyer_8,Antonio,,ES08209544318428491961,TRX_N-00525-90041912,2023-04-26T11:57:15,Labastida,expenses,cash,-100.0,-17951.18
buyer_8,Antonio,,ES08209544318428491961,TRX_N-00526-85609121,2023-04-27T16:58:17,Labastida,expenses,food,-114.99,-18066.17
buyer_8,Antonio,,ES08209544318428491961,TRX_N-00527-65955012,2023-04-27T15:04:20,Andoain,expenses,healthcare,-69.41,-18135.58
buyer_8,Antonio,,ES08209544318428491961,TRX_N-00528-36761753,2023-05-01T16:42:10,Labastida,incomes,salary,3290.72,-14844.86
buyer_8,Antonio,,ES08209544318428491961,TRX_N-00529-42787310,2023-05-01T16:42:10,Labastida,incomes,extra_income,377.3,-14467.56
buyer_8,Antonio,,ES08209544318428491961,TRX_N-00530-57892110,2023-05-01T17:11:29,Labastida,expenses,transport,-42.64,-14510.2
buyer_8,Antonio,,ES08209544318428491961,TRX_N-00531-26225955,2023-05-01T18:39:44,Errenteria,expenses,repairs,-92.68,-14602.88
buyer_8,Antonio,,ES08209544318428491961,TRX_N-00532-70455941,2023-05-03T18:06:46,Durango,expenses,transport,-66.14,-14669.02
buyer_8,Antonio,,ES08209544318428491961,TRX_N-00533-20917008,2023-05-04T07:01:56,Labastida,expenses,mortgage,-1053.21,-15722.23
buyer_8,Antonio,,ES08209544318428491961,TRX_N-00534-33413050,2023-05-05T14:02:41,Labastida,expenses,electricity,-32.19,-15754.42
buyer_8,Antonio,,ES08209544318428491961,TRX_N-00535-17241119,2023-05-06T10:57:20,Labastida,expenses,phone,-36.99,-15791.41
buyer_8,Antonio,,ES08209544318428491961,TRX_N-00536-19480704,2023-05-06T19:41:12,Labastida,expenses,repairs,-297.13,-16088.54
buyer_8,Antonio,,ES08209544318428491961,TRX_N-00537-47171718,2023-05-07T17:55:38,Labastida,expenses,gas,-82.34,-16170.88
buyer_8,Antonio,,ES08209544318428491961,TRX_N-00538-35545955,2023-05-07T20:31:10,Labastida,expenses,internet,-42.0,-16212.88
buyer_8,Antonio,,ES08209544318428491961,TRX_N-00539-70540154,2023-05-07T17:27:21,Labastida,expenses,food,-93.93,-16306.81
buyer_8,Antonio,,ES08209544318428491961,TRX_N-00540-14036364,2023-05-07T17:33:04,Pasaia,expenses,leisure,-80.56,-16387.37
buyer_8,Antonio,,ES08209544318428491961,TRX_N-00541-98817253,2023-05-08T04:32:35,Labastida,expenses,water,-42.21,-16429.58
buyer_8,Antonio,,ES08209544318428491961,TRX_N-00542-23148954,2023-05-09T18:05:39,Arrasate,expenses,clothing,-140.15,-16569.73
buyer_8,Antonio,,ES08209544318428491961,TRX_N-00543-68646708,2023-05-12T20:53:44,Labastida,expenses,food,-94.39,-16664.12
buyer_8,Antonio,,ES08209544318428491961,TRX_N-00544-40491618,2023-05-12T18:43:05,Labastida,expenses,healthcare,-175.61,-16839.73
buyer_8,Antonio,,ES08209544318428491961,TRX_N-00545-29456476,2023-05-12T23:42:20,Labastida,expenses,cash,-100.0,-16939.73
buyer_8,Antonio,,ES08209544318428491961,TRX_N-00546-50992065,2023-05-15T15:25:21,Erandio,expenses,gifts,-307.95,-17247.68
buyer_8,Antonio,,ES08209544318428491961,TRX_N-00547-65263497,2023-05-16T12:12:47,Labastida,expenses,cash,-100.0,-17347.68
buyer_8,Antonio,,ES08209544318428491961,TRX_N-00548-83695753,2023-05-19T11:44:26,Labastida,expenses,food,-91.24,-17438.92
buyer_8,Antonio,,ES08209544318428491961,TRX_N-00549-90870623,2023-05-21T15:46:44,Barakaldo,expenses,food,-123.07,-17561.99
buyer_8,Antonio,,ES08209544318428491961,TRX_N-00550-65068205,2023-05-21T11:04:25,Labastida,expenses,gifts,-97.11,-17659.1
buyer_8,Antonio,,ES08209544318428491961,TRX_N-00551-00696316,2023-05-22T00:14:44,Santurtzi,expenses,leisure,-78.82,-17737.92
buyer_8,Antonio,,ES08209544318428491961,TRX_N-00552-21548914,2023-05-23T13:07:07,Sopela,expenses,gifts,-846.62,-18584.54
buyer_8,Antonio,,ES08209544318428491961,TRX_N-00553-86731840,2023-05-26T10:53:32,Labastida,expenses,gifts,-495.15,-19079.69
buyer_8,Antonio,,ES08209544318428491961,TRX_N-00554-14720340,2023-05-29T03:41:44,Labastida,expenses,repairs,-177.47,-19257.16
buyer_8,Antonio,,ES08209544318428491961,TRX_N-00555-60166557,2023-05-30T13:05:18,Labastida,expenses,food,-120.88,-19378.04
buyer_8,Antonio,,ES08209544318428491961,TRX_N-00556-97639230,2023-05-30T18:18:41,Labastida,expenses,leisure,-76.22,-19454.26
buyer_8,Antonio,,ES08209544318428491961,TRX_N-00557-26717001,2023-05-30T14:07:10,Labastida,expenses,cash,-100.0,-19554.26
buyer_8,Antonio,,ES08209544318428491961,TRX_N-00558-31044802,2023-05-31T14:50:59,Pasaia,expenses,repairs,-184.7,-19738.96
buyer_8,Antonio,,ES08209544318428491961,TRX_N-00559-82102062,2023-06-01T19:36:57,Labastida,incomes,salary,3290.72,-16448.24
buyer_8,Antonio,,ES08209544318428491961,TRX_N-00560-63053831,2023-06-01T19:36:57,Labastida,incomes,salary_bonus,2581.81,-13866.43
buyer_8,Antonio,,ES08209544318428491961,TRX_N-00561-62575517,2023-06-02T03:09:41,Labastida,expenses,clothing,-100.4,-13966.83
buyer_8,Antonio,,ES08209544318428491961,TRX_N-00562-60371689,2023-06-03T20:10:15,Labastida,expenses,gifts,-420.67,-14387.5
buyer_8,Antonio,,ES08209544318428491961,TRX_N-00563-92950617,2023-06-04T14:04:46,Labastida,expenses,mortgage,-1053.21,-15440.71
buyer_8,Antonio,,ES08209544318428491961,TRX_N-00564-91649941,2023-06-05T20:55:05,Labastida,expenses,water,-36.29,-15477.0
buyer_8,Antonio,,ES08209544318428491961,TRX_N-00565-71593758,2023-06-05T14:39:58,Labastida,expenses,gas,-55.09,-15532.09
buyer_8,Antonio,,ES08209544318428491961,TRX_N-00566-21682063,2023-06-05T01:59:17,Labastida,expenses,internet,-42.0,-15574.09
buyer_8,Antonio,,ES08209544318428491961,TRX_N-00567-42870010,2023-06-06T16:07:19,Labastida,expenses,phone,-38.0,-15612.09
buyer_8,Antonio,,ES08209544318428491961,TRX_N-00568-55333369,2023-06-06T16:38:22,Santurtzi,expenses,food,-62.34,-15674.43
buyer_8,Antonio,,ES08209544318428491961,TRX_N-00569-37365606,2023-06-06T21:59:32,Labastida,expenses,leisure,-59.91,-15734.34
buyer_8,Antonio,,ES08209544318428491961,TRX_N-00570-60682904,2023-06-06T12:24:44,Labastida,expenses,cash,-100.0,-15834.34
buyer_8,Antonio,,ES08209544318428491961,TRX_N-00571-93509429,2023-06-07T08:29:07,Labastida,expenses,transport,-55.43,-15889.77
buyer_8,Antonio,,ES08209544318428491961,TRX_N-00572-08745478,2023-06-07T09:41:12,Labastida,expenses,cash,-100.0,-15989.77
buyer_8,Antonio,,ES08209544318428491961,TRX_N-00573-36285258,2023-06-08T03:36:06,Labastida,expenses,electricity,-69.65,-16059.42
buyer_8,Antonio,,ES08209544318428491961,TRX_N-00574-29762343,2023-06-09T20:07:51,Labastida,expenses,food,-101.61,-16161.03
buyer_8,Antonio,,ES08209544318428491961,TRX_N-00575-57289216,2023-06-11T16:47:05,Labastida,expenses,cash,-100.0,-16261.03
buyer_8,Antonio,,ES08209544318428491961,TRX_N-00576-55528462,2023-06-12T12:33:37,Labastida,expenses,cash,-100.0,-16361.03
buyer_8,Antonio,,ES08209544318428491961,TRX_N-00577-01182191,2023-06-14T16:00:58,Mungia,expenses,repairs,-196.87,-16557.9
buyer_8,Antonio,,ES08209544318428491961,TRX_N-00578-42324376,2023-06-17T09:00:50,Labastida,expenses,leisure,-35.73,-16593.63
buyer_8,Antonio,,ES08209544318428491961,TRX_N-00579-54854159,2023-06-17T18:10:49,Labastida,expenses,cash,-100.0,-16693.63
buyer_8,Antonio,,ES08209544318428491961,TRX_N-00580-48807903,2023-06-18T08:01:13,Labastida,expenses,transport,-71.51,-16765.14
buyer_8,Antonio,,ES08209544318428491961,TRX_N-00581-84906372,2023-06-19T21:05:20,Arrasate,expenses,clothing,-155.75,-16920.89
buyer_8,Antonio,,ES08209544318428491961,TRX_N-00582-79147139,2023-06-19T14:12:21,Labastida,expenses,cash,-100.0,-17020.89
buyer_8,Antonio,,ES08209544318428491961,TRX_N-00583-81237315,2023-06-19T04:55:05,Labastida,expenses,gifts,-33.77,-17054.66
buyer_8,Antonio,,ES08209544318428491961,TRX_N-00584-91014918,2023-06-20T09:19:40,Pasaia,expenses,food,-93.88,-17148.54
buyer_8,Antonio,,ES08209544318428491961,TRX_N-00585-17131854,2023-06-20T09:37:28,Labastida,expenses,gifts,-445.23,-17593.77
buyer_8,Antonio,,ES08209544318428491961,TRX_N-00586-08600943,2023-06-21T11:20:32,Labastida,expenses,food,-86.34,-17680.11
buyer_8,Antonio,,ES08209544318428491961,TRX_N-00587-02032973,2023-06-22T11:56:28,Labastida,expenses,cash,-100.0,-17780.11
buyer_8,Antonio,,ES08209544318428491961,TRX_N-00588-54548066,2023-06-23T04:51:35,Labastida,expenses,transport,-44.15,-17824.26
buyer_8,Antonio,,ES08209544318428491961,TRX_N-00589-81213477,2023-06-24T06:23:29,Labastida,expenses,gifts,-207.23,-18031.49
buyer_8,Antonio,,ES08209544318428491961,TRX_N-00590-82290204,2023-06-25T20:54:08,Errenteria,expenses,transport,-80.8,-18112.29
buyer_8,Antonio,,ES08209544318428491961,TRX_N-00591-20957359,2023-06-25T06:37:54,Labastida,expenses,healthcare,-41.24,-18153.53
buyer_8,Antonio,,ES08209544318428491961,TRX_N-00592-10332860,2023-06-25T15:41:16,Labastida,expenses,appliances,-284.78,-18438.31
buyer_8,Antonio,,ES08209544318428491961,TRX_N-00593-82314813,2023-06-26T23:42:49,Labastida,expenses,leisure,-31.86,-18470.17
buyer_8,Antonio,,ES08209544318428491961,TRX_N-00594-21791318,2023-06-28T20:03:03,Labastida,expenses,cash,-100.0,-18570.17
buyer_8,Antonio,,ES08209544318428491961,TRX_N-00595-57777900,2023-06-28T19:53:08,Labastida,expenses,gifts,-739.3,-19309.47
buyer_8,Antonio,,ES08209544318428491961,TRX_N-00596-27613966,2023-07-01T09:53:01,Labastida,incomes,salary,3290.72,-16018.75
buyer_8,Antonio,,ES08209544318428491961,TRX_N-00597-95766928,2023-07-02T08:18:02,Labastida,expenses,transport,-79.17,-16097.92
buyer_8,Antonio,,ES08209544318428491961,TRX_N-00598-68515508,2023-07-02T02:16:22,Labastida,expenses,clothing,-84.56,-16182.48
buyer_8,Antonio,,ES08209544318428491961,TRX_N-00599-68475754,2023-07-04T16:23:32,Labastida,expenses,mortgage,-1053.21,-17235.69
buyer_8,Antonio,,ES08209544318428491961,TRX_N-00600-82227061,2023-07-05T17:11:06,Labastida,expenses,water,-34.05,-17269.74
buyer_8,Antonio,,ES08209544318428491961,TRX_N-00601-41817520,2023-07-05T10:17:17,Labastida,expenses,electricity,-79.92,-17349.66
buyer_8,Antonio,,ES08209544318428491961,TRX_N-00602-03445140,2023-07-05T15:41:18,Labastida,expenses,phone,-34.34,-17384.0
buyer_8,Antonio,,ES08209544318428491961,TRX_N-00603-00243732,2023-07-05T17:01:39,Labastida,expenses,food,-80.79,-17464.79
buyer_8,Antonio,,ES08209544318428491961,TRX_N-00604-15406349,2023-07-07T17:26:00,Labastida,expenses,gas,-40.26,-17505.05
buyer_8,Antonio,,ES08209544318428491961,TRX_N-00605-67265954,2023-07-07T09:48:49,Labastida,expenses,internet,-42.0,-17547.05
buyer_8,Antonio,,ES08209544318428491961,TRX_N-00606-04796171,2023-07-07T12:57:39,Llodio,expenses,food,-86.22,-17633.27
buyer_8,Antonio,,ES08209544318428491961,TRX_N-00607-91315246,2023-07-08T14:01:06,Hondarribia,expenses,cash,-100.0,-17733.27
buyer_8,Antonio,,ES08209544318428491961,TRX_N-00608-27864130,2023-07-11T15:24:49,Labastida,expenses,cash,-100.0,-17833.27
buyer_8,Antonio,,ES08209544318428491961,TRX_N-00609-85008080,2023-07-12T22:22:53,Labastida,expenses,food,-113.86,-17947.13
buyer_8,Antonio,,ES08209544318428491961,TRX_N-00610-93647258,2023-07-16T19:18:23,Labastida,expenses,education,-57.45,-18004.58
buyer_8,Antonio,,ES08209544318428491961,TRX_N-00611-62340615,2023-07-18T14:08:06,Labastida,expenses,transport,-87.92,-18092.5
buyer_8,Antonio,,ES08209544318428491961,TRX_N-00612-75792901,2023-07-19T20:06:59,Labastida,expenses,transport,-74.63,-18167.13
buyer_8,Antonio,,ES08209544318428491961,TRX_N-00613-93121052,2023-07-20T17:14:15,Labastida,expenses,healthcare,-39.57,-18206.7
buyer_8,Antonio,,ES08209544318428491961,TRX_N-00614-23011981,2023-07-21T10:17:55,Vitoria-Gasteiz,expenses,food,-104.74,-18311.44
buyer_8,Antonio,,ES08209544318428491961,TRX_N-00615-28176652,2023-07-22T09:54:34,Labastida,expenses,appliances,-357.1,-18668.54
buyer_8,Antonio,,ES08209544318428491961,TRX_N-00616-92782188,2023-07-22T14:29:26,Labastida,expenses,gifts,-530.1,-19198.64
buyer_8,Antonio,,ES08209544318428491961,TRX_N-00617-55430286,2023-07-25T23:07:51,Labastida,expenses,transport,-75.17,-19273.81
buyer_8,Antonio,,ES08209544318428491961,TRX_N-00618-74992408,2023-07-26T05:38:39,Basauri,expenses,food,-111.77,-19385.58
buyer_8,Antonio,,ES08209544318428491961,TRX_N-00619-88309828,2023-07-27T18:17:01,Donostia,expenses,cash,-100.0,-19485.58
buyer_8,Antonio,,ES08209544318428491961,TRX_N-00620-58191596,2023-07-29T12:07:18,Labastida,expenses,food,-90.68,-19576.26
buyer_8,Antonio,,ES08209544318428491961,TRX_N-00621-85731587,2023-07-31T12:14:04,Labastida,expenses,healthcare,-75.12,-19651.38
buyer_8,Antonio,,ES08209544318428491961,TRX_N-00622-07118997,2023-08-01T14:41:20,Labastida,incomes,salary,3290.72,-16360.66
buyer_8,Antonio,,ES08209544318428491961,TRX_N-00623-70871595,2023-08-01T14:41:20,Labastida,incomes,extra_income,377.3,-15983.36
buyer_8,Antonio,,ES08209544318428491961,TRX_N-00624-64244633,2023-08-01T13:23:27,Labastida,expenses,leisure,-74.37,-16057.73
buyer_8,Antonio,,ES08209544318428491961,TRX_N-00625-84827120,2023-08-04T13:39:28,Labastida,expenses,mortgage,-1053.21,-17110.94
buyer_8,Antonio,,ES08209544318428491961,TRX_N-00626-64314956,2023-08-05T02:59:47,Labastida,expenses,electricity,-76.65,-17187.59
buyer_8,Antonio,,ES08209544318428491961,TRX_N-00627-83421321,2023-08-05T18:59:41,Labastida,expenses,transport,-55.4,-17242.99
buyer_8,Antonio,,ES08209544318428491961,TRX_N-00628-34794526,2023-08-05T09:46:12,Alegría-Dulantzi,expenses,repairs,-128.43,-17371.42
buyer_8,Antonio,,ES08209544318428491961,TRX_N-00629-29062296,2023-08-06T15:23:19,Labastida,expenses,cash,-100.0,-17471.42
buyer_8,Antonio,,ES08209544318428491961,TRX_N-00630-57639866,2023-08-08T00:38:42,Labastida,expenses,phone,-31.48,-17502.9
buyer_8,Antonio,,ES08209544318428491961,TRX_N-00631-63115220,2023-08-08T01:27:17,Labastida,expenses,water,-35.62,-17538.52
buyer_8,Antonio,,ES08209544318428491961,TRX_N-00632-44329179,2023-08-08T13:56:27,Labastida,expenses,gas,-82.26,-17620.78
buyer_8,Antonio,,ES08209544318428491961,TRX_N-00633-89226428,2023-08-08T22:20:58,Labastida,expenses,internet,-42.0,-17662.78
buyer_8,Antonio,,ES08209544318428491961,TRX_N-00634-51678151,2023-08-08T18:48:41,Amurrio,expenses,food,-79.66,-17742.44
buyer_8,Antonio,,ES08209544318428491961,TRX_N-00635-88926753,2023-08-08T12:30:38,Labastida,expenses,repairs,-291.67,-18034.11
buyer_8,Antonio,,ES08209544318428491961,TRX_N-00636-89037944,2023-08-09T15:51:31,Labastida,expenses,transport,-42.99,-18077.1
buyer_8,Antonio,,ES08209544318428491961,TRX_N-00637-32914634,2023-08-10T16:31:55,Labastida,expenses,food,-79.49,-18156.59
buyer_8,Antonio,,ES08209544318428491961,TRX_N-00638-18790280,2023-08-12T12:26:27,Labastida,expenses,education,-54.88,-18211.47
buyer_8,Antonio,,ES08209544318428491961,TRX_N-00639-51757309,2023-08-12T14:58:18,Errenteria,expenses,cash,-100.0,-18311.47
buyer_8,Antonio,,ES08209544318428491961,TRX_N-00640-96647612,2023-08-15T20:04:52,Labastida,expenses,transport,-73.27,-18384.74
buyer_8,Antonio,,ES08209544318428491961,TRX_N-00641-61474241,2023-08-15T13:27:35,Santurtzi,expenses,gifts,-278.49,-18663.23
buyer_8,Antonio,,ES08209544318428491961,TRX_N-00642-95559522,2023-08-16T22:35:04,Labastida,expenses,food,-75.39,-18738.62
buyer_8,Antonio,,ES08209544318428491961,TRX_N-00643-02468916,2023-08-16T17:05:37,Labastida,expenses,leisure,-39.89,-18778.51
buyer_8,Antonio,,ES08209544318428491961,TRX_N-00644-86479856,2023-08-16T08:05:08,Labastida,expenses,clothing,-66.96,-18845.47
buyer_8,Antonio,,ES08209544318428491961,TRX_N-00645-91895123,2023-08-17T18:45:41,Labastida,expenses,leisure,-54.98,-18900.45
buyer_8,Antonio,,ES08209544318428491961,TRX_N-00646-87354909,2023-08-18T21:38:54,Labastida,expenses,leisure,-21.29,-18921.74
buyer_8,Antonio,,ES08209544318428491961,TRX_N-00647-83713858,2023-08-19T13:27:47,Zarautz,expenses,transport,-71.71,-18993.45
buyer_8,Antonio,,ES08209544318428491961,TRX_N-00648-96232058,2023-08-20T10:04:01,Labastida,expenses,food,-124.45,-19117.9
buyer_8,Antonio,,ES08209544318428491961,TRX_N-00649-92253411,2023-08-20T12:33:26,Labastida,expenses,gifts,-662.97,-19780.87
buyer_8,Antonio,,ES08209544318428491961,TRX_N-00650-25048190,2023-08-21T19:29:07,Labastida,expenses,cash,-100.0,-19880.87
buyer_8,Antonio,,ES08209544318428491961,TRX_N-00651-17859404,2023-08-24T19:56:15,Labastida,expenses,education,-69.84,-19950.71
buyer_8,Antonio,,ES08209544318428491961,TRX_N-00652-71467079,2023-08-25T14:11:55,Hondarribia,expenses,gifts,-348.27,-20298.98
buyer_8,Antonio,,ES08209544318428491961,TRX_N-00653-99747073,2023-08-26T20:12:51,Labastida,expenses,clothing,-110.54,-20409.52
buyer_8,Antonio,,ES08209544318428491961,TRX_N-00654-12707742,2023-08-26T11:52:16,Leioa,expenses,cash,-100.0,-20509.52
buyer_8,Antonio,,ES08209544318428491961,TRX_N-00655-62963587,2023-08-28T08:09:57,Labastida,expenses,transport,-83.66,-20593.18
buyer_8,Antonio,,ES08209544318428491961,TRX_N-00656-23948408,2023-08-29T19:16:29,Labastida,expenses,leisure,-77.66,-20670.84
buyer_8,Antonio,,ES08209544318428491961,TRX_N-00657-73496516,2023-08-30T13:01:00,Sestao,expenses,cash,-100.0,-20770.84
buyer_8,Antonio,,ES08209544318428491961,TRX_N-00658-51493526,2023-08-31T08:08:56,Labastida,expenses,cash,-100.0,-20870.84
buyer_8,Antonio,,ES08209544318428491961,TRX_N-00659-87283342,2023-09-01T17:08:10,Labastida,incomes,salary,3290.72,-17580.12
buyer_8,Antonio,,ES08209544318428491961,TRX_N-00660-25527997,2023-09-01T16:10:07,Labastida,expenses,cash,-100.0,-17680.12
buyer_8,Antonio,,ES08209544318428491961,TRX_N-00661-36727613,2023-09-01T17:36:37,Labastida,expenses,gifts,-359.85,-18039.97
buyer_8,Antonio,,ES08209544318428491961,TRX_N-00662-05777789,2023-09-03T15:30:28,Alegría-Dulantzi,expenses,education,-70.68,-18110.65
buyer_8,Antonio,,ES08209544318428491961,TRX_N-00663-14752608,2023-09-04T12:13:54,Labastida,expenses,mortgage,-1053.21,-19163.86
buyer_8,Antonio,,ES08209544318428491961,TRX_N-00664-29151955,2023-09-05T13:44:46,Labastida,expenses,water,-28.31,-19192.17
buyer_8,Antonio,,ES08209544318428491961,TRX_N-00665-48355839,2023-09-05T17:24:19,Labastida,expenses,electricity,-55.54,-19247.71
buyer_8,Antonio,,ES08209544318428491961,TRX_N-00666-73411211,2023-09-05T09:46:20,Labastida,expenses,phone,-40.91,-19288.62
buyer_8,Antonio,,ES08209544318428491961,TRX_N-00667-71043226,2023-09-05T15:54:21,Labastida,expenses,food,-107.51,-19396.13
buyer_8,Antonio,,ES08209544318428491961,TRX_N-00668-73690126,2023-09-06T08:10:40,Labastida,expenses,internet,-42.0,-19438.13
buyer_8,Antonio,,ES08209544318428491961,TRX_N-00669-86233938,2023-09-07T15:46:08,Hernani,expenses,food,-68.08,-19506.21
buyer_8,Antonio,,ES08209544318428491961,TRX_N-00670-33556947,2023-09-08T17:46:20,Labastida,expenses,gas,-60.64,-19566.85
buyer_8,Antonio,,ES08209544318428491961,TRX_N-00671-86314725,2023-09-08T18:20:28,Labastida,expenses,education,-53.98,-19620.83
buyer_8,Antonio,,ES08209544318428491961,TRX_N-00672-87707395,2023-09-10T09:36:33,Erandio,expenses,healthcare,-133.41,-19754.24
buyer_8,Antonio,,ES08209544318428491961,TRX_N-00673-14193160,2023-09-11T19:40:31,Labastida,expenses,gifts,-785.79,-20540.03
buyer_8,Antonio,,ES08209544318428491961,TRX_N-00674-43954147,2023-09-14T23:34:48,Labastida,expenses,food,-112.35,-20652.38
buyer_8,Antonio,,ES08209544318428491961,TRX_N-00675-17799126,2023-09-14T16:40:12,Labastida,expenses,transport,-55.49,-20707.87
buyer_8,Antonio,,ES08209544318428491961,TRX_N-00676-22998487,2023-09-14T07:14:18,Labastida,expenses,appliances,-261.05,-20968.92
buyer_8,Antonio,,ES08209544318428491961,TRX_N-00677-98428473,2023-09-15T11:15:50,Labastida,expenses,food,-74.97,-21043.89
buyer_8,Antonio,,ES08209544318428491961,TRX_N-00678-09946750,2023-09-19T10:20:03,Labastida,expenses,leisure,-51.15,-21095.04
buyer_8,Antonio,,ES08209544318428491961,TRX_N-00679-73770023,2023-09-19T11:36:02,Labastida,expenses,cash,-100.0,-21195.04
buyer_8,Antonio,,ES08209544318428491961,TRX_N-00680-53948164,2023-09-20T19:00:47,Mungia,expenses,education,-53.95,-21248.99
buyer_8,Antonio,,ES08209544318428491961,TRX_N-00681-83382051,2023-09-21T12:20:53,Labastida,expenses,education,-65.88,-21314.87
buyer_8,Antonio,,ES08209544318428491961,TRX_N-00682-66225463,2023-09-22T14:28:44,Labastida,expenses,education,-66.56,-21381.43
buyer_8,Antonio,,ES08209544318428491961,TRX_N-00683-28507467,2023-09-24T11:27:00,Labastida,expenses,food,-97.24,-21478.67
buyer_8,Antonio,,ES08209544318428491961,TRX_N-00684-88930627,2023-09-26T19:43:43,Labastida,expenses,clothing,-158.16,-21636.83
buyer_8,Antonio,,ES08209544318428491961,TRX_N-00685-65583261,2023-09-26T16:18:47,Labastida,expenses,cash,-100.0,-21736.83
buyer_8,Antonio,,ES08209544318428491961,TRX_N-00686-26500798,2023-09-27T22:44:33,Labastida,expenses,clothing,-99.41,-21836.24
buyer_8,Antonio,,ES08209544318428491961,TRX_N-00687-31549168,2023-09-28T14:57:49,Labastida,expenses,clothing,-130.07,-21966.31
buyer_8,Antonio,,ES08209544318428491961,TRX_N-00688-20001573,2023-09-29T18:23:17,Labastida,expenses,cash,-100.0,-22066.31
buyer_8,Antonio,,ES08209544318428491961,TRX_N-00689-87273945,2023-09-30T15:02:26,Labastida,expenses,food,-81.52,-22147.83
buyer_8,Antonio,,ES08209544318428491961,TRX_N-00690-99399485,2023-10-01T12:59:49,Labastida,incomes,salary,3290.72,-18857.11
buyer_8,Antonio,,ES08209544318428491961,TRX_N-00691-42445091,2023-10-01T15:19:30,Labastida,expenses,food,-113.97,-18971.08
buyer_8,Antonio,,ES08209544318428491961,TRX_N-00692-68959957,2023-10-02T14:50:50,Labastida,expenses,food,-73.3,-19044.38
buyer_8,Antonio,,ES08209544318428491961,TRX_N-00693-35910312,2023-10-02T22:37:11,Labastida,expenses,leisure,-53.32,-19097.7
buyer_8,Antonio,,ES08209544318428491961,TRX_N-00694-48135563,2023-10-02T20:17:19,Labastida,expenses,cash,-100.0,-19197.7
buyer_8,Antonio,,ES08209544318428491961,TRX_N-00695-02328831,2023-10-03T08:55:16,Labastida,expenses,transport,-73.66,-19271.36
buyer_8,Antonio,,ES08209544318428491961,TRX_N-00696-82858211,2023-10-03T12:09:20,Labastida,expenses,gifts,-26.7,-19298.06
buyer_8,Antonio,,ES08209544318428491961,TRX_N-00697-62785233,2023-10-04T17:49:13,Labastida,expenses,mortgage,-1053.21,-20351.27
buyer_8,Antonio,,ES08209544318428491961,TRX_N-00698-56145922,2023-10-05T16:13:28,Labastida,expenses,leisure,-23.76,-20375.03
buyer_8,Antonio,,ES08209544318428491961,TRX_N-00699-37232026,2023-10-06T11:37:40,Labastida,expenses,electricity,-65.45,-20440.48
buyer_8,Antonio,,ES08209544318428491961,TRX_N-00700-14038371,2023-10-06T13:16:58,Labastida,expenses,food,-101.59,-20542.07
buyer_8,Antonio,,ES08209544318428491961,TRX_N-00701-52787461,2023-10-06T09:26:35,Galdakao,expenses,transport,-69.4,-20611.47
buyer_8,Antonio,,ES08209544318428491961,TRX_N-00702-85390235,2023-10-06T12:52:57,Labastida,expenses,cash,-100.0,-20711.47
buyer_8,Antonio,,ES08209544318428491961,TRX_N-00703-75156717,2023-10-06T08:25:02,Labastida,expenses,appliances,-376.75,-21088.22
buyer_8,Antonio,,ES08209544318428491961,TRX_N-00704-09156066,2023-10-07T09:37:29,Labastida,expenses,water,-40.41,-21128.63
buyer_8,Antonio,,ES08209544318428491961,TRX_N-00705-95265706,2023-10-08T12:05:10,Labastida,expenses,phone,-34.6,-21163.23
buyer_8,Antonio,,ES08209544318428491961,TRX_N-00706-74061041,2023-10-08T09:49:10,Labastida,expenses,gas,-108.36,-21271.59
buyer_8,Antonio,,ES08209544318428491961,TRX_N-00707-19936852,2023-10-08T09:05:51,Labastida,expenses,internet,-42.0,-21313.59
buyer_8,Antonio,,ES08209544318428491961,TRX_N-00708-01513936,2023-10-08T17:45:44,Labastida,expenses,food,-106.47,-21420.06
buyer_8,Antonio,,ES08209544318428491961,TRX_N-00709-16148083,2023-10-08T13:21:09,Labastida,expenses,clothing,-77.4,-21497.46
buyer_8,Antonio,,ES08209544318428491961,TRX_N-00710-61086364,2023-10-10T12:33:30,Labastida,expenses,cash,-100.0,-21597.46
buyer_8,Antonio,,ES08209544318428491961,TRX_N-00711-58236969,2023-10-11T18:41:34,Labastida,expenses,cash,-100.0,-21697.46
buyer_8,Antonio,,ES08209544318428491961,TRX_N-00712-94081966,2023-10-12T15:33:26,Labastida,expenses,food,-108.54,-21806.0
buyer_8,Antonio,,ES08209544318428491961,TRX_N-00713-26145062,2023-10-12T14:47:41,Labastida,expenses,transport,-54.46,-21860.46
buyer_8,Antonio,,ES08209544318428491961,TRX_N-00714-92040794,2023-10-13T13:04:07,Labastida,expenses,food,-79.58,-21940.04
buyer_8,Antonio,,ES08209544318428491961,TRX_N-00715-04509431,2023-10-14T20:10:43,Labastida,expenses,leisure,-18.91,-21958.95
buyer_8,Antonio,,ES08209544318428491961,TRX_N-00716-04929267,2023-10-14T13:12:48,Pasaia,expenses,clothing,-121.31,-22080.26
buyer_8,Antonio,,ES08209544318428491961,TRX_N-00717-31293310,2023-10-14T17:29:30,Labastida,expenses,cash,-100.0,-22180.26
buyer_8,Antonio,,ES08209544318428491961,TRX_N-00718-90308232,2023-10-15T17:41:51,Oyón-Oion,expenses,repairs,-55.72,-22235.98
buyer_8,Antonio,,ES08209544318428491961,TRX_N-00719-42525742,2023-10-19T13:00:17,Labastida,expenses,leisure,-40.05,-22276.03
buyer_8,Antonio,,ES08209544318428491961,TRX_N-00720-19535649,2023-10-21T16:49:29,Labastida,expenses,leisure,-43.44,-22319.47
buyer_8,Antonio,,ES08209544318428491961,TRX_N-00721-08597844,2023-10-21T09:18:35,Labastida,expenses,gifts,-461.25,-22780.72
buyer_8,Antonio,,ES08209544318428491961,TRX_N-00722-75980193,2023-10-23T23:54:22,Labastida,expenses,leisure,-32.31,-22813.03
buyer_8,Antonio,,ES08209544318428491961,TRX_N-00723-53867879,2023-10-23T13:01:49,Labastida,expenses,cash,-100.0,-22913.03
buyer_8,Antonio,,ES08209544318428491961,TRX_N-00724-02907718,2023-10-24T07:07:06,Iruña de Oca,expenses,food,-84.35,-22997.38
buyer_8,Antonio,,ES08209544318428491961,TRX_N-00725-05317302,2023-10-24T16:33:59,Labastida,expenses,gifts,-350.72,-23348.1
buyer_8,Antonio,,ES08209544318428491961,TRX_N-00726-43032495,2023-10-25T16:09:57,Labastida,expenses,leisure,-23.96,-23372.06
buyer_8,Antonio,,ES08209544318428491961,TRX_N-00727-48938307,2023-10-26T11:00:25,Labastida,expenses,food,-91.31,-23463.37
buyer_8,Antonio,,ES08209544318428491961,TRX_N-00728-19311712,2023-10-26T15:35:48,Labastida,expenses,transport,-64.62,-23527.99
buyer_8,Antonio,,ES08209544318428491961,TRX_N-00729-41327941,2023-10-27T11:23:22,Labastida,expenses,appliances,-118.68,-23646.67
buyer_8,Antonio,,ES08209544318428491961,TRX_N-00730-13434434,2023-10-28T13:25:49,Labastida,expenses,food,-109.98,-23756.65
buyer_8,Antonio,,ES08209544318428491961,TRX_N-00731-81418716,2023-10-30T13:16:16,Labastida,expenses,education,-60.37,-23817.02
buyer_8,Antonio,,ES08209544318428491961,TRX_N-00732-71135543,2023-10-30T14:10:50,Labastida,expenses,gifts,-374.39,-24191.41
buyer_8,Antonio,,ES08209544318428491961,TRX_N-00733-45415334,2023-10-31T21:07:20,Labastida,expenses,education,-75.14,-24266.55
buyer_8,Antonio,,ES08209544318428491961,TRX_N-00734-17719497,2023-11-01T11:36:56,Labastida,incomes,salary,3290.72,-20975.83
buyer_8,Antonio,,ES08209544318428491961,TRX_N-00735-65334507,2023-11-01T13:10:28,Labastida,expenses,cash,-100.0,-21075.83
buyer_8,Antonio,,ES08209544318428491961,TRX_N-00736-73312458,2023-11-02T23:18:45,Labastida,expenses,food,-80.79,-21156.62
buyer_8,Antonio,,ES08209544318428491961,TRX_N-00737-35590907,2023-11-03T14:39:28,Labastida,expenses,cash,-100.0,-21256.62
buyer_8,Antonio,,ES08209544318428491961,TRX_N-00738-56269171,2023-11-03T13:50:32,Labastida,expenses,repairs,-246.38,-21503.0
buyer_8,Antonio,,ES08209544318428491961,TRX_N-00739-42287057,2023-11-04T05:19:22,Labastida,expenses,mortgage,-1053.21,-22556.21
buyer_8,Antonio,,ES08209544318428491961,TRX_N-00740-86268119,2023-11-04T08:43:56,Labastida,expenses,appliances,-408.08,-22964.29
buyer_8,Antonio,,ES08209544318428491961,TRX_N-00741-36971628,2023-11-05T10:35:00,Labastida,expenses,electricity,-26.28,-22990.57
buyer_8,Antonio,,ES08209544318428491961,TRX_N-00742-74066447,2023-11-05T16:37:17,Labastida,expenses,phone,-31.33,-23021.9
buyer_8,Antonio,,ES08209544318428491961,TRX_N-00743-75788165,2023-11-05T08:40:40,Labastida,expenses,cash,-100.0,-23121.9
buyer_8,Antonio,,ES08209544318428491961,TRX_N-00744-78706997,2023-11-06T08:32:19,Labastida,expenses,internet,-42.0,-23163.9
buyer_8,Antonio,,ES08209544318428491961,TRX_N-00745-71896004,2023-11-06T08:06:22,Labastida,expenses,repairs,-295.5,-23459.4
buyer_8,Antonio,,ES08209544318428491961,TRX_N-00746-40612920,2023-11-07T11:06:26,Labastida,expenses,gas,-42.87,-23502.27
buyer_8,Antonio,,ES08209544318428491961,TRX_N-00747-19380200,2023-11-07T12:24:45,Labastida,expenses,transport,-52.49,-23554.76
buyer_8,Antonio,,ES08209544318428491961,TRX_N-00748-91911948,2023-11-07T13:15:13,Labastida,expenses,cash,-100.0,-23654.76
buyer_8,Antonio,,ES08209544318428491961,TRX_N-00749-09763957,2023-11-08T14:12:34,Labastida,expenses,water,-22.61,-23677.37
buyer_8,Antonio,,ES08209544318428491961,TRX_N-00750-20513139,2023-11-08T15:58:08,Galdakao,expenses,cash,-100.0,-23777.37
buyer_8,Antonio,,ES08209544318428491961,TRX_N-00751-34319415,2023-11-11T20:38:22,Eibar,expenses,repairs,-322.21,-24099.58
buyer_8,Antonio,,ES08209544318428491961,TRX_N-00752-78706985,2023-11-12T08:35:47,Oyón-Oion,expenses,leisure,-73.51,-24173.09
buyer_8,Antonio,,ES08209544318428491961,TRX_N-00753-06828240,2023-11-12T18:16:51,Labastida,expenses,cash,-100.0,-24273.09
buyer_8,Antonio,,ES08209544318428491961,TRX_N-00754-66826029,2023-11-13T14:07:59,Hondarribia,expenses,repairs,-149.79,-24422.88
buyer_8,Antonio,,ES08209544318428491961,TRX_N-00755-97008830,2023-11-15T08:40:40,Sopela,expenses,food,-90.3,-24513.18
buyer_8,Antonio,,ES08209544318428491961,TRX_N-00756-18741751,2023-11-15T04:38:06,Sestao,expenses,leisure,-23.07,-24536.25
buyer_8,Antonio,,ES08209544318428491961,TRX_N-00757-95803645,2023-11-15T05:37:21,Labastida,expenses,cash,-100.0,-24636.25
buyer_8,Antonio,,ES08209544318428491961,TRX_N-00758-45712647,2023-11-15T21:23:11,Labastida,expenses,appliances,-88.54,-24724.79
buyer_8,Antonio,,ES08209544318428491961,TRX_N-00759-36481975,2023-11-16T16:07:31,Berango,expenses,cash,-100.0,-24824.79
buyer_8,Antonio,,ES08209544318428491961,TRX_N-00760-97629061,2023-11-17T09:57:56,Labastida,expenses,repairs,-185.26,-25010.05
buyer_8,Antonio,,ES08209544318428491961,TRX_N-00761-24500350,2023-11-18T15:45:09,Labastida,expenses,cash,-100.0,-25110.05
buyer_8,Antonio,,ES08209544318428491961,TRX_N-00762-89775509,2023-11-18T09:05:51,Labastida,expenses,repairs,-240.97,-25351.02
buyer_8,Antonio,,ES08209544318428491961,TRX_N-00763-78558224,2023-11-19T17:03:33,Labastida,expenses,cash,-100.0,-25451.02
buyer_8,Antonio,,ES08209544318428491961,TRX_N-00764-91221664,2023-11-19T02:47:59,Labastida,expenses,gifts,-105.88,-25556.9
buyer_8,Antonio,,ES08209544318428491961,TRX_N-00765-01090460,2023-11-20T16:35:18,Labastida,expenses,cash,-100.0,-25656.9
buyer_8,Antonio,,ES08209544318428491961,TRX_N-00766-77413053,2023-11-22T11:00:21,Labastida,expenses,cash,-100.0,-25756.9
buyer_8,Antonio,,ES08209544318428491961,TRX_N-00767-12961422,2023-11-24T22:58:31,Labastida,expenses,food,-80.42,-25837.32
buyer_8,Antonio,,ES08209544318428491961,TRX_N-00768-40576965,2023-11-25T20:20:21,Labastida,expenses,food,-105.92,-25943.24
buyer_8,Antonio,,ES08209544318428491961,TRX_N-00769-09272717,2023-11-25T22:44:27,Labastida,expenses,gifts,-532.11,-26475.35
buyer_8,Antonio,,ES08209544318428491961,TRX_N-00770-51648234,2023-11-26T19:23:37,Labastida,expenses,healthcare,-176.56,-26651.91
buyer_8,Antonio,,ES08209544318428491961,TRX_N-00771-61789448,2023-11-27T12:18:29,Labastida,expenses,appliances,-298.86,-26950.77
buyer_8,Antonio,,ES08209544318428491961,TRX_N-00772-47159425,2023-11-27T11:15:31,Basauri,expenses,gifts,-379.67,-27330.44
buyer_8,Antonio,,ES08209544318428491961,TRX_N-00773-84064818,2023-11-28T22:15:24,Labastida,expenses,repairs,-187.17,-27517.61
buyer_8,Antonio,,ES08209544318428491961,TRX_N-00774-27702502,2023-11-29T14:06:14,Labastida,expenses,food,-122.9,-27640.51
buyer_8,Antonio,,ES08209544318428491961,TRX_N-00775-26144280,2023-11-29T19:48:54,Labastida,expenses,leisure,-53.5,-27694.01
buyer_8,Antonio,,ES08209544318428491961,TRX_N-00776-96513124,2023-11-30T05:30:10,Labastida,expenses,education,-56.33,-27750.34
buyer_8,Antonio,,ES08209544318428491961,TRX_N-00777-51712482,2023-12-01T18:02:12,Labastida,incomes,salary,3290.72,-24459.62
buyer_8,Antonio,,ES08209544318428491961,TRX_N-00778-88263846,2023-12-01T18:02:12,Labastida,incomes,extra_income,377.3,-24082.32
buyer_8,Antonio,,ES08209544318428491961,TRX_N-00779-29759404,2023-12-01T18:02:12,Labastida,incomes,salary_bonus,2497.31,-21585.01
buyer_8,Antonio,,ES08209544318428491961,TRX_N-00780-27433269,2023-12-01T03:10:55,Labastida,expenses,cash,-100.0,-21685.01
buyer_8,Antonio,,ES08209544318428491961,TRX_N-00781-63461030,2023-12-02T08:13:08,Labastida,expenses,food,-92.46,-21777.47
buyer_8,Antonio,,ES08209544318428491961,TRX_N-00782-94995034,2023-12-02T23:09:23,Labastida,expenses,repairs,-96.56,-21874.03
buyer_8,Antonio,,ES08209544318428491961,TRX_N-00783-07925283,2023-12-04T18:00:52,Labastida,expenses,mortgage,-1053.21,-22927.24
buyer_8,Antonio,,ES08209544318428491961,TRX_N-00784-87035400,2023-12-05T21:15:24,Labastida,expenses,phone,-32.62,-22959.86
buyer_8,Antonio,,ES08209544318428491961,TRX_N-00785-31066241,2023-12-05T18:05:59,Labastida,expenses,leisure,-74.79,-23034.65
buyer_8,Antonio,,ES08209544318428491961,TRX_N-00786-18704239,2023-12-06T10:24:05,Labastida,expenses,electricity,-56.47,-23091.12
buyer_8,Antonio,,ES08209544318428491961,TRX_N-00787-43526475,2023-12-07T18:10:56,Labastida,expenses,internet,-42.0,-23133.12
buyer_8,Antonio,,ES08209544318428491961,TRX_N-00788-76024862,2023-12-07T16:54:16,Labastida,expenses,food,-111.83,-23244.95
buyer_8,Antonio,,ES08209544318428491961,TRX_N-00789-88081870,2023-12-07T11:54:24,Donostia,expenses,repairs,-256.11,-23501.06
buyer_8,Antonio,,ES08209544318428491961,TRX_N-00790-32798358,2023-12-08T11:32:10,Labastida,expenses,water,-25.97,-23527.03
buyer_8,Antonio,,ES08209544318428491961,TRX_N-00791-99248950,2023-12-08T11:58:10,Labastida,expenses,gas,-47.36,-23574.39
buyer_8,Antonio,,ES08209544318428491961,TRX_N-00792-42252557,2023-12-08T12:51:35,Labastida,expenses,food,-65.54,-23639.93
buyer_8,Antonio,,ES08209544318428491961,TRX_N-00793-59178766,2023-12-09T16:43:39,Labastida,expenses,transport,-86.92,-23726.85
buyer_8,Antonio,,ES08209544318428491961,TRX_N-00794-78024939,2023-12-09T19:19:29,Labastida,expenses,cash,-100.0,-23826.85
buyer_8,Antonio,,ES08209544318428491961,TRX_N-00795-96608038,2023-12-09T21:31:05,Labastida,expenses,gifts,-459.08,-24285.93
buyer_8,Antonio,,ES08209544318428491961,TRX_N-00796-10005138,2023-12-10T00:57:48,Barakaldo,expenses,food,-115.75,-24401.68
buyer_8,Antonio,,ES08209544318428491961,TRX_N-00797-67235322,2023-12-12T10:32:33,Labastida,expenses,cash,-100.0,-24501.68
buyer_8,Antonio,,ES08209544318428491961,TRX_N-00798-33752445,2023-12-12T13:02:57,Labastida,expenses,gifts,-801.39,-25303.07
buyer_8,Antonio,,ES08209544318428491961,TRX_N-00799-18368350,2023-12-14T03:34:36,Labastida,expenses,leisure,-43.92,-25346.99
buyer_8,Antonio,,ES08209544318428491961,TRX_N-00800-89582434,2023-12-17T08:35:16,Andoain,expenses,leisure,-26.61,-25373.6
buyer_8,Antonio,,ES08209544318428491961,TRX_N-00801-16029038,2023-12-19T02:52:36,Labastida,expenses,repairs,-60.77,-25434.37
buyer_8,Antonio,,ES08209544318428491961,TRX_N-00802-83091829,2023-12-20T14:51:33,Labastida,expenses,cash,-100.0,-25534.37
buyer_8,Antonio,,ES08209544318428491961,TRX_N-00803-04394571,2023-12-21T12:31:09,Labastida,expenses,healthcare,-51.55,-25585.92
buyer_8,Antonio,,ES08209544318428491961,TRX_N-00804-53007200,2023-12-21T13:27:10,Leioa,expenses,cash,-100.0,-25685.92
buyer_8,Antonio,,ES08209544318428491961,TRX_N-00805-78735337,2023-12-23T17:54:30,Oyón-Oion,expenses,food,-101.74,-25787.66
buyer_8,Antonio,,ES08209544318428491961,TRX_N-00806-41374274,2023-12-23T20:01:23,Labastida,expenses,repairs,-95.04,-25882.7
buyer_8,Antonio,,ES08209544318428491961,TRX_N-00807-12909628,2023-12-24T08:03:03,Labastida,expenses,transport,-56.28,-25938.98
buyer_8,Antonio,,ES08209544318428491961,TRX_N-00808-32965845,2023-12-24T20:19:46,Labastida,expenses,cash,-100.0,-26038.98
buyer_8,Antonio,,ES08209544318428491961,TRX_N-00809-45028861,2023-12-26T20:00:12,Labastida,expenses,education,-47.18,-26086.16
buyer_8,Antonio,,ES08209544318428491961,TRX_N-00810-34294937,2023-12-27T11:43:47,Labastida,expenses,leisure,-38.69,-26124.85
buyer_8,Antonio,,ES08209544318428491961,TRX_N-00811-89980844,2023-12-28T21:44:26,Labastida,expenses,healthcare,-179.12,-26303.97
buyer_8,Antonio,,ES08209544318428491961,TRX_N-00812-45599680,2023-12-30T11:43:46,Labastida,expenses,food,-74.41,-26378.38
buyer_8,Antonio,,ES08209544318428491961,TRX_N-00813-91152185,2023-12-30T19:46:11,Labastida,expenses,leisure,-21.18,-26399.56
buyer_8,Antonio,,ES08209544318428491961,TRX_N-00814-25236297,2023-12-31T11:23:04,Labastida,expenses,food,-105.34,-26504.9
buyer_8,Antonio,,ES08209544318428491961,TRX_N-00815-57312346,2023-12-31T15:26:30,Labastida,expenses,transport,-42.09,-26546.99
buyer_8,Antonio,,ES08209544318428491961,TRX_N-00816-19492770,2024-01-01T18:47:05,Labastida,incomes,salary,3415.92,-23131.07
buyer_8,Antonio,,ES08209544318428491961,TRX_N-00817-50175634,2024-01-02T10:23:15,Labastida,expenses,food,-60.53,-23191.6
buyer_8,Antonio,,ES08209544318428491961,TRX_N-00818-75514778,2024-01-03T11:02:11,Labastida,expenses,cash,-100.0,-23291.6
buyer_8,Antonio,,ES08209544318428491961,TRX_N-00819-06462678,2024-01-04T23:18:12,Labastida,expenses,mortgage,-1053.21,-24344.81
buyer_8,Antonio,,ES08209544318428491961,TRX_N-00820-84450481,2024-01-06T22:11:53,Labastida,expenses,phone,-33.67,-24378.48
buyer_8,Antonio,,ES08209544318428491961,TRX_N-00821-05569628,2024-01-06T22:20:09,Labastida,expenses,leisure,-20.77,-24399.25
buyer_8,Antonio,,ES08209544318428491961,TRX_N-00822-83410752,2024-01-07T18:42:16,Labastida,expenses,gas,-41.61,-24440.86
buyer_8,Antonio,,ES08209544318428491961,TRX_N-00823-94317052,2024-01-08T16:07:54,Labastida,expenses,water,-43.88,-24484.74
buyer_8,Antonio,,ES08209544318428491961,TRX_N-00824-27549480,2024-01-08T17:59:05,Labastida,expenses,electricity,-37.84,-24522.58
buyer_8,Antonio,,ES08209544318428491961,TRX_N-00825-99860383,2024-01-08T10:09:42,Labastida,expenses,internet,-42.0,-24564.58
buyer_8,Antonio,,ES08209544318428491961,TRX_N-00826-08975448,2024-01-09T17:22:45,Labastida,expenses,education,-46.88,-24611.46
buyer_8,Antonio,,ES08209544318428491961,TRX_N-00827-45012987,2024-01-12T10:23:42,Zarautz,expenses,appliances,-102.06,-24713.52
buyer_8,Antonio,,ES08209544318428491961,TRX_N-00828-73129860,2024-01-13T18:28:43,Donostia,expenses,food,-85.18,-24798.7
buyer_8,Antonio,,ES08209544318428491961,TRX_N-00829-30415759,2024-01-14T15:59:51,Labastida,expenses,healthcare,-189.74,-24988.44
buyer_8,Antonio,,ES08209544318428491961,TRX_N-00830-38571224,2024-01-16T15:44:11,Labastida,expenses,cash,-100.0,-25088.44
buyer_8,Antonio,,ES08209544318428491961,TRX_N-00831-37726672,2024-01-18T13:22:33,Labastida,expenses,food,-119.4,-25207.84
buyer_8,Antonio,,ES08209544318428491961,TRX_N-00832-66645475,2024-01-19T04:57:47,Labastida,expenses,food,-116.39,-25324.23
buyer_8,Antonio,,ES08209544318428491961,TRX_N-00833-56959387,2024-01-19T21:23:13,Errenteria,expenses,cash,-100.0,-25424.23
buyer_8,Antonio,,ES08209544318428491961,TRX_N-00834-79772129,2024-01-19T04:15:18,Labastida,expenses,gifts,-282.57,-25706.8
buyer_8,Antonio,,ES08209544318428491961,TRX_N-00835-40180402,2024-01-21T15:41:11,Labastida,expenses,education,-73.33,-25780.13
buyer_8,Antonio,,ES08209544318428491961,TRX_N-00836-41277177,2024-01-22T15:30:21,Labastida,expenses,transport,-47.39,-25827.52
buyer_8,Antonio,,ES08209544318428491961,TRX_N-00837-64979813,2024-01-22T13:44:41,Lasarte-Oria,expenses,healthcare,-57.27,-25884.79
buyer_8,Antonio,,ES08209544318428491961,TRX_N-00838-18086252,2024-01-23T14:53:00,Labastida,expenses,food,-68.14,-25952.93
buyer_8,Antonio,,ES08209544318428491961,TRX_N-00839-23023325,2024-01-23T15:59:11,Labastida,expenses,leisure,-46.37,-25999.3
buyer_8,Antonio,,ES08209544318428491961,TRX_N-00840-24330834,2024-01-23T20:29:07,Labastida,expenses,clothing,-120.67,-26119.97
buyer_8,Antonio,,ES08209544318428491961,TRX_N-00841-29396924,2024-01-23T16:04:48,Labastida,expenses,cash,-100.0,-26219.97
buyer_8,Antonio,,ES08209544318428491961,TRX_N-00842-18884455,2024-01-26T14:44:57,Labastida,expenses,food,-111.21,-26331.18
buyer_8,Antonio,,ES08209544318428491961,TRX_N-00843-75030281,2024-01-27T11:58:01,Labastida,expenses,cash,-100.0,-26431.18
buyer_8,Antonio,,ES08209544318428491961,TRX_N-00844-35343567,2024-01-29T17:11:14,Labastida,expenses,gifts,-680.06,-27111.24
buyer_8,Antonio,,ES08209544318428491961,TRX_N-00845-44218135,2024-01-30T21:28:01,Labastida,expenses,food,-121.09,-27232.33
buyer_8,Antonio,,ES08209544318428491961,TRX_N-00846-69808819,2024-01-30T00:32:32,Berango,expenses,healthcare,-101.89,-27334.22
buyer_8,Antonio,,ES08209544318428491961,TRX_N-00847-36185600,2024-02-01T15:05:20,Labastida,incomes,salary,3415.92,-23918.3
buyer_8,Antonio,,ES08209544318428491961,TRX_N-00848-65766402,2024-02-01T17:35:59,Labastida,expenses,food,-113.02,-24031.32
buyer_8,Antonio,,ES08209544318428491961,TRX_N-00849-07345387,2024-02-01T11:52:14,Labastida,expenses,cash,-100.0,-24131.32
buyer_8,Antonio,,ES08209544318428491961,TRX_N-00850-66148663,2024-02-02T14:41:11,Labastida,expenses,education,-42.06,-24173.38
buyer_8,Antonio,,ES08209544318428491961,TRX_N-00851-26180069,2024-02-04T18:39:47,Labastida,expenses,mortgage,-1053.21,-25226.59
buyer_8,Antonio,,ES08209544318428491961,TRX_N-00852-91380721,2024-02-05T18:28:40,Labastida,expenses,electricity,-78.13,-25304.72
buyer_8,Antonio,,ES08209544318428491961,TRX_N-00853-90112400,2024-02-05T10:03:13,Labastida,expenses,leisure,-30.35,-25335.07
buyer_8,Antonio,,ES08209544318428491961,TRX_N-00854-82797684,2024-02-06T21:37:17,Labastida,expenses,water,-40.19,-25375.26
buyer_8,Antonio,,ES08209544318428491961,TRX_N-00855-88551986,2024-02-06T12:25:13,Llodio,expenses,transport,-64.52,-25439.78
buyer_8,Antonio,,ES08209544318428491961,TRX_N-00856-67788076,2024-02-07T16:50:51,Labastida,expenses,cash,-100.0,-25539.78
buyer_8,Antonio,,ES08209544318428491961,TRX_N-00857-74434296,2024-02-07T18:37:55,Labastida,expenses,gifts,-444.75,-25984.53
buyer_8,Antonio,,ES08209544318428491961,TRX_N-00858-19740480,2024-02-08T17:59:47,Labastida,expenses,internet,-42.0,-26026.53
buyer_8,Antonio,,ES08209544318428491961,TRX_N-00859-64799498,2024-02-08T16:42:40,Labastida,expenses,gas,-110.18,-26136.71
buyer_8,Antonio,,ES08209544318428491961,TRX_N-00860-69020327,2024-02-08T17:26:50,Labastida,expenses,phone,-42.57,-26179.28
buyer_8,Antonio,,ES08209544318428491961,TRX_N-00861-80716727,2024-02-08T10:03:21,Labastida,expenses,leisure,-71.52,-26250.8
buyer_8,Antonio,,ES08209544318428491961,TRX_N-00862-78761427,2024-02-08T19:19:42,Hondarribia,expenses,cash,-100.0,-26350.8
buyer_8,Antonio,,ES08209544318428491961,TRX_N-00863-00928565,2024-02-09T14:45:45,Labastida,expenses,transport,-62.23,-26413.03
buyer_8,Antonio,,ES08209544318428491961,TRX_N-00864-88267808,2024-02-10T09:33:09,Labastida,expenses,leisure,-59.64,-26472.67
buyer_8,Antonio,,ES08209544318428491961,TRX_N-00865-06617798,2024-02-12T04:17:26,Labastida,expenses,leisure,-64.57,-26537.24
buyer_8,Antonio,,ES08209544318428491961,TRX_N-00866-30790327,2024-02-15T20:16:11,Labastida,expenses,food,-80.69,-26617.93
buyer_8,Antonio,,ES08209544318428491961,TRX_N-00867-03176471,2024-02-15T12:27:27,Berango,expenses,cash,-100.0,-26717.93
buyer_8,Antonio,,ES08209544318428491961,TRX_N-00868-30047531,2024-02-17T02:20:38,Labastida,expenses,cash,-100.0,-26817.93
buyer_8,Antonio,,ES08209544318428491961,TRX_N-00869-90805489,2024-02-19T13:45:58,Sopela,expenses,education,-56.88,-26874.81
buyer_8,Antonio,,ES08209544318428491961,TRX_N-00870-54524176,2024-02-20T20:46:51,Labastida,expenses,leisure,-83.65,-26958.46
buyer_8,Antonio,,ES08209544318428491961,TRX_N-00871-08625356,2024-02-22T14:59:17,Getxo,expenses,cash,-100.0,-27058.46
buyer_8,Antonio,,ES08209544318428491961,TRX_N-00872-79078260,2024-02-23T08:53:58,Labastida,expenses,leisure,-41.83,-27100.29
buyer_8,Antonio,,ES08209544318428491961,TRX_N-00873-14036960,2024-02-24T17:50:08,Labastida,expenses,food,-85.61,-27185.9
buyer_8,Antonio,,ES08209544318428491961,TRX_N-00874-53720859,2024-02-28T17:59:57,Labastida,expenses,leisure,-20.53,-27206.43
buyer_8,Antonio,,ES08209544318428491961,TRX_N-00875-42490623,2024-02-29T19:47:28,Labastida,expenses,cash,-100.0,-27306.43
buyer_8,Antonio,,ES08209544318428491961,TRX_N-00876-69555341,2024-02-29T08:41:52,Labastida,expenses,gifts,-526.0,-27832.43
buyer_8,Antonio,,ES08209544318428491961,TRX_N-00877-31824484,2024-03-01T12:48:31,Labastida,incomes,salary,3415.92,-24416.51
buyer_8,Antonio,,ES08209544318428491961,TRX_N-00878-20023317,2024-03-01T12:48:31,Labastida,incomes,extra_income,377.3,-24039.21
buyer_8,Antonio,,ES08209544318428491961,TRX_N-00879-47596714,2024-03-03T15:55:09,Labastida,expenses,leisure,-53.19,-24092.4
buyer_8,Antonio,,ES08209544318428491961,TRX_N-00880-53373454,2024-03-04T07:07:43,Labastida,expenses,mortgage,-1053.21,-25145.61
buyer_8,Antonio,,ES08209544318428491961,TRX_N-00881-23352219,2024-03-04T16:23:47,Labastida,expenses,travel,-1252.0,-26397.61
buyer_8,Antonio,,ES08209544318428491961,TRX_N-00882-33390564,2024-03-05T18:27:51,Labastida,expenses,phone,-43.2,-26440.81
buyer_8,Antonio,,ES08209544318428491961,TRX_N-00883-40713259,2024-03-06T16:13:47,Labastida,expenses,food,-89.63,-26530.44
buyer_8,Antonio,,ES08209544318428491961,TRX_N-00884-92416635,2024-03-06T12:27:25,Labastida,expenses,leisure,-32.96,-26563.4
buyer_8,Antonio,,ES08209544318428491961,TRX_N-00885-95800006,2024-03-07T15:17:42,Labastida,expenses,food,-80.04,-26643.44
buyer_8,Antonio,,ES08209544318428491961,TRX_N-00886-27538994,2024-03-08T06:08:05,Labastida,expenses,water,-21.18,-26664.62
buyer_8,Antonio,,ES08209544318428491961,TRX_N-00887-43840431,2024-03-08T06:13:41,Labastida,expenses,electricity,-74.21,-26738.83
buyer_8,Antonio,,ES08209544318428491961,TRX_N-00888-61761044,2024-03-08T01:25:08,Labastida,expenses,gas,-100.9,-26839.73
buyer_8,Antonio,,ES08209544318428491961,TRX_N-00889-87087119,2024-03-08T09:30:49,Labastida,expenses,internet,-42.0,-26881.73
buyer_8,Antonio,,ES08209544318428491961,TRX_N-00890-85199784,2024-03-08T17:35:41,Oyón-Oion,expenses,leisure,-71.63,-26953.36
buyer_8,Antonio,,ES08209544318428491961,TRX_N-00891-83771561,2024-03-08T22:45:42,Labastida,expenses,clothing,-125.17,-27078.53
buyer_8,Antonio,,ES08209544318428491961,TRX_N-00892-26146563,2024-03-10T10:46:57,Pasaia,expenses,cash,-100.0,-27178.53
buyer_8,Antonio,,ES08209544318428491961,TRX_N-00893-49109887,2024-03-12T09:20:29,Labastida,expenses,travel,-1797.07,-28975.6
buyer_8,Antonio,,ES08209544318428491961,TRX_N-00894-74545493,2024-03-13T08:36:28,Labastida,expenses,leisure,-48.4,-29024.0
buyer_8,Antonio,,ES08209544318428491961,TRX_N-00895-96006380,2024-03-15T11:31:08,Labastida,expenses,repairs,-168.77,-29192.77
buyer_8,Antonio,,ES08209544318428491961,TRX_N-00896-85163235,2024-03-16T11:21:39,Barakaldo,expenses,food,-114.44,-29307.21
buyer_8,Antonio,,ES08209544318428491961,TRX_N-00897-94948460,2024-03-19T18:58:56,Labastida,expenses,food,-100.21,-29407.42
buyer_8,Antonio,,ES08209544318428491961,TRX_N-00898-70162904,2024-03-19T20:15:43,Sestao,expenses,leisure,-70.24,-29477.66
buyer_8,Antonio,,ES08209544318428491961,TRX_N-00899-60804798,2024-03-21T13:03:48,Labastida,expenses,leisure,-78.1,-29555.76
buyer_8,Antonio,,ES08209544318428491961,TRX_N-00900-75577407,2024-03-23T15:11:39,Labastida,expenses,cash,-100.0,-29655.76
buyer_8,Antonio,,ES08209544318428491961,TRX_N-00901-26759877,2024-03-24T09:05:37,Labastida,expenses,food,-99.01,-29754.77
buyer_8,Antonio,,ES08209544318428491961,TRX_N-00902-53851446,2024-03-24T20:22:32,Labastida,expenses,leisure,-68.2,-29822.97
buyer_8,Antonio,,ES08209544318428491961,TRX_N-00903-06902949,2024-03-25T08:10:03,Labastida,expenses,clothing,-58.8,-29881.77
buyer_8,Antonio,,ES08209544318428491961,TRX_N-00904-47676302,2024-03-25T12:10:33,Berango,expenses,repairs,-90.57,-29972.34
buyer_8,Antonio,,ES08209544318428491961,TRX_N-00905-56921627,2024-03-30T08:03:51,Labastida,expenses,cash,-100.0,-30072.34
buyer_8,Antonio,,ES08209544318428491961,TRX_N-00906-52043515,2024-03-31T13:11:19,Labastida,expenses,food,-102.42,-30174.76
buyer_8,Antonio,,ES08209544318428491961,TRX_N-00907-58811273,2024-04-01T10:11:49,Labastida,incomes,salary,3415.92,-26758.84
buyer_8,Antonio,,ES08209544318428491961,TRX_N-00908-31901508,2024-04-02T20:29:06,Labastida,expenses,appliances,-403.74,-27162.58
buyer_8,Antonio,,ES08209544318428491961,TRX_N-00909-39713462,2024-04-02T09:22:31,Labastida,expenses,repairs,-147.68,-27310.26
buyer_8,Antonio,,ES08209544318428491961,TRX_N-00910-66937455,2024-04-04T20:41:04,Labastida,expenses,mortgage,-1053.21,-28363.47
buyer_8,Antonio,,ES08209544318428491961,TRX_N-00911-39463908,2024-04-04T14:08:21,Labastida,expenses,travel,-1003.9,-29367.37
buyer_8,Antonio,,ES08209544318428491961,TRX_N-00912-79694525,2024-04-05T22:20:57,Labastida,expenses,phone,-39.38,-29406.75
buyer_8,Antonio,,ES08209544318428491961,TRX_N-00913-36440077,2024-04-05T03:53:58,Labastida,expenses,leisure,-68.67,-29475.42
buyer_8,Antonio,,ES08209544318428491961,TRX_N-00914-80815260,2024-04-06T16:19:29,Labastida,expenses,electricity,-36.47,-29511.89
buyer_8,Antonio,,ES08209544318428491961,TRX_N-00915-51697024,2024-04-06T18:53:48,Labastida,expenses,internet,-42.0,-29553.89
buyer_8,Antonio,,ES08209544318428491961,TRX_N-00916-16678637,2024-04-07T20:09:19,Labastida,expenses,water,-32.32,-29586.21
buyer_8,Antonio,,ES08209544318428491961,TRX_N-00917-33111435,2024-04-07T20:06:28,Labastida,expenses,leisure,-41.83,-29628.04
buyer_8,Antonio,,ES08209544318428491961,TRX_N-00918-08987823,2024-04-08T11:16:46,Labastida,expenses,gas,-96.45,-29724.49
buyer_8,Antonio,,ES08209544318428491961,TRX_N-00919-40191743,2024-04-08T09:13:02,Labastida,expenses,food,-89.26,-29813.75
buyer_8,Antonio,,ES08209544318428491961,TRX_N-00920-14343989,2024-04-09T21:45:23,Labastida,expenses,leisure,-20.49,-29834.24
buyer_8,Antonio,,ES08209544318428491961,TRX_N-00921-76327730,2024-04-11T13:41:07,Labastida,expenses,food,-87.45,-29921.69
buyer_8,Antonio,,ES08209544318428491961,TRX_N-00922-64268289,2024-04-11T11:22:05,Labastida,expenses,repairs,-174.82,-30096.51
buyer_8,Antonio,,ES08209544318428491961,TRX_N-00923-45669849,2024-04-13T14:55:15,Erandio,expenses,repairs,-59.72,-30156.23
buyer_8,Antonio,,ES08209544318428491961,TRX_N-00924-71697151,2024-04-14T14:22:39,Labastida,expenses,cash,-100.0,-30256.23
buyer_8,Antonio,,ES08209544318428491961,TRX_N-00925-94116904,2024-04-15T07:53:04,Labastida,expenses,food,-82.72,-30338.95
buyer_8,Antonio,,ES08209544318428491961,TRX_N-00926-13021196,2024-04-15T16:07:47,Labastida,expenses,leisure,-43.7,-30382.65
buyer_8,Antonio,,ES08209544318428491961,TRX_N-00927-10605528,2024-04-18T12:29:23,Labastida,expenses,cash,-100.0,-30482.65
buyer_8,Antonio,,ES08209544318428491961,TRX_N-00928-59098092,2024-04-19T09:30:54,Labastida,expenses,transport,-68.4,-30551.05
buyer_8,Antonio,,ES08209544318428491961,TRX_N-00929-93397982,2024-04-19T10:25:08,Lasarte-Oria,expenses,cash,-100.0,-30651.05
buyer_8,Antonio,,ES08209544318428491961,TRX_N-00930-96369982,2024-04-21T10:36:39,Labastida,expenses,food,-118.38,-30769.43
buyer_8,Antonio,,ES08209544318428491961,TRX_N-00931-84913347,2024-04-22T22:28:40,Labastida,expenses,travel,-1038.41,-31807.84
buyer_8,Antonio,,ES08209544318428491961,TRX_N-00932-30025227,2024-04-22T19:27:27,Labastida,expenses,repairs,-124.14,-31931.98
buyer_8,Antonio,,ES08209544318428491961,TRX_N-00933-28728034,2024-04-24T13:05:05,Labastida,expenses,food,-123.01,-32054.99
buyer_8,Antonio,,ES08209544318428491961,TRX_N-00934-56328053,2024-04-25T14:17:47,Labastida,expenses,healthcare,-140.31,-32195.3
buyer_8,Antonio,,ES08209544318428491961,TRX_N-00935-63648602,2024-04-26T13:04:38,Labastida,expenses,clothing,-150.39,-32345.69
buyer_8,Antonio,,ES08209544318428491961,TRX_N-00936-08545895,2024-04-28T18:21:47,Labastida,expenses,gifts,-197.33,-32543.02
buyer_8,Antonio,,ES08209544318428491961,TRX_N-00937-16347348,2024-04-29T18:18:28,Labastida,expenses,transport,-57.52,-32600.54
buyer_8,Antonio,,ES08209544318428491961,TRX_N-00938-85866630,2024-04-30T11:05:48,Pasaia,expenses,repairs,-142.83,-32743.37
buyer_8,Antonio,,ES08209544318428491961,TRX_N-00939-14851143,2024-05-01T12:55:12,Labastida,incomes,salary,3415.92,-29327.45
buyer_8,Antonio,,ES08209544318428491961,TRX_N-00940-95045193,2024-05-01T17:27:23,Amurrio,expenses,cash,-100.0,-29427.45
buyer_8,Antonio,,ES08209544318428491961,TRX_N-00941-92157814,2024-05-04T12:46:00,Labastida,expenses,mortgage,-1053.21,-30480.66
buyer_8,Antonio,,ES08209544318428491961,TRX_N-00942-40718490,2024-05-04T20:27:53,Sopela,expenses,leisure,-22.8,-30503.46
buyer_8,Antonio,,ES08209544318428491961,TRX_N-00943-02008003,2024-05-04T15:12:52,Labastida,expenses,cash,-100.0,-30603.46
buyer_8,Antonio,,ES08209544318428491961,TRX_N-00944-92240838,2024-05-05T16:15:51,Labastida,expenses,water,-37.19,-30640.65
buyer_8,Antonio,,ES08209544318428491961,TRX_N-00945-08491764,2024-05-05T10:33:56,Labastida,expenses,phone,-37.67,-30678.32
buyer_8,Antonio,,ES08209544318428491961,TRX_N-00946-29348289,2024-05-06T15:42:20,Labastida,expenses,electricity,-20.31,-30698.63
buyer_8,Antonio,,ES08209544318428491961,TRX_N-00947-95270074,2024-05-07T16:25:31,Labastida,expenses,internet,-42.0,-30740.63
buyer_8,Antonio,,ES08209544318428491961,TRX_N-00948-46374860,2024-05-08T19:39:49,Labastida,expenses,gas,-93.37,-30834.0
buyer_8,Antonio,,ES08209544318428491961,TRX_N-00949-15902093,2024-05-09T13:40:58,Labastida,expenses,cash,-100.0,-30934.0
buyer_8,Antonio,,ES08209544318428491961,TRX_N-00950-46502478,2024-05-10T08:14:14,Labastida,expenses,appliances,-196.03,-31130.03
buyer_8,Antonio,,ES08209544318428491961,TRX_N-00951-94170579,2024-05-10T20:54:48,Galdakao,expenses,repairs,-62.46,-31192.49
buyer_8,Antonio,,ES08209544318428491961,TRX_N-00952-29866778,2024-05-10T17:16:25,Labastida,expenses,gifts,-425.98,-31618.47
buyer_8,Antonio,,ES08209544318428491961,TRX_N-00953-67400246,2024-05-11T18:12:38,Donostia,expenses,food,-99.98,-31718.45
buyer_8,Antonio,,ES08209544318428491961,TRX_N-00954-64859020,2024-05-11T18:31:40,Labastida,expenses,cash,-100.0,-31818.45
buyer_8,Antonio,,ES08209544318428491961,TRX_N-00955-36311522,2024-05-14T11:20:03,Labastida,expenses,appliances,-117.42,-31935.87
buyer_8,Antonio,,ES08209544318428491961,TRX_N-00956-79104498,2024-05-15T01:45:12,Labastida,expenses,food,-87.13,-32023.0
buyer_8,Antonio,,ES08209544318428491961,TRX_N-00957-68116880,2024-05-17T08:14:45,Labastida,expenses,leisure,-84.44,-32107.44
buyer_8,Antonio,,ES08209544318428491961,TRX_N-00958-87321357,2024-05-21T10:44:03,Labastida,expenses,education,-69.69,-32177.13
buyer_8,Antonio,,ES08209544318428491961,TRX_N-00959-95977606,2024-05-21T10:58:43,Labastida,expenses,cash,-100.0,-32277.13
buyer_8,Antonio,,ES08209544318428491961,TRX_N-00960-49755587,2024-05-23T08:10:14,Labastida,expenses,transport,-83.71,-32360.84
buyer_8,Antonio,,ES08209544318428491961,TRX_N-00961-73882173,2024-05-23T14:32:13,Labastida,expenses,education,-69.12,-32429.96
buyer_8,Antonio,,ES08209544318428491961,TRX_N-00962-65243680,2024-05-23T10:39:41,Labastida,expenses,appliances,-355.32,-32785.28
buyer_8,Antonio,,ES08209544318428491961,TRX_N-00963-47451351,2024-05-24T14:35:38,Elciego,expenses,leisure,-30.94,-32816.22
buyer_8,Antonio,,ES08209544318428491961,TRX_N-00964-03542446,2024-05-24T15:13:14,Hondarribia,expenses,cash,-100.0,-32916.22
buyer_8,Antonio,,ES08209544318428491961,TRX_N-00965-91197263,2024-05-26T14:37:01,Labastida,expenses,food,-117.74,-33033.96
buyer_8,Antonio,,ES08209544318428491961,TRX_N-00966-38562769,2024-05-27T15:47:50,Labastida,expenses,healthcare,-67.87,-33101.83
buyer_8,Antonio,,ES08209544318428491961,TRX_N-00967-61664414,2024-05-29T20:50:09,Labastida,expenses,repairs,-111.92,-33213.75
buyer_8,Antonio,,ES08209544318428491961,TRX_N-00968-24948564,2024-05-31T18:47:56,Labastida,expenses,repairs,-278.29,-33492.04
buyer_8,Antonio,,ES08209544318428491961,TRX_N-00969-09602119,2024-06-01T10:37:00,Labastida,incomes,salary,3415.92,-30076.12
buyer_8,Antonio,,ES08209544318428491961,TRX_N-00970-91903329,2024-06-01T10:37:00,Labastida,incomes,salary_bonus,2511.27,-27564.85
buyer_8,Antonio,,ES08209544318428491961,TRX_N-00971-56242809,2024-06-04T10:02:43,Labastida,expenses,mortgage,-1053.21,-28618.06
buyer_8,Antonio,,ES08209544318428491961,TRX_N-00972-63116549,2024-06-05T20:40:13,Labastida,expenses,gas,-45.0,-28663.06
buyer_8,Antonio,,ES08209544318428491961,TRX_N-00973-34900421,2024-06-05T20:58:30,Labastida,expenses,cash,-100.0,-28763.06
buyer_8,Antonio,,ES08209544318428491961,TRX_N-00974-73848578,2024-06-05T19:52:16,Labastida,expenses,repairs,-160.0,-28923.06
buyer_8,Antonio,,ES08209544318428491961,TRX_N-00975-87319452,2024-06-06T16:58:27,Labastida,expenses,water,-20.13,-28943.19
buyer_8,Antonio,,ES08209544318428491961,TRX_N-00976-32065217,2024-06-06T10:32:29,Labastida,expenses,phone,-38.71,-28981.9
buyer_8,Antonio,,ES08209544318428491961,TRX_N-00977-03268679,2024-06-06T18:28:17,Labastida,expenses,food,-63.98,-29045.88
buyer_8,Antonio,,ES08209544318428491961,TRX_N-00978-06254073,2024-06-07T16:25:41,Labastida,expenses,electricity,-22.92,-29068.8
buyer_8,Antonio,,ES08209544318428491961,TRX_N-00979-72851777,2024-06-07T13:52:32,Labastida,expenses,internet,-42.0,-29110.8
buyer_8,Antonio,,ES08209544318428491961,TRX_N-00980-24093539,2024-06-08T09:29:36,Labastida,expenses,gifts,-368.24,-29479.04
buyer_8,Antonio,,ES08209544318428491961,TRX_N-00981-33497226,2024-06-09T11:08:47,Sopela,expenses,repairs,-292.04,-29771.08
buyer_8,Antonio,,ES08209544318428491961,TRX_N-00982-17920836,2024-06-09T08:01:39,Labastida,expenses,gifts,-355.42,-30126.5
buyer_8,Antonio,,ES08209544318428491961,TRX_N-00983-56755326,2024-06-10T08:52:07,Labastida,expenses,repairs,-316.77,-30443.27
buyer_8,Antonio,,ES08209544318428491961,TRX_N-00984-20278690,2024-06-12T14:48:12,Labastida,expenses,transport,-78.55,-30521.82
buyer_8,Antonio,,ES08209544318428491961,TRX_N-00985-76050100,2024-06-14T20:47:02,Labastida,expenses,appliances,-361.08,-30882.9
buyer_8,Antonio,,ES08209544318428491961,TRX_N-00986-35597835,2024-06-15T11:55:06,Eibar,expenses,cash,-100.0,-30982.9
buyer_8,Antonio,,ES08209544318428491961,TRX_N-00987-47989808,2024-06-16T10:02:56,Labastida,expenses,education,-63.49,-31046.39
buyer_8,Antonio,,ES08209544318428491961,TRX_N-00988-93396323,2024-06-16T08:55:57,Hondarribia,expenses,cash,-100.0,-31146.39
buyer_8,Antonio,,ES08209544318428491961,TRX_N-00989-23454321,2024-06-17T14:57:34,Labastida,expenses,leisure,-53.55,-31199.94
buyer_8,Antonio,,ES08209544318428491961,TRX_N-00990-92579406,2024-06-18T12:47:42,Labastida,expenses,clothing,-152.93,-31352.87
buyer_8,Antonio,,ES08209544318428491961,TRX_N-00991-78517249,2024-06-18T10:04:32,Labastida,expenses,cash,-100.0,-31452.87
buyer_8,Antonio,,ES08209544318428491961,TRX_N-00992-85635236,2024-06-20T10:32:55,Donostia,expenses,cash,-100.0,-31552.87
buyer_8,Antonio,,ES08209544318428491961,TRX_N-00993-89803431,2024-06-21T15:25:32,Durango,expenses,food,-77.21,-31630.08
buyer_8,Antonio,,ES08209544318428491961,TRX_N-00994-84073616,2024-06-22T15:20:24,Labastida,expenses,leisure,-61.4,-31691.48
buyer_8,Antonio,,ES08209544318428491961,TRX_N-00995-66034459,2024-06-22T21:30:28,Labastida,expenses,cash,-100.0,-31791.48
buyer_8,Antonio,,ES08209544318428491961,TRX_N-00996-86305081,2024-06-22T12:43:53,Labastida,expenses,repairs,-269.01,-32060.49
buyer_8,Antonio,,ES08209544318428491961,TRX_N-00997-89090894,2024-06-25T16:02:38,Labastida,expenses,cash,-100.0,-32160.49
buyer_8,Antonio,,ES08209544318428491961,TRX_N-00998-25598162,2024-06-25T20:23:20,Basauri,expenses,repairs,-113.3,-32273.79
buyer_8,Antonio,,ES08209544318428491961,TRX_N-00999-99993661,2024-06-26T13:36:47,Labastida,expenses,food,-93.44,-32367.23
buyer_8,Antonio,,ES08209544318428491961,TRX_N-01000-78219202,2024-06-27T16:58:06,Labastida,expenses,cash,-100.0,-32467.23
buyer_8,Antonio,,ES08209544318428491961,TRX_N-01001-87623198,2024-06-28T12:53:45,Labastida,expenses,leisure,-62.88,-32530.11
buyer_8,Antonio,,ES08209544318428491961,TRX_N-01002-14526145,2024-06-28T13:21:56,Labastida,expenses,travel,-1087.74,-33617.85
buyer_8,Antonio,,ES08209544318428491961,TRX_N-01003-26619287,2024-06-30T14:06:13,Labastida,expenses,transport,-40.68,-33658.53
buyer_8,Antonio,,ES08209544318428491961,TRX_N-01004-44000810,2024-06-30T17:51:12,Labastida,expenses,repairs,-80.08,-33738.61
buyer_8,Antonio,,ES08209544318428491961,TRX_N-01005-46969831,2024-07-01T16:48:52,Labastida,incomes,salary,3415.92,-30322.69
buyer_8,Antonio,,ES08209544318428491961,TRX_N-01006-75467999,2024-07-01T16:48:52,Labastida,incomes,extra_income,377.3,-29945.39
buyer_8,Antonio,,ES08209544318428491961,TRX_N-01007-43766449,2024-07-01T10:09:18,Labastida,expenses,food,-103.72,-30049.11
buyer_8,Antonio,,ES08209544318428491961,TRX_N-01008-17816521,2024-07-01T15:32:47,Labastida,expenses,repairs,-32.47,-30081.58
buyer_8,Antonio,,ES08209544318428491961,TRX_N-01009-22840818,2024-07-02T16:57:28,Labastida,expenses,leisure,-73.74,-30155.32
buyer_8,Antonio,,ES08209544318428491961,TRX_N-01010-16681509,2024-07-02T17:12:24,Berango,expenses,cash,-100.0,-30255.32
buyer_8,Antonio,,ES08209544318428491961,TRX_N-01011-61831463,2024-07-03T13:32:39,Labastida,expenses,food,-66.07,-30321.39
buyer_8,Antonio,,ES08209544318428491961,TRX_N-01012-99154737,2024-07-04T17:15:14,Labastida,expenses,mortgage,-1053.21,-31374.6
buyer_8,Antonio,,ES08209544318428491961,TRX_N-01013-14464417,2024-07-04T15:53:00,Labastida,expenses,leisure,-71.88,-31446.48
buyer_8,Antonio,,ES08209544318428491961,TRX_N-01014-87058572,2024-07-04T21:31:52,Labastida,expenses,repairs,-93.48,-31539.96
buyer_8,Antonio,,ES08209544318428491961,TRX_N-01015-65738938,2024-07-05T20:00:01,Labastida,expenses,water,-20.28,-31560.24
buyer_8,Antonio,,ES08209544318428491961,TRX_N-01016-46384717,2024-07-05T09:15:32,Labastida,expenses,internet,-42.0,-31602.24
buyer_8,Antonio,,ES08209544318428491961,TRX_N-01017-38931608,2024-07-05T18:50:40,Labastida,expenses,leisure,-32.55,-31634.79
buyer_8,Antonio,,ES08209544318428491961,TRX_N-01018-05519972,2024-07-06T18:29:06,Labastida,expenses,gas,-80.62,-31715.41
buyer_8,Antonio,,ES08209544318428491961,TRX_N-01019-70610871,2024-07-08T16:41:24,Labastida,expenses,electricity,-70.77,-31786.18
buyer_8,Antonio,,ES08209544318428491961,TRX_N-01020-60878546,2024-07-08T11:39:20,Labastida,expenses,phone,-38.24,-31824.42
buyer_8,Antonio,,ES08209544318428491961,TRX_N-01021-26254504,2024-07-08T11:21:33,Labastida,expenses,cash,-100.0,-31924.42
buyer_8,Antonio,,ES08209544318428491961,TRX_N-01022-67023362,2024-07-10T08:46:57,Labastida,expenses,education,-67.12,-31991.54
buyer_8,Antonio,,ES08209544318428491961,TRX_N-01023-93810974,2024-07-11T08:53:05,Labastida,expenses,food,-111.01,-32102.55
buyer_8,Antonio,,ES08209544318428491961,TRX_N-01024-65553510,2024-07-11T14:00:12,Labastida,expenses,transport,-60.08,-32162.63
buyer_8,Antonio,,ES08209544318428491961,TRX_N-01025-78929933,2024-07-14T14:00:59,Labastida,expenses,education,-58.06,-32220.69
buyer_8,Antonio,,ES08209544318428491961,TRX_N-01026-50652380,2024-07-15T08:26:25,Labastida,expenses,leisure,-20.64,-32241.33
buyer_8,Antonio,,ES08209544318428491961,TRX_N-01027-33445734,2024-07-17T10:43:19,Labastida,expenses,leisure,-21.64,-32262.97
buyer_8,Antonio,,ES08209544318428491961,TRX_N-01028-67824846,2024-07-17T12:32:18,Labastida,expenses,clothing,-60.83,-32323.8
buyer_8,Antonio,,ES08209544318428491961,TRX_N-01029-06408006,2024-07-18T20:17:12,Labastida,expenses,transport,-49.85,-32373.65
buyer_8,Antonio,,ES08209544318428491961,TRX_N-01030-76901618,2024-07-18T14:37:39,Labastida,expenses,clothing,-105.83,-32479.48
buyer_8,Antonio,,ES08209544318428491961,TRX_N-01031-56612896,2024-07-19T12:37:02,Salvatierra/Agurain,expenses,appliances,-331.48,-32810.96
buyer_8,Antonio,,ES08209544318428491961,TRX_N-01032-74354904,2024-07-21T12:29:42,Durango,expenses,leisure,-81.07,-32892.03
buyer_8,Antonio,,ES08209544318428491961,TRX_N-01033-24362966,2024-07-22T19:25:56,Labastida,expenses,gifts,-764.47,-33656.5
buyer_8,Antonio,,ES08209544318428491961,TRX_N-01034-94827308,2024-07-23T08:01:03,Labastida,expenses,repairs,-92.16,-33748.66
buyer_8,Antonio,,ES08209544318428491961,TRX_N-01035-41391203,2024-07-24T08:16:44,Eibar,expenses,appliances,-192.73,-33941.39
buyer_8,Antonio,,ES08209544318428491961,TRX_N-01036-54571629,2024-07-25T21:03:22,Labastida,expenses,education,-74.94,-34016.33
buyer_8,Antonio,,ES08209544318428491961,TRX_N-01037-30314950,2024-07-25T18:07:32,Labastida,expenses,cash,-100.0,-34116.33
buyer_8,Antonio,,ES08209544318428491961,TRX_N-01038-11138992,2024-07-25T17:31:58,Labastida,expenses,gifts,-812.44,-34928.77
buyer_8,Antonio,,ES08209544318428491961,TRX_N-01039-94835581,2024-07-26T09:02:35,Labastida,expenses,food,-68.48,-34997.25
buyer_8,Antonio,,ES08209544318428491961,TRX_N-01040-03656789,2024-07-26T10:47:33,Labastida,expenses,leisure,-19.1,-35016.35
buyer_8,Antonio,,ES08209544318428491961,TRX_N-01041-47184397,2024-07-27T18:06:18,Donostia,expenses,clothing,-121.48,-35137.83
buyer_8,Antonio,,ES08209544318428491961,TRX_N-01042-22984245,2024-07-28T08:36:31,Labastida,expenses,food,-99.96,-35237.79
buyer_8,Antonio,,ES08209544318428491961,TRX_N-01043-48272870,2024-07-29T08:47:53,Labastida,expenses,gifts,-655.5,-35893.29
buyer_8,Antonio,,ES08209544318428491961,TRX_N-01044-62758873,2024-07-30T18:57:33,Labastida,expenses,food,-106.8,-36000.09
buyer_8,Antonio,,ES08209544318428491961,TRX_N-01045-80432576,2024-07-30T06:20:31,Labastida,expenses,transport,-78.67,-36078.76
buyer_8,Antonio,,ES08209544318428491961,TRX_N-01046-86967287,2024-07-30T13:41:39,Labastida,expenses,education,-56.16,-36134.92
buyer_8,Antonio,,ES08209544318428491961,TRX_N-01047-92382666,2024-07-31T18:33:37,Bermeo,expenses,cash,-100.0,-36234.92
buyer_8,Antonio,,ES08209544318428491961,TRX_N-01048-21245274,2024-08-01T15:05:14,Labastida,incomes,salary,3415.92,-32819.0
buyer_8,Antonio,,ES08209544318428491961,TRX_N-01049-92404587,2024-08-02T10:06:47,Labastida,expenses,food,-113.17,-32932.17
buyer_8,Antonio,,ES08209544318428491961,TRX_N-01050-87727783,2024-08-02T12:43:12,Labastida,expenses,cash,-100.0,-33032.17
buyer_8,Antonio,,ES08209544318428491961,TRX_N-01051-35509182,2024-08-03T10:03:19,Labastida,expenses,cash,-100.0,-33132.17
buyer_8,Antonio,,ES08209544318428491961,TRX_N-01052-88049294,2024-08-04T22:49:24,Labastida,expenses,mortgage,-1053.21,-34185.38
buyer_8,Antonio,,ES08209544318428491961,TRX_N-01053-75025427,2024-08-04T10:02:10,Labastida,expenses,transport,-87.63,-34273.01
buyer_8,Antonio,,ES08209544318428491961,TRX_N-01054-97611745,2024-08-04T09:22:49,Labastida,expenses,clothing,-121.2,-34394.21
buyer_8,Antonio,,ES08209544318428491961,TRX_N-01055-08230320,2024-08-04T09:34:28,Mungia,expenses,cash,-100.0,-34494.21
buyer_8,Antonio,,ES08209544318428491961,TRX_N-01056-58858103,2024-08-05T12:17:23,Labastida,expenses,gas,-111.1,-34605.31
buyer_8,Antonio,,ES08209544318428491961,TRX_N-01057-97228462,2024-08-05T17:29:19,Labastida,expenses,internet,-42.0,-34647.31
buyer_8,Antonio,,ES08209544318428491961,TRX_N-01058-15949363,2024-08-05T14:58:13,Labastida,expenses,repairs,-130.03,-34777.34
buyer_8,Antonio,,ES08209544318428491961,TRX_N-01059-48179191,2024-08-06T13:34:41,Labastida,expenses,food,-70.69,-34848.03
buyer_8,Antonio,,ES08209544318428491961,TRX_N-01060-28939350,2024-08-06T11:38:06,Labastida,expenses,transport,-56.49,-34904.52
buyer_8,Antonio,,ES08209544318428491961,TRX_N-01061-52886797,2024-08-07T17:09:06,Labastida,expenses,clothing,-81.5,-34986.02
buyer_8,Antonio,,ES08209544318428491961,TRX_N-01062-39782758,2024-08-08T11:02:28,Labastida,expenses,water,-21.15,-35007.17
buyer_8,Antonio,,ES08209544318428491961,TRX_N-01063-25661876,2024-08-08T01:08:19,Labastida,expenses,electricity,-66.48,-35073.65
buyer_8,Antonio,,ES08209544318428491961,TRX_N-01064-68505564,2024-08-08T19:33:13,Labastida,expenses,phone,-38.07,-35111.72
buyer_8,Antonio,,ES08209544318428491961,TRX_N-01065-28592790,2024-08-12T11:26:04,Salvatierra/Agurain,expenses,food,-121.53,-35233.25
buyer_8,Antonio,,ES08209544318428491961,TRX_N-01066-16366372,2024-08-12T10:31:30,Labastida,expenses,clothing,-115.03,-35348.28
buyer_8,Antonio,,ES08209544318428491961,TRX_N-01067-40960259,2024-08-13T16:12:22,Labastida,expenses,transport,-64.09,-35412.37
buyer_8,Antonio,,ES08209544318428491961,TRX_N-01068-05187323,2024-08-13T09:36:23,Labastida,expenses,leisure,-84.34,-35496.71
buyer_8,Antonio,,ES08209544318428491961,TRX_N-01069-00361840,2024-08-13T14:56:06,Labastida,expenses,education,-67.18,-35563.89
buyer_8,Antonio,,ES08209544318428491961,TRX_N-01070-70635765,2024-08-13T09:31:05,Donostia,expenses,appliances,-307.48,-35871.37
buyer_8,Antonio,,ES08209544318428491961,TRX_N-01071-91609369,2024-08-14T07:01:42,Zuia,expenses,cash,-100.0,-35971.37
buyer_8,Antonio,,ES08209544318428491961,TRX_N-01072-06430192,2024-08-15T11:27:10,Erandio,expenses,leisure,-54.0,-36025.37
buyer_8,Antonio,,ES08209544318428491961,TRX_N-01073-21070277,2024-08-15T18:27:02,Labastida,expenses,clothing,-61.23,-36086.6
buyer_8,Antonio,,ES08209544318428491961,TRX_N-01074-39503286,2024-08-15T14:32:06,Labastida,expenses,gifts,-145.17,-36231.77
buyer_8,Antonio,,ES08209544318428491961,TRX_N-01075-75227182,2024-08-16T13:35:11,Labastida,expenses,food,-118.91,-36350.68
buyer_8,Antonio,,ES08209544318428491961,TRX_N-01076-90852566,2024-08-16T13:40:21,Labastida,expenses,transport,-70.39,-36421.07
buyer_8,Antonio,,ES08209544318428491961,TRX_N-01077-80749275,2024-08-16T10:45:48,Labastida,expenses,healthcare,-112.16,-36533.23
buyer_8,Antonio,,ES08209544318428491961,TRX_N-01078-07490932,2024-08-16T23:18:57,Labastida,expenses,appliances,-202.29,-36735.52
buyer_8,Antonio,,ES08209544318428491961,TRX_N-01079-52406134,2024-08-19T15:44:20,Labastida,expenses,cash,-100.0,-36835.52
buyer_8,Antonio,,ES08209544318428491961,TRX_N-01080-63664146,2024-08-20T10:35:17,Labastida,expenses,leisure,-28.36,-36863.88
buyer_8,Antonio,,ES08209544318428491961,TRX_N-01081-05464499,2024-08-23T02:16:11,Labastida,expenses,cash,-100.0,-36963.88
buyer_8,Antonio,,ES08209544318428491961,TRX_N-01082-46282625,2024-08-24T11:58:23,Labastida,expenses,gifts,-604.84,-37568.72
buyer_8,Antonio,,ES08209544318428491961,TRX_N-01083-30878766,2024-08-27T08:01:33,Labastida,expenses,food,-65.44,-37634.16
buyer_8,Antonio,,ES08209544318428491961,TRX_N-01084-33091520,2024-08-27T23:50:02,Labastida,expenses,leisure,-68.91,-37703.07
buyer_8,Antonio,,ES08209544318428491961,TRX_N-01085-52375975,2024-08-27T11:18:45,Iruña de Oca,expenses,healthcare,-90.04,-37793.11
buyer_8,Antonio,,ES08209544318428491961,TRX_N-01086-96279595,2024-08-30T16:50:38,Labastida,expenses,cash,-100.0,-37893.11
buyer_8,Antonio,,ES08209544318428491961,TRX_N-01087-54783654,2024-08-31T11:45:03,Labastida,expenses,repairs,-111.24,-38004.35
buyer_8,Antonio,,ES08209544318428491961,TRX_N-01088-57905325,2024-09-01T19:53:47,Labastida,incomes,salary,3415.92,-34588.43
buyer_8,Antonio,,ES08209544318428491961,TRX_N-01089-09193249,2024-09-01T20:19:21,Santurtzi,expenses,transport,-87.11,-34675.54
buyer_8,Antonio,,ES08209544318428491961,TRX_N-01090-57163387,2024-09-02T15:33:12,Labastida,expenses,food,-81.11,-34756.65
buyer_8,Antonio,,ES08209544318428491961,TRX_N-01091-13090640,2024-09-04T15:29:05,Labastida,expenses,mortgage,-1053.21,-35809.86
buyer_8,Antonio,,ES08209544318428491961,TRX_N-01092-49187998,2024-09-04T06:51:22,Mungia,expenses,healthcare,-118.02,-35927.88
buyer_8,Antonio,,ES08209544318428491961,TRX_N-01093-98720477,2024-09-05T20:17:21,Labastida,expenses,water,-35.86,-35963.74
buyer_8,Antonio,,ES08209544318428491961,TRX_N-01094-88505360,2024-09-05T10:40:11,Labastida,expenses,phone,-36.94,-36000.68
buyer_8,Antonio,,ES08209544318428491961,TRX_N-01095-54304158,2024-09-05T16:16:38,Labastida,expenses,food,-65.41,-36066.09
buyer_8,Antonio,,ES08209544318428491961,TRX_N-01096-36711259,2024-09-05T19:49:31,Labastida,expenses,transport,-47.7,-36113.79
buyer_8,Antonio,,ES08209544318428491961,TRX_N-01097-40211543,2024-09-06T23:59:26,Labastida,expenses,electricity,-37.46,-36151.25
buyer_8,Antonio,,ES08209544318428491961,TRX_N-01098-28577577,2024-09-06T20:12:04,Labastida,expenses,internet,-42.0,-36193.25
buyer_8,Antonio,,ES08209544318428491961,TRX_N-01099-13903308,2024-09-06T17:31:35,Labastida,expenses,appliances,-322.02,-36515.27
buyer_8,Antonio,,ES08209544318428491961,TRX_N-01100-30320102,2024-09-08T10:34:51,Labastida,expenses,gas,-51.34,-36566.61
buyer_8,Antonio,,ES08209544318428491961,TRX_N-01101-24162280,2024-09-08T08:27:08,Labastida,expenses,transport,-64.95,-36631.56
buyer_8,Antonio,,ES08209544318428491961,TRX_N-01102-39528252,2024-09-08T23:50:57,Labastida,expenses,repairs,-107.05,-36738.61
buyer_8,Antonio,,ES08209544318428491961,TRX_N-01103-23300463,2024-09-09T11:01:00,Eibar,expenses,repairs,-235.14,-36973.75
buyer_8,Antonio,,ES08209544318428491961,TRX_N-01104-78005001,2024-09-10T15:50:30,Labastida,expenses,clothing,-102.61,-37076.36
buyer_8,Antonio,,ES08209544318428491961,TRX_N-01105-52529250,2024-09-10T12:34:26,Labastida,expenses,cash,-100.0,-37176.36
buyer_8,Antonio,,ES08209544318428491961,TRX_N-01106-98998238,2024-09-11T11:27:26,Labastida,expenses,cash,-100.0,-37276.36
buyer_8,Antonio,,ES08209544318428491961,TRX_N-01107-79108585,2024-09-15T09:18:14,Labastida,expenses,food,-67.99,-37344.35
buyer_8,Antonio,,ES08209544318428491961,TRX_N-01108-01025002,2024-09-15T12:48:08,Mungia,expenses,repairs,-88.77,-37433.12
buyer_8,Antonio,,ES08209544318428491961,TRX_N-01109-52441577,2024-09-19T14:35:01,Labastida,expenses,repairs,-153.5,-37586.62
buyer_8,Antonio,,ES08209544318428491961,TRX_N-01110-04154673,2024-09-20T19:07:09,Bilbao,expenses,gifts,-695.33,-38281.95
buyer_8,Antonio,,ES08209544318428491961,TRX_N-01111-05679391,2024-09-21T19:22:31,Labastida,expenses,cash,-100.0,-38381.95
buyer_8,Antonio,,ES08209544318428491961,TRX_N-01112-74740285,2024-09-23T20:38:26,Labastida,expenses,appliances,-140.11,-38522.06
buyer_8,Antonio,,ES08209544318428491961,TRX_N-01113-95828682,2024-09-25T20:59:10,Labastida,expenses,food,-81.16,-38603.22
buyer_8,Antonio,,ES08209544318428491961,TRX_N-01114-55641110,2024-09-27T11:14:31,Labastida,expenses,leisure,-68.89,-38672.11
buyer_8,Antonio,,ES08209544318428491961,TRX_N-01115-29031483,2024-09-28T16:26:51,Labastida,expenses,transport,-70.89,-38743.0
buyer_8,Antonio,,ES08209544318428491961,TRX_N-01116-53956570,2024-09-30T13:55:13,Labastida,expenses,transport,-79.28,-38822.28
buyer_8,Antonio,,ES08209544318428491961,TRX_N-01117-38295407,2024-10-01T14:04:08,Labastida,incomes,salary,3415.92,-35406.36
buyer_8,Antonio,,ES08209544318428491961,TRX_N-01118-92110081,2024-10-04T13:32:54,Labastida,expenses,mortgage,-1053.21,-36459.57
buyer_8,Antonio,,ES08209544318428491961,TRX_N-01119-43222285,2024-10-04T16:16:56,Labastida,expenses,food,-109.67,-36569.24
buyer_8,Antonio,,ES08209544318428491961,TRX_N-01120-52038270,2024-10-04T12:31:26,Labastida,expenses,repairs,-215.85,-36785.09
buyer_8,Antonio,,ES08209544318428491961,TRX_N-01121-55062437,2024-10-05T01:32:40,Labastida,expenses,internet,-42.0,-36827.09
buyer_8,Antonio,,ES08209544318428491961,TRX_N-01122-43719965,2024-10-05T14:44:42,Labastida,expenses,transport,-59.89,-36886.98
buyer_8,Antonio,,ES08209544318428491961,TRX_N-01123-08083328,2024-10-05T22:19:12,Labastida,expenses,cash,-100.0,-36986.98
buyer_8,Antonio,,ES08209544318428491961,TRX_N-01124-47033354,2024-10-07T12:12:15,Labastida,expenses,leisure,-20.15,-37007.13
buyer_8,Antonio,,ES08209544318428491961,TRX_N-01125-81546048,2024-10-08T14:46:38,Labastida,expenses,water,-25.65,-37032.78
buyer_8,Antonio,,ES08209544318428491961,TRX_N-01126-60713932,2024-10-08T07:20:32,Labastida,expenses,electricity,-29.61,-37062.39
buyer_8,Antonio,,ES08209544318428491961,TRX_N-01127-37492912,2024-10-08T15:40:52,Labastida,expenses,gas,-77.55,-37139.94
buyer_8,Antonio,,ES08209544318428491961,TRX_N-01128-63008388,2024-10-08T03:52:03,Labastida,expenses,phone,-31.92,-37171.86
buyer_8,Antonio,,ES08209544318428491961,TRX_N-01129-87638830,2024-10-09T23:09:35,Labastida,expenses,food,-78.34,-37250.2
buyer_8,Antonio,,ES08209544318428491961,TRX_N-01130-70090653,2024-10-09T11:53:56,Labastida,expenses,cash,-100.0,-37350.2
