profile,name,age,iban,trx_id,timestamp,city,transaction_type,transaction_category,amount_eur,balance
buyer_1,Luis,28,ES71209537463196387848,TRX_N-1-524092032954,2020-01-01T15:35:12,Bilbao,transfer,Salary,1039.38,1213.47
buyer_1,Luis,28,ES71209537463196387848,TRX_N-10-688500303960,2020-01-14T13:42:02,Errenteria,Expense,transport,-180.52,-341.09
buyer_1,Luis,28,ES71209537463196387848,TRX_N-100-827801211940,2020-09-01T21:48:55,Bilbao,transfer,Salary,1039.38,-7827.35
buyer_1,Luis,28,ES71209537463196387848,TRX_N-101-313120300264,2020-09-04T09:58:51,Bilbao,Expense,food,-664.94,-8492.29
buyer_1,Luis,28,ES71209537463196387848,TRX_N-102-226303058256,2020-09-05T14:28:11,Bilbao,Housing,Rent,-607.32,-9099.61
buyer_1,Luis,28,ES71209537463196387848,TRX_N-103-283475269794,2020-09-05T11:22:06,Bilbao,Basic services,internet,-48.75,-9148.36
buyer_1,Luis,28,ES71209537463196387848,TRX_N-104-109768556094,2020-09-06T02:36:15,Bilbao,Basic services,water,-50.0,-9198.36
buyer_1,Luis,28,ES71209537463196387848,TRX_N-105-830676605938,2020-09-06T13:09:57,Bilbao,Basic services,phone,-32.77,-9231.13
buyer_1,Luis,28,ES71209537463196387848,TRX_N-106-929130152919,2020-09-07T14:55:19,Bilbao,Basic services,water,-65.58,-9296.71
buyer_1,Luis,28,ES71209537463196387848,TRX_N-107-917608508711,2020-09-07T13:44:44,Bilbao,Basic services,electricity,-40.36,-9337.07
buyer_1,Luis,28,ES71209537463196387848,TRX_N-108-542954983461,2020-09-18T12:15:26,Llodio,Expense,leisure,-19.4,-9356.47
buyer_1,Luis,28,ES71209537463196387848,TRX_N-109-78295943787,2020-09-28T14:01:23,Bilbao,Expense,healthcare,-38.84,-9395.31
buyer_1,Luis,28,ES71209537463196387848,TRX_N-11-495502257006,2020-01-18T15:32:44,Zarautz,Expense,appliances,-103.33,-444.42
buyer_1,Luis,28,ES71209537463196387848,TRX_N-110-45399981222,2020-10-01T17:30:01,Bilbao,transfer,Salary,1039.38,-8355.93
buyer_1,Luis,28,ES71209537463196387848,TRX_N-111-957026790053,2020-10-01T17:30:01,Bilbao,transfer,Extra Income,103.94,-8251.99
buyer_1,Luis,28,ES71209537463196387848,TRX_N-112-127794554602,2020-10-05T22:22:11,Bilbao,Housing,Rent,-607.32,-8859.31
buyer_1,Luis,28,ES71209537463196387848,TRX_N-113-776297715210,2020-10-06T18:28:41,Bilbao,Basic services,water,-69.42,-8928.73
buyer_1,Luis,28,ES71209537463196387848,TRX_N-114-211301597822,2020-10-06T19:42:16,Bilbao,Basic services,electricity,-78.58,-9007.31
buyer_1,Luis,28,ES71209537463196387848,TRX_N-115-793978385909,2020-10-06T18:58:29,Bilbao,Basic services,gas,-26.63,-9033.94
buyer_1,Luis,28,ES71209537463196387848,TRX_N-116-218450421070,2020-10-07T09:26:34,Bilbao,Basic services,water,-58.3,-9092.24
buyer_1,Luis,28,ES71209537463196387848,TRX_N-117-904279035651,2020-10-21T11:20:17,Bilbao,Expense,food,-772.66,-9864.9
buyer_1,Luis,28,ES71209537463196387848,TRX_N-118-257093807335,2020-10-23T18:13:06,Bilbao,Expense,food,-798.65,-10663.55
buyer_1,Luis,28,ES71209537463196387848,TRX_N-119-973194519088,2020-11-01T09:50:56,Bilbao,transfer,Salary,1039.38,-9624.17
buyer_1,Luis,28,ES71209537463196387848,TRX_N-12-92078375105,2020-01-26T13:22:29,Bilbao,Expense,food,-305.63,-750.05
buyer_1,Luis,28,ES71209537463196387848,TRX_N-120-160071672036,2020-11-01T20:57:43,Bilbao,Expense,leisure,-17.12,-9641.29
buyer_1,Luis,28,ES71209537463196387848,TRX_N-121-876574204436,2020-11-05T08:02:33,Bilbao,Housing,Rent,-607.32,-10248.61
buyer_1,Luis,28,ES71209537463196387848,TRX_N-122-154361119039,2020-11-05T10:11:47,Bilbao,Basic services,electricity,-24.79,-10273.4
buyer_1,Luis,28,ES71209537463196387848,TRX_N-123-458921008783,2020-11-05T22:33:07,Bilbao,Basic services,internet,-77.54,-10350.94
buyer_1,Luis,28,ES71209537463196387848,TRX_N-124-282649991409,2020-11-06T19:10:19,Bilbao,Basic services,water,-76.43,-10427.37
buyer_1,Luis,28,ES71209537463196387848,TRX_N-125-52021536468,2020-11-06T09:45:33,Bilbao,Basic services,electricity,-116.96,-10544.33
buyer_1,Luis,28,ES71209537463196387848,TRX_N-126-591418542222,2020-11-06T11:16:21,Bilbao,Basic services,gas,-35.24,-10579.57
buyer_1,Luis,28,ES71209537463196387848,TRX_N-127-489001310579,2020-11-07T09:08:43,Bilbao,Basic services,gas,-83.06,-10662.63
buyer_1,Luis,28,ES71209537463196387848,TRX_N-128-952989292358,2020-11-07T13:48:49,Bilbao,Basic services,phone,-41.69,-10704.32
buyer_1,Luis,28,ES71209537463196387848,TRX_N-129-327490824823,2020-11-13T09:35:48,Bilbao,Expense,transport,-143.78,-10848.1
buyer_1,Luis,28,ES71209537463196387848,TRX_N-13-688961365180,2020-01-26T16:01:22,Bilbao,Expense,transport,-29.67,-779.72
buyer_1,Luis,28,ES71209537463196387848,TRX_N-130-976017258449,2020-11-19T18:38:23,Bilbao,Expense,leisure,-226.67,-11074.77
buyer_1,Luis,28,ES71209537463196387848,TRX_N-131-721864635440,2020-11-21T12:17:16,Bilbao,Expense,leisure,-24.0,-11098.77
buyer_1,Luis,28,ES71209537463196387848,TRX_N-132-690040895979,2020-12-01T11:20:35,Bilbao,transfer,Salary,1039.38,-10059.39
buyer_1,Luis,28,ES71209537463196387848,TRX_N-133-80638424145,2020-12-01T11:20:35,Bilbao,transfer,Extra Income,103.94,-9955.45
buyer_1,Luis,28,ES71209537463196387848,TRX_N-134-493097499207,2020-12-01T11:20:35,Bilbao,transfer,Bonus,989.45,-8966.0
buyer_1,Luis,28,ES71209537463196387848,TRX_N-135-395646050106,2020-12-05T15:33:05,Bilbao,Housing,Rent,-607.32,-9573.32
buyer_1,Luis,28,ES71209537463196387848,TRX_N-136-641640181977,2020-12-05T00:54:11,Bilbao,Basic services,water,-48.45,-9621.77
buyer_1,Luis,28,ES71209537463196387848,TRX_N-137-507654511239,2020-12-05T12:26:47,Bilbao,Basic services,electricity,-67.31,-9689.08
buyer_1,Luis,28,ES71209537463196387848,TRX_N-138-578271101963,2020-12-06T15:44:41,Bilbao,Basic services,water,-55.29,-9744.37
buyer_1,Luis,28,ES71209537463196387848,TRX_N-139-852575512267,2020-12-06T10:15:02,Pasaia,Expense,food,-131.21,-9875.58
buyer_1,Luis,28,ES71209537463196387848,TRX_N-14-742048397369,2020-02-01T20:07:31,Bilbao,transfer,Salary,1039.38,259.66
buyer_1,Luis,28,ES71209537463196387848,TRX_N-140-889980823118,2020-12-06T20:13:30,Bilbao,Expense,leisure,-239.87,-10115.45
buyer_1,Luis,28,ES71209537463196387848,TRX_N-141-27073105793,2020-12-07T21:17:47,Bilbao,Basic services,water,-63.31,-10178.76
buyer_1,Luis,28,ES71209537463196387848,TRX_N-142-569672287627,2020-12-07T09:42:55,Bilbao,Basic services,gas,-19.97,-10198.73
buyer_1,Luis,28,ES71209537463196387848,TRX_N-143-564784598632,2020-12-07T09:11:37,Bilbao,Expense,healthcare,-88.05,-10286.78
buyer_1,Luis,28,ES71209537463196387848,TRX_N-144-297316871231,2020-12-07T11:42:01,Bilbao,Expense,repairs,-728.28,-11015.06
buyer_1,Luis,28,ES71209537463196387848,TRX_N-145-310611268854,2020-12-08T19:22:33,Bilbao,Expense,leisure,-88.13,-11103.19
buyer_1,Luis,28,ES71209537463196387848,TRX_N-146-802694800498,2020-12-10T13:43:04,Bilbao,Expense,transport,-113.75,-11216.94
buyer_1,Luis,28,ES71209537463196387848,TRX_N-147-917832922527,2020-12-27T15:28:01,Bilbao,Expense,food,-515.51,-11732.45
buyer_1,Luis,28,ES71209537463196387848,TRX_N-148-799341891275,2021-01-01T23:14:41,Bilbao,transfer,Salary,1039.38,-10693.07
buyer_1,Luis,28,ES71209537463196387848,TRX_N-149-476830278589,2021-01-03T20:25:48,Bilbao,Expense,transport,-69.09,-10762.16
buyer_1,Luis,28,ES71209537463196387848,TRX_N-15-498962593299,2020-02-01T20:07:31,Bilbao,transfer,Extra Income,103.94,363.6
buyer_1,Luis,28,ES71209537463196387848,TRX_N-150-289701556423,2021-01-05T13:15:58,Bilbao,Housing,Rent,-607.32,-11369.48
buyer_1,Luis,28,ES71209537463196387848,TRX_N-151-944830438535,2021-01-05T14:20:44,Bilbao,Basic services,electricity,-98.21,-11467.69
buyer_1,Luis,28,ES71209537463196387848,TRX_N-152-894229292161,2021-01-05T14:14:25,Bilbao,Basic services,gas,-30.54,-11498.23
buyer_1,Luis,28,ES71209537463196387848,TRX_N-153-876669370862,2021-01-05T14:42:01,Bilbao,Basic services,phone,-42.29,-11540.52
buyer_1,Luis,28,ES71209537463196387848,TRX_N-154-697648504998,2021-01-06T09:13:59,Bilbao,Basic services,water,-60.88,-11601.4
buyer_1,Luis,28,ES71209537463196387848,TRX_N-155-565052574712,2021-01-06T19:01:28,Bilbao,Basic services,phone,-75.61,-11677.01
buyer_1,Luis,28,ES71209537463196387848,TRX_N-156-654572492372,2021-01-07T23:27:19,Bilbao,Basic services,gas,-36.6,-11713.61
buyer_1,Luis,28,ES71209537463196387848,TRX_N-157-703385328474,2021-01-07T20:48:29,Bilbao,Basic services,internet,-52.95,-11766.56
buyer_1,Luis,28,ES71209537463196387848,TRX_N-158-964533611561,2021-01-14T16:36:07,Bilbao,Expense,food,-137.02,-11903.58
buyer_1,Luis,28,ES71209537463196387848,TRX_N-159-681605922278,2021-01-16T20:52:04,Bilbao,Expense,clothing,-214.82,-12118.4
buyer_1,Luis,28,ES71209537463196387848,TRX_N-16-810698048398,2020-02-02T09:54:33,Bilbao,Expense,clothing,-78.68,284.92
buyer_1,Luis,28,ES71209537463196387848,TRX_N-160-431466585950,2021-01-17T20:40:28,Sopela,Expense,education,-759.07,-12877.47
buyer_1,Luis,28,ES71209537463196387848,TRX_N-161-362950539734,2021-01-19T15:14:10,Bilbao,Expense,food,-534.77,-13412.24
buyer_1,Luis,28,ES71209537463196387848,TRX_N-162-666882826767,2021-02-01T17:06:52,Bilbao,transfer,Salary,1039.38,-12372.86
buyer_1,Luis,28,ES71209537463196387848,TRX_N-163-25950540604,2021-02-03T19:16:05,Bilbao,Expense,transport,-28.48,-12401.34
buyer_1,Luis,28,ES71209537463196387848,TRX_N-164-201637769661,2021-02-05T01:39:25,Bilbao,Housing,Rent,-607.32,-13008.66
buyer_1,Luis,28,ES71209537463196387848,TRX_N-165-586724828338,2021-02-05T02:23:41,Bilbao,Basic services,water,-62.38,-13071.04
buyer_1,Luis,28,ES71209537463196387848,TRX_N-166-725269679940,2021-02-05T22:27:23,Bilbao,Basic services,gas,-15.49,-13086.53
buyer_1,Luis,28,ES71209537463196387848,TRX_N-167-670427105709,2021-02-05T09:04:41,Bilbao,Basic services,phone,-37.77,-13124.3
buyer_1,Luis,28,ES71209537463196387848,TRX_N-168-647356896432,2021-02-06T10:22:18,Bilbao,Basic services,water,-52.18,-13176.48
buyer_1,Luis,28,ES71209537463196387848,TRX_N-169-279572504155,2021-02-06T19:56:55,Bilbao,Basic services,gas,-27.33,-13203.81
buyer_1,Luis,28,ES71209537463196387848,TRX_N-17-567069843939,2020-02-05T10:32:29,Bilbao,Housing,Rent,-607.32,-322.4
buyer_1,Luis,28,ES71209537463196387848,TRX_N-170-698545468660,2021-02-07T16:57:37,Bilbao,Basic services,electricity,-52.99,-13256.8
buyer_1,Luis,28,ES71209537463196387848,TRX_N-171-884779600436,2021-02-07T12:07:14,Bilbao,Basic services,internet,-66.2,-13323.0
buyer_1,Luis,28,ES71209537463196387848,TRX_N-172-956107353528,2021-02-07T20:51:25,Bilbao,Basic services,phone,-74.67,-13397.67
buyer_1,Luis,28,ES71209537463196387848,TRX_N-173-118439946125,2021-02-18T06:04:08,Bilbao,Expense,leisure,-224.15,-13621.82
buyer_1,Luis,28,ES71209537463196387848,TRX_N-174-173717389737,2021-03-01T17:12:29,Bilbao,transfer,Salary,1039.38,-12582.44
buyer_1,Luis,28,ES71209537463196387848,TRX_N-175-983453174273,2021-03-01T17:12:29,Bilbao,transfer,Extra Income,103.94,-12478.5
buyer_1,Luis,28,ES71209537463196387848,TRX_N-176-201744918218,2021-03-05T20:36:39,Bilbao,Housing,Rent,-607.32,-13085.82
buyer_1,Luis,28,ES71209537463196387848,TRX_N-177-457330220242,2021-03-05T14:10:57,Bilbao,Basic services,electricity,-101.42,-13187.24
buyer_1,Luis,28,ES71209537463196387848,TRX_N-178-662046341401,2021-03-06T16:55:10,Bilbao,Basic services,gas,-83.22,-13270.46
buyer_1,Luis,28,ES71209537463196387848,TRX_N-179-7781954813,2021-03-21T17:23:38,Bilbao,Expense,education,-425.74,-13696.2
buyer_1,Luis,28,ES71209537463196387848,TRX_N-18-632692132223,2020-02-05T18:59:13,Bilbao,Basic services,water,-58.74,-381.14
buyer_1,Luis,28,ES71209537463196387848,TRX_N-180-202532550065,2021-03-25T12:22:41,Bilbao,Expense,leisure,-82.23,-13778.43
buyer_1,Luis,28,ES71209537463196387848,TRX_N-181-475383630310,2021-04-01T12:26:23,Bilbao,transfer,Salary,1039.38,-12739.05
buyer_1,Luis,28,ES71209537463196387848,TRX_N-182-663450317007,2021-04-05T20:13:57,Bilbao,Housing,Rent,-607.32,-13346.37
buyer_1,Luis,28,ES71209537463196387848,TRX_N-183-602830335373,2021-04-05T19:09:05,Bilbao,Basic services,electricity,-122.87,-13469.24
buyer_1,Luis,28,ES71209537463196387848,TRX_N-184-377878381853,2021-04-05T18:56:12,Bilbao,Basic services,internet,-73.87,-13543.11
buyer_1,Luis,28,ES71209537463196387848,TRX_N-185-955875807004,2021-04-05T16:36:43,Bilbao,Basic services,phone,-96.76,-13639.87
buyer_1,Luis,28,ES71209537463196387848,TRX_N-186-640327954955,2021-04-06T11:22:27,Bilbao,Basic services,electricity,-79.53,-13719.4
buyer_1,Luis,28,ES71209537463196387848,TRX_N-187-870607896472,2021-04-07T18:38:03,Bilbao,Basic services,electricity,-65.72,-13785.12
buyer_1,Luis,28,ES71209537463196387848,TRX_N-188-588581822124,2021-04-08T19:17:08,Erandio,Expense,education,-325.16,-14110.28
buyer_1,Luis,28,ES71209537463196387848,TRX_N-189-224764613512,2021-04-08T09:53:14,Donostia,Expense,repairs,-625.93,-14736.21
buyer_1,Luis,28,ES71209537463196387848,TRX_N-19-390888793873,2020-02-05T07:17:36,Bilbao,Basic services,internet,-53.65,-434.79
buyer_1,Luis,28,ES71209537463196387848,TRX_N-190-127208113791,2021-05-01T17:10:43,Bilbao,transfer,Salary,1039.38,-13696.83
buyer_1,Luis,28,ES71209537463196387848,TRX_N-191-329645054568,2021-05-05T09:01:27,Bilbao,Housing,Rent,-607.32,-14304.15
buyer_1,Luis,28,ES71209537463196387848,TRX_N-192-320138244919,2021-05-06T03:31:43,Bilbao,Basic services,water,-11.99,-14316.14
buyer_1,Luis,28,ES71209537463196387848,TRX_N-193-122023962001,2021-05-06T21:19:46,Bilbao,Basic services,gas,-30.02,-14346.16
buyer_1,Luis,28,ES71209537463196387848,TRX_N-194-851707682915,2021-05-14T05:53:45,Durango,Expense,food,-446.08,-14792.24
buyer_1,Luis,28,ES71209537463196387848,TRX_N-195-328133215510,2021-05-14T05:19:26,Basauri,Expense,education,-997.52,-15789.76
buyer_1,Luis,28,ES71209537463196387848,TRX_N-196-773259230133,2021-05-25T10:27:56,Bilbao,Expense,food,-383.95,-16173.71
buyer_1,Luis,28,ES71209537463196387848,TRX_N-197-620765532766,2021-05-27T19:07:58,Bilbao,Expense,food,-201.62,-16375.33
buyer_1,Luis,28,ES71209537463196387848,TRX_N-198-669733370208,2021-05-27T17:03:29,Bilbao,Expense,clothing,-282.66,-16657.99
buyer_1,Luis,28,ES71209537463196387848,TRX_N-199-782615185105,2021-05-30T20:48:38,Bilbao,Expense,food,-189.07,-16847.06
buyer_1,Luis,28,ES71209537463196387848,TRX_N-2-106111190585,2020-01-01T04:41:55,Bilbao,Expense,food,-353.35,860.12
buyer_1,Luis,28,ES71209537463196387848,TRX_N-20-533007127994,2020-02-05T21:58:17,Bermeo,Expense,leisure,-218.93,-653.72
buyer_1,Luis,28,ES71209537463196387848,TRX_N-200-576310606761,2021-06-01T15:49:23,Bilbao,transfer,Salary,1039.38,-15807.68
buyer_1,Luis,28,ES71209537463196387848,TRX_N-201-282240578354,2021-06-01T15:49:23,Bilbao,transfer,Extra Income,103.94,-15703.74
buyer_1,Luis,28,ES71209537463196387848,TRX_N-202-789348388296,2021-06-01T15:49:23,Bilbao,transfer,Bonus,968.99,-14734.75
buyer_1,Luis,28,ES71209537463196387848,TRX_N-203-862410714697,2021-06-03T20:23:33,Bilbao,Expense,transport,-24.18,-14758.93
buyer_1,Luis,28,ES71209537463196387848,TRX_N-204-232958895058,2021-06-05T19:41:14,Bilbao,Housing,Rent,-607.32,-15366.25
buyer_1,Luis,28,ES71209537463196387848,TRX_N-205-354323479790,2021-06-05T12:07:56,Bilbao,Basic services,electricity,-78.08,-15444.33
buyer_1,Luis,28,ES71209537463196387848,TRX_N-206-395419399258,2021-06-05T20:51:48,Bilbao,Basic services,internet,-35.47,-15479.8
buyer_1,Luis,28,ES71209537463196387848,TRX_N-207-375665003238,2021-06-05T19:03:25,Bilbao,Basic services,phone,-98.43,-15578.23
buyer_1,Luis,28,ES71209537463196387848,TRX_N-208-398985909962,2021-06-06T08:45:58,Bilbao,Basic services,water,-43.73,-15621.96
buyer_1,Luis,28,ES71209537463196387848,TRX_N-209-143462900930,2021-06-06T08:21:06,Bilbao,Basic services,electricity,-44.88,-15666.84
buyer_1,Luis,28,ES71209537463196387848,TRX_N-21-224755754801,2020-02-06T22:06:34,Bilbao,Basic services,gas,-85.97,-739.69
buyer_1,Luis,28,ES71209537463196387848,TRX_N-210-992991924233,2021-06-06T10:57:22,Bilbao,Basic services,gas,-37.99,-15704.83
buyer_1,Luis,28,ES71209537463196387848,TRX_N-211-992600655010,2021-06-07T21:58:21,Bilbao,Basic services,water,-50.9,-15755.73
buyer_1,Luis,28,ES71209537463196387848,TRX_N-212-529414257452,2021-06-07T12:24:07,Bilbao,Basic services,internet,-71.67,-15827.4
buyer_1,Luis,28,ES71209537463196387848,TRX_N-213-306461520804,2021-06-07T10:29:09,Bilbao,Basic services,phone,-62.0,-15889.4
buyer_1,Luis,28,ES71209537463196387848,TRX_N-214-171270262910,2021-06-07T20:17:54,Bilbao,Expense,leisure,-299.86,-16189.26
buyer_1,Luis,28,ES71209537463196387848,TRX_N-215-876702226918,2021-06-11T16:10:01,Bilbao,Expense,appliances,-1557.7,-17746.96
buyer_1,Luis,28,ES71209537463196387848,TRX_N-216-963250267437,2021-06-12T19:28:22,Bilbao,Expense,appliances,-657.92,-18404.88
buyer_1,Luis,28,ES71209537463196387848,TRX_N-217-817376459786,2021-06-15T16:01:19,Bilbao,Expense,clothing,-457.8,-18862.68
buyer_1,Luis,28,ES71209537463196387848,TRX_N-218-367825596356,2021-06-19T08:25:46,Elciego,Expense,clothing,-59.23,-18921.91
buyer_1,Luis,28,ES71209537463196387848,TRX_N-219-674911987802,2021-06-30T10:35:07,Bilbao,Expense,transport,-125.24,-19047.15
buyer_1,Luis,28,ES71209537463196387848,TRX_N-22-257815381536,2020-02-06T19:30:10,Pasaia,Expense,gifts,-43.12,-782.81
buyer_1,Luis,28,ES71209537463196387848,TRX_N-220-560390380276,2021-07-01T04:35:41,Bilbao,transfer,Salary,1039.38,-18007.77
buyer_1,Luis,28,ES71209537463196387848,TRX_N-221-49188590321,2021-07-05T14:25:07,Bilbao,Housing,Rent,-607.32,-18615.09
buyer_1,Luis,28,ES71209537463196387848,TRX_N-222-67099237393,2021-07-05T12:49:07,Bilbao,Basic services,water,-71.95,-18687.04
buyer_1,Luis,28,ES71209537463196387848,TRX_N-223-416166217368,2021-07-05T08:10:45,Bilbao,Basic services,electricity,-20.34,-18707.38
buyer_1,Luis,28,ES71209537463196387848,TRX_N-224-588680016242,2021-07-06T16:00:49,Bilbao,Basic services,water,-47.28,-18754.66
buyer_1,Luis,28,ES71209537463196387848,TRX_N-225-505017080403,2021-07-06T13:16:27,Bilbao,Basic services,internet,-79.69,-18834.35
buyer_1,Luis,28,ES71209537463196387848,TRX_N-226-3375303993,2021-07-14T11:22:16,Bilbao,Expense,food,-204.03,-19038.38
buyer_1,Luis,28,ES71209537463196387848,TRX_N-227-653625343027,2021-07-14T17:11:57,Bilbao,Expense,clothing,-377.44,-19415.82
buyer_1,Luis,28,ES71209537463196387848,TRX_N-228-956070250092,2021-07-25T19:12:52,Bilbao,Expense,transport,-51.58,-19467.4
buyer_1,Luis,28,ES71209537463196387848,TRX_N-229-254271391433,2021-08-01T15:52:23,Bilbao,transfer,Salary,1039.38,-18428.02
buyer_1,Luis,28,ES71209537463196387848,TRX_N-23-476646842148,2020-02-19T15:38:16,Bilbao,Expense,food,-384.15,-1166.96
buyer_1,Luis,28,ES71209537463196387848,TRX_N-230-48615264910,2021-08-05T15:26:42,Bilbao,Housing,Rent,-607.32,-19035.34
buyer_1,Luis,28,ES71209537463196387848,TRX_N-231-908400915896,2021-08-05T03:32:45,Bilbao,Basic services,phone,-82.24,-19117.58
buyer_1,Luis,28,ES71209537463196387848,TRX_N-232-228881450494,2021-08-06T22:08:53,Bilbao,Basic services,internet,-33.52,-19151.1
buyer_1,Luis,28,ES71209537463196387848,TRX_N-233-377697766967,2021-08-07T18:14:30,Bilbao,Basic services,gas,-69.05,-19220.15
buyer_1,Luis,28,ES71209537463196387848,TRX_N-234-556118728454,2021-08-07T16:31:54,Bilbao,Basic services,phone,-70.73,-19290.88
buyer_1,Luis,28,ES71209537463196387848,TRX_N-235-902420857130,2021-08-11T11:16:54,Bilbao,Expense,transport,-99.8,-19390.68
buyer_1,Luis,28,ES71209537463196387848,TRX_N-236-535023235510,2021-08-16T12:44:12,Bilbao,Expense,transport,-94.87,-19485.55
buyer_1,Luis,28,ES71209537463196387848,TRX_N-237-366748309783,2021-08-18T13:09:25,Bilbao,Expense,leisure,-203.53,-19689.08
buyer_1,Luis,28,ES71209537463196387848,TRX_N-238-100964061439,2021-09-01T17:11:25,Bilbao,transfer,Salary,1039.38,-18649.7
buyer_1,Luis,28,ES71209537463196387848,TRX_N-239-901255701023,2021-09-01T17:11:25,Bilbao,transfer,Extra Income,103.94,-18545.76
buyer_1,Luis,28,ES71209537463196387848,TRX_N-24-435578192053,2020-03-01T11:43:37,Bilbao,transfer,Salary,1039.38,-127.58
buyer_1,Luis,28,ES71209537463196387848,TRX_N-240-480945724740,2021-09-05T17:35:52,Bilbao,Housing,Rent,-607.32,-19153.08
buyer_1,Luis,28,ES71209537463196387848,TRX_N-241-137003331992,2021-09-05T20:14:41,Bilbao,Basic services,water,-40.33,-19193.41
buyer_1,Luis,28,ES71209537463196387848,TRX_N-242-30119646904,2021-09-05T17:43:35,Bilbao,Basic services,internet,-49.8,-19243.21
buyer_1,Luis,28,ES71209537463196387848,TRX_N-243-450276242880,2021-09-06T12:37:20,Bilbao,Basic services,gas,-44.92,-19288.13
buyer_1,Luis,28,ES71209537463196387848,TRX_N-244-286614275617,2021-09-06T13:01:12,Bilbao,Basic services,internet,-46.93,-19335.06
buyer_1,Luis,28,ES71209537463196387848,TRX_N-245-194353721201,2021-09-06T23:24:34,Bilbao,Basic services,phone,-40.81,-19375.87
buyer_1,Luis,28,ES71209537463196387848,TRX_N-246-447697548179,2021-09-07T15:20:45,Bilbao,Basic services,water,-25.31,-19401.18
buyer_1,Luis,28,ES71209537463196387848,TRX_N-247-462482077529,2021-09-07T20:01:11,Bilbao,Basic services,internet,-72.59,-19473.77
buyer_1,Luis,28,ES71209537463196387848,TRX_N-248-106141354151,2021-09-07T14:44:46,Bilbao,Basic services,phone,-72.91,-19546.68
buyer_1,Luis,28,ES71209537463196387848,TRX_N-249-643210030544,2021-09-10T04:28:19,Bilbao,Expense,transport,-27.28,-19573.96
buyer_1,Luis,28,ES71209537463196387848,TRX_N-25-513366363179,2020-03-01T13:26:09,Zuia,Expense,food,-103.0,-230.58
buyer_1,Luis,28,ES71209537463196387848,TRX_N-250-345421510730,2021-09-18T05:02:19,Bilbao,Expense,food,-164.47,-19738.43
buyer_1,Luis,28,ES71209537463196387848,TRX_N-251-896055961510,2021-09-24T22:43:18,Bilbao,Expense,clothing,-111.51,-19849.94
buyer_1,Luis,28,ES71209537463196387848,TRX_N-252-79513018511,2021-10-01T12:48:33,Bilbao,transfer,Salary,1039.38,-18810.56
buyer_1,Luis,28,ES71209537463196387848,TRX_N-253-322007557877,2021-10-05T14:08:00,Bilbao,Housing,Rent,-607.32,-19417.88
buyer_1,Luis,28,ES71209537463196387848,TRX_N-254-240545733670,2021-10-05T22:22:19,Bilbao,Basic services,internet,-38.53,-19456.41
buyer_1,Luis,28,ES71209537463196387848,TRX_N-255-631265803132,2021-10-05T10:51:47,Mungia,Expense,food,-569.81,-20026.22
buyer_1,Luis,28,ES71209537463196387848,TRX_N-256-520654282134,2021-10-07T15:10:20,Bilbao,Basic services,water,-36.88,-20063.1
buyer_1,Luis,28,ES71209537463196387848,TRX_N-257-934560103977,2021-10-20T19:39:09,Bilbao,Expense,healthcare,-169.12,-20232.22
buyer_1,Luis,28,ES71209537463196387848,TRX_N-258-397949239923,2021-10-21T11:42:41,Bilbao,Expense,appliances,-398.34,-20630.56
buyer_1,Luis,28,ES71209537463196387848,TRX_N-259-914355603045,2021-10-26T00:30:25,Bilbao,Expense,clothing,-433.7,-21064.26
buyer_1,Luis,28,ES71209537463196387848,TRX_N-26-790535089502,2020-03-01T20:10:52,Bilbao,Expense,transport,-96.24,-326.82
buyer_1,Luis,28,ES71209537463196387848,TRX_N-260-275825467988,2021-11-01T20:44:26,Bilbao,transfer,Salary,1039.38,-20024.88
buyer_1,Luis,28,ES71209537463196387848,TRX_N-261-963907684351,2021-11-03T12:41:36,Bilbao,Expense,transport,-52.78,-20077.66
buyer_1,Luis,28,ES71209537463196387848,TRX_N-262-920591511832,2021-11-05T09:02:05,Bilbao,Housing,Rent,-607.32,-20684.98
buyer_1,Luis,28,ES71209537463196387848,TRX_N-263-694170682146,2021-11-05T21:59:33,Bilbao,Basic services,internet,-47.73,-20732.71
buyer_1,Luis,28,ES71209537463196387848,TRX_N-264-32527732737,2021-11-05T10:18:44,Bilbao,Basic services,phone,-58.99,-20791.7
buyer_1,Luis,28,ES71209537463196387848,TRX_N-265-996725555302,2021-11-06T16:44:40,Bilbao,Basic services,electricity,-57.23,-20848.93
buyer_1,Luis,28,ES71209537463196387848,TRX_N-266-597312849156,2021-11-07T12:47:04,Bilbao,Basic services,water,-21.03,-20869.96
buyer_1,Luis,28,ES71209537463196387848,TRX_N-267-562140842277,2021-11-07T14:25:30,Bilbao,Basic services,electricity,-120.4,-20990.36
buyer_1,Luis,28,ES71209537463196387848,TRX_N-268-657012115850,2021-11-09T14:19:29,Basauri,Expense,healthcare,-399.13,-21389.49
buyer_1,Luis,28,ES71209537463196387848,TRX_N-269-227795850492,2021-11-11T16:03:36,Bilbao,Expense,food,-320.54,-21710.03
buyer_1,Luis,28,ES71209537463196387848,TRX_N-27-19811391357,2020-03-02T19:56:46,Bilbao,Expense,clothing,-292.93,-619.75
buyer_1,Luis,28,ES71209537463196387848,TRX_N-270-425067646855,2021-11-12T12:17:52,Bilbao,Expense,food,-512.12,-22222.15
buyer_1,Luis,28,ES71209537463196387848,TRX_N-271-380213938672,2021-11-17T20:25:49,Bilbao,Expense,food,-644.79,-22866.94
buyer_1,Luis,28,ES71209537463196387848,TRX_N-272-551893707283,2021-11-26T15:08:20,Bilbao,Expense,food,-365.58,-23232.52
buyer_1,Luis,28,ES71209537463196387848,TRX_N-273-232721390077,2021-12-01T17:50:32,Bilbao,transfer,Salary,1039.38,-22193.14
buyer_1,Luis,28,ES71209537463196387848,TRX_N-274-276275567227,2021-12-01T17:50:32,Bilbao,transfer,Extra Income,103.94,-22089.2
buyer_1,Luis,28,ES71209537463196387848,TRX_N-275-872894285428,2021-12-01T17:50:32,Bilbao,transfer,Bonus,1027.61,-21061.59
buyer_1,Luis,28,ES71209537463196387848,TRX_N-276-829235375818,2021-12-05T19:07:17,Bilbao,Housing,Rent,-607.32,-21668.91
buyer_1,Luis,28,ES71209537463196387848,TRX_N-277-502279471904,2021-12-05T16:07:04,Bilbao,Basic services,internet,-47.61,-21716.52
buyer_1,Luis,28,ES71209537463196387848,TRX_N-278-984264457928,2021-12-05T23:00:07,Bilbao,Expense,food,-295.5,-22012.02
buyer_1,Luis,28,ES71209537463196387848,TRX_N-279-547436492870,2021-12-06T08:47:58,Bilbao,Basic services,gas,-82.7,-22094.72
buyer_1,Luis,28,ES71209537463196387848,TRX_N-28-528195281451,2020-03-05T19:05:49,Bilbao,Housing,Rent,-607.32,-1227.07
buyer_1,Luis,28,ES71209537463196387848,TRX_N-280-728604859102,2021-12-07T18:39:34,Bilbao,Basic services,electricity,-57.41,-22152.13
buyer_1,Luis,28,ES71209537463196387848,TRX_N-281-828360795491,2021-12-13T07:03:47,Irun,Expense,transport,-131.85,-22283.98
buyer_1,Luis,28,ES71209537463196387848,TRX_N-282-976183393121,2021-12-31T19:51:04,Bilbao,Expense,leisure,-126.33,-22410.31
buyer_1,Luis,28,ES71209537463196387848,TRX_N-283-96454668436,2022-01-01T15:46:16,Bilbao,transfer,Salary,1039.38,-21370.93
buyer_1,Luis,28,ES71209537463196387848,TRX_N-284-916131237191,2022-01-03T18:45:13,Bilbao,Expense,repairs,-794.48,-22165.41
buyer_1,Luis,28,ES71209537463196387848,TRX_N-285-960339586969,2022-01-05T08:08:25,Bilbao,Housing,Rent,-607.32,-22772.73
buyer_1,Luis,28,ES71209537463196387848,TRX_N-286-170640845578,2022-01-05T02:57:41,Bilbao,Basic services,electricity,-51.7,-22824.43
buyer_1,Luis,28,ES71209537463196387848,TRX_N-287-539655992434,2022-01-05T12:00:26,Bilbao,Basic services,gas,-83.01,-22907.44
buyer_1,Luis,28,ES71209537463196387848,TRX_N-288-651672434867,2022-01-05T08:22:20,Bilbao,Basic services,internet,-77.22,-22984.66
buyer_1,Luis,28,ES71209537463196387848,TRX_N-289-982897551532,2022-01-05T04:44:02,Bilbao,Basic services,phone,-54.0,-23038.66
buyer_1,Luis,28,ES71209537463196387848,TRX_N-29-149558025970,2020-03-05T09:06:52,Bilbao,Basic services,phone,-66.62,-1293.69
buyer_1,Luis,28,ES71209537463196387848,TRX_N-290-716541797402,2022-01-06T14:27:53,Bilbao,Basic services,phone,-75.71,-23114.37
buyer_1,Luis,28,ES71209537463196387848,TRX_N-291-609202468308,2022-01-07T11:28:16,Bilbao,Basic services,water,-21.07,-23135.44
buyer_1,Luis,28,ES71209537463196387848,TRX_N-292-548110689807,2022-01-07T17:03:35,Bilbao,Basic services,electricity,-70.15,-23205.59
buyer_1,Luis,28,ES71209537463196387848,TRX_N-293-942232756692,2022-01-16T08:01:05,Bilbao,Expense,food,-731.53,-23937.12
buyer_1,Luis,28,ES71209537463196387848,TRX_N-294-314204587475,2022-01-20T15:08:37,Bilbao,Expense,leisure,-279.28,-24216.4
buyer_1,Luis,28,ES71209537463196387848,TRX_N-295-860427433480,2022-01-24T17:57:29,Basauri,Expense,education,-627.86,-24844.26
buyer_1,Luis,28,ES71209537463196387848,TRX_N-296-35126090792,2022-02-01T19:20:17,Bilbao,transfer,Salary,1039.38,-23804.88
buyer_1,Luis,28,ES71209537463196387848,TRX_N-297-353551002719,2022-02-05T10:06:37,Bilbao,Housing,Rent,-607.32,-24412.2
buyer_1,Luis,28,ES71209537463196387848,TRX_N-298-37203958697,2022-02-05T20:59:15,Bilbao,Basic services,electricity,-36.17,-24448.37
buyer_1,Luis,28,ES71209537463196387848,TRX_N-299-115849632956,2022-02-05T14:11:00,Alegría-Dulantzi,Expense,transport,-23.85,-24472.22
buyer_1,Luis,28,ES71209537463196387848,TRX_N-3-473571318952,2020-01-05T17:32:25,Bilbao,Housing,Rent,-607.32,252.8
buyer_1,Luis,28,ES71209537463196387848,TRX_N-30-908753606199,2020-03-06T10:32:07,Bilbao,Basic services,gas,-71.38,-1365.07
buyer_1,Luis,28,ES71209537463196387848,TRX_N-300-193061983727,2022-02-06T11:15:50,Bilbao,Basic services,water,-62.43,-24534.65
buyer_1,Luis,28,ES71209537463196387848,TRX_N-301-252581234383,2022-02-06T08:07:14,Bilbao,Basic services,internet,-77.37,-24612.02
buyer_1,Luis,28,ES71209537463196387848,TRX_N-302-533718701142,2022-02-07T17:54:25,Bilbao,Basic services,water,-58.62,-24670.64
buyer_1,Luis,28,ES71209537463196387848,TRX_N-303-729464424817,2022-02-07T10:00:09,Bilbao,Basic services,gas,-29.87,-24700.51
buyer_1,Luis,28,ES71209537463196387848,TRX_N-304-431080107680,2022-02-07T10:10:19,Bilbao,Basic services,phone,-48.65,-24749.16
buyer_1,Luis,28,ES71209537463196387848,TRX_N-305-480898013942,2022-02-07T20:01:51,Bilbao,Expense,leisure,-269.54,-25018.7
buyer_1,Luis,28,ES71209537463196387848,TRX_N-306-690798411313,2022-02-10T12:51:33,Bilbao,Expense,transport,-124.54,-25143.24
buyer_1,Luis,28,ES71209537463196387848,TRX_N-307-286946367270,2022-02-19T17:28:32,Bilbao,Expense,repairs,-594.99,-25738.23
buyer_1,Luis,28,ES71209537463196387848,TRX_N-308-39733660555,2022-02-20T09:10:15,Bilbao,Expense,food,-303.91,-26042.14
buyer_1,Luis,28,ES71209537463196387848,TRX_N-309-141646496220,2022-03-01T22:33:50,Bilbao,transfer,Salary,1039.38,-25002.76
buyer_1,Luis,28,ES71209537463196387848,TRX_N-31-942888211277,2020-03-06T13:15:54,Bilbao,Basic services,internet,-79.5,-1444.57
buyer_1,Luis,28,ES71209537463196387848,TRX_N-310-408925781003,2022-03-01T22:33:50,Bilbao,transfer,Extra Income,103.94,-24898.82
buyer_1,Luis,28,ES71209537463196387848,TRX_N-311-688356790988,2022-03-05T17:58:01,Bilbao,Housing,Rent,-607.32,-25506.14
buyer_1,Luis,28,ES71209537463196387848,TRX_N-312-58629816742,2022-03-05T03:43:32,Bilbao,Basic services,internet,-53.78,-25559.92
buyer_1,Luis,28,ES71209537463196387848,TRX_N-313-362707208419,2022-03-05T10:38:20,Bilbao,Basic services,phone,-69.78,-25629.7
buyer_1,Luis,28,ES71209537463196387848,TRX_N-314-783241174616,2022-03-06T18:38:54,Bilbao,Basic services,water,-51.95,-25681.65
buyer_1,Luis,28,ES71209537463196387848,TRX_N-315-467337814866,2022-03-06T15:40:12,Bilbao,Basic services,electricity,-133.83,-25815.48
buyer_1,Luis,28,ES71209537463196387848,TRX_N-316-156787928517,2022-03-06T22:32:20,Bilbao,Basic services,phone,-39.5,-25854.98
buyer_1,Luis,28,ES71209537463196387848,TRX_N-317-204474389420,2022-03-07T08:32:47,Bilbao,Basic services,water,-59.54,-25914.52
buyer_1,Luis,28,ES71209537463196387848,TRX_N-318-504604504697,2022-03-07T14:48:46,Bilbao,Basic services,electricity,-114.36,-26028.88
buyer_1,Luis,28,ES71209537463196387848,TRX_N-319-99551525356,2022-03-11T05:39:17,Bilbao,Expense,transport,-42.36,-26071.24
buyer_1,Luis,28,ES71209537463196387848,TRX_N-32-190483076519,2020-03-26T22:37:21,Salvatierra/Agurain,Expense,transport,-140.61,-1585.18
buyer_1,Luis,28,ES71209537463196387848,TRX_N-320-407689772160,2022-03-20T16:51:30,Bilbao,Expense,food,-506.66,-26577.9
buyer_1,Luis,28,ES71209537463196387848,TRX_N-321-860577999085,2022-03-26T18:50:28,Bilbao,Expense,repairs,-353.06,-26930.96
buyer_1,Luis,28,ES71209537463196387848,TRX_N-322-520583185303,2022-03-28T18:59:18,Bilbao,Expense,travel,-1603.31,-28534.27
buyer_1,Luis,28,ES71209537463196387848,TRX_N-323-514386985359,2022-03-30T10:32:03,Elciego,Expense,food,-152.39,-28686.66
buyer_1,Luis,28,ES71209537463196387848,TRX_N-324-395377078239,2022-03-30T13:37:02,Bilbao,Expense,transport,-20.3,-28706.96
buyer_1,Luis,28,ES71209537463196387848,TRX_N-325-270958235907,2022-04-01T16:34:08,Bilbao,transfer,Salary,1039.38,-27667.58
buyer_1,Luis,28,ES71209537463196387848,TRX_N-326-524425389698,2022-04-05T16:13:42,Bilbao,Housing,Rent,-607.32,-28274.9
buyer_1,Luis,28,ES71209537463196387848,TRX_N-327-534585000431,2022-04-05T20:23:44,Bilbao,Basic services,water,-58.01,-28332.91
buyer_1,Luis,28,ES71209537463196387848,TRX_N-328-15336514695,2022-04-05T12:59:39,Bilbao,Basic services,electricity,-51.61,-28384.52
buyer_1,Luis,28,ES71209537463196387848,TRX_N-329-229758148447,2022-04-06T23:01:59,Bilbao,Basic services,electricity,-32.88,-28417.4
buyer_1,Luis,28,ES71209537463196387848,TRX_N-33-789375349125,2020-03-26T10:12:21,Bilbao,Expense,education,-909.6,-2494.78
buyer_1,Luis,28,ES71209537463196387848,TRX_N-330-101565222140,2022-04-07T13:21:01,Barakaldo,Expense,clothing,-330.01,-28747.41
buyer_1,Luis,28,ES71209537463196387848,TRX_N-331-297642308866,2022-04-21T08:34:56,Bilbao,Expense,education,-85.22,-28832.63
buyer_1,Luis,28,ES71209537463196387848,TRX_N-332-809126558583,2022-04-23T12:56:50,Bilbao,Expense,food,-511.18,-29343.81
buyer_1,Luis,28,ES71209537463196387848,TRX_N-333-460202519497,2022-04-28T17:45:08,Bilbao,Expense,transport,-169.09,-29512.9
buyer_1,Luis,28,ES71209537463196387848,TRX_N-334-407088238787,2022-04-28T20:57:22,Bilbao,Expense,healthcare,-60.31,-29573.21
buyer_1,Luis,28,ES71209537463196387848,TRX_N-335-672768193759,2022-05-01T22:11:50,Bilbao,transfer,Salary,1039.38,-28533.83
buyer_1,Luis,28,ES71209537463196387848,TRX_N-336-387128276161,2022-05-03T11:47:33,Galdakao,Expense,transport,-143.56,-28677.39
buyer_1,Luis,28,ES71209537463196387848,TRX_N-337-631984935491,2022-05-05T11:26:50,Bilbao,Housing,Rent,-607.32,-29284.71
buyer_1,Luis,28,ES71209537463196387848,TRX_N-338-685263512704,2022-05-05T21:40:54,Bilbao,Basic services,electricity,-43.92,-29328.63
buyer_1,Luis,28,ES71209537463196387848,TRX_N-339-163188096235,2022-05-05T14:45:53,Bilbao,Basic services,internet,-51.57,-29380.2
buyer_1,Luis,28,ES71209537463196387848,TRX_N-34-288882602208,2020-03-29T20:56:23,Bilbao,Expense,gifts,-270.29,-2765.07
buyer_1,Luis,28,ES71209537463196387848,TRX_N-340-786310616526,2022-05-05T12:57:20,Bilbao,Basic services,phone,-28.12,-29408.32
buyer_1,Luis,28,ES71209537463196387848,TRX_N-341-499344122814,2022-05-05T11:30:03,Bilbao,Expense,transport,-188.85,-29597.17
buyer_1,Luis,28,ES71209537463196387848,TRX_N-342-541723792418,2022-05-06T08:02:28,Bilbao,Basic services,water,-37.05,-29634.22
buyer_1,Luis,28,ES71209537463196387848,TRX_N-343-582144427900,2022-05-06T23:50:42,Bilbao,Basic services,internet,-60.57,-29694.79
buyer_1,Luis,28,ES71209537463196387848,TRX_N-344-272456572650,2022-05-06T12:11:48,Bilbao,Expense,repairs,-578.19,-30272.98
buyer_1,Luis,28,ES71209537463196387848,TRX_N-345-252478916172,2022-05-07T15:16:04,Bilbao,Basic services,phone,-94.18,-30367.16
buyer_1,Luis,28,ES71209537463196387848,TRX_N-346-562260411774,2022-05-09T17:22:23,Bilbao,Expense,food,-768.98,-31136.14
buyer_1,Luis,28,ES71209537463196387848,TRX_N-347-623847722829,2022-05-23T12:48:02,Bilbao,Expense,leisure,-134.5,-31270.64
buyer_1,Luis,28,ES71209537463196387848,TRX_N-348-639255288904,2022-06-01T08:16:43,Bilbao,transfer,Salary,1039.38,-30231.26
buyer_1,Luis,28,ES71209537463196387848,TRX_N-349-555800028684,2022-06-01T08:16:43,Bilbao,transfer,Extra Income,103.94,-30127.32
buyer_1,Luis,28,ES71209537463196387848,TRX_N-35-147709020675,2020-03-31T16:24:25,Bilbao,Expense,gifts,-200.72,-2965.79
buyer_1,Luis,28,ES71209537463196387848,TRX_N-350-627827913641,2022-06-01T08:16:43,Bilbao,transfer,Bonus,1080.53,-29046.79
buyer_1,Luis,28,ES71209537463196387848,TRX_N-351-453604052737,2022-06-05T10:49:23,Bilbao,Housing,Rent,-607.32,-29654.11
buyer_1,Luis,28,ES71209537463196387848,TRX_N-352-254261432227,2022-06-05T09:32:38,Bilbao,Basic services,internet,-62.78,-29716.89
buyer_1,Luis,28,ES71209537463196387848,TRX_N-353-465840543351,2022-06-05T18:13:45,Bilbao,Basic services,phone,-62.35,-29779.24
buyer_1,Luis,28,ES71209537463196387848,TRX_N-354-818415266021,2022-06-06T09:02:34,Bilbao,Basic services,internet,-60.0,-29839.24
buyer_1,Luis,28,ES71209537463196387848,TRX_N-355-245439242802,2022-06-06T15:47:17,Bilbao,Basic services,phone,-96.17,-29935.41
buyer_1,Luis,28,ES71209537463196387848,TRX_N-356-76826111287,2022-06-07T23:00:46,Bilbao,Basic services,gas,-27.61,-29963.02
buyer_1,Luis,28,ES71209537463196387848,TRX_N-357-319528605208,2022-06-07T19:26:21,Bilbao,Basic services,internet,-42.03,-30005.05
buyer_1,Luis,28,ES71209537463196387848,TRX_N-358-370382132204,2022-06-07T12:10:07,Bilbao,Basic services,phone,-20.39,-30025.44
buyer_1,Luis,28,ES71209537463196387848,TRX_N-359-467532090579,2022-06-09T19:45:08,Bilbao,Expense,clothing,-180.02,-30205.46
buyer_1,Luis,28,ES71209537463196387848,TRX_N-36-76883697800,2020-04-01T09:04:01,Bilbao,transfer,Salary,1039.38,-1926.41
buyer_1,Luis,28,ES71209537463196387848,TRX_N-360-434166278648,2022-07-01T14:37:11,Bilbao,transfer,Salary,1039.38,-29166.08
buyer_1,Luis,28,ES71209537463196387848,TRX_N-361-980998212613,2022-07-02T12:53:18,Bilbao,Expense,clothing,-127.9,-29293.98
buyer_1,Luis,28,ES71209537463196387848,TRX_N-362-240309721467,2022-07-05T14:53:09,Bilbao,Housing,Rent,-607.32,-29901.3
buyer_1,Luis,28,ES71209537463196387848,TRX_N-363-780443278599,2022-07-05T12:10:36,Bilbao,Basic services,electricity,-48.92,-29950.22
buyer_1,Luis,28,ES71209537463196387848,TRX_N-364-893371332223,2022-07-05T18:08:08,Bilbao,Basic services,internet,-65.55,-30015.77
buyer_1,Luis,28,ES71209537463196387848,TRX_N-365-764998736681,2022-07-06T13:21:10,Bilbao,Basic services,internet,-37.07,-30052.84
buyer_1,Luis,28,ES71209537463196387848,TRX_N-366-126760075106,2022-07-06T13:27:11,Bilbao,Basic services,phone,-90.59,-30143.43
buyer_1,Luis,28,ES71209537463196387848,TRX_N-367-412032096072,2022-07-07T17:30:47,Bilbao,Basic services,internet,-70.65,-30214.08
buyer_1,Luis,28,ES71209537463196387848,TRX_N-368-16470618350,2022-07-12T15:32:51,Bilbao,Expense,food,-540.63,-30754.71
buyer_1,Luis,28,ES71209537463196387848,TRX_N-369-715569448550,2022-07-20T21:40:35,Bilbao,Expense,transport,-187.29,-30942.0
buyer_1,Luis,28,ES71209537463196387848,TRX_N-37-651246274325,2020-04-05T00:07:01,Bilbao,Housing,Rent,-607.32,-2533.73
buyer_1,Luis,28,ES71209537463196387848,TRX_N-370-837842146445,2022-07-25T16:38:26,Bilbao,Expense,clothing,-375.17,-31317.17
buyer_1,Luis,28,ES71209537463196387848,TRX_N-371-193151292054,2022-07-30T08:54:10,Bilbao,Expense,leisure,-127.33,-31444.5
buyer_1,Luis,28,ES71209537463196387848,TRX_N-372-151818113463,2022-07-31T02:21:10,Leioa,Expense,food,-416.11,-31860.61
buyer_1,Luis,28,ES71209537463196387848,TRX_N-373-620836209243,2022-08-01T20:15:37,Bilbao,transfer,Salary,1039.38,-30821.23
buyer_1,Luis,28,ES71209537463196387848,TRX_N-374-717459083318,2022-08-01T20:15:37,Bilbao,transfer,Extra Income,103.94,-30717.29
buyer_1,Luis,28,ES71209537463196387848,TRX_N-375-281774121173,2022-08-02T15:18:22,Bilbao,Expense,repairs,-878.72,-31596.01
buyer_1,Luis,28,ES71209537463196387848,TRX_N-376-761585951979,2022-08-04T08:21:39,Bilbao,Expense,food,-450.98,-32046.99
buyer_1,Luis,28,ES71209537463196387848,TRX_N-377-36224703891,2022-08-05T16:58:14,Bilbao,Housing,Rent,-607.32,-32654.31
buyer_1,Luis,28,ES71209537463196387848,TRX_N-378-548185672979,2022-08-05T15:28:39,Bilbao,Basic services,gas,-32.55,-32686.86
buyer_1,Luis,28,ES71209537463196387848,TRX_N-379-896224198778,2022-08-05T23:24:10,Bilbao,Basic services,phone,-70.52,-32757.38
buyer_1,Luis,28,ES71209537463196387848,TRX_N-38-42249489299,2020-04-06T10:52:44,Bilbao,Basic services,water,-24.37,-2558.1
buyer_1,Luis,28,ES71209537463196387848,TRX_N-380-955272576752,2022-08-05T17:45:18,Bilbao,Expense,clothing,-464.56,-33221.94
buyer_1,Luis,28,ES71209537463196387848,TRX_N-381-758130846483,2022-08-06T15:51:30,Bilbao,Basic services,phone,-92.6,-33314.54
buyer_1,Luis,28,ES71209537463196387848,TRX_N-382-108116181228,2022-08-07T08:50:29,Bilbao,Basic services,gas,-20.59,-33335.13
buyer_1,Luis,28,ES71209537463196387848,TRX_N-383-913906235642,2022-08-07T09:35:41,Bilbao,Basic services,internet,-65.1,-33400.23
buyer_1,Luis,28,ES71209537463196387848,TRX_N-384-988678698432,2022-08-07T12:47:46,Bilbao,Basic services,phone,-54.1,-33454.33
buyer_1,Luis,28,ES71209537463196387848,TRX_N-385-950845467494,2022-08-07T23:05:08,Bilbao,Expense,repairs,-712.69,-34167.02
buyer_1,Luis,28,ES71209537463196387848,TRX_N-386-209789048950,2022-08-22T20:06:59,Bilbao,Expense,repairs,-349.2,-34516.22
buyer_1,Luis,28,ES71209537463196387848,TRX_N-387-521883835446,2022-08-28T14:12:10,Bilbao,Expense,food,-742.51,-35258.73
buyer_1,Luis,28,ES71209537463196387848,TRX_N-388-90738524685,2022-08-28T00:29:49,Bilbao,Expense,transport,-177.15,-35435.88
buyer_1,Luis,28,ES71209537463196387848,TRX_N-389-241544429376,2022-09-01T19:49:33,Bilbao,transfer,Salary,1039.38,-34396.5
buyer_1,Luis,28,ES71209537463196387848,TRX_N-39-283924222136,2020-04-06T14:32:27,Bilbao,Basic services,phone,-79.64,-2637.74
buyer_1,Luis,28,ES71209537463196387848,TRX_N-390-516152234856,2022-09-05T02:57:49,Bilbao,Housing,Rent,-607.32,-35003.82
buyer_1,Luis,28,ES71209537463196387848,TRX_N-391-582951662574,2022-09-05T12:05:52,Bilbao,Basic services,gas,-36.26,-35040.08
buyer_1,Luis,28,ES71209537463196387848,TRX_N-392-571608993939,2022-09-11T12:22:56,Bilbao,Expense,gifts,-431.5,-35471.58
buyer_1,Luis,28,ES71209537463196387848,TRX_N-393-386197297437,2022-09-13T13:47:47,Bilbao,Expense,transport,-78.51,-35550.09
buyer_1,Luis,28,ES71209537463196387848,TRX_N-394-629763529382,2022-09-19T13:50:21,Bilbao,Expense,leisure,-239.44,-35789.53
buyer_1,Luis,28,ES71209537463196387848,TRX_N-395-108890775241,2022-09-28T10:10:07,Bilbao,Expense,food,-502.39,-36291.92
buyer_1,Luis,28,ES71209537463196387848,TRX_N-396-714473582760,2022-10-01T20:18:27,Bilbao,transfer,Salary,1039.38,-35252.54
buyer_1,Luis,28,ES71209537463196387848,TRX_N-397-899306685534,2022-10-01T20:18:27,Bilbao,transfer,Extra Income,103.94,-35148.6
buyer_1,Luis,28,ES71209537463196387848,TRX_N-398-478686177444,2022-10-03T12:05:07,Bilbao,Expense,appliances,-645.08,-35793.68
buyer_1,Luis,28,ES71209537463196387848,TRX_N-399-903215823066,2022-10-05T12:08:18,Bilbao,Housing,Rent,-607.32,-36401.0
buyer_1,Luis,28,ES71209537463196387848,TRX_N-4-319522105382,2020-01-05T16:45:37,Bilbao,Basic services,water,-61.27,191.53
buyer_1,Luis,28,ES71209537463196387848,TRX_N-40-666113453981,2020-04-07T15:33:34,Bilbao,Basic services,electricity,-48.24,-2685.98
buyer_1,Luis,28,ES71209537463196387848,TRX_N-400-690924095177,2022-10-05T13:44:07,Bilbao,Basic services,internet,-65.19,-36466.19
buyer_1,Luis,28,ES71209537463196387848,TRX_N-401-691296675289,2022-10-06T14:02:33,Bilbao,Basic services,water,-30.18,-36496.37
buyer_1,Luis,28,ES71209537463196387848,TRX_N-402-755677378232,2022-10-14T14:40:03,Bilbao,Expense,transport,-130.06,-36626.43
buyer_1,Luis,28,ES71209537463196387848,TRX_N-403-190626205183,2022-10-15T15:59:08,Bilbao,Expense,education,-292.69,-36919.12
buyer_1,Luis,28,ES71209537463196387848,TRX_N-404-829745626581,2022-10-23T15:06:22,Bilbao,Expense,education,-917.58,-37836.7
buyer_1,Luis,28,ES71209537463196387848,TRX_N-405-467805174889,2022-11-01T14:32:41,Bilbao,transfer,Salary,1039.38,-36797.32
buyer_1,Luis,28,ES71209537463196387848,TRX_N-406-547306543364,2022-11-03T09:54:29,Bilbao,Expense,gifts,-402.31,-37199.63
buyer_1,Luis,28,ES71209537463196387848,TRX_N-407-305945115758,2022-11-05T11:31:21,Bilbao,Housing,Rent,-607.32,-37806.95
buyer_1,Luis,28,ES71209537463196387848,TRX_N-408-354505853518,2022-11-05T10:46:51,Bilbao,Basic services,electricity,-59.78,-37866.73
buyer_1,Luis,28,ES71209537463196387848,TRX_N-409-973110514262,2022-11-05T20:54:50,Bilbao,Expense,clothing,-358.98,-38225.71
buyer_1,Luis,28,ES71209537463196387848,TRX_N-41-506110600880,2020-04-07T13:24:36,Bilbao,Basic services,gas,-33.8,-2719.78
buyer_1,Luis,28,ES71209537463196387848,TRX_N-410-217951855539,2022-11-06T09:56:34,Bilbao,Basic services,electricity,-54.71,-38280.42
buyer_1,Luis,28,ES71209537463196387848,TRX_N-411-773831502953,2022-11-06T23:11:19,Bilbao,Basic services,gas,-27.0,-38307.42
buyer_1,Luis,28,ES71209537463196387848,TRX_N-412-327087913277,2022-11-06T08:12:04,Bilbao,Basic services,phone,-59.9,-38367.32
buyer_1,Luis,28,ES71209537463196387848,TRX_N-413-716173808726,2022-11-07T18:24:20,Bilbao,Basic services,water,-68.11,-38435.43
buyer_1,Luis,28,ES71209537463196387848,TRX_N-414-766146364432,2022-11-07T19:18:18,Bilbao,Basic services,electricity,-66.11,-38501.54
buyer_1,Luis,28,ES71209537463196387848,TRX_N-415-783614958034,2022-11-07T18:26:16,Bilbao,Expense,transport,-73.8,-38575.34
buyer_1,Luis,28,ES71209537463196387848,TRX_N-416-375159978960,2022-11-16T18:09:49,Bilbao,Expense,transport,-113.95,-38689.29
buyer_1,Luis,28,ES71209537463196387848,TRX_N-417-944521788424,2022-12-01T20:51:36,Bilbao,transfer,Salary,1039.38,-37649.91
buyer_1,Luis,28,ES71209537463196387848,TRX_N-418-743124910422,2022-12-01T20:51:36,Bilbao,transfer,Extra Income,103.94,-37545.97
buyer_1,Luis,28,ES71209537463196387848,TRX_N-419-657419816420,2022-12-01T20:51:36,Bilbao,transfer,Bonus,998.45,-36547.52
buyer_1,Luis,28,ES71209537463196387848,TRX_N-42-440335932953,2020-04-07T09:38:37,Bilbao,Basic services,internet,-59.91,-2779.69
buyer_1,Luis,28,ES71209537463196387848,TRX_N-420-509360682206,2022-12-01T14:33:10,Bilbao,Expense,leisure,-254.89,-36802.41
buyer_1,Luis,28,ES71209537463196387848,TRX_N-421-35411532683,2022-12-03T14:43:21,Bilbao,Expense,food,-271.33,-37073.74
buyer_1,Luis,28,ES71209537463196387848,TRX_N-422-904456778661,2022-12-05T08:35:31,Bilbao,Housing,Rent,-607.32,-37681.06
buyer_1,Luis,28,ES71209537463196387848,TRX_N-423-669116008880,2022-12-05T08:05:28,Bilbao,Basic services,internet,-37.74,-37718.8
buyer_1,Luis,28,ES71209537463196387848,TRX_N-424-399963976497,2022-12-05T15:00:54,Bilbao,Basic services,phone,-49.54,-37768.34
buyer_1,Luis,28,ES71209537463196387848,TRX_N-425-439881446605,2022-12-06T18:13:35,Bilbao,Basic services,electricity,-79.63,-37847.97
buyer_1,Luis,28,ES71209537463196387848,TRX_N-426-61147429458,2022-12-06T20:06:20,Bilbao,Basic services,internet,-32.92,-37880.89
buyer_1,Luis,28,ES71209537463196387848,TRX_N-427-779155510054,2022-12-07T11:01:41,Bilbao,Basic services,water,-75.82,-37956.71
buyer_1,Luis,28,ES71209537463196387848,TRX_N-428-415198576945,2022-12-07T09:11:36,Bilbao,Basic services,electricity,-20.2,-37976.91
buyer_1,Luis,28,ES71209537463196387848,TRX_N-429-401151805566,2022-12-07T10:57:48,Bilbao,Basic services,internet,-70.13,-38047.04
buyer_1,Luis,28,ES71209537463196387848,TRX_N-43-799727955420,2020-04-07T14:37:49,Bilbao,Basic services,phone,-72.34,-2852.03
buyer_1,Luis,28,ES71209537463196387848,TRX_N-430-280906120690,2022-12-07T17:11:38,Bilbao,Basic services,phone,-65.63,-38112.67
buyer_1,Luis,28,ES71209537463196387848,TRX_N-431-701276292413,2022-12-20T11:31:07,Bilbao,Expense,education,-720.62,-38833.29
buyer_1,Luis,28,ES71209537463196387848,TRX_N-432-114722609593,2022-12-21T17:39:30,Bilbao,Expense,food,-448.41,-39281.7
buyer_1,Luis,28,ES71209537463196387848,TRX_N-433-613642313108,2023-01-01T12:42:02,Bilbao,transfer,Salary,1039.38,-38242.32
buyer_1,Luis,28,ES71209537463196387848,TRX_N-434-696119145021,2023-01-05T15:29:28,Bilbao,Housing,Rent,-607.32,-38849.64
buyer_1,Luis,28,ES71209537463196387848,TRX_N-435-843276272734,2023-01-05T12:25:57,Bilbao,Basic services,water,-15.93,-38865.57
buyer_1,Luis,28,ES71209537463196387848,TRX_N-436-42259626807,2023-01-05T18:55:16,Bilbao,Basic services,gas,-23.79,-38889.36
buyer_1,Luis,28,ES71209537463196387848,TRX_N-437-357807631413,2023-01-06T10:26:57,Bilbao,Basic services,water,-32.71,-38922.07
buyer_1,Luis,28,ES71209537463196387848,TRX_N-438-7574612489,2023-01-06T19:36:17,Bilbao,Basic services,phone,-69.62,-38991.69
buyer_1,Luis,28,ES71209537463196387848,TRX_N-439-569451328718,2023-01-07T18:19:52,Bilbao,Basic services,gas,-44.97,-39036.66
buyer_1,Luis,28,ES71209537463196387848,TRX_N-44-961362588610,2020-04-13T12:09:51,Bilbao,Expense,clothing,-408.36,-3260.39
buyer_1,Luis,28,ES71209537463196387848,TRX_N-440-421263458119,2023-01-07T06:47:09,Bilbao,Basic services,internet,-76.12,-39112.78
buyer_1,Luis,28,ES71209537463196387848,TRX_N-441-795568306576,2023-01-09T16:55:10,Bilbao,Expense,gifts,-64.89,-39177.67
buyer_1,Luis,28,ES71209537463196387848,TRX_N-442-125982252219,2023-01-19T20:36:53,Bilbao,Expense,food,-303.95,-39481.62
buyer_1,Luis,28,ES71209537463196387848,TRX_N-443-922356061273,2023-01-21T07:03:34,Bilbao,Expense,leisure,-271.39,-39753.01
buyer_1,Luis,28,ES71209537463196387848,TRX_N-444-682926970736,2023-02-01T21:05:03,Bilbao,transfer,Salary,1039.38,-38713.63
buyer_1,Luis,28,ES71209537463196387848,TRX_N-445-345576835269,2023-02-04T12:15:37,Bilbao,Expense,transport,-190.9,-38904.53
buyer_1,Luis,28,ES71209537463196387848,TRX_N-446-174253401168,2023-02-05T08:11:04,Bilbao,Housing,Rent,-607.32,-39511.85
buyer_1,Luis,28,ES71209537463196387848,TRX_N-447-712593400246,2023-02-05T10:02:23,Bilbao,Basic services,gas,-35.22,-39547.07
buyer_1,Luis,28,ES71209537463196387848,TRX_N-448-846619701559,2023-02-05T15:55:38,Bilbao,Basic services,internet,-60.97,-39608.04
buyer_1,Luis,28,ES71209537463196387848,TRX_N-449-605346664889,2023-02-06T08:51:42,Bilbao,Basic services,water,-58.78,-39666.82
buyer_1,Luis,28,ES71209537463196387848,TRX_N-45-884285775849,2020-04-24T20:01:22,Bilbao,Expense,food,-160.8,-3421.19
buyer_1,Luis,28,ES71209537463196387848,TRX_N-450-287658037578,2023-02-06T15:38:52,Bilbao,Basic services,electricity,-51.47,-39718.29
buyer_1,Luis,28,ES71209537463196387848,TRX_N-451-803991741963,2023-02-07T08:53:32,Bilbao,Basic services,gas,-36.06,-39754.35
buyer_1,Luis,28,ES71209537463196387848,TRX_N-452-780006507581,2023-02-07T08:50:41,Bilbao,Basic services,internet,-62.11,-39816.46
buyer_1,Luis,28,ES71209537463196387848,TRX_N-453-624446912373,2023-02-12T09:41:08,Errenteria,Expense,leisure,-66.35,-39882.81
buyer_1,Luis,28,ES71209537463196387848,TRX_N-454-709284338996,2023-02-18T13:11:24,Bilbao,Expense,education,-816.68,-40699.49
buyer_1,Luis,28,ES71209537463196387848,TRX_N-455-67070800400,2023-02-23T20:45:44,Bilbao,Expense,food,-790.22,-41489.71
buyer_1,Luis,28,ES71209537463196387848,TRX_N-456-207405303827,2023-02-28T17:16:01,Bilbao,Expense,food,-408.01,-41897.72
buyer_1,Luis,28,ES71209537463196387848,TRX_N-457-281505373847,2023-03-01T20:59:24,Bilbao,transfer,Salary,1039.38,-40858.34
buyer_1,Luis,28,ES71209537463196387848,TRX_N-458-776808195019,2023-03-01T20:59:24,Bilbao,transfer,Extra Income,103.94,-40754.4
buyer_1,Luis,28,ES71209537463196387848,TRX_N-459-836609358485,2023-03-05T08:35:12,Bilbao,Housing,Rent,-607.32,-41361.72
buyer_1,Luis,28,ES71209537463196387848,TRX_N-46-287827564770,2020-04-27T08:34:15,Bilbao,Expense,food,-541.15,-3962.34
buyer_1,Luis,28,ES71209537463196387848,TRX_N-460-783892400163,2023-03-05T09:11:10,Bilbao,Basic services,phone,-59.22,-41420.94
buyer_1,Luis,28,ES71209537463196387848,TRX_N-461-720199148822,2023-03-06T16:34:09,Bilbao,Basic services,water,-53.21,-41474.15
buyer_1,Luis,28,ES71209537463196387848,TRX_N-462-987717542034,2023-03-06T13:50:30,Bilbao,Basic services,gas,-46.66,-41520.81
buyer_1,Luis,28,ES71209537463196387848,TRX_N-463-29099289746,2023-03-06T14:28:11,Bilbao,Basic services,phone,-69.5,-41590.31
buyer_1,Luis,28,ES71209537463196387848,TRX_N-464-983461161628,2023-03-07T11:45:45,Bilbao,Basic services,water,-36.39,-41626.7
buyer_1,Luis,28,ES71209537463196387848,TRX_N-465-101545652834,2023-03-07T20:48:11,Bilbao,Basic services,gas,-71.69,-41698.39
buyer_1,Luis,28,ES71209537463196387848,TRX_N-466-930874817715,2023-03-07T18:44:43,Bilbao,Basic services,internet,-41.06,-41739.45
buyer_1,Luis,28,ES71209537463196387848,TRX_N-467-931840125199,2023-03-07T16:32:18,Bilbao,Basic services,phone,-93.22,-41832.67
buyer_1,Luis,28,ES71209537463196387848,TRX_N-468-106475136184,2023-03-17T14:41:02,Bilbao,Expense,leisure,-139.25,-41971.92
buyer_1,Luis,28,ES71209537463196387848,TRX_N-469-333655448268,2023-03-18T21:18:15,Donostia,Expense,transport,-135.89,-42107.81
buyer_1,Luis,28,ES71209537463196387848,TRX_N-47-193747083037,2020-04-30T13:17:08,Bilbao,Expense,gifts,-464.5,-4426.84
buyer_1,Luis,28,ES71209537463196387848,TRX_N-470-448509489041,2023-03-30T10:59:49,Bilbao,Expense,food,-715.86,-42823.67
buyer_1,Luis,28,ES71209537463196387848,TRX_N-471-956870874688,2023-04-01T22:58:13,Bilbao,transfer,Salary,1039.38,-41784.29
buyer_1,Luis,28,ES71209537463196387848,TRX_N-472-738757594463,2023-04-05T16:57:22,Bilbao,Housing,Rent,-607.32,-42391.61
buyer_1,Luis,28,ES71209537463196387848,TRX_N-473-389789021644,2023-04-05T08:11:14,Bilbao,Basic services,phone,-31.3,-42422.91
buyer_1,Luis,28,ES71209537463196387848,TRX_N-474-798566360602,2023-04-06T11:45:17,Bilbao,Basic services,water,-33.57,-42456.48
buyer_1,Luis,28,ES71209537463196387848,TRX_N-475-191508065286,2023-04-06T15:43:00,Bilbao,Basic services,electricity,-146.07,-42602.55
buyer_1,Luis,28,ES71209537463196387848,TRX_N-476-661664137502,2023-04-07T14:40:57,Bilbao,Basic services,electricity,-100.49,-42703.04
buyer_1,Luis,28,ES71209537463196387848,TRX_N-477-665474476362,2023-04-07T13:45:56,Bilbao,Basic services,gas,-43.89,-42746.93
buyer_1,Luis,28,ES71209537463196387848,TRX_N-478-54146699895,2023-04-25T20:38:40,Bilbao,Expense,transport,-190.64,-42937.57
buyer_1,Luis,28,ES71209537463196387848,TRX_N-479-124810730352,2023-04-25T10:40:29,Bilbao,Expense,leisure,-63.39,-43000.96
buyer_1,Luis,28,ES71209537463196387848,TRX_N-48-320335926762,2020-05-01T10:47:48,Bilbao,transfer,Salary,1039.38,-3387.46
buyer_1,Luis,28,ES71209537463196387848,TRX_N-480-904303272812,2023-05-01T14:15:07,Bilbao,transfer,Salary,1039.38,-41961.58
buyer_1,Luis,28,ES71209537463196387848,TRX_N-481-484857382678,2023-05-01T14:15:07,Bilbao,transfer,Extra Income,103.94,-41857.64
buyer_1,Luis,28,ES71209537463196387848,TRX_N-482-220054821940,2023-05-02T13:36:32,Bilbao,Expense,food,-205.28,-42062.92
buyer_1,Luis,28,ES71209537463196387848,TRX_N-483-749124734134,2023-05-05T14:59:21,Bilbao,Housing,Rent,-607.32,-42670.24
buyer_1,Luis,28,ES71209537463196387848,TRX_N-484-331463457826,2023-05-05T20:48:13,Bilbao,Basic services,internet,-33.5,-42703.74
buyer_1,Luis,28,ES71209537463196387848,TRX_N-485-5669015107,2023-05-06T08:10:21,Bilbao,Basic services,water,-17.11,-42720.85
buyer_1,Luis,28,ES71209537463196387848,TRX_N-486-597691556622,2023-05-06T15:28:40,Bilbao,Basic services,gas,-19.98,-42740.83
buyer_1,Luis,28,ES71209537463196387848,TRX_N-487-384096547060,2023-05-07T19:09:34,Bilbao,Basic services,water,-26.66,-42767.49
buyer_1,Luis,28,ES71209537463196387848,TRX_N-488-587012950724,2023-05-07T17:06:49,Bilbao,Basic services,electricity,-39.1,-42806.59
buyer_1,Luis,28,ES71209537463196387848,TRX_N-489-546292662487,2023-05-10T19:14:29,Bilbao,Expense,leisure,-92.6,-42899.19
buyer_1,Luis,28,ES71209537463196387848,TRX_N-49-459005283100,2020-05-01T10:47:48,Bilbao,transfer,Extra Income,103.94,-3283.52
buyer_1,Luis,28,ES71209537463196387848,TRX_N-490-351423788622,2023-05-21T16:39:34,Bilbao,Expense,transport,-171.25,-43070.44
buyer_1,Luis,28,ES71209537463196387848,TRX_N-491-618270664637,2023-06-01T14:35:00,Bilbao,transfer,Salary,1039.38,-42031.06
buyer_1,Luis,28,ES71209537463196387848,TRX_N-492-573409293971,2023-06-01T14:35:00,Bilbao,transfer,Bonus,941.31,-41089.75
buyer_1,Luis,28,ES71209537463196387848,TRX_N-493-909715075757,2023-06-02T15:37:12,Durango,Expense,food,-669.15,-41758.9
buyer_1,Luis,28,ES71209537463196387848,TRX_N-494-299414111257,2023-06-05T20:07:34,Bilbao,Housing,Rent,-607.32,-42366.22
buyer_1,Luis,28,ES71209537463196387848,TRX_N-495-849630560828,2023-06-06T16:41:10,Bilbao,Basic services,electricity,-90.28,-42456.5
buyer_1,Luis,28,ES71209537463196387848,TRX_N-496-584614013330,2023-06-07T15:24:39,Bilbao,Basic services,phone,-79.53,-42536.03
buyer_1,Luis,28,ES71209537463196387848,TRX_N-497-152382422767,2023-06-11T23:35:46,Bilbao,Expense,leisure,-112.75,-42648.78
buyer_1,Luis,28,ES71209537463196387848,TRX_N-498-223988037845,2023-06-13T02:22:57,Barakaldo,Expense,appliances,-1294.97,-43943.75
buyer_1,Luis,28,ES71209537463196387848,TRX_N-499-977697363243,2023-06-14T20:34:37,Bilbao,Expense,leisure,-181.86,-44125.61
buyer_1,Luis,28,ES71209537463196387848,TRX_N-5-517923231799,2020-01-05T09:39:42,Bilbao,Basic services,electricity,-99.01,92.52
buyer_1,Luis,28,ES71209537463196387848,TRX_N-50-674488122112,2020-05-02T19:37:19,Bilbao,Expense,repairs,-698.46,-3981.98
buyer_1,Luis,28,ES71209537463196387848,TRX_N-500-991679920195,2023-06-30T12:30:26,Bilbao,Expense,transport,-185.28,-44310.89
buyer_1,Luis,28,ES71209537463196387848,TRX_N-501-544060990522,2023-07-01T20:05:49,Bilbao,transfer,Salary,1039.38,-43271.51
buyer_1,Luis,28,ES71209537463196387848,TRX_N-502-882995014549,2023-07-01T20:05:49,Bilbao,transfer,Extra Income,103.94,-43167.57
buyer_1,Luis,28,ES71209537463196387848,TRX_N-503-360740441330,2023-07-02T11:44:55,Bilbao,Expense,clothing,-353.99,-43521.56
buyer_1,Luis,28,ES71209537463196387848,TRX_N-504-516836061614,2023-07-05T17:02:29,Bilbao,Housing,Rent,-607.32,-44128.88
buyer_1,Luis,28,ES71209537463196387848,TRX_N-505-969998334061,2023-07-05T11:15:04,Bilbao,Basic services,internet,-33.56,-44162.44
buyer_1,Luis,28,ES71209537463196387848,TRX_N-506-152967653267,2023-07-06T13:03:48,Bilbao,Basic services,gas,-95.06,-44257.5
buyer_1,Luis,28,ES71209537463196387848,TRX_N-507-517821002927,2023-07-06T14:03:16,Bilbao,Basic services,internet,-49.17,-44306.67
buyer_1,Luis,28,ES71209537463196387848,TRX_N-508-245560872556,2023-07-07T18:46:28,Bilbao,Basic services,electricity,-23.48,-44330.15
buyer_1,Luis,28,ES71209537463196387848,TRX_N-509-779902605533,2023-07-09T13:01:13,Bilbao,Expense,food,-572.11,-44902.26
buyer_1,Luis,28,ES71209537463196387848,TRX_N-51-161656197240,2020-05-02T09:29:16,Bilbao,Expense,gifts,-431.77,-4413.75
buyer_1,Luis,28,ES71209537463196387848,TRX_N-510-895804721048,2023-08-01T17:07:46,Bilbao,transfer,Salary,1039.38,-43862.88
buyer_1,Luis,28,ES71209537463196387848,TRX_N-511-249159922281,2023-08-02T18:41:15,Bilbao,Expense,food,-248.18,-44111.06
buyer_1,Luis,28,ES71209537463196387848,TRX_N-512-223361172876,2023-08-05T11:18:18,Bilbao,Housing,Rent,-607.32,-44718.38
buyer_1,Luis,28,ES71209537463196387848,TRX_N-513-491063055660,2023-08-05T01:49:51,Bilbao,Basic services,water,-41.25,-44759.63
buyer_1,Luis,28,ES71209537463196387848,TRX_N-514-544610073852,2023-08-05T17:36:51,Bilbao,Basic services,electricity,-142.11,-44901.74
buyer_1,Luis,28,ES71209537463196387848,TRX_N-515-894057899931,2023-08-06T15:26:39,Bilbao,Basic services,water,-63.5,-44965.24
buyer_1,Luis,28,ES71209537463196387848,TRX_N-516-108371103993,2023-08-06T08:44:49,Bilbao,Basic services,gas,-60.58,-45025.82
buyer_1,Luis,28,ES71209537463196387848,TRX_N-517-934043120192,2023-08-06T21:05:29,Bilbao,Basic services,phone,-99.54,-45125.36
buyer_1,Luis,28,ES71209537463196387848,TRX_N-518-928913159640,2023-08-06T18:05:16,Bilbao,Expense,healthcare,-144.46,-45269.82
buyer_1,Luis,28,ES71209537463196387848,TRX_N-519-646062174654,2023-08-19T08:26:57,Bilbao,Expense,food,-697.17,-45966.99
buyer_1,Luis,28,ES71209537463196387848,TRX_N-52-745960155038,2020-05-05T04:12:50,Bilbao,Housing,Rent,-607.32,-5021.07
buyer_1,Luis,28,ES71209537463196387848,TRX_N-520-294115806303,2023-08-21T08:08:46,Bilbao,Expense,food,-353.4,-46320.39
buyer_1,Luis,28,ES71209537463196387848,TRX_N-521-641613260166,2023-09-01T08:18:49,Bilbao,transfer,Salary,1039.38,-45281.01
buyer_1,Luis,28,ES71209537463196387848,TRX_N-522-110386279609,2023-09-01T08:18:49,Bilbao,transfer,Extra Income,103.94,-45177.07
buyer_1,Luis,28,ES71209537463196387848,TRX_N-523-864115242623,2023-09-04T22:38:35,Bilbao,Expense,food,-796.76,-45973.83
buyer_1,Luis,28,ES71209537463196387848,TRX_N-524-659997330988,2023-09-05T10:30:09,Bilbao,Housing,Rent,-607.32,-46581.15
buyer_1,Luis,28,ES71209537463196387848,TRX_N-525-547691188377,2023-09-05T12:50:35,Bilbao,Basic services,water,-20.27,-46601.42
buyer_1,Luis,28,ES71209537463196387848,TRX_N-526-494606669573,2023-09-06T19:14:58,Bilbao,Basic services,gas,-30.67,-46632.09
buyer_1,Luis,28,ES71209537463196387848,TRX_N-527-365540508841,2023-09-07T20:05:09,Bilbao,Basic services,water,-48.32,-46680.41
buyer_1,Luis,28,ES71209537463196387848,TRX_N-528-826407985944,2023-09-07T18:16:05,Bilbao,Basic services,internet,-42.34,-46722.75
buyer_1,Luis,28,ES71209537463196387848,TRX_N-529-773085221474,2023-09-07T15:40:28,Bilbao,Basic services,phone,-42.8,-46765.55
buyer_1,Luis,28,ES71209537463196387848,TRX_N-53-243506808413,2020-05-05T19:59:12,Bilbao,Basic services,water,-41.3,-5062.37
buyer_1,Luis,28,ES71209537463196387848,TRX_N-530-625062708373,2023-09-15T17:52:52,Bilbao,Expense,leisure,-119.68,-46885.23
buyer_1,Luis,28,ES71209537463196387848,TRX_N-531-320601357515,2023-09-16T15:38:06,Bilbao,Expense,transport,-99.18,-46984.41
buyer_1,Luis,28,ES71209537463196387848,TRX_N-532-17450323606,2023-10-01T11:15:58,Bilbao,transfer,Salary,1039.38,-45945.03
buyer_1,Luis,28,ES71209537463196387848,TRX_N-533-272462823561,2023-10-05T13:35:46,Bilbao,Housing,Rent,-607.32,-46552.35
buyer_1,Luis,28,ES71209537463196387848,TRX_N-534-200389721852,2023-10-05T18:34:23,Bilbao,Basic services,water,-37.55,-46589.9
buyer_1,Luis,28,ES71209537463196387848,TRX_N-535-686683186049,2023-10-05T08:24:13,Bilbao,Basic services,electricity,-125.42,-46715.32
buyer_1,Luis,28,ES71209537463196387848,TRX_N-536-354447369763,2023-10-05T04:17:21,Bilbao,Basic services,gas,-77.4,-46792.72
buyer_1,Luis,28,ES71209537463196387848,TRX_N-537-160402570883,2023-10-05T08:30:23,Bilbao,Basic services,internet,-72.42,-46865.14
buyer_1,Luis,28,ES71209537463196387848,TRX_N-538-627309215258,2023-10-06T20:31:31,Bilbao,Basic services,electricity,-144.06,-47009.2
buyer_1,Luis,28,ES71209537463196387848,TRX_N-539-609206940207,2023-10-06T14:29:54,Bilbao,Expense,healthcare,-112.21,-47121.41
buyer_1,Luis,28,ES71209537463196387848,TRX_N-54-813816045997,2020-05-06T22:58:20,Bilbao,Basic services,water,-75.7,-5138.07
buyer_1,Luis,28,ES71209537463196387848,TRX_N-540-14186803656,2023-10-07T18:58:02,Bilbao,Basic services,internet,-78.82,-47200.23
buyer_1,Luis,28,ES71209537463196387848,TRX_N-541-963011943858,2023-10-07T06:25:02,Bilbao,Basic services,phone,-48.69,-47248.92
buyer_1,Luis,28,ES71209537463196387848,TRX_N-542-101713915904,2023-10-29T12:15:37,Arrasate/Mondragon,Expense,food,-489.23,-47738.15
buyer_1,Luis,28,ES71209537463196387848,TRX_N-543-741529492547,2023-10-30T19:26:26,Amurrio,Expense,education,-79.96,-47818.11
buyer_1,Luis,28,ES71209537463196387848,TRX_N-544-874799783822,2023-11-01T23:33:32,Bilbao,transfer,Salary,1039.38,-46778.73
buyer_1,Luis,28,ES71209537463196387848,TRX_N-545-473242946875,2023-11-01T13:54:23,Bilbao,Expense,leisure,-256.46,-47035.19
buyer_1,Luis,28,ES71209537463196387848,TRX_N-546-621036456914,2023-11-05T18:36:42,Bilbao,Housing,Rent,-607.32,-47642.51
buyer_1,Luis,28,ES71209537463196387848,TRX_N-547-497086929173,2023-11-05T12:59:08,Bilbao,Basic services,gas,-30.16,-47672.67
buyer_1,Luis,28,ES71209537463196387848,TRX_N-548-316368771951,2023-11-06T16:16:21,Bilbao,Basic services,water,-40.19,-47712.86
buyer_1,Luis,28,ES71209537463196387848,TRX_N-549-816446255025,2023-11-06T17:36:25,Bilbao,Basic services,electricity,-25.7,-47738.56
buyer_1,Luis,28,ES71209537463196387848,TRX_N-55-556442153951,2020-05-07T17:01:57,Bilbao,Basic services,gas,-21.56,-5159.63
buyer_1,Luis,28,ES71209537463196387848,TRX_N-550-88046077329,2023-11-06T13:48:35,Bilbao,Basic services,phone,-54.2,-47792.76
buyer_1,Luis,28,ES71209537463196387848,TRX_N-551-833816775222,2023-11-07T16:50:10,Bilbao,Basic services,electricity,-46.17,-47838.93
buyer_1,Luis,28,ES71209537463196387848,TRX_N-552-10936705476,2023-11-11T19:22:51,Bilbao,Expense,leisure,-84.51,-47923.44
buyer_1,Luis,28,ES71209537463196387848,TRX_N-553-575150549587,2023-11-15T08:36:57,Bilbao,Expense,transport,-54.18,-47977.62
buyer_1,Luis,28,ES71209537463196387848,TRX_N-554-860267994941,2023-11-21T20:48:11,Bilbao,Expense,leisure,-203.53,-48181.15
buyer_1,Luis,28,ES71209537463196387848,TRX_N-555-28538264656,2023-11-22T21:11:59,Bilbao,Expense,transport,-184.57,-48365.72
buyer_1,Luis,28,ES71209537463196387848,TRX_N-556-55040088415,2023-11-23T13:52:36,Bilbao,Expense,repairs,-835.59,-49201.31
buyer_1,Luis,28,ES71209537463196387848,TRX_N-557-749721940961,2023-12-01T16:03:04,Bilbao,transfer,Salary,1039.38,-48161.93
buyer_1,Luis,28,ES71209537463196387848,TRX_N-558-46767353616,2023-12-01T16:03:04,Bilbao,transfer,Extra Income,103.94,-48057.99
buyer_1,Luis,28,ES71209537463196387848,TRX_N-559-395119100557,2023-12-01T16:03:04,Bilbao,transfer,Bonus,1018.72,-47039.27
buyer_1,Luis,28,ES71209537463196387848,TRX_N-56-932641159049,2020-05-07T20:09:52,Bilbao,Basic services,internet,-49.05,-5208.68
buyer_1,Luis,28,ES71209537463196387848,TRX_N-560-106796487896,2023-12-04T09:11:34,Bilbao,Expense,food,-683.97,-47723.24
buyer_1,Luis,28,ES71209537463196387848,TRX_N-561-945603034711,2023-12-04T11:50:09,Bilbao,Expense,clothing,-95.22,-47818.46
buyer_1,Luis,28,ES71209537463196387848,TRX_N-562-647519253864,2023-12-05T17:05:16,Bilbao,Housing,Rent,-607.32,-48425.78
buyer_1,Luis,28,ES71209537463196387848,TRX_N-563-432465230126,2023-12-05T18:22:28,Bilbao,Basic services,electricity,-126.66,-48552.44
buyer_1,Luis,28,ES71209537463196387848,TRX_N-564-129864320499,2023-12-05T10:58:15,Bilbao,Basic services,gas,-52.67,-48605.11
buyer_1,Luis,28,ES71209537463196387848,TRX_N-565-418533797550,2023-12-05T20:22:29,Bilbao,Basic services,phone,-73.81,-48678.92
buyer_1,Luis,28,ES71209537463196387848,TRX_N-566-128123725635,2023-12-06T10:45:53,Bilbao,Basic services,water,-64.49,-48743.41
buyer_1,Luis,28,ES71209537463196387848,TRX_N-567-553122848783,2023-12-06T13:54:24,Bilbao,Basic services,electricity,-28.05,-48771.46
buyer_1,Luis,28,ES71209537463196387848,TRX_N-568-149399755917,2023-12-06T18:36:39,Bilbao,Basic services,internet,-56.81,-48828.27
buyer_1,Luis,28,ES71209537463196387848,TRX_N-569-266290810886,2023-12-06T01:29:27,Bilbao,Basic services,phone,-50.58,-48878.85
buyer_1,Luis,28,ES71209537463196387848,TRX_N-57-608735792732,2020-05-07T11:56:39,Bilbao,Basic services,phone,-69.54,-5278.22
buyer_1,Luis,28,ES71209537463196387848,TRX_N-570-300778795507,2023-12-07T05:51:29,Bilbao,Basic services,water,-52.15,-48931.0
buyer_1,Luis,28,ES71209537463196387848,TRX_N-571-833818372167,2023-12-07T03:53:29,Bilbao,Basic services,electricity,-107.67,-49038.67
buyer_1,Luis,28,ES71209537463196387848,TRX_N-572-830469879762,2023-12-07T15:33:58,Bilbao,Basic services,phone,-22.63,-49061.3
buyer_1,Luis,28,ES71209537463196387848,TRX_N-573-923249969861,2023-12-07T09:43:43,Bilbao,Expense,transport,-71.6,-49132.9
buyer_1,Luis,28,ES71209537463196387848,TRX_N-574-324108788087,2023-12-17T10:06:55,Bilbao,Expense,leisure,-283.34,-49416.24
buyer_1,Luis,28,ES71209537463196387848,TRX_N-575-12166119791,2023-12-28T11:35:10,Bilbao,Expense,gifts,-469.61,-49885.85
buyer_1,Luis,28,ES71209537463196387848,TRX_N-576-506031298580,2023-12-29T08:14:24,Bilbao,Expense,transport,-130.48,-50016.33
buyer_1,Luis,28,ES71209537463196387848,TRX_N-577-878878838509,2024-01-01T19:42:06,Bilbao,transfer,Salary,1039.38,-48976.95
buyer_1,Luis,28,ES71209537463196387848,TRX_N-578-193752178836,2024-01-05T19:38:39,Bilbao,Housing,Rent,-607.32,-49584.27
buyer_1,Luis,28,ES71209537463196387848,TRX_N-579-807831873919,2024-01-05T19:48:02,Bilbao,Basic services,electricity,-86.13,-49670.4
buyer_1,Luis,28,ES71209537463196387848,TRX_N-58-615015598417,2020-05-12T19:17:03,Bilbao,Expense,food,-344.0,-5622.22
buyer_1,Luis,28,ES71209537463196387848,TRX_N-580-64466218395,2024-01-05T18:53:52,Bilbao,Basic services,internet,-40.38,-49710.78
buyer_1,Luis,28,ES71209537463196387848,TRX_N-581-104117410266,2024-01-06T17:43:06,Bilbao,Basic services,water,-49.03,-49759.81
buyer_1,Luis,28,ES71209537463196387848,TRX_N-582-535805373166,2024-01-06T18:16:10,Bilbao,Basic services,electricity,-47.63,-49807.44
buyer_1,Luis,28,ES71209537463196387848,TRX_N-583-468876351302,2024-01-06T10:43:48,Bilbao,Basic services,internet,-37.51,-49844.95
buyer_1,Luis,28,ES71209537463196387848,TRX_N-584-134716460060,2024-01-06T17:10:22,Bilbao,Basic services,phone,-66.49,-49911.44
buyer_1,Luis,28,ES71209537463196387848,TRX_N-585-143057078086,2024-01-07T17:19:58,Bilbao,Basic services,gas,-50.77,-49962.21
buyer_1,Luis,28,ES71209537463196387848,TRX_N-586-853885737378,2024-01-22T14:27:03,Bilbao,Expense,repairs,-446.09,-50408.3
buyer_1,Luis,28,ES71209537463196387848,TRX_N-587-746782681795,2024-01-30T18:30:07,Bilbao,Expense,food,-386.05,-50794.35
buyer_1,Luis,28,ES71209537463196387848,TRX_N-588-649071500316,2024-02-01T16:23:07,Bilbao,transfer,Salary,1039.38,-49754.97
buyer_1,Luis,28,ES71209537463196387848,TRX_N-589-718622735474,2024-02-01T12:00:05,Bilbao,Expense,food,-259.38,-50014.35
buyer_1,Luis,28,ES71209537463196387848,TRX_N-59-219110602457,2020-05-13T21:09:27,Bilbao,Expense,food,-483.43,-6105.65
buyer_1,Luis,28,ES71209537463196387848,TRX_N-590-257209013354,2024-02-05T19:18:04,Bilbao,Housing,Rent,-607.32,-50621.67
buyer_1,Luis,28,ES71209537463196387848,TRX_N-591-51134044441,2024-02-05T15:04:36,Bilbao,Basic services,electricity,-120.91,-50742.58
buyer_1,Luis,28,ES71209537463196387848,TRX_N-592-606924522925,2024-02-06T12:08:22,Bilbao,Basic services,water,-27.74,-50770.32
buyer_1,Luis,28,ES71209537463196387848,TRX_N-593-652211370630,2024-02-06T14:54:10,Bilbao,Basic services,gas,-84.22,-50854.54
buyer_1,Luis,28,ES71209537463196387848,TRX_N-594-875735359014,2024-02-07T06:22:16,Bilbao,Basic services,water,-37.21,-50891.75
buyer_1,Luis,28,ES71209537463196387848,TRX_N-595-940449026121,2024-02-20T16:53:52,Bilbao,Expense,transport,-173.27,-51065.02
buyer_1,Luis,28,ES71209537463196387848,TRX_N-596-528746867484,2024-02-23T20:32:48,Bilbao,Expense,leisure,-176.04,-51241.06
buyer_1,Luis,28,ES71209537463196387848,TRX_N-597-381146669008,2024-03-01T12:57:21,Bilbao,transfer,Salary,1039.38,-50201.68
buyer_1,Luis,28,ES71209537463196387848,TRX_N-598-700900171455,2024-03-01T12:57:21,Bilbao,transfer,Extra Income,103.94,-50097.74
buyer_1,Luis,28,ES71209537463196387848,TRX_N-599-906175761553,2024-03-02T11:07:10,Bilbao,Expense,transport,-80.56,-50178.3
buyer_1,Luis,28,ES71209537463196387848,TRX_N-6-899327649274,2020-01-05T20:01:55,Bilbao,Basic services,gas,-95.98,-3.46
buyer_1,Luis,28,ES71209537463196387848,TRX_N-60-624566050920,2020-05-24T19:12:32,Llodio,Expense,leisure,-69.7,-6175.35
buyer_1,Luis,28,ES71209537463196387848,TRX_N-600-446670830055,2024-03-05T12:33:19,Bilbao,Housing,Rent,-607.32,-50785.62
buyer_1,Luis,28,ES71209537463196387848,TRX_N-601-149142484187,2024-03-05T14:15:29,Bilbao,Basic services,gas,-92.91,-50878.53
buyer_1,Luis,28,ES71209537463196387848,TRX_N-602-895761324436,2024-03-06T02:43:59,Bilbao,Basic services,electricity,-117.72,-50996.25
buyer_1,Luis,28,ES71209537463196387848,TRX_N-603-961818585315,2024-03-06T09:21:16,Bilbao,Basic services,gas,-38.56,-51034.81
buyer_1,Luis,28,ES71209537463196387848,TRX_N-604-354488598915,2024-03-06T21:28:18,Bilbao,Basic services,phone,-43.06,-51077.87
buyer_1,Luis,28,ES71209537463196387848,TRX_N-605-859018547352,2024-03-07T17:10:36,Bilbao,Basic services,electricity,-113.91,-51191.78
buyer_1,Luis,28,ES71209537463196387848,TRX_N-606-949789095470,2024-03-07T16:33:59,Bilbao,Basic services,gas,-97.43,-51289.21
buyer_1,Luis,28,ES71209537463196387848,TRX_N-607-948677400382,2024-03-07T10:56:23,Bilbao,Basic services,phone,-56.49,-51345.7
buyer_1,Luis,28,ES71209537463196387848,TRX_N-608-517781701596,2024-03-07T17:33:28,Bilbao,Expense,leisure,-117.41,-51463.11
buyer_1,Luis,28,ES71209537463196387848,TRX_N-609-828442139401,2024-03-19T11:29:49,Amurrio,Expense,education,-577.41,-52040.52
buyer_1,Luis,28,ES71209537463196387848,TRX_N-61-500894040333,2020-06-01T19:28:44,Bilbao,transfer,Salary,1039.38,-5135.97
buyer_1,Luis,28,ES71209537463196387848,TRX_N-610-141492080374,2024-03-30T10:53:24,Bilbao,Expense,food,-504.92,-52545.44
buyer_1,Luis,28,ES71209537463196387848,TRX_N-611-117521141643,2024-04-01T19:37:17,Bilbao,transfer,Salary,1039.38,-51506.06
buyer_1,Luis,28,ES71209537463196387848,TRX_N-612-733700900592,2024-04-03T18:46:57,Bilbao,Expense,food,-314.63,-51820.69
buyer_1,Luis,28,ES71209537463196387848,TRX_N-613-466647746832,2024-04-03T16:44:41,Bilbao,Expense,travel,-2668.48,-54489.17
buyer_1,Luis,28,ES71209537463196387848,TRX_N-614-906959301109,2024-04-05T10:21:47,Bilbao,Housing,Rent,-607.32,-55096.49
buyer_1,Luis,28,ES71209537463196387848,TRX_N-615-533209500536,2024-04-05T20:51:20,Bilbao,Basic services,electricity,-62.06,-55158.55
buyer_1,Luis,28,ES71209537463196387848,TRX_N-616-144529515105,2024-04-05T12:51:28,Bilbao,Basic services,gas,-65.98,-55224.53
buyer_1,Luis,28,ES71209537463196387848,TRX_N-617-746697319109,2024-04-05T20:51:09,Bilbao,Basic services,internet,-60.34,-55284.87
buyer_1,Luis,28,ES71209537463196387848,TRX_N-618-487283869139,2024-04-06T13:41:11,Bilbao,Basic services,water,-63.04,-55347.91
buyer_1,Luis,28,ES71209537463196387848,TRX_N-619-42333197489,2024-04-06T16:42:12,Bilbao,Basic services,gas,-54.94,-55402.85
buyer_1,Luis,28,ES71209537463196387848,TRX_N-62-687826363483,2020-06-01T19:28:44,Bilbao,transfer,Bonus,952.19,-4183.78
buyer_1,Luis,28,ES71209537463196387848,TRX_N-620-105669056616,2024-04-06T15:05:55,Bilbao,Basic services,internet,-65.11,-55467.96
buyer_1,Luis,28,ES71209537463196387848,TRX_N-621-701817025370,2024-04-06T13:39:14,Labastida/Bastida,Expense,education,-677.46,-56145.42
buyer_1,Luis,28,ES71209537463196387848,TRX_N-622-317299997551,2024-04-07T17:32:17,Bilbao,Basic services,electricity,-67.81,-56213.23
buyer_1,Luis,28,ES71209537463196387848,TRX_N-623-735816735079,2024-04-07T17:39:29,Bilbao,Basic services,internet,-58.64,-56271.87
buyer_1,Luis,28,ES71209537463196387848,TRX_N-624-324642816898,2024-04-21T14:22:09,Bilbao,Expense,transport,-167.05,-56438.92
buyer_1,Luis,28,ES71209537463196387848,TRX_N-625-920713515772,2024-04-22T12:00:52,Bilbao,Expense,leisure,-257.55,-56696.47
buyer_1,Luis,28,ES71209537463196387848,TRX_N-626-90952352588,2024-04-26T09:46:53,Bilbao,Expense,gifts,-107.46,-56803.93
buyer_1,Luis,28,ES71209537463196387848,TRX_N-627-111980168554,2024-04-29T11:56:40,Bilbao,Expense,food,-513.53,-57317.46
buyer_1,Luis,28,ES71209537463196387848,TRX_N-628-165207743307,2024-05-01T16:27:48,Bilbao,transfer,Salary,1039.38,-56278.08
buyer_1,Luis,28,ES71209537463196387848,TRX_N-629-458453030889,2024-05-01T07:42:28,Bilbao,Expense,transport,-121.24,-56399.32
buyer_1,Luis,28,ES71209537463196387848,TRX_N-63-854552855627,2020-06-05T11:48:27,Bilbao,Housing,Rent,-607.32,-4791.1
buyer_1,Luis,28,ES71209537463196387848,TRX_N-630-107780823929,2024-05-05T18:55:53,Bilbao,Housing,Rent,-607.32,-57006.64
buyer_1,Luis,28,ES71209537463196387848,TRX_N-631-249160313146,2024-05-05T18:53:20,Bilbao,Basic services,gas,-73.4,-57080.04
buyer_1,Luis,28,ES71209537463196387848,TRX_N-632-664734701910,2024-05-06T20:50:56,Bilbao,Basic services,phone,-70.95,-57150.99
buyer_1,Luis,28,ES71209537463196387848,TRX_N-633-972764577343,2024-05-06T20:42:06,Bilbao,Expense,food,-695.85,-57846.84
buyer_1,Luis,28,ES71209537463196387848,TRX_N-634-741965293483,2024-05-07T12:02:08,Bilbao,Basic services,water,-18.37,-57865.21
buyer_1,Luis,28,ES71209537463196387848,TRX_N-635-353207792213,2024-05-07T08:26:47,Bilbao,Basic services,internet,-71.86,-57937.07
buyer_1,Luis,28,ES71209537463196387848,TRX_N-636-472029099555,2024-05-07T04:33:16,Bilbao,Basic services,phone,-71.62,-58008.69
buyer_1,Luis,28,ES71209537463196387848,TRX_N-637-751806453815,2024-05-22T18:39:45,Bilbao,Expense,transport,-152.77,-58161.46
buyer_1,Luis,28,ES71209537463196387848,TRX_N-638-606743807875,2024-06-01T15:09:57,Bilbao,transfer,Salary,1039.38,-57122.08
buyer_1,Luis,28,ES71209537463196387848,TRX_N-639-285117487309,2024-06-01T15:09:57,Bilbao,transfer,Extra Income,103.94,-57018.14
buyer_1,Luis,28,ES71209537463196387848,TRX_N-64-986763852112,2020-06-05T12:11:38,Bilbao,Basic services,electricity,-127.98,-4919.08
buyer_1,Luis,28,ES71209537463196387848,TRX_N-640-346210158890,2024-06-01T15:09:57,Bilbao,transfer,Bonus,1078.42,-55939.72
buyer_1,Luis,28,ES71209537463196387848,TRX_N-641-722823187435,2024-06-04T06:40:40,Bilbao,Expense,clothing,-292.66,-56232.38
buyer_1,Luis,28,ES71209537463196387848,TRX_N-642-769173404970,2024-06-05T08:26:25,Bilbao,Housing,Rent,-607.32,-56839.7
buyer_1,Luis,28,ES71209537463196387848,TRX_N-643-565542488000,2024-06-05T11:50:03,Bilbao,Basic services,electricity,-131.71,-56971.41
buyer_1,Luis,28,ES71209537463196387848,TRX_N-644-150901971090,2024-06-05T16:34:44,Bilbao,Basic services,gas,-16.7,-56988.11
buyer_1,Luis,28,ES71209537463196387848,TRX_N-645-275244962444,2024-06-05T17:26:14,Bilbao,Basic services,internet,-58.21,-57046.32
buyer_1,Luis,28,ES71209537463196387848,TRX_N-646-140051079123,2024-06-05T08:13:14,Bilbao,Expense,food,-285.47,-57331.79
buyer_1,Luis,28,ES71209537463196387848,TRX_N-647-372570606451,2024-06-06T11:56:10,Bilbao,Basic services,water,-38.21,-57370.0
buyer_1,Luis,28,ES71209537463196387848,TRX_N-648-257831966166,2024-06-06T18:14:45,Bilbao,Basic services,gas,-41.85,-57411.85
buyer_1,Luis,28,ES71209537463196387848,TRX_N-649-892040421625,2024-06-07T09:22:12,Bilbao,Basic services,electricity,-104.0,-57515.85
buyer_1,Luis,28,ES71209537463196387848,TRX_N-65-257426761886,2020-06-05T19:48:34,Bilbao,Basic services,phone,-23.4,-4942.48
buyer_1,Luis,28,ES71209537463196387848,TRX_N-650-579494445704,2024-06-07T23:48:01,Bilbao,Basic services,gas,-77.32,-57593.17
buyer_1,Luis,28,ES71209537463196387848,TRX_N-651-663624059212,2024-06-08T18:12:58,Bilbao,Expense,leisure,-184.83,-57778.0
buyer_1,Luis,28,ES71209537463196387848,TRX_N-652-213173342825,2024-06-11T16:38:24,Bilbao,Expense,food,-180.18,-57958.18
buyer_1,Luis,28,ES71209537463196387848,TRX_N-653-295781794484,2024-06-12T10:54:06,Bilbao,Expense,education,-490.86,-58449.04
buyer_1,Luis,28,ES71209537463196387848,TRX_N-654-520549535409,2024-06-14T20:58:38,Bilbao,Expense,food,-157.2,-58606.24
buyer_1,Luis,28,ES71209537463196387848,TRX_N-655-22040793186,2024-06-17T20:12:09,Basauri,Expense,food,-214.45,-58820.69
buyer_1,Luis,28,ES71209537463196387848,TRX_N-656-278587670298,2024-07-01T18:34:39,Bilbao,transfer,Salary,1039.38,-57781.31
buyer_1,Luis,28,ES71209537463196387848,TRX_N-657-496488050547,2024-07-05T21:13:24,Bilbao,Housing,Rent,-607.32,-58388.63
buyer_1,Luis,28,ES71209537463196387848,TRX_N-658-777776802355,2024-07-05T13:38:02,Bilbao,Basic services,water,-51.09,-58439.72
buyer_1,Luis,28,ES71209537463196387848,TRX_N-659-153569479817,2024-07-05T13:46:14,Bilbao,Expense,repairs,-275.12,-58714.84
buyer_1,Luis,28,ES71209537463196387848,TRX_N-66-583894408604,2020-06-06T14:41:56,Bilbao,Basic services,gas,-73.5,-5015.98
buyer_1,Luis,28,ES71209537463196387848,TRX_N-660-418694912245,2024-07-06T10:19:05,Bilbao,Basic services,electricity,-61.8,-58776.64
buyer_1,Luis,28,ES71209537463196387848,TRX_N-661-489972588511,2024-07-08T21:34:19,Bilbao,Expense,education,-710.71,-59487.35
buyer_1,Luis,28,ES71209537463196387848,TRX_N-662-922097985655,2024-07-19T18:47:13,Bilbao,Expense,transport,-49.69,-59537.04
buyer_1,Luis,28,ES71209537463196387848,TRX_N-663-131774050713,2024-07-28T13:11:59,Bilbao,Expense,food,-254.49,-59791.53
buyer_1,Luis,28,ES71209537463196387848,TRX_N-664-530955959168,2024-07-28T16:03:32,Bilbao,Expense,healthcare,-99.24,-59890.77
buyer_1,Luis,28,ES71209537463196387848,TRX_N-665-226162054401,2024-07-28T17:03:08,Bilbao,Expense,repairs,-805.22,-60695.99
buyer_1,Luis,28,ES71209537463196387848,TRX_N-666-319519737117,2024-08-01T17:37:07,Bilbao,transfer,Salary,1039.38,-59656.61
buyer_1,Luis,28,ES71209537463196387848,TRX_N-667-335292563428,2024-08-01T17:37:07,Bilbao,transfer,Extra Income,103.94,-59552.67
buyer_1,Luis,28,ES71209537463196387848,TRX_N-668-771595237948,2024-08-05T11:19:12,Bilbao,Housing,Rent,-607.32,-60159.99
buyer_1,Luis,28,ES71209537463196387848,TRX_N-669-111154604211,2024-08-05T10:27:06,Bilbao,Basic services,water,-20.89,-60180.88
buyer_1,Luis,28,ES71209537463196387848,TRX_N-67-548273305980,2020-06-06T08:40:45,Bilbao,Expense,transport,-168.76,-5184.74
buyer_1,Luis,28,ES71209537463196387848,TRX_N-670-503040912817,2024-08-05T14:41:27,Bilbao,Basic services,gas,-95.45,-60276.33
buyer_1,Luis,28,ES71209537463196387848,TRX_N-671-676649435592,2024-08-05T12:55:44,Bilbao,Basic services,phone,-78.58,-60354.91
buyer_1,Luis,28,ES71209537463196387848,TRX_N-672-970283746439,2024-08-06T11:02:03,Bilbao,Basic services,water,-65.08,-60419.99
buyer_1,Luis,28,ES71209537463196387848,TRX_N-673-997905286135,2024-08-06T20:53:24,Bilbao,Basic services,electricity,-90.57,-60510.56
buyer_1,Luis,28,ES71209537463196387848,TRX_N-674-408265249425,2024-08-06T20:15:37,Bilbao,Basic services,gas,-73.64,-60584.2
buyer_1,Luis,28,ES71209537463196387848,TRX_N-675-316387626473,2024-08-06T20:27:34,Bilbao,Basic services,internet,-30.32,-60614.52
buyer_1,Luis,28,ES71209537463196387848,TRX_N-676-171113768634,2024-08-07T17:51:23,Bilbao,Basic services,gas,-55.57,-60670.09
buyer_1,Luis,28,ES71209537463196387848,TRX_N-677-401839250570,2024-08-07T13:15:31,Bilbao,Basic services,internet,-71.04,-60741.13
buyer_1,Luis,28,ES71209537463196387848,TRX_N-678-711852837762,2024-08-08T17:59:03,Bilbao,Expense,food,-339.95,-61081.08
buyer_1,Luis,28,ES71209537463196387848,TRX_N-679-441699449629,2024-08-15T21:28:49,Bilbao,Expense,transport,-131.15,-61212.23
buyer_1,Luis,28,ES71209537463196387848,TRX_N-68-338335685203,2020-06-07T11:41:28,Bilbao,Basic services,water,-20.39,-5205.13
buyer_1,Luis,28,ES71209537463196387848,TRX_N-680-507318592261,2024-08-21T13:42:09,Bilbao,Expense,transport,-42.86,-61255.09
buyer_1,Luis,28,ES71209537463196387848,TRX_N-681-892595736021,2024-09-01T09:24:43,Bilbao,transfer,Salary,1039.38,-60215.71
buyer_1,Luis,28,ES71209537463196387848,TRX_N-682-386444499479,2024-09-05T08:27:05,Bilbao,Housing,Rent,-607.32,-60823.03
buyer_1,Luis,28,ES71209537463196387848,TRX_N-683-629965919162,2024-09-06T20:42:40,Bilbao,Basic services,electricity,-34.3,-60857.33
buyer_1,Luis,28,ES71209537463196387848,TRX_N-684-805338379956,2024-09-07T23:51:36,Bilbao,Basic services,water,-55.42,-60912.75
buyer_1,Luis,28,ES71209537463196387848,TRX_N-685-918638443858,2024-09-07T14:43:27,Bilbao,Basic services,gas,-32.19,-60944.94
buyer_1,Luis,28,ES71209537463196387848,TRX_N-686-381902752092,2024-09-09T15:07:07,Bilbao,Expense,food,-693.21,-61638.15
buyer_1,Luis,28,ES71209537463196387848,TRX_N-687-977216542235,2024-09-14T11:52:49,Bilbao,Expense,healthcare,-55.67,-61693.82
buyer_1,Luis,28,ES71209537463196387848,TRX_N-688-905994787834,2024-09-15T12:40:09,Bilbao,Expense,leisure,-10.2,-61704.02
buyer_1,Luis,28,ES71209537463196387848,TRX_N-689-87452879002,2024-09-29T09:20:37,Bilbao,Expense,food,-643.59,-62347.61
buyer_1,Luis,28,ES71209537463196387848,TRX_N-69-370475054555,2020-06-07T05:32:29,Bilbao,Basic services,internet,-51.06,-5256.19
buyer_1,Luis,28,ES71209537463196387848,TRX_N-690-241160734640,2024-10-01T08:52:54,Bilbao,transfer,Salary,1039.38,-61308.23
buyer_1,Luis,28,ES71209537463196387848,TRX_N-691-287205886181,2024-10-05T19:34:28,Bilbao,Housing,Rent,-607.32,-61915.55
buyer_1,Luis,28,ES71209537463196387848,TRX_N-692-23306121590,2024-10-05T01:32:29,Bilbao,Basic services,water,-76.13,-61991.68
buyer_1,Luis,28,ES71209537463196387848,TRX_N-693-318346404240,2024-10-05T08:42:44,Bilbao,Basic services,gas,-93.64,-62085.32
buyer_1,Luis,28,ES71209537463196387848,TRX_N-694-589041150567,2024-10-06T14:29:26,Bilbao,Basic services,electricity,-114.31,-62199.63
buyer_1,Luis,28,ES71209537463196387848,TRX_N-695-750059300874,2024-10-07T13:01:58,Bilbao,Basic services,electricity,-67.79,-62267.42
buyer_1,Luis,28,ES71209537463196387848,TRX_N-696-405896975350,2024-10-07T12:24:16,Bilbao,Basic services,phone,-29.46,-62296.88
buyer_1,Luis,28,ES71209537463196387848,TRX_N-7-405105829296,2020-01-06T08:06:50,Bilbao,Basic services,electricity,-36.67,-40.13
buyer_1,Luis,28,ES71209537463196387848,TRX_N-70-419528178682,2020-06-07T00:20:27,Bilbao,Basic services,phone,-54.96,-5311.15
buyer_1,Luis,28,ES71209537463196387848,TRX_N-71-757934548894,2020-06-13T20:30:05,Bilbao,Expense,leisure,-155.34,-5466.49
buyer_1,Luis,28,ES71209537463196387848,TRX_N-72-187383845657,2020-07-01T09:08:40,Bilbao,transfer,Salary,1039.38,-4427.11
buyer_1,Luis,28,ES71209537463196387848,TRX_N-73-112914039958,2020-07-01T09:08:40,Bilbao,transfer,Extra Income,103.94,-4323.17
buyer_1,Luis,28,ES71209537463196387848,TRX_N-74-556110753085,2020-07-01T17:52:10,Bilbao,Expense,transport,-93.12,-4416.29
buyer_1,Luis,28,ES71209537463196387848,TRX_N-75-625527062902,2020-07-05T03:26:41,Bilbao,Housing,Rent,-607.32,-5023.61
buyer_1,Luis,28,ES71209537463196387848,TRX_N-76-441368105335,2020-07-05T03:04:58,Bilbao,Basic services,electricity,-58.05,-5081.66
buyer_1,Luis,28,ES71209537463196387848,TRX_N-77-114176080846,2020-07-05T09:34:16,Bilbao,Basic services,gas,-27.33,-5108.99
buyer_1,Luis,28,ES71209537463196387848,TRX_N-78-421760141915,2020-07-05T16:21:09,Bilbao,Basic services,internet,-76.52,-5185.51
buyer_1,Luis,28,ES71209537463196387848,TRX_N-79-160068224106,2020-07-05T08:51:42,Bilbao,Basic services,phone,-63.83,-5249.34
buyer_1,Luis,28,ES71209537463196387848,TRX_N-8-617953408289,2020-01-06T18:10:03,Bilbao,Basic services,internet,-65.57,-105.7
buyer_1,Luis,28,ES71209537463196387848,TRX_N-80-908962111929,2020-07-07T00:45:38,Bilbao,Basic services,water,-55.31,-5304.65
buyer_1,Luis,28,ES71209537463196387848,TRX_N-81-522328351954,2020-07-07T14:50:54,Bilbao,Expense,leisure,-96.51,-5401.16
buyer_1,Luis,28,ES71209537463196387848,TRX_N-82-60844439102,2020-07-07T16:55:27,Bilbao,Expense,healthcare,-273.83,-5674.99
buyer_1,Luis,28,ES71209537463196387848,TRX_N-83-220327040697,2020-07-17T17:51:36,Bilbao,Expense,food,-559.47,-6234.46
buyer_1,Luis,28,ES71209537463196387848,TRX_N-84-429352183640,2020-07-19T20:11:30,Bilbao,Expense,transport,-184.74,-6419.2
buyer_1,Luis,28,ES71209537463196387848,TRX_N-85-852123414933,2020-07-19T15:21:25,Bilbao,Expense,leisure,-299.8,-6719.0
buyer_1,Luis,28,ES71209537463196387848,TRX_N-86-58664156222,2020-07-21T12:54:38,Bilbao,Expense,healthcare,-326.68,-7045.68
buyer_1,Luis,28,ES71209537463196387848,TRX_N-87-243736963789,2020-08-01T20:38:19,Bilbao,transfer,Salary,1039.38,-6006.3
buyer_1,Luis,28,ES71209537463196387848,TRX_N-88-485292937965,2020-08-05T22:48:29,Bilbao,Housing,Rent,-607.32,-6613.62
buyer_1,Luis,28,ES71209537463196387848,TRX_N-89-303060401401,2020-08-05T04:50:32,Bilbao,Basic services,electricity,-58.21,-6671.83
buyer_1,Luis,28,ES71209537463196387848,TRX_N-9-525075026093,2020-01-07T22:45:44,Bilbao,Basic services,gas,-54.87,-160.57
buyer_1,Luis,28,ES71209537463196387848,TRX_N-90-474563407919,2020-08-05T16:54:11,Bilbao,Basic services,phone,-58.9,-6730.73
buyer_1,Luis,28,ES71209537463196387848,TRX_N-91-292884098810,2020-08-06T14:07:51,Bilbao,Basic services,internet,-40.9,-6771.63
buyer_1,Luis,28,ES71209537463196387848,TRX_N-92-823070637765,2020-08-07T12:24:05,Bilbao,Basic services,water,-77.88,-6849.51
buyer_1,Luis,28,ES71209537463196387848,TRX_N-93-443003225829,2020-08-07T12:48:03,Bilbao,Basic services,gas,-54.22,-6903.73
buyer_1,Luis,28,ES71209537463196387848,TRX_N-94-700118865777,2020-08-07T15:09:29,Bilbao,Expense,food,-666.02,-7569.75
buyer_1,Luis,28,ES71209537463196387848,TRX_N-95-600189325972,2020-08-09T13:35:08,Leioa,Expense,transport,-135.51,-7705.26
buyer_1,Luis,28,ES71209537463196387848,TRX_N-96-104627568632,2020-08-11T11:05:36,Zarautz,Expense,leisure,-69.6,-7774.86
buyer_1,Luis,28,ES71209537463196387848,TRX_N-97-538852374834,2020-08-25T17:26:39,Hondarribia,Expense,food,-769.13,-8543.99
buyer_1,Luis,28,ES71209537463196387848,TRX_N-98-673723075399,2020-08-26T11:40:51,Donostia,Expense,leisure,-44.52,-8588.51
buyer_1,Luis,28,ES71209537463196387848,TRX_N-99-348566500686,2020-08-28T20:56:01,Bilbao,Expense,food,-278.22,-8866.73
buyer_2,Carmen,40,ES96209573984845768625,TRX_N-1-454342825869,2020-01-01T16:04:39,Zarautz,transfer,Salary,1530.51,3056.02
buyer_2,Carmen,40,ES96209573984845768625,TRX_N-10-668162622841,2020-02-05T17:16:12,Zarautz,Basic services,gas,-23.51,959.94
buyer_2,Carmen,40,ES96209573984845768625,TRX_N-100-841807148032,2020-09-26T17:05:31,Zarautz,Expense,food,-545.37,-6023.04
buyer_2,Carmen,40,ES96209573984845768625,TRX_N-101-65777012138,2020-09-26T20:48:44,Zarautz,Expense,leisure,-26.71,-6049.75
buyer_2,Carmen,40,ES96209573984845768625,TRX_N-102-907037292067,2020-10-01T19:05:06,Zarautz,transfer,Salary,1530.51,-4519.24
buyer_2,Carmen,40,ES96209573984845768625,TRX_N-103-952484596532,2020-10-05T17:08:59,Zarautz,Housing,Rent,-1317.85,-5837.09
buyer_2,Carmen,40,ES96209573984845768625,TRX_N-104-309806009238,2020-10-05T08:46:57,Zarautz,Basic services,gas,-61.63,-5898.72
buyer_2,Carmen,40,ES96209573984845768625,TRX_N-105-15330299771,2020-10-05T17:02:07,Zarautz,Basic services,phone,-22.09,-5920.81
buyer_2,Carmen,40,ES96209573984845768625,TRX_N-106-115977725909,2020-10-06T20:52:43,Zarautz,Basic services,internet,-30.13,-5950.94
buyer_2,Carmen,40,ES96209573984845768625,TRX_N-107-56511046925,2020-10-13T11:52:21,Zarautz,Expense,food,-549.49,-6500.43
buyer_2,Carmen,40,ES96209573984845768625,TRX_N-108-191988520019,2020-10-13T10:21:23,Zarautz,Expense,clothing,-111.15,-6611.58
buyer_2,Carmen,40,ES96209573984845768625,TRX_N-109-369160264988,2020-10-21T16:41:40,Zarautz,Expense,healthcare,-364.45,-6976.03
buyer_2,Carmen,40,ES96209573984845768625,TRX_N-11-860789109020,2020-02-06T13:36:57,Zarautz,Basic services,water,-51.5,908.44
buyer_2,Carmen,40,ES96209573984845768625,TRX_N-110-278090840385,2020-10-21T18:21:06,Zarautz,Expense,education,-797.37,-7773.4
buyer_2,Carmen,40,ES96209573984845768625,TRX_N-111-479095020200,2020-10-31T08:00:47,Zarautz,Expense,travel,-2903.61,-10677.01
buyer_2,Carmen,40,ES96209573984845768625,TRX_N-112-499926663865,2020-11-01T09:32:30,Zarautz,transfer,Salary,1530.51,-9146.5
buyer_2,Carmen,40,ES96209573984845768625,TRX_N-113-529816400054,2020-11-04T17:46:42,Zarautz,Expense,leisure,-152.96,-9299.46
buyer_2,Carmen,40,ES96209573984845768625,TRX_N-114-837741538196,2020-11-05T14:42:56,Zarautz,Housing,Rent,-1317.85,-10617.31
buyer_2,Carmen,40,ES96209573984845768625,TRX_N-115-368878980133,2020-11-07T20:36:26,Zarautz,Basic services,internet,-43.18,-10660.49
buyer_2,Carmen,40,ES96209573984845768625,TRX_N-116-20311016704,2020-11-08T13:56:26,Hernani,Expense,food,-556.81,-11217.3
buyer_2,Carmen,40,ES96209573984845768625,TRX_N-117-985329094581,2020-11-08T16:31:09,Zarautz,Expense,transport,-84.32,-11301.62
buyer_2,Carmen,40,ES96209573984845768625,TRX_N-118-526903955610,2020-11-14T14:20:31,Elciego,Expense,food,-597.02,-11898.64
buyer_2,Carmen,40,ES96209573984845768625,TRX_N-119-983718950913,2020-11-16T13:25:32,Zarautz,Expense,leisure,-112.5,-12011.14
buyer_2,Carmen,40,ES96209573984845768625,TRX_N-12-649807604577,2020-02-06T17:15:59,Zarautz,Basic services,gas,-78.05,830.39
buyer_2,Carmen,40,ES96209573984845768625,TRX_N-120-323652419783,2020-11-26T18:44:47,Zarautz,Expense,travel,-395.41,-12406.55
buyer_2,Carmen,40,ES96209573984845768625,TRX_N-121-149729214894,2020-12-01T09:18:43,Zarautz,transfer,Salary,1530.51,-10876.04
buyer_2,Carmen,40,ES96209573984845768625,TRX_N-122-187292382247,2020-12-01T09:18:43,Zarautz,transfer,Extra Income,153.05,-10722.99
buyer_2,Carmen,40,ES96209573984845768625,TRX_N-123-323955288127,2020-12-01T09:18:43,Zarautz,transfer,Bonus,1643.26,-9079.73
buyer_2,Carmen,40,ES96209573984845768625,TRX_N-124-466239295113,2020-12-05T18:14:04,Zarautz,Housing,Rent,-1317.85,-10397.58
buyer_2,Carmen,40,ES96209573984845768625,TRX_N-125-715878478889,2020-12-05T13:15:11,Zarautz,Basic services,electricity,-70.47,-10468.05
buyer_2,Carmen,40,ES96209573984845768625,TRX_N-126-800086314411,2020-12-06T08:18:49,Zarautz,Basic services,water,-79.55,-10547.6
buyer_2,Carmen,40,ES96209573984845768625,TRX_N-127-204369183503,2020-12-06T02:34:39,Zarautz,Basic services,gas,-74.51,-10622.11
buyer_2,Carmen,40,ES96209573984845768625,TRX_N-128-58887629349,2020-12-06T15:39:09,Zarautz,Basic services,internet,-55.64,-10677.75
buyer_2,Carmen,40,ES96209573984845768625,TRX_N-129-317892218130,2020-12-07T14:01:08,Zarautz,Basic services,electricity,-137.63,-10815.38
buyer_2,Carmen,40,ES96209573984845768625,TRX_N-13-891627526712,2020-02-06T14:30:37,Zarautz,Basic services,phone,-27.03,803.36
buyer_2,Carmen,40,ES96209573984845768625,TRX_N-130-289934766406,2020-12-07T14:59:46,Zarautz,Basic services,phone,-53.99,-10869.37
buyer_2,Carmen,40,ES96209573984845768625,TRX_N-131-598140687548,2020-12-13T15:11:33,Zarautz,Expense,transport,-86.57,-10955.94
buyer_2,Carmen,40,ES96209573984845768625,TRX_N-132-625069014283,2020-12-14T08:20:54,Zarautz,Expense,food,-314.77,-11270.71
buyer_2,Carmen,40,ES96209573984845768625,TRX_N-133-268532527057,2020-12-21T15:36:56,Bilbao,Expense,transport,-189.8,-11460.51
buyer_2,Carmen,40,ES96209573984845768625,TRX_N-134-334047774134,2020-12-25T03:11:33,Zarautz,Expense,clothing,-390.32,-11850.83
buyer_2,Carmen,40,ES96209573984845768625,TRX_N-135-18861746675,2021-01-01T09:11:19,Zarautz,transfer,Salary,1530.51,-10320.32
buyer_2,Carmen,40,ES96209573984845768625,TRX_N-136-760735551704,2021-01-02T22:27:49,Zarautz,Expense,food,-337.9,-10658.22
buyer_2,Carmen,40,ES96209573984845768625,TRX_N-137-100214126423,2021-01-03T14:15:42,Zarautz,Expense,food,-451.53,-11109.75
buyer_2,Carmen,40,ES96209573984845768625,TRX_N-138-224974817370,2021-01-03T10:55:01,Zarautz,Expense,gifts,-341.75,-11451.5
buyer_2,Carmen,40,ES96209573984845768625,TRX_N-139-35813551111,2021-01-05T08:09:20,Zarautz,Housing,Rent,-1317.85,-12769.35
buyer_2,Carmen,40,ES96209573984845768625,TRX_N-14-303364341630,2020-02-07T07:12:41,Zarautz,Basic services,water,-18.55,784.81
buyer_2,Carmen,40,ES96209573984845768625,TRX_N-140-338094116230,2021-01-06T09:26:19,Zarautz,Basic services,electricity,-137.58,-12906.93
buyer_2,Carmen,40,ES96209573984845768625,TRX_N-141-389884238980,2021-01-06T11:11:22,Zarautz,Basic services,phone,-26.05,-12932.98
buyer_2,Carmen,40,ES96209573984845768625,TRX_N-142-20145975873,2021-01-07T13:43:05,Zarautz,Basic services,water,-36.8,-12969.78
buyer_2,Carmen,40,ES96209573984845768625,TRX_N-143-185693010144,2021-01-15T08:13:49,Zarautz,Expense,healthcare,-252.78,-13222.56
buyer_2,Carmen,40,ES96209573984845768625,TRX_N-144-746976273332,2021-01-17T23:02:47,Zarautz,Expense,clothing,-238.95,-13461.51
buyer_2,Carmen,40,ES96209573984845768625,TRX_N-145-324410182801,2021-01-18T02:32:50,Zarautz,Expense,education,-617.42,-14078.93
buyer_2,Carmen,40,ES96209573984845768625,TRX_N-146-522692779174,2021-01-23T08:51:31,Zarautz,Expense,clothing,-450.2,-14529.13
buyer_2,Carmen,40,ES96209573984845768625,TRX_N-147-425610978688,2021-01-23T03:27:23,Zarautz,Expense,travel,-2915.18,-17444.31
buyer_2,Carmen,40,ES96209573984845768625,TRX_N-148-728115204376,2021-01-29T19:55:06,Sopela,Expense,transport,-183.82,-17628.13
buyer_2,Carmen,40,ES96209573984845768625,TRX_N-149-285704556470,2021-02-01T16:20:43,Zarautz,transfer,Salary,1530.51,-16097.62
buyer_2,Carmen,40,ES96209573984845768625,TRX_N-15-485927855173,2020-02-07T15:50:10,Zarautz,Basic services,electricity,-143.37,641.44
buyer_2,Carmen,40,ES96209573984845768625,TRX_N-150-674958470351,2021-02-01T16:20:43,Zarautz,transfer,Extra Income,153.05,-15944.57
buyer_2,Carmen,40,ES96209573984845768625,TRX_N-151-502569755249,2021-02-04T12:03:24,Zarautz,Expense,repairs,-475.38,-16419.95
buyer_2,Carmen,40,ES96209573984845768625,TRX_N-152-678398354673,2021-02-05T13:05:22,Zarautz,Housing,Rent,-1317.85,-17737.8
buyer_2,Carmen,40,ES96209573984845768625,TRX_N-153-206080810881,2021-02-05T10:47:51,Zarautz,Basic services,electricity,-36.29,-17774.09
buyer_2,Carmen,40,ES96209573984845768625,TRX_N-154-339761671805,2021-02-06T09:59:18,Zarautz,Expense,transport,-188.14,-17962.23
buyer_2,Carmen,40,ES96209573984845768625,TRX_N-155-262993227185,2021-02-07T15:41:13,Zarautz,Basic services,electricity,-37.09,-17999.32
buyer_2,Carmen,40,ES96209573984845768625,TRX_N-156-930389705119,2021-02-07T11:16:28,Zarautz,Basic services,internet,-31.26,-18030.58
buyer_2,Carmen,40,ES96209573984845768625,TRX_N-157-144512119074,2021-02-20T00:05:02,Zarautz,Expense,food,-571.26,-18601.84
buyer_2,Carmen,40,ES96209573984845768625,TRX_N-158-535493926491,2021-02-22T09:51:49,Zarautz,Expense,education,-387.63,-18989.47
buyer_2,Carmen,40,ES96209573984845768625,TRX_N-159-908054009816,2021-02-23T10:06:07,Zarautz,Expense,food,-764.25,-19753.72
buyer_2,Carmen,40,ES96209573984845768625,TRX_N-16-308123773719,2020-02-07T16:38:52,Zarautz,Basic services,gas,-83.11,558.33
buyer_2,Carmen,40,ES96209573984845768625,TRX_N-160-875181427582,2021-03-01T18:43:14,Zarautz,transfer,Salary,1530.51,-18223.21
buyer_2,Carmen,40,ES96209573984845768625,TRX_N-161-551612152405,2021-03-03T12:43:40,Zarautz,Expense,food,-106.74,-18329.95
buyer_2,Carmen,40,ES96209573984845768625,TRX_N-162-345742437481,2021-03-05T08:56:20,Zarautz,Housing,Rent,-1317.85,-19647.8
buyer_2,Carmen,40,ES96209573984845768625,TRX_N-163-425969549568,2021-03-05T22:12:28,Zarautz,Basic services,water,-23.91,-19671.71
buyer_2,Carmen,40,ES96209573984845768625,TRX_N-164-122889215907,2021-03-05T17:20:24,Zarautz,Basic services,phone,-48.92,-19720.63
buyer_2,Carmen,40,ES96209573984845768625,TRX_N-165-928274036141,2021-03-07T11:17:47,Zarautz,Basic services,gas,-90.49,-19811.12
buyer_2,Carmen,40,ES96209573984845768625,TRX_N-166-571605569306,2021-03-07T11:29:16,Zarautz,Basic services,internet,-51.3,-19862.42
buyer_2,Carmen,40,ES96209573984845768625,TRX_N-167-254799294613,2021-03-07T10:17:51,Zarautz,Basic services,phone,-69.48,-19931.9
buyer_2,Carmen,40,ES96209573984845768625,TRX_N-168-654851716015,2021-03-19T10:58:13,Zarautz,Expense,leisure,-202.19,-20134.09
buyer_2,Carmen,40,ES96209573984845768625,TRX_N-169-482812302663,2021-03-20T10:37:42,Alegría-Dulantzi,Expense,travel,-350.89,-20484.98
buyer_2,Carmen,40,ES96209573984845768625,TRX_N-17-340510179192,2020-02-07T23:24:09,Zarautz,Basic services,internet,-75.49,482.84
buyer_2,Carmen,40,ES96209573984845768625,TRX_N-170-192502822710,2021-04-01T09:10:28,Zarautz,transfer,Salary,1530.51,-18954.47
buyer_2,Carmen,40,ES96209573984845768625,TRX_N-171-809557528522,2021-04-05T20:30:51,Zarautz,Housing,Rent,-1317.85,-20272.32
buyer_2,Carmen,40,ES96209573984845768625,TRX_N-172-751625290062,2021-04-05T18:24:25,Zarautz,Basic services,water,-24.48,-20296.8
buyer_2,Carmen,40,ES96209573984845768625,TRX_N-173-548596594476,2021-04-05T09:07:40,Zarautz,Basic services,electricity,-83.91,-20380.71
buyer_2,Carmen,40,ES96209573984845768625,TRX_N-174-486259907163,2021-04-05T09:33:45,Zarautz,Basic services,phone,-88.14,-20468.85
buyer_2,Carmen,40,ES96209573984845768625,TRX_N-175-708548301725,2021-04-06T19:27:28,Zarautz,Basic services,gas,-50.75,-20519.6
buyer_2,Carmen,40,ES96209573984845768625,TRX_N-176-599154201547,2021-04-07T17:55:53,Zarautz,Basic services,electricity,-119.5,-20639.1
buyer_2,Carmen,40,ES96209573984845768625,TRX_N-177-685432878349,2021-04-07T10:09:05,Zarautz,Basic services,gas,-18.6,-20657.7
buyer_2,Carmen,40,ES96209573984845768625,TRX_N-178-468926123236,2021-04-10T03:44:00,Zarautz,Expense,healthcare,-391.41,-21049.11
buyer_2,Carmen,40,ES96209573984845768625,TRX_N-179-991942857725,2021-04-25T14:42:36,Zarautz,Expense,gifts,-331.43,-21380.54
buyer_2,Carmen,40,ES96209573984845768625,TRX_N-18-664062480684,2020-02-08T22:16:10,Zarautz,Expense,food,-765.13,-282.29
buyer_2,Carmen,40,ES96209573984845768625,TRX_N-180-411339913262,2021-05-01T08:21:00,Zarautz,transfer,Salary,1530.51,-19850.03
buyer_2,Carmen,40,ES96209573984845768625,TRX_N-181-795674604854,2021-05-01T08:21:00,Zarautz,transfer,Extra Income,153.05,-19696.98
buyer_2,Carmen,40,ES96209573984845768625,TRX_N-182-790962079600,2021-05-05T07:22:50,Zarautz,Housing,Rent,-1317.85,-21014.83
buyer_2,Carmen,40,ES96209573984845768625,TRX_N-183-101281555113,2021-05-05T13:22:33,Zarautz,Basic services,phone,-49.39,-21064.22
buyer_2,Carmen,40,ES96209573984845768625,TRX_N-184-793211163599,2021-05-07T18:28:52,Zarautz,Basic services,water,-25.57,-21089.79
buyer_2,Carmen,40,ES96209573984845768625,TRX_N-185-585803411666,2021-05-07T13:22:19,Zarautz,Basic services,electricity,-103.98,-21193.77
buyer_2,Carmen,40,ES96209573984845768625,TRX_N-186-293668246653,2021-05-07T14:00:32,Zarautz,Basic services,gas,-97.12,-21290.89
buyer_2,Carmen,40,ES96209573984845768625,TRX_N-187-547273995880,2021-05-07T14:39:19,Zarautz,Basic services,phone,-77.18,-21368.07
buyer_2,Carmen,40,ES96209573984845768625,TRX_N-188-588785334808,2021-05-09T09:05:57,Zarautz,Expense,transport,-173.25,-21541.32
buyer_2,Carmen,40,ES96209573984845768625,TRX_N-189-564014338831,2021-05-19T19:41:08,Zarautz,Expense,repairs,-426.62,-21967.94
buyer_2,Carmen,40,ES96209573984845768625,TRX_N-19-313141248758,2020-03-01T21:14:40,Zarautz,transfer,Salary,1530.51,1248.22
buyer_2,Carmen,40,ES96209573984845768625,TRX_N-190-435694554987,2021-05-30T13:10:43,Zarautz,Expense,transport,-130.52,-22098.46
buyer_2,Carmen,40,ES96209573984845768625,TRX_N-191-810558700655,2021-06-01T20:17:00,Zarautz,transfer,Salary,1530.51,-20567.95
buyer_2,Carmen,40,ES96209573984845768625,TRX_N-192-307240117226,2021-06-01T20:17:00,Zarautz,transfer,Bonus,1667.92,-18900.03
buyer_2,Carmen,40,ES96209573984845768625,TRX_N-193-909050637514,2021-06-02T12:34:26,Zarautz,Expense,clothing,-335.33,-19235.36
buyer_2,Carmen,40,ES96209573984845768625,TRX_N-194-874633770470,2021-06-04T11:12:07,Zarautz,Expense,education,-952.21,-20187.57
buyer_2,Carmen,40,ES96209573984845768625,TRX_N-195-569243996100,2021-06-05T11:43:40,Zarautz,Housing,Rent,-1317.85,-21505.42
buyer_2,Carmen,40,ES96209573984845768625,TRX_N-196-915254530963,2021-06-06T09:09:42,Zarautz,Basic services,gas,-41.92,-21547.34
buyer_2,Carmen,40,ES96209573984845768625,TRX_N-197-645893917543,2021-06-07T19:54:38,Zarautz,Basic services,phone,-56.93,-21604.27
buyer_2,Carmen,40,ES96209573984845768625,TRX_N-198-653705525532,2021-06-07T16:28:29,Zarautz,Expense,leisure,-171.33,-21775.6
buyer_2,Carmen,40,ES96209573984845768625,TRX_N-199-497641361632,2021-06-16T23:59:50,Zarautz,Expense,food,-110.24,-21885.84
buyer_2,Carmen,40,ES96209573984845768625,TRX_N-2-50337542699,2020-01-05T12:45:29,Zarautz,Housing,Rent,-1317.85,1738.17
buyer_2,Carmen,40,ES96209573984845768625,TRX_N-20-363159568599,2020-03-01T21:14:40,Zarautz,transfer,Extra Income,153.05,1401.27
buyer_2,Carmen,40,ES96209573984845768625,TRX_N-200-721636979558,2021-06-24T13:39:55,Zarautz,Expense,transport,-44.16,-21930.0
buyer_2,Carmen,40,ES96209573984845768625,TRX_N-201-911317639411,2021-06-30T20:13:42,Zarautz,Expense,gifts,-322.47,-22252.47
buyer_2,Carmen,40,ES96209573984845768625,TRX_N-202-856729598903,2021-07-01T13:04:56,Zarautz,transfer,Salary,1530.51,-20721.96
buyer_2,Carmen,40,ES96209573984845768625,TRX_N-203-878739648102,2021-07-01T13:04:56,Zarautz,transfer,Extra Income,153.05,-20568.91
buyer_2,Carmen,40,ES96209573984845768625,TRX_N-204-65518420227,2021-07-05T14:24:18,Zarautz,Housing,Rent,-1317.85,-21886.76
buyer_2,Carmen,40,ES96209573984845768625,TRX_N-205-203683807091,2021-07-05T15:28:10,Zarautz,Basic services,water,-72.97,-21959.73
buyer_2,Carmen,40,ES96209573984845768625,TRX_N-206-648911588735,2021-07-05T09:23:52,Zarautz,Expense,food,-707.38,-22667.11
buyer_2,Carmen,40,ES96209573984845768625,TRX_N-207-681170339475,2021-07-06T15:34:46,Zarautz,Basic services,water,-12.98,-22680.09
buyer_2,Carmen,40,ES96209573984845768625,TRX_N-208-648185445348,2021-07-06T11:42:20,Zarautz,Basic services,phone,-46.33,-22726.42
buyer_2,Carmen,40,ES96209573984845768625,TRX_N-209-45526956902,2021-07-07T02:32:50,Zarautz,Basic services,electricity,-113.53,-22839.95
buyer_2,Carmen,40,ES96209573984845768625,TRX_N-21-118002412437,2020-03-01T19:16:48,Portugalete,Expense,transport,-156.64,1244.63
buyer_2,Carmen,40,ES96209573984845768625,TRX_N-210-756789149600,2021-07-07T14:37:25,Zarautz,Basic services,internet,-42.65,-22882.6
buyer_2,Carmen,40,ES96209573984845768625,TRX_N-211-491091008296,2021-07-07T15:50:15,Zarautz,Expense,education,-160.1,-23042.7
buyer_2,Carmen,40,ES96209573984845768625,TRX_N-212-821328213702,2021-07-09T10:34:15,Zarautz,Expense,transport,-121.89,-23164.59
buyer_2,Carmen,40,ES96209573984845768625,TRX_N-213-637632552152,2021-07-28T08:48:29,Zarautz,Expense,leisure,-267.44,-23432.03
buyer_2,Carmen,40,ES96209573984845768625,TRX_N-214-487220983474,2021-08-01T18:25:19,Zarautz,transfer,Salary,1530.51,-21901.52
buyer_2,Carmen,40,ES96209573984845768625,TRX_N-215-488136749814,2021-08-01T17:16:49,Zarautz,Expense,food,-382.83,-22284.35
buyer_2,Carmen,40,ES96209573984845768625,TRX_N-216-856707059744,2021-08-04T19:29:34,Zarautz,Expense,food,-376.25,-22660.6
buyer_2,Carmen,40,ES96209573984845768625,TRX_N-217-474204832888,2021-08-05T11:42:03,Zarautz,Housing,Rent,-1317.85,-23978.45
buyer_2,Carmen,40,ES96209573984845768625,TRX_N-218-250195500802,2021-08-05T16:09:46,Zarautz,Basic services,gas,-97.78,-24076.23
buyer_2,Carmen,40,ES96209573984845768625,TRX_N-219-201138222561,2021-08-05T11:18:07,Zarautz,Basic services,internet,-62.25,-24138.48
buyer_2,Carmen,40,ES96209573984845768625,TRX_N-22-760647177320,2020-03-02T20:29:30,Zarautz,Expense,transport,-191.1,1053.53
buyer_2,Carmen,40,ES96209573984845768625,TRX_N-220-686515147469,2021-08-05T20:15:25,Zarautz,Basic services,phone,-65.79,-24204.27
buyer_2,Carmen,40,ES96209573984845768625,TRX_N-221-808185529770,2021-08-05T15:49:36,Zarautz,Expense,clothing,-323.41,-24527.68
buyer_2,Carmen,40,ES96209573984845768625,TRX_N-222-532386288442,2021-08-06T21:55:30,Zarautz,Basic services,internet,-46.94,-24574.62
buyer_2,Carmen,40,ES96209573984845768625,TRX_N-223-847995158564,2021-08-07T10:04:29,Zarautz,Basic services,electricity,-59.76,-24634.38
buyer_2,Carmen,40,ES96209573984845768625,TRX_N-224-290416395294,2021-08-09T16:42:36,Zarautz,Expense,transport,-106.6,-24740.98
buyer_2,Carmen,40,ES96209573984845768625,TRX_N-225-963441635345,2021-09-01T08:52:06,Zarautz,transfer,Salary,1530.51,-23210.47
buyer_2,Carmen,40,ES96209573984845768625,TRX_N-226-908999304144,2021-09-01T08:52:06,Zarautz,transfer,Extra Income,153.05,-23057.42
buyer_2,Carmen,40,ES96209573984845768625,TRX_N-227-63348583333,2021-09-05T12:51:39,Zarautz,Housing,Rent,-1317.85,-24375.27
buyer_2,Carmen,40,ES96209573984845768625,TRX_N-228-578218594079,2021-09-05T10:16:19,Zarautz,Basic services,phone,-50.34,-24425.61
buyer_2,Carmen,40,ES96209573984845768625,TRX_N-229-574471453420,2021-09-06T09:30:56,Zarautz,Basic services,gas,-69.92,-24495.53
buyer_2,Carmen,40,ES96209573984845768625,TRX_N-23-132108507697,2020-03-05T18:59:05,Zarautz,Housing,Rent,-1317.85,-264.32
buyer_2,Carmen,40,ES96209573984845768625,TRX_N-230-227552667418,2021-09-07T16:45:26,Zarautz,Basic services,gas,-84.04,-24579.57
buyer_2,Carmen,40,ES96209573984845768625,TRX_N-231-778640081903,2021-09-17T19:36:17,Zarautz,Expense,leisure,-62.7,-24642.27
buyer_2,Carmen,40,ES96209573984845768625,TRX_N-232-177630826277,2021-09-22T13:23:14,Zarautz,Expense,leisure,-166.52,-24808.79
buyer_2,Carmen,40,ES96209573984845768625,TRX_N-233-585392599232,2021-10-01T19:33:37,Zarautz,transfer,Salary,1530.51,-23278.28
buyer_2,Carmen,40,ES96209573984845768625,TRX_N-234-382359679638,2021-10-04T08:04:10,Zarautz,Expense,clothing,-130.36,-23408.64
buyer_2,Carmen,40,ES96209573984845768625,TRX_N-235-926117356178,2021-10-05T15:06:02,Zarautz,Housing,Rent,-1317.85,-24726.49
buyer_2,Carmen,40,ES96209573984845768625,TRX_N-236-821723268218,2021-10-05T10:25:39,Zarautz,Basic services,water,-71.66,-24798.15
buyer_2,Carmen,40,ES96209573984845768625,TRX_N-237-970917465233,2021-10-05T12:54:30,Zarautz,Basic services,gas,-24.51,-24822.66
buyer_2,Carmen,40,ES96209573984845768625,TRX_N-238-913558779208,2021-10-05T01:18:06,Zarautz,Basic services,internet,-63.76,-24886.42
buyer_2,Carmen,40,ES96209573984845768625,TRX_N-239-796704886256,2021-10-06T17:55:07,Zarautz,Basic services,electricity,-80.42,-24966.84
buyer_2,Carmen,40,ES96209573984845768625,TRX_N-24-669495729977,2020-03-05T09:46:21,Zarautz,Basic services,internet,-34.48,-298.8
buyer_2,Carmen,40,ES96209573984845768625,TRX_N-240-959760535991,2021-10-06T18:58:34,Zarautz,Basic services,gas,-38.82,-25005.66
buyer_2,Carmen,40,ES96209573984845768625,TRX_N-241-417251917652,2021-10-06T02:05:01,Zarautz,Basic services,internet,-75.96,-25081.62
buyer_2,Carmen,40,ES96209573984845768625,TRX_N-242-894989565636,2021-10-06T16:26:59,Zarautz,Expense,food,-703.26,-25784.88
buyer_2,Carmen,40,ES96209573984845768625,TRX_N-243-548863309809,2021-10-07T08:35:28,Zarautz,Basic services,water,-37.72,-25822.6
buyer_2,Carmen,40,ES96209573984845768625,TRX_N-244-267474417294,2021-10-07T18:02:06,Zarautz,Basic services,internet,-43.3,-25865.9
buyer_2,Carmen,40,ES96209573984845768625,TRX_N-245-195582885696,2021-10-17T19:31:25,Zarautz,Expense,healthcare,-328.23,-26194.13
buyer_2,Carmen,40,ES96209573984845768625,TRX_N-246-184972982138,2021-10-28T15:07:12,Zarautz,Expense,healthcare,-298.76,-26492.89
buyer_2,Carmen,40,ES96209573984845768625,TRX_N-247-559580878450,2021-10-30T21:35:26,Zarautz,Expense,food,-188.13,-26681.02
buyer_2,Carmen,40,ES96209573984845768625,TRX_N-248-411886254720,2021-10-31T14:02:43,Zarautz,Expense,repairs,-648.71,-27329.73
buyer_2,Carmen,40,ES96209573984845768625,TRX_N-249-665878524501,2021-11-01T12:10:14,Zarautz,transfer,Salary,1530.51,-25799.22
buyer_2,Carmen,40,ES96209573984845768625,TRX_N-25-596549722405,2020-03-06T07:48:48,Zarautz,Basic services,water,-35.97,-334.77
buyer_2,Carmen,40,ES96209573984845768625,TRX_N-250-745117825560,2021-11-02T22:35:31,Zarautz,Expense,transport,-170.72,-25969.94
buyer_2,Carmen,40,ES96209573984845768625,TRX_N-251-405041972073,2021-11-05T20:11:37,Zarautz,Housing,Rent,-1317.85,-27287.79
buyer_2,Carmen,40,ES96209573984845768625,TRX_N-252-923744492542,2021-11-05T12:16:28,Zarautz,Basic services,electricity,-29.54,-27317.33
buyer_2,Carmen,40,ES96209573984845768625,TRX_N-253-945267884856,2021-11-05T12:04:08,Zarautz,Basic services,phone,-96.2,-27413.53
buyer_2,Carmen,40,ES96209573984845768625,TRX_N-254-862369529360,2021-11-05T08:29:04,Zarautz,Expense,transport,-36.57,-27450.1
buyer_2,Carmen,40,ES96209573984845768625,TRX_N-255-150882675015,2021-11-07T19:00:39,Zarautz,Basic services,electricity,-47.05,-27497.15
buyer_2,Carmen,40,ES96209573984845768625,TRX_N-256-257257545541,2021-11-07T14:25:51,Zarautz,Basic services,internet,-73.46,-27570.61
buyer_2,Carmen,40,ES96209573984845768625,TRX_N-257-816767967603,2021-11-10T14:17:46,Zarautz,Expense,leisure,-70.2,-27640.81
buyer_2,Carmen,40,ES96209573984845768625,TRX_N-258-729352375749,2021-11-13T10:40:44,Zarautz,Expense,leisure,-137.62,-27778.43
buyer_2,Carmen,40,ES96209573984845768625,TRX_N-259-71123039962,2021-11-15T16:55:16,Zarautz,Expense,transport,-151.32,-27929.75
buyer_2,Carmen,40,ES96209573984845768625,TRX_N-26-447931270656,2020-03-06T12:49:05,Zarautz,Basic services,gas,-17.76,-352.53
buyer_2,Carmen,40,ES96209573984845768625,TRX_N-260-637782830203,2021-11-18T19:46:48,Zarautz,Expense,gifts,-494.94,-28424.69
buyer_2,Carmen,40,ES96209573984845768625,TRX_N-261-899072907964,2021-11-27T19:08:26,Zarautz,Expense,food,-230.83,-28655.52
buyer_2,Carmen,40,ES96209573984845768625,TRX_N-262-768359091052,2021-11-29T07:41:26,Zarautz,Expense,food,-313.99,-28969.51
buyer_2,Carmen,40,ES96209573984845768625,TRX_N-263-492959760168,2021-12-01T23:42:59,Zarautz,transfer,Salary,1530.51,-27439.0
buyer_2,Carmen,40,ES96209573984845768625,TRX_N-264-947475792496,2021-12-01T23:42:59,Zarautz,transfer,Extra Income,153.05,-27285.95
buyer_2,Carmen,40,ES96209573984845768625,TRX_N-265-179510400456,2021-12-01T23:42:59,Zarautz,transfer,Bonus,1674.75,-25611.2
buyer_2,Carmen,40,ES96209573984845768625,TRX_N-266-686996830710,2021-12-05T18:53:22,Zarautz,Housing,Rent,-1317.85,-26929.05
buyer_2,Carmen,40,ES96209573984845768625,TRX_N-267-501040580784,2021-12-05T23:48:37,Zarautz,Basic services,electricity,-73.23,-27002.28
buyer_2,Carmen,40,ES96209573984845768625,TRX_N-268-231167872871,2021-12-05T10:31:47,Zarautz,Basic services,gas,-17.06,-27019.34
buyer_2,Carmen,40,ES96209573984845768625,TRX_N-269-572345152531,2021-12-05T00:56:17,Zarautz,Basic services,internet,-55.44,-27074.78
buyer_2,Carmen,40,ES96209573984845768625,TRX_N-27-212815734427,2020-03-06T12:53:28,Zarautz,Basic services,internet,-49.77,-402.3
buyer_2,Carmen,40,ES96209573984845768625,TRX_N-270-434590640739,2021-12-05T04:18:43,Zarautz,Basic services,phone,-74.53,-27149.31
buyer_2,Carmen,40,ES96209573984845768625,TRX_N-271-105445193902,2021-12-06T15:57:11,Zarautz,Basic services,electricity,-66.1,-27215.41
buyer_2,Carmen,40,ES96209573984845768625,TRX_N-272-624346190026,2021-12-07T18:57:14,Zarautz,Basic services,internet,-43.71,-27259.12
buyer_2,Carmen,40,ES96209573984845768625,TRX_N-273-34224852480,2021-12-07T08:15:53,Zarautz,Basic services,phone,-62.95,-27322.07
buyer_2,Carmen,40,ES96209573984845768625,TRX_N-274-237239668733,2021-12-07T17:59:15,Zarautz,Expense,transport,-122.96,-27445.03
buyer_2,Carmen,40,ES96209573984845768625,TRX_N-275-193802850035,2021-12-09T14:47:55,Zarautz,Expense,repairs,-600.04,-28045.07
buyer_2,Carmen,40,ES96209573984845768625,TRX_N-276-621061389676,2021-12-28T09:21:54,Amurrio,Expense,transport,-115.35,-28160.42
buyer_2,Carmen,40,ES96209573984845768625,TRX_N-277-382814701187,2021-12-28T23:16:24,Zarautz,Expense,repairs,-284.73,-28445.15
buyer_2,Carmen,40,ES96209573984845768625,TRX_N-278-556435959219,2022-01-01T21:09:44,Zarautz,transfer,Salary,1530.51,-26914.64
buyer_2,Carmen,40,ES96209573984845768625,TRX_N-279-681974226421,2022-01-05T13:39:29,Zarautz,Housing,Rent,-1317.85,-28232.49
buyer_2,Carmen,40,ES96209573984845768625,TRX_N-28-951940675995,2020-03-06T14:08:46,Zarautz,Basic services,phone,-59.29,-461.59
buyer_2,Carmen,40,ES96209573984845768625,TRX_N-280-735727589208,2022-01-05T10:35:15,Zarautz,Basic services,water,-13.71,-28246.2
buyer_2,Carmen,40,ES96209573984845768625,TRX_N-281-272051657978,2022-01-05T19:10:06,Zarautz,Basic services,electricity,-55.2,-28301.4
buyer_2,Carmen,40,ES96209573984845768625,TRX_N-282-136904359396,2022-01-05T19:55:04,Zarautz,Basic services,internet,-46.72,-28348.12
buyer_2,Carmen,40,ES96209573984845768625,TRX_N-283-346526624902,2022-01-06T14:57:21,Zarautz,Basic services,water,-19.66,-28367.78
buyer_2,Carmen,40,ES96209573984845768625,TRX_N-284-645499203629,2022-01-06T07:25:17,Zarautz,Basic services,gas,-53.12,-28420.9
buyer_2,Carmen,40,ES96209573984845768625,TRX_N-285-444107296241,2022-01-06T17:11:58,Zarautz,Basic services,internet,-59.83,-28480.73
buyer_2,Carmen,40,ES96209573984845768625,TRX_N-286-373614663852,2022-01-07T03:33:09,Zarautz,Basic services,gas,-83.43,-28564.16
buyer_2,Carmen,40,ES96209573984845768625,TRX_N-287-854560474863,2022-01-07T01:23:38,Zarautz,Expense,travel,-610.36,-29174.52
buyer_2,Carmen,40,ES96209573984845768625,TRX_N-288-568383284908,2022-01-23T09:56:04,Zarautz,Expense,food,-353.2,-29527.72
buyer_2,Carmen,40,ES96209573984845768625,TRX_N-289-118395973992,2022-01-24T14:32:27,Zarautz,Expense,transport,-80.05,-29607.77
buyer_2,Carmen,40,ES96209573984845768625,TRX_N-29-565696379795,2020-03-07T18:52:25,Zarautz,Basic services,water,-38.25,-499.84
buyer_2,Carmen,40,ES96209573984845768625,TRX_N-290-861525401702,2022-02-01T18:25:58,Zarautz,transfer,Salary,1530.51,-28077.26
buyer_2,Carmen,40,ES96209573984845768625,TRX_N-291-111721348815,2022-02-03T14:26:25,Zarautz,Expense,food,-196.04,-28273.3
buyer_2,Carmen,40,ES96209573984845768625,TRX_N-292-601124443643,2022-02-05T10:44:29,Zarautz,Housing,Rent,-1317.85,-29591.15
buyer_2,Carmen,40,ES96209573984845768625,TRX_N-293-822042916186,2022-02-05T08:29:18,Zarautz,Basic services,phone,-95.24,-29686.39
buyer_2,Carmen,40,ES96209573984845768625,TRX_N-294-338816710601,2022-02-06T01:40:56,Zarautz,Basic services,electricity,-27.29,-29713.68
buyer_2,Carmen,40,ES96209573984845768625,TRX_N-295-108337029960,2022-02-06T20:27:28,Zarautz,Basic services,internet,-56.58,-29770.26
buyer_2,Carmen,40,ES96209573984845768625,TRX_N-296-432616310121,2022-02-07T22:19:08,Zarautz,Basic services,gas,-88.34,-29858.6
buyer_2,Carmen,40,ES96209573984845768625,TRX_N-297-470304075704,2022-02-07T09:23:46,Zarautz,Basic services,internet,-51.01,-29909.61
buyer_2,Carmen,40,ES96209573984845768625,TRX_N-298-750343771933,2022-02-07T15:48:08,Zarautz,Basic services,phone,-59.41,-29969.02
buyer_2,Carmen,40,ES96209573984845768625,TRX_N-299-335715365910,2022-02-26T14:44:11,Zarautz,Expense,travel,-397.26,-30366.28
buyer_2,Carmen,40,ES96209573984845768625,TRX_N-3-753646227588,2020-01-05T16:58:50,Zarautz,Basic services,internet,-31.02,1707.15
buyer_2,Carmen,40,ES96209573984845768625,TRX_N-30-796204739105,2020-03-07T19:18:28,Zarautz,Basic services,electricity,-33.83,-533.67
buyer_2,Carmen,40,ES96209573984845768625,TRX_N-300-483528550912,2022-03-01T14:36:50,Zarautz,transfer,Salary,1530.51,-28835.77
buyer_2,Carmen,40,ES96209573984845768625,TRX_N-301-519357617791,2022-03-01T14:36:50,Zarautz,transfer,Extra Income,153.05,-28682.72
buyer_2,Carmen,40,ES96209573984845768625,TRX_N-302-478021375758,2022-03-04T11:28:10,Zarautz,Expense,transport,-35.68,-28718.4
buyer_2,Carmen,40,ES96209573984845768625,TRX_N-303-993407515391,2022-03-05T14:31:49,Zarautz,Housing,Rent,-1317.85,-30036.25
buyer_2,Carmen,40,ES96209573984845768625,TRX_N-304-591401785633,2022-03-05T16:03:45,Zarautz,Basic services,internet,-43.8,-30080.05
buyer_2,Carmen,40,ES96209573984845768625,TRX_N-305-369150388883,2022-03-05T08:00:13,Zarautz,Basic services,phone,-69.9,-30149.95
buyer_2,Carmen,40,ES96209573984845768625,TRX_N-306-534488343771,2022-03-06T19:00:21,Zarautz,Basic services,electricity,-20.26,-30170.21
buyer_2,Carmen,40,ES96209573984845768625,TRX_N-307-5962675345,2022-03-07T07:53:43,Zarautz,Basic services,water,-41.99,-30212.2
buyer_2,Carmen,40,ES96209573984845768625,TRX_N-308-140935897151,2022-03-07T20:45:06,Zarautz,Basic services,electricity,-116.19,-30328.39
buyer_2,Carmen,40,ES96209573984845768625,TRX_N-309-54079266074,2022-03-07T14:06:15,Zarautz,Basic services,gas,-73.39,-30401.78
buyer_2,Carmen,40,ES96209573984845768625,TRX_N-31-312358496290,2020-03-07T12:54:18,Zarautz,Basic services,phone,-26.15,-559.82
buyer_2,Carmen,40,ES96209573984845768625,TRX_N-310-455185387348,2022-03-24T16:50:33,Pasaia,Expense,healthcare,-271.37,-30673.15
buyer_2,Carmen,40,ES96209573984845768625,TRX_N-311-691353709808,2022-03-27T21:42:19,Zarautz,Expense,food,-545.63,-31218.78
buyer_2,Carmen,40,ES96209573984845768625,TRX_N-312-682528592337,2022-03-30T18:37:41,Zarautz,Expense,transport,-185.01,-31403.79
buyer_2,Carmen,40,ES96209573984845768625,TRX_N-313-851772845131,2022-04-01T13:24:12,Zarautz,transfer,Salary,1530.51,-29873.28
buyer_2,Carmen,40,ES96209573984845768625,TRX_N-314-678366015842,2022-04-05T04:44:46,Zarautz,Housing,Rent,-1317.85,-31191.13
buyer_2,Carmen,40,ES96209573984845768625,TRX_N-315-511478433103,2022-04-05T15:46:20,Zarautz,Basic services,gas,-70.38,-31261.51
buyer_2,Carmen,40,ES96209573984845768625,TRX_N-316-681816369631,2022-04-06T19:22:39,Zarautz,Basic services,gas,-37.59,-31299.1
buyer_2,Carmen,40,ES96209573984845768625,TRX_N-317-137493020456,2022-04-06T09:52:43,Zarautz,Basic services,phone,-94.76,-31393.86
buyer_2,Carmen,40,ES96209573984845768625,TRX_N-318-161806902643,2022-04-07T12:07:36,Zarautz,Basic services,electricity,-82.53,-31476.39
buyer_2,Carmen,40,ES96209573984845768625,TRX_N-319-92169839798,2022-04-07T21:47:33,Zarautz,Basic services,gas,-28.46,-31504.85
buyer_2,Carmen,40,ES96209573984845768625,TRX_N-32-616611922013,2020-03-16T08:29:04,Zarautz,Expense,leisure,-192.15,-751.97
buyer_2,Carmen,40,ES96209573984845768625,TRX_N-320-450839630223,2022-04-18T13:17:14,Zarautz,Expense,transport,-162.14,-31666.99
buyer_2,Carmen,40,ES96209573984845768625,TRX_N-321-743398986706,2022-05-01T17:37:19,Zarautz,transfer,Salary,1530.51,-30136.48
buyer_2,Carmen,40,ES96209573984845768625,TRX_N-322-375454563321,2022-05-01T12:47:00,Zarautz,Expense,transport,-85.15,-30221.63
buyer_2,Carmen,40,ES96209573984845768625,TRX_N-323-423467172269,2022-05-05T04:05:13,Zarautz,Housing,Rent,-1317.85,-31539.48
buyer_2,Carmen,40,ES96209573984845768625,TRX_N-324-348400540347,2022-05-05T22:36:58,Zarautz,Basic services,water,-55.99,-31595.47
buyer_2,Carmen,40,ES96209573984845768625,TRX_N-325-220429845288,2022-05-06T15:32:26,Zarautz,Basic services,water,-14.42,-31609.89
buyer_2,Carmen,40,ES96209573984845768625,TRX_N-326-183153986173,2022-05-06T18:38:59,Zarautz,Basic services,electricity,-69.64,-31679.53
buyer_2,Carmen,40,ES96209573984845768625,TRX_N-327-963647165735,2022-05-06T19:17:22,Zarautz,Basic services,gas,-68.62,-31748.15
buyer_2,Carmen,40,ES96209573984845768625,TRX_N-328-308838684858,2022-05-06T19:19:16,Zarautz,Basic services,internet,-66.74,-31814.89
buyer_2,Carmen,40,ES96209573984845768625,TRX_N-329-870426801825,2022-05-07T21:05:02,Zarautz,Basic services,electricity,-134.64,-31949.53
buyer_2,Carmen,40,ES96209573984845768625,TRX_N-33-990886373293,2020-03-31T10:47:29,Zarautz,Expense,transport,-49.12,-801.09
buyer_2,Carmen,40,ES96209573984845768625,TRX_N-330-271279286256,2022-05-22T17:19:27,Zarautz,Expense,transport,-124.24,-32073.77
buyer_2,Carmen,40,ES96209573984845768625,TRX_N-331-248386995182,2022-05-27T08:19:20,Zarautz,Expense,gifts,-215.05,-32288.82
buyer_2,Carmen,40,ES96209573984845768625,TRX_N-332-146407226384,2022-05-30T17:45:00,Zarautz,Expense,transport,-29.54,-32318.36
buyer_2,Carmen,40,ES96209573984845768625,TRX_N-333-535553402409,2022-06-01T17:18:11,Zarautz,transfer,Salary,1530.51,-30787.85
buyer_2,Carmen,40,ES96209573984845768625,TRX_N-334-857426895625,2022-06-01T17:18:11,Zarautz,transfer,Extra Income,153.05,-30634.8
buyer_2,Carmen,40,ES96209573984845768625,TRX_N-335-356155728036,2022-06-01T17:18:11,Zarautz,transfer,Bonus,1604.68,-29030.12
buyer_2,Carmen,40,ES96209573984845768625,TRX_N-336-531081214528,2022-06-02T16:41:40,Zarautz,Expense,gifts,-120.85,-29150.97
buyer_2,Carmen,40,ES96209573984845768625,TRX_N-337-759611005800,2022-06-05T09:06:37,Zarautz,Housing,Rent,-1317.85,-30468.82
buyer_2,Carmen,40,ES96209573984845768625,TRX_N-338-60040043079,2022-06-05T11:01:57,Zarautz,Basic services,water,-42.28,-30511.1
buyer_2,Carmen,40,ES96209573984845768625,TRX_N-339-430595613116,2022-06-05T18:10:57,Zarautz,Basic services,internet,-39.74,-30550.84
buyer_2,Carmen,40,ES96209573984845768625,TRX_N-34-383044840542,2020-04-01T11:26:44,Zarautz,transfer,Salary,1530.51,729.42
buyer_2,Carmen,40,ES96209573984845768625,TRX_N-340-909157935108,2022-06-06T14:46:32,Zarautz,Basic services,water,-32.3,-30583.14
buyer_2,Carmen,40,ES96209573984845768625,TRX_N-341-414727945230,2022-06-07T12:29:24,Zarautz,Basic services,water,-74.51,-30657.65
buyer_2,Carmen,40,ES96209573984845768625,TRX_N-342-966338897424,2022-06-07T18:12:00,Zarautz,Basic services,electricity,-25.51,-30683.16
buyer_2,Carmen,40,ES96209573984845768625,TRX_N-343-347928802499,2022-06-07T18:03:36,Zarautz,Basic services,gas,-90.69,-30773.85
buyer_2,Carmen,40,ES96209573984845768625,TRX_N-344-897275756133,2022-06-27T15:21:45,Zarautz,Expense,food,-235.91,-31009.76
buyer_2,Carmen,40,ES96209573984845768625,TRX_N-345-227778835267,2022-06-27T15:17:57,Zarautz,Expense,transport,-136.67,-31146.43
buyer_2,Carmen,40,ES96209573984845768625,TRX_N-346-850619441230,2022-06-28T09:12:35,Zarautz,Expense,food,-569.64,-31716.07
buyer_2,Carmen,40,ES96209573984845768625,TRX_N-347-502221045151,2022-07-01T20:06:36,Zarautz,transfer,Salary,1530.51,-30185.56
buyer_2,Carmen,40,ES96209573984845768625,TRX_N-348-250091199427,2022-07-05T15:18:49,Zarautz,Housing,Rent,-1317.85,-31503.41
buyer_2,Carmen,40,ES96209573984845768625,TRX_N-349-261702491633,2022-07-06T13:08:45,Zarautz,Basic services,electricity,-41.65,-31545.06
buyer_2,Carmen,40,ES96209573984845768625,TRX_N-35-14114581819,2020-04-05T18:05:59,Zarautz,Housing,Rent,-1317.85,-588.43
buyer_2,Carmen,40,ES96209573984845768625,TRX_N-350-433891364979,2022-07-06T09:09:56,Zarautz,Basic services,phone,-71.58,-31616.64
buyer_2,Carmen,40,ES96209573984845768625,TRX_N-351-670837164995,2022-07-06T15:24:19,Zarautz,Expense,transport,-93.87,-31710.51
buyer_2,Carmen,40,ES96209573984845768625,TRX_N-352-281437449556,2022-07-07T12:58:59,Zarautz,Basic services,water,-35.47,-31745.98
buyer_2,Carmen,40,ES96209573984845768625,TRX_N-353-591890712737,2022-07-07T08:29:28,Zarautz,Basic services,electricity,-53.11,-31799.09
buyer_2,Carmen,40,ES96209573984845768625,TRX_N-354-425006647620,2022-07-07T21:56:02,Zarautz,Basic services,gas,-97.84,-31896.93
buyer_2,Carmen,40,ES96209573984845768625,TRX_N-355-872622590736,2022-07-14T12:22:30,Zarautz,Expense,travel,-585.71,-32482.64
buyer_2,Carmen,40,ES96209573984845768625,TRX_N-356-535487633592,2022-07-31T21:56:32,Zarautz,Expense,transport,-114.78,-32597.42
buyer_2,Carmen,40,ES96209573984845768625,TRX_N-357-899302365712,2022-08-01T12:56:50,Zarautz,transfer,Salary,1530.51,-31066.91
buyer_2,Carmen,40,ES96209573984845768625,TRX_N-358-51637005328,2022-08-05T09:12:34,Zarautz,Housing,Rent,-1317.85,-32384.76
buyer_2,Carmen,40,ES96209573984845768625,TRX_N-359-809813261299,2022-08-05T03:17:42,Zarautz,Basic services,electricity,-143.43,-32528.19
buyer_2,Carmen,40,ES96209573984845768625,TRX_N-36-971564922843,2020-04-05T10:55:29,Zarautz,Basic services,gas,-58.33,-646.76
buyer_2,Carmen,40,ES96209573984845768625,TRX_N-360-956861343877,2022-08-05T09:08:11,Zarautz,Basic services,internet,-72.2,-32600.39
buyer_2,Carmen,40,ES96209573984845768625,TRX_N-361-139260266031,2022-08-05T20:51:08,Zarautz,Basic services,phone,-38.47,-32638.86
buyer_2,Carmen,40,ES96209573984845768625,TRX_N-362-721365263929,2022-08-06T20:04:15,Zarautz,Basic services,water,-33.04,-32671.9
buyer_2,Carmen,40,ES96209573984845768625,TRX_N-363-408522168102,2022-08-06T18:10:11,Zarautz,Basic services,electricity,-45.09,-32716.99
buyer_2,Carmen,40,ES96209573984845768625,TRX_N-364-728873833008,2022-08-07T17:10:16,Zarautz,Basic services,electricity,-91.41,-32808.4
buyer_2,Carmen,40,ES96209573984845768625,TRX_N-365-108766564536,2022-08-07T15:29:58,Zarautz,Basic services,gas,-18.77,-32827.17
buyer_2,Carmen,40,ES96209573984845768625,TRX_N-366-295584099153,2022-08-13T09:31:09,Zarautz,Expense,food,-683.98,-33511.15
buyer_2,Carmen,40,ES96209573984845768625,TRX_N-367-629654088216,2022-08-19T15:59:48,Zarautz,Expense,transport,-75.47,-33586.62
buyer_2,Carmen,40,ES96209573984845768625,TRX_N-368-134022591681,2022-08-30T20:48:47,Bilbao,Expense,transport,-104.98,-33691.6
buyer_2,Carmen,40,ES96209573984845768625,TRX_N-369-937700985720,2022-09-01T12:33:21,Zarautz,transfer,Salary,1530.51,-32161.09
buyer_2,Carmen,40,ES96209573984845768625,TRX_N-37-383900832064,2020-04-05T18:27:13,Zarautz,Basic services,phone,-59.97,-706.73
buyer_2,Carmen,40,ES96209573984845768625,TRX_N-370-677133039309,2022-09-01T12:33:21,Zarautz,transfer,Extra Income,153.05,-32008.04
buyer_2,Carmen,40,ES96209573984845768625,TRX_N-371-624642615,2022-09-02T10:01:51,Amurrio,Expense,transport,-148.96,-32157.0
buyer_2,Carmen,40,ES96209573984845768625,TRX_N-372-869551302908,2022-09-05T23:51:25,Zarautz,Housing,Rent,-1317.85,-33474.85
buyer_2,Carmen,40,ES96209573984845768625,TRX_N-373-314433582073,2022-09-05T18:51:40,Zarautz,Basic services,electricity,-80.48,-33555.33
buyer_2,Carmen,40,ES96209573984845768625,TRX_N-374-760312430399,2022-09-05T09:33:25,Zarautz,Basic services,gas,-37.2,-33592.53
buyer_2,Carmen,40,ES96209573984845768625,TRX_N-375-450315935344,2022-09-05T09:19:56,Zarautz,Basic services,phone,-59.04,-33651.57
buyer_2,Carmen,40,ES96209573984845768625,TRX_N-376-702830823078,2022-09-06T14:23:03,Zarautz,Basic services,gas,-56.85,-33708.42
buyer_2,Carmen,40,ES96209573984845768625,TRX_N-377-314854518576,2022-09-06T13:58:14,Zarautz,Basic services,internet,-41.71,-33750.13
buyer_2,Carmen,40,ES96209573984845768625,TRX_N-378-852633164184,2022-09-06T16:01:45,Zarautz,Basic services,phone,-22.38,-33772.51
buyer_2,Carmen,40,ES96209573984845768625,TRX_N-379-624120462205,2022-09-07T19:19:55,Zarautz,Basic services,phone,-72.37,-33844.88
buyer_2,Carmen,40,ES96209573984845768625,TRX_N-38-777267876402,2020-04-06T12:55:16,Zarautz,Basic services,gas,-32.84,-739.57
buyer_2,Carmen,40,ES96209573984845768625,TRX_N-380-917342763143,2022-09-16T13:47:37,Zarautz,Expense,food,-757.65,-34602.53
buyer_2,Carmen,40,ES96209573984845768625,TRX_N-381-411060382110,2022-10-01T14:41:17,Zarautz,transfer,Salary,1530.51,-33072.02
buyer_2,Carmen,40,ES96209573984845768625,TRX_N-382-533137697536,2022-10-02T19:24:54,Zarautz,Expense,food,-360.49,-33432.51
buyer_2,Carmen,40,ES96209573984845768625,TRX_N-383-920504729848,2022-10-05T16:41:00,Zarautz,Housing,Rent,-1317.85,-34750.36
buyer_2,Carmen,40,ES96209573984845768625,TRX_N-384-380046065141,2022-10-05T18:24:05,Zarautz,Basic services,electricity,-70.77,-34821.13
buyer_2,Carmen,40,ES96209573984845768625,TRX_N-385-907828437521,2022-10-06T09:09:33,Zarautz,Basic services,gas,-18.4,-34839.53
buyer_2,Carmen,40,ES96209573984845768625,TRX_N-386-125350805605,2022-10-07T13:17:48,Zarautz,Basic services,electricity,-93.0,-34932.53
buyer_2,Carmen,40,ES96209573984845768625,TRX_N-387-884321518741,2022-10-07T04:24:58,Zarautz,Basic services,phone,-32.69,-34965.22
buyer_2,Carmen,40,ES96209573984845768625,TRX_N-388-763578799770,2022-10-13T09:34:36,Zarautz,Expense,clothing,-75.61,-35040.83
buyer_2,Carmen,40,ES96209573984845768625,TRX_N-389-263515428620,2022-10-14T10:51:56,Zarautz,Expense,leisure,-164.75,-35205.58
buyer_2,Carmen,40,ES96209573984845768625,TRX_N-39-981782847373,2020-04-12T20:44:15,Zuia,Expense,repairs,-273.43,-1013.0
buyer_2,Carmen,40,ES96209573984845768625,TRX_N-390-740962739881,2022-11-01T15:10:48,Zarautz,transfer,Salary,1530.51,-33675.07
buyer_2,Carmen,40,ES96209573984845768625,TRX_N-391-36454885795,2022-11-05T12:37:51,Zarautz,Housing,Rent,-1317.85,-34992.92
buyer_2,Carmen,40,ES96209573984845768625,TRX_N-392-603525654716,2022-11-05T08:56:34,Zarautz,Basic services,electricity,-94.01,-35086.93
buyer_2,Carmen,40,ES96209573984845768625,TRX_N-393-505852466730,2022-11-05T15:28:12,Zarautz,Basic services,internet,-69.64,-35156.57
buyer_2,Carmen,40,ES96209573984845768625,TRX_N-394-303147195699,2022-11-05T13:05:05,Zarautz,Basic services,phone,-86.34,-35242.91
buyer_2,Carmen,40,ES96209573984845768625,TRX_N-395-466464687116,2022-11-06T08:12:28,Zarautz,Basic services,electricity,-76.14,-35319.05
buyer_2,Carmen,40,ES96209573984845768625,TRX_N-396-501501223061,2022-11-06T22:23:12,Zarautz,Basic services,internet,-39.15,-35358.2
buyer_2,Carmen,40,ES96209573984845768625,TRX_N-397-89774433952,2022-11-06T10:16:25,Zarautz,Expense,leisure,-96.9,-35455.1
buyer_2,Carmen,40,ES96209573984845768625,TRX_N-398-689939362958,2022-11-07T14:19:38,Zarautz,Basic services,water,-55.0,-35510.1
buyer_2,Carmen,40,ES96209573984845768625,TRX_N-399-620794914681,2022-11-08T19:19:28,Zarautz,Expense,leisure,-264.33,-35774.43
buyer_2,Carmen,40,ES96209573984845768625,TRX_N-4-991139085341,2020-01-06T20:29:09,Zarautz,Basic services,water,-72.33,1634.82
buyer_2,Carmen,40,ES96209573984845768625,TRX_N-40-787198542366,2020-04-14T23:35:35,Zarautz,Expense,food,-721.91,-1734.91
buyer_2,Carmen,40,ES96209573984845768625,TRX_N-400-113062100170,2022-11-08T08:33:54,Zarautz,Expense,clothing,-289.57,-36064.0
buyer_2,Carmen,40,ES96209573984845768625,TRX_N-401-610636335560,2022-11-15T10:37:13,Zarautz,Expense,food,-157.63,-36221.63
buyer_2,Carmen,40,ES96209573984845768625,TRX_N-402-883212112617,2022-11-26T13:46:10,Zarautz,Expense,food,-620.65,-36842.28
buyer_2,Carmen,40,ES96209573984845768625,TRX_N-403-449372291808,2022-11-28T11:46:19,Zarautz,Expense,transport,-40.37,-36882.65
buyer_2,Carmen,40,ES96209573984845768625,TRX_N-404-862468789169,2022-12-01T10:43:43,Zarautz,transfer,Salary,1530.51,-35352.14
buyer_2,Carmen,40,ES96209573984845768625,TRX_N-405-850511441191,2022-12-01T10:43:43,Zarautz,transfer,Extra Income,153.05,-35199.09
buyer_2,Carmen,40,ES96209573984845768625,TRX_N-406-958261128901,2022-12-01T10:43:43,Zarautz,transfer,Bonus,1597.03,-33602.06
buyer_2,Carmen,40,ES96209573984845768625,TRX_N-407-277513147966,2022-12-05T02:27:14,Zarautz,Housing,Rent,-1317.85,-34919.91
buyer_2,Carmen,40,ES96209573984845768625,TRX_N-408-715812381669,2022-12-05T16:16:59,Zarautz,Basic services,electricity,-76.29,-34996.2
buyer_2,Carmen,40,ES96209573984845768625,TRX_N-409-233949244425,2022-12-05T00:42:55,Zarautz,Basic services,internet,-50.2,-35046.4
buyer_2,Carmen,40,ES96209573984845768625,TRX_N-41-836928763558,2020-04-22T18:11:52,Zarautz,Expense,education,-83.75,-1818.66
buyer_2,Carmen,40,ES96209573984845768625,TRX_N-410-862425449015,2022-12-06T16:04:09,Zarautz,Basic services,internet,-78.03,-35124.43
buyer_2,Carmen,40,ES96209573984845768625,TRX_N-411-993336501196,2022-12-06T19:29:54,Zarautz,Basic services,phone,-78.28,-35202.71
buyer_2,Carmen,40,ES96209573984845768625,TRX_N-412-248042495368,2022-12-07T18:15:35,Zarautz,Basic services,gas,-24.26,-35226.97
buyer_2,Carmen,40,ES96209573984845768625,TRX_N-413-929023829046,2022-12-07T19:14:30,Zarautz,Expense,food,-375.6,-35602.57
buyer_2,Carmen,40,ES96209573984845768625,TRX_N-414-237205612041,2022-12-16T14:03:08,Zarautz,Expense,clothing,-194.63,-35797.2
buyer_2,Carmen,40,ES96209573984845768625,TRX_N-415-328643925246,2022-12-18T20:43:53,Zarautz,Expense,healthcare,-121.77,-35918.97
buyer_2,Carmen,40,ES96209573984845768625,TRX_N-416-344803091644,2022-12-21T12:02:28,Portugalete,Expense,transport,-95.09,-36014.06
buyer_2,Carmen,40,ES96209573984845768625,TRX_N-417-924615878795,2022-12-24T16:34:20,Zarautz,Expense,leisure,-246.61,-36260.67
buyer_2,Carmen,40,ES96209573984845768625,TRX_N-418-348102132042,2023-01-01T11:11:20,Zarautz,transfer,Salary,1530.51,-34730.16
buyer_2,Carmen,40,ES96209573984845768625,TRX_N-419-17299457033,2023-01-04T14:59:12,Zarautz,Expense,transport,-129.56,-34859.72
buyer_2,Carmen,40,ES96209573984845768625,TRX_N-42-845811021609,2020-04-24T13:53:54,Zarautz,Expense,clothing,-189.02,-2007.68
buyer_2,Carmen,40,ES96209573984845768625,TRX_N-420-490995859595,2023-01-05T16:20:31,Zarautz,Housing,Rent,-1317.85,-36177.57
buyer_2,Carmen,40,ES96209573984845768625,TRX_N-421-965006975720,2023-01-05T15:45:33,Zarautz,Basic services,phone,-84.51,-36262.08
buyer_2,Carmen,40,ES96209573984845768625,TRX_N-422-282973302323,2023-01-06T17:07:33,Zarautz,Basic services,gas,-75.65,-36337.73
buyer_2,Carmen,40,ES96209573984845768625,TRX_N-423-138505064345,2023-01-06T16:20:43,Zarautz,Basic services,internet,-45.46,-36383.19
buyer_2,Carmen,40,ES96209573984845768625,TRX_N-424-449483711198,2023-01-07T14:29:51,Zarautz,Basic services,water,-38.05,-36421.24
buyer_2,Carmen,40,ES96209573984845768625,TRX_N-425-764035459152,2023-01-07T13:41:25,Zarautz,Basic services,electricity,-59.53,-36480.77
buyer_2,Carmen,40,ES96209573984845768625,TRX_N-426-637503974701,2023-01-07T20:56:35,Zarautz,Basic services,internet,-59.84,-36540.61
buyer_2,Carmen,40,ES96209573984845768625,TRX_N-427-252521391259,2023-01-07T12:04:56,Zarautz,Basic services,phone,-85.83,-36626.44
buyer_2,Carmen,40,ES96209573984845768625,TRX_N-428-775765582769,2023-01-15T18:39:20,Zarautz,Expense,food,-319.26,-36945.7
buyer_2,Carmen,40,ES96209573984845768625,TRX_N-429-993708776532,2023-01-22T15:31:24,Llodio,Expense,education,-741.28,-37686.98
buyer_2,Carmen,40,ES96209573984845768625,TRX_N-43-182037364255,2020-05-01T10:33:29,Zarautz,transfer,Salary,1530.51,-477.17
buyer_2,Carmen,40,ES96209573984845768625,TRX_N-430-446549410350,2023-02-01T10:05:19,Zarautz,transfer,Salary,1530.51,-36156.47
buyer_2,Carmen,40,ES96209573984845768625,TRX_N-431-934955628111,2023-02-05T12:11:54,Zarautz,Housing,Rent,-1317.85,-37474.32
buyer_2,Carmen,40,ES96209573984845768625,TRX_N-432-45931020643,2023-02-05T17:19:43,Zarautz,Basic services,water,-10.92,-37485.24
buyer_2,Carmen,40,ES96209573984845768625,TRX_N-433-479843743470,2023-02-05T17:46:21,Zarautz,Basic services,gas,-61.19,-37546.43
buyer_2,Carmen,40,ES96209573984845768625,TRX_N-434-231629360530,2023-02-05T21:07:53,Zarautz,Basic services,internet,-63.67,-37610.1
buyer_2,Carmen,40,ES96209573984845768625,TRX_N-435-223459656627,2023-02-05T18:26:47,Zarautz,Basic services,phone,-84.88,-37694.98
buyer_2,Carmen,40,ES96209573984845768625,TRX_N-436-175156624727,2023-02-06T18:51:46,Zarautz,Basic services,water,-12.15,-37707.13
buyer_2,Carmen,40,ES96209573984845768625,TRX_N-437-370448810940,2023-02-06T09:49:25,Zarautz,Basic services,electricity,-108.54,-37815.67
buyer_2,Carmen,40,ES96209573984845768625,TRX_N-438-213432303067,2023-02-07T16:34:18,Zarautz,Basic services,water,-57.25,-37872.92
buyer_2,Carmen,40,ES96209573984845768625,TRX_N-439-576123763754,2023-02-07T16:12:50,Zarautz,Basic services,internet,-47.16,-37920.08
buyer_2,Carmen,40,ES96209573984845768625,TRX_N-44-653565888565,2020-05-05T16:05:22,Zarautz,Housing,Rent,-1317.85,-1795.02
buyer_2,Carmen,40,ES96209573984845768625,TRX_N-440-68313465096,2023-02-07T14:22:24,Zarautz,Basic services,phone,-88.94,-38009.02
buyer_2,Carmen,40,ES96209573984845768625,TRX_N-441-674436890373,2023-02-09T18:46:36,Zarautz,Expense,food,-780.57,-38789.59
buyer_2,Carmen,40,ES96209573984845768625,TRX_N-442-874625677054,2023-02-20T13:17:26,Amurrio,Expense,transport,-145.85,-38935.44
buyer_2,Carmen,40,ES96209573984845768625,TRX_N-443-681554571714,2023-02-25T02:31:02,Zarautz,Expense,food,-455.34,-39390.78
buyer_2,Carmen,40,ES96209573984845768625,TRX_N-444-378371440718,2023-02-27T04:33:38,Elciego,Expense,gifts,-179.69,-39570.47
buyer_2,Carmen,40,ES96209573984845768625,TRX_N-445-158574962558,2023-02-28T15:54:33,Zarautz,Expense,transport,-176.04,-39746.51
buyer_2,Carmen,40,ES96209573984845768625,TRX_N-446-427091430697,2023-03-01T07:05:43,Zarautz,transfer,Salary,1530.51,-38216.0
buyer_2,Carmen,40,ES96209573984845768625,TRX_N-447-317739400709,2023-03-01T07:05:43,Zarautz,transfer,Extra Income,153.05,-38062.95
buyer_2,Carmen,40,ES96209573984845768625,TRX_N-448-524908371867,2023-03-03T01:46:59,Barakaldo,Expense,transport,-150.44,-38213.39
buyer_2,Carmen,40,ES96209573984845768625,TRX_N-449-602711235380,2023-03-05T08:27:39,Zarautz,Housing,Rent,-1317.85,-39531.24
buyer_2,Carmen,40,ES96209573984845768625,TRX_N-45-454008760175,2020-05-05T08:26:27,Zarautz,Basic services,water,-55.11,-1850.13
buyer_2,Carmen,40,ES96209573984845768625,TRX_N-450-181810422819,2023-03-05T12:41:31,Zarautz,Basic services,water,-52.69,-39583.93
buyer_2,Carmen,40,ES96209573984845768625,TRX_N-451-720500808645,2023-03-05T22:10:24,Zarautz,Basic services,electricity,-132.36,-39716.29
buyer_2,Carmen,40,ES96209573984845768625,TRX_N-452-292683142280,2023-03-05T19:44:12,Zarautz,Basic services,internet,-79.46,-39795.75
buyer_2,Carmen,40,ES96209573984845768625,TRX_N-453-233709222351,2023-03-06T16:31:31,Zarautz,Basic services,electricity,-101.97,-39897.72
buyer_2,Carmen,40,ES96209573984845768625,TRX_N-454-543907469970,2023-03-06T16:44:47,Zarautz,Basic services,phone,-91.43,-39989.15
buyer_2,Carmen,40,ES96209573984845768625,TRX_N-455-855009736219,2023-03-07T09:11:27,Zarautz,Basic services,gas,-32.12,-40021.27
buyer_2,Carmen,40,ES96209573984845768625,TRX_N-456-78378019778,2023-03-07T20:17:39,Zarautz,Basic services,phone,-27.25,-40048.52
buyer_2,Carmen,40,ES96209573984845768625,TRX_N-457-591663585495,2023-03-10T09:44:13,Zarautz,Expense,leisure,-11.0,-40059.52
buyer_2,Carmen,40,ES96209573984845768625,TRX_N-458-39821078923,2023-03-12T14:32:51,Bermeo,Expense,education,-358.95,-40418.47
buyer_2,Carmen,40,ES96209573984845768625,TRX_N-459-924854236889,2023-03-29T10:01:22,Zarautz,Expense,food,-343.37,-40761.84
buyer_2,Carmen,40,ES96209573984845768625,TRX_N-46-77938560544,2020-05-05T16:40:12,Zarautz,Basic services,gas,-85.56,-1935.69
buyer_2,Carmen,40,ES96209573984845768625,TRX_N-460-255631674424,2023-04-01T14:36:20,Zarautz,transfer,Salary,1530.51,-39231.33
buyer_2,Carmen,40,ES96209573984845768625,TRX_N-461-22430640083,2023-04-05T15:45:31,Zarautz,Housing,Rent,-1317.85,-40549.18
buyer_2,Carmen,40,ES96209573984845768625,TRX_N-462-320434891318,2023-04-05T07:01:41,Zarautz,Basic services,gas,-93.23,-40642.41
buyer_2,Carmen,40,ES96209573984845768625,TRX_N-463-545896364763,2023-04-05T16:20:26,Zarautz,Basic services,phone,-58.08,-40700.49
buyer_2,Carmen,40,ES96209573984845768625,TRX_N-464-701474598902,2023-04-06T14:58:04,Zarautz,Basic services,gas,-40.35,-40740.84
buyer_2,Carmen,40,ES96209573984845768625,TRX_N-465-797894314868,2023-04-06T14:16:13,Zarautz,Basic services,phone,-21.93,-40762.77
buyer_2,Carmen,40,ES96209573984845768625,TRX_N-466-874994312094,2023-04-07T03:10:32,Zarautz,Basic services,electricity,-71.6,-40834.37
buyer_2,Carmen,40,ES96209573984845768625,TRX_N-467-171570371713,2023-04-07T17:42:38,Zarautz,Basic services,gas,-26.12,-40860.49
buyer_2,Carmen,40,ES96209573984845768625,TRX_N-468-245004667363,2023-04-08T16:13:25,Zarautz,Expense,leisure,-13.99,-40874.48
buyer_2,Carmen,40,ES96209573984845768625,TRX_N-469-670120031254,2023-04-20T14:31:51,Zarautz,Expense,transport,-81.86,-40956.34
buyer_2,Carmen,40,ES96209573984845768625,TRX_N-47-445217127945,2020-05-07T16:38:33,Zarautz,Basic services,phone,-97.35,-2033.04
buyer_2,Carmen,40,ES96209573984845768625,TRX_N-470-270163291088,2023-04-26T03:15:33,Zarautz,Expense,clothing,-353.01,-41309.35
buyer_2,Carmen,40,ES96209573984845768625,TRX_N-471-581516078404,2023-04-28T08:36:28,Zarautz,Expense,leisure,-120.48,-41429.83
buyer_2,Carmen,40,ES96209573984845768625,TRX_N-472-660703333740,2023-05-01T19:31:34,Zarautz,transfer,Salary,1530.51,-39899.32
buyer_2,Carmen,40,ES96209573984845768625,TRX_N-473-274472846318,2023-05-01T19:31:34,Zarautz,transfer,Extra Income,153.05,-39746.27
buyer_2,Carmen,40,ES96209573984845768625,TRX_N-474-923843826703,2023-05-03T09:01:57,Zarautz,Expense,transport,-49.35,-39795.62
buyer_2,Carmen,40,ES96209573984845768625,TRX_N-475-410277859315,2023-05-05T07:07:51,Zarautz,Housing,Rent,-1317.85,-41113.47
buyer_2,Carmen,40,ES96209573984845768625,TRX_N-476-684288750975,2023-05-05T22:27:30,Zarautz,Basic services,water,-14.73,-41128.2
buyer_2,Carmen,40,ES96209573984845768625,TRX_N-477-195624225782,2023-05-05T06:14:43,Zarautz,Basic services,gas,-30.84,-41159.04
buyer_2,Carmen,40,ES96209573984845768625,TRX_N-478-861262488550,2023-05-06T20:28:37,Zarautz,Basic services,internet,-68.27,-41227.31
buyer_2,Carmen,40,ES96209573984845768625,TRX_N-479-259427066201,2023-05-06T20:07:40,Zarautz,Basic services,phone,-56.31,-41283.62
buyer_2,Carmen,40,ES96209573984845768625,TRX_N-48-668089534892,2020-05-07T10:08:41,Zarautz,Expense,healthcare,-282.49,-2315.53
buyer_2,Carmen,40,ES96209573984845768625,TRX_N-480-647698019450,2023-05-09T21:10:20,Zarautz,Expense,food,-786.36,-42069.98
buyer_2,Carmen,40,ES96209573984845768625,TRX_N-481-772545990441,2023-05-13T18:51:17,Zarautz,Expense,food,-677.03,-42747.01
buyer_2,Carmen,40,ES96209573984845768625,TRX_N-482-265679469553,2023-05-23T18:03:28,Zarautz,Expense,transport,-148.55,-42895.56
buyer_2,Carmen,40,ES96209573984845768625,TRX_N-483-620156483934,2023-05-23T08:21:15,Zarautz,Expense,repairs,-973.22,-43868.78
buyer_2,Carmen,40,ES96209573984845768625,TRX_N-484-869135063409,2023-05-26T12:53:22,Zarautz,Expense,travel,-2644.31,-46513.09
buyer_2,Carmen,40,ES96209573984845768625,TRX_N-485-341226382057,2023-06-01T17:47:26,Zarautz,transfer,Salary,1530.51,-44982.58
buyer_2,Carmen,40,ES96209573984845768625,TRX_N-486-613847941568,2023-06-01T17:47:26,Zarautz,transfer,Bonus,1653.46,-43329.12
buyer_2,Carmen,40,ES96209573984845768625,TRX_N-487-639214782199,2023-06-05T11:01:06,Zarautz,Housing,Rent,-1317.85,-44646.97
buyer_2,Carmen,40,ES96209573984845768625,TRX_N-488-859864464594,2023-06-05T19:00:36,Zarautz,Basic services,electricity,-95.64,-44742.61
buyer_2,Carmen,40,ES96209573984845768625,TRX_N-489-231433501067,2023-06-05T09:51:40,Zarautz,Basic services,gas,-25.66,-44768.27
buyer_2,Carmen,40,ES96209573984845768625,TRX_N-49-240272159802,2020-05-09T16:18:26,Zarautz,Expense,food,-153.37,-2468.9
buyer_2,Carmen,40,ES96209573984845768625,TRX_N-490-965606140290,2023-06-05T06:12:42,Zarautz,Basic services,internet,-74.21,-44842.48
buyer_2,Carmen,40,ES96209573984845768625,TRX_N-491-85496494977,2023-06-05T20:35:02,Zarautz,Basic services,phone,-98.52,-44941.0
buyer_2,Carmen,40,ES96209573984845768625,TRX_N-492-454703115785,2023-06-06T23:39:04,Zarautz,Basic services,electricity,-110.55,-45051.55
buyer_2,Carmen,40,ES96209573984845768625,TRX_N-493-760477102873,2023-06-06T11:44:33,Zarautz,Basic services,gas,-98.46,-45150.01
buyer_2,Carmen,40,ES96209573984845768625,TRX_N-494-804724038416,2023-06-07T03:47:53,Zarautz,Basic services,internet,-30.88,-45180.89
buyer_2,Carmen,40,ES96209573984845768625,TRX_N-495-888713369993,2023-06-12T05:10:45,Zarautz,Expense,food,-733.86,-45914.75
buyer_2,Carmen,40,ES96209573984845768625,TRX_N-496-411734285638,2023-06-12T15:54:27,Zarautz,Expense,leisure,-141.39,-46056.14
buyer_2,Carmen,40,ES96209573984845768625,TRX_N-497-651698126279,2023-06-17T16:53:16,Zarautz,Expense,food,-168.64,-46224.78
buyer_2,Carmen,40,ES96209573984845768625,TRX_N-498-53017436802,2023-06-22T08:33:16,Zarautz,Expense,leisure,-66.81,-46291.59
buyer_2,Carmen,40,ES96209573984845768625,TRX_N-499-899868772253,2023-06-26T19:09:02,Zarautz,Expense,transport,-114.84,-46406.43
buyer_2,Carmen,40,ES96209573984845768625,TRX_N-5-6024961521,2020-01-06T08:15:39,Zarautz,Basic services,gas,-89.3,1545.52
buyer_2,Carmen,40,ES96209573984845768625,TRX_N-50-518426835243,2020-05-11T11:14:57,Zarautz,Expense,clothing,-453.87,-2922.77
buyer_2,Carmen,40,ES96209573984845768625,TRX_N-500-300848184564,2023-07-01T17:39:27,Zarautz,transfer,Salary,1530.51,-44875.92
buyer_2,Carmen,40,ES96209573984845768625,TRX_N-501-685592150298,2023-07-01T17:39:27,Zarautz,transfer,Extra Income,153.05,-44722.87
buyer_2,Carmen,40,ES96209573984845768625,TRX_N-502-298469346373,2023-07-01T19:09:55,Zarautz,Expense,transport,-182.53,-44905.4
buyer_2,Carmen,40,ES96209573984845768625,TRX_N-503-834222135179,2023-07-02T15:42:36,Zarautz,Expense,leisure,-59.8,-44965.2
buyer_2,Carmen,40,ES96209573984845768625,TRX_N-504-805031642455,2023-07-05T09:32:27,Zarautz,Housing,Rent,-1317.85,-46283.05
buyer_2,Carmen,40,ES96209573984845768625,TRX_N-505-715241487612,2023-07-05T10:19:52,Zarautz,Basic services,water,-64.92,-46347.97
buyer_2,Carmen,40,ES96209573984845768625,TRX_N-506-875745654783,2023-07-05T11:30:53,Zarautz,Basic services,electricity,-50.62,-46398.59
buyer_2,Carmen,40,ES96209573984845768625,TRX_N-507-751470226335,2023-07-06T20:30:38,Zarautz,Basic services,water,-44.3,-46442.89
buyer_2,Carmen,40,ES96209573984845768625,TRX_N-508-974257320281,2023-07-06T01:48:02,Zarautz,Basic services,phone,-33.87,-46476.76
buyer_2,Carmen,40,ES96209573984845768625,TRX_N-509-644969294567,2023-07-07T15:20:32,Zarautz,Basic services,water,-52.5,-46529.26
buyer_2,Carmen,40,ES96209573984845768625,TRX_N-51-159458895706,2020-05-13T18:09:14,Zarautz,Expense,education,-117.39,-3040.16
buyer_2,Carmen,40,ES96209573984845768625,TRX_N-510-634080974603,2023-07-07T15:07:34,Zarautz,Basic services,electricity,-132.52,-46661.78
buyer_2,Carmen,40,ES96209573984845768625,TRX_N-511-504346583873,2023-07-31T17:39:38,Lasarte-Oria,Expense,clothing,-498.98,-47160.76
buyer_2,Carmen,40,ES96209573984845768625,TRX_N-512-380952852273,2023-08-01T18:05:43,Zarautz,transfer,Salary,1530.51,-45630.25
buyer_2,Carmen,40,ES96209573984845768625,TRX_N-513-512782698538,2023-08-05T18:34:33,Zarautz,Housing,Rent,-1317.85,-46948.1
buyer_2,Carmen,40,ES96209573984845768625,TRX_N-514-317360341027,2023-08-05T08:56:39,Zarautz,Basic services,electricity,-87.61,-47035.71
buyer_2,Carmen,40,ES96209573984845768625,TRX_N-515-803086380598,2023-08-05T08:46:19,Zarautz,Basic services,gas,-66.78,-47102.49
buyer_2,Carmen,40,ES96209573984845768625,TRX_N-516-781177223124,2023-08-06T13:45:22,Zarautz,Basic services,electricity,-67.78,-47170.27
buyer_2,Carmen,40,ES96209573984845768625,TRX_N-517-838309465515,2023-08-06T16:24:49,Zarautz,Basic services,gas,-56.49,-47226.76
buyer_2,Carmen,40,ES96209573984845768625,TRX_N-518-427777673527,2023-08-07T13:02:40,Zarautz,Basic services,water,-66.53,-47293.29
buyer_2,Carmen,40,ES96209573984845768625,TRX_N-519-334302147530,2023-08-07T05:13:51,Zarautz,Basic services,electricity,-66.24,-47359.53
buyer_2,Carmen,40,ES96209573984845768625,TRX_N-52-734829551968,2020-05-17T16:45:08,Llodio,Expense,transport,-101.87,-3142.03
buyer_2,Carmen,40,ES96209573984845768625,TRX_N-520-354992241795,2023-08-07T12:30:02,Zarautz,Basic services,internet,-36.43,-47395.96
buyer_2,Carmen,40,ES96209573984845768625,TRX_N-521-901915843576,2023-08-18T05:06:30,Zarautz,Expense,transport,-138.86,-47534.82
buyer_2,Carmen,40,ES96209573984845768625,TRX_N-522-635460241510,2023-09-01T04:32:43,Zarautz,transfer,Salary,1530.51,-46004.31
buyer_2,Carmen,40,ES96209573984845768625,TRX_N-523-578477036501,2023-09-01T20:47:16,Iruña de Oca,Expense,clothing,-90.19,-46094.5
buyer_2,Carmen,40,ES96209573984845768625,TRX_N-524-427621584790,2023-09-05T15:18:36,Zarautz,Housing,Rent,-1317.85,-47412.35
buyer_2,Carmen,40,ES96209573984845768625,TRX_N-525-928567918377,2023-09-05T11:36:17,Zarautz,Basic services,water,-68.35,-47480.7
buyer_2,Carmen,40,ES96209573984845768625,TRX_N-526-997139589365,2023-09-05T16:12:34,Zarautz,Basic services,gas,-80.94,-47561.64
buyer_2,Carmen,40,ES96209573984845768625,TRX_N-527-947114762356,2023-09-05T19:18:49,Zarautz,Basic services,phone,-28.28,-47589.92
buyer_2,Carmen,40,ES96209573984845768625,TRX_N-528-126851456139,2023-09-06T02:20:01,Zarautz,Basic services,electricity,-30.17,-47620.09
buyer_2,Carmen,40,ES96209573984845768625,TRX_N-529-728443069350,2023-09-07T17:31:33,Zarautz,Basic services,electricity,-73.6,-47693.69
buyer_2,Carmen,40,ES96209573984845768625,TRX_N-53-12092257131,2020-05-19T11:03:55,Zarautz,Expense,food,-592.87,-3734.9
buyer_2,Carmen,40,ES96209573984845768625,TRX_N-530-594658948522,2023-09-07T20:18:41,Zarautz,Basic services,internet,-34.49,-47728.18
buyer_2,Carmen,40,ES96209573984845768625,TRX_N-531-129091707846,2023-09-07T22:32:20,Lasarte-Oria,Expense,clothing,-396.53,-48124.71
buyer_2,Carmen,40,ES96209573984845768625,TRX_N-532-201360826941,2023-09-09T14:54:21,Bermeo,Expense,leisure,-197.39,-48322.1
buyer_2,Carmen,40,ES96209573984845768625,TRX_N-533-993929861513,2023-09-16T14:18:10,Zarautz,Expense,food,-295.02,-48617.12
buyer_2,Carmen,40,ES96209573984845768625,TRX_N-534-817969143504,2023-09-29T14:09:18,Zarautz,Expense,leisure,-160.44,-48777.56
buyer_2,Carmen,40,ES96209573984845768625,TRX_N-535-876777050784,2023-10-01T21:41:37,Zarautz,transfer,Salary,1530.51,-47247.05
buyer_2,Carmen,40,ES96209573984845768625,TRX_N-536-767435958341,2023-10-01T21:41:37,Zarautz,transfer,Extra Income,153.05,-47094.0
buyer_2,Carmen,40,ES96209573984845768625,TRX_N-537-635197439327,2023-10-03T22:15:26,Zarautz,Expense,food,-442.44,-47536.44
buyer_2,Carmen,40,ES96209573984845768625,TRX_N-538-992013313624,2023-10-05T12:41:42,Zarautz,Housing,Rent,-1317.85,-48854.29
buyer_2,Carmen,40,ES96209573984845768625,TRX_N-539-244998177969,2023-10-05T18:41:00,Zarautz,Basic services,gas,-70.15,-48924.44
buyer_2,Carmen,40,ES96209573984845768625,TRX_N-54-848807764016,2020-06-01T11:34:59,Zarautz,transfer,Salary,1530.51,-2204.39
buyer_2,Carmen,40,ES96209573984845768625,TRX_N-540-779918970571,2023-10-05T19:31:34,Zarautz,Basic services,internet,-57.76,-48982.2
buyer_2,Carmen,40,ES96209573984845768625,TRX_N-541-552929734576,2023-10-05T14:23:56,Zarautz,Basic services,phone,-75.54,-49057.74
buyer_2,Carmen,40,ES96209573984845768625,TRX_N-542-935797605247,2023-10-06T13:24:58,Zarautz,Basic services,phone,-77.81,-49135.55
buyer_2,Carmen,40,ES96209573984845768625,TRX_N-543-545141075297,2023-10-07T13:05:58,Zarautz,Basic services,electricity,-48.6,-49184.15
buyer_2,Carmen,40,ES96209573984845768625,TRX_N-544-73831597962,2023-10-07T09:11:04,Zarautz,Basic services,gas,-39.44,-49223.59
buyer_2,Carmen,40,ES96209573984845768625,TRX_N-545-780737559489,2023-10-07T19:54:14,Zarautz,Basic services,internet,-76.14,-49299.73
buyer_2,Carmen,40,ES96209573984845768625,TRX_N-546-919485824183,2023-10-11T15:56:37,Basauri,Expense,leisure,-104.1,-49403.83
buyer_2,Carmen,40,ES96209573984845768625,TRX_N-547-657724831217,2023-10-20T09:20:01,Zarautz,Expense,transport,-128.09,-49531.92
buyer_2,Carmen,40,ES96209573984845768625,TRX_N-548-74714002465,2023-10-30T01:21:33,Zarautz,Expense,gifts,-445.32,-49977.24
buyer_2,Carmen,40,ES96209573984845768625,TRX_N-549-785114791588,2023-11-01T21:48:10,Zarautz,transfer,Salary,1530.51,-48446.73
buyer_2,Carmen,40,ES96209573984845768625,TRX_N-55-813500047729,2020-06-01T11:34:59,Zarautz,transfer,Extra Income,153.05,-2051.34
buyer_2,Carmen,40,ES96209573984845768625,TRX_N-550-830203335527,2023-11-05T18:59:11,Zarautz,Housing,Rent,-1317.85,-49764.58
buyer_2,Carmen,40,ES96209573984845768625,TRX_N-551-25675016129,2023-11-05T18:01:22,Zarautz,Basic services,electricity,-79.49,-49844.07
buyer_2,Carmen,40,ES96209573984845768625,TRX_N-552-528609779986,2023-11-05T13:20:11,Zarautz,Basic services,gas,-35.02,-49879.09
buyer_2,Carmen,40,ES96209573984845768625,TRX_N-553-387918967416,2023-11-06T15:08:31,Zarautz,Basic services,water,-17.24,-49896.33
buyer_2,Carmen,40,ES96209573984845768625,TRX_N-554-276711023456,2023-11-15T12:06:05,Zarautz,Expense,clothing,-148.92,-50045.25
buyer_2,Carmen,40,ES96209573984845768625,TRX_N-555-839741777640,2023-11-24T20:15:49,Zarautz,Expense,transport,-45.01,-50090.26
buyer_2,Carmen,40,ES96209573984845768625,TRX_N-556-364132594326,2023-11-26T07:33:39,Hondarribia,Expense,clothing,-142.4,-50232.66
buyer_2,Carmen,40,ES96209573984845768625,TRX_N-557-783893347645,2023-12-01T18:59:54,Zarautz,transfer,Salary,1530.51,-48702.15
buyer_2,Carmen,40,ES96209573984845768625,TRX_N-558-187579789103,2023-12-01T18:59:54,Zarautz,transfer,Extra Income,153.05,-48549.1
buyer_2,Carmen,40,ES96209573984845768625,TRX_N-559-818262569192,2023-12-01T18:59:54,Zarautz,transfer,Bonus,1590.02,-46959.08
buyer_2,Carmen,40,ES96209573984845768625,TRX_N-56-345834288687,2020-06-01T11:34:59,Zarautz,transfer,Bonus,1614.98,-436.36
buyer_2,Carmen,40,ES96209573984845768625,TRX_N-560-537911510916,2023-12-05T02:09:27,Zarautz,Housing,Rent,-1317.85,-48276.93
buyer_2,Carmen,40,ES96209573984845768625,TRX_N-561-346464231888,2023-12-05T11:55:50,Zarautz,Basic services,water,-32.18,-48309.11
buyer_2,Carmen,40,ES96209573984845768625,TRX_N-562-528192567032,2023-12-06T16:15:57,Zarautz,Basic services,electricity,-89.39,-48398.5
buyer_2,Carmen,40,ES96209573984845768625,TRX_N-563-851792238947,2023-12-06T10:28:04,Zarautz,Basic services,gas,-84.62,-48483.12
buyer_2,Carmen,40,ES96209573984845768625,TRX_N-564-738802191379,2023-12-07T20:38:22,Zarautz,Basic services,water,-70.55,-48553.67
buyer_2,Carmen,40,ES96209573984845768625,TRX_N-565-793413131970,2023-12-07T10:32:10,Zarautz,Basic services,phone,-64.68,-48618.35
buyer_2,Carmen,40,ES96209573984845768625,TRX_N-566-356871748248,2023-12-11T15:19:44,Alegría-Dulantzi,Expense,food,-496.58,-49114.93
buyer_2,Carmen,40,ES96209573984845768625,TRX_N-567-252334842111,2023-12-22T10:13:06,Zarautz,Expense,healthcare,-383.95,-49498.88
buyer_2,Carmen,40,ES96209573984845768625,TRX_N-568-485976073499,2023-12-24T13:14:20,Hondarribia,Expense,food,-715.2,-50214.08
buyer_2,Carmen,40,ES96209573984845768625,TRX_N-569-234638867224,2023-12-28T17:26:49,Hondarribia,Expense,transport,-105.01,-50319.09
buyer_2,Carmen,40,ES96209573984845768625,TRX_N-57-697951233336,2020-06-05T10:04:57,Zarautz,Housing,Rent,-1317.85,-1754.21
buyer_2,Carmen,40,ES96209573984845768625,TRX_N-570-335951483573,2024-01-01T14:58:20,Zarautz,transfer,Salary,1530.51,-48788.58
buyer_2,Carmen,40,ES96209573984845768625,TRX_N-571-419824959922,2024-01-04T08:41:03,Zarautz,Expense,food,-415.69,-49204.27
buyer_2,Carmen,40,ES96209573984845768625,TRX_N-572-778829693806,2024-01-05T15:02:23,Zarautz,Housing,Rent,-1317.85,-50522.12
buyer_2,Carmen,40,ES96209573984845768625,TRX_N-573-586690896167,2024-01-05T11:24:52,Zarautz,Basic services,internet,-49.08,-50571.2
buyer_2,Carmen,40,ES96209573984845768625,TRX_N-574-141675512822,2024-01-06T22:05:39,Zarautz,Basic services,water,-74.02,-50645.22
buyer_2,Carmen,40,ES96209573984845768625,TRX_N-575-858093293823,2024-01-06T12:56:50,Zarautz,Basic services,phone,-21.69,-50666.91
buyer_2,Carmen,40,ES96209573984845768625,TRX_N-576-649808027553,2024-01-07T12:35:26,Zarautz,Basic services,water,-40.21,-50707.12
buyer_2,Carmen,40,ES96209573984845768625,TRX_N-577-873407818623,2024-01-07T19:57:48,Zarautz,Basic services,gas,-73.0,-50780.12
buyer_2,Carmen,40,ES96209573984845768625,TRX_N-578-533962293064,2024-01-07T10:07:35,Zarautz,Basic services,phone,-28.57,-50808.69
buyer_2,Carmen,40,ES96209573984845768625,TRX_N-579-638465845675,2024-01-10T19:48:04,Zarautz,Expense,leisure,-76.43,-50885.12
buyer_2,Carmen,40,ES96209573984845768625,TRX_N-58-218639997937,2020-06-05T15:01:27,Zarautz,Basic services,water,-66.97,-1821.18
buyer_2,Carmen,40,ES96209573984845768625,TRX_N-580-801275090979,2024-01-17T18:44:43,Zarautz,Expense,food,-592.14,-51477.26
buyer_2,Carmen,40,ES96209573984845768625,TRX_N-581-712745525013,2024-01-21T20:32:18,Zarautz,Expense,food,-769.92,-52247.18
buyer_2,Carmen,40,ES96209573984845768625,TRX_N-582-229187561783,2024-01-28T14:47:27,Zarautz,Expense,clothing,-177.92,-52425.1
buyer_2,Carmen,40,ES96209573984845768625,TRX_N-583-247003117192,2024-02-01T07:15:52,Zarautz,transfer,Salary,1530.51,-50894.59
buyer_2,Carmen,40,ES96209573984845768625,TRX_N-584-231884732505,2024-02-02T16:27:26,Labastida/Bastida,Expense,clothing,-182.51,-51077.1
buyer_2,Carmen,40,ES96209573984845768625,TRX_N-585-518265391098,2024-02-05T10:21:37,Zarautz,Housing,Rent,-1317.85,-52394.95
buyer_2,Carmen,40,ES96209573984845768625,TRX_N-586-247734526963,2024-02-05T08:46:12,Zarautz,Basic services,water,-12.6,-52407.55
buyer_2,Carmen,40,ES96209573984845768625,TRX_N-587-935348681645,2024-02-06T15:24:07,Zarautz,Basic services,phone,-58.53,-52466.08
buyer_2,Carmen,40,ES96209573984845768625,TRX_N-588-462978222552,2024-03-01T04:21:42,Zarautz,transfer,Salary,1530.51,-50935.57
buyer_2,Carmen,40,ES96209573984845768625,TRX_N-589-951831209466,2024-03-01T04:21:42,Zarautz,transfer,Extra Income,153.05,-50782.52
buyer_2,Carmen,40,ES96209573984845768625,TRX_N-59-582679654955,2020-06-05T00:09:51,Zarautz,Basic services,electricity,-22.31,-1843.49
buyer_2,Carmen,40,ES96209573984845768625,TRX_N-590-991298558283,2024-03-02T08:40:28,Zarautz,Expense,food,-275.05,-51057.57
buyer_2,Carmen,40,ES96209573984845768625,TRX_N-591-770242748241,2024-03-05T15:25:19,Zarautz,Housing,Rent,-1317.85,-52375.42
buyer_2,Carmen,40,ES96209573984845768625,TRX_N-592-375594853861,2024-03-05T18:41:16,Zarautz,Basic services,phone,-42.56,-52417.98
buyer_2,Carmen,40,ES96209573984845768625,TRX_N-593-2687725270,2024-03-06T19:11:06,Zarautz,Basic services,electricity,-71.44,-52489.42
buyer_2,Carmen,40,ES96209573984845768625,TRX_N-594-338760837246,2024-03-06T17:49:25,Zarautz,Basic services,phone,-73.21,-52562.63
buyer_2,Carmen,40,ES96209573984845768625,TRX_N-595-139384100454,2024-03-07T23:44:55,Zarautz,Basic services,gas,-60.26,-52622.89
buyer_2,Carmen,40,ES96209573984845768625,TRX_N-596-16135177734,2024-03-07T11:11:28,Zarautz,Basic services,phone,-89.96,-52712.85
buyer_2,Carmen,40,ES96209573984845768625,TRX_N-597-25451397297,2024-03-10T20:44:13,Zarautz,Expense,food,-280.68,-52993.53
buyer_2,Carmen,40,ES96209573984845768625,TRX_N-598-948531691196,2024-03-13T14:04:44,Zarautz,Expense,food,-430.98,-53424.51
buyer_2,Carmen,40,ES96209573984845768625,TRX_N-599-9353302112,2024-03-14T16:26:41,Zarautz,Expense,repairs,-739.95,-54164.46
buyer_2,Carmen,40,ES96209573984845768625,TRX_N-6-689621238460,2020-01-26T23:27:15,Zarautz,Expense,food,-158.59,1386.93
buyer_2,Carmen,40,ES96209573984845768625,TRX_N-60-963170112283,2020-06-05T08:03:34,Zarautz,Basic services,gas,-64.59,-1908.08
buyer_2,Carmen,40,ES96209573984845768625,TRX_N-600-1784802667,2024-04-01T23:45:33,Zarautz,transfer,Salary,1530.51,-52633.95
buyer_2,Carmen,40,ES96209573984845768625,TRX_N-601-111626829905,2024-04-04T19:24:19,Zarautz,Expense,appliances,-1796.73,-54430.68
buyer_2,Carmen,40,ES96209573984845768625,TRX_N-602-12119002476,2024-04-05T13:37:03,Zarautz,Housing,Rent,-1317.85,-55748.53
buyer_2,Carmen,40,ES96209573984845768625,TRX_N-603-458711307168,2024-04-05T16:47:02,Zarautz,Basic services,water,-54.4,-55802.93
buyer_2,Carmen,40,ES96209573984845768625,TRX_N-604-553951064581,2024-04-05T10:34:20,Zarautz,Basic services,electricity,-42.16,-55845.09
buyer_2,Carmen,40,ES96209573984845768625,TRX_N-605-961925003390,2024-04-05T15:29:48,Zarautz,Basic services,phone,-57.86,-55902.95
buyer_2,Carmen,40,ES96209573984845768625,TRX_N-606-780386005167,2024-04-06T14:38:53,Zarautz,Basic services,electricity,-143.71,-56046.66
buyer_2,Carmen,40,ES96209573984845768625,TRX_N-607-744390751778,2024-04-06T19:24:07,Zarautz,Basic services,internet,-78.33,-56124.99
buyer_2,Carmen,40,ES96209573984845768625,TRX_N-608-251789992649,2024-04-08T17:52:10,Alegría-Dulantzi,Expense,leisure,-48.31,-56173.3
buyer_2,Carmen,40,ES96209573984845768625,TRX_N-609-204946133955,2024-04-18T18:12:57,Zarautz,Expense,transport,-90.31,-56263.61
buyer_2,Carmen,40,ES96209573984845768625,TRX_N-61-82401419022,2020-06-05T13:20:12,Zarautz,Basic services,internet,-59.09,-1967.17
buyer_2,Carmen,40,ES96209573984845768625,TRX_N-610-475122477756,2024-04-21T18:36:15,Zarautz,Expense,transport,-111.77,-56375.38
buyer_2,Carmen,40,ES96209573984845768625,TRX_N-611-628222220647,2024-05-01T12:58:58,Zarautz,transfer,Salary,1530.51,-54844.87
buyer_2,Carmen,40,ES96209573984845768625,TRX_N-612-28899822210,2024-05-04T09:30:55,Zarautz,Expense,food,-502.15,-55347.02
buyer_2,Carmen,40,ES96209573984845768625,TRX_N-613-943463797808,2024-05-05T14:56:56,Zarautz,Housing,Rent,-1317.85,-56664.87
buyer_2,Carmen,40,ES96209573984845768625,TRX_N-614-867447906341,2024-05-05T17:59:18,Zarautz,Basic services,electricity,-116.94,-56781.81
buyer_2,Carmen,40,ES96209573984845768625,TRX_N-615-703462110413,2024-05-05T16:41:59,Zarautz,Basic services,internet,-67.01,-56848.82
buyer_2,Carmen,40,ES96209573984845768625,TRX_N-616-167050334193,2024-05-05T18:05:12,Zarautz,Basic services,phone,-28.04,-56876.86
buyer_2,Carmen,40,ES96209573984845768625,TRX_N-617-918176174984,2024-05-07T18:56:50,Zarautz,Basic services,water,-71.82,-56948.68
buyer_2,Carmen,40,ES96209573984845768625,TRX_N-618-693531499884,2024-05-07T12:47:28,Zarautz,Basic services,phone,-68.77,-57017.45
buyer_2,Carmen,40,ES96209573984845768625,TRX_N-619-744976617800,2024-05-09T15:37:49,Zarautz,Expense,leisure,-13.18,-57030.63
buyer_2,Carmen,40,ES96209573984845768625,TRX_N-62-782351308203,2020-06-06T10:30:44,Zarautz,Basic services,water,-38.61,-2005.78
buyer_2,Carmen,40,ES96209573984845768625,TRX_N-620-664865024091,2024-05-13T18:23:54,Zarautz,Expense,transport,-162.91,-57193.54
buyer_2,Carmen,40,ES96209573984845768625,TRX_N-621-145056356127,2024-05-16T15:45:06,Zarautz,Expense,transport,-140.64,-57334.18
buyer_2,Carmen,40,ES96209573984845768625,TRX_N-622-989039507026,2024-05-16T16:23:23,Iruña de Oca,Expense,gifts,-114.57,-57448.75
buyer_2,Carmen,40,ES96209573984845768625,TRX_N-623-550112901135,2024-05-21T09:26:32,Alegría-Dulantzi,Expense,transport,-125.97,-57574.72
buyer_2,Carmen,40,ES96209573984845768625,TRX_N-624-750699089792,2024-05-22T11:45:27,Zarautz,Expense,transport,-167.7,-57742.42
buyer_2,Carmen,40,ES96209573984845768625,TRX_N-625-409519416210,2024-05-28T09:50:08,Zarautz,Expense,transport,-196.64,-57939.06
buyer_2,Carmen,40,ES96209573984845768625,TRX_N-626-71927652178,2024-05-31T18:23:13,Zarautz,Expense,food,-565.02,-58504.08
buyer_2,Carmen,40,ES96209573984845768625,TRX_N-627-378943401662,2024-06-01T06:10:13,Zarautz,transfer,Salary,1530.51,-56973.57
buyer_2,Carmen,40,ES96209573984845768625,TRX_N-628-484749797936,2024-06-01T06:10:13,Zarautz,transfer,Extra Income,153.05,-56820.52
buyer_2,Carmen,40,ES96209573984845768625,TRX_N-629-841028672572,2024-06-01T06:10:13,Zarautz,transfer,Bonus,1511.86,-55308.66
buyer_2,Carmen,40,ES96209573984845768625,TRX_N-63-705868378448,2020-06-07T16:50:14,Zarautz,Basic services,water,-20.43,-2026.21
buyer_2,Carmen,40,ES96209573984845768625,TRX_N-630-858954059275,2024-06-05T16:59:32,Zarautz,Housing,Rent,-1317.85,-56626.51
buyer_2,Carmen,40,ES96209573984845768625,TRX_N-631-755216581929,2024-06-05T19:49:36,Zarautz,Basic services,water,-58.7,-56685.21
buyer_2,Carmen,40,ES96209573984845768625,TRX_N-632-661641917801,2024-06-05T20:15:56,Zarautz,Basic services,internet,-78.05,-56763.26
buyer_2,Carmen,40,ES96209573984845768625,TRX_N-633-410114050121,2024-06-05T08:48:31,Zarautz,Basic services,phone,-83.18,-56846.44
buyer_2,Carmen,40,ES96209573984845768625,TRX_N-634-157491420964,2024-06-06T23:37:57,Zarautz,Basic services,gas,-16.37,-56862.81
buyer_2,Carmen,40,ES96209573984845768625,TRX_N-635-114490194775,2024-06-06T10:10:48,Zarautz,Basic services,phone,-58.95,-56921.76
buyer_2,Carmen,40,ES96209573984845768625,TRX_N-636-205914845908,2024-06-07T13:06:22,Zarautz,Basic services,gas,-29.2,-56950.96
buyer_2,Carmen,40,ES96209573984845768625,TRX_N-637-861947765978,2024-06-07T19:29:13,Zarautz,Expense,food,-408.04,-57359.0
buyer_2,Carmen,40,ES96209573984845768625,TRX_N-638-902920702925,2024-06-10T05:02:24,Bermeo,Expense,food,-438.06,-57797.06
buyer_2,Carmen,40,ES96209573984845768625,TRX_N-639-115759998767,2024-07-01T08:04:59,Zarautz,transfer,Salary,1530.51,-56266.55
buyer_2,Carmen,40,ES96209573984845768625,TRX_N-64-846220657608,2020-06-07T19:47:25,Zarautz,Basic services,phone,-30.5,-2056.71
buyer_2,Carmen,40,ES96209573984845768625,TRX_N-640-384230484349,2024-07-05T10:40:00,Zarautz,Housing,Rent,-1317.85,-57584.4
buyer_2,Carmen,40,ES96209573984845768625,TRX_N-641-111440842853,2024-07-05T09:28:43,Zarautz,Basic services,electricity,-94.12,-57678.52
buyer_2,Carmen,40,ES96209573984845768625,TRX_N-642-574255112761,2024-07-06T14:52:12,Zarautz,Basic services,gas,-64.38,-57742.9
buyer_2,Carmen,40,ES96209573984845768625,TRX_N-643-813130207269,2024-07-07T11:03:04,Zarautz,Basic services,water,-28.68,-57771.58
buyer_2,Carmen,40,ES96209573984845768625,TRX_N-644-478365710271,2024-07-07T11:00:18,Zarautz,Basic services,electricity,-50.78,-57822.36
buyer_2,Carmen,40,ES96209573984845768625,TRX_N-645-334089827371,2024-07-13T08:39:27,Zarautz,Expense,food,-380.85,-58203.21
buyer_2,Carmen,40,ES96209573984845768625,TRX_N-646-109756259830,2024-07-22T03:21:36,Zarautz,Expense,transport,-26.23,-58229.44
buyer_2,Carmen,40,ES96209573984845768625,TRX_N-647-720474292532,2024-07-23T00:25:00,Zarautz,Expense,food,-545.98,-58775.42
buyer_2,Carmen,40,ES96209573984845768625,TRX_N-648-7232151747,2024-08-01T22:12:29,Zarautz,transfer,Salary,1530.51,-57244.91
buyer_2,Carmen,40,ES96209573984845768625,TRX_N-649-115641512193,2024-08-05T18:16:47,Zarautz,Housing,Rent,-1317.85,-58562.76
buyer_2,Carmen,40,ES96209573984845768625,TRX_N-65-29752452822,2020-06-13T20:07:04,Zarautz,Expense,transport,-59.92,-2116.63
buyer_2,Carmen,40,ES96209573984845768625,TRX_N-650-581048295885,2024-08-05T09:40:57,Zarautz,Basic services,water,-43.96,-58606.72
buyer_2,Carmen,40,ES96209573984845768625,TRX_N-651-933475195735,2024-08-05T04:10:25,Zarautz,Basic services,electricity,-99.25,-58705.97
buyer_2,Carmen,40,ES96209573984845768625,TRX_N-652-752145980581,2024-08-06T20:10:30,Zarautz,Basic services,water,-62.09,-58768.06
buyer_2,Carmen,40,ES96209573984845768625,TRX_N-653-292398128929,2024-08-06T21:39:20,Zarautz,Basic services,gas,-56.12,-58824.18
buyer_2,Carmen,40,ES96209573984845768625,TRX_N-654-638991019674,2024-08-06T16:23:49,Zarautz,Basic services,internet,-41.05,-58865.23
buyer_2,Carmen,40,ES96209573984845768625,TRX_N-655-363970985338,2024-08-06T17:02:25,Zarautz,Basic services,phone,-84.6,-58949.83
buyer_2,Carmen,40,ES96209573984845768625,TRX_N-656-607003602473,2024-08-07T07:19:52,Zarautz,Basic services,electricity,-66.11,-59015.94
buyer_2,Carmen,40,ES96209573984845768625,TRX_N-657-194222246278,2024-08-07T15:45:26,Zarautz,Basic services,gas,-95.51,-59111.45
buyer_2,Carmen,40,ES96209573984845768625,TRX_N-658-78663759263,2024-08-17T12:32:01,Amurrio,Expense,clothing,-102.56,-59214.01
buyer_2,Carmen,40,ES96209573984845768625,TRX_N-659-612358536793,2024-08-30T14:29:42,Zarautz,Expense,travel,-1929.17,-61143.18
buyer_2,Carmen,40,ES96209573984845768625,TRX_N-66-811606853507,2020-07-01T12:44:25,Zarautz,transfer,Salary,1530.51,-586.12
buyer_2,Carmen,40,ES96209573984845768625,TRX_N-660-884676017040,2024-09-01T18:06:25,Zarautz,transfer,Salary,1530.51,-59612.67
buyer_2,Carmen,40,ES96209573984845768625,TRX_N-661-318709175047,2024-09-01T18:06:25,Zarautz,transfer,Extra Income,153.05,-59459.62
buyer_2,Carmen,40,ES96209573984845768625,TRX_N-662-15546567550,2024-09-05T09:15:24,Zarautz,Housing,Rent,-1317.85,-60777.47
buyer_2,Carmen,40,ES96209573984845768625,TRX_N-663-865156445688,2024-09-07T17:51:15,Zarautz,Basic services,internet,-42.79,-60820.26
buyer_2,Carmen,40,ES96209573984845768625,TRX_N-664-584736295804,2024-09-18T12:05:58,Zarautz,Expense,food,-475.55,-61295.81
buyer_2,Carmen,40,ES96209573984845768625,TRX_N-665-924516464263,2024-09-19T23:09:38,Zarautz,Expense,clothing,-431.92,-61727.73
buyer_2,Carmen,40,ES96209573984845768625,TRX_N-666-174125718416,2024-09-21T09:32:59,Zarautz,Expense,transport,-59.05,-61786.78
buyer_2,Carmen,40,ES96209573984845768625,TRX_N-667-871518898352,2024-09-25T23:28:30,Arrasate/Mondragon,Expense,leisure,-93.06,-61879.84
buyer_2,Carmen,40,ES96209573984845768625,TRX_N-668-113576393254,2024-09-27T09:44:01,Barakaldo,Expense,leisure,-214.99,-62094.83
buyer_2,Carmen,40,ES96209573984845768625,TRX_N-669-969208636021,2024-10-01T18:49:09,Zarautz,transfer,Salary,1530.51,-60564.32
buyer_2,Carmen,40,ES96209573984845768625,TRX_N-67-823110439361,2020-07-02T11:38:19,Zarautz,Expense,transport,-46.65,-632.77
buyer_2,Carmen,40,ES96209573984845768625,TRX_N-670-226143512594,2024-10-05T13:48:07,Zarautz,Housing,Rent,-1317.85,-61882.17
buyer_2,Carmen,40,ES96209573984845768625,TRX_N-671-573602920097,2024-10-05T09:10:18,Zarautz,Basic services,water,-72.54,-61954.71
buyer_2,Carmen,40,ES96209573984845768625,TRX_N-672-973880259721,2024-10-05T13:55:16,Zarautz,Basic services,electricity,-74.62,-62029.33
buyer_2,Carmen,40,ES96209573984845768625,TRX_N-673-230306413622,2024-10-05T15:56:38,Zarautz,Basic services,gas,-74.42,-62103.75
buyer_2,Carmen,40,ES96209573984845768625,TRX_N-674-207776492365,2024-10-05T14:03:40,Zarautz,Basic services,internet,-70.17,-62173.92
buyer_2,Carmen,40,ES96209573984845768625,TRX_N-675-345583262208,2024-10-05T14:00:42,Zarautz,Basic services,phone,-86.38,-62260.3
buyer_2,Carmen,40,ES96209573984845768625,TRX_N-676-576109738875,2024-10-06T05:07:23,Zarautz,Basic services,electricity,-62.31,-62322.61
buyer_2,Carmen,40,ES96209573984845768625,TRX_N-68-184415924814,2020-07-02T08:58:44,Zarautz,Expense,leisure,-187.98,-820.75
buyer_2,Carmen,40,ES96209573984845768625,TRX_N-69-336577418207,2020-07-05T15:46:21,Zarautz,Housing,Rent,-1317.85,-2138.6
buyer_2,Carmen,40,ES96209573984845768625,TRX_N-7-780338546959,2020-01-31T08:27:34,Zarautz,Expense,repairs,-616.14,770.79
buyer_2,Carmen,40,ES96209573984845768625,TRX_N-70-636133727087,2020-07-05T20:18:01,Zarautz,Basic services,gas,-82.28,-2220.88
buyer_2,Carmen,40,ES96209573984845768625,TRX_N-71-430082541967,2020-07-07T15:59:14,Zarautz,Basic services,water,-38.99,-2259.87
buyer_2,Carmen,40,ES96209573984845768625,TRX_N-72-250387710033,2020-07-07T21:26:06,Zarautz,Basic services,phone,-26.9,-2286.77
buyer_2,Carmen,40,ES96209573984845768625,TRX_N-73-432626628016,2020-07-16T16:17:29,Zarautz,Expense,repairs,-385.62,-2672.39
buyer_2,Carmen,40,ES96209573984845768625,TRX_N-74-887630001600,2020-07-28T20:29:54,Zarautz,Expense,education,-695.63,-3368.02
buyer_2,Carmen,40,ES96209573984845768625,TRX_N-75-572886445805,2020-08-01T23:31:34,Zarautz,transfer,Salary,1530.51,-1837.51
buyer_2,Carmen,40,ES96209573984845768625,TRX_N-76-298785921772,2020-08-02T12:25:20,Zarautz,Expense,food,-471.98,-2309.49
buyer_2,Carmen,40,ES96209573984845768625,TRX_N-77-638664632429,2020-08-03T13:46:50,Zarautz,Expense,transport,-66.79,-2376.28
buyer_2,Carmen,40,ES96209573984845768625,TRX_N-78-125752931851,2020-08-05T13:33:24,Zarautz,Housing,Rent,-1317.85,-3694.13
buyer_2,Carmen,40,ES96209573984845768625,TRX_N-79-469707238987,2020-08-05T13:40:54,Zarautz,Basic services,electricity,-92.66,-3786.79
buyer_2,Carmen,40,ES96209573984845768625,TRX_N-8-934742942688,2020-02-01T15:43:37,Zarautz,transfer,Salary,1530.51,2301.3
buyer_2,Carmen,40,ES96209573984845768625,TRX_N-80-120239963180,2020-08-06T10:19:57,Zarautz,Basic services,water,-49.97,-3836.76
buyer_2,Carmen,40,ES96209573984845768625,TRX_N-81-932922008538,2020-08-06T13:27:27,Zarautz,Expense,repairs,-339.74,-4176.5
buyer_2,Carmen,40,ES96209573984845768625,TRX_N-82-900187834595,2020-08-07T08:03:04,Zarautz,Basic services,electricity,-121.94,-4298.44
buyer_2,Carmen,40,ES96209573984845768625,TRX_N-83-316806764147,2020-08-12T14:28:03,Basauri,Expense,leisure,-60.72,-4359.16
buyer_2,Carmen,40,ES96209573984845768625,TRX_N-84-781350917726,2020-08-21T21:08:25,Labastida/Bastida,Expense,food,-370.25,-4729.41
buyer_2,Carmen,40,ES96209573984845768625,TRX_N-85-209020383274,2020-08-22T09:05:00,Zarautz,Expense,food,-212.41,-4941.82
buyer_2,Carmen,40,ES96209573984845768625,TRX_N-86-154691624422,2020-09-01T09:33:29,Zarautz,transfer,Salary,1530.51,-3411.31
buyer_2,Carmen,40,ES96209573984845768625,TRX_N-87-811469205956,2020-09-01T09:33:29,Zarautz,transfer,Extra Income,153.05,-3258.26
buyer_2,Carmen,40,ES96209573984845768625,TRX_N-88-694256071302,2020-09-01T15:44:00,Zarautz,Expense,transport,-39.33,-3297.59
buyer_2,Carmen,40,ES96209573984845768625,TRX_N-89-324078160238,2020-09-05T00:29:33,Zarautz,Housing,Rent,-1317.85,-4615.44
buyer_2,Carmen,40,ES96209573984845768625,TRX_N-9-406384197933,2020-02-05T20:42:01,Zarautz,Housing,Rent,-1317.85,983.45
buyer_2,Carmen,40,ES96209573984845768625,TRX_N-90-735779562497,2020-09-05T21:27:27,Zarautz,Basic services,water,-57.62,-4673.06
buyer_2,Carmen,40,ES96209573984845768625,TRX_N-91-515447353813,2020-09-05T19:43:50,Zarautz,Basic services,phone,-31.47,-4704.53
buyer_2,Carmen,40,ES96209573984845768625,TRX_N-92-718401625775,2020-09-06T08:04:18,Zarautz,Basic services,water,-18.53,-4723.06
buyer_2,Carmen,40,ES96209573984845768625,TRX_N-93-219459415971,2020-09-06T16:41:56,Zarautz,Basic services,internet,-39.46,-4762.52
buyer_2,Carmen,40,ES96209573984845768625,TRX_N-94-195636602842,2020-09-07T15:41:44,Zarautz,Basic services,gas,-88.59,-4851.11
buyer_2,Carmen,40,ES96209573984845768625,TRX_N-95-815393765631,2020-09-07T18:39:24,Zarautz,Basic services,internet,-30.23,-4881.34
buyer_2,Carmen,40,ES96209573984845768625,TRX_N-96-271271822498,2020-09-10T20:04:37,Zarautz,Expense,transport,-168.46,-5049.8
buyer_2,Carmen,40,ES96209573984845768625,TRX_N-97-2395811874,2020-09-20T14:34:14,Zarautz,Expense,transport,-104.27,-5154.07
buyer_2,Carmen,40,ES96209573984845768625,TRX_N-98-148335677272,2020-09-23T11:01:24,Zarautz,Expense,transport,-83.61,-5237.68
buyer_2,Carmen,40,ES96209573984845768625,TRX_N-99-337281573202,2020-09-24T22:29:50,Zarautz,Expense,leisure,-239.99,-5477.67
buyer_3,Ana,35,ES72209533922731448189,TRX_N-1-132059389549,2020-01-01T18:43:18,Amurrio,transfer,Salary,2487.34,6276.09
buyer_3,Ana,35,ES72209533922731448189,TRX_N-10-746461670869,2020-01-31T20:26:44,Amurrio,Expense,food,-644.53,6245.0
buyer_3,Ana,35,ES72209533922731448189,TRX_N-100-228428804054,2020-09-03T18:29:04,Amurrio,Expense,clothing,-178.26,32576.3
buyer_3,Ana,35,ES72209533922731448189,TRX_N-101-444262254457,2020-09-05T20:42:26,Amurrio,Housing,Rent,-1000.07,31576.23
buyer_3,Ana,35,ES72209533922731448189,TRX_N-102-962025400687,2020-09-05T15:48:53,Amurrio,Basic services,electricity,-50.98,31525.25
buyer_3,Ana,35,ES72209533922731448189,TRX_N-103-74156962022,2020-09-05T09:47:56,Amurrio,Basic services,gas,-65.44,31459.81
buyer_3,Ana,35,ES72209533922731448189,TRX_N-104-442440489738,2020-09-05T19:31:49,Amurrio,Basic services,internet,-35.26,31424.55
buyer_3,Ana,35,ES72209533922731448189,TRX_N-105-105166459129,2020-09-07T12:25:46,Amurrio,Basic services,gas,-67.8,31356.75
buyer_3,Ana,35,ES72209533922731448189,TRX_N-106-228705734680,2020-09-07T10:02:20,Amurrio,Expense,food,-539.17,30817.58
buyer_3,Ana,35,ES72209533922731448189,TRX_N-107-785905120061,2020-09-22T20:32:08,Amurrio,Expense,transport,-128.14,30689.44
buyer_3,Ana,35,ES72209533922731448189,TRX_N-108-753844761803,2020-09-22T11:22:19,Santurtzi,Expense,healthcare,-66.01,30623.43
buyer_3,Ana,35,ES72209533922731448189,TRX_N-109-982580556945,2020-09-24T10:26:08,Getxo,Expense,education,-698.06,29925.37
buyer_3,Ana,35,ES72209533922731448189,TRX_N-11-336093524683,2020-02-01T08:01:53,Amurrio,transfer,Salary,2487.34,8732.34
buyer_3,Ana,35,ES72209533922731448189,TRX_N-110-422626283635,2020-09-29T12:47:46,Amurrio,Expense,education,-194.99,29730.38
buyer_3,Ana,35,ES72209533922731448189,TRX_N-111-147198578510,2020-09-30T06:38:15,Durango,Expense,leisure,-258.51,29471.87
buyer_3,Ana,35,ES72209533922731448189,TRX_N-112-686111624015,2020-10-01T01:08:12,Amurrio,transfer,Salary,2487.34,31959.21
buyer_3,Ana,35,ES72209533922731448189,TRX_N-113-643432624556,2020-10-01T01:08:12,Amurrio,transfer,Partner Salary,2399.93,34359.14
buyer_3,Ana,35,ES72209533922731448189,TRX_N-114-760709496979,2020-10-02T22:23:58,Berango,Expense,gifts,-159.11,34200.03
buyer_3,Ana,35,ES72209533922731448189,TRX_N-115-211210509739,2020-10-05T23:55:49,Amurrio,Housing,Rent,-1000.07,33199.96
buyer_3,Ana,35,ES72209533922731448189,TRX_N-116-397082406019,2020-10-05T11:03:43,Amurrio,Basic services,water,-28.42,33171.54
buyer_3,Ana,35,ES72209533922731448189,TRX_N-117-577058211851,2020-10-05T14:39:05,Amurrio,Basic services,phone,-84.64,33086.9
buyer_3,Ana,35,ES72209533922731448189,TRX_N-118-866793974550,2020-10-05T21:05:50,Amurrio,Expense,food,-489.53,32597.37
buyer_3,Ana,35,ES72209533922731448189,TRX_N-119-611937760646,2020-10-06T08:59:33,Amurrio,Basic services,water,-77.93,32519.44
buyer_3,Ana,35,ES72209533922731448189,TRX_N-12-192701208546,2020-02-01T08:01:53,Amurrio,transfer,Partner Salary,2399.93,11132.27
buyer_3,Ana,35,ES72209533922731448189,TRX_N-120-945930244864,2020-10-06T08:01:15,Amurrio,Basic services,electricity,-28.95,32490.49
buyer_3,Ana,35,ES72209533922731448189,TRX_N-121-945639108986,2020-10-06T19:55:32,Amurrio,Basic services,gas,-21.11,32469.38
buyer_3,Ana,35,ES72209533922731448189,TRX_N-122-678680554633,2020-10-06T14:10:07,Amurrio,Basic services,internet,-37.22,32432.16
buyer_3,Ana,35,ES72209533922731448189,TRX_N-123-353566609920,2020-10-16T11:51:35,Llodio,Expense,clothing,-349.68,32082.48
buyer_3,Ana,35,ES72209533922731448189,TRX_N-124-494263139547,2020-10-27T18:32:38,Amurrio,Expense,education,-369.06,31713.42
buyer_3,Ana,35,ES72209533922731448189,TRX_N-125-70000675845,2020-11-01T13:56:58,Amurrio,transfer,Salary,2487.34,34200.76
buyer_3,Ana,35,ES72209533922731448189,TRX_N-126-148609541457,2020-11-01T13:56:58,Amurrio,transfer,Partner Salary,2399.93,36600.69
buyer_3,Ana,35,ES72209533922731448189,TRX_N-127-90871177731,2020-11-01T13:56:58,Amurrio,transfer,Extra Income,248.73,36849.42
buyer_3,Ana,35,ES72209533922731448189,TRX_N-128-265201914836,2020-11-05T02:45:04,Amurrio,Housing,Rent,-1000.07,35849.35
buyer_3,Ana,35,ES72209533922731448189,TRX_N-129-169231831072,2020-11-05T14:33:38,Amurrio,Basic services,internet,-78.88,35770.47
buyer_3,Ana,35,ES72209533922731448189,TRX_N-13-83996767104,2020-02-05T08:52:12,Amurrio,Housing,Rent,-1000.07,10132.2
buyer_3,Ana,35,ES72209533922731448189,TRX_N-130-987284878843,2020-11-06T23:27:21,Amurrio,Basic services,electricity,-26.5,35743.97
buyer_3,Ana,35,ES72209533922731448189,TRX_N-131-852879667427,2020-11-06T20:42:59,Amurrio,Expense,food,-143.26,35600.71
buyer_3,Ana,35,ES72209533922731448189,TRX_N-132-201042513655,2020-11-07T18:35:23,Amurrio,Basic services,internet,-49.5,35551.21
buyer_3,Ana,35,ES72209533922731448189,TRX_N-133-581889614019,2020-11-08T10:21:10,Amurrio,Expense,food,-735.16,34816.05
buyer_3,Ana,35,ES72209533922731448189,TRX_N-134-955416677059,2020-11-12T23:34:27,Amurrio,Expense,gifts,-162.06,34653.99
buyer_3,Ana,35,ES72209533922731448189,TRX_N-135-526950525384,2020-11-14T11:47:10,Amurrio,Expense,leisure,-19.49,34634.5
buyer_3,Ana,35,ES72209533922731448189,TRX_N-136-792368942355,2020-11-19T18:11:07,Amurrio,Expense,food,-178.17,34456.33
buyer_3,Ana,35,ES72209533922731448189,TRX_N-137-483057999257,2020-11-19T15:37:48,Alegría-Dulantzi,Expense,education,-734.97,33721.36
buyer_3,Ana,35,ES72209533922731448189,TRX_N-138-395936622621,2020-11-26T13:25:22,Amurrio,Expense,transport,-33.31,33688.05
buyer_3,Ana,35,ES72209533922731448189,TRX_N-139-420441494396,2020-11-27T22:40:24,Hondarribia,Expense,food,-592.89,33095.16
buyer_3,Ana,35,ES72209533922731448189,TRX_N-14-28909016629,2020-02-05T10:18:33,Amurrio,Basic services,phone,-31.16,10101.04
buyer_3,Ana,35,ES72209533922731448189,TRX_N-140-209170971265,2020-12-01T09:21:31,Amurrio,transfer,Salary,2487.34,35582.5
buyer_3,Ana,35,ES72209533922731448189,TRX_N-141-212321478440,2020-12-01T09:21:31,Amurrio,transfer,Partner Salary,2399.93,37982.43
buyer_3,Ana,35,ES72209533922731448189,TRX_N-142-791562782158,2020-12-01T09:21:31,Amurrio,transfer,Bonus,2593.0,40575.43
buyer_3,Ana,35,ES72209533922731448189,TRX_N-143-103978228514,2020-12-05T16:41:52,Amurrio,Housing,Rent,-1000.07,39575.36
buyer_3,Ana,35,ES72209533922731448189,TRX_N-144-367520632779,2020-12-05T18:58:07,Amurrio,Basic services,gas,-41.22,39534.14
buyer_3,Ana,35,ES72209533922731448189,TRX_N-145-257383512763,2020-12-06T19:24:10,Amurrio,Basic services,electricity,-41.46,39492.68
buyer_3,Ana,35,ES72209533922731448189,TRX_N-146-439543570738,2020-12-07T20:31:27,Amurrio,Basic services,water,-33.63,39459.05
buyer_3,Ana,35,ES72209533922731448189,TRX_N-147-218938280674,2020-12-12T09:55:01,Amurrio,Expense,transport,-189.51,39269.54
buyer_3,Ana,35,ES72209533922731448189,TRX_N-148-87157429960,2020-12-13T08:15:09,Sestao,Expense,food,-242.67,39026.87
buyer_3,Ana,35,ES72209533922731448189,TRX_N-149-633364177059,2020-12-13T13:37:57,Amurrio,Expense,healthcare,-349.62,38677.25
buyer_3,Ana,35,ES72209533922731448189,TRX_N-15-315820244669,2020-02-06T17:03:03,Amurrio,Basic services,water,-56.28,10044.76
buyer_3,Ana,35,ES72209533922731448189,TRX_N-150-685796806723,2020-12-14T15:36:12,Amurrio,Expense,transport,-22.6,38654.65
buyer_3,Ana,35,ES72209533922731448189,TRX_N-151-669143140474,2020-12-17T19:15:26,Zarautz,Expense,leisure,-105.11,38549.54
buyer_3,Ana,35,ES72209533922731448189,TRX_N-152-336673019255,2020-12-30T03:03:24,Amurrio,Expense,food,-414.85,38134.69
buyer_3,Ana,35,ES72209533922731448189,TRX_N-153-805876958898,2020-12-30T22:11:39,Amurrio,Expense,clothing,-463.32,37671.37
buyer_3,Ana,35,ES72209533922731448189,TRX_N-154-490931741039,2021-01-01T10:52:14,Amurrio,transfer,Salary,2487.34,40158.71
buyer_3,Ana,35,ES72209533922731448189,TRX_N-155-550221845475,2021-01-01T10:52:14,Amurrio,transfer,Partner Salary,2399.93,42558.64
buyer_3,Ana,35,ES72209533922731448189,TRX_N-156-817247939026,2021-01-01T10:52:14,Amurrio,transfer,Extra Income,248.73,42807.37
buyer_3,Ana,35,ES72209533922731448189,TRX_N-157-734710128573,2021-01-05T20:55:10,Amurrio,Housing,Rent,-1000.07,41807.3
buyer_3,Ana,35,ES72209533922731448189,TRX_N-158-756101182058,2021-01-05T18:24:16,Amurrio,Basic services,gas,-46.78,41760.52
buyer_3,Ana,35,ES72209533922731448189,TRX_N-159-264308675663,2021-01-05T11:30:08,Amurrio,Basic services,internet,-50.0,41710.52
buyer_3,Ana,35,ES72209533922731448189,TRX_N-16-104011283318,2020-02-06T09:29:16,Amurrio,Basic services,electricity,-31.8,10012.96
buyer_3,Ana,35,ES72209533922731448189,TRX_N-160-139161846947,2021-01-07T08:20:47,Amurrio,Basic services,gas,-44.8,41665.72
buyer_3,Ana,35,ES72209533922731448189,TRX_N-161-790316304388,2021-01-07T08:05:15,Amurrio,Basic services,internet,-39.6,41626.12
buyer_3,Ana,35,ES72209533922731448189,TRX_N-162-477004887090,2021-01-19T17:23:49,Amurrio,Expense,healthcare,-227.63,41398.49
buyer_3,Ana,35,ES72209533922731448189,TRX_N-163-339232448231,2021-01-26T13:37:31,Amurrio,Expense,food,-450.77,40947.72
buyer_3,Ana,35,ES72209533922731448189,TRX_N-164-139511988569,2021-02-01T08:03:30,Amurrio,transfer,Salary,2487.34,43435.06
buyer_3,Ana,35,ES72209533922731448189,TRX_N-165-976791228998,2021-02-01T08:03:30,Amurrio,transfer,Partner Salary,2399.93,45834.99
buyer_3,Ana,35,ES72209533922731448189,TRX_N-166-482940732923,2021-02-05T12:01:58,Amurrio,Housing,Rent,-1000.07,44834.92
buyer_3,Ana,35,ES72209533922731448189,TRX_N-167-350538490190,2021-02-05T16:29:44,Amurrio,Basic services,electricity,-128.47,44706.45
buyer_3,Ana,35,ES72209533922731448189,TRX_N-168-502740733404,2021-02-05T20:04:08,Amurrio,Basic services,internet,-54.12,44652.33
buyer_3,Ana,35,ES72209533922731448189,TRX_N-169-138621754275,2021-02-06T11:13:34,Amurrio,Basic services,phone,-63.08,44589.25
buyer_3,Ana,35,ES72209533922731448189,TRX_N-17-273658081049,2020-02-07T18:06:03,Amurrio,Basic services,electricity,-83.42,9929.54
buyer_3,Ana,35,ES72209533922731448189,TRX_N-170-514913113518,2021-02-06T14:59:38,Amurrio,Expense,clothing,-153.19,44436.06
buyer_3,Ana,35,ES72209533922731448189,TRX_N-171-110233786403,2021-02-07T11:36:43,Amurrio,Basic services,electricity,-124.27,44311.79
buyer_3,Ana,35,ES72209533922731448189,TRX_N-172-372856421987,2021-02-07T11:36:12,Amurrio,Basic services,internet,-65.8,44245.99
buyer_3,Ana,35,ES72209533922731448189,TRX_N-173-194001450586,2021-02-11T23:48:22,Portugalete,Expense,transport,-118.84,44127.15
buyer_3,Ana,35,ES72209533922731448189,TRX_N-174-255888079525,2021-02-15T12:16:12,Amurrio,Expense,clothing,-279.11,43848.04
buyer_3,Ana,35,ES72209533922731448189,TRX_N-175-795250896664,2021-02-20T18:53:33,Amurrio,Expense,leisure,-38.6,43809.44
buyer_3,Ana,35,ES72209533922731448189,TRX_N-176-649046056027,2021-02-22T14:24:14,Amurrio,Expense,healthcare,-347.08,43462.36
buyer_3,Ana,35,ES72209533922731448189,TRX_N-177-294565444896,2021-02-23T12:03:42,Amurrio,Expense,food,-569.85,42892.51
buyer_3,Ana,35,ES72209533922731448189,TRX_N-178-372366226171,2021-02-24T17:01:40,Amurrio,Expense,transport,-39.52,42852.99
buyer_3,Ana,35,ES72209533922731448189,TRX_N-179-199101358623,2021-02-28T04:47:21,Llodio,Expense,transport,-191.17,42661.82
buyer_3,Ana,35,ES72209533922731448189,TRX_N-18-938990773646,2020-02-27T08:48:57,Andoain,Expense,clothing,-205.38,9724.16
buyer_3,Ana,35,ES72209533922731448189,TRX_N-180-309278190604,2021-03-01T19:58:38,Amurrio,transfer,Salary,2487.34,45149.16
buyer_3,Ana,35,ES72209533922731448189,TRX_N-181-593963404372,2021-03-01T19:58:38,Amurrio,transfer,Partner Salary,2399.93,47549.09
buyer_3,Ana,35,ES72209533922731448189,TRX_N-182-535617527344,2021-03-01T19:58:38,Amurrio,transfer,Extra Income,248.73,47797.82
buyer_3,Ana,35,ES72209533922731448189,TRX_N-183-971385639862,2021-03-04T17:10:16,Amurrio,Expense,leisure,-17.04,47780.78
buyer_3,Ana,35,ES72209533922731448189,TRX_N-184-288490751118,2021-03-05T16:19:59,Amurrio,Housing,Rent,-1000.07,46780.71
buyer_3,Ana,35,ES72209533922731448189,TRX_N-185-900891218451,2021-03-05T19:40:19,Amurrio,Basic services,gas,-56.61,46724.1
buyer_3,Ana,35,ES72209533922731448189,TRX_N-186-976507018103,2021-03-05T03:55:07,Amurrio,Basic services,phone,-25.34,46698.76
buyer_3,Ana,35,ES72209533922731448189,TRX_N-187-587210151951,2021-03-05T11:16:09,Amurrio,Expense,transport,-51.99,46646.77
buyer_3,Ana,35,ES72209533922731448189,TRX_N-188-240212593996,2021-03-06T11:29:28,Amurrio,Basic services,water,-57.86,46588.91
buyer_3,Ana,35,ES72209533922731448189,TRX_N-189-604392568385,2021-03-07T09:26:05,Amurrio,Basic services,electricity,-125.45,46463.46
buyer_3,Ana,35,ES72209533922731448189,TRX_N-19-847673903218,2020-03-01T18:20:47,Amurrio,transfer,Salary,2487.34,12211.5
buyer_3,Ana,35,ES72209533922731448189,TRX_N-190-653978399847,2021-03-07T08:01:41,Amurrio,Basic services,phone,-91.7,46371.76
buyer_3,Ana,35,ES72209533922731448189,TRX_N-191-715948978369,2021-03-10T23:27:24,Amurrio,Expense,transport,-154.15,46217.61
buyer_3,Ana,35,ES72209533922731448189,TRX_N-192-721705274891,2021-03-10T17:56:41,Amurrio,Expense,clothing,-272.63,45944.98
buyer_3,Ana,35,ES72209533922731448189,TRX_N-193-652860824949,2021-03-20T09:33:16,Amurrio,Expense,appliances,-1948.27,43996.71
buyer_3,Ana,35,ES72209533922731448189,TRX_N-194-589442887238,2021-03-22T08:17:51,Amurrio,Expense,food,-600.01,43396.7
buyer_3,Ana,35,ES72209533922731448189,TRX_N-195-78904151882,2021-03-25T18:05:48,Amurrio,Expense,transport,-48.64,43348.06
buyer_3,Ana,35,ES72209533922731448189,TRX_N-196-580442390339,2021-04-01T02:47:02,Amurrio,transfer,Salary,2487.34,45835.4
buyer_3,Ana,35,ES72209533922731448189,TRX_N-197-469159732016,2021-04-01T02:47:02,Amurrio,transfer,Partner Salary,2399.93,48235.33
buyer_3,Ana,35,ES72209533922731448189,TRX_N-198-608204206279,2021-04-05T11:27:03,Amurrio,Housing,Rent,-1000.07,47235.26
buyer_3,Ana,35,ES72209533922731448189,TRX_N-199-55217655872,2021-04-05T23:05:45,Amurrio,Basic services,internet,-47.16,47188.1
buyer_3,Ana,35,ES72209533922731448189,TRX_N-2-595906727177,2020-01-01T18:43:18,Amurrio,transfer,Partner Salary,2399.93,8676.02
buyer_3,Ana,35,ES72209533922731448189,TRX_N-20-283820099098,2020-03-01T18:20:47,Amurrio,transfer,Partner Salary,2399.93,14611.43
buyer_3,Ana,35,ES72209533922731448189,TRX_N-200-220008408420,2021-04-07T09:26:33,Amurrio,Basic services,water,-11.15,47176.95
buyer_3,Ana,35,ES72209533922731448189,TRX_N-201-256532176270,2021-04-07T18:16:24,Amurrio,Basic services,gas,-93.02,47083.93
buyer_3,Ana,35,ES72209533922731448189,TRX_N-202-974049004230,2021-04-07T08:03:45,Amurrio,Expense,food,-158.76,46925.17
buyer_3,Ana,35,ES72209533922731448189,TRX_N-203-641813543956,2021-04-13T14:07:38,Amurrio,Expense,travel,-2773.08,44152.09
buyer_3,Ana,35,ES72209533922731448189,TRX_N-204-663515688491,2021-05-01T18:31:45,Amurrio,transfer,Salary,2487.34,46639.43
buyer_3,Ana,35,ES72209533922731448189,TRX_N-205-664474749230,2021-05-01T18:31:45,Amurrio,transfer,Partner Salary,2399.93,49039.36
buyer_3,Ana,35,ES72209533922731448189,TRX_N-206-596113964586,2021-05-05T22:17:26,Amurrio,Housing,Rent,-1000.07,48039.29
buyer_3,Ana,35,ES72209533922731448189,TRX_N-207-189784430418,2021-05-05T08:09:43,Amurrio,Basic services,internet,-37.01,48002.28
buyer_3,Ana,35,ES72209533922731448189,TRX_N-208-237959479137,2021-05-05T07:31:47,Amurrio,Basic services,phone,-68.67,47933.61
buyer_3,Ana,35,ES72209533922731448189,TRX_N-209-290614020582,2021-05-06T18:42:48,Amurrio,Basic services,electricity,-90.62,47842.99
buyer_3,Ana,35,ES72209533922731448189,TRX_N-21-491488892502,2020-03-01T18:20:47,Amurrio,transfer,Extra Income,248.73,14860.16
buyer_3,Ana,35,ES72209533922731448189,TRX_N-210-891549234405,2021-05-06T20:49:42,Amurrio,Basic services,phone,-53.28,47789.71
buyer_3,Ana,35,ES72209533922731448189,TRX_N-211-854761258872,2021-05-06T16:02:34,Amurrio,Expense,transport,-55.6,47734.11
buyer_3,Ana,35,ES72209533922731448189,TRX_N-212-499235108231,2021-05-07T20:02:57,Amurrio,Basic services,gas,-93.5,47640.61
buyer_3,Ana,35,ES72209533922731448189,TRX_N-213-538333351370,2021-05-08T14:39:18,Amurrio,Expense,clothing,-135.79,47504.82
buyer_3,Ana,35,ES72209533922731448189,TRX_N-214-8337259354,2021-05-10T19:20:24,Amurrio,Expense,leisure,-149.06,47355.76
buyer_3,Ana,35,ES72209533922731448189,TRX_N-215-151690581152,2021-05-12T09:40:11,Mungia,Expense,leisure,-24.63,47331.13
buyer_3,Ana,35,ES72209533922731448189,TRX_N-216-826404897885,2021-05-18T13:20:43,Amurrio,Expense,leisure,-143.84,47187.29
buyer_3,Ana,35,ES72209533922731448189,TRX_N-217-802554060007,2021-05-20T16:09:21,Amurrio,Expense,food,-566.0,46621.29
buyer_3,Ana,35,ES72209533922731448189,TRX_N-218-906504659654,2021-05-21T07:10:38,Oyón-Oion,Expense,food,-271.27,46350.02
buyer_3,Ana,35,ES72209533922731448189,TRX_N-219-394981322691,2021-05-25T01:21:16,Amurrio,Expense,food,-640.35,45709.67
buyer_3,Ana,35,ES72209533922731448189,TRX_N-22-138800840630,2020-03-01T14:10:00,Amurrio,Expense,clothing,-221.46,14638.7
buyer_3,Ana,35,ES72209533922731448189,TRX_N-220-940615607974,2021-06-01T09:56:26,Amurrio,transfer,Salary,2487.34,48197.01
buyer_3,Ana,35,ES72209533922731448189,TRX_N-221-417881238097,2021-06-01T09:56:26,Amurrio,transfer,Partner Salary,2399.93,50596.94
buyer_3,Ana,35,ES72209533922731448189,TRX_N-222-620337686077,2021-06-01T09:56:26,Amurrio,transfer,Extra Income,248.73,50845.67
buyer_3,Ana,35,ES72209533922731448189,TRX_N-223-760493992911,2021-06-01T09:56:26,Amurrio,transfer,Bonus,2676.76,53522.43
buyer_3,Ana,35,ES72209533922731448189,TRX_N-224-937828414318,2021-06-05T08:56:38,Amurrio,Housing,Rent,-1000.07,52522.36
buyer_3,Ana,35,ES72209533922731448189,TRX_N-225-982326266252,2021-06-05T09:16:49,Amurrio,Basic services,water,-48.5,52473.86
buyer_3,Ana,35,ES72209533922731448189,TRX_N-226-240589404294,2021-06-05T14:00:54,Amurrio,Basic services,gas,-87.62,52386.24
buyer_3,Ana,35,ES72209533922731448189,TRX_N-227-228433533057,2021-06-05T19:24:18,Amurrio,Basic services,phone,-82.45,52303.79
buyer_3,Ana,35,ES72209533922731448189,TRX_N-228-640781375339,2021-06-06T10:22:49,Amurrio,Basic services,water,-21.55,52282.24
buyer_3,Ana,35,ES72209533922731448189,TRX_N-229-688867910052,2021-06-06T15:23:59,Amurrio,Basic services,internet,-39.53,52242.71
buyer_3,Ana,35,ES72209533922731448189,TRX_N-23-648473286457,2020-03-03T19:53:11,Amurrio,Expense,education,-960.2,13678.5
buyer_3,Ana,35,ES72209533922731448189,TRX_N-230-512452065014,2021-06-07T21:52:26,Amurrio,Basic services,electricity,-104.54,52138.17
buyer_3,Ana,35,ES72209533922731448189,TRX_N-231-975934095022,2021-06-07T16:59:35,Amurrio,Basic services,phone,-36.78,52101.39
buyer_3,Ana,35,ES72209533922731448189,TRX_N-232-226851680542,2021-06-28T11:15:59,Amurrio,Expense,healthcare,-110.7,51990.69
buyer_3,Ana,35,ES72209533922731448189,TRX_N-233-131646996438,2021-07-01T10:44:08,Amurrio,transfer,Salary,2487.34,54478.03
buyer_3,Ana,35,ES72209533922731448189,TRX_N-234-42877338006,2021-07-01T10:44:08,Amurrio,transfer,Partner Salary,2399.93,56877.96
buyer_3,Ana,35,ES72209533922731448189,TRX_N-235-372713153178,2021-07-05T11:38:40,Amurrio,Housing,Rent,-1000.07,55877.89
buyer_3,Ana,35,ES72209533922731448189,TRX_N-236-515986545213,2021-07-05T16:03:31,Zuia,Expense,transport,-108.31,55769.58
buyer_3,Ana,35,ES72209533922731448189,TRX_N-237-899231212964,2021-07-06T15:56:34,Amurrio,Basic services,water,-26.45,55743.13
buyer_3,Ana,35,ES72209533922731448189,TRX_N-238-683455540659,2021-07-06T14:33:59,Amurrio,Basic services,gas,-67.66,55675.47
buyer_3,Ana,35,ES72209533922731448189,TRX_N-239-584977442825,2021-07-06T20:36:05,Amurrio,Basic services,phone,-93.89,55581.58
buyer_3,Ana,35,ES72209533922731448189,TRX_N-24-398829965750,2020-03-05T17:26:34,Amurrio,Housing,Rent,-1000.07,12678.43
buyer_3,Ana,35,ES72209533922731448189,TRX_N-240-152730586339,2021-07-07T20:19:50,Amurrio,Basic services,internet,-33.95,55547.63
buyer_3,Ana,35,ES72209533922731448189,TRX_N-241-637401237170,2021-07-31T13:33:26,Amurrio,Expense,healthcare,-69.33,55478.3
buyer_3,Ana,35,ES72209533922731448189,TRX_N-242-137204391650,2021-08-01T10:04:13,Amurrio,transfer,Salary,2487.34,57965.64
buyer_3,Ana,35,ES72209533922731448189,TRX_N-243-616029845319,2021-08-01T10:04:13,Amurrio,transfer,Partner Salary,2399.93,60365.57
buyer_3,Ana,35,ES72209533922731448189,TRX_N-244-703998253042,2021-08-01T10:04:13,Amurrio,transfer,Extra Income,248.73,60614.3
buyer_3,Ana,35,ES72209533922731448189,TRX_N-245-776148772646,2021-08-01T14:41:04,Andoain,Expense,transport,-28.5,60585.8
buyer_3,Ana,35,ES72209533922731448189,TRX_N-246-88918145802,2021-08-03T18:55:43,Amurrio,Expense,transport,-41.22,60544.58
buyer_3,Ana,35,ES72209533922731448189,TRX_N-247-341846984241,2021-08-04T10:04:01,Amurrio,Expense,gifts,-335.16,60209.42
buyer_3,Ana,35,ES72209533922731448189,TRX_N-248-564395850337,2021-08-05T09:56:39,Amurrio,Housing,Rent,-1000.07,59209.35
buyer_3,Ana,35,ES72209533922731448189,TRX_N-249-162598150480,2021-08-05T10:04:36,Amurrio,Basic services,electricity,-54.36,59154.99
buyer_3,Ana,35,ES72209533922731448189,TRX_N-25-986943269810,2020-03-07T16:19:29,Amurrio,Basic services,water,-68.77,12609.66
buyer_3,Ana,35,ES72209533922731448189,TRX_N-250-8583422843,2021-08-05T10:38:07,Amurrio,Basic services,internet,-57.97,59097.02
buyer_3,Ana,35,ES72209533922731448189,TRX_N-251-895683902439,2021-08-05T15:31:56,Amurrio,Basic services,phone,-48.38,59048.64
buyer_3,Ana,35,ES72209533922731448189,TRX_N-252-18004357874,2021-08-06T23:23:19,Amurrio,Basic services,electricity,-20.68,59027.96
buyer_3,Ana,35,ES72209533922731448189,TRX_N-253-721182073959,2021-08-06T08:00:50,Amurrio,Basic services,gas,-89.49,58938.47
buyer_3,Ana,35,ES72209533922731448189,TRX_N-254-356381645637,2021-08-06T19:19:10,Amurrio,Expense,leisure,-177.81,58760.66
buyer_3,Ana,35,ES72209533922731448189,TRX_N-255-519778744001,2021-08-07T18:19:06,Amurrio,Basic services,electricity,-26.5,58734.16
buyer_3,Ana,35,ES72209533922731448189,TRX_N-256-212788596584,2021-08-07T15:52:15,Amurrio,Basic services,gas,-40.49,58693.67
buyer_3,Ana,35,ES72209533922731448189,TRX_N-257-152812301113,2021-08-22T08:06:23,Amurrio,Expense,repairs,-797.67,57896.0
buyer_3,Ana,35,ES72209533922731448189,TRX_N-258-666143865692,2021-09-01T08:31:30,Amurrio,transfer,Salary,2487.34,60383.34
buyer_3,Ana,35,ES72209533922731448189,TRX_N-259-747365043647,2021-09-01T08:31:30,Amurrio,transfer,Partner Salary,2399.93,62783.27
buyer_3,Ana,35,ES72209533922731448189,TRX_N-26-148328004999,2020-03-07T17:53:10,Amurrio,Basic services,electricity,-84.12,12525.54
buyer_3,Ana,35,ES72209533922731448189,TRX_N-260-923779679861,2021-09-04T08:52:53,Amurrio,Expense,food,-370.0,62413.27
buyer_3,Ana,35,ES72209533922731448189,TRX_N-261-182003255202,2021-09-04T13:29:58,Amurrio,Expense,transport,-39.16,62374.11
buyer_3,Ana,35,ES72209533922731448189,TRX_N-262-759490819890,2021-09-05T08:51:44,Amurrio,Housing,Rent,-1000.07,61374.04
buyer_3,Ana,35,ES72209533922731448189,TRX_N-263-751003563279,2021-09-05T15:59:59,Amurrio,Basic services,gas,-55.18,61318.86
buyer_3,Ana,35,ES72209533922731448189,TRX_N-264-27601533919,2021-09-05T08:29:43,Amurrio,Basic services,internet,-63.78,61255.08
buyer_3,Ana,35,ES72209533922731448189,TRX_N-265-272019051362,2021-09-06T12:28:17,Amurrio,Basic services,water,-45.47,61209.61
buyer_3,Ana,35,ES72209533922731448189,TRX_N-266-297726037270,2021-09-06T16:39:45,Amurrio,Basic services,internet,-60.59,61149.02
buyer_3,Ana,35,ES72209533922731448189,TRX_N-267-75679105785,2021-09-07T16:58:52,Amurrio,Basic services,gas,-79.28,61069.74
buyer_3,Ana,35,ES72209533922731448189,TRX_N-268-7637569040,2021-09-07T09:04:45,Amurrio,Basic services,internet,-63.89,61005.85
buyer_3,Ana,35,ES72209533922731448189,TRX_N-269-962434456652,2021-09-07T15:06:15,Amurrio,Basic services,phone,-99.66,60906.19
buyer_3,Ana,35,ES72209533922731448189,TRX_N-27-492270922946,2020-03-07T13:25:28,Amurrio,Basic services,gas,-84.45,12441.09
buyer_3,Ana,35,ES72209533922731448189,TRX_N-270-912162822642,2021-10-01T03:05:58,Amurrio,transfer,Salary,2487.34,63393.53
buyer_3,Ana,35,ES72209533922731448189,TRX_N-271-242733904100,2021-10-01T03:05:58,Amurrio,transfer,Partner Salary,2399.93,65793.46
buyer_3,Ana,35,ES72209533922731448189,TRX_N-272-78318403883,2021-10-01T03:05:58,Amurrio,transfer,Extra Income,248.73,66042.19
buyer_3,Ana,35,ES72209533922731448189,TRX_N-273-210090127639,2021-10-04T14:34:36,Amurrio,Expense,food,-597.23,65444.96
buyer_3,Ana,35,ES72209533922731448189,TRX_N-274-850207015390,2021-10-05T17:55:39,Amurrio,Housing,Rent,-1000.07,64444.89
buyer_3,Ana,35,ES72209533922731448189,TRX_N-275-642938736091,2021-10-05T11:31:39,Amurrio,Basic services,phone,-20.6,64424.29
buyer_3,Ana,35,ES72209533922731448189,TRX_N-276-389179889855,2021-10-06T10:06:41,Amurrio,Basic services,phone,-23.06,64401.23
buyer_3,Ana,35,ES72209533922731448189,TRX_N-277-84314503043,2021-10-14T01:33:54,Amurrio,Expense,transport,-154.66,64246.57
buyer_3,Ana,35,ES72209533922731448189,TRX_N-278-944255583606,2021-10-16T11:49:34,Amurrio,Expense,transport,-145.19,64101.38
buyer_3,Ana,35,ES72209533922731448189,TRX_N-279-975977621627,2021-11-01T17:48:51,Amurrio,transfer,Salary,2487.34,66588.72
buyer_3,Ana,35,ES72209533922731448189,TRX_N-28-885940993814,2020-03-08T22:38:50,Amurrio,Expense,transport,-43.55,12397.54
buyer_3,Ana,35,ES72209533922731448189,TRX_N-280-323737089360,2021-11-01T17:48:51,Amurrio,transfer,Partner Salary,2399.93,68988.65
buyer_3,Ana,35,ES72209533922731448189,TRX_N-281-181373808082,2021-11-05T10:40:03,Amurrio,Housing,Rent,-1000.07,67988.58
buyer_3,Ana,35,ES72209533922731448189,TRX_N-282-338937518758,2021-11-05T15:41:57,Amurrio,Basic services,water,-14.43,67974.15
buyer_3,Ana,35,ES72209533922731448189,TRX_N-283-76822227943,2021-11-06T22:18:34,Amurrio,Basic services,water,-43.83,67930.32
buyer_3,Ana,35,ES72209533922731448189,TRX_N-284-772502922734,2021-11-07T08:57:13,Amurrio,Basic services,electricity,-75.56,67854.76
buyer_3,Ana,35,ES72209533922731448189,TRX_N-285-786406097358,2021-11-07T17:44:50,Amurrio,Basic services,gas,-38.54,67816.22
buyer_3,Ana,35,ES72209533922731448189,TRX_N-286-914306354079,2021-11-18T18:22:39,Amurrio,Expense,gifts,-80.15,67736.07
buyer_3,Ana,35,ES72209533922731448189,TRX_N-287-970383518591,2021-11-19T10:38:45,Amurrio,Expense,leisure,-145.07,67591.0
buyer_3,Ana,35,ES72209533922731448189,TRX_N-288-978808892118,2021-11-24T09:46:55,Amurrio,Expense,clothing,-299.71,67291.29
buyer_3,Ana,35,ES72209533922731448189,TRX_N-289-592326899872,2021-11-28T18:06:10,Durango,Expense,healthcare,-235.73,67055.56
buyer_3,Ana,35,ES72209533922731448189,TRX_N-29-128374902849,2020-03-13T20:04:19,Amurrio,Expense,transport,-146.22,12251.32
buyer_3,Ana,35,ES72209533922731448189,TRX_N-290-880839206381,2021-12-01T19:20:21,Amurrio,transfer,Salary,2487.34,69542.9
buyer_3,Ana,35,ES72209533922731448189,TRX_N-291-503148486607,2021-12-01T19:20:21,Amurrio,transfer,Partner Salary,2399.93,71942.83
buyer_3,Ana,35,ES72209533922731448189,TRX_N-292-34541198989,2021-12-01T19:20:21,Amurrio,transfer,Bonus,2419.26,74362.09
buyer_3,Ana,35,ES72209533922731448189,TRX_N-293-234169184814,2021-12-05T12:32:41,Amurrio,Housing,Rent,-1000.07,73362.02
buyer_3,Ana,35,ES72209533922731448189,TRX_N-294-215632256373,2021-12-05T08:19:51,Amurrio,Basic services,water,-66.41,73295.61
buyer_3,Ana,35,ES72209533922731448189,TRX_N-295-854323814806,2021-12-05T20:53:07,Amurrio,Basic services,electricity,-107.46,73188.15
buyer_3,Ana,35,ES72209533922731448189,TRX_N-296-336284781531,2021-12-05T12:24:26,Amurrio,Basic services,phone,-20.4,73167.75
buyer_3,Ana,35,ES72209533922731448189,TRX_N-297-996652597418,2021-12-06T11:58:35,Amurrio,Basic services,electricity,-87.31,73080.44
buyer_3,Ana,35,ES72209533922731448189,TRX_N-298-457074095241,2021-12-07T11:57:06,Amurrio,Basic services,gas,-90.7,72989.74
buyer_3,Ana,35,ES72209533922731448189,TRX_N-299-962013613082,2021-12-10T10:13:29,Amurrio,Expense,repairs,-193.38,72796.36
buyer_3,Ana,35,ES72209533922731448189,TRX_N-3-475022786973,2020-01-05T12:42:25,Amurrio,Housing,Rent,-1000.07,7675.95
buyer_3,Ana,35,ES72209533922731448189,TRX_N-30-77563211681,2020-03-30T21:50:08,Amurrio,Expense,healthcare,-191.84,12059.48
buyer_3,Ana,35,ES72209533922731448189,TRX_N-300-418511714422,2021-12-19T21:40:43,Amurrio,Expense,food,-257.88,72538.48
buyer_3,Ana,35,ES72209533922731448189,TRX_N-301-993894450892,2021-12-24T17:30:49,Sopela,Expense,healthcare,-370.21,72168.27
buyer_3,Ana,35,ES72209533922731448189,TRX_N-302-585871891218,2021-12-28T21:28:23,Amurrio,Expense,education,-838.77,71329.5
buyer_3,Ana,35,ES72209533922731448189,TRX_N-303-559960231635,2022-01-01T03:34:13,Amurrio,transfer,Salary,2487.34,73816.84
buyer_3,Ana,35,ES72209533922731448189,TRX_N-304-70629520666,2022-01-01T03:34:13,Amurrio,transfer,Partner Salary,2399.93,76216.77
buyer_3,Ana,35,ES72209533922731448189,TRX_N-305-101760356526,2022-01-01T03:34:13,Amurrio,transfer,Extra Income,248.73,76465.5
buyer_3,Ana,35,ES72209533922731448189,TRX_N-306-636612132081,2022-01-05T17:52:40,Amurrio,Housing,Rent,-1000.07,75465.43
buyer_3,Ana,35,ES72209533922731448189,TRX_N-307-847788115526,2022-01-05T14:18:54,Amurrio,Basic services,electricity,-61.84,75403.59
buyer_3,Ana,35,ES72209533922731448189,TRX_N-308-813515507522,2022-01-05T17:52:30,Amurrio,Basic services,gas,-97.5,75306.09
buyer_3,Ana,35,ES72209533922731448189,TRX_N-309-40147933676,2022-01-05T19:39:31,Amurrio,Basic services,internet,-66.25,75239.84
buyer_3,Ana,35,ES72209533922731448189,TRX_N-31-443625351419,2020-03-31T23:50:33,Amurrio,Expense,transport,-190.85,11868.63
buyer_3,Ana,35,ES72209533922731448189,TRX_N-310-882788094124,2022-01-07T06:23:18,Amurrio,Basic services,electricity,-31.21,75208.63
buyer_3,Ana,35,ES72209533922731448189,TRX_N-311-877451405299,2022-01-07T19:24:34,Amurrio,Basic services,gas,-77.2,75131.43
buyer_3,Ana,35,ES72209533922731448189,TRX_N-312-374908139170,2022-01-11T00:21:20,Amurrio,Expense,healthcare,-161.77,74969.66
buyer_3,Ana,35,ES72209533922731448189,TRX_N-313-807052662950,2022-01-23T06:45:59,Amurrio,Expense,food,-496.08,74473.58
buyer_3,Ana,35,ES72209533922731448189,TRX_N-314-832485774136,2022-01-31T05:53:52,Amurrio,Expense,clothing,-383.87,74089.71
buyer_3,Ana,35,ES72209533922731448189,TRX_N-315-256301622568,2022-02-01T21:04:38,Amurrio,transfer,Salary,2487.34,76577.05
buyer_3,Ana,35,ES72209533922731448189,TRX_N-316-936361961583,2022-02-01T21:04:38,Amurrio,transfer,Partner Salary,2399.93,78976.98
buyer_3,Ana,35,ES72209533922731448189,TRX_N-317-772803090420,2022-02-01T10:57:57,Amurrio,Expense,leisure,-293.82,78683.16
buyer_3,Ana,35,ES72209533922731448189,TRX_N-318-637779794970,2022-02-05T12:34:19,Amurrio,Housing,Rent,-1000.07,77683.09
buyer_3,Ana,35,ES72209533922731448189,TRX_N-319-380146969168,2022-02-06T12:55:00,Amurrio,Basic services,internet,-79.44,77603.65
buyer_3,Ana,35,ES72209533922731448189,TRX_N-32-585839965290,2020-04-01T23:28:19,Amurrio,transfer,Salary,2487.34,14355.97
buyer_3,Ana,35,ES72209533922731448189,TRX_N-320-64837884269,2022-02-06T11:37:37,Amurrio,Basic services,phone,-34.99,77568.66
buyer_3,Ana,35,ES72209533922731448189,TRX_N-321-533342187809,2022-02-07T12:23:33,Amurrio,Basic services,electricity,-68.23,77500.43
buyer_3,Ana,35,ES72209533922731448189,TRX_N-322-460792228767,2022-02-07T08:58:31,Amurrio,Basic services,gas,-32.36,77468.07
buyer_3,Ana,35,ES72209533922731448189,TRX_N-323-563037318670,2022-02-11T08:26:16,Amurrio,Expense,transport,-84.53,77383.54
buyer_3,Ana,35,ES72209533922731448189,TRX_N-324-297775972266,2022-03-01T08:01:16,Amurrio,transfer,Salary,2487.34,79870.88
buyer_3,Ana,35,ES72209533922731448189,TRX_N-325-104277911469,2022-03-01T08:01:16,Amurrio,transfer,Partner Salary,2399.93,82270.81
buyer_3,Ana,35,ES72209533922731448189,TRX_N-326-805086333137,2022-03-01T08:01:16,Amurrio,transfer,Extra Income,248.73,82519.54
buyer_3,Ana,35,ES72209533922731448189,TRX_N-327-372363185667,2022-03-05T10:13:32,Amurrio,Housing,Rent,-1000.07,81519.47
buyer_3,Ana,35,ES72209533922731448189,TRX_N-328-488607715939,2022-03-05T20:20:26,Amurrio,Basic services,gas,-19.43,81500.04
buyer_3,Ana,35,ES72209533922731448189,TRX_N-329-807871338127,2022-03-05T08:28:23,Amurrio,Basic services,internet,-44.37,81455.67
buyer_3,Ana,35,ES72209533922731448189,TRX_N-33-26102891014,2020-04-01T23:28:19,Amurrio,transfer,Partner Salary,2399.93,16755.9
buyer_3,Ana,35,ES72209533922731448189,TRX_N-330-146707061226,2022-03-06T09:52:00,Amurrio,Basic services,water,-58.92,81396.75
buyer_3,Ana,35,ES72209533922731448189,TRX_N-331-467862925754,2022-03-06T18:16:29,Amurrio,Basic services,phone,-49.21,81347.54
buyer_3,Ana,35,ES72209533922731448189,TRX_N-332-390720550319,2022-03-07T21:10:24,Amurrio,Basic services,internet,-39.68,81307.86
buyer_3,Ana,35,ES72209533922731448189,TRX_N-333-489477417532,2022-03-22T12:24:50,Amurrio,Expense,education,-985.68,80322.18
buyer_3,Ana,35,ES72209533922731448189,TRX_N-334-605471012135,2022-03-22T20:08:03,Amurrio,Expense,gifts,-498.44,79823.74
buyer_3,Ana,35,ES72209533922731448189,TRX_N-335-811327363897,2022-04-01T10:02:15,Amurrio,transfer,Salary,2487.34,82311.08
buyer_3,Ana,35,ES72209533922731448189,TRX_N-336-686165062281,2022-04-01T10:02:15,Amurrio,transfer,Partner Salary,2399.93,84711.01
buyer_3,Ana,35,ES72209533922731448189,TRX_N-337-174561905384,2022-04-05T14:12:32,Amurrio,Housing,Rent,-1000.07,83710.94
buyer_3,Ana,35,ES72209533922731448189,TRX_N-338-325109610939,2022-04-05T19:14:14,Amurrio,Basic services,water,-18.79,83692.15
buyer_3,Ana,35,ES72209533922731448189,TRX_N-339-63427375004,2022-04-05T08:53:50,Amurrio,Basic services,internet,-45.83,83646.32
buyer_3,Ana,35,ES72209533922731448189,TRX_N-34-748625790052,2020-04-05T19:00:27,Amurrio,Housing,Rent,-1000.07,15755.83
buyer_3,Ana,35,ES72209533922731448189,TRX_N-340-530995986098,2022-04-05T19:39:27,Amurrio,Basic services,phone,-48.62,83597.7
buyer_3,Ana,35,ES72209533922731448189,TRX_N-341-598926888400,2022-04-06T13:18:19,Amurrio,Basic services,electricity,-121.24,83476.46
buyer_3,Ana,35,ES72209533922731448189,TRX_N-342-797459446716,2022-04-07T08:18:09,Amurrio,Basic services,internet,-33.63,83442.83
buyer_3,Ana,35,ES72209533922731448189,TRX_N-343-263255686582,2022-04-07T05:40:13,Amurrio,Basic services,phone,-97.88,83344.95
buyer_3,Ana,35,ES72209533922731448189,TRX_N-344-752926601485,2022-04-22T14:22:18,Amurrio,Expense,food,-180.0,83164.95
buyer_3,Ana,35,ES72209533922731448189,TRX_N-345-728691601077,2022-04-27T11:36:09,Amurrio,Expense,repairs,-228.64,82936.31
buyer_3,Ana,35,ES72209533922731448189,TRX_N-346-323755577453,2022-04-28T15:17:56,Amurrio,Expense,transport,-24.06,82912.25
buyer_3,Ana,35,ES72209533922731448189,TRX_N-347-379685528486,2022-05-01T14:14:19,Amurrio,transfer,Salary,2487.34,85399.59
buyer_3,Ana,35,ES72209533922731448189,TRX_N-348-77796717998,2022-05-01T14:14:19,Amurrio,transfer,Partner Salary,2399.93,87799.52
buyer_3,Ana,35,ES72209533922731448189,TRX_N-349-160176196842,2022-05-05T14:37:08,Amurrio,Housing,Rent,-1000.07,86799.45
buyer_3,Ana,35,ES72209533922731448189,TRX_N-35-779234936457,2020-04-05T12:47:32,Amurrio,Basic services,water,-18.5,15737.33
buyer_3,Ana,35,ES72209533922731448189,TRX_N-350-325795262585,2022-05-05T14:42:50,Amurrio,Basic services,gas,-67.01,86732.44
buyer_3,Ana,35,ES72209533922731448189,TRX_N-351-900881999471,2022-05-05T16:12:14,Amurrio,Basic services,internet,-48.17,86684.27
buyer_3,Ana,35,ES72209533922731448189,TRX_N-352-211124734424,2022-05-05T18:47:55,Amurrio,Basic services,phone,-82.65,86601.62
buyer_3,Ana,35,ES72209533922731448189,TRX_N-353-783352738311,2022-05-05T09:33:22,Amurrio,Expense,transport,-180.3,86421.32
buyer_3,Ana,35,ES72209533922731448189,TRX_N-354-210450407719,2022-05-07T20:29:27,Amurrio,Basic services,water,-63.11,86358.21
buyer_3,Ana,35,ES72209533922731448189,TRX_N-355-408267403656,2022-05-09T18:36:10,Amurrio,Expense,healthcare,-144.7,86213.51
buyer_3,Ana,35,ES72209533922731448189,TRX_N-356-825033726045,2022-05-11T15:02:32,Amurrio,Expense,transport,-113.54,86099.97
buyer_3,Ana,35,ES72209533922731448189,TRX_N-357-507432147316,2022-06-01T18:09:16,Amurrio,transfer,Salary,2487.34,88587.31
buyer_3,Ana,35,ES72209533922731448189,TRX_N-358-618699598800,2022-06-01T18:09:16,Amurrio,transfer,Partner Salary,2399.93,90987.24
buyer_3,Ana,35,ES72209533922731448189,TRX_N-359-834346727483,2022-06-01T18:09:16,Amurrio,transfer,Extra Income,248.73,91235.97
buyer_3,Ana,35,ES72209533922731448189,TRX_N-36-164469131151,2020-04-06T11:31:13,Amurrio,Basic services,electricity,-74.77,15662.56
buyer_3,Ana,35,ES72209533922731448189,TRX_N-360-91885988569,2022-06-01T18:09:16,Amurrio,transfer,Bonus,2621.7,93857.67
buyer_3,Ana,35,ES72209533922731448189,TRX_N-361-679279632822,2022-06-05T13:15:12,Amurrio,Housing,Rent,-1000.07,92857.6
buyer_3,Ana,35,ES72209533922731448189,TRX_N-362-432949905977,2022-06-05T17:34:19,Amurrio,Basic services,water,-54.1,92803.5
buyer_3,Ana,35,ES72209533922731448189,TRX_N-363-757487312029,2022-06-05T13:18:18,Amurrio,Basic services,gas,-78.09,92725.41
buyer_3,Ana,35,ES72209533922731448189,TRX_N-364-619181883759,2022-06-07T16:56:43,Amurrio,Basic services,electricity,-92.82,92632.59
buyer_3,Ana,35,ES72209533922731448189,TRX_N-365-654705998032,2022-06-07T19:29:05,Amurrio,Expense,food,-155.77,92476.82
buyer_3,Ana,35,ES72209533922731448189,TRX_N-366-491122806283,2022-06-17T19:04:17,Amurrio,Expense,healthcare,-245.87,92230.95
buyer_3,Ana,35,ES72209533922731448189,TRX_N-367-592181681532,2022-06-21T08:13:00,Amurrio,Expense,transport,-119.79,92111.16
buyer_3,Ana,35,ES72209533922731448189,TRX_N-368-922416024450,2022-06-21T15:32:08,Amurrio,Expense,education,-700.46,91410.7
buyer_3,Ana,35,ES72209533922731448189,TRX_N-369-491818305901,2022-06-30T11:16:25,Amurrio,Expense,clothing,-225.6,91185.1
buyer_3,Ana,35,ES72209533922731448189,TRX_N-37-910131453311,2020-04-06T10:17:47,Amurrio,Basic services,gas,-35.12,15627.44
buyer_3,Ana,35,ES72209533922731448189,TRX_N-370-639821366548,2022-07-01T15:51:12,Amurrio,transfer,Salary,2487.34,93672.44
buyer_3,Ana,35,ES72209533922731448189,TRX_N-371-84034938723,2022-07-01T15:51:12,Amurrio,transfer,Partner Salary,2399.93,96072.37
buyer_3,Ana,35,ES72209533922731448189,TRX_N-372-164331492599,2022-07-05T12:43:25,Amurrio,Housing,Rent,-1000.07,95072.3
buyer_3,Ana,35,ES72209533922731448189,TRX_N-373-490775683509,2022-07-05T15:23:56,Amurrio,Basic services,internet,-60.59,95011.71
buyer_3,Ana,35,ES72209533922731448189,TRX_N-374-749252556342,2022-07-06T14:08:49,Amurrio,Basic services,gas,-69.71,94942.0
buyer_3,Ana,35,ES72209533922731448189,TRX_N-375-221615090218,2022-07-06T09:11:40,Amurrio,Basic services,phone,-77.39,94864.61
buyer_3,Ana,35,ES72209533922731448189,TRX_N-376-291212567881,2022-07-07T19:34:37,Amurrio,Basic services,gas,-65.37,94799.24
buyer_3,Ana,35,ES72209533922731448189,TRX_N-377-834794552451,2022-07-22T10:50:21,Amurrio,Expense,leisure,-240.7,94558.54
buyer_3,Ana,35,ES72209533922731448189,TRX_N-378-685006847504,2022-07-25T09:08:25,Amurrio,Expense,food,-600.04,93958.5
buyer_3,Ana,35,ES72209533922731448189,TRX_N-379-246951482263,2022-08-01T15:01:01,Amurrio,transfer,Salary,2487.34,96445.84
buyer_3,Ana,35,ES72209533922731448189,TRX_N-38-916036904544,2020-04-06T17:22:59,Amurrio,Basic services,internet,-70.9,15556.54
buyer_3,Ana,35,ES72209533922731448189,TRX_N-380-375043698250,2022-08-01T15:01:01,Amurrio,transfer,Partner Salary,2399.93,98845.77
buyer_3,Ana,35,ES72209533922731448189,TRX_N-381-104390537863,2022-08-01T15:01:01,Amurrio,transfer,Extra Income,248.73,99094.5
buyer_3,Ana,35,ES72209533922731448189,TRX_N-382-836718866273,2022-08-05T01:08:17,Amurrio,Housing,Rent,-1000.07,98094.43
buyer_3,Ana,35,ES72209533922731448189,TRX_N-383-377846557363,2022-08-05T19:35:52,Amurrio,Basic services,electricity,-58.31,98036.12
buyer_3,Ana,35,ES72209533922731448189,TRX_N-384-404057668905,2022-08-05T17:46:57,Amurrio,Basic services,gas,-29.11,98007.01
buyer_3,Ana,35,ES72209533922731448189,TRX_N-385-695738134829,2022-08-06T16:22:10,Amurrio,Basic services,water,-41.79,97965.22
buyer_3,Ana,35,ES72209533922731448189,TRX_N-386-679502644787,2022-08-06T10:41:47,Amurrio,Basic services,gas,-87.29,97877.93
buyer_3,Ana,35,ES72209533922731448189,TRX_N-387-898678104936,2022-08-06T20:04:01,Amurrio,Basic services,internet,-79.13,97798.8
buyer_3,Ana,35,ES72209533922731448189,TRX_N-388-21097080476,2022-08-06T21:13:39,Amurrio,Expense,clothing,-471.27,97327.53
buyer_3,Ana,35,ES72209533922731448189,TRX_N-389-412668270165,2022-08-07T06:15:06,Amurrio,Basic services,water,-27.43,97300.1
buyer_3,Ana,35,ES72209533922731448189,TRX_N-39-269935150935,2020-04-07T14:14:19,Amurrio,Basic services,water,-48.36,15508.18
buyer_3,Ana,35,ES72209533922731448189,TRX_N-390-651584750620,2022-08-16T05:40:53,Amurrio,Expense,leisure,-253.85,97046.25
buyer_3,Ana,35,ES72209533922731448189,TRX_N-391-714644590508,2022-08-22T13:06:33,Amurrio,Expense,transport,-86.96,96959.29
buyer_3,Ana,35,ES72209533922731448189,TRX_N-392-250868536261,2022-08-26T20:19:52,Amurrio,Expense,transport,-172.22,96787.07
buyer_3,Ana,35,ES72209533922731448189,TRX_N-393-966377691003,2022-09-01T20:38:07,Amurrio,transfer,Salary,2487.34,99274.41
buyer_3,Ana,35,ES72209533922731448189,TRX_N-394-77928326433,2022-09-01T20:38:07,Amurrio,transfer,Partner Salary,2399.93,101674.34
buyer_3,Ana,35,ES72209533922731448189,TRX_N-395-240676589735,2022-09-01T10:26:34,Amurrio,Expense,gifts,-188.9,101485.44
buyer_3,Ana,35,ES72209533922731448189,TRX_N-396-734727083667,2022-09-05T12:34:20,Amurrio,Housing,Rent,-1000.07,100485.37
buyer_3,Ana,35,ES72209533922731448189,TRX_N-397-279260702329,2022-09-05T06:05:55,Amurrio,Basic services,gas,-88.94,100396.43
buyer_3,Ana,35,ES72209533922731448189,TRX_N-398-95741355879,2022-09-05T18:01:13,Amurrio,Basic services,internet,-44.48,100351.95
buyer_3,Ana,35,ES72209533922731448189,TRX_N-399-833286085813,2022-09-06T15:26:56,Amurrio,Basic services,internet,-47.79,100304.16
buyer_3,Ana,35,ES72209533922731448189,TRX_N-4-577308271307,2020-01-05T14:15:18,Amurrio,Basic services,gas,-95.02,7580.93
buyer_3,Ana,35,ES72209533922731448189,TRX_N-40-371153304074,2020-04-07T18:11:50,Amurrio,Basic services,electricity,-34.54,15473.64
buyer_3,Ana,35,ES72209533922731448189,TRX_N-400-206490159755,2022-09-06T03:40:30,Amurrio,Basic services,phone,-65.18,100238.98
buyer_3,Ana,35,ES72209533922731448189,TRX_N-401-143256466650,2022-09-07T05:35:49,Amurrio,Basic services,internet,-42.67,100196.31
buyer_3,Ana,35,ES72209533922731448189,TRX_N-402-330897382992,2022-09-09T10:40:20,Amurrio,Expense,clothing,-360.83,99835.48
buyer_3,Ana,35,ES72209533922731448189,TRX_N-403-52869827461,2022-09-20T16:16:39,Vitoria-Gasteiz,Expense,education,-924.07,98911.41
buyer_3,Ana,35,ES72209533922731448189,TRX_N-404-434731994821,2022-09-26T15:58:37,Amurrio,Expense,food,-246.05,98665.36
buyer_3,Ana,35,ES72209533922731448189,TRX_N-405-855229115040,2022-09-26T15:59:48,Amurrio,Expense,transport,-75.42,98589.94
buyer_3,Ana,35,ES72209533922731448189,TRX_N-406-85380743692,2022-10-01T18:35:18,Amurrio,transfer,Salary,2487.34,101077.28
buyer_3,Ana,35,ES72209533922731448189,TRX_N-407-353999310357,2022-10-01T18:35:18,Amurrio,transfer,Partner Salary,2399.93,103477.21
buyer_3,Ana,35,ES72209533922731448189,TRX_N-408-572906990275,2022-10-05T20:23:16,Amurrio,Housing,Rent,-1000.07,102477.14
buyer_3,Ana,35,ES72209533922731448189,TRX_N-409-792442448549,2022-10-05T22:18:09,Amurrio,Basic services,water,-40.14,102437.0
buyer_3,Ana,35,ES72209533922731448189,TRX_N-41-640511726675,2020-04-07T19:14:23,Amurrio,Basic services,internet,-53.79,15419.85
buyer_3,Ana,35,ES72209533922731448189,TRX_N-410-80636378902,2022-10-05T04:44:36,Amurrio,Basic services,electricity,-129.76,102307.24
buyer_3,Ana,35,ES72209533922731448189,TRX_N-411-356256993928,2022-10-05T10:25:31,Amurrio,Basic services,gas,-84.23,102223.01
buyer_3,Ana,35,ES72209533922731448189,TRX_N-412-820268654333,2022-10-05T21:57:31,Amurrio,Basic services,internet,-79.27,102143.74
buyer_3,Ana,35,ES72209533922731448189,TRX_N-413-32406494709,2022-10-07T21:30:17,Amurrio,Basic services,electricity,-86.45,102057.29
buyer_3,Ana,35,ES72209533922731448189,TRX_N-414-440937770106,2022-10-07T22:09:15,Amurrio,Basic services,internet,-42.85,102014.44
buyer_3,Ana,35,ES72209533922731448189,TRX_N-415-875406886712,2022-10-07T15:58:04,Amurrio,Basic services,phone,-96.39,101918.05
buyer_3,Ana,35,ES72209533922731448189,TRX_N-416-51360327375,2022-10-18T08:04:31,Amurrio,Expense,leisure,-255.67,101662.38
buyer_3,Ana,35,ES72209533922731448189,TRX_N-417-263943292062,2022-10-22T20:51:33,Amurrio,Expense,food,-575.29,101087.09
buyer_3,Ana,35,ES72209533922731448189,TRX_N-418-239240059713,2022-11-01T14:31:19,Amurrio,transfer,Salary,2487.34,103574.43
buyer_3,Ana,35,ES72209533922731448189,TRX_N-419-249252300699,2022-11-01T14:31:19,Amurrio,transfer,Partner Salary,2399.93,105974.36
buyer_3,Ana,35,ES72209533922731448189,TRX_N-42-466786472870,2020-04-20T12:10:42,Amurrio,Expense,clothing,-97.07,15322.78
buyer_3,Ana,35,ES72209533922731448189,TRX_N-420-193693360415,2022-11-01T14:31:19,Amurrio,transfer,Extra Income,248.73,106223.09
buyer_3,Ana,35,ES72209533922731448189,TRX_N-421-491656470785,2022-11-04T21:00:30,Basauri,Expense,gifts,-29.47,106193.62
buyer_3,Ana,35,ES72209533922731448189,TRX_N-422-667447952554,2022-11-05T05:01:01,Amurrio,Housing,Rent,-1000.07,105193.55
buyer_3,Ana,35,ES72209533922731448189,TRX_N-423-389337260757,2022-11-05T09:56:27,Amurrio,Basic services,internet,-48.7,105144.85
buyer_3,Ana,35,ES72209533922731448189,TRX_N-424-814139943537,2022-11-05T13:24:25,Amurrio,Basic services,phone,-82.32,105062.53
buyer_3,Ana,35,ES72209533922731448189,TRX_N-425-543676253060,2022-11-06T02:49:17,Amurrio,Basic services,water,-39.67,105022.86
buyer_3,Ana,35,ES72209533922731448189,TRX_N-426-516669036895,2022-11-06T23:28:39,Amurrio,Basic services,electricity,-102.53,104920.33
buyer_3,Ana,35,ES72209533922731448189,TRX_N-427-464766736595,2022-11-06T11:21:46,Amurrio,Basic services,internet,-57.92,104862.41
buyer_3,Ana,35,ES72209533922731448189,TRX_N-428-721418170103,2022-11-07T19:04:05,Amurrio,Basic services,electricity,-117.69,104744.72
buyer_3,Ana,35,ES72209533922731448189,TRX_N-429-782735014130,2022-11-07T14:42:43,Amurrio,Expense,travel,-995.03,103749.69
buyer_3,Ana,35,ES72209533922731448189,TRX_N-43-54522349683,2020-04-22T19:55:26,Amurrio,Expense,food,-462.04,14860.74
buyer_3,Ana,35,ES72209533922731448189,TRX_N-430-600802607679,2022-12-01T18:59:48,Amurrio,transfer,Salary,2487.34,106237.03
buyer_3,Ana,35,ES72209533922731448189,TRX_N-431-505742127620,2022-12-01T18:59:48,Amurrio,transfer,Partner Salary,2399.93,108636.96
buyer_3,Ana,35,ES72209533922731448189,TRX_N-432-522467300576,2022-12-01T18:59:48,Amurrio,transfer,Bonus,2627.5,111264.46
buyer_3,Ana,35,ES72209533922731448189,TRX_N-433-874853325382,2022-12-05T12:30:59,Amurrio,Housing,Rent,-1000.07,110264.39
buyer_3,Ana,35,ES72209533922731448189,TRX_N-434-94141198014,2022-12-06T14:17:47,Amurrio,Basic services,water,-61.33,110203.06
buyer_3,Ana,35,ES72209533922731448189,TRX_N-435-844622285303,2022-12-06T04:03:23,Amurrio,Basic services,phone,-43.69,110159.37
buyer_3,Ana,35,ES72209533922731448189,TRX_N-436-71716198278,2022-12-07T19:47:06,Amurrio,Basic services,internet,-79.56,110079.81
buyer_3,Ana,35,ES72209533922731448189,TRX_N-437-366944993977,2022-12-07T13:33:29,Amurrio,Basic services,phone,-58.67,110021.14
buyer_3,Ana,35,ES72209533922731448189,TRX_N-438-778137101733,2022-12-07T17:52:30,Amurrio,Expense,leisure,-125.85,109895.29
buyer_3,Ana,35,ES72209533922731448189,TRX_N-439-444890398495,2022-12-11T04:09:08,Amurrio,Expense,leisure,-235.01,109660.28
buyer_3,Ana,35,ES72209533922731448189,TRX_N-44-669292240255,2020-04-27T09:12:08,Amurrio,Expense,food,-341.63,14519.11
buyer_3,Ana,35,ES72209533922731448189,TRX_N-440-311879948533,2022-12-21T00:07:41,Amurrio,Expense,food,-227.66,109432.62
buyer_3,Ana,35,ES72209533922731448189,TRX_N-441-565711061408,2022-12-27T10:55:49,Amurrio,Expense,healthcare,-60.59,109372.03
buyer_3,Ana,35,ES72209533922731448189,TRX_N-442-415628862333,2023-01-01T19:45:56,Amurrio,transfer,Salary,2487.34,111859.37
buyer_3,Ana,35,ES72209533922731448189,TRX_N-443-617657583549,2023-01-01T19:45:56,Amurrio,transfer,Partner Salary,2399.93,114259.3
buyer_3,Ana,35,ES72209533922731448189,TRX_N-444-66858302833,2023-01-05T12:02:36,Amurrio,Housing,Rent,-1000.07,113259.23
buyer_3,Ana,35,ES72209533922731448189,TRX_N-445-306977193314,2023-01-05T11:23:55,Amurrio,Basic services,water,-54.13,113205.1
buyer_3,Ana,35,ES72209533922731448189,TRX_N-446-515642929220,2023-01-06T20:08:36,Amurrio,Basic services,water,-70.96,113134.14
buyer_3,Ana,35,ES72209533922731448189,TRX_N-447-290185030923,2023-01-07T11:06:00,Amurrio,Basic services,gas,-32.37,113101.77
buyer_3,Ana,35,ES72209533922731448189,TRX_N-448-812656390505,2023-01-07T17:38:17,Amurrio,Basic services,phone,-24.47,113077.3
buyer_3,Ana,35,ES72209533922731448189,TRX_N-449-58538750170,2023-01-09T12:42:50,Amurrio,Expense,transport,-99.46,112977.84
buyer_3,Ana,35,ES72209533922731448189,TRX_N-45-319751160043,2020-05-01T22:17:04,Amurrio,transfer,Salary,2487.34,17006.45
buyer_3,Ana,35,ES72209533922731448189,TRX_N-450-928762819477,2023-01-16T11:55:13,Amurrio,Expense,transport,-88.57,112889.27
buyer_3,Ana,35,ES72209533922731448189,TRX_N-451-818334095055,2023-01-20T11:16:31,Amurrio,Expense,food,-322.61,112566.66
buyer_3,Ana,35,ES72209533922731448189,TRX_N-452-360014056279,2023-01-21T17:46:10,Errenteria,Expense,food,-629.67,111936.99
buyer_3,Ana,35,ES72209533922731448189,TRX_N-453-53302356376,2023-01-24T19:39:48,Amurrio,Expense,food,-328.48,111608.51
buyer_3,Ana,35,ES72209533922731448189,TRX_N-454-968277673701,2023-01-25T13:19:23,Amurrio,Expense,food,-505.6,111102.91
buyer_3,Ana,35,ES72209533922731448189,TRX_N-455-622408841006,2023-01-25T15:06:15,Basauri,Expense,healthcare,-217.14,110885.77
buyer_3,Ana,35,ES72209533922731448189,TRX_N-456-567199544137,2023-01-29T08:04:07,Portugalete,Expense,travel,-1710.95,109174.82
buyer_3,Ana,35,ES72209533922731448189,TRX_N-457-653525256562,2023-02-01T20:26:06,Amurrio,transfer,Salary,2487.34,111662.16
buyer_3,Ana,35,ES72209533922731448189,TRX_N-458-8658823749,2023-02-01T20:26:06,Amurrio,transfer,Partner Salary,2399.93,114062.09
buyer_3,Ana,35,ES72209533922731448189,TRX_N-459-426474681134,2023-02-01T20:26:06,Amurrio,transfer,Extra Income,248.73,114310.82
buyer_3,Ana,35,ES72209533922731448189,TRX_N-46-758944704722,2020-05-01T22:17:04,Amurrio,transfer,Partner Salary,2399.93,19406.38
buyer_3,Ana,35,ES72209533922731448189,TRX_N-460-967860699777,2023-02-02T21:32:54,Amurrio,Expense,gifts,-304.8,114006.02
buyer_3,Ana,35,ES72209533922731448189,TRX_N-461-689462269545,2023-02-05T23:28:22,Amurrio,Housing,Rent,-1000.07,113005.95
buyer_3,Ana,35,ES72209533922731448189,TRX_N-462-52423994958,2023-02-05T12:07:50,Amurrio,Basic services,water,-70.8,112935.15
buyer_3,Ana,35,ES72209533922731448189,TRX_N-463-294717948351,2023-02-05T09:29:42,Amurrio,Basic services,gas,-91.71,112843.44
buyer_3,Ana,35,ES72209533922731448189,TRX_N-464-421824126421,2023-02-06T08:04:39,Amurrio,Basic services,electricity,-98.68,112744.76
buyer_3,Ana,35,ES72209533922731448189,TRX_N-465-423509418675,2023-02-06T19:03:51,Amurrio,Basic services,gas,-78.93,112665.83
buyer_3,Ana,35,ES72209533922731448189,TRX_N-466-278213428074,2023-02-06T10:00:34,Amurrio,Basic services,internet,-36.46,112629.37
buyer_3,Ana,35,ES72209533922731448189,TRX_N-467-894924589334,2023-02-07T10:45:25,Amurrio,Expense,clothing,-203.32,112426.05
buyer_3,Ana,35,ES72209533922731448189,TRX_N-468-543248328074,2023-02-14T14:38:29,Amurrio,Expense,leisure,-195.61,112230.44
buyer_3,Ana,35,ES72209533922731448189,TRX_N-469-730273393996,2023-03-01T12:40:36,Amurrio,transfer,Salary,2487.34,114717.78
buyer_3,Ana,35,ES72209533922731448189,TRX_N-47-556926435463,2020-05-01T22:17:04,Amurrio,transfer,Extra Income,248.73,19655.11
buyer_3,Ana,35,ES72209533922731448189,TRX_N-470-338986894835,2023-03-01T12:40:36,Amurrio,transfer,Partner Salary,2399.93,117117.71
buyer_3,Ana,35,ES72209533922731448189,TRX_N-471-209050224285,2023-03-02T21:18:08,Amurrio,Expense,leisure,-103.39,117014.32
buyer_3,Ana,35,ES72209533922731448189,TRX_N-472-894166924498,2023-03-05T18:42:29,Amurrio,Housing,Rent,-1000.07,116014.25
buyer_3,Ana,35,ES72209533922731448189,TRX_N-473-647972249982,2023-03-05T11:53:05,Amurrio,Basic services,water,-42.03,115972.22
buyer_3,Ana,35,ES72209533922731448189,TRX_N-474-984113093347,2023-03-05T12:09:05,Amurrio,Basic services,internet,-51.34,115920.88
buyer_3,Ana,35,ES72209533922731448189,TRX_N-475-321700234254,2023-03-06T18:37:51,Amurrio,Basic services,internet,-42.11,115878.77
buyer_3,Ana,35,ES72209533922731448189,TRX_N-476-355016499959,2023-03-07T14:31:59,Amurrio,Basic services,internet,-47.29,115831.48
buyer_3,Ana,35,ES72209533922731448189,TRX_N-477-64485388511,2023-03-11T17:26:57,Sopela,Expense,transport,-102.06,115729.42
buyer_3,Ana,35,ES72209533922731448189,TRX_N-478-882088498360,2023-03-17T15:53:59,Amurrio,Expense,healthcare,-257.96,115471.46
buyer_3,Ana,35,ES72209533922731448189,TRX_N-479-567977799513,2023-03-24T17:41:11,Berango,Expense,appliances,-819.36,114652.1
buyer_3,Ana,35,ES72209533922731448189,TRX_N-48-87222363007,2020-05-05T17:15:19,Amurrio,Housing,Rent,-1000.07,18655.04
buyer_3,Ana,35,ES72209533922731448189,TRX_N-480-7301788956,2023-03-27T13:31:12,Amurrio,Expense,appliances,-1253.57,113398.53
buyer_3,Ana,35,ES72209533922731448189,TRX_N-481-796615661842,2023-03-29T10:02:23,Amurrio,Expense,food,-208.33,113190.2
buyer_3,Ana,35,ES72209533922731448189,TRX_N-482-657134373395,2023-04-01T15:58:58,Amurrio,transfer,Salary,2487.34,115677.54
buyer_3,Ana,35,ES72209533922731448189,TRX_N-483-792664533569,2023-04-01T15:58:58,Amurrio,transfer,Partner Salary,2399.93,118077.47
buyer_3,Ana,35,ES72209533922731448189,TRX_N-484-877390935989,2023-04-05T22:03:35,Amurrio,Housing,Rent,-1000.07,117077.4
buyer_3,Ana,35,ES72209533922731448189,TRX_N-485-837416872770,2023-04-05T14:46:09,Amurrio,Basic services,electricity,-146.35,116931.05
buyer_3,Ana,35,ES72209533922731448189,TRX_N-486-997379527543,2023-04-05T17:56:31,Amurrio,Basic services,phone,-44.69,116886.36
buyer_3,Ana,35,ES72209533922731448189,TRX_N-487-139085741445,2023-04-06T19:08:16,Amurrio,Basic services,water,-79.62,116806.74
buyer_3,Ana,35,ES72209533922731448189,TRX_N-488-894845330925,2023-04-06T15:59:47,Amurrio,Basic services,phone,-49.82,116756.92
buyer_3,Ana,35,ES72209533922731448189,TRX_N-489-27295108147,2023-04-07T10:40:28,Amurrio,Basic services,water,-17.02,116739.9
buyer_3,Ana,35,ES72209533922731448189,TRX_N-49-335139003869,2020-05-05T14:09:03,Amurrio,Basic services,electricity,-71.73,18583.31
buyer_3,Ana,35,ES72209533922731448189,TRX_N-490-998312441704,2023-04-07T06:00:48,Amurrio,Basic services,phone,-30.75,116709.15
buyer_3,Ana,35,ES72209533922731448189,TRX_N-491-534618572794,2023-04-11T21:01:39,Amurrio,Expense,transport,-123.35,116585.8
buyer_3,Ana,35,ES72209533922731448189,TRX_N-492-909595436777,2023-05-01T12:43:27,Amurrio,transfer,Salary,2487.34,119073.14
buyer_3,Ana,35,ES72209533922731448189,TRX_N-493-826276943088,2023-05-01T12:43:27,Amurrio,transfer,Partner Salary,2399.93,121473.07
buyer_3,Ana,35,ES72209533922731448189,TRX_N-494-111223773849,2023-05-01T12:43:27,Amurrio,transfer,Extra Income,248.73,121721.8
buyer_3,Ana,35,ES72209533922731448189,TRX_N-495-585415562659,2023-05-02T18:36:28,Amurrio,Expense,food,-783.47,120938.33
buyer_3,Ana,35,ES72209533922731448189,TRX_N-496-235401869830,2023-05-05T19:12:55,Amurrio,Housing,Rent,-1000.07,119938.26
buyer_3,Ana,35,ES72209533922731448189,TRX_N-497-24274367462,2023-05-05T21:49:11,Elciego,Expense,food,-450.65,119487.61
buyer_3,Ana,35,ES72209533922731448189,TRX_N-498-498531642993,2023-05-06T08:54:30,Amurrio,Basic services,water,-27.1,119460.51
buyer_3,Ana,35,ES72209533922731448189,TRX_N-499-46147802373,2023-05-07T02:52:55,Amurrio,Basic services,water,-34.03,119426.48
buyer_3,Ana,35,ES72209533922731448189,TRX_N-5-531343076122,2020-01-05T06:28:23,Amurrio,Basic services,phone,-60.3,7520.63
buyer_3,Ana,35,ES72209533922731448189,TRX_N-50-51321391759,2020-05-05T08:41:58,Amurrio,Basic services,gas,-20.18,18563.13
buyer_3,Ana,35,ES72209533922731448189,TRX_N-500-565781293189,2023-05-07T08:16:48,Amurrio,Basic services,phone,-51.98,119374.5
buyer_3,Ana,35,ES72209533922731448189,TRX_N-501-826813819375,2023-05-09T20:12:46,Amurrio,Expense,transport,-58.38,119316.12
buyer_3,Ana,35,ES72209533922731448189,TRX_N-502-734159308117,2023-05-30T16:44:44,Amurrio,Expense,repairs,-167.56,119148.56
buyer_3,Ana,35,ES72209533922731448189,TRX_N-503-333530500735,2023-06-01T10:44:23,Amurrio,transfer,Salary,2487.34,121635.9
buyer_3,Ana,35,ES72209533922731448189,TRX_N-504-465045803044,2023-06-01T10:44:23,Amurrio,transfer,Partner Salary,2399.93,124035.83
buyer_3,Ana,35,ES72209533922731448189,TRX_N-505-722468958130,2023-06-01T10:44:23,Amurrio,transfer,Bonus,2321.06,126356.89
buyer_3,Ana,35,ES72209533922731448189,TRX_N-506-516540902223,2023-06-01T20:25:30,Leioa,Expense,education,-495.0,125861.89
buyer_3,Ana,35,ES72209533922731448189,TRX_N-507-534434597648,2023-06-02T19:33:23,Amurrio,Expense,food,-747.47,125114.42
buyer_3,Ana,35,ES72209533922731448189,TRX_N-508-131253445345,2023-06-05T11:34:59,Amurrio,Housing,Rent,-1000.07,124114.35
buyer_3,Ana,35,ES72209533922731448189,TRX_N-509-343451140309,2023-06-05T10:16:39,Amurrio,Basic services,gas,-73.74,124040.61
buyer_3,Ana,35,ES72209533922731448189,TRX_N-51-288494404186,2020-05-05T15:11:18,Amurrio,Basic services,internet,-66.54,18496.59
buyer_3,Ana,35,ES72209533922731448189,TRX_N-510-895364272472,2023-06-06T08:17:30,Amurrio,Basic services,gas,-37.84,124002.77
buyer_3,Ana,35,ES72209533922731448189,TRX_N-511-320145045920,2023-06-06T20:00:17,Amurrio,Basic services,internet,-35.45,123967.32
buyer_3,Ana,35,ES72209533922731448189,TRX_N-512-854834081156,2023-06-06T19:10:00,Amurrio,Basic services,phone,-55.16,123912.16
buyer_3,Ana,35,ES72209533922731448189,TRX_N-513-125256162009,2023-06-07T19:40:30,Amurrio,Basic services,water,-76.01,123836.15
buyer_3,Ana,35,ES72209533922731448189,TRX_N-514-521830815144,2023-06-07T10:02:51,Amurrio,Basic services,gas,-55.55,123780.6
buyer_3,Ana,35,ES72209533922731448189,TRX_N-515-35200230460,2023-06-07T13:32:04,Amurrio,Basic services,internet,-42.85,123737.75
buyer_3,Ana,35,ES72209533922731448189,TRX_N-516-15857927197,2023-06-07T15:21:01,Amurrio,Basic services,phone,-40.77,123696.98
buyer_3,Ana,35,ES72209533922731448189,TRX_N-517-777884434568,2023-06-20T15:24:18,Amurrio,Expense,food,-543.81,123153.17
buyer_3,Ana,35,ES72209533922731448189,TRX_N-518-88012618785,2023-06-24T18:10:54,Amurrio,Expense,gifts,-358.26,122794.91
buyer_3,Ana,35,ES72209533922731448189,TRX_N-519-501583289388,2023-07-01T12:30:09,Amurrio,transfer,Salary,2487.34,125282.25
buyer_3,Ana,35,ES72209533922731448189,TRX_N-52-255849573115,2020-05-05T16:15:15,Amurrio,Basic services,phone,-77.52,18419.07
buyer_3,Ana,35,ES72209533922731448189,TRX_N-520-684933264791,2023-07-01T12:30:09,Amurrio,transfer,Partner Salary,2399.93,127682.18
buyer_3,Ana,35,ES72209533922731448189,TRX_N-521-811392188474,2023-07-01T12:30:09,Amurrio,transfer,Extra Income,248.73,127930.91
buyer_3,Ana,35,ES72209533922731448189,TRX_N-522-968969839573,2023-07-05T16:31:48,Amurrio,Housing,Rent,-1000.07,126930.84
buyer_3,Ana,35,ES72209533922731448189,TRX_N-523-72704984699,2023-07-05T15:38:00,Amurrio,Basic services,water,-49.47,126881.37
buyer_3,Ana,35,ES72209533922731448189,TRX_N-524-25553297921,2023-07-07T14:22:46,Amurrio,Basic services,electricity,-70.57,126810.8
buyer_3,Ana,35,ES72209533922731448189,TRX_N-525-232852827687,2023-07-07T10:51:06,Amurrio,Basic services,internet,-33.71,126777.09
buyer_3,Ana,35,ES72209533922731448189,TRX_N-526-470727298511,2023-07-07T12:37:27,Amurrio,Expense,food,-144.24,126632.85
buyer_3,Ana,35,ES72209533922731448189,TRX_N-527-96942398390,2023-07-18T20:31:56,Amurrio,Expense,clothing,-34.82,126598.03
buyer_3,Ana,35,ES72209533922731448189,TRX_N-528-814417405022,2023-07-23T10:04:56,Oyón-Oion,Expense,food,-599.69,125998.34
buyer_3,Ana,35,ES72209533922731448189,TRX_N-529-903966942745,2023-07-24T12:55:09,Amurrio,Expense,food,-315.14,125683.2
buyer_3,Ana,35,ES72209533922731448189,TRX_N-53-489828077814,2020-05-07T13:48:48,Amurrio,Basic services,internet,-42.85,18376.22
buyer_3,Ana,35,ES72209533922731448189,TRX_N-530-726479131104,2023-08-01T17:30:39,Amurrio,transfer,Salary,2487.34,128170.54
buyer_3,Ana,35,ES72209533922731448189,TRX_N-531-325280301370,2023-08-01T17:30:39,Amurrio,transfer,Partner Salary,2399.93,130570.47
buyer_3,Ana,35,ES72209533922731448189,TRX_N-532-299739246764,2023-08-05T20:25:12,Amurrio,Housing,Rent,-1000.07,129570.4
buyer_3,Ana,35,ES72209533922731448189,TRX_N-533-52573559814,2023-08-05T17:12:01,Amurrio,Basic services,internet,-76.36,129494.04
buyer_3,Ana,35,ES72209533922731448189,TRX_N-534-293937481238,2023-08-06T15:09:59,Amurrio,Basic services,water,-33.4,129460.64
buyer_3,Ana,35,ES72209533922731448189,TRX_N-535-366534831380,2023-08-07T15:55:01,Amurrio,Basic services,phone,-63.68,129396.96
buyer_3,Ana,35,ES72209533922731448189,TRX_N-536-446958032155,2023-08-14T12:51:42,Zarautz,Expense,food,-588.7,128808.26
buyer_3,Ana,35,ES72209533922731448189,TRX_N-537-707786349077,2023-08-15T17:20:46,Amurrio,Expense,food,-798.13,128010.13
buyer_3,Ana,35,ES72209533922731448189,TRX_N-538-602663819678,2023-08-19T08:34:06,Amurrio,Expense,leisure,-198.93,127811.2
buyer_3,Ana,35,ES72209533922731448189,TRX_N-539-884010347704,2023-08-24T19:21:23,Amurrio,Expense,leisure,-76.62,127734.58
buyer_3,Ana,35,ES72209533922731448189,TRX_N-54-202998594281,2020-05-14T13:13:22,Amurrio,Expense,transport,-188.89,18187.33
buyer_3,Ana,35,ES72209533922731448189,TRX_N-540-249219191490,2023-09-01T12:38:22,Amurrio,transfer,Salary,2487.34,130221.92
buyer_3,Ana,35,ES72209533922731448189,TRX_N-541-880335519115,2023-09-01T12:38:22,Amurrio,transfer,Partner Salary,2399.93,132621.85
buyer_3,Ana,35,ES72209533922731448189,TRX_N-542-912365686617,2023-09-01T12:38:22,Amurrio,transfer,Extra Income,248.73,132870.58
buyer_3,Ana,35,ES72209533922731448189,TRX_N-543-853530873811,2023-09-05T08:00:29,Amurrio,Housing,Rent,-1000.07,131870.51
buyer_3,Ana,35,ES72209533922731448189,TRX_N-544-363427312705,2023-09-05T10:34:30,Amurrio,Basic services,internet,-53.28,131817.23
buyer_3,Ana,35,ES72209533922731448189,TRX_N-545-285919044216,2023-09-05T11:26:17,Amurrio,Basic services,phone,-85.27,131731.96
buyer_3,Ana,35,ES72209533922731448189,TRX_N-546-800111479660,2023-09-11T13:11:03,Amurrio,Expense,food,-426.51,131305.45
buyer_3,Ana,35,ES72209533922731448189,TRX_N-547-163880702605,2023-09-12T21:17:24,Amurrio,Expense,clothing,-88.29,131217.16
buyer_3,Ana,35,ES72209533922731448189,TRX_N-548-615392567163,2023-09-21T14:33:02,Amurrio,Expense,food,-611.03,130606.13
buyer_3,Ana,35,ES72209533922731448189,TRX_N-549-468126250247,2023-10-01T11:35:33,Amurrio,transfer,Salary,2487.34,133093.47
buyer_3,Ana,35,ES72209533922731448189,TRX_N-55-87540276109,2020-05-15T16:31:45,Amurrio,Expense,gifts,-368.89,17818.44
buyer_3,Ana,35,ES72209533922731448189,TRX_N-550-48255835806,2023-10-01T11:35:33,Amurrio,transfer,Partner Salary,2399.93,135493.4
buyer_3,Ana,35,ES72209533922731448189,TRX_N-551-808882697148,2023-10-05T15:11:38,Amurrio,Housing,Rent,-1000.07,134493.33
buyer_3,Ana,35,ES72209533922731448189,TRX_N-552-100877919451,2023-10-05T17:08:47,Amurrio,Basic services,phone,-76.15,134417.18
buyer_3,Ana,35,ES72209533922731448189,TRX_N-553-51779676412,2023-10-06T04:57:53,Amurrio,Basic services,water,-73.85,134343.33
buyer_3,Ana,35,ES72209533922731448189,TRX_N-554-597401032991,2023-10-06T08:59:10,Amurrio,Basic services,gas,-80.5,134262.83
buyer_3,Ana,35,ES72209533922731448189,TRX_N-555-304768319394,2023-10-06T19:55:18,Amurrio,Basic services,internet,-46.36,134216.47
buyer_3,Ana,35,ES72209533922731448189,TRX_N-556-266850707427,2023-10-07T15:23:18,Amurrio,Basic services,water,-36.64,134179.83
buyer_3,Ana,35,ES72209533922731448189,TRX_N-557-105136010811,2023-10-07T18:24:54,Amurrio,Basic services,internet,-35.66,134144.17
buyer_3,Ana,35,ES72209533922731448189,TRX_N-558-202255656840,2023-10-07T17:48:18,Portugalete,Expense,gifts,-266.91,133877.26
buyer_3,Ana,35,ES72209533922731448189,TRX_N-559-838027917621,2023-10-28T12:30:26,Amurrio,Expense,transport,-61.54,133815.72
buyer_3,Ana,35,ES72209533922731448189,TRX_N-56-891246461295,2020-05-21T09:32:05,Amurrio,Expense,food,-767.39,17051.05
buyer_3,Ana,35,ES72209533922731448189,TRX_N-560-242996468878,2023-11-01T15:28:15,Amurrio,transfer,Salary,2487.34,136303.06
buyer_3,Ana,35,ES72209533922731448189,TRX_N-561-337591098340,2023-11-01T15:28:15,Amurrio,transfer,Partner Salary,2399.93,138702.99
buyer_3,Ana,35,ES72209533922731448189,TRX_N-562-383022569215,2023-11-01T15:28:15,Amurrio,transfer,Extra Income,248.73,138951.72
buyer_3,Ana,35,ES72209533922731448189,TRX_N-563-421828730027,2023-11-04T20:11:23,Amurrio,Expense,food,-105.6,138846.12
buyer_3,Ana,35,ES72209533922731448189,TRX_N-564-974969398997,2023-11-05T15:05:58,Amurrio,Housing,Rent,-1000.07,137846.05
buyer_3,Ana,35,ES72209533922731448189,TRX_N-565-472417745377,2023-11-05T14:33:09,Amurrio,Basic services,water,-13.46,137832.59
buyer_3,Ana,35,ES72209533922731448189,TRX_N-566-76556652583,2023-11-05T19:03:28,Amurrio,Basic services,internet,-37.0,137795.59
buyer_3,Ana,35,ES72209533922731448189,TRX_N-567-936938768619,2023-11-06T16:01:17,Amurrio,Basic services,gas,-95.28,137700.31
buyer_3,Ana,35,ES72209533922731448189,TRX_N-568-618196975745,2023-11-06T18:46:58,Amurrio,Basic services,phone,-95.88,137604.43
buyer_3,Ana,35,ES72209533922731448189,TRX_N-569-792640226536,2023-11-06T16:53:37,Leioa,Expense,transport,-194.83,137409.6
buyer_3,Ana,35,ES72209533922731448189,TRX_N-57-639063833275,2020-05-29T15:43:38,Erandio,Expense,clothing,-340.14,16710.91
buyer_3,Ana,35,ES72209533922731448189,TRX_N-570-187276038875,2023-11-19T14:35:40,Errenteria,Expense,transport,-96.34,137313.26
buyer_3,Ana,35,ES72209533922731448189,TRX_N-571-288942840038,2023-11-26T08:49:36,Amurrio,Expense,leisure,-19.49,137293.77
buyer_3,Ana,35,ES72209533922731448189,TRX_N-572-400677050870,2023-12-01T13:39:47,Amurrio,transfer,Salary,2487.34,139781.11
buyer_3,Ana,35,ES72209533922731448189,TRX_N-573-548814144509,2023-12-01T13:39:47,Amurrio,transfer,Partner Salary,2399.93,142181.04
buyer_3,Ana,35,ES72209533922731448189,TRX_N-574-884352921311,2023-12-01T13:39:47,Amurrio,transfer,Bonus,2243.9,144424.94
buyer_3,Ana,35,ES72209533922731448189,TRX_N-575-219443772692,2023-12-05T11:23:47,Amurrio,Housing,Rent,-1000.07,143424.87
buyer_3,Ana,35,ES72209533922731448189,TRX_N-576-285642564723,2023-12-05T22:00:44,Amurrio,Basic services,electricity,-99.33,143325.54
buyer_3,Ana,35,ES72209533922731448189,TRX_N-577-968202037057,2023-12-06T09:58:25,Amurrio,Basic services,electricity,-67.68,143257.86
buyer_3,Ana,35,ES72209533922731448189,TRX_N-578-728372129253,2023-12-06T18:11:15,Amurrio,Basic services,internet,-30.2,143227.66
buyer_3,Ana,35,ES72209533922731448189,TRX_N-579-469879581060,2023-12-06T16:51:55,Amurrio,Basic services,phone,-94.15,143133.51
buyer_3,Ana,35,ES72209533922731448189,TRX_N-58-152123975620,2020-06-01T18:28:56,Amurrio,transfer,Salary,2487.34,19198.25
buyer_3,Ana,35,ES72209533922731448189,TRX_N-580-480227719699,2023-12-07T10:07:52,Amurrio,Basic services,electricity,-67.68,143065.83
buyer_3,Ana,35,ES72209533922731448189,TRX_N-581-923094995681,2023-12-17T16:31:41,Amurrio,Expense,repairs,-974.4,142091.43
buyer_3,Ana,35,ES72209533922731448189,TRX_N-582-738427336849,2023-12-20T08:02:36,Amurrio,Expense,transport,-81.64,142009.79
buyer_3,Ana,35,ES72209533922731448189,TRX_N-583-579040135430,2023-12-27T19:03:07,Irun,Expense,transport,-20.32,141989.47
buyer_3,Ana,35,ES72209533922731448189,TRX_N-584-450780797486,2024-01-01T05:01:25,Amurrio,transfer,Salary,2487.34,144476.81
buyer_3,Ana,35,ES72209533922731448189,TRX_N-585-143733518770,2024-01-01T05:01:25,Amurrio,transfer,Partner Salary,2399.93,146876.74
buyer_3,Ana,35,ES72209533922731448189,TRX_N-586-434700959316,2024-01-01T23:31:23,Amurrio,Expense,travel,-2347.45,144529.29
buyer_3,Ana,35,ES72209533922731448189,TRX_N-587-247027076993,2024-01-05T11:08:50,Amurrio,Housing,Rent,-1000.07,143529.22
buyer_3,Ana,35,ES72209533922731448189,TRX_N-588-245145533206,2024-01-05T10:32:56,Amurrio,Basic services,internet,-66.3,143462.92
buyer_3,Ana,35,ES72209533922731448189,TRX_N-589-713795449345,2024-01-06T10:55:02,Amurrio,Basic services,water,-59.98,143402.94
buyer_3,Ana,35,ES72209533922731448189,TRX_N-59-841148113578,2020-06-01T18:28:56,Amurrio,transfer,Partner Salary,2399.93,21598.18
buyer_3,Ana,35,ES72209533922731448189,TRX_N-590-387398915034,2024-01-07T16:02:15,Amurrio,Basic services,water,-15.96,143386.98
buyer_3,Ana,35,ES72209533922731448189,TRX_N-591-369679518106,2024-01-07T21:04:32,Amurrio,Basic services,electricity,-33.03,143353.95
buyer_3,Ana,35,ES72209533922731448189,TRX_N-592-4758494404,2024-01-07T10:28:26,Amurrio,Basic services,phone,-52.16,143301.79
buyer_3,Ana,35,ES72209533922731448189,TRX_N-593-26954375333,2024-01-15T19:17:41,Amurrio,Expense,leisure,-82.32,143219.47
buyer_3,Ana,35,ES72209533922731448189,TRX_N-594-53076385721,2024-01-19T17:32:29,Errenteria,Expense,food,-540.14,142679.33
buyer_3,Ana,35,ES72209533922731448189,TRX_N-595-558428463636,2024-01-24T20:06:07,Amurrio,Expense,transport,-173.36,142505.97
buyer_3,Ana,35,ES72209533922731448189,TRX_N-596-553295633253,2024-01-25T17:14:21,Amurrio,Expense,appliances,-290.76,142215.21
buyer_3,Ana,35,ES72209533922731448189,TRX_N-597-336512350017,2024-01-31T11:32:53,Amurrio,Expense,clothing,-480.56,141734.65
buyer_3,Ana,35,ES72209533922731448189,TRX_N-598-858866602775,2024-01-31T21:42:28,Sestao,Expense,appliances,-1098.98,140635.67
buyer_3,Ana,35,ES72209533922731448189,TRX_N-599-76112967706,2024-02-01T09:42:19,Amurrio,transfer,Salary,2487.34,143123.01
buyer_3,Ana,35,ES72209533922731448189,TRX_N-6-684984363934,2020-01-07T16:32:26,Amurrio,Basic services,electricity,-142.77,7377.86
buyer_3,Ana,35,ES72209533922731448189,TRX_N-60-758209688253,2020-06-01T18:28:56,Amurrio,transfer,Bonus,2366.37,23964.55
buyer_3,Ana,35,ES72209533922731448189,TRX_N-600-44826883987,2024-02-01T09:42:19,Amurrio,transfer,Partner Salary,2399.93,145522.94
buyer_3,Ana,35,ES72209533922731448189,TRX_N-601-183976510845,2024-02-01T09:42:19,Amurrio,transfer,Extra Income,248.73,145771.67
buyer_3,Ana,35,ES72209533922731448189,TRX_N-602-351782648190,2024-02-01T12:32:38,Amurrio,Expense,leisure,-24.72,145746.95
buyer_3,Ana,35,ES72209533922731448189,TRX_N-603-763078794981,2024-02-05T11:00:45,Amurrio,Housing,Rent,-1000.07,144746.88
buyer_3,Ana,35,ES72209533922731448189,TRX_N-604-519412025159,2024-02-05T11:05:23,Amurrio,Basic services,electricity,-98.45,144648.43
buyer_3,Ana,35,ES72209533922731448189,TRX_N-605-460330942264,2024-02-05T21:49:57,Amurrio,Basic services,phone,-26.92,144621.51
buyer_3,Ana,35,ES72209533922731448189,TRX_N-606-263493890292,2024-02-05T09:12:51,Amurrio,Expense,transport,-197.19,144424.32
buyer_3,Ana,35,ES72209533922731448189,TRX_N-607-44202719918,2024-02-06T09:13:01,Amurrio,Basic services,internet,-70.4,144353.92
buyer_3,Ana,35,ES72209533922731448189,TRX_N-608-98297247828,2024-02-07T14:57:48,Amurrio,Basic services,internet,-35.16,144318.76
buyer_3,Ana,35,ES72209533922731448189,TRX_N-609-991783417692,2024-02-11T14:02:12,Amurrio,Expense,education,-267.18,144051.58
buyer_3,Ana,35,ES72209533922731448189,TRX_N-61-726867086263,2020-06-05T11:59:53,Amurrio,Housing,Rent,-1000.07,22964.48
buyer_3,Ana,35,ES72209533922731448189,TRX_N-610-194073900887,2024-02-13T16:36:14,Arrasate/Mondragon,Expense,leisure,-225.41,143826.17
buyer_3,Ana,35,ES72209533922731448189,TRX_N-611-907053551259,2024-02-14T19:16:17,Amurrio,Expense,transport,-77.83,143748.34
buyer_3,Ana,35,ES72209533922731448189,TRX_N-612-823009480652,2024-02-19T14:16:06,Amurrio,Expense,gifts,-284.26,143464.08
buyer_3,Ana,35,ES72209533922731448189,TRX_N-613-204058756826,2024-03-01T14:47:50,Amurrio,transfer,Salary,2487.34,145951.42
buyer_3,Ana,35,ES72209533922731448189,TRX_N-614-482525582840,2024-03-01T14:47:50,Amurrio,transfer,Partner Salary,2399.93,148351.35
buyer_3,Ana,35,ES72209533922731448189,TRX_N-615-454031886393,2024-03-05T22:51:48,Amurrio,Housing,Rent,-1000.07,147351.28
buyer_3,Ana,35,ES72209533922731448189,TRX_N-616-437143928039,2024-03-06T14:48:23,Amurrio,Basic services,water,-16.49,147334.79
buyer_3,Ana,35,ES72209533922731448189,TRX_N-617-779574317318,2024-03-06T17:00:28,Amurrio,Expense,food,-699.21,146635.58
buyer_3,Ana,35,ES72209533922731448189,TRX_N-618-999863428249,2024-03-07T05:44:40,Amurrio,Basic services,electricity,-104.98,146530.6
buyer_3,Ana,35,ES72209533922731448189,TRX_N-619-172909750052,2024-04-01T08:30:59,Amurrio,transfer,Salary,2487.34,149017.94
buyer_3,Ana,35,ES72209533922731448189,TRX_N-62-291957515957,2020-06-05T11:16:08,Amurrio,Basic services,water,-22.56,22941.92
buyer_3,Ana,35,ES72209533922731448189,TRX_N-620-609925525987,2024-04-01T08:30:59,Amurrio,transfer,Partner Salary,2399.93,151417.87
buyer_3,Ana,35,ES72209533922731448189,TRX_N-621-760802330443,2024-04-01T08:30:59,Amurrio,transfer,Extra Income,248.73,151666.6
buyer_3,Ana,35,ES72209533922731448189,TRX_N-622-247044061545,2024-04-01T06:32:22,Amurrio,Expense,leisure,-66.87,151599.73
buyer_3,Ana,35,ES72209533922731448189,TRX_N-623-47912089329,2024-04-05T09:34:31,Amurrio,Housing,Rent,-1000.07,150599.66
buyer_3,Ana,35,ES72209533922731448189,TRX_N-624-676410318278,2024-04-06T18:14:38,Amurrio,Basic services,gas,-42.07,150557.59
buyer_3,Ana,35,ES72209533922731448189,TRX_N-625-411604393134,2024-04-06T18:54:34,Amurrio,Basic services,internet,-52.24,150505.35
buyer_3,Ana,35,ES72209533922731448189,TRX_N-626-992626027489,2024-04-07T08:40:41,Amurrio,Basic services,water,-39.36,150465.99
buyer_3,Ana,35,ES72209533922731448189,TRX_N-627-918042656693,2024-04-07T16:37:29,Amurrio,Basic services,internet,-61.76,150404.23
buyer_3,Ana,35,ES72209533922731448189,TRX_N-628-405368314659,2024-04-11T14:35:22,Amurrio,Expense,food,-592.02,149812.21
buyer_3,Ana,35,ES72209533922731448189,TRX_N-629-793058214960,2024-04-12T14:28:23,Amurrio,Expense,food,-306.72,149505.49
buyer_3,Ana,35,ES72209533922731448189,TRX_N-63-582158504571,2020-06-05T14:18:30,Amurrio,Basic services,gas,-43.49,22898.43
buyer_3,Ana,35,ES72209533922731448189,TRX_N-630-815001275846,2024-04-14T17:48:22,Basauri,Expense,food,-238.18,149267.31
buyer_3,Ana,35,ES72209533922731448189,TRX_N-631-260332272885,2024-04-23T14:04:25,Amurrio,Expense,clothing,-341.9,148925.41
buyer_3,Ana,35,ES72209533922731448189,TRX_N-632-760795979088,2024-04-26T19:57:23,Zuia,Expense,repairs,-898.04,148027.37
buyer_3,Ana,35,ES72209533922731448189,TRX_N-633-918570780506,2024-04-30T16:40:54,Amurrio,Expense,leisure,-38.8,147988.57
buyer_3,Ana,35,ES72209533922731448189,TRX_N-634-940710887753,2024-05-01T17:14:08,Amurrio,transfer,Salary,2487.34,150475.91
buyer_3,Ana,35,ES72209533922731448189,TRX_N-635-98345304579,2024-05-01T17:14:08,Amurrio,transfer,Partner Salary,2399.93,152875.84
buyer_3,Ana,35,ES72209533922731448189,TRX_N-636-143414133266,2024-05-05T10:55:32,Amurrio,Housing,Rent,-1000.07,151875.77
buyer_3,Ana,35,ES72209533922731448189,TRX_N-637-688700908527,2024-05-05T16:25:37,Amurrio,Basic services,internet,-32.14,151843.63
buyer_3,Ana,35,ES72209533922731448189,TRX_N-638-535759744975,2024-05-06T13:23:28,Amurrio,Basic services,electricity,-82.88,151760.75
buyer_3,Ana,35,ES72209533922731448189,TRX_N-639-221713772512,2024-05-06T08:41:17,Amurrio,Basic services,gas,-27.04,151733.71
buyer_3,Ana,35,ES72209533922731448189,TRX_N-64-391544370700,2020-06-05T00:47:51,Amurrio,Basic services,internet,-69.71,22828.72
buyer_3,Ana,35,ES72209533922731448189,TRX_N-640-543665358312,2024-05-06T18:56:01,Amurrio,Basic services,internet,-35.74,151697.97
buyer_3,Ana,35,ES72209533922731448189,TRX_N-641-118725286676,2024-05-07T05:47:45,Amurrio,Basic services,water,-20.61,151677.36
buyer_3,Ana,35,ES72209533922731448189,TRX_N-642-930020617030,2024-05-07T10:00:22,Amurrio,Basic services,phone,-37.41,151639.95
buyer_3,Ana,35,ES72209533922731448189,TRX_N-643-470998347942,2024-06-01T12:37:51,Amurrio,transfer,Salary,2487.34,154127.29
buyer_3,Ana,35,ES72209533922731448189,TRX_N-644-386991290080,2024-06-01T12:37:51,Amurrio,transfer,Partner Salary,2399.93,156527.22
buyer_3,Ana,35,ES72209533922731448189,TRX_N-645-563196386293,2024-06-01T12:37:51,Amurrio,transfer,Extra Income,248.73,156775.95
buyer_3,Ana,35,ES72209533922731448189,TRX_N-646-774574049803,2024-06-01T12:37:51,Amurrio,transfer,Bonus,2655.92,159431.87
buyer_3,Ana,35,ES72209533922731448189,TRX_N-647-24020439013,2024-06-05T17:11:54,Amurrio,Housing,Rent,-1000.07,158431.8
buyer_3,Ana,35,ES72209533922731448189,TRX_N-648-258156665945,2024-06-05T09:28:19,Amurrio,Basic services,electricity,-113.83,158317.97
buyer_3,Ana,35,ES72209533922731448189,TRX_N-649-329084703545,2024-06-05T09:26:22,Amurrio,Basic services,phone,-62.63,158255.34
buyer_3,Ana,35,ES72209533922731448189,TRX_N-65-91813655161,2020-06-05T01:31:10,Amurrio,Expense,healthcare,-243.08,22585.64
buyer_3,Ana,35,ES72209533922731448189,TRX_N-650-445227606773,2024-06-06T13:01:26,Amurrio,Basic services,electricity,-111.84,158143.5
buyer_3,Ana,35,ES72209533922731448189,TRX_N-651-627861670571,2024-06-07T15:41:41,Amurrio,Basic services,internet,-53.21,158090.29
buyer_3,Ana,35,ES72209533922731448189,TRX_N-652-768587982687,2024-06-08T18:52:32,Amurrio,Expense,food,-798.93,157291.36
buyer_3,Ana,35,ES72209533922731448189,TRX_N-653-38175310823,2024-06-19T09:11:57,Amurrio,Expense,food,-258.34,157033.02
buyer_3,Ana,35,ES72209533922731448189,TRX_N-654-274231744043,2024-06-30T19:51:47,Amurrio,Expense,food,-142.17,156890.85
buyer_3,Ana,35,ES72209533922731448189,TRX_N-655-459432916732,2024-07-01T23:17:39,Amurrio,transfer,Salary,2487.34,159378.19
buyer_3,Ana,35,ES72209533922731448189,TRX_N-656-306452055358,2024-07-01T23:17:39,Amurrio,transfer,Partner Salary,2399.93,161778.12
buyer_3,Ana,35,ES72209533922731448189,TRX_N-657-676279984716,2024-07-05T08:00:13,Amurrio,Housing,Rent,-1000.07,160778.05
buyer_3,Ana,35,ES72209533922731448189,TRX_N-658-932254719878,2024-07-06T12:28:15,Amurrio,Basic services,gas,-27.41,160750.64
buyer_3,Ana,35,ES72209533922731448189,TRX_N-659-861134944481,2024-07-07T10:11:05,Amurrio,Basic services,gas,-96.41,160654.23
buyer_3,Ana,35,ES72209533922731448189,TRX_N-66-953430342696,2020-06-06T07:13:19,Amurrio,Basic services,water,-56.67,22528.97
buyer_3,Ana,35,ES72209533922731448189,TRX_N-660-597202655069,2024-07-07T16:16:19,Amurrio,Basic services,internet,-31.24,160622.99
buyer_3,Ana,35,ES72209533922731448189,TRX_N-661-409821423065,2024-07-07T16:23:02,Leioa,Expense,travel,-1928.33,158694.66
buyer_3,Ana,35,ES72209533922731448189,TRX_N-662-585838577363,2024-07-09T13:19:33,Irun,Expense,transport,-31.41,158663.25
buyer_3,Ana,35,ES72209533922731448189,TRX_N-663-977262415124,2024-07-10T16:43:19,Amurrio,Expense,food,-330.47,158332.78
buyer_3,Ana,35,ES72209533922731448189,TRX_N-664-989998657395,2024-07-20T15:56:10,Labastida/Bastida,Expense,food,-685.62,157647.16
buyer_3,Ana,35,ES72209533922731448189,TRX_N-665-696836601659,2024-08-01T13:37:58,Amurrio,transfer,Salary,2487.34,160134.5
buyer_3,Ana,35,ES72209533922731448189,TRX_N-666-516504413819,2024-08-01T13:37:58,Amurrio,transfer,Partner Salary,2399.93,162534.43
buyer_3,Ana,35,ES72209533922731448189,TRX_N-667-9694910783,2024-08-02T14:47:20,Amurrio,Expense,clothing,-253.71,162280.72
buyer_3,Ana,35,ES72209533922731448189,TRX_N-668-186062666034,2024-08-04T09:55:49,Amurrio,Expense,transport,-134.66,162146.06
buyer_3,Ana,35,ES72209533922731448189,TRX_N-669-962075721534,2024-08-05T16:41:20,Amurrio,Housing,Rent,-1000.07,161145.99
buyer_3,Ana,35,ES72209533922731448189,TRX_N-67-730413110015,2020-06-06T19:32:25,Amurrio,Basic services,gas,-35.73,22493.24
buyer_3,Ana,35,ES72209533922731448189,TRX_N-670-870617796135,2024-08-05T16:28:32,Amurrio,Basic services,water,-67.8,161078.19
buyer_3,Ana,35,ES72209533922731448189,TRX_N-671-402330999149,2024-08-05T18:18:24,Amurrio,Basic services,gas,-31.83,161046.36
buyer_3,Ana,35,ES72209533922731448189,TRX_N-672-282326837269,2024-08-05T05:36:58,Amurrio,Basic services,phone,-74.4,160971.96
buyer_3,Ana,35,ES72209533922731448189,TRX_N-673-207414829937,2024-08-06T09:59:30,Amurrio,Basic services,phone,-92.45,160879.51
buyer_3,Ana,35,ES72209533922731448189,TRX_N-674-619618653124,2024-08-07T23:24:47,Amurrio,Basic services,water,-71.71,160807.8
buyer_3,Ana,35,ES72209533922731448189,TRX_N-675-725222315085,2024-08-07T14:06:53,Amurrio,Expense,leisure,-242.53,160565.27
buyer_3,Ana,35,ES72209533922731448189,TRX_N-676-389827113135,2024-08-21T12:39:10,Sestao,Expense,travel,-2942.63,157622.64
buyer_3,Ana,35,ES72209533922731448189,TRX_N-677-195573986953,2024-08-28T21:18:52,Amurrio,Expense,clothing,-248.53,157374.11
buyer_3,Ana,35,ES72209533922731448189,TRX_N-678-355728115336,2024-08-31T19:49:54,Santurtzi,Expense,clothing,-462.99,156911.12
buyer_3,Ana,35,ES72209533922731448189,TRX_N-679-438506906666,2024-09-01T17:41:58,Amurrio,transfer,Salary,2487.34,159398.46
buyer_3,Ana,35,ES72209533922731448189,TRX_N-68-809891356892,2020-06-06T14:48:05,Amurrio,Expense,transport,-82.72,22410.52
buyer_3,Ana,35,ES72209533922731448189,TRX_N-680-146747800144,2024-09-01T17:41:58,Amurrio,transfer,Partner Salary,2399.93,161798.39
buyer_3,Ana,35,ES72209533922731448189,TRX_N-681-992903023226,2024-09-01T17:41:58,Amurrio,transfer,Extra Income,248.73,162047.12
buyer_3,Ana,35,ES72209533922731448189,TRX_N-682-168403005258,2024-09-05T14:57:17,Amurrio,Housing,Rent,-1000.07,161047.05
buyer_3,Ana,35,ES72209533922731448189,TRX_N-683-370170963712,2024-09-05T03:26:54,Amurrio,Basic services,phone,-44.9,161002.15
buyer_3,Ana,35,ES72209533922731448189,TRX_N-684-586449399724,2024-09-06T15:59:55,Amurrio,Basic services,gas,-72.5,160929.65
buyer_3,Ana,35,ES72209533922731448189,TRX_N-685-261823625574,2024-09-06T14:50:15,Amurrio,Basic services,phone,-38.37,160891.28
buyer_3,Ana,35,ES72209533922731448189,TRX_N-686-45953897925,2024-09-07T12:34:12,Amurrio,Basic services,electricity,-91.59,160799.69
buyer_3,Ana,35,ES72209533922731448189,TRX_N-687-401175210573,2024-09-07T10:05:10,Amurrio,Basic services,gas,-69.64,160730.05
buyer_3,Ana,35,ES72209533922731448189,TRX_N-688-721528304713,2024-09-13T16:51:31,Sopela,Expense,food,-192.98,160537.07
buyer_3,Ana,35,ES72209533922731448189,TRX_N-689-626026022856,2024-09-28T12:55:33,Amurrio,Expense,food,-225.11,160311.96
buyer_3,Ana,35,ES72209533922731448189,TRX_N-69-983087616127,2020-06-07T19:49:49,Amurrio,Basic services,electricity,-73.27,22337.25
buyer_3,Ana,35,ES72209533922731448189,TRX_N-690-541344009364,2024-10-01T09:27:02,Amurrio,transfer,Salary,2487.34,162799.3
buyer_3,Ana,35,ES72209533922731448189,TRX_N-691-584859222457,2024-10-01T09:27:02,Amurrio,transfer,Partner Salary,2399.93,165199.23
buyer_3,Ana,35,ES72209533922731448189,TRX_N-692-759478152262,2024-10-05T12:33:08,Amurrio,Housing,Rent,-1000.07,164199.16
buyer_3,Ana,35,ES72209533922731448189,TRX_N-693-899304404126,2024-10-06T16:47:17,Amurrio,Basic services,internet,-31.23,164167.93
buyer_3,Ana,35,ES72209533922731448189,TRX_N-694-561266228888,2024-10-06T00:40:17,Amurrio,Basic services,phone,-30.48,164137.45
buyer_3,Ana,35,ES72209533922731448189,TRX_N-695-923339218506,2024-10-07T12:00:21,Amurrio,Basic services,electricity,-120.96,164016.49
buyer_3,Ana,35,ES72209533922731448189,TRX_N-696-888560312951,2024-10-07T13:33:13,Amurrio,Basic services,internet,-31.31,163985.18
buyer_3,Ana,35,ES72209533922731448189,TRX_N-697-473056328159,2024-10-07T18:55:47,Amurrio,Basic services,phone,-44.31,163940.87
buyer_3,Ana,35,ES72209533922731448189,TRX_N-7-903412156679,2020-01-07T19:38:29,Amurrio,Basic services,phone,-45.87,7331.99
buyer_3,Ana,35,ES72209533922731448189,TRX_N-70-677252528833,2020-06-16T08:27:34,Amurrio,Expense,food,-743.49,21593.76
buyer_3,Ana,35,ES72209533922731448189,TRX_N-71-376415264262,2020-06-20T16:36:46,Amurrio,Expense,leisure,-35.38,21558.38
buyer_3,Ana,35,ES72209533922731448189,TRX_N-72-764936234564,2020-06-20T13:09:21,Amurrio,Expense,clothing,-270.87,21287.51
buyer_3,Ana,35,ES72209533922731448189,TRX_N-73-774466843498,2020-07-01T09:56:52,Amurrio,transfer,Salary,2487.34,23774.85
buyer_3,Ana,35,ES72209533922731448189,TRX_N-74-951433672265,2020-07-01T09:56:52,Amurrio,transfer,Partner Salary,2399.93,26174.78
buyer_3,Ana,35,ES72209533922731448189,TRX_N-75-803501903891,2020-07-05T08:24:40,Amurrio,Housing,Rent,-1000.07,25174.71
buyer_3,Ana,35,ES72209533922731448189,TRX_N-76-119120821593,2020-07-05T08:07:13,Amurrio,Basic services,gas,-70.49,25104.22
buyer_3,Ana,35,ES72209533922731448189,TRX_N-77-196621329224,2020-07-05T10:33:29,Amurrio,Basic services,internet,-48.09,25056.13
buyer_3,Ana,35,ES72209533922731448189,TRX_N-78-772876539088,2020-07-06T16:06:24,Amurrio,Basic services,water,-36.86,25019.27
buyer_3,Ana,35,ES72209533922731448189,TRX_N-79-427572786368,2020-07-07T20:36:59,Amurrio,Basic services,water,-64.17,24955.1
buyer_3,Ana,35,ES72209533922731448189,TRX_N-8-858003336667,2020-01-11T11:53:43,Amurrio,Expense,healthcare,-357.93,6974.06
buyer_3,Ana,35,ES72209533922731448189,TRX_N-80-773138129099,2020-07-07T09:19:25,Amurrio,Basic services,internet,-69.15,24885.95
buyer_3,Ana,35,ES72209533922731448189,TRX_N-81-576197913685,2020-07-07T15:44:06,Amurrio,Basic services,phone,-34.03,24851.92
buyer_3,Ana,35,ES72209533922731448189,TRX_N-82-242546861949,2020-07-23T17:50:09,Erandio,Expense,leisure,-10.63,24841.29
buyer_3,Ana,35,ES72209533922731448189,TRX_N-83-188715015744,2020-07-27T17:33:54,Amurrio,Expense,gifts,-430.74,24410.55
buyer_3,Ana,35,ES72209533922731448189,TRX_N-84-417607949859,2020-08-01T10:17:40,Amurrio,transfer,Salary,2487.34,26897.89
buyer_3,Ana,35,ES72209533922731448189,TRX_N-85-875071315381,2020-08-01T10:17:40,Amurrio,transfer,Partner Salary,2399.93,29297.82
buyer_3,Ana,35,ES72209533922731448189,TRX_N-86-188362547891,2020-08-01T10:17:40,Amurrio,transfer,Extra Income,248.73,29546.55
buyer_3,Ana,35,ES72209533922731448189,TRX_N-87-17202238974,2020-08-05T03:06:37,Amurrio,Housing,Rent,-1000.07,28546.48
buyer_3,Ana,35,ES72209533922731448189,TRX_N-88-61099107434,2020-08-05T07:23:25,Amurrio,Basic services,water,-49.23,28497.25
buyer_3,Ana,35,ES72209533922731448189,TRX_N-89-480290355738,2020-08-06T17:36:23,Amurrio,Basic services,water,-68.06,28429.19
buyer_3,Ana,35,ES72209533922731448189,TRX_N-9-889638792094,2020-01-16T11:05:26,Amurrio,Expense,clothing,-84.53,6889.53
buyer_3,Ana,35,ES72209533922731448189,TRX_N-90-508669893373,2020-08-06T18:32:55,Amurrio,Basic services,gas,-84.27,28344.92
buyer_3,Ana,35,ES72209533922731448189,TRX_N-91-651333110961,2020-08-07T08:30:30,Amurrio,Basic services,water,-54.58,28290.34
buyer_3,Ana,35,ES72209533922731448189,TRX_N-92-222898637098,2020-08-07T11:32:28,Amurrio,Basic services,electricity,-37.95,28252.39
buyer_3,Ana,35,ES72209533922731448189,TRX_N-93-954620022233,2020-08-07T16:06:07,Amurrio,Basic services,gas,-97.96,28154.43
buyer_3,Ana,35,ES72209533922731448189,TRX_N-94-991751682640,2020-08-07T22:42:11,Amurrio,Basic services,internet,-51.71,28102.72
buyer_3,Ana,35,ES72209533922731448189,TRX_N-95-177223749454,2020-08-08T22:23:03,Amurrio,Expense,leisure,-90.94,28011.78
buyer_3,Ana,35,ES72209533922731448189,TRX_N-96-176976528649,2020-08-09T20:57:58,Amurrio,Expense,transport,-47.07,27964.71
buyer_3,Ana,35,ES72209533922731448189,TRX_N-97-203365655799,2020-09-01T13:53:14,Amurrio,transfer,Salary,2487.34,30452.05
buyer_3,Ana,35,ES72209533922731448189,TRX_N-98-852938131491,2020-09-01T13:53:14,Amurrio,transfer,Partner Salary,2399.93,32851.98
buyer_3,Ana,35,ES72209533922731448189,TRX_N-99-956895609320,2020-09-02T12:29:21,Getxo,Expense,leisure,-97.42,32754.56
buyer_4,Jorge,50,ES96209591234020518195,TRX_N-1-902699092714,2020-01-01T09:50:56,Galdakao,transfer,Salary,2713.55,6761.25
buyer_4,Jorge,50,ES96209591234020518195,TRX_N-10-981676577793,2020-01-07T18:51:58,Galdakao,Basic services,phone,-84.69,7957.32
buyer_4,Jorge,50,ES96209591234020518195,TRX_N-100-119189275028,2020-10-01T20:10:45,Galdakao,transfer,Partner Salary,2734.53,46509.54
buyer_4,Jorge,50,ES96209591234020518195,TRX_N-101-999244871038,2020-10-03T16:30:18,Galdakao,Expense,food,-273.93,46235.61
buyer_4,Jorge,50,ES96209591234020518195,TRX_N-102-379637145734,2020-10-04T02:11:44,Galdakao,Expense,food,-546.16,45689.45
buyer_4,Jorge,50,ES96209591234020518195,TRX_N-103-248668320933,2020-10-05T19:13:00,Galdakao,Housing,Mortgage,-648.39,45041.06
buyer_4,Jorge,50,ES96209591234020518195,TRX_N-104-704393546297,2020-10-05T12:52:44,Galdakao,Basic services,water,-61.69,44979.37
buyer_4,Jorge,50,ES96209591234020518195,TRX_N-105-385198165528,2020-10-05T12:16:21,Galdakao,Basic services,electricity,-76.69,44902.68
buyer_4,Jorge,50,ES96209591234020518195,TRX_N-106-988486170638,2020-10-05T21:22:19,Galdakao,Basic services,gas,-45.07,44857.61
buyer_4,Jorge,50,ES96209591234020518195,TRX_N-107-77968891241,2020-10-06T12:31:18,Galdakao,Expense,healthcare,-23.51,44834.1
buyer_4,Jorge,50,ES96209591234020518195,TRX_N-108-826365482667,2020-10-07T14:24:20,Galdakao,Basic services,water,-17.87,44816.23
buyer_4,Jorge,50,ES96209591234020518195,TRX_N-109-193432630657,2020-10-27T22:07:03,Galdakao,Expense,transport,-101.29,44714.94
buyer_4,Jorge,50,ES96209591234020518195,TRX_N-11-903799353429,2020-01-12T16:26:38,Galdakao,Expense,gifts,-281.34,7675.98
buyer_4,Jorge,50,ES96209591234020518195,TRX_N-110-110143434757,2020-11-01T20:47:28,Galdakao,transfer,Salary,2713.55,47428.49
buyer_4,Jorge,50,ES96209591234020518195,TRX_N-111-897122164076,2020-11-01T20:47:28,Galdakao,transfer,Partner Salary,2734.53,50163.02
buyer_4,Jorge,50,ES96209591234020518195,TRX_N-112-679215042764,2020-11-01T20:47:28,Galdakao,transfer,Extra Income,271.36,50434.38
buyer_4,Jorge,50,ES96209591234020518195,TRX_N-113-401735711515,2020-11-02T21:18:42,Galdakao,Expense,clothing,-348.42,50085.96
buyer_4,Jorge,50,ES96209591234020518195,TRX_N-114-658309914613,2020-11-05T08:16:23,Galdakao,Housing,Mortgage,-648.39,49437.57
buyer_4,Jorge,50,ES96209591234020518195,TRX_N-115-189423036144,2020-11-05T03:56:53,Galdakao,Basic services,gas,-76.5,49361.07
buyer_4,Jorge,50,ES96209591234020518195,TRX_N-116-144944682032,2020-11-07T04:26:23,Galdakao,Basic services,water,-42.04,49319.03
buyer_4,Jorge,50,ES96209591234020518195,TRX_N-117-663413633144,2020-11-07T17:06:15,Galdakao,Basic services,internet,-44.9,49274.13
buyer_4,Jorge,50,ES96209591234020518195,TRX_N-118-587750817198,2020-11-07T11:11:04,Galdakao,Basic services,phone,-92.56,49181.57
buyer_4,Jorge,50,ES96209591234020518195,TRX_N-119-104638183751,2020-11-15T13:28:07,Lasarte-Oria,Expense,food,-347.09,48834.48
buyer_4,Jorge,50,ES96209591234020518195,TRX_N-12-788866192461,2020-01-14T17:26:58,Galdakao,Expense,transport,-78.09,7597.89
buyer_4,Jorge,50,ES96209591234020518195,TRX_N-120-874143132474,2020-11-24T14:29:17,Galdakao,Expense,healthcare,-384.73,48449.75
buyer_4,Jorge,50,ES96209591234020518195,TRX_N-121-622996503026,2020-12-01T09:20:02,Galdakao,transfer,Salary,2713.55,51163.3
buyer_4,Jorge,50,ES96209591234020518195,TRX_N-122-118400400383,2020-12-01T09:20:02,Galdakao,transfer,Partner Salary,2734.53,53897.83
buyer_4,Jorge,50,ES96209591234020518195,TRX_N-123-480407275672,2020-12-01T09:20:02,Galdakao,transfer,Bonus,2598.94,56496.77
buyer_4,Jorge,50,ES96209591234020518195,TRX_N-124-615747511185,2020-12-05T15:14:39,Galdakao,Housing,Mortgage,-648.39,55848.38
buyer_4,Jorge,50,ES96209591234020518195,TRX_N-125-770447017132,2020-12-05T20:19:21,Galdakao,Basic services,water,-48.38,55800.0
buyer_4,Jorge,50,ES96209591234020518195,TRX_N-126-698863291854,2020-12-05T00:42:04,Galdakao,Basic services,electricity,-88.01,55711.99
buyer_4,Jorge,50,ES96209591234020518195,TRX_N-127-47020947991,2020-12-05T17:14:18,Galdakao,Basic services,phone,-44.62,55667.37
buyer_4,Jorge,50,ES96209591234020518195,TRX_N-128-671910703871,2020-12-06T08:31:13,Galdakao,Basic services,electricity,-64.39,55602.98
buyer_4,Jorge,50,ES96209591234020518195,TRX_N-129-502617276432,2020-12-06T14:03:24,Galdakao,Basic services,internet,-60.7,55542.28
buyer_4,Jorge,50,ES96209591234020518195,TRX_N-13-557201045193,2020-01-15T19:49:44,Getxo,Expense,leisure,-138.27,7459.62
buyer_4,Jorge,50,ES96209591234020518195,TRX_N-130-527628715200,2020-12-07T01:11:17,Galdakao,Basic services,water,-65.32,55476.96
buyer_4,Jorge,50,ES96209591234020518195,TRX_N-131-538254824291,2020-12-07T09:19:34,Galdakao,Basic services,gas,-88.7,55388.26
buyer_4,Jorge,50,ES96209591234020518195,TRX_N-132-975218921944,2020-12-17T08:38:29,Galdakao,Expense,leisure,-68.08,55320.18
buyer_4,Jorge,50,ES96209591234020518195,TRX_N-133-621678597902,2021-01-01T13:26:17,Galdakao,transfer,Salary,2713.55,58033.73
buyer_4,Jorge,50,ES96209591234020518195,TRX_N-134-626028488346,2021-01-01T13:26:17,Galdakao,transfer,Partner Salary,2734.53,60768.26
buyer_4,Jorge,50,ES96209591234020518195,TRX_N-135-649575122976,2021-01-01T13:26:17,Galdakao,transfer,Extra Income,271.36,61039.62
buyer_4,Jorge,50,ES96209591234020518195,TRX_N-136-571722698192,2021-01-01T10:58:53,Galdakao,Expense,leisure,-169.96,60869.66
buyer_4,Jorge,50,ES96209591234020518195,TRX_N-137-151530617553,2021-01-05T23:27:35,Galdakao,Housing,Mortgage,-648.39,60221.27
buyer_4,Jorge,50,ES96209591234020518195,TRX_N-138-866453254996,2021-01-05T12:38:03,Galdakao,Basic services,internet,-72.71,60148.56
buyer_4,Jorge,50,ES96209591234020518195,TRX_N-139-13702059553,2021-01-07T13:21:53,Galdakao,Basic services,internet,-60.8,60087.76
buyer_4,Jorge,50,ES96209591234020518195,TRX_N-14-402873121681,2020-01-23T09:40:14,Hernani,Expense,clothing,-453.25,7006.37
buyer_4,Jorge,50,ES96209591234020518195,TRX_N-140-488422763330,2021-01-07T18:25:28,Galdakao,Expense,transport,-24.16,60063.6
buyer_4,Jorge,50,ES96209591234020518195,TRX_N-141-202277773033,2021-01-08T19:19:24,Galdakao,Expense,leisure,-297.52,59766.08
buyer_4,Jorge,50,ES96209591234020518195,TRX_N-142-32082863979,2021-01-11T12:46:08,Galdakao,Expense,transport,-184.49,59581.59
buyer_4,Jorge,50,ES96209591234020518195,TRX_N-143-889445722155,2021-01-24T09:04:04,Galdakao,Expense,repairs,-197.99,59383.6
buyer_4,Jorge,50,ES96209591234020518195,TRX_N-144-847715265132,2021-01-29T12:46:55,Galdakao,Expense,gifts,-304.37,59079.23
buyer_4,Jorge,50,ES96209591234020518195,TRX_N-145-820083546782,2021-02-01T00:15:12,Galdakao,transfer,Salary,2713.55,61792.78
buyer_4,Jorge,50,ES96209591234020518195,TRX_N-146-465903634048,2021-02-01T00:15:12,Galdakao,transfer,Partner Salary,2734.53,64527.31
buyer_4,Jorge,50,ES96209591234020518195,TRX_N-147-389142907871,2021-02-05T13:39:46,Galdakao,Housing,Mortgage,-648.39,63878.92
buyer_4,Jorge,50,ES96209591234020518195,TRX_N-148-508330623792,2021-02-05T22:53:08,Galdakao,Basic services,water,-44.01,63834.91
buyer_4,Jorge,50,ES96209591234020518195,TRX_N-149-522605548246,2021-02-05T22:19:56,Galdakao,Basic services,electricity,-43.8,63791.11
buyer_4,Jorge,50,ES96209591234020518195,TRX_N-15-554355320605,2020-02-01T19:51:46,Galdakao,transfer,Salary,2713.55,9719.92
buyer_4,Jorge,50,ES96209591234020518195,TRX_N-150-777321208266,2021-02-06T22:26:02,Galdakao,Basic services,water,-14.73,63776.38
buyer_4,Jorge,50,ES96209591234020518195,TRX_N-151-807842396471,2021-02-06T12:13:10,Galdakao,Basic services,gas,-52.44,63723.94
buyer_4,Jorge,50,ES96209591234020518195,TRX_N-152-264784964757,2021-02-10T18:22:48,Lasarte-Oria,Expense,food,-691.8,63032.14
buyer_4,Jorge,50,ES96209591234020518195,TRX_N-153-959691836337,2021-02-10T18:37:34,Galdakao,Expense,healthcare,-341.95,62690.19
buyer_4,Jorge,50,ES96209591234020518195,TRX_N-154-697706159601,2021-03-01T22:09:12,Galdakao,transfer,Salary,2713.55,65403.74
buyer_4,Jorge,50,ES96209591234020518195,TRX_N-155-989222662279,2021-03-01T22:09:12,Galdakao,transfer,Partner Salary,2734.53,68138.27
buyer_4,Jorge,50,ES96209591234020518195,TRX_N-156-156540881829,2021-03-01T12:48:16,Galdakao,Expense,transport,-107.39,68030.88
buyer_4,Jorge,50,ES96209591234020518195,TRX_N-157-808627123507,2021-03-02T23:31:37,Erandio,Expense,healthcare,-119.72,67911.16
buyer_4,Jorge,50,ES96209591234020518195,TRX_N-158-574764371571,2021-03-05T20:18:19,Galdakao,Housing,Mortgage,-648.39,67262.77
buyer_4,Jorge,50,ES96209591234020518195,TRX_N-159-149595794560,2021-03-05T20:44:57,Galdakao,Basic services,water,-66.26,67196.51
buyer_4,Jorge,50,ES96209591234020518195,TRX_N-16-366892925581,2020-02-01T19:51:46,Galdakao,transfer,Partner Salary,2734.53,12454.45
buyer_4,Jorge,50,ES96209591234020518195,TRX_N-160-169168900258,2021-03-06T18:06:28,Galdakao,Basic services,electricity,-42.06,67154.45
buyer_4,Jorge,50,ES96209591234020518195,TRX_N-161-824715577814,2021-03-06T18:41:13,Galdakao,Basic services,internet,-51.64,67102.81
buyer_4,Jorge,50,ES96209591234020518195,TRX_N-162-273788473081,2021-03-07T13:00:32,Galdakao,Basic services,water,-78.15,67024.66
buyer_4,Jorge,50,ES96209591234020518195,TRX_N-163-760580313560,2021-03-17T17:01:50,Eibar,Expense,food,-750.65,66274.01
buyer_4,Jorge,50,ES96209591234020518195,TRX_N-164-748452371847,2021-03-31T19:04:02,Galdakao,Expense,healthcare,-215.19,66058.82
buyer_4,Jorge,50,ES96209591234020518195,TRX_N-165-935828901856,2021-04-01T20:13:12,Galdakao,transfer,Salary,2713.55,68772.37
buyer_4,Jorge,50,ES96209591234020518195,TRX_N-166-213966516922,2021-04-01T20:13:12,Galdakao,transfer,Partner Salary,2734.53,71506.9
buyer_4,Jorge,50,ES96209591234020518195,TRX_N-167-746395748389,2021-04-01T20:13:12,Galdakao,transfer,Extra Income,271.36,71778.26
buyer_4,Jorge,50,ES96209591234020518195,TRX_N-168-78738548930,2021-04-05T12:35:44,Galdakao,Housing,Mortgage,-648.39,71129.87
buyer_4,Jorge,50,ES96209591234020518195,TRX_N-169-128594242610,2021-04-06T09:22:10,Galdakao,Basic services,electricity,-96.6,71033.27
buyer_4,Jorge,50,ES96209591234020518195,TRX_N-17-202777575482,2020-02-05T15:08:08,Galdakao,Housing,Mortgage,-648.39,11806.06
buyer_4,Jorge,50,ES96209591234020518195,TRX_N-170-935015347729,2021-04-07T14:43:51,Galdakao,Basic services,gas,-45.48,70987.79
buyer_4,Jorge,50,ES96209591234020518195,TRX_N-171-691634687069,2021-04-07T12:32:14,Galdakao,Basic services,internet,-59.82,70927.97
buyer_4,Jorge,50,ES96209591234020518195,TRX_N-172-800359229871,2021-04-17T08:18:48,Galdakao,Expense,healthcare,-190.73,70737.24
buyer_4,Jorge,50,ES96209591234020518195,TRX_N-173-994396008309,2021-04-18T10:03:00,Galdakao,Expense,repairs,-463.71,70273.53
buyer_4,Jorge,50,ES96209591234020518195,TRX_N-174-927978491383,2021-04-26T21:13:38,Galdakao,Expense,gifts,-445.74,69827.79
buyer_4,Jorge,50,ES96209591234020518195,TRX_N-175-89043604603,2021-04-27T04:06:24,Galdakao,Expense,healthcare,-171.77,69656.02
buyer_4,Jorge,50,ES96209591234020518195,TRX_N-176-843481667421,2021-05-01T13:02:48,Galdakao,transfer,Salary,2713.55,72369.57
buyer_4,Jorge,50,ES96209591234020518195,TRX_N-177-738477735217,2021-05-01T13:02:48,Galdakao,transfer,Partner Salary,2734.53,75104.1
buyer_4,Jorge,50,ES96209591234020518195,TRX_N-178-868374245102,2021-05-02T22:21:25,Galdakao,Expense,food,-567.27,74536.83
buyer_4,Jorge,50,ES96209591234020518195,TRX_N-179-697896253484,2021-05-05T16:50:51,Galdakao,Housing,Mortgage,-648.39,73888.44
buyer_4,Jorge,50,ES96209591234020518195,TRX_N-18-375446324791,2020-02-05T18:34:53,Galdakao,Basic services,water,-60.92,11745.14
buyer_4,Jorge,50,ES96209591234020518195,TRX_N-180-763073552585,2021-05-05T09:01:19,Galdakao,Basic services,water,-13.67,73874.77
buyer_4,Jorge,50,ES96209591234020518195,TRX_N-181-945615155718,2021-05-06T12:40:21,Galdakao,Basic services,gas,-63.91,73810.86
buyer_4,Jorge,50,ES96209591234020518195,TRX_N-182-672111220453,2021-05-07T18:06:08,Galdakao,Basic services,gas,-87.43,73723.43
buyer_4,Jorge,50,ES96209591234020518195,TRX_N-183-746090229032,2021-05-07T09:06:02,Galdakao,Basic services,internet,-45.14,73678.29
buyer_4,Jorge,50,ES96209591234020518195,TRX_N-184-779813879140,2021-05-19T21:26:46,Galdakao,Expense,food,-692.05,72986.24
buyer_4,Jorge,50,ES96209591234020518195,TRX_N-185-971731846671,2021-05-29T18:08:35,Galdakao,Expense,transport,-141.21,72845.03
buyer_4,Jorge,50,ES96209591234020518195,TRX_N-186-745424918992,2021-06-01T12:42:21,Galdakao,transfer,Salary,2713.55,75558.58
buyer_4,Jorge,50,ES96209591234020518195,TRX_N-187-499942848959,2021-06-01T12:42:21,Galdakao,transfer,Partner Salary,2734.53,78293.11
buyer_4,Jorge,50,ES96209591234020518195,TRX_N-188-708036978718,2021-06-01T12:42:21,Galdakao,transfer,Bonus,2538.28,80831.39
buyer_4,Jorge,50,ES96209591234020518195,TRX_N-189-639094310367,2021-06-05T15:06:38,Galdakao,Housing,Mortgage,-648.39,80183.0
buyer_4,Jorge,50,ES96209591234020518195,TRX_N-19-663710369103,2020-02-06T12:14:18,Galdakao,Basic services,electricity,-142.77,11602.37
buyer_4,Jorge,50,ES96209591234020518195,TRX_N-190-725230153645,2021-06-05T19:20:19,Galdakao,Basic services,internet,-35.51,80147.49
buyer_4,Jorge,50,ES96209591234020518195,TRX_N-191-422678148466,2021-06-06T19:23:48,Galdakao,Basic services,internet,-67.8,80079.69
buyer_4,Jorge,50,ES96209591234020518195,TRX_N-192-564306998643,2021-06-06T12:33:06,Galdakao,Expense,transport,-61.97,80017.72
buyer_4,Jorge,50,ES96209591234020518195,TRX_N-193-86690846184,2021-06-06T13:19:19,Galdakao,Expense,healthcare,-264.08,79753.64
buyer_4,Jorge,50,ES96209591234020518195,TRX_N-194-374084294366,2021-06-07T15:08:45,Galdakao,Basic services,electricity,-75.68,79677.96
buyer_4,Jorge,50,ES96209591234020518195,TRX_N-195-676976648637,2021-06-07T09:35:29,Galdakao,Basic services,gas,-77.25,79600.71
buyer_4,Jorge,50,ES96209591234020518195,TRX_N-196-65155848413,2021-06-12T23:56:32,Galdakao,Expense,healthcare,-292.34,79308.37
buyer_4,Jorge,50,ES96209591234020518195,TRX_N-197-273402823907,2021-06-16T18:34:12,Galdakao,Expense,travel,-2360.58,76947.79
buyer_4,Jorge,50,ES96209591234020518195,TRX_N-198-61236265211,2021-06-18T23:16:41,Galdakao,Expense,clothing,-261.91,76685.88
buyer_4,Jorge,50,ES96209591234020518195,TRX_N-199-295504785237,2021-07-01T20:59:34,Galdakao,transfer,Salary,2713.55,79399.43
buyer_4,Jorge,50,ES96209591234020518195,TRX_N-2-786868970189,2020-01-01T09:50:56,Galdakao,transfer,Partner Salary,2734.53,9495.78
buyer_4,Jorge,50,ES96209591234020518195,TRX_N-20-548854209605,2020-02-07T15:02:47,Galdakao,Basic services,internet,-63.94,11538.43
buyer_4,Jorge,50,ES96209591234020518195,TRX_N-200-85171523457,2021-07-01T20:59:34,Galdakao,transfer,Partner Salary,2734.53,82133.96
buyer_4,Jorge,50,ES96209591234020518195,TRX_N-201-480519619333,2021-07-01T20:59:34,Galdakao,transfer,Extra Income,271.36,82405.32
buyer_4,Jorge,50,ES96209591234020518195,TRX_N-202-917748224264,2021-07-05T12:39:54,Galdakao,Housing,Mortgage,-648.39,81756.93
buyer_4,Jorge,50,ES96209591234020518195,TRX_N-203-750528721380,2021-07-05T12:32:28,Galdakao,Basic services,electricity,-79.03,81677.9
buyer_4,Jorge,50,ES96209591234020518195,TRX_N-204-382320087566,2021-07-05T14:22:31,Galdakao,Basic services,gas,-28.17,81649.73
buyer_4,Jorge,50,ES96209591234020518195,TRX_N-205-794814449357,2021-07-07T16:40:48,Galdakao,Basic services,water,-65.3,81584.43
buyer_4,Jorge,50,ES96209591234020518195,TRX_N-206-991940618343,2021-07-07T09:17:21,Galdakao,Basic services,gas,-33.59,81550.84
buyer_4,Jorge,50,ES96209591234020518195,TRX_N-207-466726107984,2021-07-17T19:28:52,Galdakao,Expense,food,-342.84,81208.0
buyer_4,Jorge,50,ES96209591234020518195,TRX_N-208-161231109895,2021-07-28T17:14:15,Galdakao,Expense,gifts,-375.23,80832.77
buyer_4,Jorge,50,ES96209591234020518195,TRX_N-209-136166767850,2021-08-01T07:29:21,Galdakao,transfer,Salary,2713.55,83546.32
buyer_4,Jorge,50,ES96209591234020518195,TRX_N-21-650002147601,2020-02-16T15:12:41,Galdakao,Expense,healthcare,-140.98,11397.45
buyer_4,Jorge,50,ES96209591234020518195,TRX_N-210-9331878307,2021-08-01T07:29:21,Galdakao,transfer,Partner Salary,2734.53,86280.85
buyer_4,Jorge,50,ES96209591234020518195,TRX_N-211-291547946252,2021-08-05T15:09:39,Galdakao,Housing,Mortgage,-648.39,85632.46
buyer_4,Jorge,50,ES96209591234020518195,TRX_N-212-279003979226,2021-08-05T13:54:13,Galdakao,Basic services,water,-26.73,85605.73
buyer_4,Jorge,50,ES96209591234020518195,TRX_N-213-993124606760,2021-08-06T14:18:57,Galdakao,Basic services,gas,-31.8,85573.93
buyer_4,Jorge,50,ES96209591234020518195,TRX_N-214-327898860703,2021-08-06T20:18:14,Galdakao,Basic services,phone,-36.93,85537.0
buyer_4,Jorge,50,ES96209591234020518195,TRX_N-215-247759425389,2021-08-07T15:43:45,Galdakao,Basic services,gas,-91.73,85445.27
buyer_4,Jorge,50,ES96209591234020518195,TRX_N-216-217781472128,2021-08-13T06:22:25,Mungia,Expense,transport,-37.84,85407.43
buyer_4,Jorge,50,ES96209591234020518195,TRX_N-217-617057707164,2021-08-17T10:10:46,Bermeo,Expense,food,-332.41,85075.02
buyer_4,Jorge,50,ES96209591234020518195,TRX_N-218-602099754751,2021-08-19T17:05:56,Galdakao,Expense,transport,-67.02,85008.0
buyer_4,Jorge,50,ES96209591234020518195,TRX_N-219-580338574834,2021-08-24T10:19:23,Galdakao,Expense,transport,-34.44,84973.56
buyer_4,Jorge,50,ES96209591234020518195,TRX_N-22-174721939137,2020-02-20T17:31:15,Galdakao,Expense,food,-458.68,10938.77
buyer_4,Jorge,50,ES96209591234020518195,TRX_N-220-513950475599,2021-08-29T11:14:07,Galdakao,Expense,food,-516.33,84457.23
buyer_4,Jorge,50,ES96209591234020518195,TRX_N-221-236113467909,2021-09-01T16:19:46,Galdakao,transfer,Salary,2713.55,87170.78
buyer_4,Jorge,50,ES96209591234020518195,TRX_N-222-256851874665,2021-09-01T16:19:46,Galdakao,transfer,Partner Salary,2734.53,89905.31
buyer_4,Jorge,50,ES96209591234020518195,TRX_N-223-422411871226,2021-09-05T21:25:03,Galdakao,Housing,Mortgage,-648.39,89256.92
buyer_4,Jorge,50,ES96209591234020518195,TRX_N-224-384074368633,2021-09-05T08:30:20,Galdakao,Basic services,water,-70.76,89186.16
buyer_4,Jorge,50,ES96209591234020518195,TRX_N-225-304926363728,2021-09-05T13:49:56,Galdakao,Basic services,internet,-39.57,89146.59
buyer_4,Jorge,50,ES96209591234020518195,TRX_N-226-594666429394,2021-09-07T19:18:33,Galdakao,Basic services,water,-53.48,89093.11
buyer_4,Jorge,50,ES96209591234020518195,TRX_N-227-909480857656,2021-09-09T18:26:05,Galdakao,Expense,transport,-82.26,89010.85
buyer_4,Jorge,50,ES96209591234020518195,TRX_N-228-924738511635,2021-09-09T15:12:56,Galdakao,Expense,education,-727.49,88283.36
buyer_4,Jorge,50,ES96209591234020518195,TRX_N-229-75362610680,2021-09-12T17:39:25,Galdakao,Expense,healthcare,-334.33,87949.03
buyer_4,Jorge,50,ES96209591234020518195,TRX_N-23-939677908568,2020-03-01T20:05:58,Galdakao,transfer,Salary,2713.55,13652.32
buyer_4,Jorge,50,ES96209591234020518195,TRX_N-230-844881976793,2021-10-01T10:31:45,Galdakao,transfer,Salary,2713.55,90662.58
buyer_4,Jorge,50,ES96209591234020518195,TRX_N-231-121075331502,2021-10-01T10:31:45,Galdakao,transfer,Partner Salary,2734.53,93397.11
buyer_4,Jorge,50,ES96209591234020518195,TRX_N-232-386065382493,2021-10-01T10:31:45,Galdakao,transfer,Extra Income,271.36,93668.47
buyer_4,Jorge,50,ES96209591234020518195,TRX_N-233-116526116234,2021-10-02T09:21:03,Galdakao,Expense,food,-478.24,93190.23
buyer_4,Jorge,50,ES96209591234020518195,TRX_N-234-610040373222,2021-10-05T19:46:52,Galdakao,Housing,Mortgage,-648.39,92541.84
buyer_4,Jorge,50,ES96209591234020518195,TRX_N-235-754315780584,2021-10-05T09:12:10,Galdakao,Basic services,internet,-73.43,92468.41
buyer_4,Jorge,50,ES96209591234020518195,TRX_N-236-767939945299,2021-10-06T10:38:18,Galdakao,Basic services,phone,-52.08,92416.33
buyer_4,Jorge,50,ES96209591234020518195,TRX_N-237-712042999788,2021-10-07T15:39:12,Galdakao,Basic services,electricity,-110.69,92305.64
buyer_4,Jorge,50,ES96209591234020518195,TRX_N-238-555428783283,2021-10-17T13:29:03,Galdakao,Expense,food,-260.86,92044.78
buyer_4,Jorge,50,ES96209591234020518195,TRX_N-239-625677928196,2021-11-01T17:29:31,Galdakao,transfer,Salary,2713.55,94758.33
buyer_4,Jorge,50,ES96209591234020518195,TRX_N-24-380995713867,2020-03-01T20:05:58,Galdakao,transfer,Partner Salary,2734.53,16386.85
buyer_4,Jorge,50,ES96209591234020518195,TRX_N-240-349583615420,2021-11-01T17:29:31,Galdakao,transfer,Partner Salary,2734.53,97492.86
buyer_4,Jorge,50,ES96209591234020518195,TRX_N-241-65930713237,2021-11-01T20:40:07,Galdakao,Expense,healthcare,-79.42,97413.44
buyer_4,Jorge,50,ES96209591234020518195,TRX_N-242-729833830126,2021-11-05T07:42:13,Galdakao,Housing,Mortgage,-648.39,96765.05
buyer_4,Jorge,50,ES96209591234020518195,TRX_N-243-99479952221,2021-11-05T11:26:59,Galdakao,Basic services,internet,-63.34,96701.71
buyer_4,Jorge,50,ES96209591234020518195,TRX_N-244-548543581784,2021-11-06T10:36:33,Galdakao,Basic services,gas,-68.55,96633.16
buyer_4,Jorge,50,ES96209591234020518195,TRX_N-245-314780179427,2021-11-06T11:12:23,Galdakao,Basic services,phone,-69.49,96563.67
buyer_4,Jorge,50,ES96209591234020518195,TRX_N-246-852971888484,2021-11-07T17:26:18,Galdakao,Basic services,electricity,-62.04,96501.63
buyer_4,Jorge,50,ES96209591234020518195,TRX_N-247-623096289350,2021-11-07T23:48:30,Galdakao,Basic services,phone,-89.38,96412.25
buyer_4,Jorge,50,ES96209591234020518195,TRX_N-248-379151703626,2021-11-18T15:01:26,Oyón-Oion,Expense,food,-327.38,96084.87
buyer_4,Jorge,50,ES96209591234020518195,TRX_N-249-998094850830,2021-11-26T19:05:21,Galdakao,Expense,transport,-121.95,95962.92
buyer_4,Jorge,50,ES96209591234020518195,TRX_N-25-145146823765,2020-03-01T20:05:58,Galdakao,transfer,Extra Income,271.36,16658.21
buyer_4,Jorge,50,ES96209591234020518195,TRX_N-250-68016285707,2021-12-01T13:56:31,Galdakao,transfer,Salary,2713.55,98676.47
buyer_4,Jorge,50,ES96209591234020518195,TRX_N-251-635205447128,2021-12-01T13:56:31,Galdakao,transfer,Partner Salary,2734.53,101411.0
buyer_4,Jorge,50,ES96209591234020518195,TRX_N-252-33336486074,2021-12-01T13:56:31,Galdakao,transfer,Extra Income,271.36,101682.36
buyer_4,Jorge,50,ES96209591234020518195,TRX_N-253-660112061028,2021-12-01T13:56:31,Galdakao,transfer,Bonus,2670.26,104352.62
buyer_4,Jorge,50,ES96209591234020518195,TRX_N-254-185706555562,2021-12-05T09:40:05,Galdakao,Housing,Mortgage,-648.39,103704.23
buyer_4,Jorge,50,ES96209591234020518195,TRX_N-255-179958400943,2021-12-05T23:08:36,Galdakao,Basic services,gas,-42.57,103661.66
buyer_4,Jorge,50,ES96209591234020518195,TRX_N-256-222872964581,2021-12-05T07:14:37,Galdakao,Basic services,phone,-32.06,103629.6
buyer_4,Jorge,50,ES96209591234020518195,TRX_N-257-931268463812,2021-12-06T11:51:37,Galdakao,Basic services,internet,-36.02,103593.58
buyer_4,Jorge,50,ES96209591234020518195,TRX_N-258-871330109253,2021-12-07T17:18:10,Galdakao,Basic services,water,-57.84,103535.74
buyer_4,Jorge,50,ES96209591234020518195,TRX_N-259-586506495669,2021-12-07T16:47:11,Galdakao,Basic services,gas,-45.5,103490.24
buyer_4,Jorge,50,ES96209591234020518195,TRX_N-26-728435285224,2020-03-01T08:33:38,Galdakao,Expense,transport,-109.34,16548.87
buyer_4,Jorge,50,ES96209591234020518195,TRX_N-260-857729406536,2021-12-23T20:30:42,Galdakao,Expense,clothing,-74.02,103416.22
buyer_4,Jorge,50,ES96209591234020518195,TRX_N-261-573615018110,2021-12-25T15:39:54,Galdakao,Expense,clothing,-477.16,102939.06
buyer_4,Jorge,50,ES96209591234020518195,TRX_N-262-976086298992,2022-01-01T20:08:43,Galdakao,transfer,Salary,2713.55,105652.61
buyer_4,Jorge,50,ES96209591234020518195,TRX_N-263-333095901022,2022-01-01T20:08:43,Galdakao,transfer,Partner Salary,2734.53,108387.14
buyer_4,Jorge,50,ES96209591234020518195,TRX_N-264-633857724280,2022-01-01T17:49:01,Galdakao,Expense,food,-439.79,107947.35
buyer_4,Jorge,50,ES96209591234020518195,TRX_N-265-176687805195,2022-01-05T13:41:41,Galdakao,Housing,Mortgage,-648.39,107298.96
buyer_4,Jorge,50,ES96209591234020518195,TRX_N-266-208534654964,2022-01-05T19:28:25,Galdakao,Basic services,gas,-66.11,107232.85
buyer_4,Jorge,50,ES96209591234020518195,TRX_N-267-397644767110,2022-01-06T17:52:13,Galdakao,Basic services,gas,-61.28,107171.57
buyer_4,Jorge,50,ES96209591234020518195,TRX_N-268-982609776137,2022-01-06T01:49:03,Galdakao,Basic services,phone,-31.65,107139.92
buyer_4,Jorge,50,ES96209591234020518195,TRX_N-269-494385268034,2022-01-07T13:35:48,Galdakao,Basic services,water,-74.32,107065.6
buyer_4,Jorge,50,ES96209591234020518195,TRX_N-27-387668865252,2020-03-05T13:32:37,Galdakao,Housing,Mortgage,-648.39,15900.48
buyer_4,Jorge,50,ES96209591234020518195,TRX_N-270-667944027300,2022-01-21T23:33:04,Galdakao,Expense,repairs,-826.83,106238.77
buyer_4,Jorge,50,ES96209591234020518195,TRX_N-271-211582344011,2022-02-01T16:08:24,Galdakao,transfer,Salary,2713.55,108952.32
buyer_4,Jorge,50,ES96209591234020518195,TRX_N-272-238452774711,2022-02-01T16:08:24,Galdakao,transfer,Partner Salary,2734.53,111686.85
buyer_4,Jorge,50,ES96209591234020518195,TRX_N-273-380060957280,2022-02-05T10:52:40,Galdakao,Housing,Mortgage,-648.39,111038.46
buyer_4,Jorge,50,ES96209591234020518195,TRX_N-274-392449994257,2022-02-05T12:00:19,Galdakao,Basic services,internet,-70.67,110967.79
buyer_4,Jorge,50,ES96209591234020518195,TRX_N-275-981061370337,2022-02-06T18:37:44,Galdakao,Basic services,gas,-41.22,110926.57
buyer_4,Jorge,50,ES96209591234020518195,TRX_N-276-44421473352,2022-02-07T09:56:42,Galdakao,Basic services,electricity,-35.23,110891.34
buyer_4,Jorge,50,ES96209591234020518195,TRX_N-277-395074302987,2022-02-07T08:37:54,Galdakao,Basic services,phone,-36.3,110855.04
buyer_4,Jorge,50,ES96209591234020518195,TRX_N-278-28260837980,2022-02-13T17:28:41,Leioa,Expense,transport,-41.22,110813.82
buyer_4,Jorge,50,ES96209591234020518195,TRX_N-279-104571647874,2022-02-19T12:18:01,Galdakao,Expense,food,-701.76,110112.06
buyer_4,Jorge,50,ES96209591234020518195,TRX_N-28-694502356273,2020-03-06T18:49:46,Galdakao,Basic services,water,-55.28,15845.2
buyer_4,Jorge,50,ES96209591234020518195,TRX_N-280-770510134952,2022-02-20T13:36:51,Galdakao,Expense,education,-418.65,109693.41
buyer_4,Jorge,50,ES96209591234020518195,TRX_N-281-687537062643,2022-03-01T11:12:04,Galdakao,transfer,Salary,2713.55,112406.96
buyer_4,Jorge,50,ES96209591234020518195,TRX_N-282-345910888267,2022-03-01T11:12:04,Galdakao,transfer,Partner Salary,2734.53,115141.49
buyer_4,Jorge,50,ES96209591234020518195,TRX_N-283-880370492065,2022-03-01T11:12:04,Galdakao,transfer,Extra Income,271.36,115412.85
buyer_4,Jorge,50,ES96209591234020518195,TRX_N-284-122451939523,2022-03-05T08:11:36,Galdakao,Housing,Mortgage,-648.39,114764.46
buyer_4,Jorge,50,ES96209591234020518195,TRX_N-285-306698452389,2022-03-05T18:37:22,Galdakao,Basic services,water,-11.41,114753.05
buyer_4,Jorge,50,ES96209591234020518195,TRX_N-286-350434728524,2022-03-07T03:53:29,Galdakao,Basic services,electricity,-131.41,114621.64
buyer_4,Jorge,50,ES96209591234020518195,TRX_N-287-345974583360,2022-03-07T21:19:26,Galdakao,Basic services,gas,-28.44,114593.2
buyer_4,Jorge,50,ES96209591234020518195,TRX_N-288-885122633215,2022-03-07T14:33:52,Galdakao,Basic services,internet,-73.3,114519.9
buyer_4,Jorge,50,ES96209591234020518195,TRX_N-289-540988641853,2022-03-11T11:12:04,Pasaia,Expense,leisure,-13.26,114506.64
buyer_4,Jorge,50,ES96209591234020518195,TRX_N-29-426438506608,2020-03-06T19:40:36,Galdakao,Basic services,gas,-63.47,15781.73
buyer_4,Jorge,50,ES96209591234020518195,TRX_N-290-752703349177,2022-03-13T18:30:13,Amurrio,Expense,gifts,-329.08,114177.56
buyer_4,Jorge,50,ES96209591234020518195,TRX_N-291-763740805239,2022-04-01T12:50:08,Galdakao,transfer,Salary,2713.55,116891.11
buyer_4,Jorge,50,ES96209591234020518195,TRX_N-292-567062847594,2022-04-01T12:50:08,Galdakao,transfer,Partner Salary,2734.53,119625.64
buyer_4,Jorge,50,ES96209591234020518195,TRX_N-293-918019830121,2022-04-05T20:04:11,Galdakao,Housing,Mortgage,-648.39,118977.25
buyer_4,Jorge,50,ES96209591234020518195,TRX_N-294-42499183320,2022-04-05T23:48:59,Galdakao,Basic services,electricity,-68.53,118908.72
buyer_4,Jorge,50,ES96209591234020518195,TRX_N-295-316888035363,2022-04-05T17:24:52,Galdakao,Basic services,gas,-18.64,118890.08
buyer_4,Jorge,50,ES96209591234020518195,TRX_N-296-389606463913,2022-04-06T17:13:51,Galdakao,Basic services,water,-13.29,118876.79
buyer_4,Jorge,50,ES96209591234020518195,TRX_N-297-996343624107,2022-04-06T20:52:55,Galdakao,Expense,food,-234.81,118641.98
buyer_4,Jorge,50,ES96209591234020518195,TRX_N-298-371391384143,2022-04-07T10:02:22,Galdakao,Basic services,water,-23.31,118618.67
buyer_4,Jorge,50,ES96209591234020518195,TRX_N-299-221295992843,2022-04-07T20:25:24,Galdakao,Basic services,internet,-68.92,118549.75
buyer_4,Jorge,50,ES96209591234020518195,TRX_N-3-854272164708,2020-01-04T09:35:13,Galdakao,Expense,food,-581.95,8913.83
buyer_4,Jorge,50,ES96209591234020518195,TRX_N-30-677033710895,2020-03-07T17:55:12,Galdakao,Basic services,electricity,-82.26,15699.47
buyer_4,Jorge,50,ES96209591234020518195,TRX_N-300-874999208535,2022-04-09T20:25:15,Galdakao,Expense,leisure,-113.61,118436.14
buyer_4,Jorge,50,ES96209591234020518195,TRX_N-301-122270410725,2022-04-10T17:57:20,Galdakao,Expense,transport,-185.87,118250.27
buyer_4,Jorge,50,ES96209591234020518195,TRX_N-302-601447136791,2022-04-20T15:35:10,Galdakao,Expense,transport,-127.9,118122.37
buyer_4,Jorge,50,ES96209591234020518195,TRX_N-303-218415026392,2022-05-01T15:27:59,Galdakao,transfer,Salary,2713.55,120835.92
buyer_4,Jorge,50,ES96209591234020518195,TRX_N-304-282109383824,2022-05-01T15:27:59,Galdakao,transfer,Partner Salary,2734.53,123570.45
buyer_4,Jorge,50,ES96209591234020518195,TRX_N-305-929587309674,2022-05-01T15:27:59,Galdakao,transfer,Extra Income,271.36,123841.81
buyer_4,Jorge,50,ES96209591234020518195,TRX_N-306-105516631186,2022-05-05T13:01:44,Galdakao,Housing,Mortgage,-648.39,123193.42
buyer_4,Jorge,50,ES96209591234020518195,TRX_N-307-174545482265,2022-05-05T18:08:34,Galdakao,Basic services,water,-55.78,123137.64
buyer_4,Jorge,50,ES96209591234020518195,TRX_N-308-611923015894,2022-05-07T09:55:05,Eibar,Expense,repairs,-574.82,122562.82
buyer_4,Jorge,50,ES96209591234020518195,TRX_N-309-8543806728,2022-05-16T13:59:41,Galdakao,Expense,food,-628.75,121934.07
buyer_4,Jorge,50,ES96209591234020518195,TRX_N-31-870755903607,2020-03-12T10:29:25,Galdakao,Expense,education,-605.53,15093.94
buyer_4,Jorge,50,ES96209591234020518195,TRX_N-310-624653235602,2022-05-16T16:02:04,Galdakao,Expense,clothing,-422.09,121511.98
buyer_4,Jorge,50,ES96209591234020518195,TRX_N-311-580645919061,2022-05-20T15:21:51,Galdakao,Expense,transport,-95.24,121416.74
buyer_4,Jorge,50,ES96209591234020518195,TRX_N-312-75263578407,2022-06-01T08:48:25,Galdakao,transfer,Salary,2713.55,124130.29
buyer_4,Jorge,50,ES96209591234020518195,TRX_N-313-776798276961,2022-06-01T08:48:25,Galdakao,transfer,Partner Salary,2734.53,126864.82
buyer_4,Jorge,50,ES96209591234020518195,TRX_N-314-35920799953,2022-06-01T08:48:25,Galdakao,transfer,Bonus,2665.69,129530.51
buyer_4,Jorge,50,ES96209591234020518195,TRX_N-315-842412076659,2022-06-05T13:34:05,Galdakao,Housing,Mortgage,-648.39,128882.12
buyer_4,Jorge,50,ES96209591234020518195,TRX_N-316-485750980346,2022-06-05T15:04:21,Galdakao,Basic services,phone,-90.83,128791.29
buyer_4,Jorge,50,ES96209591234020518195,TRX_N-317-96217918823,2022-06-06T19:58:51,Galdakao,Basic services,water,-64.51,128726.78
buyer_4,Jorge,50,ES96209591234020518195,TRX_N-318-773279606563,2022-06-06T14:27:52,Galdakao,Basic services,electricity,-93.09,128633.69
buyer_4,Jorge,50,ES96209591234020518195,TRX_N-319-592988630099,2022-06-06T09:07:47,Galdakao,Basic services,gas,-67.16,128566.53
buyer_4,Jorge,50,ES96209591234020518195,TRX_N-32-620674079495,2020-03-23T22:23:34,Galdakao,Expense,leisure,-150.1,14943.84
buyer_4,Jorge,50,ES96209591234020518195,TRX_N-320-101933563688,2022-06-06T18:49:58,Galdakao,Basic services,phone,-25.46,128541.07
buyer_4,Jorge,50,ES96209591234020518195,TRX_N-321-740935265662,2022-06-07T16:40:41,Galdakao,Basic services,internet,-62.08,128478.99
buyer_4,Jorge,50,ES96209591234020518195,TRX_N-322-504883590553,2022-07-01T12:22:24,Galdakao,transfer,Salary,2713.55,131192.54
buyer_4,Jorge,50,ES96209591234020518195,TRX_N-323-473265335840,2022-07-01T12:22:24,Galdakao,transfer,Partner Salary,2734.53,133927.07
buyer_4,Jorge,50,ES96209591234020518195,TRX_N-324-363429161214,2022-07-05T17:44:43,Galdakao,Housing,Mortgage,-648.39,133278.68
buyer_4,Jorge,50,ES96209591234020518195,TRX_N-325-14429910936,2022-07-05T18:02:07,Galdakao,Basic services,electricity,-65.08,133213.6
buyer_4,Jorge,50,ES96209591234020518195,TRX_N-326-631669812344,2022-07-05T17:44:42,Galdakao,Basic services,phone,-38.98,133174.62
buyer_4,Jorge,50,ES96209591234020518195,TRX_N-327-384384896256,2022-07-06T19:07:03,Galdakao,Basic services,electricity,-53.19,133121.43
buyer_4,Jorge,50,ES96209591234020518195,TRX_N-328-250377900354,2022-07-06T22:37:23,Galdakao,Basic services,gas,-45.06,133076.37
buyer_4,Jorge,50,ES96209591234020518195,TRX_N-329-903402347711,2022-07-06T22:02:55,Galdakao,Expense,education,-602.64,132473.73
buyer_4,Jorge,50,ES96209591234020518195,TRX_N-33-903873393778,2020-04-01T02:57:18,Galdakao,transfer,Salary,2713.55,17657.39
buyer_4,Jorge,50,ES96209591234020518195,TRX_N-330-382915374451,2022-07-07T08:51:19,Galdakao,Basic services,water,-43.23,132430.5
buyer_4,Jorge,50,ES96209591234020518195,TRX_N-331-346345182493,2022-07-13T10:19:45,Galdakao,Expense,transport,-83.08,132347.42
buyer_4,Jorge,50,ES96209591234020518195,TRX_N-332-74200335,2022-07-14T15:00:15,Galdakao,Expense,travel,-2109.32,130238.1
buyer_4,Jorge,50,ES96209591234020518195,TRX_N-333-79647271010,2022-07-18T13:33:27,Galdakao,Expense,leisure,-269.16,129968.94
buyer_4,Jorge,50,ES96209591234020518195,TRX_N-334-722275171703,2022-08-01T08:41:50,Galdakao,transfer,Salary,2713.55,132682.49
buyer_4,Jorge,50,ES96209591234020518195,TRX_N-335-705734942513,2022-08-01T08:41:50,Galdakao,transfer,Partner Salary,2734.53,135417.02
buyer_4,Jorge,50,ES96209591234020518195,TRX_N-336-778249697966,2022-08-01T08:41:50,Galdakao,transfer,Extra Income,271.36,135688.38
buyer_4,Jorge,50,ES96209591234020518195,TRX_N-337-827651308836,2022-08-02T14:17:22,Galdakao,Expense,clothing,-220.15,135468.23
buyer_4,Jorge,50,ES96209591234020518195,TRX_N-338-763831378121,2022-08-05T02:55:32,Galdakao,Housing,Mortgage,-648.39,134819.84
buyer_4,Jorge,50,ES96209591234020518195,TRX_N-339-541608499839,2022-08-05T10:48:38,Galdakao,Basic services,gas,-73.08,134746.76
buyer_4,Jorge,50,ES96209591234020518195,TRX_N-34-859958057978,2020-04-01T02:57:18,Galdakao,transfer,Partner Salary,2734.53,20391.92
buyer_4,Jorge,50,ES96209591234020518195,TRX_N-340-323035933415,2022-08-05T11:09:52,Galdakao,Basic services,phone,-51.33,134695.43
buyer_4,Jorge,50,ES96209591234020518195,TRX_N-341-501880993684,2022-08-07T10:02:12,Galdakao,Basic services,water,-44.25,134651.18
buyer_4,Jorge,50,ES96209591234020518195,TRX_N-342-236566330289,2022-08-07T01:33:33,Galdakao,Basic services,phone,-99.4,134551.78
buyer_4,Jorge,50,ES96209591234020518195,TRX_N-343-504143775201,2022-08-12T17:33:09,Galdakao,Expense,education,-294.55,134257.23
buyer_4,Jorge,50,ES96209591234020518195,TRX_N-344-957166824410,2022-08-14T12:05:01,Bilbao,Expense,education,-777.1,133480.13
buyer_4,Jorge,50,ES96209591234020518195,TRX_N-345-242615771299,2022-08-25T22:52:57,Galdakao,Expense,food,-510.14,132969.99
buyer_4,Jorge,50,ES96209591234020518195,TRX_N-346-805504956466,2022-08-29T12:45:24,Galdakao,Expense,transport,-96.91,132873.08
buyer_4,Jorge,50,ES96209591234020518195,TRX_N-347-606563345512,2022-09-01T11:14:39,Galdakao,transfer,Salary,2713.55,135586.63
buyer_4,Jorge,50,ES96209591234020518195,TRX_N-348-810977960000,2022-09-01T11:14:39,Galdakao,transfer,Partner Salary,2734.53,138321.16
buyer_4,Jorge,50,ES96209591234020518195,TRX_N-349-844708794677,2022-09-05T21:17:51,Galdakao,Housing,Mortgage,-648.39,137672.77
buyer_4,Jorge,50,ES96209591234020518195,TRX_N-35-105492170008,2020-04-01T16:44:05,Galdakao,Expense,food,-649.37,19742.55
buyer_4,Jorge,50,ES96209591234020518195,TRX_N-350-813754509577,2022-09-05T20:30:23,Galdakao,Basic services,gas,-95.08,137577.69
buyer_4,Jorge,50,ES96209591234020518195,TRX_N-351-594204218307,2022-09-05T09:36:51,Galdakao,Basic services,phone,-72.52,137505.17
buyer_4,Jorge,50,ES96209591234020518195,TRX_N-352-190730666509,2022-09-06T18:14:21,Galdakao,Basic services,water,-62.59,137442.58
buyer_4,Jorge,50,ES96209591234020518195,TRX_N-353-247020390651,2022-09-06T19:52:27,Galdakao,Basic services,internet,-67.45,137375.13
buyer_4,Jorge,50,ES96209591234020518195,TRX_N-354-45621900165,2022-09-07T12:10:56,Galdakao,Basic services,internet,-69.79,137305.34
buyer_4,Jorge,50,ES96209591234020518195,TRX_N-355-13435613362,2022-09-07T22:47:30,Galdakao,Expense,leisure,-298.19,137007.15
buyer_4,Jorge,50,ES96209591234020518195,TRX_N-356-305777323754,2022-09-10T14:46:13,Galdakao,Expense,gifts,-276.46,136730.69
buyer_4,Jorge,50,ES96209591234020518195,TRX_N-357-269686859292,2022-10-01T08:17:57,Galdakao,transfer,Salary,2713.55,139444.24
buyer_4,Jorge,50,ES96209591234020518195,TRX_N-358-854051802504,2022-10-01T08:17:57,Galdakao,transfer,Partner Salary,2734.53,142178.77
buyer_4,Jorge,50,ES96209591234020518195,TRX_N-359-976769110250,2022-10-05T20:47:34,Galdakao,Housing,Mortgage,-648.39,141530.38
buyer_4,Jorge,50,ES96209591234020518195,TRX_N-36-6566211742,2020-04-05T19:57:00,Galdakao,Housing,Mortgage,-648.39,19094.16
buyer_4,Jorge,50,ES96209591234020518195,TRX_N-360-187468552966,2022-10-05T15:31:22,Galdakao,Basic services,water,-35.94,141494.44
buyer_4,Jorge,50,ES96209591234020518195,TRX_N-361-461863701656,2022-10-05T14:39:23,Galdakao,Basic services,electricity,-112.91,141381.53
buyer_4,Jorge,50,ES96209591234020518195,TRX_N-362-329697294749,2022-10-05T09:28:17,Errenteria,Expense,food,-145.02,141236.51
buyer_4,Jorge,50,ES96209591234020518195,TRX_N-363-127880372091,2022-10-06T22:18:09,Galdakao,Basic services,water,-51.93,141184.58
buyer_4,Jorge,50,ES96209591234020518195,TRX_N-364-843028238836,2022-10-06T18:05:45,Galdakao,Basic services,electricity,-79.16,141105.42
buyer_4,Jorge,50,ES96209591234020518195,TRX_N-365-93850862478,2022-10-06T18:55:00,Galdakao,Basic services,internet,-58.78,141046.64
buyer_4,Jorge,50,ES96209591234020518195,TRX_N-366-389252288142,2022-10-06T06:44:59,Galdakao,Basic services,phone,-30.17,141016.47
buyer_4,Jorge,50,ES96209591234020518195,TRX_N-367-512197873782,2022-10-07T09:31:15,Galdakao,Basic services,water,-62.73,140953.74
buyer_4,Jorge,50,ES96209591234020518195,TRX_N-368-325648513896,2022-10-10T18:04:00,Hernani,Expense,food,-592.09,140361.65
buyer_4,Jorge,50,ES96209591234020518195,TRX_N-369-899417749190,2022-10-13T13:46:43,Galdakao,Expense,food,-683.15,139678.5
buyer_4,Jorge,50,ES96209591234020518195,TRX_N-37-786371169124,2020-04-05T15:18:13,Galdakao,Basic services,water,-51.46,19042.7
buyer_4,Jorge,50,ES96209591234020518195,TRX_N-370-415848899665,2022-10-22T20:33:41,Galdakao,Expense,food,-729.08,138949.42
buyer_4,Jorge,50,ES96209591234020518195,TRX_N-371-158874124177,2022-11-01T20:06:24,Galdakao,transfer,Salary,2713.55,141662.97
buyer_4,Jorge,50,ES96209591234020518195,TRX_N-372-739792348814,2022-11-01T20:06:24,Galdakao,transfer,Partner Salary,2734.53,144397.5
buyer_4,Jorge,50,ES96209591234020518195,TRX_N-373-946401422158,2022-11-01T20:06:24,Galdakao,transfer,Extra Income,271.36,144668.86
buyer_4,Jorge,50,ES96209591234020518195,TRX_N-374-486821114019,2022-11-05T08:41:07,Galdakao,Housing,Mortgage,-648.39,144020.47
buyer_4,Jorge,50,ES96209591234020518195,TRX_N-375-827774090192,2022-11-05T11:13:46,Galdakao,Basic services,water,-26.36,143994.11
buyer_4,Jorge,50,ES96209591234020518195,TRX_N-376-976342966477,2022-11-06T15:21:49,Galdakao,Basic services,gas,-88.53,143905.58
buyer_4,Jorge,50,ES96209591234020518195,TRX_N-377-106832504455,2022-11-06T22:15:53,Galdakao,Basic services,internet,-38.14,143867.44
buyer_4,Jorge,50,ES96209591234020518195,TRX_N-378-174240088987,2022-11-07T16:17:43,Galdakao,Basic services,gas,-49.02,143818.42
buyer_4,Jorge,50,ES96209591234020518195,TRX_N-379-550420921234,2022-11-07T21:58:39,Galdakao,Basic services,phone,-93.85,143724.57
buyer_4,Jorge,50,ES96209591234020518195,TRX_N-38-17995588819,2020-04-05T23:12:07,Galdakao,Basic services,internet,-56.07,18986.63
buyer_4,Jorge,50,ES96209591234020518195,TRX_N-380-195084887960,2022-11-16T17:08:19,Galdakao,Expense,leisure,-104.79,143619.78
buyer_4,Jorge,50,ES96209591234020518195,TRX_N-381-769402054878,2022-11-23T02:17:16,Galdakao,Expense,food,-135.95,143483.83
buyer_4,Jorge,50,ES96209591234020518195,TRX_N-382-321611826065,2022-12-01T12:44:19,Galdakao,transfer,Salary,2713.55,146197.38
buyer_4,Jorge,50,ES96209591234020518195,TRX_N-383-44815472527,2022-12-01T12:44:19,Galdakao,transfer,Partner Salary,2734.53,148931.91
buyer_4,Jorge,50,ES96209591234020518195,TRX_N-384-600692429939,2022-12-01T12:44:19,Galdakao,transfer,Bonus,2529.5,151461.41
buyer_4,Jorge,50,ES96209591234020518195,TRX_N-385-976022216574,2022-12-04T13:29:46,Galdakao,Expense,transport,-191.8,151269.61
buyer_4,Jorge,50,ES96209591234020518195,TRX_N-386-761218539282,2022-12-05T10:37:55,Galdakao,Housing,Mortgage,-648.39,150621.22
buyer_4,Jorge,50,ES96209591234020518195,TRX_N-387-872612737887,2022-12-05T05:35:20,Galdakao,Basic services,gas,-84.56,150536.66
buyer_4,Jorge,50,ES96209591234020518195,TRX_N-388-874567382020,2022-12-05T12:00:55,Galdakao,Basic services,phone,-48.08,150488.58
buyer_4,Jorge,50,ES96209591234020518195,TRX_N-389-588994957652,2022-12-06T10:30:54,Galdakao,Basic services,internet,-59.25,150429.33
buyer_4,Jorge,50,ES96209591234020518195,TRX_N-39-419783349715,2020-04-06T08:11:06,Galdakao,Basic services,electricity,-96.15,18890.48
buyer_4,Jorge,50,ES96209591234020518195,TRX_N-390-951319301308,2022-12-07T16:15:21,Galdakao,Basic services,water,-38.59,150390.74
buyer_4,Jorge,50,ES96209591234020518195,TRX_N-391-27483424003,2022-12-07T08:45:47,Galdakao,Basic services,electricity,-74.08,150316.66
buyer_4,Jorge,50,ES96209591234020518195,TRX_N-392-507403135118,2022-12-07T20:43:05,Galdakao,Basic services,phone,-79.77,150236.89
buyer_4,Jorge,50,ES96209591234020518195,TRX_N-393-479343497509,2022-12-08T17:48:06,Oyón-Oion,Expense,food,-411.16,149825.73
buyer_4,Jorge,50,ES96209591234020518195,TRX_N-394-895249224280,2022-12-08T04:59:19,Galdakao,Expense,transport,-156.66,149669.07
buyer_4,Jorge,50,ES96209591234020518195,TRX_N-395-195739841953,2022-12-13T11:11:20,Galdakao,Expense,repairs,-734.09,148934.98
buyer_4,Jorge,50,ES96209591234020518195,TRX_N-396-67104518293,2022-12-22T22:00:17,Basauri,Expense,transport,-140.04,148794.94
buyer_4,Jorge,50,ES96209591234020518195,TRX_N-397-356788412743,2022-12-23T20:42:51,Galdakao,Expense,healthcare,-130.15,148664.79
buyer_4,Jorge,50,ES96209591234020518195,TRX_N-398-581260087506,2022-12-26T22:17:51,Santurtzi,Expense,food,-294.64,148370.15
buyer_4,Jorge,50,ES96209591234020518195,TRX_N-399-532894235915,2023-01-01T09:57:33,Galdakao,transfer,Salary,2713.55,151083.7
buyer_4,Jorge,50,ES96209591234020518195,TRX_N-4-226303777335,2020-01-05T20:07:27,Galdakao,Housing,Mortgage,-648.39,8265.44
buyer_4,Jorge,50,ES96209591234020518195,TRX_N-40-710913198046,2020-04-07T18:09:45,Galdakao,Basic services,internet,-61.16,18829.32
buyer_4,Jorge,50,ES96209591234020518195,TRX_N-400-902659620662,2023-01-01T09:57:33,Galdakao,transfer,Partner Salary,2734.53,153818.23
buyer_4,Jorge,50,ES96209591234020518195,TRX_N-401-813487636639,2023-01-01T09:57:33,Galdakao,transfer,Extra Income,271.36,154089.59
buyer_4,Jorge,50,ES96209591234020518195,TRX_N-402-679181445420,2023-01-05T09:17:30,Galdakao,Housing,Mortgage,-648.39,153441.2
buyer_4,Jorge,50,ES96209591234020518195,TRX_N-403-475025132674,2023-01-05T19:42:27,Galdakao,Basic services,electricity,-144.87,153296.33
buyer_4,Jorge,50,ES96209591234020518195,TRX_N-404-857103726433,2023-01-07T10:28:15,Galdakao,Basic services,water,-60.38,153235.95
buyer_4,Jorge,50,ES96209591234020518195,TRX_N-405-494619905514,2023-01-07T19:23:26,Galdakao,Basic services,gas,-96.51,153139.44
buyer_4,Jorge,50,ES96209591234020518195,TRX_N-406-316210007758,2023-01-09T17:52:45,Galdakao,Expense,leisure,-205.9,152933.54
buyer_4,Jorge,50,ES96209591234020518195,TRX_N-407-842641275376,2023-01-16T11:58:27,Galdakao,Expense,leisure,-17.82,152915.72
buyer_4,Jorge,50,ES96209591234020518195,TRX_N-408-685069527364,2023-02-01T16:12:06,Galdakao,transfer,Salary,2713.55,155629.27
buyer_4,Jorge,50,ES96209591234020518195,TRX_N-409-443994981329,2023-02-01T16:12:06,Galdakao,transfer,Partner Salary,2734.53,158363.8
buyer_4,Jorge,50,ES96209591234020518195,TRX_N-41-798609835882,2020-04-07T14:07:08,Galdakao,Basic services,phone,-99.96,18729.36
buyer_4,Jorge,50,ES96209591234020518195,TRX_N-410-193657708883,2023-02-03T14:19:21,Galdakao,Expense,gifts,-358.55,158005.25
buyer_4,Jorge,50,ES96209591234020518195,TRX_N-411-445456735333,2023-02-05T19:26:24,Galdakao,Housing,Mortgage,-648.39,157356.86
buyer_4,Jorge,50,ES96209591234020518195,TRX_N-412-939651578669,2023-02-05T21:59:08,Galdakao,Basic services,electricity,-37.83,157319.03
buyer_4,Jorge,50,ES96209591234020518195,TRX_N-413-6616303800,2023-02-07T21:13:29,Galdakao,Basic services,water,-67.62,157251.41
buyer_4,Jorge,50,ES96209591234020518195,TRX_N-414-201071994328,2023-02-07T04:32:37,Galdakao,Basic services,electricity,-63.38,157188.03
buyer_4,Jorge,50,ES96209591234020518195,TRX_N-415-169783442446,2023-02-07T19:16:37,Galdakao,Basic services,phone,-54.96,157133.07
buyer_4,Jorge,50,ES96209591234020518195,TRX_N-416-791564831112,2023-02-12T19:21:53,Galdakao,Expense,leisure,-160.54,156972.53
buyer_4,Jorge,50,ES96209591234020518195,TRX_N-417-971259352071,2023-02-13T13:20:27,Galdakao,Expense,food,-506.13,156466.4
buyer_4,Jorge,50,ES96209591234020518195,TRX_N-418-653146376512,2023-03-01T17:20:54,Galdakao,transfer,Salary,2713.55,159179.95
buyer_4,Jorge,50,ES96209591234020518195,TRX_N-419-63565624685,2023-03-01T17:20:54,Galdakao,transfer,Partner Salary,2734.53,161914.48
buyer_4,Jorge,50,ES96209591234020518195,TRX_N-42-904056622563,2020-04-22T11:02:14,Galdakao,Expense,gifts,-345.44,18383.92
buyer_4,Jorge,50,ES96209591234020518195,TRX_N-420-541571195660,2023-03-01T17:20:54,Galdakao,transfer,Extra Income,271.36,162185.84
buyer_4,Jorge,50,ES96209591234020518195,TRX_N-421-41265746951,2023-03-01T14:09:03,Galdakao,Expense,food,-762.94,161422.9
buyer_4,Jorge,50,ES96209591234020518195,TRX_N-422-632433915495,2023-03-05T17:23:25,Galdakao,Housing,Mortgage,-648.39,160774.51
buyer_4,Jorge,50,ES96209591234020518195,TRX_N-423-813122758549,2023-03-05T08:44:10,Irun,Expense,travel,-661.99,160112.52
buyer_4,Jorge,50,ES96209591234020518195,TRX_N-424-230007040512,2023-03-06T13:09:30,Galdakao,Basic services,electricity,-124.46,159988.06
buyer_4,Jorge,50,ES96209591234020518195,TRX_N-425-434819352535,2023-03-07T17:02:22,Galdakao,Basic services,water,-18.99,159969.07
buyer_4,Jorge,50,ES96209591234020518195,TRX_N-426-237781963826,2023-03-07T23:18:28,Galdakao,Basic services,electricity,-125.52,159843.55
buyer_4,Jorge,50,ES96209591234020518195,TRX_N-427-272377545111,2023-03-09T08:27:17,Galdakao,Expense,food,-386.53,159457.02
buyer_4,Jorge,50,ES96209591234020518195,TRX_N-428-231101770366,2023-03-14T11:40:37,Errenteria,Expense,food,-711.67,158745.35
buyer_4,Jorge,50,ES96209591234020518195,TRX_N-429-38177295781,2023-03-18T09:55:03,Galdakao,Expense,food,-722.08,158023.27
buyer_4,Jorge,50,ES96209591234020518195,TRX_N-43-775920515582,2020-04-30T14:33:47,Portugalete,Expense,healthcare,-61.58,18322.34
buyer_4,Jorge,50,ES96209591234020518195,TRX_N-430-246359875608,2023-03-19T19:31:06,Galdakao,Expense,healthcare,-348.25,157675.02
buyer_4,Jorge,50,ES96209591234020518195,TRX_N-431-815960441088,2023-04-01T21:43:19,Galdakao,transfer,Salary,2713.55,160388.57
buyer_4,Jorge,50,ES96209591234020518195,TRX_N-432-350710550733,2023-04-01T21:43:19,Galdakao,transfer,Partner Salary,2734.53,163123.1
buyer_4,Jorge,50,ES96209591234020518195,TRX_N-433-193736506004,2023-04-05T21:59:32,Galdakao,Housing,Mortgage,-648.39,162474.71
buyer_4,Jorge,50,ES96209591234020518195,TRX_N-434-93736377287,2023-04-05T19:50:59,Galdakao,Basic services,gas,-39.22,162435.49
buyer_4,Jorge,50,ES96209591234020518195,TRX_N-435-788957635034,2023-04-06T14:29:28,Galdakao,Basic services,electricity,-136.25,162299.24
buyer_4,Jorge,50,ES96209591234020518195,TRX_N-436-836886788858,2023-04-06T23:29:28,Galdakao,Basic services,internet,-58.41,162240.83
buyer_4,Jorge,50,ES96209591234020518195,TRX_N-437-555402281447,2023-04-20T20:53:03,Hondarribia,Expense,transport,-69.16,162171.67
buyer_4,Jorge,50,ES96209591234020518195,TRX_N-438-516812643138,2023-04-20T18:37:28,Galdakao,Expense,leisure,-148.56,162023.11
buyer_4,Jorge,50,ES96209591234020518195,TRX_N-439-233824664963,2023-04-24T10:08:39,Galdakao,Expense,clothing,-93.62,161929.49
buyer_4,Jorge,50,ES96209591234020518195,TRX_N-44-556458114595,2020-05-01T15:53:56,Galdakao,transfer,Salary,2713.55,21035.89
buyer_4,Jorge,50,ES96209591234020518195,TRX_N-440-833692419964,2023-04-29T09:57:55,Galdakao,Expense,healthcare,-224.6,161704.89
buyer_4,Jorge,50,ES96209591234020518195,TRX_N-441-540997197718,2023-05-01T12:50:30,Galdakao,transfer,Salary,2713.55,164418.44
buyer_4,Jorge,50,ES96209591234020518195,TRX_N-442-842214536137,2023-05-01T12:50:30,Galdakao,transfer,Partner Salary,2734.53,167152.97
buyer_4,Jorge,50,ES96209591234020518195,TRX_N-443-307794109127,2023-05-01T12:50:30,Galdakao,transfer,Extra Income,271.36,167424.33
buyer_4,Jorge,50,ES96209591234020518195,TRX_N-444-474164999137,2023-05-05T14:34:57,Galdakao,Housing,Mortgage,-648.39,166775.94
buyer_4,Jorge,50,ES96209591234020518195,TRX_N-445-235165849668,2023-05-05T12:59:02,Galdakao,Basic services,gas,-89.07,166686.87
buyer_4,Jorge,50,ES96209591234020518195,TRX_N-446-421370383469,2023-05-05T09:18:49,Galdakao,Basic services,internet,-79.76,166607.11
buyer_4,Jorge,50,ES96209591234020518195,TRX_N-447-156616483741,2023-05-06T09:18:05,Galdakao,Basic services,gas,-62.19,166544.92
buyer_4,Jorge,50,ES96209591234020518195,TRX_N-448-674373096032,2023-05-06T13:13:36,Galdakao,Basic services,phone,-32.16,166512.76
buyer_4,Jorge,50,ES96209591234020518195,TRX_N-449-517119491538,2023-05-07T20:41:41,Galdakao,Basic services,gas,-36.67,166476.09
buyer_4,Jorge,50,ES96209591234020518195,TRX_N-45-247993574918,2020-05-01T15:53:56,Galdakao,transfer,Partner Salary,2734.53,23770.42
buyer_4,Jorge,50,ES96209591234020518195,TRX_N-450-501479786919,2023-05-07T09:30:52,Galdakao,Basic services,internet,-45.91,166430.18
buyer_4,Jorge,50,ES96209591234020518195,TRX_N-451-786641756038,2023-05-09T18:31:45,Galdakao,Expense,healthcare,-201.73,166228.45
buyer_4,Jorge,50,ES96209591234020518195,TRX_N-452-201872607959,2023-05-12T14:53:52,Galdakao,Expense,travel,-1433.55,164794.9
buyer_4,Jorge,50,ES96209591234020518195,TRX_N-453-742995195921,2023-05-25T16:58:37,Galdakao,Expense,transport,-24.0,164770.9
buyer_4,Jorge,50,ES96209591234020518195,TRX_N-454-750824042910,2023-06-01T19:17:28,Galdakao,transfer,Salary,2713.55,167484.45
buyer_4,Jorge,50,ES96209591234020518195,TRX_N-455-487377889717,2023-06-01T19:17:28,Galdakao,transfer,Partner Salary,2734.53,170218.98
buyer_4,Jorge,50,ES96209591234020518195,TRX_N-456-599106055351,2023-06-01T19:17:28,Galdakao,transfer,Bonus,2870.95,173089.93
buyer_4,Jorge,50,ES96209591234020518195,TRX_N-457-753584523678,2023-06-05T13:11:22,Galdakao,Housing,Mortgage,-648.39,172441.54
buyer_4,Jorge,50,ES96209591234020518195,TRX_N-458-894749509830,2023-06-05T19:17:47,Galdakao,Basic services,water,-25.47,172416.07
buyer_4,Jorge,50,ES96209591234020518195,TRX_N-459-331117932618,2023-06-05T15:55:02,Galdakao,Basic services,gas,-75.26,172340.81
buyer_4,Jorge,50,ES96209591234020518195,TRX_N-46-15081579293,2020-05-02T19:31:03,Galdakao,Expense,food,-466.03,23304.39
buyer_4,Jorge,50,ES96209591234020518195,TRX_N-460-386277589857,2023-06-06T22:50:15,Galdakao,Basic services,water,-34.5,172306.31
buyer_4,Jorge,50,ES96209591234020518195,TRX_N-461-436335931305,2023-06-06T15:35:03,Galdakao,Basic services,gas,-71.41,172234.9
buyer_4,Jorge,50,ES96209591234020518195,TRX_N-462-546450847196,2023-06-06T15:37:15,Galdakao,Basic services,internet,-61.04,172173.86
buyer_4,Jorge,50,ES96209591234020518195,TRX_N-463-906965218487,2023-06-16T06:57:58,Galdakao,Expense,gifts,-345.82,171828.04
buyer_4,Jorge,50,ES96209591234020518195,TRX_N-464-978003248129,2023-07-01T18:40:29,Galdakao,transfer,Salary,2713.55,174541.59
buyer_4,Jorge,50,ES96209591234020518195,TRX_N-465-626042828581,2023-07-01T18:40:29,Galdakao,transfer,Partner Salary,2734.53,177276.12
buyer_4,Jorge,50,ES96209591234020518195,TRX_N-466-767232384330,2023-07-01T18:40:29,Galdakao,transfer,Extra Income,271.36,177547.48
buyer_4,Jorge,50,ES96209591234020518195,TRX_N-467-289629049540,2023-07-05T13:10:03,Galdakao,Housing,Mortgage,-648.39,176899.09
buyer_4,Jorge,50,ES96209591234020518195,TRX_N-468-607089084433,2023-07-05T09:31:45,Galdakao,Basic services,water,-43.72,176855.37
buyer_4,Jorge,50,ES96209591234020518195,TRX_N-469-253098567136,2023-07-05T13:53:53,Galdakao,Basic services,gas,-21.68,176833.69
buyer_4,Jorge,50,ES96209591234020518195,TRX_N-47-328854999018,2020-05-05T15:41:34,Galdakao,Housing,Mortgage,-648.39,22656.0
buyer_4,Jorge,50,ES96209591234020518195,TRX_N-470-588139878811,2023-07-06T14:35:37,Galdakao,Basic services,internet,-54.83,176778.86
buyer_4,Jorge,50,ES96209591234020518195,TRX_N-471-469253185678,2023-07-07T20:19:46,Galdakao,Basic services,gas,-22.12,176756.74
buyer_4,Jorge,50,ES96209591234020518195,TRX_N-472-640373843444,2023-07-07T14:52:53,Galdakao,Expense,food,-478.25,176278.49
buyer_4,Jorge,50,ES96209591234020518195,TRX_N-473-459925060777,2023-07-07T18:29:38,Galdakao,Expense,transport,-58.05,176220.44
buyer_4,Jorge,50,ES96209591234020518195,TRX_N-474-427059442873,2023-08-01T09:01:49,Galdakao,transfer,Salary,2713.55,178933.99
buyer_4,Jorge,50,ES96209591234020518195,TRX_N-475-924000537065,2023-08-01T09:01:49,Galdakao,transfer,Partner Salary,2734.53,181668.52
buyer_4,Jorge,50,ES96209591234020518195,TRX_N-476-159137259554,2023-08-05T08:32:17,Galdakao,Housing,Mortgage,-648.39,181020.13
buyer_4,Jorge,50,ES96209591234020518195,TRX_N-477-924588137604,2023-08-05T16:44:06,Galdakao,Basic services,water,-76.99,180943.14
buyer_4,Jorge,50,ES96209591234020518195,TRX_N-478-128023459850,2023-08-05T13:50:05,Galdakao,Basic services,electricity,-54.98,180888.16
buyer_4,Jorge,50,ES96209591234020518195,TRX_N-479-618135898930,2023-08-07T21:41:22,Galdakao,Basic services,electricity,-106.0,180782.16
buyer_4,Jorge,50,ES96209591234020518195,TRX_N-48-968156712509,2020-05-05T16:00:51,Galdakao,Basic services,water,-42.64,22613.36
buyer_4,Jorge,50,ES96209591234020518195,TRX_N-480-936034496249,2023-08-08T13:41:00,Galdakao,Expense,clothing,-310.94,180471.22
buyer_4,Jorge,50,ES96209591234020518195,TRX_N-481-670031184032,2023-08-17T16:37:33,Galdakao,Expense,travel,-2119.1,178352.12
buyer_4,Jorge,50,ES96209591234020518195,TRX_N-482-650399265487,2023-08-17T20:06:24,Bermeo,Expense,repairs,-400.98,177951.14
buyer_4,Jorge,50,ES96209591234020518195,TRX_N-483-181724884976,2023-08-21T16:35:57,Galdakao,Expense,leisure,-27.05,177924.09
buyer_4,Jorge,50,ES96209591234020518195,TRX_N-484-628525826070,2023-08-24T21:57:46,Galdakao,Expense,food,-245.52,177678.57
buyer_4,Jorge,50,ES96209591234020518195,TRX_N-485-341051062021,2023-08-25T14:59:42,Galdakao,Expense,transport,-119.75,177558.82
buyer_4,Jorge,50,ES96209591234020518195,TRX_N-486-92799743202,2023-08-26T12:31:52,Alegría-Dulantzi,Expense,food,-428.05,177130.77
buyer_4,Jorge,50,ES96209591234020518195,TRX_N-487-300568214699,2023-09-01T19:09:43,Galdakao,transfer,Salary,2713.55,179844.32
buyer_4,Jorge,50,ES96209591234020518195,TRX_N-488-845659937164,2023-09-01T19:09:43,Galdakao,transfer,Partner Salary,2734.53,182578.85
buyer_4,Jorge,50,ES96209591234020518195,TRX_N-489-742024632906,2023-09-01T19:09:43,Galdakao,transfer,Extra Income,271.36,182850.21
buyer_4,Jorge,50,ES96209591234020518195,TRX_N-49-660543080026,2020-05-05T16:51:33,Galdakao,Basic services,electricity,-88.62,22524.74
buyer_4,Jorge,50,ES96209591234020518195,TRX_N-490-858579388811,2023-09-05T09:34:39,Galdakao,Housing,Mortgage,-648.39,182201.82
buyer_4,Jorge,50,ES96209591234020518195,TRX_N-491-765896423888,2023-09-05T19:17:40,Galdakao,Basic services,water,-73.67,182128.15
buyer_4,Jorge,50,ES96209591234020518195,TRX_N-492-283162398768,2023-09-05T09:12:09,Galdakao,Basic services,electricity,-111.88,182016.27
buyer_4,Jorge,50,ES96209591234020518195,TRX_N-493-189886491845,2023-09-05T19:45:15,Galdakao,Basic services,internet,-35.79,181980.48
buyer_4,Jorge,50,ES96209591234020518195,TRX_N-494-313464937762,2023-09-05T22:02:13,Galdakao,Expense,transport,-132.22,181848.26
buyer_4,Jorge,50,ES96209591234020518195,TRX_N-495-252608018700,2023-09-06T17:07:49,Galdakao,Basic services,electricity,-67.16,181781.1
buyer_4,Jorge,50,ES96209591234020518195,TRX_N-496-783022730457,2023-09-06T01:04:53,Galdakao,Basic services,internet,-71.8,181709.3
buyer_4,Jorge,50,ES96209591234020518195,TRX_N-497-628454472447,2023-09-07T08:03:05,Galdakao,Basic services,gas,-52.41,181656.89
buyer_4,Jorge,50,ES96209591234020518195,TRX_N-498-32901132462,2023-09-07T11:20:03,Galdakao,Basic services,internet,-55.67,181601.22
buyer_4,Jorge,50,ES96209591234020518195,TRX_N-499-350299655987,2023-09-07T12:39:23,Galdakao,Basic services,phone,-31.95,181569.27
buyer_4,Jorge,50,ES96209591234020518195,TRX_N-5-473717102466,2020-01-05T13:47:44,Galdakao,Basic services,water,-17.74,8247.7
buyer_4,Jorge,50,ES96209591234020518195,TRX_N-50-575047045984,2020-05-05T09:47:38,Galdakao,Basic services,gas,-46.88,22477.86
buyer_4,Jorge,50,ES96209591234020518195,TRX_N-500-846196906223,2023-09-22T15:14:58,Galdakao,Expense,transport,-101.08,181468.19
buyer_4,Jorge,50,ES96209591234020518195,TRX_N-501-664161847964,2023-09-26T18:41:38,Galdakao,Expense,food,-495.89,180972.3
buyer_4,Jorge,50,ES96209591234020518195,TRX_N-502-683399686461,2023-09-28T07:00:37,Galdakao,Expense,leisure,-173.54,180798.76
buyer_4,Jorge,50,ES96209591234020518195,TRX_N-503-531044468157,2023-09-29T13:12:36,Galdakao,Expense,clothing,-461.6,180337.16
buyer_4,Jorge,50,ES96209591234020518195,TRX_N-504-493014095981,2023-10-01T20:30:38,Galdakao,transfer,Salary,2713.55,183050.71
buyer_4,Jorge,50,ES96209591234020518195,TRX_N-505-877486759334,2023-10-01T20:30:38,Galdakao,transfer,Partner Salary,2734.53,185785.24
buyer_4,Jorge,50,ES96209591234020518195,TRX_N-506-955439281734,2023-10-03T10:33:01,Zuia,Expense,repairs,-784.01,185001.23
buyer_4,Jorge,50,ES96209591234020518195,TRX_N-507-955503527259,2023-10-05T23:23:38,Galdakao,Housing,Mortgage,-648.39,184352.84
buyer_4,Jorge,50,ES96209591234020518195,TRX_N-508-980171993329,2023-10-05T12:49:43,Galdakao,Basic services,electricity,-24.02,184328.82
buyer_4,Jorge,50,ES96209591234020518195,TRX_N-509-844054416342,2023-10-05T11:13:00,Galdakao,Basic services,gas,-21.81,184307.01
buyer_4,Jorge,50,ES96209591234020518195,TRX_N-51-119179437991,2020-05-07T18:38:52,Galdakao,Basic services,water,-24.48,22453.38
buyer_4,Jorge,50,ES96209591234020518195,TRX_N-510-62522548634,2023-10-06T18:33:45,Galdakao,Basic services,phone,-55.32,184251.69
buyer_4,Jorge,50,ES96209591234020518195,TRX_N-511-686781573665,2023-10-06T15:11:19,Galdakao,Expense,food,-120.82,184130.87
buyer_4,Jorge,50,ES96209591234020518195,TRX_N-512-148137616093,2023-10-06T15:36:34,Galdakao,Expense,clothing,-387.64,183743.23
buyer_4,Jorge,50,ES96209591234020518195,TRX_N-513-723409235755,2023-10-11T19:24:05,Galdakao,Expense,education,-608.82,183134.41
buyer_4,Jorge,50,ES96209591234020518195,TRX_N-514-892265804316,2023-10-12T10:53:35,Erandio,Expense,transport,-82.52,183051.89
buyer_4,Jorge,50,ES96209591234020518195,TRX_N-515-12667951284,2023-10-16T16:17:45,Donostia,Expense,food,-495.13,182556.76
buyer_4,Jorge,50,ES96209591234020518195,TRX_N-516-381860159942,2023-10-21T14:37:02,Llodio,Expense,leisure,-61.09,182495.67
buyer_4,Jorge,50,ES96209591234020518195,TRX_N-517-948198806106,2023-10-30T11:31:21,Galdakao,Expense,food,-453.33,182042.34
buyer_4,Jorge,50,ES96209591234020518195,TRX_N-518-92837799735,2023-11-01T14:22:34,Galdakao,transfer,Salary,2713.55,184755.89
buyer_4,Jorge,50,ES96209591234020518195,TRX_N-519-946424117217,2023-11-01T14:22:34,Galdakao,transfer,Partner Salary,2734.53,187490.42
buyer_4,Jorge,50,ES96209591234020518195,TRX_N-52-913805109848,2020-05-07T14:22:10,Galdakao,Basic services,internet,-64.4,22388.98
buyer_4,Jorge,50,ES96209591234020518195,TRX_N-520-201093503549,2023-11-01T14:22:34,Galdakao,transfer,Extra Income,271.36,187761.78
buyer_4,Jorge,50,ES96209591234020518195,TRX_N-521-36635380747,2023-11-05T16:42:50,Galdakao,Housing,Mortgage,-648.39,187113.39
buyer_4,Jorge,50,ES96209591234020518195,TRX_N-522-845178134420,2023-11-05T08:55:18,Galdakao,Basic services,internet,-79.56,187033.83
buyer_4,Jorge,50,ES96209591234020518195,TRX_N-523-975210686389,2023-11-05T23:15:30,Galdakao,Basic services,phone,-70.5,186963.33
buyer_4,Jorge,50,ES96209591234020518195,TRX_N-524-569739246883,2023-11-06T18:13:26,Galdakao,Basic services,gas,-48.27,186915.06
buyer_4,Jorge,50,ES96209591234020518195,TRX_N-525-383955916568,2023-11-07T06:47:48,Galdakao,Basic services,gas,-16.35,186898.71
buyer_4,Jorge,50,ES96209591234020518195,TRX_N-526-315621569283,2023-11-28T20:13:33,Galdakao,Expense,leisure,-230.47,186668.24
buyer_4,Jorge,50,ES96209591234020518195,TRX_N-527-429831365093,2023-11-29T08:25:27,Galdakao,Expense,leisure,-12.07,186656.17
buyer_4,Jorge,50,ES96209591234020518195,TRX_N-528-685642952149,2023-12-01T16:39:14,Galdakao,transfer,Salary,2713.55,189369.72
buyer_4,Jorge,50,ES96209591234020518195,TRX_N-529-885265067450,2023-12-01T16:39:14,Galdakao,transfer,Partner Salary,2734.53,192104.25
buyer_4,Jorge,50,ES96209591234020518195,TRX_N-53-395463697340,2020-06-01T18:21:33,Galdakao,transfer,Salary,2713.55,25102.53
buyer_4,Jorge,50,ES96209591234020518195,TRX_N-530-895376785381,2023-12-01T16:39:14,Galdakao,transfer,Bonus,2660.89,194765.14
buyer_4,Jorge,50,ES96209591234020518195,TRX_N-531-712455117905,2023-12-05T14:43:30,Galdakao,Housing,Mortgage,-648.39,194116.75
buyer_4,Jorge,50,ES96209591234020518195,TRX_N-532-289395740653,2023-12-05T13:04:44,Galdakao,Basic services,water,-10.71,194106.04
buyer_4,Jorge,50,ES96209591234020518195,TRX_N-533-996348020788,2023-12-05T12:40:43,Galdakao,Basic services,electricity,-106.3,193999.74
buyer_4,Jorge,50,ES96209591234020518195,TRX_N-534-186213654374,2023-12-07T11:20:15,Galdakao,Basic services,water,-59.68,193940.06
buyer_4,Jorge,50,ES96209591234020518195,TRX_N-535-957233603738,2023-12-07T12:56:14,Galdakao,Basic services,gas,-48.97,193891.09
buyer_4,Jorge,50,ES96209591234020518195,TRX_N-536-611627414507,2023-12-07T20:36:23,Galdakao,Basic services,phone,-56.13,193834.96
buyer_4,Jorge,50,ES96209591234020518195,TRX_N-537-400287259173,2023-12-14T13:45:32,Galdakao,Expense,food,-527.37,193307.59
buyer_4,Jorge,50,ES96209591234020518195,TRX_N-538-193921467049,2023-12-16T14:20:18,Galdakao,Expense,food,-722.86,192584.73
buyer_4,Jorge,50,ES96209591234020518195,TRX_N-539-350348173727,2023-12-17T16:00:21,Sestao,Expense,clothing,-360.17,192224.56
buyer_4,Jorge,50,ES96209591234020518195,TRX_N-54-226868145003,2020-06-01T18:21:33,Galdakao,transfer,Partner Salary,2734.53,27837.06
buyer_4,Jorge,50,ES96209591234020518195,TRX_N-540-405430333575,2023-12-19T16:04:54,Galdakao,Expense,transport,-115.36,192109.2
buyer_4,Jorge,50,ES96209591234020518195,TRX_N-541-621641473196,2023-12-19T19:20:53,Galdakao,Expense,leisure,-263.56,191845.64
buyer_4,Jorge,50,ES96209591234020518195,TRX_N-542-543799384550,2024-01-01T00:04:18,Galdakao,transfer,Salary,2713.55,194559.19
buyer_4,Jorge,50,ES96209591234020518195,TRX_N-543-620263235102,2024-01-01T00:04:18,Galdakao,transfer,Partner Salary,2734.53,197293.72
buyer_4,Jorge,50,ES96209591234020518195,TRX_N-544-680415552821,2024-01-05T09:40:52,Galdakao,Housing,Mortgage,-648.39,196645.33
buyer_4,Jorge,50,ES96209591234020518195,TRX_N-545-837128426299,2024-01-06T10:05:45,Galdakao,Basic services,gas,-62.02,196583.31
buyer_4,Jorge,50,ES96209591234020518195,TRX_N-546-192836356529,2024-01-06T15:10:42,Galdakao,Basic services,internet,-32.02,196551.29
buyer_4,Jorge,50,ES96209591234020518195,TRX_N-547-447816138848,2024-01-06T09:07:59,Galdakao,Basic services,phone,-31.16,196520.13
buyer_4,Jorge,50,ES96209591234020518195,TRX_N-548-102440422280,2024-01-07T15:11:52,Galdakao,Basic services,water,-46.0,196474.13
buyer_4,Jorge,50,ES96209591234020518195,TRX_N-549-663360620540,2024-01-07T17:54:22,Galdakao,Basic services,electricity,-145.17,196328.96
buyer_4,Jorge,50,ES96209591234020518195,TRX_N-55-874827213924,2020-06-01T18:21:33,Galdakao,transfer,Extra Income,271.36,28108.42
buyer_4,Jorge,50,ES96209591234020518195,TRX_N-550-828407427299,2024-01-07T00:10:48,Galdakao,Basic services,phone,-78.97,196249.99
buyer_4,Jorge,50,ES96209591234020518195,TRX_N-551-445583050493,2024-01-10T14:05:12,Galdakao,Expense,leisure,-126.35,196123.64
buyer_4,Jorge,50,ES96209591234020518195,TRX_N-552-352162503771,2024-01-13T15:11:23,Galdakao,Expense,education,-299.75,195823.89
buyer_4,Jorge,50,ES96209591234020518195,TRX_N-553-136683456368,2024-01-15T19:04:14,Galdakao,Expense,education,-328.23,195495.66
buyer_4,Jorge,50,ES96209591234020518195,TRX_N-554-647585116767,2024-01-19T19:07:23,Galdakao,Expense,food,-266.45,195229.21
buyer_4,Jorge,50,ES96209591234020518195,TRX_N-555-695329205714,2024-02-01T08:22:14,Galdakao,transfer,Salary,2713.55,197942.76
buyer_4,Jorge,50,ES96209591234020518195,TRX_N-556-839505351118,2024-02-01T08:22:14,Galdakao,transfer,Partner Salary,2734.53,200677.29
buyer_4,Jorge,50,ES96209591234020518195,TRX_N-557-248530002131,2024-02-01T08:22:14,Galdakao,transfer,Extra Income,271.36,200948.65
buyer_4,Jorge,50,ES96209591234020518195,TRX_N-558-612679028695,2024-02-05T22:17:04,Galdakao,Housing,Mortgage,-648.39,200300.26
buyer_4,Jorge,50,ES96209591234020518195,TRX_N-559-229381803362,2024-02-05T15:14:58,Galdakao,Basic services,electricity,-98.29,200201.97
buyer_4,Jorge,50,ES96209591234020518195,TRX_N-56-772003068860,2020-06-01T18:21:33,Galdakao,transfer,Bonus,2835.65,30944.07
buyer_4,Jorge,50,ES96209591234020518195,TRX_N-560-196861774075,2024-02-06T23:13:37,Galdakao,Basic services,electricity,-27.72,200174.25
buyer_4,Jorge,50,ES96209591234020518195,TRX_N-561-640030374535,2024-02-06T13:04:40,Galdakao,Basic services,gas,-31.0,200143.25
buyer_4,Jorge,50,ES96209591234020518195,TRX_N-562-316778487502,2024-02-06T16:07:39,Galdakao,Basic services,internet,-79.38,200063.87
buyer_4,Jorge,50,ES96209591234020518195,TRX_N-563-391358886355,2024-02-06T10:40:13,Galdakao,Basic services,phone,-80.3,199983.57
buyer_4,Jorge,50,ES96209591234020518195,TRX_N-564-502963881905,2024-02-07T06:04:59,Galdakao,Basic services,internet,-46.22,199937.35
buyer_4,Jorge,50,ES96209591234020518195,TRX_N-565-62048318021,2024-02-20T19:09:54,Galdakao,Expense,transport,-169.42,199767.93
buyer_4,Jorge,50,ES96209591234020518195,TRX_N-566-921938728358,2024-02-25T08:53:10,Galdakao,Expense,clothing,-456.93,199311.0
buyer_4,Jorge,50,ES96209591234020518195,TRX_N-567-549848344498,2024-02-29T16:44:21,Galdakao,Expense,leisure,-158.65,199152.35
buyer_4,Jorge,50,ES96209591234020518195,TRX_N-568-937065113180,2024-03-01T02:53:09,Galdakao,transfer,Salary,2713.55,201865.9
buyer_4,Jorge,50,ES96209591234020518195,TRX_N-569-989752685527,2024-03-01T02:53:09,Galdakao,transfer,Partner Salary,2734.53,204600.43
buyer_4,Jorge,50,ES96209591234020518195,TRX_N-57-459471339914,2020-06-05T14:20:39,Galdakao,Housing,Mortgage,-648.39,30295.68
buyer_4,Jorge,50,ES96209591234020518195,TRX_N-570-124399131442,2024-03-05T19:02:59,Galdakao,Housing,Mortgage,-648.39,203952.04
buyer_4,Jorge,50,ES96209591234020518195,TRX_N-571-615614255505,2024-03-05T11:15:27,Galdakao,Basic services,electricity,-146.12,203805.92
buyer_4,Jorge,50,ES96209591234020518195,TRX_N-572-356414628052,2024-03-05T19:44:19,Galdakao,Basic services,gas,-60.44,203745.48
buyer_4,Jorge,50,ES96209591234020518195,TRX_N-573-213483546521,2024-03-05T13:12:31,Galdakao,Basic services,internet,-61.33,203684.15
buyer_4,Jorge,50,ES96209591234020518195,TRX_N-574-319501357350,2024-03-06T16:24:07,Galdakao,Basic services,water,-16.45,203667.7
buyer_4,Jorge,50,ES96209591234020518195,TRX_N-575-319842588635,2024-03-07T09:10:18,Galdakao,Basic services,internet,-38.71,203628.99
buyer_4,Jorge,50,ES96209591234020518195,TRX_N-576-332461018220,2024-03-23T18:25:56,Galdakao,Expense,transport,-27.91,203601.08
buyer_4,Jorge,50,ES96209591234020518195,TRX_N-577-378771931884,2024-03-24T13:38:42,Galdakao,Expense,repairs,-560.68,203040.4
buyer_4,Jorge,50,ES96209591234020518195,TRX_N-578-222993827937,2024-03-27T05:04:13,Galdakao,Expense,gifts,-216.04,202824.36
buyer_4,Jorge,50,ES96209591234020518195,TRX_N-579-298147202352,2024-04-01T10:12:34,Galdakao,transfer,Salary,2713.55,205537.91
buyer_4,Jorge,50,ES96209591234020518195,TRX_N-58-286070718614,2020-06-05T20:22:10,Galdakao,Basic services,water,-61.01,30234.67
buyer_4,Jorge,50,ES96209591234020518195,TRX_N-580-650228085531,2024-04-01T10:12:34,Galdakao,transfer,Partner Salary,2734.53,208272.44
buyer_4,Jorge,50,ES96209591234020518195,TRX_N-581-984910959363,2024-04-05T17:51:18,Galdakao,Housing,Mortgage,-648.39,207624.05
buyer_4,Jorge,50,ES96209591234020518195,TRX_N-582-940801943732,2024-04-05T09:14:52,Galdakao,Basic services,internet,-51.32,207572.73
buyer_4,Jorge,50,ES96209591234020518195,TRX_N-583-196077125443,2024-04-05T23:19:11,Getxo,Expense,leisure,-128.74,207443.99
buyer_4,Jorge,50,ES96209591234020518195,TRX_N-584-114627199928,2024-04-07T20:24:37,Galdakao,Basic services,water,-15.52,207428.47
buyer_4,Jorge,50,ES96209591234020518195,TRX_N-585-192738373448,2024-04-07T08:28:16,Galdakao,Basic services,electricity,-20.62,207407.85
buyer_4,Jorge,50,ES96209591234020518195,TRX_N-586-871785027104,2024-04-07T17:39:44,Galdakao,Basic services,internet,-78.21,207329.64
buyer_4,Jorge,50,ES96209591234020518195,TRX_N-587-234507925012,2024-04-07T14:30:46,Galdakao,Basic services,phone,-47.27,207282.37
buyer_4,Jorge,50,ES96209591234020518195,TRX_N-588-745126110728,2024-04-17T17:15:59,Galdakao,Expense,food,-664.15,206618.22
buyer_4,Jorge,50,ES96209591234020518195,TRX_N-589-944536523735,2024-04-21T15:03:11,Galdakao,Expense,leisure,-82.51,206535.71
buyer_4,Jorge,50,ES96209591234020518195,TRX_N-59-66939038932,2020-06-05T11:49:41,Galdakao,Basic services,internet,-56.22,30178.45
buyer_4,Jorge,50,ES96209591234020518195,TRX_N-590-598466605249,2024-05-01T13:19:21,Galdakao,transfer,Salary,2713.55,209249.26
buyer_4,Jorge,50,ES96209591234020518195,TRX_N-591-703412373084,2024-05-01T13:19:21,Galdakao,transfer,Partner Salary,2734.53,211983.79
buyer_4,Jorge,50,ES96209591234020518195,TRX_N-592-791230292380,2024-05-01T13:19:21,Galdakao,transfer,Extra Income,271.36,212255.15
buyer_4,Jorge,50,ES96209591234020518195,TRX_N-593-782755086923,2024-05-05T13:36:10,Galdakao,Housing,Mortgage,-648.39,211606.76
buyer_4,Jorge,50,ES96209591234020518195,TRX_N-594-331920975965,2024-05-05T21:44:03,Galdakao,Basic services,gas,-38.11,211568.65
buyer_4,Jorge,50,ES96209591234020518195,TRX_N-595-758287120905,2024-05-06T14:11:53,Galdakao,Basic services,water,-36.01,211532.64
buyer_4,Jorge,50,ES96209591234020518195,TRX_N-596-967583301371,2024-05-07T14:01:31,Galdakao,Basic services,gas,-32.01,211500.63
buyer_4,Jorge,50,ES96209591234020518195,TRX_N-597-548318984288,2024-05-26T12:56:54,Lasarte-Oria,Expense,transport,-49.99,211450.64
buyer_4,Jorge,50,ES96209591234020518195,TRX_N-598-146480950170,2024-06-01T20:02:52,Galdakao,transfer,Salary,2713.55,214164.19
buyer_4,Jorge,50,ES96209591234020518195,TRX_N-599-641733162220,2024-06-01T20:02:52,Galdakao,transfer,Partner Salary,2734.53,216898.72
buyer_4,Jorge,50,ES96209591234020518195,TRX_N-6-383838419650,2020-01-05T13:31:47,Galdakao,Basic services,gas,-30.11,8217.59
buyer_4,Jorge,50,ES96209591234020518195,TRX_N-60-795664586713,2020-06-07T14:25:19,Galdakao,Basic services,water,-13.04,30165.41
buyer_4,Jorge,50,ES96209591234020518195,TRX_N-600-763516762304,2024-06-01T20:02:52,Galdakao,transfer,Bonus,2934.66,219833.38
buyer_4,Jorge,50,ES96209591234020518195,TRX_N-601-25119493407,2024-06-05T19:18:33,Galdakao,Housing,Mortgage,-648.39,219184.99
buyer_4,Jorge,50,ES96209591234020518195,TRX_N-602-550408123109,2024-06-05T08:01:34,Galdakao,Basic services,gas,-53.3,219131.69
buyer_4,Jorge,50,ES96209591234020518195,TRX_N-603-638393279227,2024-06-05T17:53:34,Galdakao,Basic services,internet,-34.08,219097.61
buyer_4,Jorge,50,ES96209591234020518195,TRX_N-604-123526664573,2024-06-05T16:51:42,Galdakao,Basic services,phone,-100.0,218997.61
buyer_4,Jorge,50,ES96209591234020518195,TRX_N-605-565761737103,2024-06-05T08:32:16,Galdakao,Expense,repairs,-310.17,218687.44
buyer_4,Jorge,50,ES96209591234020518195,TRX_N-606-89910337703,2024-06-06T18:16:36,Galdakao,Basic services,water,-29.19,218658.25
buyer_4,Jorge,50,ES96209591234020518195,TRX_N-607-167712305040,2024-06-06T02:53:25,Galdakao,Basic services,electricity,-103.16,218555.09
buyer_4,Jorge,50,ES96209591234020518195,TRX_N-608-173312075630,2024-06-06T17:05:35,Galdakao,Basic services,phone,-62.17,218492.92
buyer_4,Jorge,50,ES96209591234020518195,TRX_N-609-911251556254,2024-06-07T06:10:26,Galdakao,Basic services,water,-57.52,218435.4
buyer_4,Jorge,50,ES96209591234020518195,TRX_N-61-375196272148,2020-06-07T19:54:40,Galdakao,Basic services,electricity,-58.37,30107.04
buyer_4,Jorge,50,ES96209591234020518195,TRX_N-610-809541890598,2024-06-07T20:37:30,Galdakao,Basic services,electricity,-127.5,218307.9
buyer_4,Jorge,50,ES96209591234020518195,TRX_N-611-368606504336,2024-06-11T12:41:27,Galdakao,Expense,education,-206.39,218101.51
buyer_4,Jorge,50,ES96209591234020518195,TRX_N-612-71992881257,2024-06-28T11:39:28,Getxo,Expense,leisure,-131.92,217969.59
buyer_4,Jorge,50,ES96209591234020518195,TRX_N-613-939375749051,2024-06-29T17:05:24,Galdakao,Expense,travel,-1126.91,216842.68
buyer_4,Jorge,50,ES96209591234020518195,TRX_N-614-561217281210,2024-07-01T23:54:56,Galdakao,transfer,Salary,2713.55,219556.23
buyer_4,Jorge,50,ES96209591234020518195,TRX_N-615-929387465133,2024-07-01T23:54:56,Galdakao,transfer,Partner Salary,2734.53,222290.76
buyer_4,Jorge,50,ES96209591234020518195,TRX_N-616-865053136579,2024-07-05T13:35:07,Galdakao,Housing,Mortgage,-648.39,221642.37
buyer_4,Jorge,50,ES96209591234020518195,TRX_N-617-43650443099,2024-07-06T10:54:08,Galdakao,Basic services,gas,-76.21,221566.16
buyer_4,Jorge,50,ES96209591234020518195,TRX_N-618-884085445614,2024-07-06T08:55:32,Galdakao,Basic services,phone,-87.92,221478.24
buyer_4,Jorge,50,ES96209591234020518195,TRX_N-619-480449452476,2024-07-07T23:44:56,Galdakao,Basic services,water,-44.6,221433.64
buyer_4,Jorge,50,ES96209591234020518195,TRX_N-62-591033049327,2020-06-07T12:33:01,Galdakao,Basic services,gas,-40.08,30066.96
buyer_4,Jorge,50,ES96209591234020518195,TRX_N-620-892221589801,2024-07-07T09:09:52,Galdakao,Basic services,gas,-23.04,221410.6
buyer_4,Jorge,50,ES96209591234020518195,TRX_N-621-807911265617,2024-07-07T08:33:14,Galdakao,Expense,leisure,-230.71,221179.89
buyer_4,Jorge,50,ES96209591234020518195,TRX_N-622-711047609776,2024-07-17T12:45:11,Galdakao,Expense,transport,-70.06,221109.83
buyer_4,Jorge,50,ES96209591234020518195,TRX_N-623-60972073089,2024-07-27T23:05:26,Galdakao,Expense,food,-141.03,220968.8
buyer_4,Jorge,50,ES96209591234020518195,TRX_N-624-986278723153,2024-08-01T16:14:05,Galdakao,transfer,Salary,2713.55,223682.35
buyer_4,Jorge,50,ES96209591234020518195,TRX_N-625-274417665424,2024-08-01T16:14:05,Galdakao,transfer,Partner Salary,2734.53,226416.88
buyer_4,Jorge,50,ES96209591234020518195,TRX_N-626-772071334781,2024-08-01T16:14:05,Galdakao,transfer,Extra Income,271.36,226688.24
buyer_4,Jorge,50,ES96209591234020518195,TRX_N-627-746134544021,2024-08-05T19:06:02,Galdakao,Housing,Mortgage,-648.39,226039.85
buyer_4,Jorge,50,ES96209591234020518195,TRX_N-628-575730090847,2024-08-06T20:56:55,Galdakao,Basic services,water,-21.26,226018.59
buyer_4,Jorge,50,ES96209591234020518195,TRX_N-629-652168279546,2024-08-06T14:04:31,Galdakao,Basic services,electricity,-117.18,225901.41
buyer_4,Jorge,50,ES96209591234020518195,TRX_N-63-95259809271,2020-06-10T10:15:01,Basauri,Expense,transport,-181.25,29885.71
buyer_4,Jorge,50,ES96209591234020518195,TRX_N-630-78553427728,2024-08-07T23:04:56,Galdakao,Basic services,gas,-55.02,225846.39
buyer_4,Jorge,50,ES96209591234020518195,TRX_N-631-48515346943,2024-08-27T12:12:40,Galdakao,Expense,clothing,-284.83,225561.56
buyer_4,Jorge,50,ES96209591234020518195,TRX_N-632-165059271500,2024-08-28T15:50:58,Portugalete,Expense,leisure,-174.91,225386.65
buyer_4,Jorge,50,ES96209591234020518195,TRX_N-633-252575924816,2024-09-01T14:47:26,Galdakao,transfer,Salary,2713.55,228100.2
buyer_4,Jorge,50,ES96209591234020518195,TRX_N-634-656285516809,2024-09-01T14:47:26,Galdakao,transfer,Partner Salary,2734.53,230834.73
buyer_4,Jorge,50,ES96209591234020518195,TRX_N-635-757208505767,2024-09-05T18:08:05,Galdakao,Housing,Mortgage,-648.39,230186.34
buyer_4,Jorge,50,ES96209591234020518195,TRX_N-636-895135827512,2024-09-06T23:21:03,Galdakao,Basic services,water,-56.74,230129.6
buyer_4,Jorge,50,ES96209591234020518195,TRX_N-637-940979900453,2024-09-07T09:46:13,Galdakao,Basic services,electricity,-124.95,230004.65
buyer_4,Jorge,50,ES96209591234020518195,TRX_N-638-634456163441,2024-09-08T17:49:47,Galdakao,Expense,transport,-126.28,229878.37
buyer_4,Jorge,50,ES96209591234020518195,TRX_N-639-500641215005,2024-09-12T08:33:17,Galdakao,Expense,clothing,-79.2,229799.17
buyer_4,Jorge,50,ES96209591234020518195,TRX_N-64-203202495899,2020-06-16T16:06:58,Galdakao,Expense,food,-278.68,29607.03
buyer_4,Jorge,50,ES96209591234020518195,TRX_N-640-574491455773,2024-09-16T03:17:45,Zarautz,Expense,education,-286.08,229513.09
buyer_4,Jorge,50,ES96209591234020518195,TRX_N-641-62719923357,2024-10-01T18:06:09,Galdakao,transfer,Salary,2713.55,232226.64
buyer_4,Jorge,50,ES96209591234020518195,TRX_N-642-832265995497,2024-10-01T18:06:09,Galdakao,transfer,Partner Salary,2734.53,234961.17
buyer_4,Jorge,50,ES96209591234020518195,TRX_N-643-804202432736,2024-10-01T18:06:09,Galdakao,transfer,Extra Income,271.36,235232.53
buyer_4,Jorge,50,ES96209591234020518195,TRX_N-644-543397892750,2024-10-05T18:51:30,Galdakao,Housing,Mortgage,-648.39,234584.14
buyer_4,Jorge,50,ES96209591234020518195,TRX_N-645-949456122626,2024-10-05T22:32:09,Galdakao,Basic services,water,-53.15,234530.99
buyer_4,Jorge,50,ES96209591234020518195,TRX_N-646-969959593653,2024-10-05T13:05:50,Galdakao,Basic services,gas,-24.42,234506.57
buyer_4,Jorge,50,ES96209591234020518195,TRX_N-647-867857180562,2024-10-07T04:44:22,Galdakao,Basic services,water,-68.58,234437.99
buyer_4,Jorge,50,ES96209591234020518195,TRX_N-648-106019248548,2024-10-07T14:21:33,Galdakao,Basic services,electricity,-59.76,234378.23
buyer_4,Jorge,50,ES96209591234020518195,TRX_N-65-465487799077,2020-06-26T19:15:43,Galdakao,Expense,leisure,-106.01,29501.02
buyer_4,Jorge,50,ES96209591234020518195,TRX_N-66-596446910690,2020-07-01T16:08:17,Galdakao,transfer,Salary,2713.55,32214.57
buyer_4,Jorge,50,ES96209591234020518195,TRX_N-67-913858164420,2020-07-01T16:08:17,Galdakao,transfer,Partner Salary,2734.53,34949.1
buyer_4,Jorge,50,ES96209591234020518195,TRX_N-68-776474971229,2020-07-05T09:06:34,Galdakao,Housing,Mortgage,-648.39,34300.71
buyer_4,Jorge,50,ES96209591234020518195,TRX_N-69-546790332327,2020-07-05T08:07:13,Galdakao,Basic services,water,-23.46,34277.25
buyer_4,Jorge,50,ES96209591234020518195,TRX_N-7-670999708281,2020-01-06T10:57:54,Galdakao,Basic services,gas,-78.06,8139.53
buyer_4,Jorge,50,ES96209591234020518195,TRX_N-70-364168832545,2020-07-05T20:04:36,Galdakao,Basic services,internet,-58.2,34219.05
buyer_4,Jorge,50,ES96209591234020518195,TRX_N-71-24406030255,2020-07-06T20:45:52,Galdakao,Basic services,water,-11.94,34207.11
buyer_4,Jorge,50,ES96209591234020518195,TRX_N-72-850537392940,2020-07-06T21:46:14,Galdakao,Expense,food,-599.27,33607.84
buyer_4,Jorge,50,ES96209591234020518195,TRX_N-73-82121703390,2020-07-07T13:56:04,Galdakao,Basic services,electricity,-107.69,33500.15
buyer_4,Jorge,50,ES96209591234020518195,TRX_N-74-312836508883,2020-07-07T15:55:45,Galdakao,Basic services,gas,-22.2,33477.95
buyer_4,Jorge,50,ES96209591234020518195,TRX_N-75-973054162482,2020-07-07T12:38:44,Galdakao,Basic services,phone,-27.74,33450.21
buyer_4,Jorge,50,ES96209591234020518195,TRX_N-76-868065659480,2020-07-10T15:34:11,Galdakao,Expense,healthcare,-99.72,33350.49
buyer_4,Jorge,50,ES96209591234020518195,TRX_N-77-814274912962,2020-07-22T11:26:51,Galdakao,Expense,food,-519.03,32831.46
buyer_4,Jorge,50,ES96209591234020518195,TRX_N-78-130494701902,2020-08-01T18:38:40,Galdakao,transfer,Salary,2713.55,35545.01
buyer_4,Jorge,50,ES96209591234020518195,TRX_N-79-494105649102,2020-08-01T18:38:40,Galdakao,transfer,Partner Salary,2734.53,38279.54
buyer_4,Jorge,50,ES96209591234020518195,TRX_N-8-567573862081,2020-01-06T16:54:56,Galdakao,Basic services,internet,-55.41,8084.12
buyer_4,Jorge,50,ES96209591234020518195,TRX_N-80-220191280583,2020-08-05T00:35:10,Galdakao,Housing,Mortgage,-648.39,37631.15
buyer_4,Jorge,50,ES96209591234020518195,TRX_N-81-867050308174,2020-08-05T17:25:12,Galdakao,Basic services,water,-31.47,37599.68
buyer_4,Jorge,50,ES96209591234020518195,TRX_N-82-527611338596,2020-08-05T11:37:27,Galdakao,Expense,gifts,-133.88,37465.8
buyer_4,Jorge,50,ES96209591234020518195,TRX_N-83-100053797849,2020-08-06T15:34:39,Galdakao,Basic services,water,-75.93,37389.87
buyer_4,Jorge,50,ES96209591234020518195,TRX_N-84-308587201674,2020-08-06T18:21:07,Galdakao,Basic services,electricity,-148.1,37241.77
buyer_4,Jorge,50,ES96209591234020518195,TRX_N-85-308344773167,2020-08-07T18:25:14,Galdakao,Basic services,internet,-52.92,37188.85
buyer_4,Jorge,50,ES96209591234020518195,TRX_N-86-805170576633,2020-08-13T12:43:16,Galdakao,Expense,gifts,-468.61,36720.24
buyer_4,Jorge,50,ES96209591234020518195,TRX_N-87-141315828938,2020-08-22T14:44:28,Bermeo,Expense,transport,-81.09,36639.15
buyer_4,Jorge,50,ES96209591234020518195,TRX_N-88-715144866700,2020-08-26T19:02:31,Galdakao,Expense,transport,-157.07,36482.08
buyer_4,Jorge,50,ES96209591234020518195,TRX_N-89-321866414836,2020-09-01T16:52:20,Galdakao,transfer,Salary,2713.55,39195.63
buyer_4,Jorge,50,ES96209591234020518195,TRX_N-9-23371071288,2020-01-07T08:11:50,Galdakao,Basic services,water,-42.11,8042.01
buyer_4,Jorge,50,ES96209591234020518195,TRX_N-90-295844497029,2020-09-01T16:52:20,Galdakao,transfer,Partner Salary,2734.53,41930.16
buyer_4,Jorge,50,ES96209591234020518195,TRX_N-91-180666946771,2020-09-01T16:52:20,Galdakao,transfer,Extra Income,271.36,42201.52
buyer_4,Jorge,50,ES96209591234020518195,TRX_N-92-505128111385,2020-09-05T13:09:38,Galdakao,Housing,Mortgage,-648.39,41553.13
buyer_4,Jorge,50,ES96209591234020518195,TRX_N-93-627465160382,2020-09-05T10:58:03,Galdakao,Basic services,water,-48.27,41504.86
buyer_4,Jorge,50,ES96209591234020518195,TRX_N-94-216907789455,2020-09-05T13:30:41,Galdakao,Basic services,gas,-34.62,41470.24
buyer_4,Jorge,50,ES96209591234020518195,TRX_N-95-660924615933,2020-09-05T18:00:43,Galdakao,Expense,transport,-31.0,41439.24
buyer_4,Jorge,50,ES96209591234020518195,TRX_N-96-475934054587,2020-09-06T22:20:26,Galdakao,Basic services,gas,-25.83,41413.41
buyer_4,Jorge,50,ES96209591234020518195,TRX_N-97-473978296742,2020-09-06T09:54:14,Eibar,Expense,food,-212.97,41200.44
buyer_4,Jorge,50,ES96209591234020518195,TRX_N-98-405673480809,2020-09-25T18:10:14,Galdakao,Expense,transport,-138.98,41061.46
buyer_4,Jorge,50,ES96209591234020518195,TRX_N-99-738363880410,2020-10-01T20:10:45,Galdakao,transfer,Salary,2713.55,43775.01
buyer_5,Sara,30,ES72209552827491055369,TRX_N-1-753620482424,2020-01-01T18:57:20,Donostia,transfer,Salary,3359.75,21186.49
buyer_5,Sara,30,ES72209552827491055369,TRX_N-10-851772209402,2020-01-07T16:26:30,Donostia,Basic services,gas,-98.18,22009.95
buyer_5,Sara,30,ES72209552827491055369,TRX_N-100-812036664989,2020-08-26T14:17:25,Getxo,Expense,transport,-31.69,46646.17
buyer_5,Sara,30,ES72209552827491055369,TRX_N-101-589883882210,2020-08-27T02:02:19,Donostia,Expense,food,-274.3,46371.87
buyer_5,Sara,30,ES72209552827491055369,TRX_N-102-590931661397,2020-08-30T18:05:04,Donostia,Expense,food,-257.22,46114.65
buyer_5,Sara,30,ES72209552827491055369,TRX_N-103-357878537673,2020-09-01T13:06:10,Donostia,transfer,Salary,3359.75,49474.4
buyer_5,Sara,30,ES72209552827491055369,TRX_N-104-366763950305,2020-09-01T13:06:10,Donostia,transfer,Partner Salary,3407.23,52881.63
buyer_5,Sara,30,ES72209552827491055369,TRX_N-105-238059062855,2020-09-02T09:29:56,Donostia,Expense,healthcare,-30.46,52851.17
buyer_5,Sara,30,ES72209552827491055369,TRX_N-106-12277767390,2020-09-03T10:00:59,Donostia,Expense,leisure,-45.67,52805.5
buyer_5,Sara,30,ES72209552827491055369,TRX_N-107-507720177778,2020-09-05T20:27:02,Donostia,Housing,Mortgage,-1902.5,50903.0
buyer_5,Sara,30,ES72209552827491055369,TRX_N-108-141122997839,2020-09-05T10:53:40,Donostia,Expense,transport,-55.64,50847.36
buyer_5,Sara,30,ES72209552827491055369,TRX_N-109-525429112748,2020-09-06T18:50:00,Donostia,Basic services,gas,-23.32,50824.04
buyer_5,Sara,30,ES72209552827491055369,TRX_N-11-698746919646,2020-01-21T09:58:34,Bermeo,Expense,gifts,-224.77,21785.18
buyer_5,Sara,30,ES72209552827491055369,TRX_N-110-652655221696,2020-09-06T14:17:53,Donostia,Basic services,phone,-81.3,50742.74
buyer_5,Sara,30,ES72209552827491055369,TRX_N-111-589613648330,2020-09-07T22:04:28,Donostia,Basic services,gas,-51.08,50691.66
buyer_5,Sara,30,ES72209552827491055369,TRX_N-112-585542920960,2020-09-07T08:52:31,Donostia,Basic services,internet,-66.06,50625.6
buyer_5,Sara,30,ES72209552827491055369,TRX_N-113-832416057617,2020-09-07T14:00:53,Donostia,Basic services,phone,-88.79,50536.81
buyer_5,Sara,30,ES72209552827491055369,TRX_N-114-743713479147,2020-09-09T17:21:25,Donostia,Expense,transport,-112.37,50424.44
buyer_5,Sara,30,ES72209552827491055369,TRX_N-115-362140463414,2020-09-16T17:24:48,Donostia,Expense,transport,-135.87,50288.57
buyer_5,Sara,30,ES72209552827491055369,TRX_N-116-119341098935,2020-09-20T18:10:30,Donostia,Expense,food,-319.07,49969.5
buyer_5,Sara,30,ES72209552827491055369,TRX_N-117-857560909661,2020-09-23T12:45:07,Donostia,Expense,leisure,-161.6,49807.9
buyer_5,Sara,30,ES72209552827491055369,TRX_N-118-179911379404,2020-09-24T10:32:58,Donostia,Expense,food,-720.75,49087.15
buyer_5,Sara,30,ES72209552827491055369,TRX_N-119-581058534697,2020-10-01T08:16:22,Donostia,transfer,Salary,3359.75,52446.9
buyer_5,Sara,30,ES72209552827491055369,TRX_N-12-487822260863,2020-01-22T11:23:45,Donostia,Expense,appliances,-1899.35,19885.83
buyer_5,Sara,30,ES72209552827491055369,TRX_N-120-76027976938,2020-10-01T08:16:22,Donostia,transfer,Partner Salary,3407.23,55854.13
buyer_5,Sara,30,ES72209552827491055369,TRX_N-121-161429744622,2020-10-01T08:16:22,Donostia,transfer,Extra Income,335.98,56190.11
buyer_5,Sara,30,ES72209552827491055369,TRX_N-122-921704102526,2020-10-05T23:39:45,Donostia,Housing,Mortgage,-1902.5,54287.61
buyer_5,Sara,30,ES72209552827491055369,TRX_N-123-972178649481,2020-10-06T17:18:24,Donostia,Basic services,gas,-69.7,54217.91
buyer_5,Sara,30,ES72209552827491055369,TRX_N-124-497332795121,2020-10-07T19:09:28,Donostia,Basic services,water,-63.65,54154.26
buyer_5,Sara,30,ES72209552827491055369,TRX_N-125-285058954399,2020-10-07T19:21:41,Donostia,Basic services,electricity,-93.82,54060.44
buyer_5,Sara,30,ES72209552827491055369,TRX_N-126-129357501396,2020-10-07T15:25:54,Donostia,Basic services,internet,-39.29,54021.15
buyer_5,Sara,30,ES72209552827491055369,TRX_N-127-310535101930,2020-10-22T15:07:41,Donostia,Expense,transport,-76.6,53944.55
buyer_5,Sara,30,ES72209552827491055369,TRX_N-128-820530821870,2020-10-23T08:03:17,Donostia,Expense,travel,-941.01,53003.54
buyer_5,Sara,30,ES72209552827491055369,TRX_N-129-735833218289,2020-11-01T16:36:39,Donostia,transfer,Salary,3359.75,56363.29
buyer_5,Sara,30,ES72209552827491055369,TRX_N-13-890542970222,2020-01-25T15:01:30,Donostia,Expense,gifts,-430.55,19455.28
buyer_5,Sara,30,ES72209552827491055369,TRX_N-130-11217288628,2020-11-01T16:36:39,Donostia,transfer,Partner Salary,3407.23,59770.52
buyer_5,Sara,30,ES72209552827491055369,TRX_N-131-387509487733,2020-11-05T12:38:53,Donostia,Housing,Mortgage,-1902.5,57868.02
buyer_5,Sara,30,ES72209552827491055369,TRX_N-132-245176329658,2020-11-05T17:29:35,Donostia,Basic services,water,-12.14,57855.88
buyer_5,Sara,30,ES72209552827491055369,TRX_N-133-693802344942,2020-11-05T19:53:29,Donostia,Basic services,electricity,-61.16,57794.72
buyer_5,Sara,30,ES72209552827491055369,TRX_N-134-33390154747,2020-11-05T15:04:33,Donostia,Basic services,internet,-46.98,57747.74
buyer_5,Sara,30,ES72209552827491055369,TRX_N-135-984158241135,2020-11-06T10:33:29,Donostia,Basic services,gas,-78.31,57669.43
buyer_5,Sara,30,ES72209552827491055369,TRX_N-136-170466606336,2020-11-07T10:30:31,Donostia,Basic services,electricity,-45.47,57623.96
buyer_5,Sara,30,ES72209552827491055369,TRX_N-137-33953420561,2020-11-07T11:23:36,Donostia,Basic services,internet,-41.69,57582.27
buyer_5,Sara,30,ES72209552827491055369,TRX_N-138-192377130901,2020-11-18T12:30:55,Donostia,Expense,leisure,-172.69,57409.58
buyer_5,Sara,30,ES72209552827491055369,TRX_N-139-362679249764,2020-11-24T02:53:37,Donostia,Expense,healthcare,-336.55,57073.03
buyer_5,Sara,30,ES72209552827491055369,TRX_N-14-897589511794,2020-02-01T20:26:56,Donostia,transfer,Salary,3359.75,22815.03
buyer_5,Sara,30,ES72209552827491055369,TRX_N-140-78792229111,2020-12-01T12:49:07,Donostia,transfer,Salary,3359.75,60432.78
buyer_5,Sara,30,ES72209552827491055369,TRX_N-141-828012669104,2020-12-01T12:49:07,Donostia,transfer,Partner Salary,3407.23,63840.01
buyer_5,Sara,30,ES72209552827491055369,TRX_N-142-133421063020,2020-12-01T12:49:07,Donostia,transfer,Bonus,3577.43,67417.44
buyer_5,Sara,30,ES72209552827491055369,TRX_N-143-325754775899,2020-12-05T11:01:00,Donostia,Housing,Mortgage,-1902.5,65514.94
buyer_5,Sara,30,ES72209552827491055369,TRX_N-144-122927204481,2020-12-05T12:56:02,Donostia,Basic services,electricity,-148.1,65366.84
buyer_5,Sara,30,ES72209552827491055369,TRX_N-145-743150276325,2020-12-05T11:14:01,Donostia,Basic services,gas,-60.71,65306.13
buyer_5,Sara,30,ES72209552827491055369,TRX_N-146-435302897923,2020-12-06T11:12:23,Donostia,Basic services,phone,-62.43,65243.7
buyer_5,Sara,30,ES72209552827491055369,TRX_N-147-600842620373,2020-12-06T19:13:07,Donostia,Expense,gifts,-336.79,64906.91
buyer_5,Sara,30,ES72209552827491055369,TRX_N-148-678623691964,2020-12-07T16:15:37,Donostia,Basic services,water,-49.75,64857.16
buyer_5,Sara,30,ES72209552827491055369,TRX_N-149-6183235932,2020-12-07T03:19:37,Donostia,Basic services,gas,-63.51,64793.65
buyer_5,Sara,30,ES72209552827491055369,TRX_N-15-307934605847,2020-02-01T20:26:56,Donostia,transfer,Partner Salary,3407.23,26222.26
buyer_5,Sara,30,ES72209552827491055369,TRX_N-150-127459313203,2020-12-07T11:23:41,Donostia,Basic services,internet,-46.18,64747.47
buyer_5,Sara,30,ES72209552827491055369,TRX_N-151-509759903696,2020-12-17T18:49:53,Donostia,Expense,transport,-173.66,64573.81
buyer_5,Sara,30,ES72209552827491055369,TRX_N-152-60183078656,2020-12-18T12:59:34,Donostia,Expense,food,-288.27,64285.54
buyer_5,Sara,30,ES72209552827491055369,TRX_N-153-235998650716,2020-12-19T08:37:31,Llodio,Expense,food,-645.7,63639.84
buyer_5,Sara,30,ES72209552827491055369,TRX_N-154-915433496067,2020-12-28T17:59:05,Andoain,Expense,repairs,-103.03,63536.81
buyer_5,Sara,30,ES72209552827491055369,TRX_N-155-964866986166,2021-01-01T20:18:12,Donostia,transfer,Salary,3359.75,66896.56
buyer_5,Sara,30,ES72209552827491055369,TRX_N-156-649942277439,2021-01-01T20:18:12,Donostia,transfer,Partner Salary,3407.23,70303.79
buyer_5,Sara,30,ES72209552827491055369,TRX_N-157-716827290240,2021-01-01T20:18:12,Donostia,transfer,Extra Income,335.98,70639.77
buyer_5,Sara,30,ES72209552827491055369,TRX_N-158-199963925583,2021-01-03T09:44:41,Donostia,Expense,transport,-118.11,70521.66
buyer_5,Sara,30,ES72209552827491055369,TRX_N-159-440167278916,2021-01-03T19:44:09,Donostia,Expense,leisure,-126.71,70394.95
buyer_5,Sara,30,ES72209552827491055369,TRX_N-16-199332759126,2020-02-01T20:26:56,Donostia,transfer,Extra Income,335.98,26558.24
buyer_5,Sara,30,ES72209552827491055369,TRX_N-160-628858166834,2021-01-05T08:35:02,Donostia,Housing,Mortgage,-1902.5,68492.45
buyer_5,Sara,30,ES72209552827491055369,TRX_N-161-902042511775,2021-01-05T01:31:23,Donostia,Basic services,internet,-54.04,68438.41
buyer_5,Sara,30,ES72209552827491055369,TRX_N-162-836886547035,2021-01-05T19:54:41,Donostia,Expense,transport,-33.74,68404.67
buyer_5,Sara,30,ES72209552827491055369,TRX_N-163-44195613676,2021-01-06T08:27:22,Donostia,Basic services,gas,-73.9,68330.77
buyer_5,Sara,30,ES72209552827491055369,TRX_N-164-621860822762,2021-01-07T16:39:25,Donostia,Basic services,electricity,-47.95,68282.82
buyer_5,Sara,30,ES72209552827491055369,TRX_N-165-91266142415,2021-01-07T20:24:03,Donostia,Basic services,gas,-86.66,68196.16
buyer_5,Sara,30,ES72209552827491055369,TRX_N-166-849017373412,2021-01-12T17:22:59,Donostia,Expense,transport,-128.48,68067.68
buyer_5,Sara,30,ES72209552827491055369,TRX_N-167-494255183307,2021-01-13T11:03:51,Donostia,Expense,food,-450.79,67616.89
buyer_5,Sara,30,ES72209552827491055369,TRX_N-168-713067396793,2021-01-16T07:43:41,Donostia,Expense,leisure,-115.8,67501.09
buyer_5,Sara,30,ES72209552827491055369,TRX_N-169-987813551605,2021-01-17T15:40:09,Labastida/Bastida,Expense,leisure,-284.95,67216.14
buyer_5,Sara,30,ES72209552827491055369,TRX_N-17-861554929211,2020-02-01T06:47:08,Donostia,Expense,gifts,-250.0,26308.24
buyer_5,Sara,30,ES72209552827491055369,TRX_N-170-453842272710,2021-01-22T12:45:48,Hondarribia,Expense,clothing,-359.65,66856.49
buyer_5,Sara,30,ES72209552827491055369,TRX_N-171-789360354165,2021-02-01T19:10:57,Donostia,transfer,Salary,3359.75,70216.24
buyer_5,Sara,30,ES72209552827491055369,TRX_N-172-456559678407,2021-02-01T19:10:57,Donostia,transfer,Partner Salary,3407.23,73623.47
buyer_5,Sara,30,ES72209552827491055369,TRX_N-173-361948925338,2021-02-03T20:24:52,Donostia,Expense,food,-795.17,72828.3
buyer_5,Sara,30,ES72209552827491055369,TRX_N-174-927138973907,2021-02-05T09:24:58,Donostia,Housing,Mortgage,-1902.5,70925.8
buyer_5,Sara,30,ES72209552827491055369,TRX_N-175-676958796634,2021-02-05T20:16:11,Donostia,Basic services,phone,-61.96,70863.84
buyer_5,Sara,30,ES72209552827491055369,TRX_N-176-491744025950,2021-02-06T15:44:48,Donostia,Basic services,internet,-62.78,70801.06
buyer_5,Sara,30,ES72209552827491055369,TRX_N-177-285187936030,2021-02-06T10:37:11,Donostia,Basic services,phone,-72.78,70728.28
buyer_5,Sara,30,ES72209552827491055369,TRX_N-178-268627667350,2021-02-06T09:50:50,Berango,Expense,leisure,-89.87,70638.41
buyer_5,Sara,30,ES72209552827491055369,TRX_N-179-93461772821,2021-02-07T19:15:05,Donostia,Basic services,water,-71.66,70566.75
buyer_5,Sara,30,ES72209552827491055369,TRX_N-18-7472405170,2020-02-05T13:29:47,Donostia,Housing,Mortgage,-1902.5,24405.74
buyer_5,Sara,30,ES72209552827491055369,TRX_N-180-64527328507,2021-02-07T00:29:51,Donostia,Expense,leisure,-53.79,70512.96
buyer_5,Sara,30,ES72209552827491055369,TRX_N-181-299852432840,2021-03-01T18:29:50,Donostia,transfer,Salary,3359.75,73872.71
buyer_5,Sara,30,ES72209552827491055369,TRX_N-182-948571912408,2021-03-01T18:29:50,Donostia,transfer,Partner Salary,3407.23,77279.94
buyer_5,Sara,30,ES72209552827491055369,TRX_N-183-986269224973,2021-03-01T18:29:50,Donostia,transfer,Extra Income,335.98,77615.92
buyer_5,Sara,30,ES72209552827491055369,TRX_N-184-908292211803,2021-03-01T11:41:14,Donostia,Expense,food,-597.8,77018.12
buyer_5,Sara,30,ES72209552827491055369,TRX_N-185-477108912059,2021-03-05T14:34:15,Donostia,Housing,Mortgage,-1902.5,75115.62
buyer_5,Sara,30,ES72209552827491055369,TRX_N-186-35138443015,2021-03-06T15:10:29,Donostia,Basic services,water,-70.8,75044.82
buyer_5,Sara,30,ES72209552827491055369,TRX_N-187-932353433922,2021-03-06T16:02:15,Donostia,Basic services,gas,-62.6,74982.22
buyer_5,Sara,30,ES72209552827491055369,TRX_N-188-546515456243,2021-03-06T13:12:54,Donostia,Basic services,phone,-80.37,74901.85
buyer_5,Sara,30,ES72209552827491055369,TRX_N-189-156071857591,2021-03-07T15:07:36,Donostia,Basic services,phone,-49.85,74852.0
buyer_5,Sara,30,ES72209552827491055369,TRX_N-19-616198040796,2020-02-06T19:32:51,Donostia,Basic services,electricity,-69.16,24336.58
buyer_5,Sara,30,ES72209552827491055369,TRX_N-190-20586551540,2021-03-15T13:53:23,Donostia,Expense,healthcare,-130.68,74721.32
buyer_5,Sara,30,ES72209552827491055369,TRX_N-191-329606440229,2021-03-30T13:50:13,Donostia,Expense,education,-799.95,73921.37
buyer_5,Sara,30,ES72209552827491055369,TRX_N-192-644641246721,2021-04-01T15:17:18,Donostia,transfer,Salary,3359.75,77281.12
buyer_5,Sara,30,ES72209552827491055369,TRX_N-193-336478181494,2021-04-01T15:17:18,Donostia,transfer,Partner Salary,3407.23,80688.35
buyer_5,Sara,30,ES72209552827491055369,TRX_N-194-42524963445,2021-04-05T18:06:57,Donostia,Housing,Mortgage,-1902.5,78785.85
buyer_5,Sara,30,ES72209552827491055369,TRX_N-195-682773461120,2021-04-05T23:03:22,Donostia,Basic services,water,-72.77,78713.08
buyer_5,Sara,30,ES72209552827491055369,TRX_N-196-56438362010,2021-04-05T09:42:49,Donostia,Basic services,electricity,-81.94,78631.14
buyer_5,Sara,30,ES72209552827491055369,TRX_N-197-488657336945,2021-04-05T11:59:27,Donostia,Basic services,phone,-47.29,78583.85
buyer_5,Sara,30,ES72209552827491055369,TRX_N-198-421937354277,2021-04-06T17:47:45,Donostia,Basic services,electricity,-102.41,78481.44
buyer_5,Sara,30,ES72209552827491055369,TRX_N-199-414210129213,2021-04-06T02:18:50,Donostia,Basic services,internet,-38.4,78443.04
buyer_5,Sara,30,ES72209552827491055369,TRX_N-2-276140170945,2020-01-01T18:57:20,Donostia,transfer,Partner Salary,3407.23,24593.72
buyer_5,Sara,30,ES72209552827491055369,TRX_N-20-295449645977,2020-02-06T13:56:38,Donostia,Basic services,internet,-69.82,24266.76
buyer_5,Sara,30,ES72209552827491055369,TRX_N-200-893064115276,2021-04-06T11:51:46,Donostia,Basic services,phone,-53.0,78390.04
buyer_5,Sara,30,ES72209552827491055369,TRX_N-201-313869953844,2021-04-07T12:19:56,Donostia,Basic services,gas,-42.49,78347.55
buyer_5,Sara,30,ES72209552827491055369,TRX_N-202-82474831387,2021-04-07T21:20:58,Donostia,Basic services,phone,-47.96,78299.59
buyer_5,Sara,30,ES72209552827491055369,TRX_N-203-26536713513,2021-04-19T13:17:02,Donostia,Expense,transport,-32.42,78267.17
buyer_5,Sara,30,ES72209552827491055369,TRX_N-204-285182547772,2021-04-21T19:31:49,Donostia,Expense,transport,-134.46,78132.71
buyer_5,Sara,30,ES72209552827491055369,TRX_N-205-210461597852,2021-04-28T15:09:21,Donostia,Expense,food,-667.6,77465.11
buyer_5,Sara,30,ES72209552827491055369,TRX_N-206-684661837433,2021-05-01T17:25:29,Donostia,transfer,Salary,3359.75,80824.86
buyer_5,Sara,30,ES72209552827491055369,TRX_N-207-443511255898,2021-05-01T17:25:29,Donostia,transfer,Partner Salary,3407.23,84232.09
buyer_5,Sara,30,ES72209552827491055369,TRX_N-208-912928692157,2021-05-05T19:47:30,Donostia,Housing,Mortgage,-1902.5,82329.59
buyer_5,Sara,30,ES72209552827491055369,TRX_N-209-656918516238,2021-05-06T12:07:33,Donostia,Basic services,phone,-93.78,82235.81
buyer_5,Sara,30,ES72209552827491055369,TRX_N-21-525026758652,2020-02-06T08:39:18,Donostia,Basic services,phone,-47.74,24219.02
buyer_5,Sara,30,ES72209552827491055369,TRX_N-210-674680455734,2021-05-06T11:32:21,Donostia,Expense,leisure,-223.15,82012.66
buyer_5,Sara,30,ES72209552827491055369,TRX_N-211-459322287358,2021-05-07T11:00:20,Donostia,Basic services,electricity,-47.87,81964.79
buyer_5,Sara,30,ES72209552827491055369,TRX_N-212-937678107187,2021-05-07T20:49:55,Donostia,Basic services,gas,-86.06,81878.73
buyer_5,Sara,30,ES72209552827491055369,TRX_N-213-957320772635,2021-05-18T11:36:18,Donostia,Expense,food,-607.61,81271.12
buyer_5,Sara,30,ES72209552827491055369,TRX_N-214-472707418045,2021-05-19T08:03:57,Hondarribia,Expense,gifts,-275.89,80995.23
buyer_5,Sara,30,ES72209552827491055369,TRX_N-215-368309895840,2021-05-28T08:56:21,Donostia,Expense,healthcare,-374.45,80620.78
buyer_5,Sara,30,ES72209552827491055369,TRX_N-216-341421888099,2021-06-01T14:58:39,Donostia,transfer,Salary,3359.75,83980.53
buyer_5,Sara,30,ES72209552827491055369,TRX_N-217-420238049486,2021-06-01T14:58:39,Donostia,transfer,Partner Salary,3407.23,87387.76
buyer_5,Sara,30,ES72209552827491055369,TRX_N-218-486086296466,2021-06-01T14:58:39,Donostia,transfer,Extra Income,335.98,87723.74
buyer_5,Sara,30,ES72209552827491055369,TRX_N-219-903584416609,2021-06-01T14:58:39,Donostia,transfer,Bonus,3331.62,91055.36
buyer_5,Sara,30,ES72209552827491055369,TRX_N-22-185561721181,2020-02-07T09:27:58,Donostia,Basic services,gas,-81.84,24137.18
buyer_5,Sara,30,ES72209552827491055369,TRX_N-220-624078851300,2021-06-05T23:33:45,Donostia,Housing,Mortgage,-1902.5,89152.86
buyer_5,Sara,30,ES72209552827491055369,TRX_N-221-146084124067,2021-06-05T04:54:56,Donostia,Basic services,electricity,-146.77,89006.09
buyer_5,Sara,30,ES72209552827491055369,TRX_N-222-446870483760,2021-06-05T09:32:40,Donostia,Basic services,gas,-92.66,88913.43
buyer_5,Sara,30,ES72209552827491055369,TRX_N-223-82851026442,2021-06-05T08:03:15,Donostia,Basic services,internet,-64.79,88848.64
buyer_5,Sara,30,ES72209552827491055369,TRX_N-224-44444602815,2021-06-06T13:52:18,Donostia,Basic services,electricity,-46.62,88802.02
buyer_5,Sara,30,ES72209552827491055369,TRX_N-225-665343268283,2021-06-07T11:01:14,Donostia,Basic services,gas,-89.84,88712.18
buyer_5,Sara,30,ES72209552827491055369,TRX_N-226-613515085313,2021-06-07T23:34:21,Donostia,Expense,transport,-87.03,88625.15
buyer_5,Sara,30,ES72209552827491055369,TRX_N-227-837051519168,2021-06-12T09:34:57,Donostia,Expense,appliances,-940.93,87684.22
buyer_5,Sara,30,ES72209552827491055369,TRX_N-228-662655295197,2021-07-01T20:28:53,Donostia,transfer,Salary,3359.75,91043.97
buyer_5,Sara,30,ES72209552827491055369,TRX_N-229-805859761247,2021-07-01T20:28:53,Donostia,transfer,Partner Salary,3407.23,94451.2
buyer_5,Sara,30,ES72209552827491055369,TRX_N-23-416934734256,2020-02-07T11:59:33,Donostia,Basic services,phone,-22.31,24114.87
buyer_5,Sara,30,ES72209552827491055369,TRX_N-230-581068995280,2021-07-05T11:08:29,Donostia,Housing,Mortgage,-1902.5,92548.7
buyer_5,Sara,30,ES72209552827491055369,TRX_N-231-478149037287,2021-07-05T14:17:20,Donostia,Basic services,internet,-33.26,92515.44
buyer_5,Sara,30,ES72209552827491055369,TRX_N-232-550161662917,2021-07-07T22:26:30,Donostia,Basic services,water,-32.51,92482.93
buyer_5,Sara,30,ES72209552827491055369,TRX_N-233-743270902458,2021-07-07T04:49:13,Donostia,Basic services,internet,-46.87,92436.06
buyer_5,Sara,30,ES72209552827491055369,TRX_N-234-942859438845,2021-07-07T10:05:58,Donostia,Expense,leisure,-20.82,92415.24
buyer_5,Sara,30,ES72209552827491055369,TRX_N-235-281479009395,2021-07-08T14:09:23,Donostia,Expense,education,-810.31,91604.93
buyer_5,Sara,30,ES72209552827491055369,TRX_N-236-831624399381,2021-07-12T16:37:05,Donostia,Expense,food,-255.16,91349.77
buyer_5,Sara,30,ES72209552827491055369,TRX_N-237-179391845353,2021-08-01T20:55:01,Donostia,transfer,Salary,3359.75,94709.52
buyer_5,Sara,30,ES72209552827491055369,TRX_N-238-192752914764,2021-08-01T20:55:01,Donostia,transfer,Partner Salary,3407.23,98116.75
buyer_5,Sara,30,ES72209552827491055369,TRX_N-239-757035639471,2021-08-01T20:55:01,Donostia,transfer,Extra Income,335.98,98452.73
buyer_5,Sara,30,ES72209552827491055369,TRX_N-24-257309657125,2020-02-14T13:21:03,Donostia,Expense,transport,-20.84,24094.03
buyer_5,Sara,30,ES72209552827491055369,TRX_N-240-97347749729,2021-08-05T23:29:57,Donostia,Housing,Mortgage,-1902.5,96550.23
buyer_5,Sara,30,ES72209552827491055369,TRX_N-241-755960223732,2021-08-05T17:58:11,Donostia,Basic services,water,-52.93,96497.3
buyer_5,Sara,30,ES72209552827491055369,TRX_N-242-462278810688,2021-08-06T17:37:36,Donostia,Basic services,gas,-88.56,96408.74
buyer_5,Sara,30,ES72209552827491055369,TRX_N-243-100629634218,2021-08-06T15:35:06,Donostia,Basic services,internet,-64.12,96344.62
buyer_5,Sara,30,ES72209552827491055369,TRX_N-244-634718650138,2021-08-06T13:38:23,Donostia,Basic services,phone,-54.27,96290.35
buyer_5,Sara,30,ES72209552827491055369,TRX_N-245-922780545606,2021-08-15T10:06:22,Donostia,Expense,leisure,-236.98,96053.37
buyer_5,Sara,30,ES72209552827491055369,TRX_N-246-416328716821,2021-08-19T12:56:18,Donostia,Expense,healthcare,-224.8,95828.57
buyer_5,Sara,30,ES72209552827491055369,TRX_N-247-979902497953,2021-08-20T13:02:17,Donostia,Expense,leisure,-157.74,95670.83
buyer_5,Sara,30,ES72209552827491055369,TRX_N-248-92376982585,2021-09-01T11:47:18,Donostia,transfer,Salary,3359.75,99030.58
buyer_5,Sara,30,ES72209552827491055369,TRX_N-249-432166739449,2021-09-01T11:47:18,Donostia,transfer,Partner Salary,3407.23,102437.81
buyer_5,Sara,30,ES72209552827491055369,TRX_N-25-549817277641,2020-02-26T19:59:14,Donostia,Expense,gifts,-112.82,23981.21
buyer_5,Sara,30,ES72209552827491055369,TRX_N-250-180060766086,2021-09-01T21:20:42,Salvatierra/Agurain,Expense,leisure,-240.56,102197.25
buyer_5,Sara,30,ES72209552827491055369,TRX_N-251-622033568605,2021-09-05T15:31:34,Donostia,Housing,Mortgage,-1902.5,100294.75
buyer_5,Sara,30,ES72209552827491055369,TRX_N-252-36733775851,2021-09-11T14:19:01,Donostia,Expense,repairs,-93.48,100201.27
buyer_5,Sara,30,ES72209552827491055369,TRX_N-253-809800119061,2021-10-01T12:16:14,Donostia,transfer,Salary,3359.75,103561.02
buyer_5,Sara,30,ES72209552827491055369,TRX_N-254-705324573411,2021-10-01T12:16:14,Donostia,transfer,Partner Salary,3407.23,106968.25
buyer_5,Sara,30,ES72209552827491055369,TRX_N-255-568153511583,2021-10-05T10:46:38,Donostia,Housing,Mortgage,-1902.5,105065.75
buyer_5,Sara,30,ES72209552827491055369,TRX_N-256-172236247081,2021-10-05T18:45:03,Donostia,Basic services,phone,-30.59,105035.16
buyer_5,Sara,30,ES72209552827491055369,TRX_N-257-587453951776,2021-10-07T19:57:05,Donostia,Basic services,water,-32.22,105002.94
buyer_5,Sara,30,ES72209552827491055369,TRX_N-258-490276273505,2021-10-07T15:19:05,Donostia,Basic services,phone,-26.47,104976.47
buyer_5,Sara,30,ES72209552827491055369,TRX_N-259-212672666799,2021-10-07T08:03:23,Donostia,Expense,food,-723.46,104253.01
buyer_5,Sara,30,ES72209552827491055369,TRX_N-26-635730619846,2020-02-27T17:48:18,Donostia,Expense,transport,-164.71,23816.5
buyer_5,Sara,30,ES72209552827491055369,TRX_N-260-857921394716,2021-10-22T16:10:32,Donostia,Expense,food,-575.66,103677.35
buyer_5,Sara,30,ES72209552827491055369,TRX_N-261-433586059780,2021-10-30T17:01:59,Donostia,Expense,food,-377.49,103299.86
buyer_5,Sara,30,ES72209552827491055369,TRX_N-262-386045244034,2021-11-01T19:06:44,Donostia,transfer,Salary,3359.75,106659.61
buyer_5,Sara,30,ES72209552827491055369,TRX_N-263-637266494970,2021-11-01T19:06:44,Donostia,transfer,Partner Salary,3407.23,110066.84
buyer_5,Sara,30,ES72209552827491055369,TRX_N-264-470958091518,2021-11-01T19:06:44,Donostia,transfer,Extra Income,335.98,110402.82
buyer_5,Sara,30,ES72209552827491055369,TRX_N-265-626561582843,2021-11-05T15:23:03,Donostia,Housing,Mortgage,-1902.5,108500.32
buyer_5,Sara,30,ES72209552827491055369,TRX_N-266-640757262655,2021-11-05T14:42:13,Donostia,Basic services,water,-35.13,108465.19
buyer_5,Sara,30,ES72209552827491055369,TRX_N-267-913604871632,2021-11-06T19:35:43,Donostia,Basic services,electricity,-32.99,108432.2
buyer_5,Sara,30,ES72209552827491055369,TRX_N-268-34279463257,2021-11-07T23:53:41,Donostia,Basic services,gas,-52.54,108379.66
buyer_5,Sara,30,ES72209552827491055369,TRX_N-269-310816371353,2021-11-10T13:32:27,Donostia,Expense,food,-561.36,107818.3
buyer_5,Sara,30,ES72209552827491055369,TRX_N-27-251027654475,2020-02-29T19:25:33,Donostia,Expense,healthcare,-87.77,23728.73
buyer_5,Sara,30,ES72209552827491055369,TRX_N-270-36911871047,2021-11-16T17:42:48,Portugalete,Expense,repairs,-411.23,107407.07
buyer_5,Sara,30,ES72209552827491055369,TRX_N-271-881336416082,2021-11-19T11:41:49,Donostia,Expense,healthcare,-308.86,107098.21
buyer_5,Sara,30,ES72209552827491055369,TRX_N-272-77089568750,2021-11-24T11:23:13,Iruña de Oca,Expense,healthcare,-162.58,106935.63
buyer_5,Sara,30,ES72209552827491055369,TRX_N-273-587012027649,2021-11-25T01:09:14,Donostia,Expense,food,-586.22,106349.41
buyer_5,Sara,30,ES72209552827491055369,TRX_N-274-273932152223,2021-11-26T23:32:30,Bermeo,Expense,food,-580.37,105769.04
buyer_5,Sara,30,ES72209552827491055369,TRX_N-275-57242853539,2021-11-28T16:54:04,Donostia,Expense,education,-546.99,105222.05
buyer_5,Sara,30,ES72209552827491055369,TRX_N-276-285181524967,2021-12-01T09:10:49,Donostia,transfer,Salary,3359.75,108581.8
buyer_5,Sara,30,ES72209552827491055369,TRX_N-277-825419613157,2021-12-01T09:10:49,Donostia,transfer,Partner Salary,3407.23,111989.03
buyer_5,Sara,30,ES72209552827491055369,TRX_N-278-830090210529,2021-12-01T09:10:49,Donostia,transfer,Bonus,3116.63,115105.66
buyer_5,Sara,30,ES72209552827491055369,TRX_N-279-351182684250,2021-12-05T13:51:20,Donostia,Housing,Mortgage,-1902.5,113203.16
buyer_5,Sara,30,ES72209552827491055369,TRX_N-28-597950701653,2020-03-01T08:40:49,Donostia,transfer,Salary,3359.75,27088.48
buyer_5,Sara,30,ES72209552827491055369,TRX_N-280-446272561090,2021-12-05T06:01:29,Donostia,Basic services,water,-69.62,113133.54
buyer_5,Sara,30,ES72209552827491055369,TRX_N-281-841776344694,2021-12-06T16:41:08,Donostia,Basic services,gas,-80.07,113053.47
buyer_5,Sara,30,ES72209552827491055369,TRX_N-282-757735284827,2021-12-06T20:15:53,Donostia,Basic services,internet,-75.35,112978.12
buyer_5,Sara,30,ES72209552827491055369,TRX_N-283-834528504126,2021-12-07T13:10:06,Donostia,Basic services,electricity,-113.58,112864.54
buyer_5,Sara,30,ES72209552827491055369,TRX_N-284-944493505255,2021-12-23T00:10:50,Errenteria,Expense,food,-239.14,112625.4
buyer_5,Sara,30,ES72209552827491055369,TRX_N-285-76508302342,2022-01-01T12:30:25,Donostia,transfer,Salary,3359.75,115985.15
buyer_5,Sara,30,ES72209552827491055369,TRX_N-286-778790950748,2022-01-01T12:30:25,Donostia,transfer,Partner Salary,3407.23,119392.38
buyer_5,Sara,30,ES72209552827491055369,TRX_N-287-77110513842,2022-01-01T12:52:31,Donostia,Expense,food,-170.9,119221.48
buyer_5,Sara,30,ES72209552827491055369,TRX_N-288-48638658723,2022-01-04T11:35:28,Donostia,Expense,transport,-63.45,119158.03
buyer_5,Sara,30,ES72209552827491055369,TRX_N-289-438575679835,2022-01-05T01:17:23,Donostia,Housing,Mortgage,-1902.5,117255.53
buyer_5,Sara,30,ES72209552827491055369,TRX_N-29-524745247323,2020-03-01T08:40:49,Donostia,transfer,Partner Salary,3407.23,30495.71
buyer_5,Sara,30,ES72209552827491055369,TRX_N-290-190327910516,2022-01-06T11:35:43,Donostia,Basic services,water,-74.13,117181.4
buyer_5,Sara,30,ES72209552827491055369,TRX_N-291-677397520138,2022-01-06T10:57:38,Donostia,Basic services,gas,-31.29,117150.11
buyer_5,Sara,30,ES72209552827491055369,TRX_N-292-13370449352,2022-01-06T03:44:54,Donostia,Basic services,internet,-65.08,117085.03
buyer_5,Sara,30,ES72209552827491055369,TRX_N-293-911843707282,2022-01-06T13:06:57,Donostia,Basic services,phone,-37.67,117047.36
buyer_5,Sara,30,ES72209552827491055369,TRX_N-294-355327234746,2022-01-07T13:15:07,Donostia,Basic services,gas,-81.56,116965.8
buyer_5,Sara,30,ES72209552827491055369,TRX_N-295-504812910426,2022-01-22T17:58:47,Donostia,Expense,food,-568.12,116397.68
buyer_5,Sara,30,ES72209552827491055369,TRX_N-296-198447136332,2022-01-25T15:38:05,Zuia,Expense,healthcare,-278.36,116119.32
buyer_5,Sara,30,ES72209552827491055369,TRX_N-297-410320267272,2022-01-27T20:53:35,Donostia,Expense,clothing,-117.85,116001.47
buyer_5,Sara,30,ES72209552827491055369,TRX_N-298-986310545803,2022-01-31T20:38:40,Donostia,Expense,food,-614.71,115386.76
buyer_5,Sara,30,ES72209552827491055369,TRX_N-299-186248319893,2022-02-01T11:02:34,Donostia,transfer,Salary,3359.75,118746.51
buyer_5,Sara,30,ES72209552827491055369,TRX_N-3-241588457231,2020-01-01T14:02:42,Donostia,Expense,transport,-128.68,24465.04
buyer_5,Sara,30,ES72209552827491055369,TRX_N-30-822922900892,2020-03-05T18:16:19,Donostia,Housing,Mortgage,-1902.5,28593.21
buyer_5,Sara,30,ES72209552827491055369,TRX_N-300-469178804952,2022-02-01T11:02:34,Donostia,transfer,Partner Salary,3407.23,122153.74
buyer_5,Sara,30,ES72209552827491055369,TRX_N-301-11585609315,2022-02-01T11:02:34,Donostia,transfer,Extra Income,335.98,122489.72
buyer_5,Sara,30,ES72209552827491055369,TRX_N-302-820386470075,2022-02-03T12:47:11,Donostia,Expense,leisure,-43.99,122445.73
buyer_5,Sara,30,ES72209552827491055369,TRX_N-303-614346363475,2022-02-05T20:19:38,Donostia,Housing,Mortgage,-1902.5,120543.23
buyer_5,Sara,30,ES72209552827491055369,TRX_N-304-57879802566,2022-02-05T17:23:33,Donostia,Basic services,water,-31.37,120511.86
buyer_5,Sara,30,ES72209552827491055369,TRX_N-305-187813289408,2022-02-05T17:30:58,Donostia,Basic services,electricity,-36.98,120474.88
buyer_5,Sara,30,ES72209552827491055369,TRX_N-306-595924510997,2022-02-05T19:14:27,Donostia,Basic services,gas,-38.53,120436.35
buyer_5,Sara,30,ES72209552827491055369,TRX_N-307-939256320282,2022-02-06T20:12:03,Donostia,Basic services,gas,-55.45,120380.9
buyer_5,Sara,30,ES72209552827491055369,TRX_N-308-966114244514,2022-02-06T09:52:57,Donostia,Expense,leisure,-287.72,120093.18
buyer_5,Sara,30,ES72209552827491055369,TRX_N-309-882995825978,2022-02-07T12:47:26,Donostia,Basic services,internet,-57.48,120035.7
buyer_5,Sara,30,ES72209552827491055369,TRX_N-31-207121390030,2020-03-05T18:06:09,Donostia,Basic services,water,-10.88,28582.33
buyer_5,Sara,30,ES72209552827491055369,TRX_N-310-19903602710,2022-02-14T05:22:27,Donostia,Expense,gifts,-314.82,119720.88
buyer_5,Sara,30,ES72209552827491055369,TRX_N-311-988940307502,2022-02-20T19:47:52,Donostia,Expense,food,-777.92,118942.96
buyer_5,Sara,30,ES72209552827491055369,TRX_N-312-288084195703,2022-03-01T18:11:02,Donostia,transfer,Salary,3359.75,122302.71
buyer_5,Sara,30,ES72209552827491055369,TRX_N-313-517033204064,2022-03-01T18:11:02,Donostia,transfer,Partner Salary,3407.23,125709.94
buyer_5,Sara,30,ES72209552827491055369,TRX_N-314-190281562776,2022-03-05T08:28:06,Donostia,Housing,Mortgage,-1902.5,123807.44
buyer_5,Sara,30,ES72209552827491055369,TRX_N-315-562801309998,2022-03-06T08:47:04,Donostia,Basic services,water,-22.56,123784.88
buyer_5,Sara,30,ES72209552827491055369,TRX_N-316-889941987691,2022-03-06T16:12:08,Donostia,Basic services,internet,-78.56,123706.32
buyer_5,Sara,30,ES72209552827491055369,TRX_N-317-549556088286,2022-03-07T13:05:28,Donostia,Basic services,internet,-41.72,123664.6
buyer_5,Sara,30,ES72209552827491055369,TRX_N-318-120882118713,2022-03-20T13:53:55,Donostia,Expense,leisure,-128.66,123535.94
buyer_5,Sara,30,ES72209552827491055369,TRX_N-319-650544045200,2022-04-01T16:52:50,Donostia,transfer,Salary,3359.75,126895.69
buyer_5,Sara,30,ES72209552827491055369,TRX_N-32-467296634421,2020-03-05T11:59:30,Donostia,Basic services,electricity,-68.16,28514.17
buyer_5,Sara,30,ES72209552827491055369,TRX_N-320-573474742202,2022-04-01T16:52:50,Donostia,transfer,Partner Salary,3407.23,130302.92
buyer_5,Sara,30,ES72209552827491055369,TRX_N-321-813871752714,2022-04-01T16:52:50,Donostia,transfer,Extra Income,335.98,130638.9
buyer_5,Sara,30,ES72209552827491055369,TRX_N-322-659202841951,2022-04-01T10:50:20,Donostia,Expense,transport,-122.34,130516.56
buyer_5,Sara,30,ES72209552827491055369,TRX_N-323-431021402414,2022-04-03T08:15:51,Donostia,Expense,healthcare,-140.09,130376.47
buyer_5,Sara,30,ES72209552827491055369,TRX_N-324-793281602080,2022-04-05T16:02:00,Donostia,Housing,Mortgage,-1902.5,128473.97
buyer_5,Sara,30,ES72209552827491055369,TRX_N-325-174126977987,2022-04-05T11:22:52,Donostia,Basic services,internet,-74.67,128399.3
buyer_5,Sara,30,ES72209552827491055369,TRX_N-326-476739818253,2022-04-06T20:01:30,Donostia,Basic services,gas,-61.73,128337.57
buyer_5,Sara,30,ES72209552827491055369,TRX_N-327-230604592327,2022-04-06T19:54:15,Donostia,Basic services,internet,-48.06,128289.51
buyer_5,Sara,30,ES72209552827491055369,TRX_N-328-623562430393,2022-04-07T14:56:36,Donostia,Basic services,gas,-27.8,128261.71
buyer_5,Sara,30,ES72209552827491055369,TRX_N-329-337502152358,2022-04-07T16:01:45,Donostia,Basic services,phone,-97.16,128164.55
buyer_5,Sara,30,ES72209552827491055369,TRX_N-33-118641614378,2020-03-05T16:49:21,Donostia,Basic services,phone,-38.01,28476.16
buyer_5,Sara,30,ES72209552827491055369,TRX_N-330-373047054578,2022-04-07T16:10:30,Donostia,Expense,transport,-135.8,128028.75
buyer_5,Sara,30,ES72209552827491055369,TRX_N-331-251009543435,2022-04-13T10:42:35,Llodio,Expense,food,-419.82,127608.93
buyer_5,Sara,30,ES72209552827491055369,TRX_N-332-465274653940,2022-05-01T12:06:04,Donostia,transfer,Salary,3359.75,130968.68
buyer_5,Sara,30,ES72209552827491055369,TRX_N-333-997719295360,2022-05-01T12:06:04,Donostia,transfer,Partner Salary,3407.23,134375.91
buyer_5,Sara,30,ES72209552827491055369,TRX_N-334-284985681082,2022-05-02T11:50:16,Donostia,Expense,food,-328.64,134047.27
buyer_5,Sara,30,ES72209552827491055369,TRX_N-335-210034547818,2022-05-05T23:47:47,Donostia,Housing,Mortgage,-1902.5,132144.77
buyer_5,Sara,30,ES72209552827491055369,TRX_N-336-491909229615,2022-05-05T08:19:16,Donostia,Basic services,water,-25.87,132118.9
buyer_5,Sara,30,ES72209552827491055369,TRX_N-337-819740515015,2022-05-05T19:27:59,Donostia,Expense,clothing,-348.9,131770.0
buyer_5,Sara,30,ES72209552827491055369,TRX_N-338-815100314995,2022-05-06T08:34:04,Donostia,Basic services,water,-27.1,131742.9
buyer_5,Sara,30,ES72209552827491055369,TRX_N-339-67198625098,2022-05-07T12:07:13,Donostia,Basic services,water,-67.7,131675.2
buyer_5,Sara,30,ES72209552827491055369,TRX_N-34-176880219312,2020-03-06T12:20:12,Donostia,Basic services,electricity,-82.47,28393.69
buyer_5,Sara,30,ES72209552827491055369,TRX_N-340-751252123470,2022-05-07T17:20:28,Donostia,Basic services,electricity,-34.83,131640.37
buyer_5,Sara,30,ES72209552827491055369,TRX_N-341-405234640655,2022-05-07T11:28:35,Donostia,Basic services,internet,-57.35,131583.02
buyer_5,Sara,30,ES72209552827491055369,TRX_N-342-549006769765,2022-05-09T10:14:19,Donostia,Expense,healthcare,-160.25,131422.77
buyer_5,Sara,30,ES72209552827491055369,TRX_N-343-593004764861,2022-05-12T18:51:17,Zarautz,Expense,food,-752.01,130670.76
buyer_5,Sara,30,ES72209552827491055369,TRX_N-344-574132885150,2022-06-01T11:19:02,Donostia,transfer,Salary,3359.75,134030.51
buyer_5,Sara,30,ES72209552827491055369,TRX_N-345-488022788408,2022-06-01T11:19:02,Donostia,transfer,Partner Salary,3407.23,137437.74
buyer_5,Sara,30,ES72209552827491055369,TRX_N-346-383239355502,2022-06-01T11:19:02,Donostia,transfer,Extra Income,335.98,137773.72
buyer_5,Sara,30,ES72209552827491055369,TRX_N-347-416643685817,2022-06-01T11:19:02,Donostia,transfer,Bonus,3651.43,141425.15
buyer_5,Sara,30,ES72209552827491055369,TRX_N-348-771926048512,2022-06-01T20:12:28,Donostia,Expense,clothing,-248.81,141176.34
buyer_5,Sara,30,ES72209552827491055369,TRX_N-349-791306785336,2022-06-05T09:23:47,Donostia,Housing,Mortgage,-1902.5,139273.84
buyer_5,Sara,30,ES72209552827491055369,TRX_N-35-300108757800,2020-03-06T14:54:57,Donostia,Basic services,internet,-61.19,28332.5
buyer_5,Sara,30,ES72209552827491055369,TRX_N-350-427438246403,2022-06-05T12:58:10,Donostia,Basic services,water,-18.8,139255.04
buyer_5,Sara,30,ES72209552827491055369,TRX_N-351-579241343260,2022-06-05T16:40:29,Donostia,Basic services,phone,-79.87,139175.17
buyer_5,Sara,30,ES72209552827491055369,TRX_N-352-741217046281,2022-06-06T20:11:13,Donostia,Basic services,electricity,-67.76,139107.41
buyer_5,Sara,30,ES72209552827491055369,TRX_N-353-326312136787,2022-06-06T19:24:29,Donostia,Basic services,gas,-19.12,139088.29
buyer_5,Sara,30,ES72209552827491055369,TRX_N-354-954997131981,2022-06-07T20:23:31,Donostia,Basic services,phone,-44.95,139043.34
buyer_5,Sara,30,ES72209552827491055369,TRX_N-355-574703770932,2022-06-14T20:46:34,Donostia,Expense,gifts,-175.59,138867.75
buyer_5,Sara,30,ES72209552827491055369,TRX_N-356-483994891855,2022-06-26T00:17:57,Getxo,Expense,transport,-129.09,138738.66
buyer_5,Sara,30,ES72209552827491055369,TRX_N-357-38337976895,2022-07-01T18:17:54,Donostia,transfer,Salary,3359.75,142098.41
buyer_5,Sara,30,ES72209552827491055369,TRX_N-358-357520922601,2022-07-01T18:17:54,Donostia,transfer,Partner Salary,3407.23,145505.64
buyer_5,Sara,30,ES72209552827491055369,TRX_N-359-699090077519,2022-07-05T19:36:00,Donostia,Housing,Mortgage,-1902.5,143603.14
buyer_5,Sara,30,ES72209552827491055369,TRX_N-36-872085485233,2020-03-07T19:29:39,Donostia,Basic services,water,-40.22,28292.28
buyer_5,Sara,30,ES72209552827491055369,TRX_N-360-372906153939,2022-07-05T15:41:28,Donostia,Basic services,electricity,-130.05,143473.09
buyer_5,Sara,30,ES72209552827491055369,TRX_N-361-300110271728,2022-07-05T09:07:02,Donostia,Basic services,gas,-61.87,143411.22
buyer_5,Sara,30,ES72209552827491055369,TRX_N-362-712179394400,2022-07-05T09:34:24,Donostia,Basic services,internet,-70.24,143340.98
buyer_5,Sara,30,ES72209552827491055369,TRX_N-363-340761565937,2022-07-06T14:06:21,Donostia,Basic services,water,-14.31,143326.67
buyer_5,Sara,30,ES72209552827491055369,TRX_N-364-807105337942,2022-07-06T22:11:35,Donostia,Basic services,internet,-55.84,143270.83
buyer_5,Sara,30,ES72209552827491055369,TRX_N-365-418779615572,2022-07-07T12:52:58,Donostia,Basic services,water,-53.24,143217.59
buyer_5,Sara,30,ES72209552827491055369,TRX_N-366-880956467353,2022-07-07T10:59:57,Donostia,Basic services,electricity,-123.24,143094.35
buyer_5,Sara,30,ES72209552827491055369,TRX_N-367-800123331596,2022-07-07T18:02:35,Donostia,Basic services,gas,-95.29,142999.06
buyer_5,Sara,30,ES72209552827491055369,TRX_N-368-845436953963,2022-07-12T20:13:23,Donostia,Expense,food,-225.98,142773.08
buyer_5,Sara,30,ES72209552827491055369,TRX_N-369-139010247751,2022-07-29T08:21:36,Donostia,Expense,transport,-145.96,142627.12
buyer_5,Sara,30,ES72209552827491055369,TRX_N-37-305641754298,2020-03-07T21:52:39,Donostia,Basic services,electricity,-113.44,28178.84
buyer_5,Sara,30,ES72209552827491055369,TRX_N-370-795808300202,2022-07-30T20:00:45,Donostia,Expense,travel,-1191.29,141435.83
buyer_5,Sara,30,ES72209552827491055369,TRX_N-371-176494346757,2022-07-31T09:15:42,Donostia,Expense,clothing,-204.78,141231.05
buyer_5,Sara,30,ES72209552827491055369,TRX_N-372-715540728014,2022-08-01T22:25:27,Donostia,transfer,Salary,3359.75,144590.8
buyer_5,Sara,30,ES72209552827491055369,TRX_N-373-150511158261,2022-08-01T22:25:27,Donostia,transfer,Partner Salary,3407.23,147998.03
buyer_5,Sara,30,ES72209552827491055369,TRX_N-374-482139384167,2022-08-01T22:25:27,Donostia,transfer,Extra Income,335.98,148334.01
buyer_5,Sara,30,ES72209552827491055369,TRX_N-375-468206434520,2022-08-01T10:30:53,Donostia,Expense,healthcare,-328.19,148005.82
buyer_5,Sara,30,ES72209552827491055369,TRX_N-376-532996556377,2022-08-05T14:35:31,Donostia,Housing,Mortgage,-1902.5,146103.32
buyer_5,Sara,30,ES72209552827491055369,TRX_N-377-350067320133,2022-08-05T13:21:36,Donostia,Basic services,electricity,-88.21,146015.11
buyer_5,Sara,30,ES72209552827491055369,TRX_N-378-441086528394,2022-08-05T09:42:51,Donostia,Basic services,gas,-85.65,145929.46
buyer_5,Sara,30,ES72209552827491055369,TRX_N-379-79625478727,2022-08-05T23:23:26,Donostia,Basic services,phone,-63.56,145865.9
buyer_5,Sara,30,ES72209552827491055369,TRX_N-38-246160104116,2020-03-07T13:16:23,Donostia,Basic services,internet,-60.04,28118.8
buyer_5,Sara,30,ES72209552827491055369,TRX_N-380-226876542640,2022-08-06T16:05:40,Donostia,Basic services,water,-41.46,145824.44
buyer_5,Sara,30,ES72209552827491055369,TRX_N-381-717803097038,2022-08-07T15:03:56,Donostia,Basic services,water,-50.79,145773.65
buyer_5,Sara,30,ES72209552827491055369,TRX_N-382-496650491488,2022-08-07T17:25:27,Donostia,Basic services,phone,-85.41,145688.24
buyer_5,Sara,30,ES72209552827491055369,TRX_N-383-480691139578,2022-08-11T14:50:39,Donostia,Expense,transport,-199.4,145488.84
buyer_5,Sara,30,ES72209552827491055369,TRX_N-384-121470180777,2022-08-17T08:23:27,Donostia,Expense,food,-288.64,145200.2
buyer_5,Sara,30,ES72209552827491055369,TRX_N-385-53586195945,2022-09-01T13:54:45,Donostia,transfer,Salary,3359.75,148559.95
buyer_5,Sara,30,ES72209552827491055369,TRX_N-386-593246600392,2022-09-01T13:54:45,Donostia,transfer,Partner Salary,3407.23,151967.18
buyer_5,Sara,30,ES72209552827491055369,TRX_N-387-151447955810,2022-09-05T12:44:34,Donostia,Housing,Mortgage,-1902.5,150064.68
buyer_5,Sara,30,ES72209552827491055369,TRX_N-388-569475947971,2022-09-05T20:44:58,Donostia,Basic services,internet,-39.49,150025.19
buyer_5,Sara,30,ES72209552827491055369,TRX_N-389-121660143420,2022-09-06T19:59:28,Donostia,Basic services,gas,-90.76,149934.43
buyer_5,Sara,30,ES72209552827491055369,TRX_N-39-414481801175,2020-03-07T12:42:15,Donostia,Basic services,phone,-53.25,28065.55
buyer_5,Sara,30,ES72209552827491055369,TRX_N-390-805551215092,2022-09-06T11:55:13,Donostia,Basic services,phone,-51.13,149883.3
buyer_5,Sara,30,ES72209552827491055369,TRX_N-391-717652335683,2022-09-06T14:30:28,Donostia,Expense,transport,-163.89,149719.41
buyer_5,Sara,30,ES72209552827491055369,TRX_N-392-245841032347,2022-09-07T10:35:03,Donostia,Basic services,internet,-49.24,149670.17
buyer_5,Sara,30,ES72209552827491055369,TRX_N-393-841138965502,2022-09-07T18:43:51,Donostia,Basic services,phone,-68.62,149601.55
buyer_5,Sara,30,ES72209552827491055369,TRX_N-394-323676835872,2022-09-29T00:23:49,Donostia,Expense,food,-201.68,149399.87
buyer_5,Sara,30,ES72209552827491055369,TRX_N-395-520955115825,2022-10-01T02:17:36,Donostia,transfer,Salary,3359.75,152759.62
buyer_5,Sara,30,ES72209552827491055369,TRX_N-396-79334835527,2022-10-01T02:17:36,Donostia,transfer,Partner Salary,3407.23,156166.85
buyer_5,Sara,30,ES72209552827491055369,TRX_N-397-248106999162,2022-10-01T02:17:36,Donostia,transfer,Extra Income,335.98,156502.83
buyer_5,Sara,30,ES72209552827491055369,TRX_N-398-853148971242,2022-10-04T11:11:16,Donostia,Expense,transport,-62.8,156440.03
buyer_5,Sara,30,ES72209552827491055369,TRX_N-399-441793534428,2022-10-05T14:24:45,Donostia,Housing,Mortgage,-1902.5,154537.53
buyer_5,Sara,30,ES72209552827491055369,TRX_N-4-595534887973,2020-01-03T23:57:48,Lasarte-Oria,Expense,healthcare,-124.94,24340.1
buyer_5,Sara,30,ES72209552827491055369,TRX_N-40-954575267787,2020-03-20T10:09:19,Labastida/Bastida,Expense,education,-321.74,27743.81
buyer_5,Sara,30,ES72209552827491055369,TRX_N-400-159235770080,2022-10-05T17:03:43,Donostia,Basic services,water,-20.85,154516.68
buyer_5,Sara,30,ES72209552827491055369,TRX_N-401-734465411405,2022-10-05T13:53:37,Donostia,Basic services,electricity,-147.97,154368.71
buyer_5,Sara,30,ES72209552827491055369,TRX_N-402-864468734850,2022-10-05T20:36:37,Donostia,Basic services,phone,-85.21,154283.5
buyer_5,Sara,30,ES72209552827491055369,TRX_N-403-255558614913,2022-10-05T13:15:04,Donostia,Expense,travel,-861.51,153421.99
buyer_5,Sara,30,ES72209552827491055369,TRX_N-404-676573775404,2022-10-06T17:36:46,Donostia,Basic services,water,-34.38,153387.61
buyer_5,Sara,30,ES72209552827491055369,TRX_N-405-709263154149,2022-10-06T17:48:16,Donostia,Basic services,gas,-35.76,153351.85
buyer_5,Sara,30,ES72209552827491055369,TRX_N-406-34926884732,2022-10-07T09:42:35,Donostia,Basic services,gas,-21.8,153330.05
buyer_5,Sara,30,ES72209552827491055369,TRX_N-407-285467948434,2022-10-07T21:52:56,Donostia,Basic services,phone,-91.56,153238.49
buyer_5,Sara,30,ES72209552827491055369,TRX_N-408-841300387042,2022-10-08T19:00:37,Donostia,Expense,transport,-168.61,153069.88
buyer_5,Sara,30,ES72209552827491055369,TRX_N-409-958867857002,2022-10-14T12:34:11,Donostia,Expense,travel,-731.37,152338.51
buyer_5,Sara,30,ES72209552827491055369,TRX_N-41-370298327891,2020-03-21T12:47:26,Donostia,Expense,education,-359.97,27383.84
buyer_5,Sara,30,ES72209552827491055369,TRX_N-410-95005796092,2022-10-15T23:52:07,Donostia,Expense,transport,-57.62,152280.89
buyer_5,Sara,30,ES72209552827491055369,TRX_N-411-403619545477,2022-10-19T17:17:51,Donostia,Expense,leisure,-150.06,152130.83
buyer_5,Sara,30,ES72209552827491055369,TRX_N-412-434560657918,2022-10-21T11:51:31,Alegría-Dulantzi,Expense,food,-606.77,151524.06
buyer_5,Sara,30,ES72209552827491055369,TRX_N-413-479047550243,2022-10-25T10:25:28,Donostia,Expense,transport,-110.17,151413.89
buyer_5,Sara,30,ES72209552827491055369,TRX_N-414-720787121105,2022-11-01T09:09:30,Donostia,transfer,Salary,3359.75,154773.64
buyer_5,Sara,30,ES72209552827491055369,TRX_N-415-879290073313,2022-11-01T09:09:30,Donostia,transfer,Partner Salary,3407.23,158180.87
buyer_5,Sara,30,ES72209552827491055369,TRX_N-416-326116474131,2022-11-05T13:38:24,Donostia,Housing,Mortgage,-1902.5,156278.37
buyer_5,Sara,30,ES72209552827491055369,TRX_N-417-816193753104,2022-11-06T16:58:20,Donostia,Basic services,internet,-73.42,156204.95
buyer_5,Sara,30,ES72209552827491055369,TRX_N-418-249259435530,2022-11-06T08:07:29,Donostia,Basic services,phone,-63.66,156141.29
buyer_5,Sara,30,ES72209552827491055369,TRX_N-419-662250350471,2022-11-07T14:32:51,Donostia,Basic services,electricity,-149.43,155991.86
buyer_5,Sara,30,ES72209552827491055369,TRX_N-42-292765186328,2020-03-24T21:56:31,Irun,Expense,food,-138.93,27244.91
buyer_5,Sara,30,ES72209552827491055369,TRX_N-420-883188841939,2022-11-07T16:49:04,Donostia,Basic services,gas,-63.37,155928.49
buyer_5,Sara,30,ES72209552827491055369,TRX_N-421-291976276484,2022-11-08T12:19:26,Donostia,Expense,healthcare,-366.02,155562.47
buyer_5,Sara,30,ES72209552827491055369,TRX_N-422-622007372885,2022-11-20T18:09:26,Donostia,Expense,leisure,-260.75,155301.72
buyer_5,Sara,30,ES72209552827491055369,TRX_N-423-74463763172,2022-11-22T10:29:34,Hondarribia,Expense,food,-452.25,154849.47
buyer_5,Sara,30,ES72209552827491055369,TRX_N-424-502207647846,2022-11-23T17:18:44,Donostia,Expense,food,-640.08,154209.39
buyer_5,Sara,30,ES72209552827491055369,TRX_N-425-781341073194,2022-11-29T15:45:37,Donostia,Expense,education,-54.56,154154.83
buyer_5,Sara,30,ES72209552827491055369,TRX_N-426-866267753215,2022-12-01T20:43:19,Donostia,transfer,Salary,3359.75,157514.58
buyer_5,Sara,30,ES72209552827491055369,TRX_N-427-758224511745,2022-12-01T20:43:19,Donostia,transfer,Partner Salary,3407.23,160921.81
buyer_5,Sara,30,ES72209552827491055369,TRX_N-428-957987893380,2022-12-01T20:43:19,Donostia,transfer,Bonus,3245.53,164167.34
buyer_5,Sara,30,ES72209552827491055369,TRX_N-429-485055380074,2022-12-05T08:20:39,Donostia,Housing,Mortgage,-1902.5,162264.84
buyer_5,Sara,30,ES72209552827491055369,TRX_N-43-94426222390,2020-03-29T19:19:40,Bilbao,Expense,food,-256.55,26988.36
buyer_5,Sara,30,ES72209552827491055369,TRX_N-430-123901978795,2022-12-05T11:51:12,Donostia,Basic services,electricity,-114.45,162150.39
buyer_5,Sara,30,ES72209552827491055369,TRX_N-431-553028655084,2022-12-05T13:49:54,Donostia,Basic services,gas,-23.67,162126.72
buyer_5,Sara,30,ES72209552827491055369,TRX_N-432-539121269540,2022-12-05T00:38:36,Donostia,Basic services,internet,-62.88,162063.84
buyer_5,Sara,30,ES72209552827491055369,TRX_N-433-679711130755,2022-12-05T19:15:22,Donostia,Basic services,phone,-85.27,161978.57
buyer_5,Sara,30,ES72209552827491055369,TRX_N-434-996365793146,2022-12-06T20:51:47,Donostia,Basic services,internet,-36.39,161942.18
buyer_5,Sara,30,ES72209552827491055369,TRX_N-435-179793487789,2022-12-07T11:04:43,Donostia,Basic services,water,-30.73,161911.45
buyer_5,Sara,30,ES72209552827491055369,TRX_N-436-499050209187,2022-12-07T08:35:00,Donostia,Basic services,electricity,-50.9,161860.55
buyer_5,Sara,30,ES72209552827491055369,TRX_N-437-344401018642,2022-12-07T14:14:57,Donostia,Basic services,phone,-88.18,161772.37
buyer_5,Sara,30,ES72209552827491055369,TRX_N-438-793073011852,2022-12-18T09:25:09,Donostia,Expense,food,-257.41,161514.96
buyer_5,Sara,30,ES72209552827491055369,TRX_N-439-269654653734,2022-12-22T08:23:40,Donostia,Expense,appliances,-313.16,161201.8
buyer_5,Sara,30,ES72209552827491055369,TRX_N-44-568258181333,2020-03-31T06:46:46,Donostia,Expense,food,-618.57,26369.79
buyer_5,Sara,30,ES72209552827491055369,TRX_N-440-258464212316,2022-12-27T13:36:14,Donostia,Expense,transport,-147.22,161054.58
buyer_5,Sara,30,ES72209552827491055369,TRX_N-441-943213284497,2022-12-27T13:33:55,Donostia,Expense,clothing,-39.65,161014.93
buyer_5,Sara,30,ES72209552827491055369,TRX_N-442-924997920071,2022-12-29T10:16:32,Donostia,Expense,transport,-53.14,160961.79
buyer_5,Sara,30,ES72209552827491055369,TRX_N-443-644213503841,2023-01-01T09:39:10,Donostia,transfer,Salary,3359.75,164321.54
buyer_5,Sara,30,ES72209552827491055369,TRX_N-444-494927471705,2023-01-01T09:39:10,Donostia,transfer,Partner Salary,3407.23,167728.77
buyer_5,Sara,30,ES72209552827491055369,TRX_N-445-817121178550,2023-01-01T09:39:10,Donostia,transfer,Extra Income,335.98,168064.75
buyer_5,Sara,30,ES72209552827491055369,TRX_N-446-675929384353,2023-01-05T14:37:49,Donostia,Housing,Mortgage,-1902.5,166162.25
buyer_5,Sara,30,ES72209552827491055369,TRX_N-447-379998558308,2023-01-05T10:56:41,Donostia,Basic services,gas,-55.18,166107.07
buyer_5,Sara,30,ES72209552827491055369,TRX_N-448-836022225512,2023-01-05T12:03:17,Donostia,Basic services,internet,-60.73,166046.34
buyer_5,Sara,30,ES72209552827491055369,TRX_N-449-923446814310,2023-01-06T20:05:36,Donostia,Basic services,gas,-98.63,165947.71
buyer_5,Sara,30,ES72209552827491055369,TRX_N-45-479737845,2020-04-01T13:00:21,Donostia,transfer,Salary,3359.75,29729.54
buyer_5,Sara,30,ES72209552827491055369,TRX_N-450-948100557484,2023-01-06T20:32:59,Donostia,Basic services,internet,-55.29,165892.42
buyer_5,Sara,30,ES72209552827491055369,TRX_N-451-929012671646,2023-01-07T18:17:23,Donostia,Basic services,water,-43.55,165848.87
buyer_5,Sara,30,ES72209552827491055369,TRX_N-452-210019739611,2023-01-07T17:13:50,Donostia,Basic services,internet,-68.18,165780.69
buyer_5,Sara,30,ES72209552827491055369,TRX_N-453-815952384926,2023-01-26T14:26:17,Donostia,Expense,food,-529.59,165251.1
buyer_5,Sara,30,ES72209552827491055369,TRX_N-454-698295134583,2023-02-01T00:59:51,Donostia,transfer,Salary,3359.75,168610.85
buyer_5,Sara,30,ES72209552827491055369,TRX_N-455-668275489789,2023-02-01T00:59:51,Donostia,transfer,Partner Salary,3407.23,172018.08
buyer_5,Sara,30,ES72209552827491055369,TRX_N-456-759819122416,2023-02-05T12:13:32,Donostia,Housing,Mortgage,-1902.5,170115.58
buyer_5,Sara,30,ES72209552827491055369,TRX_N-457-706076445496,2023-02-05T13:06:37,Donostia,Basic services,gas,-42.74,170072.84
buyer_5,Sara,30,ES72209552827491055369,TRX_N-458-628904961431,2023-02-06T18:16:29,Donostia,Basic services,electricity,-51.02,170021.82
buyer_5,Sara,30,ES72209552827491055369,TRX_N-459-412727299927,2023-02-06T14:29:36,Donostia,Basic services,phone,-95.65,169926.17
buyer_5,Sara,30,ES72209552827491055369,TRX_N-46-496407087830,2020-04-01T13:00:21,Donostia,transfer,Partner Salary,3407.23,33136.77
buyer_5,Sara,30,ES72209552827491055369,TRX_N-460-278289035538,2023-02-07T08:38:29,Donostia,Basic services,electricity,-23.81,169902.36
buyer_5,Sara,30,ES72209552827491055369,TRX_N-461-681002433332,2023-02-07T07:50:08,Donostia,Basic services,gas,-78.51,169823.85
buyer_5,Sara,30,ES72209552827491055369,TRX_N-462-33187153085,2023-02-13T14:25:12,Donostia,Expense,food,-183.15,169640.7
buyer_5,Sara,30,ES72209552827491055369,TRX_N-463-684014897805,2023-02-14T11:08:08,Donostia,Expense,transport,-100.2,169540.5
buyer_5,Sara,30,ES72209552827491055369,TRX_N-464-34690945917,2023-03-01T10:49:06,Donostia,transfer,Salary,3359.75,172900.25
buyer_5,Sara,30,ES72209552827491055369,TRX_N-465-744195011129,2023-03-01T10:49:06,Donostia,transfer,Partner Salary,3407.23,176307.48
buyer_5,Sara,30,ES72209552827491055369,TRX_N-466-163998643708,2023-03-03T09:46:11,Donostia,Expense,food,-493.8,175813.68
buyer_5,Sara,30,ES72209552827491055369,TRX_N-467-795637391952,2023-03-05T18:16:59,Donostia,Housing,Mortgage,-1902.5,173911.18
buyer_5,Sara,30,ES72209552827491055369,TRX_N-468-756757872908,2023-03-05T17:30:26,Donostia,Basic services,gas,-32.24,173878.94
buyer_5,Sara,30,ES72209552827491055369,TRX_N-469-560331539012,2023-03-06T20:18:08,Donostia,Basic services,gas,-32.4,173846.54
buyer_5,Sara,30,ES72209552827491055369,TRX_N-47-464023923233,2020-04-01T14:23:25,Donostia,Expense,gifts,-468.09,32668.68
buyer_5,Sara,30,ES72209552827491055369,TRX_N-470-909795209472,2023-03-07T19:25:42,Donostia,Basic services,water,-69.56,173776.98
buyer_5,Sara,30,ES72209552827491055369,TRX_N-471-197909632213,2023-03-08T04:29:50,Durango,Expense,education,-697.71,173079.27
buyer_5,Sara,30,ES72209552827491055369,TRX_N-472-214502357574,2023-03-15T10:37:10,Donostia,Expense,leisure,-71.33,173007.94
buyer_5,Sara,30,ES72209552827491055369,TRX_N-473-652330913330,2023-03-16T08:42:31,Donostia,Expense,leisure,-243.74,172764.2
buyer_5,Sara,30,ES72209552827491055369,TRX_N-474-971533675494,2023-03-17T11:09:31,Donostia,Expense,food,-678.38,172085.82
buyer_5,Sara,30,ES72209552827491055369,TRX_N-475-70019579143,2023-03-19T08:21:59,Donostia,Expense,transport,-124.97,171960.85
buyer_5,Sara,30,ES72209552827491055369,TRX_N-476-910316659108,2023-04-01T13:23:50,Donostia,transfer,Salary,3359.75,175320.6
buyer_5,Sara,30,ES72209552827491055369,TRX_N-477-198069732587,2023-04-01T13:23:50,Donostia,transfer,Partner Salary,3407.23,178727.83
buyer_5,Sara,30,ES72209552827491055369,TRX_N-478-937327576671,2023-04-01T13:23:50,Donostia,transfer,Extra Income,335.98,179063.81
buyer_5,Sara,30,ES72209552827491055369,TRX_N-479-445138664169,2023-04-03T14:38:48,Donostia,Expense,clothing,-485.55,178578.26
buyer_5,Sara,30,ES72209552827491055369,TRX_N-48-825983866445,2020-04-05T17:55:52,Donostia,Housing,Mortgage,-1902.5,30766.18
buyer_5,Sara,30,ES72209552827491055369,TRX_N-480-47775011063,2023-04-05T21:27:58,Donostia,Housing,Mortgage,-1902.5,176675.76
buyer_5,Sara,30,ES72209552827491055369,TRX_N-481-81741722975,2023-04-05T16:30:31,Donostia,Basic services,water,-77.45,176598.31
buyer_5,Sara,30,ES72209552827491055369,TRX_N-482-677765620282,2023-04-05T09:26:27,Donostia,Basic services,gas,-44.17,176554.14
buyer_5,Sara,30,ES72209552827491055369,TRX_N-483-216924877367,2023-04-06T10:20:27,Donostia,Basic services,water,-10.42,176543.72
buyer_5,Sara,30,ES72209552827491055369,TRX_N-484-240361772418,2023-04-06T09:53:36,Donostia,Basic services,electricity,-68.71,176475.01
buyer_5,Sara,30,ES72209552827491055369,TRX_N-485-40514475561,2023-04-06T14:51:58,Donostia,Basic services,gas,-17.91,176457.1
buyer_5,Sara,30,ES72209552827491055369,TRX_N-486-611485086500,2023-04-06T12:26:37,Donostia,Basic services,internet,-79.42,176377.68
buyer_5,Sara,30,ES72209552827491055369,TRX_N-487-580026503115,2023-04-07T05:26:00,Donostia,Basic services,water,-16.8,176360.88
buyer_5,Sara,30,ES72209552827491055369,TRX_N-488-793236667802,2023-04-07T22:24:35,Donostia,Basic services,electricity,-122.08,176238.8
buyer_5,Sara,30,ES72209552827491055369,TRX_N-489-371255901982,2023-04-07T08:29:18,Donostia,Expense,food,-424.97,175813.83
buyer_5,Sara,30,ES72209552827491055369,TRX_N-49-272725460468,2020-04-05T19:54:19,Donostia,Basic services,water,-78.56,30687.62
buyer_5,Sara,30,ES72209552827491055369,TRX_N-490-899355378491,2023-04-15T09:55:46,Donostia,Expense,clothing,-447.05,175366.78
buyer_5,Sara,30,ES72209552827491055369,TRX_N-491-516726032180,2023-04-20T10:27:55,Donostia,Expense,food,-545.42,174821.36
buyer_5,Sara,30,ES72209552827491055369,TRX_N-492-179656818934,2023-04-27T20:49:39,Labastida/Bastida,Expense,gifts,-353.81,174467.55
buyer_5,Sara,30,ES72209552827491055369,TRX_N-493-887821295875,2023-05-01T07:22:27,Donostia,transfer,Salary,3359.75,177827.3
buyer_5,Sara,30,ES72209552827491055369,TRX_N-494-437157827439,2023-05-01T07:22:27,Donostia,transfer,Partner Salary,3407.23,181234.53
buyer_5,Sara,30,ES72209552827491055369,TRX_N-495-400380093668,2023-05-05T16:40:21,Donostia,Housing,Mortgage,-1902.5,179332.03
buyer_5,Sara,30,ES72209552827491055369,TRX_N-496-991384870721,2023-05-06T12:46:40,Donostia,Basic services,phone,-75.42,179256.61
buyer_5,Sara,30,ES72209552827491055369,TRX_N-497-114426889134,2023-05-07T08:20:59,Donostia,Basic services,water,-12.53,179244.08
buyer_5,Sara,30,ES72209552827491055369,TRX_N-498-598991367547,2023-05-07T13:23:19,Donostia,Basic services,electricity,-85.87,179158.21
buyer_5,Sara,30,ES72209552827491055369,TRX_N-499-707309927507,2023-05-26T17:13:35,Donostia,Expense,transport,-148.78,179009.43
buyer_5,Sara,30,ES72209552827491055369,TRX_N-5-734079095469,2020-01-05T19:11:13,Donostia,Housing,Mortgage,-1902.5,22437.6
buyer_5,Sara,30,ES72209552827491055369,TRX_N-50-105935671271,2020-04-05T09:16:14,Donostia,Basic services,gas,-19.43,30668.19
buyer_5,Sara,30,ES72209552827491055369,TRX_N-500-400858229701,2023-05-29T16:28:02,Donostia,Expense,leisure,-207.91,178801.52
buyer_5,Sara,30,ES72209552827491055369,TRX_N-501-579808057196,2023-06-01T14:43:32,Donostia,transfer,Salary,3359.75,182161.27
buyer_5,Sara,30,ES72209552827491055369,TRX_N-502-979203364469,2023-06-01T14:43:32,Donostia,transfer,Partner Salary,3407.23,185568.5
buyer_5,Sara,30,ES72209552827491055369,TRX_N-503-283974969812,2023-06-01T14:43:32,Donostia,transfer,Bonus,3666.42,189234.92
buyer_5,Sara,30,ES72209552827491055369,TRX_N-504-965077142339,2023-06-05T16:34:09,Donostia,Housing,Mortgage,-1902.5,187332.42
buyer_5,Sara,30,ES72209552827491055369,TRX_N-505-303575905421,2023-06-05T19:36:45,Donostia,Basic services,water,-36.08,187296.34
buyer_5,Sara,30,ES72209552827491055369,TRX_N-506-237757394434,2023-06-06T11:41:40,Donostia,Basic services,electricity,-124.97,187171.37
buyer_5,Sara,30,ES72209552827491055369,TRX_N-507-472678497872,2023-06-06T11:26:58,Donostia,Basic services,phone,-24.68,187146.69
buyer_5,Sara,30,ES72209552827491055369,TRX_N-508-578577540886,2023-06-07T17:42:42,Donostia,Basic services,electricity,-106.09,187040.6
buyer_5,Sara,30,ES72209552827491055369,TRX_N-509-508259658549,2023-06-07T22:25:09,Donostia,Basic services,gas,-18.99,187021.61
buyer_5,Sara,30,ES72209552827491055369,TRX_N-51-372294982223,2020-04-05T15:36:34,Donostia,Basic services,phone,-85.83,30582.36
buyer_5,Sara,30,ES72209552827491055369,TRX_N-510-358086460418,2023-06-07T14:50:27,Donostia,Basic services,internet,-42.79,186978.82
buyer_5,Sara,30,ES72209552827491055369,TRX_N-511-357383095171,2023-06-08T13:33:45,Donostia,Expense,clothing,-235.86,186742.96
buyer_5,Sara,30,ES72209552827491055369,TRX_N-512-611649467398,2023-06-17T12:44:21,Donostia,Expense,food,-264.72,186478.24
buyer_5,Sara,30,ES72209552827491055369,TRX_N-513-833494913974,2023-06-26T19:47:03,Bermeo,Expense,clothing,-85.23,186393.01
buyer_5,Sara,30,ES72209552827491055369,TRX_N-514-548157693332,2023-06-28T14:42:54,Pasaia,Expense,transport,-51.82,186341.19
buyer_5,Sara,30,ES72209552827491055369,TRX_N-515-44997197442,2023-07-01T17:31:42,Donostia,transfer,Salary,3359.75,189700.94
buyer_5,Sara,30,ES72209552827491055369,TRX_N-516-450407732188,2023-07-01T17:31:42,Donostia,transfer,Partner Salary,3407.23,193108.17
buyer_5,Sara,30,ES72209552827491055369,TRX_N-517-484410087442,2023-07-01T17:31:42,Donostia,transfer,Extra Income,335.98,193444.15
buyer_5,Sara,30,ES72209552827491055369,TRX_N-518-262366256013,2023-07-02T12:46:22,Donostia,Expense,transport,-135.88,193308.27
buyer_5,Sara,30,ES72209552827491055369,TRX_N-519-762148991827,2023-07-02T10:04:10,Zarautz,Expense,clothing,-232.11,193076.16
buyer_5,Sara,30,ES72209552827491055369,TRX_N-52-622211231254,2020-04-06T16:54:03,Donostia,Basic services,gas,-86.0,30496.36
buyer_5,Sara,30,ES72209552827491055369,TRX_N-520-284221235368,2023-07-02T10:57:06,Donostia,Expense,education,-667.66,192408.5
buyer_5,Sara,30,ES72209552827491055369,TRX_N-521-885900999646,2023-07-03T14:55:46,Donostia,Expense,food,-209.38,192199.12
buyer_5,Sara,30,ES72209552827491055369,TRX_N-522-996957527865,2023-07-05T09:04:24,Donostia,Housing,Mortgage,-1902.5,190296.62
buyer_5,Sara,30,ES72209552827491055369,TRX_N-523-929322527311,2023-07-05T19:18:53,Donostia,Basic services,electricity,-148.99,190147.63
buyer_5,Sara,30,ES72209552827491055369,TRX_N-524-842872533372,2023-07-05T23:01:09,Donostia,Basic services,gas,-41.15,190106.48
buyer_5,Sara,30,ES72209552827491055369,TRX_N-525-927972056896,2023-07-05T22:33:48,Donostia,Basic services,internet,-74.21,190032.27
buyer_5,Sara,30,ES72209552827491055369,TRX_N-526-260746888198,2023-07-06T01:58:43,Donostia,Basic services,water,-10.07,190022.2
buyer_5,Sara,30,ES72209552827491055369,TRX_N-527-165728857618,2023-07-06T08:06:26,Donostia,Basic services,gas,-48.2,189974.0
buyer_5,Sara,30,ES72209552827491055369,TRX_N-528-633296329555,2023-07-23T21:54:44,Labastida/Bastida,Expense,food,-568.2,189405.8
buyer_5,Sara,30,ES72209552827491055369,TRX_N-529-459991671473,2023-07-28T05:36:54,Santurtzi,Expense,clothing,-451.46,188954.34
buyer_5,Sara,30,ES72209552827491055369,TRX_N-53-535944589750,2020-04-07T20:38:44,Donostia,Basic services,gas,-85.04,30411.32
buyer_5,Sara,30,ES72209552827491055369,TRX_N-530-31394717167,2023-08-01T04:13:49,Donostia,transfer,Salary,3359.75,192314.09
buyer_5,Sara,30,ES72209552827491055369,TRX_N-531-460129872248,2023-08-01T04:13:49,Donostia,transfer,Partner Salary,3407.23,195721.32
buyer_5,Sara,30,ES72209552827491055369,TRX_N-532-139129298192,2023-08-04T17:56:54,Donostia,Expense,gifts,-176.98,195544.34
buyer_5,Sara,30,ES72209552827491055369,TRX_N-533-154809136934,2023-08-05T10:21:40,Donostia,Housing,Mortgage,-1902.5,193641.84
buyer_5,Sara,30,ES72209552827491055369,TRX_N-534-828743641863,2023-08-06T00:49:11,Donostia,Basic services,water,-67.4,193574.44
buyer_5,Sara,30,ES72209552827491055369,TRX_N-535-363370502246,2023-08-06T23:37:20,Donostia,Basic services,electricity,-142.48,193431.96
buyer_5,Sara,30,ES72209552827491055369,TRX_N-536-979765134988,2023-08-06T15:41:17,Donostia,Basic services,gas,-35.68,193396.28
buyer_5,Sara,30,ES72209552827491055369,TRX_N-537-111032119822,2023-08-07T11:50:25,Donostia,Basic services,electricity,-128.84,193267.44
buyer_5,Sara,30,ES72209552827491055369,TRX_N-538-835516328519,2023-08-09T12:22:52,Donostia,Expense,transport,-193.41,193074.03
buyer_5,Sara,30,ES72209552827491055369,TRX_N-539-176687490185,2023-08-21T17:40:38,Donostia,Expense,repairs,-507.92,192566.11
buyer_5,Sara,30,ES72209552827491055369,TRX_N-54-600900453813,2020-04-07T10:20:36,Donostia,Expense,repairs,-267.25,30144.07
buyer_5,Sara,30,ES72209552827491055369,TRX_N-540-987436784804,2023-08-22T13:39:20,Donostia,Expense,clothing,-490.6,192075.51
buyer_5,Sara,30,ES72209552827491055369,TRX_N-541-250826635317,2023-08-30T16:29:19,Berango,Expense,leisure,-197.73,191877.78
buyer_5,Sara,30,ES72209552827491055369,TRX_N-542-506784875870,2023-09-01T20:52:59,Donostia,transfer,Salary,3359.75,195237.53
buyer_5,Sara,30,ES72209552827491055369,TRX_N-543-301143632031,2023-09-01T20:52:59,Donostia,transfer,Partner Salary,3407.23,198644.76
buyer_5,Sara,30,ES72209552827491055369,TRX_N-544-303593564466,2023-09-01T12:19:20,Donostia,Expense,leisure,-87.37,198557.39
buyer_5,Sara,30,ES72209552827491055369,TRX_N-545-916048801591,2023-09-05T11:56:05,Donostia,Housing,Mortgage,-1902.5,196654.89
buyer_5,Sara,30,ES72209552827491055369,TRX_N-546-449280571944,2023-09-05T16:27:06,Donostia,Basic services,water,-68.56,196586.33
buyer_5,Sara,30,ES72209552827491055369,TRX_N-547-779689461558,2023-09-05T16:59:14,Donostia,Basic services,internet,-30.37,196555.96
buyer_5,Sara,30,ES72209552827491055369,TRX_N-548-704779187095,2023-09-05T20:40:36,Donostia,Basic services,phone,-48.97,196506.99
buyer_5,Sara,30,ES72209552827491055369,TRX_N-549-638052045444,2023-09-05T10:44:59,Donostia,Expense,repairs,-559.62,195947.37
buyer_5,Sara,30,ES72209552827491055369,TRX_N-55-415735277675,2020-04-21T15:44:59,Donostia,Expense,gifts,-397.22,29746.85
buyer_5,Sara,30,ES72209552827491055369,TRX_N-550-344939762436,2023-09-07T17:48:08,Donostia,Basic services,water,-68.9,195878.47
buyer_5,Sara,30,ES72209552827491055369,TRX_N-551-129147333658,2023-09-07T11:13:34,Donostia,Basic services,phone,-53.35,195825.12
buyer_5,Sara,30,ES72209552827491055369,TRX_N-552-795355407921,2023-09-07T15:00:59,Donostia,Expense,food,-250.35,195574.77
buyer_5,Sara,30,ES72209552827491055369,TRX_N-553-572097257637,2023-09-12T12:29:29,Donostia,Expense,food,-653.42,194921.35
buyer_5,Sara,30,ES72209552827491055369,TRX_N-554-517927524673,2023-09-16T18:19:25,Donostia,Expense,travel,-880.2,194041.15
buyer_5,Sara,30,ES72209552827491055369,TRX_N-555-863083589859,2023-09-24T13:33:29,Donostia,Expense,education,-565.54,193475.61
buyer_5,Sara,30,ES72209552827491055369,TRX_N-556-733657338033,2023-10-01T11:38:16,Donostia,transfer,Salary,3359.75,196835.36
buyer_5,Sara,30,ES72209552827491055369,TRX_N-557-925865272193,2023-10-01T11:38:16,Donostia,transfer,Partner Salary,3407.23,200242.59
buyer_5,Sara,30,ES72209552827491055369,TRX_N-558-792847991534,2023-10-01T11:38:16,Donostia,transfer,Extra Income,335.98,200578.57
buyer_5,Sara,30,ES72209552827491055369,TRX_N-559-983654971012,2023-10-03T09:03:39,Arrasate/Mondragon,Expense,leisure,-234.55,200344.02
buyer_5,Sara,30,ES72209552827491055369,TRX_N-56-397488260650,2020-04-24T20:24:54,Donostia,Expense,leisure,-264.38,29482.47
buyer_5,Sara,30,ES72209552827491055369,TRX_N-560-995376674723,2023-10-04T19:05:37,Donostia,Expense,repairs,-444.4,199899.62
buyer_5,Sara,30,ES72209552827491055369,TRX_N-561-762351729008,2023-10-05T20:23:34,Donostia,Housing,Mortgage,-1902.5,197997.12
buyer_5,Sara,30,ES72209552827491055369,TRX_N-562-267218819914,2023-10-05T17:52:48,Donostia,Basic services,water,-32.53,197964.59
buyer_5,Sara,30,ES72209552827491055369,TRX_N-563-7192356905,2023-10-06T20:30:37,Donostia,Basic services,gas,-21.68,197942.91
buyer_5,Sara,30,ES72209552827491055369,TRX_N-564-566255930899,2023-10-06T16:40:59,Donostia,Basic services,internet,-67.93,197874.98
buyer_5,Sara,30,ES72209552827491055369,TRX_N-565-678042632078,2023-10-07T06:22:20,Donostia,Basic services,gas,-97.01,197777.97
buyer_5,Sara,30,ES72209552827491055369,TRX_N-566-228394444995,2023-11-01T15:02:48,Donostia,transfer,Salary,3359.75,201137.72
buyer_5,Sara,30,ES72209552827491055369,TRX_N-567-471554484938,2023-11-01T15:02:48,Donostia,transfer,Partner Salary,3407.23,204544.95
buyer_5,Sara,30,ES72209552827491055369,TRX_N-568-63418571945,2023-11-05T10:42:29,Donostia,Housing,Mortgage,-1902.5,202642.45
buyer_5,Sara,30,ES72209552827491055369,TRX_N-569-58583548842,2023-11-06T11:19:08,Donostia,Basic services,electricity,-62.49,202579.96
buyer_5,Sara,30,ES72209552827491055369,TRX_N-57-753857665533,2020-05-01T02:04:00,Donostia,transfer,Salary,3359.75,32842.22
buyer_5,Sara,30,ES72209552827491055369,TRX_N-570-111146688281,2023-11-06T10:19:37,Donostia,Basic services,gas,-34.1,202545.86
buyer_5,Sara,30,ES72209552827491055369,TRX_N-571-856183907132,2023-11-07T13:59:01,Donostia,Basic services,internet,-76.12,202469.74
buyer_5,Sara,30,ES72209552827491055369,TRX_N-572-133881739450,2023-11-07T17:13:56,Donostia,Basic services,phone,-76.43,202393.31
buyer_5,Sara,30,ES72209552827491055369,TRX_N-573-485144662408,2023-11-18T18:46:56,Donostia,Expense,travel,-358.3,202035.01
buyer_5,Sara,30,ES72209552827491055369,TRX_N-574-315860792692,2023-11-22T16:17:49,Donostia,Expense,education,-59.58,201975.43
buyer_5,Sara,30,ES72209552827491055369,TRX_N-575-382988166725,2023-11-27T10:01:44,Donostia,Expense,clothing,-293.07,201682.36
buyer_5,Sara,30,ES72209552827491055369,TRX_N-576-284472481901,2023-12-01T21:48:28,Donostia,transfer,Salary,3359.75,205042.11
buyer_5,Sara,30,ES72209552827491055369,TRX_N-577-5816747123,2023-12-01T21:48:28,Donostia,transfer,Partner Salary,3407.23,208449.34
buyer_5,Sara,30,ES72209552827491055369,TRX_N-578-553742495346,2023-12-01T21:48:28,Donostia,transfer,Extra Income,335.98,208785.32
buyer_5,Sara,30,ES72209552827491055369,TRX_N-579-961552482027,2023-12-01T21:48:28,Donostia,transfer,Bonus,3310.33,212095.65
buyer_5,Sara,30,ES72209552827491055369,TRX_N-58-17488366432,2020-05-01T02:04:00,Donostia,transfer,Partner Salary,3407.23,36249.45
buyer_5,Sara,30,ES72209552827491055369,TRX_N-580-341501808626,2023-12-05T15:36:40,Donostia,Housing,Mortgage,-1902.5,210193.15
buyer_5,Sara,30,ES72209552827491055369,TRX_N-581-763504430909,2023-12-05T14:57:20,Donostia,Basic services,gas,-74.66,210118.49
buyer_5,Sara,30,ES72209552827491055369,TRX_N-582-774975704288,2023-12-07T08:34:33,Donostia,Basic services,gas,-46.06,210072.43
buyer_5,Sara,30,ES72209552827491055369,TRX_N-583-168777739606,2023-12-07T10:26:37,Donostia,Basic services,phone,-30.73,210041.7
buyer_5,Sara,30,ES72209552827491055369,TRX_N-584-48697541527,2023-12-09T14:52:30,Donostia,Expense,food,-227.92,209813.78
buyer_5,Sara,30,ES72209552827491055369,TRX_N-585-39860317471,2023-12-29T20:05:12,Donostia,Expense,food,-716.04,209097.74
buyer_5,Sara,30,ES72209552827491055369,TRX_N-586-673616453049,2024-01-01T23:26:33,Donostia,transfer,Salary,3359.75,212457.49
buyer_5,Sara,30,ES72209552827491055369,TRX_N-587-797063212343,2024-01-01T23:26:33,Donostia,transfer,Partner Salary,3407.23,215864.72
buyer_5,Sara,30,ES72209552827491055369,TRX_N-588-556536206249,2024-01-05T15:25:52,Donostia,Housing,Mortgage,-1902.5,213962.22
buyer_5,Sara,30,ES72209552827491055369,TRX_N-589-427248169092,2024-01-05T20:56:10,Donostia,Basic services,electricity,-77.81,213884.41
buyer_5,Sara,30,ES72209552827491055369,TRX_N-59-412463700736,2020-05-01T02:04:00,Donostia,transfer,Extra Income,335.98,36585.43
buyer_5,Sara,30,ES72209552827491055369,TRX_N-590-63963396816,2024-01-05T15:16:21,Donostia,Basic services,internet,-52.9,213831.51
buyer_5,Sara,30,ES72209552827491055369,TRX_N-591-628170797517,2024-01-05T10:54:20,Donostia,Basic services,phone,-35.17,213796.34
buyer_5,Sara,30,ES72209552827491055369,TRX_N-592-395044881005,2024-01-07T09:18:28,Donostia,Basic services,gas,-52.26,213744.08
buyer_5,Sara,30,ES72209552827491055369,TRX_N-593-756384402530,2024-01-07T18:28:37,Donostia,Basic services,internet,-46.49,213697.59
buyer_5,Sara,30,ES72209552827491055369,TRX_N-594-308587873633,2024-01-07T19:20:24,Donostia,Expense,clothing,-34.22,213663.37
buyer_5,Sara,30,ES72209552827491055369,TRX_N-595-42600880926,2024-01-10T23:20:20,Donostia,Expense,food,-480.8,213182.57
buyer_5,Sara,30,ES72209552827491055369,TRX_N-596-247219201869,2024-01-13T19:00:19,Donostia,Expense,clothing,-334.4,212848.17
buyer_5,Sara,30,ES72209552827491055369,TRX_N-597-444625932163,2024-01-30T11:16:49,Donostia,Expense,education,-835.17,212013.0
buyer_5,Sara,30,ES72209552827491055369,TRX_N-598-88185450193,2024-02-01T14:18:38,Donostia,transfer,Salary,3359.75,215372.75
buyer_5,Sara,30,ES72209552827491055369,TRX_N-599-451435829810,2024-02-01T14:18:38,Donostia,transfer,Partner Salary,3407.23,218779.98
buyer_5,Sara,30,ES72209552827491055369,TRX_N-6-13832068492,2020-01-05T12:47:22,Donostia,Basic services,water,-46.89,22390.71
buyer_5,Sara,30,ES72209552827491055369,TRX_N-60-921942094445,2020-05-05T14:25:42,Donostia,Housing,Mortgage,-1902.5,34682.93
buyer_5,Sara,30,ES72209552827491055369,TRX_N-600-228191809873,2024-02-05T18:00:51,Donostia,Housing,Mortgage,-1902.5,216877.48
buyer_5,Sara,30,ES72209552827491055369,TRX_N-601-581066739752,2024-02-06T15:15:52,Donostia,Basic services,water,-45.66,216831.82
buyer_5,Sara,30,ES72209552827491055369,TRX_N-602-913473653690,2024-02-06T18:35:00,Donostia,Basic services,internet,-65.57,216766.25
buyer_5,Sara,30,ES72209552827491055369,TRX_N-603-294046334841,2024-02-07T11:17:48,Donostia,Basic services,electricity,-121.06,216645.19
buyer_5,Sara,30,ES72209552827491055369,TRX_N-604-153461002807,2024-02-07T12:48:43,Donostia,Basic services,gas,-32.1,216613.09
buyer_5,Sara,30,ES72209552827491055369,TRX_N-605-91649307852,2024-02-10T11:28:59,Alegría-Dulantzi,Expense,leisure,-60.25,216552.84
buyer_5,Sara,30,ES72209552827491055369,TRX_N-606-506504411279,2024-02-21T15:03:24,Donostia,Expense,clothing,-171.48,216381.36
buyer_5,Sara,30,ES72209552827491055369,TRX_N-607-88924453639,2024-03-01T20:36:28,Donostia,transfer,Salary,3359.75,219741.11
buyer_5,Sara,30,ES72209552827491055369,TRX_N-608-738138187944,2024-03-01T20:36:28,Donostia,transfer,Partner Salary,3407.23,223148.34
buyer_5,Sara,30,ES72209552827491055369,TRX_N-609-540412513371,2024-03-01T20:36:28,Donostia,transfer,Extra Income,335.98,223484.32
buyer_5,Sara,30,ES72209552827491055369,TRX_N-61-272033569174,2020-05-05T08:43:04,Donostia,Basic services,gas,-69.98,34612.95
buyer_5,Sara,30,ES72209552827491055369,TRX_N-610-592283909493,2024-03-05T08:52:36,Donostia,Housing,Mortgage,-1902.5,221581.82
buyer_5,Sara,30,ES72209552827491055369,TRX_N-611-373141733904,2024-03-05T09:05:21,Donostia,Basic services,internet,-72.9,221508.92
buyer_5,Sara,30,ES72209552827491055369,TRX_N-612-139146071255,2024-03-06T05:33:22,Donostia,Basic services,water,-35.71,221473.21
buyer_5,Sara,30,ES72209552827491055369,TRX_N-613-701965145322,2024-03-06T23:41:42,Donostia,Basic services,phone,-59.91,221413.3
buyer_5,Sara,30,ES72209552827491055369,TRX_N-614-100854031150,2024-03-06T09:31:46,Donostia,Expense,food,-772.59,220640.71
buyer_5,Sara,30,ES72209552827491055369,TRX_N-615-776521298333,2024-03-06T12:24:28,Donostia,Expense,transport,-61.06,220579.65
buyer_5,Sara,30,ES72209552827491055369,TRX_N-616-808791869532,2024-03-06T11:45:02,Donostia,Expense,healthcare,-236.14,220343.51
buyer_5,Sara,30,ES72209552827491055369,TRX_N-617-352925476349,2024-03-07T12:11:22,Donostia,Basic services,electricity,-107.18,220236.33
buyer_5,Sara,30,ES72209552827491055369,TRX_N-618-19406243753,2024-03-07T15:28:29,Donostia,Expense,leisure,-220.99,220015.34
buyer_5,Sara,30,ES72209552827491055369,TRX_N-619-4304275346,2024-03-10T09:44:28,Zuia,Expense,transport,-137.25,219878.09
buyer_5,Sara,30,ES72209552827491055369,TRX_N-62-61472847379,2020-05-06T14:40:31,Donostia,Basic services,phone,-87.93,34525.02
buyer_5,Sara,30,ES72209552827491055369,TRX_N-620-673045957095,2024-03-14T10:15:57,Donostia,Expense,healthcare,-356.32,219521.77
buyer_5,Sara,30,ES72209552827491055369,TRX_N-621-567576443996,2024-04-01T09:57:24,Donostia,transfer,Salary,3359.75,222881.52
buyer_5,Sara,30,ES72209552827491055369,TRX_N-622-981470460111,2024-04-01T09:57:24,Donostia,transfer,Partner Salary,3407.23,226288.75
buyer_5,Sara,30,ES72209552827491055369,TRX_N-623-332187788187,2024-04-04T23:30:01,Durango,Expense,clothing,-51.41,226237.34
buyer_5,Sara,30,ES72209552827491055369,TRX_N-624-74095887963,2024-04-05T09:58:41,Donostia,Housing,Mortgage,-1902.5,224334.84
buyer_5,Sara,30,ES72209552827491055369,TRX_N-625-592835448162,2024-04-05T08:45:13,Donostia,Basic services,gas,-66.54,224268.3
buyer_5,Sara,30,ES72209552827491055369,TRX_N-626-702289484647,2024-04-05T17:50:00,Donostia,Basic services,internet,-32.71,224235.59
buyer_5,Sara,30,ES72209552827491055369,TRX_N-627-440121684335,2024-04-05T15:16:32,Donostia,Basic services,phone,-90.15,224145.44
buyer_5,Sara,30,ES72209552827491055369,TRX_N-628-684464443045,2024-04-06T15:47:37,Donostia,Expense,healthcare,-342.29,223803.15
buyer_5,Sara,30,ES72209552827491055369,TRX_N-629-57706362066,2024-04-07T12:55:35,Donostia,Basic services,electricity,-30.21,223772.94
buyer_5,Sara,30,ES72209552827491055369,TRX_N-63-458233466277,2020-05-07T20:46:18,Donostia,Basic services,water,-53.36,34471.66
buyer_5,Sara,30,ES72209552827491055369,TRX_N-630-829346902084,2024-04-07T15:34:58,Donostia,Basic services,gas,-84.5,223688.44
buyer_5,Sara,30,ES72209552827491055369,TRX_N-631-772370456645,2024-04-07T17:01:07,Donostia,Basic services,internet,-30.29,223658.15
buyer_5,Sara,30,ES72209552827491055369,TRX_N-632-538157012941,2024-04-16T17:46:09,Donostia,Expense,transport,-156.11,223502.04
buyer_5,Sara,30,ES72209552827491055369,TRX_N-633-95437502434,2024-04-24T09:41:30,Donostia,Expense,gifts,-193.58,223308.46
buyer_5,Sara,30,ES72209552827491055369,TRX_N-634-681216747223,2024-05-01T09:20:12,Donostia,transfer,Salary,3359.75,226668.21
buyer_5,Sara,30,ES72209552827491055369,TRX_N-635-157732817373,2024-05-01T09:20:12,Donostia,transfer,Partner Salary,3407.23,230075.44
buyer_5,Sara,30,ES72209552827491055369,TRX_N-636-927387666335,2024-05-01T09:20:12,Donostia,transfer,Extra Income,335.98,230411.42
buyer_5,Sara,30,ES72209552827491055369,TRX_N-637-233388184558,2024-05-05T21:42:08,Donostia,Housing,Mortgage,-1902.5,228508.92
buyer_5,Sara,30,ES72209552827491055369,TRX_N-638-852361382781,2024-05-05T15:10:17,Donostia,Basic services,water,-20.2,228488.72
buyer_5,Sara,30,ES72209552827491055369,TRX_N-639-110220242654,2024-05-05T11:36:20,Donostia,Basic services,internet,-37.92,228450.8
buyer_5,Sara,30,ES72209552827491055369,TRX_N-64-595910668655,2020-05-13T12:18:22,Donostia,Expense,leisure,-196.84,34274.82
buyer_5,Sara,30,ES72209552827491055369,TRX_N-640-183331607266,2024-05-06T12:08:43,Donostia,Basic services,water,-48.22,228402.58
buyer_5,Sara,30,ES72209552827491055369,TRX_N-641-947426095292,2024-05-06T06:50:32,Donostia,Basic services,internet,-46.27,228356.31
buyer_5,Sara,30,ES72209552827491055369,TRX_N-642-957865389425,2024-05-07T01:13:20,Donostia,Basic services,internet,-45.73,228310.58
buyer_5,Sara,30,ES72209552827491055369,TRX_N-643-466713079084,2024-05-12T10:47:52,Donostia,Expense,gifts,-298.31,228012.27
buyer_5,Sara,30,ES72209552827491055369,TRX_N-644-906994382686,2024-05-27T10:13:58,Donostia,Expense,transport,-160.86,227851.41
buyer_5,Sara,30,ES72209552827491055369,TRX_N-645-863666212169,2024-06-01T19:52:54,Donostia,transfer,Salary,3359.75,231211.16
buyer_5,Sara,30,ES72209552827491055369,TRX_N-646-85706765669,2024-06-01T19:52:54,Donostia,transfer,Partner Salary,3407.23,234618.39
buyer_5,Sara,30,ES72209552827491055369,TRX_N-647-535379880150,2024-06-01T19:52:54,Donostia,transfer,Bonus,3513.58,238131.97
buyer_5,Sara,30,ES72209552827491055369,TRX_N-648-842787192564,2024-06-03T15:53:52,Salvatierra/Agurain,Expense,leisure,-200.82,237931.15
buyer_5,Sara,30,ES72209552827491055369,TRX_N-649-199904591507,2024-06-05T20:06:19,Donostia,Housing,Mortgage,-1902.5,236028.65
buyer_5,Sara,30,ES72209552827491055369,TRX_N-65-702410421576,2020-05-23T09:56:45,Donostia,Expense,food,-703.66,33571.16
buyer_5,Sara,30,ES72209552827491055369,TRX_N-650-350757871299,2024-06-05T13:33:03,Donostia,Basic services,internet,-39.02,235989.63
buyer_5,Sara,30,ES72209552827491055369,TRX_N-651-771568692972,2024-06-06T16:10:56,Donostia,Basic services,water,-71.71,235917.92
buyer_5,Sara,30,ES72209552827491055369,TRX_N-652-922337594598,2024-06-06T16:13:07,Donostia,Basic services,electricity,-23.73,235894.19
buyer_5,Sara,30,ES72209552827491055369,TRX_N-653-428888723700,2024-06-07T08:18:02,Donostia,Basic services,water,-44.37,235849.82
buyer_5,Sara,30,ES72209552827491055369,TRX_N-654-762200782852,2024-06-07T10:10:11,Donostia,Basic services,internet,-53.78,235796.04
buyer_5,Sara,30,ES72209552827491055369,TRX_N-655-943745159864,2024-06-20T23:23:54,Zarautz,Expense,transport,-78.45,235717.59
buyer_5,Sara,30,ES72209552827491055369,TRX_N-656-266444003266,2024-06-27T05:07:34,Donostia,Expense,transport,-160.7,235556.89
buyer_5,Sara,30,ES72209552827491055369,TRX_N-657-419721101862,2024-06-27T16:54:36,Getxo,Expense,healthcare,-370.73,235186.16
buyer_5,Sara,30,ES72209552827491055369,TRX_N-658-922446192138,2024-07-01T22:59:56,Donostia,transfer,Salary,3359.75,238545.91
buyer_5,Sara,30,ES72209552827491055369,TRX_N-659-364170028658,2024-07-01T22:59:56,Donostia,transfer,Partner Salary,3407.23,241953.14
buyer_5,Sara,30,ES72209552827491055369,TRX_N-66-967823085242,2020-06-01T03:03:15,Donostia,transfer,Salary,3359.75,36930.91
buyer_5,Sara,30,ES72209552827491055369,TRX_N-660-185160101798,2024-07-01T22:59:56,Donostia,transfer,Extra Income,335.98,242289.12
buyer_5,Sara,30,ES72209552827491055369,TRX_N-661-991693507057,2024-07-05T18:28:17,Donostia,Housing,Mortgage,-1902.5,240386.62
buyer_5,Sara,30,ES72209552827491055369,TRX_N-662-641989963389,2024-07-05T04:47:31,Donostia,Basic services,water,-57.09,240329.53
buyer_5,Sara,30,ES72209552827491055369,TRX_N-663-829166718258,2024-07-05T09:45:54,Donostia,Basic services,phone,-73.87,240255.66
buyer_5,Sara,30,ES72209552827491055369,TRX_N-664-25952566859,2024-07-06T15:33:29,Donostia,Basic services,gas,-37.29,240218.37
buyer_5,Sara,30,ES72209552827491055369,TRX_N-665-995077099895,2024-07-07T12:24:00,Donostia,Basic services,water,-47.04,240171.33
buyer_5,Sara,30,ES72209552827491055369,TRX_N-666-716529464128,2024-07-07T10:06:26,Donostia,Basic services,electricity,-134.05,240037.28
buyer_5,Sara,30,ES72209552827491055369,TRX_N-667-415176891742,2024-07-07T20:47:49,Donostia,Basic services,internet,-79.63,239957.65
buyer_5,Sara,30,ES72209552827491055369,TRX_N-668-732663529624,2024-07-07T19:06:50,Donostia,Expense,transport,-153.96,239803.69
buyer_5,Sara,30,ES72209552827491055369,TRX_N-669-445962152997,2024-07-17T18:14:11,Donostia,Expense,travel,-652.3,239151.39
buyer_5,Sara,30,ES72209552827491055369,TRX_N-67-7477043338,2020-06-01T03:03:15,Donostia,transfer,Partner Salary,3407.23,40338.14
buyer_5,Sara,30,ES72209552827491055369,TRX_N-670-506849850856,2024-08-01T23:23:20,Donostia,transfer,Salary,3359.75,242511.14
buyer_5,Sara,30,ES72209552827491055369,TRX_N-671-484060899026,2024-08-01T23:23:20,Donostia,transfer,Partner Salary,3407.23,245918.37
buyer_5,Sara,30,ES72209552827491055369,TRX_N-672-634466592391,2024-08-05T21:48:24,Donostia,Housing,Mortgage,-1902.5,244015.87
buyer_5,Sara,30,ES72209552827491055369,TRX_N-673-118610493258,2024-08-05T21:05:41,Donostia,Basic services,gas,-79.12,243936.75
buyer_5,Sara,30,ES72209552827491055369,TRX_N-674-775943900619,2024-08-05T20:31:45,Donostia,Basic services,internet,-56.19,243880.56
buyer_5,Sara,30,ES72209552827491055369,TRX_N-675-671686080154,2024-08-06T16:17:36,Donostia,Basic services,internet,-69.26,243811.3
buyer_5,Sara,30,ES72209552827491055369,TRX_N-676-952844741488,2024-08-07T18:54:02,Donostia,Basic services,water,-53.05,243758.25
buyer_5,Sara,30,ES72209552827491055369,TRX_N-677-994157904589,2024-08-07T20:36:59,Donostia,Basic services,phone,-22.34,243735.91
buyer_5,Sara,30,ES72209552827491055369,TRX_N-678-359151901622,2024-08-08T08:12:48,Donostia,Expense,food,-778.18,242957.73
buyer_5,Sara,30,ES72209552827491055369,TRX_N-679-926518361318,2024-08-10T23:01:01,Donostia,Expense,transport,-61.45,242896.28
buyer_5,Sara,30,ES72209552827491055369,TRX_N-68-814010820238,2020-06-01T03:03:15,Donostia,transfer,Bonus,3278.87,43617.01
buyer_5,Sara,30,ES72209552827491055369,TRX_N-680-576024102426,2024-09-01T17:12:23,Donostia,transfer,Salary,3359.75,246256.03
buyer_5,Sara,30,ES72209552827491055369,TRX_N-681-422431916778,2024-09-01T17:12:23,Donostia,transfer,Partner Salary,3407.23,249663.26
buyer_5,Sara,30,ES72209552827491055369,TRX_N-682-429706597627,2024-09-03T15:37:39,Donostia,Expense,food,-293.45,249369.81
buyer_5,Sara,30,ES72209552827491055369,TRX_N-683-826495136701,2024-09-04T15:16:08,Donostia,Expense,food,-601.0,248768.81
buyer_5,Sara,30,ES72209552827491055369,TRX_N-684-200198328333,2024-09-05T23:33:02,Donostia,Housing,Mortgage,-1902.5,246866.31
buyer_5,Sara,30,ES72209552827491055369,TRX_N-685-954984788641,2024-09-05T20:18:05,Donostia,Basic services,water,-26.9,246839.41
buyer_5,Sara,30,ES72209552827491055369,TRX_N-686-245243363429,2024-09-05T10:52:47,Donostia,Basic services,phone,-49.06,246790.35
buyer_5,Sara,30,ES72209552827491055369,TRX_N-687-752802506282,2024-09-06T13:10:25,Donostia,Basic services,gas,-32.65,246757.7
buyer_5,Sara,30,ES72209552827491055369,TRX_N-688-643210222090,2024-09-07T20:41:32,Donostia,Basic services,electricity,-83.26,246674.44
buyer_5,Sara,30,ES72209552827491055369,TRX_N-689-762826920697,2024-09-16T12:12:01,Getxo,Expense,clothing,-296.71,246377.73
buyer_5,Sara,30,ES72209552827491055369,TRX_N-69-88254427357,2020-06-02T09:56:30,Donostia,Expense,leisure,-145.0,43472.01
buyer_5,Sara,30,ES72209552827491055369,TRX_N-690-482218810044,2024-09-27T10:32:30,Donostia,Expense,leisure,-60.18,246317.55
buyer_5,Sara,30,ES72209552827491055369,TRX_N-691-600501606156,2024-09-30T11:26:46,Donostia,Expense,education,-759.11,245558.44
buyer_5,Sara,30,ES72209552827491055369,TRX_N-692-967528638983,2024-10-01T09:13:09,Donostia,transfer,Salary,3359.75,248918.19
buyer_5,Sara,30,ES72209552827491055369,TRX_N-693-717784078323,2024-10-01T09:13:09,Donostia,transfer,Partner Salary,3407.23,252325.42
buyer_5,Sara,30,ES72209552827491055369,TRX_N-694-368610751178,2024-10-01T09:13:09,Donostia,transfer,Extra Income,335.98,252661.4
buyer_5,Sara,30,ES72209552827491055369,TRX_N-695-539046058219,2024-10-01T22:15:16,Donostia,Expense,clothing,-206.07,252455.33
buyer_5,Sara,30,ES72209552827491055369,TRX_N-696-613103276235,2024-10-05T17:53:28,Donostia,Housing,Mortgage,-1902.5,250552.83
buyer_5,Sara,30,ES72209552827491055369,TRX_N-697-684947313628,2024-10-05T13:05:36,Donostia,Basic services,electricity,-54.59,250498.24
buyer_5,Sara,30,ES72209552827491055369,TRX_N-698-206265468455,2024-10-07T03:02:20,Donostia,Basic services,water,-36.17,250462.07
buyer_5,Sara,30,ES72209552827491055369,TRX_N-699-813565716090,2024-10-07T09:09:47,Donostia,Basic services,electricity,-20.45,250441.62
buyer_5,Sara,30,ES72209552827491055369,TRX_N-7-95701640593,2020-01-05T13:53:49,Donostia,Basic services,phone,-93.06,22297.65
buyer_5,Sara,30,ES72209552827491055369,TRX_N-70-938857692735,2020-06-04T15:04:46,Donostia,Expense,education,-955.14,42516.87
buyer_5,Sara,30,ES72209552827491055369,TRX_N-700-276040366707,2024-10-07T22:45:17,Donostia,Basic services,phone,-65.67,250375.95
buyer_5,Sara,30,ES72209552827491055369,TRX_N-701-213184651835,2024-10-08T20:15:24,Donostia,Expense,education,-75.82,250300.13
buyer_5,Sara,30,ES72209552827491055369,TRX_N-71-862649923339,2020-06-05T19:18:33,Donostia,Housing,Mortgage,-1902.5,40614.37
buyer_5,Sara,30,ES72209552827491055369,TRX_N-72-4732065501,2020-06-06T14:34:20,Donostia,Basic services,gas,-98.94,40515.43
buyer_5,Sara,30,ES72209552827491055369,TRX_N-73-409618762811,2020-06-06T20:58:31,Donostia,Basic services,internet,-39.92,40475.51
buyer_5,Sara,30,ES72209552827491055369,TRX_N-74-271123200072,2020-06-10T19:43:17,Donostia,Expense,healthcare,-65.44,40410.07
buyer_5,Sara,30,ES72209552827491055369,TRX_N-75-621645079273,2020-06-11T19:11:04,Donostia,Expense,appliances,-1257.4,39152.67
buyer_5,Sara,30,ES72209552827491055369,TRX_N-76-443502317360,2020-06-21T12:39:30,Donostia,Expense,food,-368.05,38784.62
buyer_5,Sara,30,ES72209552827491055369,TRX_N-77-911610763795,2020-07-01T18:48:32,Donostia,transfer,Salary,3359.75,42144.37
buyer_5,Sara,30,ES72209552827491055369,TRX_N-78-457812635930,2020-07-01T18:48:32,Donostia,transfer,Partner Salary,3407.23,45551.6
buyer_5,Sara,30,ES72209552827491055369,TRX_N-79-167996069561,2020-07-01T18:48:32,Donostia,transfer,Extra Income,335.98,45887.58
buyer_5,Sara,30,ES72209552827491055369,TRX_N-8-204788140135,2020-01-06T08:34:38,Donostia,Basic services,electricity,-114.81,22182.84
buyer_5,Sara,30,ES72209552827491055369,TRX_N-80-31495787123,2020-07-01T16:58:37,Donostia,Expense,transport,-43.05,45844.53
buyer_5,Sara,30,ES72209552827491055369,TRX_N-81-531145783456,2020-07-05T20:31:29,Donostia,Housing,Mortgage,-1902.5,43942.03
buyer_5,Sara,30,ES72209552827491055369,TRX_N-82-256736789898,2020-07-06T21:27:33,Donostia,Basic services,internet,-70.62,43871.41
buyer_5,Sara,30,ES72209552827491055369,TRX_N-83-843466052960,2020-07-07T19:44:33,Donostia,Expense,education,-203.56,43667.85
buyer_5,Sara,30,ES72209552827491055369,TRX_N-84-455143049793,2020-07-26T02:38:12,Donostia,Expense,food,-571.66,43096.19
buyer_5,Sara,30,ES72209552827491055369,TRX_N-85-77179895459,2020-07-30T21:12:03,Donostia,Expense,transport,-92.11,43004.08
buyer_5,Sara,30,ES72209552827491055369,TRX_N-86-885541893861,2020-08-01T22:55:38,Donostia,transfer,Salary,3359.75,46363.83
buyer_5,Sara,30,ES72209552827491055369,TRX_N-87-238136785486,2020-08-01T22:55:38,Donostia,transfer,Partner Salary,3407.23,49771.06
buyer_5,Sara,30,ES72209552827491055369,TRX_N-88-927873555721,2020-08-03T20:04:43,Donostia,Expense,transport,-95.29,49675.77
buyer_5,Sara,30,ES72209552827491055369,TRX_N-89-906387872023,2020-08-05T23:38:36,Donostia,Housing,Mortgage,-1902.5,47773.27
buyer_5,Sara,30,ES72209552827491055369,TRX_N-9-494662216932,2020-01-06T10:51:22,Donostia,Basic services,phone,-74.71,22108.13
buyer_5,Sara,30,ES72209552827491055369,TRX_N-90-522898108895,2020-08-05T18:47:58,Donostia,Basic services,electricity,-72.11,47701.16
buyer_5,Sara,30,ES72209552827491055369,TRX_N-91-429517763722,2020-08-05T20:14:43,Donostia,Basic services,internet,-44.37,47656.79
buyer_5,Sara,30,ES72209552827491055369,TRX_N-92-790718161595,2020-08-05T18:45:28,Donostia,Basic services,phone,-96.91,47559.88
buyer_5,Sara,30,ES72209552827491055369,TRX_N-93-47696151713,2020-08-06T19:40:55,Donostia,Basic services,gas,-66.23,47493.65
buyer_5,Sara,30,ES72209552827491055369,TRX_N-94-26888570159,2020-08-07T08:58:23,Donostia,Basic services,water,-29.24,47464.41
buyer_5,Sara,30,ES72209552827491055369,TRX_N-95-83784481725,2020-08-07T18:20:57,Donostia,Basic services,electricity,-23.23,47441.18
buyer_5,Sara,30,ES72209552827491055369,TRX_N-96-282859249680,2020-08-07T16:50:36,Donostia,Basic services,gas,-35.41,47405.77
buyer_5,Sara,30,ES72209552827491055369,TRX_N-97-264975291502,2020-08-07T08:25:13,Donostia,Expense,transport,-136.38,47269.39
buyer_5,Sara,30,ES72209552827491055369,TRX_N-98-407055229286,2020-08-11T11:49:23,Donostia,Expense,repairs,-466.65,46802.74
buyer_5,Sara,30,ES72209552827491055369,TRX_N-99-634467560155,2020-08-24T16:20:22,Donostia,Expense,leisure,-124.88,46677.86
buyer_6,Manuel,45,ES48209552855708573275,TRX_N-1-223387202131,2020-01-01T17:15:02,Vitoria-Gasteiz,transfer,Salary,1289.87,2066.23
buyer_6,Manuel,45,ES48209552855708573275,TRX_N-10-188784682956,2020-02-01T11:54:27,Vitoria-Gasteiz,transfer,Salary,1289.87,1756.34
buyer_6,Manuel,45,ES48209552855708573275,TRX_N-100-448687283310,2020-09-16T18:14:49,Vitoria-Gasteiz,Expense,healthcare,-168.0,-8303.13
buyer_6,Manuel,45,ES48209552855708573275,TRX_N-101-492075752457,2020-09-20T09:01:54,Vitoria-Gasteiz,Expense,food,-151.38,-8454.51
buyer_6,Manuel,45,ES48209552855708573275,TRX_N-102-828306984891,2020-09-24T19:08:19,Vitoria-Gasteiz,Expense,clothing,-80.48,-8534.99
buyer_6,Manuel,45,ES48209552855708573275,TRX_N-103-655049302745,2020-09-30T19:12:31,Vitoria-Gasteiz,Expense,healthcare,-221.65,-8756.64
buyer_6,Manuel,45,ES48209552855708573275,TRX_N-104-435439862850,2020-10-01T13:31:36,Vitoria-Gasteiz,transfer,Salary,1289.87,-7466.77
buyer_6,Manuel,45,ES48209552855708573275,TRX_N-105-381900433265,2020-10-05T23:24:55,Vitoria-Gasteiz,Housing,Rent,-1119.73,-8586.5
buyer_6,Manuel,45,ES48209552855708573275,TRX_N-106-508063312599,2020-10-05T17:29:52,Vitoria-Gasteiz,Basic services,water,-55.53,-8642.03
buyer_6,Manuel,45,ES48209552855708573275,TRX_N-107-218580246118,2020-10-05T11:50:11,Vitoria-Gasteiz,Basic services,gas,-50.37,-8692.4
buyer_6,Manuel,45,ES48209552855708573275,TRX_N-108-299309498260,2020-10-06T19:23:23,Vitoria-Gasteiz,Basic services,electricity,-80.61,-8773.01
buyer_6,Manuel,45,ES48209552855708573275,TRX_N-109-181281155021,2020-10-06T13:15:22,Vitoria-Gasteiz,Basic services,phone,-85.09,-8858.1
buyer_6,Manuel,45,ES48209552855708573275,TRX_N-11-253531070624,2020-02-01T11:54:27,Vitoria-Gasteiz,transfer,Extra Income,128.99,1885.33
buyer_6,Manuel,45,ES48209552855708573275,TRX_N-110-36878469489,2020-10-07T11:03:27,Vitoria-Gasteiz,Basic services,internet,-60.53,-8918.63
buyer_6,Manuel,45,ES48209552855708573275,TRX_N-111-316992386536,2020-10-10T20:43:52,Vitoria-Gasteiz,Expense,gifts,-150.31,-9068.94
buyer_6,Manuel,45,ES48209552855708573275,TRX_N-112-312293578393,2020-10-21T12:20:41,Vitoria-Gasteiz,Expense,education,-107.35,-9176.29
buyer_6,Manuel,45,ES48209552855708573275,TRX_N-113-591228649940,2020-10-23T23:55:50,Vitoria-Gasteiz,Expense,leisure,-239.22,-9415.51
buyer_6,Manuel,45,ES48209552855708573275,TRX_N-114-990397940592,2020-11-01T09:35:43,Vitoria-Gasteiz,transfer,Salary,1289.87,-8125.64
buyer_6,Manuel,45,ES48209552855708573275,TRX_N-115-86880095877,2020-11-03T11:10:33,Vitoria-Gasteiz,Expense,gifts,-212.15,-8337.79
buyer_6,Manuel,45,ES48209552855708573275,TRX_N-116-447243954816,2020-11-05T17:19:57,Vitoria-Gasteiz,Housing,Rent,-1119.73,-9457.52
buyer_6,Manuel,45,ES48209552855708573275,TRX_N-117-905599507812,2020-11-05T12:44:32,Vitoria-Gasteiz,Basic services,gas,-59.64,-9517.16
buyer_6,Manuel,45,ES48209552855708573275,TRX_N-118-753229422668,2020-11-06T22:41:37,Vitoria-Gasteiz,Basic services,electricity,-137.4,-9654.56
buyer_6,Manuel,45,ES48209552855708573275,TRX_N-119-241299031029,2020-11-06T10:41:03,Vitoria-Gasteiz,Basic services,internet,-46.87,-9701.43
buyer_6,Manuel,45,ES48209552855708573275,TRX_N-12-30398469471,2020-02-03T13:12:07,Vitoria-Gasteiz,Expense,clothing,-268.22,1617.11
buyer_6,Manuel,45,ES48209552855708573275,TRX_N-120-982388246005,2020-11-06T08:51:53,Vitoria-Gasteiz,Basic services,phone,-95.84,-9797.27
buyer_6,Manuel,45,ES48209552855708573275,TRX_N-121-637542936609,2020-11-07T13:03:07,Vitoria-Gasteiz,Basic services,gas,-28.62,-9825.89
buyer_6,Manuel,45,ES48209552855708573275,TRX_N-122-407427158946,2020-11-07T18:44:49,Vitoria-Gasteiz,Basic services,phone,-28.33,-9854.22
buyer_6,Manuel,45,ES48209552855708573275,TRX_N-123-159455727444,2020-11-08T11:07:28,Vitoria-Gasteiz,Expense,food,-147.62,-10001.84
buyer_6,Manuel,45,ES48209552855708573275,TRX_N-124-287427406013,2020-11-17T14:36:45,Vitoria-Gasteiz,Expense,clothing,-265.1,-10266.94
buyer_6,Manuel,45,ES48209552855708573275,TRX_N-125-139527909728,2020-11-22T11:40:38,Vitoria-Gasteiz,Expense,education,-794.66,-11061.6
buyer_6,Manuel,45,ES48209552855708573275,TRX_N-126-180515630848,2020-12-01T08:47:43,Vitoria-Gasteiz,transfer,Salary,1289.87,-9771.73
buyer_6,Manuel,45,ES48209552855708573275,TRX_N-127-996948534032,2020-12-01T08:47:43,Vitoria-Gasteiz,transfer,Extra Income,128.99,-9642.74
buyer_6,Manuel,45,ES48209552855708573275,TRX_N-128-873645984178,2020-12-01T08:47:43,Vitoria-Gasteiz,transfer,Bonus,1180.95,-8461.79
buyer_6,Manuel,45,ES48209552855708573275,TRX_N-129-907879369516,2020-12-05T22:52:07,Vitoria-Gasteiz,Housing,Rent,-1119.73,-9581.52
buyer_6,Manuel,45,ES48209552855708573275,TRX_N-13-370090095936,2020-02-05T10:40:18,Vitoria-Gasteiz,Housing,Rent,-1119.73,497.38
buyer_6,Manuel,45,ES48209552855708573275,TRX_N-130-252519071267,2020-12-05T10:15:59,Vitoria-Gasteiz,Basic services,electricity,-50.92,-9632.44
buyer_6,Manuel,45,ES48209552855708573275,TRX_N-131-561991351123,2020-12-05T15:30:43,Vitoria-Gasteiz,Basic services,internet,-58.18,-9690.62
buyer_6,Manuel,45,ES48209552855708573275,TRX_N-132-744990288611,2020-12-06T10:18:12,Vitoria-Gasteiz,Basic services,phone,-93.87,-9784.49
buyer_6,Manuel,45,ES48209552855708573275,TRX_N-133-303716191235,2020-12-07T11:12:08,Vitoria-Gasteiz,Basic services,electricity,-39.89,-9824.38
buyer_6,Manuel,45,ES48209552855708573275,TRX_N-134-850579109121,2020-12-07T21:19:13,Vitoria-Gasteiz,Basic services,internet,-46.44,-9870.82
buyer_6,Manuel,45,ES48209552855708573275,TRX_N-135-16464391247,2020-12-07T15:57:01,Vitoria-Gasteiz,Basic services,phone,-40.1,-9910.92
buyer_6,Manuel,45,ES48209552855708573275,TRX_N-136-917326336037,2020-12-24T07:20:48,Iruña de Oca,Expense,food,-286.75,-10197.67
buyer_6,Manuel,45,ES48209552855708573275,TRX_N-137-477849453528,2020-12-28T19:05:28,Vitoria-Gasteiz,Expense,food,-633.47,-10831.14
buyer_6,Manuel,45,ES48209552855708573275,TRX_N-138-692763740706,2021-01-01T20:12:56,Vitoria-Gasteiz,transfer,Salary,1289.87,-9541.27
buyer_6,Manuel,45,ES48209552855708573275,TRX_N-139-519654196386,2021-01-05T14:54:27,Vitoria-Gasteiz,Housing,Rent,-1119.73,-10661.0
buyer_6,Manuel,45,ES48209552855708573275,TRX_N-14-86670468387,2020-02-05T08:44:57,Vitoria-Gasteiz,Basic services,water,-45.14,452.24
buyer_6,Manuel,45,ES48209552855708573275,TRX_N-140-753689696434,2021-01-05T17:58:19,Vitoria-Gasteiz,Basic services,electricity,-78.73,-10739.73
buyer_6,Manuel,45,ES48209552855708573275,TRX_N-141-859510702519,2021-01-05T09:41:12,Vitoria-Gasteiz,Basic services,gas,-39.41,-10779.14
buyer_6,Manuel,45,ES48209552855708573275,TRX_N-142-39543539085,2021-01-05T11:27:24,Vitoria-Gasteiz,Basic services,internet,-34.31,-10813.45
buyer_6,Manuel,45,ES48209552855708573275,TRX_N-143-197135725434,2021-01-05T08:14:44,Vitoria-Gasteiz,Expense,leisure,-37.96,-10851.41
buyer_6,Manuel,45,ES48209552855708573275,TRX_N-144-10595080776,2021-01-06T06:55:14,Vitoria-Gasteiz,Basic services,electricity,-33.09,-10884.5
buyer_6,Manuel,45,ES48209552855708573275,TRX_N-145-732061134157,2021-01-13T14:29:59,Vitoria-Gasteiz,Expense,transport,-29.37,-10913.87
buyer_6,Manuel,45,ES48209552855708573275,TRX_N-146-229743653807,2021-02-01T15:53:13,Vitoria-Gasteiz,transfer,Salary,1289.87,-9624.0
buyer_6,Manuel,45,ES48209552855708573275,TRX_N-147-443823386970,2021-02-05T14:44:22,Vitoria-Gasteiz,Housing,Rent,-1119.73,-10743.73
buyer_6,Manuel,45,ES48209552855708573275,TRX_N-148-549085627305,2021-02-05T10:08:12,Vitoria-Gasteiz,Basic services,internet,-74.83,-10818.56
buyer_6,Manuel,45,ES48209552855708573275,TRX_N-149-971629628101,2021-02-05T04:23:24,Vitoria-Gasteiz,Basic services,phone,-82.04,-10900.6
buyer_6,Manuel,45,ES48209552855708573275,TRX_N-15-546271803777,2020-02-05T10:15:08,Vitoria-Gasteiz,Basic services,phone,-25.03,427.21
buyer_6,Manuel,45,ES48209552855708573275,TRX_N-150-909570776814,2021-02-07T09:16:38,Vitoria-Gasteiz,Basic services,water,-17.43,-10918.03
buyer_6,Manuel,45,ES48209552855708573275,TRX_N-151-272732139935,2021-02-07T17:01:23,Vitoria-Gasteiz,Basic services,internet,-70.24,-10988.27
buyer_6,Manuel,45,ES48209552855708573275,TRX_N-152-244176183979,2021-02-07T16:07:18,Vitoria-Gasteiz,Basic services,phone,-71.58,-11059.85
buyer_6,Manuel,45,ES48209552855708573275,TRX_N-153-252620780075,2021-02-15T08:31:59,Vitoria-Gasteiz,Expense,healthcare,-54.71,-11114.56
buyer_6,Manuel,45,ES48209552855708573275,TRX_N-154-24586404682,2021-02-24T00:09:23,Bilbao,Expense,transport,-163.41,-11277.97
buyer_6,Manuel,45,ES48209552855708573275,TRX_N-155-677653207192,2021-03-01T21:07:36,Vitoria-Gasteiz,transfer,Salary,1289.87,-9988.1
buyer_6,Manuel,45,ES48209552855708573275,TRX_N-156-727053440592,2021-03-01T21:07:36,Vitoria-Gasteiz,transfer,Extra Income,128.99,-9859.11
buyer_6,Manuel,45,ES48209552855708573275,TRX_N-157-647108538814,2021-03-05T20:32:33,Vitoria-Gasteiz,Housing,Rent,-1119.73,-10978.84
buyer_6,Manuel,45,ES48209552855708573275,TRX_N-158-87705370098,2021-03-05T15:12:46,Vitoria-Gasteiz,Basic services,water,-74.5,-11053.34
buyer_6,Manuel,45,ES48209552855708573275,TRX_N-159-154456120130,2021-03-05T13:26:11,Vitoria-Gasteiz,Basic services,internet,-34.4,-11087.74
buyer_6,Manuel,45,ES48209552855708573275,TRX_N-16-120637334902,2020-02-06T05:07:25,Vitoria-Gasteiz,Basic services,water,-20.19,407.02
buyer_6,Manuel,45,ES48209552855708573275,TRX_N-160-478735131354,2021-03-05T14:38:27,Vitoria-Gasteiz,Basic services,phone,-86.89,-11174.63
buyer_6,Manuel,45,ES48209552855708573275,TRX_N-161-944944670661,2021-03-06T20:52:37,Vitoria-Gasteiz,Basic services,internet,-31.66,-11206.29
buyer_6,Manuel,45,ES48209552855708573275,TRX_N-162-817880272350,2021-03-07T19:00:04,Vitoria-Gasteiz,Basic services,water,-30.13,-11236.42
buyer_6,Manuel,45,ES48209552855708573275,TRX_N-163-792679631458,2021-03-07T14:08:51,Vitoria-Gasteiz,Basic services,electricity,-108.06,-11344.48
buyer_6,Manuel,45,ES48209552855708573275,TRX_N-164-993414591017,2021-03-07T14:20:21,Vitoria-Gasteiz,Basic services,phone,-91.39,-11435.87
buyer_6,Manuel,45,ES48209552855708573275,TRX_N-165-190165034444,2021-03-18T13:18:48,Vitoria-Gasteiz,Expense,healthcare,-280.79,-11716.66
buyer_6,Manuel,45,ES48209552855708573275,TRX_N-166-498133077297,2021-03-21T11:02:27,Vitoria-Gasteiz,Expense,gifts,-314.02,-12030.68
buyer_6,Manuel,45,ES48209552855708573275,TRX_N-167-647049024428,2021-04-01T17:43:55,Vitoria-Gasteiz,transfer,Salary,1289.87,-10740.81
buyer_6,Manuel,45,ES48209552855708573275,TRX_N-168-260056620598,2021-04-01T09:50:58,Vitoria-Gasteiz,Expense,food,-383.81,-11124.62
buyer_6,Manuel,45,ES48209552855708573275,TRX_N-169-288123567795,2021-04-02T09:54:22,Elciego,Expense,transport,-74.13,-11198.75
buyer_6,Manuel,45,ES48209552855708573275,TRX_N-17-350507856554,2020-02-06T23:15:55,Vitoria-Gasteiz,Basic services,gas,-76.52,330.5
buyer_6,Manuel,45,ES48209552855708573275,TRX_N-170-883092945484,2021-04-04T19:25:07,Vitoria-Gasteiz,Expense,transport,-80.72,-11279.47
buyer_6,Manuel,45,ES48209552855708573275,TRX_N-171-785009050712,2021-04-05T10:03:25,Vitoria-Gasteiz,Housing,Rent,-1119.73,-12399.2
buyer_6,Manuel,45,ES48209552855708573275,TRX_N-172-922220846378,2021-04-05T13:15:08,Vitoria-Gasteiz,Basic services,water,-73.58,-12472.78
buyer_6,Manuel,45,ES48209552855708573275,TRX_N-173-282102391463,2021-04-05T12:45:57,Vitoria-Gasteiz,Basic services,gas,-48.54,-12521.32
buyer_6,Manuel,45,ES48209552855708573275,TRX_N-174-59311518573,2021-04-05T16:09:00,Vitoria-Gasteiz,Basic services,internet,-55.68,-12577.0
buyer_6,Manuel,45,ES48209552855708573275,TRX_N-175-326186254323,2021-04-05T09:03:34,Vitoria-Gasteiz,Basic services,phone,-32.74,-12609.74
buyer_6,Manuel,45,ES48209552855708573275,TRX_N-176-773267867530,2021-04-06T13:28:12,Vitoria-Gasteiz,Basic services,water,-72.47,-12682.21
buyer_6,Manuel,45,ES48209552855708573275,TRX_N-177-168026608728,2021-04-06T19:34:44,Vitoria-Gasteiz,Basic services,gas,-39.5,-12721.71
buyer_6,Manuel,45,ES48209552855708573275,TRX_N-178-638836350093,2021-04-06T11:16:49,Vitoria-Gasteiz,Basic services,phone,-29.84,-12751.55
buyer_6,Manuel,45,ES48209552855708573275,TRX_N-179-371023155147,2021-04-07T19:09:39,Vitoria-Gasteiz,Basic services,water,-18.46,-12770.01
buyer_6,Manuel,45,ES48209552855708573275,TRX_N-18-405059939144,2020-02-06T09:53:05,Vitoria-Gasteiz,Basic services,phone,-59.08,271.42
buyer_6,Manuel,45,ES48209552855708573275,TRX_N-180-5712848553,2021-04-07T08:03:49,Sestao,Expense,food,-754.83,-13524.84
buyer_6,Manuel,45,ES48209552855708573275,TRX_N-181-82052083568,2021-04-19T08:17:04,Vitoria-Gasteiz,Expense,healthcare,-220.94,-13745.78
buyer_6,Manuel,45,ES48209552855708573275,TRX_N-182-917798333680,2021-04-30T19:54:08,Vitoria-Gasteiz,Expense,healthcare,-365.93,-14111.71
buyer_6,Manuel,45,ES48209552855708573275,TRX_N-183-369684018637,2021-05-01T07:14:43,Vitoria-Gasteiz,transfer,Salary,1289.87,-12821.84
buyer_6,Manuel,45,ES48209552855708573275,TRX_N-184-484131829985,2021-05-02T05:08:19,Irun,Expense,clothing,-208.79,-13030.63
buyer_6,Manuel,45,ES48209552855708573275,TRX_N-185-172896372869,2021-05-05T11:36:27,Vitoria-Gasteiz,Housing,Rent,-1119.73,-14150.36
buyer_6,Manuel,45,ES48209552855708573275,TRX_N-186-354015184603,2021-05-05T18:03:32,Vitoria-Gasteiz,Basic services,water,-47.29,-14197.65
buyer_6,Manuel,45,ES48209552855708573275,TRX_N-187-587491265153,2021-05-05T08:53:29,Vitoria-Gasteiz,Basic services,electricity,-63.82,-14261.47
buyer_6,Manuel,45,ES48209552855708573275,TRX_N-188-9001622416,2021-05-05T13:15:17,Vitoria-Gasteiz,Basic services,gas,-67.37,-14328.84
buyer_6,Manuel,45,ES48209552855708573275,TRX_N-189-729894069704,2021-05-05T13:22:06,Vitoria-Gasteiz,Basic services,internet,-58.36,-14387.2
buyer_6,Manuel,45,ES48209552855708573275,TRX_N-19-903571040586,2020-02-07T19:26:34,Vitoria-Gasteiz,Basic services,water,-56.93,214.49
buyer_6,Manuel,45,ES48209552855708573275,TRX_N-190-323983261368,2021-05-06T08:48:47,Vitoria-Gasteiz,Basic services,phone,-54.45,-14441.65
buyer_6,Manuel,45,ES48209552855708573275,TRX_N-191-794536323755,2021-05-07T14:55:22,Vitoria-Gasteiz,Basic services,internet,-56.36,-14498.01
buyer_6,Manuel,45,ES48209552855708573275,TRX_N-192-885443512942,2021-05-07T20:08:20,Vitoria-Gasteiz,Expense,transport,-111.69,-14609.7
buyer_6,Manuel,45,ES48209552855708573275,TRX_N-193-311967580313,2021-05-07T02:12:22,Vitoria-Gasteiz,Expense,education,-502.87,-15112.57
buyer_6,Manuel,45,ES48209552855708573275,TRX_N-194-351972470765,2021-05-10T16:10:32,Vitoria-Gasteiz,Expense,transport,-161.79,-15274.36
buyer_6,Manuel,45,ES48209552855708573275,TRX_N-195-579836581410,2021-05-10T12:11:21,Vitoria-Gasteiz,Expense,healthcare,-248.6,-15522.96
buyer_6,Manuel,45,ES48209552855708573275,TRX_N-196-868737750512,2021-05-11T13:38:13,Vitoria-Gasteiz,Expense,leisure,-230.68,-15753.64
buyer_6,Manuel,45,ES48209552855708573275,TRX_N-197-328959786669,2021-05-15T11:43:55,Vitoria-Gasteiz,Expense,food,-214.14,-15967.78
buyer_6,Manuel,45,ES48209552855708573275,TRX_N-198-503305453476,2021-05-27T10:10:07,Vitoria-Gasteiz,Expense,transport,-50.01,-16017.79
buyer_6,Manuel,45,ES48209552855708573275,TRX_N-199-582809928837,2021-06-01T10:34:07,Vitoria-Gasteiz,transfer,Salary,1289.87,-14727.92
buyer_6,Manuel,45,ES48209552855708573275,TRX_N-2-914920784785,2020-01-01T02:17:09,Amurrio,Expense,transport,-55.86,2010.37
buyer_6,Manuel,45,ES48209552855708573275,TRX_N-20-496377155054,2020-02-10T13:48:42,Vitoria-Gasteiz,Expense,healthcare,-346.33,-131.84
buyer_6,Manuel,45,ES48209552855708573275,TRX_N-200-567684866120,2021-06-01T10:34:07,Vitoria-Gasteiz,transfer,Extra Income,128.99,-14598.93
buyer_6,Manuel,45,ES48209552855708573275,TRX_N-201-94439974998,2021-06-01T10:34:07,Vitoria-Gasteiz,transfer,Bonus,1185.68,-13413.25
buyer_6,Manuel,45,ES48209552855708573275,TRX_N-202-883203541716,2021-06-01T08:41:54,Bermeo,Expense,travel,-1879.91,-15293.16
buyer_6,Manuel,45,ES48209552855708573275,TRX_N-203-185635939502,2021-06-02T08:39:42,Vitoria-Gasteiz,Expense,leisure,-218.8,-15511.96
buyer_6,Manuel,45,ES48209552855708573275,TRX_N-204-234904145542,2021-06-05T16:43:23,Vitoria-Gasteiz,Housing,Rent,-1119.73,-16631.69
buyer_6,Manuel,45,ES48209552855708573275,TRX_N-205-784379715230,2021-06-07T18:17:15,Vitoria-Gasteiz,Basic services,gas,-77.07,-16708.76
buyer_6,Manuel,45,ES48209552855708573275,TRX_N-206-759838971796,2021-06-07T01:05:46,Vitoria-Gasteiz,Basic services,phone,-50.16,-16758.92
buyer_6,Manuel,45,ES48209552855708573275,TRX_N-207-891881376910,2021-06-13T15:57:26,Vitoria-Gasteiz,Expense,travel,-1261.05,-18019.97
buyer_6,Manuel,45,ES48209552855708573275,TRX_N-208-390961847972,2021-06-24T18:49:43,Sopela,Expense,leisure,-30.24,-18050.21
buyer_6,Manuel,45,ES48209552855708573275,TRX_N-209-276577617061,2021-07-01T19:04:05,Vitoria-Gasteiz,transfer,Salary,1289.87,-16760.34
buyer_6,Manuel,45,ES48209552855708573275,TRX_N-21-305223668502,2020-02-21T19:40:28,Vitoria-Gasteiz,Expense,transport,-116.78,-248.62
buyer_6,Manuel,45,ES48209552855708573275,TRX_N-210-137979946743,2021-07-05T14:52:36,Vitoria-Gasteiz,Housing,Rent,-1119.73,-17880.07
buyer_6,Manuel,45,ES48209552855708573275,TRX_N-211-296774033924,2021-07-05T14:15:26,Vitoria-Gasteiz,Basic services,water,-46.58,-17926.65
buyer_6,Manuel,45,ES48209552855708573275,TRX_N-212-413574994749,2021-07-05T23:19:38,Vitoria-Gasteiz,Basic services,electricity,-147.38,-18074.03
buyer_6,Manuel,45,ES48209552855708573275,TRX_N-213-819525718520,2021-07-07T09:08:27,Vitoria-Gasteiz,Basic services,water,-38.71,-18112.74
buyer_6,Manuel,45,ES48209552855708573275,TRX_N-214-712259854299,2021-07-07T16:46:03,Vitoria-Gasteiz,Basic services,gas,-39.07,-18151.81
buyer_6,Manuel,45,ES48209552855708573275,TRX_N-215-485863503974,2021-07-29T21:48:40,Vitoria-Gasteiz,Expense,food,-525.75,-18677.56
buyer_6,Manuel,45,ES48209552855708573275,TRX_N-216-966500208289,2021-07-29T08:41:14,Vitoria-Gasteiz,Expense,clothing,-421.89,-19099.45
buyer_6,Manuel,45,ES48209552855708573275,TRX_N-217-251396756560,2021-08-01T10:48:44,Vitoria-Gasteiz,transfer,Salary,1289.87,-17809.58
buyer_6,Manuel,45,ES48209552855708573275,TRX_N-218-72786087157,2021-08-01T10:48:44,Vitoria-Gasteiz,transfer,Extra Income,128.99,-17680.59
buyer_6,Manuel,45,ES48209552855708573275,TRX_N-219-69691946702,2021-08-04T05:53:20,Vitoria-Gasteiz,Expense,leisure,-167.26,-17847.85
buyer_6,Manuel,45,ES48209552855708573275,TRX_N-22-391813844468,2020-02-23T11:52:53,Vitoria-Gasteiz,Expense,food,-328.68,-577.3
buyer_6,Manuel,45,ES48209552855708573275,TRX_N-220-389409383138,2021-08-05T13:10:14,Vitoria-Gasteiz,Housing,Rent,-1119.73,-18967.58
buyer_6,Manuel,45,ES48209552855708573275,TRX_N-221-494311582422,2021-08-05T15:43:54,Vitoria-Gasteiz,Basic services,internet,-78.0,-19045.58
buyer_6,Manuel,45,ES48209552855708573275,TRX_N-222-31260628888,2021-08-07T09:01:35,Vitoria-Gasteiz,Basic services,electricity,-80.34,-19125.92
buyer_6,Manuel,45,ES48209552855708573275,TRX_N-223-503165079412,2021-08-07T19:50:53,Vitoria-Gasteiz,Basic services,gas,-33.92,-19159.84
buyer_6,Manuel,45,ES48209552855708573275,TRX_N-224-319386186598,2021-08-07T05:18:26,Vitoria-Gasteiz,Expense,food,-393.83,-19553.67
buyer_6,Manuel,45,ES48209552855708573275,TRX_N-225-769995928909,2021-08-17T15:12:29,Vitoria-Gasteiz,Expense,transport,-21.3,-19574.97
buyer_6,Manuel,45,ES48209552855708573275,TRX_N-226-450916839616,2021-08-17T20:08:15,Vitoria-Gasteiz,Expense,leisure,-229.11,-19804.08
buyer_6,Manuel,45,ES48209552855708573275,TRX_N-227-69990150705,2021-08-20T09:48:55,Vitoria-Gasteiz,Expense,leisure,-43.87,-19847.95
buyer_6,Manuel,45,ES48209552855708573275,TRX_N-228-586317377565,2021-08-25T09:51:04,Vitoria-Gasteiz,Expense,food,-192.29,-20040.24
buyer_6,Manuel,45,ES48209552855708573275,TRX_N-229-644623772661,2021-08-26T08:26:12,Vitoria-Gasteiz,Expense,food,-725.18,-20765.42
buyer_6,Manuel,45,ES48209552855708573275,TRX_N-23-151283311835,2020-02-28T11:37:31,Vitoria-Gasteiz,Expense,healthcare,-39.39,-616.69
buyer_6,Manuel,45,ES48209552855708573275,TRX_N-230-585064955017,2021-09-01T18:25:59,Vitoria-Gasteiz,transfer,Salary,1289.87,-19475.55
buyer_6,Manuel,45,ES48209552855708573275,TRX_N-231-547375802615,2021-09-02T14:32:06,Zuia,Expense,food,-514.57,-19990.12
buyer_6,Manuel,45,ES48209552855708573275,TRX_N-232-972289396521,2021-09-05T08:19:28,Vitoria-Gasteiz,Housing,Rent,-1119.73,-21109.85
buyer_6,Manuel,45,ES48209552855708573275,TRX_N-233-210187189498,2021-09-05T12:52:59,Vitoria-Gasteiz,Basic services,internet,-48.55,-21158.4
buyer_6,Manuel,45,ES48209552855708573275,TRX_N-234-819462581014,2021-09-07T18:15:19,Vitoria-Gasteiz,Basic services,electricity,-128.47,-21286.87
buyer_6,Manuel,45,ES48209552855708573275,TRX_N-235-896766043092,2021-09-08T11:00:15,Vitoria-Gasteiz,Expense,food,-681.67,-21968.54
buyer_6,Manuel,45,ES48209552855708573275,TRX_N-236-257135666253,2021-10-01T11:30:57,Vitoria-Gasteiz,transfer,Salary,1289.87,-20678.67
buyer_6,Manuel,45,ES48209552855708573275,TRX_N-237-484041130123,2021-10-01T12:56:43,Vitoria-Gasteiz,Expense,transport,-115.97,-20794.64
buyer_6,Manuel,45,ES48209552855708573275,TRX_N-238-37371424712,2021-10-05T13:20:58,Vitoria-Gasteiz,Housing,Rent,-1119.73,-21914.37
buyer_6,Manuel,45,ES48209552855708573275,TRX_N-239-853911123820,2021-10-05T18:57:52,Vitoria-Gasteiz,Basic services,gas,-42.41,-21956.78
buyer_6,Manuel,45,ES48209552855708573275,TRX_N-24-422357375746,2020-03-01T17:37:13,Vitoria-Gasteiz,transfer,Salary,1289.87,673.18
buyer_6,Manuel,45,ES48209552855708573275,TRX_N-240-242212679577,2021-10-05T15:48:45,Vitoria-Gasteiz,Basic services,phone,-30.21,-21986.99
buyer_6,Manuel,45,ES48209552855708573275,TRX_N-241-166796890398,2021-10-06T14:53:59,Vitoria-Gasteiz,Basic services,water,-50.97,-22037.96
buyer_6,Manuel,45,ES48209552855708573275,TRX_N-242-931469070475,2021-10-06T01:10:39,Vitoria-Gasteiz,Basic services,electricity,-39.63,-22077.59
buyer_6,Manuel,45,ES48209552855708573275,TRX_N-243-293116655164,2021-10-06T14:38:56,Vitoria-Gasteiz,Basic services,internet,-76.98,-22154.57
buyer_6,Manuel,45,ES48209552855708573275,TRX_N-244-494415287277,2021-10-06T20:24:21,Vitoria-Gasteiz,Basic services,phone,-32.2,-22186.77
buyer_6,Manuel,45,ES48209552855708573275,TRX_N-245-288509225790,2021-10-07T20:50:30,Vitoria-Gasteiz,Basic services,gas,-40.94,-22227.71
buyer_6,Manuel,45,ES48209552855708573275,TRX_N-246-297193471547,2021-10-21T17:03:16,Vitoria-Gasteiz,Expense,leisure,-177.25,-22404.96
buyer_6,Manuel,45,ES48209552855708573275,TRX_N-247-205842415893,2021-11-01T12:28:55,Vitoria-Gasteiz,transfer,Salary,1289.87,-21115.09
buyer_6,Manuel,45,ES48209552855708573275,TRX_N-248-538407449575,2021-11-01T12:28:55,Vitoria-Gasteiz,transfer,Extra Income,128.99,-20986.1
buyer_6,Manuel,45,ES48209552855708573275,TRX_N-249-711713312030,2021-11-05T09:18:32,Vitoria-Gasteiz,Housing,Rent,-1119.73,-22105.83
buyer_6,Manuel,45,ES48209552855708573275,TRX_N-25-804357375119,2020-03-05T20:05:10,Vitoria-Gasteiz,Housing,Rent,-1119.73,-446.55
buyer_6,Manuel,45,ES48209552855708573275,TRX_N-250-574371646887,2021-11-05T10:11:34,Vitoria-Gasteiz,Basic services,electricity,-143.16,-22248.99
buyer_6,Manuel,45,ES48209552855708573275,TRX_N-251-143373014338,2021-11-06T18:58:03,Vitoria-Gasteiz,Basic services,electricity,-78.12,-22327.11
buyer_6,Manuel,45,ES48209552855708573275,TRX_N-252-472491320170,2021-11-07T09:34:43,Vitoria-Gasteiz,Basic services,water,-65.59,-22392.7
buyer_6,Manuel,45,ES48209552855708573275,TRX_N-253-447216163405,2021-11-07T14:45:07,Vitoria-Gasteiz,Basic services,gas,-26.42,-22419.12
buyer_6,Manuel,45,ES48209552855708573275,TRX_N-254-705832590672,2021-11-07T18:51:11,Vitoria-Gasteiz,Basic services,phone,-62.57,-22481.69
buyer_6,Manuel,45,ES48209552855708573275,TRX_N-255-378250122821,2021-11-15T15:18:52,Vitoria-Gasteiz,Expense,clothing,-135.2,-22616.89
buyer_6,Manuel,45,ES48209552855708573275,TRX_N-256-775108160557,2021-11-26T10:16:14,Erandio,Expense,food,-563.45,-23180.34
buyer_6,Manuel,45,ES48209552855708573275,TRX_N-257-171524602913,2021-12-01T10:28:21,Vitoria-Gasteiz,transfer,Salary,1289.87,-21890.47
buyer_6,Manuel,45,ES48209552855708573275,TRX_N-258-215870686684,2021-12-01T10:28:21,Vitoria-Gasteiz,transfer,Bonus,1309.01,-20581.46
buyer_6,Manuel,45,ES48209552855708573275,TRX_N-259-529968491923,2021-12-02T21:52:20,Vitoria-Gasteiz,Expense,transport,-20.24,-20601.7
buyer_6,Manuel,45,ES48209552855708573275,TRX_N-26-715684504742,2020-03-05T13:39:16,Vitoria-Gasteiz,Basic services,electricity,-27.88,-474.43
buyer_6,Manuel,45,ES48209552855708573275,TRX_N-260-341317839076,2021-12-02T13:01:50,Vitoria-Gasteiz,Expense,leisure,-73.65,-20675.35
buyer_6,Manuel,45,ES48209552855708573275,TRX_N-261-508291252335,2021-12-05T09:55:29,Vitoria-Gasteiz,Housing,Rent,-1119.73,-21795.08
buyer_6,Manuel,45,ES48209552855708573275,TRX_N-262-923710723294,2021-12-05T06:29:38,Vitoria-Gasteiz,Basic services,water,-35.41,-21830.49
buyer_6,Manuel,45,ES48209552855708573275,TRX_N-263-514084018315,2021-12-06T14:21:25,Vitoria-Gasteiz,Basic services,water,-43.7,-21874.19
buyer_6,Manuel,45,ES48209552855708573275,TRX_N-264-180905621688,2021-12-07T15:00:00,Vitoria-Gasteiz,Basic services,water,-67.48,-21941.67
buyer_6,Manuel,45,ES48209552855708573275,TRX_N-265-964277159288,2021-12-07T16:04:04,Vitoria-Gasteiz,Basic services,internet,-31.19,-21972.86
buyer_6,Manuel,45,ES48209552855708573275,TRX_N-266-270979083753,2021-12-07T10:46:04,Vitoria-Gasteiz,Expense,transport,-103.94,-22076.8
buyer_6,Manuel,45,ES48209552855708573275,TRX_N-267-168856326210,2021-12-16T18:07:20,Vitoria-Gasteiz,Expense,food,-402.52,-22479.32
buyer_6,Manuel,45,ES48209552855708573275,TRX_N-268-559582963163,2021-12-24T12:44:41,Vitoria-Gasteiz,Expense,food,-525.65,-23004.97
buyer_6,Manuel,45,ES48209552855708573275,TRX_N-269-889010474172,2022-01-01T09:32:45,Vitoria-Gasteiz,transfer,Salary,1289.87,-21715.1
buyer_6,Manuel,45,ES48209552855708573275,TRX_N-27-924791392755,2020-03-06T22:59:31,Vitoria-Gasteiz,Basic services,water,-66.04,-540.47
buyer_6,Manuel,45,ES48209552855708573275,TRX_N-270-498850705770,2022-01-01T09:32:45,Vitoria-Gasteiz,transfer,Extra Income,128.99,-21586.11
buyer_6,Manuel,45,ES48209552855708573275,TRX_N-271-780322881981,2022-01-05T14:03:39,Vitoria-Gasteiz,Housing,Rent,-1119.73,-22705.84
buyer_6,Manuel,45,ES48209552855708573275,TRX_N-272-93013606753,2022-01-05T15:28:51,Vitoria-Gasteiz,Basic services,internet,-54.05,-22759.89
buyer_6,Manuel,45,ES48209552855708573275,TRX_N-273-550126042226,2022-01-06T12:03:31,Vitoria-Gasteiz,Expense,food,-285.25,-23045.14
buyer_6,Manuel,45,ES48209552855708573275,TRX_N-274-386589328780,2022-01-07T13:13:05,Vitoria-Gasteiz,Basic services,water,-45.16,-23090.3
buyer_6,Manuel,45,ES48209552855708573275,TRX_N-275-638912355850,2022-01-09T11:50:24,Vitoria-Gasteiz,Expense,clothing,-276.14,-23366.44
buyer_6,Manuel,45,ES48209552855708573275,TRX_N-276-876360025284,2022-01-14T21:51:36,Amurrio,Expense,leisure,-195.61,-23562.05
buyer_6,Manuel,45,ES48209552855708573275,TRX_N-277-450493183316,2022-01-16T19:45:22,Vitoria-Gasteiz,Expense,gifts,-409.73,-23971.78
buyer_6,Manuel,45,ES48209552855708573275,TRX_N-278-709232917159,2022-01-19T13:15:10,Vitoria-Gasteiz,Expense,leisure,-68.84,-24040.62
buyer_6,Manuel,45,ES48209552855708573275,TRX_N-279-283910821889,2022-01-26T07:50:59,Berango,Expense,healthcare,-162.71,-24203.33
buyer_6,Manuel,45,ES48209552855708573275,TRX_N-28-486209795939,2020-03-07T16:57:03,Vitoria-Gasteiz,Basic services,electricity,-81.85,-622.32
buyer_6,Manuel,45,ES48209552855708573275,TRX_N-280-174552248410,2022-01-29T08:26:53,Vitoria-Gasteiz,Expense,clothing,-163.89,-24367.22
buyer_6,Manuel,45,ES48209552855708573275,TRX_N-281-286200973382,2022-02-01T08:37:00,Vitoria-Gasteiz,transfer,Salary,1289.87,-23077.35
buyer_6,Manuel,45,ES48209552855708573275,TRX_N-282-972190967362,2022-02-02T10:47:00,Vitoria-Gasteiz,Expense,transport,-116.65,-23194.0
buyer_6,Manuel,45,ES48209552855708573275,TRX_N-283-761501961242,2022-02-04T22:53:20,Vitoria-Gasteiz,Expense,leisure,-126.38,-23320.38
buyer_6,Manuel,45,ES48209552855708573275,TRX_N-284-759579129933,2022-02-05T13:17:19,Vitoria-Gasteiz,Housing,Rent,-1119.73,-24440.11
buyer_6,Manuel,45,ES48209552855708573275,TRX_N-285-854863350463,2022-02-05T17:58:07,Vitoria-Gasteiz,Basic services,gas,-40.12,-24480.23
buyer_6,Manuel,45,ES48209552855708573275,TRX_N-286-290730972247,2022-02-05T12:49:57,Vitoria-Gasteiz,Basic services,internet,-42.41,-24522.64
buyer_6,Manuel,45,ES48209552855708573275,TRX_N-287-972716395022,2022-02-05T16:52:43,Vitoria-Gasteiz,Basic services,phone,-34.66,-24557.3
buyer_6,Manuel,45,ES48209552855708573275,TRX_N-288-83750898707,2022-02-06T16:51:45,Vitoria-Gasteiz,Basic services,electricity,-25.85,-24583.15
buyer_6,Manuel,45,ES48209552855708573275,TRX_N-289-33959885722,2022-02-07T12:49:28,Vitoria-Gasteiz,Basic services,electricity,-116.47,-24699.62
buyer_6,Manuel,45,ES48209552855708573275,TRX_N-29-753259234331,2020-03-11T19:51:09,Vitoria-Gasteiz,Expense,food,-170.86,-793.18
buyer_6,Manuel,45,ES48209552855708573275,TRX_N-290-953073719495,2022-02-07T14:02:44,Vitoria-Gasteiz,Basic services,phone,-33.41,-24733.03
buyer_6,Manuel,45,ES48209552855708573275,TRX_N-291-78614250460,2022-02-10T00:57:26,Vitoria-Gasteiz,Expense,gifts,-103.25,-24836.28
buyer_6,Manuel,45,ES48209552855708573275,TRX_N-292-667825571396,2022-02-13T20:56:23,Vitoria-Gasteiz,Expense,gifts,-50.98,-24887.26
buyer_6,Manuel,45,ES48209552855708573275,TRX_N-293-410044136240,2022-02-18T20:18:48,Vitoria-Gasteiz,Expense,leisure,-225.17,-25112.43
buyer_6,Manuel,45,ES48209552855708573275,TRX_N-294-239242642190,2022-02-25T10:29:46,Vitoria-Gasteiz,Expense,food,-537.62,-25650.05
buyer_6,Manuel,45,ES48209552855708573275,TRX_N-295-59656854123,2022-02-26T16:20:29,Vitoria-Gasteiz,Expense,leisure,-144.67,-25794.72
buyer_6,Manuel,45,ES48209552855708573275,TRX_N-296-112587232846,2022-03-01T23:15:38,Vitoria-Gasteiz,transfer,Salary,1289.87,-24504.85
buyer_6,Manuel,45,ES48209552855708573275,TRX_N-297-816393305850,2022-03-02T07:31:19,Vitoria-Gasteiz,Expense,food,-706.57,-25211.42
buyer_6,Manuel,45,ES48209552855708573275,TRX_N-298-702387912030,2022-03-05T11:30:13,Vitoria-Gasteiz,Housing,Rent,-1119.73,-26331.15
buyer_6,Manuel,45,ES48209552855708573275,TRX_N-299-121721956992,2022-03-05T16:44:06,Vitoria-Gasteiz,Basic services,water,-61.61,-26392.76
buyer_6,Manuel,45,ES48209552855708573275,TRX_N-3-637914282630,2020-01-05T19:00:37,Vitoria-Gasteiz,Housing,Rent,-1119.73,890.64
buyer_6,Manuel,45,ES48209552855708573275,TRX_N-30-384981932924,2020-04-01T12:22:48,Vitoria-Gasteiz,transfer,Salary,1289.87,496.69
buyer_6,Manuel,45,ES48209552855708573275,TRX_N-300-478682783237,2022-03-05T16:16:09,Vitoria-Gasteiz,Basic services,electricity,-60.56,-26453.32
buyer_6,Manuel,45,ES48209552855708573275,TRX_N-301-497652375658,2022-03-05T20:36:28,Vitoria-Gasteiz,Basic services,internet,-70.53,-26523.85
buyer_6,Manuel,45,ES48209552855708573275,TRX_N-302-147501878760,2022-03-07T12:01:56,Vitoria-Gasteiz,Basic services,phone,-78.43,-26602.28
buyer_6,Manuel,45,ES48209552855708573275,TRX_N-303-764334035354,2022-04-01T19:48:43,Vitoria-Gasteiz,transfer,Salary,1289.87,-25312.41
buyer_6,Manuel,45,ES48209552855708573275,TRX_N-304-435815323823,2022-04-01T19:48:43,Vitoria-Gasteiz,transfer,Extra Income,128.99,-25183.42
buyer_6,Manuel,45,ES48209552855708573275,TRX_N-305-924474171502,2022-04-05T10:45:22,Vitoria-Gasteiz,Housing,Rent,-1119.73,-26303.15
buyer_6,Manuel,45,ES48209552855708573275,TRX_N-306-3734736548,2022-04-05T10:03:47,Vitoria-Gasteiz,Basic services,gas,-65.97,-26369.12
buyer_6,Manuel,45,ES48209552855708573275,TRX_N-307-71809044262,2022-04-06T09:44:52,Vitoria-Gasteiz,Expense,leisure,-193.17,-26562.29
buyer_6,Manuel,45,ES48209552855708573275,TRX_N-308-406276100874,2022-04-07T08:45:23,Vitoria-Gasteiz,Basic services,water,-60.58,-26622.87
buyer_6,Manuel,45,ES48209552855708573275,TRX_N-309-730023085270,2022-04-07T20:11:12,Vitoria-Gasteiz,Basic services,electricity,-125.85,-26748.72
buyer_6,Manuel,45,ES48209552855708573275,TRX_N-31-241606968094,2020-04-04T12:35:12,Vitoria-Gasteiz,Expense,healthcare,-104.56,392.13
buyer_6,Manuel,45,ES48209552855708573275,TRX_N-310-661673812544,2022-04-07T18:21:28,Vitoria-Gasteiz,Basic services,gas,-44.72,-26793.44
buyer_6,Manuel,45,ES48209552855708573275,TRX_N-311-439089430694,2022-04-10T19:29:28,Vitoria-Gasteiz,Expense,clothing,-190.38,-26983.82
buyer_6,Manuel,45,ES48209552855708573275,TRX_N-312-932788467168,2022-04-20T14:51:48,Vitoria-Gasteiz,Expense,food,-437.24,-27421.06
buyer_6,Manuel,45,ES48209552855708573275,TRX_N-313-29397277672,2022-04-30T12:00:07,Vitoria-Gasteiz,Expense,transport,-98.18,-27519.24
buyer_6,Manuel,45,ES48209552855708573275,TRX_N-314-173744495481,2022-05-01T11:52:21,Vitoria-Gasteiz,transfer,Salary,1289.87,-26229.37
buyer_6,Manuel,45,ES48209552855708573275,TRX_N-315-43006220514,2022-05-03T09:33:59,Vitoria-Gasteiz,Expense,clothing,-302.99,-26532.36
buyer_6,Manuel,45,ES48209552855708573275,TRX_N-316-882272077068,2022-05-05T22:14:04,Vitoria-Gasteiz,Housing,Rent,-1119.73,-27652.09
buyer_6,Manuel,45,ES48209552855708573275,TRX_N-317-512167740017,2022-05-05T18:52:55,Vitoria-Gasteiz,Basic services,water,-68.84,-27720.93
buyer_6,Manuel,45,ES48209552855708573275,TRX_N-318-18494936027,2022-05-05T16:43:21,Vitoria-Gasteiz,Basic services,internet,-70.19,-27791.12
buyer_6,Manuel,45,ES48209552855708573275,TRX_N-319-930889231617,2022-05-06T23:01:23,Vitoria-Gasteiz,Basic services,water,-32.92,-27824.04
buyer_6,Manuel,45,ES48209552855708573275,TRX_N-32-769122552449,2020-04-05T11:14:43,Vitoria-Gasteiz,Housing,Rent,-1119.73,-727.6
buyer_6,Manuel,45,ES48209552855708573275,TRX_N-320-589041345343,2022-05-06T18:55:37,Vitoria-Gasteiz,Basic services,electricity,-41.08,-27865.12
buyer_6,Manuel,45,ES48209552855708573275,TRX_N-321-20423248181,2022-05-06T13:50:11,Vitoria-Gasteiz,Basic services,gas,-61.99,-27927.11
buyer_6,Manuel,45,ES48209552855708573275,TRX_N-322-137469930192,2022-05-06T23:16:44,Vitoria-Gasteiz,Basic services,internet,-58.44,-27985.55
buyer_6,Manuel,45,ES48209552855708573275,TRX_N-323-787604222440,2022-05-07T17:49:53,Vitoria-Gasteiz,Basic services,internet,-64.64,-28050.19
buyer_6,Manuel,45,ES48209552855708573275,TRX_N-324-758222006402,2022-05-17T20:32:42,Vitoria-Gasteiz,Expense,leisure,-162.6,-28212.79
buyer_6,Manuel,45,ES48209552855708573275,TRX_N-325-92352437881,2022-06-01T16:50:53,Vitoria-Gasteiz,transfer,Salary,1289.87,-26922.92
buyer_6,Manuel,45,ES48209552855708573275,TRX_N-326-351460188956,2022-06-01T16:50:53,Vitoria-Gasteiz,transfer,Extra Income,128.99,-26793.93
buyer_6,Manuel,45,ES48209552855708573275,TRX_N-327-223589819222,2022-06-01T16:50:53,Vitoria-Gasteiz,transfer,Bonus,1320.7,-25473.23
buyer_6,Manuel,45,ES48209552855708573275,TRX_N-328-359491584996,2022-06-01T23:35:28,Vitoria-Gasteiz,Expense,food,-554.92,-26028.15
buyer_6,Manuel,45,ES48209552855708573275,TRX_N-329-47253639827,2022-06-05T19:33:17,Vitoria-Gasteiz,Housing,Rent,-1119.73,-27147.88
buyer_6,Manuel,45,ES48209552855708573275,TRX_N-33-85713919891,2020-04-05T08:56:15,Vitoria-Gasteiz,Basic services,water,-16.49,-744.09
buyer_6,Manuel,45,ES48209552855708573275,TRX_N-330-665629202650,2022-06-05T15:37:49,Vitoria-Gasteiz,Basic services,gas,-98.24,-27246.12
buyer_6,Manuel,45,ES48209552855708573275,TRX_N-331-479124018079,2022-06-06T22:15:45,Vitoria-Gasteiz,Basic services,gas,-28.56,-27274.68
buyer_6,Manuel,45,ES48209552855708573275,TRX_N-332-996349110334,2022-06-06T05:41:28,Vitoria-Gasteiz,Basic services,internet,-45.0,-27319.68
buyer_6,Manuel,45,ES48209552855708573275,TRX_N-333-347884464368,2022-06-06T12:48:00,Vitoria-Gasteiz,Basic services,phone,-64.57,-27384.25
buyer_6,Manuel,45,ES48209552855708573275,TRX_N-334-329802488211,2022-06-07T18:56:14,Vitoria-Gasteiz,Basic services,water,-41.19,-27425.44
buyer_6,Manuel,45,ES48209552855708573275,TRX_N-335-325521353198,2022-06-07T05:48:32,Vitoria-Gasteiz,Basic services,internet,-38.55,-27463.99
buyer_6,Manuel,45,ES48209552855708573275,TRX_N-336-616402568903,2022-06-09T12:01:27,Vitoria-Gasteiz,Expense,transport,-76.37,-27540.36
buyer_6,Manuel,45,ES48209552855708573275,TRX_N-337-785011387556,2022-06-16T20:45:07,Vitoria-Gasteiz,Expense,food,-308.85,-27849.21
buyer_6,Manuel,45,ES48209552855708573275,TRX_N-338-474854562258,2022-06-18T06:59:25,Vitoria-Gasteiz,Expense,transport,-197.24,-28046.45
buyer_6,Manuel,45,ES48209552855708573275,TRX_N-339-683135859597,2022-06-22T14:42:09,Vitoria-Gasteiz,Expense,leisure,-99.82,-28146.27
buyer_6,Manuel,45,ES48209552855708573275,TRX_N-34-951206729657,2020-04-06T08:47:56,Vitoria-Gasteiz,Basic services,electricity,-73.95,-818.04
buyer_6,Manuel,45,ES48209552855708573275,TRX_N-340-50633617576,2022-07-01T12:30:43,Vitoria-Gasteiz,transfer,Salary,1289.87,-26856.4
buyer_6,Manuel,45,ES48209552855708573275,TRX_N-341-229098312538,2022-07-03T20:59:04,Vitoria-Gasteiz,Expense,clothing,-356.12,-27212.52
buyer_6,Manuel,45,ES48209552855708573275,TRX_N-342-528434260358,2022-07-05T19:06:24,Vitoria-Gasteiz,Housing,Rent,-1119.73,-28332.25
buyer_6,Manuel,45,ES48209552855708573275,TRX_N-343-482830986939,2022-07-05T19:09:11,Vitoria-Gasteiz,Basic services,water,-74.75,-28407.0
buyer_6,Manuel,45,ES48209552855708573275,TRX_N-344-646911009432,2022-07-05T04:02:07,Vitoria-Gasteiz,Basic services,electricity,-138.83,-28545.83
buyer_6,Manuel,45,ES48209552855708573275,TRX_N-345-728260508110,2022-07-05T14:43:44,Vitoria-Gasteiz,Expense,transport,-195.49,-28741.32
buyer_6,Manuel,45,ES48209552855708573275,TRX_N-346-43026797643,2022-07-06T20:36:21,Vitoria-Gasteiz,Basic services,phone,-41.92,-28783.24
buyer_6,Manuel,45,ES48209552855708573275,TRX_N-347-494336066841,2022-07-06T10:10:24,Berango,Expense,leisure,-59.47,-28842.71
buyer_6,Manuel,45,ES48209552855708573275,TRX_N-348-484821970249,2022-07-07T08:46:20,Vitoria-Gasteiz,Basic services,internet,-46.95,-28889.66
buyer_6,Manuel,45,ES48209552855708573275,TRX_N-349-3093226941,2022-07-23T23:44:48,Vitoria-Gasteiz,Expense,transport,-29.0,-28918.66
buyer_6,Manuel,45,ES48209552855708573275,TRX_N-35-799867818415,2020-04-06T13:42:04,Vitoria-Gasteiz,Basic services,internet,-68.76,-886.8
buyer_6,Manuel,45,ES48209552855708573275,TRX_N-350-476118490615,2022-07-24T05:16:43,Vitoria-Gasteiz,Expense,food,-234.51,-29153.17
buyer_6,Manuel,45,ES48209552855708573275,TRX_N-351-402219219059,2022-07-25T13:39:18,Vitoria-Gasteiz,Expense,transport,-144.81,-29297.98
buyer_6,Manuel,45,ES48209552855708573275,TRX_N-352-566949089480,2022-08-01T17:48:10,Vitoria-Gasteiz,transfer,Salary,1289.87,-28008.11
buyer_6,Manuel,45,ES48209552855708573275,TRX_N-353-92033480705,2022-08-04T23:22:41,Vitoria-Gasteiz,Expense,healthcare,-52.89,-28061.0
buyer_6,Manuel,45,ES48209552855708573275,TRX_N-354-347795538864,2022-08-05T19:42:56,Vitoria-Gasteiz,Housing,Rent,-1119.73,-29180.73
buyer_6,Manuel,45,ES48209552855708573275,TRX_N-355-212396838548,2022-08-05T15:14:24,Vitoria-Gasteiz,Basic services,water,-29.21,-29209.94
buyer_6,Manuel,45,ES48209552855708573275,TRX_N-356-362576474686,2022-08-05T10:31:58,Vitoria-Gasteiz,Basic services,gas,-22.78,-29232.72
buyer_6,Manuel,45,ES48209552855708573275,TRX_N-357-670222622591,2022-08-06T20:20:56,Vitoria-Gasteiz,Basic services,water,-43.64,-29276.36
buyer_6,Manuel,45,ES48209552855708573275,TRX_N-358-605965986060,2022-08-07T12:34:47,Vitoria-Gasteiz,Basic services,water,-53.63,-29329.99
buyer_6,Manuel,45,ES48209552855708573275,TRX_N-359-837537236526,2022-08-16T17:16:43,Vitoria-Gasteiz,Expense,healthcare,-81.58,-29411.57
buyer_6,Manuel,45,ES48209552855708573275,TRX_N-36-333490798550,2020-04-06T17:42:24,Vitoria-Gasteiz,Basic services,phone,-42.74,-929.54
buyer_6,Manuel,45,ES48209552855708573275,TRX_N-360-343292011170,2022-09-01T09:40:27,Vitoria-Gasteiz,transfer,Salary,1289.87,-28121.7
buyer_6,Manuel,45,ES48209552855708573275,TRX_N-361-794114283092,2022-09-01T09:40:27,Vitoria-Gasteiz,transfer,Extra Income,128.99,-27992.71
buyer_6,Manuel,45,ES48209552855708573275,TRX_N-362-809423544459,2022-09-04T16:40:22,Donostia,Expense,food,-528.16,-28520.87
buyer_6,Manuel,45,ES48209552855708573275,TRX_N-363-804443950407,2022-09-05T08:47:17,Vitoria-Gasteiz,Housing,Rent,-1119.73,-29640.6
buyer_6,Manuel,45,ES48209552855708573275,TRX_N-364-684928431288,2022-09-05T21:49:21,Vitoria-Gasteiz,Basic services,electricity,-50.71,-29691.31
buyer_6,Manuel,45,ES48209552855708573275,TRX_N-365-784186167283,2022-09-05T15:10:51,Vitoria-Gasteiz,Basic services,internet,-55.89,-29747.2
buyer_6,Manuel,45,ES48209552855708573275,TRX_N-366-57605376352,2022-09-06T15:18:38,Vitoria-Gasteiz,Basic services,electricity,-28.1,-29775.3
buyer_6,Manuel,45,ES48209552855708573275,TRX_N-367-943829039325,2022-09-07T11:55:30,Vitoria-Gasteiz,Expense,leisure,-52.61,-29827.91
buyer_6,Manuel,45,ES48209552855708573275,TRX_N-368-187893546257,2022-09-18T07:11:40,Arrasate/Mondragon,Expense,repairs,-426.84,-30254.75
buyer_6,Manuel,45,ES48209552855708573275,TRX_N-369-262394399372,2022-09-19T16:59:22,Oyón-Oion,Expense,transport,-119.02,-30373.77
buyer_6,Manuel,45,ES48209552855708573275,TRX_N-37-915072004326,2020-04-07T15:49:08,Vitoria-Gasteiz,Basic services,electricity,-47.41,-976.95
buyer_6,Manuel,45,ES48209552855708573275,TRX_N-370-75496296536,2022-09-21T08:09:49,Vitoria-Gasteiz,Expense,food,-408.22,-30781.99
buyer_6,Manuel,45,ES48209552855708573275,TRX_N-371-89911173860,2022-09-24T11:34:15,Hondarribia,Expense,transport,-66.0,-30847.99
buyer_6,Manuel,45,ES48209552855708573275,TRX_N-372-906888355090,2022-09-25T10:07:17,Leioa,Expense,leisure,-173.13,-31021.12
buyer_6,Manuel,45,ES48209552855708573275,TRX_N-373-383714226640,2022-09-27T17:10:26,Zuia,Expense,clothing,-37.5,-31058.62
buyer_6,Manuel,45,ES48209552855708573275,TRX_N-374-153430759221,2022-10-01T08:24:09,Vitoria-Gasteiz,transfer,Salary,1289.87,-29768.75
buyer_6,Manuel,45,ES48209552855708573275,TRX_N-375-697087758815,2022-10-04T20:39:27,Vitoria-Gasteiz,Expense,leisure,-230.04,-29998.79
buyer_6,Manuel,45,ES48209552855708573275,TRX_N-376-547708495414,2022-10-05T10:32:34,Vitoria-Gasteiz,Housing,Rent,-1119.73,-31118.52
buyer_6,Manuel,45,ES48209552855708573275,TRX_N-377-136722892623,2022-10-05T08:58:30,Vitoria-Gasteiz,Basic services,gas,-36.88,-31155.4
buyer_6,Manuel,45,ES48209552855708573275,TRX_N-378-774395311332,2022-10-05T19:28:41,Vitoria-Gasteiz,Basic services,phone,-28.04,-31183.44
buyer_6,Manuel,45,ES48209552855708573275,TRX_N-379-751970018337,2022-10-06T17:15:42,Vitoria-Gasteiz,Basic services,water,-59.34,-31242.78
buyer_6,Manuel,45,ES48209552855708573275,TRX_N-38-965580078464,2020-04-07T14:01:07,Vitoria-Gasteiz,Basic services,phone,-42.96,-1019.91
buyer_6,Manuel,45,ES48209552855708573275,TRX_N-380-394630827772,2022-10-06T20:09:24,Vitoria-Gasteiz,Basic services,gas,-63.09,-31305.87
buyer_6,Manuel,45,ES48209552855708573275,TRX_N-381-643996817947,2022-10-06T17:45:23,Vitoria-Gasteiz,Basic services,internet,-66.57,-31372.44
buyer_6,Manuel,45,ES48209552855708573275,TRX_N-382-343814250216,2022-10-06T06:16:31,Vitoria-Gasteiz,Basic services,phone,-65.8,-31438.24
buyer_6,Manuel,45,ES48209552855708573275,TRX_N-383-657572739376,2022-10-06T13:22:15,Vitoria-Gasteiz,Expense,leisure,-139.67,-31577.91
buyer_6,Manuel,45,ES48209552855708573275,TRX_N-384-833013720813,2022-10-07T09:37:57,Vitoria-Gasteiz,Basic services,water,-52.53,-31630.44
buyer_6,Manuel,45,ES48209552855708573275,TRX_N-385-351204636071,2022-10-07T22:39:59,Vitoria-Gasteiz,Basic services,electricity,-56.81,-31687.25
buyer_6,Manuel,45,ES48209552855708573275,TRX_N-386-913077255526,2022-10-07T08:58:19,Vitoria-Gasteiz,Basic services,gas,-89.79,-31777.04
buyer_6,Manuel,45,ES48209552855708573275,TRX_N-387-459833735638,2022-10-08T18:10:22,Vitoria-Gasteiz,Expense,transport,-74.89,-31851.93
buyer_6,Manuel,45,ES48209552855708573275,TRX_N-388-191642304653,2022-10-09T08:39:41,Vitoria-Gasteiz,Expense,clothing,-185.68,-32037.61
buyer_6,Manuel,45,ES48209552855708573275,TRX_N-389-109748292908,2022-10-14T08:53:48,Hernani,Expense,leisure,-104.9,-32142.51
buyer_6,Manuel,45,ES48209552855708573275,TRX_N-39-10835133763,2020-04-12T15:59:31,Vitoria-Gasteiz,Expense,food,-760.53,-1780.44
buyer_6,Manuel,45,ES48209552855708573275,TRX_N-390-200115084829,2022-10-23T09:25:45,Vitoria-Gasteiz,Expense,leisure,-181.35,-32323.86
buyer_6,Manuel,45,ES48209552855708573275,TRX_N-391-907603096362,2022-11-01T05:25:03,Vitoria-Gasteiz,transfer,Salary,1289.87,-31033.99
buyer_6,Manuel,45,ES48209552855708573275,TRX_N-392-932938462328,2022-11-05T19:06:50,Vitoria-Gasteiz,Housing,Rent,-1119.73,-32153.72
buyer_6,Manuel,45,ES48209552855708573275,TRX_N-393-629456826772,2022-11-05T20:01:23,Vitoria-Gasteiz,Basic services,water,-18.55,-32172.27
buyer_6,Manuel,45,ES48209552855708573275,TRX_N-394-674648411643,2022-11-05T10:01:33,Vitoria-Gasteiz,Basic services,gas,-86.49,-32258.76
buyer_6,Manuel,45,ES48209552855708573275,TRX_N-395-480544603874,2022-11-05T22:48:31,Vitoria-Gasteiz,Basic services,internet,-34.86,-32293.62
buyer_6,Manuel,45,ES48209552855708573275,TRX_N-396-284975052875,2022-11-06T16:22:54,Vitoria-Gasteiz,Basic services,water,-58.22,-32351.84
buyer_6,Manuel,45,ES48209552855708573275,TRX_N-397-936489727155,2022-11-06T19:43:55,Vitoria-Gasteiz,Basic services,electricity,-80.9,-32432.74
buyer_6,Manuel,45,ES48209552855708573275,TRX_N-398-97543028887,2022-11-07T20:04:06,Vitoria-Gasteiz,Basic services,water,-69.75,-32502.49
buyer_6,Manuel,45,ES48209552855708573275,TRX_N-399-777206089326,2022-11-07T18:39:40,Vitoria-Gasteiz,Basic services,gas,-51.23,-32553.72
buyer_6,Manuel,45,ES48209552855708573275,TRX_N-4-618809901785,2020-01-06T19:31:02,Vitoria-Gasteiz,Basic services,electricity,-79.3,811.34
buyer_6,Manuel,45,ES48209552855708573275,TRX_N-40-918955515713,2020-04-30T04:55:09,Vitoria-Gasteiz,Expense,education,-841.06,-2621.5
buyer_6,Manuel,45,ES48209552855708573275,TRX_N-400-56547687915,2022-11-07T13:56:23,Vitoria-Gasteiz,Expense,transport,-120.57,-32674.29
buyer_6,Manuel,45,ES48209552855708573275,TRX_N-401-353144109323,2022-11-26T10:56:02,Vitoria-Gasteiz,Expense,leisure,-82.71,-32757.0
buyer_6,Manuel,45,ES48209552855708573275,TRX_N-402-565296756699,2022-12-01T12:38:41,Vitoria-Gasteiz,transfer,Salary,1289.87,-31467.13
buyer_6,Manuel,45,ES48209552855708573275,TRX_N-403-11969408652,2022-12-01T12:38:41,Vitoria-Gasteiz,transfer,Extra Income,128.99,-31338.14
buyer_6,Manuel,45,ES48209552855708573275,TRX_N-404-336095756455,2022-12-01T12:38:41,Vitoria-Gasteiz,transfer,Bonus,1244.77,-30093.37
buyer_6,Manuel,45,ES48209552855708573275,TRX_N-405-696032146551,2022-12-01T22:25:30,Elciego,Expense,leisure,-268.85,-30362.22
buyer_6,Manuel,45,ES48209552855708573275,TRX_N-406-696913738479,2022-12-05T10:51:44,Vitoria-Gasteiz,Housing,Rent,-1119.73,-31481.95
buyer_6,Manuel,45,ES48209552855708573275,TRX_N-407-629456526996,2022-12-05T11:28:42,Vitoria-Gasteiz,Basic services,water,-40.12,-31522.07
buyer_6,Manuel,45,ES48209552855708573275,TRX_N-408-765028150793,2022-12-05T21:03:07,Vitoria-Gasteiz,Basic services,gas,-25.67,-31547.74
buyer_6,Manuel,45,ES48209552855708573275,TRX_N-409-423631659900,2022-12-05T15:46:51,Vitoria-Gasteiz,Basic services,internet,-74.83,-31622.57
buyer_6,Manuel,45,ES48209552855708573275,TRX_N-41-482500157902,2020-05-01T10:59:46,Vitoria-Gasteiz,transfer,Salary,1289.87,-1331.63
buyer_6,Manuel,45,ES48209552855708573275,TRX_N-410-123594791727,2022-12-06T10:01:00,Vitoria-Gasteiz,Basic services,gas,-65.49,-31688.06
buyer_6,Manuel,45,ES48209552855708573275,TRX_N-411-958562518032,2022-12-16T18:03:07,Vitoria-Gasteiz,Expense,food,-550.65,-32238.71
buyer_6,Manuel,45,ES48209552855708573275,TRX_N-412-806557116660,2022-12-19T23:07:02,Vitoria-Gasteiz,Expense,transport,-145.23,-32383.94
buyer_6,Manuel,45,ES48209552855708573275,TRX_N-413-904481635368,2022-12-26T09:41:02,Vitoria-Gasteiz,Expense,clothing,-53.99,-32437.93
buyer_6,Manuel,45,ES48209552855708573275,TRX_N-414-361284183472,2022-12-27T15:52:33,Vitoria-Gasteiz,Expense,food,-647.95,-33085.88
buyer_6,Manuel,45,ES48209552855708573275,TRX_N-415-354948670740,2023-01-01T20:59:11,Vitoria-Gasteiz,transfer,Salary,1289.87,-31796.01
buyer_6,Manuel,45,ES48209552855708573275,TRX_N-416-939579001868,2023-01-05T09:17:59,Vitoria-Gasteiz,Housing,Rent,-1119.73,-32915.74
buyer_6,Manuel,45,ES48209552855708573275,TRX_N-417-732736715066,2023-01-05T17:36:55,Vitoria-Gasteiz,Basic services,phone,-43.29,-32959.03
buyer_6,Manuel,45,ES48209552855708573275,TRX_N-418-463247426125,2023-01-06T14:47:16,Vitoria-Gasteiz,Basic services,internet,-63.62,-33022.65
buyer_6,Manuel,45,ES48209552855708573275,TRX_N-419-131907575998,2023-01-07T18:16:18,Vitoria-Gasteiz,Basic services,internet,-61.21,-33083.86
buyer_6,Manuel,45,ES48209552855708573275,TRX_N-42-251608849908,2020-05-01T10:59:46,Vitoria-Gasteiz,transfer,Extra Income,128.99,-1202.64
buyer_6,Manuel,45,ES48209552855708573275,TRX_N-420-310266192080,2023-01-07T19:52:02,Vitoria-Gasteiz,Basic services,phone,-35.8,-33119.66
buyer_6,Manuel,45,ES48209552855708573275,TRX_N-421-702488877210,2023-01-10T20:55:45,Vitoria-Gasteiz,Expense,food,-262.97,-33382.63
buyer_6,Manuel,45,ES48209552855708573275,TRX_N-422-499235495639,2023-01-11T14:50:11,Vitoria-Gasteiz,Expense,clothing,-161.23,-33543.86
buyer_6,Manuel,45,ES48209552855708573275,TRX_N-423-112535592326,2023-01-12T13:31:36,Vitoria-Gasteiz,Expense,transport,-28.71,-33572.57
buyer_6,Manuel,45,ES48209552855708573275,TRX_N-424-554706088459,2023-01-13T17:12:03,Vitoria-Gasteiz,Expense,leisure,-127.39,-33699.96
buyer_6,Manuel,45,ES48209552855708573275,TRX_N-425-406585165640,2023-01-18T12:53:48,Donostia,Expense,education,-539.06,-34239.02
buyer_6,Manuel,45,ES48209552855708573275,TRX_N-426-500510674323,2023-02-01T08:45:20,Vitoria-Gasteiz,transfer,Salary,1289.87,-32949.15
buyer_6,Manuel,45,ES48209552855708573275,TRX_N-427-906733489470,2023-02-01T08:45:20,Vitoria-Gasteiz,transfer,Extra Income,128.99,-32820.16
buyer_6,Manuel,45,ES48209552855708573275,TRX_N-428-507559537713,2023-02-01T04:42:41,Vitoria-Gasteiz,Expense,transport,-199.95,-33020.11
buyer_6,Manuel,45,ES48209552855708573275,TRX_N-429-57445468373,2023-02-04T20:53:30,Vitoria-Gasteiz,Expense,food,-638.78,-33658.89
buyer_6,Manuel,45,ES48209552855708573275,TRX_N-43-547171922199,2020-05-05T11:22:31,Vitoria-Gasteiz,Housing,Rent,-1119.73,-2322.37
buyer_6,Manuel,45,ES48209552855708573275,TRX_N-430-398971330786,2023-02-05T08:17:26,Vitoria-Gasteiz,Housing,Rent,-1119.73,-34778.62
buyer_6,Manuel,45,ES48209552855708573275,TRX_N-431-980662824037,2023-02-05T17:14:57,Vitoria-Gasteiz,Basic services,electricity,-34.72,-34813.34
buyer_6,Manuel,45,ES48209552855708573275,TRX_N-432-653081279846,2023-02-06T04:08:01,Vitoria-Gasteiz,Basic services,phone,-89.82,-34903.16
buyer_6,Manuel,45,ES48209552855708573275,TRX_N-433-841197445863,2023-02-06T20:32:40,Vitoria-Gasteiz,Expense,healthcare,-67.97,-34971.13
buyer_6,Manuel,45,ES48209552855708573275,TRX_N-434-304874059970,2023-02-07T10:49:59,Vitoria-Gasteiz,Basic services,internet,-67.77,-35038.9
buyer_6,Manuel,45,ES48209552855708573275,TRX_N-435-40771649597,2023-02-15T14:05:18,Vitoria-Gasteiz,Expense,education,-284.13,-35323.03
buyer_6,Manuel,45,ES48209552855708573275,TRX_N-436-497349262733,2023-02-27T10:13:06,Vitoria-Gasteiz,Expense,clothing,-388.52,-35711.55
buyer_6,Manuel,45,ES48209552855708573275,TRX_N-437-28670015705,2023-03-01T16:53:24,Vitoria-Gasteiz,transfer,Salary,1289.87,-34421.68
buyer_6,Manuel,45,ES48209552855708573275,TRX_N-438-580387561634,2023-03-01T16:26:58,Bermeo,Expense,healthcare,-51.44,-34473.12
buyer_6,Manuel,45,ES48209552855708573275,TRX_N-439-12878271103,2023-03-04T18:36:14,Vitoria-Gasteiz,Expense,food,-674.51,-35147.63
buyer_6,Manuel,45,ES48209552855708573275,TRX_N-44-320097443456,2020-05-05T09:21:06,Vitoria-Gasteiz,Basic services,electricity,-97.2,-2419.57
buyer_6,Manuel,45,ES48209552855708573275,TRX_N-440-502952263973,2023-03-05T09:59:16,Vitoria-Gasteiz,Housing,Rent,-1119.73,-36267.36
buyer_6,Manuel,45,ES48209552855708573275,TRX_N-441-630622407229,2023-03-05T00:45:12,Vitoria-Gasteiz,Expense,transport,-103.68,-36371.04
buyer_6,Manuel,45,ES48209552855708573275,TRX_N-442-545137804942,2023-03-06T18:02:43,Vitoria-Gasteiz,Basic services,water,-16.6,-36387.64
buyer_6,Manuel,45,ES48209552855708573275,TRX_N-443-598179980789,2023-03-06T07:06:06,Vitoria-Gasteiz,Basic services,electricity,-28.44,-36416.08
buyer_6,Manuel,45,ES48209552855708573275,TRX_N-444-62481733943,2023-03-06T17:33:00,Vitoria-Gasteiz,Basic services,gas,-81.82,-36497.9
buyer_6,Manuel,45,ES48209552855708573275,TRX_N-445-202415734333,2023-03-07T16:23:44,Vitoria-Gasteiz,Basic services,gas,-68.91,-36566.81
buyer_6,Manuel,45,ES48209552855708573275,TRX_N-446-632627522530,2023-03-13T18:49:55,Vitoria-Gasteiz,Expense,transport,-96.19,-36663.0
buyer_6,Manuel,45,ES48209552855708573275,TRX_N-447-139910845159,2023-03-13T10:14:56,Vitoria-Gasteiz,Expense,travel,-1588.11,-38251.11
buyer_6,Manuel,45,ES48209552855708573275,TRX_N-448-259702841404,2023-03-19T08:15:10,Zarautz,Expense,food,-357.54,-38608.65
buyer_6,Manuel,45,ES48209552855708573275,TRX_N-449-678444119563,2023-03-21T14:49:55,Vitoria-Gasteiz,Expense,healthcare,-365.39,-38974.04
buyer_6,Manuel,45,ES48209552855708573275,TRX_N-45-733804880346,2020-05-05T14:37:27,Vitoria-Gasteiz,Basic services,gas,-84.52,-2504.09
buyer_6,Manuel,45,ES48209552855708573275,TRX_N-450-648865002592,2023-03-28T13:37:41,Barakaldo,Expense,healthcare,-236.92,-39210.96
buyer_6,Manuel,45,ES48209552855708573275,TRX_N-451-337678162076,2023-04-01T21:39:56,Vitoria-Gasteiz,transfer,Salary,1289.87,-37921.09
buyer_6,Manuel,45,ES48209552855708573275,TRX_N-452-323548801237,2023-04-01T21:39:56,Vitoria-Gasteiz,transfer,Extra Income,128.99,-37792.1
buyer_6,Manuel,45,ES48209552855708573275,TRX_N-453-564236099953,2023-04-02T18:57:05,Bermeo,Expense,appliances,-864.3,-38656.4
buyer_6,Manuel,45,ES48209552855708573275,TRX_N-454-528555234925,2023-04-05T16:20:07,Vitoria-Gasteiz,Housing,Rent,-1119.73,-39776.13
buyer_6,Manuel,45,ES48209552855708573275,TRX_N-455-639271137093,2023-04-05T19:02:51,Vitoria-Gasteiz,Expense,leisure,-22.75,-39798.88
buyer_6,Manuel,45,ES48209552855708573275,TRX_N-456-976951417097,2023-04-06T03:10:30,Vitoria-Gasteiz,Basic services,electricity,-38.92,-39837.8
buyer_6,Manuel,45,ES48209552855708573275,TRX_N-457-601170790865,2023-04-06T21:58:32,Vitoria-Gasteiz,Basic services,gas,-41.88,-39879.68
buyer_6,Manuel,45,ES48209552855708573275,TRX_N-458-114178081312,2023-04-07T11:08:09,Vitoria-Gasteiz,Basic services,water,-12.94,-39892.62
buyer_6,Manuel,45,ES48209552855708573275,TRX_N-459-89463308897,2023-04-07T12:48:06,Vitoria-Gasteiz,Basic services,electricity,-25.95,-39918.57
buyer_6,Manuel,45,ES48209552855708573275,TRX_N-46-530764961069,2020-05-05T10:19:10,Vitoria-Gasteiz,Basic services,internet,-40.21,-2544.3
buyer_6,Manuel,45,ES48209552855708573275,TRX_N-460-260850876780,2023-04-07T18:44:59,Vitoria-Gasteiz,Basic services,gas,-39.31,-39957.88
buyer_6,Manuel,45,ES48209552855708573275,TRX_N-461-270438897276,2023-04-10T21:10:58,Salvatierra/Agurain,Expense,food,-144.35,-40102.23
buyer_6,Manuel,45,ES48209552855708573275,TRX_N-462-925150810723,2023-04-11T22:41:19,Vitoria-Gasteiz,Expense,food,-143.26,-40245.49
buyer_6,Manuel,45,ES48209552855708573275,TRX_N-463-889982753998,2023-04-26T12:58:18,Vitoria-Gasteiz,Expense,clothing,-133.28,-40378.77
buyer_6,Manuel,45,ES48209552855708573275,TRX_N-464-732158011285,2023-05-01T11:57:57,Vitoria-Gasteiz,transfer,Salary,1289.87,-39088.9
buyer_6,Manuel,45,ES48209552855708573275,TRX_N-465-36146489808,2023-05-05T14:26:36,Vitoria-Gasteiz,Housing,Rent,-1119.73,-40208.63
buyer_6,Manuel,45,ES48209552855708573275,TRX_N-466-761824158751,2023-05-05T10:49:25,Vitoria-Gasteiz,Basic services,electricity,-110.35,-40318.98
buyer_6,Manuel,45,ES48209552855708573275,TRX_N-467-91601705332,2023-05-05T20:11:18,Vitoria-Gasteiz,Basic services,phone,-88.56,-40407.54
buyer_6,Manuel,45,ES48209552855708573275,TRX_N-468-451202094289,2023-05-06T20:02:11,Vitoria-Gasteiz,Basic services,gas,-53.58,-40461.12
buyer_6,Manuel,45,ES48209552855708573275,TRX_N-469-171376341358,2023-05-07T14:49:29,Vitoria-Gasteiz,Basic services,water,-54.97,-40516.09
buyer_6,Manuel,45,ES48209552855708573275,TRX_N-47-939540344157,2020-05-05T17:40:15,Vitoria-Gasteiz,Basic services,phone,-80.32,-2624.62
buyer_6,Manuel,45,ES48209552855708573275,TRX_N-470-261216452314,2023-05-07T12:32:38,Vitoria-Gasteiz,Basic services,phone,-34.41,-40550.5
buyer_6,Manuel,45,ES48209552855708573275,TRX_N-471-519934327172,2023-05-10T19:27:08,Vitoria-Gasteiz,Expense,clothing,-439.93,-40990.43
buyer_6,Manuel,45,ES48209552855708573275,TRX_N-472-304211389074,2023-05-14T16:36:02,Vitoria-Gasteiz,Expense,gifts,-81.5,-41071.93
buyer_6,Manuel,45,ES48209552855708573275,TRX_N-473-80154245158,2023-05-24T08:35:26,Vitoria-Gasteiz,Expense,gifts,-354.81,-41426.74
buyer_6,Manuel,45,ES48209552855708573275,TRX_N-474-440642260778,2023-06-01T20:28:47,Vitoria-Gasteiz,transfer,Salary,1289.87,-40136.87
buyer_6,Manuel,45,ES48209552855708573275,TRX_N-475-731587370606,2023-06-01T20:28:47,Vitoria-Gasteiz,transfer,Extra Income,128.99,-40007.88
buyer_6,Manuel,45,ES48209552855708573275,TRX_N-476-447773218894,2023-06-01T20:28:47,Vitoria-Gasteiz,transfer,Bonus,1325.5,-38682.38
buyer_6,Manuel,45,ES48209552855708573275,TRX_N-477-259225987744,2023-06-05T11:33:51,Vitoria-Gasteiz,Housing,Rent,-1119.73,-39802.11
buyer_6,Manuel,45,ES48209552855708573275,TRX_N-478-164054433168,2023-06-06T22:37:56,Vitoria-Gasteiz,Expense,transport,-81.98,-39884.09
buyer_6,Manuel,45,ES48209552855708573275,TRX_N-479-911294218494,2023-06-13T17:34:14,Vitoria-Gasteiz,Expense,transport,-91.62,-39975.71
buyer_6,Manuel,45,ES48209552855708573275,TRX_N-48-959750849853,2020-05-05T11:26:10,Vitoria-Gasteiz,Expense,food,-693.13,-3317.75
buyer_6,Manuel,45,ES48209552855708573275,TRX_N-480-408683204741,2023-06-23T19:39:58,Vitoria-Gasteiz,Expense,food,-430.41,-40406.12
buyer_6,Manuel,45,ES48209552855708573275,TRX_N-481-834471576360,2023-06-24T17:40:39,Getxo,Expense,food,-387.7,-40793.82
buyer_6,Manuel,45,ES48209552855708573275,TRX_N-482-905644899469,2023-06-24T08:19:38,Vitoria-Gasteiz,Expense,clothing,-99.34,-40893.16
buyer_6,Manuel,45,ES48209552855708573275,TRX_N-483-124413771683,2023-07-01T23:26:56,Vitoria-Gasteiz,transfer,Salary,1289.87,-39603.29
buyer_6,Manuel,45,ES48209552855708573275,TRX_N-484-607082038963,2023-07-05T11:39:01,Vitoria-Gasteiz,Housing,Rent,-1119.73,-40723.02
buyer_6,Manuel,45,ES48209552855708573275,TRX_N-485-4974147588,2023-07-05T18:52:21,Vitoria-Gasteiz,Basic services,water,-54.75,-40777.77
buyer_6,Manuel,45,ES48209552855708573275,TRX_N-486-101676741944,2023-07-05T19:30:48,Vitoria-Gasteiz,Basic services,gas,-74.83,-40852.6
buyer_6,Manuel,45,ES48209552855708573275,TRX_N-487-983411717945,2023-07-05T18:52:19,Vitoria-Gasteiz,Basic services,internet,-78.35,-40930.95
buyer_6,Manuel,45,ES48209552855708573275,TRX_N-488-895818783666,2023-07-05T12:17:57,Vitoria-Gasteiz,Expense,leisure,-228.6,-41159.55
buyer_6,Manuel,45,ES48209552855708573275,TRX_N-489-273361912179,2023-07-06T13:30:58,Irun,Expense,gifts,-59.05,-41218.6
buyer_6,Manuel,45,ES48209552855708573275,TRX_N-49-611735791885,2020-05-07T11:32:49,Vitoria-Gasteiz,Basic services,electricity,-105.36,-3423.11
buyer_6,Manuel,45,ES48209552855708573275,TRX_N-490-937309673768,2023-07-07T15:59:59,Vitoria-Gasteiz,Basic services,water,-11.04,-41229.64
buyer_6,Manuel,45,ES48209552855708573275,TRX_N-491-524609597589,2023-07-07T10:49:41,Vitoria-Gasteiz,Basic services,electricity,-30.13,-41259.77
buyer_6,Manuel,45,ES48209552855708573275,TRX_N-492-136217564097,2023-07-07T16:45:31,Vitoria-Gasteiz,Basic services,internet,-36.79,-41296.56
buyer_6,Manuel,45,ES48209552855708573275,TRX_N-493-391294908465,2023-07-13T01:24:40,Vitoria-Gasteiz,Expense,food,-639.88,-41936.44
buyer_6,Manuel,45,ES48209552855708573275,TRX_N-494-484323646676,2023-07-16T03:37:46,Vitoria-Gasteiz,Expense,appliances,-484.12,-42420.56
buyer_6,Manuel,45,ES48209552855708573275,TRX_N-495-363040278693,2023-07-18T08:15:19,Vitoria-Gasteiz,Expense,food,-756.54,-43177.1
buyer_6,Manuel,45,ES48209552855708573275,TRX_N-496-581836819190,2023-07-18T17:48:56,Salvatierra/Agurain,Expense,gifts,-388.28,-43565.38
buyer_6,Manuel,45,ES48209552855708573275,TRX_N-497-140348764674,2023-07-21T18:26:47,Vitoria-Gasteiz,Expense,transport,-49.8,-43615.18
buyer_6,Manuel,45,ES48209552855708573275,TRX_N-498-416911884439,2023-07-22T08:34:28,Vitoria-Gasteiz,Expense,healthcare,-94.69,-43709.87
buyer_6,Manuel,45,ES48209552855708573275,TRX_N-499-268780923354,2023-08-01T20:07:55,Vitoria-Gasteiz,transfer,Salary,1289.87,-42420.0
buyer_6,Manuel,45,ES48209552855708573275,TRX_N-5-402933340352,2020-01-06T00:29:53,Vitoria-Gasteiz,Basic services,phone,-21.29,790.05
buyer_6,Manuel,45,ES48209552855708573275,TRX_N-50-94393932561,2020-05-09T20:07:46,Vitoria-Gasteiz,Expense,leisure,-88.61,-3511.72
buyer_6,Manuel,45,ES48209552855708573275,TRX_N-500-576975588810,2023-08-01T20:07:55,Vitoria-Gasteiz,transfer,Extra Income,128.99,-42291.01
buyer_6,Manuel,45,ES48209552855708573275,TRX_N-501-836924999072,2023-08-04T00:36:31,Zuia,Expense,leisure,-32.91,-42323.92
buyer_6,Manuel,45,ES48209552855708573275,TRX_N-502-920105237099,2023-08-05T12:01:27,Vitoria-Gasteiz,Housing,Rent,-1119.73,-43443.65
buyer_6,Manuel,45,ES48209552855708573275,TRX_N-503-233751884465,2023-08-05T20:16:21,Vitoria-Gasteiz,Basic services,water,-32.65,-43476.3
buyer_6,Manuel,45,ES48209552855708573275,TRX_N-504-392757054428,2023-08-06T18:50:40,Vitoria-Gasteiz,Basic services,electricity,-110.21,-43586.51
buyer_6,Manuel,45,ES48209552855708573275,TRX_N-505-414011626080,2023-08-06T12:28:08,Vitoria-Gasteiz,Basic services,gas,-62.69,-43649.2
buyer_6,Manuel,45,ES48209552855708573275,TRX_N-506-337469766468,2023-08-06T09:48:07,Vitoria-Gasteiz,Basic services,phone,-32.03,-43681.23
buyer_6,Manuel,45,ES48209552855708573275,TRX_N-507-984824266365,2023-08-07T21:46:26,Vitoria-Gasteiz,Basic services,phone,-91.06,-43772.29
buyer_6,Manuel,45,ES48209552855708573275,TRX_N-508-51128134941,2023-08-12T15:42:42,Hondarribia,Expense,food,-673.86,-44446.15
buyer_6,Manuel,45,ES48209552855708573275,TRX_N-509-148655242440,2023-08-19T17:27:28,Oyón-Oion,Expense,clothing,-459.81,-44905.96
buyer_6,Manuel,45,ES48209552855708573275,TRX_N-51-899302202110,2020-05-18T15:50:50,Vitoria-Gasteiz,Expense,food,-130.25,-3641.97
buyer_6,Manuel,45,ES48209552855708573275,TRX_N-510-749893909042,2023-08-24T18:12:42,Vitoria-Gasteiz,Expense,clothing,-135.97,-45041.93
buyer_6,Manuel,45,ES48209552855708573275,TRX_N-511-768055488211,2023-09-01T13:55:26,Vitoria-Gasteiz,transfer,Salary,1289.87,-43752.06
buyer_6,Manuel,45,ES48209552855708573275,TRX_N-512-641838102008,2023-09-02T20:58:47,Sopela,Expense,food,-595.29,-44347.35
buyer_6,Manuel,45,ES48209552855708573275,TRX_N-513-127705463620,2023-09-05T19:17:47,Vitoria-Gasteiz,Housing,Rent,-1119.73,-45467.08
buyer_6,Manuel,45,ES48209552855708573275,TRX_N-514-746382545636,2023-09-05T16:35:46,Vitoria-Gasteiz,Basic services,internet,-57.38,-45524.46
buyer_6,Manuel,45,ES48209552855708573275,TRX_N-515-970864219925,2023-09-07T09:07:15,Vitoria-Gasteiz,Basic services,water,-57.83,-45582.29
buyer_6,Manuel,45,ES48209552855708573275,TRX_N-516-909870600749,2023-09-07T22:19:54,Vitoria-Gasteiz,Basic services,gas,-54.82,-45637.11
buyer_6,Manuel,45,ES48209552855708573275,TRX_N-517-113870033371,2023-09-07T11:25:12,Vitoria-Gasteiz,Basic services,internet,-45.35,-45682.46
buyer_6,Manuel,45,ES48209552855708573275,TRX_N-518-636244547144,2023-09-07T15:30:57,Vitoria-Gasteiz,Basic services,phone,-85.1,-45767.56
buyer_6,Manuel,45,ES48209552855708573275,TRX_N-519-196200579353,2023-09-17T20:45:10,Vitoria-Gasteiz,Expense,transport,-162.28,-45929.84
buyer_6,Manuel,45,ES48209552855708573275,TRX_N-52-290611473970,2020-06-01T16:40:59,Vitoria-Gasteiz,transfer,Salary,1289.87,-2352.1
buyer_6,Manuel,45,ES48209552855708573275,TRX_N-520-796709323042,2023-09-18T18:09:48,Vitoria-Gasteiz,Expense,food,-131.35,-46061.19
buyer_6,Manuel,45,ES48209552855708573275,TRX_N-521-260711435234,2023-09-20T20:22:01,Vitoria-Gasteiz,Expense,repairs,-666.96,-46728.15
buyer_6,Manuel,45,ES48209552855708573275,TRX_N-522-226201591331,2023-10-01T16:19:24,Vitoria-Gasteiz,transfer,Salary,1289.87,-45438.28
buyer_6,Manuel,45,ES48209552855708573275,TRX_N-523-469048899583,2023-10-05T02:16:47,Vitoria-Gasteiz,Housing,Rent,-1119.73,-46558.01
buyer_6,Manuel,45,ES48209552855708573275,TRX_N-524-13002209706,2023-10-05T05:17:21,Vitoria-Gasteiz,Basic services,water,-27.96,-46585.97
buyer_6,Manuel,45,ES48209552855708573275,TRX_N-525-568337651503,2023-10-05T22:45:48,Vitoria-Gasteiz,Basic services,gas,-27.78,-46613.75
buyer_6,Manuel,45,ES48209552855708573275,TRX_N-526-944689085592,2023-10-06T19:36:39,Vitoria-Gasteiz,Basic services,gas,-99.58,-46713.33
buyer_6,Manuel,45,ES48209552855708573275,TRX_N-527-513928463185,2023-10-06T11:12:13,Vitoria-Gasteiz,Basic services,internet,-39.33,-46752.66
buyer_6,Manuel,45,ES48209552855708573275,TRX_N-528-104511569191,2023-10-07T17:10:40,Vitoria-Gasteiz,Basic services,water,-22.36,-46775.02
buyer_6,Manuel,45,ES48209552855708573275,TRX_N-529-925733889076,2023-10-07T08:37:52,Vitoria-Gasteiz,Basic services,internet,-36.95,-46811.97
buyer_6,Manuel,45,ES48209552855708573275,TRX_N-53-618445551505,2020-06-01T16:40:59,Vitoria-Gasteiz,transfer,Bonus,1234.66,-1117.44
buyer_6,Manuel,45,ES48209552855708573275,TRX_N-530-379137399951,2023-10-07T17:02:58,Salvatierra/Agurain,Expense,transport,-134.54,-46946.51
buyer_6,Manuel,45,ES48209552855708573275,TRX_N-531-155173308850,2023-10-26T15:38:16,Donostia,Expense,healthcare,-137.76,-47084.27
buyer_6,Manuel,45,ES48209552855708573275,TRX_N-532-11567988561,2023-10-28T05:49:51,Getxo,Expense,gifts,-322.21,-47406.48
buyer_6,Manuel,45,ES48209552855708573275,TRX_N-533-548179568202,2023-11-01T22:21:03,Vitoria-Gasteiz,transfer,Salary,1289.87,-46116.61
buyer_6,Manuel,45,ES48209552855708573275,TRX_N-534-422408649901,2023-11-01T22:21:03,Vitoria-Gasteiz,transfer,Extra Income,128.99,-45987.62
buyer_6,Manuel,45,ES48209552855708573275,TRX_N-535-537559146734,2023-11-02T14:50:33,Vitoria-Gasteiz,Expense,transport,-67.91,-46055.53
buyer_6,Manuel,45,ES48209552855708573275,TRX_N-536-934201734513,2023-11-04T05:18:45,Vitoria-Gasteiz,Expense,appliances,-362.24,-46417.77
buyer_6,Manuel,45,ES48209552855708573275,TRX_N-537-404291601907,2023-11-05T03:34:17,Vitoria-Gasteiz,Housing,Rent,-1119.73,-47537.5
buyer_6,Manuel,45,ES48209552855708573275,TRX_N-538-213402636104,2023-11-05T08:48:02,Vitoria-Gasteiz,Basic services,water,-61.91,-47599.41
buyer_6,Manuel,45,ES48209552855708573275,TRX_N-539-177524328391,2023-11-05T10:53:53,Vitoria-Gasteiz,Basic services,gas,-15.52,-47614.93
buyer_6,Manuel,45,ES48209552855708573275,TRX_N-54-351360027073,2020-06-05T08:24:41,Vitoria-Gasteiz,Housing,Rent,-1119.73,-2237.17
buyer_6,Manuel,45,ES48209552855708573275,TRX_N-540-222812834468,2023-11-05T09:28:53,Vitoria-Gasteiz,Basic services,internet,-43.02,-47657.95
buyer_6,Manuel,45,ES48209552855708573275,TRX_N-541-953449549783,2023-11-05T16:57:13,Vitoria-Gasteiz,Basic services,phone,-96.01,-47753.96
buyer_6,Manuel,45,ES48209552855708573275,TRX_N-542-83911447783,2023-11-06T13:16:16,Vitoria-Gasteiz,Basic services,water,-55.17,-47809.13
buyer_6,Manuel,45,ES48209552855708573275,TRX_N-543-613035941439,2023-11-06T23:34:45,Vitoria-Gasteiz,Basic services,electricity,-42.84,-47851.97
buyer_6,Manuel,45,ES48209552855708573275,TRX_N-544-587759888152,2023-11-07T16:21:10,Vitoria-Gasteiz,Expense,food,-472.73,-48324.7
buyer_6,Manuel,45,ES48209552855708573275,TRX_N-545-463059551004,2023-11-12T16:27:22,Vitoria-Gasteiz,Expense,transport,-93.57,-48418.27
buyer_6,Manuel,45,ES48209552855708573275,TRX_N-546-840011200321,2023-11-14T18:37:58,Vitoria-Gasteiz,Expense,transport,-41.15,-48459.42
buyer_6,Manuel,45,ES48209552855708573275,TRX_N-547-13071390168,2023-11-16T15:45:18,Vitoria-Gasteiz,Expense,gifts,-429.66,-48889.08
buyer_6,Manuel,45,ES48209552855708573275,TRX_N-548-600298171766,2023-11-20T17:14:37,Vitoria-Gasteiz,Expense,food,-564.87,-49453.95
buyer_6,Manuel,45,ES48209552855708573275,TRX_N-549-470894835206,2023-11-22T09:34:14,Elciego,Expense,transport,-37.95,-49491.9
buyer_6,Manuel,45,ES48209552855708573275,TRX_N-55-473510299318,2020-06-05T08:31:38,Vitoria-Gasteiz,Basic services,internet,-41.16,-2278.33
buyer_6,Manuel,45,ES48209552855708573275,TRX_N-550-446758790756,2023-11-28T07:30:22,Zarautz,Expense,healthcare,-67.65,-49559.55
buyer_6,Manuel,45,ES48209552855708573275,TRX_N-551-850345336632,2023-11-29T19:37:20,Vitoria-Gasteiz,Expense,food,-555.73,-50115.28
buyer_6,Manuel,45,ES48209552855708573275,TRX_N-552-63019466878,2023-12-01T19:35:36,Vitoria-Gasteiz,transfer,Salary,1289.87,-48825.41
buyer_6,Manuel,45,ES48209552855708573275,TRX_N-553-92610757037,2023-12-01T19:35:36,Vitoria-Gasteiz,transfer,Bonus,1222.9,-47602.51
buyer_6,Manuel,45,ES48209552855708573275,TRX_N-554-42578241624,2023-12-05T19:19:38,Vitoria-Gasteiz,Housing,Rent,-1119.73,-48722.24
buyer_6,Manuel,45,ES48209552855708573275,TRX_N-555-463869677462,2023-12-05T10:08:04,Vitoria-Gasteiz,Basic services,internet,-61.03,-48783.27
buyer_6,Manuel,45,ES48209552855708573275,TRX_N-556-594998955089,2023-12-05T17:50:54,Vitoria-Gasteiz,Basic services,phone,-27.93,-48811.2
buyer_6,Manuel,45,ES48209552855708573275,TRX_N-557-554804694464,2023-12-06T13:23:28,Vitoria-Gasteiz,Basic services,electricity,-75.82,-48887.02
buyer_6,Manuel,45,ES48209552855708573275,TRX_N-558-696229280239,2023-12-06T18:36:14,Vitoria-Gasteiz,Basic services,internet,-76.52,-48963.54
buyer_6,Manuel,45,ES48209552855708573275,TRX_N-559-13681716720,2023-12-06T15:37:35,Vitoria-Gasteiz,Basic services,phone,-56.3,-49019.84
buyer_6,Manuel,45,ES48209552855708573275,TRX_N-56-293664956414,2020-06-06T20:42:34,Vitoria-Gasteiz,Expense,transport,-104.48,-2382.81
buyer_6,Manuel,45,ES48209552855708573275,TRX_N-560-783365389829,2023-12-07T10:15:23,Vitoria-Gasteiz,Basic services,electricity,-131.35,-49151.19
buyer_6,Manuel,45,ES48209552855708573275,TRX_N-561-903731417556,2023-12-07T13:13:12,Vitoria-Gasteiz,Basic services,phone,-32.74,-49183.93
buyer_6,Manuel,45,ES48209552855708573275,TRX_N-562-779257977185,2023-12-13T06:29:22,Vitoria-Gasteiz,Expense,transport,-136.77,-49320.7
buyer_6,Manuel,45,ES48209552855708573275,TRX_N-563-808506063355,2023-12-22T09:47:11,Vitoria-Gasteiz,Expense,transport,-136.72,-49457.42
buyer_6,Manuel,45,ES48209552855708573275,TRX_N-564-691636843434,2024-01-01T08:45:25,Vitoria-Gasteiz,transfer,Salary,1289.87,-48167.55
buyer_6,Manuel,45,ES48209552855708573275,TRX_N-565-327646458105,2024-01-05T08:10:02,Vitoria-Gasteiz,Housing,Rent,-1119.73,-49287.28
buyer_6,Manuel,45,ES48209552855708573275,TRX_N-566-978374689965,2024-01-05T08:28:34,Vitoria-Gasteiz,Basic services,phone,-56.8,-49344.08
buyer_6,Manuel,45,ES48209552855708573275,TRX_N-567-438392945312,2024-01-06T08:00:17,Vitoria-Gasteiz,Basic services,phone,-55.79,-49399.87
buyer_6,Manuel,45,ES48209552855708573275,TRX_N-568-581143074319,2024-01-07T15:32:53,Vitoria-Gasteiz,Basic services,water,-67.52,-49467.39
buyer_6,Manuel,45,ES48209552855708573275,TRX_N-569-928890369092,2024-01-07T17:24:23,Vitoria-Gasteiz,Basic services,electricity,-110.85,-49578.24
buyer_6,Manuel,45,ES48209552855708573275,TRX_N-57-911785155368,2020-06-07T10:43:01,Vitoria-Gasteiz,Basic services,water,-49.47,-2432.28
buyer_6,Manuel,45,ES48209552855708573275,TRX_N-570-942348326848,2024-01-07T13:11:47,Vitoria-Gasteiz,Basic services,gas,-72.33,-49650.57
buyer_6,Manuel,45,ES48209552855708573275,TRX_N-571-851368004437,2024-01-07T16:55:35,Vitoria-Gasteiz,Basic services,phone,-84.04,-49734.61
buyer_6,Manuel,45,ES48209552855708573275,TRX_N-572-763793626737,2024-01-12T08:24:46,Vitoria-Gasteiz,Expense,healthcare,-312.75,-50047.36
buyer_6,Manuel,45,ES48209552855708573275,TRX_N-573-193983303457,2024-01-21T18:17:06,Erandio,Expense,gifts,-140.86,-50188.22
buyer_6,Manuel,45,ES48209552855708573275,TRX_N-574-104597003154,2024-01-30T13:28:55,Vitoria-Gasteiz,Expense,food,-605.01,-50793.23
buyer_6,Manuel,45,ES48209552855708573275,TRX_N-575-287756475640,2024-02-01T20:05:03,Vitoria-Gasteiz,transfer,Salary,1289.87,-49503.36
buyer_6,Manuel,45,ES48209552855708573275,TRX_N-576-780627354220,2024-02-01T20:05:03,Vitoria-Gasteiz,transfer,Extra Income,128.99,-49374.37
buyer_6,Manuel,45,ES48209552855708573275,TRX_N-577-831954027948,2024-02-05T20:53:15,Vitoria-Gasteiz,Housing,Rent,-1119.73,-50494.1
buyer_6,Manuel,45,ES48209552855708573275,TRX_N-578-405850772462,2024-02-05T18:49:29,Vitoria-Gasteiz,Basic services,gas,-78.32,-50572.42
buyer_6,Manuel,45,ES48209552855708573275,TRX_N-579-817803556077,2024-02-06T09:16:02,Vitoria-Gasteiz,Basic services,water,-17.45,-50589.87
buyer_6,Manuel,45,ES48209552855708573275,TRX_N-58-23455729814,2020-06-07T03:54:12,Vitoria-Gasteiz,Basic services,electricity,-43.35,-2475.63
buyer_6,Manuel,45,ES48209552855708573275,TRX_N-580-776884484046,2024-02-06T08:39:08,Vitoria-Gasteiz,Basic services,gas,-18.72,-50608.59
buyer_6,Manuel,45,ES48209552855708573275,TRX_N-581-939965735025,2024-02-06T12:52:29,Vitoria-Gasteiz,Basic services,phone,-23.94,-50632.53
buyer_6,Manuel,45,ES48209552855708573275,TRX_N-582-974987247281,2024-02-08T11:50:06,Vitoria-Gasteiz,Expense,transport,-76.36,-50708.89
buyer_6,Manuel,45,ES48209552855708573275,TRX_N-583-586057797191,2024-02-11T15:06:14,Vitoria-Gasteiz,Expense,leisure,-63.39,-50772.28
buyer_6,Manuel,45,ES48209552855708573275,TRX_N-584-831463631551,2024-03-01T17:31:54,Vitoria-Gasteiz,transfer,Salary,1289.87,-49482.41
buyer_6,Manuel,45,ES48209552855708573275,TRX_N-585-637638936000,2024-03-05T13:22:20,Vitoria-Gasteiz,Housing,Rent,-1119.73,-50602.14
buyer_6,Manuel,45,ES48209552855708573275,TRX_N-586-380297183086,2024-03-05T08:42:12,Vitoria-Gasteiz,Basic services,water,-38.39,-50640.53
buyer_6,Manuel,45,ES48209552855708573275,TRX_N-587-214459761850,2024-03-05T12:25:54,Vitoria-Gasteiz,Basic services,electricity,-58.88,-50699.41
buyer_6,Manuel,45,ES48209552855708573275,TRX_N-588-788333351387,2024-03-05T13:29:19,Vitoria-Gasteiz,Basic services,gas,-47.84,-50747.25
buyer_6,Manuel,45,ES48209552855708573275,TRX_N-589-453600162736,2024-03-06T11:54:33,Vitoria-Gasteiz,Basic services,electricity,-73.24,-50820.49
buyer_6,Manuel,45,ES48209552855708573275,TRX_N-59-124334833152,2020-06-07T16:01:44,Vitoria-Gasteiz,Expense,transport,-76.22,-2551.85
buyer_6,Manuel,45,ES48209552855708573275,TRX_N-590-320002894961,2024-03-06T08:25:27,Vitoria-Gasteiz,Basic services,gas,-21.74,-50842.23
buyer_6,Manuel,45,ES48209552855708573275,TRX_N-591-929482024561,2024-03-06T12:45:05,Vitoria-Gasteiz,Basic services,phone,-40.59,-50882.82
buyer_6,Manuel,45,ES48209552855708573275,TRX_N-592-797124171715,2024-03-07T09:13:10,Vitoria-Gasteiz,Basic services,gas,-80.19,-50963.01
buyer_6,Manuel,45,ES48209552855708573275,TRX_N-593-365504558274,2024-03-19T21:48:10,Bilbao,Expense,clothing,-441.44,-51404.45
buyer_6,Manuel,45,ES48209552855708573275,TRX_N-594-352469931371,2024-03-19T12:35:30,Vitoria-Gasteiz,Expense,education,-555.14,-51959.59
buyer_6,Manuel,45,ES48209552855708573275,TRX_N-595-436121605857,2024-04-01T08:17:37,Vitoria-Gasteiz,transfer,Salary,1289.87,-50669.72
buyer_6,Manuel,45,ES48209552855708573275,TRX_N-596-866114043950,2024-04-05T18:18:18,Vitoria-Gasteiz,Housing,Rent,-1119.73,-51789.45
buyer_6,Manuel,45,ES48209552855708573275,TRX_N-597-94355188241,2024-04-05T15:03:19,Vitoria-Gasteiz,Basic services,water,-37.98,-51827.43
buyer_6,Manuel,45,ES48209552855708573275,TRX_N-598-449338171934,2024-04-05T22:15:05,Vitoria-Gasteiz,Basic services,internet,-33.79,-51861.22
buyer_6,Manuel,45,ES48209552855708573275,TRX_N-599-823297215483,2024-04-06T10:17:04,Vitoria-Gasteiz,Basic services,electricity,-109.5,-51970.72
buyer_6,Manuel,45,ES48209552855708573275,TRX_N-6-169045428247,2020-01-07T18:00:31,Vitoria-Gasteiz,Basic services,water,-34.08,755.97
buyer_6,Manuel,45,ES48209552855708573275,TRX_N-60-546554344491,2020-06-12T21:23:41,Erandio,Expense,education,-780.12,-3331.97
buyer_6,Manuel,45,ES48209552855708573275,TRX_N-600-251327217339,2024-04-06T17:27:22,Vitoria-Gasteiz,Basic services,internet,-70.33,-52041.05
buyer_6,Manuel,45,ES48209552855708573275,TRX_N-601-718625804623,2024-04-24T18:49:47,Vitoria-Gasteiz,Expense,leisure,-279.1,-52320.15
buyer_6,Manuel,45,ES48209552855708573275,TRX_N-602-971565669540,2024-05-01T16:22:13,Vitoria-Gasteiz,transfer,Salary,1289.87,-51030.28
buyer_6,Manuel,45,ES48209552855708573275,TRX_N-603-589190891843,2024-05-01T16:22:13,Vitoria-Gasteiz,transfer,Extra Income,128.99,-50901.29
buyer_6,Manuel,45,ES48209552855708573275,TRX_N-604-930054979963,2024-05-01T18:49:25,Vitoria-Gasteiz,Expense,healthcare,-190.61,-51091.9
buyer_6,Manuel,45,ES48209552855708573275,TRX_N-605-523897205935,2024-05-05T08:36:06,Vitoria-Gasteiz,Housing,Rent,-1119.73,-52211.63
buyer_6,Manuel,45,ES48209552855708573275,TRX_N-606-312850783239,2024-05-05T12:21:40,Vitoria-Gasteiz,Basic services,phone,-25.4,-52237.03
buyer_6,Manuel,45,ES48209552855708573275,TRX_N-607-38355094179,2024-05-06T11:27:33,Vitoria-Gasteiz,Basic services,water,-23.68,-52260.71
buyer_6,Manuel,45,ES48209552855708573275,TRX_N-608-943887597553,2024-05-06T15:36:17,Vitoria-Gasteiz,Basic services,electricity,-129.02,-52389.73
buyer_6,Manuel,45,ES48209552855708573275,TRX_N-609-34521805911,2024-05-06T07:48:45,Vitoria-Gasteiz,Basic services,phone,-65.57,-52455.3
buyer_6,Manuel,45,ES48209552855708573275,TRX_N-61-191556864468,2020-06-13T09:24:38,Amurrio,Expense,transport,-104.21,-3436.18
buyer_6,Manuel,45,ES48209552855708573275,TRX_N-610-140825723909,2024-05-11T11:34:21,Vitoria-Gasteiz,Expense,leisure,-287.78,-52743.08
buyer_6,Manuel,45,ES48209552855708573275,TRX_N-611-856023138153,2024-05-14T13:44:58,Hernani,Expense,clothing,-266.75,-53009.83
buyer_6,Manuel,45,ES48209552855708573275,TRX_N-612-923844821104,2024-05-15T09:52:52,Vitoria-Gasteiz,Expense,food,-207.13,-53216.96
buyer_6,Manuel,45,ES48209552855708573275,TRX_N-613-230348691011,2024-06-01T14:59:48,Vitoria-Gasteiz,transfer,Salary,1289.87,-51927.09
buyer_6,Manuel,45,ES48209552855708573275,TRX_N-614-512406274475,2024-06-01T14:59:48,Vitoria-Gasteiz,transfer,Bonus,1323.54,-50603.55
buyer_6,Manuel,45,ES48209552855708573275,TRX_N-615-654036180243,2024-06-05T21:04:24,Vitoria-Gasteiz,Housing,Rent,-1119.73,-51723.28
buyer_6,Manuel,45,ES48209552855708573275,TRX_N-616-386688136439,2024-06-05T18:25:12,Vitoria-Gasteiz,Basic services,water,-41.96,-51765.24
buyer_6,Manuel,45,ES48209552855708573275,TRX_N-617-687830428519,2024-06-06T07:54:57,Vitoria-Gasteiz,Basic services,water,-35.08,-51800.32
buyer_6,Manuel,45,ES48209552855708573275,TRX_N-618-108421531077,2024-06-07T21:54:18,Vitoria-Gasteiz,Basic services,water,-26.45,-51826.77
buyer_6,Manuel,45,ES48209552855708573275,TRX_N-619-886275676335,2024-06-07T10:39:20,Vitoria-Gasteiz,Basic services,electricity,-116.61,-51943.38
buyer_6,Manuel,45,ES48209552855708573275,TRX_N-62-745051595875,2020-06-14T16:04:16,Vitoria-Gasteiz,Expense,clothing,-498.19,-3934.37
buyer_6,Manuel,45,ES48209552855708573275,TRX_N-620-629605380636,2024-06-07T13:29:29,Vitoria-Gasteiz,Basic services,internet,-58.36,-52001.74
buyer_6,Manuel,45,ES48209552855708573275,TRX_N-621-341480982725,2024-06-26T18:29:43,Salvatierra/Agurain,Expense,food,-732.57,-52734.31
buyer_6,Manuel,45,ES48209552855708573275,TRX_N-622-521661691957,2024-07-01T19:04:36,Vitoria-Gasteiz,transfer,Salary,1289.87,-51444.44
buyer_6,Manuel,45,ES48209552855708573275,TRX_N-623-784312459472,2024-07-05T20:03:03,Vitoria-Gasteiz,Housing,Rent,-1119.73,-52564.17
buyer_6,Manuel,45,ES48209552855708573275,TRX_N-624-28781582214,2024-07-05T18:16:11,Vitoria-Gasteiz,Basic services,gas,-37.06,-52601.23
buyer_6,Manuel,45,ES48209552855708573275,TRX_N-625-851544059165,2024-07-06T13:56:55,Vitoria-Gasteiz,Basic services,gas,-30.99,-52632.22
buyer_6,Manuel,45,ES48209552855708573275,TRX_N-626-515629267233,2024-07-07T04:58:29,Vitoria-Gasteiz,Basic services,electricity,-91.07,-52723.29
buyer_6,Manuel,45,ES48209552855708573275,TRX_N-627-449037361351,2024-07-07T14:01:46,Vitoria-Gasteiz,Basic services,internet,-61.27,-52784.56
buyer_6,Manuel,45,ES48209552855708573275,TRX_N-628-267086449090,2024-07-10T13:25:54,Vitoria-Gasteiz,Expense,leisure,-263.59,-53048.15
buyer_6,Manuel,45,ES48209552855708573275,TRX_N-629-567427881579,2024-07-11T14:36:55,Vitoria-Gasteiz,Expense,transport,-82.67,-53130.82
buyer_6,Manuel,45,ES48209552855708573275,TRX_N-63-400088218070,2020-06-26T22:27:34,Vitoria-Gasteiz,Expense,clothing,-294.78,-4229.15
buyer_6,Manuel,45,ES48209552855708573275,TRX_N-630-978799690030,2024-07-20T08:32:17,Vitoria-Gasteiz,Expense,appliances,-974.44,-54105.26
buyer_6,Manuel,45,ES48209552855708573275,TRX_N-631-591273062426,2024-07-21T14:45:55,Vitoria-Gasteiz,Expense,clothing,-351.02,-54456.28
buyer_6,Manuel,45,ES48209552855708573275,TRX_N-632-158490941601,2024-07-28T10:26:30,Vitoria-Gasteiz,Expense,food,-208.48,-54664.76
buyer_6,Manuel,45,ES48209552855708573275,TRX_N-633-148286201661,2024-08-01T05:28:21,Vitoria-Gasteiz,transfer,Salary,1289.87,-53374.89
buyer_6,Manuel,45,ES48209552855708573275,TRX_N-634-447171975691,2024-08-01T05:28:21,Vitoria-Gasteiz,transfer,Extra Income,128.99,-53245.9
buyer_6,Manuel,45,ES48209552855708573275,TRX_N-635-88187848745,2024-08-04T14:59:31,Vitoria-Gasteiz,Expense,clothing,-329.09,-53574.99
buyer_6,Manuel,45,ES48209552855708573275,TRX_N-636-395358512890,2024-08-05T20:36:16,Vitoria-Gasteiz,Housing,Rent,-1119.73,-54694.72
buyer_6,Manuel,45,ES48209552855708573275,TRX_N-637-480686465702,2024-08-05T19:16:20,Vitoria-Gasteiz,Basic services,internet,-38.29,-54733.01
buyer_6,Manuel,45,ES48209552855708573275,TRX_N-638-212784067607,2024-08-06T14:07:09,Vitoria-Gasteiz,Basic services,electricity,-107.66,-54840.67
buyer_6,Manuel,45,ES48209552855708573275,TRX_N-639-611743214940,2024-08-06T19:15:22,Vitoria-Gasteiz,Basic services,internet,-64.13,-54904.8
buyer_6,Manuel,45,ES48209552855708573275,TRX_N-64-622847375754,2020-06-26T18:49:51,Vitoria-Gasteiz,Expense,education,-156.44,-4385.59
buyer_6,Manuel,45,ES48209552855708573275,TRX_N-640-320588444591,2024-08-07T09:52:35,Vitoria-Gasteiz,Basic services,electricity,-57.57,-54962.37
buyer_6,Manuel,45,ES48209552855708573275,TRX_N-641-304168530973,2024-09-01T15:49:40,Vitoria-Gasteiz,transfer,Salary,1289.87,-53672.5
buyer_6,Manuel,45,ES48209552855708573275,TRX_N-642-12828758128,2024-09-02T08:16:16,Vitoria-Gasteiz,Expense,transport,-170.12,-53842.62
buyer_6,Manuel,45,ES48209552855708573275,TRX_N-643-52501510171,2024-09-05T16:02:13,Vitoria-Gasteiz,Housing,Rent,-1119.73,-54962.35
buyer_6,Manuel,45,ES48209552855708573275,TRX_N-644-948039958781,2024-09-05T17:48:48,Vitoria-Gasteiz,Basic services,gas,-92.34,-55054.69
buyer_6,Manuel,45,ES48209552855708573275,TRX_N-645-22249050909,2024-09-05T15:50:23,Vitoria-Gasteiz,Basic services,internet,-44.44,-55099.13
buyer_6,Manuel,45,ES48209552855708573275,TRX_N-646-332019637986,2024-09-06T09:44:52,Vitoria-Gasteiz,Basic services,water,-20.62,-55119.75
buyer_6,Manuel,45,ES48209552855708573275,TRX_N-647-552738561589,2024-09-06T08:44:54,Vitoria-Gasteiz,Basic services,electricity,-87.37,-55207.12
buyer_6,Manuel,45,ES48209552855708573275,TRX_N-648-19046849018,2024-09-06T13:38:15,Vitoria-Gasteiz,Basic services,gas,-36.16,-55243.28
buyer_6,Manuel,45,ES48209552855708573275,TRX_N-649-872817439720,2024-09-06T14:15:14,Vitoria-Gasteiz,Basic services,internet,-57.41,-55300.69
buyer_6,Manuel,45,ES48209552855708573275,TRX_N-65-82264702945,2020-06-29T20:40:25,Amurrio,Expense,transport,-42.85,-4428.44
buyer_6,Manuel,45,ES48209552855708573275,TRX_N-650-997192479321,2024-09-06T20:42:11,Vitoria-Gasteiz,Basic services,phone,-28.24,-55328.93
buyer_6,Manuel,45,ES48209552855708573275,TRX_N-651-129808316865,2024-09-06T13:36:22,Vitoria-Gasteiz,Expense,food,-582.07,-55911.0
buyer_6,Manuel,45,ES48209552855708573275,TRX_N-652-375813388851,2024-09-07T14:44:22,Vitoria-Gasteiz,Basic services,gas,-74.84,-55985.84
buyer_6,Manuel,45,ES48209552855708573275,TRX_N-653-582783295218,2024-09-07T08:11:40,Vitoria-Gasteiz,Basic services,internet,-59.53,-56045.37
buyer_6,Manuel,45,ES48209552855708573275,TRX_N-654-584906028625,2024-09-07T09:36:28,Vitoria-Gasteiz,Expense,clothing,-153.04,-56198.41
buyer_6,Manuel,45,ES48209552855708573275,TRX_N-655-957806484775,2024-09-19T15:42:05,Alegría-Dulantzi,Expense,healthcare,-293.12,-56491.53
buyer_6,Manuel,45,ES48209552855708573275,TRX_N-656-596429577990,2024-10-01T23:38:07,Vitoria-Gasteiz,transfer,Salary,1289.87,-55201.66
buyer_6,Manuel,45,ES48209552855708573275,TRX_N-657-22748488634,2024-10-01T23:38:07,Vitoria-Gasteiz,transfer,Extra Income,128.99,-55072.67
buyer_6,Manuel,45,ES48209552855708573275,TRX_N-658-131503483497,2024-10-05T12:08:59,Vitoria-Gasteiz,Housing,Rent,-1119.73,-56192.4
buyer_6,Manuel,45,ES48209552855708573275,TRX_N-659-604548182700,2024-10-06T12:57:41,Vitoria-Gasteiz,Basic services,water,-64.36,-56256.76
buyer_6,Manuel,45,ES48209552855708573275,TRX_N-66-87434641051,2020-07-01T10:20:58,Vitoria-Gasteiz,transfer,Salary,1289.87,-3138.57
buyer_6,Manuel,45,ES48209552855708573275,TRX_N-660-175271841735,2024-10-06T20:30:57,Vitoria-Gasteiz,Basic services,gas,-38.0,-56294.76
buyer_6,Manuel,45,ES48209552855708573275,TRX_N-661-783629369442,2024-10-06T09:57:06,Vitoria-Gasteiz,Basic services,internet,-58.17,-56352.93
buyer_6,Manuel,45,ES48209552855708573275,TRX_N-662-948481654889,2024-10-06T17:44:48,Vitoria-Gasteiz,Basic services,phone,-62.25,-56415.18
buyer_6,Manuel,45,ES48209552855708573275,TRX_N-663-835322052026,2024-10-06T14:37:29,Vitoria-Gasteiz,Expense,transport,-124.79,-56539.97
buyer_6,Manuel,45,ES48209552855708573275,TRX_N-67-846901205580,2020-07-01T10:20:58,Vitoria-Gasteiz,transfer,Extra Income,128.99,-3009.58
buyer_6,Manuel,45,ES48209552855708573275,TRX_N-68-807337322609,2020-07-05T11:39:09,Vitoria-Gasteiz,Housing,Rent,-1119.73,-4129.31
buyer_6,Manuel,45,ES48209552855708573275,TRX_N-69-319750407655,2020-07-07T15:23:11,Vitoria-Gasteiz,Basic services,electricity,-39.67,-4168.98
buyer_6,Manuel,45,ES48209552855708573275,TRX_N-7-460132931505,2020-01-07T20:56:31,Vitoria-Gasteiz,Basic services,phone,-32.4,723.57
buyer_6,Manuel,45,ES48209552855708573275,TRX_N-70-235553363030,2020-07-07T22:39:45,Vitoria-Gasteiz,Basic services,gas,-94.31,-4263.29
buyer_6,Manuel,45,ES48209552855708573275,TRX_N-71-827603732691,2020-07-07T15:56:44,Vitoria-Gasteiz,Basic services,internet,-33.06,-4296.35
buyer_6,Manuel,45,ES48209552855708573275,TRX_N-72-522096129364,2020-07-07T18:02:15,Vitoria-Gasteiz,Basic services,phone,-60.68,-4357.03
buyer_6,Manuel,45,ES48209552855708573275,TRX_N-73-863848268230,2020-07-16T05:13:23,Vitoria-Gasteiz,Expense,repairs,-921.84,-5278.87
buyer_6,Manuel,45,ES48209552855708573275,TRX_N-74-289975783904,2020-08-01T00:50:07,Vitoria-Gasteiz,transfer,Salary,1289.87,-3989.0
buyer_6,Manuel,45,ES48209552855708573275,TRX_N-75-905270679006,2020-08-05T14:50:24,Vitoria-Gasteiz,Housing,Rent,-1119.73,-5108.73
buyer_6,Manuel,45,ES48209552855708573275,TRX_N-76-987798816113,2020-08-05T09:10:29,Vitoria-Gasteiz,Basic services,water,-15.13,-5123.86
buyer_6,Manuel,45,ES48209552855708573275,TRX_N-77-645020525132,2020-08-05T21:25:05,Vitoria-Gasteiz,Basic services,gas,-39.8,-5163.66
buyer_6,Manuel,45,ES48209552855708573275,TRX_N-78-776000710539,2020-08-05T14:48:15,Vitoria-Gasteiz,Basic services,internet,-78.99,-5242.65
buyer_6,Manuel,45,ES48209552855708573275,TRX_N-79-572057739765,2020-08-06T18:06:13,Vitoria-Gasteiz,Basic services,electricity,-83.78,-5326.43
buyer_6,Manuel,45,ES48209552855708573275,TRX_N-8-755700221977,2020-01-10T13:37:40,Vitoria-Gasteiz,Expense,gifts,-76.13,647.44
buyer_6,Manuel,45,ES48209552855708573275,TRX_N-80-58729503128,2020-08-06T18:22:26,Vitoria-Gasteiz,Basic services,internet,-62.24,-5388.67
buyer_6,Manuel,45,ES48209552855708573275,TRX_N-81-662292505910,2020-08-06T20:12:34,Vitoria-Gasteiz,Basic services,phone,-66.35,-5455.02
buyer_6,Manuel,45,ES48209552855708573275,TRX_N-82-870008711825,2020-08-07T10:00:49,Vitoria-Gasteiz,Basic services,electricity,-145.52,-5600.54
buyer_6,Manuel,45,ES48209552855708573275,TRX_N-83-594788557033,2020-08-07T17:17:34,Vitoria-Gasteiz,Basic services,gas,-45.72,-5646.26
buyer_6,Manuel,45,ES48209552855708573275,TRX_N-84-654138265359,2020-08-15T12:58:12,Vitoria-Gasteiz,Expense,repairs,-791.55,-6437.81
buyer_6,Manuel,45,ES48209552855708573275,TRX_N-85-740577277188,2020-08-16T12:25:42,Vitoria-Gasteiz,Expense,healthcare,-379.67,-6817.48
buyer_6,Manuel,45,ES48209552855708573275,TRX_N-86-4688821688,2020-08-17T11:23:48,Vitoria-Gasteiz,Expense,food,-701.52,-7519.0
buyer_6,Manuel,45,ES48209552855708573275,TRX_N-87-40594714949,2020-08-21T11:26:00,Vitoria-Gasteiz,Expense,leisure,-157.82,-7676.82
buyer_6,Manuel,45,ES48209552855708573275,TRX_N-88-760001132362,2020-08-23T16:37:38,Vitoria-Gasteiz,Expense,transport,-168.46,-7845.28
buyer_6,Manuel,45,ES48209552855708573275,TRX_N-89-506195163873,2020-08-25T19:31:08,Zuia,Expense,clothing,-138.33,-7983.61
buyer_6,Manuel,45,ES48209552855708573275,TRX_N-9-425253277393,2020-01-17T12:16:33,Vitoria-Gasteiz,Expense,leisure,-180.97,466.47
buyer_6,Manuel,45,ES48209552855708573275,TRX_N-90-930669757856,2020-09-01T11:06:34,Vitoria-Gasteiz,transfer,Salary,1289.87,-6693.74
buyer_6,Manuel,45,ES48209552855708573275,TRX_N-91-821800609525,2020-09-01T11:06:34,Vitoria-Gasteiz,transfer,Extra Income,128.99,-6564.75
buyer_6,Manuel,45,ES48209552855708573275,TRX_N-92-196848856877,2020-09-05T20:18:15,Vitoria-Gasteiz,Housing,Rent,-1119.73,-7684.48
buyer_6,Manuel,45,ES48209552855708573275,TRX_N-93-786823923234,2020-09-05T18:28:30,Vitoria-Gasteiz,Basic services,internet,-47.92,-7732.4
buyer_6,Manuel,45,ES48209552855708573275,TRX_N-94-837137095665,2020-09-05T12:58:52,Vitoria-Gasteiz,Basic services,phone,-47.74,-7780.14
buyer_6,Manuel,45,ES48209552855708573275,TRX_N-95-519808360709,2020-09-06T22:04:35,Vitoria-Gasteiz,Basic services,water,-76.91,-7857.05
buyer_6,Manuel,45,ES48209552855708573275,TRX_N-96-498934898578,2020-09-06T20:56:56,Vitoria-Gasteiz,Basic services,electricity,-27.89,-7884.94
buyer_6,Manuel,45,ES48209552855708573275,TRX_N-97-1804748182,2020-09-06T19:22:55,Vitoria-Gasteiz,Basic services,gas,-26.16,-7911.1
buyer_6,Manuel,45,ES48209552855708573275,TRX_N-98-80012905527,2020-09-07T10:12:12,Vitoria-Gasteiz,Basic services,internet,-42.03,-7953.13
buyer_6,Manuel,45,ES48209552855708573275,TRX_N-99-90095580555,2020-09-10T21:53:04,Vitoria-Gasteiz,Expense,food,-182.0,-8135.13
buyer_7,María,56,ES56209544508593173856,TRX_N-1-106245528223,2020-01-01T11:41:44,Portugalete,transfer,Salary,2867.97,7123.98
buyer_7,María,56,ES56209544508593173856,TRX_N-10-274243666174,2020-01-11T08:42:04,Portugalete,Expense,transport,-84.64,9108.2
buyer_7,María,56,ES56209544508593173856,TRX_N-100-353245651803,2020-09-07T07:26:53,Portugalete,Basic services,gas,-34.86,48472.41
buyer_7,María,56,ES56209544508593173856,TRX_N-101-734861411287,2020-09-11T16:15:33,Portugalete,Expense,transport,-183.61,48288.8
buyer_7,María,56,ES56209544508593173856,TRX_N-102-660820901351,2020-09-25T19:48:30,Portugalete,Expense,food,-774.13,47514.67
buyer_7,María,56,ES56209544508593173856,TRX_N-103-267706490135,2020-09-25T18:36:33,Portugalete,Expense,leisure,-250.88,47263.79
buyer_7,María,56,ES56209544508593173856,TRX_N-104-697559446318,2020-09-27T21:11:01,Portugalete,Expense,healthcare,-329.31,46934.48
buyer_7,María,56,ES56209544508593173856,TRX_N-105-438940544998,2020-10-01T14:34:42,Portugalete,transfer,Salary,2867.97,49802.45
buyer_7,María,56,ES56209544508593173856,TRX_N-106-65955831606,2020-10-01T14:34:42,Portugalete,transfer,Partner Salary,3420.52,53222.97
buyer_7,María,56,ES56209544508593173856,TRX_N-107-923991093726,2020-10-01T14:34:42,Portugalete,transfer,Extra Income,286.8,53509.77
buyer_7,María,56,ES56209544508593173856,TRX_N-108-538210721185,2020-10-05T17:41:16,Portugalete,Housing,Mortgage,-896.33,52613.44
buyer_7,María,56,ES56209544508593173856,TRX_N-109-535155057357,2020-10-05T11:04:26,Portugalete,Basic services,gas,-15.62,52597.82
buyer_7,María,56,ES56209544508593173856,TRX_N-11-857310995660,2020-01-18T14:05:17,Portugalete,Expense,transport,-97.12,9011.08
buyer_7,María,56,ES56209544508593173856,TRX_N-110-88507816328,2020-10-06T17:18:40,Portugalete,Basic services,gas,-83.97,52513.85
buyer_7,María,56,ES56209544508593173856,TRX_N-111-614520801680,2020-10-06T10:44:18,Portugalete,Basic services,phone,-91.66,52422.19
buyer_7,María,56,ES56209544508593173856,TRX_N-112-482051889993,2020-10-07T11:33:39,Portugalete,Basic services,gas,-39.82,52382.37
buyer_7,María,56,ES56209544508593173856,TRX_N-113-755122754028,2020-10-15T18:44:23,Portugalete,Expense,food,-408.96,51973.41
buyer_7,María,56,ES56209544508593173856,TRX_N-114-130620095513,2020-10-17T08:10:59,Portugalete,Expense,leisure,-194.39,51779.02
buyer_7,María,56,ES56209544508593173856,TRX_N-115-475322256863,2020-10-26T20:42:18,Portugalete,Expense,food,-646.2,51132.82
buyer_7,María,56,ES56209544508593173856,TRX_N-116-269244220656,2020-11-01T15:24:09,Portugalete,transfer,Salary,2867.97,54000.79
buyer_7,María,56,ES56209544508593173856,TRX_N-117-911875863758,2020-11-01T15:24:09,Portugalete,transfer,Partner Salary,3420.52,57421.31
buyer_7,María,56,ES56209544508593173856,TRX_N-118-386194966518,2020-11-01T21:09:09,Portugalete,Expense,food,-463.58,56957.73
buyer_7,María,56,ES56209544508593173856,TRX_N-119-471781503134,2020-11-05T21:51:49,Portugalete,Housing,Mortgage,-896.33,56061.4
buyer_7,María,56,ES56209544508593173856,TRX_N-12-464683096188,2020-02-01T21:15:54,Portugalete,transfer,Salary,2867.97,11879.05
buyer_7,María,56,ES56209544508593173856,TRX_N-120-88978963448,2020-11-05T08:53:09,Portugalete,Basic services,water,-79.42,55981.98
buyer_7,María,56,ES56209544508593173856,TRX_N-121-353844572471,2020-11-06T14:53:41,Portugalete,Basic services,water,-36.03,55945.95
buyer_7,María,56,ES56209544508593173856,TRX_N-122-429935866032,2020-11-06T19:03:01,Portugalete,Basic services,gas,-28.66,55917.29
buyer_7,María,56,ES56209544508593173856,TRX_N-123-40365896440,2020-11-06T11:25:17,Portugalete,Basic services,internet,-54.79,55862.5
buyer_7,María,56,ES56209544508593173856,TRX_N-124-569530009560,2020-11-07T08:04:48,Portugalete,Basic services,phone,-83.01,55779.49
buyer_7,María,56,ES56209544508593173856,TRX_N-125-41369299626,2020-11-11T18:41:31,Portugalete,Expense,transport,-51.38,55728.11
buyer_7,María,56,ES56209544508593173856,TRX_N-126-403399822432,2020-11-17T14:15:18,Lasarte-Oria,Expense,food,-764.34,54963.77
buyer_7,María,56,ES56209544508593173856,TRX_N-127-493797387406,2020-11-24T18:20:18,Portugalete,Expense,travel,-301.36,54662.41
buyer_7,María,56,ES56209544508593173856,TRX_N-128-655468792141,2020-11-26T12:52:08,Portugalete,Expense,transport,-104.25,54558.16
buyer_7,María,56,ES56209544508593173856,TRX_N-129-992016555062,2020-12-01T10:27:01,Portugalete,transfer,Salary,2867.97,57426.13
buyer_7,María,56,ES56209544508593173856,TRX_N-13-658899687944,2020-02-01T21:15:54,Portugalete,transfer,Partner Salary,3420.52,15299.57
buyer_7,María,56,ES56209544508593173856,TRX_N-130-568977148709,2020-12-01T10:27:01,Portugalete,transfer,Partner Salary,3420.52,60846.65
buyer_7,María,56,ES56209544508593173856,TRX_N-131-947112928124,2020-12-01T10:27:01,Portugalete,transfer,Extra Income,286.8,61133.45
buyer_7,María,56,ES56209544508593173856,TRX_N-132-797456023894,2020-12-01T10:27:01,Portugalete,transfer,Bonus,2816.96,63950.41
buyer_7,María,56,ES56209544508593173856,TRX_N-133-469461685714,2020-12-05T03:55:11,Portugalete,Housing,Mortgage,-896.33,63054.08
buyer_7,María,56,ES56209544508593173856,TRX_N-134-473724227080,2020-12-05T15:38:30,Portugalete,Basic services,water,-24.84,63029.24
buyer_7,María,56,ES56209544508593173856,TRX_N-135-3029153832,2020-12-05T20:42:04,Portugalete,Basic services,electricity,-49.45,62979.79
buyer_7,María,56,ES56209544508593173856,TRX_N-136-351570651485,2020-12-05T18:06:52,Portugalete,Basic services,gas,-86.84,62892.95
buyer_7,María,56,ES56209544508593173856,TRX_N-137-294382489192,2020-12-05T13:00:29,Portugalete,Expense,healthcare,-313.79,62579.16
buyer_7,María,56,ES56209544508593173856,TRX_N-138-450276111077,2020-12-07T11:38:34,Portugalete,Basic services,electricity,-33.98,62545.18
buyer_7,María,56,ES56209544508593173856,TRX_N-139-771346735205,2020-12-07T20:14:43,Portugalete,Basic services,phone,-85.0,62460.18
buyer_7,María,56,ES56209544508593173856,TRX_N-14-193443697407,2020-02-05T09:03:47,Portugalete,Housing,Mortgage,-896.33,14403.24
buyer_7,María,56,ES56209544508593173856,TRX_N-140-273034667363,2020-12-31T11:11:54,Portugalete,Expense,healthcare,-221.68,62238.5
buyer_7,María,56,ES56209544508593173856,TRX_N-141-411235198168,2021-01-01T14:28:41,Portugalete,transfer,Salary,2867.97,65106.47
buyer_7,María,56,ES56209544508593173856,TRX_N-142-856855334823,2021-01-01T14:28:41,Portugalete,transfer,Partner Salary,3420.52,68526.99
buyer_7,María,56,ES56209544508593173856,TRX_N-143-946886053598,2021-01-05T17:11:39,Portugalete,Housing,Mortgage,-896.33,67630.66
buyer_7,María,56,ES56209544508593173856,TRX_N-144-253244457922,2021-01-05T19:56:37,Portugalete,Basic services,water,-31.86,67598.8
buyer_7,María,56,ES56209544508593173856,TRX_N-145-607723258115,2021-01-05T02:12:06,Portugalete,Basic services,electricity,-32.5,67566.3
buyer_7,María,56,ES56209544508593173856,TRX_N-146-92516850545,2021-01-05T20:37:33,Portugalete,Basic services,phone,-84.76,67481.54
buyer_7,María,56,ES56209544508593173856,TRX_N-147-709476435226,2021-01-05T12:29:58,Leioa,Expense,leisure,-264.1,67217.44
buyer_7,María,56,ES56209544508593173856,TRX_N-148-28533704769,2021-01-06T00:19:49,Portugalete,Basic services,water,-58.89,67158.55
buyer_7,María,56,ES56209544508593173856,TRX_N-149-766480105426,2021-01-06T12:05:28,Portugalete,Basic services,gas,-38.08,67120.47
buyer_7,María,56,ES56209544508593173856,TRX_N-15-959893893046,2020-02-05T11:40:46,Portugalete,Basic services,gas,-45.3,14357.94
buyer_7,María,56,ES56209544508593173856,TRX_N-150-708886833037,2021-01-07T08:41:04,Portugalete,Basic services,water,-33.33,67087.14
buyer_7,María,56,ES56209544508593173856,TRX_N-151-946336478379,2021-01-07T10:18:23,Portugalete,Basic services,gas,-47.91,67039.23
buyer_7,María,56,ES56209544508593173856,TRX_N-152-296266481141,2021-01-30T18:37:56,Portugalete,Expense,transport,-46.69,66992.54
buyer_7,María,56,ES56209544508593173856,TRX_N-153-100258439107,2021-01-31T21:23:30,Portugalete,Expense,clothing,-437.22,66555.32
buyer_7,María,56,ES56209544508593173856,TRX_N-154-141059970107,2021-02-01T10:05:24,Portugalete,transfer,Salary,2867.97,69423.29
buyer_7,María,56,ES56209544508593173856,TRX_N-155-366555764316,2021-02-01T10:05:24,Portugalete,transfer,Partner Salary,3420.52,72843.81
buyer_7,María,56,ES56209544508593173856,TRX_N-156-555271551482,2021-02-01T10:05:24,Portugalete,transfer,Extra Income,286.8,73130.61
buyer_7,María,56,ES56209544508593173856,TRX_N-157-309134265165,2021-02-05T18:37:32,Portugalete,Housing,Mortgage,-896.33,72234.28
buyer_7,María,56,ES56209544508593173856,TRX_N-158-380722279350,2021-02-05T08:38:52,Portugalete,Basic services,water,-43.55,72190.73
buyer_7,María,56,ES56209544508593173856,TRX_N-159-224742615894,2021-02-05T16:22:21,Portugalete,Basic services,electricity,-112.96,72077.77
buyer_7,María,56,ES56209544508593173856,TRX_N-16-439709403363,2020-02-05T11:09:03,Portugalete,Basic services,phone,-40.37,14317.57
buyer_7,María,56,ES56209544508593173856,TRX_N-160-64035541390,2021-02-05T16:24:15,Portugalete,Basic services,internet,-69.95,72007.82
buyer_7,María,56,ES56209544508593173856,TRX_N-161-63673642634,2021-02-06T14:55:09,Portugalete,Basic services,internet,-40.91,71966.91
buyer_7,María,56,ES56209544508593173856,TRX_N-162-307435996851,2021-02-06T16:55:19,Portugalete,Basic services,phone,-74.32,71892.59
buyer_7,María,56,ES56209544508593173856,TRX_N-163-572183592108,2021-02-07T08:46:42,Portugalete,Basic services,water,-10.52,71882.07
buyer_7,María,56,ES56209544508593173856,TRX_N-164-732422510778,2021-02-07T10:04:21,Portugalete,Basic services,gas,-44.68,71837.39
buyer_7,María,56,ES56209544508593173856,TRX_N-165-469266370401,2021-02-07T10:31:46,Portugalete,Basic services,internet,-39.99,71797.4
buyer_7,María,56,ES56209544508593173856,TRX_N-166-920016740020,2021-02-07T10:33:37,Portugalete,Basic services,phone,-54.89,71742.51
buyer_7,María,56,ES56209544508593173856,TRX_N-167-190282207012,2021-02-14T09:01:52,Portugalete,Expense,repairs,-460.37,71282.14
buyer_7,María,56,ES56209544508593173856,TRX_N-168-832632860587,2021-02-17T08:11:45,Portugalete,Expense,transport,-109.81,71172.33
buyer_7,María,56,ES56209544508593173856,TRX_N-169-763957021608,2021-02-18T11:30:11,Portugalete,Expense,repairs,-780.28,70392.05
buyer_7,María,56,ES56209544508593173856,TRX_N-17-300916075243,2020-02-06T22:42:40,Portugalete,Expense,food,-136.21,14181.36
buyer_7,María,56,ES56209544508593173856,TRX_N-170-926843879054,2021-02-19T15:27:21,Portugalete,Expense,travel,-1828.63,68563.42
buyer_7,María,56,ES56209544508593173856,TRX_N-171-773625519782,2021-03-01T11:51:44,Portugalete,transfer,Salary,2867.97,71431.39
buyer_7,María,56,ES56209544508593173856,TRX_N-172-600030271977,2021-03-01T11:51:44,Portugalete,transfer,Partner Salary,3420.52,74851.91
buyer_7,María,56,ES56209544508593173856,TRX_N-173-878565863436,2021-03-05T13:22:02,Portugalete,Housing,Mortgage,-896.33,73955.58
buyer_7,María,56,ES56209544508593173856,TRX_N-174-583366835556,2021-03-05T15:17:46,Portugalete,Basic services,internet,-77.51,73878.07
buyer_7,María,56,ES56209544508593173856,TRX_N-175-498022866674,2021-03-06T08:10:20,Portugalete,Basic services,internet,-61.93,73816.14
buyer_7,María,56,ES56209544508593173856,TRX_N-176-258706530921,2021-03-07T18:05:08,Portugalete,Basic services,gas,-85.88,73730.26
buyer_7,María,56,ES56209544508593173856,TRX_N-177-931521551568,2021-03-07T14:25:13,Portugalete,Basic services,internet,-40.94,73689.32
buyer_7,María,56,ES56209544508593173856,TRX_N-178-543061254192,2021-03-07T14:55:59,Portugalete,Basic services,phone,-90.31,73599.01
buyer_7,María,56,ES56209544508593173856,TRX_N-179-662471857450,2021-03-17T08:28:10,Portugalete,Expense,clothing,-434.13,73164.88
buyer_7,María,56,ES56209544508593173856,TRX_N-18-318382402304,2020-02-16T15:59:56,Portugalete,Expense,repairs,-691.28,13490.08
buyer_7,María,56,ES56209544508593173856,TRX_N-180-862270457633,2021-03-23T15:41:07,Portugalete,Expense,food,-695.78,72469.1
buyer_7,María,56,ES56209544508593173856,TRX_N-181-849927743839,2021-03-23T15:06:31,Portugalete,Expense,gifts,-219.78,72249.32
buyer_7,María,56,ES56209544508593173856,TRX_N-182-166100808695,2021-03-27T13:05:01,Errenteria,Expense,gifts,-89.53,72159.79
buyer_7,María,56,ES56209544508593173856,TRX_N-183-158447942282,2021-04-01T10:15:28,Portugalete,transfer,Salary,2867.97,75027.76
buyer_7,María,56,ES56209544508593173856,TRX_N-184-649578712777,2021-04-01T10:15:28,Portugalete,transfer,Partner Salary,3420.52,78448.28
buyer_7,María,56,ES56209544508593173856,TRX_N-185-799881046406,2021-04-01T10:15:28,Portugalete,transfer,Extra Income,286.8,78735.08
buyer_7,María,56,ES56209544508593173856,TRX_N-186-234594209567,2021-04-02T16:52:35,Santurtzi,Expense,clothing,-306.61,78428.47
buyer_7,María,56,ES56209544508593173856,TRX_N-187-415195359324,2021-04-05T18:19:56,Portugalete,Housing,Mortgage,-896.33,77532.14
buyer_7,María,56,ES56209544508593173856,TRX_N-188-115672694830,2021-04-05T18:14:21,Portugalete,Basic services,electricity,-68.24,77463.9
buyer_7,María,56,ES56209544508593173856,TRX_N-189-742101895785,2021-04-06T13:02:05,Portugalete,Basic services,water,-28.27,77435.63
buyer_7,María,56,ES56209544508593173856,TRX_N-19-939136574772,2020-02-18T14:05:12,Leioa,Expense,education,-369.3,13120.78
buyer_7,María,56,ES56209544508593173856,TRX_N-190-605940135197,2021-04-07T18:55:43,Portugalete,Basic services,water,-23.5,77412.13
buyer_7,María,56,ES56209544508593173856,TRX_N-191-277956632820,2021-04-07T22:11:29,Portugalete,Basic services,gas,-63.96,77348.17
buyer_7,María,56,ES56209544508593173856,TRX_N-192-18277603021,2021-04-07T11:17:00,Portugalete,Basic services,phone,-93.94,77254.23
buyer_7,María,56,ES56209544508593173856,TRX_N-193-233277286339,2021-04-12T09:41:35,Portugalete,Expense,repairs,-920.34,76333.89
buyer_7,María,56,ES56209544508593173856,TRX_N-194-326090809246,2021-04-20T11:30:23,Portugalete,Expense,leisure,-131.44,76202.45
buyer_7,María,56,ES56209544508593173856,TRX_N-195-130906062697,2021-05-01T09:19:30,Portugalete,transfer,Salary,2867.97,79070.42
buyer_7,María,56,ES56209544508593173856,TRX_N-196-828847069044,2021-05-01T09:19:30,Portugalete,transfer,Partner Salary,3420.52,82490.94
buyer_7,María,56,ES56209544508593173856,TRX_N-197-575869989067,2021-05-01T17:54:36,Portugalete,Expense,transport,-150.65,82340.29
buyer_7,María,56,ES56209544508593173856,TRX_N-198-932858135924,2021-05-05T16:12:48,Portugalete,Housing,Mortgage,-896.33,81443.96
buyer_7,María,56,ES56209544508593173856,TRX_N-199-596523935960,2021-05-05T18:50:07,Portugalete,Basic services,water,-75.05,81368.91
buyer_7,María,56,ES56209544508593173856,TRX_N-2-586283258611,2020-01-01T11:41:44,Portugalete,transfer,Partner Salary,3420.52,10544.5
buyer_7,María,56,ES56209544508593173856,TRX_N-20-583035539618,2020-02-26T20:56:17,Portugalete,Expense,leisure,-268.95,12851.83
buyer_7,María,56,ES56209544508593173856,TRX_N-200-783686385189,2021-05-06T14:22:16,Portugalete,Basic services,gas,-66.99,81301.92
buyer_7,María,56,ES56209544508593173856,TRX_N-201-514460358827,2021-05-07T09:35:58,Portugalete,Basic services,water,-37.46,81264.46
buyer_7,María,56,ES56209544508593173856,TRX_N-202-874606005089,2021-05-07T17:38:18,Portugalete,Basic services,phone,-93.04,81171.42
buyer_7,María,56,ES56209544508593173856,TRX_N-203-90518269403,2021-05-10T08:07:15,Portugalete,Expense,repairs,-792.72,80378.7
buyer_7,María,56,ES56209544508593173856,TRX_N-204-536619045738,2021-05-16T08:51:52,Portugalete,Expense,leisure,-299.07,80079.63
buyer_7,María,56,ES56209544508593173856,TRX_N-205-197283501475,2021-05-17T18:15:35,Portugalete,Expense,transport,-166.12,79913.51
buyer_7,María,56,ES56209544508593173856,TRX_N-206-130496040150,2021-05-27T15:52:43,Labastida/Bastida,Expense,food,-680.98,79232.53
buyer_7,María,56,ES56209544508593173856,TRX_N-207-591603502757,2021-06-01T12:34:19,Portugalete,transfer,Salary,2867.97,82100.5
buyer_7,María,56,ES56209544508593173856,TRX_N-208-699479396545,2021-06-01T12:34:19,Portugalete,transfer,Partner Salary,3420.52,85521.02
buyer_7,María,56,ES56209544508593173856,TRX_N-209-839297567683,2021-06-01T12:34:19,Portugalete,transfer,Extra Income,286.8,85807.82
buyer_7,María,56,ES56209544508593173856,TRX_N-21-562279786434,2020-03-01T18:53:28,Portugalete,transfer,Salary,2867.97,15719.8
buyer_7,María,56,ES56209544508593173856,TRX_N-210-699864394178,2021-06-01T12:34:19,Portugalete,transfer,Bonus,2808.05,88615.87
buyer_7,María,56,ES56209544508593173856,TRX_N-211-386252764436,2021-06-05T08:35:58,Portugalete,Housing,Mortgage,-896.33,87719.54
buyer_7,María,56,ES56209544508593173856,TRX_N-212-764930358218,2021-06-05T15:06:41,Portugalete,Basic services,internet,-56.16,87663.38
buyer_7,María,56,ES56209544508593173856,TRX_N-213-509360014294,2021-06-07T11:10:18,Portugalete,Basic services,internet,-78.99,87584.39
buyer_7,María,56,ES56209544508593173856,TRX_N-214-896930878976,2021-06-15T09:12:43,Portugalete,Expense,education,-292.43,87291.96
buyer_7,María,56,ES56209544508593173856,TRX_N-215-685493611348,2021-06-21T09:20:19,Portugalete,Expense,transport,-181.41,87110.55
buyer_7,María,56,ES56209544508593173856,TRX_N-216-529854624680,2021-06-24T11:31:09,Pasaia,Expense,healthcare,-209.76,86900.79
buyer_7,María,56,ES56209544508593173856,TRX_N-217-733277721717,2021-06-26T12:43:33,Portugalete,Expense,food,-721.96,86178.83
buyer_7,María,56,ES56209544508593173856,TRX_N-218-112344174368,2021-06-29T01:25:31,Portugalete,Expense,leisure,-125.27,86053.56
buyer_7,María,56,ES56209544508593173856,TRX_N-219-988621932380,2021-07-01T17:47:21,Portugalete,transfer,Salary,2867.97,88921.53
buyer_7,María,56,ES56209544508593173856,TRX_N-22-77798101692,2020-03-01T18:53:28,Portugalete,transfer,Partner Salary,3420.52,19140.32
buyer_7,María,56,ES56209544508593173856,TRX_N-220-25568268449,2021-07-01T17:47:21,Portugalete,transfer,Partner Salary,3420.52,92342.05
buyer_7,María,56,ES56209544508593173856,TRX_N-221-461176838225,2021-07-02T17:08:06,Portugalete,Expense,transport,-108.41,92233.64
buyer_7,María,56,ES56209544508593173856,TRX_N-222-233270627162,2021-07-04T09:39:18,Hernani,Expense,gifts,-280.58,91953.06
buyer_7,María,56,ES56209544508593173856,TRX_N-223-490662440264,2021-07-05T18:41:42,Portugalete,Housing,Mortgage,-896.33,91056.73
buyer_7,María,56,ES56209544508593173856,TRX_N-224-459462677591,2021-07-05T20:33:02,Portugalete,Basic services,electricity,-93.54,90963.19
buyer_7,María,56,ES56209544508593173856,TRX_N-225-922936728471,2021-07-05T15:53:11,Portugalete,Basic services,gas,-37.19,90926.0
buyer_7,María,56,ES56209544508593173856,TRX_N-226-119776501962,2021-07-06T15:17:07,Portugalete,Basic services,gas,-92.45,90833.55
buyer_7,María,56,ES56209544508593173856,TRX_N-227-101287284270,2021-07-07T18:59:05,Portugalete,Basic services,gas,-36.9,90796.65
buyer_7,María,56,ES56209544508593173856,TRX_N-228-787339742451,2021-07-08T12:35:42,Portugalete,Expense,leisure,-126.57,90670.08
buyer_7,María,56,ES56209544508593173856,TRX_N-229-585191727026,2021-07-10T08:57:32,Portugalete,Expense,gifts,-314.28,90355.8
buyer_7,María,56,ES56209544508593173856,TRX_N-23-875391692631,2020-03-01T18:53:28,Portugalete,transfer,Extra Income,286.8,19427.12
buyer_7,María,56,ES56209544508593173856,TRX_N-230-548709799925,2021-08-01T19:09:57,Portugalete,transfer,Salary,2867.97,93223.77
buyer_7,María,56,ES56209544508593173856,TRX_N-231-942125830100,2021-08-01T19:09:57,Portugalete,transfer,Partner Salary,3420.52,96644.29
buyer_7,María,56,ES56209544508593173856,TRX_N-232-39154377448,2021-08-02T10:27:17,Portugalete,Expense,transport,-110.18,96534.11
buyer_7,María,56,ES56209544508593173856,TRX_N-233-60148310400,2021-08-05T15:35:16,Portugalete,Housing,Mortgage,-896.33,95637.78
buyer_7,María,56,ES56209544508593173856,TRX_N-234-151561222288,2021-08-05T20:22:46,Portugalete,Basic services,water,-41.58,95596.2
buyer_7,María,56,ES56209544508593173856,TRX_N-235-503238435525,2021-08-05T16:29:02,Portugalete,Basic services,electricity,-40.41,95555.79
buyer_7,María,56,ES56209544508593173856,TRX_N-236-745202358696,2021-08-05T16:21:02,Portugalete,Basic services,gas,-77.92,95477.87
buyer_7,María,56,ES56209544508593173856,TRX_N-237-881575162438,2021-08-05T15:38:10,Portugalete,Basic services,phone,-61.51,95416.36
buyer_7,María,56,ES56209544508593173856,TRX_N-238-960901174030,2021-08-06T18:43:41,Portugalete,Basic services,internet,-60.92,95355.44
buyer_7,María,56,ES56209544508593173856,TRX_N-239-54150368811,2021-08-06T16:33:52,Portugalete,Basic services,phone,-40.39,95315.05
buyer_7,María,56,ES56209544508593173856,TRX_N-24-64201331723,2020-03-05T05:24:08,Portugalete,Housing,Mortgage,-896.33,18530.79
buyer_7,María,56,ES56209544508593173856,TRX_N-240-310517431142,2021-08-07T14:44:03,Portugalete,Basic services,electricity,-116.16,95198.89
buyer_7,María,56,ES56209544508593173856,TRX_N-241-690056436305,2021-08-07T11:35:17,Portugalete,Basic services,phone,-89.81,95109.08
buyer_7,María,56,ES56209544508593173856,TRX_N-242-432489621920,2021-08-15T13:59:37,Alegría-Dulantzi,Expense,education,-824.6,94284.48
buyer_7,María,56,ES56209544508593173856,TRX_N-243-814324504017,2021-08-20T17:58:01,Portugalete,Expense,transport,-34.47,94250.01
buyer_7,María,56,ES56209544508593173856,TRX_N-244-435942683388,2021-08-28T13:25:21,Portugalete,Expense,clothing,-106.21,94143.8
buyer_7,María,56,ES56209544508593173856,TRX_N-245-452411478698,2021-09-01T17:02:14,Portugalete,transfer,Salary,2867.97,97011.77
buyer_7,María,56,ES56209544508593173856,TRX_N-246-676899293446,2021-09-01T17:02:14,Portugalete,transfer,Partner Salary,3420.52,100432.29
buyer_7,María,56,ES56209544508593173856,TRX_N-247-468150288180,2021-09-01T17:02:14,Portugalete,transfer,Extra Income,286.8,100719.09
buyer_7,María,56,ES56209544508593173856,TRX_N-248-117854317005,2021-09-02T09:47:36,Portugalete,Expense,food,-630.99,100088.1
buyer_7,María,56,ES56209544508593173856,TRX_N-249-357595954082,2021-09-05T10:23:50,Portugalete,Housing,Mortgage,-896.33,99191.77
buyer_7,María,56,ES56209544508593173856,TRX_N-25-216056265619,2020-03-05T17:13:28,Portugalete,Basic services,water,-12.06,18518.73
buyer_7,María,56,ES56209544508593173856,TRX_N-250-984129733175,2021-09-06T12:13:52,Portugalete,Basic services,electricity,-121.92,99069.85
buyer_7,María,56,ES56209544508593173856,TRX_N-251-494354713056,2021-09-06T12:13:16,Portugalete,Basic services,internet,-75.43,98994.42
buyer_7,María,56,ES56209544508593173856,TRX_N-252-683897187552,2021-09-07T08:25:51,Portugalete,Basic services,gas,-30.02,98964.4
buyer_7,María,56,ES56209544508593173856,TRX_N-253-724193124980,2021-09-17T20:25:53,Portugalete,Expense,transport,-181.25,98783.15
buyer_7,María,56,ES56209544508593173856,TRX_N-254-499754992177,2021-09-19T13:35:13,Portugalete,Expense,food,-291.51,98491.64
buyer_7,María,56,ES56209544508593173856,TRX_N-255-668619156823,2021-09-23T21:45:54,Portugalete,Expense,education,-597.54,97894.1
buyer_7,María,56,ES56209544508593173856,TRX_N-256-790116128071,2021-09-30T18:55:08,Portugalete,Expense,leisure,-11.88,97882.22
buyer_7,María,56,ES56209544508593173856,TRX_N-257-367256119620,2021-10-01T20:50:32,Portugalete,transfer,Salary,2867.97,100750.19
buyer_7,María,56,ES56209544508593173856,TRX_N-258-130684725187,2021-10-01T20:50:32,Portugalete,transfer,Partner Salary,3420.52,104170.71
buyer_7,María,56,ES56209544508593173856,TRX_N-259-54619732801,2021-10-05T11:03:01,Portugalete,Housing,Mortgage,-896.33,103274.38
buyer_7,María,56,ES56209544508593173856,TRX_N-26-906345435429,2020-03-05T12:47:14,Portugalete,Basic services,electricity,-82.03,18436.7
buyer_7,María,56,ES56209544508593173856,TRX_N-260-205628408452,2021-10-05T15:39:14,Portugalete,Basic services,gas,-42.39,103231.99
buyer_7,María,56,ES56209544508593173856,TRX_N-261-652052438531,2021-10-06T11:24:32,Portugalete,Basic services,electricity,-20.6,103211.39
buyer_7,María,56,ES56209544508593173856,TRX_N-262-3088183953,2021-10-06T20:43:57,Portugalete,Basic services,gas,-60.11,103151.28
buyer_7,María,56,ES56209544508593173856,TRX_N-263-64720427141,2021-10-07T14:04:31,Portugalete,Basic services,electricity,-106.53,103044.75
buyer_7,María,56,ES56209544508593173856,TRX_N-264-512981596241,2021-10-07T19:11:34,Portugalete,Basic services,gas,-80.17,102964.58
buyer_7,María,56,ES56209544508593173856,TRX_N-265-148562048299,2021-10-07T14:19:57,Portugalete,Basic services,internet,-79.7,102884.88
buyer_7,María,56,ES56209544508593173856,TRX_N-266-577598812029,2021-11-01T23:24:34,Portugalete,transfer,Salary,2867.97,105752.85
buyer_7,María,56,ES56209544508593173856,TRX_N-267-117135509386,2021-11-01T23:24:34,Portugalete,transfer,Partner Salary,3420.52,109173.37
buyer_7,María,56,ES56209544508593173856,TRX_N-268-637811086113,2021-11-01T23:24:34,Portugalete,transfer,Extra Income,286.8,109460.17
buyer_7,María,56,ES56209544508593173856,TRX_N-269-27312558414,2021-11-05T10:43:16,Portugalete,Housing,Mortgage,-896.33,108563.84
buyer_7,María,56,ES56209544508593173856,TRX_N-27-882798835750,2020-03-05T10:49:58,Portugalete,Basic services,gas,-53.18,18383.52
buyer_7,María,56,ES56209544508593173856,TRX_N-270-403471490690,2021-11-05T20:29:07,Portugalete,Basic services,water,-58.99,108504.85
buyer_7,María,56,ES56209544508593173856,TRX_N-271-130302012231,2021-11-05T12:14:07,Portugalete,Basic services,electricity,-50.17,108454.68
buyer_7,María,56,ES56209544508593173856,TRX_N-272-286294591891,2021-11-05T11:09:28,Portugalete,Basic services,phone,-62.61,108392.07
buyer_7,María,56,ES56209544508593173856,TRX_N-273-521436734713,2021-11-06T21:27:00,Portugalete,Basic services,electricity,-113.92,108278.15
buyer_7,María,56,ES56209544508593173856,TRX_N-274-66647676610,2021-11-06T16:01:00,Portugalete,Basic services,internet,-73.9,108204.25
buyer_7,María,56,ES56209544508593173856,TRX_N-275-66114898451,2021-11-07T19:52:37,Portugalete,Basic services,electricity,-53.47,108150.78
buyer_7,María,56,ES56209544508593173856,TRX_N-276-904856654931,2021-11-07T23:54:49,Portugalete,Basic services,gas,-17.86,108132.92
buyer_7,María,56,ES56209544508593173856,TRX_N-277-773585189186,2021-11-07T18:46:23,Portugalete,Basic services,phone,-53.87,108079.05
buyer_7,María,56,ES56209544508593173856,TRX_N-278-995440818213,2021-11-07T09:06:09,Portugalete,Expense,leisure,-64.15,108014.9
buyer_7,María,56,ES56209544508593173856,TRX_N-279-749495820003,2021-11-26T20:54:07,Irun,Expense,leisure,-71.64,107943.26
buyer_7,María,56,ES56209544508593173856,TRX_N-28-999604395148,2020-03-05T15:05:34,Portugalete,Basic services,phone,-29.78,18353.74
buyer_7,María,56,ES56209544508593173856,TRX_N-280-27334541817,2021-11-27T13:05:22,Portugalete,Expense,healthcare,-204.03,107739.23
buyer_7,María,56,ES56209544508593173856,TRX_N-281-829634684612,2021-12-01T08:43:48,Portugalete,transfer,Salary,2867.97,110607.2
buyer_7,María,56,ES56209544508593173856,TRX_N-282-587156913414,2021-12-01T08:43:48,Portugalete,transfer,Partner Salary,3420.52,114027.72
buyer_7,María,56,ES56209544508593173856,TRX_N-283-205210040595,2021-12-01T08:43:48,Portugalete,transfer,Bonus,2639.99,116667.71
buyer_7,María,56,ES56209544508593173856,TRX_N-284-827227882466,2021-12-05T19:09:19,Portugalete,Housing,Mortgage,-896.33,115771.38
buyer_7,María,56,ES56209544508593173856,TRX_N-285-963997902332,2021-12-05T13:12:59,Portugalete,Basic services,water,-32.08,115739.3
buyer_7,María,56,ES56209544508593173856,TRX_N-286-385069378948,2021-12-05T08:39:54,Portugalete,Basic services,gas,-78.17,115661.13
buyer_7,María,56,ES56209544508593173856,TRX_N-287-751064242336,2021-12-05T19:33:22,Portugalete,Basic services,internet,-73.09,115588.04
buyer_7,María,56,ES56209544508593173856,TRX_N-288-155095248545,2021-12-05T01:39:51,Portugalete,Basic services,phone,-47.01,115541.03
buyer_7,María,56,ES56209544508593173856,TRX_N-289-357539263494,2021-12-05T17:33:17,Portugalete,Expense,leisure,-288.01,115253.02
buyer_7,María,56,ES56209544508593173856,TRX_N-29-423720399580,2020-03-06T15:02:46,Portugalete,Basic services,gas,-46.82,18306.92
buyer_7,María,56,ES56209544508593173856,TRX_N-290-32633385916,2021-12-07T14:08:14,Portugalete,Basic services,gas,-49.95,115203.07
buyer_7,María,56,ES56209544508593173856,TRX_N-291-401601814166,2021-12-07T10:10:10,Portugalete,Basic services,phone,-74.13,115128.94
buyer_7,María,56,ES56209544508593173856,TRX_N-292-129593709776,2021-12-07T19:03:07,Portugalete,Expense,transport,-139.34,114989.6
buyer_7,María,56,ES56209544508593173856,TRX_N-293-76591280094,2021-12-08T09:16:57,Portugalete,Expense,clothing,-139.15,114850.45
buyer_7,María,56,ES56209544508593173856,TRX_N-294-282523710816,2021-12-11T14:16:30,Portugalete,Expense,leisure,-83.06,114767.39
buyer_7,María,56,ES56209544508593173856,TRX_N-295-308894968515,2021-12-16T09:38:34,Portugalete,Expense,clothing,-106.45,114660.94
buyer_7,María,56,ES56209544508593173856,TRX_N-296-86248150679,2022-01-01T17:02:24,Portugalete,transfer,Salary,2867.97,117528.91
buyer_7,María,56,ES56209544508593173856,TRX_N-297-42357571385,2022-01-01T17:02:24,Portugalete,transfer,Partner Salary,3420.52,120949.43
buyer_7,María,56,ES56209544508593173856,TRX_N-298-695361303271,2022-01-04T15:44:55,Portugalete,Expense,leisure,-95.99,120853.44
buyer_7,María,56,ES56209544508593173856,TRX_N-299-925116315443,2022-01-05T10:28:05,Portugalete,Housing,Mortgage,-896.33,119957.11
buyer_7,María,56,ES56209544508593173856,TRX_N-3-490880264925,2020-01-05T11:31:58,Portugalete,Housing,Mortgage,-896.33,9648.17
buyer_7,María,56,ES56209544508593173856,TRX_N-30-138404476038,2020-03-06T09:00:55,Portugalete,Basic services,internet,-38.99,18267.93
buyer_7,María,56,ES56209544508593173856,TRX_N-300-729846971062,2022-01-06T23:44:11,Portugalete,Basic services,electricity,-42.13,119914.98
buyer_7,María,56,ES56209544508593173856,TRX_N-301-800724608385,2022-01-06T02:38:11,Portugalete,Basic services,gas,-82.9,119832.08
buyer_7,María,56,ES56209544508593173856,TRX_N-302-107078055795,2022-01-19T21:44:32,Portugalete,Expense,transport,-67.02,119765.06
buyer_7,María,56,ES56209544508593173856,TRX_N-303-710607700788,2022-01-23T14:04:29,Portugalete,Expense,food,-744.03,119021.03
buyer_7,María,56,ES56209544508593173856,TRX_N-304-201763667124,2022-01-31T01:25:47,Portugalete,Expense,leisure,-272.67,118748.36
buyer_7,María,56,ES56209544508593173856,TRX_N-305-943338887357,2022-02-01T03:42:34,Portugalete,transfer,Salary,2867.97,121616.33
buyer_7,María,56,ES56209544508593173856,TRX_N-306-452349892929,2022-02-01T03:42:34,Portugalete,transfer,Partner Salary,3420.52,125036.85
buyer_7,María,56,ES56209544508593173856,TRX_N-307-759480108131,2022-02-01T03:42:34,Portugalete,transfer,Extra Income,286.8,125323.65
buyer_7,María,56,ES56209544508593173856,TRX_N-308-683446096634,2022-02-05T23:44:50,Portugalete,Housing,Mortgage,-896.33,124427.32
buyer_7,María,56,ES56209544508593173856,TRX_N-309-563392199966,2022-02-05T16:49:23,Portugalete,Basic services,water,-18.45,124408.87
buyer_7,María,56,ES56209544508593173856,TRX_N-31-887589418087,2020-03-07T08:40:26,Portugalete,Basic services,electricity,-132.49,18135.44
buyer_7,María,56,ES56209544508593173856,TRX_N-310-388481704705,2022-02-05T16:08:11,Portugalete,Basic services,gas,-96.13,124312.74
buyer_7,María,56,ES56209544508593173856,TRX_N-311-223073881728,2022-02-05T14:01:42,Portugalete,Basic services,phone,-42.82,124269.92
buyer_7,María,56,ES56209544508593173856,TRX_N-312-755658611055,2022-02-05T11:59:20,Portugalete,Expense,healthcare,-40.58,124229.34
buyer_7,María,56,ES56209544508593173856,TRX_N-313-248395114665,2022-02-06T14:01:11,Portugalete,Expense,clothing,-430.45,123798.89
buyer_7,María,56,ES56209544508593173856,TRX_N-314-530745426430,2022-02-07T10:10:49,Portugalete,Basic services,electricity,-46.35,123752.54
buyer_7,María,56,ES56209544508593173856,TRX_N-315-917770905436,2022-02-07T17:43:33,Portugalete,Basic services,gas,-18.87,123733.67
buyer_7,María,56,ES56209544508593173856,TRX_N-316-219425314602,2022-02-13T16:58:38,Portugalete,Expense,transport,-103.75,123629.92
buyer_7,María,56,ES56209544508593173856,TRX_N-317-631582837781,2022-02-21T12:33:54,Portugalete,Expense,food,-549.78,123080.14
buyer_7,María,56,ES56209544508593173856,TRX_N-318-665956456125,2022-03-01T22:03:27,Portugalete,transfer,Salary,2867.97,125948.11
buyer_7,María,56,ES56209544508593173856,TRX_N-319-470486587847,2022-03-01T22:03:27,Portugalete,transfer,Partner Salary,3420.52,129368.63
buyer_7,María,56,ES56209544508593173856,TRX_N-32-703472083247,2020-03-07T20:16:46,Portugalete,Basic services,gas,-56.19,18079.25
buyer_7,María,56,ES56209544508593173856,TRX_N-320-98789695312,2022-03-05T09:53:26,Portugalete,Housing,Mortgage,-896.33,128472.3
buyer_7,María,56,ES56209544508593173856,TRX_N-321-729454046594,2022-03-05T17:47:04,Portugalete,Basic services,water,-23.2,128449.1
buyer_7,María,56,ES56209544508593173856,TRX_N-322-664368563069,2022-03-05T00:40:29,Portugalete,Basic services,electricity,-53.86,128395.24
buyer_7,María,56,ES56209544508593173856,TRX_N-323-24614594768,2022-03-06T17:33:44,Portugalete,Basic services,water,-76.34,128318.9
buyer_7,María,56,ES56209544508593173856,TRX_N-324-20656491015,2022-03-06T10:21:46,Portugalete,Basic services,electricity,-107.0,128211.9
buyer_7,María,56,ES56209544508593173856,TRX_N-325-570034953726,2022-03-06T04:39:45,Portugalete,Basic services,gas,-70.02,128141.88
buyer_7,María,56,ES56209544508593173856,TRX_N-326-882295275905,2022-03-06T05:30:52,Portugalete,Basic services,internet,-46.46,128095.42
buyer_7,María,56,ES56209544508593173856,TRX_N-327-679997478830,2022-03-07T13:57:54,Portugalete,Basic services,electricity,-45.9,128049.52
buyer_7,María,56,ES56209544508593173856,TRX_N-328-490230778157,2022-03-27T11:25:15,Portugalete,Expense,leisure,-103.93,127945.59
buyer_7,María,56,ES56209544508593173856,TRX_N-329-877921059955,2022-03-29T20:39:37,Portugalete,Expense,food,-592.47,127353.12
buyer_7,María,56,ES56209544508593173856,TRX_N-33-185418401267,2020-03-07T19:48:04,Portugalete,Basic services,internet,-43.42,18035.83
buyer_7,María,56,ES56209544508593173856,TRX_N-330-274191489166,2022-04-01T15:35:32,Portugalete,transfer,Salary,2867.97,130221.09
buyer_7,María,56,ES56209544508593173856,TRX_N-331-163167599378,2022-04-01T15:35:32,Portugalete,transfer,Partner Salary,3420.52,133641.61
buyer_7,María,56,ES56209544508593173856,TRX_N-332-329612042266,2022-04-03T11:21:28,Portugalete,Expense,transport,-188.34,133453.27
buyer_7,María,56,ES56209544508593173856,TRX_N-333-257057926035,2022-04-05T01:40:34,Portugalete,Housing,Mortgage,-896.33,132556.94
buyer_7,María,56,ES56209544508593173856,TRX_N-334-215464371477,2022-04-05T10:55:19,Portugalete,Basic services,water,-29.34,132527.6
buyer_7,María,56,ES56209544508593173856,TRX_N-335-483099035758,2022-04-05T19:22:33,Portugalete,Basic services,phone,-88.73,132438.87
buyer_7,María,56,ES56209544508593173856,TRX_N-336-106491223911,2022-04-05T19:17:02,Portugalete,Expense,healthcare,-221.21,132217.66
buyer_7,María,56,ES56209544508593173856,TRX_N-337-780965963642,2022-04-06T17:02:38,Portugalete,Basic services,gas,-95.5,132122.16
buyer_7,María,56,ES56209544508593173856,TRX_N-338-753083181401,2022-04-06T11:59:57,Portugalete,Basic services,internet,-47.4,132074.76
buyer_7,María,56,ES56209544508593173856,TRX_N-339-340221272467,2022-04-12T20:29:14,Portugalete,Expense,travel,-1476.73,130598.03
buyer_7,María,56,ES56209544508593173856,TRX_N-34-451105167762,2020-03-30T20:19:11,Portugalete,Expense,leisure,-17.39,18018.44
buyer_7,María,56,ES56209544508593173856,TRX_N-340-807427827237,2022-04-20T15:47:35,Portugalete,Expense,transport,-85.84,130512.19
buyer_7,María,56,ES56209544508593173856,TRX_N-341-507690258693,2022-05-01T13:49:29,Portugalete,transfer,Salary,2867.97,133380.16
buyer_7,María,56,ES56209544508593173856,TRX_N-342-785693076230,2022-05-01T13:49:29,Portugalete,transfer,Partner Salary,3420.52,136800.68
buyer_7,María,56,ES56209544508593173856,TRX_N-343-838552547868,2022-05-01T13:49:29,Portugalete,transfer,Extra Income,286.8,137087.48
buyer_7,María,56,ES56209544508593173856,TRX_N-344-159123614243,2022-05-01T06:12:15,Portugalete,Expense,transport,-143.51,136943.97
buyer_7,María,56,ES56209544508593173856,TRX_N-345-533996407830,2022-05-05T20:16:55,Portugalete,Housing,Mortgage,-896.33,136047.64
buyer_7,María,56,ES56209544508593173856,TRX_N-346-911733430979,2022-05-05T09:22:50,Portugalete,Basic services,internet,-33.06,136014.58
buyer_7,María,56,ES56209544508593173856,TRX_N-347-521246789931,2022-05-05T17:19:54,Portugalete,Basic services,phone,-35.62,135978.96
buyer_7,María,56,ES56209544508593173856,TRX_N-348-253623353968,2022-05-06T10:07:24,Portugalete,Basic services,gas,-74.32,135904.64
buyer_7,María,56,ES56209544508593173856,TRX_N-349-535687283994,2022-05-07T03:41:30,Portugalete,Basic services,electricity,-145.38,135759.26
buyer_7,María,56,ES56209544508593173856,TRX_N-35-859889278566,2020-04-01T17:12:48,Portugalete,transfer,Salary,2867.97,20886.41
buyer_7,María,56,ES56209544508593173856,TRX_N-350-562846363155,2022-05-16T12:25:04,Portugalete,Expense,leisure,-150.61,135608.65
buyer_7,María,56,ES56209544508593173856,TRX_N-351-351856941744,2022-05-23T20:55:48,Portugalete,Expense,education,-322.25,135286.4
buyer_7,María,56,ES56209544508593173856,TRX_N-352-50595160683,2022-05-26T15:17:01,Donostia,Expense,transport,-25.09,135261.31
buyer_7,María,56,ES56209544508593173856,TRX_N-353-240623878960,2022-05-27T19:12:31,Berango,Expense,healthcare,-214.97,135046.34
buyer_7,María,56,ES56209544508593173856,TRX_N-354-613877562683,2022-06-01T09:06:30,Portugalete,transfer,Salary,2867.97,137914.31
buyer_7,María,56,ES56209544508593173856,TRX_N-355-693726282651,2022-06-01T09:06:30,Portugalete,transfer,Partner Salary,3420.52,141334.83
buyer_7,María,56,ES56209544508593173856,TRX_N-356-641890697850,2022-06-01T09:06:30,Portugalete,transfer,Bonus,2639.17,143974.0
buyer_7,María,56,ES56209544508593173856,TRX_N-357-542404934253,2022-06-05T17:43:40,Portugalete,Housing,Mortgage,-896.33,143077.67
buyer_7,María,56,ES56209544508593173856,TRX_N-358-712559326504,2022-06-05T02:19:34,Portugalete,Basic services,gas,-54.7,143022.97
buyer_7,María,56,ES56209544508593173856,TRX_N-359-761537694066,2022-06-06T19:06:08,Portugalete,Basic services,electricity,-123.1,142899.87
buyer_7,María,56,ES56209544508593173856,TRX_N-36-378103867257,2020-04-01T17:12:48,Portugalete,transfer,Partner Salary,3420.52,24306.93
buyer_7,María,56,ES56209544508593173856,TRX_N-360-702173271686,2022-06-06T20:06:53,Portugalete,Basic services,internet,-67.44,142832.43
buyer_7,María,56,ES56209544508593173856,TRX_N-361-355019940026,2022-06-07T10:41:06,Portugalete,Basic services,water,-28.91,142803.52
buyer_7,María,56,ES56209544508593173856,TRX_N-362-319378852606,2022-06-07T10:55:10,Portugalete,Basic services,electricity,-132.5,142671.02
buyer_7,María,56,ES56209544508593173856,TRX_N-363-641170270423,2022-06-07T11:10:12,Portugalete,Basic services,gas,-31.69,142639.33
buyer_7,María,56,ES56209544508593173856,TRX_N-364-732755403063,2022-06-15T14:54:51,Portugalete,Expense,transport,-60.31,142579.02
buyer_7,María,56,ES56209544508593173856,TRX_N-365-66534063504,2022-06-20T12:12:38,Portugalete,Expense,clothing,-440.13,142138.89
buyer_7,María,56,ES56209544508593173856,TRX_N-366-79985313221,2022-06-27T13:25:05,Portugalete,Expense,leisure,-295.6,141843.29
buyer_7,María,56,ES56209544508593173856,TRX_N-367-66904447909,2022-07-01T19:47:15,Portugalete,transfer,Salary,2867.97,144711.26
buyer_7,María,56,ES56209544508593173856,TRX_N-368-889571492582,2022-07-01T19:47:15,Portugalete,transfer,Partner Salary,3420.52,148131.78
buyer_7,María,56,ES56209544508593173856,TRX_N-369-656498128477,2022-07-05T13:47:52,Portugalete,Housing,Mortgage,-896.33,147235.45
buyer_7,María,56,ES56209544508593173856,TRX_N-37-350775799331,2020-04-04T14:13:39,Portugalete,Expense,healthcare,-194.09,24112.84
buyer_7,María,56,ES56209544508593173856,TRX_N-370-383333686627,2022-07-05T10:29:20,Portugalete,Basic services,electricity,-110.47,147124.98
buyer_7,María,56,ES56209544508593173856,TRX_N-371-754088379114,2022-07-05T15:14:39,Portugalete,Basic services,gas,-29.64,147095.34
buyer_7,María,56,ES56209544508593173856,TRX_N-372-179025946437,2022-07-05T14:09:18,Portugalete,Basic services,phone,-20.36,147074.98
buyer_7,María,56,ES56209544508593173856,TRX_N-373-145586084953,2022-07-06T18:49:04,Portugalete,Basic services,electricity,-41.65,147033.33
buyer_7,María,56,ES56209544508593173856,TRX_N-374-648519779305,2022-07-07T22:37:12,Portugalete,Basic services,internet,-64.11,146969.22
buyer_7,María,56,ES56209544508593173856,TRX_N-375-162548900705,2022-07-08T17:18:48,Portugalete,Expense,food,-466.38,146502.84
buyer_7,María,56,ES56209544508593173856,TRX_N-376-504781755307,2022-07-13T14:45:00,Portugalete,Expense,food,-189.86,146312.98
buyer_7,María,56,ES56209544508593173856,TRX_N-377-865135363748,2022-07-25T10:59:55,Portugalete,Expense,clothing,-461.82,145851.16
buyer_7,María,56,ES56209544508593173856,TRX_N-378-966047715900,2022-08-01T01:50:53,Portugalete,transfer,Salary,2867.97,148719.13
buyer_7,María,56,ES56209544508593173856,TRX_N-379-269593864528,2022-08-01T01:50:53,Portugalete,transfer,Partner Salary,3420.52,152139.65
buyer_7,María,56,ES56209544508593173856,TRX_N-38-204609420154,2020-04-05T20:09:11,Portugalete,Housing,Mortgage,-896.33,23216.51
buyer_7,María,56,ES56209544508593173856,TRX_N-380-395906136912,2022-08-01T01:50:53,Portugalete,transfer,Extra Income,286.8,152426.45
buyer_7,María,56,ES56209544508593173856,TRX_N-381-266036441611,2022-08-01T09:27:06,Portugalete,Expense,transport,-137.07,152289.38
buyer_7,María,56,ES56209544508593173856,TRX_N-382-600268837635,2022-08-01T08:21:12,Portugalete,Expense,repairs,-971.37,151318.01
buyer_7,María,56,ES56209544508593173856,TRX_N-383-349612866482,2022-08-05T17:09:58,Portugalete,Housing,Mortgage,-896.33,150421.68
buyer_7,María,56,ES56209544508593173856,TRX_N-384-334801345777,2022-08-05T17:49:50,Portugalete,Basic services,electricity,-117.61,150304.07
buyer_7,María,56,ES56209544508593173856,TRX_N-385-491591784197,2022-08-06T09:00:47,Portugalete,Basic services,water,-61.69,150242.38
buyer_7,María,56,ES56209544508593173856,TRX_N-386-786401576918,2022-08-06T23:40:22,Portugalete,Basic services,internet,-55.52,150186.86
buyer_7,María,56,ES56209544508593173856,TRX_N-387-99481289898,2022-08-06T21:40:50,Portugalete,Expense,food,-138.11,150048.75
buyer_7,María,56,ES56209544508593173856,TRX_N-388-763523471493,2022-08-07T17:36:48,Portugalete,Basic services,water,-20.16,150028.59
buyer_7,María,56,ES56209544508593173856,TRX_N-389-187423768843,2022-08-07T18:44:54,Portugalete,Basic services,electricity,-105.35,149923.24
buyer_7,María,56,ES56209544508593173856,TRX_N-39-662250865704,2020-04-05T14:17:52,Portugalete,Basic services,water,-70.37,23146.14
buyer_7,María,56,ES56209544508593173856,TRX_N-390-835302721299,2022-08-07T21:50:44,Portugalete,Basic services,phone,-69.97,149853.27
buyer_7,María,56,ES56209544508593173856,TRX_N-391-579402760792,2022-08-14T20:50:39,Portugalete,Expense,clothing,-337.38,149515.89
buyer_7,María,56,ES56209544508593173856,TRX_N-392-167000347513,2022-08-20T16:04:09,Portugalete,Expense,leisure,-201.44,149314.45
buyer_7,María,56,ES56209544508593173856,TRX_N-393-946496142289,2022-08-23T13:36:24,Portugalete,Expense,education,-314.92,148999.53
buyer_7,María,56,ES56209544508593173856,TRX_N-394-519041832446,2022-09-01T18:01:48,Portugalete,transfer,Salary,2867.97,151867.5
buyer_7,María,56,ES56209544508593173856,TRX_N-395-561048591402,2022-09-01T18:01:48,Portugalete,transfer,Partner Salary,3420.52,155288.02
buyer_7,María,56,ES56209544508593173856,TRX_N-396-389892556670,2022-09-01T22:32:39,Portugalete,Expense,food,-194.94,155093.08
buyer_7,María,56,ES56209544508593173856,TRX_N-397-289089261400,2022-09-04T13:24:47,Alegría-Dulantzi,Expense,clothing,-101.03,154992.05
buyer_7,María,56,ES56209544508593173856,TRX_N-398-356094235725,2022-09-05T02:20:41,Portugalete,Housing,Mortgage,-896.33,154095.72
buyer_7,María,56,ES56209544508593173856,TRX_N-399-443963405398,2022-09-05T20:21:13,Portugalete,Basic services,water,-40.75,154054.97
buyer_7,María,56,ES56209544508593173856,TRX_N-4-896500718375,2020-01-05T12:19:03,Portugalete,Basic services,electricity,-104.74,9543.43
buyer_7,María,56,ES56209544508593173856,TRX_N-40-911406072465,2020-04-05T18:59:36,Portugalete,Basic services,internet,-63.15,23082.99
buyer_7,María,56,ES56209544508593173856,TRX_N-400-460258415650,2022-09-06T22:21:14,Portugalete,Basic services,internet,-40.72,154014.25
buyer_7,María,56,ES56209544508593173856,TRX_N-401-240012841804,2022-09-06T13:19:17,Portugalete,Basic services,phone,-81.73,153932.52
buyer_7,María,56,ES56209544508593173856,TRX_N-402-26145129211,2022-09-07T20:41:03,Portugalete,Basic services,internet,-58.65,153873.87
buyer_7,María,56,ES56209544508593173856,TRX_N-403-169771552233,2022-09-15T05:22:50,Portugalete,Expense,clothing,-140.9,153732.97
buyer_7,María,56,ES56209544508593173856,TRX_N-404-396434062438,2022-09-30T18:28:51,Portugalete,Expense,transport,-103.15,153629.82
buyer_7,María,56,ES56209544508593173856,TRX_N-405-123835608365,2022-10-01T08:11:45,Portugalete,transfer,Salary,2867.97,156497.79
buyer_7,María,56,ES56209544508593173856,TRX_N-406-927146661524,2022-10-01T08:11:45,Portugalete,transfer,Partner Salary,3420.52,159918.31
buyer_7,María,56,ES56209544508593173856,TRX_N-407-827904041038,2022-10-01T08:11:45,Portugalete,transfer,Extra Income,286.8,160205.11
buyer_7,María,56,ES56209544508593173856,TRX_N-408-215965043922,2022-10-05T15:03:32,Portugalete,Housing,Mortgage,-896.33,159308.78
buyer_7,María,56,ES56209544508593173856,TRX_N-409-807250366274,2022-10-05T17:36:56,Portugalete,Basic services,water,-78.07,159230.71
buyer_7,María,56,ES56209544508593173856,TRX_N-41-382662627751,2020-04-05T18:29:54,Portugalete,Expense,healthcare,-94.09,22988.9
buyer_7,María,56,ES56209544508593173856,TRX_N-410-526497736843,2022-10-05T08:28:31,Portugalete,Basic services,internet,-44.52,159186.19
buyer_7,María,56,ES56209544508593173856,TRX_N-411-753828836668,2022-10-05T13:06:18,Portugalete,Basic services,phone,-66.41,159119.78
buyer_7,María,56,ES56209544508593173856,TRX_N-412-545840524958,2022-10-06T23:22:28,Portugalete,Basic services,gas,-59.83,159059.95
buyer_7,María,56,ES56209544508593173856,TRX_N-413-895254716763,2022-10-06T08:38:32,Portugalete,Basic services,internet,-65.57,158994.38
buyer_7,María,56,ES56209544508593173856,TRX_N-414-683416701085,2022-10-07T10:48:19,Portugalete,Basic services,water,-54.7,158939.68
buyer_7,María,56,ES56209544508593173856,TRX_N-415-641533897077,2022-10-07T10:29:22,Portugalete,Basic services,electricity,-55.7,158883.98
buyer_7,María,56,ES56209544508593173856,TRX_N-416-736787510713,2022-10-07T22:00:46,Portugalete,Basic services,internet,-37.29,158846.69
buyer_7,María,56,ES56209544508593173856,TRX_N-417-20822608393,2022-10-22T19:58:45,Portugalete,Expense,gifts,-286.41,158560.28
buyer_7,María,56,ES56209544508593173856,TRX_N-418-275916606242,2022-11-01T14:33:03,Portugalete,transfer,Salary,2867.97,161428.25
buyer_7,María,56,ES56209544508593173856,TRX_N-419-89978951102,2022-11-01T14:33:03,Portugalete,transfer,Partner Salary,3420.52,164848.77
buyer_7,María,56,ES56209544508593173856,TRX_N-42-401313395245,2020-04-06T20:30:18,Portugalete,Basic services,water,-12.0,22976.9
buyer_7,María,56,ES56209544508593173856,TRX_N-420-356077735867,2022-11-03T15:45:23,Labastida/Bastida,Expense,food,-142.17,164706.6
buyer_7,María,56,ES56209544508593173856,TRX_N-421-524352420479,2022-11-05T19:04:43,Portugalete,Housing,Mortgage,-896.33,163810.27
buyer_7,María,56,ES56209544508593173856,TRX_N-422-498622534808,2022-11-05T09:57:19,Portugalete,Basic services,internet,-30.91,163779.36
buyer_7,María,56,ES56209544508593173856,TRX_N-423-238047706600,2022-11-05T20:47:26,Portugalete,Basic services,phone,-82.57,163696.79
buyer_7,María,56,ES56209544508593173856,TRX_N-424-708606868282,2022-11-06T11:43:45,Portugalete,Basic services,gas,-55.59,163641.2
buyer_7,María,56,ES56209544508593173856,TRX_N-425-338763204284,2022-11-07T00:28:45,Portugalete,Basic services,gas,-72.19,163569.01
buyer_7,María,56,ES56209544508593173856,TRX_N-426-369547217652,2022-11-07T10:26:57,Portugalete,Basic services,internet,-63.91,163505.1
buyer_7,María,56,ES56209544508593173856,TRX_N-427-58667672985,2022-11-10T12:05:39,Amurrio,Expense,healthcare,-41.7,163463.4
buyer_7,María,56,ES56209544508593173856,TRX_N-428-495611987864,2022-11-11T16:44:56,Portugalete,Expense,transport,-116.96,163346.44
buyer_7,María,56,ES56209544508593173856,TRX_N-429-622466778543,2022-12-01T18:29:51,Portugalete,transfer,Salary,2867.97,166214.41
buyer_7,María,56,ES56209544508593173856,TRX_N-43-960334455937,2020-04-06T14:02:03,Portugalete,Basic services,phone,-93.66,22883.24
buyer_7,María,56,ES56209544508593173856,TRX_N-430-453566294856,2022-12-01T18:29:51,Portugalete,transfer,Partner Salary,3420.52,169634.93
buyer_7,María,56,ES56209544508593173856,TRX_N-431-772245535799,2022-12-01T18:29:51,Portugalete,transfer,Extra Income,286.8,169921.73
buyer_7,María,56,ES56209544508593173856,TRX_N-432-929829745012,2022-12-01T18:29:51,Portugalete,transfer,Bonus,2669.88,172591.61
buyer_7,María,56,ES56209544508593173856,TRX_N-433-621589185706,2022-12-04T11:52:04,Portugalete,Expense,transport,-40.4,172551.21
buyer_7,María,56,ES56209544508593173856,TRX_N-434-428903968491,2022-12-05T20:22:45,Portugalete,Housing,Mortgage,-896.33,171654.88
buyer_7,María,56,ES56209544508593173856,TRX_N-435-846213639113,2022-12-05T13:11:06,Portugalete,Basic services,electricity,-21.33,171633.55
buyer_7,María,56,ES56209544508593173856,TRX_N-436-603562906602,2022-12-05T16:04:25,Portugalete,Basic services,gas,-70.98,171562.57
buyer_7,María,56,ES56209544508593173856,TRX_N-437-909795357760,2022-12-06T10:16:25,Portugalete,Basic services,water,-26.41,171536.16
buyer_7,María,56,ES56209544508593173856,TRX_N-438-10129490118,2022-12-06T10:35:27,Portugalete,Basic services,gas,-75.07,171461.09
buyer_7,María,56,ES56209544508593173856,TRX_N-439-423669420290,2022-12-07T16:12:51,Portugalete,Basic services,internet,-75.26,171385.83
buyer_7,María,56,ES56209544508593173856,TRX_N-44-763743252970,2020-04-07T17:07:51,Portugalete,Basic services,water,-72.6,22810.64
buyer_7,María,56,ES56209544508593173856,TRX_N-440-87606108053,2022-12-07T20:31:05,Portugalete,Basic services,phone,-39.43,171346.4
buyer_7,María,56,ES56209544508593173856,TRX_N-441-921050412533,2022-12-08T09:07:43,Labastida/Bastida,Expense,food,-284.06,171062.34
buyer_7,María,56,ES56209544508593173856,TRX_N-442-266049614546,2022-12-10T14:16:59,Donostia,Expense,transport,-158.73,170903.61
buyer_7,María,56,ES56209544508593173856,TRX_N-443-485289722660,2022-12-19T08:16:14,Portugalete,Expense,education,-841.24,170062.37
buyer_7,María,56,ES56209544508593173856,TRX_N-444-390598151300,2022-12-25T11:54:10,Portugalete,Expense,gifts,-307.01,169755.36
buyer_7,María,56,ES56209544508593173856,TRX_N-445-404522277894,2023-01-01T08:28:37,Portugalete,transfer,Salary,2867.97,172623.33
buyer_7,María,56,ES56209544508593173856,TRX_N-446-330732993214,2023-01-01T08:28:37,Portugalete,transfer,Partner Salary,3420.52,176043.85
buyer_7,María,56,ES56209544508593173856,TRX_N-447-523860213,2023-01-05T17:16:54,Portugalete,Housing,Mortgage,-896.33,175147.52
buyer_7,María,56,ES56209544508593173856,TRX_N-448-897002787034,2023-01-05T18:35:31,Portugalete,Basic services,gas,-62.84,175084.68
buyer_7,María,56,ES56209544508593173856,TRX_N-449-415206139301,2023-01-05T14:23:03,Portugalete,Basic services,internet,-61.47,175023.21
buyer_7,María,56,ES56209544508593173856,TRX_N-45-114529040329,2020-04-07T16:30:05,Portugalete,Basic services,gas,-93.93,22716.71
buyer_7,María,56,ES56209544508593173856,TRX_N-450-997279839643,2023-01-05T17:27:51,Portugalete,Expense,food,-428.78,174594.43
buyer_7,María,56,ES56209544508593173856,TRX_N-451-89616531942,2023-01-06T19:00:03,Portugalete,Basic services,internet,-40.18,174554.25
buyer_7,María,56,ES56209544508593173856,TRX_N-452-527842636688,2023-01-07T12:45:23,Portugalete,Basic services,water,-17.68,174536.57
buyer_7,María,56,ES56209544508593173856,TRX_N-453-185433019180,2023-01-07T09:13:22,Portugalete,Basic services,electricity,-127.29,174409.28
buyer_7,María,56,ES56209544508593173856,TRX_N-454-239368823303,2023-01-07T08:13:27,Portugalete,Basic services,phone,-65.8,174343.48
buyer_7,María,56,ES56209544508593173856,TRX_N-455-357220994565,2023-01-08T11:08:51,Portugalete,Expense,gifts,-64.48,174279.0
buyer_7,María,56,ES56209544508593173856,TRX_N-456-982410173852,2023-01-21T17:56:40,Lasarte-Oria,Expense,transport,-86.23,174192.77
buyer_7,María,56,ES56209544508593173856,TRX_N-457-328486669233,2023-01-21T14:10:03,Portugalete,Expense,leisure,-224.8,173967.97
buyer_7,María,56,ES56209544508593173856,TRX_N-458-135238964668,2023-01-23T13:45:02,Portugalete,Expense,repairs,-570.38,173397.59
buyer_7,María,56,ES56209544508593173856,TRX_N-459-518951233230,2023-02-01T18:25:39,Portugalete,transfer,Salary,2867.97,176265.56
buyer_7,María,56,ES56209544508593173856,TRX_N-46-998026535970,2020-04-10T18:41:11,Portugalete,Expense,transport,-198.69,22518.02
buyer_7,María,56,ES56209544508593173856,TRX_N-460-181046635499,2023-02-01T18:25:39,Portugalete,transfer,Partner Salary,3420.52,179686.08
buyer_7,María,56,ES56209544508593173856,TRX_N-461-82459716433,2023-02-05T12:46:51,Portugalete,Housing,Mortgage,-896.33,178789.75
buyer_7,María,56,ES56209544508593173856,TRX_N-462-278773473445,2023-02-05T18:37:41,Portugalete,Basic services,water,-23.54,178766.21
buyer_7,María,56,ES56209544508593173856,TRX_N-463-255285964426,2023-02-05T17:02:00,Portugalete,Basic services,electricity,-107.66,178658.55
buyer_7,María,56,ES56209544508593173856,TRX_N-464-411761392589,2023-02-05T08:35:27,Portugalete,Basic services,gas,-79.89,178578.66
buyer_7,María,56,ES56209544508593173856,TRX_N-465-624563661784,2023-02-06T16:48:43,Portugalete,Basic services,gas,-61.46,178517.2
buyer_7,María,56,ES56209544508593173856,TRX_N-466-559683059772,2023-02-07T20:31:45,Portugalete,Basic services,gas,-94.5,178422.7
buyer_7,María,56,ES56209544508593173856,TRX_N-467-455575386783,2023-02-07T10:22:48,Portugalete,Basic services,phone,-71.99,178350.71
buyer_7,María,56,ES56209544508593173856,TRX_N-468-994825546524,2023-02-11T05:14:20,Portugalete,Expense,transport,-119.23,178231.48
buyer_7,María,56,ES56209544508593173856,TRX_N-469-222768516188,2023-02-17T13:10:10,Portugalete,Expense,healthcare,-108.8,178122.68
buyer_7,María,56,ES56209544508593173856,TRX_N-47-751701866563,2020-04-18T04:44:35,Portugalete,Expense,repairs,-97.47,22420.55
buyer_7,María,56,ES56209544508593173856,TRX_N-470-503037997462,2023-03-01T11:09:37,Portugalete,transfer,Salary,2867.97,180990.65
buyer_7,María,56,ES56209544508593173856,TRX_N-471-224266052643,2023-03-01T11:09:37,Portugalete,transfer,Partner Salary,3420.52,184411.17
buyer_7,María,56,ES56209544508593173856,TRX_N-472-581701793406,2023-03-01T11:09:37,Portugalete,transfer,Extra Income,286.8,184697.97
buyer_7,María,56,ES56209544508593173856,TRX_N-473-167034486092,2023-03-03T15:55:47,Portugalete,Expense,transport,-138.49,184559.48
buyer_7,María,56,ES56209544508593173856,TRX_N-474-341384650342,2023-03-05T09:19:56,Portugalete,Housing,Mortgage,-896.33,183663.15
buyer_7,María,56,ES56209544508593173856,TRX_N-475-655771066999,2023-03-05T12:32:53,Portugalete,Basic services,water,-17.73,183645.42
buyer_7,María,56,ES56209544508593173856,TRX_N-476-969412775041,2023-03-06T14:13:51,Portugalete,Basic services,electricity,-95.1,183550.32
buyer_7,María,56,ES56209544508593173856,TRX_N-477-929948857817,2023-03-06T15:59:25,Portugalete,Basic services,internet,-79.43,183470.89
buyer_7,María,56,ES56209544508593173856,TRX_N-478-368831903344,2023-03-06T18:12:57,Portugalete,Expense,food,-753.84,182717.05
buyer_7,María,56,ES56209544508593173856,TRX_N-479-19884148084,2023-03-07T17:33:26,Portugalete,Basic services,water,-31.13,182685.92
buyer_7,María,56,ES56209544508593173856,TRX_N-48-19159081754,2020-05-01T11:49:19,Portugalete,transfer,Salary,2867.97,25288.52
buyer_7,María,56,ES56209544508593173856,TRX_N-480-19964140633,2023-03-10T11:31:12,Portugalete,Expense,education,-160.41,182525.51
buyer_7,María,56,ES56209544508593173856,TRX_N-481-9069522264,2023-03-12T18:34:21,Portugalete,Expense,transport,-188.69,182336.82
buyer_7,María,56,ES56209544508593173856,TRX_N-482-284160010720,2023-03-15T10:08:03,Portugalete,Expense,transport,-125.49,182211.33
buyer_7,María,56,ES56209544508593173856,TRX_N-483-720092613737,2023-03-19T09:33:47,Portugalete,Expense,healthcare,-85.31,182126.02
buyer_7,María,56,ES56209544508593173856,TRX_N-484-133798454512,2023-04-01T20:31:44,Portugalete,transfer,Salary,2867.97,184993.99
buyer_7,María,56,ES56209544508593173856,TRX_N-485-56603127459,2023-04-01T20:31:44,Portugalete,transfer,Partner Salary,3420.52,188414.51
buyer_7,María,56,ES56209544508593173856,TRX_N-486-725334738859,2023-04-05T14:31:56,Portugalete,Housing,Mortgage,-896.33,187518.18
buyer_7,María,56,ES56209544508593173856,TRX_N-487-234246740273,2023-04-06T21:22:30,Portugalete,Basic services,electricity,-124.57,187393.61
buyer_7,María,56,ES56209544508593173856,TRX_N-488-396793306249,2023-04-06T10:18:10,Portugalete,Basic services,phone,-71.38,187322.23
buyer_7,María,56,ES56209544508593173856,TRX_N-489-72477007612,2023-04-07T11:28:56,Portugalete,Basic services,phone,-89.0,187233.23
buyer_7,María,56,ES56209544508593173856,TRX_N-49-61125889564,2020-05-01T11:49:19,Portugalete,transfer,Partner Salary,3420.52,28709.04
buyer_7,María,56,ES56209544508593173856,TRX_N-490-74302962470,2023-04-27T11:44:01,Portugalete,Expense,food,-633.83,186599.4
buyer_7,María,56,ES56209544508593173856,TRX_N-491-623024952733,2023-05-01T13:49:53,Portugalete,transfer,Salary,2867.97,189467.37
buyer_7,María,56,ES56209544508593173856,TRX_N-492-445420258869,2023-05-01T13:49:53,Portugalete,transfer,Partner Salary,3420.52,192887.89
buyer_7,María,56,ES56209544508593173856,TRX_N-493-870352254621,2023-05-01T13:49:53,Portugalete,transfer,Extra Income,286.8,193174.69
buyer_7,María,56,ES56209544508593173856,TRX_N-494-973268409890,2023-05-01T14:18:24,Portugalete,Expense,clothing,-455.77,192718.92
buyer_7,María,56,ES56209544508593173856,TRX_N-495-272038444979,2023-05-05T03:51:47,Portugalete,Housing,Mortgage,-896.33,191822.59
buyer_7,María,56,ES56209544508593173856,TRX_N-496-110159482328,2023-05-05T17:14:50,Portugalete,Basic services,water,-20.07,191802.52
buyer_7,María,56,ES56209544508593173856,TRX_N-497-909345498886,2023-05-05T14:23:39,Portugalete,Basic services,gas,-30.13,191772.39
buyer_7,María,56,ES56209544508593173856,TRX_N-498-713398781718,2023-05-05T14:15:46,Portugalete,Basic services,internet,-64.06,191708.33
buyer_7,María,56,ES56209544508593173856,TRX_N-499-788134017157,2023-05-06T09:51:36,Portugalete,Basic services,water,-42.49,191665.84
buyer_7,María,56,ES56209544508593173856,TRX_N-5-62231385280,2020-01-05T09:24:35,Portugalete,Basic services,internet,-40.59,9502.84
buyer_7,María,56,ES56209544508593173856,TRX_N-50-97774471180,2020-05-05T20:02:25,Portugalete,Housing,Mortgage,-896.33,27812.71
buyer_7,María,56,ES56209544508593173856,TRX_N-500-476980460136,2023-05-06T12:43:38,Portugalete,Basic services,gas,-31.29,191634.55
buyer_7,María,56,ES56209544508593173856,TRX_N-501-307007208510,2023-05-06T08:20:15,Portugalete,Basic services,internet,-30.19,191604.36
buyer_7,María,56,ES56209544508593173856,TRX_N-502-808807660562,2023-05-07T10:41:40,Portugalete,Basic services,internet,-52.24,191552.12
buyer_7,María,56,ES56209544508593173856,TRX_N-503-900527471076,2023-05-07T23:28:57,Portugalete,Basic services,phone,-67.03,191485.09
buyer_7,María,56,ES56209544508593173856,TRX_N-504-144172494033,2023-05-17T09:30:23,Portugalete,Expense,food,-116.61,191368.48
buyer_7,María,56,ES56209544508593173856,TRX_N-505-258703607588,2023-05-24T11:57:12,Portugalete,Expense,clothing,-359.2,191009.28
buyer_7,María,56,ES56209544508593173856,TRX_N-506-23477338744,2023-05-25T18:02:59,Portugalete,Expense,food,-314.58,190694.7
buyer_7,María,56,ES56209544508593173856,TRX_N-507-401363547470,2023-05-28T12:46:48,Portugalete,Expense,transport,-123.79,190570.91
buyer_7,María,56,ES56209544508593173856,TRX_N-508-519430036612,2023-06-01T18:42:25,Portugalete,transfer,Salary,2867.97,193438.88
buyer_7,María,56,ES56209544508593173856,TRX_N-509-454064901699,2023-06-01T18:42:25,Portugalete,transfer,Partner Salary,3420.52,196859.4
buyer_7,María,56,ES56209544508593173856,TRX_N-51-162011125907,2020-05-05T14:50:43,Portugalete,Basic services,water,-39.85,27772.86
buyer_7,María,56,ES56209544508593173856,TRX_N-510-935324320440,2023-06-01T18:42:25,Portugalete,transfer,Bonus,2774.32,199633.72
buyer_7,María,56,ES56209544508593173856,TRX_N-511-339320731199,2023-06-02T18:20:24,Portugalete,Expense,food,-145.95,199487.77
buyer_7,María,56,ES56209544508593173856,TRX_N-512-259345425505,2023-06-04T12:53:03,Portugalete,Expense,leisure,-245.09,199242.68
buyer_7,María,56,ES56209544508593173856,TRX_N-513-322213043508,2023-06-05T10:33:29,Portugalete,Housing,Mortgage,-896.33,198346.35
buyer_7,María,56,ES56209544508593173856,TRX_N-514-992730792441,2023-06-05T05:21:47,Portugalete,Basic services,electricity,-53.83,198292.52
buyer_7,María,56,ES56209544508593173856,TRX_N-515-874774655323,2023-06-05T18:57:19,Portugalete,Basic services,gas,-67.17,198225.35
buyer_7,María,56,ES56209544508593173856,TRX_N-516-226963552977,2023-06-07T21:12:46,Portugalete,Basic services,internet,-41.04,198184.31
buyer_7,María,56,ES56209544508593173856,TRX_N-517-818501679268,2023-06-07T13:11:03,Portugalete,Basic services,phone,-48.22,198136.09
buyer_7,María,56,ES56209544508593173856,TRX_N-518-83606197644,2023-06-08T15:26:16,Portugalete,Expense,repairs,-957.21,197178.88
buyer_7,María,56,ES56209544508593173856,TRX_N-519-507038668485,2023-06-10T23:09:34,Portugalete,Expense,transport,-132.33,197046.55
buyer_7,María,56,ES56209544508593173856,TRX_N-52-7318874207,2020-05-05T14:38:46,Portugalete,Basic services,gas,-71.26,27701.6
buyer_7,María,56,ES56209544508593173856,TRX_N-520-927615050789,2023-06-16T14:55:49,Portugalete,Expense,transport,-157.92,196888.63
buyer_7,María,56,ES56209544508593173856,TRX_N-521-745211971214,2023-06-18T08:34:58,Portugalete,Expense,gifts,-422.73,196465.9
buyer_7,María,56,ES56209544508593173856,TRX_N-522-262956911807,2023-07-01T11:13:57,Portugalete,transfer,Salary,2867.97,199333.87
buyer_7,María,56,ES56209544508593173856,TRX_N-523-373545567967,2023-07-01T11:13:57,Portugalete,transfer,Partner Salary,3420.52,202754.39
buyer_7,María,56,ES56209544508593173856,TRX_N-524-369326206682,2023-07-01T11:13:57,Portugalete,transfer,Extra Income,286.8,203041.19
buyer_7,María,56,ES56209544508593173856,TRX_N-525-724240176893,2023-07-05T15:34:57,Portugalete,Housing,Mortgage,-896.33,202144.86
buyer_7,María,56,ES56209544508593173856,TRX_N-526-791142048313,2023-07-05T11:19:51,Portugalete,Basic services,water,-79.37,202065.49
buyer_7,María,56,ES56209544508593173856,TRX_N-527-607408067630,2023-07-05T17:50:45,Portugalete,Basic services,electricity,-129.68,201935.81
buyer_7,María,56,ES56209544508593173856,TRX_N-528-116615858293,2023-07-05T08:45:56,Portugalete,Basic services,gas,-21.67,201914.14
buyer_7,María,56,ES56209544508593173856,TRX_N-529-198011958263,2023-07-05T20:32:24,Portugalete,Basic services,internet,-52.6,201861.54
buyer_7,María,56,ES56209544508593173856,TRX_N-53-512548846701,2020-05-06T16:05:14,Portugalete,Basic services,electricity,-81.08,27620.52
buyer_7,María,56,ES56209544508593173856,TRX_N-530-418170717485,2023-07-05T12:30:26,Portugalete,Basic services,phone,-58.63,201802.91
buyer_7,María,56,ES56209544508593173856,TRX_N-531-636595617928,2023-07-07T20:31:24,Portugalete,Basic services,gas,-77.52,201725.39
buyer_7,María,56,ES56209544508593173856,TRX_N-532-24211065304,2023-07-08T12:32:01,Portugalete,Expense,food,-648.32,201077.07
buyer_7,María,56,ES56209544508593173856,TRX_N-533-539000229224,2023-07-09T11:28:49,Portugalete,Expense,travel,-806.13,200270.94
buyer_7,María,56,ES56209544508593173856,TRX_N-534-599692668542,2023-07-10T08:16:00,Portugalete,Expense,education,-259.66,200011.28
buyer_7,María,56,ES56209544508593173856,TRX_N-535-45690333754,2023-07-16T12:31:49,Portugalete,Expense,transport,-29.05,199982.23
buyer_7,María,56,ES56209544508593173856,TRX_N-536-572369109664,2023-07-19T17:10:02,Sopela,Expense,leisure,-135.59,199846.64
buyer_7,María,56,ES56209544508593173856,TRX_N-537-289760539122,2023-07-25T10:09:30,Portugalete,Expense,repairs,-626.43,199220.21
buyer_7,María,56,ES56209544508593173856,TRX_N-538-703240188835,2023-07-30T22:08:53,Portugalete,Expense,leisure,-218.39,199001.82
buyer_7,María,56,ES56209544508593173856,TRX_N-539-531276405047,2023-08-01T17:09:54,Portugalete,transfer,Salary,2867.97,201869.79
buyer_7,María,56,ES56209544508593173856,TRX_N-54-747632266567,2020-05-06T12:31:47,Portugalete,Basic services,gas,-43.17,27577.35
buyer_7,María,56,ES56209544508593173856,TRX_N-540-166412405425,2023-08-01T17:09:54,Portugalete,transfer,Partner Salary,3420.52,205290.31
buyer_7,María,56,ES56209544508593173856,TRX_N-541-189287507979,2023-08-05T09:25:24,Portugalete,Housing,Mortgage,-896.33,204393.98
buyer_7,María,56,ES56209544508593173856,TRX_N-542-269672972749,2023-08-05T13:34:23,Portugalete,Basic services,water,-57.83,204336.15
buyer_7,María,56,ES56209544508593173856,TRX_N-543-518377185059,2023-08-05T10:32:00,Portugalete,Basic services,gas,-92.25,204243.9
buyer_7,María,56,ES56209544508593173856,TRX_N-544-332961628161,2023-08-05T12:36:19,Portugalete,Basic services,phone,-87.53,204156.37
buyer_7,María,56,ES56209544508593173856,TRX_N-545-197809871239,2023-08-07T08:16:54,Portugalete,Basic services,water,-72.82,204083.55
buyer_7,María,56,ES56209544508593173856,TRX_N-546-658990037931,2023-08-07T14:11:47,Portugalete,Basic services,internet,-48.58,204034.97
buyer_7,María,56,ES56209544508593173856,TRX_N-547-679817631828,2023-08-07T18:04:26,Portugalete,Basic services,phone,-83.66,203951.31
buyer_7,María,56,ES56209544508593173856,TRX_N-548-45074314341,2023-08-08T10:14:40,Portugalete,Expense,food,-349.02,203602.29
buyer_7,María,56,ES56209544508593173856,TRX_N-549-94020957985,2023-08-14T17:40:36,Errenteria,Expense,healthcare,-56.06,203546.23
buyer_7,María,56,ES56209544508593173856,TRX_N-55-537417081642,2020-05-07T10:08:09,Portugalete,Basic services,electricity,-136.38,27440.97
buyer_7,María,56,ES56209544508593173856,TRX_N-550-216788790835,2023-08-31T16:44:35,Vitoria-Gasteiz,Expense,leisure,-242.08,203304.15
buyer_7,María,56,ES56209544508593173856,TRX_N-551-584637876781,2023-09-01T13:07:52,Portugalete,transfer,Salary,2867.97,206172.12
buyer_7,María,56,ES56209544508593173856,TRX_N-552-549475891261,2023-09-01T13:07:52,Portugalete,transfer,Partner Salary,3420.52,209592.64
buyer_7,María,56,ES56209544508593173856,TRX_N-553-499574232189,2023-09-05T16:34:10,Portugalete,Housing,Mortgage,-896.33,208696.31
buyer_7,María,56,ES56209544508593173856,TRX_N-554-923745659233,2023-09-07T01:22:23,Portugalete,Basic services,electricity,-144.82,208551.49
buyer_7,María,56,ES56209544508593173856,TRX_N-555-831729492427,2023-09-11T07:45:49,Portugalete,Expense,leisure,-203.16,208348.33
buyer_7,María,56,ES56209544508593173856,TRX_N-556-944620053738,2023-09-11T15:50:07,Portugalete,Expense,gifts,-147.4,208200.93
buyer_7,María,56,ES56209544508593173856,TRX_N-557-109308428353,2023-09-23T18:04:30,Portugalete,Expense,appliances,-243.95,207956.98
buyer_7,María,56,ES56209544508593173856,TRX_N-558-374920190259,2023-10-01T11:55:39,Portugalete,transfer,Salary,2867.97,210824.95
buyer_7,María,56,ES56209544508593173856,TRX_N-559-496894763414,2023-10-01T11:55:39,Portugalete,transfer,Partner Salary,3420.52,214245.47
buyer_7,María,56,ES56209544508593173856,TRX_N-56-821348428638,2020-05-07T16:00:22,Portugalete,Basic services,gas,-91.48,27349.49
buyer_7,María,56,ES56209544508593173856,TRX_N-560-577869478767,2023-10-01T11:55:39,Portugalete,transfer,Extra Income,286.8,214532.27
buyer_7,María,56,ES56209544508593173856,TRX_N-561-109883834777,2023-10-01T20:38:25,Portugalete,Expense,transport,-128.29,214403.98
buyer_7,María,56,ES56209544508593173856,TRX_N-562-720557611416,2023-10-02T18:31:14,Portugalete,Expense,food,-768.98,213635.0
buyer_7,María,56,ES56209544508593173856,TRX_N-563-473936151296,2023-10-05T13:24:51,Portugalete,Housing,Mortgage,-896.33,212738.67
buyer_7,María,56,ES56209544508593173856,TRX_N-564-248837245484,2023-10-05T16:45:59,Portugalete,Basic services,internet,-79.32,212659.35
buyer_7,María,56,ES56209544508593173856,TRX_N-565-341222165793,2023-10-06T22:32:49,Portugalete,Basic services,gas,-78.21,212581.14
buyer_7,María,56,ES56209544508593173856,TRX_N-566-412200300048,2023-10-06T14:45:05,Portugalete,Basic services,phone,-95.23,212485.91
buyer_7,María,56,ES56209544508593173856,TRX_N-567-939551635222,2023-10-07T20:54:07,Portugalete,Basic services,gas,-33.94,212451.97
buyer_7,María,56,ES56209544508593173856,TRX_N-568-615210747227,2023-10-07T23:57:41,Portugalete,Basic services,internet,-75.52,212376.45
buyer_7,María,56,ES56209544508593173856,TRX_N-569-523508710257,2023-10-18T09:14:56,Getxo,Expense,leisure,-193.05,212183.4
buyer_7,María,56,ES56209544508593173856,TRX_N-57-779292980173,2020-05-30T15:13:47,Sestao,Expense,food,-239.24,27110.25
buyer_7,María,56,ES56209544508593173856,TRX_N-570-423949632165,2023-10-27T17:26:11,Berango,Expense,food,-599.15,211584.25
buyer_7,María,56,ES56209544508593173856,TRX_N-571-627171466128,2023-10-27T15:43:27,Portugalete,Expense,clothing,-31.71,211552.54
buyer_7,María,56,ES56209544508593173856,TRX_N-572-309185468246,2023-11-01T12:59:00,Portugalete,transfer,Salary,2867.97,214420.51
buyer_7,María,56,ES56209544508593173856,TRX_N-573-100932079476,2023-11-01T12:59:00,Portugalete,transfer,Partner Salary,3420.52,217841.03
buyer_7,María,56,ES56209544508593173856,TRX_N-574-774427789762,2023-11-05T12:58:27,Portugalete,Housing,Mortgage,-896.33,216944.7
buyer_7,María,56,ES56209544508593173856,TRX_N-575-878902597890,2023-11-05T03:18:00,Portugalete,Basic services,electricity,-27.23,216917.47
buyer_7,María,56,ES56209544508593173856,TRX_N-576-777217569511,2023-11-05T16:45:57,Portugalete,Basic services,gas,-76.26,216841.21
buyer_7,María,56,ES56209544508593173856,TRX_N-577-153036359590,2023-11-06T11:19:36,Portugalete,Basic services,water,-14.32,216826.89
buyer_7,María,56,ES56209544508593173856,TRX_N-578-13501681765,2023-11-07T13:42:58,Portugalete,Basic services,electricity,-74.14,216752.75
buyer_7,María,56,ES56209544508593173856,TRX_N-579-393119272766,2023-11-08T10:46:23,Portugalete,Expense,leisure,-47.67,216705.08
buyer_7,María,56,ES56209544508593173856,TRX_N-58-143388206288,2020-06-01T13:56:50,Portugalete,transfer,Salary,2867.97,29978.22
buyer_7,María,56,ES56209544508593173856,TRX_N-580-565989281349,2023-11-11T16:40:37,Bilbao,Expense,food,-622.14,216082.94
buyer_7,María,56,ES56209544508593173856,TRX_N-581-357960462158,2023-11-17T14:53:09,Portugalete,Expense,transport,-197.93,215885.01
buyer_7,María,56,ES56209544508593173856,TRX_N-582-735964624597,2023-11-25T10:33:57,Portugalete,Expense,leisure,-120.46,215764.55
buyer_7,María,56,ES56209544508593173856,TRX_N-583-490088565976,2023-11-27T20:42:47,Portugalete,Expense,transport,-146.88,215617.67
buyer_7,María,56,ES56209544508593173856,TRX_N-584-23706940683,2023-12-01T22:11:49,Portugalete,transfer,Salary,2867.97,218485.64
buyer_7,María,56,ES56209544508593173856,TRX_N-585-951086863649,2023-12-01T22:11:49,Portugalete,transfer,Partner Salary,3420.52,221906.16
buyer_7,María,56,ES56209544508593173856,TRX_N-586-11274563335,2023-12-01T22:11:49,Portugalete,transfer,Bonus,3108.84,225015.0
buyer_7,María,56,ES56209544508593173856,TRX_N-587-936888585919,2023-12-01T20:38:43,Portugalete,Expense,appliances,-741.6,224273.4
buyer_7,María,56,ES56209544508593173856,TRX_N-588-212895758137,2023-12-02T11:43:42,Portugalete,Expense,leisure,-170.59,224102.81
buyer_7,María,56,ES56209544508593173856,TRX_N-589-496988106365,2023-12-05T11:17:10,Portugalete,Housing,Mortgage,-896.33,223206.48
buyer_7,María,56,ES56209544508593173856,TRX_N-59-74557346282,2020-06-01T13:56:50,Portugalete,transfer,Partner Salary,3420.52,33398.74
buyer_7,María,56,ES56209544508593173856,TRX_N-590-889659695045,2023-12-05T19:11:54,Portugalete,Basic services,electricity,-103.51,223102.97
buyer_7,María,56,ES56209544508593173856,TRX_N-591-776981926242,2023-12-05T14:47:43,Portugalete,Basic services,gas,-92.77,223010.2
buyer_7,María,56,ES56209544508593173856,TRX_N-592-506085867219,2023-12-05T12:31:44,Portugalete,Basic services,internet,-72.28,222937.92
buyer_7,María,56,ES56209544508593173856,TRX_N-593-917899247957,2023-12-05T13:30:18,Portugalete,Expense,food,-543.3,222394.62
buyer_7,María,56,ES56209544508593173856,TRX_N-594-799482031235,2023-12-06T12:17:11,Portugalete,Basic services,gas,-48.05,222346.57
buyer_7,María,56,ES56209544508593173856,TRX_N-595-162390990555,2023-12-06T22:36:06,Portugalete,Basic services,internet,-60.63,222285.94
buyer_7,María,56,ES56209544508593173856,TRX_N-596-472992109955,2023-12-06T09:00:45,Portugalete,Basic services,phone,-88.97,222196.97
buyer_7,María,56,ES56209544508593173856,TRX_N-597-314337733709,2023-12-07T12:57:58,Portugalete,Basic services,water,-63.21,222133.76
buyer_7,María,56,ES56209544508593173856,TRX_N-598-576881534191,2023-12-07T12:23:40,Portugalete,Basic services,electricity,-88.44,222045.32
buyer_7,María,56,ES56209544508593173856,TRX_N-599-414725564231,2024-01-01T18:56:06,Portugalete,transfer,Salary,2867.97,224913.29
buyer_7,María,56,ES56209544508593173856,TRX_N-6-208565927407,2020-01-06T16:24:53,Portugalete,Basic services,electricity,-112.19,9390.65
buyer_7,María,56,ES56209544508593173856,TRX_N-60-809803720997,2020-06-01T13:56:50,Portugalete,transfer,Extra Income,286.8,33685.54
buyer_7,María,56,ES56209544508593173856,TRX_N-600-838287437622,2024-01-01T18:56:06,Portugalete,transfer,Partner Salary,3420.52,228333.81
buyer_7,María,56,ES56209544508593173856,TRX_N-601-266802359770,2024-01-01T18:56:06,Portugalete,transfer,Extra Income,286.8,228620.61
buyer_7,María,56,ES56209544508593173856,TRX_N-602-678948115909,2024-01-05T16:44:53,Portugalete,Housing,Mortgage,-896.33,227724.28
buyer_7,María,56,ES56209544508593173856,TRX_N-603-805763880525,2024-01-05T13:10:22,Portugalete,Basic services,internet,-56.78,227667.5
buyer_7,María,56,ES56209544508593173856,TRX_N-604-703739509244,2024-01-05T16:31:58,Portugalete,Basic services,phone,-39.66,227627.84
buyer_7,María,56,ES56209544508593173856,TRX_N-605-436605520382,2024-01-06T17:08:06,Portugalete,Basic services,electricity,-113.59,227514.25
buyer_7,María,56,ES56209544508593173856,TRX_N-606-853256242543,2024-01-06T19:59:30,Portugalete,Basic services,gas,-20.52,227493.73
buyer_7,María,56,ES56209544508593173856,TRX_N-607-401850448676,2024-01-06T08:41:46,Portugalete,Basic services,internet,-47.45,227446.28
buyer_7,María,56,ES56209544508593173856,TRX_N-608-38773841214,2024-01-07T12:59:50,Portugalete,Basic services,phone,-60.1,227386.18
buyer_7,María,56,ES56209544508593173856,TRX_N-609-738849218128,2024-01-08T09:15:59,Portugalete,Expense,transport,-61.34,227324.84
buyer_7,María,56,ES56209544508593173856,TRX_N-61-403443949792,2020-06-01T13:56:50,Portugalete,transfer,Bonus,2604.73,36290.27
buyer_7,María,56,ES56209544508593173856,TRX_N-610-368657391282,2024-01-28T00:13:32,Portugalete,Expense,clothing,-297.97,227026.87
buyer_7,María,56,ES56209544508593173856,TRX_N-611-726431890240,2024-02-01T22:17:50,Portugalete,transfer,Salary,2867.97,229894.84
buyer_7,María,56,ES56209544508593173856,TRX_N-612-565287088727,2024-02-01T22:17:50,Portugalete,transfer,Partner Salary,3420.52,233315.36
buyer_7,María,56,ES56209544508593173856,TRX_N-613-44083657518,2024-02-01T22:22:32,Portugalete,Expense,food,-354.49,232960.87
buyer_7,María,56,ES56209544508593173856,TRX_N-614-805978061510,2024-02-01T18:42:29,Errenteria,Expense,transport,-74.69,232886.18
buyer_7,María,56,ES56209544508593173856,TRX_N-615-78551489451,2024-02-05T16:36:28,Portugalete,Housing,Mortgage,-896.33,231989.85
buyer_7,María,56,ES56209544508593173856,TRX_N-616-660550670328,2024-02-05T17:14:52,Portugalete,Basic services,phone,-65.79,231924.06
buyer_7,María,56,ES56209544508593173856,TRX_N-617-357371721199,2024-02-07T13:43:30,Portugalete,Basic services,internet,-78.02,231846.04
buyer_7,María,56,ES56209544508593173856,TRX_N-618-892869655302,2024-02-07T11:17:54,Portugalete,Expense,clothing,-184.21,231661.83
buyer_7,María,56,ES56209544508593173856,TRX_N-619-241525647120,2024-02-14T08:12:21,Portugalete,Expense,food,-776.82,230885.01
buyer_7,María,56,ES56209544508593173856,TRX_N-62-317107608449,2020-06-05T19:35:55,Portugalete,Housing,Mortgage,-896.33,35393.94
buyer_7,María,56,ES56209544508593173856,TRX_N-620-931578269013,2024-02-24T12:45:43,Portugalete,Expense,healthcare,-190.18,230694.83
buyer_7,María,56,ES56209544508593173856,TRX_N-621-878573996465,2024-02-28T15:17:14,Portugalete,Expense,transport,-122.84,230571.99
buyer_7,María,56,ES56209544508593173856,TRX_N-622-456356826815,2024-03-01T19:23:21,Portugalete,transfer,Salary,2867.97,233439.96
buyer_7,María,56,ES56209544508593173856,TRX_N-623-859761206670,2024-03-01T19:23:21,Portugalete,transfer,Partner Salary,3420.52,236860.48
buyer_7,María,56,ES56209544508593173856,TRX_N-624-710998657393,2024-03-01T19:23:21,Portugalete,transfer,Extra Income,286.8,237147.28
buyer_7,María,56,ES56209544508593173856,TRX_N-625-542485098844,2024-03-05T15:07:31,Portugalete,Housing,Mortgage,-896.33,236250.95
buyer_7,María,56,ES56209544508593173856,TRX_N-626-495215999014,2024-03-06T07:33:59,Portugalete,Basic services,water,-45.54,236205.41
buyer_7,María,56,ES56209544508593173856,TRX_N-627-779176832536,2024-03-06T03:58:56,Portugalete,Basic services,internet,-41.56,236163.85
buyer_7,María,56,ES56209544508593173856,TRX_N-628-486472185533,2024-03-06T14:57:35,Portugalete,Basic services,phone,-79.0,236084.85
buyer_7,María,56,ES56209544508593173856,TRX_N-629-999066337245,2024-03-07T14:37:12,Portugalete,Basic services,electricity,-95.6,235989.25
buyer_7,María,56,ES56209544508593173856,TRX_N-63-744375822124,2020-06-05T20:40:40,Portugalete,Basic services,internet,-54.32,35339.62
buyer_7,María,56,ES56209544508593173856,TRX_N-630-280894619943,2024-03-07T14:45:59,Portugalete,Basic services,internet,-35.69,235953.56
buyer_7,María,56,ES56209544508593173856,TRX_N-631-693313038503,2024-03-08T10:21:35,Sopela,Expense,leisure,-148.08,235805.48
buyer_7,María,56,ES56209544508593173856,TRX_N-632-317588829211,2024-03-14T18:26:28,Portugalete,Expense,education,-764.42,235041.06
buyer_7,María,56,ES56209544508593173856,TRX_N-633-657226380691,2024-03-20T10:04:31,Portugalete,Expense,leisure,-100.73,234940.33
buyer_7,María,56,ES56209544508593173856,TRX_N-634-784578447508,2024-03-25T06:19:40,Portugalete,Expense,gifts,-163.61,234776.72
buyer_7,María,56,ES56209544508593173856,TRX_N-635-492593893765,2024-03-31T14:06:46,Santurtzi,Expense,food,-383.76,234392.96
buyer_7,María,56,ES56209544508593173856,TRX_N-636-590392287860,2024-04-01T08:52:49,Portugalete,transfer,Salary,2867.97,237260.93
buyer_7,María,56,ES56209544508593173856,TRX_N-637-825646198869,2024-04-01T08:52:49,Portugalete,transfer,Partner Salary,3420.52,240681.45
buyer_7,María,56,ES56209544508593173856,TRX_N-638-425953998143,2024-04-05T14:19:21,Portugalete,Housing,Mortgage,-896.33,239785.12
buyer_7,María,56,ES56209544508593173856,TRX_N-639-269931010250,2024-04-05T18:17:32,Portugalete,Basic services,gas,-94.29,239690.83
buyer_7,María,56,ES56209544508593173856,TRX_N-64-651162867587,2020-06-05T14:13:30,Portugalete,Expense,food,-531.28,34808.34
buyer_7,María,56,ES56209544508593173856,TRX_N-640-999822810771,2024-04-05T23:44:16,Portugalete,Basic services,phone,-80.31,239610.52
buyer_7,María,56,ES56209544508593173856,TRX_N-641-960772924391,2024-04-06T13:39:20,Portugalete,Basic services,water,-35.94,239574.58
buyer_7,María,56,ES56209544508593173856,TRX_N-642-832589830477,2024-04-06T19:35:49,Portugalete,Basic services,electricity,-86.43,239488.15
buyer_7,María,56,ES56209544508593173856,TRX_N-643-634375987638,2024-04-07T13:41:04,Portugalete,Basic services,gas,-62.86,239425.29
buyer_7,María,56,ES56209544508593173856,TRX_N-644-558398263592,2024-04-07T12:08:09,Portugalete,Basic services,internet,-56.9,239368.39
buyer_7,María,56,ES56209544508593173856,TRX_N-645-385122307568,2024-04-08T16:35:04,Portugalete,Expense,food,-107.4,239260.99
buyer_7,María,56,ES56209544508593173856,TRX_N-646-39176035609,2024-04-10T14:07:14,Hondarribia,Expense,transport,-123.24,239137.75
buyer_7,María,56,ES56209544508593173856,TRX_N-647-261605823594,2024-04-11T09:46:46,Portugalete,Expense,clothing,-117.04,239020.71
buyer_7,María,56,ES56209544508593173856,TRX_N-648-269429330547,2024-04-14T23:08:22,Portugalete,Expense,food,-441.19,238579.52
buyer_7,María,56,ES56209544508593173856,TRX_N-649-560015012689,2024-05-01T18:36:12,Portugalete,transfer,Salary,2867.97,241447.49
buyer_7,María,56,ES56209544508593173856,TRX_N-65-916327522417,2020-06-06T12:23:50,Portugalete,Basic services,water,-47.99,34760.35
buyer_7,María,56,ES56209544508593173856,TRX_N-650-917942089481,2024-05-01T18:36:12,Portugalete,transfer,Partner Salary,3420.52,244868.01
buyer_7,María,56,ES56209544508593173856,TRX_N-651-522867234288,2024-05-03T13:18:49,Pasaia,Expense,gifts,-432.26,244435.75
buyer_7,María,56,ES56209544508593173856,TRX_N-652-379713646358,2024-05-05T10:04:32,Portugalete,Housing,Mortgage,-896.33,243539.42
buyer_7,María,56,ES56209544508593173856,TRX_N-653-166640669671,2024-05-07T11:52:02,Portugalete,Basic services,gas,-70.38,243469.04
buyer_7,María,56,ES56209544508593173856,TRX_N-654-186124461344,2024-05-07T17:08:59,Portugalete,Basic services,internet,-78.18,243390.86
buyer_7,María,56,ES56209544508593173856,TRX_N-655-969659232114,2024-05-12T18:30:18,Portugalete,Expense,food,-325.46,243065.4
buyer_7,María,56,ES56209544508593173856,TRX_N-656-61688014394,2024-05-13T19:04:36,Portugalete,Expense,leisure,-108.32,242957.08
buyer_7,María,56,ES56209544508593173856,TRX_N-657-294992553546,2024-05-15T12:16:55,Portugalete,Expense,clothing,-402.58,242554.5
buyer_7,María,56,ES56209544508593173856,TRX_N-658-108077121255,2024-05-18T10:45:22,Portugalete,Expense,travel,-2378.66,240175.84
buyer_7,María,56,ES56209544508593173856,TRX_N-659-130437974588,2024-06-01T11:37:02,Portugalete,transfer,Salary,2867.97,243043.81
buyer_7,María,56,ES56209544508593173856,TRX_N-66-188718935577,2020-06-06T16:45:09,Portugalete,Basic services,gas,-64.36,34695.99
buyer_7,María,56,ES56209544508593173856,TRX_N-660-860043586512,2024-06-01T11:37:02,Portugalete,transfer,Partner Salary,3420.52,246464.33
buyer_7,María,56,ES56209544508593173856,TRX_N-661-379344276806,2024-06-01T11:37:02,Portugalete,transfer,Extra Income,286.8,246751.13
buyer_7,María,56,ES56209544508593173856,TRX_N-662-495438895759,2024-06-01T11:37:02,Portugalete,transfer,Bonus,2822.94,249574.07
buyer_7,María,56,ES56209544508593173856,TRX_N-663-875393536522,2024-06-05T00:37:38,Portugalete,Housing,Mortgage,-896.33,248677.74
buyer_7,María,56,ES56209544508593173856,TRX_N-664-457728480704,2024-06-05T10:25:12,Portugalete,Basic services,internet,-44.5,248633.24
buyer_7,María,56,ES56209544508593173856,TRX_N-665-777235225650,2024-06-06T21:23:06,Portugalete,Basic services,gas,-15.07,248618.17
buyer_7,María,56,ES56209544508593173856,TRX_N-666-629874617785,2024-06-06T08:00:34,Portugalete,Basic services,phone,-66.21,248551.96
buyer_7,María,56,ES56209544508593173856,TRX_N-667-15873583795,2024-06-06T23:21:50,Portugalete,Expense,food,-386.42,248165.54
buyer_7,María,56,ES56209544508593173856,TRX_N-668-235261757035,2024-06-07T13:37:47,Portugalete,Basic services,electricity,-65.8,248099.74
buyer_7,María,56,ES56209544508593173856,TRX_N-669-962418502249,2024-06-07T10:30:18,Portugalete,Expense,food,-580.3,247519.44
buyer_7,María,56,ES56209544508593173856,TRX_N-67-842962768222,2020-06-07T17:24:39,Portugalete,Expense,transport,-134.86,34561.13
buyer_7,María,56,ES56209544508593173856,TRX_N-670-614515730765,2024-06-16T12:52:41,Berango,Expense,healthcare,-334.75,247184.69
buyer_7,María,56,ES56209544508593173856,TRX_N-671-842987970494,2024-06-20T22:46:36,Portugalete,Expense,clothing,-213.34,246971.35
buyer_7,María,56,ES56209544508593173856,TRX_N-672-283872922767,2024-06-23T21:18:25,Portugalete,Expense,food,-699.69,246271.66
buyer_7,María,56,ES56209544508593173856,TRX_N-673-668094268378,2024-06-25T15:45:17,Portugalete,Expense,food,-653.6,245618.06
buyer_7,María,56,ES56209544508593173856,TRX_N-674-409503040016,2024-07-01T20:54:24,Portugalete,transfer,Salary,2867.97,248486.03
buyer_7,María,56,ES56209544508593173856,TRX_N-675-302204559205,2024-07-01T20:54:24,Portugalete,transfer,Partner Salary,3420.52,251906.55
buyer_7,María,56,ES56209544508593173856,TRX_N-676-939354427593,2024-07-03T12:36:32,Portugalete,Expense,leisure,-237.3,251669.25
buyer_7,María,56,ES56209544508593173856,TRX_N-677-363315337016,2024-07-05T16:42:46,Portugalete,Housing,Mortgage,-896.33,250772.92
buyer_7,María,56,ES56209544508593173856,TRX_N-678-933627139497,2024-07-05T05:06:49,Portugalete,Basic services,electricity,-69.32,250703.6
buyer_7,María,56,ES56209544508593173856,TRX_N-679-166913326533,2024-07-06T15:40:52,Portugalete,Basic services,electricity,-92.86,250610.74
buyer_7,María,56,ES56209544508593173856,TRX_N-68-631305700188,2020-06-18T08:58:00,Portugalete,Expense,clothing,-235.47,34325.66
buyer_7,María,56,ES56209544508593173856,TRX_N-680-379781900529,2024-07-08T13:49:19,Alegría-Dulantzi,Expense,food,-760.98,249849.76
buyer_7,María,56,ES56209544508593173856,TRX_N-681-925621867556,2024-07-27T19:11:58,Portugalete,Expense,leisure,-291.37,249558.39
buyer_7,María,56,ES56209544508593173856,TRX_N-682-201010756459,2024-08-01T12:03:06,Portugalete,transfer,Salary,2867.97,252426.36
buyer_7,María,56,ES56209544508593173856,TRX_N-683-777156448517,2024-08-01T12:03:06,Portugalete,transfer,Partner Salary,3420.52,255846.88
buyer_7,María,56,ES56209544508593173856,TRX_N-684-300223545867,2024-08-05T10:42:57,Portugalete,Housing,Mortgage,-896.33,254950.55
buyer_7,María,56,ES56209544508593173856,TRX_N-685-566787262619,2024-08-05T20:26:51,Portugalete,Basic services,electricity,-67.91,254882.64
buyer_7,María,56,ES56209544508593173856,TRX_N-686-627948434139,2024-08-05T09:30:27,Portugalete,Basic services,phone,-67.83,254814.81
buyer_7,María,56,ES56209544508593173856,TRX_N-687-133951490154,2024-08-06T13:24:03,Portugalete,Basic services,gas,-35.4,254779.41
buyer_7,María,56,ES56209544508593173856,TRX_N-688-642604774810,2024-08-06T13:13:11,Portugalete,Basic services,internet,-41.68,254737.73
buyer_7,María,56,ES56209544508593173856,TRX_N-689-99100366349,2024-08-06T19:57:37,Portugalete,Basic services,phone,-58.27,254679.46
buyer_7,María,56,ES56209544508593173856,TRX_N-69-91214836679,2020-07-01T10:23:26,Portugalete,transfer,Salary,2867.97,37193.63
buyer_7,María,56,ES56209544508593173856,TRX_N-690-313810513633,2024-08-06T15:46:43,Portugalete,Expense,clothing,-298.3,254381.16
buyer_7,María,56,ES56209544508593173856,TRX_N-691-316107280592,2024-08-07T17:48:52,Portugalete,Basic services,water,-70.97,254310.19
buyer_7,María,56,ES56209544508593173856,TRX_N-692-773625222350,2024-08-07T17:22:09,Portugalete,Basic services,electricity,-20.34,254289.85
buyer_7,María,56,ES56209544508593173856,TRX_N-693-899675605714,2024-08-07T17:51:24,Portugalete,Basic services,gas,-68.1,254221.75
buyer_7,María,56,ES56209544508593173856,TRX_N-694-928675199874,2024-08-11T02:14:35,Portugalete,Expense,food,-691.38,253530.37
buyer_7,María,56,ES56209544508593173856,TRX_N-695-13140289982,2024-08-20T14:42:38,Getxo,Expense,healthcare,-170.07,253360.3
buyer_7,María,56,ES56209544508593173856,TRX_N-696-964050952063,2024-09-01T11:14:45,Portugalete,transfer,Salary,2867.97,256228.27
buyer_7,María,56,ES56209544508593173856,TRX_N-697-382857143941,2024-09-01T11:14:45,Portugalete,transfer,Partner Salary,3420.52,259648.79
buyer_7,María,56,ES56209544508593173856,TRX_N-698-138835944255,2024-09-01T11:14:45,Portugalete,transfer,Extra Income,286.8,259935.59
buyer_7,María,56,ES56209544508593173856,TRX_N-699-335665137914,2024-09-02T06:55:11,Portugalete,Expense,transport,-149.13,259786.46
buyer_7,María,56,ES56209544508593173856,TRX_N-7-502268186602,2020-01-06T11:46:51,Portugalete,Basic services,gas,-68.58,9322.07
buyer_7,María,56,ES56209544508593173856,TRX_N-70-416444535729,2020-07-01T10:23:26,Portugalete,transfer,Partner Salary,3420.52,40614.15
buyer_7,María,56,ES56209544508593173856,TRX_N-700-325806587270,2024-09-05T13:14:04,Portugalete,Housing,Mortgage,-896.33,258890.13
buyer_7,María,56,ES56209544508593173856,TRX_N-701-155428535223,2024-09-05T16:31:37,Portugalete,Basic services,water,-34.81,258855.32
buyer_7,María,56,ES56209544508593173856,TRX_N-702-467868761001,2024-09-05T03:43:59,Portugalete,Basic services,electricity,-79.4,258775.92
buyer_7,María,56,ES56209544508593173856,TRX_N-703-262258340483,2024-09-05T11:02:04,Portugalete,Basic services,phone,-30.77,258745.15
buyer_7,María,56,ES56209544508593173856,TRX_N-704-530753240290,2024-09-05T23:02:05,Portugalete,Expense,transport,-194.45,258550.7
buyer_7,María,56,ES56209544508593173856,TRX_N-705-859742354858,2024-09-06T17:51:20,Portugalete,Basic services,gas,-17.08,258533.62
buyer_7,María,56,ES56209544508593173856,TRX_N-706-254280891249,2024-09-08T18:23:58,Portugalete,Expense,transport,-108.41,258425.21
buyer_7,María,56,ES56209544508593173856,TRX_N-707-501768684913,2024-09-16T22:24:55,Portugalete,Expense,transport,-174.38,258250.83
buyer_7,María,56,ES56209544508593173856,TRX_N-708-250944867406,2024-09-25T13:04:07,Portugalete,Expense,food,-389.74,257861.09
buyer_7,María,56,ES56209544508593173856,TRX_N-709-57007131992,2024-10-01T14:36:53,Portugalete,transfer,Salary,2867.97,260729.06
buyer_7,María,56,ES56209544508593173856,TRX_N-71-928962566874,2020-07-03T16:44:06,Portugalete,Expense,leisure,-224.44,40389.71
buyer_7,María,56,ES56209544508593173856,TRX_N-710-464527162304,2024-10-01T14:36:53,Portugalete,transfer,Partner Salary,3420.52,264149.58
buyer_7,María,56,ES56209544508593173856,TRX_N-711-108755021510,2024-10-02T14:26:08,Portugalete,Expense,repairs,-253.88,263895.7
buyer_7,María,56,ES56209544508593173856,TRX_N-712-393077635557,2024-10-05T11:07:31,Portugalete,Housing,Mortgage,-896.33,262999.37
buyer_7,María,56,ES56209544508593173856,TRX_N-713-643157184368,2024-10-05T10:02:30,Portugalete,Basic services,gas,-90.86,262908.51
buyer_7,María,56,ES56209544508593173856,TRX_N-714-147593819934,2024-10-06T09:24:18,Portugalete,Basic services,water,-10.72,262897.79
buyer_7,María,56,ES56209544508593173856,TRX_N-715-440366764229,2024-10-06T16:17:12,Portugalete,Basic services,internet,-74.41,262823.38
buyer_7,María,56,ES56209544508593173856,TRX_N-716-778366354456,2024-10-07T16:49:36,Portugalete,Basic services,phone,-75.76,262747.62
buyer_7,María,56,ES56209544508593173856,TRX_N-72-431393453032,2020-07-05T18:37:35,Portugalete,Housing,Mortgage,-896.33,39493.38
buyer_7,María,56,ES56209544508593173856,TRX_N-73-700854190168,2020-07-06T14:35:58,Portugalete,Basic services,electricity,-73.41,39419.97
buyer_7,María,56,ES56209544508593173856,TRX_N-74-454139523592,2020-07-06T19:44:36,Portugalete,Basic services,gas,-23.94,39396.03
buyer_7,María,56,ES56209544508593173856,TRX_N-75-760988087254,2020-07-06T17:40:33,Portugalete,Basic services,internet,-74.54,39321.49
buyer_7,María,56,ES56209544508593173856,TRX_N-76-650132534556,2020-07-07T13:50:19,Portugalete,Basic services,water,-66.49,39255.0
buyer_7,María,56,ES56209544508593173856,TRX_N-77-652086028626,2020-07-07T22:23:05,Portugalete,Basic services,internet,-73.75,39181.25
buyer_7,María,56,ES56209544508593173856,TRX_N-78-684972084171,2020-07-07T23:09:14,Portugalete,Basic services,phone,-32.52,39148.73
buyer_7,María,56,ES56209544508593173856,TRX_N-79-862539265921,2020-07-26T11:03:43,Portugalete,Expense,gifts,-89.74,39058.99
buyer_7,María,56,ES56209544508593173856,TRX_N-8-714707297183,2020-01-07T10:43:12,Portugalete,Basic services,electricity,-50.35,9271.72
buyer_7,María,56,ES56209544508593173856,TRX_N-80-298992460399,2020-08-01T12:41:16,Portugalete,transfer,Salary,2867.97,41926.96
buyer_7,María,56,ES56209544508593173856,TRX_N-81-850881622859,2020-08-01T12:41:16,Portugalete,transfer,Partner Salary,3420.52,45347.48
buyer_7,María,56,ES56209544508593173856,TRX_N-82-798404157852,2020-08-01T12:41:16,Portugalete,transfer,Extra Income,286.8,45634.28
buyer_7,María,56,ES56209544508593173856,TRX_N-83-253157702111,2020-08-05T16:59:56,Portugalete,Housing,Mortgage,-896.33,44737.95
buyer_7,María,56,ES56209544508593173856,TRX_N-84-525459732146,2020-08-06T09:57:38,Portugalete,Basic services,gas,-71.1,44666.85
buyer_7,María,56,ES56209544508593173856,TRX_N-85-522625435061,2020-08-06T09:25:06,Portugalete,Basic services,phone,-33.15,44633.7
buyer_7,María,56,ES56209544508593173856,TRX_N-86-840493457195,2020-08-07T19:41:10,Portugalete,Basic services,water,-21.38,44612.32
buyer_7,María,56,ES56209544508593173856,TRX_N-87-962439052913,2020-08-07T13:00:01,Portugalete,Basic services,electricity,-72.76,44539.56
buyer_7,María,56,ES56209544508593173856,TRX_N-88-592588304984,2020-08-07T09:18:19,Portugalete,Basic services,phone,-27.92,44511.64
buyer_7,María,56,ES56209544508593173856,TRX_N-89-691372801230,2020-08-19T20:53:45,Portugalete,Expense,food,-724.77,43786.87
buyer_7,María,56,ES56209544508593173856,TRX_N-9-518852652264,2020-01-07T16:16:15,Portugalete,Basic services,internet,-78.88,9192.84
buyer_7,María,56,ES56209544508593173856,TRX_N-90-857129057663,2020-08-26T15:52:07,Portugalete,Expense,transport,-82.51,43704.36
buyer_7,María,56,ES56209544508593173856,TRX_N-91-638495960617,2020-09-01T10:20:55,Portugalete,transfer,Salary,2867.97,46572.33
buyer_7,María,56,ES56209544508593173856,TRX_N-92-182055660954,2020-09-01T10:20:55,Portugalete,transfer,Partner Salary,3420.52,49992.85
buyer_7,María,56,ES56209544508593173856,TRX_N-93-603890404555,2020-09-01T17:42:24,Portugalete,Expense,gifts,-281.65,49711.2
buyer_7,María,56,ES56209544508593173856,TRX_N-94-652531363890,2020-09-05T08:02:13,Portugalete,Housing,Mortgage,-896.33,48814.87
buyer_7,María,56,ES56209544508593173856,TRX_N-95-722622074467,2020-09-05T14:55:06,Portugalete,Basic services,gas,-80.51,48734.36
buyer_7,María,56,ES56209544508593173856,TRX_N-96-951017193328,2020-09-05T13:36:42,Portugalete,Basic services,internet,-56.33,48678.03
buyer_7,María,56,ES56209544508593173856,TRX_N-97-97455785930,2020-09-06T05:47:26,Portugalete,Basic services,water,-12.78,48665.25
buyer_7,María,56,ES56209544508593173856,TRX_N-98-290854791119,2020-09-06T14:56:51,Portugalete,Basic services,electricity,-105.83,48559.42
buyer_7,María,56,ES56209544508593173856,TRX_N-99-754702898436,2020-09-06T09:04:56,Portugalete,Basic services,gas,-52.15,48507.27
buyer_8,Antonio,45,ES37209501030856981675,TRX_N-1-134450460513,2020-01-01T17:44:55,Labastida,transfer,Salary,2144.78,3954.44
buyer_8,Antonio,45,ES37209501030856981675,TRX_N-10-348713040593,2020-01-09T14:05:23,Labastida,Expense,transport,-101.04,2344.49
buyer_8,Antonio,45,ES37209501030856981675,TRX_N-100-688356206655,2020-09-05T11:17:53,Labastida,Basic services,electricity,-130.02,6482.31
buyer_8,Antonio,45,ES37209501030856981675,TRX_N-101-962548440965,2020-09-06T12:16:50,Labastida,Basic services,electricity,-86.27,6396.04
buyer_8,Antonio,45,ES37209501030856981675,TRX_N-102-846452390597,2020-09-06T11:10:10,Labastida,Basic services,internet,-77.5,6318.54
buyer_8,Antonio,45,ES37209501030856981675,TRX_N-103-835418543496,2020-09-06T16:39:01,Labastida,Expense,clothing,-188.33,6130.21
buyer_8,Antonio,45,ES37209501030856981675,TRX_N-104-988761181416,2020-09-20T15:49:00,Portugalete,Expense,healthcare,-363.42,5766.79
buyer_8,Antonio,45,ES37209501030856981675,TRX_N-105-642554582273,2020-09-20T12:41:06,Labastida,Expense,gifts,-247.02,5519.77
buyer_8,Antonio,45,ES37209501030856981675,TRX_N-106-389050075686,2020-10-01T10:53:33,Labastida,transfer,Salary,2144.78,7664.55
buyer_8,Antonio,45,ES37209501030856981675,TRX_N-107-835614619454,2020-10-01T10:53:33,Labastida,transfer,Extra Income,214.48,7879.03
buyer_8,Antonio,45,ES37209501030856981675,TRX_N-108-935880623035,2020-10-03T22:02:35,Labastida,Expense,food,-274.77,7604.26
buyer_8,Antonio,45,ES37209501030856981675,TRX_N-109-100272416643,2020-10-05T18:12:41,Labastida,Housing,Mortgage,-921.75,6682.51
buyer_8,Antonio,45,ES37209501030856981675,TRX_N-11-22656386225,2020-01-23T14:42:33,Labastida,Expense,leisure,-43.31,2301.18
buyer_8,Antonio,45,ES37209501030856981675,TRX_N-110-690353559887,2020-10-05T11:53:40,Labastida,Basic services,water,-14.31,6668.2
buyer_8,Antonio,45,ES37209501030856981675,TRX_N-111-57422307444,2020-10-06T20:10:38,Labastida,Basic services,electricity,-119.52,6548.68
buyer_8,Antonio,45,ES37209501030856981675,TRX_N-112-646852168480,2020-10-06T19:37:09,Labastida,Basic services,gas,-85.82,6462.86
buyer_8,Antonio,45,ES37209501030856981675,TRX_N-113-944445448452,2020-10-07T09:39:16,Labastida,Basic services,gas,-74.73,6388.13
buyer_8,Antonio,45,ES37209501030856981675,TRX_N-114-444262700903,2020-10-09T10:30:45,Labastida,Expense,travel,-2720.38,3667.75
buyer_8,Antonio,45,ES37209501030856981675,TRX_N-115-262839271711,2020-10-11T15:18:56,Labastida,Expense,gifts,-347.76,3319.99
buyer_8,Antonio,45,ES37209501030856981675,TRX_N-116-859212203643,2020-10-16T12:01:27,Berango,Expense,healthcare,-208.95,3111.04
buyer_8,Antonio,45,ES37209501030856981675,TRX_N-117-298806827035,2020-11-01T02:23:18,Labastida,transfer,Salary,2144.78,5255.82
buyer_8,Antonio,45,ES37209501030856981675,TRX_N-118-973244444574,2020-11-05T19:31:33,Labastida,Housing,Mortgage,-921.75,4334.07
buyer_8,Antonio,45,ES37209501030856981675,TRX_N-119-54194643892,2020-11-05T08:38:38,Labastida,Basic services,phone,-78.59,4255.48
buyer_8,Antonio,45,ES37209501030856981675,TRX_N-12-105893920057,2020-01-26T10:20:43,Labastida,Expense,travel,-2318.67,-17.49
buyer_8,Antonio,45,ES37209501030856981675,TRX_N-120-773959852781,2020-11-05T10:23:02,Labastida,Expense,food,-688.01,3567.47
buyer_8,Antonio,45,ES37209501030856981675,TRX_N-121-629813996917,2020-11-06T22:31:26,Labastida,Basic services,gas,-74.07,3493.4
buyer_8,Antonio,45,ES37209501030856981675,TRX_N-122-500252388694,2020-11-06T19:18:19,Labastida,Expense,transport,-87.2,3406.2
buyer_8,Antonio,45,ES37209501030856981675,TRX_N-123-204271652432,2020-11-07T19:14:29,Labastida,Basic services,phone,-20.81,3385.39
buyer_8,Antonio,45,ES37209501030856981675,TRX_N-124-449865937371,2020-11-24T17:00:49,Basauri,Expense,clothing,-429.86,2955.53
buyer_8,Antonio,45,ES37209501030856981675,TRX_N-125-468478212698,2020-11-28T12:09:58,Mungia,Expense,transport,-53.28,2902.25
buyer_8,Antonio,45,ES37209501030856981675,TRX_N-126-984991681128,2020-11-30T19:43:47,Donostia,Expense,healthcare,-56.86,2845.39
buyer_8,Antonio,45,ES37209501030856981675,TRX_N-127-799355342672,2020-11-30T22:17:15,Labastida,Expense,appliances,-884.99,1960.4
buyer_8,Antonio,45,ES37209501030856981675,TRX_N-128-67640163946,2020-12-01T20:23:00,Labastida,transfer,Salary,2144.78,4105.18
buyer_8,Antonio,45,ES37209501030856981675,TRX_N-129-871256848802,2020-12-01T20:23:00,Labastida,transfer,Extra Income,214.48,4319.66
buyer_8,Antonio,45,ES37209501030856981675,TRX_N-13-519355315232,2020-02-01T11:02:15,Labastida,transfer,Salary,2144.78,2127.29
buyer_8,Antonio,45,ES37209501030856981675,TRX_N-130-308126714680,2020-12-01T20:23:00,Labastida,transfer,Bonus,2307.43,6627.09
buyer_8,Antonio,45,ES37209501030856981675,TRX_N-131-953728113479,2020-12-05T09:53:13,Labastida,Housing,Mortgage,-921.75,5705.34
buyer_8,Antonio,45,ES37209501030856981675,TRX_N-132-753565360669,2020-12-05T16:54:38,Labastida,Basic services,electricity,-35.55,5669.79
buyer_8,Antonio,45,ES37209501030856981675,TRX_N-133-498049908577,2020-12-06T08:42:58,Labastida,Basic services,water,-65.66,5604.13
buyer_8,Antonio,45,ES37209501030856981675,TRX_N-134-211730841475,2020-12-06T20:03:45,Labastida,Basic services,electricity,-35.59,5568.54
buyer_8,Antonio,45,ES37209501030856981675,TRX_N-135-735924124250,2020-12-07T05:03:29,Labastida,Basic services,water,-40.3,5528.24
buyer_8,Antonio,45,ES37209501030856981675,TRX_N-136-431342022678,2020-12-07T10:44:15,Labastida,Basic services,internet,-38.63,5489.61
buyer_8,Antonio,45,ES37209501030856981675,TRX_N-137-790530188711,2020-12-07T15:19:01,Labastida,Basic services,phone,-64.9,5424.71
buyer_8,Antonio,45,ES37209501030856981675,TRX_N-138-523505270531,2020-12-09T19:54:31,Labastida,Expense,clothing,-374.73,5049.98
buyer_8,Antonio,45,ES37209501030856981675,TRX_N-139-99994228257,2020-12-21T22:40:29,Labastida,Expense,food,-562.94,4487.04
buyer_8,Antonio,45,ES37209501030856981675,TRX_N-14-254122591366,2020-02-05T17:01:40,Labastida,Housing,Mortgage,-921.75,1205.54
buyer_8,Antonio,45,ES37209501030856981675,TRX_N-140-705192894512,2020-12-29T16:28:48,Labastida,Expense,food,-593.72,3893.32
buyer_8,Antonio,45,ES37209501030856981675,TRX_N-141-482482127296,2021-01-01T15:29:50,Labastida,transfer,Salary,2144.78,6038.1
buyer_8,Antonio,45,ES37209501030856981675,TRX_N-142-784730183342,2021-01-05T05:43:16,Labastida,Housing,Mortgage,-921.75,5116.35
buyer_8,Antonio,45,ES37209501030856981675,TRX_N-143-431267014680,2021-01-05T09:48:04,Labastida,Basic services,water,-21.25,5095.1
buyer_8,Antonio,45,ES37209501030856981675,TRX_N-144-527901101751,2021-01-05T12:26:09,Labastida,Basic services,gas,-16.35,5078.75
buyer_8,Antonio,45,ES37209501030856981675,TRX_N-145-787822760155,2021-01-06T09:13:39,Labastida,Basic services,gas,-51.55,5027.2
buyer_8,Antonio,45,ES37209501030856981675,TRX_N-146-714382029827,2021-01-06T22:42:44,Labastida,Basic services,internet,-34.99,4992.21
buyer_8,Antonio,45,ES37209501030856981675,TRX_N-147-882494079099,2021-01-06T09:46:51,Labastida,Basic services,phone,-57.93,4934.28
buyer_8,Antonio,45,ES37209501030856981675,TRX_N-148-58420887454,2021-01-06T12:03:48,Labastida,Expense,food,-785.06,4149.22
buyer_8,Antonio,45,ES37209501030856981675,TRX_N-149-603233710889,2021-01-09T16:22:10,Labastida,Expense,clothing,-69.76,4079.46
buyer_8,Antonio,45,ES37209501030856981675,TRX_N-15-507486346963,2020-02-05T00:21:57,Labastida,Basic services,gas,-77.79,1127.75
buyer_8,Antonio,45,ES37209501030856981675,TRX_N-150-421493587225,2021-01-13T18:40:46,Labastida,Expense,food,-270.53,3808.93
buyer_8,Antonio,45,ES37209501030856981675,TRX_N-151-949066692585,2021-01-19T22:33:25,Labastida,Expense,healthcare,-262.6,3546.33
buyer_8,Antonio,45,ES37209501030856981675,TRX_N-152-914518319218,2021-02-01T12:59:53,Labastida,transfer,Salary,2144.78,5691.11
buyer_8,Antonio,45,ES37209501030856981675,TRX_N-153-168728577109,2021-02-05T09:34:23,Labastida,Housing,Mortgage,-921.75,4769.36
buyer_8,Antonio,45,ES37209501030856981675,TRX_N-154-494769978318,2021-02-05T04:05:09,Labastida,Basic services,electricity,-69.55,4699.81
buyer_8,Antonio,45,ES37209501030856981675,TRX_N-155-30062192901,2021-02-06T18:32:39,Labastida,Basic services,water,-18.53,4681.28
buyer_8,Antonio,45,ES37209501030856981675,TRX_N-156-509504226382,2021-02-07T19:18:42,Labastida,Basic services,gas,-68.96,4612.32
buyer_8,Antonio,45,ES37209501030856981675,TRX_N-157-357604498465,2021-02-11T18:56:22,Labastida,Expense,transport,-40.74,4571.58
buyer_8,Antonio,45,ES37209501030856981675,TRX_N-158-625987054408,2021-03-01T14:26:58,Labastida,transfer,Salary,2144.78,6716.36
buyer_8,Antonio,45,ES37209501030856981675,TRX_N-159-516073615883,2021-03-01T14:26:58,Labastida,transfer,Extra Income,214.48,6930.84
buyer_8,Antonio,45,ES37209501030856981675,TRX_N-16-66271645725,2020-02-05T03:37:36,Labastida,Basic services,phone,-72.43,1055.32
buyer_8,Antonio,45,ES37209501030856981675,TRX_N-160-50380915015,2021-03-05T18:11:54,Labastida,Housing,Mortgage,-921.75,6009.09
buyer_8,Antonio,45,ES37209501030856981675,TRX_N-161-612186054634,2021-03-05T10:14:59,Labastida,Expense,clothing,-138.71,5870.38
buyer_8,Antonio,45,ES37209501030856981675,TRX_N-162-654762505294,2021-03-06T08:39:09,Labastida,Basic services,water,-48.8,5821.58
buyer_8,Antonio,45,ES37209501030856981675,TRX_N-163-685852806734,2021-03-07T09:43:51,Labastida,Basic services,internet,-63.54,5758.04
buyer_8,Antonio,45,ES37209501030856981675,TRX_N-164-719260318811,2021-03-07T17:58:56,Labastida,Basic services,phone,-42.26,5715.78
buyer_8,Antonio,45,ES37209501030856981675,TRX_N-165-835425245492,2021-03-10T20:14:34,Labastida,Expense,travel,-2258.77,3457.01
buyer_8,Antonio,45,ES37209501030856981675,TRX_N-166-19269563185,2021-04-01T20:08:59,Labastida,transfer,Salary,2144.78,5601.79
buyer_8,Antonio,45,ES37209501030856981675,TRX_N-167-836296931147,2021-04-05T14:16:44,Labastida,Housing,Mortgage,-921.75,4680.04
buyer_8,Antonio,45,ES37209501030856981675,TRX_N-168-1511273704,2021-04-05T15:34:46,Labastida,Basic services,electricity,-69.77,4610.27
buyer_8,Antonio,45,ES37209501030856981675,TRX_N-169-434112274741,2021-04-06T15:20:33,Labastida,Basic services,electricity,-145.98,4464.29
buyer_8,Antonio,45,ES37209501030856981675,TRX_N-17-393332814288,2020-02-06T22:29:21,Labastida,Basic services,water,-55.74,999.58
buyer_8,Antonio,45,ES37209501030856981675,TRX_N-170-417386946136,2021-04-06T12:14:09,Labastida,Basic services,internet,-54.06,4410.23
buyer_8,Antonio,45,ES37209501030856981675,TRX_N-171-41855999292,2021-04-06T09:10:33,Labastida,Basic services,phone,-89.49,4320.74
buyer_8,Antonio,45,ES37209501030856981675,TRX_N-172-185194684149,2021-04-09T10:05:06,Labastida,Expense,leisure,-127.84,4192.9
buyer_8,Antonio,45,ES37209501030856981675,TRX_N-173-100541278993,2021-04-12T12:59:52,Labastida,Expense,transport,-129.97,4062.93
buyer_8,Antonio,45,ES37209501030856981675,TRX_N-174-818703831405,2021-04-13T16:51:02,Labastida,Expense,gifts,-143.72,3919.21
buyer_8,Antonio,45,ES37209501030856981675,TRX_N-175-917288496813,2021-05-01T12:14:13,Labastida,transfer,Salary,2144.78,6063.99
buyer_8,Antonio,45,ES37209501030856981675,TRX_N-176-826736343834,2021-05-01T12:14:13,Labastida,transfer,Extra Income,214.48,6278.47
buyer_8,Antonio,45,ES37209501030856981675,TRX_N-177-34352325675,2021-05-02T18:35:15,Labastida,Expense,transport,-132.88,6145.59
buyer_8,Antonio,45,ES37209501030856981675,TRX_N-178-130918420163,2021-05-02T16:30:23,Labastida,Expense,clothing,-170.09,5975.5
buyer_8,Antonio,45,ES37209501030856981675,TRX_N-179-44684094926,2021-05-05T09:16:57,Labastida,Housing,Mortgage,-921.75,5053.75
buyer_8,Antonio,45,ES37209501030856981675,TRX_N-18-515909224531,2020-02-06T14:47:40,Labastida,Basic services,internet,-30.74,968.84
buyer_8,Antonio,45,ES37209501030856981675,TRX_N-180-114212517205,2021-05-05T11:50:59,Labastida,Basic services,gas,-23.75,5030.0
buyer_8,Antonio,45,ES37209501030856981675,TRX_N-181-395407506798,2021-05-05T14:56:16,Labastida,Basic services,phone,-74.42,4955.58
buyer_8,Antonio,45,ES37209501030856981675,TRX_N-182-740545843057,2021-05-06T11:38:44,Labastida,Basic services,electricity,-27.02,4928.56
buyer_8,Antonio,45,ES37209501030856981675,TRX_N-183-534245718782,2021-05-16T11:55:07,Labastida,Expense,gifts,-59.5,4869.06
buyer_8,Antonio,45,ES37209501030856981675,TRX_N-184-361533380326,2021-05-19T12:32:11,Labastida,Expense,leisure,-225.38,4643.68
buyer_8,Antonio,45,ES37209501030856981675,TRX_N-185-836916836575,2021-05-29T10:05:13,Labastida,Expense,transport,-95.44,4548.24
buyer_8,Antonio,45,ES37209501030856981675,TRX_N-186-281831233594,2021-06-01T17:53:38,Labastida,transfer,Salary,2144.78,6693.02
buyer_8,Antonio,45,ES37209501030856981675,TRX_N-187-906329291571,2021-06-01T17:53:38,Labastida,transfer,Bonus,2345.4,9038.42
buyer_8,Antonio,45,ES37209501030856981675,TRX_N-188-515125594849,2021-06-05T11:31:24,Labastida,Housing,Mortgage,-921.75,8116.67
buyer_8,Antonio,45,ES37209501030856981675,TRX_N-189-45337326865,2021-06-05T19:26:26,Labastida,Basic services,electricity,-99.83,8016.84
buyer_8,Antonio,45,ES37209501030856981675,TRX_N-19-222544655658,2020-02-06T18:42:35,Labastida,Basic services,phone,-77.81,891.03
buyer_8,Antonio,45,ES37209501030856981675,TRX_N-190-462636170599,2021-06-05T14:14:11,Labastida,Basic services,gas,-79.43,7937.41
buyer_8,Antonio,45,ES37209501030856981675,TRX_N-191-794181694372,2021-06-05T09:27:11,Labastida,Basic services,internet,-60.68,7876.73
buyer_8,Antonio,45,ES37209501030856981675,TRX_N-192-788910414536,2021-06-06T20:08:54,Labastida,Basic services,electricity,-31.96,7844.77
buyer_8,Antonio,45,ES37209501030856981675,TRX_N-193-497477441369,2021-06-06T09:31:09,Labastida,Basic services,gas,-51.98,7792.79
buyer_8,Antonio,45,ES37209501030856981675,TRX_N-194-882081342005,2021-06-06T18:28:20,Labastida,Expense,leisure,-257.89,7534.9
buyer_8,Antonio,45,ES37209501030856981675,TRX_N-195-687490661467,2021-06-08T21:54:52,Labastida,Expense,leisure,-86.47,7448.43
buyer_8,Antonio,45,ES37209501030856981675,TRX_N-196-810102055575,2021-06-23T14:38:56,Labastida,Expense,clothing,-124.59,7323.84
buyer_8,Antonio,45,ES37209501030856981675,TRX_N-197-372371104261,2021-06-25T16:22:15,Labastida,Expense,transport,-35.06,7288.78
buyer_8,Antonio,45,ES37209501030856981675,TRX_N-198-843471207389,2021-06-30T11:37:56,Erandio,Expense,gifts,-256.12,7032.66
buyer_8,Antonio,45,ES37209501030856981675,TRX_N-199-872495735050,2021-07-01T18:17:01,Labastida,transfer,Salary,2144.78,9177.44
buyer_8,Antonio,45,ES37209501030856981675,TRX_N-2-839617988356,2020-01-04T10:17:49,Labastida,Expense,transport,-60.6,3893.84
buyer_8,Antonio,45,ES37209501030856981675,TRX_N-20-348013446716,2020-02-07T09:34:19,Labastida,Basic services,electricity,-56.08,834.95
buyer_8,Antonio,45,ES37209501030856981675,TRX_N-200-316654737479,2021-07-01T18:17:01,Labastida,transfer,Extra Income,214.48,9391.92
buyer_8,Antonio,45,ES37209501030856981675,TRX_N-201-904423411431,2021-07-01T18:37:13,Labastida,Expense,clothing,-401.89,8990.03
buyer_8,Antonio,45,ES37209501030856981675,TRX_N-202-493426862514,2021-07-05T18:31:26,Labastida,Housing,Mortgage,-921.75,8068.28
buyer_8,Antonio,45,ES37209501030856981675,TRX_N-203-481431244313,2021-07-05T18:39:44,Labastida,Basic services,internet,-48.09,8020.19
buyer_8,Antonio,45,ES37209501030856981675,TRX_N-204-431798089416,2021-07-06T16:21:06,Labastida,Basic services,water,-30.3,7989.89
buyer_8,Antonio,45,ES37209501030856981675,TRX_N-205-82567077320,2021-07-06T11:55:16,Labastida,Basic services,internet,-73.29,7916.6
buyer_8,Antonio,45,ES37209501030856981675,TRX_N-206-595031479148,2021-07-06T09:18:22,Labastida,Basic services,phone,-39.98,7876.62
buyer_8,Antonio,45,ES37209501030856981675,TRX_N-207-946286002161,2021-07-07T09:31:47,Labastida,Basic services,electricity,-80.17,7796.45
buyer_8,Antonio,45,ES37209501030856981675,TRX_N-208-893410350762,2021-07-07T08:03:49,Labastida,Expense,food,-640.32,7156.13
buyer_8,Antonio,45,ES37209501030856981675,TRX_N-209-977473001966,2021-07-11T23:18:49,Labastida,Expense,food,-367.95,6788.18
buyer_8,Antonio,45,ES37209501030856981675,TRX_N-21-556304514718,2020-02-07T20:35:14,Labastida,Basic services,gas,-65.91,769.04
buyer_8,Antonio,45,ES37209501030856981675,TRX_N-210-581104523794,2021-07-14T20:16:24,Salvatierra/Agurain,Expense,clothing,-66.6,6721.58
buyer_8,Antonio,45,ES37209501030856981675,TRX_N-211-93224382803,2021-07-16T13:22:15,Labastida,Expense,food,-470.93,6250.65
buyer_8,Antonio,45,ES37209501030856981675,TRX_N-212-34588034248,2021-07-26T14:02:08,Mungia,Expense,food,-755.87,5494.78
buyer_8,Antonio,45,ES37209501030856981675,TRX_N-213-334055122729,2021-07-27T14:25:34,Barakaldo,Expense,healthcare,-357.9,5136.88
buyer_8,Antonio,45,ES37209501030856981675,TRX_N-214-658221798185,2021-08-01T12:57:55,Labastida,transfer,Salary,2144.78,7281.66
buyer_8,Antonio,45,ES37209501030856981675,TRX_N-215-928127310068,2021-08-04T11:53:25,Labastida,Expense,leisure,-232.39,7049.27
buyer_8,Antonio,45,ES37209501030856981675,TRX_N-216-472585578362,2021-08-05T11:21:15,Labastida,Housing,Mortgage,-921.75,6127.52
buyer_8,Antonio,45,ES37209501030856981675,TRX_N-217-971518623411,2021-08-05T11:41:24,Labastida,Expense,clothing,-440.16,5687.36
buyer_8,Antonio,45,ES37209501030856981675,TRX_N-218-263532275037,2021-08-06T12:18:42,Labastida,Basic services,gas,-23.04,5664.32
buyer_8,Antonio,45,ES37209501030856981675,TRX_N-219-686095693534,2021-08-06T14:34:17,Labastida,Basic services,phone,-69.54,5594.78
buyer_8,Antonio,45,ES37209501030856981675,TRX_N-22-12102121918,2020-02-07T00:59:06,Labastida,Basic services,internet,-43.08,725.96
buyer_8,Antonio,45,ES37209501030856981675,TRX_N-220-485682451923,2021-08-07T12:20:45,Labastida,Basic services,water,-60.61,5534.17
buyer_8,Antonio,45,ES37209501030856981675,TRX_N-221-977127089607,2021-08-07T23:45:52,Labastida,Basic services,gas,-52.52,5481.65
buyer_8,Antonio,45,ES37209501030856981675,TRX_N-222-258573328769,2021-08-28T11:55:13,Labastida,Expense,repairs,-368.96,5112.69
buyer_8,Antonio,45,ES37209501030856981675,TRX_N-223-533120169797,2021-09-01T13:28:29,Labastida,transfer,Salary,2144.78,7257.47
buyer_8,Antonio,45,ES37209501030856981675,TRX_N-224-722809818224,2021-09-01T22:49:06,Labastida,Expense,leisure,-202.56,7054.91
buyer_8,Antonio,45,ES37209501030856981675,TRX_N-225-682123268221,2021-09-05T13:31:49,Labastida,Housing,Mortgage,-921.75,6133.16
buyer_8,Antonio,45,ES37209501030856981675,TRX_N-226-888739758193,2021-09-06T20:53:56,Labastida,Basic services,gas,-56.68,6076.48
buyer_8,Antonio,45,ES37209501030856981675,TRX_N-227-857803886780,2021-09-19T09:43:21,Labastida,Expense,leisure,-29.1,6047.38
buyer_8,Antonio,45,ES37209501030856981675,TRX_N-228-136965681723,2021-10-01T17:43:41,Labastida,transfer,Salary,2144.78,8192.16
buyer_8,Antonio,45,ES37209501030856981675,TRX_N-229-787099069321,2021-10-01T17:43:41,Labastida,transfer,Extra Income,214.48,8406.64
buyer_8,Antonio,45,ES37209501030856981675,TRX_N-23-38361213063,2020-02-07T15:10:02,Labastida,Basic services,phone,-61.8,664.16
buyer_8,Antonio,45,ES37209501030856981675,TRX_N-230-856740141659,2021-10-03T09:48:31,Labastida,Expense,repairs,-566.14,7840.5
buyer_8,Antonio,45,ES37209501030856981675,TRX_N-231-692556170408,2021-10-05T09:43:04,Labastida,Housing,Mortgage,-921.75,6918.75
buyer_8,Antonio,45,ES37209501030856981675,TRX_N-232-68075920231,2021-10-05T19:05:55,Labastida,Basic services,electricity,-69.48,6849.27
buyer_8,Antonio,45,ES37209501030856981675,TRX_N-233-873063090126,2021-10-07T10:57:18,Labastida,Basic services,water,-21.73,6827.54
buyer_8,Antonio,45,ES37209501030856981675,TRX_N-234-751887465572,2021-10-07T15:39:16,Labastida,Basic services,internet,-64.64,6762.9
buyer_8,Antonio,45,ES37209501030856981675,TRX_N-235-183021811181,2021-10-07T16:29:14,Labastida,Expense,leisure,-290.78,6472.12
buyer_8,Antonio,45,ES37209501030856981675,TRX_N-236-589340318273,2021-10-11T10:54:30,Labastida,Expense,transport,-158.31,6313.81
buyer_8,Antonio,45,ES37209501030856981675,TRX_N-237-733034563366,2021-11-01T08:40:09,Labastida,transfer,Salary,2144.78,8458.59
buyer_8,Antonio,45,ES37209501030856981675,TRX_N-238-837334648586,2021-11-03T16:51:37,Labastida,Expense,education,-95.44,8363.15
buyer_8,Antonio,45,ES37209501030856981675,TRX_N-239-891796386760,2021-11-05T10:02:44,Labastida,Housing,Mortgage,-921.75,7441.4
buyer_8,Antonio,45,ES37209501030856981675,TRX_N-24-271959496143,2020-02-14T12:34:41,Labastida,Expense,leisure,-122.13,542.03
buyer_8,Antonio,45,ES37209501030856981675,TRX_N-240-913889337912,2021-11-05T15:58:06,Labastida,Basic services,water,-12.2,7429.2
buyer_8,Antonio,45,ES37209501030856981675,TRX_N-241-475449714612,2021-11-05T14:52:03,Labastida,Basic services,phone,-67.83,7361.37
buyer_8,Antonio,45,ES37209501030856981675,TRX_N-242-86427747724,2021-11-07T09:57:30,Labastida,Basic services,gas,-42.29,7319.08
buyer_8,Antonio,45,ES37209501030856981675,TRX_N-243-535393823016,2021-11-07T08:51:10,Labastida,Basic services,internet,-34.41,7284.67
buyer_8,Antonio,45,ES37209501030856981675,TRX_N-244-687853748207,2021-11-07T09:55:53,Labastida,Basic services,phone,-70.09,7214.58
buyer_8,Antonio,45,ES37209501030856981675,TRX_N-245-673546333884,2021-11-20T13:18:45,Labastida,Expense,repairs,-845.97,6368.61
buyer_8,Antonio,45,ES37209501030856981675,TRX_N-246-694036737410,2021-11-30T16:41:04,Hernani,Expense,food,-617.84,5750.77
buyer_8,Antonio,45,ES37209501030856981675,TRX_N-247-972748628450,2021-12-01T07:07:00,Labastida,transfer,Salary,2144.78,7895.55
buyer_8,Antonio,45,ES37209501030856981675,TRX_N-248-966191586320,2021-12-01T07:07:00,Labastida,transfer,Bonus,2008.98,9904.53
buyer_8,Antonio,45,ES37209501030856981675,TRX_N-249-951970002871,2021-12-05T22:17:24,Labastida,Housing,Mortgage,-921.75,8982.78
buyer_8,Antonio,45,ES37209501030856981675,TRX_N-25-50078413652,2020-02-27T16:03:14,Labastida,Expense,leisure,-152.18,389.85
buyer_8,Antonio,45,ES37209501030856981675,TRX_N-250-791005955357,2021-12-05T01:16:22,Labastida,Basic services,electricity,-56.5,8926.28
buyer_8,Antonio,45,ES37209501030856981675,TRX_N-251-608936719193,2021-12-05T11:45:03,Labastida,Basic services,internet,-59.45,8866.83
buyer_8,Antonio,45,ES37209501030856981675,TRX_N-252-443825813870,2021-12-06T09:20:08,Labastida,Basic services,internet,-31.86,8834.97
buyer_8,Antonio,45,ES37209501030856981675,TRX_N-253-484549095372,2021-12-06T19:32:22,Labastida,Basic services,phone,-25.75,8809.22
buyer_8,Antonio,45,ES37209501030856981675,TRX_N-254-856905092118,2021-12-07T21:17:28,Labastida,Basic services,electricity,-42.42,8766.8
buyer_8,Antonio,45,ES37209501030856981675,TRX_N-255-858997566536,2021-12-07T07:38:27,Labastida,Basic services,gas,-38.75,8728.05
buyer_8,Antonio,45,ES37209501030856981675,TRX_N-256-962680346115,2021-12-17T10:32:55,Labastida,Expense,clothing,-459.83,8268.22
buyer_8,Antonio,45,ES37209501030856981675,TRX_N-257-235908038900,2021-12-26T21:59:33,Labastida,Expense,food,-352.99,7915.23
buyer_8,Antonio,45,ES37209501030856981675,TRX_N-258-754198376159,2021-12-26T10:23:42,Labastida,Expense,transport,-160.19,7755.04
buyer_8,Antonio,45,ES37209501030856981675,TRX_N-259-231142621445,2021-12-29T19:22:13,Labastida,Expense,education,-446.15,7308.89
buyer_8,Antonio,45,ES37209501030856981675,TRX_N-26-790245030008,2020-03-01T20:07:00,Labastida,transfer,Salary,2144.78,2534.63
buyer_8,Antonio,45,ES37209501030856981675,TRX_N-260-908170310154,2022-01-01T22:31:33,Labastida,transfer,Salary,2144.78,9453.67
buyer_8,Antonio,45,ES37209501030856981675,TRX_N-261-24155919066,2022-01-01T22:31:33,Labastida,transfer,Extra Income,214.48,9668.15
buyer_8,Antonio,45,ES37209501030856981675,TRX_N-262-671821694914,2022-01-04T12:48:26,Hernani,Expense,leisure,-298.5,9369.65
buyer_8,Antonio,45,ES37209501030856981675,TRX_N-263-443798395413,2022-01-05T15:48:47,Labastida,Housing,Mortgage,-921.75,8447.9
buyer_8,Antonio,45,ES37209501030856981675,TRX_N-264-123935160831,2022-01-06T18:10:58,Labastida,Basic services,electricity,-133.83,8314.07
buyer_8,Antonio,45,ES37209501030856981675,TRX_N-265-945005675504,2022-01-06T13:42:43,Labastida,Basic services,internet,-61.26,8252.81
buyer_8,Antonio,45,ES37209501030856981675,TRX_N-266-233145884173,2022-01-07T17:05:33,Labastida,Basic services,water,-47.98,8204.83
buyer_8,Antonio,45,ES37209501030856981675,TRX_N-267-114079138885,2022-01-07T08:24:34,Labastida,Basic services,gas,-92.41,8112.42
buyer_8,Antonio,45,ES37209501030856981675,TRX_N-268-891434495484,2022-01-14T17:15:14,Labastida,Expense,food,-384.63,7727.79
buyer_8,Antonio,45,ES37209501030856981675,TRX_N-269-138791351355,2022-01-18T19:59:48,Labastida,Expense,leisure,-107.1,7620.69
buyer_8,Antonio,45,ES37209501030856981675,TRX_N-27-396260771353,2020-03-01T20:07:00,Labastida,transfer,Extra Income,214.48,2749.11
buyer_8,Antonio,45,ES37209501030856981675,TRX_N-270-347813987976,2022-01-28T16:33:58,Labastida,Expense,leisure,-211.78,7408.91
buyer_8,Antonio,45,ES37209501030856981675,TRX_N-271-204442326388,2022-02-01T09:36:07,Labastida,transfer,Salary,2144.78,9553.69
buyer_8,Antonio,45,ES37209501030856981675,TRX_N-272-134262889701,2022-02-05T19:32:15,Labastida,Housing,Mortgage,-921.75,8631.94
buyer_8,Antonio,45,ES37209501030856981675,TRX_N-273-772645536625,2022-02-05T18:50:12,Labastida,Basic services,water,-64.95,8566.99
buyer_8,Antonio,45,ES37209501030856981675,TRX_N-274-558873532305,2022-02-05T01:02:16,Labastida,Basic services,electricity,-83.12,8483.87
buyer_8,Antonio,45,ES37209501030856981675,TRX_N-275-955299103175,2022-02-06T20:40:01,Labastida,Basic services,phone,-55.89,8427.98
buyer_8,Antonio,45,ES37209501030856981675,TRX_N-276-276300728635,2022-02-07T10:29:38,Labastida,Basic services,gas,-29.01,8398.97
buyer_8,Antonio,45,ES37209501030856981675,TRX_N-277-806976133321,2022-02-08T19:41:47,Mungia,Expense,clothing,-137.64,8261.33
buyer_8,Antonio,45,ES37209501030856981675,TRX_N-278-49114457481,2022-02-22T15:17:44,Labastida,Expense,transport,-39.54,8221.79
buyer_8,Antonio,45,ES37209501030856981675,TRX_N-279-952510753405,2022-02-25T21:15:12,Labastida,Expense,gifts,-425.21,7796.58
buyer_8,Antonio,45,ES37209501030856981675,TRX_N-28-623522815739,2020-03-01T19:45:25,Labastida,Expense,gifts,-25.98,2723.13
buyer_8,Antonio,45,ES37209501030856981675,TRX_N-280-476203151196,2022-02-28T14:30:50,Leioa,Expense,leisure,-76.24,7720.34
buyer_8,Antonio,45,ES37209501030856981675,TRX_N-281-816356198005,2022-02-28T17:25:56,Eibar,Expense,clothing,-152.95,7567.39
buyer_8,Antonio,45,ES37209501030856981675,TRX_N-282-226898305590,2022-03-01T12:04:33,Labastida,transfer,Salary,2144.78,9712.17
buyer_8,Antonio,45,ES37209501030856981675,TRX_N-283-102526104853,2022-03-03T16:18:08,Labastida,Expense,transport,-118.27,9593.9
buyer_8,Antonio,45,ES37209501030856981675,TRX_N-284-616130621692,2022-03-05T11:07:51,Labastida,Housing,Mortgage,-921.75,8672.15
buyer_8,Antonio,45,ES37209501030856981675,TRX_N-285-211725950418,2022-03-05T17:07:28,Labastida,Basic services,electricity,-105.94,8566.21
buyer_8,Antonio,45,ES37209501030856981675,TRX_N-286-505130924731,2022-03-05T20:42:40,Labastida,Basic services,phone,-47.98,8518.23
buyer_8,Antonio,45,ES37209501030856981675,TRX_N-287-558016895067,2022-03-06T18:25:47,Labastida,Basic services,electricity,-36.42,8481.81
buyer_8,Antonio,45,ES37209501030856981675,TRX_N-288-367815159282,2022-03-07T09:58:27,Labastida,Basic services,water,-32.33,8449.48
buyer_8,Antonio,45,ES37209501030856981675,TRX_N-289-30180231604,2022-03-07T07:24:03,Labastida,Basic services,internet,-71.89,8377.59
buyer_8,Antonio,45,ES37209501030856981675,TRX_N-29-579753007330,2020-03-05T11:07:48,Labastida,Housing,Mortgage,-921.75,1801.38
buyer_8,Antonio,45,ES37209501030856981675,TRX_N-290-771131794767,2022-03-07T12:48:19,Labastida,Basic services,phone,-36.25,8341.34
buyer_8,Antonio,45,ES37209501030856981675,TRX_N-291-79718672597,2022-03-11T21:42:11,Lasarte-Oria,Expense,clothing,-227.24,8114.1
buyer_8,Antonio,45,ES37209501030856981675,TRX_N-292-892580844757,2022-03-17T12:59:19,Labastida,Expense,food,-112.64,8001.46
buyer_8,Antonio,45,ES37209501030856981675,TRX_N-293-711949921958,2022-03-24T09:06:50,Labastida,Expense,food,-109.71,7891.75
buyer_8,Antonio,45,ES37209501030856981675,TRX_N-294-81443894468,2022-04-01T01:51:56,Labastida,transfer,Salary,2144.78,10036.53
buyer_8,Antonio,45,ES37209501030856981675,TRX_N-295-920508384034,2022-04-01T01:51:56,Labastida,transfer,Extra Income,214.48,10251.01
buyer_8,Antonio,45,ES37209501030856981675,TRX_N-296-464486455779,2022-04-05T18:15:32,Labastida,Housing,Mortgage,-921.75,9329.26
buyer_8,Antonio,45,ES37209501030856981675,TRX_N-297-880801924962,2022-04-06T12:32:18,Labastida,Basic services,gas,-95.02,9234.24
buyer_8,Antonio,45,ES37209501030856981675,TRX_N-298-274556742511,2022-04-06T22:10:30,Labastida,Basic services,phone,-28.19,9206.05
buyer_8,Antonio,45,ES37209501030856981675,TRX_N-299-188213232212,2022-04-07T00:58:06,Labastida,Basic services,electricity,-110.11,9095.94
buyer_8,Antonio,45,ES37209501030856981675,TRX_N-3-476477704501,2020-01-05T20:41:46,Labastida,Housing,Mortgage,-921.75,2972.09
buyer_8,Antonio,45,ES37209501030856981675,TRX_N-30-449537957769,2020-03-05T13:02:28,Labastida,Basic services,electricity,-132.31,1669.07
buyer_8,Antonio,45,ES37209501030856981675,TRX_N-300-602292323897,2022-04-07T02:33:07,Labastida,Basic services,gas,-90.01,9005.93
buyer_8,Antonio,45,ES37209501030856981675,TRX_N-301-971811282290,2022-04-20T17:14:15,Labastida,Expense,travel,-1478.76,7527.17
buyer_8,Antonio,45,ES37209501030856981675,TRX_N-302-208887995892,2022-05-01T14:30:52,Labastida,transfer,Salary,2144.78,9671.95
buyer_8,Antonio,45,ES37209501030856981675,TRX_N-303-911698465512,2022-05-05T10:28:19,Labastida,Housing,Mortgage,-921.75,8750.2
buyer_8,Antonio,45,ES37209501030856981675,TRX_N-304-47841706418,2022-05-05T20:14:07,Labastida,Basic services,water,-25.91,8724.29
buyer_8,Antonio,45,ES37209501030856981675,TRX_N-305-361847896672,2022-05-05T16:44:42,Labastida,Basic services,gas,-42.1,8682.19
buyer_8,Antonio,45,ES37209501030856981675,TRX_N-306-466174502274,2022-05-05T04:57:51,Labastida,Basic services,phone,-53.43,8628.76
buyer_8,Antonio,45,ES37209501030856981675,TRX_N-307-973915859880,2022-05-05T10:48:55,Salvatierra/Agurain,Expense,leisure,-255.36,8373.4
buyer_8,Antonio,45,ES37209501030856981675,TRX_N-308-982683336174,2022-05-06T10:40:00,Labastida,Basic services,internet,-47.76,8325.64
buyer_8,Antonio,45,ES37209501030856981675,TRX_N-309-614777234944,2022-05-06T09:42:22,Labastida,Basic services,phone,-42.26,8283.38
buyer_8,Antonio,45,ES37209501030856981675,TRX_N-31-124343378645,2020-03-06T10:42:28,Labastida,Basic services,water,-55.78,1613.29
buyer_8,Antonio,45,ES37209501030856981675,TRX_N-310-110105929976,2022-05-13T08:59:01,Labastida,Expense,transport,-149.38,8134.0
buyer_8,Antonio,45,ES37209501030856981675,TRX_N-311-190536904447,2022-05-14T09:42:59,Labastida,Expense,education,-608.36,7525.64
buyer_8,Antonio,45,ES37209501030856981675,TRX_N-312-72559636458,2022-05-17T22:59:28,Labastida,Expense,clothing,-427.98,7097.66
buyer_8,Antonio,45,ES37209501030856981675,TRX_N-313-117365553562,2022-05-20T11:55:09,Labastida,Expense,transport,-145.13,6952.53
buyer_8,Antonio,45,ES37209501030856981675,TRX_N-314-109579860309,2022-05-23T20:18:27,Labastida,Expense,food,-648.51,6304.02
buyer_8,Antonio,45,ES37209501030856981675,TRX_N-315-650461602471,2022-05-23T10:26:26,Labastida,Expense,transport,-64.29,6239.73
buyer_8,Antonio,45,ES37209501030856981675,TRX_N-316-428088987809,2022-05-24T09:01:33,Labastida,Expense,leisure,-49.39,6190.34
buyer_8,Antonio,45,ES37209501030856981675,TRX_N-317-167185626406,2022-06-01T11:47:44,Labastida,transfer,Salary,2144.78,8335.12
buyer_8,Antonio,45,ES37209501030856981675,TRX_N-318-313942076173,2022-06-01T11:47:44,Labastida,transfer,Bonus,2098.38,10433.5
buyer_8,Antonio,45,ES37209501030856981675,TRX_N-319-475511392401,2022-06-04T15:28:58,Labastida,Expense,gifts,-379.74,10053.76
buyer_8,Antonio,45,ES37209501030856981675,TRX_N-32-465637829968,2020-03-06T14:01:07,Labastida,Basic services,electricity,-54.64,1558.65
buyer_8,Antonio,45,ES37209501030856981675,TRX_N-320-508724770076,2022-06-05T19:34:57,Labastida,Housing,Mortgage,-921.75,9132.01
buyer_8,Antonio,45,ES37209501030856981675,TRX_N-321-37880340269,2022-06-06T03:01:12,Labastida,Basic services,gas,-49.33,9082.68
buyer_8,Antonio,45,ES37209501030856981675,TRX_N-322-941333312547,2022-06-06T23:04:24,Labastida,Basic services,phone,-24.36,9058.32
buyer_8,Antonio,45,ES37209501030856981675,TRX_N-323-18464958620,2022-06-07T19:22:37,Labastida,Basic services,gas,-44.75,9013.57
buyer_8,Antonio,45,ES37209501030856981675,TRX_N-324-279739857324,2022-06-14T13:32:30,Labastida,Expense,transport,-32.78,8980.79
buyer_8,Antonio,45,ES37209501030856981675,TRX_N-325-753037777418,2022-07-01T13:42:04,Labastida,transfer,Salary,2144.78,11125.57
buyer_8,Antonio,45,ES37209501030856981675,TRX_N-326-123525406396,2022-07-01T13:42:04,Labastida,transfer,Extra Income,214.48,11340.05
buyer_8,Antonio,45,ES37209501030856981675,TRX_N-327-527058120242,2022-07-01T11:03:50,Labastida,Expense,food,-643.9,10696.15
buyer_8,Antonio,45,ES37209501030856981675,TRX_N-328-677728080237,2022-07-05T16:34:01,Labastida,Housing,Mortgage,-921.75,9774.4
buyer_8,Antonio,45,ES37209501030856981675,TRX_N-329-390213480220,2022-07-05T10:26:18,Labastida,Basic services,water,-10.38,9764.02
buyer_8,Antonio,45,ES37209501030856981675,TRX_N-33-1503274014,2020-03-06T12:27:00,Labastida,Basic services,internet,-39.82,1518.83
buyer_8,Antonio,45,ES37209501030856981675,TRX_N-330-774622382757,2022-07-06T17:56:42,Labastida,Basic services,water,-15.8,9748.22
buyer_8,Antonio,45,ES37209501030856981675,TRX_N-331-907158072295,2022-07-06T20:08:26,Labastida,Basic services,electricity,-20.42,9727.8
buyer_8,Antonio,45,ES37209501030856981675,TRX_N-332-33051807340,2022-07-06T10:42:18,Labastida,Basic services,phone,-75.7,9652.1
buyer_8,Antonio,45,ES37209501030856981675,TRX_N-333-994839178815,2022-07-07T20:01:36,Labastida,Basic services,water,-19.26,9632.84
buyer_8,Antonio,45,ES37209501030856981675,TRX_N-334-197842230833,2022-07-07T23:14:06,Labastida,Basic services,phone,-70.95,9561.89
buyer_8,Antonio,45,ES37209501030856981675,TRX_N-335-569520772142,2022-07-12T23:26:50,Santurtzi,Expense,transport,-108.95,9452.94
buyer_8,Antonio,45,ES37209501030856981675,TRX_N-336-607814283960,2022-07-13T20:22:26,Labastida,Expense,food,-560.77,8892.17
buyer_8,Antonio,45,ES37209501030856981675,TRX_N-337-660493053984,2022-07-22T00:00:06,Labastida,Expense,travel,-969.71,7922.46
buyer_8,Antonio,45,ES37209501030856981675,TRX_N-338-506179814245,2022-07-24T17:13:16,Labastida,Expense,healthcare,-275.75,7646.71
buyer_8,Antonio,45,ES37209501030856981675,TRX_N-339-124135349893,2022-08-01T18:11:49,Labastida,transfer,Salary,2144.78,9791.49
buyer_8,Antonio,45,ES37209501030856981675,TRX_N-34-329114257,2020-03-06T17:59:31,Labastida,Basic services,phone,-46.55,1472.28
buyer_8,Antonio,45,ES37209501030856981675,TRX_N-340-869531809172,2022-08-05T12:38:08,Labastida,Housing,Mortgage,-921.75,8869.74
buyer_8,Antonio,45,ES37209501030856981675,TRX_N-341-770809127799,2022-08-05T15:13:47,Labastida,Basic services,gas,-24.06,8845.68
buyer_8,Antonio,45,ES37209501030856981675,TRX_N-342-816769398323,2022-08-05T01:16:54,Labastida,Expense,clothing,-413.46,8432.22
buyer_8,Antonio,45,ES37209501030856981675,TRX_N-343-556750662773,2022-08-06T14:07:19,Labastida,Basic services,water,-68.87,8363.35
buyer_8,Antonio,45,ES37209501030856981675,TRX_N-344-99155774575,2022-08-07T07:12:24,Labastida,Basic services,internet,-78.78,8284.57
buyer_8,Antonio,45,ES37209501030856981675,TRX_N-345-987688805420,2022-08-07T12:53:31,Labastida,Basic services,phone,-33.86,8250.71
buyer_8,Antonio,45,ES37209501030856981675,TRX_N-346-991945136122,2022-08-29T08:33:34,Elciego,Expense,education,-961.47,7289.24
buyer_8,Antonio,45,ES37209501030856981675,TRX_N-347-304419203445,2022-09-01T11:57:15,Labastida,transfer,Salary,2144.78,9434.02
buyer_8,Antonio,45,ES37209501030856981675,TRX_N-348-898300520425,2022-09-01T11:57:15,Labastida,transfer,Extra Income,214.48,9648.5
buyer_8,Antonio,45,ES37209501030856981675,TRX_N-349-603191618890,2022-09-05T13:39:46,Labastida,Housing,Mortgage,-921.75,8726.75
buyer_8,Antonio,45,ES37209501030856981675,TRX_N-35-858229770645,2020-03-07T13:22:13,Labastida,Basic services,electricity,-118.76,1353.52
buyer_8,Antonio,45,ES37209501030856981675,TRX_N-350-454404368688,2022-09-06T00:31:52,Labastida,Basic services,water,-78.33,8648.42
buyer_8,Antonio,45,ES37209501030856981675,TRX_N-351-639425446851,2022-09-06T16:01:51,Labastida,Basic services,electricity,-33.85,8614.57
buyer_8,Antonio,45,ES37209501030856981675,TRX_N-352-196624058219,2022-09-06T08:04:50,Labastida,Basic services,internet,-36.03,8578.54
buyer_8,Antonio,45,ES37209501030856981675,TRX_N-353-367580079580,2022-09-07T11:37:03,Labastida,Basic services,electricity,-63.76,8514.78
buyer_8,Antonio,45,ES37209501030856981675,TRX_N-354-567338917118,2022-09-07T19:13:27,Labastida,Basic services,phone,-24.95,8489.83
buyer_8,Antonio,45,ES37209501030856981675,TRX_N-355-743167435367,2022-09-14T01:26:59,Labastida,Expense,food,-657.1,7832.73
buyer_8,Antonio,45,ES37209501030856981675,TRX_N-356-628726385017,2022-09-19T10:27:38,Labastida,Expense,transport,-109.07,7723.66
buyer_8,Antonio,45,ES37209501030856981675,TRX_N-357-620504968867,2022-09-29T19:55:49,Llodio,Expense,healthcare,-106.05,7617.61
buyer_8,Antonio,45,ES37209501030856981675,TRX_N-358-492351069656,2022-10-01T19:57:21,Labastida,transfer,Salary,2144.78,9762.39
buyer_8,Antonio,45,ES37209501030856981675,TRX_N-359-478848246545,2022-10-05T12:34:59,Labastida,Housing,Mortgage,-921.75,8840.64
buyer_8,Antonio,45,ES37209501030856981675,TRX_N-36-420891359112,2020-03-07T13:41:18,Labastida,Basic services,gas,-50.7,1302.82
buyer_8,Antonio,45,ES37209501030856981675,TRX_N-360-879382662117,2022-10-05T15:59:50,Labastida,Basic services,internet,-35.88,8804.76
buyer_8,Antonio,45,ES37209501030856981675,TRX_N-361-826237673202,2022-10-06T09:19:15,Labastida,Basic services,phone,-85.01,8719.75
buyer_8,Antonio,45,ES37209501030856981675,TRX_N-362-99218416085,2022-10-07T22:14:25,Labastida,Basic services,internet,-33.22,8686.53
buyer_8,Antonio,45,ES37209501030856981675,TRX_N-363-616528048084,2022-10-07T19:10:17,Labastida,Basic services,phone,-83.77,8602.76
buyer_8,Antonio,45,ES37209501030856981675,TRX_N-364-218790371882,2022-10-09T10:32:33,Labastida,Expense,clothing,-129.98,8472.78
buyer_8,Antonio,45,ES37209501030856981675,TRX_N-365-756197416824,2022-10-16T15:02:20,Labastida,Expense,healthcare,-70.75,8402.03
buyer_8,Antonio,45,ES37209501030856981675,TRX_N-366-758488585734,2022-10-25T19:17:01,Bermeo,Expense,leisure,-286.37,8115.66
buyer_8,Antonio,45,ES37209501030856981675,TRX_N-367-930505366212,2022-10-28T14:30:38,Santurtzi,Expense,leisure,-230.03,7885.63
buyer_8,Antonio,45,ES37209501030856981675,TRX_N-368-442542305738,2022-11-01T14:56:26,Labastida,transfer,Salary,2144.78,10030.41
buyer_8,Antonio,45,ES37209501030856981675,TRX_N-369-61551681956,2022-11-01T14:56:26,Labastida,transfer,Extra Income,214.48,10244.89
buyer_8,Antonio,45,ES37209501030856981675,TRX_N-37-231796646931,2020-03-07T20:27:26,Labastida,Basic services,internet,-71.49,1231.33
buyer_8,Antonio,45,ES37209501030856981675,TRX_N-370-859505521457,2022-11-05T11:06:04,Labastida,Housing,Mortgage,-921.75,9323.14
buyer_8,Antonio,45,ES37209501030856981675,TRX_N-371-922871475683,2022-11-05T17:49:57,Labastida,Basic services,internet,-74.74,9248.4
buyer_8,Antonio,45,ES37209501030856981675,TRX_N-372-809923796685,2022-11-06T09:53:59,Labastida,Basic services,electricity,-99.36,9149.04
buyer_8,Antonio,45,ES37209501030856981675,TRX_N-373-261888632051,2022-11-06T20:47:35,Labastida,Basic services,internet,-40.31,9108.73
buyer_8,Antonio,45,ES37209501030856981675,TRX_N-374-653584497072,2022-11-23T08:38:34,Iruña de Oca,Expense,healthcare,-345.47,8763.26
buyer_8,Antonio,45,ES37209501030856981675,TRX_N-375-876128534884,2022-11-24T13:22:27,Llodio,Expense,transport,-134.77,8628.49
buyer_8,Antonio,45,ES37209501030856981675,TRX_N-376-61705185191,2022-11-30T21:17:25,Labastida,Expense,clothing,-375.22,8253.27
buyer_8,Antonio,45,ES37209501030856981675,TRX_N-377-459873496459,2022-12-01T15:53:19,Labastida,transfer,Salary,2144.78,10398.05
buyer_8,Antonio,45,ES37209501030856981675,TRX_N-378-23281997353,2022-12-01T15:53:19,Labastida,transfer,Bonus,1937.81,12335.86
buyer_8,Antonio,45,ES37209501030856981675,TRX_N-379-597215028098,2022-12-05T10:23:32,Labastida,Housing,Mortgage,-921.75,11414.11
buyer_8,Antonio,45,ES37209501030856981675,TRX_N-38-930623753464,2020-03-07T10:43:21,Labastida,Basic services,phone,-36.73,1194.6
buyer_8,Antonio,45,ES37209501030856981675,TRX_N-380-800630695293,2022-12-05T10:11:12,Labastida,Basic services,internet,-50.51,11363.6
buyer_8,Antonio,45,ES37209501030856981675,TRX_N-381-259510662742,2022-12-05T19:07:45,Labastida,Expense,education,-964.99,10398.61
buyer_8,Antonio,45,ES37209501030856981675,TRX_N-382-281226457777,2022-12-06T16:50:13,Labastida,Basic services,water,-41.0,10357.61
buyer_8,Antonio,45,ES37209501030856981675,TRX_N-383-640775054849,2022-12-06T16:32:02,Labastida,Basic services,gas,-67.58,10290.03
buyer_8,Antonio,45,ES37209501030856981675,TRX_N-384-400491920419,2022-12-06T14:50:58,Labastida,Basic services,phone,-61.57,10228.46
buyer_8,Antonio,45,ES37209501030856981675,TRX_N-385-451862497512,2022-12-07T13:32:59,Labastida,Basic services,water,-54.65,10173.81
buyer_8,Antonio,45,ES37209501030856981675,TRX_N-386-50052869529,2022-12-22T18:22:10,Arrasate/Mondragon,Expense,appliances,-1545.27,8628.54
buyer_8,Antonio,45,ES37209501030856981675,TRX_N-387-819435566994,2022-12-23T14:29:54,Labastida,Expense,transport,-190.4,8438.14
buyer_8,Antonio,45,ES37209501030856981675,TRX_N-388-617294826019,2022-12-24T11:56:21,Labastida,Expense,healthcare,-194.7,8243.44
buyer_8,Antonio,45,ES37209501030856981675,TRX_N-389-383166134897,2023-01-01T09:10:01,Labastida,transfer,Salary,2144.78,10388.22
buyer_8,Antonio,45,ES37209501030856981675,TRX_N-39-252370243189,2020-03-09T14:31:16,Leioa,Expense,transport,-106.22,1088.38
buyer_8,Antonio,45,ES37209501030856981675,TRX_N-390-484810512318,2023-01-01T09:10:01,Labastida,transfer,Extra Income,214.48,10602.7
buyer_8,Antonio,45,ES37209501030856981675,TRX_N-391-568323706578,2023-01-05T12:34:58,Labastida,Housing,Mortgage,-921.75,9680.95
buyer_8,Antonio,45,ES37209501030856981675,TRX_N-392-431792338579,2023-01-05T14:25:53,Labastida,Basic services,gas,-95.46,9585.49
buyer_8,Antonio,45,ES37209501030856981675,TRX_N-393-494202145690,2023-01-05T22:16:44,Labastida,Basic services,internet,-78.31,9507.18
buyer_8,Antonio,45,ES37209501030856981675,TRX_N-394-148436459032,2023-01-05T20:51:47,Labastida,Basic services,phone,-39.07,9468.11
buyer_8,Antonio,45,ES37209501030856981675,TRX_N-395-548208428372,2023-01-06T14:51:13,Labastida,Basic services,electricity,-32.39,9435.72
buyer_8,Antonio,45,ES37209501030856981675,TRX_N-396-431017749945,2023-01-06T17:23:03,Labastida,Basic services,gas,-35.43,9400.29
buyer_8,Antonio,45,ES37209501030856981675,TRX_N-397-322590454174,2023-01-07T12:15:55,Labastida,Basic services,water,-31.6,9368.69
buyer_8,Antonio,45,ES37209501030856981675,TRX_N-398-737184817031,2023-01-19T16:51:59,Labastida,Expense,food,-155.21,9213.48
buyer_8,Antonio,45,ES37209501030856981675,TRX_N-399-822150715047,2023-01-26T16:02:13,Labastida,Expense,leisure,-11.91,9201.57
buyer_8,Antonio,45,ES37209501030856981675,TRX_N-4-374085565144,2020-01-05T16:32:58,Labastida,Basic services,electricity,-118.98,2853.11
buyer_8,Antonio,45,ES37209501030856981675,TRX_N-40-732205431867,2020-03-12T15:27:25,Labastida,Expense,transport,-114.67,973.71
buyer_8,Antonio,45,ES37209501030856981675,TRX_N-400-815010648169,2023-02-01T11:03:59,Labastida,transfer,Salary,2144.78,11346.35
buyer_8,Antonio,45,ES37209501030856981675,TRX_N-401-527324003121,2023-02-04T19:49:10,Labastida,Expense,gifts,-49.21,11297.14
buyer_8,Antonio,45,ES37209501030856981675,TRX_N-402-807967406614,2023-02-05T22:19:39,Labastida,Housing,Mortgage,-921.75,10375.39
buyer_8,Antonio,45,ES37209501030856981675,TRX_N-403-207780196066,2023-02-05T07:57:34,Labastida,Basic services,water,-64.42,10310.97
buyer_8,Antonio,45,ES37209501030856981675,TRX_N-404-272495756823,2023-02-06T14:49:33,Labastida,Basic services,phone,-62.36,10248.61
buyer_8,Antonio,45,ES37209501030856981675,TRX_N-405-218794385664,2023-02-07T16:26:55,Labastida,Basic services,gas,-56.86,10191.75
buyer_8,Antonio,45,ES37209501030856981675,TRX_N-406-635469359486,2023-02-07T14:09:31,Labastida,Basic services,internet,-75.89,10115.86
buyer_8,Antonio,45,ES37209501030856981675,TRX_N-407-445193884534,2023-02-13T08:46:08,Labastida,Expense,clothing,-210.41,9905.45
buyer_8,Antonio,45,ES37209501030856981675,TRX_N-408-134702821734,2023-02-25T18:17:19,Labastida,Expense,food,-544.74,9360.71
buyer_8,Antonio,45,ES37209501030856981675,TRX_N-409-991342292868,2023-03-01T21:18:44,Labastida,transfer,Salary,2144.78,11505.49
buyer_8,Antonio,45,ES37209501030856981675,TRX_N-41-443374737714,2020-03-18T16:35:26,Labastida,Expense,leisure,-259.36,714.35
buyer_8,Antonio,45,ES37209501030856981675,TRX_N-410-339392481604,2023-03-01T13:16:41,Labastida,Expense,clothing,-361.03,11144.46
buyer_8,Antonio,45,ES37209501030856981675,TRX_N-411-780201657825,2023-03-05T14:15:44,Labastida,Housing,Mortgage,-921.75,10222.71
buyer_8,Antonio,45,ES37209501030856981675,TRX_N-412-824242076473,2023-03-05T13:18:14,Labastida,Basic services,phone,-34.52,10188.19
buyer_8,Antonio,45,ES37209501030856981675,TRX_N-413-576010859017,2023-03-06T12:41:15,Labastida,Basic services,electricity,-95.4,10092.79
buyer_8,Antonio,45,ES37209501030856981675,TRX_N-414-96286654093,2023-03-06T22:40:51,Labastida,Basic services,internet,-59.64,10033.15
buyer_8,Antonio,45,ES37209501030856981675,TRX_N-415-136069544582,2023-03-06T14:06:13,Labastida,Basic services,phone,-93.62,9939.53
buyer_8,Antonio,45,ES37209501030856981675,TRX_N-416-152234395764,2023-03-07T13:51:23,Labastida,Basic services,water,-53.04,9886.49
buyer_8,Antonio,45,ES37209501030856981675,TRX_N-417-650832016013,2023-03-07T12:23:01,Labastida,Basic services,phone,-58.07,9828.42
buyer_8,Antonio,45,ES37209501030856981675,TRX_N-418-684416288703,2023-03-13T16:25:45,Labastida,Expense,clothing,-49.54,9778.88
buyer_8,Antonio,45,ES37209501030856981675,TRX_N-419-472745791189,2023-03-16T13:55:41,Labastida,Expense,food,-240.41,9538.47
buyer_8,Antonio,45,ES37209501030856981675,TRX_N-42-898481161464,2020-04-01T17:41:38,Labastida,transfer,Salary,2144.78,2859.13
buyer_8,Antonio,45,ES37209501030856981675,TRX_N-420-941252835108,2023-03-20T12:21:28,Labastida,Expense,clothing,-492.55,9045.92
buyer_8,Antonio,45,ES37209501030856981675,TRX_N-421-398808245953,2023-03-29T11:13:58,Labastida,Expense,healthcare,-112.58,8933.34
buyer_8,Antonio,45,ES37209501030856981675,TRX_N-422-438399632948,2023-04-01T13:15:40,Labastida,transfer,Salary,2144.78,11078.12
buyer_8,Antonio,45,ES37209501030856981675,TRX_N-423-98088338028,2023-04-01T13:15:40,Labastida,transfer,Extra Income,214.48,11292.6
buyer_8,Antonio,45,ES37209501030856981675,TRX_N-424-593678848673,2023-04-05T11:18:38,Labastida,Housing,Mortgage,-921.75,10370.85
buyer_8,Antonio,45,ES37209501030856981675,TRX_N-425-749118927090,2023-04-05T12:17:27,Labastida,Basic services,water,-31.72,10339.13
buyer_8,Antonio,45,ES37209501030856981675,TRX_N-426-110725818355,2023-04-05T14:13:04,Labastida,Basic services,electricity,-134.38,10204.75
buyer_8,Antonio,45,ES37209501030856981675,TRX_N-427-915413406142,2023-04-05T21:19:49,Labastida,Basic services,gas,-28.43,10176.32
buyer_8,Antonio,45,ES37209501030856981675,TRX_N-428-412407978370,2023-04-05T18:52:28,Labastida,Basic services,internet,-49.92,10126.4
buyer_8,Antonio,45,ES37209501030856981675,TRX_N-429-469853490161,2023-04-05T15:56:32,Labastida,Basic services,phone,-28.07,10098.33
buyer_8,Antonio,45,ES37209501030856981675,TRX_N-43-21395329979,2020-04-01T05:12:45,Hondarribia,Expense,gifts,-202.32,2656.81
buyer_8,Antonio,45,ES37209501030856981675,TRX_N-430-729302542124,2023-04-06T10:25:25,Labastida,Basic services,electricity,-67.3,10031.03
buyer_8,Antonio,45,ES37209501030856981675,TRX_N-431-405893094397,2023-04-06T15:36:43,Labastida,Expense,education,-667.28,9363.75
buyer_8,Antonio,45,ES37209501030856981675,TRX_N-432-185495561880,2023-04-07T08:08:59,Labastida,Basic services,internet,-35.96,9327.79
buyer_8,Antonio,45,ES37209501030856981675,TRX_N-433-871174987204,2023-04-07T08:16:47,Labastida,Basic services,phone,-70.56,9257.23
buyer_8,Antonio,45,ES37209501030856981675,TRX_N-434-680796623291,2023-04-22T10:36:16,Hernani,Expense,clothing,-230.93,9026.3
buyer_8,Antonio,45,ES37209501030856981675,TRX_N-435-498456326564,2023-04-23T07:25:43,Labastida,Expense,transport,-140.11,8886.19
buyer_8,Antonio,45,ES37209501030856981675,TRX_N-436-810095615131,2023-05-01T10:49:08,Labastida,transfer,Salary,2144.78,11030.97
buyer_8,Antonio,45,ES37209501030856981675,TRX_N-437-715985337811,2023-05-05T15:44:59,Labastida,Housing,Mortgage,-921.75,10109.22
buyer_8,Antonio,45,ES37209501030856981675,TRX_N-438-935063338124,2023-05-05T11:56:57,Labastida,Basic services,internet,-46.32,10062.9
buyer_8,Antonio,45,ES37209501030856981675,TRX_N-439-112960047750,2023-05-06T18:29:04,Labastida,Basic services,electricity,-126.14,9936.76
buyer_8,Antonio,45,ES37209501030856981675,TRX_N-44-522179569279,2020-04-03T14:45:52,Labastida,Expense,transport,-37.94,2618.87
buyer_8,Antonio,45,ES37209501030856981675,TRX_N-440-446192592572,2023-05-06T11:09:31,Labastida,Basic services,phone,-76.78,9859.98
buyer_8,Antonio,45,ES37209501030856981675,TRX_N-441-78358164379,2023-05-07T21:07:58,Labastida,Basic services,electricity,-75.31,9784.67
buyer_8,Antonio,45,ES37209501030856981675,TRX_N-442-814761743039,2023-05-07T12:42:12,Labastida,Basic services,gas,-49.9,9734.77
buyer_8,Antonio,45,ES37209501030856981675,TRX_N-443-222645330837,2023-05-14T08:37:17,Labastida,Expense,leisure,-151.91,9582.86
buyer_8,Antonio,45,ES37209501030856981675,TRX_N-444-657365397310,2023-05-23T01:46:05,Labastida,Expense,healthcare,-22.56,9560.3
buyer_8,Antonio,45,ES37209501030856981675,TRX_N-445-161409058319,2023-06-01T11:48:35,Labastida,transfer,Salary,2144.78,11705.08
buyer_8,Antonio,45,ES37209501030856981675,TRX_N-446-148800026584,2023-06-01T11:48:35,Labastida,transfer,Extra Income,214.48,11919.56
buyer_8,Antonio,45,ES37209501030856981675,TRX_N-447-673920650769,2023-06-01T11:48:35,Labastida,transfer,Bonus,2168.34,14087.9
buyer_8,Antonio,45,ES37209501030856981675,TRX_N-448-700991621627,2023-06-04T11:01:43,Labastida,Expense,appliances,-1118.92,12968.98
buyer_8,Antonio,45,ES37209501030856981675,TRX_N-449-251631987148,2023-06-05T19:45:54,Labastida,Housing,Mortgage,-921.75,12047.23
buyer_8,Antonio,45,ES37209501030856981675,TRX_N-45-362005007568,2020-04-05T09:43:11,Labastida,Housing,Mortgage,-921.75,1697.12
buyer_8,Antonio,45,ES37209501030856981675,TRX_N-450-736203897427,2023-06-05T18:03:05,Labastida,Basic services,electricity,-43.5,12003.73
buyer_8,Antonio,45,ES37209501030856981675,TRX_N-451-486394493003,2023-06-05T16:55:52,Labastida,Expense,food,-412.81,11590.92
buyer_8,Antonio,45,ES37209501030856981675,TRX_N-452-953168042427,2023-06-06T12:18:26,Labastida,Basic services,water,-66.59,11524.33
buyer_8,Antonio,45,ES37209501030856981675,TRX_N-453-629119027421,2023-06-06T14:54:29,Labastida,Basic services,gas,-82.36,11441.97
buyer_8,Antonio,45,ES37209501030856981675,TRX_N-454-431832018084,2023-06-07T08:38:04,Labastida,Basic services,water,-78.62,11363.35
buyer_8,Antonio,45,ES37209501030856981675,TRX_N-455-185427205461,2023-06-07T08:53:09,Labastida,Basic services,gas,-46.56,11316.79
buyer_8,Antonio,45,ES37209501030856981675,TRX_N-456-538909741788,2023-06-15T12:35:57,Labastida,Expense,healthcare,-187.29,11129.5
buyer_8,Antonio,45,ES37209501030856981675,TRX_N-457-186598181148,2023-06-21T10:40:30,Labastida,Expense,food,-427.91,10701.59
buyer_8,Antonio,45,ES37209501030856981675,TRX_N-458-166775248476,2023-07-01T18:58:22,Labastida,transfer,Salary,2144.78,12846.37
buyer_8,Antonio,45,ES37209501030856981675,TRX_N-459-474122539419,2023-07-05T15:04:57,Labastida,Housing,Mortgage,-921.75,11924.62
buyer_8,Antonio,45,ES37209501030856981675,TRX_N-46-949608461593,2020-04-06T14:04:30,Labastida,Basic services,water,-18.25,1678.87
buyer_8,Antonio,45,ES37209501030856981675,TRX_N-460-863695591667,2023-07-05T17:53:59,Labastida,Basic services,water,-69.26,11855.36
buyer_8,Antonio,45,ES37209501030856981675,TRX_N-461-465628341554,2023-07-05T16:33:56,Labastida,Basic services,internet,-45.99,11809.37
buyer_8,Antonio,45,ES37209501030856981675,TRX_N-462-138356075108,2023-07-06T10:30:08,Labastida,Basic services,water,-54.58,11754.79
buyer_8,Antonio,45,ES37209501030856981675,TRX_N-463-759575879075,2023-07-06T10:58:39,Labastida,Basic services,gas,-54.2,11700.59
buyer_8,Antonio,45,ES37209501030856981675,TRX_N-464-400155425891,2023-07-07T18:11:07,Labastida,Basic services,water,-32.43,11668.16
buyer_8,Antonio,45,ES37209501030856981675,TRX_N-465-985050698345,2023-07-08T16:13:31,Labastida,Expense,clothing,-461.91,11206.25
buyer_8,Antonio,45,ES37209501030856981675,TRX_N-466-258032483445,2023-07-19T11:54:20,Zuia,Expense,leisure,-191.51,11014.74
buyer_8,Antonio,45,ES37209501030856981675,TRX_N-467-81606222872,2023-07-27T04:09:30,Labastida,Expense,transport,-132.39,10882.35
buyer_8,Antonio,45,ES37209501030856981675,TRX_N-468-586302754036,2023-07-31T02:30:38,Labastida,Expense,clothing,-54.92,10827.43
buyer_8,Antonio,45,ES37209501030856981675,TRX_N-469-105676865376,2023-08-01T11:34:03,Labastida,transfer,Salary,2144.78,12972.21
buyer_8,Antonio,45,ES37209501030856981675,TRX_N-47-557923409278,2020-04-06T17:24:40,Labastida,Basic services,internet,-44.71,1634.16
buyer_8,Antonio,45,ES37209501030856981675,TRX_N-470-243515382552,2023-08-01T11:34:03,Labastida,transfer,Extra Income,214.48,13186.69
buyer_8,Antonio,45,ES37209501030856981675,TRX_N-471-507982309685,2023-08-01T08:46:59,Elciego,Expense,transport,-106.12,13080.57
buyer_8,Antonio,45,ES37209501030856981675,TRX_N-472-497479135785,2023-08-05T17:11:23,Labastida,Housing,Mortgage,-921.75,12158.82
buyer_8,Antonio,45,ES37209501030856981675,TRX_N-473-88805542071,2023-08-05T21:02:49,Labastida,Basic services,gas,-39.06,12119.76
buyer_8,Antonio,45,ES37209501030856981675,TRX_N-474-145278295479,2023-08-05T22:59:19,Labastida,Basic services,internet,-41.44,12078.32
buyer_8,Antonio,45,ES37209501030856981675,TRX_N-475-991505910962,2023-08-06T09:57:40,Labastida,Basic services,electricity,-71.6,12006.72
buyer_8,Antonio,45,ES37209501030856981675,TRX_N-476-461455640365,2023-08-17T08:42:11,Labastida,Expense,food,-306.54,11700.18
buyer_8,Antonio,45,ES37209501030856981675,TRX_N-477-177867764861,2023-08-24T14:14:43,Labastida,Expense,food,-364.1,11336.08
buyer_8,Antonio,45,ES37209501030856981675,TRX_N-478-868033623017,2023-08-31T16:50:12,Labastida,Expense,food,-406.53,10929.55
buyer_8,Antonio,45,ES37209501030856981675,TRX_N-479-113336455207,2023-09-01T19:34:43,Labastida,transfer,Salary,2144.78,13074.33
buyer_8,Antonio,45,ES37209501030856981675,TRX_N-48-25964094246,2020-04-06T19:00:58,Labastida,Expense,transport,-56.24,1577.92
buyer_8,Antonio,45,ES37209501030856981675,TRX_N-480-769687425818,2023-09-05T09:39:40,Labastida,Housing,Mortgage,-921.75,12152.58
buyer_8,Antonio,45,ES37209501030856981675,TRX_N-481-596160755008,2023-09-05T09:14:02,Labastida,Basic services,water,-77.49,12075.09
buyer_8,Antonio,45,ES37209501030856981675,TRX_N-482-328656078491,2023-09-05T20:58:58,Labastida,Basic services,internet,-71.15,12003.94
buyer_8,Antonio,45,ES37209501030856981675,TRX_N-483-455028265386,2023-09-05T17:46:26,Labastida,Basic services,phone,-89.6,11914.34
buyer_8,Antonio,45,ES37209501030856981675,TRX_N-484-138461834172,2023-09-06T13:05:09,Labastida,Basic services,electricity,-65.52,11848.82
buyer_8,Antonio,45,ES37209501030856981675,TRX_N-485-344590036267,2023-09-07T08:16:13,Labastida,Basic services,water,-51.86,11796.96
buyer_8,Antonio,45,ES37209501030856981675,TRX_N-486-127611767215,2023-09-07T10:27:34,Labastida,Basic services,electricity,-98.56,11698.4
buyer_8,Antonio,45,ES37209501030856981675,TRX_N-487-764815235642,2023-09-07T12:34:51,Labastida,Basic services,gas,-81.09,11617.31
buyer_8,Antonio,45,ES37209501030856981675,TRX_N-488-690643782886,2023-10-01T14:34:07,Labastida,transfer,Salary,2144.78,13762.09
buyer_8,Antonio,45,ES37209501030856981675,TRX_N-489-412527627020,2023-10-05T14:41:37,Labastida,Housing,Mortgage,-921.75,12840.34
buyer_8,Antonio,45,ES37209501030856981675,TRX_N-49-373130815598,2020-05-01T14:49:59,Labastida,transfer,Salary,2144.78,3722.7
buyer_8,Antonio,45,ES37209501030856981675,TRX_N-490-15648013763,2023-10-05T18:22:49,Labastida,Basic services,water,-63.05,12777.29
buyer_8,Antonio,45,ES37209501030856981675,TRX_N-491-578270131251,2023-10-05T10:06:52,Labastida,Basic services,phone,-46.96,12730.33
buyer_8,Antonio,45,ES37209501030856981675,TRX_N-492-133016264379,2023-10-06T16:21:24,Labastida,Basic services,water,-77.15,12653.18
buyer_8,Antonio,45,ES37209501030856981675,TRX_N-493-856791401836,2023-10-06T08:36:52,Labastida,Basic services,electricity,-74.36,12578.82
buyer_8,Antonio,45,ES37209501030856981675,TRX_N-494-833302749309,2023-10-06T15:08:32,Labastida,Basic services,internet,-67.62,12511.2
buyer_8,Antonio,45,ES37209501030856981675,TRX_N-495-712306833446,2023-10-06T12:02:00,Labastida,Basic services,phone,-58.19,12453.01
buyer_8,Antonio,45,ES37209501030856981675,TRX_N-496-392366524822,2023-10-07T22:11:17,Labastida,Basic services,water,-75.28,12377.73
buyer_8,Antonio,45,ES37209501030856981675,TRX_N-497-192034228680,2023-10-07T14:07:58,Labastida,Basic services,electricity,-129.34,12248.39
buyer_8,Antonio,45,ES37209501030856981675,TRX_N-498-241704113092,2023-10-07T18:06:58,Labastida,Basic services,gas,-15.42,12232.97
buyer_8,Antonio,45,ES37209501030856981675,TRX_N-499-597864247758,2023-10-07T07:58:46,Labastida,Basic services,internet,-51.0,12181.97
buyer_8,Antonio,45,ES37209501030856981675,TRX_N-5-801587323498,2020-01-06T08:50:06,Labastida,Basic services,water,-70.97,2782.14
buyer_8,Antonio,45,ES37209501030856981675,TRX_N-50-558202467395,2020-05-02T15:19:04,Labastida,Expense,leisure,-32.64,3690.06
buyer_8,Antonio,45,ES37209501030856981675,TRX_N-500-936503879879,2023-10-07T14:21:26,Labastida,Basic services,phone,-56.12,12125.85
buyer_8,Antonio,45,ES37209501030856981675,TRX_N-501-519064452433,2023-11-01T14:19:32,Labastida,transfer,Salary,2144.78,14270.63
buyer_8,Antonio,45,ES37209501030856981675,TRX_N-502-655814762232,2023-11-01T14:19:32,Labastida,transfer,Extra Income,214.48,14485.11
buyer_8,Antonio,45,ES37209501030856981675,TRX_N-503-140333121876,2023-11-05T15:55:21,Labastida,Housing,Mortgage,-921.75,13563.36
buyer_8,Antonio,45,ES37209501030856981675,TRX_N-504-357317413382,2023-11-05T13:13:36,Labastida,Basic services,electricity,-98.84,13464.52
buyer_8,Antonio,45,ES37209501030856981675,TRX_N-505-505067786368,2023-11-05T11:00:44,Labastida,Basic services,gas,-22.97,13441.55
buyer_8,Antonio,45,ES37209501030856981675,TRX_N-506-479885295318,2023-11-05T14:19:55,Labastida,Basic services,internet,-47.51,13394.04
buyer_8,Antonio,45,ES37209501030856981675,TRX_N-507-812023934146,2023-11-06T10:01:45,Labastida,Expense,food,-465.22,12928.82
buyer_8,Antonio,45,ES37209501030856981675,TRX_N-508-125271374919,2023-11-07T15:54:17,Labastida,Basic services,water,-35.11,12893.71
buyer_8,Antonio,45,ES37209501030856981675,TRX_N-509-840339421964,2023-11-07T13:37:02,Labastida,Basic services,gas,-63.91,12829.8
buyer_8,Antonio,45,ES37209501030856981675,TRX_N-51-712696835852,2020-05-04T16:10:47,Labastida,Expense,transport,-98.82,3591.24
buyer_8,Antonio,45,ES37209501030856981675,TRX_N-510-456563182764,2023-11-07T11:23:37,Labastida,Basic services,internet,-64.79,12765.01
buyer_8,Antonio,45,ES37209501030856981675,TRX_N-511-347201149484,2023-11-19T10:41:36,Labastida,Expense,clothing,-339.14,12425.87
buyer_8,Antonio,45,ES37209501030856981675,TRX_N-512-721173886715,2023-11-26T09:40:35,Labastida,Expense,transport,-89.57,12336.3
buyer_8,Antonio,45,ES37209501030856981675,TRX_N-513-358100889956,2023-12-01T10:18:25,Labastida,transfer,Salary,2144.78,14481.08
buyer_8,Antonio,45,ES37209501030856981675,TRX_N-514-305898278100,2023-12-01T10:18:25,Labastida,transfer,Bonus,2296.98,16778.06
buyer_8,Antonio,45,ES37209501030856981675,TRX_N-515-647223816661,2023-12-04T16:12:25,Labastida,Expense,food,-298.88,16479.18
buyer_8,Antonio,45,ES37209501030856981675,TRX_N-516-20987364204,2023-12-05T08:04:25,Labastida,Housing,Mortgage,-921.75,15557.43
buyer_8,Antonio,45,ES37209501030856981675,TRX_N-517-613999047525,2023-12-05T10:48:56,Labastida,Basic services,internet,-69.07,15488.36
buyer_8,Antonio,45,ES37209501030856981675,TRX_N-518-556878077560,2023-12-05T19:04:14,Labastida,Basic services,phone,-79.96,15408.4
buyer_8,Antonio,45,ES37209501030856981675,TRX_N-519-574999782936,2023-12-06T16:31:37,Labastida,Basic services,water,-33.92,15374.48
buyer_8,Antonio,45,ES37209501030856981675,TRX_N-52-773696924358,2020-05-05T20:36:18,Labastida,Housing,Mortgage,-921.75,2669.49
buyer_8,Antonio,45,ES37209501030856981675,TRX_N-520-278001463049,2023-12-07T18:01:04,Labastida,Basic services,water,-30.47,15344.01
buyer_8,Antonio,45,ES37209501030856981675,TRX_N-521-2710234399,2023-12-07T17:04:45,Labastida,Basic services,gas,-71.09,15272.92
buyer_8,Antonio,45,ES37209501030856981675,TRX_N-522-328999976951,2023-12-07T18:13:07,Labastida,Basic services,internet,-77.24,15195.68
buyer_8,Antonio,45,ES37209501030856981675,TRX_N-523-621833118042,2023-12-07T17:19:15,Labastida,Expense,leisure,-205.14,14990.54
buyer_8,Antonio,45,ES37209501030856981675,TRX_N-524-605497499028,2024-01-01T12:46:30,Labastida,transfer,Salary,2144.78,17135.32
buyer_8,Antonio,45,ES37209501030856981675,TRX_N-525-949757095138,2024-01-01T12:46:30,Labastida,transfer,Extra Income,214.48,17349.8
buyer_8,Antonio,45,ES37209501030856981675,TRX_N-526-645171416031,2024-01-03T11:44:19,Labastida,Expense,food,-252.91,17096.89
buyer_8,Antonio,45,ES37209501030856981675,TRX_N-527-207130716267,2024-01-05T11:48:37,Labastida,Housing,Mortgage,-921.75,16175.14
buyer_8,Antonio,45,ES37209501030856981675,TRX_N-528-598409933605,2024-01-05T15:52:29,Labastida,Basic services,water,-26.06,16149.08
buyer_8,Antonio,45,ES37209501030856981675,TRX_N-529-934476018322,2024-01-05T17:21:43,Labastida,Basic services,internet,-31.51,16117.57
buyer_8,Antonio,45,ES37209501030856981675,TRX_N-53-149802883550,2020-05-05T15:36:26,Labastida,Basic services,internet,-53.14,2616.35
buyer_8,Antonio,45,ES37209501030856981675,TRX_N-530-909562780173,2024-01-06T09:24:01,Labastida,Basic services,water,-35.45,16082.12
buyer_8,Antonio,45,ES37209501030856981675,TRX_N-531-422795974606,2024-01-06T18:51:32,Labastida,Basic services,gas,-63.66,16018.46
buyer_8,Antonio,45,ES37209501030856981675,TRX_N-532-980690611828,2024-01-06T21:35:53,Labastida,Basic services,internet,-36.92,15981.54
buyer_8,Antonio,45,ES37209501030856981675,TRX_N-533-88221024701,2024-01-07T23:27:10,Labastida,Basic services,water,-66.35,15915.19
buyer_8,Antonio,45,ES37209501030856981675,TRX_N-534-195012766708,2024-01-07T08:26:36,Labastida,Basic services,electricity,-106.57,15808.62
buyer_8,Antonio,45,ES37209501030856981675,TRX_N-535-509211232839,2024-01-07T18:01:47,Labastida,Basic services,gas,-28.22,15780.4
buyer_8,Antonio,45,ES37209501030856981675,TRX_N-536-983560858749,2024-01-12T05:47:14,Eibar,Expense,food,-182.07,15598.33
buyer_8,Antonio,45,ES37209501030856981675,TRX_N-537-644657126520,2024-01-13T15:41:30,Labastida,Expense,leisure,-113.09,15485.24
buyer_8,Antonio,45,ES37209501030856981675,TRX_N-538-572726669615,2024-01-22T11:20:05,Labastida,Expense,leisure,-121.01,15364.23
buyer_8,Antonio,45,ES37209501030856981675,TRX_N-539-795076800120,2024-01-25T13:42:59,Labastida,Expense,food,-737.86,14626.37
buyer_8,Antonio,45,ES37209501030856981675,TRX_N-54-101000700991,2020-05-06T08:24:50,Labastida,Basic services,water,-68.37,2547.98
buyer_8,Antonio,45,ES37209501030856981675,TRX_N-540-620003575083,2024-01-29T08:08:22,Elciego,Expense,leisure,-148.25,14478.12
buyer_8,Antonio,45,ES37209501030856981675,TRX_N-541-29214488334,2024-02-01T12:48:50,Labastida,transfer,Salary,2144.78,16622.9
buyer_8,Antonio,45,ES37209501030856981675,TRX_N-542-798212327244,2024-02-05T09:44:43,Labastida,Housing,Mortgage,-921.75,15701.15
buyer_8,Antonio,45,ES37209501030856981675,TRX_N-543-751451118153,2024-02-05T18:56:27,Labastida,Basic services,water,-30.73,15670.42
buyer_8,Antonio,45,ES37209501030856981675,TRX_N-544-208259778745,2024-02-05T10:05:43,Labastida,Basic services,electricity,-40.46,15629.96
buyer_8,Antonio,45,ES37209501030856981675,TRX_N-545-546650524998,2024-02-05T13:05:28,Labastida,Basic services,gas,-21.7,15608.26
buyer_8,Antonio,45,ES37209501030856981675,TRX_N-546-957523301665,2024-02-06T19:55:25,Labastida,Basic services,gas,-39.31,15568.95
buyer_8,Antonio,45,ES37209501030856981675,TRX_N-547-488925442276,2024-02-06T00:06:09,Labastida,Basic services,phone,-41.26,15527.69
buyer_8,Antonio,45,ES37209501030856981675,TRX_N-548-357925224605,2024-02-07T18:26:42,Labastida,Basic services,internet,-50.95,15476.74
buyer_8,Antonio,45,ES37209501030856981675,TRX_N-549-714684561212,2024-02-07T08:52:00,Labastida,Basic services,phone,-20.53,15456.21
buyer_8,Antonio,45,ES37209501030856981675,TRX_N-55-561491566776,2020-05-06T10:58:50,Labastida,Basic services,phone,-78.47,2469.51
buyer_8,Antonio,45,ES37209501030856981675,TRX_N-550-978845199052,2024-02-07T23:28:12,Donostia,Expense,transport,-96.88,15359.33
buyer_8,Antonio,45,ES37209501030856981675,TRX_N-551-438422102015,2024-02-12T20:54:41,Vitoria-Gasteiz,Expense,transport,-117.46,15241.87
buyer_8,Antonio,45,ES37209501030856981675,TRX_N-552-417535395836,2024-02-15T10:53:43,Labastida,Expense,food,-347.65,14894.22
buyer_8,Antonio,45,ES37209501030856981675,TRX_N-553-847191732824,2024-02-15T18:03:51,Hondarribia,Expense,leisure,-127.17,14767.05
buyer_8,Antonio,45,ES37209501030856981675,TRX_N-554-757512996914,2024-02-22T07:07:49,Bilbao,Expense,food,-633.82,14133.23
buyer_8,Antonio,45,ES37209501030856981675,TRX_N-555-726202066051,2024-03-01T11:04:23,Labastida,transfer,Salary,2144.78,16278.01
buyer_8,Antonio,45,ES37209501030856981675,TRX_N-556-99697479840,2024-03-01T11:04:23,Labastida,transfer,Extra Income,214.48,16492.49
buyer_8,Antonio,45,ES37209501030856981675,TRX_N-557-590158159932,2024-03-05T14:54:57,Labastida,Housing,Mortgage,-921.75,15570.74
buyer_8,Antonio,45,ES37209501030856981675,TRX_N-558-731204612896,2024-03-05T08:55:03,Labastida,Basic services,water,-44.43,15526.31
buyer_8,Antonio,45,ES37209501030856981675,TRX_N-559-163181682179,2024-03-05T11:57:59,Labastida,Basic services,electricity,-117.15,15409.16
buyer_8,Antonio,45,ES37209501030856981675,TRX_N-56-37539864132,2020-05-07T09:48:47,Labastida,Basic services,water,-71.03,2398.48
buyer_8,Antonio,45,ES37209501030856981675,TRX_N-560-757834108372,2024-03-05T13:47:56,Labastida,Basic services,gas,-88.83,15320.33
buyer_8,Antonio,45,ES37209501030856981675,TRX_N-561-982292594559,2024-03-06T11:36:51,Labastida,Basic services,electricity,-31.08,15289.25
buyer_8,Antonio,45,ES37209501030856981675,TRX_N-562-953425073874,2024-03-06T13:11:02,Labastida,Expense,gifts,-330.51,14958.74
buyer_8,Antonio,45,ES37209501030856981675,TRX_N-563-830589103253,2024-03-07T06:57:09,Labastida,Basic services,electricity,-103.57,14855.17
buyer_8,Antonio,45,ES37209501030856981675,TRX_N-564-240229652662,2024-03-08T10:03:16,Andoain,Expense,healthcare,-143.87,14711.3
buyer_8,Antonio,45,ES37209501030856981675,TRX_N-565-479520508337,2024-03-14T05:29:23,Labastida,Expense,leisure,-148.23,14563.07
buyer_8,Antonio,45,ES37209501030856981675,TRX_N-566-539171955217,2024-03-14T18:35:33,Alegría-Dulantzi,Expense,gifts,-363.18,14199.89
buyer_8,Antonio,45,ES37209501030856981675,TRX_N-567-787364096026,2024-03-16T12:27:27,Labastida,Expense,healthcare,-384.61,13815.28
buyer_8,Antonio,45,ES37209501030856981675,TRX_N-568-219390468222,2024-04-01T19:55:40,Labastida,transfer,Salary,2144.78,15960.06
buyer_8,Antonio,45,ES37209501030856981675,TRX_N-569-933959285339,2024-04-03T14:42:54,Labastida,Expense,healthcare,-180.38,15779.68
buyer_8,Antonio,45,ES37209501030856981675,TRX_N-57-846758975496,2020-05-07T20:37:01,Labastida,Basic services,internet,-50.84,2347.64
buyer_8,Antonio,45,ES37209501030856981675,TRX_N-570-346701209413,2024-04-05T23:32:07,Labastida,Housing,Mortgage,-921.75,14857.93
buyer_8,Antonio,45,ES37209501030856981675,TRX_N-571-761833027641,2024-04-06T12:14:13,Labastida,Basic services,phone,-66.13,14791.8
buyer_8,Antonio,45,ES37209501030856981675,TRX_N-572-980845429186,2024-04-07T20:10:04,Labastida,Basic services,internet,-35.36,14756.44
buyer_8,Antonio,45,ES37209501030856981675,TRX_N-573-133737455477,2024-04-12T00:39:49,Labastida,Expense,food,-255.88,14500.56
buyer_8,Antonio,45,ES37209501030856981675,TRX_N-574-516686048335,2024-04-17T17:47:02,Labastida,Expense,clothing,-155.27,14345.29
buyer_8,Antonio,45,ES37209501030856981675,TRX_N-575-698771243658,2024-04-28T14:04:23,Labastida,Expense,leisure,-109.68,14235.61
buyer_8,Antonio,45,ES37209501030856981675,TRX_N-576-555564248089,2024-05-01T16:03:41,Labastida,transfer,Salary,2144.78,16380.39
buyer_8,Antonio,45,ES37209501030856981675,TRX_N-577-551102241620,2024-05-02T18:39:07,Labastida,Expense,clothing,-342.28,16038.11
buyer_8,Antonio,45,ES37209501030856981675,TRX_N-578-976068337879,2024-05-05T18:43:40,Labastida,Housing,Mortgage,-921.75,15116.36
buyer_8,Antonio,45,ES37209501030856981675,TRX_N-579-935758629321,2024-05-05T08:16:05,Labastida,Basic services,water,-57.59,15058.77
buyer_8,Antonio,45,ES37209501030856981675,TRX_N-58-857184933313,2020-05-26T19:01:00,Labastida,Expense,clothing,-444.29,1903.35
buyer_8,Antonio,45,ES37209501030856981675,TRX_N-580-953382114896,2024-05-05T19:29:25,Labastida,Basic services,electricity,-99.0,14959.77
buyer_8,Antonio,45,ES37209501030856981675,TRX_N-581-416398726431,2024-05-05T23:49:41,Labastida,Basic services,phone,-53.43,14906.34
buyer_8,Antonio,45,ES37209501030856981675,TRX_N-582-680791880698,2024-05-07T05:32:41,Labastida,Basic services,water,-36.45,14869.89
buyer_8,Antonio,45,ES37209501030856981675,TRX_N-583-691498814907,2024-05-11T19:59:34,Labastida,Expense,transport,-125.71,14744.18
buyer_8,Antonio,45,ES37209501030856981675,TRX_N-584-329487408364,2024-05-27T17:37:14,Galdakao,Expense,food,-469.05,14275.13
buyer_8,Antonio,45,ES37209501030856981675,TRX_N-585-216668506023,2024-06-01T17:16:59,Labastida,transfer,Salary,2144.78,16419.91
buyer_8,Antonio,45,ES37209501030856981675,TRX_N-586-597992938124,2024-06-01T17:16:59,Labastida,transfer,Extra Income,214.48,16634.39
buyer_8,Antonio,45,ES37209501030856981675,TRX_N-587-880834806404,2024-06-01T17:16:59,Labastida,transfer,Bonus,2259.07,18893.46
buyer_8,Antonio,45,ES37209501030856981675,TRX_N-588-13301447500,2024-06-03T18:19:41,Hernani,Expense,transport,-57.74,18835.72
buyer_8,Antonio,45,ES37209501030856981675,TRX_N-589-801875208169,2024-06-05T15:34:54,Labastida,Housing,Mortgage,-921.75,17913.97
buyer_8,Antonio,45,ES37209501030856981675,TRX_N-59-900898903534,2020-05-30T14:11:08,Santurtzi,Expense,food,-219.09,1684.26
buyer_8,Antonio,45,ES37209501030856981675,TRX_N-590-756515629002,2024-06-05T19:25:00,Labastida,Basic services,internet,-58.17,17855.8
buyer_8,Antonio,45,ES37209501030856981675,TRX_N-591-542070355846,2024-06-05T10:06:28,Labastida,Basic services,phone,-46.12,17809.68
buyer_8,Antonio,45,ES37209501030856981675,TRX_N-592-798371688230,2024-06-07T10:34:08,Labastida,Basic services,electricity,-85.29,17724.39
buyer_8,Antonio,45,ES37209501030856981675,TRX_N-593-989996557977,2024-06-07T17:16:51,Labastida,Basic services,internet,-47.1,17677.29
buyer_8,Antonio,45,ES37209501030856981675,TRX_N-594-316773639793,2024-06-16T07:48:51,Labastida,Expense,transport,-42.98,17634.31
buyer_8,Antonio,45,ES37209501030856981675,TRX_N-595-706782721664,2024-06-28T20:32:29,Labastida,Expense,clothing,-306.01,17328.3
buyer_8,Antonio,45,ES37209501030856981675,TRX_N-596-618317786763,2024-06-30T17:28:06,Labastida,Expense,transport,-69.99,17258.31
buyer_8,Antonio,45,ES37209501030856981675,TRX_N-597-380246924093,2024-06-30T14:11:29,Labastida,Expense,clothing,-360.37,16897.94
buyer_8,Antonio,45,ES37209501030856981675,TRX_N-598-411840876744,2024-07-01T20:15:44,Labastida,transfer,Salary,2144.78,19042.72
buyer_8,Antonio,45,ES37209501030856981675,TRX_N-599-362303861046,2024-07-04T10:55:39,Labastida,Expense,food,-676.14,18366.58
buyer_8,Antonio,45,ES37209501030856981675,TRX_N-6-751443377550,2020-01-06T15:34:37,Labastida,Basic services,gas,-71.87,2710.27
buyer_8,Antonio,45,ES37209501030856981675,TRX_N-60-180383288637,2020-06-01T14:12:28,Labastida,transfer,Salary,2144.78,3829.04
buyer_8,Antonio,45,ES37209501030856981675,TRX_N-600-319261017755,2024-07-05T17:51:34,Labastida,Housing,Mortgage,-921.75,17444.83
buyer_8,Antonio,45,ES37209501030856981675,TRX_N-601-610697998962,2024-07-06T13:48:55,Labastida,Basic services,water,-30.7,17414.13
buyer_8,Antonio,45,ES37209501030856981675,TRX_N-602-743222123316,2024-07-06T10:07:50,Labastida,Basic services,electricity,-141.69,17272.44
buyer_8,Antonio,45,ES37209501030856981675,TRX_N-603-145038222815,2024-07-07T08:42:17,Labastida,Basic services,electricity,-34.32,17238.12
buyer_8,Antonio,45,ES37209501030856981675,TRX_N-604-740191794624,2024-07-07T09:17:02,Labastida,Basic services,phone,-60.13,17177.99
buyer_8,Antonio,45,ES37209501030856981675,TRX_N-605-168157279337,2024-07-11T18:58:45,Labastida,Expense,food,-160.4,17017.59
buyer_8,Antonio,45,ES37209501030856981675,TRX_N-606-693664518302,2024-07-14T20:41:49,Labastida,Expense,healthcare,-256.99,16760.6
buyer_8,Antonio,45,ES37209501030856981675,TRX_N-607-599582783409,2024-07-15T12:50:23,Labastida,Expense,leisure,-195.73,16564.87
buyer_8,Antonio,45,ES37209501030856981675,TRX_N-608-479297470565,2024-07-19T09:33:15,Labastida,Expense,education,-166.38,16398.49
buyer_8,Antonio,45,ES37209501030856981675,TRX_N-609-49430862191,2024-07-21T18:10:42,Labastida,Expense,healthcare,-290.71,16107.78
buyer_8,Antonio,45,ES37209501030856981675,TRX_N-61-361635063171,2020-06-01T14:12:28,Labastida,transfer,Extra Income,214.48,4043.52
buyer_8,Antonio,45,ES37209501030856981675,TRX_N-610-671753705351,2024-08-01T19:22:10,Labastida,transfer,Salary,2144.78,18252.56
buyer_8,Antonio,45,ES37209501030856981675,TRX_N-611-682209055502,2024-08-02T13:27:36,Labastida,Expense,food,-540.09,17712.47
buyer_8,Antonio,45,ES37209501030856981675,TRX_N-612-741088668016,2024-08-02T10:12:17,Hernani,Expense,healthcare,-22.5,17689.97
buyer_8,Antonio,45,ES37209501030856981675,TRX_N-613-712255442444,2024-08-05T12:42:39,Labastida,Housing,Mortgage,-921.75,16768.22
buyer_8,Antonio,45,ES37209501030856981675,TRX_N-614-190284315823,2024-08-05T08:56:39,Labastida,Basic services,internet,-37.1,16731.12
buyer_8,Antonio,45,ES37209501030856981675,TRX_N-615-276469568015,2024-08-05T09:48:59,Labastida,Expense,education,-571.79,16159.33
buyer_8,Antonio,45,ES37209501030856981675,TRX_N-616-604270148496,2024-08-06T09:41:33,Labastida,Basic services,electricity,-53.85,16105.48
buyer_8,Antonio,45,ES37209501030856981675,TRX_N-617-333934073347,2024-08-06T15:53:24,Labastida,Basic services,phone,-55.77,16049.71
buyer_8,Antonio,45,ES37209501030856981675,TRX_N-618-556320597904,2024-08-07T15:31:34,Labastida,Basic services,water,-49.12,16000.59
buyer_8,Antonio,45,ES37209501030856981675,TRX_N-619-407797636840,2024-08-07T17:55:21,Labastida,Basic services,electricity,-143.07,15857.52
buyer_8,Antonio,45,ES37209501030856981675,TRX_N-62-306903920917,2020-06-01T14:12:28,Labastida,transfer,Bonus,2266.76,6310.28
buyer_8,Antonio,45,ES37209501030856981675,TRX_N-620-622388515710,2024-08-07T05:24:39,Labastida,Basic services,internet,-35.41,15822.11
buyer_8,Antonio,45,ES37209501030856981675,TRX_N-621-565619094330,2024-08-07T20:44:14,Hernani,Expense,food,-155.79,15666.32
buyer_8,Antonio,45,ES37209501030856981675,TRX_N-622-715207940001,2024-08-07T10:14:42,Labastida,Expense,travel,-2713.45,12952.87
buyer_8,Antonio,45,ES37209501030856981675,TRX_N-623-933866579725,2024-08-12T20:29:52,Labastida,Expense,repairs,-388.33,12564.54
buyer_8,Antonio,45,ES37209501030856981675,TRX_N-624-409024010437,2024-08-20T09:26:46,Labastida,Expense,clothing,-431.15,12133.39
buyer_8,Antonio,45,ES37209501030856981675,TRX_N-625-666789033809,2024-08-29T12:14:57,Labastida,Expense,food,-554.6,11578.79
buyer_8,Antonio,45,ES37209501030856981675,TRX_N-626-591047471200,2024-09-01T19:11:11,Labastida,transfer,Salary,2144.78,13723.57
buyer_8,Antonio,45,ES37209501030856981675,TRX_N-627-741245289382,2024-09-01T19:11:11,Labastida,transfer,Extra Income,214.48,13938.05
buyer_8,Antonio,45,ES37209501030856981675,TRX_N-628-915308905626,2024-09-04T11:50:23,Labastida,Expense,leisure,-215.98,13722.07
buyer_8,Antonio,45,ES37209501030856981675,TRX_N-629-387697344319,2024-09-05T16:36:06,Labastida,Housing,Mortgage,-921.75,12800.32
buyer_8,Antonio,45,ES37209501030856981675,TRX_N-63-811526852257,2020-06-05T13:21:33,Labastida,Housing,Mortgage,-921.75,5388.53
buyer_8,Antonio,45,ES37209501030856981675,TRX_N-630-526384395286,2024-09-05T17:29:07,Labastida,Basic services,internet,-53.47,12746.85
buyer_8,Antonio,45,ES37209501030856981675,TRX_N-631-5795429311,2024-09-06T17:04:05,Labastida,Basic services,electricity,-55.37,12691.48
buyer_8,Antonio,45,ES37209501030856981675,TRX_N-632-459000252627,2024-09-06T20:06:01,Labastida,Basic services,internet,-49.31,12642.17
buyer_8,Antonio,45,ES37209501030856981675,TRX_N-633-930423212924,2024-09-06T17:41:04,Labastida,Basic services,phone,-48.47,12593.7
buyer_8,Antonio,45,ES37209501030856981675,TRX_N-634-69466725167,2024-09-07T17:42:27,Labastida,Basic services,electricity,-35.88,12557.82
buyer_8,Antonio,45,ES37209501030856981675,TRX_N-635-629577562578,2024-09-07T15:26:59,Labastida,Basic services,phone,-88.61,12469.21
buyer_8,Antonio,45,ES37209501030856981675,TRX_N-636-110490065587,2024-09-12T10:43:48,Labastida,Expense,education,-692.37,11776.84
buyer_8,Antonio,45,ES37209501030856981675,TRX_N-637-519706394078,2024-09-19T11:15:56,Labastida,Expense,leisure,-51.43,11725.41
buyer_8,Antonio,45,ES37209501030856981675,TRX_N-638-959531802446,2024-09-26T00:45:49,Alegría-Dulantzi,Expense,transport,-112.12,11613.29
buyer_8,Antonio,45,ES37209501030856981675,TRX_N-639-870543611665,2024-10-01T21:54:45,Labastida,transfer,Salary,2144.78,13758.07
buyer_8,Antonio,45,ES37209501030856981675,TRX_N-64-356688042926,2020-06-05T09:06:29,Labastida,Basic services,gas,-60.17,5328.36
buyer_8,Antonio,45,ES37209501030856981675,TRX_N-640-830789940386,2024-10-05T14:40:16,Labastida,Housing,Mortgage,-921.75,12836.32
buyer_8,Antonio,45,ES37209501030856981675,TRX_N-641-573338638637,2024-10-05T12:04:32,Labastida,Basic services,water,-73.42,12762.9
buyer_8,Antonio,45,ES37209501030856981675,TRX_N-642-608304075052,2024-10-06T11:35:23,Labastida,Basic services,water,-21.31,12741.59
buyer_8,Antonio,45,ES37209501030856981675,TRX_N-643-646362270855,2024-10-06T20:03:28,Labastida,Basic services,electricity,-116.47,12625.12
buyer_8,Antonio,45,ES37209501030856981675,TRX_N-644-780048179948,2024-10-06T16:13:51,Labastida,Basic services,gas,-82.29,12542.83
buyer_8,Antonio,45,ES37209501030856981675,TRX_N-645-742744515892,2024-10-07T13:29:14,Labastida,Basic services,electricity,-36.27,12506.56
buyer_8,Antonio,45,ES37209501030856981675,TRX_N-646-74316206106,2024-10-07T19:36:54,Labastida,Basic services,gas,-94.21,12412.35
buyer_8,Antonio,45,ES37209501030856981675,TRX_N-65-272439998091,2020-06-05T11:50:33,Labastida,Basic services,internet,-75.32,5253.04
buyer_8,Antonio,45,ES37209501030856981675,TRX_N-66-515123707649,2020-06-05T18:12:24,Labastida,Basic services,phone,-83.71,5169.33
buyer_8,Antonio,45,ES37209501030856981675,TRX_N-67-441779317228,2020-06-05T18:10:19,Labastida,Expense,transport,-180.56,4988.77
buyer_8,Antonio,45,ES37209501030856981675,TRX_N-68-313920868402,2020-06-06T17:00:06,Labastida,Basic services,water,-12.63,4976.14
buyer_8,Antonio,45,ES37209501030856981675,TRX_N-69-29971212639,2020-06-06T10:32:00,Labastida,Basic services,electricity,-68.1,4908.04
buyer_8,Antonio,45,ES37209501030856981675,TRX_N-7-122245354725,2020-01-06T13:35:19,Labastida,Expense,transport,-181.73,2528.54
buyer_8,Antonio,45,ES37209501030856981675,TRX_N-70-354246421232,2020-06-06T21:26:52,Labastida,Basic services,gas,-15.34,4892.7
buyer_8,Antonio,45,ES37209501030856981675,TRX_N-71-348474789241,2020-06-06T11:28:39,Labastida,Basic services,phone,-89.1,4803.6
buyer_8,Antonio,45,ES37209501030856981675,TRX_N-72-515810232898,2020-06-06T04:15:17,Portugalete,Expense,transport,-26.86,4776.74
buyer_8,Antonio,45,ES37209501030856981675,TRX_N-73-85595071247,2020-06-07T16:55:34,Labastida,Basic services,gas,-75.05,4701.69
buyer_8,Antonio,45,ES37209501030856981675,TRX_N-74-254830168577,2020-06-07T11:51:11,Labastida,Basic services,internet,-76.78,4624.91
buyer_8,Antonio,45,ES37209501030856981675,TRX_N-75-889572702497,2020-06-07T10:56:12,Labastida,Expense,transport,-77.04,4547.87
buyer_8,Antonio,45,ES37209501030856981675,TRX_N-76-293077434203,2020-06-10T12:54:53,Labastida,Expense,clothing,-195.09,4352.78
buyer_8,Antonio,45,ES37209501030856981675,TRX_N-77-339536245984,2020-06-18T23:18:18,Labastida,Expense,leisure,-86.32,4266.46
buyer_8,Antonio,45,ES37209501030856981675,TRX_N-78-448056772568,2020-06-21T15:27:17,Labastida,Expense,transport,-130.8,4135.66
buyer_8,Antonio,45,ES37209501030856981675,TRX_N-79-188223081288,2020-06-23T16:48:04,Labastida,Expense,transport,-158.11,3977.55
buyer_8,Antonio,45,ES37209501030856981675,TRX_N-8-233544241498,2020-01-07T12:05:37,Labastida,Basic services,gas,-33.93,2494.61
buyer_8,Antonio,45,ES37209501030856981675,TRX_N-80-486992141778,2020-07-01T20:26:19,Labastida,transfer,Salary,2144.78,6122.33
buyer_8,Antonio,45,ES37209501030856981675,TRX_N-81-391970276270,2020-07-05T12:36:15,Labastida,Housing,Mortgage,-921.75,5200.58
buyer_8,Antonio,45,ES37209501030856981675,TRX_N-82-203789030623,2020-07-05T10:28:07,Labastida,Basic services,water,-41.69,5158.89
buyer_8,Antonio,45,ES37209501030856981675,TRX_N-83-825433720562,2020-07-05T13:58:03,Labastida,Basic services,gas,-60.8,5098.09
buyer_8,Antonio,45,ES37209501030856981675,TRX_N-84-563591376235,2020-07-05T17:05:21,Labastida,Basic services,phone,-68.13,5029.96
buyer_8,Antonio,45,ES37209501030856981675,TRX_N-85-97502323256,2020-07-06T11:43:36,Labastida,Basic services,gas,-69.35,4960.61
buyer_8,Antonio,45,ES37209501030856981675,TRX_N-86-263838149633,2020-07-07T10:36:32,Labastida,Basic services,electricity,-90.44,4870.17
buyer_8,Antonio,45,ES37209501030856981675,TRX_N-87-860478340281,2020-07-09T18:43:37,Labastida,Expense,leisure,-86.72,4783.45
buyer_8,Antonio,45,ES37209501030856981675,TRX_N-88-633863835668,2020-07-27T09:43:26,Basauri,Expense,transport,-165.36,4618.09
buyer_8,Antonio,45,ES37209501030856981675,TRX_N-89-423751701203,2020-08-01T17:23:58,Labastida,transfer,Salary,2144.78,6762.87
buyer_8,Antonio,45,ES37209501030856981675,TRX_N-9-730533917084,2020-01-07T13:50:33,Labastida,Basic services,phone,-49.08,2445.53
buyer_8,Antonio,45,ES37209501030856981675,TRX_N-90-555324794761,2020-08-01T17:23:58,Labastida,transfer,Extra Income,214.48,6977.35
buyer_8,Antonio,45,ES37209501030856981675,TRX_N-91-52307250717,2020-08-05T10:56:21,Labastida,Housing,Mortgage,-921.75,6055.6
buyer_8,Antonio,45,ES37209501030856981675,TRX_N-92-130786930693,2020-08-05T04:36:41,Labastida,Basic services,water,-68.53,5987.07
buyer_8,Antonio,45,ES37209501030856981675,TRX_N-93-468253234635,2020-08-05T20:20:51,Labastida,Basic services,internet,-40.08,5946.99
buyer_8,Antonio,45,ES37209501030856981675,TRX_N-94-865156686318,2020-08-05T15:46:01,Labastida,Basic services,phone,-93.91,5853.08
buyer_8,Antonio,45,ES37209501030856981675,TRX_N-95-570893051672,2020-08-07T19:05:56,Labastida,Basic services,internet,-58.59,5794.49
buyer_8,Antonio,45,ES37209501030856981675,TRX_N-96-723957270593,2020-08-25T14:49:38,Erandio,Expense,food,-345.67,5448.82
buyer_8,Antonio,45,ES37209501030856981675,TRX_N-97-178868495398,2020-08-28T10:21:50,Labastida,Expense,transport,-59.52,5389.3
buyer_8,Antonio,45,ES37209501030856981675,TRX_N-98-559321706686,2020-09-01T14:06:32,Labastida,transfer,Salary,2144.78,7534.08
buyer_8,Antonio,45,ES37209501030856981675,TRX_N-99-359473422869,2020-09-05T16:07:52,Labastida,Housing,Mortgage,-921.75,6612.33
