profile,name,age,iban,trx_id,timestamp,city,transaction_type,transaction_category,amount_eur,balance
buyer_1,Luis,28,ES15209597283499285728,TRX_N-00001-58876010,2020-01-01T11:45:59,Bilbao,transfer,Salary,1289.91,1806.5
buyer_1,Luis,28,ES15209597283499285728,TRX_N-00002-82798164,2020-01-05T12:04:29,Bilbao,Housing,Rent,-1240.78,565.72
buyer_1,Luis,28,ES15209597283499285728,TRX_N-00003-36958124,2020-01-05T12:04:42,Bilbao,Basic services,electricity,-108.95,456.77
buyer_1,Luis,28,ES15209597283499285728,TRX_N-00004-96642598,2020-01-06T16:43:55,Bilbao,Basic services,water,-28.2,428.57
buyer_1,Luis,28,ES15209597283499285728,TRX_N-00005-29064556,2020-01-06T08:31:33,Bilbao,Basic services,electricity,-137.99,290.58
buyer_1,Luis,28,ES15209597283499285728,TRX_N-00006-97082271,2020-01-07T19:04:32,Bilbao,Basic services,gas,-74.23,216.35
buyer_1,Luis,28,ES15209597283499285728,TRX_N-00007-13019309,2020-01-07T17:48:42,Bilbao,Basic services,phone,-78.83,137.52
buyer_1,Luis,28,ES15209597283499285728,TRX_N-00008-65879071,2020-01-17T11:19:21,Bilbao,Expense,leisure,-282.93,-145.41
buyer_1,Luis,28,ES15209597283499285728,TRX_N-00009-27506648,2020-01-19T12:13:53,Bilbao,Expense,leisure,-157.17,-302.58
buyer_1,Luis,28,ES15209597283499285728,TRX_N-00010-61538416,2020-01-19T14:22:42,Bilbao,Expense,education,-533.95,-836.53
buyer_1,Luis,28,ES15209597283499285728,TRX_N-00011-43259649,2020-01-19T19:59:32,Bilbao,Expense,gifts,-208.51,-1045.04
buyer_1,Luis,28,ES15209597283499285728,TRX_N-00012-48076611,2020-01-22T09:29:24,Bilbao,Expense,gifts,-413.82,-1458.86
buyer_1,Luis,28,ES15209597283499285728,TRX_N-00013-29010897,2020-01-27T16:09:40,Barakaldo,Expense,clothing,-63.95,-1522.81
buyer_1,Luis,28,ES15209597283499285728,TRX_N-00014-55424730,2020-01-30T13:38:49,Bilbao,Expense,transport,-86.3,-1609.11
buyer_1,Luis,28,ES15209597283499285728,TRX_N-00015-08868844,2020-02-01T19:29:13,Bilbao,transfer,Salary,1289.91,-319.2
buyer_1,Luis,28,ES15209597283499285728,TRX_N-00016-32962010,2020-02-01T19:29:13,Bilbao,transfer,Extra Income,128.99,-190.21
buyer_1,Luis,28,ES15209597283499285728,TRX_N-00017-79234722,2020-02-05T05:09:39,Bilbao,Housing,Rent,-1240.78,-1430.99
buyer_1,Luis,28,ES15209597283499285728,TRX_N-00018-75945856,2020-02-05T12:33:53,Bilbao,Basic services,gas,-88.54,-1519.53
buyer_1,Luis,28,ES15209597283499285728,TRX_N-00019-47440844,2020-02-05T20:10:54,Bilbao,Expense,food,-364.27,-1883.8
buyer_1,Luis,28,ES15209597283499285728,TRX_N-00020-37607197,2020-02-06T04:55:46,Bilbao,Basic services,phone,-63.32,-1947.12
buyer_1,Luis,28,ES15209597283499285728,TRX_N-00021-53397618,2020-02-07T20:13:38,Bilbao,Basic services,water,-74.14,-2021.26
buyer_1,Luis,28,ES15209597283499285728,TRX_N-00022-54464871,2020-02-10T14:45:54,Bilbao,Expense,healthcare,-21.54,-2042.8
buyer_1,Luis,28,ES15209597283499285728,TRX_N-00023-63783247,2020-02-12T07:18:33,Bilbao,Expense,food,-724.6,-2767.4
buyer_1,Luis,28,ES15209597283499285728,TRX_N-00024-46765801,2020-02-29T15:16:53,Bilbao,Expense,education,-151.28,-2918.68
buyer_1,Luis,28,ES15209597283499285728,TRX_N-00025-80802522,2020-03-01T16:22:09,Bilbao,transfer,Salary,1289.91,-1628.77
buyer_1,Luis,28,ES15209597283499285728,TRX_N-00026-48111735,2020-03-05T09:15:10,Bilbao,Housing,Rent,-1240.78,-2869.55
buyer_1,Luis,28,ES15209597283499285728,TRX_N-00027-18482888,2020-03-05T14:03:26,Bilbao,Basic services,electricity,-145.86,-3015.41
buyer_1,Luis,28,ES15209597283499285728,TRX_N-00028-00882083,2020-03-05T12:43:53,Bilbao,Basic services,gas,-73.84,-3089.25
buyer_1,Luis,28,ES15209597283499285728,TRX_N-00029-37460782,2020-03-05T05:41:35,Bilbao,Basic services,phone,-29.65,-3118.9
buyer_1,Luis,28,ES15209597283499285728,TRX_N-00030-25127561,2020-03-07T07:46:35,Bilbao,Basic services,water,-41.89,-3160.79
buyer_1,Luis,28,ES15209597283499285728,TRX_N-00031-58682510,2020-03-07T09:20:05,Bilbao,Basic services,internet,-39.57,-3200.36
buyer_1,Luis,28,ES15209597283499285728,TRX_N-00032-16745967,2020-03-19T14:49:11,Bilbao,Expense,leisure,-253.8,-3454.16
buyer_1,Luis,28,ES15209597283499285728,TRX_N-00033-69656583,2020-03-28T16:33:01,Bilbao,Expense,food,-151.18,-3605.34
buyer_1,Luis,28,ES15209597283499285728,TRX_N-00034-68660392,2020-04-01T17:04:22,Bilbao,transfer,Salary,1289.91,-2315.43
buyer_1,Luis,28,ES15209597283499285728,TRX_N-00035-78326483,2020-04-05T13:28:35,Bilbao,Housing,Rent,-1240.78,-3556.21
buyer_1,Luis,28,ES15209597283499285728,TRX_N-00036-61108426,2020-04-05T10:54:26,Bilbao,Basic services,water,-48.14,-3604.35
buyer_1,Luis,28,ES15209597283499285728,TRX_N-00037-98893335,2020-04-05T21:31:30,Bilbao,Basic services,gas,-37.99,-3642.34
buyer_1,Luis,28,ES15209597283499285728,TRX_N-00038-87325755,2020-04-05T16:18:09,Bilbao,Basic services,internet,-58.89,-3701.23
buyer_1,Luis,28,ES15209597283499285728,TRX_N-00039-20648740,2020-04-06T21:04:09,Bilbao,Basic services,water,-28.78,-3730.01
buyer_1,Luis,28,ES15209597283499285728,TRX_N-00040-56130238,2020-04-06T05:17:52,Bilbao,Basic services,phone,-71.21,-3801.22
buyer_1,Luis,28,ES15209597283499285728,TRX_N-00041-82088425,2020-04-23T17:30:13,Vitoria-Gasteiz,Expense,food,-561.06,-4362.28
buyer_1,Luis,28,ES15209597283499285728,TRX_N-00042-66169394,2020-05-01T17:51:14,Bilbao,transfer,Salary,1289.91,-3072.37
buyer_1,Luis,28,ES15209597283499285728,TRX_N-00043-76395394,2020-05-01T17:51:14,Bilbao,transfer,Extra Income,128.99,-2943.38
buyer_1,Luis,28,ES15209597283499285728,TRX_N-00044-93168420,2020-05-02T01:56:53,Bilbao,Expense,education,-914.37,-3857.75
buyer_1,Luis,28,ES15209597283499285728,TRX_N-00045-50900695,2020-05-05T13:16:25,Bilbao,Housing,Rent,-1240.78,-5098.53
buyer_1,Luis,28,ES15209597283499285728,TRX_N-00046-20422363,2020-05-05T11:13:44,Bilbao,Basic services,water,-69.75,-5168.28
buyer_1,Luis,28,ES15209597283499285728,TRX_N-00047-75885764,2020-05-06T17:21:20,Bilbao,Basic services,water,-36.15,-5204.43
buyer_1,Luis,28,ES15209597283499285728,TRX_N-00048-15764989,2020-05-07T16:14:18,Bilbao,Basic services,electricity,-105.22,-5309.65
buyer_1,Luis,28,ES15209597283499285728,TRX_N-00049-45554663,2020-05-07T05:01:18,Bilbao,Basic services,gas,-62.05,-5371.7
buyer_1,Luis,28,ES15209597283499285728,TRX_N-00050-72934479,2020-05-07T08:44:33,Bilbao,Basic services,phone,-75.13,-5446.83
buyer_1,Luis,28,ES15209597283499285728,TRX_N-00051-28348565,2020-05-14T15:10:29,Bilbao,Expense,food,-744.84,-6191.67
buyer_1,Luis,28,ES15209597283499285728,TRX_N-00052-00039759,2020-05-26T11:52:28,Bilbao,Expense,food,-716.97,-6908.64
buyer_1,Luis,28,ES15209597283499285728,TRX_N-00053-78751302,2020-06-01T10:08:39,Bilbao,transfer,Salary,1289.91,-5618.73
buyer_1,Luis,28,ES15209597283499285728,TRX_N-00054-31029555,2020-06-01T10:08:39,Bilbao,transfer,Bonus,1272.06,-4346.67
buyer_1,Luis,28,ES15209597283499285728,TRX_N-00055-33343719,2020-06-05T15:38:54,Bilbao,Housing,Rent,-1240.78,-5587.45
buyer_1,Luis,28,ES15209597283499285728,TRX_N-00056-28453358,2020-06-05T16:42:48,Bilbao,Basic services,internet,-67.16,-5654.61
buyer_1,Luis,28,ES15209597283499285728,TRX_N-00057-92747372,2020-06-07T14:32:43,Bilbao,Basic services,gas,-38.83,-5693.44
buyer_1,Luis,28,ES15209597283499285728,TRX_N-00058-49302750,2020-06-12T08:47:18,Galdakao,Expense,food,-749.63,-6443.07
buyer_1,Luis,28,ES15209597283499285728,TRX_N-00059-36476596,2020-06-14T18:26:29,Bilbao,Expense,leisure,-65.42,-6508.49
buyer_1,Luis,28,ES15209597283499285728,TRX_N-00060-22376966,2020-06-22T06:58:04,Bilbao,Expense,food,-275.73,-6784.22
buyer_1,Luis,28,ES15209597283499285728,TRX_N-00061-28488562,2020-07-01T01:00:09,Bilbao,transfer,Salary,1289.91,-5494.31
buyer_1,Luis,28,ES15209597283499285728,TRX_N-00062-54408944,2020-07-04T18:06:43,Bilbao,Expense,transport,-126.76,-5621.07
buyer_1,Luis,28,ES15209597283499285728,TRX_N-00063-59764318,2020-07-05T07:05:53,Bilbao,Housing,Rent,-1240.78,-6861.85
buyer_1,Luis,28,ES15209597283499285728,TRX_N-00064-63806578,2020-07-05T03:58:53,Bilbao,Basic services,water,-36.63,-6898.48
buyer_1,Luis,28,ES15209597283499285728,TRX_N-00065-88691870,2020-07-06T10:16:42,Bilbao,Basic services,electricity,-143.44,-7041.92
buyer_1,Luis,28,ES15209597283499285728,TRX_N-00066-96224568,2020-07-06T21:38:29,Bilbao,Basic services,phone,-42.15,-7084.07
buyer_1,Luis,28,ES15209597283499285728,TRX_N-00067-49123011,2020-07-14T22:10:54,Bilbao,Expense,appliances,-1958.71,-9042.78
buyer_1,Luis,28,ES15209597283499285728,TRX_N-00068-87116369,2020-07-15T16:54:27,Bilbao,Expense,transport,-87.64,-9130.42
buyer_1,Luis,28,ES15209597283499285728,TRX_N-00069-97946878,2020-07-17T11:41:57,Bilbao,Expense,healthcare,-367.06,-9497.48
buyer_1,Luis,28,ES15209597283499285728,TRX_N-00070-54829635,2020-07-22T13:52:59,Bilbao,Expense,transport,-161.13,-9658.61
buyer_1,Luis,28,ES15209597283499285728,TRX_N-00071-43374124,2020-07-24T14:41:19,Bilbao,Expense,food,-543.5,-10202.11
buyer_1,Luis,28,ES15209597283499285728,TRX_N-00072-68229813,2020-07-26T12:04:09,Errenteria,Expense,leisure,-104.83,-10306.94
buyer_1,Luis,28,ES15209597283499285728,TRX_N-00073-08830699,2020-08-01T10:07:46,Bilbao,transfer,Salary,1289.91,-9017.03
buyer_1,Luis,28,ES15209597283499285728,TRX_N-00074-61047430,2020-08-01T10:07:46,Bilbao,transfer,Extra Income,128.99,-8888.04
buyer_1,Luis,28,ES15209597283499285728,TRX_N-00075-15932008,2020-08-05T08:15:29,Bilbao,Housing,Rent,-1240.78,-10128.82
buyer_1,Luis,28,ES15209597283499285728,TRX_N-00076-91418825,2020-08-05T18:55:01,Bilbao,Basic services,internet,-65.26,-10194.08
buyer_1,Luis,28,ES15209597283499285728,TRX_N-00077-53312478,2020-08-06T09:54:27,Bilbao,Basic services,electricity,-133.07,-10327.15
buyer_1,Luis,28,ES15209597283499285728,TRX_N-00078-20266175,2020-08-06T20:46:09,Bilbao,Basic services,gas,-50.13,-10377.28
buyer_1,Luis,28,ES15209597283499285728,TRX_N-00079-49430222,2020-08-07T08:40:36,Bilbao,Basic services,water,-18.81,-10396.09
buyer_1,Luis,28,ES15209597283499285728,TRX_N-00080-48029259,2020-08-07T15:17:28,Bilbao,Basic services,phone,-90.33,-10486.42
buyer_1,Luis,28,ES15209597283499285728,TRX_N-00081-10632933,2020-08-20T12:23:43,Bilbao,Expense,leisure,-252.34,-10738.76
buyer_1,Luis,28,ES15209597283499285728,TRX_N-00082-32994502,2020-09-01T09:50:07,Bilbao,transfer,Salary,1289.91,-9448.85
buyer_1,Luis,28,ES15209597283499285728,TRX_N-00083-60428070,2020-09-05T11:10:04,Bilbao,Housing,Rent,-1240.78,-10689.63
buyer_1,Luis,28,ES15209597283499285728,TRX_N-00084-52387469,2020-09-05T10:48:19,Bilbao,Basic services,water,-15.21,-10704.84
buyer_1,Luis,28,ES15209597283499285728,TRX_N-00085-97032047,2020-09-05T20:45:46,Bilbao,Basic services,internet,-54.33,-10759.17
buyer_1,Luis,28,ES15209597283499285728,TRX_N-00086-64659951,2020-09-07T13:05:31,Bilbao,Basic services,phone,-64.24,-10823.41
buyer_1,Luis,28,ES15209597283499285728,TRX_N-00087-49755597,2020-09-12T08:36:06,Bilbao,Expense,healthcare,-32.33,-10855.74
buyer_1,Luis,28,ES15209597283499285728,TRX_N-00088-27829448,2020-10-01T11:32:40,Bilbao,transfer,Salary,1289.91,-9565.83
buyer_1,Luis,28,ES15209597283499285728,TRX_N-00089-72238054,2020-10-05T00:16:59,Bilbao,Housing,Rent,-1240.78,-10806.61
buyer_1,Luis,28,ES15209597283499285728,TRX_N-00090-46708560,2020-10-05T13:55:32,Bilbao,Basic services,water,-54.24,-10860.85
buyer_1,Luis,28,ES15209597283499285728,TRX_N-00091-63934455,2020-10-05T19:00:03,Bilbao,Basic services,electricity,-70.96,-10931.81
buyer_1,Luis,28,ES15209597283499285728,TRX_N-00092-23211514,2020-10-05T08:39:29,Bilbao,Basic services,internet,-67.75,-10999.56
buyer_1,Luis,28,ES15209597283499285728,TRX_N-00093-62693893,2020-10-05T11:10:52,Bilbao,Basic services,phone,-90.21,-11089.77
buyer_1,Luis,28,ES15209597283499285728,TRX_N-00094-20357628,2020-10-06T05:31:15,Bilbao,Basic services,electricity,-45.9,-11135.67
buyer_1,Luis,28,ES15209597283499285728,TRX_N-00095-71548765,2020-10-06T18:01:29,Bilbao,Expense,clothing,-276.71,-11412.38
buyer_1,Luis,28,ES15209597283499285728,TRX_N-00096-67502496,2020-10-07T16:15:33,Bilbao,Basic services,water,-32.61,-11444.99
buyer_1,Luis,28,ES15209597283499285728,TRX_N-00097-61876162,2020-10-07T14:33:18,Bilbao,Basic services,gas,-30.94,-11475.93
buyer_1,Luis,28,ES15209597283499285728,TRX_N-00098-31665820,2020-10-07T14:57:12,Bilbao,Basic services,internet,-72.74,-11548.67
buyer_1,Luis,28,ES15209597283499285728,TRX_N-00099-66049773,2020-10-10T18:34:37,Leioa,Expense,clothing,-336.76,-11885.43
buyer_1,Luis,28,ES15209597283499285728,TRX_N-00100-67077074,2020-10-16T12:48:39,Bilbao,Expense,leisure,-215.51,-12100.94
buyer_1,Luis,28,ES15209597283499285728,TRX_N-00101-41015859,2020-10-22T14:53:59,Bilbao,Expense,education,-57.86,-12158.8
buyer_1,Luis,28,ES15209597283499285728,TRX_N-00102-21953908,2020-10-26T08:35:18,Bilbao,Expense,food,-380.96,-12539.76
buyer_1,Luis,28,ES15209597283499285728,TRX_N-00103-47221974,2020-10-30T22:52:22,Leioa,Expense,food,-646.65,-13186.41
buyer_1,Luis,28,ES15209597283499285728,TRX_N-00104-20792087,2020-11-01T16:33:45,Bilbao,transfer,Salary,1289.91,-11896.5
buyer_1,Luis,28,ES15209597283499285728,TRX_N-00105-70170265,2020-11-01T16:33:45,Bilbao,transfer,Extra Income,128.99,-11767.51
buyer_1,Luis,28,ES15209597283499285728,TRX_N-00106-08279584,2020-11-03T19:59:52,Andoain,Expense,food,-325.01,-12092.52
buyer_1,Luis,28,ES15209597283499285728,TRX_N-00107-94535124,2020-11-05T10:16:28,Bilbao,Housing,Rent,-1240.78,-13333.3
buyer_1,Luis,28,ES15209597283499285728,TRX_N-00108-22783708,2020-11-05T20:12:54,Bilbao,Basic services,water,-26.02,-13359.32
buyer_1,Luis,28,ES15209597283499285728,TRX_N-00109-93406241,2020-11-05T00:18:26,Bilbao,Basic services,phone,-37.32,-13396.64
buyer_1,Luis,28,ES15209597283499285728,TRX_N-00110-89398427,2020-11-06T10:41:43,Bilbao,Basic services,phone,-71.96,-13468.6
buyer_1,Luis,28,ES15209597283499285728,TRX_N-00111-19766295,2020-11-07T10:00:38,Bilbao,Basic services,water,-10.8,-13479.4
buyer_1,Luis,28,ES15209597283499285728,TRX_N-00112-60508461,2020-11-07T16:19:22,Bilbao,Basic services,internet,-31.11,-13510.51
buyer_1,Luis,28,ES15209597283499285728,TRX_N-00113-17061200,2020-11-21T18:52:24,Labastida/Bastida,Expense,food,-692.19,-14202.7
buyer_1,Luis,28,ES15209597283499285728,TRX_N-00114-58490041,2020-11-23T19:10:03,Bilbao,Expense,leisure,-238.83,-14441.53
buyer_1,Luis,28,ES15209597283499285728,TRX_N-00115-71710760,2020-11-24T15:37:34,Bilbao,Expense,repairs,-427.33,-14868.86
buyer_1,Luis,28,ES15209597283499285728,TRX_N-00116-60935906,2020-12-01T09:48:07,Bilbao,transfer,Salary,1289.91,-13578.95
buyer_1,Luis,28,ES15209597283499285728,TRX_N-00117-61984867,2020-12-01T09:48:07,Bilbao,transfer,Bonus,1174.39,-12404.56
buyer_1,Luis,28,ES15209597283499285728,TRX_N-00118-14128236,2020-12-05T11:06:24,Bilbao,Housing,Rent,-1240.78,-13645.34
buyer_1,Luis,28,ES15209597283499285728,TRX_N-00119-68980910,2020-12-07T08:51:57,Bilbao,Basic services,gas,-85.84,-13731.18
buyer_1,Luis,28,ES15209597283499285728,TRX_N-00120-42851831,2020-12-09T15:10:05,Bilbao,Expense,transport,-24.51,-13755.69
buyer_1,Luis,28,ES15209597283499285728,TRX_N-00121-79793587,2020-12-10T18:03:27,Bilbao,Expense,food,-403.02,-14158.71
buyer_1,Luis,28,ES15209597283499285728,TRX_N-00122-96298787,2020-12-11T19:09:34,Errenteria,Expense,leisure,-242.13,-14400.84
buyer_1,Luis,28,ES15209597283499285728,TRX_N-00123-60061937,2020-12-18T11:18:04,Erandio,Expense,transport,-36.47,-14437.31
buyer_1,Luis,28,ES15209597283499285728,TRX_N-00124-28028420,2020-12-28T14:54:48,Bilbao,Expense,transport,-49.89,-14487.2
buyer_1,Luis,28,ES15209597283499285728,TRX_N-00125-09840377,2020-12-29T09:36:50,Bilbao,Expense,repairs,-973.68,-15460.88
buyer_1,Luis,28,ES15209597283499285728,TRX_N-00126-17448321,2020-12-30T08:33:49,Bilbao,Expense,gifts,-252.42,-15713.3
buyer_1,Luis,28,ES15209597283499285728,TRX_N-00127-29519427,2021-01-01T18:22:20,Bilbao,transfer,Salary,1289.91,-14423.39
buyer_1,Luis,28,ES15209597283499285728,TRX_N-00128-76643160,2021-01-01T18:22:20,Bilbao,transfer,Extra Income,128.99,-14294.4
buyer_1,Luis,28,ES15209597283499285728,TRX_N-00129-05554597,2021-01-05T12:42:02,Bilbao,Housing,Rent,-1240.78,-15535.18
buyer_1,Luis,28,ES15209597283499285728,TRX_N-00130-87341437,2021-01-05T15:48:39,Bilbao,Basic services,internet,-57.24,-15592.42
buyer_1,Luis,28,ES15209597283499285728,TRX_N-00131-67610139,2021-01-05T15:56:44,Bilbao,Expense,clothing,-36.91,-15629.33
buyer_1,Luis,28,ES15209597283499285728,TRX_N-00132-56844827,2021-01-06T19:30:39,Bilbao,Basic services,water,-30.44,-15659.77
buyer_1,Luis,28,ES15209597283499285728,TRX_N-00133-89742622,2021-01-06T03:55:58,Bilbao,Basic services,phone,-92.24,-15752.01
buyer_1,Luis,28,ES15209597283499285728,TRX_N-00134-07212092,2021-01-07T11:05:58,Bilbao,Basic services,gas,-58.39,-15810.4
buyer_1,Luis,28,ES15209597283499285728,TRX_N-00135-36086274,2021-01-07T19:32:32,Bilbao,Basic services,phone,-61.24,-15871.64
buyer_1,Luis,28,ES15209597283499285728,TRX_N-00136-09192676,2021-01-12T13:02:11,Bilbao,Expense,leisure,-29.59,-15901.23
buyer_1,Luis,28,ES15209597283499285728,TRX_N-00137-89605174,2021-01-23T23:38:54,Bilbao,Expense,gifts,-30.23,-15931.46
buyer_1,Luis,28,ES15209597283499285728,TRX_N-00138-08462146,2021-02-01T18:46:40,Bilbao,transfer,Salary,1289.91,-14641.55
buyer_1,Luis,28,ES15209597283499285728,TRX_N-00139-07766126,2021-02-03T08:53:57,Bilbao,Expense,food,-658.9,-15300.45
buyer_1,Luis,28,ES15209597283499285728,TRX_N-00140-23451946,2021-02-05T09:35:28,Bilbao,Housing,Rent,-1240.78,-16541.23
buyer_1,Luis,28,ES15209597283499285728,TRX_N-00141-71928352,2021-02-05T11:02:17,Bilbao,Basic services,electricity,-123.75,-16664.98
buyer_1,Luis,28,ES15209597283499285728,TRX_N-00142-57220067,2021-02-05T10:59:02,Bilbao,Basic services,phone,-39.37,-16704.35
buyer_1,Luis,28,ES15209597283499285728,TRX_N-00143-76118981,2021-02-06T16:19:51,Bilbao,Basic services,electricity,-50.34,-16754.69
buyer_1,Luis,28,ES15209597283499285728,TRX_N-00144-46702542,2021-02-06T10:13:52,Bilbao,Basic services,internet,-79.25,-16833.94
buyer_1,Luis,28,ES15209597283499285728,TRX_N-00145-16388425,2021-02-07T08:46:50,Bilbao,Basic services,water,-75.49,-16909.43
buyer_1,Luis,28,ES15209597283499285728,TRX_N-00146-97898756,2021-02-10T16:39:09,Bilbao,Expense,travel,-2462.87,-19372.3
buyer_1,Luis,28,ES15209597283499285728,TRX_N-00147-61483013,2021-02-18T06:06:32,Bilbao,Expense,leisure,-24.27,-19396.57
buyer_1,Luis,28,ES15209597283499285728,TRX_N-00148-62271392,2021-02-18T11:35:42,Bilbao,Expense,education,-92.28,-19488.85
buyer_1,Luis,28,ES15209597283499285728,TRX_N-00149-70812161,2021-02-25T16:13:46,Bilbao,Expense,transport,-66.58,-19555.43
buyer_1,Luis,28,ES15209597283499285728,TRX_N-00150-69529849,2021-03-01T14:46:45,Bilbao,transfer,Salary,1289.91,-18265.52
buyer_1,Luis,28,ES15209597283499285728,TRX_N-00151-94936947,2021-03-01T14:46:45,Bilbao,transfer,Extra Income,128.99,-18136.53
buyer_1,Luis,28,ES15209597283499285728,TRX_N-00152-06492887,2021-03-04T20:59:19,Bilbao,Expense,leisure,-133.25,-18269.78
buyer_1,Luis,28,ES15209597283499285728,TRX_N-00153-64701544,2021-03-05T16:22:09,Bilbao,Housing,Rent,-1240.78,-19510.56
buyer_1,Luis,28,ES15209597283499285728,TRX_N-00154-39816808,2021-03-05T13:59:43,Bilbao,Basic services,internet,-72.19,-19582.75
buyer_1,Luis,28,ES15209597283499285728,TRX_N-00155-29846129,2021-03-06T08:08:51,Bilbao,Basic services,internet,-61.43,-19644.18
buyer_1,Luis,28,ES15209597283499285728,TRX_N-00156-24975727,2021-03-06T11:06:18,Bilbao,Expense,transport,-109.41,-19753.59
buyer_1,Luis,28,ES15209597283499285728,TRX_N-00157-07819490,2021-03-17T14:44:13,Leioa,Expense,transport,-39.8,-19793.39
buyer_1,Luis,28,ES15209597283499285728,TRX_N-00158-75432148,2021-03-18T23:18:32,Bilbao,Expense,clothing,-251.67,-20045.06
buyer_1,Luis,28,ES15209597283499285728,TRX_N-00159-93062910,2021-03-30T10:37:46,Bilbao,Expense,education,-734.79,-20779.85
buyer_1,Luis,28,ES15209597283499285728,TRX_N-00160-58583500,2021-03-31T11:28:37,Bilbao,Expense,leisure,-132.7,-20912.55
buyer_1,Luis,28,ES15209597283499285728,TRX_N-00161-86143474,2021-04-01T11:44:20,Bilbao,transfer,Salary,1289.91,-19622.64
buyer_1,Luis,28,ES15209597283499285728,TRX_N-00162-80972738,2021-04-05T12:59:24,Bilbao,Housing,Rent,-1240.78,-20863.42
buyer_1,Luis,28,ES15209597283499285728,TRX_N-00163-92055174,2021-04-05T21:44:44,Bilbao,Basic services,phone,-77.12,-20940.54
buyer_1,Luis,28,ES15209597283499285728,TRX_N-00164-11675177,2021-04-06T09:00:02,Bilbao,Basic services,gas,-56.68,-20997.22
buyer_1,Luis,28,ES15209597283499285728,TRX_N-00165-37645124,2021-04-07T16:28:20,Bilbao,Basic services,phone,-31.09,-21028.31
buyer_1,Luis,28,ES15209597283499285728,TRX_N-00166-40090690,2021-04-25T11:04:54,Bilbao,Expense,transport,-51.71,-21080.02
buyer_1,Luis,28,ES15209597283499285728,TRX_N-00167-85719536,2021-05-01T16:15:08,Bilbao,transfer,Salary,1289.91,-19790.11
buyer_1,Luis,28,ES15209597283499285728,TRX_N-00168-22289787,2021-05-01T16:15:08,Bilbao,transfer,Extra Income,128.99,-19661.12
buyer_1,Luis,28,ES15209597283499285728,TRX_N-00169-12857653,2021-05-01T11:15:52,Bilbao,Expense,repairs,-580.36,-20241.48
buyer_1,Luis,28,ES15209597283499285728,TRX_N-00170-51408139,2021-05-05T11:23:55,Bilbao,Housing,Rent,-1240.78,-21482.26
buyer_1,Luis,28,ES15209597283499285728,TRX_N-00171-25774342,2021-05-05T09:15:04,Bilbao,Basic services,water,-71.31,-21553.57
buyer_1,Luis,28,ES15209597283499285728,TRX_N-00172-71185314,2021-05-06T11:51:48,Bilbao,Basic services,internet,-71.35,-21624.92
buyer_1,Luis,28,ES15209597283499285728,TRX_N-00173-10426439,2021-05-06T22:57:55,Bilbao,Basic services,phone,-37.92,-21662.84
buyer_1,Luis,28,ES15209597283499285728,TRX_N-00174-55200289,2021-05-07T20:10:06,Bilbao,Basic services,water,-23.32,-21686.16
buyer_1,Luis,28,ES15209597283499285728,TRX_N-00175-10829535,2021-05-07T09:45:27,Bilbao,Basic services,electricity,-45.42,-21731.58
buyer_1,Luis,28,ES15209597283499285728,TRX_N-00176-42628735,2021-05-13T03:05:02,Bilbao,Expense,food,-461.65,-22193.23
buyer_1,Luis,28,ES15209597283499285728,TRX_N-00177-97850511,2021-05-31T20:21:14,Bilbao,Expense,transport,-40.57,-22233.8
buyer_1,Luis,28,ES15209597283499285728,TRX_N-00178-97179255,2021-06-01T15:09:51,Bilbao,transfer,Salary,1289.91,-20943.89
buyer_1,Luis,28,ES15209597283499285728,TRX_N-00179-76766483,2021-06-01T15:09:51,Bilbao,transfer,Bonus,1330.18,-19613.71
buyer_1,Luis,28,ES15209597283499285728,TRX_N-00180-41229206,2021-06-02T19:27:12,Bilbao,Expense,education,-342.35,-19956.06
buyer_1,Luis,28,ES15209597283499285728,TRX_N-00181-47225642,2021-06-04T15:15:36,Bilbao,Expense,healthcare,-53.35,-20009.41
buyer_1,Luis,28,ES15209597283499285728,TRX_N-00182-90244333,2021-06-05T08:27:01,Bilbao,Housing,Rent,-1240.78,-21250.19
buyer_1,Luis,28,ES15209597283499285728,TRX_N-00183-77997953,2021-06-05T11:25:24,Bilbao,Basic services,water,-30.93,-21281.12
buyer_1,Luis,28,ES15209597283499285728,TRX_N-00184-72982264,2021-06-05T19:29:15,Bilbao,Basic services,gas,-66.51,-21347.63
buyer_1,Luis,28,ES15209597283499285728,TRX_N-00185-49363946,2021-06-06T19:08:44,Bilbao,Basic services,phone,-32.02,-21379.65
buyer_1,Luis,28,ES15209597283499285728,TRX_N-00186-53862278,2021-06-07T21:20:28,Bilbao,Basic services,gas,-60.54,-21440.19
buyer_1,Luis,28,ES15209597283499285728,TRX_N-00187-79538557,2021-06-07T09:39:17,Bilbao,Basic services,phone,-97.6,-21537.79
buyer_1,Luis,28,ES15209597283499285728,TRX_N-00188-58523946,2021-06-14T13:56:07,Bilbao,Expense,transport,-75.78,-21613.57
buyer_1,Luis,28,ES15209597283499285728,TRX_N-00189-10634590,2021-06-24T16:20:28,Bilbao,Expense,healthcare,-227.6,-21841.17
buyer_1,Luis,28,ES15209597283499285728,TRX_N-00190-54109835,2021-07-01T11:22:09,Bilbao,transfer,Salary,1289.91,-20551.26
buyer_1,Luis,28,ES15209597283499285728,TRX_N-00191-29359349,2021-07-05T20:22:55,Bilbao,Housing,Rent,-1240.78,-21792.04
buyer_1,Luis,28,ES15209597283499285728,TRX_N-00192-55595979,2021-07-06T18:22:17,Bilbao,Basic services,electricity,-66.21,-21858.25
buyer_1,Luis,28,ES15209597283499285728,TRX_N-00193-40723348,2021-07-06T17:17:28,Bilbao,Basic services,internet,-32.86,-21891.11
buyer_1,Luis,28,ES15209597283499285728,TRX_N-00194-95998838,2021-07-07T10:05:37,Bilbao,Basic services,gas,-31.42,-21922.53
buyer_1,Luis,28,ES15209597283499285728,TRX_N-00195-45618633,2021-07-17T19:02:18,Bilbao,Expense,clothing,-83.06,-22005.59
buyer_1,Luis,28,ES15209597283499285728,TRX_N-00196-52261699,2021-07-21T14:10:59,Bilbao,Expense,transport,-56.74,-22062.33
buyer_1,Luis,28,ES15209597283499285728,TRX_N-00197-63766998,2021-07-28T03:34:48,Durango,Expense,leisure,-73.31,-22135.64
buyer_1,Luis,28,ES15209597283499285728,TRX_N-00198-81983346,2021-08-01T23:04:09,Bilbao,transfer,Salary,1289.91,-20845.73
buyer_1,Luis,28,ES15209597283499285728,TRX_N-00199-67541628,2021-08-01T23:04:09,Bilbao,transfer,Extra Income,128.99,-20716.74
buyer_1,Luis,28,ES15209597283499285728,TRX_N-00200-01432795,2021-08-05T16:55:29,Bilbao,Housing,Rent,-1240.78,-21957.52
buyer_1,Luis,28,ES15209597283499285728,TRX_N-00201-17474492,2021-08-05T15:49:54,Bilbao,Basic services,water,-36.47,-21993.99
buyer_1,Luis,28,ES15209597283499285728,TRX_N-00202-44207244,2021-08-05T01:19:30,Bilbao,Basic services,phone,-69.81,-22063.8
buyer_1,Luis,28,ES15209597283499285728,TRX_N-00203-64893769,2021-08-06T07:52:59,Bilbao,Basic services,water,-44.39,-22108.19
buyer_1,Luis,28,ES15209597283499285728,TRX_N-00204-37889312,2021-08-07T23:03:39,Bilbao,Basic services,electricity,-29.48,-22137.67
buyer_1,Luis,28,ES15209597283499285728,TRX_N-00205-79766534,2021-08-07T08:42:59,Bilbao,Basic services,internet,-75.04,-22212.71
buyer_1,Luis,28,ES15209597283499285728,TRX_N-00206-48923216,2021-08-09T16:18:00,Alegría-Dulantzi,Expense,education,-388.17,-22600.88
buyer_1,Luis,28,ES15209597283499285728,TRX_N-00207-98161761,2021-08-14T10:24:37,Bilbao,Expense,education,-525.83,-23126.71
buyer_1,Luis,28,ES15209597283499285728,TRX_N-00208-40065542,2021-08-18T17:57:48,Bilbao,Expense,transport,-190.77,-23317.48
buyer_1,Luis,28,ES15209597283499285728,TRX_N-00209-90633936,2021-09-01T02:49:55,Bilbao,transfer,Salary,1289.91,-22027.57
buyer_1,Luis,28,ES15209597283499285728,TRX_N-00210-57815381,2021-09-05T15:31:48,Bilbao,Housing,Rent,-1240.78,-23268.35
buyer_1,Luis,28,ES15209597283499285728,TRX_N-00211-70268156,2021-09-05T17:32:20,Bilbao,Basic services,gas,-86.3,-23354.65
buyer_1,Luis,28,ES15209597283499285728,TRX_N-00212-99507001,2021-09-05T08:34:30,Bilbao,Basic services,internet,-60.53,-23415.18
buyer_1,Luis,28,ES15209597283499285728,TRX_N-00213-67955241,2021-09-07T14:37:23,Bilbao,Basic services,water,-20.81,-23435.99
buyer_1,Luis,28,ES15209597283499285728,TRX_N-00214-72219534,2021-09-07T11:28:09,Bilbao,Basic services,electricity,-71.42,-23507.41
buyer_1,Luis,28,ES15209597283499285728,TRX_N-00215-91464584,2021-09-07T07:29:08,Bilbao,Basic services,gas,-39.8,-23547.21
buyer_1,Luis,28,ES15209597283499285728,TRX_N-00216-30014423,2021-09-07T14:12:59,Bilbao,Basic services,internet,-44.93,-23592.14
buyer_1,Luis,28,ES15209597283499285728,TRX_N-00217-89171721,2021-09-08T14:34:39,Bilbao,Expense,leisure,-10.79,-23602.93
buyer_1,Luis,28,ES15209597283499285728,TRX_N-00218-12793184,2021-09-15T13:31:50,Bilbao,Expense,gifts,-105.56,-23708.49
buyer_1,Luis,28,ES15209597283499285728,TRX_N-00219-34117031,2021-09-27T13:26:02,Mungia,Expense,transport,-25.63,-23734.12
buyer_1,Luis,28,ES15209597283499285728,TRX_N-00220-13153716,2021-09-27T09:19:58,Bilbao,Expense,gifts,-162.72,-23896.84
buyer_1,Luis,28,ES15209597283499285728,TRX_N-00221-94854902,2021-10-01T08:36:33,Bilbao,transfer,Salary,1289.91,-22606.93
buyer_1,Luis,28,ES15209597283499285728,TRX_N-00222-05143246,2021-10-01T08:36:33,Bilbao,transfer,Extra Income,128.99,-22477.94
buyer_1,Luis,28,ES15209597283499285728,TRX_N-00223-73987528,2021-10-01T19:59:16,Bilbao,Expense,food,-332.64,-22810.58
buyer_1,Luis,28,ES15209597283499285728,TRX_N-00224-31408931,2021-10-02T14:52:00,Bilbao,Expense,food,-182.19,-22992.77
buyer_1,Luis,28,ES15209597283499285728,TRX_N-00225-97247980,2021-10-02T04:28:27,Bilbao,Expense,transport,-158.26,-23151.03
buyer_1,Luis,28,ES15209597283499285728,TRX_N-00226-73479088,2021-10-05T21:34:48,Bilbao,Housing,Rent,-1240.78,-24391.81
buyer_1,Luis,28,ES15209597283499285728,TRX_N-00227-97808108,2021-10-06T12:40:40,Bilbao,Basic services,water,-44.55,-24436.36
buyer_1,Luis,28,ES15209597283499285728,TRX_N-00228-78270936,2021-10-06T08:12:06,Bilbao,Basic services,electricity,-35.29,-24471.65
buyer_1,Luis,28,ES15209597283499285728,TRX_N-00229-43435467,2021-10-06T19:12:22,Bilbao,Basic services,internet,-56.85,-24528.5
buyer_1,Luis,28,ES15209597283499285728,TRX_N-00230-78520178,2021-10-06T16:01:32,Bilbao,Basic services,phone,-45.08,-24573.58
buyer_1,Luis,28,ES15209597283499285728,TRX_N-00231-19979504,2021-10-07T06:17:48,Bilbao,Basic services,water,-68.46,-24642.04
buyer_1,Luis,28,ES15209597283499285728,TRX_N-00232-80801565,2021-10-07T08:35:47,Bilbao,Basic services,electricity,-46.5,-24688.54
buyer_1,Luis,28,ES15209597283499285728,TRX_N-00233-95374700,2021-10-14T00:06:08,Bilbao,Expense,food,-783.71,-25472.25
buyer_1,Luis,28,ES15209597283499285728,TRX_N-00234-77976592,2021-10-14T15:02:12,Bilbao,Expense,repairs,-309.55,-25781.8
buyer_1,Luis,28,ES15209597283499285728,TRX_N-00235-12489955,2021-10-21T02:29:19,Bilbao,Expense,food,-485.39,-26267.19
buyer_1,Luis,28,ES15209597283499285728,TRX_N-00236-47408857,2021-10-22T08:47:38,Bilbao,Expense,transport,-166.55,-26433.74
buyer_1,Luis,28,ES15209597283499285728,TRX_N-00237-18211998,2021-10-25T08:02:48,Bilbao,Expense,travel,-1526.75,-27960.49
buyer_1,Luis,28,ES15209597283499285728,TRX_N-00238-26721109,2021-11-01T11:44:04,Bilbao,transfer,Salary,1289.91,-26670.58
buyer_1,Luis,28,ES15209597283499285728,TRX_N-00239-15499274,2021-11-01T00:53:02,Bilbao,Expense,leisure,-170.22,-26840.8
buyer_1,Luis,28,ES15209597283499285728,TRX_N-00240-86680633,2021-11-01T20:20:56,Bilbao,Expense,clothing,-80.16,-26920.96
buyer_1,Luis,28,ES15209597283499285728,TRX_N-00241-19448487,2021-11-04T04:07:30,Bilbao,Expense,education,-758.99,-27679.95
buyer_1,Luis,28,ES15209597283499285728,TRX_N-00242-40403950,2021-11-05T03:22:35,Bilbao,Housing,Rent,-1240.78,-28920.73
buyer_1,Luis,28,ES15209597283499285728,TRX_N-00243-19877018,2021-11-05T17:51:32,Bilbao,Basic services,gas,-21.02,-28941.75
buyer_1,Luis,28,ES15209597283499285728,TRX_N-00244-10470293,2021-11-05T14:18:38,Bilbao,Basic services,phone,-38.06,-28979.81
buyer_1,Luis,28,ES15209597283499285728,TRX_N-00245-54261785,2021-11-07T17:36:53,Bilbao,Basic services,gas,-96.86,-29076.67
buyer_1,Luis,28,ES15209597283499285728,TRX_N-00246-80740164,2021-11-12T14:03:59,Bilbao,Expense,clothing,-368.52,-29445.19
buyer_1,Luis,28,ES15209597283499285728,TRX_N-00247-58294365,2021-11-13T18:07:54,Bilbao,Expense,clothing,-416.76,-29861.95
buyer_1,Luis,28,ES15209597283499285728,TRX_N-00248-73220930,2021-11-15T20:49:13,Bilbao,Expense,leisure,-209.3,-30071.25
buyer_1,Luis,28,ES15209597283499285728,TRX_N-00249-49564574,2021-11-16T01:58:11,Bilbao,Expense,food,-376.49,-30447.74
buyer_1,Luis,28,ES15209597283499285728,TRX_N-00250-18251493,2021-11-18T09:43:38,Bilbao,Expense,travel,-2635.58,-33083.32
buyer_1,Luis,28,ES15209597283499285728,TRX_N-00251-52857898,2021-11-20T12:37:45,Bilbao,Expense,food,-175.03,-33258.35
buyer_1,Luis,28,ES15209597283499285728,TRX_N-00252-41426963,2021-11-27T15:45:28,Lasarte-Oria,Expense,healthcare,-118.64,-33376.99
buyer_1,Luis,28,ES15209597283499285728,TRX_N-00253-48090704,2021-11-28T13:37:22,Bilbao,Expense,appliances,-234.78,-33611.77
buyer_1,Luis,28,ES15209597283499285728,TRX_N-00254-20058774,2021-12-01T09:57:23,Bilbao,transfer,Salary,1289.91,-32321.86
buyer_1,Luis,28,ES15209597283499285728,TRX_N-00255-10805959,2021-12-01T09:57:23,Bilbao,transfer,Bonus,1325.46,-30996.4
buyer_1,Luis,28,ES15209597283499285728,TRX_N-00256-34164676,2021-12-05T10:10:08,Bilbao,Housing,Rent,-1240.78,-32237.18
buyer_1,Luis,28,ES15209597283499285728,TRX_N-00257-24472014,2021-12-05T13:20:24,Bilbao,Basic services,gas,-78.83,-32316.01
buyer_1,Luis,28,ES15209597283499285728,TRX_N-00258-34582506,2021-12-06T10:44:44,Bilbao,Basic services,electricity,-111.21,-32427.22
buyer_1,Luis,28,ES15209597283499285728,TRX_N-00259-63338920,2021-12-07T06:46:03,Bilbao,Basic services,electricity,-82.74,-32509.96
buyer_1,Luis,28,ES15209597283499285728,TRX_N-00260-85450863,2021-12-07T09:29:29,Bilbao,Basic services,gas,-99.88,-32609.84
buyer_1,Luis,28,ES15209597283499285728,TRX_N-00261-31407353,2021-12-16T17:35:28,Bilbao,Expense,clothing,-373.58,-32983.42
buyer_1,Luis,28,ES15209597283499285728,TRX_N-00262-12478229,2021-12-26T12:48:46,Oyón-Oion,Expense,leisure,-67.82,-33051.24
buyer_1,Luis,28,ES15209597283499285728,TRX_N-00263-17290585,2021-12-27T11:13:19,Bilbao,Expense,leisure,-111.07,-33162.31
buyer_1,Luis,28,ES15209597283499285728,TRX_N-00264-46843882,2022-01-01T11:07:19,Bilbao,transfer,Salary,1289.91,-31872.4
buyer_1,Luis,28,ES15209597283499285728,TRX_N-00265-50125039,2022-01-01T11:07:19,Bilbao,transfer,Extra Income,128.99,-31743.41
buyer_1,Luis,28,ES15209597283499285728,TRX_N-00266-85031939,2022-01-05T13:41:06,Bilbao,Housing,Rent,-1240.78,-32984.19
buyer_1,Luis,28,ES15209597283499285728,TRX_N-00267-69685481,2022-01-05T13:02:54,Bilbao,Basic services,electricity,-37.64,-33021.83
buyer_1,Luis,28,ES15209597283499285728,TRX_N-00268-56524231,2022-01-06T14:02:47,Bilbao,Basic services,electricity,-133.85,-33155.68
buyer_1,Luis,28,ES15209597283499285728,TRX_N-00269-06051263,2022-01-06T08:54:16,Bilbao,Basic services,gas,-33.5,-33189.18
buyer_1,Luis,28,ES15209597283499285728,TRX_N-00270-15794602,2022-01-07T02:20:50,Bilbao,Basic services,gas,-56.7,-33245.88
buyer_1,Luis,28,ES15209597283499285728,TRX_N-00271-62887424,2022-01-25T15:10:21,Bilbao,Expense,repairs,-523.63,-33769.51
buyer_1,Luis,28,ES15209597283499285728,TRX_N-00272-25364654,2022-02-01T15:22:34,Bilbao,transfer,Salary,1289.91,-32479.6
buyer_1,Luis,28,ES15209597283499285728,TRX_N-00273-74499872,2022-02-05T19:37:33,Bilbao,Housing,Rent,-1240.78,-33720.38
buyer_1,Luis,28,ES15209597283499285728,TRX_N-00274-06178437,2022-02-05T19:57:34,Bilbao,Basic services,electricity,-63.4,-33783.78
buyer_1,Luis,28,ES15209597283499285728,TRX_N-00275-81612319,2022-02-06T16:50:29,Bilbao,Basic services,phone,-90.92,-33874.7
buyer_1,Luis,28,ES15209597283499285728,TRX_N-00276-55901998,2022-02-07T09:26:00,Bilbao,Basic services,internet,-57.35,-33932.05
buyer_1,Luis,28,ES15209597283499285728,TRX_N-00277-10879852,2022-02-07T21:15:09,Bilbao,Basic services,phone,-23.87,-33955.92
buyer_1,Luis,28,ES15209597283499285728,TRX_N-00278-62563319,2022-02-09T18:29:25,Vitoria-Gasteiz,Expense,healthcare,-366.46,-34322.38
buyer_1,Luis,28,ES15209597283499285728,TRX_N-00279-73400826,2022-02-25T20:53:03,Bilbao,Expense,gifts,-460.7,-34783.08
buyer_1,Luis,28,ES15209597283499285728,TRX_N-00280-54788771,2022-03-01T17:14:15,Bilbao,transfer,Salary,1289.91,-33493.17
buyer_1,Luis,28,ES15209597283499285728,TRX_N-00281-35024441,2022-03-05T15:21:37,Bilbao,Housing,Rent,-1240.78,-34733.95
buyer_1,Luis,28,ES15209597283499285728,TRX_N-00282-40120839,2022-03-05T18:04:30,Bilbao,Basic services,electricity,-102.67,-34836.62
buyer_1,Luis,28,ES15209597283499285728,TRX_N-00283-95633516,2022-03-06T13:28:22,Bilbao,Basic services,internet,-58.64,-34895.26
buyer_1,Luis,28,ES15209597283499285728,TRX_N-00284-18167653,2022-03-07T13:44:09,Bilbao,Basic services,electricity,-26.15,-34921.41
buyer_1,Luis,28,ES15209597283499285728,TRX_N-00285-64713156,2022-03-07T15:52:42,Bilbao,Basic services,internet,-65.02,-34986.43
buyer_1,Luis,28,ES15209597283499285728,TRX_N-00286-86647652,2022-03-16T19:13:18,Bilbao,Expense,leisure,-216.05,-35202.48
buyer_1,Luis,28,ES15209597283499285728,TRX_N-00287-78890367,2022-03-18T12:13:48,Bilbao,Expense,leisure,-90.62,-35293.1
buyer_1,Luis,28,ES15209597283499285728,TRX_N-00288-95720671,2022-04-01T20:09:43,Bilbao,transfer,Salary,1289.91,-34003.19
buyer_1,Luis,28,ES15209597283499285728,TRX_N-00289-19284232,2022-04-01T20:09:43,Bilbao,transfer,Extra Income,128.99,-33874.2
buyer_1,Luis,28,ES15209597283499285728,TRX_N-00290-72897659,2022-04-03T08:02:17,Bilbao,Expense,repairs,-409.48,-34283.68
buyer_1,Luis,28,ES15209597283499285728,TRX_N-00291-27431826,2022-04-05T14:11:32,Bilbao,Housing,Rent,-1240.78,-35524.46
buyer_1,Luis,28,ES15209597283499285728,TRX_N-00292-19462647,2022-04-05T08:50:01,Bilbao,Basic services,electricity,-42.59,-35567.05
buyer_1,Luis,28,ES15209597283499285728,TRX_N-00293-94154501,2022-04-05T16:03:19,Bilbao,Basic services,internet,-33.43,-35600.48
buyer_1,Luis,28,ES15209597283499285728,TRX_N-00294-49242646,2022-04-06T20:10:27,Bilbao,Basic services,water,-49.96,-35650.44
buyer_1,Luis,28,ES15209597283499285728,TRX_N-00295-15772108,2022-04-06T22:58:24,Bilbao,Basic services,gas,-91.41,-35741.85
buyer_1,Luis,28,ES15209597283499285728,TRX_N-00296-13084087,2022-04-07T19:50:11,Bilbao,Basic services,electricity,-77.54,-35819.39
buyer_1,Luis,28,ES15209597283499285728,TRX_N-00297-85952625,2022-04-07T16:55:44,Bilbao,Basic services,gas,-18.25,-35837.64
buyer_1,Luis,28,ES15209597283499285728,TRX_N-00298-80573143,2022-04-07T16:24:00,Bilbao,Basic services,internet,-78.97,-35916.61
buyer_1,Luis,28,ES15209597283499285728,TRX_N-00299-67006560,2022-04-14T14:48:26,Zarautz,Expense,leisure,-120.43,-36037.04
buyer_1,Luis,28,ES15209597283499285728,TRX_N-00300-79098961,2022-04-24T08:51:10,Bilbao,Expense,transport,-109.47,-36146.51
buyer_1,Luis,28,ES15209597283499285728,TRX_N-00301-43246673,2022-05-01T09:42:20,Bilbao,transfer,Salary,1289.91,-34856.6
buyer_1,Luis,28,ES15209597283499285728,TRX_N-00302-40776946,2022-05-05T13:16:53,Bilbao,Housing,Rent,-1240.78,-36097.38
buyer_1,Luis,28,ES15209597283499285728,TRX_N-00303-62030561,2022-05-05T10:02:19,Bilbao,Basic services,electricity,-118.32,-36215.7
buyer_1,Luis,28,ES15209597283499285728,TRX_N-00304-98589342,2022-05-05T08:36:55,Bilbao,Basic services,internet,-64.12,-36279.82
buyer_1,Luis,28,ES15209597283499285728,TRX_N-00305-19562928,2022-05-05T19:00:40,Bilbao,Expense,repairs,-191.29,-36471.11
buyer_1,Luis,28,ES15209597283499285728,TRX_N-00306-18967241,2022-05-06T17:10:42,Bilbao,Basic services,electricity,-110.5,-36581.61
buyer_1,Luis,28,ES15209597283499285728,TRX_N-00307-90836941,2022-05-06T21:14:57,Bilbao,Basic services,gas,-55.23,-36636.84
buyer_1,Luis,28,ES15209597283499285728,TRX_N-00308-30942606,2022-05-06T14:06:21,Bilbao,Basic services,internet,-79.9,-36716.74
buyer_1,Luis,28,ES15209597283499285728,TRX_N-00309-07041356,2022-05-07T09:31:01,Bilbao,Basic services,water,-51.81,-36768.55
buyer_1,Luis,28,ES15209597283499285728,TRX_N-00310-78529630,2022-05-07T15:12:55,Bilbao,Expense,repairs,-469.84,-37238.39
buyer_1,Luis,28,ES15209597283499285728,TRX_N-00311-00276399,2022-05-28T12:43:39,Bilbao,Expense,gifts,-45.01,-37283.4
buyer_1,Luis,28,ES15209597283499285728,TRX_N-00312-20600557,2022-05-29T19:19:19,Galdakao,Expense,education,-218.39,-37501.79
buyer_1,Luis,28,ES15209597283499285728,TRX_N-00313-63437879,2022-06-01T11:18:44,Bilbao,transfer,Salary,1289.91,-36211.88
buyer_1,Luis,28,ES15209597283499285728,TRX_N-00314-88189839,2022-06-01T11:18:44,Bilbao,transfer,Bonus,1167.79,-35044.09
buyer_1,Luis,28,ES15209597283499285728,TRX_N-00315-19983808,2022-06-05T07:59:46,Bilbao,Housing,Rent,-1240.78,-36284.87
buyer_1,Luis,28,ES15209597283499285728,TRX_N-00316-25194706,2022-06-05T12:27:29,Bilbao,Basic services,water,-73.49,-36358.36
buyer_1,Luis,28,ES15209597283499285728,TRX_N-00317-02694552,2022-06-06T16:40:05,Bilbao,Basic services,water,-27.76,-36386.12
buyer_1,Luis,28,ES15209597283499285728,TRX_N-00318-95725766,2022-06-06T20:04:52,Bilbao,Basic services,internet,-38.93,-36425.05
buyer_1,Luis,28,ES15209597283499285728,TRX_N-00319-89717814,2022-06-06T12:07:45,Bilbao,Expense,transport,-72.12,-36497.17
buyer_1,Luis,28,ES15209597283499285728,TRX_N-00320-06121747,2022-06-07T04:55:31,Bilbao,Basic services,water,-44.61,-36541.78
buyer_1,Luis,28,ES15209597283499285728,TRX_N-00321-40282892,2022-06-07T13:46:43,Bilbao,Basic services,electricity,-65.35,-36607.13
buyer_1,Luis,28,ES15209597283499285728,TRX_N-00322-40817466,2022-06-07T08:55:34,Bilbao,Basic services,gas,-48.06,-36655.19
buyer_1,Luis,28,ES15209597283499285728,TRX_N-00323-46066552,2022-06-13T19:52:57,Portugalete,Expense,food,-518.26,-37173.45
buyer_1,Luis,28,ES15209597283499285728,TRX_N-00324-13936697,2022-06-19T20:22:25,Bilbao,Expense,leisure,-127.63,-37301.08
buyer_1,Luis,28,ES15209597283499285728,TRX_N-00325-86257080,2022-06-23T10:45:43,Bilbao,Expense,clothing,-83.21,-37384.29
buyer_1,Luis,28,ES15209597283499285728,TRX_N-00326-05116896,2022-06-25T16:33:30,Bilbao,Expense,healthcare,-275.51,-37659.8
buyer_1,Luis,28,ES15209597283499285728,TRX_N-00327-84790352,2022-06-28T18:51:18,Bilbao,Expense,transport,-40.71,-37700.51
buyer_1,Luis,28,ES15209597283499285728,TRX_N-00328-61953582,2022-07-01T17:01:16,Bilbao,transfer,Salary,1289.91,-36410.6
buyer_1,Luis,28,ES15209597283499285728,TRX_N-00329-09753481,2022-07-01T17:01:16,Bilbao,transfer,Extra Income,128.99,-36281.61
buyer_1,Luis,28,ES15209597283499285728,TRX_N-00330-90211109,2022-07-05T10:24:26,Bilbao,Housing,Rent,-1240.78,-37522.39
buyer_1,Luis,28,ES15209597283499285728,TRX_N-00331-94291261,2022-07-05T17:28:59,Bilbao,Basic services,water,-48.08,-37570.47
buyer_1,Luis,28,ES15209597283499285728,TRX_N-00332-04572863,2022-07-05T14:04:02,Bilbao,Basic services,gas,-77.75,-37648.22
buyer_1,Luis,28,ES15209597283499285728,TRX_N-00333-27498070,2022-07-06T18:34:17,Bilbao,Basic services,internet,-69.76,-37717.98
buyer_1,Luis,28,ES15209597283499285728,TRX_N-00334-54106632,2022-07-07T14:34:41,Bilbao,Basic services,water,-20.88,-37738.86
buyer_1,Luis,28,ES15209597283499285728,TRX_N-00335-98150981,2022-07-07T13:54:26,Bilbao,Basic services,gas,-83.69,-37822.55
buyer_1,Luis,28,ES15209597283499285728,TRX_N-00336-70722437,2022-07-07T17:09:30,Bilbao,Basic services,internet,-73.96,-37896.51
buyer_1,Luis,28,ES15209597283499285728,TRX_N-00337-19216191,2022-07-07T18:12:49,Bilbao,Basic services,phone,-20.89,-37917.4
buyer_1,Luis,28,ES15209597283499285728,TRX_N-00338-09097010,2022-07-09T12:07:11,Bilbao,Expense,clothing,-449.83,-38367.23
buyer_1,Luis,28,ES15209597283499285728,TRX_N-00339-65295205,2022-07-16T14:13:01,Bilbao,Expense,clothing,-384.25,-38751.48
buyer_1,Luis,28,ES15209597283499285728,TRX_N-00340-82512616,2022-07-17T23:37:54,Bilbao,Expense,appliances,-631.81,-39383.29
buyer_1,Luis,28,ES15209597283499285728,TRX_N-00341-21560601,2022-07-23T20:58:07,Bilbao,Expense,leisure,-86.88,-39470.17
buyer_1,Luis,28,ES15209597283499285728,TRX_N-00342-78802868,2022-08-01T20:37:07,Bilbao,transfer,Salary,1289.91,-38180.26
buyer_1,Luis,28,ES15209597283499285728,TRX_N-00343-42382328,2022-08-02T11:15:42,Pasaia,Expense,leisure,-49.03,-38229.29
buyer_1,Luis,28,ES15209597283499285728,TRX_N-00344-06042204,2022-08-05T16:15:07,Bilbao,Housing,Rent,-1240.78,-39470.07
buyer_1,Luis,28,ES15209597283499285728,TRX_N-00345-06167479,2022-08-05T16:06:49,Bilbao,Basic services,electricity,-118.25,-39588.32
buyer_1,Luis,28,ES15209597283499285728,TRX_N-00346-54132328,2022-08-05T07:25:42,Bilbao,Basic services,internet,-63.43,-39651.75
buyer_1,Luis,28,ES15209597283499285728,TRX_N-00347-92587424,2022-08-06T16:18:03,Bilbao,Basic services,water,-69.86,-39721.61
buyer_1,Luis,28,ES15209597283499285728,TRX_N-00348-55761899,2022-08-06T21:16:21,Bilbao,Basic services,gas,-51.61,-39773.22
buyer_1,Luis,28,ES15209597283499285728,TRX_N-00349-67942213,2022-08-31T14:41:20,Bilbao,Expense,healthcare,-160.36,-39933.58
buyer_1,Luis,28,ES15209597283499285728,TRX_N-00350-37292665,2022-09-01T06:40:10,Bilbao,transfer,Salary,1289.91,-38643.67
buyer_1,Luis,28,ES15209597283499285728,TRX_N-00351-30792240,2022-09-01T06:40:10,Bilbao,transfer,Extra Income,128.99,-38514.68
buyer_1,Luis,28,ES15209597283499285728,TRX_N-00352-13129850,2022-09-05T11:29:11,Bilbao,Housing,Rent,-1240.78,-39755.46
buyer_1,Luis,28,ES15209597283499285728,TRX_N-00353-91398121,2022-09-05T11:16:05,Bilbao,Basic services,water,-58.65,-39814.11
buyer_1,Luis,28,ES15209597283499285728,TRX_N-00354-40929589,2022-09-05T13:05:09,Bilbao,Basic services,phone,-80.8,-39894.91
buyer_1,Luis,28,ES15209597283499285728,TRX_N-00355-29430542,2022-09-06T12:30:05,Bilbao,Basic services,water,-42.51,-39937.42
buyer_1,Luis,28,ES15209597283499285728,TRX_N-00356-32971228,2022-09-06T11:16:46,Bilbao,Basic services,gas,-95.28,-40032.7
buyer_1,Luis,28,ES15209597283499285728,TRX_N-00357-58823155,2022-09-06T13:51:37,Bilbao,Basic services,internet,-60.46,-40093.16
buyer_1,Luis,28,ES15209597283499285728,TRX_N-00358-35644777,2022-09-07T03:18:56,Bilbao,Basic services,electricity,-108.23,-40201.39
buyer_1,Luis,28,ES15209597283499285728,TRX_N-00359-45122561,2022-09-14T14:05:35,Bilbao,Expense,food,-445.4,-40646.79
buyer_1,Luis,28,ES15209597283499285728,TRX_N-00360-80603327,2022-09-25T13:50:58,Bilbao,Expense,healthcare,-309.75,-40956.54
buyer_1,Luis,28,ES15209597283499285728,TRX_N-00361-84295824,2022-09-27T23:06:57,Bilbao,Expense,healthcare,-270.22,-41226.76
buyer_1,Luis,28,ES15209597283499285728,TRX_N-00362-82462185,2022-10-01T18:20:15,Bilbao,transfer,Salary,1289.91,-39936.85
buyer_1,Luis,28,ES15209597283499285728,TRX_N-00363-73803507,2022-10-05T12:43:58,Bilbao,Housing,Rent,-1240.78,-41177.63
buyer_1,Luis,28,ES15209597283499285728,TRX_N-00364-20619408,2022-10-06T15:30:21,Bilbao,Basic services,electricity,-119.96,-41297.59
buyer_1,Luis,28,ES15209597283499285728,TRX_N-00365-68578185,2022-10-06T09:57:05,Bilbao,Basic services,internet,-72.5,-41370.09
buyer_1,Luis,28,ES15209597283499285728,TRX_N-00366-47207850,2022-10-06T10:14:00,Bilbao,Basic services,phone,-66.07,-41436.16
buyer_1,Luis,28,ES15209597283499285728,TRX_N-00367-60352740,2022-10-07T12:54:45,Bilbao,Basic services,gas,-91.43,-41527.59
buyer_1,Luis,28,ES15209597283499285728,TRX_N-00368-30393690,2022-10-09T17:56:31,Bilbao,Expense,food,-563.78,-42091.37
buyer_1,Luis,28,ES15209597283499285728,TRX_N-00369-49789777,2022-10-19T13:01:49,Bilbao,Expense,clothing,-98.28,-42189.65
buyer_1,Luis,28,ES15209597283499285728,TRX_N-00370-87935370,2022-10-19T07:11:55,Bilbao,Expense,healthcare,-386.01,-42575.66
buyer_1,Luis,28,ES15209597283499285728,TRX_N-00371-64531390,2022-10-20T20:18:25,Bilbao,Expense,food,-276.6,-42852.26
buyer_1,Luis,28,ES15209597283499285728,TRX_N-00372-33378361,2022-10-25T23:42:02,Andoain,Expense,transport,-103.71,-42955.97
buyer_1,Luis,28,ES15209597283499285728,TRX_N-00373-45710211,2022-11-01T18:54:50,Bilbao,transfer,Salary,1289.91,-41666.06
buyer_1,Luis,28,ES15209597283499285728,TRX_N-00374-81697783,2022-11-01T18:54:50,Bilbao,transfer,Extra Income,128.99,-41537.07
buyer_1,Luis,28,ES15209597283499285728,TRX_N-00375-81855141,2022-11-05T11:10:05,Bilbao,Housing,Rent,-1240.78,-42777.85
buyer_1,Luis,28,ES15209597283499285728,TRX_N-00376-41963824,2022-11-05T15:37:27,Bilbao,Basic services,water,-32.54,-42810.39
buyer_1,Luis,28,ES15209597283499285728,TRX_N-00377-96329000,2022-11-06T15:24:34,Bilbao,Basic services,phone,-90.73,-42901.12
buyer_1,Luis,28,ES15209597283499285728,TRX_N-00378-89322447,2022-11-07T21:23:22,Bilbao,Basic services,gas,-72.6,-42973.72
buyer_1,Luis,28,ES15209597283499285728,TRX_N-00379-16207984,2022-11-08T17:27:28,Bilbao,Expense,transport,-98.85,-43072.57
buyer_1,Luis,28,ES15209597283499285728,TRX_N-00380-63958276,2022-11-09T07:20:34,Erandio,Expense,food,-210.41,-43282.98
buyer_1,Luis,28,ES15209597283499285728,TRX_N-00381-52399467,2022-11-10T11:28:29,Bilbao,Expense,food,-399.88,-43682.86
buyer_1,Luis,28,ES15209597283499285728,TRX_N-00382-94973492,2022-11-23T09:54:28,Bilbao,Expense,food,-383.95,-44066.81
buyer_1,Luis,28,ES15209597283499285728,TRX_N-00383-92103621,2022-11-26T13:55:23,Bilbao,Expense,food,-499.28,-44566.09
buyer_1,Luis,28,ES15209597283499285728,TRX_N-00384-52487061,2022-11-26T10:32:57,Donostia,Expense,leisure,-134.31,-44700.4
buyer_1,Luis,28,ES15209597283499285728,TRX_N-00385-59268592,2022-12-01T18:18:17,Bilbao,transfer,Salary,1289.91,-43410.49
buyer_1,Luis,28,ES15209597283499285728,TRX_N-00386-40634244,2022-12-01T18:18:17,Bilbao,transfer,Bonus,1372.81,-42037.68
buyer_1,Luis,28,ES15209597283499285728,TRX_N-00387-79236862,2022-12-01T10:36:28,Lasarte-Oria,Expense,food,-456.2,-42493.88
buyer_1,Luis,28,ES15209597283499285728,TRX_N-00388-90281054,2022-12-01T15:26:23,Bilbao,Expense,transport,-36.42,-42530.3
buyer_1,Luis,28,ES15209597283499285728,TRX_N-00389-71264532,2022-12-05T11:50:53,Bilbao,Housing,Rent,-1240.78,-43771.08
buyer_1,Luis,28,ES15209597283499285728,TRX_N-00390-92149379,2022-12-05T17:44:31,Bilbao,Basic services,internet,-45.96,-43817.04
buyer_1,Luis,28,ES15209597283499285728,TRX_N-00391-55966444,2022-12-06T15:55:25,Bilbao,Basic services,water,-65.84,-43882.88
buyer_1,Luis,28,ES15209597283499285728,TRX_N-00392-66263857,2022-12-06T20:11:25,Bilbao,Basic services,electricity,-110.47,-43993.35
buyer_1,Luis,28,ES15209597283499285728,TRX_N-00393-09178701,2022-12-06T17:24:46,Bilbao,Basic services,gas,-26.99,-44020.34
buyer_1,Luis,28,ES15209597283499285728,TRX_N-00394-97920819,2022-12-06T19:33:58,Bilbao,Basic services,internet,-44.3,-44064.64
buyer_1,Luis,28,ES15209597283499285728,TRX_N-00395-46983906,2022-12-10T21:04:13,Bilbao,Expense,food,-477.82,-44542.46
buyer_1,Luis,28,ES15209597283499285728,TRX_N-00396-16021905,2022-12-14T10:26:52,Bilbao,Expense,clothing,-195.56,-44738.02
buyer_1,Luis,28,ES15209597283499285728,TRX_N-00397-62861909,2022-12-19T18:36:40,Bilbao,Expense,food,-479.92,-45217.94
buyer_1,Luis,28,ES15209597283499285728,TRX_N-00398-26915705,2023-01-01T20:41:02,Bilbao,transfer,Salary,1289.91,-43928.03
buyer_1,Luis,28,ES15209597283499285728,TRX_N-00399-51411237,2023-01-01T20:41:02,Bilbao,transfer,Extra Income,128.99,-43799.04
buyer_1,Luis,28,ES15209597283499285728,TRX_N-00400-77292265,2023-01-01T15:58:23,Bilbao,Expense,leisure,-16.71,-43815.75
buyer_1,Luis,28,ES15209597283499285728,TRX_N-00401-02230282,2023-01-01T16:13:51,Bilbao,Expense,clothing,-464.38,-44280.13
buyer_1,Luis,28,ES15209597283499285728,TRX_N-00402-10806064,2023-01-04T20:23:31,Bilbao,Expense,leisure,-139.35,-44419.48
buyer_1,Luis,28,ES15209597283499285728,TRX_N-00403-95636181,2023-01-05T19:48:46,Bilbao,Housing,Rent,-1240.78,-45660.26
buyer_1,Luis,28,ES15209597283499285728,TRX_N-00404-73719517,2023-01-06T21:29:10,Bilbao,Basic services,electricity,-72.57,-45732.83
buyer_1,Luis,28,ES15209597283499285728,TRX_N-00405-00888168,2023-01-07T21:50:02,Bilbao,Basic services,gas,-50.52,-45783.35
buyer_1,Luis,28,ES15209597283499285728,TRX_N-00406-19424174,2023-01-24T00:39:22,Durango,Expense,healthcare,-252.38,-46035.73
buyer_1,Luis,28,ES15209597283499285728,TRX_N-00407-74343898,2023-02-01T19:52:16,Bilbao,transfer,Salary,1289.91,-44745.82
buyer_1,Luis,28,ES15209597283499285728,TRX_N-00408-36238587,2023-02-05T20:06:00,Bilbao,Housing,Rent,-1240.78,-45986.6
buyer_1,Luis,28,ES15209597283499285728,TRX_N-00409-76443928,2023-02-06T05:15:27,Bilbao,Basic services,water,-68.03,-46054.63
buyer_1,Luis,28,ES15209597283499285728,TRX_N-00410-97171603,2023-02-06T12:10:44,Bilbao,Basic services,electricity,-38.5,-46093.13
buyer_1,Luis,28,ES15209597283499285728,TRX_N-00411-90120912,2023-02-07T22:36:57,Bilbao,Basic services,electricity,-134.02,-46227.15
buyer_1,Luis,28,ES15209597283499285728,TRX_N-00412-16887725,2023-02-12T14:15:39,Bilbao,Expense,food,-753.6,-46980.75
buyer_1,Luis,28,ES15209597283499285728,TRX_N-00413-80990356,2023-02-21T23:28:15,Bilbao,Expense,leisure,-56.29,-47037.04
buyer_1,Luis,28,ES15209597283499285728,TRX_N-00414-34414931,2023-03-01T17:29:02,Bilbao,transfer,Salary,1289.91,-45747.13
buyer_1,Luis,28,ES15209597283499285728,TRX_N-00415-22858696,2023-03-01T17:29:02,Bilbao,transfer,Extra Income,128.99,-45618.14
buyer_1,Luis,28,ES15209597283499285728,TRX_N-00416-39019978,2023-03-05T18:06:26,Bilbao,Housing,Rent,-1240.78,-46858.92
buyer_1,Luis,28,ES15209597283499285728,TRX_N-00417-22876145,2023-03-05T04:54:00,Bilbao,Basic services,electricity,-51.61,-46910.53
buyer_1,Luis,28,ES15209597283499285728,TRX_N-00418-09020392,2023-03-05T10:42:13,Bilbao,Basic services,gas,-18.24,-46928.77
buyer_1,Luis,28,ES15209597283499285728,TRX_N-00419-04653801,2023-03-05T12:32:20,Bilbao,Basic services,internet,-50.9,-46979.67
buyer_1,Luis,28,ES15209597283499285728,TRX_N-00420-72289169,2023-03-05T11:19:17,Bilbao,Basic services,phone,-48.32,-47027.99
buyer_1,Luis,28,ES15209597283499285728,TRX_N-00421-00509036,2023-03-06T08:44:15,Bilbao,Basic services,water,-12.43,-47040.42
buyer_1,Luis,28,ES15209597283499285728,TRX_N-00422-38161092,2023-03-07T16:53:40,Bilbao,Basic services,electricity,-139.71,-47180.13
buyer_1,Luis,28,ES15209597283499285728,TRX_N-00423-56349500,2023-03-11T17:10:25,Hondarribia,Expense,food,-748.49,-47928.62
buyer_1,Luis,28,ES15209597283499285728,TRX_N-00424-08147959,2023-03-20T19:00:06,Bilbao,Expense,food,-530.54,-48459.16
buyer_1,Luis,28,ES15209597283499285728,TRX_N-00425-10053167,2023-04-01T18:48:09,Bilbao,transfer,Salary,1289.91,-47169.25
buyer_1,Luis,28,ES15209597283499285728,TRX_N-00426-62506639,2023-04-05T12:27:50,Bilbao,Housing,Rent,-1240.78,-48410.03
buyer_1,Luis,28,ES15209597283499285728,TRX_N-00427-35780719,2023-04-05T00:25:54,Bilbao,Basic services,phone,-20.5,-48430.53
buyer_1,Luis,28,ES15209597283499285728,TRX_N-00428-42902378,2023-04-07T22:47:09,Bilbao,Basic services,water,-24.84,-48455.37
buyer_1,Luis,28,ES15209597283499285728,TRX_N-00429-24744409,2023-04-07T13:32:10,Bilbao,Basic services,internet,-39.06,-48494.43
buyer_1,Luis,28,ES15209597283499285728,TRX_N-00430-11557810,2023-04-07T08:55:34,Bilbao,Basic services,phone,-65.99,-48560.42
buyer_1,Luis,28,ES15209597283499285728,TRX_N-00431-19019706,2023-05-01T08:07:04,Bilbao,transfer,Salary,1289.91,-47270.51
buyer_1,Luis,28,ES15209597283499285728,TRX_N-00432-93668275,2023-05-05T18:30:35,Bilbao,Housing,Rent,-1240.78,-48511.29
buyer_1,Luis,28,ES15209597283499285728,TRX_N-00433-56628926,2023-05-05T10:36:43,Bilbao,Basic services,water,-65.25,-48576.54
buyer_1,Luis,28,ES15209597283499285728,TRX_N-00434-54251994,2023-05-05T20:46:30,Bilbao,Basic services,electricity,-140.57,-48717.11
buyer_1,Luis,28,ES15209597283499285728,TRX_N-00435-85316095,2023-05-06T08:56:53,Bilbao,Basic services,phone,-63.05,-48780.16
buyer_1,Luis,28,ES15209597283499285728,TRX_N-00436-84938829,2023-05-07T18:41:42,Bilbao,Basic services,electricity,-109.2,-48889.36
buyer_1,Luis,28,ES15209597283499285728,TRX_N-00437-92967622,2023-05-07T10:21:59,Bilbao,Basic services,gas,-18.35,-48907.71
buyer_1,Luis,28,ES15209597283499285728,TRX_N-00438-67572083,2023-05-07T12:46:10,Bilbao,Basic services,phone,-25.21,-48932.92
buyer_1,Luis,28,ES15209597283499285728,TRX_N-00439-04979616,2023-06-01T18:54:33,Bilbao,transfer,Salary,1289.91,-47643.01
buyer_1,Luis,28,ES15209597283499285728,TRX_N-00440-27890303,2023-06-01T18:54:33,Bilbao,transfer,Extra Income,128.99,-47514.02
buyer_1,Luis,28,ES15209597283499285728,TRX_N-00441-23851844,2023-06-01T18:54:33,Bilbao,transfer,Bonus,1174.99,-46339.03
buyer_1,Luis,28,ES15209597283499285728,TRX_N-00442-97916422,2023-06-05T11:03:05,Bilbao,Housing,Rent,-1240.78,-47579.81
buyer_1,Luis,28,ES15209597283499285728,TRX_N-00443-23229159,2023-06-05T16:59:51,Bilbao,Basic services,gas,-44.03,-47623.84
buyer_1,Luis,28,ES15209597283499285728,TRX_N-00444-30256392,2023-06-06T23:11:59,Bilbao,Basic services,electricity,-110.63,-47734.47
buyer_1,Luis,28,ES15209597283499285728,TRX_N-00445-79094378,2023-06-07T13:02:50,Bilbao,Basic services,electricity,-115.91,-47850.38
buyer_1,Luis,28,ES15209597283499285728,TRX_N-00446-84742765,2023-06-07T12:36:45,Bilbao,Basic services,internet,-55.0,-47905.38
buyer_1,Luis,28,ES15209597283499285728,TRX_N-00447-11802888,2023-06-07T13:27:52,Bilbao,Basic services,phone,-49.23,-47954.61
buyer_1,Luis,28,ES15209597283499285728,TRX_N-00448-67781662,2023-06-18T14:03:09,Bilbao,Expense,education,-904.49,-48859.1
buyer_1,Luis,28,ES15209597283499285728,TRX_N-00449-34568981,2023-06-30T09:48:57,Bilbao,Expense,clothing,-435.39,-49294.49
buyer_1,Luis,28,ES15209597283499285728,TRX_N-00450-22179285,2023-07-01T04:24:36,Bilbao,transfer,Salary,1289.91,-48004.58
buyer_1,Luis,28,ES15209597283499285728,TRX_N-00451-20551285,2023-07-02T01:53:50,Bilbao,Expense,healthcare,-36.46,-48041.04
buyer_1,Luis,28,ES15209597283499285728,TRX_N-00452-70246539,2023-07-05T12:46:44,Bilbao,Housing,Rent,-1240.78,-49281.82
buyer_1,Luis,28,ES15209597283499285728,TRX_N-00453-32469818,2023-07-07T12:01:48,Bilbao,Basic services,electricity,-54.71,-49336.53
buyer_1,Luis,28,ES15209597283499285728,TRX_N-00454-06664923,2023-07-07T11:12:17,Bilbao,Basic services,gas,-40.16,-49376.69
buyer_1,Luis,28,ES15209597283499285728,TRX_N-00455-16455007,2023-07-18T13:54:42,Bilbao,Expense,leisure,-135.7,-49512.39
buyer_1,Luis,28,ES15209597283499285728,TRX_N-00456-35500683,2023-07-22T18:42:11,Bilbao,Expense,food,-787.76,-50300.15
buyer_1,Luis,28,ES15209597283499285728,TRX_N-00457-01914448,2023-07-30T14:33:42,Bilbao,Expense,transport,-22.73,-50322.88
buyer_1,Luis,28,ES15209597283499285728,TRX_N-00458-59224037,2023-08-01T01:32:59,Bilbao,transfer,Salary,1289.91,-49032.97
buyer_1,Luis,28,ES15209597283499285728,TRX_N-00459-54438911,2023-08-03T08:32:48,Bilbao,Expense,education,-185.12,-49218.09
buyer_1,Luis,28,ES15209597283499285728,TRX_N-00460-94226759,2023-08-05T05:45:34,Bilbao,Housing,Rent,-1240.78,-50458.87
buyer_1,Luis,28,ES15209597283499285728,TRX_N-00461-78724879,2023-08-05T19:28:53,Bilbao,Basic services,gas,-55.19,-50514.06
buyer_1,Luis,28,ES15209597283499285728,TRX_N-00462-87150479,2023-08-05T11:36:00,Bilbao,Expense,food,-267.46,-50781.52
buyer_1,Luis,28,ES15209597283499285728,TRX_N-00463-00677188,2023-08-06T18:38:40,Bilbao,Basic services,electricity,-105.44,-50886.96
buyer_1,Luis,28,ES15209597283499285728,TRX_N-00464-16353855,2023-08-06T15:59:28,Bilbao,Expense,healthcare,-182.92,-51069.88
buyer_1,Luis,28,ES15209597283499285728,TRX_N-00465-02291925,2023-08-07T12:20:04,Bilbao,Basic services,phone,-59.07,-51128.95
buyer_1,Luis,28,ES15209597283499285728,TRX_N-00466-06157743,2023-08-09T08:16:23,Bilbao,Expense,healthcare,-347.82,-51476.77
buyer_1,Luis,28,ES15209597283499285728,TRX_N-00467-16573610,2023-08-21T15:15:30,Bilbao,Expense,leisure,-132.63,-51609.4
buyer_1,Luis,28,ES15209597283499285728,TRX_N-00468-60862543,2023-08-26T14:03:26,Bilbao,Expense,leisure,-247.16,-51856.56
buyer_1,Luis,28,ES15209597283499285728,TRX_N-00469-38209417,2023-09-01T14:03:59,Bilbao,transfer,Salary,1289.91,-50566.65
buyer_1,Luis,28,ES15209597283499285728,TRX_N-00470-20295250,2023-09-01T14:03:59,Bilbao,transfer,Extra Income,128.99,-50437.66
buyer_1,Luis,28,ES15209597283499285728,TRX_N-00471-10570530,2023-09-01T20:18:06,Bilbao,Expense,transport,-135.16,-50572.82
buyer_1,Luis,28,ES15209597283499285728,TRX_N-00472-49207118,2023-09-02T09:56:35,Bilbao,Expense,food,-728.01,-51300.83
buyer_1,Luis,28,ES15209597283499285728,TRX_N-00473-53094829,2023-09-05T20:25:30,Bilbao,Housing,Rent,-1240.78,-52541.61
buyer_1,Luis,28,ES15209597283499285728,TRX_N-00474-17317784,2023-09-05T00:37:15,Bilbao,Basic services,electricity,-76.69,-52618.3
buyer_1,Luis,28,ES15209597283499285728,TRX_N-00475-32892679,2023-09-06T15:49:39,Bilbao,Basic services,electricity,-134.75,-52753.05
buyer_1,Luis,28,ES15209597283499285728,TRX_N-00476-19292708,2023-09-06T09:50:05,Bilbao,Basic services,internet,-60.5,-52813.55
buyer_1,Luis,28,ES15209597283499285728,TRX_N-00477-24480805,2023-09-07T13:00:50,Bilbao,Basic services,water,-71.46,-52885.01
buyer_1,Luis,28,ES15209597283499285728,TRX_N-00478-96721557,2023-09-07T12:20:14,Bilbao,Basic services,gas,-71.51,-52956.52
buyer_1,Luis,28,ES15209597283499285728,TRX_N-00479-72526125,2023-09-11T11:14:16,Bilbao,Expense,clothing,-219.73,-53176.25
buyer_1,Luis,28,ES15209597283499285728,TRX_N-00480-64804160,2023-09-14T12:57:20,Bilbao,Expense,clothing,-372.0,-53548.25
buyer_1,Luis,28,ES15209597283499285728,TRX_N-00481-01426494,2023-09-29T16:03:29,Bilbao,Expense,transport,-192.42,-53740.67
buyer_1,Luis,28,ES15209597283499285728,TRX_N-00482-61814270,2023-09-30T18:59:14,Llodio,Expense,education,-155.85,-53896.52
buyer_1,Luis,28,ES15209597283499285728,TRX_N-00483-86174057,2023-10-01T09:44:35,Bilbao,transfer,Salary,1289.91,-52606.61
buyer_1,Luis,28,ES15209597283499285728,TRX_N-00484-38880603,2023-10-05T21:41:05,Bilbao,Housing,Rent,-1240.78,-53847.39
buyer_1,Luis,28,ES15209597283499285728,TRX_N-00485-87056598,2023-10-05T09:03:39,Bilbao,Basic services,electricity,-37.06,-53884.45
buyer_1,Luis,28,ES15209597283499285728,TRX_N-00486-64543949,2023-10-05T19:09:43,Bilbao,Basic services,internet,-49.15,-53933.6
buyer_1,Luis,28,ES15209597283499285728,TRX_N-00487-51127816,2023-10-06T04:49:33,Bilbao,Basic services,water,-39.49,-53973.09
buyer_1,Luis,28,ES15209597283499285728,TRX_N-00488-33429153,2023-10-06T08:23:48,Bilbao,Basic services,phone,-87.96,-54061.05
buyer_1,Luis,28,ES15209597283499285728,TRX_N-00489-43386712,2023-10-06T02:57:53,Bilbao,Expense,healthcare,-360.14,-54421.19
buyer_1,Luis,28,ES15209597283499285728,TRX_N-00490-50103210,2023-10-16T18:09:03,Bilbao,Expense,leisure,-244.52,-54665.71
buyer_1,Luis,28,ES15209597283499285728,TRX_N-00491-91341935,2023-10-20T16:55:09,Bilbao,Expense,healthcare,-313.09,-54978.8
buyer_1,Luis,28,ES15209597283499285728,TRX_N-00492-55221106,2023-10-22T09:09:19,Bilbao,Expense,leisure,-242.83,-55221.63
buyer_1,Luis,28,ES15209597283499285728,TRX_N-00493-40306325,2023-10-25T21:29:21,Bilbao,Expense,leisure,-187.26,-55408.89
buyer_1,Luis,28,ES15209597283499285728,TRX_N-00494-35261847,2023-10-25T20:16:15,Donostia,Expense,healthcare,-183.04,-55591.93
buyer_1,Luis,28,ES15209597283499285728,TRX_N-00495-32894774,2023-11-01T02:52:05,Bilbao,transfer,Salary,1289.91,-54302.02
buyer_1,Luis,28,ES15209597283499285728,TRX_N-00496-86569117,2023-11-05T09:59:25,Bilbao,Housing,Rent,-1240.78,-55542.8
buyer_1,Luis,28,ES15209597283499285728,TRX_N-00497-45825044,2023-11-05T10:19:23,Bilbao,Basic services,electricity,-35.38,-55578.18
buyer_1,Luis,28,ES15209597283499285728,TRX_N-00498-27330254,2023-11-06T12:17:16,Bilbao,Basic services,water,-70.72,-55648.9
buyer_1,Luis,28,ES15209597283499285728,TRX_N-00499-52052235,2023-11-06T13:45:38,Bilbao,Basic services,gas,-21.99,-55670.89
buyer_1,Luis,28,ES15209597283499285728,TRX_N-00500-46445812,2023-11-06T23:29:27,Bilbao,Basic services,phone,-38.02,-55708.91
buyer_1,Luis,28,ES15209597283499285728,TRX_N-00501-47390477,2023-11-07T09:09:31,Bilbao,Basic services,electricity,-101.22,-55810.13
buyer_1,Luis,28,ES15209597283499285728,TRX_N-00502-28501441,2023-11-28T08:50:23,Bilbao,Expense,food,-680.89,-56491.02
buyer_1,Luis,28,ES15209597283499285728,TRX_N-00503-74344280,2023-12-01T04:04:36,Bilbao,transfer,Salary,1289.91,-55201.11
buyer_1,Luis,28,ES15209597283499285728,TRX_N-00504-45676912,2023-12-01T04:04:36,Bilbao,transfer,Extra Income,128.99,-55072.12
buyer_1,Luis,28,ES15209597283499285728,TRX_N-00505-40392266,2023-12-01T04:04:36,Bilbao,transfer,Bonus,1272.74,-53799.38
buyer_1,Luis,28,ES15209597283499285728,TRX_N-00506-39946506,2023-12-03T04:35:36,Berango,Expense,transport,-47.89,-53847.27
buyer_1,Luis,28,ES15209597283499285728,TRX_N-00507-98396880,2023-12-05T12:27:54,Bilbao,Housing,Rent,-1240.78,-55088.05
buyer_1,Luis,28,ES15209597283499285728,TRX_N-00508-23166375,2023-12-05T18:42:13,Bilbao,Expense,food,-491.22,-55579.27
buyer_1,Luis,28,ES15209597283499285728,TRX_N-00509-03044606,2023-12-06T15:34:56,Bilbao,Basic services,phone,-82.62,-55661.89
buyer_1,Luis,28,ES15209597283499285728,TRX_N-00510-15053452,2023-12-06T09:00:46,Bilbao,Expense,transport,-116.16,-55778.05
buyer_1,Luis,28,ES15209597283499285728,TRX_N-00511-92414610,2023-12-07T13:00:18,Bilbao,Basic services,water,-25.9,-55803.95
buyer_1,Luis,28,ES15209597283499285728,TRX_N-00512-82960658,2023-12-08T15:05:54,Bilbao,Expense,transport,-58.78,-55862.73
buyer_1,Luis,28,ES15209597283499285728,TRX_N-00513-29536164,2023-12-19T08:02:52,Bilbao,Expense,repairs,-554.63,-56417.36
buyer_1,Luis,28,ES15209597283499285728,TRX_N-00514-35670505,2023-12-20T13:54:42,Bilbao,Expense,transport,-80.98,-56498.34
buyer_1,Luis,28,ES15209597283499285728,TRX_N-00515-61250908,2024-01-01T14:56:41,Bilbao,transfer,Salary,1289.91,-55208.43
buyer_1,Luis,28,ES15209597283499285728,TRX_N-00516-43204891,2024-01-03T20:31:29,Sopela,Expense,food,-292.44,-55500.87
buyer_1,Luis,28,ES15209597283499285728,TRX_N-00517-96094171,2024-01-05T18:58:28,Bilbao,Housing,Rent,-1240.78,-56741.65
buyer_1,Luis,28,ES15209597283499285728,TRX_N-00518-88319381,2024-01-05T11:30:15,Bilbao,Basic services,internet,-69.99,-56811.64
buyer_1,Luis,28,ES15209597283499285728,TRX_N-00519-78653620,2024-01-05T16:25:11,Bilbao,Basic services,phone,-44.83,-56856.47
buyer_1,Luis,28,ES15209597283499285728,TRX_N-00520-92904843,2024-01-06T08:18:54,Bilbao,Basic services,electricity,-147.85,-57004.32
buyer_1,Luis,28,ES15209597283499285728,TRX_N-00521-86771920,2024-01-06T23:36:06,Bilbao,Basic services,gas,-70.52,-57074.84
buyer_1,Luis,28,ES15209597283499285728,TRX_N-00522-07853100,2024-01-06T06:34:09,Bilbao,Basic services,internet,-66.55,-57141.39
buyer_1,Luis,28,ES15209597283499285728,TRX_N-00523-64666303,2024-01-07T19:17:08,Bilbao,Basic services,phone,-89.06,-57230.45
buyer_1,Luis,28,ES15209597283499285728,TRX_N-00524-27858414,2024-01-16T09:57:04,Bilbao,Expense,clothing,-109.43,-57339.88
buyer_1,Luis,28,ES15209597283499285728,TRX_N-00525-16035463,2024-01-23T06:41:23,Bilbao,Expense,education,-81.46,-57421.34
buyer_1,Luis,28,ES15209597283499285728,TRX_N-00526-93446439,2024-02-01T02:06:48,Bilbao,transfer,Salary,1289.91,-56131.43
buyer_1,Luis,28,ES15209597283499285728,TRX_N-00527-96980137,2024-02-05T10:16:23,Bilbao,Housing,Rent,-1240.78,-57372.21
buyer_1,Luis,28,ES15209597283499285728,TRX_N-00528-77690545,2024-02-05T10:43:53,Bilbao,Basic services,internet,-76.4,-57448.61
buyer_1,Luis,28,ES15209597283499285728,TRX_N-00529-37952480,2024-02-05T15:17:37,Bilbao,Basic services,phone,-53.56,-57502.17
buyer_1,Luis,28,ES15209597283499285728,TRX_N-00530-90104083,2024-02-06T10:29:58,Bilbao,Basic services,electricity,-62.99,-57565.16
buyer_1,Luis,28,ES15209597283499285728,TRX_N-00531-40491608,2024-02-06T12:33:09,Bilbao,Basic services,gas,-26.74,-57591.9
buyer_1,Luis,28,ES15209597283499285728,TRX_N-00532-60635037,2024-02-06T22:10:44,Bilbao,Basic services,internet,-37.07,-57628.97
buyer_1,Luis,28,ES15209597283499285728,TRX_N-00533-98239417,2024-02-07T17:49:43,Bilbao,Basic services,electricity,-42.34,-57671.31
buyer_1,Luis,28,ES15209597283499285728,TRX_N-00534-46644037,2024-02-08T12:21:28,Hernani,Expense,clothing,-301.92,-57973.23
buyer_1,Luis,28,ES15209597283499285728,TRX_N-00535-96512383,2024-02-09T14:48:50,Oyón-Oion,Expense,clothing,-428.92,-58402.15
buyer_1,Luis,28,ES15209597283499285728,TRX_N-00536-65305635,2024-03-01T11:55:25,Bilbao,transfer,Salary,1289.91,-57112.24
buyer_1,Luis,28,ES15209597283499285728,TRX_N-00537-87130375,2024-03-01T11:55:25,Bilbao,transfer,Extra Income,128.99,-56983.25
buyer_1,Luis,28,ES15209597283499285728,TRX_N-00538-65888058,2024-03-05T10:31:07,Bilbao,Housing,Rent,-1240.78,-58224.03
buyer_1,Luis,28,ES15209597283499285728,TRX_N-00539-82083564,2024-03-06T15:28:30,Bilbao,Basic services,gas,-67.75,-58291.78
buyer_1,Luis,28,ES15209597283499285728,TRX_N-00540-56054238,2024-03-06T11:28:24,Bilbao,Basic services,phone,-71.33,-58363.11
buyer_1,Luis,28,ES15209597283499285728,TRX_N-00541-76069426,2024-03-15T06:00:44,Getxo,Expense,leisure,-191.29,-58554.4
buyer_1,Luis,28,ES15209597283499285728,TRX_N-00542-60506402,2024-03-31T19:05:05,Bilbao,Expense,healthcare,-165.88,-58720.28
buyer_1,Luis,28,ES15209597283499285728,TRX_N-00543-77389313,2024-04-01T18:45:34,Bilbao,transfer,Salary,1289.91,-57430.37
buyer_1,Luis,28,ES15209597283499285728,TRX_N-00544-47936280,2024-04-05T08:49:13,Bilbao,Housing,Rent,-1240.78,-58671.15
buyer_1,Luis,28,ES15209597283499285728,TRX_N-00545-50332008,2024-04-05T15:19:59,Bilbao,Basic services,internet,-48.97,-58720.12
buyer_1,Luis,28,ES15209597283499285728,TRX_N-00546-72378207,2024-04-05T07:41:01,Bilbao,Basic services,phone,-47.27,-58767.39
buyer_1,Luis,28,ES15209597283499285728,TRX_N-00547-95712225,2024-04-06T09:39:28,Bilbao,Basic services,electricity,-117.63,-58885.02
buyer_1,Luis,28,ES15209597283499285728,TRX_N-00548-59495239,2024-04-06T15:47:31,Bilbao,Basic services,phone,-23.81,-58908.83
buyer_1,Luis,28,ES15209597283499285728,TRX_N-00549-00454411,2024-04-07T12:54:48,Bilbao,Basic services,water,-38.01,-58946.84
buyer_1,Luis,28,ES15209597283499285728,TRX_N-00550-48435467,2024-04-07T14:41:43,Bilbao,Basic services,gas,-72.14,-59018.98
buyer_1,Luis,28,ES15209597283499285728,TRX_N-00551-15605752,2024-04-12T17:41:03,Bilbao,Expense,food,-620.58,-59639.56
buyer_1,Luis,28,ES15209597283499285728,TRX_N-00552-12554888,2024-04-16T13:23:49,Bilbao,Expense,transport,-165.6,-59805.16
buyer_1,Luis,28,ES15209597283499285728,TRX_N-00553-06664720,2024-05-01T18:19:08,Bilbao,transfer,Salary,1289.91,-58515.25
buyer_1,Luis,28,ES15209597283499285728,TRX_N-00554-17701749,2024-05-01T18:19:08,Bilbao,transfer,Extra Income,128.99,-58386.26
buyer_1,Luis,28,ES15209597283499285728,TRX_N-00555-33353009,2024-05-05T09:09:28,Bilbao,Housing,Rent,-1240.78,-59627.04
buyer_1,Luis,28,ES15209597283499285728,TRX_N-00556-14825747,2024-05-05T08:37:25,Bilbao,Basic services,water,-78.27,-59705.31
buyer_1,Luis,28,ES15209597283499285728,TRX_N-00557-08177909,2024-05-06T12:30:25,Bilbao,Basic services,water,-73.38,-59778.69
buyer_1,Luis,28,ES15209597283499285728,TRX_N-00558-24378771,2024-05-07T14:17:25,Bilbao,Basic services,phone,-96.01,-59874.7
buyer_1,Luis,28,ES15209597283499285728,TRX_N-00559-81732488,2024-05-15T19:12:26,Bilbao,Expense,leisure,-151.59,-60026.29
buyer_1,Luis,28,ES15209597283499285728,TRX_N-00560-65678355,2024-05-20T18:53:11,Bilbao,Expense,appliances,-868.94,-60895.23
buyer_1,Luis,28,ES15209597283499285728,TRX_N-00561-44505202,2024-06-01T17:03:34,Bilbao,transfer,Salary,1289.91,-59605.32
buyer_1,Luis,28,ES15209597283499285728,TRX_N-00562-72367138,2024-06-01T17:03:34,Bilbao,transfer,Bonus,1338.98,-58266.34
buyer_1,Luis,28,ES15209597283499285728,TRX_N-00563-77684573,2024-06-03T18:09:21,Bilbao,Expense,leisure,-287.53,-58553.87
buyer_1,Luis,28,ES15209597283499285728,TRX_N-00564-91383063,2024-06-05T20:42:58,Bilbao,Housing,Rent,-1240.78,-59794.65
buyer_1,Luis,28,ES15209597283499285728,TRX_N-00565-13258094,2024-06-05T13:37:49,Bilbao,Basic services,internet,-49.14,-59843.79
buyer_1,Luis,28,ES15209597283499285728,TRX_N-00566-26212846,2024-06-06T16:42:20,Bilbao,Basic services,water,-52.89,-59896.68
buyer_1,Luis,28,ES15209597283499285728,TRX_N-00567-36182605,2024-06-07T20:46:28,Bilbao,Basic services,internet,-61.66,-59958.34
buyer_1,Luis,28,ES15209597283499285728,TRX_N-00568-81599361,2024-06-07T14:17:36,Bilbao,Basic services,phone,-89.94,-60048.28
buyer_1,Luis,28,ES15209597283499285728,TRX_N-00569-31248865,2024-06-09T20:41:14,Bilbao,Expense,transport,-167.43,-60215.71
buyer_1,Luis,28,ES15209597283499285728,TRX_N-00570-35376796,2024-06-13T16:06:58,Bilbao,Expense,leisure,-77.41,-60293.12
buyer_1,Luis,28,ES15209597283499285728,TRX_N-00571-29877995,2024-06-17T20:41:39,Bilbao,Expense,repairs,-643.84,-60936.96
buyer_1,Luis,28,ES15209597283499285728,TRX_N-00572-17242849,2024-06-28T09:05:35,Bilbao,Expense,gifts,-122.92,-61059.88
buyer_1,Luis,28,ES15209597283499285728,TRX_N-00573-15938412,2024-07-01T17:23:04,Bilbao,transfer,Salary,1289.91,-59769.97
buyer_1,Luis,28,ES15209597283499285728,TRX_N-00574-81781256,2024-07-01T17:23:04,Bilbao,transfer,Extra Income,128.99,-59640.98
buyer_1,Luis,28,ES15209597283499285728,TRX_N-00575-81483567,2024-07-05T17:34:23,Bilbao,Housing,Rent,-1240.78,-60881.76
buyer_1,Luis,28,ES15209597283499285728,TRX_N-00576-21114986,2024-07-05T20:38:57,Bilbao,Basic services,electricity,-85.23,-60966.99
buyer_1,Luis,28,ES15209597283499285728,TRX_N-00577-25300188,2024-07-05T08:37:35,Bilbao,Basic services,internet,-54.87,-61021.86
buyer_1,Luis,28,ES15209597283499285728,TRX_N-00578-44644516,2024-07-06T13:22:22,Bilbao,Basic services,gas,-21.06,-61042.92
buyer_1,Luis,28,ES15209597283499285728,TRX_N-00579-57265381,2024-07-06T10:10:10,Bilbao,Basic services,phone,-83.47,-61126.39
buyer_1,Luis,28,ES15209597283499285728,TRX_N-00580-59571994,2024-07-07T18:10:16,Bilbao,Basic services,water,-12.58,-61138.97
buyer_1,Luis,28,ES15209597283499285728,TRX_N-00581-31136883,2024-07-07T19:54:14,Bilbao,Basic services,gas,-44.4,-61183.37
buyer_1,Luis,28,ES15209597283499285728,TRX_N-00582-17421689,2024-07-07T18:32:14,Bilbao,Basic services,internet,-31.0,-61214.37
buyer_1,Luis,28,ES15209597283499285728,TRX_N-00583-63301159,2024-07-13T14:16:42,Bilbao,Expense,appliances,-483.82,-61698.19
buyer_1,Luis,28,ES15209597283499285728,TRX_N-00584-36705122,2024-08-01T18:29:29,Bilbao,transfer,Salary,1289.91,-60408.28
buyer_1,Luis,28,ES15209597283499285728,TRX_N-00585-92192347,2024-08-04T19:46:59,Bilbao,Expense,transport,-80.39,-60488.67
buyer_1,Luis,28,ES15209597283499285728,TRX_N-00586-79235926,2024-08-05T09:15:30,Bilbao,Housing,Rent,-1240.78,-61729.45
buyer_1,Luis,28,ES15209597283499285728,TRX_N-00587-12892764,2024-08-05T17:57:03,Bilbao,Basic services,gas,-35.8,-61765.25
buyer_1,Luis,28,ES15209597283499285728,TRX_N-00588-79377423,2024-08-05T21:48:35,Bilbao,Basic services,internet,-71.26,-61836.51
buyer_1,Luis,28,ES15209597283499285728,TRX_N-00589-45480139,2024-08-05T13:39:26,Bilbao,Basic services,phone,-24.51,-61861.02
buyer_1,Luis,28,ES15209597283499285728,TRX_N-00590-04069274,2024-08-06T02:09:55,Bilbao,Basic services,water,-54.25,-61915.27
buyer_1,Luis,28,ES15209597283499285728,TRX_N-00591-17173671,2024-08-06T12:47:37,Bilbao,Basic services,electricity,-143.74,-62059.01
buyer_1,Luis,28,ES15209597283499285728,TRX_N-00592-05928048,2024-08-12T20:14:56,Bilbao,Expense,transport,-106.66,-62165.67
buyer_1,Luis,28,ES15209597283499285728,TRX_N-00593-22121729,2024-08-22T12:44:49,Bilbao,Expense,leisure,-37.73,-62203.4
buyer_1,Luis,28,ES15209597283499285728,TRX_N-00594-44119919,2024-09-01T09:41:46,Bilbao,transfer,Salary,1289.91,-60913.49
buyer_1,Luis,28,ES15209597283499285728,TRX_N-00595-08580114,2024-09-01T09:41:46,Bilbao,transfer,Extra Income,128.99,-60784.5
buyer_1,Luis,28,ES15209597283499285728,TRX_N-00596-09314538,2024-09-05T19:47:25,Bilbao,Housing,Rent,-1240.78,-62025.28
buyer_1,Luis,28,ES15209597283499285728,TRX_N-00597-57895802,2024-09-06T11:40:29,Bilbao,Basic services,phone,-27.34,-62052.62
buyer_1,Luis,28,ES15209597283499285728,TRX_N-00598-14172089,2024-09-07T13:54:30,Bilbao,Basic services,gas,-86.93,-62139.55
buyer_1,Luis,28,ES15209597283499285728,TRX_N-00599-51255758,2024-09-07T16:38:37,Bilbao,Basic services,internet,-48.32,-62187.87
buyer_1,Luis,28,ES15209597283499285728,TRX_N-00600-62865032,2024-09-22T16:45:23,Bilbao,Expense,healthcare,-60.47,-62248.34
buyer_1,Luis,28,ES15209597283499285728,TRX_N-00601-11549610,2024-09-24T19:35:43,Bermeo,Expense,transport,-106.75,-62355.09
buyer_1,Luis,28,ES15209597283499285728,TRX_N-00602-72654170,2024-09-27T16:54:43,Bilbao,Expense,transport,-102.71,-62457.8
buyer_1,Luis,28,ES15209597283499285728,TRX_N-00603-62474204,2024-10-01T19:47:12,Bilbao,transfer,Salary,1289.91,-61167.89
buyer_1,Luis,28,ES15209597283499285728,TRX_N-00604-55304380,2024-10-05T20:29:17,Bilbao,Housing,Rent,-1240.78,-62408.67
buyer_1,Luis,28,ES15209597283499285728,TRX_N-00605-84011080,2024-10-06T19:36:54,Bilbao,Basic services,water,-70.46,-62479.13
buyer_1,Luis,28,ES15209597283499285728,TRX_N-00606-55652492,2024-10-06T19:32:53,Bilbao,Basic services,gas,-78.41,-62557.54
buyer_1,Luis,28,ES15209597283499285728,TRX_N-00607-82008364,2024-10-07T00:34:23,Bilbao,Basic services,gas,-41.62,-62599.16
buyer_1,Luis,28,ES15209597283499285728,TRX_N-00608-46541249,2024-10-07T15:10:49,Bilbao,Basic services,phone,-65.73,-62664.89
buyer_2,Carmen,40,ES76209545461096905487,TRX_N-00001-53480202,2020-01-01T19:39:57,Zarautz,transfer,Salary,1970.02,3587.69
buyer_2,Carmen,40,ES76209545461096905487,TRX_N-00002-78339113,2020-01-04T16:39:09,Zarautz,Expense,travel,-1008.12,2579.57
buyer_2,Carmen,40,ES76209545461096905487,TRX_N-00003-03524672,2020-01-05T08:37:51,Zarautz,Housing,Rent,-666.22,1913.35
buyer_2,Carmen,40,ES76209545461096905487,TRX_N-00004-61948925,2020-01-05T19:41:03,Zarautz,Basic services,gas,-63.87,1849.48
buyer_2,Carmen,40,ES76209545461096905487,TRX_N-00005-13808619,2020-01-06T12:18:07,Zarautz,Basic services,electricity,-87.67,1761.81
buyer_2,Carmen,40,ES76209545461096905487,TRX_N-00006-46359694,2020-01-06T12:01:37,Zarautz,Basic services,internet,-59.67,1702.14
buyer_2,Carmen,40,ES76209545461096905487,TRX_N-00007-99574353,2020-01-07T12:11:03,Zarautz,Basic services,gas,-48.85,1653.29
buyer_2,Carmen,40,ES76209545461096905487,TRX_N-00008-25167797,2020-01-07T18:26:34,Zarautz,Basic services,internet,-65.53,1587.76
buyer_2,Carmen,40,ES76209545461096905487,TRX_N-00009-46907591,2020-01-07T14:40:59,Barakaldo,Expense,leisure,-212.73,1375.03
buyer_2,Carmen,40,ES76209545461096905487,TRX_N-00010-28040741,2020-01-13T03:12:39,Zarautz,Expense,healthcare,-123.33,1251.7
buyer_2,Carmen,40,ES76209545461096905487,TRX_N-00011-66611221,2020-01-21T17:05:49,Zarautz,Expense,transport,-120.45,1131.25
buyer_2,Carmen,40,ES76209545461096905487,TRX_N-00012-01005822,2020-01-27T07:56:44,Zarautz,Expense,leisure,-71.07,1060.18
buyer_2,Carmen,40,ES76209545461096905487,TRX_N-00013-75312403,2020-01-31T23:25:54,Zarautz,Expense,leisure,-182.75,877.43
buyer_2,Carmen,40,ES76209545461096905487,TRX_N-00014-93029244,2020-02-01T12:38:54,Zarautz,transfer,Salary,1970.02,2847.45
buyer_2,Carmen,40,ES76209545461096905487,TRX_N-00015-98023012,2020-02-05T15:56:00,Zarautz,Housing,Rent,-666.22,2181.23
buyer_2,Carmen,40,ES76209545461096905487,TRX_N-00016-50453120,2020-02-05T01:19:43,Zarautz,Basic services,electricity,-137.31,2043.92
buyer_2,Carmen,40,ES76209545461096905487,TRX_N-00017-03874297,2020-02-18T11:33:58,Zarautz,Expense,healthcare,-266.14,1777.78
buyer_2,Carmen,40,ES76209545461096905487,TRX_N-00018-05974428,2020-02-27T16:19:56,Zarautz,Expense,clothing,-304.67,1473.11
buyer_2,Carmen,40,ES76209545461096905487,TRX_N-00019-30872579,2020-03-01T14:18:13,Zarautz,transfer,Salary,1970.02,3443.13
buyer_2,Carmen,40,ES76209545461096905487,TRX_N-00020-41348816,2020-03-01T14:18:13,Zarautz,transfer,Extra Income,197.0,3640.13
buyer_2,Carmen,40,ES76209545461096905487,TRX_N-00021-30510527,2020-03-02T15:54:21,Zarautz,Expense,leisure,-229.77,3410.36
buyer_2,Carmen,40,ES76209545461096905487,TRX_N-00022-98660404,2020-03-04T17:39:34,Zarautz,Expense,transport,-58.9,3351.46
buyer_2,Carmen,40,ES76209545461096905487,TRX_N-00023-49458578,2020-03-05T14:20:29,Zarautz,Housing,Rent,-666.22,2685.24
buyer_2,Carmen,40,ES76209545461096905487,TRX_N-00024-97059661,2020-03-05T17:15:59,Zarautz,Basic services,water,-63.63,2621.61
buyer_2,Carmen,40,ES76209545461096905487,TRX_N-00025-17843210,2020-03-06T09:12:21,Zarautz,Basic services,phone,-72.04,2549.57
buyer_2,Carmen,40,ES76209545461096905487,TRX_N-00026-15770888,2020-03-07T20:43:25,Zarautz,Basic services,gas,-98.47,2451.1
buyer_2,Carmen,40,ES76209545461096905487,TRX_N-00027-56148718,2020-03-08T10:10:54,Zarautz,Expense,food,-518.35,1932.75
buyer_2,Carmen,40,ES76209545461096905487,TRX_N-00028-95556840,2020-03-11T10:27:54,Zarautz,Expense,transport,-168.45,1764.3
buyer_2,Carmen,40,ES76209545461096905487,TRX_N-00029-26488131,2020-03-19T13:39:50,Zarautz,Expense,transport,-134.98,1629.32
buyer_2,Carmen,40,ES76209545461096905487,TRX_N-00030-78509350,2020-03-24T12:52:43,Zarautz,Expense,leisure,-24.92,1604.4
buyer_2,Carmen,40,ES76209545461096905487,TRX_N-00031-69763700,2020-04-01T23:20:31,Zarautz,transfer,Salary,1970.02,3574.42
buyer_2,Carmen,40,ES76209545461096905487,TRX_N-00032-69394465,2020-04-05T16:45:37,Zarautz,Housing,Rent,-666.22,2908.2
buyer_2,Carmen,40,ES76209545461096905487,TRX_N-00033-89531850,2020-04-05T18:13:58,Zarautz,Basic services,electricity,-65.62,2842.58
buyer_2,Carmen,40,ES76209545461096905487,TRX_N-00034-57573655,2020-04-05T14:04:12,Zarautz,Basic services,internet,-77.63,2764.95
buyer_2,Carmen,40,ES76209545461096905487,TRX_N-00035-49838480,2020-04-05T12:35:52,Zarautz,Basic services,phone,-71.3,2693.65
buyer_2,Carmen,40,ES76209545461096905487,TRX_N-00036-96575775,2020-04-06T05:06:46,Zarautz,Basic services,electricity,-95.22,2598.43
buyer_2,Carmen,40,ES76209545461096905487,TRX_N-00037-23011373,2020-04-06T23:21:45,Zarautz,Basic services,phone,-83.82,2514.61
buyer_2,Carmen,40,ES76209545461096905487,TRX_N-00038-37410467,2020-04-07T09:47:44,Zarautz,Basic services,phone,-40.38,2474.23
buyer_2,Carmen,40,ES76209545461096905487,TRX_N-00039-40134579,2020-04-11T05:57:47,Zarautz,Expense,leisure,-103.79,2370.44
buyer_2,Carmen,40,ES76209545461096905487,TRX_N-00040-86576376,2020-04-14T11:12:36,Zarautz,Expense,transport,-182.62,2187.82
buyer_2,Carmen,40,ES76209545461096905487,TRX_N-00041-68025746,2020-04-22T10:20:56,Zarautz,Expense,food,-157.46,2030.36
buyer_2,Carmen,40,ES76209545461096905487,TRX_N-00042-22008231,2020-04-30T10:14:04,Zarautz,Expense,leisure,-165.95,1864.41
buyer_2,Carmen,40,ES76209545461096905487,TRX_N-00043-51475707,2020-05-01T18:13:43,Zarautz,transfer,Salary,1970.02,3834.43
buyer_2,Carmen,40,ES76209545461096905487,TRX_N-00044-62270385,2020-05-01T18:13:43,Zarautz,transfer,Extra Income,197.0,4031.43
buyer_2,Carmen,40,ES76209545461096905487,TRX_N-00045-90377560,2020-05-05T13:22:49,Zarautz,Housing,Rent,-666.22,3365.21
buyer_2,Carmen,40,ES76209545461096905487,TRX_N-00046-30319538,2020-05-05T22:55:28,Zarautz,Basic services,water,-78.28,3286.93
buyer_2,Carmen,40,ES76209545461096905487,TRX_N-00047-53842540,2020-05-05T04:11:17,Zarautz,Basic services,phone,-77.25,3209.68
buyer_2,Carmen,40,ES76209545461096905487,TRX_N-00048-33707254,2020-05-05T13:14:32,Zarautz,Expense,travel,-1028.2,2181.48
buyer_2,Carmen,40,ES76209545461096905487,TRX_N-00049-46702294,2020-05-06T16:24:29,Zarautz,Basic services,internet,-53.39,2128.09
buyer_2,Carmen,40,ES76209545461096905487,TRX_N-00050-66685247,2020-05-06T14:40:26,Zarautz,Basic services,phone,-38.64,2089.45
buyer_2,Carmen,40,ES76209545461096905487,TRX_N-00051-93233791,2020-05-06T13:13:56,Portugalete,Expense,travel,-1907.99,181.46
buyer_2,Carmen,40,ES76209545461096905487,TRX_N-00052-86122761,2020-05-07T19:19:57,Zarautz,Basic services,electricity,-141.75,39.71
buyer_2,Carmen,40,ES76209545461096905487,TRX_N-00053-32824963,2020-05-07T12:49:32,Zarautz,Basic services,phone,-76.22,-36.51
buyer_2,Carmen,40,ES76209545461096905487,TRX_N-00054-22742411,2020-05-10T09:57:20,Zarautz,Expense,leisure,-64.2,-100.71
buyer_2,Carmen,40,ES76209545461096905487,TRX_N-00055-59321506,2020-05-10T09:53:48,Zarautz,Expense,education,-397.6,-498.31
buyer_2,Carmen,40,ES76209545461096905487,TRX_N-00056-97327340,2020-05-23T17:44:51,Zarautz,Expense,travel,-1744.87,-2243.18
buyer_2,Carmen,40,ES76209545461096905487,TRX_N-00057-57950114,2020-05-29T20:41:18,Sopela,Expense,leisure,-176.43,-2419.61
buyer_2,Carmen,40,ES76209545461096905487,TRX_N-00058-84397188,2020-06-01T10:28:23,Zarautz,transfer,Salary,1970.02,-449.59
buyer_2,Carmen,40,ES76209545461096905487,TRX_N-00059-52249856,2020-06-01T10:28:23,Zarautz,transfer,Bonus,2051.62,1602.03
buyer_2,Carmen,40,ES76209545461096905487,TRX_N-00060-68242525,2020-06-05T09:01:50,Zarautz,Housing,Rent,-666.22,935.81
buyer_2,Carmen,40,ES76209545461096905487,TRX_N-00061-19870705,2020-06-06T16:58:51,Zarautz,Basic services,water,-51.27,884.54
buyer_2,Carmen,40,ES76209545461096905487,TRX_N-00062-94022503,2020-06-06T11:33:17,Zarautz,Basic services,internet,-59.93,824.61
buyer_2,Carmen,40,ES76209545461096905487,TRX_N-00063-67833454,2020-06-07T08:37:45,Zarautz,Basic services,water,-50.68,773.93
buyer_2,Carmen,40,ES76209545461096905487,TRX_N-00064-38321247,2020-06-07T19:48:14,Zarautz,Basic services,electricity,-20.54,753.39
buyer_2,Carmen,40,ES76209545461096905487,TRX_N-00065-47926947,2020-06-07T11:04:50,Zarautz,Expense,clothing,-284.57,468.82
buyer_2,Carmen,40,ES76209545461096905487,TRX_N-00066-32160646,2020-06-13T12:09:49,Labastida/Bastida,Expense,clothing,-347.24,121.58
buyer_2,Carmen,40,ES76209545461096905487,TRX_N-00067-71225500,2020-06-16T15:45:52,Zarautz,Expense,food,-787.44,-665.86
buyer_2,Carmen,40,ES76209545461096905487,TRX_N-00068-97134270,2020-06-17T19:13:09,Zarautz,Expense,food,-708.72,-1374.58
buyer_2,Carmen,40,ES76209545461096905487,TRX_N-00069-49936052,2020-06-24T21:00:20,Zarautz,Expense,leisure,-161.18,-1535.76
buyer_2,Carmen,40,ES76209545461096905487,TRX_N-00070-73799180,2020-06-24T18:53:37,Zarautz,Expense,education,-552.21,-2087.97
buyer_2,Carmen,40,ES76209545461096905487,TRX_N-00071-60825038,2020-07-01T15:01:35,Zarautz,transfer,Salary,1970.02,-117.95
buyer_2,Carmen,40,ES76209545461096905487,TRX_N-00072-13903822,2020-07-01T15:01:35,Zarautz,transfer,Extra Income,197.0,79.05
buyer_2,Carmen,40,ES76209545461096905487,TRX_N-00073-07355591,2020-07-05T22:15:25,Zarautz,Housing,Rent,-666.22,-587.17
buyer_2,Carmen,40,ES76209545461096905487,TRX_N-00074-10904128,2020-07-05T21:01:15,Zarautz,Basic services,electricity,-126.08,-713.25
buyer_2,Carmen,40,ES76209545461096905487,TRX_N-00075-61953609,2020-07-05T19:04:40,Zarautz,Basic services,internet,-76.8,-790.05
buyer_2,Carmen,40,ES76209545461096905487,TRX_N-00076-29252884,2020-07-06T23:00:12,Zarautz,Basic services,electricity,-103.35,-893.4
buyer_2,Carmen,40,ES76209545461096905487,TRX_N-00077-57212430,2020-07-06T14:02:36,Zarautz,Basic services,gas,-34.95,-928.35
buyer_2,Carmen,40,ES76209545461096905487,TRX_N-00078-54119611,2020-07-07T09:17:11,Zarautz,Basic services,water,-28.61,-956.96
buyer_2,Carmen,40,ES76209545461096905487,TRX_N-00079-13591033,2020-07-07T19:58:06,Zarautz,Basic services,electricity,-48.6,-1005.56
buyer_2,Carmen,40,ES76209545461096905487,TRX_N-00080-52330886,2020-07-07T16:48:01,Zarautz,Basic services,internet,-64.47,-1070.03
buyer_2,Carmen,40,ES76209545461096905487,TRX_N-00081-90125886,2020-07-11T19:06:47,Zarautz,Expense,transport,-139.75,-1209.78
buyer_2,Carmen,40,ES76209545461096905487,TRX_N-00082-67105580,2020-07-12T10:06:23,Zarautz,Expense,leisure,-197.12,-1406.9
buyer_2,Carmen,40,ES76209545461096905487,TRX_N-00083-69481773,2020-07-20T22:47:20,Zarautz,Expense,transport,-74.13,-1481.03
buyer_2,Carmen,40,ES76209545461096905487,TRX_N-00084-64642788,2020-08-01T20:11:45,Zarautz,transfer,Salary,1970.02,488.99
buyer_2,Carmen,40,ES76209545461096905487,TRX_N-00085-20204773,2020-08-05T08:23:48,Zarautz,Housing,Rent,-666.22,-177.23
buyer_2,Carmen,40,ES76209545461096905487,TRX_N-00086-54480601,2020-08-05T18:32:43,Zarautz,Basic services,gas,-43.81,-221.04
buyer_2,Carmen,40,ES76209545461096905487,TRX_N-00087-58782767,2020-08-06T19:59:19,Zarautz,Basic services,water,-56.37,-277.41
buyer_2,Carmen,40,ES76209545461096905487,TRX_N-00088-34430469,2020-08-06T16:17:41,Zarautz,Basic services,electricity,-104.95,-382.36
buyer_2,Carmen,40,ES76209545461096905487,TRX_N-00089-17718024,2020-08-06T23:56:03,Zarautz,Basic services,phone,-49.7,-432.06
buyer_2,Carmen,40,ES76209545461096905487,TRX_N-00090-75342503,2020-08-13T15:07:11,Zarautz,Expense,repairs,-440.04,-872.1
buyer_2,Carmen,40,ES76209545461096905487,TRX_N-00091-13556623,2020-08-14T14:25:46,Iruña de Oca,Expense,transport,-124.88,-996.98
buyer_2,Carmen,40,ES76209545461096905487,TRX_N-00092-28056486,2020-08-21T23:08:46,Zarautz,Expense,food,-485.47,-1482.45
buyer_2,Carmen,40,ES76209545461096905487,TRX_N-00093-65581950,2020-08-22T11:27:41,Zarautz,Expense,transport,-197.98,-1680.43
buyer_2,Carmen,40,ES76209545461096905487,TRX_N-00094-56190598,2020-08-26T18:43:59,Mungia,Expense,food,-322.52,-2002.95
buyer_2,Carmen,40,ES76209545461096905487,TRX_N-00095-52875073,2020-08-28T12:51:43,Zarautz,Expense,transport,-77.57,-2080.52
buyer_2,Carmen,40,ES76209545461096905487,TRX_N-00096-15355154,2020-09-01T11:53:21,Zarautz,transfer,Salary,1970.02,-110.5
buyer_2,Carmen,40,ES76209545461096905487,TRX_N-00097-36527101,2020-09-01T11:53:20,Zarautz,Expense,leisure,-270.55,-381.05
buyer_2,Carmen,40,ES76209545461096905487,TRX_N-00098-55186212,2020-09-05T14:51:59,Zarautz,Housing,Rent,-666.22,-1047.27
buyer_2,Carmen,40,ES76209545461096905487,TRX_N-00099-85064090,2020-09-05T12:41:42,Zarautz,Basic services,gas,-37.0,-1084.27
buyer_2,Carmen,40,ES76209545461096905487,TRX_N-00100-89929566,2020-09-06T15:43:09,Zarautz,Basic services,gas,-50.44,-1134.71
buyer_2,Carmen,40,ES76209545461096905487,TRX_N-00101-72005408,2020-09-07T12:32:22,Zarautz,Basic services,gas,-60.27,-1194.98
buyer_2,Carmen,40,ES76209545461096905487,TRX_N-00102-67714584,2020-09-07T16:03:41,Zarautz,Basic services,internet,-78.87,-1273.85
buyer_2,Carmen,40,ES76209545461096905487,TRX_N-00103-52551209,2020-09-12T19:12:56,Zarautz,Expense,gifts,-156.61,-1430.46
buyer_2,Carmen,40,ES76209545461096905487,TRX_N-00104-05235871,2020-09-25T17:27:20,Zarautz,Expense,food,-751.31,-2181.77
buyer_2,Carmen,40,ES76209545461096905487,TRX_N-00105-21598023,2020-09-30T07:13:33,Elciego,Expense,food,-118.14,-2299.91
buyer_2,Carmen,40,ES76209545461096905487,TRX_N-00106-89974724,2020-10-01T15:07:13,Zarautz,transfer,Salary,1970.02,-329.89
buyer_2,Carmen,40,ES76209545461096905487,TRX_N-00107-62965507,2020-10-01T15:07:13,Zarautz,transfer,Extra Income,197.0,-132.89
buyer_2,Carmen,40,ES76209545461096905487,TRX_N-00108-42161680,2020-10-04T18:02:49,Zarautz,Expense,education,-574.1,-706.99
buyer_2,Carmen,40,ES76209545461096905487,TRX_N-00109-12910843,2020-10-05T11:41:26,Zarautz,Housing,Rent,-666.22,-1373.21
buyer_2,Carmen,40,ES76209545461096905487,TRX_N-00110-35049606,2020-10-05T17:15:24,Zarautz,Basic services,water,-21.56,-1394.77
buyer_2,Carmen,40,ES76209545461096905487,TRX_N-00111-84607802,2020-10-05T15:02:59,Zarautz,Basic services,electricity,-100.2,-1494.97
buyer_2,Carmen,40,ES76209545461096905487,TRX_N-00112-36164422,2020-10-05T03:30:53,Zarautz,Basic services,internet,-62.73,-1557.7
buyer_2,Carmen,40,ES76209545461096905487,TRX_N-00113-91414072,2020-10-05T16:20:28,Zarautz,Basic services,phone,-53.91,-1611.61
buyer_2,Carmen,40,ES76209545461096905487,TRX_N-00114-10114119,2020-10-06T08:29:33,Zarautz,Basic services,electricity,-51.37,-1662.98
buyer_2,Carmen,40,ES76209545461096905487,TRX_N-00115-59642590,2020-10-06T18:00:17,Zarautz,Basic services,gas,-42.52,-1705.5
buyer_2,Carmen,40,ES76209545461096905487,TRX_N-00116-87695612,2020-10-06T17:59:27,Zarautz,Basic services,internet,-67.28,-1772.78
buyer_2,Carmen,40,ES76209545461096905487,TRX_N-00117-51832966,2020-10-06T13:52:07,Zarautz,Basic services,phone,-64.78,-1837.56
buyer_2,Carmen,40,ES76209545461096905487,TRX_N-00118-71380033,2020-10-07T19:05:55,Zarautz,Basic services,gas,-44.39,-1881.95
buyer_2,Carmen,40,ES76209545461096905487,TRX_N-00119-00972716,2020-10-07T18:07:22,Zarautz,Basic services,internet,-40.43,-1922.38
buyer_2,Carmen,40,ES76209545461096905487,TRX_N-00120-95003928,2020-10-11T19:03:29,Zarautz,Expense,leisure,-31.75,-1954.13
buyer_2,Carmen,40,ES76209545461096905487,TRX_N-00121-13558399,2020-11-01T02:56:32,Zarautz,transfer,Salary,1970.02,15.89
buyer_2,Carmen,40,ES76209545461096905487,TRX_N-00122-85133004,2020-11-05T20:52:38,Zarautz,Housing,Rent,-666.22,-650.33
buyer_2,Carmen,40,ES76209545461096905487,TRX_N-00123-67139391,2020-11-05T11:14:01,Zarautz,Basic services,gas,-27.43,-677.76
buyer_2,Carmen,40,ES76209545461096905487,TRX_N-00124-67731684,2020-11-05T23:59:55,Zarautz,Basic services,internet,-78.31,-756.07
buyer_2,Carmen,40,ES76209545461096905487,TRX_N-00125-36590987,2020-11-06T09:59:25,Zarautz,Basic services,water,-71.93,-828.0
buyer_2,Carmen,40,ES76209545461096905487,TRX_N-00126-28462996,2020-11-07T13:50:09,Zarautz,Basic services,gas,-63.57,-891.57
buyer_2,Carmen,40,ES76209545461096905487,TRX_N-00127-32172747,2020-11-13T16:42:04,Zarautz,Expense,transport,-42.38,-933.95
buyer_2,Carmen,40,ES76209545461096905487,TRX_N-00128-55030032,2020-11-29T17:39:06,Zarautz,Expense,food,-682.03,-1615.98
buyer_2,Carmen,40,ES76209545461096905487,TRX_N-00129-12313659,2020-12-01T15:10:36,Zarautz,transfer,Salary,1970.02,354.04
buyer_2,Carmen,40,ES76209545461096905487,TRX_N-00130-82399637,2020-12-01T15:10:36,Zarautz,transfer,Extra Income,197.0,551.04
buyer_2,Carmen,40,ES76209545461096905487,TRX_N-00131-13394914,2020-12-01T15:10:36,Zarautz,transfer,Bonus,1992.65,2543.69
buyer_2,Carmen,40,ES76209545461096905487,TRX_N-00132-83975410,2020-12-05T17:30:45,Zarautz,Housing,Rent,-666.22,1877.47
buyer_2,Carmen,40,ES76209545461096905487,TRX_N-00133-27961071,2020-12-06T17:24:28,Zarautz,Basic services,water,-42.59,1834.88
buyer_2,Carmen,40,ES76209545461096905487,TRX_N-00134-48471854,2020-12-06T09:02:53,Zarautz,Basic services,electricity,-48.71,1786.17
buyer_2,Carmen,40,ES76209545461096905487,TRX_N-00135-88708731,2020-12-07T17:50:13,Zarautz,Basic services,electricity,-22.59,1763.58
buyer_2,Carmen,40,ES76209545461096905487,TRX_N-00136-23842227,2020-12-07T13:12:57,Zarautz,Basic services,gas,-37.54,1726.04
buyer_2,Carmen,40,ES76209545461096905487,TRX_N-00137-17329352,2020-12-30T10:21:06,Zarautz,Expense,leisure,-243.54,1482.5
buyer_2,Carmen,40,ES76209545461096905487,TRX_N-00138-94151911,2021-01-01T09:27:17,Zarautz,transfer,Salary,1970.02,3452.52
buyer_2,Carmen,40,ES76209545461096905487,TRX_N-00139-49544341,2021-01-03T19:08:55,Zarautz,Expense,clothing,-451.16,3001.36
buyer_2,Carmen,40,ES76209545461096905487,TRX_N-00140-57341148,2021-01-05T05:55:18,Zarautz,Housing,Rent,-666.22,2335.14
buyer_2,Carmen,40,ES76209545461096905487,TRX_N-00141-52633243,2021-01-05T07:03:31,Zarautz,Basic services,water,-55.03,2280.11
buyer_2,Carmen,40,ES76209545461096905487,TRX_N-00142-58557802,2021-01-06T11:47:17,Zarautz,Basic services,water,-42.82,2237.29
buyer_2,Carmen,40,ES76209545461096905487,TRX_N-00143-27044731,2021-01-06T19:23:08,Zarautz,Basic services,internet,-77.95,2159.34
buyer_2,Carmen,40,ES76209545461096905487,TRX_N-00144-09639565,2021-01-06T16:03:29,Zarautz,Basic services,phone,-75.57,2083.77
buyer_2,Carmen,40,ES76209545461096905487,TRX_N-00145-44515500,2021-01-07T16:07:02,Zarautz,Basic services,water,-58.97,2024.8
buyer_2,Carmen,40,ES76209545461096905487,TRX_N-00146-63424582,2021-01-07T15:23:03,Zarautz,Basic services,electricity,-149.64,1875.16
buyer_2,Carmen,40,ES76209545461096905487,TRX_N-00147-40386391,2021-01-07T08:23:18,Zarautz,Basic services,phone,-51.88,1823.28
buyer_2,Carmen,40,ES76209545461096905487,TRX_N-00148-92004347,2021-01-08T18:43:49,Zarautz,Expense,food,-460.05,1363.23
buyer_2,Carmen,40,ES76209545461096905487,TRX_N-00149-41032134,2021-01-16T15:58:19,Zarautz,Expense,healthcare,-40.56,1322.67
buyer_2,Carmen,40,ES76209545461096905487,TRX_N-00150-51458672,2021-01-22T22:32:52,Iruña de Oca,Expense,travel,-2818.61,-1495.94
buyer_2,Carmen,40,ES76209545461096905487,TRX_N-00151-46676556,2021-01-23T10:05:01,Zarautz,Expense,transport,-47.62,-1543.56
buyer_2,Carmen,40,ES76209545461096905487,TRX_N-00152-56906695,2021-02-01T10:38:38,Zarautz,transfer,Salary,1970.02,426.46
buyer_2,Carmen,40,ES76209545461096905487,TRX_N-00153-59831185,2021-02-01T10:38:38,Zarautz,transfer,Extra Income,197.0,623.46
buyer_2,Carmen,40,ES76209545461096905487,TRX_N-00154-26333672,2021-02-05T18:36:59,Zarautz,Housing,Rent,-666.22,-42.76
buyer_2,Carmen,40,ES76209545461096905487,TRX_N-00155-82595151,2021-02-05T09:23:47,Zarautz,Basic services,internet,-77.0,-119.76
buyer_2,Carmen,40,ES76209545461096905487,TRX_N-00156-65694494,2021-02-05T10:20:47,Zarautz,Expense,leisure,-249.62,-369.38
buyer_2,Carmen,40,ES76209545461096905487,TRX_N-00157-42852051,2021-02-06T09:18:12,Zarautz,Basic services,water,-52.28,-421.66
buyer_2,Carmen,40,ES76209545461096905487,TRX_N-00158-79461957,2021-02-07T18:46:55,Zarautz,Basic services,water,-37.56,-459.22
buyer_2,Carmen,40,ES76209545461096905487,TRX_N-00159-68019800,2021-02-07T15:00:45,Zarautz,Basic services,gas,-62.25,-521.47
buyer_2,Carmen,40,ES76209545461096905487,TRX_N-00160-05754623,2021-02-07T08:37:38,Zarautz,Basic services,internet,-59.31,-580.78
buyer_2,Carmen,40,ES76209545461096905487,TRX_N-00161-06433412,2021-02-07T04:07:33,Zarautz,Basic services,phone,-57.49,-638.27
buyer_2,Carmen,40,ES76209545461096905487,TRX_N-00162-66296067,2021-02-23T09:28:10,Zarautz,Expense,clothing,-435.6,-1073.87
buyer_2,Carmen,40,ES76209545461096905487,TRX_N-00163-23782914,2021-03-01T02:00:49,Zarautz,transfer,Salary,1970.02,896.15
buyer_2,Carmen,40,ES76209545461096905487,TRX_N-00164-76742998,2021-03-03T15:28:37,Zarautz,Expense,leisure,-277.36,618.79
buyer_2,Carmen,40,ES76209545461096905487,TRX_N-00165-66580098,2021-03-05T14:55:20,Zarautz,Housing,Rent,-666.22,-47.43
buyer_2,Carmen,40,ES76209545461096905487,TRX_N-00166-02461012,2021-03-05T16:37:02,Zarautz,Basic services,gas,-19.22,-66.65
buyer_2,Carmen,40,ES76209545461096905487,TRX_N-00167-05601111,2021-03-06T12:11:48,Zarautz,Basic services,water,-16.41,-83.06
buyer_2,Carmen,40,ES76209545461096905487,TRX_N-00168-01275229,2021-03-06T14:21:18,Zarautz,Basic services,electricity,-135.62,-218.68
buyer_2,Carmen,40,ES76209545461096905487,TRX_N-00169-81992910,2021-03-06T21:23:12,Zarautz,Basic services,phone,-35.42,-254.1
buyer_2,Carmen,40,ES76209545461096905487,TRX_N-00170-12893051,2021-03-07T14:37:06,Zarautz,Basic services,electricity,-38.86,-292.96
buyer_2,Carmen,40,ES76209545461096905487,TRX_N-00171-56142665,2021-03-07T10:57:49,Zarautz,Basic services,phone,-63.42,-356.38
buyer_2,Carmen,40,ES76209545461096905487,TRX_N-00172-84312723,2021-03-07T11:56:35,Zarautz,Expense,gifts,-401.06,-757.44
buyer_2,Carmen,40,ES76209545461096905487,TRX_N-00173-85393264,2021-03-23T22:44:35,Hernani,Expense,clothing,-441.46,-1198.9
buyer_2,Carmen,40,ES76209545461096905487,TRX_N-00174-92079342,2021-04-01T14:27:05,Zarautz,transfer,Salary,1970.02,771.12
buyer_2,Carmen,40,ES76209545461096905487,TRX_N-00175-39178822,2021-04-01T14:27:05,Zarautz,transfer,Extra Income,197.0,968.12
buyer_2,Carmen,40,ES76209545461096905487,TRX_N-00176-31685377,2021-04-02T22:35:36,Zarautz,Expense,transport,-114.75,853.37
buyer_2,Carmen,40,ES76209545461096905487,TRX_N-00177-97800911,2021-04-05T11:24:05,Zarautz,Housing,Rent,-666.22,187.15
buyer_2,Carmen,40,ES76209545461096905487,TRX_N-00178-66506743,2021-04-05T18:58:00,Zarautz,Basic services,internet,-50.05,137.1
buyer_2,Carmen,40,ES76209545461096905487,TRX_N-00179-56212991,2021-04-05T02:25:27,Zarautz,Basic services,phone,-99.74,37.36
buyer_2,Carmen,40,ES76209545461096905487,TRX_N-00180-86958540,2021-04-06T00:55:57,Zarautz,Basic services,internet,-59.29,-21.93
buyer_2,Carmen,40,ES76209545461096905487,TRX_N-00181-79774067,2021-04-07T16:27:59,Zarautz,Basic services,water,-31.38,-53.31
buyer_2,Carmen,40,ES76209545461096905487,TRX_N-00182-98025724,2021-04-07T12:21:32,Zarautz,Basic services,phone,-76.64,-129.95
buyer_2,Carmen,40,ES76209545461096905487,TRX_N-00183-80854573,2021-04-09T13:40:45,Sopela,Expense,food,-466.4,-596.35
buyer_2,Carmen,40,ES76209545461096905487,TRX_N-00184-68986267,2021-04-11T09:44:26,Zarautz,Expense,education,-742.97,-1339.32
buyer_2,Carmen,40,ES76209545461096905487,TRX_N-00185-03031287,2021-05-01T13:35:53,Zarautz,transfer,Salary,1970.02,630.7
buyer_2,Carmen,40,ES76209545461096905487,TRX_N-00186-47874010,2021-05-05T09:30:18,Zarautz,Housing,Rent,-666.22,-35.52
buyer_2,Carmen,40,ES76209545461096905487,TRX_N-00187-22658597,2021-05-05T16:19:02,Zarautz,Basic services,water,-73.64,-109.16
buyer_2,Carmen,40,ES76209545461096905487,TRX_N-00188-39543076,2021-05-05T20:33:44,Zarautz,Basic services,phone,-75.71,-184.87
buyer_2,Carmen,40,ES76209545461096905487,TRX_N-00189-92122189,2021-05-06T11:35:00,Zarautz,Basic services,water,-58.79,-243.66
buyer_2,Carmen,40,ES76209545461096905487,TRX_N-00190-11625391,2021-05-06T16:30:34,Zarautz,Basic services,gas,-40.36,-284.02
buyer_2,Carmen,40,ES76209545461096905487,TRX_N-00191-85827696,2021-05-07T21:04:17,Zarautz,Basic services,water,-47.1,-331.12
buyer_2,Carmen,40,ES76209545461096905487,TRX_N-00192-48417954,2021-05-07T12:39:26,Zarautz,Basic services,gas,-63.14,-394.26
buyer_2,Carmen,40,ES76209545461096905487,TRX_N-00193-73145395,2021-05-07T18:47:54,Zarautz,Basic services,phone,-54.35,-448.61
buyer_2,Carmen,40,ES76209545461096905487,TRX_N-00194-58500303,2021-05-07T10:32:35,Zarautz,Expense,clothing,-398.57,-847.18
buyer_2,Carmen,40,ES76209545461096905487,TRX_N-00195-12921960,2021-05-14T13:32:26,Salvatierra/Agurain,Expense,clothing,-496.08,-1343.26
buyer_2,Carmen,40,ES76209545461096905487,TRX_N-00196-62007230,2021-05-19T11:32:40,Erandio,Expense,leisure,-159.81,-1503.07
buyer_2,Carmen,40,ES76209545461096905487,TRX_N-00197-35531794,2021-06-01T10:16:23,Zarautz,transfer,Salary,1970.02,466.95
buyer_2,Carmen,40,ES76209545461096905487,TRX_N-00198-35293289,2021-06-01T10:16:23,Zarautz,transfer,Extra Income,197.0,663.95
buyer_2,Carmen,40,ES76209545461096905487,TRX_N-00199-49464049,2021-06-01T10:16:23,Zarautz,transfer,Bonus,2018.15,2682.1
buyer_2,Carmen,40,ES76209545461096905487,TRX_N-00200-44454012,2021-06-05T09:05:25,Zarautz,Housing,Rent,-666.22,2015.88
buyer_2,Carmen,40,ES76209545461096905487,TRX_N-00201-51840435,2021-06-05T19:48:29,Zarautz,Basic services,water,-56.69,1959.19
buyer_2,Carmen,40,ES76209545461096905487,TRX_N-00202-46626626,2021-06-05T19:04:53,Zarautz,Basic services,electricity,-149.38,1809.81
buyer_2,Carmen,40,ES76209545461096905487,TRX_N-00203-14220539,2021-06-05T09:03:20,Zarautz,Basic services,gas,-31.51,1778.3
buyer_2,Carmen,40,ES76209545461096905487,TRX_N-00204-00788788,2021-06-06T13:22:17,Zarautz,Basic services,water,-58.77,1719.53
buyer_2,Carmen,40,ES76209545461096905487,TRX_N-00205-39948170,2021-06-07T22:37:35,Zarautz,Basic services,gas,-39.18,1680.35
buyer_2,Carmen,40,ES76209545461096905487,TRX_N-00206-92305917,2021-07-01T11:42:15,Zarautz,transfer,Salary,1970.02,3650.37
buyer_2,Carmen,40,ES76209545461096905487,TRX_N-00207-01145657,2021-07-05T11:29:15,Zarautz,Housing,Rent,-666.22,2984.15
buyer_2,Carmen,40,ES76209545461096905487,TRX_N-00208-62883653,2021-07-05T14:57:16,Zarautz,Basic services,gas,-90.8,2893.35
buyer_2,Carmen,40,ES76209545461096905487,TRX_N-00209-10850388,2021-07-05T09:48:25,Zarautz,Basic services,phone,-93.6,2799.75
buyer_2,Carmen,40,ES76209545461096905487,TRX_N-00210-68963405,2021-07-06T09:50:53,Zarautz,Basic services,gas,-62.22,2737.53
buyer_2,Carmen,40,ES76209545461096905487,TRX_N-00211-68284907,2021-07-06T19:05:22,Zarautz,Basic services,internet,-33.59,2703.94
buyer_2,Carmen,40,ES76209545461096905487,TRX_N-00212-18507394,2021-07-07T15:02:00,Zarautz,Basic services,water,-62.75,2641.19
buyer_2,Carmen,40,ES76209545461096905487,TRX_N-00213-25061438,2021-07-07T08:20:33,Zarautz,Basic services,gas,-42.85,2598.34
buyer_2,Carmen,40,ES76209545461096905487,TRX_N-00214-03593756,2021-07-07T09:04:22,Zarautz,Basic services,phone,-54.06,2544.28
buyer_2,Carmen,40,ES76209545461096905487,TRX_N-00215-06899028,2021-07-16T09:08:16,Zarautz,Expense,food,-569.92,1974.36
buyer_2,Carmen,40,ES76209545461096905487,TRX_N-00216-80623206,2021-07-22T00:58:13,Zarautz,Expense,leisure,-76.54,1897.82
buyer_2,Carmen,40,ES76209545461096905487,TRX_N-00217-74314843,2021-08-01T08:23:32,Zarautz,transfer,Salary,1970.02,3867.84
buyer_2,Carmen,40,ES76209545461096905487,TRX_N-00218-66896794,2021-08-05T12:18:13,Zarautz,Housing,Rent,-666.22,3201.62
buyer_2,Carmen,40,ES76209545461096905487,TRX_N-00219-53042469,2021-08-05T15:55:46,Zarautz,Basic services,water,-14.21,3187.41
buyer_2,Carmen,40,ES76209545461096905487,TRX_N-00220-53776585,2021-08-05T18:54:32,Zarautz,Basic services,electricity,-61.91,3125.5
buyer_2,Carmen,40,ES76209545461096905487,TRX_N-00221-80895248,2021-08-05T11:16:19,Zarautz,Basic services,phone,-42.06,3083.44
buyer_2,Carmen,40,ES76209545461096905487,TRX_N-00222-39842462,2021-08-06T16:23:46,Zarautz,Basic services,internet,-66.39,3017.05
buyer_2,Carmen,40,ES76209545461096905487,TRX_N-00223-58621108,2021-08-07T14:08:14,Zarautz,Basic services,gas,-70.16,2946.89
buyer_2,Carmen,40,ES76209545461096905487,TRX_N-00224-50737508,2021-08-24T20:20:13,Zarautz,Expense,gifts,-169.44,2777.45
buyer_2,Carmen,40,ES76209545461096905487,TRX_N-00225-67402265,2021-08-31T06:58:46,Zarautz,Expense,food,-530.23,2247.22
buyer_2,Carmen,40,ES76209545461096905487,TRX_N-00226-82674240,2021-09-01T22:33:41,Zarautz,transfer,Salary,1970.02,4217.24
buyer_2,Carmen,40,ES76209545461096905487,TRX_N-00227-85240476,2021-09-01T22:33:41,Zarautz,transfer,Extra Income,197.0,4414.24
buyer_2,Carmen,40,ES76209545461096905487,TRX_N-00228-47143945,2021-09-05T16:10:02,Zarautz,Housing,Rent,-666.22,3748.02
buyer_2,Carmen,40,ES76209545461096905487,TRX_N-00229-88339246,2021-09-06T16:10:16,Zarautz,Basic services,electricity,-120.1,3627.92
buyer_2,Carmen,40,ES76209545461096905487,TRX_N-00230-96324597,2021-09-21T23:04:30,Zarautz,Expense,gifts,-276.0,3351.92
buyer_2,Carmen,40,ES76209545461096905487,TRX_N-00231-45346400,2021-09-22T23:19:14,Errenteria,Expense,food,-216.22,3135.7
buyer_2,Carmen,40,ES76209545461096905487,TRX_N-00232-55434139,2021-09-24T16:35:52,Sopela,Expense,leisure,-39.3,3096.4
buyer_2,Carmen,40,ES76209545461096905487,TRX_N-00233-66247188,2021-09-30T19:39:53,Eibar,Expense,transport,-194.47,2901.93
buyer_2,Carmen,40,ES76209545461096905487,TRX_N-00234-76348822,2021-10-01T19:47:00,Zarautz,transfer,Salary,1970.02,4871.95
buyer_2,Carmen,40,ES76209545461096905487,TRX_N-00235-54682544,2021-10-05T23:50:59,Zarautz,Housing,Rent,-666.22,4205.73
buyer_2,Carmen,40,ES76209545461096905487,TRX_N-00236-37311791,2021-10-05T10:36:24,Zarautz,Basic services,water,-60.49,4145.24
buyer_2,Carmen,40,ES76209545461096905487,TRX_N-00237-33180899,2021-10-05T12:15:16,Zarautz,Basic services,electricity,-76.84,4068.4
buyer_2,Carmen,40,ES76209545461096905487,TRX_N-00238-63664690,2021-10-05T13:28:31,Zarautz,Basic services,internet,-50.68,4017.72
buyer_2,Carmen,40,ES76209545461096905487,TRX_N-00239-40134267,2021-10-23T19:34:53,Zarautz,Expense,leisure,-103.26,3914.46
buyer_2,Carmen,40,ES76209545461096905487,TRX_N-00240-15007428,2021-10-27T12:01:21,Salvatierra/Agurain,Expense,repairs,-444.26,3470.2
buyer_2,Carmen,40,ES76209545461096905487,TRX_N-00241-77746309,2021-10-31T18:54:40,Santurtzi,Expense,leisure,-281.86,3188.34
buyer_2,Carmen,40,ES76209545461096905487,TRX_N-00242-30363472,2021-11-01T22:40:44,Zarautz,transfer,Salary,1970.02,5158.36
buyer_2,Carmen,40,ES76209545461096905487,TRX_N-00243-06943224,2021-11-01T22:40:44,Zarautz,transfer,Extra Income,197.0,5355.36
buyer_2,Carmen,40,ES76209545461096905487,TRX_N-00244-37166469,2021-11-01T10:51:17,Zarautz,Expense,transport,-78.57,5276.79
buyer_2,Carmen,40,ES76209545461096905487,TRX_N-00245-97129789,2021-11-05T16:36:59,Zarautz,Housing,Rent,-666.22,4610.57
buyer_2,Carmen,40,ES76209545461096905487,TRX_N-00246-52121068,2021-11-05T23:56:10,Zarautz,Basic services,phone,-34.12,4576.45
buyer_2,Carmen,40,ES76209545461096905487,TRX_N-00247-46565182,2021-11-07T09:29:58,Zarautz,Basic services,water,-32.56,4543.89
buyer_2,Carmen,40,ES76209545461096905487,TRX_N-00248-06197408,2021-11-07T10:18:30,Zarautz,Basic services,gas,-33.68,4510.21
buyer_2,Carmen,40,ES76209545461096905487,TRX_N-00249-60141180,2021-11-07T16:43:40,Zarautz,Basic services,internet,-52.98,4457.23
buyer_2,Carmen,40,ES76209545461096905487,TRX_N-00250-08183533,2021-11-07T14:41:32,Zarautz,Basic services,phone,-23.89,4433.34
buyer_2,Carmen,40,ES76209545461096905487,TRX_N-00251-22633976,2021-11-21T20:31:29,Zarautz,Expense,gifts,-346.92,4086.42
buyer_2,Carmen,40,ES76209545461096905487,TRX_N-00252-96181744,2021-12-01T13:21:30,Zarautz,transfer,Salary,1970.02,6056.44
buyer_2,Carmen,40,ES76209545461096905487,TRX_N-00253-11035086,2021-12-01T13:21:30,Zarautz,transfer,Bonus,2006.53,8062.97
buyer_2,Carmen,40,ES76209545461096905487,TRX_N-00254-83337514,2021-12-05T16:03:55,Zarautz,Housing,Rent,-666.22,7396.75
buyer_2,Carmen,40,ES76209545461096905487,TRX_N-00255-09830583,2021-12-05T11:17:28,Zarautz,Basic services,electricity,-73.11,7323.64
buyer_2,Carmen,40,ES76209545461096905487,TRX_N-00256-05456902,2021-12-06T09:52:01,Zarautz,Basic services,water,-69.98,7253.66
buyer_2,Carmen,40,ES76209545461096905487,TRX_N-00257-79074283,2021-12-06T10:02:15,Zarautz,Basic services,gas,-70.65,7183.01
buyer_2,Carmen,40,ES76209545461096905487,TRX_N-00258-12844195,2021-12-06T12:20:10,Zarautz,Basic services,phone,-87.97,7095.04
buyer_2,Carmen,40,ES76209545461096905487,TRX_N-00259-10005571,2021-12-07T21:25:30,Zarautz,Basic services,water,-18.28,7076.76
buyer_2,Carmen,40,ES76209545461096905487,TRX_N-00260-34991248,2021-12-07T16:10:17,Zarautz,Basic services,gas,-85.96,6990.8
buyer_2,Carmen,40,ES76209545461096905487,TRX_N-00261-35990259,2021-12-07T04:01:19,Zarautz,Basic services,internet,-65.36,6925.44
buyer_2,Carmen,40,ES76209545461096905487,TRX_N-00262-51343992,2021-12-09T11:54:07,Zarautz,Expense,gifts,-107.01,6818.43
buyer_2,Carmen,40,ES76209545461096905487,TRX_N-00263-00922815,2021-12-14T14:51:47,Zarautz,Expense,transport,-21.88,6796.55
buyer_2,Carmen,40,ES76209545461096905487,TRX_N-00264-28590807,2021-12-28T15:16:15,Zarautz,Expense,leisure,-235.59,6560.96
buyer_2,Carmen,40,ES76209545461096905487,TRX_N-00265-34088869,2022-01-01T20:10:54,Zarautz,transfer,Salary,1970.02,8530.98
buyer_2,Carmen,40,ES76209545461096905487,TRX_N-00266-57338123,2022-01-01T13:17:51,Zarautz,Expense,clothing,-331.19,8199.79
buyer_2,Carmen,40,ES76209545461096905487,TRX_N-00267-21211653,2022-01-05T11:44:58,Zarautz,Housing,Rent,-666.22,7533.57
buyer_2,Carmen,40,ES76209545461096905487,TRX_N-00268-49847878,2022-01-06T18:13:01,Zarautz,Basic services,internet,-30.67,7502.9
buyer_2,Carmen,40,ES76209545461096905487,TRX_N-00269-45805052,2022-01-07T16:40:26,Zarautz,Basic services,gas,-71.18,7431.72
buyer_2,Carmen,40,ES76209545461096905487,TRX_N-00270-44576098,2022-01-07T17:16:15,Zarautz,Basic services,internet,-40.12,7391.6
buyer_2,Carmen,40,ES76209545461096905487,TRX_N-00271-46762141,2022-01-17T10:09:59,Zarautz,Expense,food,-642.23,6749.37
buyer_2,Carmen,40,ES76209545461096905487,TRX_N-00272-17349143,2022-02-01T14:46:57,Zarautz,transfer,Salary,1970.02,8719.39
buyer_2,Carmen,40,ES76209545461096905487,TRX_N-00273-20456054,2022-02-01T14:46:57,Zarautz,transfer,Extra Income,197.0,8916.39
buyer_2,Carmen,40,ES76209545461096905487,TRX_N-00274-17731691,2022-02-02T13:31:28,Zarautz,Expense,transport,-141.23,8775.16
buyer_2,Carmen,40,ES76209545461096905487,TRX_N-00275-44824673,2022-02-05T18:54:25,Zarautz,Housing,Rent,-666.22,8108.94
buyer_2,Carmen,40,ES76209545461096905487,TRX_N-00276-22626100,2022-02-05T13:21:22,Zarautz,Basic services,phone,-84.69,8024.25
buyer_2,Carmen,40,ES76209545461096905487,TRX_N-00277-57510478,2022-02-06T20:00:49,Zarautz,Basic services,gas,-25.22,7999.03
buyer_2,Carmen,40,ES76209545461096905487,TRX_N-00278-92973921,2022-02-06T16:25:37,Zarautz,Basic services,phone,-91.71,7907.32
buyer_2,Carmen,40,ES76209545461096905487,TRX_N-00279-11973270,2022-02-07T23:23:04,Zarautz,Basic services,water,-27.16,7880.16
buyer_2,Carmen,40,ES76209545461096905487,TRX_N-00280-48234359,2022-02-11T12:12:20,Zarautz,Expense,food,-579.42,7300.74
buyer_2,Carmen,40,ES76209545461096905487,TRX_N-00281-91238196,2022-02-18T15:29:29,Zarautz,Expense,food,-772.37,6528.37
buyer_2,Carmen,40,ES76209545461096905487,TRX_N-00282-44437565,2022-02-22T12:20:23,Zarautz,Expense,food,-147.5,6380.87
buyer_2,Carmen,40,ES76209545461096905487,TRX_N-00283-48000010,2022-03-01T16:14:37,Zarautz,transfer,Salary,1970.02,8350.89
buyer_2,Carmen,40,ES76209545461096905487,TRX_N-00284-72244708,2022-03-05T15:48:35,Zarautz,Housing,Rent,-666.22,7684.67
buyer_2,Carmen,40,ES76209545461096905487,TRX_N-00285-11649919,2022-03-05T20:34:38,Zarautz,Basic services,electricity,-131.5,7553.17
buyer_2,Carmen,40,ES76209545461096905487,TRX_N-00286-98456257,2022-03-06T06:08:42,Zarautz,Basic services,electricity,-21.35,7531.82
buyer_2,Carmen,40,ES76209545461096905487,TRX_N-00287-29303563,2022-03-06T20:50:09,Zarautz,Basic services,gas,-70.42,7461.4
buyer_2,Carmen,40,ES76209545461096905487,TRX_N-00288-47281698,2022-03-07T16:27:10,Zarautz,Basic services,electricity,-131.75,7329.65
buyer_2,Carmen,40,ES76209545461096905487,TRX_N-00289-46039101,2022-03-07T14:43:41,Zarautz,Basic services,phone,-54.66,7274.99
buyer_2,Carmen,40,ES76209545461096905487,TRX_N-00290-88537935,2022-03-09T09:30:57,Zarautz,Expense,leisure,-39.23,7235.76
buyer_2,Carmen,40,ES76209545461096905487,TRX_N-00291-88933458,2022-03-17T19:20:08,Andoain,Expense,education,-124.25,7111.51
buyer_2,Carmen,40,ES76209545461096905487,TRX_N-00292-81883202,2022-03-18T11:03:02,Zarautz,Expense,leisure,-104.05,7007.46
buyer_2,Carmen,40,ES76209545461096905487,TRX_N-00293-67533736,2022-03-20T17:42:43,Zarautz,Expense,leisure,-174.82,6832.64
buyer_2,Carmen,40,ES76209545461096905487,TRX_N-00294-20140997,2022-03-23T10:04:47,Zarautz,Expense,healthcare,-52.86,6779.78
buyer_2,Carmen,40,ES76209545461096905487,TRX_N-00295-42093414,2022-03-29T10:01:49,Zarautz,Expense,transport,-197.97,6581.81
buyer_2,Carmen,40,ES76209545461096905487,TRX_N-00296-32106974,2022-04-01T08:15:13,Zarautz,transfer,Salary,1970.02,8551.83
buyer_2,Carmen,40,ES76209545461096905487,TRX_N-00297-78194191,2022-04-01T08:15:13,Zarautz,transfer,Extra Income,197.0,8748.83
buyer_2,Carmen,40,ES76209545461096905487,TRX_N-00298-43423183,2022-04-02T11:44:56,Bilbao,Expense,leisure,-282.43,8466.4
buyer_2,Carmen,40,ES76209545461096905487,TRX_N-00299-06803363,2022-04-04T12:15:56,Alegría-Dulantzi,Expense,travel,-2299.37,6167.03
buyer_2,Carmen,40,ES76209545461096905487,TRX_N-00300-90813233,2022-04-05T10:19:31,Zarautz,Housing,Rent,-666.22,5500.81
buyer_2,Carmen,40,ES76209545461096905487,TRX_N-00301-53992577,2022-04-05T10:40:56,Zarautz,Basic services,gas,-36.98,5463.83
buyer_2,Carmen,40,ES76209545461096905487,TRX_N-00302-41576172,2022-04-06T15:36:40,Zarautz,Basic services,internet,-62.68,5401.15
buyer_2,Carmen,40,ES76209545461096905487,TRX_N-00303-29499280,2022-04-06T11:26:55,Hernani,Expense,gifts,-445.88,4955.27
buyer_2,Carmen,40,ES76209545461096905487,TRX_N-00304-10205987,2022-04-07T14:55:48,Zarautz,Basic services,phone,-22.58,4932.69
buyer_2,Carmen,40,ES76209545461096905487,TRX_N-00305-09669827,2022-04-11T19:28:14,Zarautz,Expense,leisure,-250.42,4682.27
buyer_2,Carmen,40,ES76209545461096905487,TRX_N-00306-99131112,2022-04-15T16:34:56,Zarautz,Expense,transport,-94.77,4587.5
buyer_2,Carmen,40,ES76209545461096905487,TRX_N-00307-67504759,2022-04-17T01:29:21,Zarautz,Expense,travel,-1664.49,2923.01
buyer_2,Carmen,40,ES76209545461096905487,TRX_N-00308-23331679,2022-04-19T15:59:03,Zarautz,Expense,transport,-73.08,2849.93
buyer_2,Carmen,40,ES76209545461096905487,TRX_N-00309-70215104,2022-04-20T08:34:11,Zarautz,Expense,food,-738.51,2111.42
buyer_2,Carmen,40,ES76209545461096905487,TRX_N-00310-99203916,2022-05-01T11:51:00,Zarautz,transfer,Salary,1970.02,4081.44
buyer_2,Carmen,40,ES76209545461096905487,TRX_N-00311-43004897,2022-05-05T11:49:19,Zarautz,Housing,Rent,-666.22,3415.22
buyer_2,Carmen,40,ES76209545461096905487,TRX_N-00312-96975267,2022-05-05T19:26:07,Zarautz,Basic services,gas,-87.41,3327.81
buyer_2,Carmen,40,ES76209545461096905487,TRX_N-00313-60333522,2022-05-05T20:31:22,Zarautz,Expense,transport,-105.32,3222.49
buyer_2,Carmen,40,ES76209545461096905487,TRX_N-00314-55049541,2022-05-06T10:38:12,Zarautz,Basic services,water,-31.37,3191.12
buyer_2,Carmen,40,ES76209545461096905487,TRX_N-00315-68164156,2022-05-17T19:19:37,Zarautz,Expense,food,-589.88,2601.24
buyer_2,Carmen,40,ES76209545461096905487,TRX_N-00316-54126789,2022-05-20T09:47:41,Santurtzi,Expense,food,-443.22,2158.02
buyer_2,Carmen,40,ES76209545461096905487,TRX_N-00317-45979379,2022-05-23T11:46:50,Zarautz,Expense,leisure,-235.95,1922.07
buyer_2,Carmen,40,ES76209545461096905487,TRX_N-00318-19480146,2022-06-01T12:42:30,Zarautz,transfer,Salary,1970.02,3892.09
buyer_2,Carmen,40,ES76209545461096905487,TRX_N-00319-27035432,2022-06-01T12:42:30,Zarautz,transfer,Bonus,1839.43,5731.52
buyer_2,Carmen,40,ES76209545461096905487,TRX_N-00320-57895490,2022-06-05T15:12:07,Zarautz,Housing,Rent,-666.22,5065.3
buyer_2,Carmen,40,ES76209545461096905487,TRX_N-00321-71101506,2022-06-05T16:41:43,Zarautz,Basic services,electricity,-132.62,4932.68
buyer_2,Carmen,40,ES76209545461096905487,TRX_N-00322-58888981,2022-06-05T09:06:31,Zarautz,Basic services,gas,-44.98,4887.7
buyer_2,Carmen,40,ES76209545461096905487,TRX_N-00323-26381036,2022-06-06T19:22:00,Zarautz,Basic services,gas,-49.11,4838.59
buyer_2,Carmen,40,ES76209545461096905487,TRX_N-00324-08711826,2022-06-06T18:13:43,Zarautz,Expense,gifts,-480.35,4358.24
buyer_2,Carmen,40,ES76209545461096905487,TRX_N-00325-08944893,2022-06-07T20:25:23,Zarautz,Basic services,water,-69.98,4288.26
buyer_2,Carmen,40,ES76209545461096905487,TRX_N-00326-96094041,2022-06-13T14:14:21,Zarautz,Expense,transport,-186.23,4102.03
buyer_2,Carmen,40,ES76209545461096905487,TRX_N-00327-27094403,2022-06-17T13:52:22,Berango,Expense,transport,-27.26,4074.77
buyer_2,Carmen,40,ES76209545461096905487,TRX_N-00328-32995138,2022-06-18T11:56:00,Zarautz,Expense,leisure,-40.19,4034.58
buyer_2,Carmen,40,ES76209545461096905487,TRX_N-00329-74535333,2022-06-19T13:34:58,Zarautz,Expense,food,-396.46,3638.12
buyer_2,Carmen,40,ES76209545461096905487,TRX_N-00330-17151186,2022-06-22T09:14:00,Zarautz,Expense,transport,-88.27,3549.85
buyer_2,Carmen,40,ES76209545461096905487,TRX_N-00331-62043952,2022-06-23T16:42:35,Zarautz,Expense,clothing,-334.94,3214.91
buyer_2,Carmen,40,ES76209545461096905487,TRX_N-00332-94099102,2022-07-01T18:41:00,Zarautz,transfer,Salary,1970.02,5184.93
buyer_2,Carmen,40,ES76209545461096905487,TRX_N-00333-85592806,2022-07-01T18:41:00,Zarautz,transfer,Extra Income,197.0,5381.93
buyer_2,Carmen,40,ES76209545461096905487,TRX_N-00334-03600167,2022-07-05T08:15:11,Zarautz,Housing,Rent,-666.22,4715.71
buyer_2,Carmen,40,ES76209545461096905487,TRX_N-00335-50459807,2022-07-05T19:29:40,Zarautz,Basic services,internet,-35.23,4680.48
buyer_2,Carmen,40,ES76209545461096905487,TRX_N-00336-83676027,2022-07-05T14:54:02,Zarautz,Basic services,phone,-97.03,4583.45
buyer_2,Carmen,40,ES76209545461096905487,TRX_N-00337-63129672,2022-07-06T15:55:47,Zarautz,Basic services,water,-59.25,4524.2
buyer_2,Carmen,40,ES76209545461096905487,TRX_N-00338-16749652,2022-07-06T17:20:52,Zarautz,Basic services,gas,-39.71,4484.49
buyer_2,Carmen,40,ES76209545461096905487,TRX_N-00339-58473777,2022-07-06T05:49:07,Zarautz,Basic services,internet,-54.54,4429.95
buyer_2,Carmen,40,ES76209545461096905487,TRX_N-00340-48749938,2022-07-06T09:22:01,Zarautz,Basic services,phone,-56.36,4373.59
buyer_2,Carmen,40,ES76209545461096905487,TRX_N-00341-89341176,2022-07-07T19:33:57,Zarautz,Basic services,water,-29.94,4343.65
buyer_2,Carmen,40,ES76209545461096905487,TRX_N-00342-34319298,2022-07-07T12:24:46,Zarautz,Basic services,gas,-35.86,4307.79
buyer_2,Carmen,40,ES76209545461096905487,TRX_N-00343-20280739,2022-07-12T10:24:56,Zarautz,Expense,transport,-67.56,4240.23
buyer_2,Carmen,40,ES76209545461096905487,TRX_N-00344-94892317,2022-07-17T15:12:18,Zarautz,Expense,repairs,-113.98,4126.25
buyer_2,Carmen,40,ES76209545461096905487,TRX_N-00345-96163111,2022-08-01T16:15:52,Zarautz,transfer,Salary,1970.02,6096.27
buyer_2,Carmen,40,ES76209545461096905487,TRX_N-00346-76260733,2022-08-01T12:23:00,Zarautz,Expense,transport,-119.39,5976.88
buyer_2,Carmen,40,ES76209545461096905487,TRX_N-00347-04640986,2022-08-04T15:34:57,Zarautz,Expense,repairs,-94.82,5882.06
buyer_2,Carmen,40,ES76209545461096905487,TRX_N-00348-83112342,2022-08-05T19:05:50,Zarautz,Housing,Rent,-666.22,5215.84
buyer_2,Carmen,40,ES76209545461096905487,TRX_N-00349-72468063,2022-08-05T03:28:12,Zarautz,Basic services,water,-24.13,5191.71
buyer_2,Carmen,40,ES76209545461096905487,TRX_N-00350-07728337,2022-08-05T21:58:02,Zarautz,Basic services,gas,-39.84,5151.87
buyer_2,Carmen,40,ES76209545461096905487,TRX_N-00351-95302181,2022-08-05T12:07:34,Zarautz,Basic services,internet,-37.15,5114.72
buyer_2,Carmen,40,ES76209545461096905487,TRX_N-00352-19153516,2022-08-06T17:28:14,Zarautz,Basic services,electricity,-116.67,4998.05
buyer_2,Carmen,40,ES76209545461096905487,TRX_N-00353-29007220,2022-08-07T16:24:06,Zarautz,Basic services,gas,-67.51,4930.54
buyer_2,Carmen,40,ES76209545461096905487,TRX_N-00354-92332538,2022-08-13T17:16:25,Zarautz,Expense,healthcare,-161.5,4769.04
buyer_2,Carmen,40,ES76209545461096905487,TRX_N-00355-86243631,2022-08-26T15:43:47,Zarautz,Expense,healthcare,-136.21,4632.83
buyer_2,Carmen,40,ES76209545461096905487,TRX_N-00356-27777491,2022-08-28T13:04:35,Zarautz,Expense,leisure,-193.99,4438.84
buyer_2,Carmen,40,ES76209545461096905487,TRX_N-00357-89407778,2022-09-01T14:59:58,Zarautz,transfer,Salary,1970.02,6408.86
buyer_2,Carmen,40,ES76209545461096905487,TRX_N-00358-62699038,2022-09-01T14:59:58,Zarautz,transfer,Extra Income,197.0,6605.86
buyer_2,Carmen,40,ES76209545461096905487,TRX_N-00359-91955481,2022-09-04T13:56:50,Zarautz,Expense,food,-506.04,6099.82
buyer_2,Carmen,40,ES76209545461096905487,TRX_N-00360-30768387,2022-09-05T14:05:37,Zarautz,Housing,Rent,-666.22,5433.6
buyer_2,Carmen,40,ES76209545461096905487,TRX_N-00361-21957549,2022-09-05T00:36:39,Zarautz,Basic services,water,-41.84,5391.76
buyer_2,Carmen,40,ES76209545461096905487,TRX_N-00362-77304247,2022-09-05T08:58:12,Zarautz,Basic services,electricity,-68.04,5323.72
buyer_2,Carmen,40,ES76209545461096905487,TRX_N-00363-19505318,2022-09-06T19:37:11,Zarautz,Basic services,gas,-65.93,5257.79
buyer_2,Carmen,40,ES76209545461096905487,TRX_N-00364-19120866,2022-09-07T20:24:04,Zarautz,Basic services,gas,-42.85,5214.94
buyer_2,Carmen,40,ES76209545461096905487,TRX_N-00365-56368293,2022-09-12T12:11:46,Zarautz,Expense,repairs,-849.06,4365.88
buyer_2,Carmen,40,ES76209545461096905487,TRX_N-00366-00998597,2022-09-18T12:26:28,Zarautz,Expense,healthcare,-135.19,4230.69
buyer_2,Carmen,40,ES76209545461096905487,TRX_N-00367-75140383,2022-09-21T18:24:46,Zarautz,Expense,food,-784.05,3446.64
buyer_2,Carmen,40,ES76209545461096905487,TRX_N-00368-11114320,2022-09-26T08:16:03,Hondarribia,Expense,clothing,-167.31,3279.33
buyer_2,Carmen,40,ES76209545461096905487,TRX_N-00369-47437630,2022-10-01T17:20:27,Zarautz,transfer,Salary,1970.02,5249.35
buyer_2,Carmen,40,ES76209545461096905487,TRX_N-00370-30111898,2022-10-05T10:20:52,Zarautz,Housing,Rent,-666.22,4583.13
buyer_2,Carmen,40,ES76209545461096905487,TRX_N-00371-06973740,2022-10-05T20:32:08,Zarautz,Basic services,water,-45.06,4538.07
buyer_2,Carmen,40,ES76209545461096905487,TRX_N-00372-07412023,2022-10-05T10:58:29,Zarautz,Basic services,electricity,-86.17,4451.9
buyer_2,Carmen,40,ES76209545461096905487,TRX_N-00373-33381028,2022-10-06T10:57:04,Zarautz,Basic services,water,-13.94,4437.96
buyer_2,Carmen,40,ES76209545461096905487,TRX_N-00374-79847711,2022-10-06T11:37:57,Zarautz,Basic services,electricity,-113.57,4324.39
buyer_2,Carmen,40,ES76209545461096905487,TRX_N-00375-36506716,2022-10-07T18:12:41,Zarautz,Basic services,electricity,-100.76,4223.63
buyer_2,Carmen,40,ES76209545461096905487,TRX_N-00376-66862023,2022-10-15T17:33:12,Zarautz,Expense,clothing,-122.35,4101.28
buyer_2,Carmen,40,ES76209545461096905487,TRX_N-00377-27806005,2022-10-22T17:06:16,Zarautz,Expense,healthcare,-397.8,3703.48
buyer_2,Carmen,40,ES76209545461096905487,TRX_N-00378-65332630,2022-10-27T15:18:42,Sestao,Expense,leisure,-208.77,3494.71
buyer_2,Carmen,40,ES76209545461096905487,TRX_N-00379-65114547,2022-11-01T17:30:17,Zarautz,transfer,Salary,1970.02,5464.73
buyer_2,Carmen,40,ES76209545461096905487,TRX_N-00380-49621907,2022-11-02T02:57:00,Elciego,Expense,leisure,-106.54,5358.19
buyer_2,Carmen,40,ES76209545461096905487,TRX_N-00381-28186228,2022-11-04T17:22:25,Zarautz,Expense,leisure,-38.23,5319.96
buyer_2,Carmen,40,ES76209545461096905487,TRX_N-00382-05712577,2022-11-05T20:01:57,Zarautz,Housing,Rent,-666.22,4653.74
buyer_2,Carmen,40,ES76209545461096905487,TRX_N-00383-50689335,2022-11-05T08:27:54,Zarautz,Basic services,water,-40.53,4613.21
buyer_2,Carmen,40,ES76209545461096905487,TRX_N-00384-78808351,2022-11-05T09:33:39,Zarautz,Basic services,gas,-16.02,4597.19
buyer_2,Carmen,40,ES76209545461096905487,TRX_N-00385-90023091,2022-11-05T20:07:39,Hernani,Expense,education,-478.2,4118.99
buyer_2,Carmen,40,ES76209545461096905487,TRX_N-00386-74191763,2022-11-06T17:03:46,Zarautz,Basic services,electricity,-138.54,3980.45
buyer_2,Carmen,40,ES76209545461096905487,TRX_N-00387-53270582,2022-11-06T11:37:14,Zarautz,Basic services,internet,-52.85,3927.6
buyer_2,Carmen,40,ES76209545461096905487,TRX_N-00388-82813401,2022-11-08T20:51:09,Zarautz,Expense,food,-292.16,3635.44
buyer_2,Carmen,40,ES76209545461096905487,TRX_N-00389-16406378,2022-11-11T18:26:09,Zarautz,Expense,food,-663.95,2971.49
buyer_2,Carmen,40,ES76209545461096905487,TRX_N-00390-88218305,2022-11-17T17:26:14,Zarautz,Expense,transport,-36.13,2935.36
buyer_2,Carmen,40,ES76209545461096905487,TRX_N-00391-85943964,2022-12-01T12:10:12,Zarautz,transfer,Salary,1970.02,4905.38
buyer_2,Carmen,40,ES76209545461096905487,TRX_N-00392-87411988,2022-12-01T12:10:12,Zarautz,transfer,Extra Income,197.0,5102.38
buyer_2,Carmen,40,ES76209545461096905487,TRX_N-00393-45745556,2022-12-01T12:10:12,Zarautz,transfer,Bonus,1881.03,6983.41
buyer_2,Carmen,40,ES76209545461096905487,TRX_N-00394-62203463,2022-12-05T13:18:06,Zarautz,Housing,Rent,-666.22,6317.19
buyer_2,Carmen,40,ES76209545461096905487,TRX_N-00395-41409291,2022-12-06T05:26:34,Zarautz,Basic services,electricity,-27.01,6290.18
buyer_2,Carmen,40,ES76209545461096905487,TRX_N-00396-38144454,2022-12-06T08:57:54,Zarautz,Basic services,gas,-59.29,6230.89
buyer_2,Carmen,40,ES76209545461096905487,TRX_N-00397-37598569,2022-12-07T19:41:17,Zarautz,Basic services,electricity,-77.18,6153.71
buyer_2,Carmen,40,ES76209545461096905487,TRX_N-00398-76729932,2022-12-07T11:52:22,Zarautz,Basic services,gas,-53.56,6100.15
buyer_2,Carmen,40,ES76209545461096905487,TRX_N-00399-31953766,2022-12-07T16:08:20,Zarautz,Basic services,phone,-95.0,6005.15
buyer_2,Carmen,40,ES76209545461096905487,TRX_N-00400-31177292,2022-12-22T19:56:14,Arrasate/Mondragon,Expense,food,-730.05,5275.1
buyer_2,Carmen,40,ES76209545461096905487,TRX_N-00401-92683617,2022-12-30T16:34:16,Zarautz,Expense,transport,-151.73,5123.37
buyer_2,Carmen,40,ES76209545461096905487,TRX_N-00402-63076592,2023-01-01T17:27:42,Zarautz,transfer,Salary,1970.02,7093.39
buyer_2,Carmen,40,ES76209545461096905487,TRX_N-00403-82320267,2023-01-01T09:25:03,Zarautz,Expense,food,-448.1,6645.29
buyer_2,Carmen,40,ES76209545461096905487,TRX_N-00404-58793019,2023-01-05T08:44:57,Zarautz,Housing,Rent,-666.22,5979.07
buyer_2,Carmen,40,ES76209545461096905487,TRX_N-00405-51455364,2023-01-05T09:04:04,Zarautz,Basic services,water,-26.31,5952.76
buyer_2,Carmen,40,ES76209545461096905487,TRX_N-00406-73004034,2023-01-05T00:44:24,Zarautz,Basic services,gas,-77.14,5875.62
buyer_2,Carmen,40,ES76209545461096905487,TRX_N-00407-78309960,2023-01-06T14:12:04,Zarautz,Basic services,water,-62.49,5813.13
buyer_2,Carmen,40,ES76209545461096905487,TRX_N-00408-44815899,2023-01-06T21:44:34,Zarautz,Basic services,gas,-49.48,5763.65
buyer_2,Carmen,40,ES76209545461096905487,TRX_N-00409-29683587,2023-01-06T22:47:28,Zarautz,Expense,leisure,-35.66,5727.99
buyer_2,Carmen,40,ES76209545461096905487,TRX_N-00410-70750192,2023-01-07T12:27:27,Zarautz,Basic services,phone,-90.87,5637.12
buyer_2,Carmen,40,ES76209545461096905487,TRX_N-00411-48472661,2023-01-16T21:44:17,Zarautz,Expense,appliances,-1321.15,4315.97
buyer_2,Carmen,40,ES76209545461096905487,TRX_N-00412-64757473,2023-01-31T08:18:26,Zarautz,Expense,appliances,-1095.87,3220.1
buyer_2,Carmen,40,ES76209545461096905487,TRX_N-00413-11453582,2023-02-01T11:36:43,Zarautz,transfer,Salary,1970.02,5190.12
buyer_2,Carmen,40,ES76209545461096905487,TRX_N-00414-65803797,2023-02-01T11:36:43,Zarautz,transfer,Extra Income,197.0,5387.12
buyer_2,Carmen,40,ES76209545461096905487,TRX_N-00415-32410638,2023-02-03T12:43:09,Zarautz,Expense,healthcare,-324.8,5062.32
buyer_2,Carmen,40,ES76209545461096905487,TRX_N-00416-24192551,2023-02-03T09:37:00,Zarautz,Expense,gifts,-275.63,4786.69
buyer_2,Carmen,40,ES76209545461096905487,TRX_N-00417-81681722,2023-02-05T13:58:29,Zarautz,Housing,Rent,-666.22,4120.47
buyer_2,Carmen,40,ES76209545461096905487,TRX_N-00418-91854224,2023-02-05T10:41:14,Zarautz,Basic services,water,-66.25,4054.22
buyer_2,Carmen,40,ES76209545461096905487,TRX_N-00419-65162173,2023-02-06T11:36:07,Zarautz,Basic services,electricity,-69.75,3984.47
buyer_2,Carmen,40,ES76209545461096905487,TRX_N-00420-38553609,2023-02-07T16:30:12,Zarautz,Basic services,water,-57.33,3927.14
buyer_2,Carmen,40,ES76209545461096905487,TRX_N-00421-33512759,2023-02-08T16:49:05,Zarautz,Expense,clothing,-355.36,3571.78
buyer_2,Carmen,40,ES76209545461096905487,TRX_N-00422-73685786,2023-02-13T09:31:01,Zarautz,Expense,leisure,-121.94,3449.84
buyer_2,Carmen,40,ES76209545461096905487,TRX_N-00423-39880017,2023-02-19T12:23:16,Andoain,Expense,food,-400.23,3049.61
buyer_2,Carmen,40,ES76209545461096905487,TRX_N-00424-62939358,2023-03-01T15:13:55,Zarautz,transfer,Salary,1970.02,5019.63
buyer_2,Carmen,40,ES76209545461096905487,TRX_N-00425-72623204,2023-03-05T20:17:10,Zarautz,Housing,Rent,-666.22,4353.41
buyer_2,Carmen,40,ES76209545461096905487,TRX_N-00426-73861607,2023-03-05T23:18:49,Zarautz,Basic services,water,-11.22,4342.19
buyer_2,Carmen,40,ES76209545461096905487,TRX_N-00427-50956096,2023-03-06T19:02:06,Zarautz,Basic services,electricity,-52.54,4289.65
buyer_2,Carmen,40,ES76209545461096905487,TRX_N-00428-58657659,2023-03-06T17:42:47,Zarautz,Basic services,phone,-82.34,4207.31
buyer_2,Carmen,40,ES76209545461096905487,TRX_N-00429-60152852,2023-03-11T08:54:27,Zarautz,Expense,food,-382.53,3824.78
buyer_2,Carmen,40,ES76209545461096905487,TRX_N-00430-71919680,2023-04-01T09:00:09,Zarautz,transfer,Salary,1970.02,5794.8
buyer_2,Carmen,40,ES76209545461096905487,TRX_N-00431-46462513,2023-04-01T09:00:09,Zarautz,transfer,Extra Income,197.0,5991.8
buyer_2,Carmen,40,ES76209545461096905487,TRX_N-00432-31461452,2023-04-05T09:09:49,Zarautz,Housing,Rent,-666.22,5325.58
buyer_2,Carmen,40,ES76209545461096905487,TRX_N-00433-99585484,2023-04-05T21:34:36,Zarautz,Expense,clothing,-471.91,4853.67
buyer_2,Carmen,40,ES76209545461096905487,TRX_N-00434-32961673,2023-04-06T19:20:32,Zarautz,Basic services,internet,-57.27,4796.4
buyer_2,Carmen,40,ES76209545461096905487,TRX_N-00435-20148303,2023-04-06T10:21:17,Zarautz,Basic services,phone,-77.14,4719.26
buyer_2,Carmen,40,ES76209545461096905487,TRX_N-00436-30982245,2023-04-07T09:34:17,Zarautz,Basic services,water,-47.45,4671.81
buyer_2,Carmen,40,ES76209545461096905487,TRX_N-00437-43840620,2023-04-07T20:43:20,Zarautz,Basic services,electricity,-114.39,4557.42
buyer_2,Carmen,40,ES76209545461096905487,TRX_N-00438-64485870,2023-04-07T19:59:44,Zarautz,Basic services,gas,-26.53,4530.89
buyer_2,Carmen,40,ES76209545461096905487,TRX_N-00439-53352704,2023-04-09T18:33:27,Zarautz,Expense,education,-166.6,4364.29
buyer_2,Carmen,40,ES76209545461096905487,TRX_N-00440-73744712,2023-04-11T12:51:05,Zarautz,Expense,leisure,-53.05,4311.24
buyer_2,Carmen,40,ES76209545461096905487,TRX_N-00441-51430646,2023-04-20T14:30:56,Zarautz,Expense,food,-218.57,4092.67
buyer_2,Carmen,40,ES76209545461096905487,TRX_N-00442-41269215,2023-04-21T20:15:22,Zarautz,Expense,education,-474.15,3618.52
buyer_2,Carmen,40,ES76209545461096905487,TRX_N-00443-18472038,2023-05-01T20:24:04,Zarautz,transfer,Salary,1970.02,5588.54
buyer_2,Carmen,40,ES76209545461096905487,TRX_N-00444-89720537,2023-05-05T11:10:32,Zarautz,Housing,Rent,-666.22,4922.32
buyer_2,Carmen,40,ES76209545461096905487,TRX_N-00445-04859048,2023-05-05T20:18:52,Durango,Expense,healthcare,-376.18,4546.14
buyer_2,Carmen,40,ES76209545461096905487,TRX_N-00446-96274516,2023-05-06T20:23:53,Zarautz,Basic services,electricity,-85.01,4461.13
buyer_2,Carmen,40,ES76209545461096905487,TRX_N-00447-15152213,2023-05-06T01:51:56,Zarautz,Basic services,internet,-31.43,4429.7
buyer_2,Carmen,40,ES76209545461096905487,TRX_N-00448-00815982,2023-05-06T15:29:34,Zarautz,Basic services,phone,-99.22,4330.48
buyer_2,Carmen,40,ES76209545461096905487,TRX_N-00449-06210939,2023-05-07T19:25:25,Zarautz,Basic services,electricity,-126.64,4203.84
buyer_2,Carmen,40,ES76209545461096905487,TRX_N-00450-51492307,2023-05-07T16:37:05,Zarautz,Basic services,internet,-78.63,4125.21
buyer_2,Carmen,40,ES76209545461096905487,TRX_N-00451-07196553,2023-05-10T11:12:08,Zarautz,Expense,transport,-115.65,4009.56
buyer_2,Carmen,40,ES76209545461096905487,TRX_N-00452-06701617,2023-05-15T16:50:33,Zarautz,Expense,leisure,-270.96,3738.6
buyer_2,Carmen,40,ES76209545461096905487,TRX_N-00453-85444738,2023-05-17T18:00:56,Zarautz,Expense,leisure,-65.52,3673.08
buyer_2,Carmen,40,ES76209545461096905487,TRX_N-00454-15088590,2023-05-29T09:21:48,Zarautz,Expense,clothing,-78.94,3594.14
buyer_2,Carmen,40,ES76209545461096905487,TRX_N-00455-39412644,2023-06-01T18:12:02,Zarautz,transfer,Salary,1970.02,5564.16
buyer_2,Carmen,40,ES76209545461096905487,TRX_N-00456-00745606,2023-06-01T18:12:02,Zarautz,transfer,Extra Income,197.0,5761.16
buyer_2,Carmen,40,ES76209545461096905487,TRX_N-00457-07082204,2023-06-01T18:12:02,Zarautz,transfer,Bonus,2093.66,7854.82
buyer_2,Carmen,40,ES76209545461096905487,TRX_N-00458-79069290,2023-06-02T21:14:09,Errenteria,Expense,transport,-41.2,7813.62
buyer_2,Carmen,40,ES76209545461096905487,TRX_N-00459-46667115,2023-06-02T14:48:21,Zarautz,Expense,leisure,-224.81,7588.81
buyer_2,Carmen,40,ES76209545461096905487,TRX_N-00460-24756243,2023-06-05T18:31:55,Zarautz,Housing,Rent,-666.22,6922.59
buyer_2,Carmen,40,ES76209545461096905487,TRX_N-00461-85744320,2023-06-05T10:46:48,Zarautz,Basic services,water,-34.77,6887.82
buyer_2,Carmen,40,ES76209545461096905487,TRX_N-00462-50827177,2023-06-05T15:18:19,Zarautz,Basic services,phone,-65.08,6822.74
buyer_2,Carmen,40,ES76209545461096905487,TRX_N-00463-44002292,2023-06-06T14:33:37,Zarautz,Basic services,water,-47.33,6775.41
buyer_2,Carmen,40,ES76209545461096905487,TRX_N-00464-21789283,2023-06-06T20:22:57,Zarautz,Basic services,gas,-95.4,6680.01
buyer_2,Carmen,40,ES76209545461096905487,TRX_N-00465-71779968,2023-06-06T08:59:25,Zarautz,Basic services,phone,-45.3,6634.71
buyer_2,Carmen,40,ES76209545461096905487,TRX_N-00466-09446096,2023-06-07T20:15:05,Zarautz,Basic services,water,-78.96,6555.75
buyer_2,Carmen,40,ES76209545461096905487,TRX_N-00467-23670787,2023-06-07T08:56:29,Zarautz,Basic services,electricity,-61.01,6494.74
buyer_2,Carmen,40,ES76209545461096905487,TRX_N-00468-69609922,2023-06-09T10:26:09,Zarautz,Expense,healthcare,-316.04,6178.7
buyer_2,Carmen,40,ES76209545461096905487,TRX_N-00469-55281986,2023-06-10T14:15:02,Zarautz,Expense,food,-719.99,5458.71
buyer_2,Carmen,40,ES76209545461096905487,TRX_N-00470-17408021,2023-06-14T22:53:48,Zarautz,Expense,education,-855.94,4602.77
buyer_2,Carmen,40,ES76209545461096905487,TRX_N-00471-38047946,2023-06-21T09:59:11,Zarautz,Expense,transport,-123.26,4479.51
buyer_2,Carmen,40,ES76209545461096905487,TRX_N-00472-25512322,2023-06-23T20:02:26,Zarautz,Expense,travel,-1848.24,2631.27
buyer_2,Carmen,40,ES76209545461096905487,TRX_N-00473-85370636,2023-06-27T12:26:21,Zarautz,Expense,education,-869.56,1761.71
buyer_2,Carmen,40,ES76209545461096905487,TRX_N-00474-99922210,2023-06-29T16:21:06,Zarautz,Expense,travel,-1719.49,42.22
buyer_2,Carmen,40,ES76209545461096905487,TRX_N-00475-56187664,2023-07-01T12:02:27,Zarautz,transfer,Salary,1970.02,2012.24
buyer_2,Carmen,40,ES76209545461096905487,TRX_N-00476-96343264,2023-07-05T06:15:40,Zarautz,Housing,Rent,-666.22,1346.02
buyer_2,Carmen,40,ES76209545461096905487,TRX_N-00477-64106267,2023-07-06T10:16:40,Zarautz,Basic services,electricity,-45.03,1300.99
buyer_2,Carmen,40,ES76209545461096905487,TRX_N-00478-14853538,2023-07-07T10:59:42,Zarautz,Basic services,gas,-97.76,1203.23
buyer_2,Carmen,40,ES76209545461096905487,TRX_N-00479-06069341,2023-07-07T00:45:36,Zarautz,Basic services,internet,-48.81,1154.42
buyer_2,Carmen,40,ES76209545461096905487,TRX_N-00480-63813132,2023-07-07T22:54:56,Zarautz,Basic services,phone,-64.91,1089.51
buyer_2,Carmen,40,ES76209545461096905487,TRX_N-00481-04172478,2023-07-11T17:31:12,Zarautz,Expense,leisure,-56.51,1033.0
buyer_2,Carmen,40,ES76209545461096905487,TRX_N-00482-43421514,2023-07-13T14:39:50,Zarautz,Expense,education,-250.26,782.74
buyer_2,Carmen,40,ES76209545461096905487,TRX_N-00483-78633063,2023-07-18T22:28:25,Sopela,Expense,transport,-51.78,730.96
buyer_2,Carmen,40,ES76209545461096905487,TRX_N-00484-24151901,2023-07-28T10:55:14,Zarautz,Expense,food,-704.17,26.79
buyer_2,Carmen,40,ES76209545461096905487,TRX_N-00485-53648448,2023-08-01T12:56:41,Zarautz,transfer,Salary,1970.02,1996.81
buyer_2,Carmen,40,ES76209545461096905487,TRX_N-00486-17273069,2023-08-01T12:56:41,Zarautz,transfer,Extra Income,197.0,2193.81
buyer_2,Carmen,40,ES76209545461096905487,TRX_N-00487-80243452,2023-08-02T11:36:21,Zarautz,Expense,transport,-48.05,2145.76
buyer_2,Carmen,40,ES76209545461096905487,TRX_N-00488-64399588,2023-08-04T04:10:32,Zarautz,Expense,transport,-182.16,1963.6
buyer_2,Carmen,40,ES76209545461096905487,TRX_N-00489-61542630,2023-08-05T16:23:07,Zarautz,Housing,Rent,-666.22,1297.38
buyer_2,Carmen,40,ES76209545461096905487,TRX_N-00490-06995787,2023-08-05T11:18:48,Zarautz,Basic services,electricity,-51.53,1245.85
buyer_2,Carmen,40,ES76209545461096905487,TRX_N-00491-75343549,2023-08-07T15:30:26,Zarautz,Basic services,water,-11.64,1234.21
buyer_2,Carmen,40,ES76209545461096905487,TRX_N-00492-34239021,2023-08-07T00:10:17,Zarautz,Basic services,electricity,-101.54,1132.67
buyer_2,Carmen,40,ES76209545461096905487,TRX_N-00493-54707578,2023-08-07T15:08:26,Zarautz,Basic services,gas,-76.52,1056.15
buyer_2,Carmen,40,ES76209545461096905487,TRX_N-00494-47160327,2023-08-07T10:40:11,Zarautz,Expense,transport,-158.42,897.73
buyer_2,Carmen,40,ES76209545461096905487,TRX_N-00495-66902866,2023-08-11T03:50:07,Arrasate/Mondragon,Expense,transport,-22.92,874.81
buyer_2,Carmen,40,ES76209545461096905487,TRX_N-00496-31752388,2023-08-11T11:19:34,Santurtzi,Expense,repairs,-66.26,808.55
buyer_2,Carmen,40,ES76209545461096905487,TRX_N-00497-31548087,2023-08-12T10:48:31,Amurrio,Expense,food,-123.92,684.63
buyer_2,Carmen,40,ES76209545461096905487,TRX_N-00498-98618065,2023-08-17T13:24:51,Zarautz,Expense,healthcare,-98.05,586.58
buyer_2,Carmen,40,ES76209545461096905487,TRX_N-00499-29134284,2023-08-23T10:24:08,Zarautz,Expense,food,-141.41,445.17
buyer_2,Carmen,40,ES76209545461096905487,TRX_N-00500-21146210,2023-09-01T22:55:33,Zarautz,transfer,Salary,1970.02,2415.19
buyer_2,Carmen,40,ES76209545461096905487,TRX_N-00501-92616519,2023-09-05T09:42:02,Zarautz,Housing,Rent,-666.22,1748.97
buyer_2,Carmen,40,ES76209545461096905487,TRX_N-00502-63934371,2023-09-05T20:32:57,Zarautz,Basic services,phone,-73.86,1675.11
buyer_2,Carmen,40,ES76209545461096905487,TRX_N-00503-70176991,2023-09-06T20:48:18,Zarautz,Basic services,gas,-19.02,1656.09
buyer_2,Carmen,40,ES76209545461096905487,TRX_N-00504-22802882,2023-09-06T03:14:09,Zarautz,Basic services,phone,-26.79,1629.3
buyer_2,Carmen,40,ES76209545461096905487,TRX_N-00505-19678215,2023-09-07T13:48:12,Zarautz,Basic services,gas,-72.6,1556.7
buyer_2,Carmen,40,ES76209545461096905487,TRX_N-00506-73488880,2023-09-07T19:05:55,Zarautz,Basic services,internet,-52.39,1504.31
buyer_2,Carmen,40,ES76209545461096905487,TRX_N-00507-53914160,2023-09-07T16:31:47,Zarautz,Expense,leisure,-249.24,1255.07
buyer_2,Carmen,40,ES76209545461096905487,TRX_N-00508-30935495,2023-09-08T10:36:50,Pasaia,Expense,food,-185.38,1069.69
buyer_2,Carmen,40,ES76209545461096905487,TRX_N-00509-87835686,2023-09-21T11:02:51,Zarautz,Expense,repairs,-341.15,728.54
buyer_2,Carmen,40,ES76209545461096905487,TRX_N-00510-53116117,2023-09-24T14:54:34,Zarautz,Expense,education,-809.81,-81.27
buyer_2,Carmen,40,ES76209545461096905487,TRX_N-00511-02774340,2023-09-26T19:10:46,Zarautz,Expense,healthcare,-44.86,-126.13
buyer_2,Carmen,40,ES76209545461096905487,TRX_N-00512-85942389,2023-10-01T20:36:53,Zarautz,transfer,Salary,1970.02,1843.89
buyer_2,Carmen,40,ES76209545461096905487,TRX_N-00513-22372458,2023-10-05T14:10:46,Zarautz,Housing,Rent,-666.22,1177.67
buyer_2,Carmen,40,ES76209545461096905487,TRX_N-00514-82327344,2023-10-05T20:52:25,Zarautz,Basic services,water,-68.78,1108.89
buyer_2,Carmen,40,ES76209545461096905487,TRX_N-00515-71670571,2023-10-05T16:08:02,Zarautz,Basic services,internet,-35.84,1073.05
buyer_2,Carmen,40,ES76209545461096905487,TRX_N-00516-71486046,2023-10-05T11:24:40,Zarautz,Basic services,phone,-79.26,993.79
buyer_2,Carmen,40,ES76209545461096905487,TRX_N-00517-81951667,2023-10-06T23:14:11,Zarautz,Basic services,water,-49.49,944.3
buyer_2,Carmen,40,ES76209545461096905487,TRX_N-00518-87365119,2023-10-06T17:03:49,Zarautz,Basic services,internet,-32.66,911.64
buyer_2,Carmen,40,ES76209545461096905487,TRX_N-00519-10414509,2023-10-07T13:15:52,Zarautz,Basic services,electricity,-140.81,770.83
buyer_2,Carmen,40,ES76209545461096905487,TRX_N-00520-20871843,2023-10-07T13:37:25,Zarautz,Basic services,phone,-62.19,708.64
buyer_2,Carmen,40,ES76209545461096905487,TRX_N-00521-41339467,2023-10-14T13:14:47,Zarautz,Expense,transport,-37.2,671.44
buyer_2,Carmen,40,ES76209545461096905487,TRX_N-00522-83881631,2023-10-17T16:37:23,Zarautz,Expense,gifts,-170.22,501.22
buyer_2,Carmen,40,ES76209545461096905487,TRX_N-00523-47871303,2023-10-22T08:30:34,Zarautz,Expense,leisure,-62.42,438.8
buyer_2,Carmen,40,ES76209545461096905487,TRX_N-00524-25471712,2023-11-01T10:21:46,Zarautz,transfer,Salary,1970.02,2408.82
buyer_2,Carmen,40,ES76209545461096905487,TRX_N-00525-99223943,2023-11-01T10:21:46,Zarautz,transfer,Extra Income,197.0,2605.82
buyer_2,Carmen,40,ES76209545461096905487,TRX_N-00526-42631712,2023-11-05T15:51:15,Zarautz,Housing,Rent,-666.22,1939.6
buyer_2,Carmen,40,ES76209545461096905487,TRX_N-00527-89021551,2023-11-05T21:29:36,Zarautz,Basic services,water,-24.61,1914.99
buyer_2,Carmen,40,ES76209545461096905487,TRX_N-00528-15986774,2023-11-05T11:13:51,Zarautz,Basic services,electricity,-129.61,1785.38
buyer_2,Carmen,40,ES76209545461096905487,TRX_N-00529-29195850,2023-11-05T15:46:37,Zarautz,Basic services,internet,-33.37,1752.01
buyer_2,Carmen,40,ES76209545461096905487,TRX_N-00530-13487444,2023-11-06T15:11:14,Zarautz,Basic services,electricity,-97.75,1654.26
buyer_2,Carmen,40,ES76209545461096905487,TRX_N-00531-10695006,2023-11-06T17:36:01,Zarautz,Basic services,internet,-51.44,1602.82
buyer_2,Carmen,40,ES76209545461096905487,TRX_N-00532-94356381,2023-11-07T13:32:15,Zarautz,Basic services,gas,-29.09,1573.73
buyer_2,Carmen,40,ES76209545461096905487,TRX_N-00533-30570747,2023-11-07T13:06:14,Oyón-Oion,Expense,transport,-52.45,1521.28
buyer_2,Carmen,40,ES76209545461096905487,TRX_N-00534-43863152,2023-11-16T12:43:40,Zarautz,Expense,transport,-166.15,1355.13
buyer_2,Carmen,40,ES76209545461096905487,TRX_N-00535-15604382,2023-11-17T16:42:12,Zarautz,Expense,healthcare,-283.96,1071.17
buyer_2,Carmen,40,ES76209545461096905487,TRX_N-00536-17310272,2023-11-18T15:51:36,Zarautz,Expense,healthcare,-325.46,745.71
buyer_2,Carmen,40,ES76209545461096905487,TRX_N-00537-79754410,2023-11-23T11:57:52,Zarautz,Expense,leisure,-218.07,527.64
buyer_2,Carmen,40,ES76209545461096905487,TRX_N-00538-78619493,2023-11-24T13:20:30,Zarautz,Expense,food,-281.4,246.24
buyer_2,Carmen,40,ES76209545461096905487,TRX_N-00539-05419032,2023-12-01T12:54:47,Zarautz,transfer,Salary,1970.02,2216.26
buyer_2,Carmen,40,ES76209545461096905487,TRX_N-00540-55113186,2023-12-01T12:54:47,Zarautz,transfer,Bonus,2012.86,4229.12
buyer_2,Carmen,40,ES76209545461096905487,TRX_N-00541-62306176,2023-12-02T12:02:49,Zarautz,Expense,gifts,-241.88,3987.24
buyer_2,Carmen,40,ES76209545461096905487,TRX_N-00542-18449121,2023-12-05T13:55:24,Zarautz,Housing,Rent,-666.22,3321.02
buyer_2,Carmen,40,ES76209545461096905487,TRX_N-00543-55230681,2023-12-05T10:48:51,Zarautz,Basic services,water,-13.86,3307.16
buyer_2,Carmen,40,ES76209545461096905487,TRX_N-00544-32987779,2023-12-05T11:46:50,Zarautz,Basic services,gas,-21.8,3285.36
buyer_2,Carmen,40,ES76209545461096905487,TRX_N-00545-20980354,2023-12-06T10:44:46,Zarautz,Basic services,internet,-30.16,3255.2
buyer_2,Carmen,40,ES76209545461096905487,TRX_N-00546-17832291,2023-12-06T18:23:55,Zarautz,Basic services,phone,-49.03,3206.17
buyer_2,Carmen,40,ES76209545461096905487,TRX_N-00547-90975226,2023-12-07T17:58:16,Zarautz,Basic services,electricity,-59.96,3146.21
buyer_2,Carmen,40,ES76209545461096905487,TRX_N-00548-21920489,2023-12-07T11:24:35,Zarautz,Basic services,gas,-49.43,3096.78
buyer_2,Carmen,40,ES76209545461096905487,TRX_N-00549-09513188,2023-12-07T11:20:43,Zarautz,Basic services,internet,-38.14,3058.64
buyer_2,Carmen,40,ES76209545461096905487,TRX_N-00550-09583123,2023-12-13T19:27:50,Zarautz,Expense,transport,-172.13,2886.51
buyer_2,Carmen,40,ES76209545461096905487,TRX_N-00551-78505385,2023-12-18T19:38:13,Hernani,Expense,transport,-199.18,2687.33
buyer_2,Carmen,40,ES76209545461096905487,TRX_N-00552-90385899,2023-12-20T08:14:56,Irun,Expense,healthcare,-46.0,2641.33
buyer_2,Carmen,40,ES76209545461096905487,TRX_N-00553-59021370,2023-12-22T08:24:52,Zarautz,Expense,clothing,-128.46,2512.87
buyer_2,Carmen,40,ES76209545461096905487,TRX_N-00554-01480196,2023-12-22T22:25:50,Zarautz,Expense,gifts,-187.59,2325.28
buyer_2,Carmen,40,ES76209545461096905487,TRX_N-00555-98376819,2023-12-24T13:20:16,Zarautz,Expense,repairs,-841.24,1484.04
buyer_2,Carmen,40,ES76209545461096905487,TRX_N-00556-11762166,2023-12-27T20:48:16,Zarautz,Expense,leisure,-88.31,1395.73
buyer_2,Carmen,40,ES76209545461096905487,TRX_N-00557-53061274,2024-01-01T19:27:57,Zarautz,transfer,Salary,1970.02,3365.75
buyer_2,Carmen,40,ES76209545461096905487,TRX_N-00558-67709723,2024-01-02T18:07:38,Elciego,Expense,clothing,-403.05,2962.7
buyer_2,Carmen,40,ES76209545461096905487,TRX_N-00559-71566429,2024-01-04T10:18:13,Zarautz,Expense,transport,-97.62,2865.08
buyer_2,Carmen,40,ES76209545461096905487,TRX_N-00560-80237580,2024-01-05T18:24:57,Zarautz,Housing,Rent,-666.22,2198.86
buyer_2,Carmen,40,ES76209545461096905487,TRX_N-00561-43805440,2024-01-05T18:56:37,Zarautz,Basic services,electricity,-96.19,2102.67
buyer_2,Carmen,40,ES76209545461096905487,TRX_N-00562-27163957,2024-01-06T14:32:29,Zarautz,Basic services,water,-29.18,2073.49
buyer_2,Carmen,40,ES76209545461096905487,TRX_N-00563-97175573,2024-01-07T18:08:19,Zarautz,Basic services,water,-30.77,2042.72
buyer_2,Carmen,40,ES76209545461096905487,TRX_N-00564-73313688,2024-01-07T22:29:09,Zarautz,Basic services,electricity,-83.78,1958.94
buyer_2,Carmen,40,ES76209545461096905487,TRX_N-00565-06388261,2024-01-31T15:43:37,Zarautz,Expense,healthcare,-250.09,1708.85
buyer_2,Carmen,40,ES76209545461096905487,TRX_N-00566-36778254,2024-02-01T14:23:11,Zarautz,transfer,Salary,1970.02,3678.87
buyer_2,Carmen,40,ES76209545461096905487,TRX_N-00567-83146507,2024-02-01T14:23:11,Zarautz,transfer,Extra Income,197.0,3875.87
buyer_2,Carmen,40,ES76209545461096905487,TRX_N-00568-62051033,2024-02-05T18:57:04,Zarautz,Housing,Rent,-666.22,3209.65
buyer_2,Carmen,40,ES76209545461096905487,TRX_N-00569-41036654,2024-02-05T19:57:48,Zarautz,Basic services,water,-38.01,3171.64
buyer_2,Carmen,40,ES76209545461096905487,TRX_N-00570-24936499,2024-02-05T21:09:01,Zarautz,Basic services,electricity,-102.54,3069.1
buyer_2,Carmen,40,ES76209545461096905487,TRX_N-00571-18597348,2024-02-05T11:23:47,Zarautz,Basic services,gas,-25.36,3043.74
buyer_2,Carmen,40,ES76209545461096905487,TRX_N-00572-20980090,2024-02-06T10:43:01,Zarautz,Basic services,gas,-16.24,3027.5
buyer_2,Carmen,40,ES76209545461096905487,TRX_N-00573-46083890,2024-02-06T11:38:53,Zarautz,Basic services,internet,-46.85,2980.65
buyer_2,Carmen,40,ES76209545461096905487,TRX_N-00574-68715749,2024-02-07T18:13:03,Zarautz,Basic services,water,-63.79,2916.86
buyer_2,Carmen,40,ES76209545461096905487,TRX_N-00575-98469764,2024-02-07T20:31:49,Zarautz,Basic services,electricity,-144.04,2772.82
buyer_2,Carmen,40,ES76209545461096905487,TRX_N-00576-43718876,2024-02-07T08:56:08,Zarautz,Basic services,phone,-32.36,2740.46
buyer_2,Carmen,40,ES76209545461096905487,TRX_N-00577-61496025,2024-02-07T09:33:13,Zarautz,Expense,clothing,-414.5,2325.96
buyer_2,Carmen,40,ES76209545461096905487,TRX_N-00578-39492346,2024-02-08T18:12:45,Zarautz,Expense,gifts,-364.01,1961.95
buyer_2,Carmen,40,ES76209545461096905487,TRX_N-00579-27399185,2024-02-26T09:46:00,Berango,Expense,food,-620.68,1341.27
buyer_2,Carmen,40,ES76209545461096905487,TRX_N-00580-85882586,2024-03-01T19:54:51,Zarautz,transfer,Salary,1970.02,3311.29
buyer_2,Carmen,40,ES76209545461096905487,TRX_N-00581-11253852,2024-03-04T10:26:09,Zarautz,Expense,leisure,-12.61,3298.68
buyer_2,Carmen,40,ES76209545461096905487,TRX_N-00582-59841655,2024-03-05T18:45:11,Zarautz,Housing,Rent,-666.22,2632.46
buyer_2,Carmen,40,ES76209545461096905487,TRX_N-00583-27491071,2024-03-05T18:47:17,Zarautz,Basic services,phone,-94.25,2538.21
buyer_2,Carmen,40,ES76209545461096905487,TRX_N-00584-31023433,2024-03-06T15:35:15,Zarautz,Basic services,gas,-96.0,2442.21
buyer_2,Carmen,40,ES76209545461096905487,TRX_N-00585-71980371,2024-03-07T01:22:49,Zarautz,Basic services,water,-50.02,2392.19
buyer_2,Carmen,40,ES76209545461096905487,TRX_N-00586-85243027,2024-03-07T03:33:27,Zarautz,Basic services,gas,-76.64,2315.55
buyer_2,Carmen,40,ES76209545461096905487,TRX_N-00587-04274594,2024-03-07T07:57:58,Zarautz,Basic services,internet,-62.44,2253.11
buyer_2,Carmen,40,ES76209545461096905487,TRX_N-00588-70598553,2024-03-12T19:36:43,Zarautz,Expense,food,-568.6,1684.51
buyer_2,Carmen,40,ES76209545461096905487,TRX_N-00589-14832790,2024-03-14T10:44:08,Donostia,Expense,transport,-152.96,1531.55
buyer_2,Carmen,40,ES76209545461096905487,TRX_N-00590-07427545,2024-03-20T13:54:46,Erandio,Expense,education,-934.53,597.02
buyer_2,Carmen,40,ES76209545461096905487,TRX_N-00591-92129096,2024-04-01T11:23:07,Zarautz,transfer,Salary,1970.02,2567.04
buyer_2,Carmen,40,ES76209545461096905487,TRX_N-00592-67835459,2024-04-01T11:23:07,Zarautz,transfer,Extra Income,197.0,2764.04
buyer_2,Carmen,40,ES76209545461096905487,TRX_N-00593-24795017,2024-04-05T11:10:10,Zarautz,Housing,Rent,-666.22,2097.82
buyer_2,Carmen,40,ES76209545461096905487,TRX_N-00594-01609621,2024-04-05T19:43:31,Zarautz,Basic services,electricity,-25.28,2072.54
buyer_2,Carmen,40,ES76209545461096905487,TRX_N-00595-30388482,2024-04-05T18:01:12,Zarautz,Basic services,internet,-57.9,2014.64
buyer_2,Carmen,40,ES76209545461096905487,TRX_N-00596-34564628,2024-04-06T13:54:52,Zarautz,Basic services,water,-64.63,1950.01
buyer_2,Carmen,40,ES76209545461096905487,TRX_N-00597-31869116,2024-04-06T08:48:06,Zarautz,Basic services,gas,-68.91,1881.1
buyer_2,Carmen,40,ES76209545461096905487,TRX_N-00598-86318029,2024-04-06T18:19:28,Zarautz,Basic services,phone,-73.95,1807.15
buyer_2,Carmen,40,ES76209545461096905487,TRX_N-00599-50083998,2024-04-22T20:26:43,Zarautz,Expense,leisure,-39.78,1767.37
buyer_2,Carmen,40,ES76209545461096905487,TRX_N-00600-80366512,2024-04-29T13:09:28,Zarautz,Expense,food,-262.56,1504.81
buyer_2,Carmen,40,ES76209545461096905487,TRX_N-00601-04332911,2024-05-01T11:02:16,Zarautz,transfer,Salary,1970.02,3474.83
buyer_2,Carmen,40,ES76209545461096905487,TRX_N-00602-71637118,2024-05-01T13:09:42,Zarautz,Expense,leisure,-181.31,3293.52
buyer_2,Carmen,40,ES76209545461096905487,TRX_N-00603-46343923,2024-05-05T08:24:32,Zarautz,Housing,Rent,-666.22,2627.3
buyer_2,Carmen,40,ES76209545461096905487,TRX_N-00604-58008321,2024-05-05T14:30:52,Zarautz,Basic services,electricity,-112.17,2515.13
buyer_2,Carmen,40,ES76209545461096905487,TRX_N-00605-55847856,2024-05-05T19:58:54,Zarautz,Basic services,gas,-31.09,2484.04
buyer_2,Carmen,40,ES76209545461096905487,TRX_N-00606-90499564,2024-05-06T23:00:36,Zarautz,Basic services,water,-41.33,2442.71
buyer_2,Carmen,40,ES76209545461096905487,TRX_N-00607-35135022,2024-05-06T14:41:17,Zarautz,Basic services,electricity,-60.91,2381.8
buyer_2,Carmen,40,ES76209545461096905487,TRX_N-00608-79165131,2024-05-06T18:38:52,Zarautz,Basic services,internet,-56.8,2325.0
buyer_2,Carmen,40,ES76209545461096905487,TRX_N-00609-78982189,2024-05-07T04:12:28,Zarautz,Basic services,gas,-28.03,2296.97
buyer_2,Carmen,40,ES76209545461096905487,TRX_N-00610-45002852,2024-05-07T08:01:48,Zarautz,Expense,transport,-34.6,2262.37
buyer_2,Carmen,40,ES76209545461096905487,TRX_N-00611-92321225,2024-05-26T08:23:43,Zarautz,Expense,food,-218.1,2044.27
buyer_2,Carmen,40,ES76209545461096905487,TRX_N-00612-78722083,2024-06-01T11:25:03,Zarautz,transfer,Salary,1970.02,4014.29
buyer_2,Carmen,40,ES76209545461096905487,TRX_N-00613-33376435,2024-06-01T11:25:03,Zarautz,transfer,Bonus,2056.85,6071.14
buyer_2,Carmen,40,ES76209545461096905487,TRX_N-00614-99725577,2024-06-02T11:56:51,Zarautz,Expense,food,-578.36,5492.78
buyer_2,Carmen,40,ES76209545461096905487,TRX_N-00615-73268796,2024-06-05T00:01:04,Zarautz,Housing,Rent,-666.22,4826.56
buyer_2,Carmen,40,ES76209545461096905487,TRX_N-00616-19048427,2024-06-05T05:31:49,Zarautz,Basic services,electricity,-37.25,4789.31
buyer_2,Carmen,40,ES76209545461096905487,TRX_N-00617-49468344,2024-06-05T14:12:33,Zarautz,Basic services,gas,-54.96,4734.35
buyer_2,Carmen,40,ES76209545461096905487,TRX_N-00618-01798376,2024-06-06T23:47:17,Zarautz,Basic services,electricity,-70.86,4663.49
buyer_2,Carmen,40,ES76209545461096905487,TRX_N-00619-20839552,2024-06-06T03:50:33,Zarautz,Basic services,gas,-72.35,4591.14
buyer_2,Carmen,40,ES76209545461096905487,TRX_N-00620-81705833,2024-06-07T19:52:01,Zarautz,Basic services,water,-65.17,4525.97
buyer_2,Carmen,40,ES76209545461096905487,TRX_N-00621-39193123,2024-06-07T19:56:21,Zarautz,Basic services,internet,-33.35,4492.62
buyer_2,Carmen,40,ES76209545461096905487,TRX_N-00622-76621410,2024-06-07T11:52:17,Durango,Expense,leisure,-221.54,4271.08
buyer_2,Carmen,40,ES76209545461096905487,TRX_N-00623-07435895,2024-06-08T20:21:58,Zarautz,Expense,leisure,-52.11,4218.97
buyer_2,Carmen,40,ES76209545461096905487,TRX_N-00624-32713322,2024-06-10T18:12:43,Zarautz,Expense,healthcare,-68.49,4150.48
buyer_2,Carmen,40,ES76209545461096905487,TRX_N-00625-19747202,2024-06-12T09:41:46,Zarautz,Expense,leisure,-75.02,4075.46
buyer_2,Carmen,40,ES76209545461096905487,TRX_N-00626-73945297,2024-06-14T22:46:57,Zarautz,Expense,food,-217.42,3858.04
buyer_2,Carmen,40,ES76209545461096905487,TRX_N-00627-24594269,2024-06-19T01:38:19,Zarautz,Expense,clothing,-359.49,3498.55
buyer_2,Carmen,40,ES76209545461096905487,TRX_N-00628-79864919,2024-06-26T15:48:21,Zarautz,Expense,clothing,-320.5,3178.05
buyer_2,Carmen,40,ES76209545461096905487,TRX_N-00629-20938659,2024-07-01T08:47:03,Zarautz,transfer,Salary,1970.02,5148.07
buyer_2,Carmen,40,ES76209545461096905487,TRX_N-00630-33342246,2024-07-01T08:47:03,Zarautz,transfer,Extra Income,197.0,5345.07
buyer_2,Carmen,40,ES76209545461096905487,TRX_N-00631-35656065,2024-07-01T23:17:13,Donostia,Expense,education,-712.97,4632.1
buyer_2,Carmen,40,ES76209545461096905487,TRX_N-00632-60670929,2024-07-05T17:11:12,Zarautz,Housing,Rent,-666.22,3965.88
buyer_2,Carmen,40,ES76209545461096905487,TRX_N-00633-80385035,2024-07-05T10:13:55,Zarautz,Basic services,gas,-78.02,3887.86
buyer_2,Carmen,40,ES76209545461096905487,TRX_N-00634-45820311,2024-07-05T18:31:57,Zarautz,Basic services,phone,-68.35,3819.51
buyer_2,Carmen,40,ES76209545461096905487,TRX_N-00635-17756010,2024-07-06T09:01:19,Zarautz,Basic services,water,-38.85,3780.66
buyer_2,Carmen,40,ES76209545461096905487,TRX_N-00636-02245478,2024-07-06T14:37:21,Zarautz,Basic services,electricity,-71.03,3709.63
buyer_2,Carmen,40,ES76209545461096905487,TRX_N-00637-32138898,2024-07-06T22:59:38,Zarautz,Basic services,gas,-19.41,3690.22
buyer_2,Carmen,40,ES76209545461096905487,TRX_N-00638-10544954,2024-07-21T20:24:29,Hernani,Expense,food,-233.32,3456.9
buyer_2,Carmen,40,ES76209545461096905487,TRX_N-00639-98144456,2024-07-25T12:57:51,Zarautz,Expense,leisure,-23.09,3433.81
buyer_2,Carmen,40,ES76209545461096905487,TRX_N-00640-14233416,2024-08-01T09:09:03,Zarautz,transfer,Salary,1970.02,5403.83
buyer_2,Carmen,40,ES76209545461096905487,TRX_N-00641-59924341,2024-08-03T18:02:09,Zarautz,Expense,healthcare,-49.39,5354.44
buyer_2,Carmen,40,ES76209545461096905487,TRX_N-00642-54298647,2024-08-05T23:08:53,Zarautz,Housing,Rent,-666.22,4688.22
buyer_2,Carmen,40,ES76209545461096905487,TRX_N-00643-60932277,2024-08-05T15:49:26,Zarautz,Basic services,electricity,-101.64,4586.58
buyer_2,Carmen,40,ES76209545461096905487,TRX_N-00644-73824015,2024-08-05T13:21:27,Zarautz,Basic services,gas,-39.05,4547.53
buyer_2,Carmen,40,ES76209545461096905487,TRX_N-00645-62448751,2024-08-05T05:19:42,Zarautz,Basic services,phone,-48.68,4498.85
buyer_2,Carmen,40,ES76209545461096905487,TRX_N-00646-52884657,2024-08-05T16:43:12,Zarautz,Expense,healthcare,-264.15,4234.7
buyer_2,Carmen,40,ES76209545461096905487,TRX_N-00647-22420790,2024-08-06T16:44:16,Zarautz,Basic services,water,-73.16,4161.54
buyer_2,Carmen,40,ES76209545461096905487,TRX_N-00648-27924652,2024-08-06T11:30:14,Zarautz,Basic services,electricity,-87.07,4074.47
buyer_2,Carmen,40,ES76209545461096905487,TRX_N-00649-88242017,2024-08-06T15:35:31,Zarautz,Basic services,internet,-61.05,4013.42
buyer_2,Carmen,40,ES76209545461096905487,TRX_N-00650-27133839,2024-08-13T08:36:21,Zarautz,Expense,transport,-154.36,3859.06
buyer_2,Carmen,40,ES76209545461096905487,TRX_N-00651-49420238,2024-09-01T11:57:01,Zarautz,transfer,Salary,1970.02,5829.08
buyer_2,Carmen,40,ES76209545461096905487,TRX_N-00652-08132317,2024-09-03T10:15:59,Zarautz,Expense,leisure,-154.77,5674.31
buyer_2,Carmen,40,ES76209545461096905487,TRX_N-00653-89035937,2024-09-05T11:27:23,Zarautz,Housing,Rent,-666.22,5008.09
buyer_2,Carmen,40,ES76209545461096905487,TRX_N-00654-79075515,2024-09-05T13:07:13,Zarautz,Basic services,electricity,-44.32,4963.77
buyer_2,Carmen,40,ES76209545461096905487,TRX_N-00655-06745171,2024-09-06T20:24:54,Zarautz,Basic services,water,-17.09,4946.68
buyer_2,Carmen,40,ES76209545461096905487,TRX_N-00656-23134143,2024-09-06T12:33:50,Zarautz,Basic services,gas,-83.05,4863.63
buyer_2,Carmen,40,ES76209545461096905487,TRX_N-00657-63008127,2024-09-06T20:16:54,Zarautz,Basic services,internet,-56.24,4807.39
buyer_2,Carmen,40,ES76209545461096905487,TRX_N-00658-23013445,2024-09-07T08:41:37,Zarautz,Basic services,electricity,-90.33,4717.06
buyer_2,Carmen,40,ES76209545461096905487,TRX_N-00659-21535808,2024-09-07T09:04:23,Zarautz,Basic services,internet,-78.88,4638.18
buyer_2,Carmen,40,ES76209545461096905487,TRX_N-00660-61972624,2024-09-15T13:42:02,Zarautz,Expense,leisure,-192.99,4445.19
buyer_2,Carmen,40,ES76209545461096905487,TRX_N-00661-97598646,2024-09-26T15:00:03,Zarautz,Expense,healthcare,-164.39,4280.8
buyer_2,Carmen,40,ES76209545461096905487,TRX_N-00662-95938339,2024-10-01T15:30:14,Zarautz,transfer,Salary,1970.02,6250.82
buyer_2,Carmen,40,ES76209545461096905487,TRX_N-00663-82129560,2024-10-01T15:30:14,Zarautz,transfer,Extra Income,197.0,6447.82
buyer_2,Carmen,40,ES76209545461096905487,TRX_N-00664-58891876,2024-10-05T08:18:53,Zarautz,Housing,Rent,-666.22,5781.6
buyer_2,Carmen,40,ES76209545461096905487,TRX_N-00665-09219155,2024-10-05T11:50:33,Zarautz,Basic services,water,-30.31,5751.29
buyer_2,Carmen,40,ES76209545461096905487,TRX_N-00666-14156298,2024-10-05T14:05:51,Zarautz,Basic services,gas,-92.39,5658.9
buyer_2,Carmen,40,ES76209545461096905487,TRX_N-00667-64372070,2024-10-05T21:37:26,Zarautz,Basic services,internet,-43.84,5615.06
buyer_2,Carmen,40,ES76209545461096905487,TRX_N-00668-77735698,2024-10-06T09:09:45,Zarautz,Basic services,water,-22.97,5592.09
buyer_2,Carmen,40,ES76209545461096905487,TRX_N-00669-10504320,2024-10-06T13:15:43,Zarautz,Basic services,internet,-58.25,5533.84
buyer_2,Carmen,40,ES76209545461096905487,TRX_N-00670-26011430,2024-10-06T19:19:34,Zarautz,Basic services,phone,-69.03,5464.81
buyer_2,Carmen,40,ES76209545461096905487,TRX_N-00671-82255924,2024-10-07T06:39:25,Zarautz,Basic services,phone,-34.52,5430.29
buyer_2,Carmen,40,ES76209545461096905487,TRX_N-00672-03351231,2024-10-07T08:42:45,Zarautz,Expense,food,-158.81,5271.48
buyer_3,Ana,35,ES37209503791832526348,TRX_N-00001-22695330,2020-01-01T12:28:01,Amurrio,transfer,Salary,2410.14,3869.62
buyer_3,Ana,35,ES37209503791832526348,TRX_N-00002-43356617,2020-01-01T12:28:01,Amurrio,transfer,Partner Salary,2139.99,6009.61
buyer_3,Ana,35,ES37209503791832526348,TRX_N-00003-74081155,2020-01-05T08:34:30,Amurrio,Housing,Rent,-975.99,5033.62
buyer_3,Ana,35,ES37209503791832526348,TRX_N-00004-39215912,2020-01-05T18:05:14,Amurrio,Basic services,electricity,-31.29,5002.33
buyer_3,Ana,35,ES37209503791832526348,TRX_N-00005-16814737,2020-01-06T15:40:20,Amurrio,Basic services,water,-50.59,4951.74
buyer_3,Ana,35,ES37209503791832526348,TRX_N-00006-02831945,2020-01-07T11:14:00,Amurrio,Basic services,internet,-63.13,4888.61
buyer_3,Ana,35,ES37209503791832526348,TRX_N-00007-28658000,2020-02-01T09:48:33,Amurrio,transfer,Salary,2410.14,7298.75
buyer_3,Ana,35,ES37209503791832526348,TRX_N-00008-59992831,2020-02-01T09:48:33,Amurrio,transfer,Partner Salary,2139.99,9438.74
buyer_3,Ana,35,ES37209503791832526348,TRX_N-00009-15297236,2020-02-05T13:16:15,Amurrio,Housing,Rent,-975.99,8462.75
buyer_3,Ana,35,ES37209503791832526348,TRX_N-00010-09361795,2020-02-05T19:21:27,Amurrio,Basic services,electricity,-64.99,8397.76
buyer_3,Ana,35,ES37209503791832526348,TRX_N-00011-83779062,2020-02-06T13:23:32,Amurrio,Basic services,water,-17.95,8379.81
buyer_3,Ana,35,ES37209503791832526348,TRX_N-00012-47747202,2020-02-06T20:40:26,Amurrio,Expense,clothing,-88.86,8290.95
buyer_3,Ana,35,ES37209503791832526348,TRX_N-00013-90691865,2020-02-15T12:39:08,Oyón-Oion,Expense,transport,-127.95,8163.0
buyer_3,Ana,35,ES37209503791832526348,TRX_N-00014-14729036,2020-02-24T19:35:58,Amurrio,Expense,leisure,-113.62,8049.38
buyer_3,Ana,35,ES37209503791832526348,TRX_N-00015-32543657,2020-03-01T20:57:44,Amurrio,transfer,Salary,2410.14,10459.52
buyer_3,Ana,35,ES37209503791832526348,TRX_N-00016-38408643,2020-03-01T20:57:44,Amurrio,transfer,Partner Salary,2139.99,12599.51
buyer_3,Ana,35,ES37209503791832526348,TRX_N-00017-77503384,2020-03-01T20:57:44,Amurrio,transfer,Extra Income,241.01,12840.52
buyer_3,Ana,35,ES37209503791832526348,TRX_N-00018-66256280,2020-03-05T09:58:27,Amurrio,Housing,Rent,-975.99,11864.53
buyer_3,Ana,35,ES37209503791832526348,TRX_N-00019-10666867,2020-03-05T12:40:46,Amurrio,Basic services,internet,-30.66,11833.87
buyer_3,Ana,35,ES37209503791832526348,TRX_N-00020-55131407,2020-03-05T04:22:19,Amurrio,Basic services,phone,-61.09,11772.78
buyer_3,Ana,35,ES37209503791832526348,TRX_N-00021-94685136,2020-03-05T10:11:58,Amurrio,Expense,education,-586.25,11186.53
buyer_3,Ana,35,ES37209503791832526348,TRX_N-00022-41409696,2020-03-06T17:19:20,Amurrio,Basic services,water,-49.27,11137.26
buyer_3,Ana,35,ES37209503791832526348,TRX_N-00023-96696506,2020-03-06T13:00:07,Amurrio,Basic services,electricity,-71.42,11065.84
buyer_3,Ana,35,ES37209503791832526348,TRX_N-00024-51889122,2020-03-06T11:17:42,Amurrio,Basic services,gas,-72.06,10993.78
buyer_3,Ana,35,ES37209503791832526348,TRX_N-00025-49051482,2020-03-06T14:32:30,Amurrio,Basic services,internet,-48.12,10945.66
buyer_3,Ana,35,ES37209503791832526348,TRX_N-00026-96362263,2020-03-07T11:52:32,Amurrio,Basic services,phone,-54.23,10891.43
buyer_3,Ana,35,ES37209503791832526348,TRX_N-00027-45896734,2020-03-19T12:56:36,Amurrio,Expense,clothing,-371.57,10519.86
buyer_3,Ana,35,ES37209503791832526348,TRX_N-00028-38768758,2020-03-26T15:46:31,Amurrio,Expense,leisure,-295.03,10224.83
buyer_3,Ana,35,ES37209503791832526348,TRX_N-00029-58673557,2020-04-01T19:39:03,Amurrio,transfer,Salary,2410.14,12634.97
buyer_3,Ana,35,ES37209503791832526348,TRX_N-00030-29377597,2020-04-01T19:39:03,Amurrio,transfer,Partner Salary,2139.99,14774.96
buyer_3,Ana,35,ES37209503791832526348,TRX_N-00031-90291649,2020-04-05T12:08:11,Amurrio,Housing,Rent,-975.99,13798.97
buyer_3,Ana,35,ES37209503791832526348,TRX_N-00032-75953319,2020-04-06T21:54:16,Amurrio,Basic services,gas,-58.36,13740.61
buyer_3,Ana,35,ES37209503791832526348,TRX_N-00033-90928645,2020-04-07T15:39:48,Amurrio,Basic services,water,-77.34,13663.27
buyer_3,Ana,35,ES37209503791832526348,TRX_N-00034-64065744,2020-04-07T15:20:38,Amurrio,Basic services,phone,-24.86,13638.41
buyer_3,Ana,35,ES37209503791832526348,TRX_N-00035-14535979,2020-04-08T21:52:58,Amurrio,Expense,transport,-133.95,13504.46
buyer_3,Ana,35,ES37209503791832526348,TRX_N-00036-53405812,2020-04-20T09:22:15,Amurrio,Expense,transport,-55.37,13449.09
buyer_3,Ana,35,ES37209503791832526348,TRX_N-00037-67969382,2020-04-24T17:39:47,Durango,Expense,transport,-83.04,13366.05
buyer_3,Ana,35,ES37209503791832526348,TRX_N-00038-58001077,2020-05-01T01:50:51,Amurrio,transfer,Salary,2410.14,15776.19
buyer_3,Ana,35,ES37209503791832526348,TRX_N-00039-71131922,2020-05-01T01:50:51,Amurrio,transfer,Partner Salary,2139.99,17916.18
buyer_3,Ana,35,ES37209503791832526348,TRX_N-00040-47762495,2020-05-03T18:35:04,Amurrio,Expense,healthcare,-291.17,17625.01
buyer_3,Ana,35,ES37209503791832526348,TRX_N-00041-32669875,2020-05-05T13:14:55,Amurrio,Housing,Rent,-975.99,16649.02
buyer_3,Ana,35,ES37209503791832526348,TRX_N-00042-06315567,2020-05-05T09:32:21,Amurrio,Basic services,electricity,-88.78,16560.24
buyer_3,Ana,35,ES37209503791832526348,TRX_N-00043-39635321,2020-05-05T12:20:26,Amurrio,Expense,transport,-122.7,16437.54
buyer_3,Ana,35,ES37209503791832526348,TRX_N-00044-32675544,2020-05-06T17:11:23,Amurrio,Basic services,water,-21.03,16416.51
buyer_3,Ana,35,ES37209503791832526348,TRX_N-00045-19152569,2020-05-06T08:51:18,Amurrio,Basic services,internet,-43.49,16373.02
buyer_3,Ana,35,ES37209503791832526348,TRX_N-00046-50161182,2020-05-06T11:47:37,Oyón-Oion,Expense,travel,-473.65,15899.37
buyer_3,Ana,35,ES37209503791832526348,TRX_N-00047-37018668,2020-05-07T20:03:23,Amurrio,Basic services,water,-65.49,15833.88
buyer_3,Ana,35,ES37209503791832526348,TRX_N-00048-33635307,2020-05-07T11:16:55,Amurrio,Basic services,electricity,-26.45,15807.43
buyer_3,Ana,35,ES37209503791832526348,TRX_N-00049-35295419,2020-05-07T13:12:17,Amurrio,Basic services,internet,-44.63,15762.8
buyer_3,Ana,35,ES37209503791832526348,TRX_N-00050-86417510,2020-05-08T17:34:59,Amurrio,Expense,food,-256.15,15506.65
buyer_3,Ana,35,ES37209503791832526348,TRX_N-00051-53125747,2020-05-12T20:05:37,Amurrio,Expense,healthcare,-41.09,15465.56
buyer_3,Ana,35,ES37209503791832526348,TRX_N-00052-93304988,2020-05-16T08:03:19,Amurrio,Expense,food,-435.94,15029.62
buyer_3,Ana,35,ES37209503791832526348,TRX_N-00053-34653220,2020-05-25T21:16:42,Amurrio,Expense,leisure,-142.44,14887.18
buyer_3,Ana,35,ES37209503791832526348,TRX_N-00054-76675393,2020-05-27T18:29:34,Amurrio,Expense,healthcare,-321.32,14565.86
buyer_3,Ana,35,ES37209503791832526348,TRX_N-00055-19234776,2020-05-31T21:41:16,Bilbao,Expense,food,-245.84,14320.02
buyer_3,Ana,35,ES37209503791832526348,TRX_N-00056-11145460,2020-06-01T23:51:48,Amurrio,transfer,Salary,2410.14,16730.16
buyer_3,Ana,35,ES37209503791832526348,TRX_N-00057-57131417,2020-06-01T23:51:48,Amurrio,transfer,Partner Salary,2139.99,18870.15
buyer_3,Ana,35,ES37209503791832526348,TRX_N-00058-41642636,2020-06-01T23:51:48,Amurrio,transfer,Extra Income,241.01,19111.16
buyer_3,Ana,35,ES37209503791832526348,TRX_N-00059-93597354,2020-06-01T23:51:48,Amurrio,transfer,Bonus,2185.21,21296.37
buyer_3,Ana,35,ES37209503791832526348,TRX_N-00060-46810466,2020-06-02T13:34:33,Amurrio,Expense,food,-289.9,21006.47
buyer_3,Ana,35,ES37209503791832526348,TRX_N-00061-19574897,2020-06-05T14:10:01,Amurrio,Housing,Rent,-975.99,20030.48
buyer_3,Ana,35,ES37209503791832526348,TRX_N-00062-74017125,2020-06-05T11:55:54,Amurrio,Basic services,water,-17.57,20012.91
buyer_3,Ana,35,ES37209503791832526348,TRX_N-00063-13083934,2020-06-05T22:17:28,Amurrio,Basic services,internet,-51.04,19961.87
buyer_3,Ana,35,ES37209503791832526348,TRX_N-00064-31450205,2020-06-05T12:55:40,Amurrio,Basic services,phone,-56.82,19905.05
buyer_3,Ana,35,ES37209503791832526348,TRX_N-00065-44944714,2020-06-06T11:10:34,Amurrio,Basic services,gas,-54.06,19850.99
buyer_3,Ana,35,ES37209503791832526348,TRX_N-00066-72843836,2020-06-06T08:56:09,Amurrio,Basic services,phone,-73.31,19777.68
buyer_3,Ana,35,ES37209503791832526348,TRX_N-00067-96572981,2020-06-07T17:09:50,Amurrio,Basic services,water,-15.28,19762.4
buyer_3,Ana,35,ES37209503791832526348,TRX_N-00068-16855565,2020-06-07T06:45:28,Amurrio,Expense,education,-701.37,19061.03
buyer_3,Ana,35,ES37209503791832526348,TRX_N-00069-71430387,2020-06-08T09:53:13,Oyón-Oion,Expense,clothing,-228.56,18832.47
buyer_3,Ana,35,ES37209503791832526348,TRX_N-00070-67331086,2020-06-17T23:35:07,Amurrio,Expense,travel,-1450.97,17381.5
buyer_3,Ana,35,ES37209503791832526348,TRX_N-00071-39706785,2020-06-19T08:05:11,Amurrio,Expense,repairs,-976.96,16404.54
buyer_3,Ana,35,ES37209503791832526348,TRX_N-00072-00452638,2020-06-21T18:07:17,Amurrio,Expense,leisure,-120.96,16283.58
buyer_3,Ana,35,ES37209503791832526348,TRX_N-00073-10968362,2020-06-22T17:40:53,Amurrio,Expense,leisure,-78.42,16205.16
buyer_3,Ana,35,ES37209503791832526348,TRX_N-00074-76431706,2020-06-23T20:48:21,Bermeo,Expense,transport,-142.77,16062.39
buyer_3,Ana,35,ES37209503791832526348,TRX_N-00075-25027356,2020-06-24T10:34:54,Amurrio,Expense,transport,-49.79,16012.6
buyer_3,Ana,35,ES37209503791832526348,TRX_N-00076-36916501,2020-06-27T19:05:52,Amurrio,Expense,food,-709.13,15303.47
buyer_3,Ana,35,ES37209503791832526348,TRX_N-00077-47156808,2020-07-01T14:39:54,Amurrio,transfer,Salary,2410.14,17713.61
buyer_3,Ana,35,ES37209503791832526348,TRX_N-00078-57036680,2020-07-01T14:39:54,Amurrio,transfer,Partner Salary,2139.99,19853.6
buyer_3,Ana,35,ES37209503791832526348,TRX_N-00079-49550755,2020-07-05T10:12:52,Amurrio,Housing,Rent,-975.99,18877.61
buyer_3,Ana,35,ES37209503791832526348,TRX_N-00080-21877344,2020-07-05T12:34:36,Amurrio,Basic services,water,-52.41,18825.2
buyer_3,Ana,35,ES37209503791832526348,TRX_N-00081-25657875,2020-07-05T13:18:14,Amurrio,Basic services,electricity,-102.4,18722.8
buyer_3,Ana,35,ES37209503791832526348,TRX_N-00082-25482987,2020-07-05T15:59:12,Amurrio,Basic services,phone,-58.88,18663.92
buyer_3,Ana,35,ES37209503791832526348,TRX_N-00083-94370908,2020-07-06T16:52:40,Amurrio,Basic services,phone,-97.12,18566.8
buyer_3,Ana,35,ES37209503791832526348,TRX_N-00084-58516595,2020-07-07T20:08:40,Amurrio,Basic services,water,-42.78,18524.02
buyer_3,Ana,35,ES37209503791832526348,TRX_N-00085-93653537,2020-07-07T13:29:32,Amurrio,Basic services,gas,-46.56,18477.46
buyer_3,Ana,35,ES37209503791832526348,TRX_N-00086-63720576,2020-07-07T14:30:28,Amurrio,Basic services,phone,-67.77,18409.69
buyer_3,Ana,35,ES37209503791832526348,TRX_N-00087-43356857,2020-07-19T23:57:54,Amurrio,Expense,clothing,-299.66,18110.03
buyer_3,Ana,35,ES37209503791832526348,TRX_N-00088-33030059,2020-07-29T13:06:15,Amurrio,Expense,transport,-142.95,17967.08
buyer_3,Ana,35,ES37209503791832526348,TRX_N-00089-74377566,2020-08-01T20:58:08,Amurrio,transfer,Salary,2410.14,20377.22
buyer_3,Ana,35,ES37209503791832526348,TRX_N-00090-11314267,2020-08-01T20:58:08,Amurrio,transfer,Partner Salary,2139.99,22517.21
buyer_3,Ana,35,ES37209503791832526348,TRX_N-00091-00181238,2020-08-01T20:58:08,Amurrio,transfer,Extra Income,241.01,22758.22
buyer_3,Ana,35,ES37209503791832526348,TRX_N-00092-26257469,2020-08-02T18:12:39,Elciego,Expense,food,-125.35,22632.87
buyer_3,Ana,35,ES37209503791832526348,TRX_N-00093-47563214,2020-08-05T14:13:20,Amurrio,Housing,Rent,-975.99,21656.88
buyer_3,Ana,35,ES37209503791832526348,TRX_N-00094-87268286,2020-08-05T14:46:28,Amurrio,Basic services,water,-27.74,21629.14
buyer_3,Ana,35,ES37209503791832526348,TRX_N-00095-72192140,2020-08-06T09:42:30,Amurrio,Basic services,internet,-33.41,21595.73
buyer_3,Ana,35,ES37209503791832526348,TRX_N-00096-70353338,2020-08-07T21:48:14,Amurrio,Basic services,water,-48.52,21547.21
buyer_3,Ana,35,ES37209503791832526348,TRX_N-00097-77325182,2020-08-07T09:19:36,Amurrio,Basic services,gas,-82.6,21464.61
buyer_3,Ana,35,ES37209503791832526348,TRX_N-00098-59221452,2020-08-07T12:12:47,Amurrio,Basic services,phone,-50.61,21414.0
buyer_3,Ana,35,ES37209503791832526348,TRX_N-00099-88915302,2020-08-24T15:01:25,Donostia,Expense,food,-677.74,20736.26
buyer_3,Ana,35,ES37209503791832526348,TRX_N-00100-66193847,2020-09-01T12:28:25,Amurrio,transfer,Salary,2410.14,23146.4
buyer_3,Ana,35,ES37209503791832526348,TRX_N-00101-89361649,2020-09-01T12:28:25,Amurrio,transfer,Partner Salary,2139.99,25286.39
buyer_3,Ana,35,ES37209503791832526348,TRX_N-00102-68011129,2020-09-05T00:21:04,Amurrio,Housing,Rent,-975.99,24310.4
buyer_3,Ana,35,ES37209503791832526348,TRX_N-00103-12579944,2020-09-06T12:22:03,Amurrio,Basic services,gas,-97.86,24212.54
buyer_3,Ana,35,ES37209503791832526348,TRX_N-00104-77546766,2020-09-06T16:14:42,Amurrio,Basic services,phone,-67.64,24144.9
buyer_3,Ana,35,ES37209503791832526348,TRX_N-00105-35060488,2020-09-07T06:20:31,Amurrio,Basic services,water,-45.01,24099.89
buyer_3,Ana,35,ES37209503791832526348,TRX_N-00106-20834594,2020-09-07T09:57:07,Amurrio,Basic services,internet,-33.43,24066.46
buyer_3,Ana,35,ES37209503791832526348,TRX_N-00107-96631285,2020-09-07T18:17:31,Amurrio,Basic services,phone,-73.61,23992.85
buyer_3,Ana,35,ES37209503791832526348,TRX_N-00108-79942505,2020-09-28T18:01:46,Amurrio,Expense,transport,-144.67,23848.18
buyer_3,Ana,35,ES37209503791832526348,TRX_N-00109-69990302,2020-10-01T13:32:59,Amurrio,transfer,Salary,2410.14,26258.32
buyer_3,Ana,35,ES37209503791832526348,TRX_N-00110-33859914,2020-10-01T13:32:59,Amurrio,transfer,Partner Salary,2139.99,28398.31
buyer_3,Ana,35,ES37209503791832526348,TRX_N-00111-63996705,2020-10-01T13:32:59,Amurrio,transfer,Extra Income,241.01,28639.32
buyer_3,Ana,35,ES37209503791832526348,TRX_N-00112-15869202,2020-10-05T07:06:43,Amurrio,Housing,Rent,-975.99,27663.33
buyer_3,Ana,35,ES37209503791832526348,TRX_N-00113-21615497,2020-10-05T20:11:28,Amurrio,Basic services,internet,-51.14,27612.19
buyer_3,Ana,35,ES37209503791832526348,TRX_N-00114-35104601,2020-10-06T16:49:30,Amurrio,Basic services,electricity,-39.87,27572.32
buyer_3,Ana,35,ES37209503791832526348,TRX_N-00115-30238780,2020-10-06T08:26:48,Amurrio,Basic services,gas,-45.66,27526.66
buyer_3,Ana,35,ES37209503791832526348,TRX_N-00116-05054526,2020-10-07T01:44:40,Amurrio,Expense,leisure,-120.61,27406.05
buyer_3,Ana,35,ES37209503791832526348,TRX_N-00117-61941187,2020-10-08T09:28:46,Amurrio,Expense,food,-672.36,26733.69
buyer_3,Ana,35,ES37209503791832526348,TRX_N-00118-72892203,2020-10-12T18:48:11,Amurrio,Expense,leisure,-88.25,26645.44
buyer_3,Ana,35,ES37209503791832526348,TRX_N-00119-16093069,2020-10-13T14:48:02,Amurrio,Expense,transport,-84.96,26560.48
buyer_3,Ana,35,ES37209503791832526348,TRX_N-00120-81667365,2020-10-23T17:41:42,Amurrio,Expense,food,-381.77,26178.71
buyer_3,Ana,35,ES37209503791832526348,TRX_N-00121-60602620,2020-10-26T16:49:04,Lasarte-Oria,Expense,transport,-70.27,26108.44
buyer_3,Ana,35,ES37209503791832526348,TRX_N-00122-92281071,2020-10-30T09:41:25,Amurrio,Expense,transport,-172.37,25936.07
buyer_3,Ana,35,ES37209503791832526348,TRX_N-00123-87857786,2020-11-01T18:15:03,Amurrio,transfer,Salary,2410.14,28346.21
buyer_3,Ana,35,ES37209503791832526348,TRX_N-00124-13154764,2020-11-01T18:15:03,Amurrio,transfer,Partner Salary,2139.99,30486.2
buyer_3,Ana,35,ES37209503791832526348,TRX_N-00125-19366374,2020-11-05T16:12:28,Amurrio,Housing,Rent,-975.99,29510.21
buyer_3,Ana,35,ES37209503791832526348,TRX_N-00126-31536283,2020-11-05T05:59:07,Amurrio,Basic services,gas,-54.77,29455.44
buyer_3,Ana,35,ES37209503791832526348,TRX_N-00127-81617110,2020-11-05T14:36:08,Amurrio,Expense,healthcare,-188.35,29267.09
buyer_3,Ana,35,ES37209503791832526348,TRX_N-00128-57262175,2020-11-06T18:15:03,Amurrio,Basic services,electricity,-70.63,29196.46
buyer_3,Ana,35,ES37209503791832526348,TRX_N-00129-11984091,2020-11-06T10:53:50,Amurrio,Basic services,gas,-85.73,29110.73
buyer_3,Ana,35,ES37209503791832526348,TRX_N-00130-14046498,2020-11-06T15:28:30,Amurrio,Basic services,internet,-47.0,29063.73
buyer_3,Ana,35,ES37209503791832526348,TRX_N-00131-65427900,2020-11-06T08:37:37,Amurrio,Basic services,phone,-65.14,28998.59
buyer_3,Ana,35,ES37209503791832526348,TRX_N-00132-64006387,2020-11-07T18:38:35,Amurrio,Basic services,water,-34.62,28963.97
buyer_3,Ana,35,ES37209503791832526348,TRX_N-00133-91226400,2020-11-07T13:59:26,Amurrio,Basic services,gas,-27.29,28936.68
buyer_3,Ana,35,ES37209503791832526348,TRX_N-00134-50417302,2020-11-07T17:22:23,Amurrio,Basic services,internet,-62.69,28873.99
buyer_3,Ana,35,ES37209503791832526348,TRX_N-00135-54165545,2020-11-07T00:41:35,Amurrio,Basic services,phone,-49.22,28824.77
buyer_3,Ana,35,ES37209503791832526348,TRX_N-00136-35468213,2020-11-13T14:30:35,Amurrio,Expense,food,-482.52,28342.25
buyer_3,Ana,35,ES37209503791832526348,TRX_N-00137-46659704,2020-11-14T14:43:36,Amurrio,Expense,appliances,-1520.51,26821.74
buyer_3,Ana,35,ES37209503791832526348,TRX_N-00138-33941475,2020-11-21T15:57:33,Andoain,Expense,transport,-198.26,26623.48
buyer_3,Ana,35,ES37209503791832526348,TRX_N-00139-85774919,2020-11-25T14:10:38,Amurrio,Expense,clothing,-313.91,26309.57
buyer_3,Ana,35,ES37209503791832526348,TRX_N-00140-56870948,2020-12-01T09:19:39,Amurrio,transfer,Salary,2410.14,28719.71
buyer_3,Ana,35,ES37209503791832526348,TRX_N-00141-35191527,2020-12-01T09:19:39,Amurrio,transfer,Partner Salary,2139.99,30859.7
buyer_3,Ana,35,ES37209503791832526348,TRX_N-00142-97310480,2020-12-01T09:19:39,Amurrio,transfer,Extra Income,241.01,31100.71
buyer_3,Ana,35,ES37209503791832526348,TRX_N-00143-66041028,2020-12-01T09:19:39,Amurrio,transfer,Bonus,2535.22,33635.93
buyer_3,Ana,35,ES37209503791832526348,TRX_N-00144-82361567,2020-12-01T11:10:27,Amurrio,Expense,food,-551.61,33084.32
buyer_3,Ana,35,ES37209503791832526348,TRX_N-00145-17062705,2020-12-05T11:16:28,Amurrio,Housing,Rent,-975.99,32108.33
buyer_3,Ana,35,ES37209503791832526348,TRX_N-00146-24022114,2020-12-05T08:07:17,Amurrio,Basic services,water,-33.19,32075.14
buyer_3,Ana,35,ES37209503791832526348,TRX_N-00147-05310264,2020-12-05T08:18:15,Amurrio,Basic services,gas,-26.2,32048.94
buyer_3,Ana,35,ES37209503791832526348,TRX_N-00148-07950227,2020-12-06T20:58:29,Amurrio,Basic services,gas,-43.73,32005.21
buyer_3,Ana,35,ES37209503791832526348,TRX_N-00149-67620368,2020-12-06T12:34:53,Amurrio,Basic services,internet,-59.93,31945.28
buyer_3,Ana,35,ES37209503791832526348,TRX_N-00150-36175717,2020-12-06T09:59:37,Amurrio,Basic services,phone,-51.82,31893.46
buyer_3,Ana,35,ES37209503791832526348,TRX_N-00151-21508020,2020-12-07T13:23:16,Amurrio,Basic services,water,-57.53,31835.93
buyer_3,Ana,35,ES37209503791832526348,TRX_N-00152-25738216,2020-12-07T18:24:46,Amurrio,Basic services,phone,-67.64,31768.29
buyer_3,Ana,35,ES37209503791832526348,TRX_N-00153-62854432,2020-12-10T12:52:08,Amurrio,Expense,food,-535.01,31233.28
buyer_3,Ana,35,ES37209503791832526348,TRX_N-00154-29954463,2020-12-20T10:00:20,Amurrio,Expense,food,-491.75,30741.53
buyer_3,Ana,35,ES37209503791832526348,TRX_N-00155-33946437,2020-12-29T08:54:42,Amurrio,Expense,clothing,-332.41,30409.12
buyer_3,Ana,35,ES37209503791832526348,TRX_N-00156-73312653,2021-01-01T13:50:24,Amurrio,transfer,Salary,2410.14,32819.26
buyer_3,Ana,35,ES37209503791832526348,TRX_N-00157-17327303,2021-01-01T13:50:24,Amurrio,transfer,Partner Salary,2139.99,34959.25
buyer_3,Ana,35,ES37209503791832526348,TRX_N-00158-41862196,2021-01-01T12:06:36,Amurrio,Expense,transport,-35.38,34923.87
buyer_3,Ana,35,ES37209503791832526348,TRX_N-00159-75480671,2021-01-05T23:28:05,Amurrio,Housing,Rent,-975.99,33947.88
buyer_3,Ana,35,ES37209503791832526348,TRX_N-00160-71304123,2021-01-05T17:21:11,Amurrio,Basic services,phone,-88.57,33859.31
buyer_3,Ana,35,ES37209503791832526348,TRX_N-00161-87843797,2021-01-06T10:43:46,Amurrio,Basic services,water,-56.55,33802.76
buyer_3,Ana,35,ES37209503791832526348,TRX_N-00162-94566979,2021-01-06T18:31:31,Amurrio,Basic services,phone,-27.51,33775.25
buyer_3,Ana,35,ES37209503791832526348,TRX_N-00163-25913999,2021-01-07T20:53:55,Amurrio,Basic services,gas,-22.82,33752.43
buyer_3,Ana,35,ES37209503791832526348,TRX_N-00164-69619162,2021-01-12T21:09:27,Amurrio,Expense,food,-635.91,33116.52
buyer_3,Ana,35,ES37209503791832526348,TRX_N-00165-46351362,2021-01-14T17:00:23,Amurrio,Expense,leisure,-104.4,33012.12
buyer_3,Ana,35,ES37209503791832526348,TRX_N-00166-10495399,2021-01-23T17:00:50,Amurrio,Expense,food,-416.6,32595.52
buyer_3,Ana,35,ES37209503791832526348,TRX_N-00167-45249003,2021-01-25T14:15:51,Hernani,Expense,transport,-48.73,32546.79
buyer_3,Ana,35,ES37209503791832526348,TRX_N-00168-55754352,2021-01-27T19:47:24,Amurrio,Expense,food,-580.78,31966.01
buyer_3,Ana,35,ES37209503791832526348,TRX_N-00169-29012183,2021-02-01T11:06:05,Amurrio,transfer,Salary,2410.14,34376.15
buyer_3,Ana,35,ES37209503791832526348,TRX_N-00170-74747330,2021-02-01T11:06:05,Amurrio,transfer,Partner Salary,2139.99,36516.14
buyer_3,Ana,35,ES37209503791832526348,TRX_N-00171-53480265,2021-02-01T11:06:05,Amurrio,transfer,Extra Income,241.01,36757.15
buyer_3,Ana,35,ES37209503791832526348,TRX_N-00172-26065597,2021-02-04T19:57:00,Amurrio,Expense,clothing,-300.48,36456.67
buyer_3,Ana,35,ES37209503791832526348,TRX_N-00173-99966029,2021-02-05T15:37:21,Amurrio,Housing,Rent,-975.99,35480.68
buyer_3,Ana,35,ES37209503791832526348,TRX_N-00174-45688490,2021-02-06T12:04:42,Amurrio,Basic services,internet,-59.32,35421.36
buyer_3,Ana,35,ES37209503791832526348,TRX_N-00175-90234251,2021-02-07T08:10:09,Zuia,Expense,food,-185.81,35235.55
buyer_3,Ana,35,ES37209503791832526348,TRX_N-00176-82145574,2021-02-08T21:28:05,Amurrio,Expense,transport,-102.52,35133.03
buyer_3,Ana,35,ES37209503791832526348,TRX_N-00177-80523324,2021-02-15T19:48:48,Amurrio,Expense,travel,-2899.82,32233.21
buyer_3,Ana,35,ES37209503791832526348,TRX_N-00178-36391438,2021-03-01T15:50:00,Amurrio,transfer,Salary,2410.14,34643.35
buyer_3,Ana,35,ES37209503791832526348,TRX_N-00179-23276042,2021-03-01T15:50:00,Amurrio,transfer,Partner Salary,2139.99,36783.34
buyer_3,Ana,35,ES37209503791832526348,TRX_N-00180-53887590,2021-03-02T18:51:12,Amurrio,Expense,transport,-66.38,36716.96
buyer_3,Ana,35,ES37209503791832526348,TRX_N-00181-27678827,2021-03-02T05:37:51,Amurrio,Expense,leisure,-24.89,36692.07
buyer_3,Ana,35,ES37209503791832526348,TRX_N-00182-96511830,2021-03-05T16:33:17,Amurrio,Housing,Rent,-975.99,35716.08
buyer_3,Ana,35,ES37209503791832526348,TRX_N-00183-54895309,2021-03-05T19:33:45,Amurrio,Basic services,electricity,-117.84,35598.24
buyer_3,Ana,35,ES37209503791832526348,TRX_N-00184-90479740,2021-03-05T22:18:58,Amurrio,Basic services,gas,-44.5,35553.74
buyer_3,Ana,35,ES37209503791832526348,TRX_N-00185-27190917,2021-03-05T10:45:28,Amurrio,Basic services,internet,-30.36,35523.38
buyer_3,Ana,35,ES37209503791832526348,TRX_N-00186-27626191,2021-03-06T19:38:26,Amurrio,Basic services,electricity,-54.07,35469.31
buyer_3,Ana,35,ES37209503791832526348,TRX_N-00187-23625150,2021-03-06T18:29:06,Amurrio,Basic services,phone,-97.49,35371.82
buyer_3,Ana,35,ES37209503791832526348,TRX_N-00188-75780269,2021-03-07T08:10:33,Amurrio,Basic services,water,-73.07,35298.75
buyer_3,Ana,35,ES37209503791832526348,TRX_N-00189-41182078,2021-03-07T15:04:41,Amurrio,Basic services,electricity,-43.8,35254.95
buyer_3,Ana,35,ES37209503791832526348,TRX_N-00190-66120677,2021-03-07T20:52:23,Amurrio,Basic services,internet,-58.52,35196.43
buyer_3,Ana,35,ES37209503791832526348,TRX_N-00191-63779252,2021-03-07T19:32:07,Amurrio,Basic services,phone,-65.85,35130.58
buyer_3,Ana,35,ES37209503791832526348,TRX_N-00192-11973448,2021-03-29T20:06:33,Amurrio,Expense,leisure,-80.04,35050.54
buyer_3,Ana,35,ES37209503791832526348,TRX_N-00193-65695790,2021-04-01T01:08:58,Amurrio,transfer,Salary,2410.14,37460.68
buyer_3,Ana,35,ES37209503791832526348,TRX_N-00194-21898206,2021-04-01T01:08:58,Amurrio,transfer,Partner Salary,2139.99,39600.67
buyer_3,Ana,35,ES37209503791832526348,TRX_N-00195-52629039,2021-04-01T01:08:58,Amurrio,transfer,Extra Income,241.01,39841.68
buyer_3,Ana,35,ES37209503791832526348,TRX_N-00196-65268906,2021-04-04T14:44:05,Zarautz,Expense,gifts,-450.08,39391.6
buyer_3,Ana,35,ES37209503791832526348,TRX_N-00197-50791737,2021-04-05T08:12:06,Amurrio,Housing,Rent,-975.99,38415.61
buyer_3,Ana,35,ES37209503791832526348,TRX_N-00198-43992626,2021-04-05T23:15:17,Amurrio,Basic services,phone,-34.35,38381.26
buyer_3,Ana,35,ES37209503791832526348,TRX_N-00199-71336551,2021-04-05T15:47:29,Amurrio,Expense,transport,-131.78,38249.48
buyer_3,Ana,35,ES37209503791832526348,TRX_N-00200-08333602,2021-04-07T10:49:28,Amurrio,Basic services,water,-23.72,38225.76
buyer_3,Ana,35,ES37209503791832526348,TRX_N-00201-91224735,2021-04-07T19:14:04,Amurrio,Basic services,internet,-32.03,38193.73
buyer_3,Ana,35,ES37209503791832526348,TRX_N-00202-48975371,2021-04-07T08:34:28,Amurrio,Basic services,phone,-97.09,38096.64
buyer_3,Ana,35,ES37209503791832526348,TRX_N-00203-67617394,2021-04-11T10:57:30,Amurrio,Expense,education,-873.01,37223.63
buyer_3,Ana,35,ES37209503791832526348,TRX_N-00204-71078142,2021-04-14T19:37:18,Amurrio,Expense,food,-613.44,36610.19
buyer_3,Ana,35,ES37209503791832526348,TRX_N-00205-86868300,2021-04-18T22:58:35,Amurrio,Expense,healthcare,-262.13,36348.06
buyer_3,Ana,35,ES37209503791832526348,TRX_N-00206-85178106,2021-04-25T10:20:05,Amurrio,Expense,healthcare,-89.96,36258.1
buyer_3,Ana,35,ES37209503791832526348,TRX_N-00207-93539767,2021-04-27T10:26:35,Amurrio,Expense,transport,-39.77,36218.33
buyer_3,Ana,35,ES37209503791832526348,TRX_N-00208-45978411,2021-04-29T20:23:42,Amurrio,Expense,transport,-192.25,36026.08
buyer_3,Ana,35,ES37209503791832526348,TRX_N-00209-11642046,2021-05-01T18:53:11,Amurrio,transfer,Salary,2410.14,38436.22
buyer_3,Ana,35,ES37209503791832526348,TRX_N-00210-02103771,2021-05-01T18:53:11,Amurrio,transfer,Partner Salary,2139.99,40576.21
buyer_3,Ana,35,ES37209503791832526348,TRX_N-00211-60661204,2021-05-05T13:29:03,Amurrio,Housing,Rent,-975.99,39600.22
buyer_3,Ana,35,ES37209503791832526348,TRX_N-00212-77157342,2021-05-05T20:02:05,Amurrio,Basic services,water,-60.75,39539.47
buyer_3,Ana,35,ES37209503791832526348,TRX_N-00213-76670676,2021-05-05T14:46:32,Amurrio,Basic services,electricity,-86.83,39452.64
buyer_3,Ana,35,ES37209503791832526348,TRX_N-00214-36583340,2021-05-06T09:39:38,Amurrio,Basic services,gas,-70.42,39382.22
buyer_3,Ana,35,ES37209503791832526348,TRX_N-00215-81521239,2021-05-06T23:23:39,Amurrio,Basic services,internet,-38.06,39344.16
buyer_3,Ana,35,ES37209503791832526348,TRX_N-00216-77707676,2021-05-06T17:20:03,Amurrio,Basic services,phone,-58.61,39285.55
buyer_3,Ana,35,ES37209503791832526348,TRX_N-00217-08724006,2021-06-01T20:34:25,Amurrio,transfer,Salary,2410.14,41695.69
buyer_3,Ana,35,ES37209503791832526348,TRX_N-00218-54362491,2021-06-01T20:34:25,Amurrio,transfer,Partner Salary,2139.99,43835.68
buyer_3,Ana,35,ES37209503791832526348,TRX_N-00219-38985224,2021-06-01T20:34:25,Amurrio,transfer,Extra Income,241.01,44076.69
buyer_3,Ana,35,ES37209503791832526348,TRX_N-00220-30255642,2021-06-01T20:34:25,Amurrio,transfer,Bonus,2426.96,46503.65
buyer_3,Ana,35,ES37209503791832526348,TRX_N-00221-82971055,2021-06-05T11:07:15,Amurrio,Housing,Rent,-975.99,45527.66
buyer_3,Ana,35,ES37209503791832526348,TRX_N-00222-50561701,2021-06-05T10:18:26,Amurrio,Basic services,electricity,-118.95,45408.71
buyer_3,Ana,35,ES37209503791832526348,TRX_N-00223-38337204,2021-06-06T11:31:30,Amurrio,Basic services,gas,-38.12,45370.59
buyer_3,Ana,35,ES37209503791832526348,TRX_N-00224-48129668,2021-06-06T15:34:06,Amurrio,Basic services,phone,-69.25,45301.34
buyer_3,Ana,35,ES37209503791832526348,TRX_N-00225-92505805,2021-06-07T08:06:39,Amurrio,Basic services,phone,-71.42,45229.92
buyer_3,Ana,35,ES37209503791832526348,TRX_N-00226-62514778,2021-06-09T14:51:19,Amurrio,Expense,food,-497.62,44732.3
buyer_3,Ana,35,ES37209503791832526348,TRX_N-00227-83373445,2021-06-12T18:29:21,Amurrio,Expense,leisure,-85.57,44646.73
buyer_3,Ana,35,ES37209503791832526348,TRX_N-00228-78425348,2021-06-14T17:54:31,Amurrio,Expense,healthcare,-305.99,44340.74
buyer_3,Ana,35,ES37209503791832526348,TRX_N-00229-12237994,2021-06-17T20:56:48,Amurrio,Expense,clothing,-120.04,44220.7
buyer_3,Ana,35,ES37209503791832526348,TRX_N-00230-86725751,2021-06-18T14:45:42,Amurrio,Expense,clothing,-216.77,44003.93
buyer_3,Ana,35,ES37209503791832526348,TRX_N-00231-63317089,2021-07-01T10:05:19,Amurrio,transfer,Salary,2410.14,46414.07
buyer_3,Ana,35,ES37209503791832526348,TRX_N-00232-93721310,2021-07-01T10:05:19,Amurrio,transfer,Partner Salary,2139.99,48554.06
buyer_3,Ana,35,ES37209503791832526348,TRX_N-00233-79751338,2021-07-05T11:39:41,Amurrio,Housing,Rent,-975.99,47578.07
buyer_3,Ana,35,ES37209503791832526348,TRX_N-00234-21804830,2021-07-05T13:47:11,Amurrio,Basic services,water,-36.01,47542.06
buyer_3,Ana,35,ES37209503791832526348,TRX_N-00235-80245923,2021-07-06T06:22:36,Amurrio,Basic services,water,-43.09,47498.97
buyer_3,Ana,35,ES37209503791832526348,TRX_N-00236-70408579,2021-07-06T19:33:43,Amurrio,Basic services,electricity,-87.62,47411.35
buyer_3,Ana,35,ES37209503791832526348,TRX_N-00237-53363669,2021-07-07T19:23:35,Amurrio,Basic services,electricity,-63.28,47348.07
buyer_3,Ana,35,ES37209503791832526348,TRX_N-00238-83858687,2021-07-07T18:37:14,Amurrio,Basic services,gas,-64.33,47283.74
buyer_3,Ana,35,ES37209503791832526348,TRX_N-00239-06034809,2021-07-07T22:00:30,Amurrio,Basic services,internet,-51.25,47232.49
buyer_3,Ana,35,ES37209503791832526348,TRX_N-00240-12351651,2021-07-07T12:07:48,Amurrio,Basic services,phone,-77.37,47155.12
buyer_3,Ana,35,ES37209503791832526348,TRX_N-00241-84004260,2021-07-13T16:12:55,Amurrio,Expense,education,-80.18,47074.94
buyer_3,Ana,35,ES37209503791832526348,TRX_N-00242-28011826,2021-07-20T13:35:04,Amurrio,Expense,food,-410.27,46664.67
buyer_3,Ana,35,ES37209503791832526348,TRX_N-00243-20419454,2021-07-22T16:20:59,Amurrio,Expense,repairs,-475.75,46188.92
buyer_3,Ana,35,ES37209503791832526348,TRX_N-00244-92389701,2021-07-26T18:15:30,Amurrio,Expense,transport,-122.55,46066.37
buyer_3,Ana,35,ES37209503791832526348,TRX_N-00245-45302251,2021-08-01T11:08:06,Amurrio,transfer,Salary,2410.14,48476.51
buyer_3,Ana,35,ES37209503791832526348,TRX_N-00246-67208266,2021-08-01T11:08:06,Amurrio,transfer,Partner Salary,2139.99,50616.5
buyer_3,Ana,35,ES37209503791832526348,TRX_N-00247-25413101,2021-08-05T11:03:08,Amurrio,Housing,Rent,-975.99,49640.51
buyer_3,Ana,35,ES37209503791832526348,TRX_N-00248-44171618,2021-08-05T17:57:08,Amurrio,Basic services,gas,-74.15,49566.36
buyer_3,Ana,35,ES37209503791832526348,TRX_N-00249-16180352,2021-08-06T12:28:36,Amurrio,Basic services,water,-27.98,49538.38
buyer_3,Ana,35,ES37209503791832526348,TRX_N-00250-90051817,2021-08-06T18:02:05,Amurrio,Basic services,phone,-61.86,49476.52
buyer_3,Ana,35,ES37209503791832526348,TRX_N-00251-43994492,2021-08-07T20:41:49,Amurrio,Basic services,internet,-57.48,49419.04
buyer_3,Ana,35,ES37209503791832526348,TRX_N-00252-12192932,2021-08-07T17:49:20,Amurrio,Basic services,phone,-20.24,49398.8
buyer_3,Ana,35,ES37209503791832526348,TRX_N-00253-31526416,2021-08-11T18:14:42,Oyón-Oion,Expense,food,-229.82,49168.98
buyer_3,Ana,35,ES37209503791832526348,TRX_N-00254-04857995,2021-08-16T08:43:24,Barakaldo,Expense,food,-750.22,48418.76
buyer_3,Ana,35,ES37209503791832526348,TRX_N-00255-45970939,2021-09-01T12:38:37,Amurrio,transfer,Salary,2410.14,50828.9
buyer_3,Ana,35,ES37209503791832526348,TRX_N-00256-32678816,2021-09-01T12:38:37,Amurrio,transfer,Partner Salary,2139.99,52968.89
buyer_3,Ana,35,ES37209503791832526348,TRX_N-00257-24802690,2021-09-01T12:38:37,Amurrio,transfer,Extra Income,241.01,53209.9
buyer_3,Ana,35,ES37209503791832526348,TRX_N-00258-13090965,2021-09-05T22:30:26,Amurrio,Housing,Rent,-975.99,52233.91
buyer_3,Ana,35,ES37209503791832526348,TRX_N-00259-21208978,2021-09-05T14:12:52,Amurrio,Basic services,gas,-40.79,52193.12
buyer_3,Ana,35,ES37209503791832526348,TRX_N-00260-09333168,2021-09-07T18:07:06,Amurrio,Basic services,water,-56.3,52136.82
buyer_3,Ana,35,ES37209503791832526348,TRX_N-00261-31044455,2021-09-10T12:19:52,Amurrio,Expense,education,-936.98,51199.84
buyer_3,Ana,35,ES37209503791832526348,TRX_N-00262-55697012,2021-09-21T18:03:06,Amurrio,Expense,transport,-175.63,51024.21
buyer_3,Ana,35,ES37209503791832526348,TRX_N-00263-36424981,2021-09-22T00:59:23,Amurrio,Expense,food,-141.34,50882.87
buyer_3,Ana,35,ES37209503791832526348,TRX_N-00264-07549076,2021-09-25T14:02:47,Amurrio,Expense,gifts,-210.61,50672.26
buyer_3,Ana,35,ES37209503791832526348,TRX_N-00265-68680080,2021-09-30T20:19:37,Amurrio,Expense,education,-682.3,49989.96
buyer_3,Ana,35,ES37209503791832526348,TRX_N-00266-51804371,2021-10-01T18:10:18,Amurrio,transfer,Salary,2410.14,52400.1
buyer_3,Ana,35,ES37209503791832526348,TRX_N-00267-14831157,2021-10-01T18:10:18,Amurrio,transfer,Partner Salary,2139.99,54540.09
buyer_3,Ana,35,ES37209503791832526348,TRX_N-00268-01763053,2021-10-03T01:33:31,Eibar,Expense,gifts,-209.09,54331.0
buyer_3,Ana,35,ES37209503791832526348,TRX_N-00269-53045208,2021-10-05T17:01:27,Amurrio,Housing,Rent,-975.99,53355.01
buyer_3,Ana,35,ES37209503791832526348,TRX_N-00270-28136031,2021-10-05T15:12:02,Amurrio,Basic services,water,-60.61,53294.4
buyer_3,Ana,35,ES37209503791832526348,TRX_N-00271-73853686,2021-10-06T12:18:27,Amurrio,Basic services,phone,-52.62,53241.78
buyer_3,Ana,35,ES37209503791832526348,TRX_N-00272-03708033,2021-10-07T08:29:02,Amurrio,Basic services,water,-73.62,53168.16
buyer_3,Ana,35,ES37209503791832526348,TRX_N-00273-16962884,2021-10-07T01:38:26,Amurrio,Basic services,electricity,-34.0,53134.16
buyer_3,Ana,35,ES37209503791832526348,TRX_N-00274-60179391,2021-10-11T17:30:05,Amurrio,Expense,leisure,-249.52,52884.64
buyer_3,Ana,35,ES37209503791832526348,TRX_N-00275-08146958,2021-10-27T09:28:03,Amurrio,Expense,gifts,-293.59,52591.05
buyer_3,Ana,35,ES37209503791832526348,TRX_N-00276-88661571,2021-10-28T22:58:12,Galdakao,Expense,clothing,-274.25,52316.8
buyer_3,Ana,35,ES37209503791832526348,TRX_N-00277-91047237,2021-10-31T08:55:06,Amurrio,Expense,transport,-111.71,52205.09
buyer_3,Ana,35,ES37209503791832526348,TRX_N-00278-42461400,2021-11-01T18:15:36,Amurrio,transfer,Salary,2410.14,54615.23
buyer_3,Ana,35,ES37209503791832526348,TRX_N-00279-92689996,2021-11-01T18:15:36,Amurrio,transfer,Partner Salary,2139.99,56755.22
buyer_3,Ana,35,ES37209503791832526348,TRX_N-00280-82973977,2021-11-05T15:15:59,Amurrio,Housing,Rent,-975.99,55779.23
buyer_3,Ana,35,ES37209503791832526348,TRX_N-00281-16096424,2021-11-05T13:31:11,Amurrio,Basic services,water,-12.62,55766.61
buyer_3,Ana,35,ES37209503791832526348,TRX_N-00282-92700756,2021-11-05T22:25:21,Amurrio,Basic services,electricity,-145.59,55621.02
buyer_3,Ana,35,ES37209503791832526348,TRX_N-00283-74868704,2021-11-05T19:29:57,Amurrio,Basic services,internet,-37.04,55583.98
buyer_3,Ana,35,ES37209503791832526348,TRX_N-00284-16147495,2021-11-05T17:28:09,Amurrio,Basic services,phone,-77.78,55506.2
buyer_3,Ana,35,ES37209503791832526348,TRX_N-00285-26628432,2021-11-06T14:16:26,Amurrio,Basic services,electricity,-55.45,55450.75
buyer_3,Ana,35,ES37209503791832526348,TRX_N-00286-32163403,2021-11-06T13:38:15,Amurrio,Basic services,gas,-25.48,55425.27
buyer_3,Ana,35,ES37209503791832526348,TRX_N-00287-56597945,2021-11-06T12:12:44,Berango,Expense,food,-547.07,54878.2
buyer_3,Ana,35,ES37209503791832526348,TRX_N-00288-91565951,2021-11-06T11:47:51,Amurrio,Expense,transport,-123.28,54754.92
buyer_3,Ana,35,ES37209503791832526348,TRX_N-00289-39007942,2021-11-07T11:02:48,Amurrio,Basic services,water,-35.43,54719.49
buyer_3,Ana,35,ES37209503791832526348,TRX_N-00290-11819079,2021-11-07T08:08:45,Amurrio,Basic services,electricity,-67.07,54652.42
buyer_3,Ana,35,ES37209503791832526348,TRX_N-00291-22552864,2021-11-07T14:10:14,Amurrio,Basic services,internet,-78.71,54573.71
buyer_3,Ana,35,ES37209503791832526348,TRX_N-00292-72680312,2021-11-08T17:48:57,Amurrio,Expense,education,-563.91,54009.8
buyer_3,Ana,35,ES37209503791832526348,TRX_N-00293-08420817,2021-11-25T17:35:05,Amurrio,Expense,food,-308.99,53700.81
buyer_3,Ana,35,ES37209503791832526348,TRX_N-00294-97387118,2021-12-01T14:53:53,Amurrio,transfer,Salary,2410.14,56110.95
buyer_3,Ana,35,ES37209503791832526348,TRX_N-00295-62605559,2021-12-01T14:53:53,Amurrio,transfer,Partner Salary,2139.99,58250.94
buyer_3,Ana,35,ES37209503791832526348,TRX_N-00296-97925060,2021-12-01T14:53:53,Amurrio,transfer,Extra Income,241.01,58491.95
buyer_3,Ana,35,ES37209503791832526348,TRX_N-00297-39820217,2021-12-01T14:53:53,Amurrio,transfer,Bonus,2376.53,60868.48
buyer_3,Ana,35,ES37209503791832526348,TRX_N-00298-77656246,2021-12-05T18:22:12,Amurrio,Housing,Rent,-975.99,59892.49
buyer_3,Ana,35,ES37209503791832526348,TRX_N-00299-09745708,2021-12-06T11:39:56,Amurrio,Basic services,gas,-43.32,59849.17
buyer_3,Ana,35,ES37209503791832526348,TRX_N-00300-42337062,2021-12-07T11:46:04,Amurrio,Basic services,internet,-71.98,59777.19
buyer_3,Ana,35,ES37209503791832526348,TRX_N-00301-54748917,2021-12-07T22:11:50,Amurrio,Basic services,phone,-25.53,59751.66
buyer_3,Ana,35,ES37209503791832526348,TRX_N-00302-66889386,2021-12-26T13:13:50,Amurrio,Expense,food,-365.65,59386.01
buyer_3,Ana,35,ES37209503791832526348,TRX_N-00303-31998323,2022-01-01T12:54:17,Amurrio,transfer,Salary,2410.14,61796.15
buyer_3,Ana,35,ES37209503791832526348,TRX_N-00304-04335344,2022-01-01T12:54:17,Amurrio,transfer,Partner Salary,2139.99,63936.14
buyer_3,Ana,35,ES37209503791832526348,TRX_N-00305-18585213,2022-01-05T18:16:19,Amurrio,Housing,Rent,-975.99,62960.15
buyer_3,Ana,35,ES37209503791832526348,TRX_N-00306-60279027,2022-01-05T16:19:37,Amurrio,Basic services,electricity,-74.28,62885.87
buyer_3,Ana,35,ES37209503791832526348,TRX_N-00307-96189068,2022-01-06T19:24:49,Amurrio,Basic services,internet,-57.92,62827.95
buyer_3,Ana,35,ES37209503791832526348,TRX_N-00308-91250168,2022-01-07T14:23:49,Amurrio,Basic services,water,-42.6,62785.35
buyer_3,Ana,35,ES37209503791832526348,TRX_N-00309-17796280,2022-01-07T16:27:22,Amurrio,Basic services,phone,-94.74,62690.61
buyer_3,Ana,35,ES37209503791832526348,TRX_N-00310-35131226,2022-01-08T17:56:30,Amurrio,Expense,appliances,-241.09,62449.52
buyer_3,Ana,35,ES37209503791832526348,TRX_N-00311-58760438,2022-01-30T09:20:35,Amurrio,Expense,transport,-183.56,62265.96
buyer_3,Ana,35,ES37209503791832526348,TRX_N-00312-56059856,2022-02-01T19:34:43,Amurrio,transfer,Salary,2410.14,64676.1
buyer_3,Ana,35,ES37209503791832526348,TRX_N-00313-74975120,2022-02-01T19:34:43,Amurrio,transfer,Partner Salary,2139.99,66816.09
buyer_3,Ana,35,ES37209503791832526348,TRX_N-00314-74225304,2022-02-01T19:34:43,Amurrio,transfer,Extra Income,241.01,67057.1
buyer_3,Ana,35,ES37209503791832526348,TRX_N-00315-30418485,2022-02-03T10:40:19,Amurrio,Expense,transport,-142.72,66914.38
buyer_3,Ana,35,ES37209503791832526348,TRX_N-00316-17386502,2022-02-05T13:14:27,Amurrio,Housing,Rent,-975.99,65938.39
buyer_3,Ana,35,ES37209503791832526348,TRX_N-00317-61319992,2022-02-05T10:27:09,Amurrio,Basic services,water,-13.78,65924.61
buyer_3,Ana,35,ES37209503791832526348,TRX_N-00318-68552729,2022-02-05T14:40:22,Amurrio,Basic services,gas,-48.57,65876.04
buyer_3,Ana,35,ES37209503791832526348,TRX_N-00319-73060847,2022-02-06T22:26:08,Amurrio,Basic services,gas,-93.38,65782.66
buyer_3,Ana,35,ES37209503791832526348,TRX_N-00320-66533245,2022-02-06T14:45:21,Amurrio,Basic services,phone,-69.82,65712.84
buyer_3,Ana,35,ES37209503791832526348,TRX_N-00321-23317175,2022-02-07T20:28:49,Amurrio,Basic services,water,-37.09,65675.75
buyer_3,Ana,35,ES37209503791832526348,TRX_N-00322-66512555,2022-02-07T23:07:56,Amurrio,Basic services,electricity,-84.84,65590.91
buyer_3,Ana,35,ES37209503791832526348,TRX_N-00323-98879745,2022-02-07T18:00:21,Amurrio,Basic services,gas,-28.42,65562.49
buyer_3,Ana,35,ES37209503791832526348,TRX_N-00324-14713484,2022-02-07T15:29:45,Amurrio,Basic services,internet,-76.64,65485.85
buyer_3,Ana,35,ES37209503791832526348,TRX_N-00325-82423049,2022-02-07T15:17:01,Amurrio,Basic services,phone,-93.25,65392.6
buyer_3,Ana,35,ES37209503791832526348,TRX_N-00326-60395037,2022-02-10T19:52:47,Amurrio,Expense,leisure,-83.14,65309.46
buyer_3,Ana,35,ES37209503791832526348,TRX_N-00327-38087293,2022-02-17T17:16:36,Amurrio,Expense,leisure,-280.14,65029.32
buyer_3,Ana,35,ES37209503791832526348,TRX_N-00328-78936311,2022-02-19T09:39:12,Amurrio,Expense,leisure,-147.26,64882.06
buyer_3,Ana,35,ES37209503791832526348,TRX_N-00329-57396279,2022-02-20T18:16:51,Irun,Expense,leisure,-55.98,64826.08
buyer_3,Ana,35,ES37209503791832526348,TRX_N-00330-08165486,2022-03-01T18:35:46,Amurrio,transfer,Salary,2410.14,67236.22
buyer_3,Ana,35,ES37209503791832526348,TRX_N-00331-26789014,2022-03-01T18:35:46,Amurrio,transfer,Partner Salary,2139.99,69376.21
buyer_3,Ana,35,ES37209503791832526348,TRX_N-00332-87790170,2022-03-05T13:43:50,Amurrio,Housing,Rent,-975.99,68400.22
buyer_3,Ana,35,ES37209503791832526348,TRX_N-00333-54510670,2022-03-05T04:16:44,Amurrio,Basic services,water,-77.84,68322.38
buyer_3,Ana,35,ES37209503791832526348,TRX_N-00334-89819514,2022-03-05T10:40:24,Amurrio,Basic services,electricity,-39.79,68282.59
buyer_3,Ana,35,ES37209503791832526348,TRX_N-00335-55495847,2022-03-06T16:21:19,Amurrio,Basic services,water,-74.96,68207.63
buyer_3,Ana,35,ES37209503791832526348,TRX_N-00336-76450962,2022-03-06T04:59:23,Amurrio,Basic services,electricity,-143.64,68063.99
buyer_3,Ana,35,ES37209503791832526348,TRX_N-00337-65729988,2022-03-06T10:39:54,Amurrio,Basic services,internet,-79.13,67984.86
buyer_3,Ana,35,ES37209503791832526348,TRX_N-00338-56978962,2022-03-07T03:28:15,Amurrio,Basic services,electricity,-95.36,67889.5
buyer_3,Ana,35,ES37209503791832526348,TRX_N-00339-07791790,2022-03-07T17:05:35,Amurrio,Basic services,gas,-62.89,67826.61
buyer_3,Ana,35,ES37209503791832526348,TRX_N-00340-79673228,2022-03-07T09:43:36,Amurrio,Basic services,phone,-63.42,67763.19
buyer_3,Ana,35,ES37209503791832526348,TRX_N-00341-97086356,2022-03-12T12:23:51,Amurrio,Expense,leisure,-214.25,67548.94
buyer_3,Ana,35,ES37209503791832526348,TRX_N-00342-19021605,2022-03-24T09:39:51,Erandio,Expense,food,-344.49,67204.45
buyer_3,Ana,35,ES37209503791832526348,TRX_N-00343-03744356,2022-03-31T08:54:16,Amurrio,Expense,food,-777.41,66427.04
buyer_3,Ana,35,ES37209503791832526348,TRX_N-00344-11772976,2022-04-01T13:16:43,Amurrio,transfer,Salary,2410.14,68837.18
buyer_3,Ana,35,ES37209503791832526348,TRX_N-00345-10200718,2022-04-01T13:16:43,Amurrio,transfer,Partner Salary,2139.99,70977.17
buyer_3,Ana,35,ES37209503791832526348,TRX_N-00346-75878059,2022-04-01T13:16:43,Amurrio,transfer,Extra Income,241.01,71218.18
buyer_3,Ana,35,ES37209503791832526348,TRX_N-00347-89109456,2022-04-05T18:40:12,Amurrio,Housing,Rent,-975.99,70242.19
buyer_3,Ana,35,ES37209503791832526348,TRX_N-00348-96418960,2022-04-05T13:09:41,Amurrio,Basic services,water,-38.37,70203.82
buyer_3,Ana,35,ES37209503791832526348,TRX_N-00349-91249833,2022-04-07T17:58:41,Amurrio,Basic services,gas,-42.39,70161.43
buyer_3,Ana,35,ES37209503791832526348,TRX_N-00350-23488954,2022-04-07T09:31:21,Amurrio,Basic services,internet,-37.93,70123.5
buyer_3,Ana,35,ES37209503791832526348,TRX_N-00351-66939582,2022-04-07T18:07:43,Amurrio,Basic services,phone,-59.0,70064.5
buyer_3,Ana,35,ES37209503791832526348,TRX_N-00352-22766255,2022-04-07T22:51:23,Amurrio,Expense,transport,-69.6,69994.9
buyer_3,Ana,35,ES37209503791832526348,TRX_N-00353-39382338,2022-04-09T23:45:11,Amurrio,Expense,clothing,-86.8,69908.1
buyer_3,Ana,35,ES37209503791832526348,TRX_N-00354-72201176,2022-04-15T09:19:39,Leioa,Expense,clothing,-188.03,69720.07
buyer_3,Ana,35,ES37209503791832526348,TRX_N-00355-78292501,2022-04-17T14:20:32,Salvatierra/Agurain,Expense,food,-618.07,69102.0
buyer_3,Ana,35,ES37209503791832526348,TRX_N-00356-53123385,2022-04-21T12:07:07,Amurrio,Expense,food,-199.06,68902.94
buyer_3,Ana,35,ES37209503791832526348,TRX_N-00357-26252648,2022-04-30T22:15:02,Alegría-Dulantzi,Expense,food,-547.79,68355.15
buyer_3,Ana,35,ES37209503791832526348,TRX_N-00358-92945166,2022-05-01T14:00:38,Amurrio,transfer,Salary,2410.14,70765.29
buyer_3,Ana,35,ES37209503791832526348,TRX_N-00359-71048717,2022-05-01T14:00:38,Amurrio,transfer,Partner Salary,2139.99,72905.28
buyer_3,Ana,35,ES37209503791832526348,TRX_N-00360-94194152,2022-05-05T05:27:36,Amurrio,Housing,Rent,-975.99,71929.29
buyer_3,Ana,35,ES37209503791832526348,TRX_N-00361-02342577,2022-05-05T01:07:07,Amurrio,Basic services,internet,-58.43,71870.86
buyer_3,Ana,35,ES37209503791832526348,TRX_N-00362-74726993,2022-05-06T20:40:23,Amurrio,Basic services,water,-51.13,71819.73
buyer_3,Ana,35,ES37209503791832526348,TRX_N-00363-04702862,2022-05-07T13:33:33,Amurrio,Basic services,water,-43.92,71775.81
buyer_3,Ana,35,ES37209503791832526348,TRX_N-00364-30015267,2022-05-08T07:45:38,Amurrio,Expense,food,-647.37,71128.44
buyer_3,Ana,35,ES37209503791832526348,TRX_N-00365-50348233,2022-05-09T12:12:33,Llodio,Expense,clothing,-44.11,71084.33
buyer_3,Ana,35,ES37209503791832526348,TRX_N-00366-84685721,2022-05-10T15:00:54,Amurrio,Expense,healthcare,-212.81,70871.52
buyer_3,Ana,35,ES37209503791832526348,TRX_N-00367-49269111,2022-05-10T19:09:49,Amurrio,Expense,gifts,-281.65,70589.87
buyer_3,Ana,35,ES37209503791832526348,TRX_N-00368-97937926,2022-05-24T17:23:07,Amurrio,Expense,leisure,-278.57,70311.3
buyer_3,Ana,35,ES37209503791832526348,TRX_N-00369-98424279,2022-05-28T09:44:01,Amurrio,Expense,food,-338.44,69972.86
buyer_3,Ana,35,ES37209503791832526348,TRX_N-00370-95764963,2022-05-29T13:04:38,Amurrio,Expense,healthcare,-328.3,69644.56
buyer_3,Ana,35,ES37209503791832526348,TRX_N-00371-99917398,2022-05-31T10:21:20,Amurrio,Expense,transport,-189.53,69455.03
buyer_3,Ana,35,ES37209503791832526348,TRX_N-00372-89013803,2022-06-01T08:09:57,Amurrio,transfer,Salary,2410.14,71865.17
buyer_3,Ana,35,ES37209503791832526348,TRX_N-00373-45371439,2022-06-01T08:09:57,Amurrio,transfer,Partner Salary,2139.99,74005.16
buyer_3,Ana,35,ES37209503791832526348,TRX_N-00374-44865925,2022-06-01T08:09:57,Amurrio,transfer,Extra Income,241.01,74246.17
buyer_3,Ana,35,ES37209503791832526348,TRX_N-00375-68671978,2022-06-01T08:09:57,Amurrio,transfer,Bonus,2361.84,76608.01
buyer_3,Ana,35,ES37209503791832526348,TRX_N-00376-30186583,2022-06-03T19:12:20,Amurrio,Expense,food,-471.59,76136.42
buyer_3,Ana,35,ES37209503791832526348,TRX_N-00377-83251333,2022-06-05T13:31:47,Amurrio,Housing,Rent,-975.99,75160.43
buyer_3,Ana,35,ES37209503791832526348,TRX_N-00378-37791057,2022-06-05T06:17:16,Amurrio,Basic services,internet,-77.55,75082.88
buyer_3,Ana,35,ES37209503791832526348,TRX_N-00379-33300282,2022-06-06T11:38:05,Amurrio,Basic services,electricity,-58.27,75024.61
buyer_3,Ana,35,ES37209503791832526348,TRX_N-00380-62109321,2022-06-06T06:14:33,Amurrio,Basic services,phone,-26.27,74998.34
buyer_3,Ana,35,ES37209503791832526348,TRX_N-00381-31098838,2022-06-06T15:31:51,Amurrio,Expense,transport,-82.3,74916.04
buyer_3,Ana,35,ES37209503791832526348,TRX_N-00382-63555446,2022-06-07T15:02:25,Amurrio,Basic services,phone,-77.43,74838.61
buyer_3,Ana,35,ES37209503791832526348,TRX_N-00383-83631132,2022-06-17T08:05:42,Amurrio,Expense,clothing,-195.5,74643.11
buyer_3,Ana,35,ES37209503791832526348,TRX_N-00384-34851604,2022-06-19T04:03:21,Amurrio,Expense,leisure,-48.68,74594.43
buyer_3,Ana,35,ES37209503791832526348,TRX_N-00385-40108294,2022-06-20T20:06:20,Amurrio,Expense,leisure,-155.1,74439.33
buyer_3,Ana,35,ES37209503791832526348,TRX_N-00386-00337895,2022-06-20T18:56:07,Amurrio,Expense,clothing,-370.03,74069.3
buyer_3,Ana,35,ES37209503791832526348,TRX_N-00387-93920798,2022-06-25T22:45:41,Amurrio,Expense,food,-515.81,73553.49
buyer_3,Ana,35,ES37209503791832526348,TRX_N-00388-46623673,2022-06-25T11:30:38,Vitoria-Gasteiz,Expense,repairs,-80.02,73473.47
buyer_3,Ana,35,ES37209503791832526348,TRX_N-00389-97517237,2022-07-01T20:25:07,Amurrio,transfer,Salary,2410.14,75883.61
buyer_3,Ana,35,ES37209503791832526348,TRX_N-00390-81706937,2022-07-01T20:25:07,Amurrio,transfer,Partner Salary,2139.99,78023.6
buyer_3,Ana,35,ES37209503791832526348,TRX_N-00391-97632016,2022-07-02T18:31:19,Amurrio,Expense,gifts,-262.83,77760.77
buyer_3,Ana,35,ES37209503791832526348,TRX_N-00392-09400282,2022-07-05T17:39:30,Amurrio,Housing,Rent,-975.99,76784.78
buyer_3,Ana,35,ES37209503791832526348,TRX_N-00393-69512363,2022-07-05T23:46:53,Amurrio,Basic services,water,-18.14,76766.64
buyer_3,Ana,35,ES37209503791832526348,TRX_N-00394-95270573,2022-07-06T12:03:58,Amurrio,Basic services,electricity,-120.07,76646.57
buyer_3,Ana,35,ES37209503791832526348,TRX_N-00395-74485139,2022-07-06T11:16:45,Amurrio,Basic services,gas,-18.84,76627.73
buyer_3,Ana,35,ES37209503791832526348,TRX_N-00396-34028498,2022-07-06T20:44:02,Amurrio,Basic services,internet,-41.49,76586.24
buyer_3,Ana,35,ES37209503791832526348,TRX_N-00397-06685942,2022-07-06T16:50:04,Amurrio,Basic services,phone,-24.26,76561.98
buyer_3,Ana,35,ES37209503791832526348,TRX_N-00398-68859913,2022-07-07T12:46:10,Amurrio,Basic services,internet,-67.37,76494.61
buyer_3,Ana,35,ES37209503791832526348,TRX_N-00399-58080492,2022-07-07T23:01:24,Amurrio,Expense,transport,-107.99,76386.62
buyer_3,Ana,35,ES37209503791832526348,TRX_N-00400-61962243,2022-07-11T09:04:34,Galdakao,Expense,leisure,-210.03,76176.59
buyer_3,Ana,35,ES37209503791832526348,TRX_N-00401-49446480,2022-07-11T11:08:36,Amurrio,Expense,clothing,-159.13,76017.46
buyer_3,Ana,35,ES37209503791832526348,TRX_N-00402-01209531,2022-07-15T13:43:12,Amurrio,Expense,gifts,-216.92,75800.54
buyer_3,Ana,35,ES37209503791832526348,TRX_N-00403-49566666,2022-07-20T13:56:40,Amurrio,Expense,leisure,-268.34,75532.2
buyer_3,Ana,35,ES37209503791832526348,TRX_N-00404-39912387,2022-07-24T03:41:17,Amurrio,Expense,education,-905.38,74626.82
buyer_3,Ana,35,ES37209503791832526348,TRX_N-00405-32091294,2022-07-29T16:03:27,Amurrio,Expense,food,-539.54,74087.28
buyer_3,Ana,35,ES37209503791832526348,TRX_N-00406-64130711,2022-08-01T20:40:00,Amurrio,transfer,Salary,2410.14,76497.42
buyer_3,Ana,35,ES37209503791832526348,TRX_N-00407-33828947,2022-08-01T20:40:00,Amurrio,transfer,Partner Salary,2139.99,78637.41
buyer_3,Ana,35,ES37209503791832526348,TRX_N-00408-51921347,2022-08-05T12:09:48,Amurrio,Housing,Rent,-975.99,77661.42
buyer_3,Ana,35,ES37209503791832526348,TRX_N-00409-57131317,2022-08-05T17:28:51,Amurrio,Basic services,electricity,-65.11,77596.31
buyer_3,Ana,35,ES37209503791832526348,TRX_N-00410-43995081,2022-08-07T21:02:53,Amurrio,Basic services,electricity,-83.04,77513.27
buyer_3,Ana,35,ES37209503791832526348,TRX_N-00411-53414001,2022-08-07T13:40:37,Amurrio,Basic services,phone,-27.98,77485.29
buyer_3,Ana,35,ES37209503791832526348,TRX_N-00412-15666471,2022-08-09T15:20:33,Amurrio,Expense,transport,-97.31,77387.98
buyer_3,Ana,35,ES37209503791832526348,TRX_N-00413-32336076,2022-09-01T18:51:37,Amurrio,transfer,Salary,2410.14,79798.12
buyer_3,Ana,35,ES37209503791832526348,TRX_N-00414-52857874,2022-09-01T18:51:37,Amurrio,transfer,Partner Salary,2139.99,81938.11
buyer_3,Ana,35,ES37209503791832526348,TRX_N-00415-40809913,2022-09-01T18:51:37,Amurrio,transfer,Extra Income,241.01,82179.12
buyer_3,Ana,35,ES37209503791832526348,TRX_N-00416-98372323,2022-09-04T17:13:47,Eibar,Expense,healthcare,-335.19,81843.93
buyer_3,Ana,35,ES37209503791832526348,TRX_N-00417-82391879,2022-09-05T22:19:30,Amurrio,Housing,Rent,-975.99,80867.94
buyer_3,Ana,35,ES37209503791832526348,TRX_N-00418-06249351,2022-09-05T06:54:24,Amurrio,Basic services,gas,-56.78,80811.16
buyer_3,Ana,35,ES37209503791832526348,TRX_N-00419-40348106,2022-09-06T17:11:05,Amurrio,Basic services,electricity,-25.66,80785.5
buyer_3,Ana,35,ES37209503791832526348,TRX_N-00420-25179461,2022-09-06T06:36:32,Amurrio,Basic services,gas,-26.42,80759.08
buyer_3,Ana,35,ES37209503791832526348,TRX_N-00421-10888627,2022-09-06T15:27:31,Amurrio,Basic services,internet,-58.93,80700.15
buyer_3,Ana,35,ES37209503791832526348,TRX_N-00422-49382674,2022-09-07T18:29:30,Amurrio,Basic services,gas,-39.44,80660.71
buyer_3,Ana,35,ES37209503791832526348,TRX_N-00423-84649860,2022-09-07T13:23:22,Amurrio,Basic services,internet,-60.11,80600.6
buyer_3,Ana,35,ES37209503791832526348,TRX_N-00424-71161626,2022-09-09T16:20:15,Amurrio,Expense,clothing,-398.37,80202.23
buyer_3,Ana,35,ES37209503791832526348,TRX_N-00425-90671172,2022-09-13T18:03:03,Amurrio,Expense,transport,-180.63,80021.6
buyer_3,Ana,35,ES37209503791832526348,TRX_N-00426-90312940,2022-10-01T17:23:35,Amurrio,transfer,Salary,2410.14,82431.74
buyer_3,Ana,35,ES37209503791832526348,TRX_N-00427-74219794,2022-10-01T17:23:35,Amurrio,transfer,Partner Salary,2139.99,84571.73
buyer_3,Ana,35,ES37209503791832526348,TRX_N-00428-50189305,2022-10-05T23:55:14,Amurrio,Housing,Rent,-975.99,83595.74
buyer_3,Ana,35,ES37209503791832526348,TRX_N-00429-10787168,2022-10-05T23:16:04,Amurrio,Basic services,electricity,-115.12,83480.62
buyer_3,Ana,35,ES37209503791832526348,TRX_N-00430-74962704,2022-10-05T10:00:59,Amurrio,Basic services,gas,-32.72,83447.9
buyer_3,Ana,35,ES37209503791832526348,TRX_N-00431-51921532,2022-10-05T17:17:36,Amurrio,Basic services,phone,-81.41,83366.49
buyer_3,Ana,35,ES37209503791832526348,TRX_N-00432-39883360,2022-10-06T15:05:17,Amurrio,Basic services,electricity,-67.18,83299.31
buyer_3,Ana,35,ES37209503791832526348,TRX_N-00433-27304013,2022-10-07T12:14:05,Amurrio,Basic services,water,-64.59,83234.72
buyer_3,Ana,35,ES37209503791832526348,TRX_N-00434-53330078,2022-10-07T08:06:17,Amurrio,Basic services,gas,-37.16,83197.56
buyer_3,Ana,35,ES37209503791832526348,TRX_N-00435-41528606,2022-10-07T14:07:17,Amurrio,Basic services,phone,-56.12,83141.44
buyer_3,Ana,35,ES37209503791832526348,TRX_N-00436-18797020,2022-10-18T15:08:56,Amurrio,Expense,transport,-54.41,83087.03
buyer_3,Ana,35,ES37209503791832526348,TRX_N-00437-53553640,2022-11-01T22:57:25,Amurrio,transfer,Salary,2410.14,85497.17
buyer_3,Ana,35,ES37209503791832526348,TRX_N-00438-65677236,2022-11-01T22:57:25,Amurrio,transfer,Partner Salary,2139.99,87637.16
buyer_3,Ana,35,ES37209503791832526348,TRX_N-00439-28913177,2022-11-01T22:57:25,Amurrio,transfer,Extra Income,241.01,87878.17
buyer_3,Ana,35,ES37209503791832526348,TRX_N-00440-31023060,2022-11-05T22:14:55,Amurrio,Housing,Rent,-975.99,86902.18
buyer_3,Ana,35,ES37209503791832526348,TRX_N-00441-95577810,2022-11-05T02:49:08,Amurrio,Basic services,gas,-82.46,86819.72
buyer_3,Ana,35,ES37209503791832526348,TRX_N-00442-90125654,2022-11-05T21:44:59,Amurrio,Basic services,phone,-83.86,86735.86
buyer_3,Ana,35,ES37209503791832526348,TRX_N-00443-64177881,2022-11-05T19:29:08,Amurrio,Expense,gifts,-425.12,86310.74
buyer_3,Ana,35,ES37209503791832526348,TRX_N-00444-52532803,2022-11-06T09:43:16,Amurrio,Basic services,water,-52.36,86258.38
buyer_3,Ana,35,ES37209503791832526348,TRX_N-00445-81709717,2022-11-06T17:20:54,Amurrio,Basic services,internet,-32.56,86225.82
buyer_3,Ana,35,ES37209503791832526348,TRX_N-00446-64326898,2022-11-07T08:58:06,Amurrio,Basic services,water,-59.41,86166.41
buyer_3,Ana,35,ES37209503791832526348,TRX_N-00447-98052226,2022-11-14T10:38:57,Amurrio,Expense,education,-230.38,85936.03
buyer_3,Ana,35,ES37209503791832526348,TRX_N-00448-96823782,2022-11-21T18:04:06,Amurrio,Expense,travel,-1978.82,83957.21
buyer_3,Ana,35,ES37209503791832526348,TRX_N-00449-31788054,2022-11-28T19:09:11,Amurrio,Expense,clothing,-237.55,83719.66
buyer_3,Ana,35,ES37209503791832526348,TRX_N-00450-02444935,2022-11-29T08:17:30,Amurrio,Expense,healthcare,-316.48,83403.18
buyer_3,Ana,35,ES37209503791832526348,TRX_N-00451-81573922,2022-12-01T17:22:59,Amurrio,transfer,Salary,2410.14,85813.32
buyer_3,Ana,35,ES37209503791832526348,TRX_N-00452-29000011,2022-12-01T17:22:59,Amurrio,transfer,Partner Salary,2139.99,87953.31
buyer_3,Ana,35,ES37209503791832526348,TRX_N-00453-22368094,2022-12-01T17:22:59,Amurrio,transfer,Bonus,2265.29,90218.6
buyer_3,Ana,35,ES37209503791832526348,TRX_N-00454-29231535,2022-12-05T09:33:55,Amurrio,Housing,Rent,-975.99,89242.61
buyer_3,Ana,35,ES37209503791832526348,TRX_N-00455-83099275,2022-12-05T12:15:17,Amurrio,Basic services,water,-23.2,89219.41
buyer_3,Ana,35,ES37209503791832526348,TRX_N-00456-90319856,2022-12-05T15:38:54,Amurrio,Basic services,gas,-17.23,89202.18
buyer_3,Ana,35,ES37209503791832526348,TRX_N-00457-96556361,2022-12-07T20:31:24,Amurrio,Basic services,electricity,-119.3,89082.88
buyer_3,Ana,35,ES37209503791832526348,TRX_N-00458-56985550,2022-12-07T15:35:00,Amurrio,Basic services,internet,-33.45,89049.43
buyer_3,Ana,35,ES37209503791832526348,TRX_N-00459-51506081,2022-12-07T17:58:17,Amurrio,Basic services,phone,-79.81,88969.62
buyer_3,Ana,35,ES37209503791832526348,TRX_N-00460-40974489,2022-12-14T15:46:46,Amurrio,Expense,travel,-424.05,88545.57
buyer_3,Ana,35,ES37209503791832526348,TRX_N-00461-43881547,2022-12-25T06:57:36,Amurrio,Expense,leisure,-164.83,88380.74
buyer_3,Ana,35,ES37209503791832526348,TRX_N-00462-04030521,2023-01-01T16:01:14,Amurrio,transfer,Salary,2410.14,90790.88
buyer_3,Ana,35,ES37209503791832526348,TRX_N-00463-11113279,2023-01-01T16:01:14,Amurrio,transfer,Partner Salary,2139.99,92930.87
buyer_3,Ana,35,ES37209503791832526348,TRX_N-00464-03128943,2023-01-05T20:16:36,Amurrio,Housing,Rent,-975.99,91954.88
buyer_3,Ana,35,ES37209503791832526348,TRX_N-00465-07045009,2023-01-05T18:11:13,Amurrio,Basic services,water,-17.56,91937.32
buyer_3,Ana,35,ES37209503791832526348,TRX_N-00466-47152832,2023-01-05T14:20:33,Amurrio,Expense,food,-669.55,91267.77
buyer_3,Ana,35,ES37209503791832526348,TRX_N-00467-68351344,2023-01-06T18:14:14,Amurrio,Basic services,water,-53.78,91213.99
buyer_3,Ana,35,ES37209503791832526348,TRX_N-00468-52650104,2023-01-06T22:31:11,Amurrio,Basic services,internet,-73.38,91140.61
buyer_3,Ana,35,ES37209503791832526348,TRX_N-00469-46383626,2023-01-06T13:45:11,Amurrio,Basic services,phone,-25.15,91115.46
buyer_3,Ana,35,ES37209503791832526348,TRX_N-00470-74896163,2023-01-07T14:23:02,Amurrio,Basic services,gas,-48.82,91066.64
buyer_3,Ana,35,ES37209503791832526348,TRX_N-00471-67612110,2023-01-07T15:17:20,Amurrio,Basic services,internet,-56.4,91010.24
buyer_3,Ana,35,ES37209503791832526348,TRX_N-00472-09875504,2023-01-10T13:37:24,Amurrio,Expense,healthcare,-245.9,90764.34
buyer_3,Ana,35,ES37209503791832526348,TRX_N-00473-53922302,2023-01-11T15:07:04,Amurrio,Expense,clothing,-336.54,90427.8
buyer_3,Ana,35,ES37209503791832526348,TRX_N-00474-14840950,2023-01-31T12:52:12,Amurrio,Expense,leisure,-79.29,90348.51
buyer_3,Ana,35,ES37209503791832526348,TRX_N-00475-49436966,2023-02-01T17:26:30,Amurrio,transfer,Salary,2410.14,92758.65
buyer_3,Ana,35,ES37209503791832526348,TRX_N-00476-45835285,2023-02-01T17:26:30,Amurrio,transfer,Partner Salary,2139.99,94898.64
buyer_3,Ana,35,ES37209503791832526348,TRX_N-00477-32397558,2023-02-01T17:26:30,Amurrio,transfer,Extra Income,241.01,95139.65
buyer_3,Ana,35,ES37209503791832526348,TRX_N-00478-64346992,2023-02-05T08:56:24,Amurrio,Housing,Rent,-975.99,94163.66
buyer_3,Ana,35,ES37209503791832526348,TRX_N-00479-59063656,2023-02-05T11:07:30,Amurrio,Basic services,gas,-89.13,94074.53
buyer_3,Ana,35,ES37209503791832526348,TRX_N-00480-48994450,2023-02-05T10:29:01,Amurrio,Basic services,phone,-48.62,94025.91
buyer_3,Ana,35,ES37209503791832526348,TRX_N-00481-82470115,2023-02-05T14:54:07,Amurrio,Expense,healthcare,-392.3,93633.61
buyer_3,Ana,35,ES37209503791832526348,TRX_N-00482-36427702,2023-02-06T21:44:41,Amurrio,Basic services,gas,-56.25,93577.36
buyer_3,Ana,35,ES37209503791832526348,TRX_N-00483-86667183,2023-02-07T16:26:47,Amurrio,Basic services,electricity,-58.23,93519.13
buyer_3,Ana,35,ES37209503791832526348,TRX_N-00484-62765212,2023-02-07T10:45:37,Amurrio,Basic services,phone,-91.16,93427.97
buyer_3,Ana,35,ES37209503791832526348,TRX_N-00485-16999778,2023-02-09T21:36:39,Amurrio,Expense,gifts,-282.41,93145.56
buyer_3,Ana,35,ES37209503791832526348,TRX_N-00486-29627954,2023-02-12T18:59:48,Amurrio,Expense,leisure,-136.5,93009.06
buyer_3,Ana,35,ES37209503791832526348,TRX_N-00487-11876384,2023-02-17T20:38:05,Amurrio,Expense,clothing,-340.02,92669.04
buyer_3,Ana,35,ES37209503791832526348,TRX_N-00488-83290691,2023-02-27T18:39:32,Amurrio,Expense,clothing,-494.78,92174.26
buyer_3,Ana,35,ES37209503791832526348,TRX_N-00489-85736573,2023-03-01T13:13:33,Amurrio,transfer,Salary,2410.14,94584.4
buyer_3,Ana,35,ES37209503791832526348,TRX_N-00490-90693454,2023-03-01T13:13:33,Amurrio,transfer,Partner Salary,2139.99,96724.39
buyer_3,Ana,35,ES37209503791832526348,TRX_N-00491-85790263,2023-03-03T18:59:46,Amurrio,Expense,travel,-2821.32,93903.07
buyer_3,Ana,35,ES37209503791832526348,TRX_N-00492-66673882,2023-03-05T15:46:19,Amurrio,Housing,Rent,-975.99,92927.08
buyer_3,Ana,35,ES37209503791832526348,TRX_N-00493-46451447,2023-03-05T11:39:13,Amurrio,Basic services,gas,-58.21,92868.87
buyer_3,Ana,35,ES37209503791832526348,TRX_N-00494-46696145,2023-03-05T16:58:45,Amurrio,Basic services,phone,-35.1,92833.77
buyer_3,Ana,35,ES37209503791832526348,TRX_N-00495-48557207,2023-03-06T12:13:25,Amurrio,Basic services,water,-23.27,92810.5
buyer_3,Ana,35,ES37209503791832526348,TRX_N-00496-38239537,2023-03-06T16:55:54,Amurrio,Basic services,electricity,-83.17,92727.33
buyer_3,Ana,35,ES37209503791832526348,TRX_N-00497-41204748,2023-03-06T16:32:41,Amurrio,Basic services,phone,-97.22,92630.11
buyer_3,Ana,35,ES37209503791832526348,TRX_N-00498-01894468,2023-03-13T18:36:09,Amurrio,Expense,clothing,-266.44,92363.67
buyer_3,Ana,35,ES37209503791832526348,TRX_N-00499-87058468,2023-03-22T22:22:14,Andoain,Expense,clothing,-158.25,92205.42
buyer_3,Ana,35,ES37209503791832526348,TRX_N-00500-34041807,2023-04-01T20:09:35,Amurrio,transfer,Salary,2410.14,94615.56
buyer_3,Ana,35,ES37209503791832526348,TRX_N-00501-67888748,2023-04-01T20:09:35,Amurrio,transfer,Partner Salary,2139.99,96755.55
buyer_3,Ana,35,ES37209503791832526348,TRX_N-00502-63786348,2023-04-05T09:27:44,Amurrio,Housing,Rent,-975.99,95779.56
buyer_3,Ana,35,ES37209503791832526348,TRX_N-00503-97166167,2023-04-05T08:45:54,Amurrio,Basic services,internet,-54.58,95724.98
buyer_3,Ana,35,ES37209503791832526348,TRX_N-00504-38851455,2023-04-06T11:32:26,Amurrio,Basic services,gas,-61.79,95663.19
buyer_3,Ana,35,ES37209503791832526348,TRX_N-00505-52207277,2023-04-12T15:19:28,Amurrio,Expense,transport,-191.58,95471.61
buyer_3,Ana,35,ES37209503791832526348,TRX_N-00506-28054819,2023-04-18T14:20:04,Amurrio,Expense,food,-754.48,94717.13
buyer_3,Ana,35,ES37209503791832526348,TRX_N-00507-93601434,2023-05-01T10:42:07,Amurrio,transfer,Salary,2410.14,97127.27
buyer_3,Ana,35,ES37209503791832526348,TRX_N-00508-52670858,2023-05-01T10:42:07,Amurrio,transfer,Partner Salary,2139.99,99267.26
buyer_3,Ana,35,ES37209503791832526348,TRX_N-00509-68722834,2023-05-01T10:42:07,Amurrio,transfer,Extra Income,241.01,99508.27
buyer_3,Ana,35,ES37209503791832526348,TRX_N-00510-00843637,2023-05-05T17:07:01,Amurrio,Housing,Rent,-975.99,98532.28
buyer_3,Ana,35,ES37209503791832526348,TRX_N-00511-58008045,2023-05-05T12:49:54,Amurrio,Basic services,electricity,-36.1,98496.18
buyer_3,Ana,35,ES37209503791832526348,TRX_N-00512-37906099,2023-05-05T17:35:24,Amurrio,Basic services,internet,-67.02,98429.16
buyer_3,Ana,35,ES37209503791832526348,TRX_N-00513-16374468,2023-05-07T09:32:15,Amurrio,Basic services,electricity,-83.27,98345.89
buyer_3,Ana,35,ES37209503791832526348,TRX_N-00514-86870019,2023-05-07T03:34:24,Amurrio,Basic services,phone,-22.79,98323.1
buyer_3,Ana,35,ES37209503791832526348,TRX_N-00515-13207319,2023-06-01T14:14:33,Amurrio,transfer,Salary,2410.14,100733.24
buyer_3,Ana,35,ES37209503791832526348,TRX_N-00516-07344757,2023-06-01T14:14:33,Amurrio,transfer,Partner Salary,2139.99,102873.23
buyer_3,Ana,35,ES37209503791832526348,TRX_N-00517-06722272,2023-06-01T14:14:33,Amurrio,transfer,Bonus,2406.08,105279.31
buyer_3,Ana,35,ES37209503791832526348,TRX_N-00518-06090173,2023-06-03T09:19:35,Amurrio,Expense,transport,-109.94,105169.37
buyer_3,Ana,35,ES37209503791832526348,TRX_N-00519-16481718,2023-06-05T09:18:27,Amurrio,Housing,Rent,-975.99,104193.38
buyer_3,Ana,35,ES37209503791832526348,TRX_N-00520-27070422,2023-06-05T18:14:00,Amurrio,Basic services,electricity,-42.92,104150.46
buyer_3,Ana,35,ES37209503791832526348,TRX_N-00521-98105999,2023-06-05T13:34:45,Amurrio,Basic services,internet,-36.2,104114.26
buyer_3,Ana,35,ES37209503791832526348,TRX_N-00522-35817023,2023-06-06T16:49:01,Amurrio,Basic services,electricity,-70.75,104043.51
buyer_3,Ana,35,ES37209503791832526348,TRX_N-00523-10557948,2023-06-06T09:51:49,Amurrio,Basic services,gas,-25.21,104018.3
buyer_3,Ana,35,ES37209503791832526348,TRX_N-00524-88056903,2023-06-07T11:50:08,Amurrio,Basic services,electricity,-95.26,103923.04
buyer_3,Ana,35,ES37209503791832526348,TRX_N-00525-16734876,2023-06-07T15:57:25,Amurrio,Basic services,internet,-32.51,103890.53
buyer_3,Ana,35,ES37209503791832526348,TRX_N-00526-01743035,2023-06-07T05:40:44,Amurrio,Basic services,phone,-51.25,103839.28
buyer_3,Ana,35,ES37209503791832526348,TRX_N-00527-81504531,2023-06-08T13:41:11,Amurrio,Expense,food,-425.38,103413.9
buyer_3,Ana,35,ES37209503791832526348,TRX_N-00528-39822987,2023-06-19T13:33:50,Amurrio,Expense,clothing,-469.31,102944.59
buyer_3,Ana,35,ES37209503791832526348,TRX_N-00529-78077273,2023-07-01T15:08:16,Amurrio,transfer,Salary,2410.14,105354.73
buyer_3,Ana,35,ES37209503791832526348,TRX_N-00530-54824492,2023-07-01T15:08:16,Amurrio,transfer,Partner Salary,2139.99,107494.72
buyer_3,Ana,35,ES37209503791832526348,TRX_N-00531-25098460,2023-07-05T09:07:02,Amurrio,Housing,Rent,-975.99,106518.73
buyer_3,Ana,35,ES37209503791832526348,TRX_N-00532-00300333,2023-07-05T22:52:52,Amurrio,Basic services,water,-29.06,106489.67
buyer_3,Ana,35,ES37209503791832526348,TRX_N-00533-75091871,2023-07-05T18:56:41,Amurrio,Basic services,phone,-35.36,106454.31
buyer_3,Ana,35,ES37209503791832526348,TRX_N-00534-57112041,2023-07-06T20:54:20,Amurrio,Basic services,internet,-32.03,106422.28
buyer_3,Ana,35,ES37209503791832526348,TRX_N-00535-50518053,2023-07-06T13:21:38,Amurrio,Basic services,phone,-77.16,106345.12
buyer_3,Ana,35,ES37209503791832526348,TRX_N-00536-51423699,2023-07-06T20:30:02,Amurrio,Expense,food,-416.5,105928.62
buyer_3,Ana,35,ES37209503791832526348,TRX_N-00537-98520104,2023-07-07T10:20:45,Amurrio,Basic services,water,-67.4,105861.22
buyer_3,Ana,35,ES37209503791832526348,TRX_N-00538-23285002,2023-07-07T16:34:14,Amurrio,Basic services,electricity,-24.95,105836.27
buyer_3,Ana,35,ES37209503791832526348,TRX_N-00539-30382938,2023-07-07T18:39:38,Amurrio,Basic services,gas,-19.36,105816.91
buyer_3,Ana,35,ES37209503791832526348,TRX_N-00540-55690383,2023-07-07T06:56:19,Amurrio,Basic services,internet,-51.62,105765.29
buyer_3,Ana,35,ES37209503791832526348,TRX_N-00541-22837244,2023-07-07T11:42:43,Amurrio,Basic services,phone,-88.25,105677.04
buyer_3,Ana,35,ES37209503791832526348,TRX_N-00542-94452333,2023-07-08T11:57:01,Amurrio,Expense,education,-847.68,104829.36
buyer_3,Ana,35,ES37209503791832526348,TRX_N-00543-34966542,2023-07-21T19:34:06,Amurrio,Expense,leisure,-142.44,104686.92
buyer_3,Ana,35,ES37209503791832526348,TRX_N-00544-90928675,2023-08-01T10:28:15,Amurrio,transfer,Salary,2410.14,107097.06
buyer_3,Ana,35,ES37209503791832526348,TRX_N-00545-64995462,2023-08-01T10:28:15,Amurrio,transfer,Partner Salary,2139.99,109237.05
buyer_3,Ana,35,ES37209503791832526348,TRX_N-00546-79817378,2023-08-01T10:28:15,Amurrio,transfer,Extra Income,241.01,109478.06
buyer_3,Ana,35,ES37209503791832526348,TRX_N-00547-15143054,2023-08-05T17:28:01,Amurrio,Housing,Rent,-975.99,108502.07
buyer_3,Ana,35,ES37209503791832526348,TRX_N-00548-91399391,2023-08-05T10:40:26,Amurrio,Basic services,electricity,-108.58,108393.49
buyer_3,Ana,35,ES37209503791832526348,TRX_N-00549-99101437,2023-08-06T23:15:19,Amurrio,Basic services,phone,-47.06,108346.43
buyer_3,Ana,35,ES37209503791832526348,TRX_N-00550-46844611,2023-08-09T09:35:05,Salvatierra/Agurain,Expense,transport,-111.99,108234.44
buyer_3,Ana,35,ES37209503791832526348,TRX_N-00551-57409545,2023-08-18T20:02:27,Amurrio,Expense,food,-751.66,107482.78
buyer_3,Ana,35,ES37209503791832526348,TRX_N-00552-05988697,2023-08-24T14:03:09,Amurrio,Expense,gifts,-204.24,107278.54
buyer_3,Ana,35,ES37209503791832526348,TRX_N-00553-54988909,2023-09-01T20:58:07,Amurrio,transfer,Salary,2410.14,109688.68
buyer_3,Ana,35,ES37209503791832526348,TRX_N-00554-71207416,2023-09-01T20:58:07,Amurrio,transfer,Partner Salary,2139.99,111828.67
buyer_3,Ana,35,ES37209503791832526348,TRX_N-00555-86482526,2023-09-05T18:35:52,Amurrio,Housing,Rent,-975.99,110852.68
buyer_3,Ana,35,ES37209503791832526348,TRX_N-00556-80588318,2023-09-05T17:23:25,Amurrio,Basic services,water,-27.13,110825.55
buyer_3,Ana,35,ES37209503791832526348,TRX_N-00557-78360212,2023-09-05T13:39:26,Amurrio,Basic services,internet,-36.83,110788.72
buyer_3,Ana,35,ES37209503791832526348,TRX_N-00558-16689207,2023-09-06T10:21:03,Amurrio,Basic services,water,-50.87,110737.85
buyer_3,Ana,35,ES37209503791832526348,TRX_N-00559-61939534,2023-09-06T20:05:17,Amurrio,Basic services,electricity,-99.16,110638.69
buyer_3,Ana,35,ES37209503791832526348,TRX_N-00560-75941283,2023-09-06T19:49:59,Amurrio,Basic services,gas,-23.38,110615.31
buyer_3,Ana,35,ES37209503791832526348,TRX_N-00561-65784537,2023-09-06T13:25:00,Amurrio,Basic services,internet,-79.17,110536.14
buyer_3,Ana,35,ES37209503791832526348,TRX_N-00562-91905040,2023-09-07T03:26:02,Amurrio,Basic services,electricity,-28.87,110507.27
buyer_3,Ana,35,ES37209503791832526348,TRX_N-00563-24233310,2023-09-07T12:33:42,Amurrio,Basic services,phone,-89.45,110417.82
buyer_3,Ana,35,ES37209503791832526348,TRX_N-00564-77320718,2023-09-08T11:09:56,Amurrio,Expense,gifts,-355.25,110062.57
buyer_3,Ana,35,ES37209503791832526348,TRX_N-00565-70987222,2023-09-15T14:30:33,Llodio,Expense,repairs,-949.02,109113.55
buyer_3,Ana,35,ES37209503791832526348,TRX_N-00566-88582242,2023-09-18T20:40:56,Amurrio,Expense,leisure,-184.27,108929.28
buyer_3,Ana,35,ES37209503791832526348,TRX_N-00567-34373148,2023-09-18T15:20:50,Amurrio,Expense,healthcare,-46.94,108882.34
buyer_3,Ana,35,ES37209503791832526348,TRX_N-00568-12929904,2023-09-24T11:07:47,Amurrio,Expense,transport,-120.71,108761.63
buyer_3,Ana,35,ES37209503791832526348,TRX_N-00569-38009416,2023-10-01T19:25:14,Amurrio,transfer,Salary,2410.14,111171.77
buyer_3,Ana,35,ES37209503791832526348,TRX_N-00570-78091926,2023-10-01T19:25:14,Amurrio,transfer,Partner Salary,2139.99,113311.76
buyer_3,Ana,35,ES37209503791832526348,TRX_N-00571-64500849,2023-10-05T03:14:30,Amurrio,Housing,Rent,-975.99,112335.77
buyer_3,Ana,35,ES37209503791832526348,TRX_N-00572-36905738,2023-10-05T15:59:26,Amurrio,Basic services,electricity,-44.26,112291.51
buyer_3,Ana,35,ES37209503791832526348,TRX_N-00573-85971677,2023-10-05T09:32:18,Amurrio,Basic services,gas,-58.71,112232.8
buyer_3,Ana,35,ES37209503791832526348,TRX_N-00574-06399307,2023-10-05T13:48:16,Amurrio,Basic services,internet,-57.35,112175.45
buyer_3,Ana,35,ES37209503791832526348,TRX_N-00575-11980309,2023-10-05T05:34:12,Amurrio,Basic services,phone,-79.62,112095.83
buyer_3,Ana,35,ES37209503791832526348,TRX_N-00576-02929529,2023-10-06T20:14:26,Amurrio,Basic services,water,-22.38,112073.45
buyer_3,Ana,35,ES37209503791832526348,TRX_N-00577-72586132,2023-10-07T10:53:45,Amurrio,Basic services,water,-14.27,112059.18
buyer_3,Ana,35,ES37209503791832526348,TRX_N-00578-95293375,2023-10-07T19:32:36,Amurrio,Basic services,electricity,-75.06,111984.12
buyer_3,Ana,35,ES37209503791832526348,TRX_N-00579-77299998,2023-10-07T08:27:44,Amurrio,Basic services,internet,-40.92,111943.2
buyer_3,Ana,35,ES37209503791832526348,TRX_N-00580-49566138,2023-11-01T12:50:29,Amurrio,transfer,Salary,2410.14,114353.34
buyer_3,Ana,35,ES37209503791832526348,TRX_N-00581-36329506,2023-11-01T12:50:29,Amurrio,transfer,Partner Salary,2139.99,116493.33
buyer_3,Ana,35,ES37209503791832526348,TRX_N-00582-70675114,2023-11-01T12:50:29,Amurrio,transfer,Extra Income,241.01,116734.34
buyer_3,Ana,35,ES37209503791832526348,TRX_N-00583-27180699,2023-11-05T16:36:57,Amurrio,Housing,Rent,-975.99,115758.35
buyer_3,Ana,35,ES37209503791832526348,TRX_N-00584-08563616,2023-11-05T19:45:18,Amurrio,Basic services,electricity,-117.2,115641.15
buyer_3,Ana,35,ES37209503791832526348,TRX_N-00585-43533544,2023-11-05T18:09:16,Amurrio,Basic services,internet,-59.23,115581.92
buyer_3,Ana,35,ES37209503791832526348,TRX_N-00586-76400294,2023-11-06T14:02:06,Amurrio,Basic services,water,-74.6,115507.32
buyer_3,Ana,35,ES37209503791832526348,TRX_N-00587-90566735,2023-11-06T18:59:05,Amurrio,Basic services,electricity,-115.78,115391.54
buyer_3,Ana,35,ES37209503791832526348,TRX_N-00588-73289025,2023-11-06T13:21:10,Amurrio,Basic services,phone,-77.63,115313.91
buyer_3,Ana,35,ES37209503791832526348,TRX_N-00589-14116432,2023-11-06T17:50:01,Amurrio,Expense,repairs,-665.38,114648.53
buyer_3,Ana,35,ES37209503791832526348,TRX_N-00590-00505849,2023-11-07T13:13:31,Amurrio,Basic services,gas,-24.38,114624.15
buyer_3,Ana,35,ES37209503791832526348,TRX_N-00591-71916470,2023-11-07T20:31:41,Amurrio,Basic services,internet,-58.89,114565.26
buyer_3,Ana,35,ES37209503791832526348,TRX_N-00592-54465990,2023-11-18T01:07:56,Portugalete,Expense,appliances,-474.58,114090.68
buyer_3,Ana,35,ES37209503791832526348,TRX_N-00593-02868870,2023-11-27T09:24:14,Amurrio,Expense,healthcare,-129.16,113961.52
buyer_3,Ana,35,ES37209503791832526348,TRX_N-00594-38982063,2023-12-01T13:19:55,Amurrio,transfer,Salary,2410.14,116371.66
buyer_3,Ana,35,ES37209503791832526348,TRX_N-00595-22464868,2023-12-01T13:19:55,Amurrio,transfer,Partner Salary,2139.99,118511.65
buyer_3,Ana,35,ES37209503791832526348,TRX_N-00596-04543239,2023-12-01T13:19:55,Amurrio,transfer,Bonus,2285.79,120797.44
buyer_3,Ana,35,ES37209503791832526348,TRX_N-00597-08595380,2023-12-02T12:18:28,Eibar,Expense,food,-105.26,120692.18
buyer_3,Ana,35,ES37209503791832526348,TRX_N-00598-48638393,2023-12-04T18:43:54,Amurrio,Expense,transport,-56.03,120636.15
buyer_3,Ana,35,ES37209503791832526348,TRX_N-00599-66261665,2023-12-05T14:32:23,Amurrio,Housing,Rent,-975.99,119660.16
buyer_3,Ana,35,ES37209503791832526348,TRX_N-00600-64939098,2023-12-05T12:24:12,Amurrio,Basic services,gas,-18.63,119641.53
buyer_3,Ana,35,ES37209503791832526348,TRX_N-00601-20631063,2023-12-06T18:34:42,Amurrio,Basic services,electricity,-50.43,119591.1
buyer_3,Ana,35,ES37209503791832526348,TRX_N-00602-07376545,2023-12-06T14:45:00,Amurrio,Expense,leisure,-195.68,119395.42
buyer_3,Ana,35,ES37209503791832526348,TRX_N-00603-85365496,2023-12-07T01:04:44,Amurrio,Basic services,phone,-89.63,119305.79
buyer_3,Ana,35,ES37209503791832526348,TRX_N-00604-39568697,2024-01-01T12:35:59,Amurrio,transfer,Salary,2410.14,121715.93
buyer_3,Ana,35,ES37209503791832526348,TRX_N-00605-48219835,2024-01-01T12:35:59,Amurrio,transfer,Partner Salary,2139.99,123855.92
buyer_3,Ana,35,ES37209503791832526348,TRX_N-00606-49680275,2024-01-01T12:35:59,Amurrio,transfer,Extra Income,241.01,124096.93
buyer_3,Ana,35,ES37209503791832526348,TRX_N-00607-66831937,2024-01-05T08:04:18,Amurrio,Housing,Rent,-975.99,123120.94
buyer_3,Ana,35,ES37209503791832526348,TRX_N-00608-05213627,2024-01-06T22:24:36,Amurrio,Basic services,phone,-31.73,123089.21
buyer_3,Ana,35,ES37209503791832526348,TRX_N-00609-29800826,2024-01-07T13:38:15,Amurrio,Basic services,gas,-66.35,123022.86
buyer_3,Ana,35,ES37209503791832526348,TRX_N-00610-03200495,2024-01-07T17:14:14,Amurrio,Basic services,phone,-98.74,122924.12
buyer_3,Ana,35,ES37209503791832526348,TRX_N-00611-23649706,2024-01-14T17:40:29,Amurrio,Expense,food,-638.53,122285.59
buyer_3,Ana,35,ES37209503791832526348,TRX_N-00612-75257396,2024-01-21T11:59:09,Amurrio,Expense,leisure,-132.51,122153.08
buyer_3,Ana,35,ES37209503791832526348,TRX_N-00613-46615949,2024-01-23T12:23:16,Amurrio,Expense,clothing,-90.54,122062.54
buyer_3,Ana,35,ES37209503791832526348,TRX_N-00614-66533665,2024-02-01T18:18:08,Amurrio,transfer,Salary,2410.14,124472.68
buyer_3,Ana,35,ES37209503791832526348,TRX_N-00615-42679991,2024-02-01T18:18:08,Amurrio,transfer,Partner Salary,2139.99,126612.67
buyer_3,Ana,35,ES37209503791832526348,TRX_N-00616-82670089,2024-02-04T09:37:03,Donostia,Expense,leisure,-175.11,126437.56
buyer_3,Ana,35,ES37209503791832526348,TRX_N-00617-32848099,2024-02-05T08:59:00,Amurrio,Housing,Rent,-975.99,125461.57
buyer_3,Ana,35,ES37209503791832526348,TRX_N-00618-71781880,2024-02-05T19:31:07,Amurrio,Basic services,electricity,-35.61,125425.96
buyer_3,Ana,35,ES37209503791832526348,TRX_N-00619-39760413,2024-02-05T09:39:00,Amurrio,Basic services,gas,-19.25,125406.71
buyer_3,Ana,35,ES37209503791832526348,TRX_N-00620-89344682,2024-02-05T10:29:44,Amurrio,Basic services,phone,-26.66,125380.05
buyer_3,Ana,35,ES37209503791832526348,TRX_N-00621-82682617,2024-02-06T16:18:23,Amurrio,Basic services,internet,-63.6,125316.45
buyer_3,Ana,35,ES37209503791832526348,TRX_N-00622-64230949,2024-02-07T08:02:34,Amurrio,Basic services,gas,-33.13,125283.32
buyer_3,Ana,35,ES37209503791832526348,TRX_N-00623-73727163,2024-02-17T12:56:58,Amurrio,Expense,leisure,-119.87,125163.45
buyer_3,Ana,35,ES37209503791832526348,TRX_N-00624-87958768,2024-02-20T10:47:25,Getxo,Expense,leisure,-277.97,124885.48
buyer_3,Ana,35,ES37209503791832526348,TRX_N-00625-05095836,2024-02-21T23:27:21,Amurrio,Expense,repairs,-71.66,124813.82
buyer_3,Ana,35,ES37209503791832526348,TRX_N-00626-98071030,2024-02-24T12:26:26,Amurrio,Expense,food,-614.97,124198.85
buyer_3,Ana,35,ES37209503791832526348,TRX_N-00627-62511665,2024-03-01T09:32:18,Amurrio,transfer,Salary,2410.14,126608.99
buyer_3,Ana,35,ES37209503791832526348,TRX_N-00628-27953833,2024-03-01T09:32:18,Amurrio,transfer,Partner Salary,2139.99,128748.98
buyer_3,Ana,35,ES37209503791832526348,TRX_N-00629-26723679,2024-03-05T19:00:45,Amurrio,Housing,Rent,-975.99,127772.99
buyer_3,Ana,35,ES37209503791832526348,TRX_N-00630-83743199,2024-03-05T16:03:29,Amurrio,Basic services,gas,-70.14,127702.85
buyer_3,Ana,35,ES37209503791832526348,TRX_N-00631-92426785,2024-03-06T01:24:52,Amurrio,Basic services,water,-69.92,127632.93
buyer_3,Ana,35,ES37209503791832526348,TRX_N-00632-85889739,2024-03-06T19:31:45,Amurrio,Basic services,electricity,-127.62,127505.31
buyer_3,Ana,35,ES37209503791832526348,TRX_N-00633-95583229,2024-03-06T17:15:00,Amurrio,Basic services,internet,-66.25,127439.06
buyer_3,Ana,35,ES37209503791832526348,TRX_N-00634-77206140,2024-03-06T23:13:41,Amurrio,Expense,education,-655.3,126783.76
buyer_3,Ana,35,ES37209503791832526348,TRX_N-00635-34193767,2024-03-07T11:00:37,Amurrio,Basic services,gas,-25.91,126757.85
buyer_3,Ana,35,ES37209503791832526348,TRX_N-00636-05751715,2024-03-11T20:24:31,Amurrio,Expense,leisure,-217.63,126540.22
buyer_3,Ana,35,ES37209503791832526348,TRX_N-00637-93441242,2024-03-15T21:02:49,Amurrio,Expense,transport,-46.36,126493.86
buyer_3,Ana,35,ES37209503791832526348,TRX_N-00638-81986618,2024-03-27T19:39:15,Amurrio,Expense,transport,-150.78,126343.08
buyer_3,Ana,35,ES37209503791832526348,TRX_N-00639-25660871,2024-03-29T09:40:31,Amurrio,Expense,transport,-172.81,126170.27
buyer_3,Ana,35,ES37209503791832526348,TRX_N-00640-76866994,2024-04-01T11:35:43,Amurrio,transfer,Salary,2410.14,128580.41
buyer_3,Ana,35,ES37209503791832526348,TRX_N-00641-71405960,2024-04-01T11:35:43,Amurrio,transfer,Partner Salary,2139.99,130720.4
buyer_3,Ana,35,ES37209503791832526348,TRX_N-00642-78298802,2024-04-01T11:35:43,Amurrio,transfer,Extra Income,241.01,130961.41
buyer_3,Ana,35,ES37209503791832526348,TRX_N-00643-27702971,2024-04-01T10:22:53,Amurrio,Expense,leisure,-75.38,130886.03
buyer_3,Ana,35,ES37209503791832526348,TRX_N-00644-19082939,2024-04-02T13:21:14,Amurrio,Expense,leisure,-31.19,130854.84
buyer_3,Ana,35,ES37209503791832526348,TRX_N-00645-05233951,2024-04-05T11:05:00,Amurrio,Housing,Rent,-975.99,129878.85
buyer_3,Ana,35,ES37209503791832526348,TRX_N-00646-51282524,2024-04-05T19:54:40,Amurrio,Basic services,gas,-97.76,129781.09
buyer_3,Ana,35,ES37209503791832526348,TRX_N-00647-11837114,2024-04-06T10:38:44,Amurrio,Basic services,electricity,-139.37,129641.72
buyer_3,Ana,35,ES37209503791832526348,TRX_N-00648-27280246,2024-04-07T20:31:30,Amurrio,Basic services,water,-64.59,129577.13
buyer_3,Ana,35,ES37209503791832526348,TRX_N-00649-57137104,2024-04-07T22:09:27,Amurrio,Basic services,gas,-86.38,129490.75
buyer_3,Ana,35,ES37209503791832526348,TRX_N-00650-56290008,2024-04-07T15:18:00,Amurrio,Basic services,phone,-89.96,129400.79
buyer_3,Ana,35,ES37209503791832526348,TRX_N-00651-22083740,2024-04-12T13:06:43,Amurrio,Expense,transport,-127.32,129273.47
buyer_3,Ana,35,ES37209503791832526348,TRX_N-00652-43547346,2024-05-01T07:44:31,Amurrio,transfer,Salary,2410.14,131683.61
buyer_3,Ana,35,ES37209503791832526348,TRX_N-00653-11033959,2024-05-01T07:44:31,Amurrio,transfer,Partner Salary,2139.99,133823.6
buyer_3,Ana,35,ES37209503791832526348,TRX_N-00654-41624672,2024-05-05T09:11:04,Amurrio,Housing,Rent,-975.99,132847.61
buyer_3,Ana,35,ES37209503791832526348,TRX_N-00655-34944069,2024-05-06T11:56:31,Amurrio,Basic services,electricity,-98.73,132748.88
buyer_3,Ana,35,ES37209503791832526348,TRX_N-00656-84571863,2024-05-06T19:27:51,Amurrio,Basic services,internet,-43.16,132705.72
buyer_3,Ana,35,ES37209503791832526348,TRX_N-00657-69929012,2024-05-06T10:33:50,Amurrio,Basic services,phone,-94.53,132611.19
buyer_3,Ana,35,ES37209503791832526348,TRX_N-00658-54304838,2024-05-07T13:24:46,Amurrio,Basic services,water,-32.03,132579.16
buyer_3,Ana,35,ES37209503791832526348,TRX_N-00659-55881007,2024-06-01T16:09:05,Amurrio,transfer,Salary,2410.14,134989.3
buyer_3,Ana,35,ES37209503791832526348,TRX_N-00660-02362156,2024-06-01T16:09:05,Amurrio,transfer,Partner Salary,2139.99,137129.29
buyer_3,Ana,35,ES37209503791832526348,TRX_N-00661-64922128,2024-06-01T16:09:05,Amurrio,transfer,Extra Income,241.01,137370.3
buyer_3,Ana,35,ES37209503791832526348,TRX_N-00662-95585481,2024-06-01T16:09:05,Amurrio,transfer,Bonus,2305.89,139676.19
buyer_3,Ana,35,ES37209503791832526348,TRX_N-00663-03981504,2024-06-02T22:23:36,Amurrio,Expense,leisure,-11.11,139665.08
buyer_3,Ana,35,ES37209503791832526348,TRX_N-00664-63689993,2024-06-05T08:22:25,Amurrio,Housing,Rent,-975.99,138689.09
buyer_3,Ana,35,ES37209503791832526348,TRX_N-00665-71840799,2024-06-05T15:28:20,Amurrio,Basic services,water,-59.48,138629.61
buyer_3,Ana,35,ES37209503791832526348,TRX_N-00666-74812771,2024-06-05T17:28:10,Amurrio,Basic services,electricity,-92.51,138537.1
buyer_3,Ana,35,ES37209503791832526348,TRX_N-00667-52625481,2024-06-05T16:24:03,Amurrio,Basic services,phone,-92.27,138444.83
buyer_3,Ana,35,ES37209503791832526348,TRX_N-00668-45928795,2024-06-06T19:21:05,Amurrio,Basic services,phone,-43.0,138401.83
buyer_3,Ana,35,ES37209503791832526348,TRX_N-00669-03873023,2024-06-06T13:56:55,Erandio,Expense,transport,-111.01,138290.82
buyer_3,Ana,35,ES37209503791832526348,TRX_N-00670-83913986,2024-06-07T09:20:12,Amurrio,Basic services,electricity,-56.24,138234.58
buyer_3,Ana,35,ES37209503791832526348,TRX_N-00671-51116703,2024-06-13T16:21:10,Amurrio,Expense,food,-583.16,137651.42
buyer_3,Ana,35,ES37209503791832526348,TRX_N-00672-71057845,2024-06-13T09:16:41,Amurrio,Expense,education,-483.35,137168.07
buyer_3,Ana,35,ES37209503791832526348,TRX_N-00673-55064348,2024-06-20T08:21:06,Amurrio,Expense,transport,-154.45,137013.62
buyer_3,Ana,35,ES37209503791832526348,TRX_N-00674-22519185,2024-06-20T09:58:00,Amurrio,Expense,leisure,-299.61,136714.01
buyer_3,Ana,35,ES37209503791832526348,TRX_N-00675-57673082,2024-06-27T11:46:24,Amurrio,Expense,gifts,-426.56,136287.45
buyer_3,Ana,35,ES37209503791832526348,TRX_N-00676-16280734,2024-07-01T11:45:42,Amurrio,transfer,Salary,2410.14,138697.59
buyer_3,Ana,35,ES37209503791832526348,TRX_N-00677-02116371,2024-07-01T11:45:42,Amurrio,transfer,Partner Salary,2139.99,140837.58
buyer_3,Ana,35,ES37209503791832526348,TRX_N-00678-47404284,2024-07-05T20:13:02,Amurrio,Housing,Rent,-975.99,139861.59
buyer_3,Ana,35,ES37209503791832526348,TRX_N-00679-06519431,2024-07-05T09:25:00,Amurrio,Basic services,water,-62.49,139799.1
buyer_3,Ana,35,ES37209503791832526348,TRX_N-00680-17176520,2024-07-05T14:22:50,Amurrio,Basic services,electricity,-34.59,139764.51
buyer_3,Ana,35,ES37209503791832526348,TRX_N-00681-33748241,2024-07-06T14:41:23,Amurrio,Basic services,water,-63.76,139700.75
buyer_3,Ana,35,ES37209503791832526348,TRX_N-00682-04246624,2024-07-06T14:39:45,Amurrio,Basic services,gas,-97.76,139602.99
buyer_3,Ana,35,ES37209503791832526348,TRX_N-00683-77885381,2024-07-06T19:31:28,Amurrio,Basic services,internet,-56.64,139546.35
buyer_3,Ana,35,ES37209503791832526348,TRX_N-00684-57047224,2024-07-06T19:11:22,Amurrio,Basic services,phone,-51.25,139495.1
buyer_3,Ana,35,ES37209503791832526348,TRX_N-00685-03340185,2024-07-06T23:35:49,Amurrio,Expense,food,-680.0,138815.1
buyer_3,Ana,35,ES37209503791832526348,TRX_N-00686-69866539,2024-07-07T13:21:55,Amurrio,Basic services,internet,-67.77,138747.33
buyer_3,Ana,35,ES37209503791832526348,TRX_N-00687-16328799,2024-07-10T21:16:26,Amurrio,Expense,transport,-128.19,138619.14
buyer_3,Ana,35,ES37209503791832526348,TRX_N-00688-34003428,2024-07-13T18:20:37,Amurrio,Expense,travel,-2314.14,136305.0
buyer_3,Ana,35,ES37209503791832526348,TRX_N-00689-55060799,2024-07-19T01:41:26,Durango,Expense,food,-429.39,135875.61
buyer_3,Ana,35,ES37209503791832526348,TRX_N-00690-38193119,2024-07-19T01:37:11,Amurrio,Expense,leisure,-19.58,135856.03
buyer_3,Ana,35,ES37209503791832526348,TRX_N-00691-42067684,2024-08-01T13:03:20,Amurrio,transfer,Salary,2410.14,138266.17
buyer_3,Ana,35,ES37209503791832526348,TRX_N-00692-27071695,2024-08-01T13:03:20,Amurrio,transfer,Partner Salary,2139.99,140406.16
buyer_3,Ana,35,ES37209503791832526348,TRX_N-00693-62687257,2024-08-01T13:03:20,Amurrio,transfer,Extra Income,241.01,140647.17
buyer_3,Ana,35,ES37209503791832526348,TRX_N-00694-65544892,2024-08-05T13:35:26,Amurrio,Housing,Rent,-975.99,139671.18
buyer_3,Ana,35,ES37209503791832526348,TRX_N-00695-86506869,2024-08-05T22:23:38,Amurrio,Expense,transport,-39.94,139631.24
buyer_3,Ana,35,ES37209503791832526348,TRX_N-00696-25379470,2024-08-06T20:22:07,Amurrio,Basic services,water,-27.17,139604.07
buyer_3,Ana,35,ES37209503791832526348,TRX_N-00697-13092516,2024-08-06T18:39:58,Amurrio,Basic services,electricity,-146.88,139457.19
buyer_3,Ana,35,ES37209503791832526348,TRX_N-00698-69483675,2024-08-06T09:16:30,Amurrio,Basic services,phone,-69.53,139387.66
buyer_3,Ana,35,ES37209503791832526348,TRX_N-00699-73719349,2024-08-07T11:04:45,Amurrio,Basic services,electricity,-80.55,139307.11
buyer_3,Ana,35,ES37209503791832526348,TRX_N-00700-53454042,2024-08-09T21:35:01,Amurrio,Expense,food,-451.44,138855.67
buyer_3,Ana,35,ES37209503791832526348,TRX_N-00701-94393560,2024-08-25T17:39:36,Portugalete,Expense,transport,-140.6,138715.07
buyer_3,Ana,35,ES37209503791832526348,TRX_N-00702-23721149,2024-09-01T11:12:45,Amurrio,transfer,Salary,2410.14,141125.21
buyer_3,Ana,35,ES37209503791832526348,TRX_N-00703-40346138,2024-09-01T11:12:45,Amurrio,transfer,Partner Salary,2139.99,143265.2
buyer_3,Ana,35,ES37209503791832526348,TRX_N-00704-43913419,2024-09-01T16:19:17,Amurrio,Expense,clothing,-169.64,143095.56
buyer_3,Ana,35,ES37209503791832526348,TRX_N-00705-65177256,2024-09-04T09:47:48,Leioa,Expense,clothing,-105.94,142989.62
buyer_3,Ana,35,ES37209503791832526348,TRX_N-00706-55349959,2024-09-04T23:01:38,Amurrio,Expense,healthcare,-159.8,142829.82
buyer_3,Ana,35,ES37209503791832526348,TRX_N-00707-02991564,2024-09-05T15:14:55,Amurrio,Housing,Rent,-975.99,141853.83
buyer_3,Ana,35,ES37209503791832526348,TRX_N-00708-32936121,2024-09-05T20:39:29,Amurrio,Basic services,water,-20.39,141833.44
buyer_3,Ana,35,ES37209503791832526348,TRX_N-00709-96021403,2024-09-05T10:16:32,Amurrio,Basic services,electricity,-97.6,141735.84
buyer_3,Ana,35,ES37209503791832526348,TRX_N-00710-84381650,2024-09-06T23:56:10,Amurrio,Basic services,gas,-24.2,141711.64
buyer_3,Ana,35,ES37209503791832526348,TRX_N-00711-25570748,2024-09-07T12:27:15,Amurrio,Basic services,gas,-33.61,141678.03
buyer_3,Ana,35,ES37209503791832526348,TRX_N-00712-00550754,2024-09-07T13:42:32,Amurrio,Basic services,internet,-70.55,141607.48
buyer_3,Ana,35,ES37209503791832526348,TRX_N-00713-70455867,2024-09-14T10:53:54,Amurrio,Expense,clothing,-175.81,141431.67
buyer_3,Ana,35,ES37209503791832526348,TRX_N-00714-24507212,2024-09-22T15:45:28,Amurrio,Expense,transport,-187.79,141243.88
buyer_3,Ana,35,ES37209503791832526348,TRX_N-00715-06612985,2024-10-01T16:51:26,Amurrio,transfer,Salary,2410.14,143654.02
buyer_3,Ana,35,ES37209503791832526348,TRX_N-00716-90269855,2024-10-01T16:51:26,Amurrio,transfer,Partner Salary,2139.99,145794.01
buyer_3,Ana,35,ES37209503791832526348,TRX_N-00717-20421031,2024-10-01T16:51:26,Amurrio,transfer,Extra Income,241.01,146035.02
buyer_3,Ana,35,ES37209503791832526348,TRX_N-00718-35285459,2024-10-05T09:16:06,Amurrio,Housing,Rent,-975.99,145059.03
buyer_3,Ana,35,ES37209503791832526348,TRX_N-00719-00385950,2024-10-05T10:17:33,Amurrio,Basic services,phone,-98.3,144960.73
buyer_3,Ana,35,ES37209503791832526348,TRX_N-00720-34298622,2024-10-06T09:17:29,Amurrio,Basic services,electricity,-106.45,144854.28
buyer_3,Ana,35,ES37209503791832526348,TRX_N-00721-05618786,2024-10-06T19:45:29,Amurrio,Basic services,phone,-62.85,144791.43
buyer_3,Ana,35,ES37209503791832526348,TRX_N-00722-59929340,2024-10-07T12:47:23,Amurrio,Basic services,gas,-85.39,144706.04
buyer_3,Ana,35,ES37209503791832526348,TRX_N-00723-07279082,2024-10-07T01:01:53,Amurrio,Basic services,internet,-39.13,144666.91
buyer_3,Ana,35,ES37209503791832526348,TRX_N-00724-81787858,2024-10-08T14:11:48,Amurrio,Expense,education,-78.29,144588.62
buyer_4,Jorge,50,ES43209504011748589219,TRX_N-00001-55862395,2020-01-01T14:44:36,Galdakao,transfer,Salary,2956.3,5988.08
buyer_4,Jorge,50,ES43209504011748589219,TRX_N-00002-22819786,2020-01-01T14:44:36,Galdakao,transfer,Partner Salary,2643.03,8631.11
buyer_4,Jorge,50,ES43209504011748589219,TRX_N-00003-13270252,2020-01-02T08:30:00,Galdakao,Expense,healthcare,-266.32,8364.79
buyer_4,Jorge,50,ES43209504011748589219,TRX_N-00004-79377366,2020-01-03T18:07:06,Galdakao,Expense,healthcare,-246.23,8118.56
buyer_4,Jorge,50,ES43209504011748589219,TRX_N-00005-98975563,2020-01-05T11:15:11,Galdakao,Housing,Mortgage,-549.47,7569.09
buyer_4,Jorge,50,ES43209504011748589219,TRX_N-00006-78908078,2020-01-05T23:29:23,Galdakao,Basic services,water,-52.19,7516.9
buyer_4,Jorge,50,ES43209504011748589219,TRX_N-00007-69804716,2020-01-05T13:08:38,Galdakao,Basic services,electricity,-104.26,7412.64
buyer_4,Jorge,50,ES43209504011748589219,TRX_N-00008-42895102,2020-01-05T20:06:34,Galdakao,Basic services,phone,-51.7,7360.94
buyer_4,Jorge,50,ES43209504011748589219,TRX_N-00009-78312459,2020-01-06T11:26:53,Galdakao,Basic services,phone,-49.39,7311.55
buyer_4,Jorge,50,ES43209504011748589219,TRX_N-00010-24298142,2020-01-07T12:47:48,Galdakao,Basic services,water,-28.17,7283.38
buyer_4,Jorge,50,ES43209504011748589219,TRX_N-00011-87200671,2020-01-07T14:34:05,Galdakao,Basic services,phone,-51.47,7231.91
buyer_4,Jorge,50,ES43209504011748589219,TRX_N-00012-45705059,2020-01-20T19:42:36,Galdakao,Expense,food,-332.4,6899.51
buyer_4,Jorge,50,ES43209504011748589219,TRX_N-00013-86565030,2020-01-23T17:52:52,Galdakao,Expense,transport,-191.29,6708.22
buyer_4,Jorge,50,ES43209504011748589219,TRX_N-00014-07341451,2020-02-01T08:25:53,Galdakao,transfer,Salary,2956.3,9664.52
buyer_4,Jorge,50,ES43209504011748589219,TRX_N-00015-02318502,2020-02-01T08:25:53,Galdakao,transfer,Partner Salary,2643.03,12307.55
buyer_4,Jorge,50,ES43209504011748589219,TRX_N-00016-76485048,2020-02-05T22:15:11,Galdakao,Housing,Mortgage,-549.47,11758.08
buyer_4,Jorge,50,ES43209504011748589219,TRX_N-00017-69284868,2020-02-05T13:40:21,Galdakao,Basic services,electricity,-43.4,11714.68
buyer_4,Jorge,50,ES43209504011748589219,TRX_N-00018-47650016,2020-02-06T20:56:41,Galdakao,Basic services,phone,-51.81,11662.87
buyer_4,Jorge,50,ES43209504011748589219,TRX_N-00019-27792216,2020-02-06T19:24:40,Santurtzi,Expense,leisure,-299.05,11363.82
buyer_4,Jorge,50,ES43209504011748589219,TRX_N-00020-71495038,2020-02-07T18:20:04,Galdakao,Basic services,water,-61.24,11302.58
buyer_4,Jorge,50,ES43209504011748589219,TRX_N-00021-75385276,2020-02-07T15:30:32,Galdakao,Basic services,internet,-67.94,11234.64
buyer_4,Jorge,50,ES43209504011748589219,TRX_N-00022-71373351,2020-02-07T08:52:50,Erandio,Expense,leisure,-143.07,11091.57
buyer_4,Jorge,50,ES43209504011748589219,TRX_N-00023-78651943,2020-02-08T14:08:12,Mungia,Expense,clothing,-308.61,10782.96
buyer_4,Jorge,50,ES43209504011748589219,TRX_N-00024-96202636,2020-02-13T17:47:36,Galdakao,Expense,clothing,-301.18,10481.78
buyer_4,Jorge,50,ES43209504011748589219,TRX_N-00025-29312995,2020-02-20T15:56:50,Galdakao,Expense,education,-279.51,10202.27
buyer_4,Jorge,50,ES43209504011748589219,TRX_N-00026-90418993,2020-03-01T13:25:52,Galdakao,transfer,Salary,2956.3,13158.57
buyer_4,Jorge,50,ES43209504011748589219,TRX_N-00027-90691914,2020-03-01T13:25:52,Galdakao,transfer,Partner Salary,2643.03,15801.6
buyer_4,Jorge,50,ES43209504011748589219,TRX_N-00028-40171062,2020-03-01T13:25:52,Galdakao,transfer,Extra Income,295.63,16097.23
buyer_4,Jorge,50,ES43209504011748589219,TRX_N-00029-89447584,2020-03-03T20:05:36,Galdakao,Expense,transport,-146.82,15950.41
buyer_4,Jorge,50,ES43209504011748589219,TRX_N-00030-94090886,2020-03-05T18:12:32,Galdakao,Housing,Mortgage,-549.47,15400.94
buyer_4,Jorge,50,ES43209504011748589219,TRX_N-00031-53901142,2020-03-05T20:23:04,Galdakao,Basic services,water,-59.9,15341.04
buyer_4,Jorge,50,ES43209504011748589219,TRX_N-00032-38369574,2020-03-05T10:23:10,Galdakao,Basic services,phone,-25.89,15315.15
buyer_4,Jorge,50,ES43209504011748589219,TRX_N-00033-48864395,2020-03-05T14:33:33,Llodio,Expense,leisure,-11.27,15303.88
buyer_4,Jorge,50,ES43209504011748589219,TRX_N-00034-67662157,2020-03-06T09:10:02,Galdakao,Basic services,gas,-70.11,15233.77
buyer_4,Jorge,50,ES43209504011748589219,TRX_N-00035-44622153,2020-03-07T09:48:05,Galdakao,Basic services,electricity,-90.43,15143.34
buyer_4,Jorge,50,ES43209504011748589219,TRX_N-00036-40994301,2020-03-07T08:52:09,Galdakao,Basic services,internet,-73.4,15069.94
buyer_4,Jorge,50,ES43209504011748589219,TRX_N-00037-25926022,2020-03-08T13:08:35,Iruña de Oca,Expense,food,-332.58,14737.36
buyer_4,Jorge,50,ES43209504011748589219,TRX_N-00038-90385043,2020-03-19T14:43:46,Galdakao,Expense,food,-608.0,14129.36
buyer_4,Jorge,50,ES43209504011748589219,TRX_N-00039-18727941,2020-03-20T20:15:39,Galdakao,Expense,leisure,-96.46,14032.9
buyer_4,Jorge,50,ES43209504011748589219,TRX_N-00040-99844265,2020-04-01T22:56:44,Galdakao,transfer,Salary,2956.3,16989.2
buyer_4,Jorge,50,ES43209504011748589219,TRX_N-00041-43478797,2020-04-01T22:56:44,Galdakao,transfer,Partner Salary,2643.03,19632.23
buyer_4,Jorge,50,ES43209504011748589219,TRX_N-00042-23549661,2020-04-05T17:21:09,Galdakao,Housing,Mortgage,-549.47,19082.76
buyer_4,Jorge,50,ES43209504011748589219,TRX_N-00043-90995878,2020-04-07T10:29:03,Galdakao,Basic services,water,-58.69,19024.07
buyer_4,Jorge,50,ES43209504011748589219,TRX_N-00044-33099821,2020-04-07T11:15:52,Galdakao,Basic services,gas,-86.11,18937.96
buyer_4,Jorge,50,ES43209504011748589219,TRX_N-00045-97516089,2020-04-09T22:15:29,Galdakao,Expense,food,-751.48,18186.48
buyer_4,Jorge,50,ES43209504011748589219,TRX_N-00046-96915474,2020-04-13T16:08:46,Galdakao,Expense,transport,-23.54,18162.94
buyer_4,Jorge,50,ES43209504011748589219,TRX_N-00047-99542286,2020-04-21T15:50:10,Galdakao,Expense,education,-513.2,17649.74
buyer_4,Jorge,50,ES43209504011748589219,TRX_N-00048-48908279,2020-04-21T19:36:47,Galdakao,Expense,gifts,-337.17,17312.57
buyer_4,Jorge,50,ES43209504011748589219,TRX_N-00049-67130741,2020-04-30T21:29:30,Bermeo,Expense,food,-233.19,17079.38
buyer_4,Jorge,50,ES43209504011748589219,TRX_N-00050-17122974,2020-05-01T07:34:47,Galdakao,transfer,Salary,2956.3,20035.68
buyer_4,Jorge,50,ES43209504011748589219,TRX_N-00051-69542770,2020-05-01T07:34:47,Galdakao,transfer,Partner Salary,2643.03,22678.71
buyer_4,Jorge,50,ES43209504011748589219,TRX_N-00052-54621316,2020-05-01T07:34:47,Galdakao,transfer,Extra Income,295.63,22974.34
buyer_4,Jorge,50,ES43209504011748589219,TRX_N-00053-16424852,2020-05-01T17:15:46,Galdakao,Expense,leisure,-210.14,22764.2
buyer_4,Jorge,50,ES43209504011748589219,TRX_N-00054-21773062,2020-05-05T19:48:00,Galdakao,Housing,Mortgage,-549.47,22214.73
buyer_4,Jorge,50,ES43209504011748589219,TRX_N-00055-28345709,2020-05-05T20:09:16,Galdakao,Basic services,internet,-74.89,22139.84
buyer_4,Jorge,50,ES43209504011748589219,TRX_N-00056-65100944,2020-05-07T11:00:32,Galdakao,Basic services,water,-38.85,22100.99
buyer_4,Jorge,50,ES43209504011748589219,TRX_N-00057-63699636,2020-05-07T10:05:53,Galdakao,Basic services,internet,-49.04,22051.95
buyer_4,Jorge,50,ES43209504011748589219,TRX_N-00058-81859338,2020-05-20T12:09:06,Labastida/Bastida,Expense,leisure,-276.24,21775.71
buyer_4,Jorge,50,ES43209504011748589219,TRX_N-00059-34498064,2020-06-01T14:11:00,Galdakao,transfer,Salary,2956.3,24732.01
buyer_4,Jorge,50,ES43209504011748589219,TRX_N-00060-92482531,2020-06-01T14:11:00,Galdakao,transfer,Partner Salary,2643.03,27375.04
buyer_4,Jorge,50,ES43209504011748589219,TRX_N-00061-68652858,2020-06-01T14:11:00,Galdakao,transfer,Bonus,3034.22,30409.26
buyer_4,Jorge,50,ES43209504011748589219,TRX_N-00062-70508052,2020-06-05T13:43:55,Galdakao,Housing,Mortgage,-549.47,29859.79
buyer_4,Jorge,50,ES43209504011748589219,TRX_N-00063-56379865,2020-06-05T08:55:50,Galdakao,Basic services,phone,-24.06,29835.73
buyer_4,Jorge,50,ES43209504011748589219,TRX_N-00064-58940899,2020-06-07T13:25:38,Galdakao,Basic services,electricity,-75.57,29760.16
buyer_4,Jorge,50,ES43209504011748589219,TRX_N-00065-81433481,2020-06-16T20:32:16,Galdakao,Expense,repairs,-628.6,29131.56
buyer_4,Jorge,50,ES43209504011748589219,TRX_N-00066-13082945,2020-06-17T10:55:03,Galdakao,Expense,food,-650.42,28481.14
buyer_4,Jorge,50,ES43209504011748589219,TRX_N-00067-00006127,2020-06-25T19:34:20,Galdakao,Expense,food,-711.07,27770.07
buyer_4,Jorge,50,ES43209504011748589219,TRX_N-00068-95286979,2020-07-01T16:35:10,Galdakao,transfer,Salary,2956.3,30726.37
buyer_4,Jorge,50,ES43209504011748589219,TRX_N-00069-28481664,2020-07-01T16:35:10,Galdakao,transfer,Partner Salary,2643.03,33369.4
buyer_4,Jorge,50,ES43209504011748589219,TRX_N-00070-63826776,2020-07-01T16:35:10,Galdakao,transfer,Extra Income,295.63,33665.03
buyer_4,Jorge,50,ES43209504011748589219,TRX_N-00071-10473976,2020-07-05T14:00:57,Galdakao,Housing,Mortgage,-549.47,33115.56
buyer_4,Jorge,50,ES43209504011748589219,TRX_N-00072-33659671,2020-07-05T15:39:10,Galdakao,Basic services,electricity,-54.62,33060.94
buyer_4,Jorge,50,ES43209504011748589219,TRX_N-00073-88997994,2020-07-05T20:27:53,Galdakao,Basic services,phone,-82.82,32978.12
buyer_4,Jorge,50,ES43209504011748589219,TRX_N-00074-18832822,2020-07-06T10:49:24,Galdakao,Basic services,electricity,-63.89,32914.23
buyer_4,Jorge,50,ES43209504011748589219,TRX_N-00075-75115974,2020-07-06T08:40:52,Galdakao,Basic services,gas,-93.14,32821.09
buyer_4,Jorge,50,ES43209504011748589219,TRX_N-00076-98132356,2020-07-07T11:27:59,Galdakao,Basic services,gas,-75.8,32745.29
buyer_4,Jorge,50,ES43209504011748589219,TRX_N-00077-29538915,2020-07-10T08:51:59,Galdakao,Expense,appliances,-1673.79,31071.5
buyer_4,Jorge,50,ES43209504011748589219,TRX_N-00078-72904390,2020-07-16T17:26:57,Galdakao,Expense,leisure,-17.86,31053.64
buyer_4,Jorge,50,ES43209504011748589219,TRX_N-00079-84330375,2020-07-18T02:48:07,Amurrio,Expense,transport,-55.19,30998.45
buyer_4,Jorge,50,ES43209504011748589219,TRX_N-00080-55201243,2020-07-21T08:10:38,Galdakao,Expense,transport,-91.64,30906.81
buyer_4,Jorge,50,ES43209504011748589219,TRX_N-00081-69623728,2020-07-31T19:36:37,Getxo,Expense,gifts,-103.43,30803.38
buyer_4,Jorge,50,ES43209504011748589219,TRX_N-00082-85416153,2020-08-01T13:56:41,Galdakao,transfer,Salary,2956.3,33759.68
buyer_4,Jorge,50,ES43209504011748589219,TRX_N-00083-52816120,2020-08-01T13:56:41,Galdakao,transfer,Partner Salary,2643.03,36402.71
buyer_4,Jorge,50,ES43209504011748589219,TRX_N-00084-52961683,2020-08-02T14:49:39,Zuia,Expense,food,-696.24,35706.47
buyer_4,Jorge,50,ES43209504011748589219,TRX_N-00085-01390318,2020-08-05T18:46:19,Galdakao,Housing,Mortgage,-549.47,35157.0
buyer_4,Jorge,50,ES43209504011748589219,TRX_N-00086-90368465,2020-08-05T11:17:59,Galdakao,Basic services,water,-27.53,35129.47
buyer_4,Jorge,50,ES43209504011748589219,TRX_N-00087-89021532,2020-08-05T19:01:01,Galdakao,Basic services,gas,-27.61,35101.86
buyer_4,Jorge,50,ES43209504011748589219,TRX_N-00088-32092281,2020-08-05T00:07:51,Galdakao,Basic services,internet,-51.38,35050.48
buyer_4,Jorge,50,ES43209504011748589219,TRX_N-00089-48564876,2020-08-05T13:17:30,Galdakao,Expense,transport,-152.16,34898.32
buyer_4,Jorge,50,ES43209504011748589219,TRX_N-00090-38533986,2020-08-06T20:07:37,Galdakao,Basic services,gas,-23.79,34874.53
buyer_4,Jorge,50,ES43209504011748589219,TRX_N-00091-33197467,2020-08-06T14:28:31,Galdakao,Basic services,internet,-62.78,34811.75
buyer_4,Jorge,50,ES43209504011748589219,TRX_N-00092-10734682,2020-08-07T12:42:08,Galdakao,Basic services,water,-78.88,34732.87
buyer_4,Jorge,50,ES43209504011748589219,TRX_N-00093-78630198,2020-08-07T19:21:52,Galdakao,Basic services,electricity,-139.59,34593.28
buyer_4,Jorge,50,ES43209504011748589219,TRX_N-00094-16733988,2020-08-07T21:48:54,Galdakao,Basic services,internet,-55.77,34537.51
buyer_4,Jorge,50,ES43209504011748589219,TRX_N-00095-42463538,2020-08-08T09:31:38,Galdakao,Expense,transport,-114.92,34422.59
buyer_4,Jorge,50,ES43209504011748589219,TRX_N-00096-01471623,2020-08-10T15:50:47,Galdakao,Expense,leisure,-217.22,34205.37
buyer_4,Jorge,50,ES43209504011748589219,TRX_N-00097-63962279,2020-08-10T18:29:53,Galdakao,Expense,healthcare,-297.63,33907.74
buyer_4,Jorge,50,ES43209504011748589219,TRX_N-00098-52379314,2020-08-14T20:50:28,Getxo,Expense,food,-605.05,33302.69
buyer_4,Jorge,50,ES43209504011748589219,TRX_N-00099-52004664,2020-08-23T15:46:25,Galdakao,Expense,food,-437.32,32865.37
buyer_4,Jorge,50,ES43209504011748589219,TRX_N-00100-35535764,2020-08-30T12:38:13,Galdakao,Expense,food,-653.7,32211.67
buyer_4,Jorge,50,ES43209504011748589219,TRX_N-00101-67701386,2020-08-31T08:44:44,Galdakao,Expense,education,-819.79,31391.88
buyer_4,Jorge,50,ES43209504011748589219,TRX_N-00102-19335675,2020-09-01T11:23:45,Galdakao,transfer,Salary,2956.3,34348.18
buyer_4,Jorge,50,ES43209504011748589219,TRX_N-00103-61495539,2020-09-01T11:23:45,Galdakao,transfer,Partner Salary,2643.03,36991.21
buyer_4,Jorge,50,ES43209504011748589219,TRX_N-00104-02717045,2020-09-01T11:23:45,Galdakao,transfer,Extra Income,295.63,37286.84
buyer_4,Jorge,50,ES43209504011748589219,TRX_N-00105-94705064,2020-09-05T10:48:50,Galdakao,Housing,Mortgage,-549.47,36737.37
buyer_4,Jorge,50,ES43209504011748589219,TRX_N-00106-45842150,2020-09-06T12:12:29,Galdakao,Basic services,internet,-30.82,36706.55
buyer_4,Jorge,50,ES43209504011748589219,TRX_N-00107-36006985,2020-09-07T20:05:50,Galdakao,Basic services,phone,-59.79,36646.76
buyer_4,Jorge,50,ES43209504011748589219,TRX_N-00108-59036261,2020-09-09T03:06:51,Galdakao,Expense,repairs,-518.34,36128.42
buyer_4,Jorge,50,ES43209504011748589219,TRX_N-00109-53640249,2020-09-13T20:03:18,Galdakao,Expense,transport,-179.71,35948.71
buyer_4,Jorge,50,ES43209504011748589219,TRX_N-00110-38054079,2020-09-19T10:39:49,Galdakao,Expense,healthcare,-346.0,35602.71
buyer_4,Jorge,50,ES43209504011748589219,TRX_N-00111-04604577,2020-09-20T18:31:48,Galdakao,Expense,leisure,-44.14,35558.57
buyer_4,Jorge,50,ES43209504011748589219,TRX_N-00112-95255717,2020-09-23T14:25:25,Galdakao,Expense,clothing,-217.99,35340.58
buyer_4,Jorge,50,ES43209504011748589219,TRX_N-00113-45090712,2020-09-26T19:36:03,Galdakao,Expense,transport,-180.54,35160.04
buyer_4,Jorge,50,ES43209504011748589219,TRX_N-00114-17615467,2020-10-01T20:12:51,Galdakao,transfer,Salary,2956.3,38116.34
buyer_4,Jorge,50,ES43209504011748589219,TRX_N-00115-98668390,2020-10-01T20:12:51,Galdakao,transfer,Partner Salary,2643.03,40759.37
buyer_4,Jorge,50,ES43209504011748589219,TRX_N-00116-02078241,2020-10-03T20:06:03,Zarautz,Expense,clothing,-399.42,40359.95
buyer_4,Jorge,50,ES43209504011748589219,TRX_N-00117-48445277,2020-10-05T20:47:47,Galdakao,Housing,Mortgage,-549.47,39810.48
buyer_4,Jorge,50,ES43209504011748589219,TRX_N-00118-17539897,2020-10-05T15:11:10,Galdakao,Basic services,water,-26.35,39784.13
buyer_4,Jorge,50,ES43209504011748589219,TRX_N-00119-49235484,2020-10-06T22:40:00,Galdakao,Basic services,water,-50.71,39733.42
buyer_4,Jorge,50,ES43209504011748589219,TRX_N-00120-04112764,2020-10-06T04:38:05,Galdakao,Basic services,electricity,-65.86,39667.56
buyer_4,Jorge,50,ES43209504011748589219,TRX_N-00121-12294169,2020-10-06T08:48:51,Galdakao,Basic services,phone,-38.06,39629.5
buyer_4,Jorge,50,ES43209504011748589219,TRX_N-00122-37324426,2020-10-06T17:30:54,Errenteria,Expense,leisure,-52.16,39577.34
buyer_4,Jorge,50,ES43209504011748589219,TRX_N-00123-94653575,2020-10-07T19:14:51,Galdakao,Basic services,phone,-63.94,39513.4
buyer_4,Jorge,50,ES43209504011748589219,TRX_N-00124-58681496,2020-10-21T20:46:44,Alegría-Dulantzi,Expense,healthcare,-299.03,39214.37
buyer_4,Jorge,50,ES43209504011748589219,TRX_N-00125-98529280,2020-10-25T06:11:08,Galdakao,Expense,food,-457.68,38756.69
buyer_4,Jorge,50,ES43209504011748589219,TRX_N-00126-12281434,2020-10-31T09:52:39,Erandio,Expense,leisure,-173.87,38582.82
buyer_4,Jorge,50,ES43209504011748589219,TRX_N-00127-00326423,2020-11-01T11:51:35,Galdakao,transfer,Salary,2956.3,41539.12
buyer_4,Jorge,50,ES43209504011748589219,TRX_N-00128-68513248,2020-11-01T11:51:35,Galdakao,transfer,Partner Salary,2643.03,44182.15
buyer_4,Jorge,50,ES43209504011748589219,TRX_N-00129-86051399,2020-11-01T11:51:35,Galdakao,transfer,Extra Income,295.63,44477.78
buyer_4,Jorge,50,ES43209504011748589219,TRX_N-00130-92447632,2020-11-05T18:58:54,Galdakao,Housing,Mortgage,-549.47,43928.31
buyer_4,Jorge,50,ES43209504011748589219,TRX_N-00131-25652645,2020-11-05T07:33:34,Galdakao,Basic services,electricity,-144.35,43783.96
buyer_4,Jorge,50,ES43209504011748589219,TRX_N-00132-62516825,2020-11-05T15:01:56,Galdakao,Basic services,gas,-27.1,43756.86
buyer_4,Jorge,50,ES43209504011748589219,TRX_N-00133-88379541,2020-11-06T02:55:05,Galdakao,Basic services,internet,-48.75,43708.11
buyer_4,Jorge,50,ES43209504011748589219,TRX_N-00134-91742102,2020-11-07T09:53:10,Galdakao,Basic services,electricity,-21.29,43686.82
buyer_4,Jorge,50,ES43209504011748589219,TRX_N-00135-26895507,2020-11-07T17:58:59,Galdakao,Basic services,gas,-69.19,43617.63
buyer_4,Jorge,50,ES43209504011748589219,TRX_N-00136-86571877,2020-11-07T17:58:28,Galdakao,Basic services,phone,-36.49,43581.14
buyer_4,Jorge,50,ES43209504011748589219,TRX_N-00137-43852528,2020-11-17T21:15:07,Galdakao,Expense,food,-730.64,42850.5
buyer_4,Jorge,50,ES43209504011748589219,TRX_N-00138-42162811,2020-11-29T09:55:26,Galdakao,Expense,transport,-24.84,42825.66
buyer_4,Jorge,50,ES43209504011748589219,TRX_N-00139-15026559,2020-11-30T13:12:11,Galdakao,Expense,education,-303.68,42521.98
buyer_4,Jorge,50,ES43209504011748589219,TRX_N-00140-84998883,2020-12-01T19:31:35,Galdakao,transfer,Salary,2956.3,45478.28
buyer_4,Jorge,50,ES43209504011748589219,TRX_N-00141-66860178,2020-12-01T19:31:35,Galdakao,transfer,Partner Salary,2643.03,48121.31
buyer_4,Jorge,50,ES43209504011748589219,TRX_N-00142-01741165,2020-12-01T19:31:35,Galdakao,transfer,Bonus,2730.29,50851.6
buyer_4,Jorge,50,ES43209504011748589219,TRX_N-00143-86052819,2020-12-01T21:17:30,Galdakao,Expense,leisure,-92.68,50758.92
buyer_4,Jorge,50,ES43209504011748589219,TRX_N-00144-53841550,2020-12-05T09:36:41,Galdakao,Housing,Mortgage,-549.47,50209.45
buyer_4,Jorge,50,ES43209504011748589219,TRX_N-00145-39871698,2020-12-05T15:12:06,Galdakao,Basic services,internet,-35.85,50173.6
buyer_4,Jorge,50,ES43209504011748589219,TRX_N-00146-16723444,2020-12-07T03:17:35,Galdakao,Basic services,water,-26.85,50146.75
buyer_4,Jorge,50,ES43209504011748589219,TRX_N-00147-94130137,2020-12-07T13:10:39,Galdakao,Basic services,electricity,-131.38,50015.37
buyer_4,Jorge,50,ES43209504011748589219,TRX_N-00148-51660887,2020-12-07T16:59:48,Galdakao,Basic services,phone,-30.61,49984.76
buyer_4,Jorge,50,ES43209504011748589219,TRX_N-00149-05902775,2020-12-25T19:25:32,Galdakao,Expense,transport,-25.71,49959.05
buyer_4,Jorge,50,ES43209504011748589219,TRX_N-00150-69892821,2020-12-31T12:42:04,Galdakao,Expense,leisure,-246.98,49712.07
buyer_4,Jorge,50,ES43209504011748589219,TRX_N-00151-62918779,2021-01-01T18:07:25,Galdakao,transfer,Salary,2956.3,52668.37
buyer_4,Jorge,50,ES43209504011748589219,TRX_N-00152-04591366,2021-01-01T18:07:25,Galdakao,transfer,Partner Salary,2643.03,55311.4
buyer_4,Jorge,50,ES43209504011748589219,TRX_N-00153-30386041,2021-01-01T09:43:58,Galdakao,Expense,education,-920.07,54391.33
buyer_4,Jorge,50,ES43209504011748589219,TRX_N-00154-74631015,2021-01-05T23:36:47,Galdakao,Housing,Mortgage,-549.47,53841.86
buyer_4,Jorge,50,ES43209504011748589219,TRX_N-00155-43679747,2021-01-07T12:04:43,Galdakao,Basic services,phone,-36.54,53805.32
buyer_4,Jorge,50,ES43209504011748589219,TRX_N-00156-47002306,2021-01-08T08:56:00,Galdakao,Expense,leisure,-44.7,53760.62
buyer_4,Jorge,50,ES43209504011748589219,TRX_N-00157-38171741,2021-01-20T19:03:17,Galdakao,Expense,leisure,-283.99,53476.63
buyer_4,Jorge,50,ES43209504011748589219,TRX_N-00158-73131541,2021-01-27T09:21:58,Galdakao,Expense,food,-439.35,53037.28
buyer_4,Jorge,50,ES43209504011748589219,TRX_N-00159-90709542,2021-02-01T18:59:09,Galdakao,transfer,Salary,2956.3,55993.58
buyer_4,Jorge,50,ES43209504011748589219,TRX_N-00160-49823873,2021-02-01T18:59:09,Galdakao,transfer,Partner Salary,2643.03,58636.61
buyer_4,Jorge,50,ES43209504011748589219,TRX_N-00161-06603699,2021-02-01T18:59:09,Galdakao,transfer,Extra Income,295.63,58932.24
buyer_4,Jorge,50,ES43209504011748589219,TRX_N-00162-77818607,2021-02-05T13:54:18,Galdakao,Housing,Mortgage,-549.47,58382.77
buyer_4,Jorge,50,ES43209504011748589219,TRX_N-00163-91255289,2021-02-05T08:52:51,Galdakao,Basic services,electricity,-131.14,58251.63
buyer_4,Jorge,50,ES43209504011748589219,TRX_N-00164-11132481,2021-02-05T04:42:52,Galdakao,Basic services,gas,-67.2,58184.43
buyer_4,Jorge,50,ES43209504011748589219,TRX_N-00165-31814317,2021-02-05T19:48:48,Galdakao,Basic services,internet,-61.14,58123.29
buyer_4,Jorge,50,ES43209504011748589219,TRX_N-00166-52901842,2021-02-05T08:47:46,Galdakao,Basic services,phone,-37.82,58085.47
buyer_4,Jorge,50,ES43209504011748589219,TRX_N-00167-42949797,2021-02-05T12:57:41,Eibar,Expense,healthcare,-149.48,57935.99
buyer_4,Jorge,50,ES43209504011748589219,TRX_N-00168-01132121,2021-02-06T15:48:10,Galdakao,Basic services,water,-76.78,57859.21
buyer_4,Jorge,50,ES43209504011748589219,TRX_N-00169-41761318,2021-02-06T04:55:47,Galdakao,Basic services,internet,-64.76,57794.45
buyer_4,Jorge,50,ES43209504011748589219,TRX_N-00170-12065464,2021-02-06T10:59:30,Galdakao,Basic services,phone,-57.83,57736.62
buyer_4,Jorge,50,ES43209504011748589219,TRX_N-00171-25923386,2021-02-14T23:23:31,Galdakao,Expense,clothing,-64.9,57671.72
buyer_4,Jorge,50,ES43209504011748589219,TRX_N-00172-67121433,2021-03-01T09:03:07,Galdakao,transfer,Salary,2956.3,60628.02
buyer_4,Jorge,50,ES43209504011748589219,TRX_N-00173-71715930,2021-03-01T09:03:07,Galdakao,transfer,Partner Salary,2643.03,63271.05
buyer_4,Jorge,50,ES43209504011748589219,TRX_N-00174-37965696,2021-03-05T22:11:17,Galdakao,Housing,Mortgage,-549.47,62721.58
buyer_4,Jorge,50,ES43209504011748589219,TRX_N-00175-77440790,2021-03-05T08:32:13,Galdakao,Basic services,electricity,-118.78,62602.8
buyer_4,Jorge,50,ES43209504011748589219,TRX_N-00176-12292016,2021-03-06T19:03:53,Galdakao,Basic services,electricity,-90.98,62511.82
buyer_4,Jorge,50,ES43209504011748589219,TRX_N-00177-15227673,2021-03-06T16:24:31,Galdakao,Basic services,internet,-61.41,62450.41
buyer_4,Jorge,50,ES43209504011748589219,TRX_N-00178-37264290,2021-03-07T10:45:32,Galdakao,Basic services,internet,-57.25,62393.16
buyer_4,Jorge,50,ES43209504011748589219,TRX_N-00179-41030257,2021-03-11T19:49:23,Basauri,Expense,leisure,-32.16,62361.0
buyer_4,Jorge,50,ES43209504011748589219,TRX_N-00180-48489929,2021-04-01T19:43:16,Galdakao,transfer,Salary,2956.3,65317.3
buyer_4,Jorge,50,ES43209504011748589219,TRX_N-00181-93163939,2021-04-01T19:43:16,Galdakao,transfer,Partner Salary,2643.03,67960.33
buyer_4,Jorge,50,ES43209504011748589219,TRX_N-00182-29998147,2021-04-01T19:43:16,Galdakao,transfer,Extra Income,295.63,68255.96
buyer_4,Jorge,50,ES43209504011748589219,TRX_N-00183-98507796,2021-04-05T06:44:33,Galdakao,Housing,Mortgage,-549.47,67706.49
buyer_4,Jorge,50,ES43209504011748589219,TRX_N-00184-70396986,2021-04-05T13:25:54,Galdakao,Basic services,water,-65.18,67641.31
buyer_4,Jorge,50,ES43209504011748589219,TRX_N-00185-56403614,2021-04-05T18:45:40,Galdakao,Basic services,gas,-44.03,67597.28
buyer_4,Jorge,50,ES43209504011748589219,TRX_N-00186-71306987,2021-04-05T18:43:05,Galdakao,Basic services,internet,-51.43,67545.85
buyer_4,Jorge,50,ES43209504011748589219,TRX_N-00187-99775277,2021-04-05T15:45:09,Galdakao,Basic services,phone,-41.17,67504.68
buyer_4,Jorge,50,ES43209504011748589219,TRX_N-00188-55389433,2021-04-06T19:34:43,Galdakao,Basic services,electricity,-117.97,67386.71
buyer_4,Jorge,50,ES43209504011748589219,TRX_N-00189-90334255,2021-04-07T14:14:48,Galdakao,Basic services,internet,-60.49,67326.22
buyer_4,Jorge,50,ES43209504011748589219,TRX_N-00190-84496861,2021-04-08T08:17:29,Galdakao,Expense,leisure,-38.36,67287.86
buyer_4,Jorge,50,ES43209504011748589219,TRX_N-00191-16234809,2021-04-14T15:05:53,Galdakao,Expense,food,-682.21,66605.65
buyer_4,Jorge,50,ES43209504011748589219,TRX_N-00192-02188567,2021-04-21T01:40:03,Galdakao,Expense,transport,-32.44,66573.21
buyer_4,Jorge,50,ES43209504011748589219,TRX_N-00193-05836586,2021-05-01T13:19:17,Galdakao,transfer,Salary,2956.3,69529.51
buyer_4,Jorge,50,ES43209504011748589219,TRX_N-00194-43416974,2021-05-01T13:19:17,Galdakao,transfer,Partner Salary,2643.03,72172.54
buyer_4,Jorge,50,ES43209504011748589219,TRX_N-00195-00760826,2021-05-02T16:32:32,Zuia,Expense,transport,-107.18,72065.36
buyer_4,Jorge,50,ES43209504011748589219,TRX_N-00196-80685942,2021-05-04T15:12:39,Galdakao,Expense,gifts,-332.71,71732.65
buyer_4,Jorge,50,ES43209504011748589219,TRX_N-00197-07240035,2021-05-05T02:26:59,Galdakao,Housing,Mortgage,-549.47,71183.18
buyer_4,Jorge,50,ES43209504011748589219,TRX_N-00198-72917522,2021-05-05T09:08:36,Galdakao,Basic services,water,-29.67,71153.51
buyer_4,Jorge,50,ES43209504011748589219,TRX_N-00199-11934660,2021-05-05T23:12:50,Galdakao,Basic services,gas,-67.9,71085.61
buyer_4,Jorge,50,ES43209504011748589219,TRX_N-00200-60660996,2021-05-05T22:31:50,Galdakao,Expense,leisure,-91.61,70994.0
buyer_4,Jorge,50,ES43209504011748589219,TRX_N-00201-57348347,2021-05-07T17:07:46,Galdakao,Basic services,electricity,-128.66,70865.34
buyer_4,Jorge,50,ES43209504011748589219,TRX_N-00202-02977138,2021-05-07T18:43:39,Galdakao,Basic services,gas,-27.28,70838.06
buyer_4,Jorge,50,ES43209504011748589219,TRX_N-00203-49164284,2021-05-07T10:38:15,Galdakao,Basic services,phone,-49.58,70788.48
buyer_4,Jorge,50,ES43209504011748589219,TRX_N-00204-76502979,2021-05-09T12:33:57,Galdakao,Expense,healthcare,-304.27,70484.21
buyer_4,Jorge,50,ES43209504011748589219,TRX_N-00205-92479410,2021-05-10T14:12:38,Irun,Expense,transport,-50.36,70433.85
buyer_4,Jorge,50,ES43209504011748589219,TRX_N-00206-83851855,2021-05-22T18:50:37,Galdakao,Expense,food,-507.78,69926.07
buyer_4,Jorge,50,ES43209504011748589219,TRX_N-00207-74901137,2021-06-01T20:35:42,Galdakao,transfer,Salary,2956.3,72882.37
buyer_4,Jorge,50,ES43209504011748589219,TRX_N-00208-60115583,2021-06-01T20:35:42,Galdakao,transfer,Partner Salary,2643.03,75525.4
buyer_4,Jorge,50,ES43209504011748589219,TRX_N-00209-67668389,2021-06-01T20:35:42,Galdakao,transfer,Extra Income,295.63,75821.03
buyer_4,Jorge,50,ES43209504011748589219,TRX_N-00210-35467466,2021-06-01T20:35:42,Galdakao,transfer,Bonus,2886.29,78707.32
buyer_4,Jorge,50,ES43209504011748589219,TRX_N-00211-46253748,2021-06-05T12:36:59,Galdakao,Housing,Mortgage,-549.47,78157.85
buyer_4,Jorge,50,ES43209504011748589219,TRX_N-00212-11564906,2021-06-05T08:15:38,Galdakao,Basic services,water,-24.28,78133.57
buyer_4,Jorge,50,ES43209504011748589219,TRX_N-00213-10802110,2021-06-06T08:02:09,Galdakao,Basic services,water,-78.07,78055.5
buyer_4,Jorge,50,ES43209504011748589219,TRX_N-00214-49278241,2021-06-07T23:27:58,Galdakao,Basic services,water,-77.57,77977.93
buyer_4,Jorge,50,ES43209504011748589219,TRX_N-00215-17973721,2021-06-07T15:47:23,Galdakao,Basic services,electricity,-136.76,77841.17
buyer_4,Jorge,50,ES43209504011748589219,TRX_N-00216-47441445,2021-06-07T11:18:52,Galdakao,Basic services,gas,-91.27,77749.9
buyer_4,Jorge,50,ES43209504011748589219,TRX_N-00217-11227088,2021-06-07T06:21:58,Galdakao,Basic services,phone,-35.59,77714.31
buyer_4,Jorge,50,ES43209504011748589219,TRX_N-00218-20661116,2021-06-11T22:46:21,Mungia,Expense,transport,-92.47,77621.84
buyer_4,Jorge,50,ES43209504011748589219,TRX_N-00219-79411839,2021-06-28T17:16:07,Galdakao,Expense,transport,-114.9,77506.94
buyer_4,Jorge,50,ES43209504011748589219,TRX_N-00220-80001968,2021-07-01T14:11:39,Galdakao,transfer,Salary,2956.3,80463.24
buyer_4,Jorge,50,ES43209504011748589219,TRX_N-00221-15894812,2021-07-01T14:11:39,Galdakao,transfer,Partner Salary,2643.03,83106.27
buyer_4,Jorge,50,ES43209504011748589219,TRX_N-00222-75389284,2021-07-04T09:42:00,Galdakao,Expense,transport,-30.89,83075.38
buyer_4,Jorge,50,ES43209504011748589219,TRX_N-00223-15509551,2021-07-05T10:46:07,Galdakao,Housing,Mortgage,-549.47,82525.91
buyer_4,Jorge,50,ES43209504011748589219,TRX_N-00224-34968359,2021-07-05T11:43:32,Galdakao,Basic services,gas,-35.5,82490.41
buyer_4,Jorge,50,ES43209504011748589219,TRX_N-00225-96964165,2021-07-05T05:36:54,Galdakao,Basic services,phone,-76.02,82414.39
buyer_4,Jorge,50,ES43209504011748589219,TRX_N-00226-52071199,2021-07-06T08:09:17,Galdakao,Basic services,gas,-37.25,82377.14
buyer_4,Jorge,50,ES43209504011748589219,TRX_N-00227-74658985,2021-07-06T15:36:13,Galdakao,Basic services,phone,-54.36,82322.78
buyer_4,Jorge,50,ES43209504011748589219,TRX_N-00228-90258358,2021-07-07T14:40:09,Galdakao,Basic services,water,-62.51,82260.27
buyer_4,Jorge,50,ES43209504011748589219,TRX_N-00229-04036310,2021-07-07T04:50:27,Galdakao,Basic services,electricity,-97.22,82163.05
buyer_4,Jorge,50,ES43209504011748589219,TRX_N-00230-02123662,2021-07-07T08:44:41,Galdakao,Basic services,phone,-98.18,82064.87
buyer_4,Jorge,50,ES43209504011748589219,TRX_N-00231-30843391,2021-07-07T17:26:18,Galdakao,Expense,repairs,-888.45,81176.42
buyer_4,Jorge,50,ES43209504011748589219,TRX_N-00232-01070778,2021-07-09T14:19:02,Galdakao,Expense,transport,-143.3,81033.12
buyer_4,Jorge,50,ES43209504011748589219,TRX_N-00233-98718103,2021-07-10T06:17:22,Galdakao,Expense,clothing,-394.06,80639.06
buyer_4,Jorge,50,ES43209504011748589219,TRX_N-00234-05140932,2021-07-26T21:21:15,Galdakao,Expense,transport,-174.63,80464.43
buyer_4,Jorge,50,ES43209504011748589219,TRX_N-00235-57618276,2021-08-01T20:44:14,Galdakao,transfer,Salary,2956.3,83420.73
buyer_4,Jorge,50,ES43209504011748589219,TRX_N-00236-74255451,2021-08-01T20:44:14,Galdakao,transfer,Partner Salary,2643.03,86063.76
buyer_4,Jorge,50,ES43209504011748589219,TRX_N-00237-38421885,2021-08-01T20:44:14,Galdakao,transfer,Extra Income,295.63,86359.39
buyer_4,Jorge,50,ES43209504011748589219,TRX_N-00238-18326360,2021-08-01T20:31:43,Galdakao,Expense,education,-780.24,85579.15
buyer_4,Jorge,50,ES43209504011748589219,TRX_N-00239-08169249,2021-08-05T07:12:48,Galdakao,Housing,Mortgage,-549.47,85029.68
buyer_4,Jorge,50,ES43209504011748589219,TRX_N-00240-94768371,2021-08-05T21:42:41,Galdakao,Basic services,water,-52.22,84977.46
buyer_4,Jorge,50,ES43209504011748589219,TRX_N-00241-93407412,2021-08-06T18:07:11,Galdakao,Basic services,electricity,-75.91,84901.55
buyer_4,Jorge,50,ES43209504011748589219,TRX_N-00242-09752198,2021-08-06T19:25:01,Galdakao,Basic services,gas,-18.83,84882.72
buyer_4,Jorge,50,ES43209504011748589219,TRX_N-00243-85477618,2021-08-07T10:51:07,Galdakao,Basic services,electricity,-94.42,84788.3
buyer_4,Jorge,50,ES43209504011748589219,TRX_N-00244-76570052,2021-08-07T18:51:37,Galdakao,Basic services,internet,-65.96,84722.34
buyer_4,Jorge,50,ES43209504011748589219,TRX_N-00245-32683781,2021-08-27T15:53:40,Donostia,Expense,gifts,-33.37,84688.97
buyer_4,Jorge,50,ES43209504011748589219,TRX_N-00246-23403164,2021-08-31T16:00:37,Galdakao,Expense,leisure,-152.59,84536.38
buyer_4,Jorge,50,ES43209504011748589219,TRX_N-00247-40237493,2021-09-01T13:55:37,Galdakao,transfer,Salary,2956.3,87492.68
buyer_4,Jorge,50,ES43209504011748589219,TRX_N-00248-67627263,2021-09-01T13:55:37,Galdakao,transfer,Partner Salary,2643.03,90135.71
buyer_4,Jorge,50,ES43209504011748589219,TRX_N-00249-21309481,2021-09-04T11:56:40,Alegría-Dulantzi,Expense,education,-412.93,89722.78
buyer_4,Jorge,50,ES43209504011748589219,TRX_N-00250-36167975,2021-09-05T12:16:25,Galdakao,Housing,Mortgage,-549.47,89173.31
buyer_4,Jorge,50,ES43209504011748589219,TRX_N-00251-59849775,2021-09-05T17:49:06,Galdakao,Basic services,gas,-93.71,89079.6
buyer_4,Jorge,50,ES43209504011748589219,TRX_N-00252-76870585,2021-09-06T11:38:08,Galdakao,Basic services,electricity,-120.6,88959.0
buyer_4,Jorge,50,ES43209504011748589219,TRX_N-00253-76086948,2021-09-06T20:17:28,Galdakao,Basic services,gas,-70.4,88888.6
buyer_4,Jorge,50,ES43209504011748589219,TRX_N-00254-03094214,2021-09-06T13:33:37,Galdakao,Basic services,internet,-59.37,88829.23
buyer_4,Jorge,50,ES43209504011748589219,TRX_N-00255-12343906,2021-09-07T10:44:34,Galdakao,Basic services,gas,-58.62,88770.61
buyer_4,Jorge,50,ES43209504011748589219,TRX_N-00256-73255746,2021-09-07T10:20:10,Galdakao,Basic services,internet,-70.73,88699.88
buyer_4,Jorge,50,ES43209504011748589219,TRX_N-00257-79662220,2021-09-11T17:10:49,Galdakao,Expense,food,-624.8,88075.08
buyer_4,Jorge,50,ES43209504011748589219,TRX_N-00258-98629725,2021-09-12T12:20:22,Galdakao,Expense,food,-117.5,87957.58
buyer_4,Jorge,50,ES43209504011748589219,TRX_N-00259-78156039,2021-09-16T07:20:12,Galdakao,Expense,gifts,-229.61,87727.97
buyer_4,Jorge,50,ES43209504011748589219,TRX_N-00260-77822396,2021-09-21T11:02:10,Galdakao,Expense,clothing,-427.73,87300.24
buyer_4,Jorge,50,ES43209504011748589219,TRX_N-00261-24130021,2021-10-01T14:18:16,Galdakao,transfer,Salary,2956.3,90256.54
buyer_4,Jorge,50,ES43209504011748589219,TRX_N-00262-23239734,2021-10-01T14:18:16,Galdakao,transfer,Partner Salary,2643.03,92899.57
buyer_4,Jorge,50,ES43209504011748589219,TRX_N-00263-04314391,2021-10-02T23:00:02,Galdakao,Expense,transport,-102.82,92796.75
buyer_4,Jorge,50,ES43209504011748589219,TRX_N-00264-46462619,2021-10-02T07:56:00,Galdakao,Expense,leisure,-249.25,92547.5
buyer_4,Jorge,50,ES43209504011748589219,TRX_N-00265-33715648,2021-10-05T16:41:51,Galdakao,Housing,Mortgage,-549.47,91998.03
buyer_4,Jorge,50,ES43209504011748589219,TRX_N-00266-76347161,2021-10-05T19:44:29,Galdakao,Basic services,water,-73.57,91924.46
buyer_4,Jorge,50,ES43209504011748589219,TRX_N-00267-28127248,2021-10-05T09:52:40,Galdakao,Basic services,electricity,-142.46,91782.0
buyer_4,Jorge,50,ES43209504011748589219,TRX_N-00268-17302275,2021-10-06T16:35:23,Galdakao,Basic services,internet,-68.82,91713.18
buyer_4,Jorge,50,ES43209504011748589219,TRX_N-00269-77146217,2021-10-07T05:13:20,Galdakao,Basic services,electricity,-40.08,91673.1
buyer_4,Jorge,50,ES43209504011748589219,TRX_N-00270-04104997,2021-10-07T14:44:10,Galdakao,Basic services,gas,-42.79,91630.31
buyer_4,Jorge,50,ES43209504011748589219,TRX_N-00271-04490789,2021-10-18T09:25:39,Galdakao,Expense,transport,-124.62,91505.69
buyer_4,Jorge,50,ES43209504011748589219,TRX_N-00272-44085513,2021-10-22T08:56:57,Galdakao,Expense,food,-359.66,91146.03
buyer_4,Jorge,50,ES43209504011748589219,TRX_N-00273-75587685,2021-11-01T16:02:16,Galdakao,transfer,Salary,2956.3,94102.33
buyer_4,Jorge,50,ES43209504011748589219,TRX_N-00274-65331639,2021-11-01T16:02:16,Galdakao,transfer,Partner Salary,2643.03,96745.36
buyer_4,Jorge,50,ES43209504011748589219,TRX_N-00275-76172006,2021-11-01T16:02:16,Galdakao,transfer,Extra Income,295.63,97040.99
buyer_4,Jorge,50,ES43209504011748589219,TRX_N-00276-53372724,2021-11-05T23:35:26,Galdakao,Housing,Mortgage,-549.47,96491.52
buyer_4,Jorge,50,ES43209504011748589219,TRX_N-00277-76888869,2021-11-05T17:14:47,Galdakao,Basic services,electricity,-112.96,96378.56
buyer_4,Jorge,50,ES43209504011748589219,TRX_N-00278-32560226,2021-11-05T20:34:14,Galdakao,Basic services,internet,-35.16,96343.4
buyer_4,Jorge,50,ES43209504011748589219,TRX_N-00279-30040413,2021-11-06T19:24:49,Galdakao,Basic services,water,-33.5,96309.9
buyer_4,Jorge,50,ES43209504011748589219,TRX_N-00280-62776096,2021-11-06T19:00:37,Galdakao,Basic services,internet,-67.79,96242.11
buyer_4,Jorge,50,ES43209504011748589219,TRX_N-00281-34718955,2021-11-06T17:24:10,Galdakao,Basic services,phone,-27.67,96214.44
buyer_4,Jorge,50,ES43209504011748589219,TRX_N-00282-17711336,2021-11-07T23:27:34,Galdakao,Basic services,electricity,-28.02,96186.42
buyer_4,Jorge,50,ES43209504011748589219,TRX_N-00283-56423613,2021-11-07T09:19:22,Galdakao,Basic services,phone,-22.63,96163.79
buyer_4,Jorge,50,ES43209504011748589219,TRX_N-00284-85109474,2021-11-22T19:47:18,Iruña de Oca,Expense,healthcare,-226.74,95937.05
buyer_4,Jorge,50,ES43209504011748589219,TRX_N-00285-55356475,2021-11-28T08:41:04,Galdakao,Expense,transport,-47.96,95889.09
buyer_4,Jorge,50,ES43209504011748589219,TRX_N-00286-84391022,2021-12-01T10:53:09,Galdakao,transfer,Salary,2956.3,98845.39
buyer_4,Jorge,50,ES43209504011748589219,TRX_N-00287-72263744,2021-12-01T10:53:09,Galdakao,transfer,Partner Salary,2643.03,101488.42
buyer_4,Jorge,50,ES43209504011748589219,TRX_N-00288-18245682,2021-12-01T10:53:09,Galdakao,transfer,Bonus,2672.15,104160.57
buyer_4,Jorge,50,ES43209504011748589219,TRX_N-00289-28943525,2021-12-04T12:00:38,Galdakao,Expense,leisure,-20.92,104139.65
buyer_4,Jorge,50,ES43209504011748589219,TRX_N-00290-72532085,2021-12-05T10:12:02,Galdakao,Housing,Mortgage,-549.47,103590.18
buyer_4,Jorge,50,ES43209504011748589219,TRX_N-00291-60997038,2021-12-05T09:52:40,Galdakao,Basic services,electricity,-122.36,103467.82
buyer_4,Jorge,50,ES43209504011748589219,TRX_N-00292-80655697,2021-12-05T18:12:30,Galdakao,Basic services,internet,-65.87,103401.95
buyer_4,Jorge,50,ES43209504011748589219,TRX_N-00293-36423738,2021-12-05T21:03:42,Galdakao,Basic services,phone,-77.55,103324.4
buyer_4,Jorge,50,ES43209504011748589219,TRX_N-00294-86664017,2021-12-06T15:37:19,Galdakao,Basic services,phone,-66.46,103257.94
buyer_4,Jorge,50,ES43209504011748589219,TRX_N-00295-52974001,2021-12-08T23:18:40,Galdakao,Expense,food,-360.39,102897.55
buyer_4,Jorge,50,ES43209504011748589219,TRX_N-00296-44658461,2021-12-10T13:37:30,Galdakao,Expense,appliances,-931.8,101965.75
buyer_4,Jorge,50,ES43209504011748589219,TRX_N-00297-19048171,2021-12-21T13:06:11,Getxo,Expense,food,-597.87,101367.88
buyer_4,Jorge,50,ES43209504011748589219,TRX_N-00298-51283335,2022-01-01T17:06:42,Galdakao,transfer,Salary,2956.3,104324.18
buyer_4,Jorge,50,ES43209504011748589219,TRX_N-00299-45466679,2022-01-01T17:06:42,Galdakao,transfer,Partner Salary,2643.03,106967.21
buyer_4,Jorge,50,ES43209504011748589219,TRX_N-00300-12267570,2022-01-01T17:06:42,Galdakao,transfer,Extra Income,295.63,107262.84
buyer_4,Jorge,50,ES43209504011748589219,TRX_N-00301-72129581,2022-01-01T17:00:30,Galdakao,Expense,leisure,-193.36,107069.48
buyer_4,Jorge,50,ES43209504011748589219,TRX_N-00302-43443068,2022-01-05T22:54:05,Galdakao,Housing,Mortgage,-549.47,106520.01
buyer_4,Jorge,50,ES43209504011748589219,TRX_N-00303-06279065,2022-01-05T18:04:02,Galdakao,Basic services,water,-22.39,106497.62
buyer_4,Jorge,50,ES43209504011748589219,TRX_N-00304-60958417,2022-01-05T09:09:05,Galdakao,Basic services,internet,-68.47,106429.15
buyer_4,Jorge,50,ES43209504011748589219,TRX_N-00305-82645527,2022-01-06T17:40:17,Galdakao,Basic services,water,-72.05,106357.1
buyer_4,Jorge,50,ES43209504011748589219,TRX_N-00306-00192954,2022-01-06T11:45:48,Galdakao,Basic services,gas,-77.64,106279.46
buyer_4,Jorge,50,ES43209504011748589219,TRX_N-00307-09404155,2022-01-06T03:57:58,Galdakao,Basic services,internet,-50.83,106228.63
buyer_4,Jorge,50,ES43209504011748589219,TRX_N-00308-85727037,2022-01-06T19:04:24,Galdakao,Basic services,phone,-22.49,106206.14
buyer_4,Jorge,50,ES43209504011748589219,TRX_N-00309-63212297,2022-01-07T17:45:14,Galdakao,Basic services,gas,-15.08,106191.06
buyer_4,Jorge,50,ES43209504011748589219,TRX_N-00310-57019971,2022-01-07T01:43:24,Galdakao,Basic services,internet,-77.61,106113.45
buyer_4,Jorge,50,ES43209504011748589219,TRX_N-00311-36063561,2022-01-15T16:30:08,Galdakao,Expense,education,-150.13,105963.32
buyer_4,Jorge,50,ES43209504011748589219,TRX_N-00312-19717290,2022-01-18T15:01:07,Galdakao,Expense,food,-398.98,105564.34
buyer_4,Jorge,50,ES43209504011748589219,TRX_N-00313-32319809,2022-01-22T20:29:52,Galdakao,Expense,clothing,-451.7,105112.64
buyer_4,Jorge,50,ES43209504011748589219,TRX_N-00314-52508246,2022-02-01T10:10:53,Galdakao,transfer,Salary,2956.3,108068.94
buyer_4,Jorge,50,ES43209504011748589219,TRX_N-00315-55817154,2022-02-01T10:10:53,Galdakao,transfer,Partner Salary,2643.03,110711.97
buyer_4,Jorge,50,ES43209504011748589219,TRX_N-00316-28631960,2022-02-02T09:21:44,Galdakao,Expense,healthcare,-300.07,110411.9
buyer_4,Jorge,50,ES43209504011748589219,TRX_N-00317-51685321,2022-02-05T08:42:19,Galdakao,Housing,Mortgage,-549.47,109862.43
buyer_4,Jorge,50,ES43209504011748589219,TRX_N-00318-98103405,2022-02-05T20:01:38,Galdakao,Basic services,phone,-25.26,109837.17
buyer_4,Jorge,50,ES43209504011748589219,TRX_N-00319-10894394,2022-02-06T13:23:25,Galdakao,Basic services,water,-41.48,109795.69
buyer_4,Jorge,50,ES43209504011748589219,TRX_N-00320-79485438,2022-02-06T20:33:55,Galdakao,Basic services,electricity,-88.81,109706.88
buyer_4,Jorge,50,ES43209504011748589219,TRX_N-00321-02985029,2022-02-06T10:00:06,Galdakao,Basic services,gas,-87.38,109619.5
buyer_4,Jorge,50,ES43209504011748589219,TRX_N-00322-90049130,2022-02-06T20:23:37,Galdakao,Basic services,internet,-52.77,109566.73
buyer_4,Jorge,50,ES43209504011748589219,TRX_N-00323-52965446,2022-02-06T12:29:54,Galdakao,Basic services,phone,-89.11,109477.62
buyer_4,Jorge,50,ES43209504011748589219,TRX_N-00324-96601616,2022-02-07T22:02:10,Galdakao,Basic services,water,-12.92,109464.7
buyer_4,Jorge,50,ES43209504011748589219,TRX_N-00325-66784865,2022-02-07T02:39:49,Galdakao,Basic services,electricity,-149.61,109315.09
buyer_4,Jorge,50,ES43209504011748589219,TRX_N-00326-75611447,2022-02-07T08:48:35,Galdakao,Basic services,gas,-55.97,109259.12
buyer_4,Jorge,50,ES43209504011748589219,TRX_N-00327-46542113,2022-02-07T17:12:30,Galdakao,Basic services,phone,-45.08,109214.04
buyer_4,Jorge,50,ES43209504011748589219,TRX_N-00328-52686066,2022-02-10T09:43:57,Arrasate/Mondragon,Expense,food,-247.37,108966.67
buyer_4,Jorge,50,ES43209504011748589219,TRX_N-00329-86894075,2022-02-12T10:18:29,Galdakao,Expense,gifts,-348.31,108618.36
buyer_4,Jorge,50,ES43209504011748589219,TRX_N-00330-85246291,2022-02-20T08:14:31,Galdakao,Expense,education,-897.03,107721.33
buyer_4,Jorge,50,ES43209504011748589219,TRX_N-00331-74210473,2022-02-22T20:51:33,Galdakao,Expense,food,-416.87,107304.46
buyer_4,Jorge,50,ES43209504011748589219,TRX_N-00332-96371676,2022-02-22T11:45:18,Galdakao,Expense,transport,-87.76,107216.7
buyer_4,Jorge,50,ES43209504011748589219,TRX_N-00333-57085009,2022-03-01T16:12:03,Galdakao,transfer,Salary,2956.3,110173.0
buyer_4,Jorge,50,ES43209504011748589219,TRX_N-00334-51454628,2022-03-01T16:12:03,Galdakao,transfer,Partner Salary,2643.03,112816.03
buyer_4,Jorge,50,ES43209504011748589219,TRX_N-00335-60196570,2022-03-01T16:12:03,Galdakao,transfer,Extra Income,295.63,113111.66
buyer_4,Jorge,50,ES43209504011748589219,TRX_N-00336-15383024,2022-03-03T04:07:12,Galdakao,Expense,clothing,-108.75,113002.91
buyer_4,Jorge,50,ES43209504011748589219,TRX_N-00337-81892952,2022-03-05T06:39:40,Galdakao,Housing,Mortgage,-549.47,112453.44
buyer_4,Jorge,50,ES43209504011748589219,TRX_N-00338-43606759,2022-03-05T16:26:03,Galdakao,Basic services,electricity,-68.58,112384.86
buyer_4,Jorge,50,ES43209504011748589219,TRX_N-00339-57369727,2022-03-05T16:19:35,Galdakao,Basic services,gas,-71.84,112313.02
buyer_4,Jorge,50,ES43209504011748589219,TRX_N-00340-25165056,2022-03-05T10:10:13,Galdakao,Basic services,internet,-64.79,112248.23
buyer_4,Jorge,50,ES43209504011748589219,TRX_N-00341-31445170,2022-03-06T11:31:09,Galdakao,Basic services,gas,-15.32,112232.91
buyer_4,Jorge,50,ES43209504011748589219,TRX_N-00342-35484895,2022-03-07T17:08:04,Galdakao,Basic services,electricity,-98.91,112134.0
buyer_4,Jorge,50,ES43209504011748589219,TRX_N-00343-01742337,2022-03-10T19:29:11,Alegría-Dulantzi,Expense,food,-504.97,111629.03
buyer_4,Jorge,50,ES43209504011748589219,TRX_N-00344-50021860,2022-03-21T11:21:49,Galdakao,Expense,food,-491.22,111137.81
buyer_4,Jorge,50,ES43209504011748589219,TRX_N-00345-98613103,2022-03-22T13:17:36,Galdakao,Expense,travel,-2938.36,108199.45
buyer_4,Jorge,50,ES43209504011748589219,TRX_N-00346-23919045,2022-04-01T12:09:42,Galdakao,transfer,Salary,2956.3,111155.75
buyer_4,Jorge,50,ES43209504011748589219,TRX_N-00347-38105967,2022-04-01T12:09:42,Galdakao,transfer,Partner Salary,2643.03,113798.78
buyer_4,Jorge,50,ES43209504011748589219,TRX_N-00348-02518354,2022-04-05T14:48:43,Galdakao,Housing,Mortgage,-549.47,113249.31
buyer_4,Jorge,50,ES43209504011748589219,TRX_N-00349-97202372,2022-04-05T21:02:41,Galdakao,Basic services,phone,-69.46,113179.85
buyer_4,Jorge,50,ES43209504011748589219,TRX_N-00350-69407153,2022-04-06T13:44:20,Galdakao,Basic services,electricity,-83.37,113096.48
buyer_4,Jorge,50,ES43209504011748589219,TRX_N-00351-49452923,2022-04-06T20:11:04,Galdakao,Basic services,internet,-50.21,113046.27
buyer_4,Jorge,50,ES43209504011748589219,TRX_N-00352-48673430,2022-04-06T16:33:25,Galdakao,Basic services,phone,-29.53,113016.74
buyer_4,Jorge,50,ES43209504011748589219,TRX_N-00353-44400877,2022-04-07T08:28:15,Galdakao,Basic services,water,-20.9,112995.84
buyer_4,Jorge,50,ES43209504011748589219,TRX_N-00354-78112796,2022-04-07T17:44:20,Galdakao,Expense,food,-469.58,112526.26
buyer_4,Jorge,50,ES43209504011748589219,TRX_N-00355-50838343,2022-04-26T16:30:15,Andoain,Expense,food,-467.26,112059.0
buyer_4,Jorge,50,ES43209504011748589219,TRX_N-00356-16671422,2022-05-01T10:08:42,Galdakao,transfer,Salary,2956.3,115015.3
buyer_4,Jorge,50,ES43209504011748589219,TRX_N-00357-04806618,2022-05-01T10:08:42,Galdakao,transfer,Partner Salary,2643.03,117658.33
buyer_4,Jorge,50,ES43209504011748589219,TRX_N-00358-11748254,2022-05-01T10:08:42,Galdakao,transfer,Extra Income,295.63,117953.96
buyer_4,Jorge,50,ES43209504011748589219,TRX_N-00359-92459026,2022-05-05T10:14:31,Galdakao,Housing,Mortgage,-549.47,117404.49
buyer_4,Jorge,50,ES43209504011748589219,TRX_N-00360-73401298,2022-05-05T11:34:29,Galdakao,Basic services,gas,-68.06,117336.43
buyer_4,Jorge,50,ES43209504011748589219,TRX_N-00361-56828144,2022-05-06T23:54:04,Galdakao,Basic services,electricity,-140.55,117195.88
buyer_4,Jorge,50,ES43209504011748589219,TRX_N-00362-86182610,2022-05-06T13:43:19,Galdakao,Basic services,internet,-43.48,117152.4
buyer_4,Jorge,50,ES43209504011748589219,TRX_N-00363-48947560,2022-05-06T17:34:56,Galdakao,Basic services,phone,-75.97,117076.43
buyer_4,Jorge,50,ES43209504011748589219,TRX_N-00364-85907168,2022-05-07T22:20:58,Galdakao,Basic services,water,-18.7,117057.73
buyer_4,Jorge,50,ES43209504011748589219,TRX_N-00365-94157271,2022-05-07T09:45:57,Galdakao,Basic services,electricity,-39.11,117018.62
buyer_4,Jorge,50,ES43209504011748589219,TRX_N-00366-87013413,2022-05-13T08:37:32,Galdakao,Expense,transport,-95.97,116922.65
buyer_4,Jorge,50,ES43209504011748589219,TRX_N-00367-44262676,2022-05-23T10:24:11,Galdakao,Expense,transport,-185.77,116736.88
buyer_4,Jorge,50,ES43209504011748589219,TRX_N-00368-27363036,2022-05-25T13:17:03,Galdakao,Expense,education,-323.54,116413.34
buyer_4,Jorge,50,ES43209504011748589219,TRX_N-00369-50902620,2022-05-29T12:09:06,Galdakao,Expense,transport,-131.41,116281.93
buyer_4,Jorge,50,ES43209504011748589219,TRX_N-00370-81247080,2022-06-01T20:06:56,Galdakao,transfer,Salary,2956.3,119238.23
buyer_4,Jorge,50,ES43209504011748589219,TRX_N-00371-27031179,2022-06-01T20:06:56,Galdakao,transfer,Partner Salary,2643.03,121881.26
buyer_4,Jorge,50,ES43209504011748589219,TRX_N-00372-42637406,2022-06-01T20:06:56,Galdakao,transfer,Bonus,2681.96,124563.22
buyer_4,Jorge,50,ES43209504011748589219,TRX_N-00373-05249484,2022-06-05T08:59:39,Galdakao,Housing,Mortgage,-549.47,124013.75
buyer_4,Jorge,50,ES43209504011748589219,TRX_N-00374-69331929,2022-06-05T17:05:41,Galdakao,Basic services,water,-76.49,123937.26
buyer_4,Jorge,50,ES43209504011748589219,TRX_N-00375-85934807,2022-06-05T14:13:26,Galdakao,Basic services,electricity,-129.55,123807.71
buyer_4,Jorge,50,ES43209504011748589219,TRX_N-00376-26086395,2022-06-05T10:06:36,Galdakao,Basic services,gas,-88.03,123719.68
buyer_4,Jorge,50,ES43209504011748589219,TRX_N-00377-83256476,2022-06-06T14:40:19,Galdakao,Basic services,water,-69.61,123650.07
buyer_4,Jorge,50,ES43209504011748589219,TRX_N-00378-15884371,2022-06-06T05:59:00,Galdakao,Basic services,electricity,-134.34,123515.73
buyer_4,Jorge,50,ES43209504011748589219,TRX_N-00379-10989599,2022-06-07T11:56:58,Galdakao,Basic services,electricity,-79.15,123436.58
buyer_4,Jorge,50,ES43209504011748589219,TRX_N-00380-74284234,2022-06-07T16:58:06,Galdakao,Basic services,gas,-77.56,123359.02
buyer_4,Jorge,50,ES43209504011748589219,TRX_N-00381-58934573,2022-06-07T08:12:22,Galdakao,Basic services,phone,-45.01,123314.01
buyer_4,Jorge,50,ES43209504011748589219,TRX_N-00382-38326339,2022-06-14T15:00:41,Galdakao,Expense,transport,-195.99,123118.02
buyer_4,Jorge,50,ES43209504011748589219,TRX_N-00383-35002939,2022-06-29T16:52:00,Galdakao,Expense,leisure,-85.98,123032.04
buyer_4,Jorge,50,ES43209504011748589219,TRX_N-00384-73448652,2022-06-30T10:00:17,Galdakao,Expense,food,-531.4,122500.64
buyer_4,Jorge,50,ES43209504011748589219,TRX_N-00385-89787872,2022-07-01T10:55:22,Galdakao,transfer,Salary,2956.3,125456.94
buyer_4,Jorge,50,ES43209504011748589219,TRX_N-00386-40960211,2022-07-01T10:55:22,Galdakao,transfer,Partner Salary,2643.03,128099.97
buyer_4,Jorge,50,ES43209504011748589219,TRX_N-00387-72372096,2022-07-01T10:55:22,Galdakao,transfer,Extra Income,295.63,128395.6
buyer_4,Jorge,50,ES43209504011748589219,TRX_N-00388-17008178,2022-07-05T05:19:07,Galdakao,Housing,Mortgage,-549.47,127846.13
buyer_4,Jorge,50,ES43209504011748589219,TRX_N-00389-90952188,2022-07-05T09:59:00,Galdakao,Basic services,water,-48.15,127797.98
buyer_4,Jorge,50,ES43209504011748589219,TRX_N-00390-23897958,2022-07-05T10:24:48,Galdakao,Basic services,gas,-45.27,127752.71
buyer_4,Jorge,50,ES43209504011748589219,TRX_N-00391-53357067,2022-07-05T21:52:42,Galdakao,Basic services,internet,-61.74,127690.97
buyer_4,Jorge,50,ES43209504011748589219,TRX_N-00392-61539736,2022-07-06T11:27:19,Galdakao,Basic services,gas,-86.35,127604.62
buyer_4,Jorge,50,ES43209504011748589219,TRX_N-00393-18753268,2022-07-06T13:05:51,Galdakao,Basic services,phone,-59.54,127545.08
buyer_4,Jorge,50,ES43209504011748589219,TRX_N-00394-29512514,2022-07-07T15:28:24,Galdakao,Basic services,electricity,-105.8,127439.28
buyer_4,Jorge,50,ES43209504011748589219,TRX_N-00395-09052537,2022-07-07T15:11:37,Galdakao,Basic services,phone,-78.25,127361.03
buyer_4,Jorge,50,ES43209504011748589219,TRX_N-00396-11277840,2022-07-10T13:30:01,Galdakao,Expense,food,-229.5,127131.53
buyer_4,Jorge,50,ES43209504011748589219,TRX_N-00397-93414173,2022-07-12T12:05:26,Galdakao,Expense,gifts,-491.38,126640.15
buyer_4,Jorge,50,ES43209504011748589219,TRX_N-00398-10218707,2022-07-21T14:17:46,Galdakao,Expense,transport,-53.52,126586.63
buyer_4,Jorge,50,ES43209504011748589219,TRX_N-00399-90692616,2022-07-25T19:41:06,Galdakao,Expense,transport,-36.04,126550.59
buyer_4,Jorge,50,ES43209504011748589219,TRX_N-00400-43613856,2022-07-30T05:14:38,Berango,Expense,leisure,-289.55,126261.04
buyer_4,Jorge,50,ES43209504011748589219,TRX_N-00401-15736839,2022-08-01T19:25:46,Galdakao,transfer,Salary,2956.3,129217.34
buyer_4,Jorge,50,ES43209504011748589219,TRX_N-00402-44160388,2022-08-01T19:25:46,Galdakao,transfer,Partner Salary,2643.03,131860.37
buyer_4,Jorge,50,ES43209504011748589219,TRX_N-00403-29464509,2022-08-05T19:34:41,Galdakao,Housing,Mortgage,-549.47,131310.9
buyer_4,Jorge,50,ES43209504011748589219,TRX_N-00404-70554224,2022-08-05T15:56:51,Galdakao,Basic services,electricity,-97.87,131213.03
buyer_4,Jorge,50,ES43209504011748589219,TRX_N-00405-90391796,2022-08-05T13:46:19,Galdakao,Basic services,gas,-57.48,131155.55
buyer_4,Jorge,50,ES43209504011748589219,TRX_N-00406-23880753,2022-08-05T14:45:42,Galdakao,Basic services,phone,-68.62,131086.93
buyer_4,Jorge,50,ES43209504011748589219,TRX_N-00407-62958482,2022-08-07T16:56:24,Galdakao,Basic services,water,-23.26,131063.67
buyer_4,Jorge,50,ES43209504011748589219,TRX_N-00408-83482861,2022-08-07T05:34:37,Galdakao,Basic services,electricity,-81.79,130981.88
buyer_4,Jorge,50,ES43209504011748589219,TRX_N-00409-70793756,2022-08-19T11:08:18,Galdakao,Expense,transport,-23.59,130958.29
buyer_4,Jorge,50,ES43209504011748589219,TRX_N-00410-92669722,2022-08-19T13:25:31,Erandio,Expense,repairs,-366.06,130592.23
buyer_4,Jorge,50,ES43209504011748589219,TRX_N-00411-41649713,2022-08-24T09:43:34,Galdakao,Expense,leisure,-65.5,130526.73
buyer_4,Jorge,50,ES43209504011748589219,TRX_N-00412-64825732,2022-08-27T16:53:01,Galdakao,Expense,transport,-92.65,130434.08
buyer_4,Jorge,50,ES43209504011748589219,TRX_N-00413-30679854,2022-08-30T08:41:58,Galdakao,Expense,repairs,-365.28,130068.8
buyer_4,Jorge,50,ES43209504011748589219,TRX_N-00414-18969801,2022-08-31T17:31:43,Galdakao,Expense,food,-531.96,129536.84
buyer_4,Jorge,50,ES43209504011748589219,TRX_N-00415-97562640,2022-09-01T16:59:31,Galdakao,transfer,Salary,2956.3,132493.14
buyer_4,Jorge,50,ES43209504011748589219,TRX_N-00416-46715505,2022-09-01T16:59:31,Galdakao,transfer,Partner Salary,2643.03,135136.17
buyer_4,Jorge,50,ES43209504011748589219,TRX_N-00417-26475980,2022-09-05T10:58:30,Galdakao,Housing,Mortgage,-549.47,134586.7
buyer_4,Jorge,50,ES43209504011748589219,TRX_N-00418-12637500,2022-09-05T12:04:23,Galdakao,Basic services,phone,-21.3,134565.4
buyer_4,Jorge,50,ES43209504011748589219,TRX_N-00419-95668593,2022-09-06T14:10:27,Galdakao,Basic services,water,-43.26,134522.14
buyer_4,Jorge,50,ES43209504011748589219,TRX_N-00420-10174762,2022-09-06T20:13:46,Galdakao,Basic services,electricity,-78.53,134443.61
buyer_4,Jorge,50,ES43209504011748589219,TRX_N-00421-29579009,2022-09-06T11:46:15,Galdakao,Basic services,internet,-73.04,134370.57
buyer_4,Jorge,50,ES43209504011748589219,TRX_N-00422-44284790,2022-09-07T14:45:55,Galdakao,Basic services,gas,-79.77,134290.8
buyer_4,Jorge,50,ES43209504011748589219,TRX_N-00423-96731569,2022-10-01T23:13:28,Galdakao,transfer,Salary,2956.3,137247.1
buyer_4,Jorge,50,ES43209504011748589219,TRX_N-00424-16370243,2022-10-01T23:13:28,Galdakao,transfer,Partner Salary,2643.03,139890.13
buyer_4,Jorge,50,ES43209504011748589219,TRX_N-00425-11039179,2022-10-01T23:13:28,Galdakao,transfer,Extra Income,295.63,140185.76
buyer_4,Jorge,50,ES43209504011748589219,TRX_N-00426-73480875,2022-10-01T14:57:46,Galdakao,Expense,food,-608.91,139576.85
buyer_4,Jorge,50,ES43209504011748589219,TRX_N-00427-87026452,2022-10-02T15:28:59,Galdakao,Expense,transport,-83.42,139493.43
buyer_4,Jorge,50,ES43209504011748589219,TRX_N-00428-84954512,2022-10-05T13:30:02,Galdakao,Housing,Mortgage,-549.47,138943.96
buyer_4,Jorge,50,ES43209504011748589219,TRX_N-00429-03870759,2022-10-05T12:33:49,Galdakao,Basic services,electricity,-116.4,138827.56
buyer_4,Jorge,50,ES43209504011748589219,TRX_N-00430-68368509,2022-10-06T19:59:59,Galdakao,Basic services,phone,-38.87,138788.69
buyer_4,Jorge,50,ES43209504011748589219,TRX_N-00431-81955951,2022-10-30T18:06:05,Galdakao,Expense,leisure,-266.75,138521.94
buyer_4,Jorge,50,ES43209504011748589219,TRX_N-00432-72391643,2022-11-01T08:07:33,Galdakao,transfer,Salary,2956.3,141478.24
buyer_4,Jorge,50,ES43209504011748589219,TRX_N-00433-52174775,2022-11-01T08:07:33,Galdakao,transfer,Partner Salary,2643.03,144121.27
buyer_4,Jorge,50,ES43209504011748589219,TRX_N-00434-70640572,2022-11-05T22:15:54,Galdakao,Housing,Mortgage,-549.47,143571.8
buyer_4,Jorge,50,ES43209504011748589219,TRX_N-00435-80643065,2022-11-05T14:35:30,Galdakao,Basic services,internet,-49.08,143522.72
buyer_4,Jorge,50,ES43209504011748589219,TRX_N-00436-93913382,2022-11-05T11:21:15,Galdakao,Basic services,phone,-43.13,143479.59
buyer_4,Jorge,50,ES43209504011748589219,TRX_N-00437-34650867,2022-11-07T08:32:44,Galdakao,Basic services,gas,-81.63,143397.96
buyer_4,Jorge,50,ES43209504011748589219,TRX_N-00438-84928933,2022-11-07T19:29:45,Galdakao,Basic services,internet,-48.25,143349.71
buyer_4,Jorge,50,ES43209504011748589219,TRX_N-00439-91898808,2022-11-07T21:27:37,Galdakao,Basic services,phone,-66.25,143283.46
buyer_4,Jorge,50,ES43209504011748589219,TRX_N-00440-26253589,2022-11-07T15:32:43,Alegría-Dulantzi,Expense,transport,-194.04,143089.42
buyer_4,Jorge,50,ES43209504011748589219,TRX_N-00441-27349051,2022-11-18T15:22:46,Hernani,Expense,food,-675.34,142414.08
buyer_4,Jorge,50,ES43209504011748589219,TRX_N-00442-52185965,2022-12-01T09:31:36,Galdakao,transfer,Salary,2956.3,145370.38
buyer_4,Jorge,50,ES43209504011748589219,TRX_N-00443-98079577,2022-12-01T09:31:36,Galdakao,transfer,Partner Salary,2643.03,148013.41
buyer_4,Jorge,50,ES43209504011748589219,TRX_N-00444-68517803,2022-12-01T09:31:36,Galdakao,transfer,Bonus,3171.74,151185.15
buyer_4,Jorge,50,ES43209504011748589219,TRX_N-00445-50801712,2022-12-02T19:49:16,Galdakao,Expense,transport,-54.25,151130.9
buyer_4,Jorge,50,ES43209504011748589219,TRX_N-00446-86807251,2022-12-05T08:17:09,Galdakao,Housing,Mortgage,-549.47,150581.43
buyer_4,Jorge,50,ES43209504011748589219,TRX_N-00447-42837335,2022-12-06T13:24:25,Galdakao,Basic services,water,-48.21,150533.22
buyer_4,Jorge,50,ES43209504011748589219,TRX_N-00448-94704813,2022-12-06T12:19:16,Galdakao,Basic services,internet,-52.1,150481.12
buyer_4,Jorge,50,ES43209504011748589219,TRX_N-00449-86123705,2022-12-07T12:58:35,Galdakao,Basic services,electricity,-98.01,150383.11
buyer_4,Jorge,50,ES43209504011748589219,TRX_N-00450-53824348,2022-12-25T13:51:35,Galdakao,Expense,education,-573.19,149809.92
buyer_4,Jorge,50,ES43209504011748589219,TRX_N-00451-28002422,2023-01-01T14:16:07,Galdakao,transfer,Salary,2956.3,152766.22
buyer_4,Jorge,50,ES43209504011748589219,TRX_N-00452-07839130,2023-01-01T14:16:07,Galdakao,transfer,Partner Salary,2643.03,155409.25
buyer_4,Jorge,50,ES43209504011748589219,TRX_N-00453-89191136,2023-01-01T14:16:07,Galdakao,transfer,Extra Income,295.63,155704.88
buyer_4,Jorge,50,ES43209504011748589219,TRX_N-00454-37770489,2023-01-05T20:57:08,Galdakao,Housing,Mortgage,-549.47,155155.41
buyer_4,Jorge,50,ES43209504011748589219,TRX_N-00455-37224061,2023-01-05T15:21:52,Galdakao,Basic services,gas,-25.62,155129.79
buyer_4,Jorge,50,ES43209504011748589219,TRX_N-00456-75601763,2023-01-05T13:39:58,Galdakao,Basic services,internet,-38.06,155091.73
buyer_4,Jorge,50,ES43209504011748589219,TRX_N-00457-30825611,2023-01-06T14:13:04,Galdakao,Basic services,water,-77.41,155014.32
buyer_4,Jorge,50,ES43209504011748589219,TRX_N-00458-94676964,2023-01-06T08:35:32,Galdakao,Basic services,electricity,-93.64,154920.68
buyer_4,Jorge,50,ES43209504011748589219,TRX_N-00459-27554650,2023-01-07T15:37:51,Galdakao,Basic services,electricity,-106.89,154813.79
buyer_4,Jorge,50,ES43209504011748589219,TRX_N-00460-66691484,2023-01-07T20:19:09,Galdakao,Basic services,phone,-75.31,154738.48
buyer_4,Jorge,50,ES43209504011748589219,TRX_N-00461-55354423,2023-01-18T17:28:34,Galdakao,Expense,transport,-123.62,154614.86
buyer_4,Jorge,50,ES43209504011748589219,TRX_N-00462-79872526,2023-01-23T22:43:16,Galdakao,Expense,travel,-2681.54,151933.32
buyer_4,Jorge,50,ES43209504011748589219,TRX_N-00463-20365752,2023-01-24T17:10:50,Galdakao,Expense,clothing,-360.17,151573.15
buyer_4,Jorge,50,ES43209504011748589219,TRX_N-00464-23517896,2023-01-27T09:26:27,Galdakao,Expense,food,-461.37,151111.78
buyer_4,Jorge,50,ES43209504011748589219,TRX_N-00465-02221640,2023-01-29T05:14:29,Galdakao,Expense,food,-395.04,150716.74
buyer_4,Jorge,50,ES43209504011748589219,TRX_N-00466-15347734,2023-01-29T14:14:49,Galdakao,Expense,transport,-163.27,150553.47
buyer_4,Jorge,50,ES43209504011748589219,TRX_N-00467-98707071,2023-02-01T17:57:55,Galdakao,transfer,Salary,2956.3,153509.77
buyer_4,Jorge,50,ES43209504011748589219,TRX_N-00468-88631536,2023-02-01T17:57:55,Galdakao,transfer,Partner Salary,2643.03,156152.8
buyer_4,Jorge,50,ES43209504011748589219,TRX_N-00469-06726080,2023-02-02T13:51:39,Donostia,Expense,gifts,-389.11,155763.69
buyer_4,Jorge,50,ES43209504011748589219,TRX_N-00470-41524651,2023-02-03T13:07:35,Sopela,Expense,travel,-1197.62,154566.07
buyer_4,Jorge,50,ES43209504011748589219,TRX_N-00471-41659605,2023-02-05T17:28:12,Galdakao,Housing,Mortgage,-549.47,154016.6
buyer_4,Jorge,50,ES43209504011748589219,TRX_N-00472-30553791,2023-02-05T16:35:07,Galdakao,Basic services,water,-78.86,153937.74
buyer_4,Jorge,50,ES43209504011748589219,TRX_N-00473-02208305,2023-02-05T16:20:19,Galdakao,Basic services,electricity,-139.81,153797.93
buyer_4,Jorge,50,ES43209504011748589219,TRX_N-00474-99357007,2023-02-06T16:26:06,Galdakao,Basic services,electricity,-53.21,153744.72
buyer_4,Jorge,50,ES43209504011748589219,TRX_N-00475-68862790,2023-02-07T10:09:07,Galdakao,Basic services,gas,-58.15,153686.57
buyer_4,Jorge,50,ES43209504011748589219,TRX_N-00476-09570892,2023-02-07T16:12:48,Galdakao,Basic services,phone,-56.18,153630.39
buyer_4,Jorge,50,ES43209504011748589219,TRX_N-00477-04376385,2023-02-16T10:09:01,Galdakao,Expense,food,-369.29,153261.1
buyer_4,Jorge,50,ES43209504011748589219,TRX_N-00478-16032097,2023-02-18T10:06:30,Andoain,Expense,clothing,-482.38,152778.72
buyer_4,Jorge,50,ES43209504011748589219,TRX_N-00479-42167340,2023-02-19T13:02:49,Galdakao,Expense,transport,-27.75,152750.97
buyer_4,Jorge,50,ES43209504011748589219,TRX_N-00480-61006311,2023-02-24T19:13:39,Llodio,Expense,food,-627.67,152123.3
buyer_4,Jorge,50,ES43209504011748589219,TRX_N-00481-09331650,2023-02-26T15:13:04,Galdakao,Expense,leisure,-200.19,151923.11
buyer_4,Jorge,50,ES43209504011748589219,TRX_N-00482-07589722,2023-02-28T11:45:05,Galdakao,Expense,clothing,-112.42,151810.69
buyer_4,Jorge,50,ES43209504011748589219,TRX_N-00483-24200505,2023-03-01T16:31:53,Galdakao,transfer,Salary,2956.3,154766.99
buyer_4,Jorge,50,ES43209504011748589219,TRX_N-00484-45766039,2023-03-01T16:31:53,Galdakao,transfer,Partner Salary,2643.03,157410.02
buyer_4,Jorge,50,ES43209504011748589219,TRX_N-00485-81129760,2023-03-01T16:31:53,Galdakao,transfer,Extra Income,295.63,157705.65
buyer_4,Jorge,50,ES43209504011748589219,TRX_N-00486-94839685,2023-03-03T19:34:59,Galdakao,Expense,food,-696.54,157009.11
buyer_4,Jorge,50,ES43209504011748589219,TRX_N-00487-32618060,2023-03-05T23:38:49,Galdakao,Housing,Mortgage,-549.47,156459.64
buyer_4,Jorge,50,ES43209504011748589219,TRX_N-00488-52637298,2023-03-05T18:59:31,Galdakao,Basic services,gas,-45.06,156414.58
buyer_4,Jorge,50,ES43209504011748589219,TRX_N-00489-46397979,2023-03-05T19:15:39,Galdakao,Basic services,phone,-38.73,156375.85
buyer_4,Jorge,50,ES43209504011748589219,TRX_N-00490-97319884,2023-03-06T15:11:51,Galdakao,Basic services,water,-31.47,156344.38
buyer_4,Jorge,50,ES43209504011748589219,TRX_N-00491-30641061,2023-03-06T14:47:17,Galdakao,Basic services,gas,-70.4,156273.98
buyer_4,Jorge,50,ES43209504011748589219,TRX_N-00492-25496135,2023-03-07T11:04:17,Galdakao,Basic services,electricity,-114.87,156159.11
buyer_4,Jorge,50,ES43209504011748589219,TRX_N-00493-72699273,2023-03-07T22:26:59,Galdakao,Basic services,internet,-38.59,156120.52
buyer_4,Jorge,50,ES43209504011748589219,TRX_N-00494-51116453,2023-03-10T17:57:23,Galdakao,Expense,leisure,-209.27,155911.25
buyer_4,Jorge,50,ES43209504011748589219,TRX_N-00495-58679048,2023-03-13T21:56:24,Galdakao,Expense,food,-295.72,155615.53
buyer_4,Jorge,50,ES43209504011748589219,TRX_N-00496-55399804,2023-03-21T09:26:36,Galdakao,Expense,leisure,-49.32,155566.21
buyer_4,Jorge,50,ES43209504011748589219,TRX_N-00497-21707640,2023-04-01T22:28:03,Galdakao,transfer,Salary,2956.3,158522.51
buyer_4,Jorge,50,ES43209504011748589219,TRX_N-00498-58091550,2023-04-01T22:28:03,Galdakao,transfer,Partner Salary,2643.03,161165.54
buyer_4,Jorge,50,ES43209504011748589219,TRX_N-00499-19934239,2023-04-05T05:04:41,Galdakao,Housing,Mortgage,-549.47,160616.07
buyer_4,Jorge,50,ES43209504011748589219,TRX_N-00500-07792524,2023-04-05T06:23:29,Galdakao,Basic services,water,-10.06,160606.01
buyer_4,Jorge,50,ES43209504011748589219,TRX_N-00501-05152490,2023-04-06T15:25:52,Galdakao,Expense,leisure,-292.8,160313.21
buyer_4,Jorge,50,ES43209504011748589219,TRX_N-00502-47034105,2023-04-07T11:37:56,Galdakao,Basic services,electricity,-41.8,160271.41
buyer_4,Jorge,50,ES43209504011748589219,TRX_N-00503-89568315,2023-04-07T16:38:40,Galdakao,Basic services,gas,-70.82,160200.59
buyer_4,Jorge,50,ES43209504011748589219,TRX_N-00504-82108976,2023-04-07T21:42:41,Galdakao,Expense,healthcare,-368.02,159832.57
buyer_4,Jorge,50,ES43209504011748589219,TRX_N-00505-47718745,2023-04-22T11:31:14,Galdakao,Expense,food,-430.37,159402.2
buyer_4,Jorge,50,ES43209504011748589219,TRX_N-00506-59064393,2023-04-24T18:12:39,Galdakao,Expense,leisure,-193.58,159208.62
buyer_4,Jorge,50,ES43209504011748589219,TRX_N-00507-09931285,2023-04-25T10:53:29,Galdakao,Expense,transport,-42.62,159166.0
buyer_4,Jorge,50,ES43209504011748589219,TRX_N-00508-28202657,2023-04-27T12:45:16,Galdakao,Expense,transport,-48.82,159117.18
buyer_4,Jorge,50,ES43209504011748589219,TRX_N-00509-99614805,2023-05-01T19:22:56,Galdakao,transfer,Salary,2956.3,162073.48
buyer_4,Jorge,50,ES43209504011748589219,TRX_N-00510-02568396,2023-05-01T19:22:56,Galdakao,transfer,Partner Salary,2643.03,164716.51
buyer_4,Jorge,50,ES43209504011748589219,TRX_N-00511-97744307,2023-05-01T19:22:56,Galdakao,transfer,Extra Income,295.63,165012.14
buyer_4,Jorge,50,ES43209504011748589219,TRX_N-00512-35932557,2023-05-05T08:58:41,Galdakao,Housing,Mortgage,-549.47,164462.67
buyer_4,Jorge,50,ES43209504011748589219,TRX_N-00513-91166183,2023-05-07T12:57:52,Galdakao,Basic services,electricity,-65.87,164396.8
buyer_4,Jorge,50,ES43209504011748589219,TRX_N-00514-63173086,2023-05-07T12:03:36,Galdakao,Basic services,gas,-99.76,164297.04
buyer_4,Jorge,50,ES43209504011748589219,TRX_N-00515-80818981,2023-05-08T10:41:19,Sestao,Expense,food,-764.02,163533.02
buyer_4,Jorge,50,ES43209504011748589219,TRX_N-00516-79817459,2023-05-12T09:14:08,Arrasate/Mondragon,Expense,leisure,-160.14,163372.88
buyer_4,Jorge,50,ES43209504011748589219,TRX_N-00517-65611936,2023-05-14T14:44:30,Iruña de Oca,Expense,education,-606.81,162766.07
buyer_4,Jorge,50,ES43209504011748589219,TRX_N-00518-53321679,2023-05-31T12:30:36,Galdakao,Expense,appliances,-1211.62,161554.45
buyer_4,Jorge,50,ES43209504011748589219,TRX_N-00519-35711708,2023-06-01T12:33:05,Galdakao,transfer,Salary,2956.3,164510.75
buyer_4,Jorge,50,ES43209504011748589219,TRX_N-00520-16265967,2023-06-01T12:33:05,Galdakao,transfer,Partner Salary,2643.03,167153.78
buyer_4,Jorge,50,ES43209504011748589219,TRX_N-00521-09835390,2023-06-01T12:33:05,Galdakao,transfer,Bonus,2909.36,170063.14
buyer_4,Jorge,50,ES43209504011748589219,TRX_N-00522-30708916,2023-06-05T14:50:45,Galdakao,Housing,Mortgage,-549.47,169513.67
buyer_4,Jorge,50,ES43209504011748589219,TRX_N-00523-64544978,2023-06-05T14:54:42,Galdakao,Basic services,water,-25.52,169488.15
buyer_4,Jorge,50,ES43209504011748589219,TRX_N-00524-97442352,2023-06-07T08:51:28,Galdakao,Basic services,phone,-42.82,169445.33
buyer_4,Jorge,50,ES43209504011748589219,TRX_N-00525-32743733,2023-06-17T21:06:02,Galdakao,Expense,transport,-57.53,169387.8
buyer_4,Jorge,50,ES43209504011748589219,TRX_N-00526-98235478,2023-06-18T21:47:48,Galdakao,Expense,clothing,-480.03,168907.77
buyer_4,Jorge,50,ES43209504011748589219,TRX_N-00527-19652953,2023-06-21T13:02:52,Galdakao,Expense,transport,-186.57,168721.2
buyer_4,Jorge,50,ES43209504011748589219,TRX_N-00528-35632817,2023-06-29T22:25:14,Galdakao,Expense,transport,-113.62,168607.58
buyer_4,Jorge,50,ES43209504011748589219,TRX_N-00529-72997390,2023-07-01T10:26:34,Galdakao,transfer,Salary,2956.3,171563.88
buyer_4,Jorge,50,ES43209504011748589219,TRX_N-00530-95752517,2023-07-01T10:26:34,Galdakao,transfer,Partner Salary,2643.03,174206.91
buyer_4,Jorge,50,ES43209504011748589219,TRX_N-00531-38816680,2023-07-01T10:26:34,Galdakao,transfer,Extra Income,295.63,174502.54
buyer_4,Jorge,50,ES43209504011748589219,TRX_N-00532-13726451,2023-07-05T08:39:07,Galdakao,Housing,Mortgage,-549.47,173953.07
buyer_4,Jorge,50,ES43209504011748589219,TRX_N-00533-03184441,2023-07-05T12:03:30,Galdakao,Basic services,electricity,-136.79,173816.28
buyer_4,Jorge,50,ES43209504011748589219,TRX_N-00534-84733703,2023-07-06T12:12:30,Galdakao,Basic services,internet,-57.28,173759.0
buyer_4,Jorge,50,ES43209504011748589219,TRX_N-00535-52091818,2023-07-06T14:30:39,Galdakao,Basic services,phone,-87.55,173671.45
buyer_4,Jorge,50,ES43209504011748589219,TRX_N-00536-34424804,2023-07-07T10:42:27,Galdakao,Basic services,electricity,-108.59,173562.86
buyer_4,Jorge,50,ES43209504011748589219,TRX_N-00537-53238424,2023-07-12T16:12:56,Galdakao,Expense,transport,-50.51,173512.35
buyer_4,Jorge,50,ES43209504011748589219,TRX_N-00538-24026591,2023-07-13T18:53:13,Iruña de Oca,Expense,clothing,-274.3,173238.05
buyer_4,Jorge,50,ES43209504011748589219,TRX_N-00539-29667405,2023-07-16T15:38:03,Galdakao,Expense,food,-246.22,172991.83
buyer_4,Jorge,50,ES43209504011748589219,TRX_N-00540-02368928,2023-07-21T11:26:47,Galdakao,Expense,education,-748.27,172243.56
buyer_4,Jorge,50,ES43209504011748589219,TRX_N-00541-99153504,2023-07-23T18:48:50,Galdakao,Expense,transport,-55.35,172188.21
buyer_4,Jorge,50,ES43209504011748589219,TRX_N-00542-21853079,2023-07-23T17:17:45,Galdakao,Expense,travel,-2234.91,169953.3
buyer_4,Jorge,50,ES43209504011748589219,TRX_N-00543-36957861,2023-07-24T15:58:20,Galdakao,Expense,travel,-1167.89,168785.41
buyer_4,Jorge,50,ES43209504011748589219,TRX_N-00544-38300677,2023-07-25T09:29:28,Galdakao,Expense,transport,-108.52,168676.89
buyer_4,Jorge,50,ES43209504011748589219,TRX_N-00545-37029925,2023-07-26T20:44:35,Galdakao,Expense,transport,-41.23,168635.66
buyer_4,Jorge,50,ES43209504011748589219,TRX_N-00546-68780669,2023-07-29T15:20:59,Galdakao,Expense,repairs,-422.96,168212.7
buyer_4,Jorge,50,ES43209504011748589219,TRX_N-00547-83088430,2023-08-01T16:24:21,Galdakao,transfer,Salary,2956.3,171169.0
buyer_4,Jorge,50,ES43209504011748589219,TRX_N-00548-64343529,2023-08-01T16:24:21,Galdakao,transfer,Partner Salary,2643.03,173812.03
buyer_4,Jorge,50,ES43209504011748589219,TRX_N-00549-03723074,2023-08-04T11:18:32,Galdakao,Expense,education,-782.11,173029.92
buyer_4,Jorge,50,ES43209504011748589219,TRX_N-00550-41015681,2023-08-05T12:33:59,Galdakao,Housing,Mortgage,-549.47,172480.45
buyer_4,Jorge,50,ES43209504011748589219,TRX_N-00551-75829916,2023-08-05T13:58:56,Galdakao,Basic services,internet,-68.97,172411.48
buyer_4,Jorge,50,ES43209504011748589219,TRX_N-00552-42180243,2023-08-06T17:59:00,Galdakao,Basic services,gas,-56.49,172354.99
buyer_4,Jorge,50,ES43209504011748589219,TRX_N-00553-17929185,2023-08-06T10:47:05,Galdakao,Basic services,internet,-62.41,172292.58
buyer_4,Jorge,50,ES43209504011748589219,TRX_N-00554-78232204,2023-08-07T14:27:35,Galdakao,Basic services,water,-45.18,172247.4
buyer_4,Jorge,50,ES43209504011748589219,TRX_N-00555-49902954,2023-08-10T20:04:07,Arrasate/Mondragon,Expense,leisure,-56.56,172190.84
buyer_4,Jorge,50,ES43209504011748589219,TRX_N-00556-46144965,2023-08-16T09:06:33,Galdakao,Expense,transport,-188.75,172002.09
buyer_4,Jorge,50,ES43209504011748589219,TRX_N-00557-46196629,2023-09-01T02:12:09,Galdakao,transfer,Salary,2956.3,174958.39
buyer_4,Jorge,50,ES43209504011748589219,TRX_N-00558-79538464,2023-09-01T02:12:09,Galdakao,transfer,Partner Salary,2643.03,177601.42
buyer_4,Jorge,50,ES43209504011748589219,TRX_N-00559-32724418,2023-09-01T02:12:09,Galdakao,transfer,Extra Income,295.63,177897.05
buyer_4,Jorge,50,ES43209504011748589219,TRX_N-00560-79594320,2023-09-05T11:40:21,Galdakao,Housing,Mortgage,-549.47,177347.58
buyer_4,Jorge,50,ES43209504011748589219,TRX_N-00561-02557013,2023-09-05T20:36:05,Galdakao,Basic services,phone,-87.4,177260.18
buyer_4,Jorge,50,ES43209504011748589219,TRX_N-00562-68354278,2023-09-06T19:01:50,Galdakao,Basic services,water,-39.06,177221.12
buyer_4,Jorge,50,ES43209504011748589219,TRX_N-00563-54160765,2023-09-06T02:22:20,Galdakao,Basic services,electricity,-60.97,177160.15
buyer_4,Jorge,50,ES43209504011748589219,TRX_N-00564-43936412,2023-09-06T11:06:58,Galdakao,Basic services,internet,-67.1,177093.05
buyer_4,Jorge,50,ES43209504011748589219,TRX_N-00565-66997157,2023-09-07T19:13:03,Galdakao,Basic services,electricity,-128.67,176964.38
buyer_4,Jorge,50,ES43209504011748589219,TRX_N-00566-73407998,2023-09-07T09:37:13,Galdakao,Basic services,internet,-52.04,176912.34
buyer_4,Jorge,50,ES43209504011748589219,TRX_N-00567-35432471,2023-09-08T18:04:16,Sestao,Expense,education,-571.03,176341.31
buyer_4,Jorge,50,ES43209504011748589219,TRX_N-00568-01970037,2023-09-09T15:22:26,Galdakao,Expense,clothing,-154.35,176186.96
buyer_4,Jorge,50,ES43209504011748589219,TRX_N-00569-82539221,2023-09-10T15:56:55,Galdakao,Expense,food,-136.16,176050.8
buyer_4,Jorge,50,ES43209504011748589219,TRX_N-00570-96245234,2023-09-27T16:42:40,Galdakao,Expense,healthcare,-276.25,175774.55
buyer_4,Jorge,50,ES43209504011748589219,TRX_N-00571-89739114,2023-10-01T21:48:50,Galdakao,transfer,Salary,2956.3,178730.85
buyer_4,Jorge,50,ES43209504011748589219,TRX_N-00572-22304215,2023-10-01T21:48:50,Galdakao,transfer,Partner Salary,2643.03,181373.88
buyer_4,Jorge,50,ES43209504011748589219,TRX_N-00573-25736874,2023-10-03T20:56:36,Lasarte-Oria,Expense,healthcare,-83.83,181290.05
buyer_4,Jorge,50,ES43209504011748589219,TRX_N-00574-60149669,2023-10-05T19:28:58,Galdakao,Housing,Mortgage,-549.47,180740.58
buyer_4,Jorge,50,ES43209504011748589219,TRX_N-00575-09848414,2023-10-05T12:26:12,Galdakao,Basic services,water,-36.06,180704.52
buyer_4,Jorge,50,ES43209504011748589219,TRX_N-00576-58722278,2023-10-05T21:48:52,Galdakao,Basic services,electricity,-44.19,180660.33
buyer_4,Jorge,50,ES43209504011748589219,TRX_N-00577-86250870,2023-10-05T14:54:39,Galdakao,Basic services,internet,-34.5,180625.83
buyer_4,Jorge,50,ES43209504011748589219,TRX_N-00578-08146199,2023-10-06T22:14:29,Galdakao,Basic services,water,-49.97,180575.86
buyer_4,Jorge,50,ES43209504011748589219,TRX_N-00579-75654163,2023-10-06T11:56:59,Galdakao,Basic services,internet,-64.51,180511.35
buyer_4,Jorge,50,ES43209504011748589219,TRX_N-00580-25203210,2023-10-06T20:08:58,Galdakao,Basic services,phone,-69.16,180442.19
buyer_4,Jorge,50,ES43209504011748589219,TRX_N-00581-36967980,2023-10-07T04:14:15,Galdakao,Basic services,water,-22.05,180420.14
buyer_4,Jorge,50,ES43209504011748589219,TRX_N-00582-03984487,2023-10-07T11:15:09,Galdakao,Basic services,gas,-54.04,180366.1
buyer_4,Jorge,50,ES43209504011748589219,TRX_N-00583-30170657,2023-10-07T06:45:07,Galdakao,Basic services,internet,-55.63,180310.47
buyer_4,Jorge,50,ES43209504011748589219,TRX_N-00584-19657218,2023-10-07T20:26:20,Galdakao,Basic services,phone,-64.83,180245.64
buyer_4,Jorge,50,ES43209504011748589219,TRX_N-00585-73929094,2023-10-14T19:08:35,Galdakao,Expense,food,-430.19,179815.45
buyer_4,Jorge,50,ES43209504011748589219,TRX_N-00586-19160851,2023-10-19T23:38:17,Donostia,Expense,clothing,-81.55,179733.9
buyer_4,Jorge,50,ES43209504011748589219,TRX_N-00587-02320719,2023-10-20T21:00:27,Galdakao,Expense,food,-378.11,179355.79
buyer_4,Jorge,50,ES43209504011748589219,TRX_N-00588-27277055,2023-10-21T09:48:18,Galdakao,Expense,transport,-139.64,179216.15
buyer_4,Jorge,50,ES43209504011748589219,TRX_N-00589-82348065,2023-11-01T17:54:52,Galdakao,transfer,Salary,2956.3,182172.45
buyer_4,Jorge,50,ES43209504011748589219,TRX_N-00590-05260023,2023-11-01T17:54:52,Galdakao,transfer,Partner Salary,2643.03,184815.48
buyer_4,Jorge,50,ES43209504011748589219,TRX_N-00591-92747459,2023-11-01T17:54:52,Galdakao,transfer,Extra Income,295.63,185111.11
buyer_4,Jorge,50,ES43209504011748589219,TRX_N-00592-21678536,2023-11-05T23:27:52,Galdakao,Housing,Mortgage,-549.47,184561.64
buyer_4,Jorge,50,ES43209504011748589219,TRX_N-00593-75601849,2023-11-05T20:48:15,Galdakao,Basic services,electricity,-70.01,184491.63
buyer_4,Jorge,50,ES43209504011748589219,TRX_N-00594-20898043,2023-11-05T23:29:46,Galdakao,Basic services,phone,-24.82,184466.81
buyer_4,Jorge,50,ES43209504011748589219,TRX_N-00595-87771045,2023-11-06T17:57:23,Galdakao,Basic services,electricity,-43.8,184423.01
buyer_4,Jorge,50,ES43209504011748589219,TRX_N-00596-66510589,2023-11-06T10:16:47,Galdakao,Basic services,gas,-90.95,184332.06
buyer_4,Jorge,50,ES43209504011748589219,TRX_N-00597-35504376,2023-11-06T18:59:55,Galdakao,Basic services,internet,-58.68,184273.38
buyer_4,Jorge,50,ES43209504011748589219,TRX_N-00598-83855763,2023-11-07T18:38:26,Galdakao,Basic services,water,-61.99,184211.39
buyer_4,Jorge,50,ES43209504011748589219,TRX_N-00599-43416534,2023-11-07T05:39:20,Galdakao,Basic services,internet,-43.54,184167.85
buyer_4,Jorge,50,ES43209504011748589219,TRX_N-00600-10759894,2023-11-13T10:47:22,Galdakao,Expense,leisure,-229.3,183938.55
buyer_4,Jorge,50,ES43209504011748589219,TRX_N-00601-79327580,2023-11-16T16:48:05,Galdakao,Expense,food,-249.77,183688.78
buyer_4,Jorge,50,ES43209504011748589219,TRX_N-00602-39215631,2023-12-01T18:14:21,Galdakao,transfer,Salary,2956.3,186645.08
buyer_4,Jorge,50,ES43209504011748589219,TRX_N-00603-50135483,2023-12-01T18:14:21,Galdakao,transfer,Partner Salary,2643.03,189288.11
buyer_4,Jorge,50,ES43209504011748589219,TRX_N-00604-15325826,2023-12-01T18:14:21,Galdakao,transfer,Bonus,2964.85,192252.96
buyer_4,Jorge,50,ES43209504011748589219,TRX_N-00605-56023480,2023-12-02T21:48:13,Berango,Expense,healthcare,-326.3,191926.66
buyer_4,Jorge,50,ES43209504011748589219,TRX_N-00606-46019566,2023-12-05T15:00:59,Galdakao,Housing,Mortgage,-549.47,191377.19
buyer_4,Jorge,50,ES43209504011748589219,TRX_N-00607-98387371,2023-12-05T12:44:34,Galdakao,Basic services,electricity,-148.66,191228.53
buyer_4,Jorge,50,ES43209504011748589219,TRX_N-00608-34973670,2023-12-05T21:36:25,Galdakao,Basic services,phone,-56.76,191171.77
buyer_4,Jorge,50,ES43209504011748589219,TRX_N-00609-03913661,2023-12-06T18:20:06,Galdakao,Expense,healthcare,-20.69,191151.08
buyer_4,Jorge,50,ES43209504011748589219,TRX_N-00610-80790128,2023-12-07T19:09:59,Galdakao,Basic services,phone,-58.37,191092.71
buyer_4,Jorge,50,ES43209504011748589219,TRX_N-00611-16703397,2023-12-08T18:43:53,Galdakao,Expense,leisure,-293.22,190799.49
buyer_4,Jorge,50,ES43209504011748589219,TRX_N-00612-82502631,2023-12-10T14:09:03,Galdakao,Expense,clothing,-219.29,190580.2
buyer_4,Jorge,50,ES43209504011748589219,TRX_N-00613-48437291,2023-12-20T14:16:03,Galdakao,Expense,transport,-80.45,190499.75
buyer_4,Jorge,50,ES43209504011748589219,TRX_N-00614-17095037,2023-12-31T11:42:15,Galdakao,Expense,transport,-128.34,190371.41
buyer_4,Jorge,50,ES43209504011748589219,TRX_N-00615-88815801,2024-01-01T13:27:21,Galdakao,transfer,Salary,2956.3,193327.71
buyer_4,Jorge,50,ES43209504011748589219,TRX_N-00616-25656368,2024-01-01T13:27:21,Galdakao,transfer,Partner Salary,2643.03,195970.74
buyer_4,Jorge,50,ES43209504011748589219,TRX_N-00617-61060019,2024-01-01T13:27:21,Galdakao,transfer,Extra Income,295.63,196266.37
buyer_4,Jorge,50,ES43209504011748589219,TRX_N-00618-63446134,2024-01-05T05:56:03,Galdakao,Housing,Mortgage,-549.47,195716.9
buyer_4,Jorge,50,ES43209504011748589219,TRX_N-00619-59388680,2024-01-05T09:47:52,Galdakao,Basic services,water,-64.68,195652.22
buyer_4,Jorge,50,ES43209504011748589219,TRX_N-00620-80754925,2024-01-05T09:51:09,Galdakao,Basic services,electricity,-55.09,195597.13
buyer_4,Jorge,50,ES43209504011748589219,TRX_N-00621-52173636,2024-01-05T11:32:02,Galdakao,Basic services,gas,-27.08,195570.05
buyer_4,Jorge,50,ES43209504011748589219,TRX_N-00622-87476251,2024-01-06T23:10:55,Galdakao,Basic services,water,-27.59,195542.46
buyer_4,Jorge,50,ES43209504011748589219,TRX_N-00623-28112007,2024-01-07T19:08:30,Galdakao,Basic services,gas,-59.22,195483.24
buyer_4,Jorge,50,ES43209504011748589219,TRX_N-00624-41716816,2024-01-09T16:23:10,Galdakao,Expense,clothing,-342.68,195140.56
buyer_4,Jorge,50,ES43209504011748589219,TRX_N-00625-17953803,2024-01-17T18:27:50,Galdakao,Expense,clothing,-476.93,194663.63
buyer_4,Jorge,50,ES43209504011748589219,TRX_N-00626-54395711,2024-01-30T18:01:17,Galdakao,Expense,healthcare,-222.85,194440.78
buyer_4,Jorge,50,ES43209504011748589219,TRX_N-00627-98881368,2024-02-01T20:36:37,Galdakao,transfer,Salary,2956.3,197397.08
buyer_4,Jorge,50,ES43209504011748589219,TRX_N-00628-55357521,2024-02-01T20:36:37,Galdakao,transfer,Partner Salary,2643.03,200040.11
buyer_4,Jorge,50,ES43209504011748589219,TRX_N-00629-80699307,2024-02-02T19:37:14,Galdakao,Expense,food,-245.96,199794.15
buyer_4,Jorge,50,ES43209504011748589219,TRX_N-00630-02184328,2024-02-05T08:13:34,Galdakao,Housing,Mortgage,-549.47,199244.68
buyer_4,Jorge,50,ES43209504011748589219,TRX_N-00631-73858742,2024-02-06T19:07:28,Galdakao,Basic services,gas,-24.06,199220.62
buyer_4,Jorge,50,ES43209504011748589219,TRX_N-00632-57052025,2024-02-07T13:12:49,Galdakao,Basic services,water,-16.51,199204.11
buyer_4,Jorge,50,ES43209504011748589219,TRX_N-00633-71066919,2024-02-07T20:20:14,Galdakao,Basic services,gas,-98.26,199105.85
buyer_4,Jorge,50,ES43209504011748589219,TRX_N-00634-98359301,2024-02-07T13:55:05,Galdakao,Basic services,internet,-51.01,199054.84
buyer_4,Jorge,50,ES43209504011748589219,TRX_N-00635-51466071,2024-02-13T09:45:49,Andoain,Expense,leisure,-271.62,198783.22
buyer_4,Jorge,50,ES43209504011748589219,TRX_N-00636-93329630,2024-03-01T16:14:56,Galdakao,transfer,Salary,2956.3,201739.52
buyer_4,Jorge,50,ES43209504011748589219,TRX_N-00637-93578226,2024-03-01T16:14:56,Galdakao,transfer,Partner Salary,2643.03,204382.55
buyer_4,Jorge,50,ES43209504011748589219,TRX_N-00638-38954920,2024-03-01T16:14:56,Galdakao,transfer,Extra Income,295.63,204678.18
buyer_4,Jorge,50,ES43209504011748589219,TRX_N-00639-69659380,2024-03-01T19:47:21,Galdakao,Expense,food,-400.95,204277.23
buyer_4,Jorge,50,ES43209504011748589219,TRX_N-00640-17481188,2024-03-05T17:06:22,Galdakao,Housing,Mortgage,-549.47,203727.76
buyer_4,Jorge,50,ES43209504011748589219,TRX_N-00641-04563378,2024-03-05T08:07:57,Galdakao,Basic services,electricity,-54.57,203673.19
buyer_4,Jorge,50,ES43209504011748589219,TRX_N-00642-18939569,2024-03-05T13:17:24,Galdakao,Expense,transport,-52.68,203620.51
buyer_4,Jorge,50,ES43209504011748589219,TRX_N-00643-77996398,2024-03-06T15:54:55,Galdakao,Basic services,water,-44.78,203575.73
buyer_4,Jorge,50,ES43209504011748589219,TRX_N-00644-11577066,2024-03-06T10:53:17,Galdakao,Basic services,electricity,-108.05,203467.68
buyer_4,Jorge,50,ES43209504011748589219,TRX_N-00645-03668609,2024-03-07T23:03:59,Galdakao,Basic services,internet,-73.92,203393.76
buyer_4,Jorge,50,ES43209504011748589219,TRX_N-00646-46874622,2024-03-11T06:14:13,Mungia,Expense,transport,-154.32,203239.44
buyer_4,Jorge,50,ES43209504011748589219,TRX_N-00647-41666746,2024-03-19T23:31:26,Galdakao,Expense,transport,-141.53,203097.91
buyer_4,Jorge,50,ES43209504011748589219,TRX_N-00648-58355210,2024-03-22T13:37:02,Galdakao,Expense,transport,-101.67,202996.24
buyer_4,Jorge,50,ES43209504011748589219,TRX_N-00649-47118251,2024-03-28T06:14:00,Galdakao,Expense,repairs,-84.52,202911.72
buyer_4,Jorge,50,ES43209504011748589219,TRX_N-00650-52051714,2024-04-01T16:28:57,Galdakao,transfer,Salary,2956.3,205868.02
buyer_4,Jorge,50,ES43209504011748589219,TRX_N-00651-86344724,2024-04-01T16:28:57,Galdakao,transfer,Partner Salary,2643.03,208511.05
buyer_4,Jorge,50,ES43209504011748589219,TRX_N-00652-72157355,2024-04-03T22:14:04,Galdakao,Expense,healthcare,-305.32,208205.73
buyer_4,Jorge,50,ES43209504011748589219,TRX_N-00653-86221280,2024-04-05T17:47:00,Galdakao,Housing,Mortgage,-549.47,207656.26
buyer_4,Jorge,50,ES43209504011748589219,TRX_N-00654-08169239,2024-04-05T22:03:48,Galdakao,Basic services,internet,-70.06,207586.2
buyer_4,Jorge,50,ES43209504011748589219,TRX_N-00655-85723037,2024-04-05T13:43:52,Galdakao,Basic services,phone,-66.97,207519.23
buyer_4,Jorge,50,ES43209504011748589219,TRX_N-00656-47778199,2024-04-06T14:48:22,Galdakao,Basic services,water,-49.53,207469.7
buyer_4,Jorge,50,ES43209504011748589219,TRX_N-00657-70413700,2024-04-06T11:08:27,Galdakao,Basic services,phone,-77.57,207392.13
buyer_4,Jorge,50,ES43209504011748589219,TRX_N-00658-83280212,2024-04-18T15:17:09,Galdakao,Expense,repairs,-947.32,206444.81
buyer_4,Jorge,50,ES43209504011748589219,TRX_N-00659-98403049,2024-04-22T18:58:41,Galdakao,Expense,leisure,-141.84,206302.97
buyer_4,Jorge,50,ES43209504011748589219,TRX_N-00660-00565349,2024-04-24T19:45:00,Erandio,Expense,travel,-2851.46,203451.51
buyer_4,Jorge,50,ES43209504011748589219,TRX_N-00661-62610536,2024-04-25T10:51:59,Galdakao,Expense,gifts,-482.34,202969.17
buyer_4,Jorge,50,ES43209504011748589219,TRX_N-00662-54094289,2024-05-01T16:06:11,Galdakao,transfer,Salary,2956.3,205925.47
buyer_4,Jorge,50,ES43209504011748589219,TRX_N-00663-72661966,2024-05-01T16:06:11,Galdakao,transfer,Partner Salary,2643.03,208568.5
buyer_4,Jorge,50,ES43209504011748589219,TRX_N-00664-34761895,2024-05-01T16:06:11,Galdakao,transfer,Extra Income,295.63,208864.13
buyer_4,Jorge,50,ES43209504011748589219,TRX_N-00665-23531123,2024-05-05T03:19:21,Galdakao,Housing,Mortgage,-549.47,208314.66
buyer_4,Jorge,50,ES43209504011748589219,TRX_N-00666-65076248,2024-05-05T11:05:30,Galdakao,Basic services,water,-43.85,208270.81
buyer_4,Jorge,50,ES43209504011748589219,TRX_N-00667-32704316,2024-05-05T20:00:50,Galdakao,Basic services,gas,-69.69,208201.12
buyer_4,Jorge,50,ES43209504011748589219,TRX_N-00668-59656939,2024-05-05T23:47:24,Galdakao,Basic services,internet,-38.52,208162.6
buyer_4,Jorge,50,ES43209504011748589219,TRX_N-00669-44709829,2024-05-05T10:14:33,Galdakao,Basic services,phone,-55.02,208107.58
buyer_4,Jorge,50,ES43209504011748589219,TRX_N-00670-73048401,2024-05-06T18:38:11,Galdakao,Basic services,gas,-70.89,208036.69
buyer_4,Jorge,50,ES43209504011748589219,TRX_N-00671-10896061,2024-05-07T13:45:51,Galdakao,Basic services,gas,-31.57,208005.12
buyer_4,Jorge,50,ES43209504011748589219,TRX_N-00672-86352051,2024-05-07T09:38:55,Galdakao,Basic services,internet,-41.06,207964.06
buyer_4,Jorge,50,ES43209504011748589219,TRX_N-00673-55179730,2024-05-11T12:22:49,Galdakao,Expense,gifts,-48.69,207915.37
buyer_4,Jorge,50,ES43209504011748589219,TRX_N-00674-53072869,2024-05-12T14:31:19,Galdakao,Expense,food,-580.04,207335.33
buyer_4,Jorge,50,ES43209504011748589219,TRX_N-00675-84235346,2024-05-14T07:58:44,Galdakao,Expense,food,-358.43,206976.9
buyer_4,Jorge,50,ES43209504011748589219,TRX_N-00676-53790427,2024-05-28T10:34:34,Galdakao,Expense,healthcare,-144.76,206832.14
buyer_4,Jorge,50,ES43209504011748589219,TRX_N-00677-94167567,2024-06-01T16:28:29,Galdakao,transfer,Salary,2956.3,209788.44
buyer_4,Jorge,50,ES43209504011748589219,TRX_N-00678-72357586,2024-06-01T16:28:29,Galdakao,transfer,Partner Salary,2643.03,212431.47
buyer_4,Jorge,50,ES43209504011748589219,TRX_N-00679-03085024,2024-06-01T16:28:29,Galdakao,transfer,Bonus,2848.8,215280.27
buyer_4,Jorge,50,ES43209504011748589219,TRX_N-00680-40184133,2024-06-05T17:53:52,Galdakao,Housing,Mortgage,-549.47,214730.8
buyer_4,Jorge,50,ES43209504011748589219,TRX_N-00681-69003385,2024-06-06T15:09:48,Galdakao,Basic services,water,-66.41,214664.39
buyer_4,Jorge,50,ES43209504011748589219,TRX_N-00682-84962050,2024-06-06T21:46:46,Galdakao,Basic services,gas,-53.71,214610.68
buyer_4,Jorge,50,ES43209504011748589219,TRX_N-00683-58366580,2024-06-07T05:09:07,Galdakao,Basic services,water,-15.32,214595.36
buyer_4,Jorge,50,ES43209504011748589219,TRX_N-00684-81559447,2024-06-09T19:44:03,Galdakao,Expense,food,-345.53,214249.83
buyer_4,Jorge,50,ES43209504011748589219,TRX_N-00685-93144073,2024-07-01T21:12:38,Galdakao,transfer,Salary,2956.3,217206.13
buyer_4,Jorge,50,ES43209504011748589219,TRX_N-00686-05359669,2024-07-01T21:12:38,Galdakao,transfer,Partner Salary,2643.03,219849.16
buyer_4,Jorge,50,ES43209504011748589219,TRX_N-00687-35731972,2024-07-02T19:00:38,Galdakao,Expense,food,-744.98,219104.18
buyer_4,Jorge,50,ES43209504011748589219,TRX_N-00688-41416482,2024-07-05T12:49:53,Galdakao,Housing,Mortgage,-549.47,218554.71
buyer_4,Jorge,50,ES43209504011748589219,TRX_N-00689-95960342,2024-07-06T09:37:42,Galdakao,Basic services,internet,-38.92,218515.79
buyer_4,Jorge,50,ES43209504011748589219,TRX_N-00690-00946741,2024-07-07T22:50:00,Galdakao,Basic services,internet,-56.39,218459.4
buyer_4,Jorge,50,ES43209504011748589219,TRX_N-00691-48127947,2024-07-12T18:37:04,Galdakao,Expense,leisure,-11.71,218447.69
buyer_4,Jorge,50,ES43209504011748589219,TRX_N-00692-26863679,2024-07-20T09:20:54,Sestao,Expense,food,-541.8,217905.89
buyer_4,Jorge,50,ES43209504011748589219,TRX_N-00693-31674094,2024-08-01T18:19:20,Galdakao,transfer,Salary,2956.3,220862.19
buyer_4,Jorge,50,ES43209504011748589219,TRX_N-00694-13589340,2024-08-01T18:19:20,Galdakao,transfer,Partner Salary,2643.03,223505.22
buyer_4,Jorge,50,ES43209504011748589219,TRX_N-00695-40614304,2024-08-01T18:19:20,Galdakao,transfer,Extra Income,295.63,223800.85
buyer_4,Jorge,50,ES43209504011748589219,TRX_N-00696-96381162,2024-08-02T11:11:27,Galdakao,Expense,gifts,-360.5,223440.35
buyer_4,Jorge,50,ES43209504011748589219,TRX_N-00697-39443543,2024-08-03T17:01:26,Galdakao,Expense,transport,-171.01,223269.34
buyer_4,Jorge,50,ES43209504011748589219,TRX_N-00698-95542767,2024-08-05T13:12:33,Galdakao,Housing,Mortgage,-549.47,222719.87
buyer_4,Jorge,50,ES43209504011748589219,TRX_N-00699-62441794,2024-08-05T01:47:32,Galdakao,Basic services,water,-22.59,222697.28
buyer_4,Jorge,50,ES43209504011748589219,TRX_N-00700-68893082,2024-08-05T22:40:58,Galdakao,Basic services,phone,-92.85,222604.43
buyer_4,Jorge,50,ES43209504011748589219,TRX_N-00701-14340571,2024-08-06T21:41:55,Galdakao,Basic services,internet,-39.88,222564.55
buyer_4,Jorge,50,ES43209504011748589219,TRX_N-00702-63046117,2024-08-07T20:41:18,Galdakao,Basic services,electricity,-103.17,222461.38
buyer_4,Jorge,50,ES43209504011748589219,TRX_N-00703-20153864,2024-08-07T12:18:33,Galdakao,Basic services,internet,-66.17,222395.21
buyer_4,Jorge,50,ES43209504011748589219,TRX_N-00704-86221634,2024-08-12T12:29:51,Galdakao,Expense,clothing,-464.09,221931.12
buyer_4,Jorge,50,ES43209504011748589219,TRX_N-00705-21893671,2024-09-01T10:21:19,Galdakao,transfer,Salary,2956.3,224887.42
buyer_4,Jorge,50,ES43209504011748589219,TRX_N-00706-72461249,2024-09-01T10:21:19,Galdakao,transfer,Partner Salary,2643.03,227530.45
buyer_4,Jorge,50,ES43209504011748589219,TRX_N-00707-47450457,2024-09-05T14:51:12,Galdakao,Housing,Mortgage,-549.47,226980.98
buyer_4,Jorge,50,ES43209504011748589219,TRX_N-00708-76796747,2024-09-05T11:48:13,Galdakao,Basic services,gas,-37.01,226943.97
buyer_4,Jorge,50,ES43209504011748589219,TRX_N-00709-08509073,2024-09-05T19:55:43,Galdakao,Expense,food,-764.23,226179.74
buyer_4,Jorge,50,ES43209504011748589219,TRX_N-00710-73012145,2024-09-06T14:54:14,Galdakao,Basic services,electricity,-84.25,226095.49
buyer_4,Jorge,50,ES43209504011748589219,TRX_N-00711-61524234,2024-09-06T09:04:59,Galdakao,Basic services,gas,-76.0,226019.49
buyer_4,Jorge,50,ES43209504011748589219,TRX_N-00712-37294055,2024-09-06T09:13:46,Galdakao,Basic services,phone,-84.05,225935.44
buyer_4,Jorge,50,ES43209504011748589219,TRX_N-00713-57660316,2024-09-19T12:17:39,Galdakao,Expense,leisure,-206.82,225728.62
buyer_4,Jorge,50,ES43209504011748589219,TRX_N-00714-48802163,2024-09-20T06:23:51,Galdakao,Expense,transport,-105.98,225622.64
buyer_4,Jorge,50,ES43209504011748589219,TRX_N-00715-94829504,2024-09-24T15:06:13,Galdakao,Expense,leisure,-208.85,225413.79
buyer_4,Jorge,50,ES43209504011748589219,TRX_N-00716-49460358,2024-10-01T12:25:56,Galdakao,transfer,Salary,2956.3,228370.09
buyer_4,Jorge,50,ES43209504011748589219,TRX_N-00717-91087460,2024-10-01T12:25:56,Galdakao,transfer,Partner Salary,2643.03,231013.12
buyer_4,Jorge,50,ES43209504011748589219,TRX_N-00718-84205254,2024-10-03T18:09:55,Galdakao,Expense,transport,-77.56,230935.56
buyer_4,Jorge,50,ES43209504011748589219,TRX_N-00719-96592513,2024-10-05T09:38:06,Galdakao,Housing,Mortgage,-549.47,230386.09
buyer_4,Jorge,50,ES43209504011748589219,TRX_N-00720-86456363,2024-10-06T16:22:57,Galdakao,Basic services,gas,-51.42,230334.67
buyer_4,Jorge,50,ES43209504011748589219,TRX_N-00721-06196291,2024-10-06T19:48:48,Galdakao,Basic services,internet,-61.01,230273.66
buyer_4,Jorge,50,ES43209504011748589219,TRX_N-00722-56609500,2024-10-07T13:35:36,Galdakao,Basic services,gas,-93.29,230180.37
buyer_4,Jorge,50,ES43209504011748589219,TRX_N-00723-09980894,2024-10-07T10:25:31,Galdakao,Basic services,internet,-61.5,230118.87
buyer_5,Sara,30,ES36209532986776033440,TRX_N-00001-08459797,2020-01-01T18:51:55,Donostia,transfer,Salary,3055.89,21014.16
buyer_5,Sara,30,ES36209532986776033440,TRX_N-00002-85810560,2020-01-01T18:51:55,Donostia,transfer,Partner Salary,3147.16,24161.32
buyer_5,Sara,30,ES36209532986776033440,TRX_N-00003-65675840,2020-01-02T15:56:02,Basauri,Expense,food,-584.27,23577.05
buyer_5,Sara,30,ES36209532986776033440,TRX_N-00004-13707223,2020-01-05T12:57:01,Donostia,Housing,Mortgage,-569.36,23007.69
buyer_5,Sara,30,ES36209532986776033440,TRX_N-00005-47742955,2020-01-05T08:21:09,Donostia,Basic services,electricity,-43.47,22964.22
buyer_5,Sara,30,ES36209532986776033440,TRX_N-00006-93101241,2020-01-05T17:49:04,Donostia,Basic services,internet,-35.66,22928.56
buyer_5,Sara,30,ES36209532986776033440,TRX_N-00007-36796231,2020-01-05T22:09:14,Donostia,Basic services,phone,-26.46,22902.1
buyer_5,Sara,30,ES36209532986776033440,TRX_N-00008-83664816,2020-01-06T12:41:33,Donostia,Basic services,water,-32.73,22869.37
buyer_5,Sara,30,ES36209532986776033440,TRX_N-00009-22123871,2020-01-06T12:57:07,Donostia,Basic services,internet,-44.77,22824.6
buyer_5,Sara,30,ES36209532986776033440,TRX_N-00010-99544692,2020-01-07T13:10:51,Donostia,Basic services,water,-54.45,22770.15
buyer_5,Sara,30,ES36209532986776033440,TRX_N-00011-41206511,2020-01-07T20:30:00,Donostia,Expense,leisure,-232.41,22537.74
buyer_5,Sara,30,ES36209532986776033440,TRX_N-00012-17229928,2020-02-01T00:37:41,Donostia,transfer,Salary,3055.89,25593.63
buyer_5,Sara,30,ES36209532986776033440,TRX_N-00013-12992108,2020-02-01T00:37:41,Donostia,transfer,Partner Salary,3147.16,28740.79
buyer_5,Sara,30,ES36209532986776033440,TRX_N-00014-61658948,2020-02-01T00:37:41,Donostia,transfer,Extra Income,305.59,29046.38
buyer_5,Sara,30,ES36209532986776033440,TRX_N-00015-22698225,2020-02-04T18:14:30,Lasarte-Oria,Expense,food,-443.35,28603.03
buyer_5,Sara,30,ES36209532986776033440,TRX_N-00016-25394242,2020-02-05T18:31:22,Donostia,Housing,Mortgage,-569.36,28033.67
buyer_5,Sara,30,ES36209532986776033440,TRX_N-00017-06593419,2020-02-05T05:57:15,Donostia,Expense,food,-718.8,27314.87
buyer_5,Sara,30,ES36209532986776033440,TRX_N-00018-97802842,2020-02-06T20:14:14,Donostia,Basic services,water,-38.26,27276.61
buyer_5,Sara,30,ES36209532986776033440,TRX_N-00019-28477992,2020-02-06T14:28:56,Donostia,Basic services,electricity,-23.64,27252.97
buyer_5,Sara,30,ES36209532986776033440,TRX_N-00020-81402128,2020-02-06T16:28:45,Donostia,Basic services,gas,-98.06,27154.91
buyer_5,Sara,30,ES36209532986776033440,TRX_N-00021-81303634,2020-02-07T08:51:25,Donostia,Basic services,water,-66.2,27088.71
buyer_5,Sara,30,ES36209532986776033440,TRX_N-00022-02271057,2020-02-07T09:27:14,Donostia,Basic services,phone,-68.38,27020.33
buyer_5,Sara,30,ES36209532986776033440,TRX_N-00023-36328408,2020-02-07T14:09:15,Santurtzi,Expense,transport,-120.19,26900.14
buyer_5,Sara,30,ES36209532986776033440,TRX_N-00024-20960604,2020-02-21T15:07:45,Donostia,Expense,leisure,-230.56,26669.58
buyer_5,Sara,30,ES36209532986776033440,TRX_N-00025-12785792,2020-02-23T10:39:39,Labastida/Bastida,Expense,food,-181.39,26488.19
buyer_5,Sara,30,ES36209532986776033440,TRX_N-00026-51497544,2020-03-01T14:50:30,Donostia,transfer,Salary,3055.89,29544.08
buyer_5,Sara,30,ES36209532986776033440,TRX_N-00027-73016265,2020-03-01T14:50:30,Donostia,transfer,Partner Salary,3147.16,32691.24
buyer_5,Sara,30,ES36209532986776033440,TRX_N-00028-52748841,2020-03-05T13:04:30,Donostia,Housing,Mortgage,-569.36,32121.88
buyer_5,Sara,30,ES36209532986776033440,TRX_N-00029-18593915,2020-03-05T10:12:58,Donostia,Basic services,gas,-53.0,32068.88
buyer_5,Sara,30,ES36209532986776033440,TRX_N-00030-70397949,2020-03-05T08:30:50,Donostia,Basic services,internet,-75.69,31993.19
buyer_5,Sara,30,ES36209532986776033440,TRX_N-00031-69333843,2020-03-06T16:52:16,Donostia,Basic services,water,-55.96,31937.23
buyer_5,Sara,30,ES36209532986776033440,TRX_N-00032-25537933,2020-03-07T15:49:58,Donostia,Basic services,electricity,-92.8,31844.43
buyer_5,Sara,30,ES36209532986776033440,TRX_N-00033-65520838,2020-03-07T23:09:31,Donostia,Basic services,gas,-64.65,31779.78
buyer_5,Sara,30,ES36209532986776033440,TRX_N-00034-57684020,2020-03-09T20:49:37,Donostia,Expense,leisure,-44.54,31735.24
buyer_5,Sara,30,ES36209532986776033440,TRX_N-00035-35155260,2020-03-11T19:28:00,Berango,Expense,food,-102.67,31632.57
buyer_5,Sara,30,ES36209532986776033440,TRX_N-00036-79986261,2020-03-20T19:07:20,Donostia,Expense,food,-382.37,31250.2
buyer_5,Sara,30,ES36209532986776033440,TRX_N-00037-57925010,2020-03-22T05:22:45,Donostia,Expense,repairs,-453.52,30796.68
buyer_5,Sara,30,ES36209532986776033440,TRX_N-00038-54701350,2020-03-26T12:23:33,Donostia,Expense,clothing,-146.27,30650.41
buyer_5,Sara,30,ES36209532986776033440,TRX_N-00039-88277220,2020-04-01T08:56:38,Donostia,transfer,Salary,3055.89,33706.3
buyer_5,Sara,30,ES36209532986776033440,TRX_N-00040-68607113,2020-04-01T08:56:38,Donostia,transfer,Partner Salary,3147.16,36853.46
buyer_5,Sara,30,ES36209532986776033440,TRX_N-00041-76828936,2020-04-05T19:48:26,Donostia,Housing,Mortgage,-569.36,36284.1
buyer_5,Sara,30,ES36209532986776033440,TRX_N-00042-83250449,2020-04-05T11:59:16,Donostia,Basic services,phone,-25.71,36258.39
buyer_5,Sara,30,ES36209532986776033440,TRX_N-00043-17134056,2020-04-06T12:52:02,Donostia,Basic services,water,-59.89,36198.5
buyer_5,Sara,30,ES36209532986776033440,TRX_N-00044-96990411,2020-04-07T14:08:50,Mungia,Expense,travel,-1017.47,35181.03
buyer_5,Sara,30,ES36209532986776033440,TRX_N-00045-25713873,2020-04-13T23:35:36,Donostia,Expense,clothing,-323.52,34857.51
buyer_5,Sara,30,ES36209532986776033440,TRX_N-00046-09043409,2020-04-23T19:36:11,Amurrio,Expense,food,-188.62,34668.89
buyer_5,Sara,30,ES36209532986776033440,TRX_N-00047-43253781,2020-04-24T16:26:53,Donostia,Expense,food,-729.21,33939.68
buyer_5,Sara,30,ES36209532986776033440,TRX_N-00048-47392994,2020-05-01T03:19:51,Donostia,transfer,Salary,3055.89,36995.57
buyer_5,Sara,30,ES36209532986776033440,TRX_N-00049-76986797,2020-05-01T03:19:51,Donostia,transfer,Partner Salary,3147.16,40142.73
buyer_5,Sara,30,ES36209532986776033440,TRX_N-00050-20641414,2020-05-01T03:19:51,Donostia,transfer,Extra Income,305.59,40448.32
buyer_5,Sara,30,ES36209532986776033440,TRX_N-00051-52827200,2020-05-05T09:24:36,Donostia,Housing,Mortgage,-569.36,39878.96
buyer_5,Sara,30,ES36209532986776033440,TRX_N-00052-15591854,2020-05-05T11:23:51,Donostia,Basic services,water,-66.0,39812.96
buyer_5,Sara,30,ES36209532986776033440,TRX_N-00053-94817434,2020-05-05T21:36:27,Donostia,Basic services,electricity,-96.44,39716.52
buyer_5,Sara,30,ES36209532986776033440,TRX_N-00054-90022238,2020-05-05T17:15:32,Donostia,Basic services,gas,-67.73,39648.79
buyer_5,Sara,30,ES36209532986776033440,TRX_N-00055-78162084,2020-05-05T15:04:04,Donostia,Basic services,phone,-73.45,39575.34
buyer_5,Sara,30,ES36209532986776033440,TRX_N-00056-25541091,2020-05-06T21:57:25,Donostia,Basic services,water,-67.28,39508.06
buyer_5,Sara,30,ES36209532986776033440,TRX_N-00057-58378186,2020-05-07T22:58:30,Donostia,Basic services,internet,-50.48,39457.58
buyer_5,Sara,30,ES36209532986776033440,TRX_N-00058-29061586,2020-05-07T12:23:31,Donostia,Basic services,phone,-87.41,39370.17
buyer_5,Sara,30,ES36209532986776033440,TRX_N-00059-16454402,2020-05-13T18:03:59,Hondarribia,Expense,transport,-193.47,39176.7
buyer_5,Sara,30,ES36209532986776033440,TRX_N-00060-89900004,2020-05-31T14:38:49,Berango,Expense,transport,-92.11,39084.59
buyer_5,Sara,30,ES36209532986776033440,TRX_N-00061-37524825,2020-06-01T16:26:30,Donostia,transfer,Salary,3055.89,42140.48
buyer_5,Sara,30,ES36209532986776033440,TRX_N-00062-59781417,2020-06-01T16:26:30,Donostia,transfer,Partner Salary,3147.16,45287.64
buyer_5,Sara,30,ES36209532986776033440,TRX_N-00063-87376010,2020-06-01T16:26:30,Donostia,transfer,Bonus,3165.26,48452.9
buyer_5,Sara,30,ES36209532986776033440,TRX_N-00064-26949641,2020-06-05T12:26:17,Donostia,Housing,Mortgage,-569.36,47883.54
buyer_5,Sara,30,ES36209532986776033440,TRX_N-00065-78842497,2020-06-05T15:13:23,Donostia,Basic services,water,-60.01,47823.53
buyer_5,Sara,30,ES36209532986776033440,TRX_N-00066-11676107,2020-06-05T19:39:12,Donostia,Basic services,electricity,-41.91,47781.62
buyer_5,Sara,30,ES36209532986776033440,TRX_N-00067-53094633,2020-06-06T13:11:35,Donostia,Basic services,water,-28.63,47752.99
buyer_5,Sara,30,ES36209532986776033440,TRX_N-00068-22563037,2020-06-06T11:51:14,Donostia,Basic services,gas,-61.1,47691.89
buyer_5,Sara,30,ES36209532986776033440,TRX_N-00069-01022638,2020-06-06T08:29:48,Vitoria-Gasteiz,Expense,transport,-86.77,47605.12
buyer_5,Sara,30,ES36209532986776033440,TRX_N-00070-08658448,2020-06-07T09:06:05,Donostia,Basic services,water,-50.64,47554.48
buyer_5,Sara,30,ES36209532986776033440,TRX_N-00071-84161841,2020-06-07T20:24:21,Donostia,Basic services,internet,-76.24,47478.24
buyer_5,Sara,30,ES36209532986776033440,TRX_N-00072-80809816,2020-06-07T16:09:18,Donostia,Expense,appliances,-1729.12,45749.12
buyer_5,Sara,30,ES36209532986776033440,TRX_N-00073-99098859,2020-06-09T08:51:38,Donostia,Expense,leisure,-131.85,45617.27
buyer_5,Sara,30,ES36209532986776033440,TRX_N-00074-19829594,2020-06-09T23:45:47,Andoain,Expense,repairs,-310.9,45306.37
buyer_5,Sara,30,ES36209532986776033440,TRX_N-00075-31028651,2020-06-15T08:12:04,Donostia,Expense,food,-372.27,44934.1
buyer_5,Sara,30,ES36209532986776033440,TRX_N-00076-14779990,2020-07-01T09:17:11,Donostia,transfer,Salary,3055.89,47989.99
buyer_5,Sara,30,ES36209532986776033440,TRX_N-00077-59133929,2020-07-01T09:17:11,Donostia,transfer,Partner Salary,3147.16,51137.15
buyer_5,Sara,30,ES36209532986776033440,TRX_N-00078-01928721,2020-07-01T09:17:11,Donostia,transfer,Extra Income,305.59,51442.74
buyer_5,Sara,30,ES36209532986776033440,TRX_N-00079-38093260,2020-07-05T11:33:33,Donostia,Housing,Mortgage,-569.36,50873.38
buyer_5,Sara,30,ES36209532986776033440,TRX_N-00080-15100256,2020-07-05T10:43:42,Donostia,Basic services,water,-41.95,50831.43
buyer_5,Sara,30,ES36209532986776033440,TRX_N-00081-41367116,2020-07-05T21:28:36,Donostia,Basic services,electricity,-93.09,50738.34
buyer_5,Sara,30,ES36209532986776033440,TRX_N-00082-12070878,2020-07-05T11:58:38,Donostia,Expense,clothing,-408.23,50330.11
buyer_5,Sara,30,ES36209532986776033440,TRX_N-00083-21637976,2020-07-06T12:35:07,Donostia,Basic services,gas,-64.87,50265.24
buyer_5,Sara,30,ES36209532986776033440,TRX_N-00084-06655858,2020-07-07T18:21:11,Donostia,Basic services,gas,-25.56,50239.68
buyer_5,Sara,30,ES36209532986776033440,TRX_N-00085-90648382,2020-07-07T13:51:27,Donostia,Basic services,internet,-69.49,50170.19
buyer_5,Sara,30,ES36209532986776033440,TRX_N-00086-82060139,2020-07-07T22:24:52,Donostia,Basic services,phone,-29.53,50140.66
buyer_5,Sara,30,ES36209532986776033440,TRX_N-00087-08200855,2020-07-31T16:42:23,Donostia,Expense,transport,-69.47,50071.19
buyer_5,Sara,30,ES36209532986776033440,TRX_N-00088-87497836,2020-08-01T16:44:56,Donostia,transfer,Salary,3055.89,53127.08
buyer_5,Sara,30,ES36209532986776033440,TRX_N-00089-62118849,2020-08-01T16:44:56,Donostia,transfer,Partner Salary,3147.16,56274.24
buyer_5,Sara,30,ES36209532986776033440,TRX_N-00090-79272461,2020-08-05T21:36:06,Donostia,Housing,Mortgage,-569.36,55704.88
buyer_5,Sara,30,ES36209532986776033440,TRX_N-00091-89061898,2020-08-06T11:17:15,Donostia,Basic services,water,-77.68,55627.2
buyer_5,Sara,30,ES36209532986776033440,TRX_N-00092-24398427,2020-08-06T10:25:05,Donostia,Basic services,electricity,-50.98,55576.22
buyer_5,Sara,30,ES36209532986776033440,TRX_N-00093-65693285,2020-08-06T08:24:15,Donostia,Basic services,gas,-30.15,55546.07
buyer_5,Sara,30,ES36209532986776033440,TRX_N-00094-54980926,2020-08-07T13:12:32,Donostia,Basic services,water,-72.36,55473.71
buyer_5,Sara,30,ES36209532986776033440,TRX_N-00095-07122218,2020-08-07T23:08:22,Donostia,Basic services,electricity,-40.76,55432.95
buyer_5,Sara,30,ES36209532986776033440,TRX_N-00096-29594124,2020-08-07T18:00:21,Donostia,Basic services,gas,-29.69,55403.26
buyer_5,Sara,30,ES36209532986776033440,TRX_N-00097-82367689,2020-08-07T16:41:15,Donostia,Basic services,internet,-42.93,55360.33
buyer_5,Sara,30,ES36209532986776033440,TRX_N-00098-16203757,2020-08-13T20:42:57,Donostia,Expense,gifts,-497.96,54862.37
buyer_5,Sara,30,ES36209532986776033440,TRX_N-00099-73091394,2020-08-28T18:46:24,Donostia,Expense,transport,-23.51,54838.86
buyer_5,Sara,30,ES36209532986776033440,TRX_N-00100-64368131,2020-08-31T18:06:24,Donostia,Expense,transport,-21.58,54817.28
buyer_5,Sara,30,ES36209532986776033440,TRX_N-00101-69309383,2020-09-01T19:27:51,Donostia,transfer,Salary,3055.89,57873.17
buyer_5,Sara,30,ES36209532986776033440,TRX_N-00102-23562134,2020-09-01T19:27:51,Donostia,transfer,Partner Salary,3147.16,61020.33
buyer_5,Sara,30,ES36209532986776033440,TRX_N-00103-66202624,2020-09-05T08:55:14,Donostia,Housing,Mortgage,-569.36,60450.97
buyer_5,Sara,30,ES36209532986776033440,TRX_N-00104-00160575,2020-09-05T15:42:45,Donostia,Basic services,gas,-19.32,60431.65
buyer_5,Sara,30,ES36209532986776033440,TRX_N-00105-48962406,2020-09-06T02:01:05,Donostia,Basic services,electricity,-64.29,60367.36
buyer_5,Sara,30,ES36209532986776033440,TRX_N-00106-78132719,2020-09-06T18:24:33,Donostia,Basic services,phone,-29.95,60337.41
buyer_5,Sara,30,ES36209532986776033440,TRX_N-00107-99944940,2020-09-07T17:06:44,Donostia,Basic services,electricity,-121.42,60215.99
buyer_5,Sara,30,ES36209532986776033440,TRX_N-00108-16050300,2020-09-07T09:16:43,Donostia,Basic services,internet,-79.4,60136.59
buyer_5,Sara,30,ES36209532986776033440,TRX_N-00109-14655675,2020-09-23T00:19:38,Zarautz,Expense,transport,-69.62,60066.97
buyer_5,Sara,30,ES36209532986776033440,TRX_N-00110-68058068,2020-09-30T20:25:21,Bilbao,Expense,clothing,-429.57,59637.4
buyer_5,Sara,30,ES36209532986776033440,TRX_N-00111-92165899,2020-10-01T02:59:31,Donostia,transfer,Salary,3055.89,62693.29
buyer_5,Sara,30,ES36209532986776033440,TRX_N-00112-83683309,2020-10-01T02:59:31,Donostia,transfer,Partner Salary,3147.16,65840.45
buyer_5,Sara,30,ES36209532986776033440,TRX_N-00113-61196020,2020-10-01T02:59:31,Donostia,transfer,Extra Income,305.59,66146.04
buyer_5,Sara,30,ES36209532986776033440,TRX_N-00114-71712989,2020-10-05T14:08:11,Donostia,Housing,Mortgage,-569.36,65576.68
buyer_5,Sara,30,ES36209532986776033440,TRX_N-00115-24966246,2020-10-05T19:26:43,Hernani,Expense,transport,-115.56,65461.12
buyer_5,Sara,30,ES36209532986776033440,TRX_N-00116-23615537,2020-10-06T16:51:13,Donostia,Basic services,internet,-39.52,65421.6
buyer_5,Sara,30,ES36209532986776033440,TRX_N-00117-45201910,2020-10-07T17:59:17,Donostia,Basic services,water,-51.32,65370.28
buyer_5,Sara,30,ES36209532986776033440,TRX_N-00118-78509008,2020-10-07T11:03:33,Donostia,Basic services,internet,-71.76,65298.52
buyer_5,Sara,30,ES36209532986776033440,TRX_N-00119-18512011,2020-10-18T09:10:46,Donostia,Expense,leisure,-207.82,65090.7
buyer_5,Sara,30,ES36209532986776033440,TRX_N-00120-71542701,2020-10-18T18:28:37,Donostia,Expense,repairs,-195.9,64894.8
buyer_5,Sara,30,ES36209532986776033440,TRX_N-00121-75941949,2020-10-25T16:09:13,Barakaldo,Expense,transport,-57.69,64837.11
buyer_5,Sara,30,ES36209532986776033440,TRX_N-00122-23159774,2020-11-01T11:11:52,Donostia,transfer,Salary,3055.89,67893.0
buyer_5,Sara,30,ES36209532986776033440,TRX_N-00123-06778972,2020-11-01T11:11:52,Donostia,transfer,Partner Salary,3147.16,71040.16
buyer_5,Sara,30,ES36209532986776033440,TRX_N-00124-98005085,2020-11-02T17:35:39,Donostia,Expense,clothing,-187.91,70852.25
buyer_5,Sara,30,ES36209532986776033440,TRX_N-00125-24221317,2020-11-05T08:59:31,Donostia,Housing,Mortgage,-569.36,70282.89
buyer_5,Sara,30,ES36209532986776033440,TRX_N-00126-35297355,2020-11-05T20:46:01,Donostia,Basic services,water,-11.11,70271.78
buyer_5,Sara,30,ES36209532986776033440,TRX_N-00127-21570970,2020-11-06T08:53:47,Donostia,Basic services,electricity,-148.91,70122.87
buyer_5,Sara,30,ES36209532986776033440,TRX_N-00128-43160687,2020-11-06T14:46:30,Donostia,Basic services,gas,-32.49,70090.38
buyer_5,Sara,30,ES36209532986776033440,TRX_N-00129-74821433,2020-11-06T13:58:16,Donostia,Basic services,phone,-52.01,70038.37
buyer_5,Sara,30,ES36209532986776033440,TRX_N-00130-25915391,2020-11-07T11:57:53,Donostia,Basic services,gas,-75.69,69962.68
buyer_5,Sara,30,ES36209532986776033440,TRX_N-00131-57886451,2020-11-07T10:39:03,Donostia,Basic services,internet,-76.16,69886.52
buyer_5,Sara,30,ES36209532986776033440,TRX_N-00132-11090050,2020-11-07T14:57:22,Donostia,Expense,clothing,-149.73,69736.79
buyer_5,Sara,30,ES36209532986776033440,TRX_N-00133-86090670,2020-11-14T23:52:39,Donostia,Expense,food,-214.77,69522.02
buyer_5,Sara,30,ES36209532986776033440,TRX_N-00134-23357369,2020-11-30T15:44:06,Salvatierra/Agurain,Expense,transport,-150.88,69371.14
buyer_5,Sara,30,ES36209532986776033440,TRX_N-00135-83622975,2020-12-01T11:01:37,Donostia,transfer,Salary,3055.89,72427.03
buyer_5,Sara,30,ES36209532986776033440,TRX_N-00136-19930735,2020-12-01T11:01:37,Donostia,transfer,Partner Salary,3147.16,75574.19
buyer_5,Sara,30,ES36209532986776033440,TRX_N-00137-26146487,2020-12-01T11:01:37,Donostia,transfer,Bonus,3070.87,78645.06
buyer_5,Sara,30,ES36209532986776033440,TRX_N-00138-76288887,2020-12-05T07:40:48,Donostia,Housing,Mortgage,-569.36,78075.7
buyer_5,Sara,30,ES36209532986776033440,TRX_N-00139-47709537,2020-12-05T18:15:32,Donostia,Basic services,electricity,-118.13,77957.57
buyer_5,Sara,30,ES36209532986776033440,TRX_N-00140-17427942,2020-12-05T15:06:55,Donostia,Basic services,gas,-55.76,77901.81
buyer_5,Sara,30,ES36209532986776033440,TRX_N-00141-93192139,2020-12-05T12:19:46,Donostia,Basic services,internet,-63.95,77837.86
buyer_5,Sara,30,ES36209532986776033440,TRX_N-00142-65586394,2020-12-06T12:31:06,Donostia,Basic services,electricity,-25.13,77812.73
buyer_5,Sara,30,ES36209532986776033440,TRX_N-00143-88713817,2020-12-07T14:15:53,Donostia,Basic services,internet,-30.27,77782.46
buyer_5,Sara,30,ES36209532986776033440,TRX_N-00144-29842945,2020-12-07T10:41:55,Donostia,Basic services,phone,-44.81,77737.65
buyer_5,Sara,30,ES36209532986776033440,TRX_N-00145-62003745,2020-12-08T19:57:55,Donostia,Expense,transport,-103.65,77634.0
buyer_5,Sara,30,ES36209532986776033440,TRX_N-00146-05942465,2021-01-01T00:28:08,Donostia,transfer,Salary,3055.89,80689.89
buyer_5,Sara,30,ES36209532986776033440,TRX_N-00147-11721363,2021-01-01T00:28:08,Donostia,transfer,Partner Salary,3147.16,83837.05
buyer_5,Sara,30,ES36209532986776033440,TRX_N-00148-95257665,2021-01-01T00:28:08,Donostia,transfer,Extra Income,305.59,84142.64
buyer_5,Sara,30,ES36209532986776033440,TRX_N-00149-09538318,2021-01-05T18:03:33,Donostia,Housing,Mortgage,-569.36,83573.28
buyer_5,Sara,30,ES36209532986776033440,TRX_N-00150-90613124,2021-01-05T07:03:43,Donostia,Basic services,water,-17.62,83555.66
buyer_5,Sara,30,ES36209532986776033440,TRX_N-00151-32030254,2021-01-05T15:09:02,Donostia,Basic services,gas,-42.4,83513.26
buyer_5,Sara,30,ES36209532986776033440,TRX_N-00152-40605440,2021-01-06T16:35:53,Donostia,Basic services,water,-67.82,83445.44
buyer_5,Sara,30,ES36209532986776033440,TRX_N-00153-09838305,2021-01-06T20:55:13,Donostia,Basic services,internet,-47.39,83398.05
buyer_5,Sara,30,ES36209532986776033440,TRX_N-00154-43027433,2021-01-06T17:43:19,Donostia,Expense,clothing,-378.47,83019.58
buyer_5,Sara,30,ES36209532986776033440,TRX_N-00155-80480902,2021-01-07T14:42:31,Donostia,Basic services,internet,-63.28,82956.3
buyer_5,Sara,30,ES36209532986776033440,TRX_N-00156-90225509,2021-01-07T21:16:57,Donostia,Basic services,phone,-94.31,82861.99
buyer_5,Sara,30,ES36209532986776033440,TRX_N-00157-62732240,2021-01-21T23:10:10,Berango,Expense,healthcare,-246.65,82615.34
buyer_5,Sara,30,ES36209532986776033440,TRX_N-00158-64339502,2021-01-27T22:36:58,Donostia,Expense,transport,-197.02,82418.32
buyer_5,Sara,30,ES36209532986776033440,TRX_N-00159-13497430,2021-02-01T10:11:01,Donostia,transfer,Salary,3055.89,85474.21
buyer_5,Sara,30,ES36209532986776033440,TRX_N-00160-98154846,2021-02-01T10:11:01,Donostia,transfer,Partner Salary,3147.16,88621.37
buyer_5,Sara,30,ES36209532986776033440,TRX_N-00161-99534744,2021-02-05T23:12:13,Donostia,Housing,Mortgage,-569.36,88052.01
buyer_5,Sara,30,ES36209532986776033440,TRX_N-00162-75854689,2021-02-05T17:45:48,Donostia,Basic services,electricity,-133.3,87918.71
buyer_5,Sara,30,ES36209532986776033440,TRX_N-00163-73478517,2021-02-05T19:32:12,Donostia,Basic services,gas,-29.38,87889.33
buyer_5,Sara,30,ES36209532986776033440,TRX_N-00164-54774641,2021-02-05T10:00:46,Donostia,Basic services,phone,-92.96,87796.37
buyer_5,Sara,30,ES36209532986776033440,TRX_N-00165-34596104,2021-02-06T16:17:52,Donostia,Basic services,gas,-48.79,87747.58
buyer_5,Sara,30,ES36209532986776033440,TRX_N-00166-58783878,2021-02-07T14:53:31,Donostia,Basic services,water,-66.76,87680.82
buyer_5,Sara,30,ES36209532986776033440,TRX_N-00167-28953628,2021-02-07T22:14:52,Donostia,Basic services,gas,-38.41,87642.41
buyer_5,Sara,30,ES36209532986776033440,TRX_N-00168-19440369,2021-02-07T12:10:18,Donostia,Basic services,internet,-72.59,87569.82
buyer_5,Sara,30,ES36209532986776033440,TRX_N-00169-10780046,2021-02-08T08:32:18,Bilbao,Expense,healthcare,-293.62,87276.2
buyer_5,Sara,30,ES36209532986776033440,TRX_N-00170-27520652,2021-02-09T19:54:05,Donostia,Expense,food,-661.89,86614.31
buyer_5,Sara,30,ES36209532986776033440,TRX_N-00171-10444287,2021-02-26T08:19:34,Donostia,Expense,travel,-2000.9,84613.41
buyer_5,Sara,30,ES36209532986776033440,TRX_N-00172-88694180,2021-03-01T16:41:43,Donostia,transfer,Salary,3055.89,87669.3
buyer_5,Sara,30,ES36209532986776033440,TRX_N-00173-18130604,2021-03-01T16:41:43,Donostia,transfer,Partner Salary,3147.16,90816.46
buyer_5,Sara,30,ES36209532986776033440,TRX_N-00174-91685304,2021-03-04T16:18:42,Donostia,Expense,clothing,-274.21,90542.25
buyer_5,Sara,30,ES36209532986776033440,TRX_N-00175-42743570,2021-03-05T10:52:02,Donostia,Housing,Mortgage,-569.36,89972.89
buyer_5,Sara,30,ES36209532986776033440,TRX_N-00176-02458723,2021-03-05T16:05:32,Donostia,Basic services,internet,-37.84,89935.05
buyer_5,Sara,30,ES36209532986776033440,TRX_N-00177-54806267,2021-03-05T17:56:52,Donostia,Basic services,phone,-88.72,89846.33
buyer_5,Sara,30,ES36209532986776033440,TRX_N-00178-41498340,2021-03-06T19:21:42,Donostia,Basic services,phone,-59.06,89787.27
buyer_5,Sara,30,ES36209532986776033440,TRX_N-00179-46090520,2021-03-07T13:39:03,Donostia,Basic services,gas,-42.75,89744.52
buyer_5,Sara,30,ES36209532986776033440,TRX_N-00180-25858141,2021-03-07T12:18:51,Durango,Expense,transport,-38.69,89705.83
buyer_5,Sara,30,ES36209532986776033440,TRX_N-00181-20504135,2021-03-10T16:36:52,Donostia,Expense,gifts,-75.88,89629.95
buyer_5,Sara,30,ES36209532986776033440,TRX_N-00182-47575444,2021-03-14T11:56:52,Donostia,Expense,transport,-59.8,89570.15
buyer_5,Sara,30,ES36209532986776033440,TRX_N-00183-94677077,2021-03-17T02:21:42,Oyón-Oion,Expense,leisure,-57.96,89512.19
buyer_5,Sara,30,ES36209532986776033440,TRX_N-00184-42528554,2021-03-19T13:39:55,Donostia,Expense,food,-362.54,89149.65
buyer_5,Sara,30,ES36209532986776033440,TRX_N-00185-21656462,2021-03-31T12:58:02,Donostia,Expense,clothing,-75.42,89074.23
buyer_5,Sara,30,ES36209532986776033440,TRX_N-00186-46960991,2021-04-01T18:38:30,Donostia,transfer,Salary,3055.89,92130.12
buyer_5,Sara,30,ES36209532986776033440,TRX_N-00187-64397132,2021-04-01T18:38:30,Donostia,transfer,Partner Salary,3147.16,95277.28
buyer_5,Sara,30,ES36209532986776033440,TRX_N-00188-64428222,2021-04-01T18:38:30,Donostia,transfer,Extra Income,305.59,95582.87
buyer_5,Sara,30,ES36209532986776033440,TRX_N-00189-45753940,2021-04-01T17:29:02,Donostia,Expense,food,-742.03,94840.84
buyer_5,Sara,30,ES36209532986776033440,TRX_N-00190-78146934,2021-04-05T01:59:34,Donostia,Housing,Mortgage,-569.36,94271.48
buyer_5,Sara,30,ES36209532986776033440,TRX_N-00191-55397656,2021-04-05T12:46:40,Donostia,Basic services,internet,-48.3,94223.18
buyer_5,Sara,30,ES36209532986776033440,TRX_N-00192-58212059,2021-04-06T11:16:07,Donostia,Basic services,water,-14.07,94209.11
buyer_5,Sara,30,ES36209532986776033440,TRX_N-00193-75897097,2021-04-06T21:14:48,Donostia,Basic services,gas,-91.57,94117.54
buyer_5,Sara,30,ES36209532986776033440,TRX_N-00194-77073554,2021-04-06T12:45:13,Donostia,Basic services,phone,-88.84,94028.7
buyer_5,Sara,30,ES36209532986776033440,TRX_N-00195-83790769,2021-04-07T19:32:19,Donostia,Basic services,internet,-48.62,93980.08
buyer_5,Sara,30,ES36209532986776033440,TRX_N-00196-68976172,2021-04-17T23:40:36,Donostia,Expense,leisure,-235.27,93744.81
buyer_5,Sara,30,ES36209532986776033440,TRX_N-00197-73560274,2021-04-24T13:19:00,Donostia,Expense,transport,-31.42,93713.39
buyer_5,Sara,30,ES36209532986776033440,TRX_N-00198-84037300,2021-04-27T08:59:17,Eibar,Expense,repairs,-569.22,93144.17
buyer_5,Sara,30,ES36209532986776033440,TRX_N-00199-46413602,2021-05-01T12:05:23,Donostia,transfer,Salary,3055.89,96200.06
buyer_5,Sara,30,ES36209532986776033440,TRX_N-00200-67257840,2021-05-01T12:05:23,Donostia,transfer,Partner Salary,3147.16,99347.22
buyer_5,Sara,30,ES36209532986776033440,TRX_N-00201-75487926,2021-05-04T23:22:36,Donostia,Expense,food,-393.79,98953.43
buyer_5,Sara,30,ES36209532986776033440,TRX_N-00202-30192199,2021-05-05T12:12:58,Donostia,Housing,Mortgage,-569.36,98384.07
buyer_5,Sara,30,ES36209532986776033440,TRX_N-00203-62802457,2021-05-05T07:15:30,Donostia,Basic services,gas,-27.9,98356.17
buyer_5,Sara,30,ES36209532986776033440,TRX_N-00204-03488990,2021-05-05T18:37:43,Portugalete,Expense,food,-124.75,98231.42
buyer_5,Sara,30,ES36209532986776033440,TRX_N-00205-73323181,2021-05-06T10:08:50,Donostia,Basic services,internet,-70.87,98160.55
buyer_5,Sara,30,ES36209532986776033440,TRX_N-00206-39309343,2021-05-07T23:53:48,Donostia,Basic services,gas,-29.1,98131.45
buyer_5,Sara,30,ES36209532986776033440,TRX_N-00207-14712094,2021-05-09T16:39:35,Donostia,Expense,leisure,-150.62,97980.83
buyer_5,Sara,30,ES36209532986776033440,TRX_N-00208-54016789,2021-05-14T16:11:28,Donostia,Expense,leisure,-73.53,97907.3
buyer_5,Sara,30,ES36209532986776033440,TRX_N-00209-28481898,2021-05-25T20:12:16,Donostia,Expense,repairs,-205.27,97702.03
buyer_5,Sara,30,ES36209532986776033440,TRX_N-00210-48523689,2021-06-01T00:09:30,Donostia,transfer,Salary,3055.89,100757.92
buyer_5,Sara,30,ES36209532986776033440,TRX_N-00211-91599519,2021-06-01T00:09:30,Donostia,transfer,Partner Salary,3147.16,103905.08
buyer_5,Sara,30,ES36209532986776033440,TRX_N-00212-59581296,2021-06-01T00:09:30,Donostia,transfer,Extra Income,305.59,104210.67
buyer_5,Sara,30,ES36209532986776033440,TRX_N-00213-24473123,2021-06-01T00:09:30,Donostia,transfer,Bonus,3289.13,107499.8
buyer_5,Sara,30,ES36209532986776033440,TRX_N-00214-00877324,2021-06-05T10:24:50,Donostia,Housing,Mortgage,-569.36,106930.44
buyer_5,Sara,30,ES36209532986776033440,TRX_N-00215-21001003,2021-06-05T19:13:41,Donostia,Basic services,water,-77.14,106853.3
buyer_5,Sara,30,ES36209532986776033440,TRX_N-00216-83197450,2021-06-05T10:31:26,Donostia,Basic services,electricity,-127.75,106725.55
buyer_5,Sara,30,ES36209532986776033440,TRX_N-00217-15813818,2021-06-06T20:35:28,Donostia,Basic services,phone,-46.5,106679.05
buyer_5,Sara,30,ES36209532986776033440,TRX_N-00218-28814824,2021-06-07T13:37:33,Donostia,Basic services,electricity,-80.46,106598.59
buyer_5,Sara,30,ES36209532986776033440,TRX_N-00219-98700543,2021-06-07T15:04:43,Donostia,Basic services,gas,-38.27,106560.32
buyer_5,Sara,30,ES36209532986776033440,TRX_N-00220-91051952,2021-06-11T09:54:39,Donostia,Expense,leisure,-149.33,106410.99
buyer_5,Sara,30,ES36209532986776033440,TRX_N-00221-52189038,2021-06-15T11:52:26,Donostia,Expense,clothing,-70.92,106340.07
buyer_5,Sara,30,ES36209532986776033440,TRX_N-00222-17169047,2021-06-20T13:24:54,Donostia,Expense,clothing,-39.62,106300.45
buyer_5,Sara,30,ES36209532986776033440,TRX_N-00223-81904963,2021-06-28T18:05:52,Donostia,Expense,education,-55.52,106244.93
buyer_5,Sara,30,ES36209532986776033440,TRX_N-00224-92593339,2021-07-01T13:02:56,Donostia,transfer,Salary,3055.89,109300.82
buyer_5,Sara,30,ES36209532986776033440,TRX_N-00225-78479751,2021-07-01T13:02:56,Donostia,transfer,Partner Salary,3147.16,112447.98
buyer_5,Sara,30,ES36209532986776033440,TRX_N-00226-12888842,2021-07-05T18:56:33,Donostia,Housing,Mortgage,-569.36,111878.62
buyer_5,Sara,30,ES36209532986776033440,TRX_N-00227-62906931,2021-07-06T07:56:13,Donostia,Basic services,gas,-79.1,111799.52
buyer_5,Sara,30,ES36209532986776033440,TRX_N-00228-51377232,2021-07-07T09:55:14,Donostia,Basic services,internet,-48.65,111750.87
buyer_5,Sara,30,ES36209532986776033440,TRX_N-00229-16414714,2021-07-22T02:12:07,Barakaldo,Expense,leisure,-176.38,111574.49
buyer_5,Sara,30,ES36209532986776033440,TRX_N-00230-29719728,2021-07-28T10:42:53,Donostia,Expense,repairs,-810.02,110764.47
buyer_5,Sara,30,ES36209532986776033440,TRX_N-00231-30914949,2021-08-01T13:17:09,Donostia,transfer,Salary,3055.89,113820.36
buyer_5,Sara,30,ES36209532986776033440,TRX_N-00232-85994611,2021-08-01T13:17:09,Donostia,transfer,Partner Salary,3147.16,116967.52
buyer_5,Sara,30,ES36209532986776033440,TRX_N-00233-34518105,2021-08-01T13:17:09,Donostia,transfer,Extra Income,305.59,117273.11
buyer_5,Sara,30,ES36209532986776033440,TRX_N-00234-15278309,2021-08-05T13:50:26,Donostia,Housing,Mortgage,-569.36,116703.75
buyer_5,Sara,30,ES36209532986776033440,TRX_N-00235-75819222,2021-08-05T07:20:29,Donostia,Basic services,water,-62.58,116641.17
buyer_5,Sara,30,ES36209532986776033440,TRX_N-00236-93861346,2021-08-05T19:21:29,Donostia,Basic services,gas,-28.79,116612.38
buyer_5,Sara,30,ES36209532986776033440,TRX_N-00237-03220522,2021-08-05T18:21:49,Donostia,Basic services,phone,-62.39,116549.99
buyer_5,Sara,30,ES36209532986776033440,TRX_N-00238-51532759,2021-08-06T15:44:49,Donostia,Basic services,water,-16.16,116533.83
buyer_5,Sara,30,ES36209532986776033440,TRX_N-00239-59008092,2021-08-07T11:53:53,Donostia,Basic services,water,-47.92,116485.91
buyer_5,Sara,30,ES36209532986776033440,TRX_N-00240-22531403,2021-08-07T11:31:00,Donostia,Basic services,electricity,-96.45,116389.46
buyer_5,Sara,30,ES36209532986776033440,TRX_N-00241-72478497,2021-08-07T01:41:36,Donostia,Basic services,gas,-82.95,116306.51
buyer_5,Sara,30,ES36209532986776033440,TRX_N-00242-44038968,2021-08-20T14:03:43,Donostia,Expense,transport,-197.4,116109.11
buyer_5,Sara,30,ES36209532986776033440,TRX_N-00243-67935566,2021-08-24T07:42:53,Donostia,Expense,transport,-164.52,115944.59
buyer_5,Sara,30,ES36209532986776033440,TRX_N-00244-77963812,2021-08-26T17:22:08,Donostia,Expense,clothing,-50.53,115894.06
buyer_5,Sara,30,ES36209532986776033440,TRX_N-00245-23722649,2021-08-28T10:13:24,Donostia,Expense,clothing,-348.34,115545.72
buyer_5,Sara,30,ES36209532986776033440,TRX_N-00246-96849477,2021-09-01T11:20:06,Donostia,transfer,Salary,3055.89,118601.61
buyer_5,Sara,30,ES36209532986776033440,TRX_N-00247-23082745,2021-09-01T11:20:06,Donostia,transfer,Partner Salary,3147.16,121748.77
buyer_5,Sara,30,ES36209532986776033440,TRX_N-00248-82367749,2021-09-05T15:50:11,Donostia,Housing,Mortgage,-569.36,121179.41
buyer_5,Sara,30,ES36209532986776033440,TRX_N-00249-35256985,2021-09-05T09:20:56,Donostia,Basic services,electricity,-114.37,121065.04
buyer_5,Sara,30,ES36209532986776033440,TRX_N-00250-88837945,2021-09-05T08:51:49,Donostia,Basic services,internet,-50.29,121014.75
buyer_5,Sara,30,ES36209532986776033440,TRX_N-00251-18422518,2021-09-06T15:50:16,Donostia,Basic services,electricity,-132.21,120882.54
buyer_5,Sara,30,ES36209532986776033440,TRX_N-00252-91563882,2021-09-25T17:42:24,Donostia,Expense,food,-392.15,120490.39
buyer_5,Sara,30,ES36209532986776033440,TRX_N-00253-80708887,2021-09-26T06:36:01,Donostia,Expense,gifts,-133.22,120357.17
buyer_5,Sara,30,ES36209532986776033440,TRX_N-00254-93157515,2021-09-28T05:03:49,Donostia,Expense,transport,-129.38,120227.79
buyer_5,Sara,30,ES36209532986776033440,TRX_N-00255-78586285,2021-10-01T14:30:58,Donostia,transfer,Salary,3055.89,123283.68
buyer_5,Sara,30,ES36209532986776033440,TRX_N-00256-30185885,2021-10-01T14:30:58,Donostia,transfer,Partner Salary,3147.16,126430.84
buyer_5,Sara,30,ES36209532986776033440,TRX_N-00257-79555104,2021-10-01T14:30:58,Donostia,transfer,Extra Income,305.59,126736.43
buyer_5,Sara,30,ES36209532986776033440,TRX_N-00258-60022847,2021-10-03T12:56:38,Zuia,Expense,transport,-77.73,126658.7
buyer_5,Sara,30,ES36209532986776033440,TRX_N-00259-29147654,2021-10-05T15:08:01,Donostia,Housing,Mortgage,-569.36,126089.34
buyer_5,Sara,30,ES36209532986776033440,TRX_N-00260-12030625,2021-10-05T15:36:38,Donostia,Basic services,water,-37.48,126051.86
buyer_5,Sara,30,ES36209532986776033440,TRX_N-00261-22145574,2021-10-05T16:02:23,Donostia,Basic services,internet,-49.68,126002.18
buyer_5,Sara,30,ES36209532986776033440,TRX_N-00262-44136127,2021-10-05T13:17:55,Donostia,Basic services,phone,-64.92,125937.26
buyer_5,Sara,30,ES36209532986776033440,TRX_N-00263-15813059,2021-10-06T22:47:41,Donostia,Basic services,phone,-43.04,125894.22
buyer_5,Sara,30,ES36209532986776033440,TRX_N-00264-97197673,2021-10-10T23:16:34,Donostia,Expense,food,-797.19,125097.03
buyer_5,Sara,30,ES36209532986776033440,TRX_N-00265-85586592,2021-10-19T16:41:44,Donostia,Expense,transport,-115.69,124981.34
buyer_5,Sara,30,ES36209532986776033440,TRX_N-00266-57609270,2021-11-01T20:29:20,Donostia,transfer,Salary,3055.89,128037.23
buyer_5,Sara,30,ES36209532986776033440,TRX_N-00267-64313386,2021-11-01T20:29:20,Donostia,transfer,Partner Salary,3147.16,131184.39
buyer_5,Sara,30,ES36209532986776033440,TRX_N-00268-51667090,2021-11-05T11:43:45,Donostia,Housing,Mortgage,-569.36,130615.03
buyer_5,Sara,30,ES36209532986776033440,TRX_N-00269-81697436,2021-11-05T11:27:25,Donostia,Basic services,electricity,-144.44,130470.59
buyer_5,Sara,30,ES36209532986776033440,TRX_N-00270-87548967,2021-11-06T06:56:20,Donostia,Basic services,water,-63.6,130406.99
buyer_5,Sara,30,ES36209532986776033440,TRX_N-00271-70127201,2021-11-06T09:17:05,Donostia,Basic services,electricity,-60.94,130346.05
buyer_5,Sara,30,ES36209532986776033440,TRX_N-00272-57354269,2021-11-07T13:54:11,Donostia,Basic services,water,-42.91,130303.14
buyer_5,Sara,30,ES36209532986776033440,TRX_N-00273-08079429,2021-11-07T11:06:39,Donostia,Basic services,internet,-76.71,130226.43
buyer_5,Sara,30,ES36209532986776033440,TRX_N-00274-91639682,2021-12-01T14:25:18,Donostia,transfer,Salary,3055.89,133282.32
buyer_5,Sara,30,ES36209532986776033440,TRX_N-00275-93496190,2021-12-01T14:25:18,Donostia,transfer,Partner Salary,3147.16,136429.48
buyer_5,Sara,30,ES36209532986776033440,TRX_N-00276-92191811,2021-12-01T14:25:18,Donostia,transfer,Bonus,2754.2,139183.68
buyer_5,Sara,30,ES36209532986776033440,TRX_N-00277-02876683,2021-12-01T12:20:00,Donostia,Expense,food,-312.22,138871.46
buyer_5,Sara,30,ES36209532986776033440,TRX_N-00278-16825844,2021-12-02T14:04:01,Donostia,Expense,transport,-82.98,138788.48
buyer_5,Sara,30,ES36209532986776033440,TRX_N-00279-92531869,2021-12-05T08:12:46,Donostia,Housing,Mortgage,-569.36,138219.12
buyer_5,Sara,30,ES36209532986776033440,TRX_N-00280-03888439,2021-12-05T15:01:15,Donostia,Basic services,phone,-97.08,138122.04
buyer_5,Sara,30,ES36209532986776033440,TRX_N-00281-49387363,2021-12-06T10:28:32,Donostia,Basic services,water,-20.83,138101.21
buyer_5,Sara,30,ES36209532986776033440,TRX_N-00282-95223298,2021-12-06T09:59:50,Donostia,Basic services,gas,-85.91,138015.3
buyer_5,Sara,30,ES36209532986776033440,TRX_N-00283-52319931,2021-12-06T22:31:52,Donostia,Basic services,internet,-54.22,137961.08
buyer_5,Sara,30,ES36209532986776033440,TRX_N-00284-69953601,2021-12-07T11:03:08,Donostia,Basic services,water,-21.65,137939.43
buyer_5,Sara,30,ES36209532986776033440,TRX_N-00285-81941889,2021-12-07T19:24:45,Donostia,Basic services,electricity,-33.94,137905.49
buyer_5,Sara,30,ES36209532986776033440,TRX_N-00286-54644896,2021-12-07T15:03:52,Donostia,Basic services,gas,-62.81,137842.68
buyer_5,Sara,30,ES36209532986776033440,TRX_N-00287-09701404,2021-12-07T10:29:41,Donostia,Expense,transport,-46.98,137795.7
buyer_5,Sara,30,ES36209532986776033440,TRX_N-00288-97896734,2021-12-19T13:55:20,Vitoria-Gasteiz,Expense,food,-728.61,137067.09
buyer_5,Sara,30,ES36209532986776033440,TRX_N-00289-56250118,2021-12-31T02:50:14,Arrasate/Mondragon,Expense,healthcare,-147.9,136919.19
buyer_5,Sara,30,ES36209532986776033440,TRX_N-00290-30813495,2022-01-01T08:50:52,Donostia,transfer,Salary,3055.89,139975.08
buyer_5,Sara,30,ES36209532986776033440,TRX_N-00291-66959214,2022-01-01T08:50:52,Donostia,transfer,Partner Salary,3147.16,143122.24
buyer_5,Sara,30,ES36209532986776033440,TRX_N-00292-97848171,2022-01-01T08:50:52,Donostia,transfer,Extra Income,305.59,143427.83
buyer_5,Sara,30,ES36209532986776033440,TRX_N-00293-93709446,2022-01-02T09:49:15,Donostia,Expense,transport,-99.43,143328.4
buyer_5,Sara,30,ES36209532986776033440,TRX_N-00294-15607203,2022-01-05T15:00:27,Donostia,Housing,Mortgage,-569.36,142759.04
buyer_5,Sara,30,ES36209532986776033440,TRX_N-00295-75701542,2022-01-05T12:00:41,Donostia,Expense,food,-788.22,141970.82
buyer_5,Sara,30,ES36209532986776033440,TRX_N-00296-53288326,2022-01-11T09:44:54,Zarautz,Expense,clothing,-169.72,141801.1
buyer_5,Sara,30,ES36209532986776033440,TRX_N-00297-16377487,2022-01-17T14:31:36,Donostia,Expense,repairs,-686.66,141114.44
buyer_5,Sara,30,ES36209532986776033440,TRX_N-00298-19122500,2022-01-18T14:28:00,Donostia,Expense,transport,-169.5,140944.94
buyer_5,Sara,30,ES36209532986776033440,TRX_N-00299-74221583,2022-01-21T13:47:26,Donostia,Expense,food,-319.24,140625.7
buyer_5,Sara,30,ES36209532986776033440,TRX_N-00300-64268691,2022-02-01T21:38:00,Donostia,transfer,Salary,3055.89,143681.59
buyer_5,Sara,30,ES36209532986776033440,TRX_N-00301-11304465,2022-02-01T21:38:00,Donostia,transfer,Partner Salary,3147.16,146828.75
buyer_5,Sara,30,ES36209532986776033440,TRX_N-00302-42067143,2022-02-05T00:00:19,Donostia,Housing,Mortgage,-569.36,146259.39
buyer_5,Sara,30,ES36209532986776033440,TRX_N-00303-54368614,2022-02-05T13:08:27,Donostia,Basic services,water,-29.37,146230.02
buyer_5,Sara,30,ES36209532986776033440,TRX_N-00304-44854961,2022-02-05T19:52:59,Donostia,Basic services,gas,-40.21,146189.81
buyer_5,Sara,30,ES36209532986776033440,TRX_N-00305-19763760,2022-02-06T09:46:09,Donostia,Basic services,phone,-73.3,146116.51
buyer_5,Sara,30,ES36209532986776033440,TRX_N-00306-31518020,2022-02-06T22:58:14,Donostia,Expense,healthcare,-359.73,145756.78
buyer_5,Sara,30,ES36209532986776033440,TRX_N-00307-97824479,2022-02-07T16:11:40,Donostia,Basic services,electricity,-120.74,145636.04
buyer_5,Sara,30,ES36209532986776033440,TRX_N-00308-39461040,2022-02-07T08:57:52,Donostia,Basic services,phone,-29.33,145606.71
buyer_5,Sara,30,ES36209532986776033440,TRX_N-00309-19575597,2022-02-10T15:15:04,Donostia,Expense,transport,-34.9,145571.81
buyer_5,Sara,30,ES36209532986776033440,TRX_N-00310-64361587,2022-02-20T16:05:10,Donostia,Expense,clothing,-377.87,145193.94
buyer_5,Sara,30,ES36209532986776033440,TRX_N-00311-43109501,2022-03-01T20:02:46,Donostia,transfer,Salary,3055.89,148249.83
buyer_5,Sara,30,ES36209532986776033440,TRX_N-00312-90404531,2022-03-01T20:02:46,Donostia,transfer,Partner Salary,3147.16,151396.99
buyer_5,Sara,30,ES36209532986776033440,TRX_N-00313-01706819,2022-03-01T20:02:46,Donostia,transfer,Extra Income,305.59,151702.58
buyer_5,Sara,30,ES36209532986776033440,TRX_N-00314-80046366,2022-03-05T23:10:34,Donostia,Housing,Mortgage,-569.36,151133.22
buyer_5,Sara,30,ES36209532986776033440,TRX_N-00315-12959384,2022-03-05T19:41:25,Donostia,Basic services,internet,-55.45,151077.77
buyer_5,Sara,30,ES36209532986776033440,TRX_N-00316-44457416,2022-03-05T16:52:38,Donostia,Basic services,phone,-33.06,151044.71
buyer_5,Sara,30,ES36209532986776033440,TRX_N-00317-94476534,2022-03-06T10:18:00,Donostia,Basic services,gas,-30.19,151014.52
buyer_5,Sara,30,ES36209532986776033440,TRX_N-00318-04703107,2022-03-06T09:31:22,Donostia,Basic services,internet,-61.15,150953.37
buyer_5,Sara,30,ES36209532986776033440,TRX_N-00319-56618949,2022-03-06T23:14:55,Donostia,Basic services,phone,-79.58,150873.79
buyer_5,Sara,30,ES36209532986776033440,TRX_N-00320-37061723,2022-03-07T04:40:44,Donostia,Basic services,water,-60.03,150813.76
buyer_5,Sara,30,ES36209532986776033440,TRX_N-00321-19212862,2022-03-07T17:16:58,Donostia,Basic services,phone,-60.11,150753.65
buyer_5,Sara,30,ES36209532986776033440,TRX_N-00322-18473872,2022-03-12T08:16:48,Donostia,Expense,transport,-70.39,150683.26
buyer_5,Sara,30,ES36209532986776033440,TRX_N-00323-42818782,2022-03-19T01:05:04,Donostia,Expense,travel,-1725.92,148957.34
buyer_5,Sara,30,ES36209532986776033440,TRX_N-00324-98852677,2022-04-01T17:19:03,Donostia,transfer,Salary,3055.89,152013.23
buyer_5,Sara,30,ES36209532986776033440,TRX_N-00325-29154726,2022-04-01T17:19:03,Donostia,transfer,Partner Salary,3147.16,155160.39
buyer_5,Sara,30,ES36209532986776033440,TRX_N-00326-51030130,2022-04-05T09:48:49,Donostia,Housing,Mortgage,-569.36,154591.03
buyer_5,Sara,30,ES36209532986776033440,TRX_N-00327-61340946,2022-04-05T08:21:29,Donostia,Basic services,water,-35.22,154555.81
buyer_5,Sara,30,ES36209532986776033440,TRX_N-00328-88448536,2022-04-05T13:38:48,Donostia,Basic services,gas,-19.49,154536.32
buyer_5,Sara,30,ES36209532986776033440,TRX_N-00329-51399243,2022-04-06T17:02:50,Donostia,Basic services,gas,-37.88,154498.44
buyer_5,Sara,30,ES36209532986776033440,TRX_N-00330-56968865,2022-04-06T11:18:38,Donostia,Basic services,internet,-75.44,154423.0
buyer_5,Sara,30,ES36209532986776033440,TRX_N-00331-51056674,2022-04-07T15:42:13,Donostia,Basic services,water,-43.05,154379.95
buyer_5,Sara,30,ES36209532986776033440,TRX_N-00332-92828227,2022-04-07T19:15:57,Donostia,Basic services,gas,-81.49,154298.46
buyer_5,Sara,30,ES36209532986776033440,TRX_N-00333-21826641,2022-04-13T10:33:27,Donostia,Expense,food,-189.02,154109.44
buyer_5,Sara,30,ES36209532986776033440,TRX_N-00334-19603071,2022-05-01T22:29:44,Donostia,transfer,Salary,3055.89,157165.33
buyer_5,Sara,30,ES36209532986776033440,TRX_N-00335-31745781,2022-05-01T22:29:44,Donostia,transfer,Partner Salary,3147.16,160312.49
buyer_5,Sara,30,ES36209532986776033440,TRX_N-00336-12952652,2022-05-05T02:35:00,Donostia,Housing,Mortgage,-569.36,159743.13
buyer_5,Sara,30,ES36209532986776033440,TRX_N-00337-21619547,2022-05-05T08:24:56,Donostia,Basic services,phone,-51.14,159691.99
buyer_5,Sara,30,ES36209532986776033440,TRX_N-00338-12923238,2022-05-06T12:00:44,Donostia,Basic services,internet,-57.14,159634.85
buyer_5,Sara,30,ES36209532986776033440,TRX_N-00339-10760496,2022-05-06T18:36:54,Donostia,Basic services,phone,-88.41,159546.44
buyer_5,Sara,30,ES36209532986776033440,TRX_N-00340-49462472,2022-05-07T08:11:25,Donostia,Basic services,electricity,-118.24,159428.2
buyer_5,Sara,30,ES36209532986776033440,TRX_N-00341-27444323,2022-05-11T10:23:35,Zuia,Expense,leisure,-27.54,159400.66
buyer_5,Sara,30,ES36209532986776033440,TRX_N-00342-50216350,2022-05-19T11:44:52,Donostia,Expense,clothing,-228.41,159172.25
buyer_5,Sara,30,ES36209532986776033440,TRX_N-00343-74301381,2022-05-26T17:53:12,Basauri,Expense,healthcare,-121.62,159050.63
buyer_5,Sara,30,ES36209532986776033440,TRX_N-00344-18344522,2022-06-01T21:32:59,Donostia,transfer,Salary,3055.89,162106.52
buyer_5,Sara,30,ES36209532986776033440,TRX_N-00345-74949093,2022-06-01T21:32:59,Donostia,transfer,Partner Salary,3147.16,165253.68
buyer_5,Sara,30,ES36209532986776033440,TRX_N-00346-49230103,2022-06-01T21:32:59,Donostia,transfer,Extra Income,305.59,165559.27
buyer_5,Sara,30,ES36209532986776033440,TRX_N-00347-89228498,2022-06-01T21:32:59,Donostia,transfer,Bonus,2893.14,168452.41
buyer_5,Sara,30,ES36209532986776033440,TRX_N-00348-28425799,2022-06-01T17:45:43,Donostia,Expense,food,-159.86,168292.55
buyer_5,Sara,30,ES36209532986776033440,TRX_N-00349-92887889,2022-06-05T16:30:38,Donostia,Housing,Mortgage,-569.36,167723.19
buyer_5,Sara,30,ES36209532986776033440,TRX_N-00350-16693839,2022-06-05T09:07:17,Donostia,Basic services,gas,-53.18,167670.01
buyer_5,Sara,30,ES36209532986776033440,TRX_N-00351-65092827,2022-06-06T20:08:29,Donostia,Basic services,water,-44.76,167625.25
buyer_5,Sara,30,ES36209532986776033440,TRX_N-00352-94632980,2022-06-06T11:10:55,Donostia,Basic services,electricity,-116.62,167508.63
buyer_5,Sara,30,ES36209532986776033440,TRX_N-00353-38889610,2022-06-06T09:33:10,Donostia,Basic services,gas,-75.39,167433.24
buyer_5,Sara,30,ES36209532986776033440,TRX_N-00354-95331157,2022-06-06T10:32:46,Donostia,Basic services,phone,-95.31,167337.93
buyer_5,Sara,30,ES36209532986776033440,TRX_N-00355-01710085,2022-06-07T10:46:51,Donostia,Basic services,water,-45.59,167292.34
buyer_5,Sara,30,ES36209532986776033440,TRX_N-00356-39633079,2022-06-07T14:50:56,Donostia,Basic services,gas,-84.41,167207.93
buyer_5,Sara,30,ES36209532986776033440,TRX_N-00357-56409766,2022-06-07T09:51:07,Donostia,Basic services,phone,-75.15,167132.78
buyer_5,Sara,30,ES36209532986776033440,TRX_N-00358-27453380,2022-06-15T11:05:35,Donostia,Expense,food,-703.67,166429.11
buyer_5,Sara,30,ES36209532986776033440,TRX_N-00359-14488813,2022-06-18T15:26:02,Donostia,Expense,leisure,-294.58,166134.53
buyer_5,Sara,30,ES36209532986776033440,TRX_N-00360-57921431,2022-06-20T19:16:48,Eibar,Expense,clothing,-237.62,165896.91
buyer_5,Sara,30,ES36209532986776033440,TRX_N-00361-36596510,2022-06-28T23:29:24,Donostia,Expense,food,-148.01,165748.9
buyer_5,Sara,30,ES36209532986776033440,TRX_N-00362-65630374,2022-07-01T17:10:22,Donostia,transfer,Salary,3055.89,168804.79
buyer_5,Sara,30,ES36209532986776033440,TRX_N-00363-01715741,2022-07-01T17:10:22,Donostia,transfer,Partner Salary,3147.16,171951.95
buyer_5,Sara,30,ES36209532986776033440,TRX_N-00364-98449782,2022-07-01T18:37:12,Donostia,Expense,education,-898.24,171053.71
buyer_5,Sara,30,ES36209532986776033440,TRX_N-00365-15484090,2022-07-05T10:46:24,Donostia,Housing,Mortgage,-569.36,170484.35
buyer_5,Sara,30,ES36209532986776033440,TRX_N-00366-83450153,2022-07-05T11:03:40,Donostia,Basic services,water,-62.24,170422.11
buyer_5,Sara,30,ES36209532986776033440,TRX_N-00367-81937895,2022-07-05T13:24:26,Donostia,Basic services,electricity,-127.23,170294.88
buyer_5,Sara,30,ES36209532986776033440,TRX_N-00368-26582124,2022-07-07T13:39:56,Donostia,Basic services,electricity,-118.66,170176.22
buyer_5,Sara,30,ES36209532986776033440,TRX_N-00369-48742924,2022-07-07T19:27:51,Donostia,Basic services,phone,-39.9,170136.32
buyer_5,Sara,30,ES36209532986776033440,TRX_N-00370-51188025,2022-07-10T16:31:44,Lasarte-Oria,Expense,food,-230.24,169906.08
buyer_5,Sara,30,ES36209532986776033440,TRX_N-00371-14362946,2022-07-21T09:10:31,Eibar,Expense,transport,-158.8,169747.28
buyer_5,Sara,30,ES36209532986776033440,TRX_N-00372-44377816,2022-07-23T15:24:47,Donostia,Expense,healthcare,-107.46,169639.82
buyer_5,Sara,30,ES36209532986776033440,TRX_N-00373-23582738,2022-07-27T16:26:24,Donostia,Expense,clothing,-221.99,169417.83
buyer_5,Sara,30,ES36209532986776033440,TRX_N-00374-26362239,2022-08-01T13:55:40,Donostia,transfer,Salary,3055.89,172473.72
buyer_5,Sara,30,ES36209532986776033440,TRX_N-00375-61267918,2022-08-01T13:55:40,Donostia,transfer,Partner Salary,3147.16,175620.88
buyer_5,Sara,30,ES36209532986776033440,TRX_N-00376-95734033,2022-08-05T16:38:35,Donostia,Housing,Mortgage,-569.36,175051.52
buyer_5,Sara,30,ES36209532986776033440,TRX_N-00377-60100838,2022-08-05T17:43:28,Donostia,Basic services,electricity,-58.95,174992.57
buyer_5,Sara,30,ES36209532986776033440,TRX_N-00378-33540650,2022-08-05T10:07:00,Donostia,Basic services,gas,-19.63,174972.94
buyer_5,Sara,30,ES36209532986776033440,TRX_N-00379-98312877,2022-08-05T09:13:08,Donostia,Basic services,phone,-27.71,174945.23
buyer_5,Sara,30,ES36209532986776033440,TRX_N-00380-16860765,2022-08-06T13:53:50,Donostia,Basic services,gas,-49.8,174895.43
buyer_5,Sara,30,ES36209532986776033440,TRX_N-00381-29068273,2022-08-06T11:13:54,Donostia,Basic services,internet,-67.36,174828.07
buyer_5,Sara,30,ES36209532986776033440,TRX_N-00382-88488222,2022-08-07T16:48:42,Donostia,Basic services,electricity,-72.01,174756.06
buyer_5,Sara,30,ES36209532986776033440,TRX_N-00383-18416066,2022-09-01T14:31:55,Donostia,transfer,Salary,3055.89,177811.95
buyer_5,Sara,30,ES36209532986776033440,TRX_N-00384-59827106,2022-09-01T14:31:55,Donostia,transfer,Partner Salary,3147.16,180959.11
buyer_5,Sara,30,ES36209532986776033440,TRX_N-00385-19106695,2022-09-01T14:31:55,Donostia,transfer,Extra Income,305.59,181264.7
buyer_5,Sara,30,ES36209532986776033440,TRX_N-00386-12356468,2022-09-05T15:17:57,Donostia,Housing,Mortgage,-569.36,180695.34
buyer_5,Sara,30,ES36209532986776033440,TRX_N-00387-47775993,2022-09-05T21:49:17,Donostia,Basic services,electricity,-31.96,180663.38
buyer_5,Sara,30,ES36209532986776033440,TRX_N-00388-33893462,2022-09-05T08:18:10,Donostia,Basic services,internet,-65.09,180598.29
buyer_5,Sara,30,ES36209532986776033440,TRX_N-00389-54408213,2022-09-06T09:04:49,Donostia,Basic services,gas,-26.84,180571.45
buyer_5,Sara,30,ES36209532986776033440,TRX_N-00390-06857514,2022-09-15T17:47:02,Donostia,Expense,leisure,-63.24,180508.21
buyer_5,Sara,30,ES36209532986776033440,TRX_N-00391-45633964,2022-09-16T20:45:48,Donostia,Expense,food,-293.73,180214.48
buyer_5,Sara,30,ES36209532986776033440,TRX_N-00392-05266898,2022-09-17T20:44:27,Donostia,Expense,transport,-73.23,180141.25
buyer_5,Sara,30,ES36209532986776033440,TRX_N-00393-86782731,2022-09-17T16:27:11,Donostia,Expense,travel,-2322.07,177819.18
buyer_5,Sara,30,ES36209532986776033440,TRX_N-00394-92334404,2022-10-01T08:58:38,Donostia,transfer,Salary,3055.89,180875.07
buyer_5,Sara,30,ES36209532986776033440,TRX_N-00395-46500148,2022-10-01T08:58:38,Donostia,transfer,Partner Salary,3147.16,184022.23
buyer_5,Sara,30,ES36209532986776033440,TRX_N-00396-99560605,2022-10-02T09:29:10,Iruña de Oca,Expense,gifts,-216.54,183805.69
buyer_5,Sara,30,ES36209532986776033440,TRX_N-00397-34041474,2022-10-05T02:56:26,Donostia,Housing,Mortgage,-569.36,183236.33
buyer_5,Sara,30,ES36209532986776033440,TRX_N-00398-82493630,2022-10-05T21:22:53,Donostia,Basic services,internet,-74.76,183161.57
buyer_5,Sara,30,ES36209532986776033440,TRX_N-00399-22661381,2022-10-05T00:07:05,Donostia,Basic services,phone,-27.61,183133.96
buyer_5,Sara,30,ES36209532986776033440,TRX_N-00400-06020603,2022-10-06T10:41:29,Donostia,Basic services,phone,-77.21,183056.75
buyer_5,Sara,30,ES36209532986776033440,TRX_N-00401-62352414,2022-10-07T09:50:46,Donostia,Basic services,gas,-56.17,183000.58
buyer_5,Sara,30,ES36209532986776033440,TRX_N-00402-46985882,2022-10-07T18:11:58,Donostia,Basic services,internet,-47.86,182952.72
buyer_5,Sara,30,ES36209532986776033440,TRX_N-00403-60497864,2022-10-08T14:49:56,Donostia,Expense,travel,-604.48,182348.24
buyer_5,Sara,30,ES36209532986776033440,TRX_N-00404-60094169,2022-10-25T13:22:51,Donostia,Expense,healthcare,-37.87,182310.37
buyer_5,Sara,30,ES36209532986776033440,TRX_N-00405-62507034,2022-10-29T13:10:13,Donostia,Expense,food,-601.71,181708.66
buyer_5,Sara,30,ES36209532986776033440,TRX_N-00406-24253934,2022-11-01T00:02:03,Donostia,transfer,Salary,3055.89,184764.55
buyer_5,Sara,30,ES36209532986776033440,TRX_N-00407-15779715,2022-11-01T00:02:03,Donostia,transfer,Partner Salary,3147.16,187911.71
buyer_5,Sara,30,ES36209532986776033440,TRX_N-00408-57777481,2022-11-01T00:02:03,Donostia,transfer,Extra Income,305.59,188217.3
buyer_5,Sara,30,ES36209532986776033440,TRX_N-00409-71706235,2022-11-01T20:34:13,Donostia,Expense,healthcare,-35.78,188181.52
buyer_5,Sara,30,ES36209532986776033440,TRX_N-00410-25011440,2022-11-03T02:05:57,Vitoria-Gasteiz,Expense,travel,-2771.9,185409.62
buyer_5,Sara,30,ES36209532986776033440,TRX_N-00411-99004855,2022-11-05T16:23:49,Donostia,Housing,Mortgage,-569.36,184840.26
buyer_5,Sara,30,ES36209532986776033440,TRX_N-00412-84880750,2022-11-05T20:56:48,Donostia,Basic services,electricity,-122.25,184718.01
buyer_5,Sara,30,ES36209532986776033440,TRX_N-00413-35843722,2022-11-05T13:34:46,Donostia,Basic services,gas,-68.23,184649.78
buyer_5,Sara,30,ES36209532986776033440,TRX_N-00414-63737959,2022-11-05T18:17:23,Donostia,Basic services,internet,-51.77,184598.01
buyer_5,Sara,30,ES36209532986776033440,TRX_N-00415-46230520,2022-11-05T19:42:20,Donostia,Basic services,phone,-84.61,184513.4
buyer_5,Sara,30,ES36209532986776033440,TRX_N-00416-83645647,2022-11-06T15:36:58,Donostia,Basic services,internet,-58.75,184454.65
buyer_5,Sara,30,ES36209532986776033440,TRX_N-00417-85254874,2022-11-07T16:17:39,Donostia,Basic services,water,-50.86,184403.79
buyer_5,Sara,30,ES36209532986776033440,TRX_N-00418-41764673,2022-11-07T14:05:09,Donostia,Basic services,internet,-66.13,184337.66
buyer_5,Sara,30,ES36209532986776033440,TRX_N-00419-98149057,2022-11-07T21:49:58,Donostia,Basic services,phone,-67.88,184269.78
buyer_5,Sara,30,ES36209532986776033440,TRX_N-00420-14392912,2022-11-09T03:38:30,Donostia,Expense,clothing,-199.43,184070.35
buyer_5,Sara,30,ES36209532986776033440,TRX_N-00421-87275424,2022-11-17T16:55:42,Donostia,Expense,transport,-21.57,184048.78
buyer_5,Sara,30,ES36209532986776033440,TRX_N-00422-11955930,2022-11-23T11:35:56,Iruña de Oca,Expense,leisure,-227.78,183821.0
buyer_5,Sara,30,ES36209532986776033440,TRX_N-00423-40918151,2022-11-27T21:29:43,Donostia,Expense,food,-758.78,183062.22
buyer_5,Sara,30,ES36209532986776033440,TRX_N-00424-54840653,2022-12-01T19:04:48,Donostia,transfer,Salary,3055.89,186118.11
buyer_5,Sara,30,ES36209532986776033440,TRX_N-00425-82354147,2022-12-01T19:04:48,Donostia,transfer,Partner Salary,3147.16,189265.27
buyer_5,Sara,30,ES36209532986776033440,TRX_N-00426-87088093,2022-12-01T19:04:48,Donostia,transfer,Bonus,3251.06,192516.33
buyer_5,Sara,30,ES36209532986776033440,TRX_N-00427-85057886,2022-12-05T13:41:37,Donostia,Housing,Mortgage,-569.36,191946.97
buyer_5,Sara,30,ES36209532986776033440,TRX_N-00428-11421078,2022-12-05T20:12:12,Donostia,Basic services,phone,-60.01,191886.96
buyer_5,Sara,30,ES36209532986776033440,TRX_N-00429-86307317,2022-12-06T14:26:45,Donostia,Basic services,gas,-24.84,191862.12
buyer_5,Sara,30,ES36209532986776033440,TRX_N-00430-82850160,2022-12-07T14:56:13,Donostia,Basic services,water,-43.73,191818.39
buyer_5,Sara,30,ES36209532986776033440,TRX_N-00431-40650019,2022-12-09T18:21:30,Donostia,Expense,food,-585.92,191232.47
buyer_5,Sara,30,ES36209532986776033440,TRX_N-00432-28886207,2022-12-12T21:35:04,Donostia,Expense,transport,-158.03,191074.44
buyer_5,Sara,30,ES36209532986776033440,TRX_N-00433-68538346,2022-12-16T11:25:53,Donostia,Expense,transport,-57.89,191016.55
buyer_5,Sara,30,ES36209532986776033440,TRX_N-00434-68634432,2023-01-01T20:53:29,Donostia,transfer,Salary,3055.89,194072.44
buyer_5,Sara,30,ES36209532986776033440,TRX_N-00435-88826589,2023-01-01T20:53:29,Donostia,transfer,Partner Salary,3147.16,197219.6
buyer_5,Sara,30,ES36209532986776033440,TRX_N-00436-15099840,2023-01-05T20:45:41,Donostia,Housing,Mortgage,-569.36,196650.24
buyer_5,Sara,30,ES36209532986776033440,TRX_N-00437-63574466,2023-01-05T19:08:31,Donostia,Basic services,water,-13.19,196637.05
buyer_5,Sara,30,ES36209532986776033440,TRX_N-00438-00580459,2023-01-05T09:12:35,Donostia,Basic services,electricity,-144.89,196492.16
buyer_5,Sara,30,ES36209532986776033440,TRX_N-00439-22031055,2023-01-06T12:13:00,Donostia,Basic services,internet,-41.49,196450.67
buyer_5,Sara,30,ES36209532986776033440,TRX_N-00440-32051695,2023-01-06T11:46:06,Donostia,Basic services,phone,-93.67,196357.0
buyer_5,Sara,30,ES36209532986776033440,TRX_N-00441-59615053,2023-01-07T09:04:42,Donostia,Basic services,internet,-79.4,196277.6
buyer_5,Sara,30,ES36209532986776033440,TRX_N-00442-68133461,2023-01-07T03:00:35,Donostia,Basic services,phone,-99.75,196177.85
buyer_5,Sara,30,ES36209532986776033440,TRX_N-00443-85041360,2023-02-01T11:41:33,Donostia,transfer,Salary,3055.89,199233.74
buyer_5,Sara,30,ES36209532986776033440,TRX_N-00444-25536162,2023-02-01T11:41:33,Donostia,transfer,Partner Salary,3147.16,202380.9
buyer_5,Sara,30,ES36209532986776033440,TRX_N-00445-10067287,2023-02-01T11:41:33,Donostia,transfer,Extra Income,305.59,202686.49
buyer_5,Sara,30,ES36209532986776033440,TRX_N-00446-52526380,2023-02-05T13:34:09,Donostia,Housing,Mortgage,-569.36,202117.13
buyer_5,Sara,30,ES36209532986776033440,TRX_N-00447-40075748,2023-02-05T15:26:53,Donostia,Basic services,gas,-58.19,202058.94
buyer_5,Sara,30,ES36209532986776033440,TRX_N-00448-32888529,2023-02-05T13:34:22,Donostia,Basic services,internet,-78.33,201980.61
buyer_5,Sara,30,ES36209532986776033440,TRX_N-00449-92431335,2023-02-06T17:00:40,Donostia,Basic services,electricity,-78.8,201901.81
buyer_5,Sara,30,ES36209532986776033440,TRX_N-00450-45434697,2023-02-06T13:39:33,Donostia,Basic services,internet,-32.06,201869.75
buyer_5,Sara,30,ES36209532986776033440,TRX_N-00451-62882784,2023-02-07T13:31:04,Donostia,Basic services,gas,-92.16,201777.59
buyer_5,Sara,30,ES36209532986776033440,TRX_N-00452-80393579,2023-02-07T11:39:03,Donostia,Basic services,internet,-78.32,201699.27
buyer_5,Sara,30,ES36209532986776033440,TRX_N-00453-98298945,2023-02-25T14:49:17,Donostia,Expense,clothing,-467.69,201231.58
buyer_5,Sara,30,ES36209532986776033440,TRX_N-00454-24719925,2023-03-01T05:03:59,Donostia,transfer,Salary,3055.89,204287.47
buyer_5,Sara,30,ES36209532986776033440,TRX_N-00455-83696148,2023-03-01T05:03:59,Donostia,transfer,Partner Salary,3147.16,207434.63
buyer_5,Sara,30,ES36209532986776033440,TRX_N-00456-75411666,2023-03-01T15:28:40,Donostia,Expense,transport,-133.8,207300.83
buyer_5,Sara,30,ES36209532986776033440,TRX_N-00457-64583040,2023-03-05T12:52:21,Donostia,Housing,Mortgage,-569.36,206731.47
buyer_5,Sara,30,ES36209532986776033440,TRX_N-00458-02746847,2023-03-05T12:32:29,Donostia,Basic services,water,-49.89,206681.58
buyer_5,Sara,30,ES36209532986776033440,TRX_N-00459-24638453,2023-03-05T06:10:27,Donostia,Basic services,gas,-27.48,206654.1
buyer_5,Sara,30,ES36209532986776033440,TRX_N-00460-64151223,2023-03-05T17:46:24,Donostia,Basic services,internet,-45.84,206608.26
buyer_5,Sara,30,ES36209532986776033440,TRX_N-00461-64299356,2023-03-06T22:02:38,Donostia,Basic services,water,-27.33,206580.93
buyer_5,Sara,30,ES36209532986776033440,TRX_N-00462-54144608,2023-03-06T19:16:04,Donostia,Basic services,gas,-88.13,206492.8
buyer_5,Sara,30,ES36209532986776033440,TRX_N-00463-90425725,2023-03-06T08:54:13,Donostia,Basic services,phone,-54.17,206438.63
buyer_5,Sara,30,ES36209532986776033440,TRX_N-00464-38401591,2023-03-07T16:26:23,Donostia,Basic services,electricity,-117.58,206321.05
buyer_5,Sara,30,ES36209532986776033440,TRX_N-00465-53850162,2023-03-20T15:53:12,Irun,Expense,healthcare,-54.63,206266.42
buyer_5,Sara,30,ES36209532986776033440,TRX_N-00466-18783244,2023-03-24T20:57:19,Donostia,Expense,education,-381.8,205884.62
buyer_5,Sara,30,ES36209532986776033440,TRX_N-00467-05794072,2023-04-01T17:27:49,Donostia,transfer,Salary,3055.89,208940.51
buyer_5,Sara,30,ES36209532986776033440,TRX_N-00468-50968300,2023-04-01T17:27:49,Donostia,transfer,Partner Salary,3147.16,212087.67
buyer_5,Sara,30,ES36209532986776033440,TRX_N-00469-32008004,2023-04-03T21:35:55,Donostia,Expense,leisure,-111.47,211976.2
buyer_5,Sara,30,ES36209532986776033440,TRX_N-00470-42674528,2023-04-05T17:54:34,Donostia,Housing,Mortgage,-569.36,211406.84
buyer_5,Sara,30,ES36209532986776033440,TRX_N-00471-73385732,2023-04-05T09:49:37,Donostia,Basic services,internet,-78.94,211327.9
buyer_5,Sara,30,ES36209532986776033440,TRX_N-00472-59202067,2023-04-06T17:50:59,Donostia,Basic services,gas,-93.36,211234.54
buyer_5,Sara,30,ES36209532986776033440,TRX_N-00473-50319649,2023-04-07T11:55:41,Donostia,Basic services,water,-38.6,211195.94
buyer_5,Sara,30,ES36209532986776033440,TRX_N-00474-35695575,2023-04-07T17:10:01,Donostia,Basic services,gas,-95.27,211100.67
buyer_5,Sara,30,ES36209532986776033440,TRX_N-00475-48395678,2023-04-07T12:31:01,Mungia,Expense,leisure,-139.22,210961.45
buyer_5,Sara,30,ES36209532986776033440,TRX_N-00476-72093359,2023-04-07T20:47:52,Donostia,Expense,clothing,-212.02,210749.43
buyer_5,Sara,30,ES36209532986776033440,TRX_N-00477-04150654,2023-04-09T15:03:06,Bermeo,Expense,transport,-39.35,210710.08
buyer_5,Sara,30,ES36209532986776033440,TRX_N-00478-01047822,2023-04-16T15:41:43,Donostia,Expense,education,-143.2,210566.88
buyer_5,Sara,30,ES36209532986776033440,TRX_N-00479-53499412,2023-04-18T21:53:37,Donostia,Expense,travel,-2521.61,208045.27
buyer_5,Sara,30,ES36209532986776033440,TRX_N-00480-47478965,2023-04-30T09:34:59,Donostia,Expense,travel,-2145.74,205899.53
buyer_5,Sara,30,ES36209532986776033440,TRX_N-00481-33427096,2023-05-01T20:31:05,Donostia,transfer,Salary,3055.89,208955.42
buyer_5,Sara,30,ES36209532986776033440,TRX_N-00482-00130571,2023-05-01T20:31:05,Donostia,transfer,Partner Salary,3147.16,212102.58
buyer_5,Sara,30,ES36209532986776033440,TRX_N-00483-10746793,2023-05-01T20:31:05,Donostia,transfer,Extra Income,305.59,212408.17
buyer_5,Sara,30,ES36209532986776033440,TRX_N-00484-00050822,2023-05-05T04:17:27,Donostia,Housing,Mortgage,-569.36,211838.81
buyer_5,Sara,30,ES36209532986776033440,TRX_N-00485-56159616,2023-05-06T20:26:16,Donostia,Basic services,water,-23.03,211815.78
buyer_5,Sara,30,ES36209532986776033440,TRX_N-00486-95146911,2023-05-06T15:52:51,Donostia,Basic services,internet,-56.52,211759.26
buyer_5,Sara,30,ES36209532986776033440,TRX_N-00487-57212670,2023-05-06T14:50:51,Donostia,Basic services,phone,-24.15,211735.11
buyer_5,Sara,30,ES36209532986776033440,TRX_N-00488-69692721,2023-05-07T17:20:34,Donostia,Basic services,gas,-34.1,211701.01
buyer_5,Sara,30,ES36209532986776033440,TRX_N-00489-26962033,2023-05-12T15:24:54,Donostia,Expense,leisure,-77.1,211623.91
buyer_5,Sara,30,ES36209532986776033440,TRX_N-00490-28020870,2023-05-20T10:18:25,Donostia,Expense,transport,-173.96,211449.95
buyer_5,Sara,30,ES36209532986776033440,TRX_N-00491-27628521,2023-06-01T10:27:52,Donostia,transfer,Salary,3055.89,214505.84
buyer_5,Sara,30,ES36209532986776033440,TRX_N-00492-17796392,2023-06-01T10:27:52,Donostia,transfer,Partner Salary,3147.16,217653.0
buyer_5,Sara,30,ES36209532986776033440,TRX_N-00493-48062886,2023-06-01T10:27:52,Donostia,transfer,Bonus,3033.64,220686.64
buyer_5,Sara,30,ES36209532986776033440,TRX_N-00494-58515600,2023-06-05T08:45:47,Donostia,Housing,Mortgage,-569.36,220117.28
buyer_5,Sara,30,ES36209532986776033440,TRX_N-00495-68511951,2023-06-05T20:19:15,Donostia,Basic services,water,-47.83,220069.45
buyer_5,Sara,30,ES36209532986776033440,TRX_N-00496-69457415,2023-06-05T22:23:19,Donostia,Basic services,gas,-40.34,220029.11
buyer_5,Sara,30,ES36209532986776033440,TRX_N-00497-50897913,2023-06-07T18:25:48,Donostia,Basic services,water,-77.63,219951.48
buyer_5,Sara,30,ES36209532986776033440,TRX_N-00498-02979298,2023-06-09T16:43:57,Donostia,Expense,repairs,-90.97,219860.51
buyer_5,Sara,30,ES36209532986776033440,TRX_N-00499-39240782,2023-06-15T19:40:15,Donostia,Expense,food,-523.02,219337.49
buyer_5,Sara,30,ES36209532986776033440,TRX_N-00500-18235700,2023-06-16T19:14:06,Donostia,Expense,healthcare,-216.76,219120.73
buyer_5,Sara,30,ES36209532986776033440,TRX_N-00501-10716065,2023-06-28T18:05:02,Donostia,Expense,transport,-197.37,218923.36
buyer_5,Sara,30,ES36209532986776033440,TRX_N-00502-92695381,2023-06-28T20:08:12,Donostia,Expense,appliances,-1259.48,217663.88
buyer_5,Sara,30,ES36209532986776033440,TRX_N-00503-78297797,2023-06-30T13:38:58,Donostia,Expense,food,-107.28,217556.6
buyer_5,Sara,30,ES36209532986776033440,TRX_N-00504-14955141,2023-07-01T05:12:01,Donostia,transfer,Salary,3055.89,220612.49
buyer_5,Sara,30,ES36209532986776033440,TRX_N-00505-58512469,2023-07-01T05:12:01,Donostia,transfer,Partner Salary,3147.16,223759.65
buyer_5,Sara,30,ES36209532986776033440,TRX_N-00506-22292514,2023-07-01T05:12:01,Donostia,transfer,Extra Income,305.59,224065.24
buyer_5,Sara,30,ES36209532986776033440,TRX_N-00507-54779440,2023-07-05T05:13:47,Donostia,Housing,Mortgage,-569.36,223495.88
buyer_5,Sara,30,ES36209532986776033440,TRX_N-00508-17911406,2023-07-05T17:51:14,Donostia,Basic services,water,-28.2,223467.68
buyer_5,Sara,30,ES36209532986776033440,TRX_N-00509-16428381,2023-07-05T16:32:44,Donostia,Basic services,phone,-70.55,223397.13
buyer_5,Sara,30,ES36209532986776033440,TRX_N-00510-87002930,2023-07-06T17:19:45,Donostia,Basic services,gas,-38.64,223358.49
buyer_5,Sara,30,ES36209532986776033440,TRX_N-00511-92769644,2023-07-06T15:12:39,Donostia,Basic services,phone,-80.31,223278.18
buyer_5,Sara,30,ES36209532986776033440,TRX_N-00512-43278865,2023-07-12T04:05:02,Donostia,Expense,education,-854.18,222424.0
buyer_5,Sara,30,ES36209532986776033440,TRX_N-00513-71449529,2023-07-25T18:14:34,Donostia,Expense,food,-701.74,221722.26
buyer_5,Sara,30,ES36209532986776033440,TRX_N-00514-59752174,2023-08-01T19:03:39,Donostia,transfer,Salary,3055.89,224778.15
buyer_5,Sara,30,ES36209532986776033440,TRX_N-00515-72360824,2023-08-01T19:03:39,Donostia,transfer,Partner Salary,3147.16,227925.31
buyer_5,Sara,30,ES36209532986776033440,TRX_N-00516-37174167,2023-08-04T20:15:32,Berango,Expense,transport,-109.21,227816.1
buyer_5,Sara,30,ES36209532986776033440,TRX_N-00517-72925930,2023-08-05T17:20:36,Donostia,Housing,Mortgage,-569.36,227246.74
buyer_5,Sara,30,ES36209532986776033440,TRX_N-00518-84615548,2023-08-05T12:49:34,Donostia,Basic services,internet,-46.67,227200.07
buyer_5,Sara,30,ES36209532986776033440,TRX_N-00519-55905228,2023-08-07T14:30:55,Donostia,Basic services,phone,-83.39,227116.68
buyer_5,Sara,30,ES36209532986776033440,TRX_N-00520-98570499,2023-08-29T14:42:19,Donostia,Expense,food,-328.64,226788.04
buyer_5,Sara,30,ES36209532986776033440,TRX_N-00521-69004803,2023-09-01T14:59:51,Donostia,transfer,Salary,3055.89,229843.93
buyer_5,Sara,30,ES36209532986776033440,TRX_N-00522-30398986,2023-09-01T14:59:51,Donostia,transfer,Partner Salary,3147.16,232991.09
buyer_5,Sara,30,ES36209532986776033440,TRX_N-00523-33539926,2023-09-05T17:48:52,Donostia,Housing,Mortgage,-569.36,232421.73
buyer_5,Sara,30,ES36209532986776033440,TRX_N-00524-03218083,2023-09-05T19:38:55,Donostia,Basic services,water,-32.65,232389.08
buyer_5,Sara,30,ES36209532986776033440,TRX_N-00525-06924118,2023-09-05T11:17:05,Donostia,Basic services,electricity,-113.08,232276.0
buyer_5,Sara,30,ES36209532986776033440,TRX_N-00526-72499310,2023-09-05T14:00:42,Donostia,Basic services,gas,-80.74,232195.26
buyer_5,Sara,30,ES36209532986776033440,TRX_N-00527-30897881,2023-09-05T07:13:42,Donostia,Basic services,internet,-56.58,232138.68
buyer_5,Sara,30,ES36209532986776033440,TRX_N-00528-60942205,2023-09-05T02:59:29,Donostia,Basic services,phone,-61.07,232077.61
buyer_5,Sara,30,ES36209532986776033440,TRX_N-00529-79983029,2023-09-05T11:03:06,Alegría-Dulantzi,Expense,clothing,-189.19,231888.42
buyer_5,Sara,30,ES36209532986776033440,TRX_N-00530-06566067,2023-09-06T18:14:30,Donostia,Basic services,gas,-95.39,231793.03
buyer_5,Sara,30,ES36209532986776033440,TRX_N-00531-65410659,2023-09-06T14:56:17,Donostia,Expense,food,-263.82,231529.21
buyer_5,Sara,30,ES36209532986776033440,TRX_N-00532-92987471,2023-09-07T11:32:11,Donostia,Basic services,electricity,-86.36,231442.85
buyer_5,Sara,30,ES36209532986776033440,TRX_N-00533-10322373,2023-09-07T18:20:01,Donostia,Basic services,gas,-87.73,231355.12
buyer_5,Sara,30,ES36209532986776033440,TRX_N-00534-60065094,2023-09-07T13:23:26,Donostia,Expense,food,-200.95,231154.17
buyer_5,Sara,30,ES36209532986776033440,TRX_N-00535-51754212,2023-10-01T16:35:02,Donostia,transfer,Salary,3055.89,234210.06
buyer_5,Sara,30,ES36209532986776033440,TRX_N-00536-47392763,2023-10-01T16:35:02,Donostia,transfer,Partner Salary,3147.16,237357.22
buyer_5,Sara,30,ES36209532986776033440,TRX_N-00537-99484792,2023-10-01T16:35:02,Donostia,transfer,Extra Income,305.59,237662.81
buyer_5,Sara,30,ES36209532986776033440,TRX_N-00538-33939361,2023-10-04T12:28:09,Donostia,Expense,transport,-49.44,237613.37
buyer_5,Sara,30,ES36209532986776033440,TRX_N-00539-34719537,2023-10-05T21:39:18,Donostia,Housing,Mortgage,-569.36,237044.01
buyer_5,Sara,30,ES36209532986776033440,TRX_N-00540-93634922,2023-10-05T17:18:11,Donostia,Basic services,gas,-74.08,236969.93
buyer_5,Sara,30,ES36209532986776033440,TRX_N-00541-10138619,2023-10-05T14:45:39,Donostia,Basic services,phone,-28.74,236941.19
buyer_5,Sara,30,ES36209532986776033440,TRX_N-00542-03234522,2023-10-06T16:19:04,Donostia,Basic services,water,-13.59,236927.6
buyer_5,Sara,30,ES36209532986776033440,TRX_N-00543-93335910,2023-10-06T23:41:07,Donostia,Basic services,internet,-46.25,236881.35
buyer_5,Sara,30,ES36209532986776033440,TRX_N-00544-15493069,2023-10-06T10:50:48,Donostia,Basic services,phone,-68.86,236812.49
buyer_5,Sara,30,ES36209532986776033440,TRX_N-00545-40838259,2023-10-07T19:27:57,Donostia,Basic services,electricity,-83.87,236728.62
buyer_5,Sara,30,ES36209532986776033440,TRX_N-00546-70574496,2023-10-07T15:35:51,Donostia,Basic services,internet,-58.45,236670.17
buyer_5,Sara,30,ES36209532986776033440,TRX_N-00547-49477571,2023-10-17T20:34:27,Donostia,Expense,transport,-50.43,236619.74
buyer_5,Sara,30,ES36209532986776033440,TRX_N-00548-36252641,2023-11-01T11:34:33,Donostia,transfer,Salary,3055.89,239675.63
buyer_5,Sara,30,ES36209532986776033440,TRX_N-00549-74945310,2023-11-01T11:34:33,Donostia,transfer,Partner Salary,3147.16,242822.79
buyer_5,Sara,30,ES36209532986776033440,TRX_N-00550-66104784,2023-11-05T09:02:42,Donostia,Housing,Mortgage,-569.36,242253.43
buyer_5,Sara,30,ES36209532986776033440,TRX_N-00551-11901295,2023-11-06T20:44:35,Donostia,Basic services,electricity,-27.05,242226.38
buyer_5,Sara,30,ES36209532986776033440,TRX_N-00552-87460156,2023-11-06T12:00:23,Donostia,Basic services,gas,-74.95,242151.43
buyer_5,Sara,30,ES36209532986776033440,TRX_N-00553-74703742,2023-11-07T12:38:07,Donostia,Basic services,gas,-74.3,242077.13
buyer_5,Sara,30,ES36209532986776033440,TRX_N-00554-41010389,2023-11-07T11:49:51,Donostia,Basic services,phone,-26.69,242050.44
buyer_5,Sara,30,ES36209532986776033440,TRX_N-00555-20431430,2023-11-19T01:04:41,Donostia,Expense,transport,-162.2,241888.24
buyer_5,Sara,30,ES36209532986776033440,TRX_N-00556-41824113,2023-11-22T12:49:26,Donostia,Expense,food,-163.06,241725.18
buyer_5,Sara,30,ES36209532986776033440,TRX_N-00557-42055909,2023-11-22T11:44:14,Donostia,Expense,gifts,-145.33,241579.85
buyer_5,Sara,30,ES36209532986776033440,TRX_N-00558-73835977,2023-11-27T06:33:07,Donostia,Expense,transport,-117.82,241462.03
buyer_5,Sara,30,ES36209532986776033440,TRX_N-00559-99982984,2023-12-01T17:06:12,Donostia,transfer,Salary,3055.89,244517.92
buyer_5,Sara,30,ES36209532986776033440,TRX_N-00560-41267509,2023-12-01T17:06:12,Donostia,transfer,Partner Salary,3147.16,247665.08
buyer_5,Sara,30,ES36209532986776033440,TRX_N-00561-35093514,2023-12-01T17:06:12,Donostia,transfer,Extra Income,305.59,247970.67
buyer_5,Sara,30,ES36209532986776033440,TRX_N-00562-67750220,2023-12-01T17:06:12,Donostia,transfer,Bonus,3351.53,251322.2
buyer_5,Sara,30,ES36209532986776033440,TRX_N-00563-34708409,2023-12-05T13:06:22,Donostia,Housing,Mortgage,-569.36,250752.84
buyer_5,Sara,30,ES36209532986776033440,TRX_N-00564-08494672,2023-12-05T08:36:31,Donostia,Basic services,electricity,-77.77,250675.07
buyer_5,Sara,30,ES36209532986776033440,TRX_N-00565-37010142,2023-12-05T10:34:06,Donostia,Basic services,gas,-91.77,250583.3
buyer_5,Sara,30,ES36209532986776033440,TRX_N-00566-29075883,2023-12-06T20:33:04,Donostia,Basic services,water,-39.96,250543.34
buyer_5,Sara,30,ES36209532986776033440,TRX_N-00567-85307277,2023-12-06T11:51:21,Donostia,Basic services,gas,-52.0,250491.34
buyer_5,Sara,30,ES36209532986776033440,TRX_N-00568-22295347,2023-12-06T15:55:48,Donostia,Basic services,phone,-45.94,250445.4
buyer_5,Sara,30,ES36209532986776033440,TRX_N-00569-91062273,2023-12-14T08:53:14,Elciego,Expense,healthcare,-291.98,250153.42
buyer_5,Sara,30,ES36209532986776033440,TRX_N-00570-13568306,2023-12-25T12:20:38,Donostia,Expense,food,-232.06,249921.36
buyer_5,Sara,30,ES36209532986776033440,TRX_N-00571-53745120,2024-01-01T22:45:45,Donostia,transfer,Salary,3055.89,252977.25
buyer_5,Sara,30,ES36209532986776033440,TRX_N-00572-54055826,2024-01-01T22:45:45,Donostia,transfer,Partner Salary,3147.16,256124.41
buyer_5,Sara,30,ES36209532986776033440,TRX_N-00573-36870156,2024-01-05T08:59:05,Donostia,Housing,Mortgage,-569.36,255555.05
buyer_5,Sara,30,ES36209532986776033440,TRX_N-00574-55621274,2024-01-05T08:12:57,Donostia,Basic services,electricity,-104.84,255450.21
buyer_5,Sara,30,ES36209532986776033440,TRX_N-00575-87910889,2024-01-05T17:49:09,Donostia,Basic services,gas,-96.94,255353.27
buyer_5,Sara,30,ES36209532986776033440,TRX_N-00576-68165582,2024-01-05T10:00:26,Donostia,Basic services,internet,-45.89,255307.38
buyer_5,Sara,30,ES36209532986776033440,TRX_N-00577-04953983,2024-01-05T23:54:00,Donostia,Basic services,phone,-60.47,255246.91
buyer_5,Sara,30,ES36209532986776033440,TRX_N-00578-26577094,2024-01-06T12:30:38,Donostia,Basic services,water,-54.44,255192.47
buyer_5,Sara,30,ES36209532986776033440,TRX_N-00579-02802272,2024-01-07T21:38:18,Donostia,Basic services,water,-70.29,255122.18
buyer_5,Sara,30,ES36209532986776033440,TRX_N-00580-04083493,2024-01-07T16:38:30,Donostia,Basic services,electricity,-109.44,255012.74
buyer_5,Sara,30,ES36209532986776033440,TRX_N-00581-38281685,2024-01-07T13:49:08,Donostia,Basic services,gas,-73.36,254939.38
buyer_5,Sara,30,ES36209532986776033440,TRX_N-00582-15796358,2024-01-07T23:45:00,Donostia,Basic services,phone,-42.28,254897.1
buyer_5,Sara,30,ES36209532986776033440,TRX_N-00583-04967448,2024-01-08T18:21:45,Andoain,Expense,gifts,-404.57,254492.53
buyer_5,Sara,30,ES36209532986776033440,TRX_N-00584-52966582,2024-01-13T08:39:20,Donostia,Expense,food,-796.06,253696.47
buyer_5,Sara,30,ES36209532986776033440,TRX_N-00585-12795759,2024-01-17T18:01:33,Donostia,Expense,clothing,-370.69,253325.78
buyer_5,Sara,30,ES36209532986776033440,TRX_N-00586-19139998,2024-01-19T16:00:58,Donostia,Expense,food,-701.03,252624.75
buyer_5,Sara,30,ES36209532986776033440,TRX_N-00587-05053505,2024-01-21T11:03:10,Donostia,Expense,leisure,-214.9,252409.85
buyer_5,Sara,30,ES36209532986776033440,TRX_N-00588-88367212,2024-02-01T19:34:25,Donostia,transfer,Salary,3055.89,255465.74
buyer_5,Sara,30,ES36209532986776033440,TRX_N-00589-29117996,2024-02-01T19:34:25,Donostia,transfer,Partner Salary,3147.16,258612.9
buyer_5,Sara,30,ES36209532986776033440,TRX_N-00590-97691625,2024-02-03T06:57:46,Sopela,Expense,transport,-156.29,258456.61
buyer_5,Sara,30,ES36209532986776033440,TRX_N-00591-97347614,2024-02-05T18:19:41,Donostia,Housing,Mortgage,-569.36,257887.25
buyer_5,Sara,30,ES36209532986776033440,TRX_N-00592-91435000,2024-02-05T09:29:54,Donostia,Basic services,electricity,-55.64,257831.61
buyer_5,Sara,30,ES36209532986776033440,TRX_N-00593-06751560,2024-02-05T09:33:49,Donostia,Basic services,phone,-96.67,257734.94
buyer_5,Sara,30,ES36209532986776033440,TRX_N-00594-54609305,2024-02-06T15:03:36,Donostia,Basic services,electricity,-90.79,257644.15
buyer_5,Sara,30,ES36209532986776033440,TRX_N-00595-80072385,2024-02-06T12:27:57,Donostia,Expense,healthcare,-84.23,257559.92
buyer_5,Sara,30,ES36209532986776033440,TRX_N-00596-56448541,2024-03-01T22:44:50,Donostia,transfer,Salary,3055.89,260615.81
buyer_5,Sara,30,ES36209532986776033440,TRX_N-00597-77418798,2024-03-01T22:44:50,Donostia,transfer,Partner Salary,3147.16,263762.97
buyer_5,Sara,30,ES36209532986776033440,TRX_N-00598-32946184,2024-03-01T22:44:50,Donostia,transfer,Extra Income,305.59,264068.56
buyer_5,Sara,30,ES36209532986776033440,TRX_N-00599-67876062,2024-03-04T02:36:29,Donostia,Expense,leisure,-21.05,264047.51
buyer_5,Sara,30,ES36209532986776033440,TRX_N-00600-65502106,2024-03-05T13:12:32,Donostia,Housing,Mortgage,-569.36,263478.15
buyer_5,Sara,30,ES36209532986776033440,TRX_N-00601-79604409,2024-03-05T08:18:59,Donostia,Expense,food,-565.92,262912.23
buyer_5,Sara,30,ES36209532986776033440,TRX_N-00602-19036599,2024-03-07T16:22:36,Donostia,Basic services,electricity,-126.06,262786.17
buyer_5,Sara,30,ES36209532986776033440,TRX_N-00603-06015441,2024-03-07T08:23:49,Donostia,Basic services,phone,-33.68,262752.49
buyer_5,Sara,30,ES36209532986776033440,TRX_N-00604-05866129,2024-03-23T12:18:47,Donostia,Expense,healthcare,-173.78,262578.71
buyer_5,Sara,30,ES36209532986776033440,TRX_N-00605-43035703,2024-03-24T13:34:41,Donostia,Expense,leisure,-257.13,262321.58
buyer_5,Sara,30,ES36209532986776033440,TRX_N-00606-92650646,2024-03-26T18:03:14,Donostia,Expense,transport,-43.91,262277.67
buyer_5,Sara,30,ES36209532986776033440,TRX_N-00607-46063998,2024-04-01T21:00:57,Donostia,transfer,Salary,3055.89,265333.56
buyer_5,Sara,30,ES36209532986776033440,TRX_N-00608-86493984,2024-04-01T21:00:57,Donostia,transfer,Partner Salary,3147.16,268480.72
buyer_5,Sara,30,ES36209532986776033440,TRX_N-00609-97669389,2024-04-05T16:48:38,Donostia,Housing,Mortgage,-569.36,267911.36
buyer_5,Sara,30,ES36209532986776033440,TRX_N-00610-94387558,2024-04-05T07:55:58,Donostia,Basic services,water,-75.73,267835.63
buyer_5,Sara,30,ES36209532986776033440,TRX_N-00611-99209631,2024-04-06T17:31:37,Donostia,Basic services,water,-38.26,267797.37
buyer_5,Sara,30,ES36209532986776033440,TRX_N-00612-76124105,2024-04-06T06:01:58,Donostia,Basic services,internet,-45.98,267751.39
buyer_5,Sara,30,ES36209532986776033440,TRX_N-00613-16556910,2024-04-06T07:05:11,Donostia,Basic services,phone,-32.86,267718.53
buyer_5,Sara,30,ES36209532986776033440,TRX_N-00614-18141482,2024-04-07T20:42:05,Donostia,Basic services,water,-19.06,267699.47
buyer_5,Sara,30,ES36209532986776033440,TRX_N-00615-67287633,2024-04-12T22:08:55,Donostia,Expense,leisure,-162.72,267536.75
buyer_5,Sara,30,ES36209532986776033440,TRX_N-00616-92364300,2024-04-14T02:40:11,Donostia,Expense,leisure,-55.43,267481.32
buyer_5,Sara,30,ES36209532986776033440,TRX_N-00617-20937919,2024-04-17T19:40:51,Donostia,Expense,food,-424.79,267056.53
buyer_5,Sara,30,ES36209532986776033440,TRX_N-00618-72520404,2024-05-01T15:28:31,Donostia,transfer,Salary,3055.89,270112.42
buyer_5,Sara,30,ES36209532986776033440,TRX_N-00619-86825077,2024-05-01T15:28:31,Donostia,transfer,Partner Salary,3147.16,273259.58
buyer_5,Sara,30,ES36209532986776033440,TRX_N-00620-07456758,2024-05-05T18:05:25,Donostia,Housing,Mortgage,-569.36,272690.22
buyer_5,Sara,30,ES36209532986776033440,TRX_N-00621-63225644,2024-05-05T09:15:13,Donostia,Basic services,internet,-49.81,272640.41
buyer_5,Sara,30,ES36209532986776033440,TRX_N-00622-17895563,2024-05-06T12:44:07,Donostia,Basic services,gas,-42.75,272597.66
buyer_5,Sara,30,ES36209532986776033440,TRX_N-00623-36720752,2024-05-06T20:41:47,Donostia,Basic services,internet,-41.98,272555.68
buyer_5,Sara,30,ES36209532986776033440,TRX_N-00624-31522536,2024-05-07T11:52:43,Donostia,Basic services,water,-36.18,272519.5
buyer_5,Sara,30,ES36209532986776033440,TRX_N-00625-10988651,2024-05-07T20:08:57,Donostia,Basic services,phone,-79.15,272440.35
buyer_5,Sara,30,ES36209532986776033440,TRX_N-00626-10419112,2024-05-09T08:48:29,Bilbao,Expense,clothing,-429.14,272011.21
buyer_5,Sara,30,ES36209532986776033440,TRX_N-00627-90828849,2024-05-17T19:13:56,Donostia,Expense,leisure,-69.63,271941.58
buyer_5,Sara,30,ES36209532986776033440,TRX_N-00628-47159159,2024-05-19T11:58:38,Donostia,Expense,transport,-137.14,271804.44
buyer_5,Sara,30,ES36209532986776033440,TRX_N-00629-82140463,2024-06-01T15:51:31,Donostia,transfer,Salary,3055.89,274860.33
buyer_5,Sara,30,ES36209532986776033440,TRX_N-00630-08282811,2024-06-01T15:51:31,Donostia,transfer,Partner Salary,3147.16,278007.49
buyer_5,Sara,30,ES36209532986776033440,TRX_N-00631-12844641,2024-06-01T15:51:31,Donostia,transfer,Extra Income,305.59,278313.08
buyer_5,Sara,30,ES36209532986776033440,TRX_N-00632-58708326,2024-06-01T15:51:31,Donostia,transfer,Bonus,3203.17,281516.25
buyer_5,Sara,30,ES36209532986776033440,TRX_N-00633-31116620,2024-06-02T18:37:40,Donostia,Expense,transport,-23.4,281492.85
buyer_5,Sara,30,ES36209532986776033440,TRX_N-00634-74869957,2024-06-03T11:11:12,Donostia,Expense,transport,-37.01,281455.84
buyer_5,Sara,30,ES36209532986776033440,TRX_N-00635-98953740,2024-06-05T15:25:25,Donostia,Housing,Mortgage,-569.36,280886.48
buyer_5,Sara,30,ES36209532986776033440,TRX_N-00636-89456833,2024-06-05T13:30:36,Donostia,Basic services,water,-75.34,280811.14
buyer_5,Sara,30,ES36209532986776033440,TRX_N-00637-24519115,2024-06-05T17:30:30,Donostia,Basic services,phone,-99.54,280711.6
buyer_5,Sara,30,ES36209532986776033440,TRX_N-00638-13682883,2024-06-06T04:58:39,Donostia,Basic services,water,-46.18,280665.42
buyer_5,Sara,30,ES36209532986776033440,TRX_N-00639-53630484,2024-06-06T10:17:22,Donostia,Basic services,internet,-58.85,280606.57
buyer_5,Sara,30,ES36209532986776033440,TRX_N-00640-02443003,2024-06-07T16:56:25,Donostia,Basic services,gas,-28.08,280578.49
buyer_5,Sara,30,ES36209532986776033440,TRX_N-00641-71715307,2024-06-07T15:47:32,Irun,Expense,food,-578.07,280000.42
buyer_5,Sara,30,ES36209532986776033440,TRX_N-00642-42375527,2024-06-14T18:59:34,Donostia,Expense,transport,-50.5,279949.92
buyer_5,Sara,30,ES36209532986776033440,TRX_N-00643-42518314,2024-06-16T14:47:51,Donostia,Expense,food,-557.59,279392.33
buyer_5,Sara,30,ES36209532986776033440,TRX_N-00644-30973237,2024-06-18T21:51:38,Donostia,Expense,food,-566.66,278825.67
buyer_5,Sara,30,ES36209532986776033440,TRX_N-00645-85641781,2024-06-23T13:19:50,Salvatierra/Agurain,Expense,food,-527.9,278297.77
buyer_5,Sara,30,ES36209532986776033440,TRX_N-00646-89398955,2024-06-26T09:44:03,Donostia,Expense,transport,-193.13,278104.64
buyer_5,Sara,30,ES36209532986776033440,TRX_N-00647-07427573,2024-07-01T13:08:41,Donostia,transfer,Salary,3055.89,281160.53
buyer_5,Sara,30,ES36209532986776033440,TRX_N-00648-52022924,2024-07-01T13:08:41,Donostia,transfer,Partner Salary,3147.16,284307.69
buyer_5,Sara,30,ES36209532986776033440,TRX_N-00649-74995694,2024-07-03T15:14:11,Donostia,Expense,food,-471.53,283836.16
buyer_5,Sara,30,ES36209532986776033440,TRX_N-00650-83197516,2024-07-05T09:08:36,Donostia,Housing,Mortgage,-569.36,283266.8
buyer_5,Sara,30,ES36209532986776033440,TRX_N-00651-86525854,2024-07-05T17:22:51,Donostia,Basic services,internet,-31.36,283235.44
buyer_5,Sara,30,ES36209532986776033440,TRX_N-00652-37852123,2024-07-05T09:59:19,Sestao,Expense,transport,-185.47,283049.97
buyer_5,Sara,30,ES36209532986776033440,TRX_N-00653-44755497,2024-07-06T19:20:40,Donostia,Basic services,internet,-47.06,283002.91
buyer_5,Sara,30,ES36209532986776033440,TRX_N-00654-81611801,2024-07-06T09:37:42,Donostia,Basic services,phone,-93.76,282909.15
buyer_5,Sara,30,ES36209532986776033440,TRX_N-00655-58284639,2024-07-07T08:28:03,Donostia,Basic services,water,-38.2,282870.95
buyer_5,Sara,30,ES36209532986776033440,TRX_N-00656-57346330,2024-07-07T17:22:26,Donostia,Basic services,gas,-68.9,282802.05
buyer_5,Sara,30,ES36209532986776033440,TRX_N-00657-82872253,2024-07-18T20:44:22,Bermeo,Expense,healthcare,-312.23,282489.82
buyer_5,Sara,30,ES36209532986776033440,TRX_N-00658-81607336,2024-07-26T13:28:28,Donostia,Expense,food,-645.01,281844.81
buyer_5,Sara,30,ES36209532986776033440,TRX_N-00659-08531610,2024-08-01T08:36:22,Donostia,transfer,Salary,3055.89,284900.7
buyer_5,Sara,30,ES36209532986776033440,TRX_N-00660-60622012,2024-08-01T08:36:22,Donostia,transfer,Partner Salary,3147.16,288047.86
buyer_5,Sara,30,ES36209532986776033440,TRX_N-00661-08981300,2024-08-05T22:39:35,Donostia,Housing,Mortgage,-569.36,287478.5
buyer_5,Sara,30,ES36209532986776033440,TRX_N-00662-86160404,2024-08-06T08:37:20,Donostia,Basic services,water,-60.68,287417.82
buyer_5,Sara,30,ES36209532986776033440,TRX_N-00663-32360579,2024-08-06T18:34:41,Donostia,Basic services,electricity,-109.83,287307.99
buyer_5,Sara,30,ES36209532986776033440,TRX_N-00664-53820565,2024-08-06T20:36:47,Donostia,Basic services,internet,-72.29,287235.7
buyer_5,Sara,30,ES36209532986776033440,TRX_N-00665-91607927,2024-08-07T02:49:33,Donostia,Basic services,electricity,-118.52,287117.18
buyer_5,Sara,30,ES36209532986776033440,TRX_N-00666-12846514,2024-08-07T16:13:20,Donostia,Basic services,internet,-48.26,287068.92
buyer_5,Sara,30,ES36209532986776033440,TRX_N-00667-14965710,2024-08-07T11:35:46,Donostia,Basic services,phone,-82.35,286986.57
buyer_5,Sara,30,ES36209532986776033440,TRX_N-00668-97288548,2024-08-09T14:30:39,Donostia,Expense,food,-670.93,286315.64
buyer_5,Sara,30,ES36209532986776033440,TRX_N-00669-74292929,2024-08-14T07:29:04,Donostia,Expense,transport,-64.52,286251.12
buyer_5,Sara,30,ES36209532986776033440,TRX_N-00670-19135944,2024-08-24T14:24:31,Donostia,Expense,food,-797.77,285453.35
buyer_5,Sara,30,ES36209532986776033440,TRX_N-00671-87374536,2024-08-24T08:46:06,Donostia,Expense,leisure,-256.5,285196.85
buyer_5,Sara,30,ES36209532986776033440,TRX_N-00672-22891944,2024-08-25T14:48:53,Donostia,Expense,leisure,-35.59,285161.26
buyer_5,Sara,30,ES36209532986776033440,TRX_N-00673-36445632,2024-08-26T12:06:21,Donostia,Expense,transport,-130.18,285031.08
buyer_5,Sara,30,ES36209532986776033440,TRX_N-00674-70424984,2024-09-01T14:20:05,Donostia,transfer,Salary,3055.89,288086.97
buyer_5,Sara,30,ES36209532986776033440,TRX_N-00675-58323454,2024-09-01T14:20:05,Donostia,transfer,Partner Salary,3147.16,291234.13
buyer_5,Sara,30,ES36209532986776033440,TRX_N-00676-72646241,2024-09-01T14:20:05,Donostia,transfer,Extra Income,305.59,291539.72
buyer_5,Sara,30,ES36209532986776033440,TRX_N-00677-70135073,2024-09-03T15:06:31,Donostia,Expense,food,-504.16,291035.56
buyer_5,Sara,30,ES36209532986776033440,TRX_N-00678-27898461,2024-09-05T17:19:59,Donostia,Housing,Mortgage,-569.36,290466.2
buyer_5,Sara,30,ES36209532986776033440,TRX_N-00679-32407502,2024-09-05T16:29:46,Donostia,Basic services,internet,-64.65,290401.55
buyer_5,Sara,30,ES36209532986776033440,TRX_N-00680-54639091,2024-09-06T15:31:22,Donostia,Basic services,water,-63.16,290338.39
buyer_5,Sara,30,ES36209532986776033440,TRX_N-00681-13661565,2024-09-06T22:28:37,Donostia,Basic services,gas,-23.1,290315.29
buyer_5,Sara,30,ES36209532986776033440,TRX_N-00682-59727440,2024-09-06T17:56:39,Donostia,Basic services,internet,-77.97,290237.32
buyer_5,Sara,30,ES36209532986776033440,TRX_N-00683-10619896,2024-09-07T20:38:49,Donostia,Basic services,water,-44.65,290192.67
buyer_5,Sara,30,ES36209532986776033440,TRX_N-00684-39229623,2024-09-08T11:13:49,Donostia,Expense,food,-576.17,289616.5
buyer_5,Sara,30,ES36209532986776033440,TRX_N-00685-49297228,2024-10-01T18:33:01,Donostia,transfer,Salary,3055.89,292672.39
buyer_5,Sara,30,ES36209532986776033440,TRX_N-00686-89952176,2024-10-01T18:33:01,Donostia,transfer,Partner Salary,3147.16,295819.55
buyer_5,Sara,30,ES36209532986776033440,TRX_N-00687-39824689,2024-10-03T16:38:34,Donostia,Expense,food,-226.57,295592.98
buyer_5,Sara,30,ES36209532986776033440,TRX_N-00688-58652197,2024-10-05T11:46:07,Donostia,Housing,Mortgage,-569.36,295023.62
buyer_5,Sara,30,ES36209532986776033440,TRX_N-00689-67873767,2024-10-05T10:04:54,Donostia,Basic services,electricity,-125.09,294898.53
buyer_5,Sara,30,ES36209532986776033440,TRX_N-00690-53958304,2024-10-05T13:04:57,Donostia,Basic services,internet,-51.64,294846.89
buyer_5,Sara,30,ES36209532986776033440,TRX_N-00691-35964051,2024-10-05T15:23:19,Donostia,Basic services,phone,-21.06,294825.83
buyer_5,Sara,30,ES36209532986776033440,TRX_N-00692-74773054,2024-10-07T12:04:50,Donostia,Basic services,water,-27.82,294798.01
buyer_5,Sara,30,ES36209532986776033440,TRX_N-00693-28191889,2024-10-07T18:18:57,Donostia,Basic services,internet,-51.97,294746.04
buyer_5,Sara,30,ES36209532986776033440,TRX_N-00694-19835217,2024-10-07T10:20:39,Donostia,Basic services,phone,-81.2,294664.84
buyer_6,Manuel,45,ES48209597376888441122,TRX_N-00001-93974078,2020-01-01T01:03:49,Vitoria-Gasteiz,transfer,Salary,1795.63,2238.1
buyer_6,Manuel,45,ES48209597376888441122,TRX_N-00002-83169451,2020-01-05T19:15:14,Vitoria-Gasteiz,Housing,Rent,-1329.48,908.62
buyer_6,Manuel,45,ES48209597376888441122,TRX_N-00003-76255903,2020-01-05T16:04:29,Vitoria-Gasteiz,Basic services,electricity,-129.12,779.5
buyer_6,Manuel,45,ES48209597376888441122,TRX_N-00004-18289621,2020-01-05T13:54:58,Vitoria-Gasteiz,Expense,transport,-107.87,671.63
buyer_6,Manuel,45,ES48209597376888441122,TRX_N-00005-65960616,2020-01-06T18:40:06,Vitoria-Gasteiz,Basic services,water,-17.43,654.2
buyer_6,Manuel,45,ES48209597376888441122,TRX_N-00006-68182430,2020-01-06T11:18:06,Vitoria-Gasteiz,Basic services,internet,-73.89,580.31
buyer_6,Manuel,45,ES48209597376888441122,TRX_N-00007-96811606,2020-01-07T17:20:01,Vitoria-Gasteiz,Basic services,water,-52.29,528.02
buyer_6,Manuel,45,ES48209597376888441122,TRX_N-00008-66818080,2020-01-07T20:45:48,Vitoria-Gasteiz,Basic services,electricity,-73.11,454.91
buyer_6,Manuel,45,ES48209597376888441122,TRX_N-00009-87443891,2020-01-07T15:20:43,Vitoria-Gasteiz,Basic services,gas,-47.47,407.44
buyer_6,Manuel,45,ES48209597376888441122,TRX_N-00010-91573175,2020-01-07T21:59:18,Vitoria-Gasteiz,Basic services,internet,-64.86,342.58
buyer_6,Manuel,45,ES48209597376888441122,TRX_N-00011-96324189,2020-01-09T06:57:32,Vitoria-Gasteiz,Expense,healthcare,-326.85,15.73
buyer_6,Manuel,45,ES48209597376888441122,TRX_N-00012-98182651,2020-01-22T14:30:54,Vitoria-Gasteiz,Expense,leisure,-43.7,-27.97
buyer_6,Manuel,45,ES48209597376888441122,TRX_N-00013-57418976,2020-01-30T16:45:50,Vitoria-Gasteiz,Expense,repairs,-570.39,-598.36
buyer_6,Manuel,45,ES48209597376888441122,TRX_N-00014-37014872,2020-02-01T11:09:04,Vitoria-Gasteiz,transfer,Salary,1795.63,1197.27
buyer_6,Manuel,45,ES48209597376888441122,TRX_N-00015-10027793,2020-02-01T11:24:15,Vitoria-Gasteiz,Expense,food,-727.02,470.25
buyer_6,Manuel,45,ES48209597376888441122,TRX_N-00016-83431840,2020-02-03T08:12:41,Vitoria-Gasteiz,Expense,food,-266.84,203.41
buyer_6,Manuel,45,ES48209597376888441122,TRX_N-00017-02804549,2020-02-05T18:21:24,Vitoria-Gasteiz,Housing,Rent,-1329.48,-1126.07
buyer_6,Manuel,45,ES48209597376888441122,TRX_N-00018-60941904,2020-02-05T13:04:21,Vitoria-Gasteiz,Basic services,internet,-31.69,-1157.76
buyer_6,Manuel,45,ES48209597376888441122,TRX_N-00019-82408554,2020-02-06T19:19:16,Vitoria-Gasteiz,Basic services,water,-28.8,-1186.56
buyer_6,Manuel,45,ES48209597376888441122,TRX_N-00020-79939232,2020-02-06T12:09:07,Vitoria-Gasteiz,Basic services,electricity,-118.87,-1305.43
buyer_6,Manuel,45,ES48209597376888441122,TRX_N-00021-33548284,2020-02-06T21:55:51,Vitoria-Gasteiz,Basic services,phone,-73.59,-1379.02
buyer_6,Manuel,45,ES48209597376888441122,TRX_N-00022-98000427,2020-02-10T20:25:55,Lasarte-Oria,Expense,education,-213.68,-1592.7
buyer_6,Manuel,45,ES48209597376888441122,TRX_N-00023-67788564,2020-02-11T15:27:50,Vitoria-Gasteiz,Expense,transport,-66.72,-1659.42
buyer_6,Manuel,45,ES48209597376888441122,TRX_N-00024-59062292,2020-03-01T09:36:51,Vitoria-Gasteiz,transfer,Salary,1795.63,136.21
buyer_6,Manuel,45,ES48209597376888441122,TRX_N-00025-26055284,2020-03-01T09:36:51,Vitoria-Gasteiz,transfer,Extra Income,179.56,315.77
buyer_6,Manuel,45,ES48209597376888441122,TRX_N-00026-48565278,2020-03-05T23:50:54,Vitoria-Gasteiz,Housing,Rent,-1329.48,-1013.71
buyer_6,Manuel,45,ES48209597376888441122,TRX_N-00027-22047665,2020-03-05T14:39:19,Vitoria-Gasteiz,Expense,food,-407.29,-1421.0
buyer_6,Manuel,45,ES48209597376888441122,TRX_N-00028-30084129,2020-03-06T09:47:37,Vitoria-Gasteiz,Basic services,water,-71.47,-1492.47
buyer_6,Manuel,45,ES48209597376888441122,TRX_N-00029-30151891,2020-03-06T11:51:10,Vitoria-Gasteiz,Basic services,gas,-31.49,-1523.96
buyer_6,Manuel,45,ES48209597376888441122,TRX_N-00030-80838774,2020-03-06T16:26:22,Vitoria-Gasteiz,Basic services,internet,-43.97,-1567.93
buyer_6,Manuel,45,ES48209597376888441122,TRX_N-00031-72140875,2020-03-06T16:11:16,Vitoria-Gasteiz,Expense,food,-124.55,-1692.48
buyer_6,Manuel,45,ES48209597376888441122,TRX_N-00032-70474930,2020-03-07T11:42:28,Vitoria-Gasteiz,Basic services,gas,-50.66,-1743.14
buyer_6,Manuel,45,ES48209597376888441122,TRX_N-00033-58395059,2020-03-10T23:38:34,Vitoria-Gasteiz,Expense,food,-707.02,-2450.16
buyer_6,Manuel,45,ES48209597376888441122,TRX_N-00034-97477957,2020-03-19T19:16:08,Vitoria-Gasteiz,Expense,clothing,-163.68,-2613.84
buyer_6,Manuel,45,ES48209597376888441122,TRX_N-00035-90665734,2020-03-22T13:59:35,Amurrio,Expense,food,-428.25,-3042.09
buyer_6,Manuel,45,ES48209597376888441122,TRX_N-00036-60709654,2020-03-25T18:14:14,Vitoria-Gasteiz,Expense,healthcare,-131.04,-3173.13
buyer_6,Manuel,45,ES48209597376888441122,TRX_N-00037-52935749,2020-04-01T08:36:22,Vitoria-Gasteiz,transfer,Salary,1795.63,-1377.5
buyer_6,Manuel,45,ES48209597376888441122,TRX_N-00038-62521314,2020-04-02T05:20:49,Vitoria-Gasteiz,Expense,leisure,-217.29,-1594.79
buyer_6,Manuel,45,ES48209597376888441122,TRX_N-00039-12159477,2020-04-03T15:35:09,Vitoria-Gasteiz,Expense,healthcare,-381.89,-1976.68
buyer_6,Manuel,45,ES48209597376888441122,TRX_N-00040-62981630,2020-04-05T08:20:16,Vitoria-Gasteiz,Housing,Rent,-1329.48,-3306.16
buyer_6,Manuel,45,ES48209597376888441122,TRX_N-00041-31195937,2020-04-05T15:16:23,Vitoria-Gasteiz,Basic services,water,-65.78,-3371.94
buyer_6,Manuel,45,ES48209597376888441122,TRX_N-00042-51733729,2020-04-05T15:09:52,Vitoria-Gasteiz,Basic services,electricity,-71.31,-3443.25
buyer_6,Manuel,45,ES48209597376888441122,TRX_N-00043-39002241,2020-04-05T12:05:26,Vitoria-Gasteiz,Basic services,gas,-83.82,-3527.07
buyer_6,Manuel,45,ES48209597376888441122,TRX_N-00044-51700836,2020-04-05T16:33:38,Vitoria-Gasteiz,Basic services,internet,-60.77,-3587.84
buyer_6,Manuel,45,ES48209597376888441122,TRX_N-00045-74370482,2020-04-06T09:33:26,Vitoria-Gasteiz,Basic services,internet,-58.53,-3646.37
buyer_6,Manuel,45,ES48209597376888441122,TRX_N-00046-37455999,2020-04-06T21:53:43,Vitoria-Gasteiz,Basic services,phone,-21.16,-3667.53
buyer_6,Manuel,45,ES48209597376888441122,TRX_N-00047-30974926,2020-04-07T09:04:07,Vitoria-Gasteiz,Expense,transport,-34.96,-3702.49
buyer_6,Manuel,45,ES48209597376888441122,TRX_N-00048-92255491,2020-04-13T12:16:57,Vitoria-Gasteiz,Expense,food,-244.24,-3946.73
buyer_6,Manuel,45,ES48209597376888441122,TRX_N-00049-91974849,2020-04-27T15:47:30,Vitoria-Gasteiz,Expense,transport,-55.95,-4002.68
buyer_6,Manuel,45,ES48209597376888441122,TRX_N-00050-32654352,2020-05-01T22:52:31,Vitoria-Gasteiz,transfer,Salary,1795.63,-2207.05
buyer_6,Manuel,45,ES48209597376888441122,TRX_N-00051-73536522,2020-05-04T15:12:03,Vitoria-Gasteiz,Expense,food,-578.4,-2785.45
buyer_6,Manuel,45,ES48209597376888441122,TRX_N-00052-11513464,2020-05-05T02:58:26,Vitoria-Gasteiz,Housing,Rent,-1329.48,-4114.93
buyer_6,Manuel,45,ES48209597376888441122,TRX_N-00053-84778766,2020-05-05T12:27:58,Vitoria-Gasteiz,Basic services,water,-13.06,-4127.99
buyer_6,Manuel,45,ES48209597376888441122,TRX_N-00054-62408799,2020-05-05T15:10:14,Vitoria-Gasteiz,Basic services,phone,-56.01,-4184.0
buyer_6,Manuel,45,ES48209597376888441122,TRX_N-00055-60964035,2020-05-06T11:39:38,Vitoria-Gasteiz,Basic services,water,-41.23,-4225.23
buyer_6,Manuel,45,ES48209597376888441122,TRX_N-00056-31796184,2020-05-06T14:08:42,Vitoria-Gasteiz,Basic services,phone,-22.11,-4247.34
buyer_6,Manuel,45,ES48209597376888441122,TRX_N-00057-24229980,2020-05-07T18:15:54,Vitoria-Gasteiz,Basic services,gas,-53.97,-4301.31
buyer_6,Manuel,45,ES48209597376888441122,TRX_N-00058-71866521,2020-05-07T14:42:50,Vitoria-Gasteiz,Basic services,internet,-49.62,-4350.93
buyer_6,Manuel,45,ES48209597376888441122,TRX_N-00059-06768920,2020-05-10T04:13:50,Vitoria-Gasteiz,Expense,food,-498.82,-4849.75
buyer_6,Manuel,45,ES48209597376888441122,TRX_N-00060-65658751,2020-06-01T14:55:28,Vitoria-Gasteiz,transfer,Salary,1795.63,-3054.12
buyer_6,Manuel,45,ES48209597376888441122,TRX_N-00061-07668073,2020-06-01T14:55:28,Vitoria-Gasteiz,transfer,Extra Income,179.56,-2874.56
buyer_6,Manuel,45,ES48209597376888441122,TRX_N-00062-06220144,2020-06-01T14:55:28,Vitoria-Gasteiz,transfer,Bonus,1626.11,-1248.45
buyer_6,Manuel,45,ES48209597376888441122,TRX_N-00063-48232401,2020-06-05T11:16:59,Vitoria-Gasteiz,Housing,Rent,-1329.48,-2577.93
buyer_6,Manuel,45,ES48209597376888441122,TRX_N-00064-42176373,2020-06-05T20:32:55,Vitoria-Gasteiz,Basic services,water,-11.42,-2589.35
buyer_6,Manuel,45,ES48209597376888441122,TRX_N-00065-79745428,2020-06-05T10:10:30,Vitoria-Gasteiz,Basic services,gas,-67.6,-2656.95
buyer_6,Manuel,45,ES48209597376888441122,TRX_N-00066-67941798,2020-06-05T12:38:14,Vitoria-Gasteiz,Basic services,internet,-54.95,-2711.9
buyer_6,Manuel,45,ES48209597376888441122,TRX_N-00067-30216906,2020-06-07T20:38:01,Vitoria-Gasteiz,Basic services,gas,-41.65,-2753.55
buyer_6,Manuel,45,ES48209597376888441122,TRX_N-00068-44916173,2020-06-07T03:40:37,Vitoria-Gasteiz,Basic services,internet,-60.58,-2814.13
buyer_6,Manuel,45,ES48209597376888441122,TRX_N-00069-38700624,2020-06-07T10:30:00,Vitoria-Gasteiz,Expense,food,-747.4,-3561.53
buyer_6,Manuel,45,ES48209597376888441122,TRX_N-00070-19629290,2020-06-22T15:19:13,Vitoria-Gasteiz,Expense,transport,-29.97,-3591.5
buyer_6,Manuel,45,ES48209597376888441122,TRX_N-00071-52927762,2020-07-01T23:18:23,Vitoria-Gasteiz,transfer,Salary,1795.63,-1795.87
buyer_6,Manuel,45,ES48209597376888441122,TRX_N-00072-85906460,2020-07-02T11:13:33,Vitoria-Gasteiz,Expense,healthcare,-369.97,-2165.84
buyer_6,Manuel,45,ES48209597376888441122,TRX_N-00073-68298729,2020-07-04T10:29:32,Vitoria-Gasteiz,Expense,food,-596.63,-2762.47
buyer_6,Manuel,45,ES48209597376888441122,TRX_N-00074-32395920,2020-07-05T10:29:46,Vitoria-Gasteiz,Housing,Rent,-1329.48,-4091.95
buyer_6,Manuel,45,ES48209597376888441122,TRX_N-00075-81551885,2020-07-05T16:13:36,Vitoria-Gasteiz,Basic services,gas,-24.09,-4116.04
buyer_6,Manuel,45,ES48209597376888441122,TRX_N-00076-87366225,2020-07-05T08:34:23,Vitoria-Gasteiz,Basic services,phone,-38.52,-4154.56
buyer_6,Manuel,45,ES48209597376888441122,TRX_N-00077-82632948,2020-07-06T09:54:12,Vitoria-Gasteiz,Basic services,water,-11.78,-4166.34
buyer_6,Manuel,45,ES48209597376888441122,TRX_N-00078-51898068,2020-07-06T08:34:35,Vitoria-Gasteiz,Basic services,internet,-73.46,-4239.8
buyer_6,Manuel,45,ES48209597376888441122,TRX_N-00079-66448279,2020-07-07T21:22:56,Vitoria-Gasteiz,Basic services,water,-78.68,-4318.48
buyer_6,Manuel,45,ES48209597376888441122,TRX_N-00080-61614934,2020-07-07T13:24:56,Vitoria-Gasteiz,Basic services,phone,-44.57,-4363.05
buyer_6,Manuel,45,ES48209597376888441122,TRX_N-00081-23735138,2020-07-23T13:23:41,Vitoria-Gasteiz,Expense,leisure,-225.52,-4588.57
buyer_6,Manuel,45,ES48209597376888441122,TRX_N-00082-71718368,2020-07-30T11:27:51,Vitoria-Gasteiz,Expense,leisure,-276.74,-4865.31
buyer_6,Manuel,45,ES48209597376888441122,TRX_N-00083-82295670,2020-08-01T16:31:02,Vitoria-Gasteiz,transfer,Salary,1795.63,-3069.68
buyer_6,Manuel,45,ES48209597376888441122,TRX_N-00084-68846786,2020-08-01T16:31:02,Vitoria-Gasteiz,transfer,Extra Income,179.56,-2890.12
buyer_6,Manuel,45,ES48209597376888441122,TRX_N-00085-48077170,2020-08-05T10:17:06,Vitoria-Gasteiz,Housing,Rent,-1329.48,-4219.6
buyer_6,Manuel,45,ES48209597376888441122,TRX_N-00086-44724166,2020-08-05T16:37:54,Vitoria-Gasteiz,Basic services,water,-71.08,-4290.68
buyer_6,Manuel,45,ES48209597376888441122,TRX_N-00087-98091492,2020-08-06T14:42:43,Vitoria-Gasteiz,Basic services,water,-33.88,-4324.56
buyer_6,Manuel,45,ES48209597376888441122,TRX_N-00088-76997914,2020-08-06T19:29:38,Vitoria-Gasteiz,Basic services,internet,-43.82,-4368.38
buyer_6,Manuel,45,ES48209597376888441122,TRX_N-00089-94961109,2020-08-06T20:32:14,Vitoria-Gasteiz,Basic services,phone,-86.95,-4455.33
buyer_6,Manuel,45,ES48209597376888441122,TRX_N-00090-56694760,2020-08-07T14:42:27,Vitoria-Gasteiz,Basic services,water,-63.5,-4518.83
buyer_6,Manuel,45,ES48209597376888441122,TRX_N-00091-12171966,2020-09-01T13:59:04,Vitoria-Gasteiz,transfer,Salary,1795.63,-2723.2
buyer_6,Manuel,45,ES48209597376888441122,TRX_N-00092-14024162,2020-09-05T13:43:37,Vitoria-Gasteiz,Housing,Rent,-1329.48,-4052.68
buyer_6,Manuel,45,ES48209597376888441122,TRX_N-00093-14436749,2020-09-05T13:35:39,Vitoria-Gasteiz,Basic services,water,-77.8,-4130.48
buyer_6,Manuel,45,ES48209597376888441122,TRX_N-00094-91428754,2020-09-05T11:03:36,Vitoria-Gasteiz,Basic services,internet,-34.78,-4165.26
buyer_6,Manuel,45,ES48209597376888441122,TRX_N-00095-14115827,2020-09-05T14:16:18,Vitoria-Gasteiz,Basic services,phone,-32.83,-4198.09
buyer_6,Manuel,45,ES48209597376888441122,TRX_N-00096-85819024,2020-09-06T07:03:52,Vitoria-Gasteiz,Basic services,electricity,-112.71,-4310.8
buyer_6,Manuel,45,ES48209597376888441122,TRX_N-00097-96560665,2020-09-06T12:33:31,Vitoria-Gasteiz,Basic services,phone,-63.76,-4374.56
buyer_6,Manuel,45,ES48209597376888441122,TRX_N-00098-95952776,2020-09-07T14:05:25,Vitoria-Gasteiz,Basic services,water,-50.33,-4424.89
buyer_6,Manuel,45,ES48209597376888441122,TRX_N-00099-08145703,2020-09-07T12:45:08,Vitoria-Gasteiz,Basic services,electricity,-116.89,-4541.78
buyer_6,Manuel,45,ES48209597376888441122,TRX_N-00100-36246834,2020-09-07T14:02:59,Vitoria-Gasteiz,Basic services,internet,-34.58,-4576.36
buyer_6,Manuel,45,ES48209597376888441122,TRX_N-00101-06749005,2020-09-07T20:32:05,Vitoria-Gasteiz,Basic services,phone,-36.76,-4613.12
buyer_6,Manuel,45,ES48209597376888441122,TRX_N-00102-84700868,2020-09-11T14:02:06,Vitoria-Gasteiz,Expense,food,-568.66,-5181.78
buyer_6,Manuel,45,ES48209597376888441122,TRX_N-00103-21051181,2020-09-16T19:39:06,Vitoria-Gasteiz,Expense,leisure,-289.23,-5471.01
buyer_6,Manuel,45,ES48209597376888441122,TRX_N-00104-47650385,2020-09-18T11:03:53,Vitoria-Gasteiz,Expense,healthcare,-22.97,-5493.98
buyer_6,Manuel,45,ES48209597376888441122,TRX_N-00105-14153916,2020-09-20T14:21:58,Vitoria-Gasteiz,Expense,food,-137.54,-5631.52
buyer_6,Manuel,45,ES48209597376888441122,TRX_N-00106-89294141,2020-09-24T22:57:38,Leioa,Expense,transport,-134.67,-5766.19
buyer_6,Manuel,45,ES48209597376888441122,TRX_N-00107-77556197,2020-09-28T23:27:25,Vitoria-Gasteiz,Expense,education,-428.87,-6195.06
buyer_6,Manuel,45,ES48209597376888441122,TRX_N-00108-69221238,2020-10-01T10:13:20,Vitoria-Gasteiz,transfer,Salary,1795.63,-4399.43
buyer_6,Manuel,45,ES48209597376888441122,TRX_N-00109-69050559,2020-10-03T15:46:38,Sopela,Expense,clothing,-31.74,-4431.17
buyer_6,Manuel,45,ES48209597376888441122,TRX_N-00110-41607475,2020-10-05T09:00:38,Vitoria-Gasteiz,Housing,Rent,-1329.48,-5760.65
buyer_6,Manuel,45,ES48209597376888441122,TRX_N-00111-05886551,2020-10-05T13:11:21,Vitoria-Gasteiz,Basic services,gas,-74.16,-5834.81
buyer_6,Manuel,45,ES48209597376888441122,TRX_N-00112-67157523,2020-10-06T10:31:14,Vitoria-Gasteiz,Basic services,gas,-85.21,-5920.02
buyer_6,Manuel,45,ES48209597376888441122,TRX_N-00113-83065476,2020-10-06T08:08:24,Vitoria-Gasteiz,Basic services,phone,-41.73,-5961.75
buyer_6,Manuel,45,ES48209597376888441122,TRX_N-00114-02030527,2020-10-07T01:45:44,Vitoria-Gasteiz,Basic services,water,-46.14,-6007.89
buyer_6,Manuel,45,ES48209597376888441122,TRX_N-00115-26722488,2020-10-14T08:05:41,Lasarte-Oria,Expense,leisure,-67.24,-6075.13
buyer_6,Manuel,45,ES48209597376888441122,TRX_N-00116-54002932,2020-11-01T10:13:45,Vitoria-Gasteiz,transfer,Salary,1795.63,-4279.5
buyer_6,Manuel,45,ES48209597376888441122,TRX_N-00117-32786260,2020-11-01T10:13:45,Vitoria-Gasteiz,transfer,Extra Income,179.56,-4099.94
buyer_6,Manuel,45,ES48209597376888441122,TRX_N-00118-20579766,2020-11-05T15:05:21,Vitoria-Gasteiz,Housing,Rent,-1329.48,-5429.42
buyer_6,Manuel,45,ES48209597376888441122,TRX_N-00119-56833024,2020-11-05T10:17:54,Vitoria-Gasteiz,Basic services,electricity,-104.82,-5534.24
buyer_6,Manuel,45,ES48209597376888441122,TRX_N-00120-10157144,2020-11-05T12:19:51,Vitoria-Gasteiz,Basic services,internet,-30.78,-5565.02
buyer_6,Manuel,45,ES48209597376888441122,TRX_N-00121-97680978,2020-11-06T18:26:42,Vitoria-Gasteiz,Basic services,water,-74.52,-5639.54
buyer_6,Manuel,45,ES48209597376888441122,TRX_N-00122-16038171,2020-11-06T15:41:39,Vitoria-Gasteiz,Basic services,electricity,-47.89,-5687.43
buyer_6,Manuel,45,ES48209597376888441122,TRX_N-00123-64694108,2020-11-07T23:49:39,Vitoria-Gasteiz,Basic services,gas,-43.49,-5730.92
buyer_6,Manuel,45,ES48209597376888441122,TRX_N-00124-84277198,2020-11-07T11:44:02,Vitoria-Gasteiz,Basic services,internet,-53.31,-5784.23
buyer_6,Manuel,45,ES48209597376888441122,TRX_N-00125-31242530,2020-11-21T03:07:38,Vitoria-Gasteiz,Expense,travel,-2760.77,-8545.0
buyer_6,Manuel,45,ES48209597376888441122,TRX_N-00126-57541812,2020-11-22T18:16:41,Donostia,Expense,education,-562.66,-9107.66
buyer_6,Manuel,45,ES48209597376888441122,TRX_N-00127-02425060,2020-11-23T10:25:06,Vitoria-Gasteiz,Expense,leisure,-87.63,-9195.29
buyer_6,Manuel,45,ES48209597376888441122,TRX_N-00128-01132718,2020-11-23T14:08:52,Vitoria-Gasteiz,Expense,education,-446.46,-9641.75
buyer_6,Manuel,45,ES48209597376888441122,TRX_N-00129-37777907,2020-11-30T15:36:39,Vitoria-Gasteiz,Expense,transport,-118.46,-9760.21
buyer_6,Manuel,45,ES48209597376888441122,TRX_N-00130-92388113,2020-12-01T22:12:56,Vitoria-Gasteiz,transfer,Salary,1795.63,-7964.58
buyer_6,Manuel,45,ES48209597376888441122,TRX_N-00131-22493183,2020-12-01T22:12:56,Vitoria-Gasteiz,transfer,Bonus,1814.82,-6149.76
buyer_6,Manuel,45,ES48209597376888441122,TRX_N-00132-21703324,2020-12-05T17:02:12,Vitoria-Gasteiz,Housing,Rent,-1329.48,-7479.24
buyer_6,Manuel,45,ES48209597376888441122,TRX_N-00133-28925874,2020-12-05T10:23:52,Vitoria-Gasteiz,Basic services,gas,-28.93,-7508.17
buyer_6,Manuel,45,ES48209597376888441122,TRX_N-00134-16719177,2020-12-05T20:35:08,Vitoria-Gasteiz,Basic services,internet,-56.56,-7564.73
buyer_6,Manuel,45,ES48209597376888441122,TRX_N-00135-61898434,2020-12-06T13:06:46,Vitoria-Gasteiz,Basic services,phone,-70.28,-7635.01
buyer_6,Manuel,45,ES48209597376888441122,TRX_N-00136-75452899,2020-12-07T09:35:02,Vitoria-Gasteiz,Basic services,water,-65.9,-7700.91
buyer_6,Manuel,45,ES48209597376888441122,TRX_N-00137-80853700,2020-12-14T14:17:28,Vitoria-Gasteiz,Expense,healthcare,-65.46,-7766.37
buyer_6,Manuel,45,ES48209597376888441122,TRX_N-00138-34361724,2020-12-19T12:22:38,Vitoria-Gasteiz,Expense,clothing,-437.98,-8204.35
buyer_6,Manuel,45,ES48209597376888441122,TRX_N-00139-35833715,2020-12-22T22:15:52,Vitoria-Gasteiz,Expense,food,-567.26,-8771.61
buyer_6,Manuel,45,ES48209597376888441122,TRX_N-00140-23982702,2021-01-01T17:53:42,Vitoria-Gasteiz,transfer,Salary,1795.63,-6975.98
buyer_6,Manuel,45,ES48209597376888441122,TRX_N-00141-40475708,2021-01-05T16:58:02,Vitoria-Gasteiz,Housing,Rent,-1329.48,-8305.46
buyer_6,Manuel,45,ES48209597376888441122,TRX_N-00142-37371711,2021-01-05T19:29:51,Vitoria-Gasteiz,Basic services,gas,-96.83,-8402.29
buyer_6,Manuel,45,ES48209597376888441122,TRX_N-00143-88291302,2021-01-05T09:09:38,Vitoria-Gasteiz,Expense,transport,-75.81,-8478.1
buyer_6,Manuel,45,ES48209597376888441122,TRX_N-00144-14268515,2021-01-06T19:47:40,Vitoria-Gasteiz,Basic services,gas,-34.18,-8512.28
buyer_6,Manuel,45,ES48209597376888441122,TRX_N-00145-05618315,2021-01-06T12:11:47,Vitoria-Gasteiz,Basic services,internet,-61.59,-8573.87
buyer_6,Manuel,45,ES48209597376888441122,TRX_N-00146-54752268,2021-01-07T18:12:41,Vitoria-Gasteiz,Basic services,water,-38.73,-8612.6
buyer_6,Manuel,45,ES48209597376888441122,TRX_N-00147-16035384,2021-01-07T18:17:48,Vitoria-Gasteiz,Basic services,phone,-52.06,-8664.66
buyer_6,Manuel,45,ES48209597376888441122,TRX_N-00148-02345979,2021-01-11T20:48:18,Vitoria-Gasteiz,Expense,leisure,-111.08,-8775.74
buyer_6,Manuel,45,ES48209597376888441122,TRX_N-00149-67325584,2021-01-16T19:56:30,Vitoria-Gasteiz,Expense,food,-165.23,-8940.97
buyer_6,Manuel,45,ES48209597376888441122,TRX_N-00150-27139140,2021-02-01T13:15:00,Vitoria-Gasteiz,transfer,Salary,1795.63,-7145.34
buyer_6,Manuel,45,ES48209597376888441122,TRX_N-00151-22429422,2021-02-01T13:15:00,Vitoria-Gasteiz,transfer,Extra Income,179.56,-6965.78
buyer_6,Manuel,45,ES48209597376888441122,TRX_N-00152-63723652,2021-02-05T17:46:55,Vitoria-Gasteiz,Housing,Rent,-1329.48,-8295.26
buyer_6,Manuel,45,ES48209597376888441122,TRX_N-00153-95360560,2021-02-05T10:23:53,Vitoria-Gasteiz,Basic services,gas,-42.62,-8337.88
buyer_6,Manuel,45,ES48209597376888441122,TRX_N-00154-19813228,2021-02-05T13:22:04,Vitoria-Gasteiz,Expense,transport,-26.86,-8364.74
buyer_6,Manuel,45,ES48209597376888441122,TRX_N-00155-95869080,2021-02-06T20:14:41,Vitoria-Gasteiz,Basic services,water,-73.38,-8438.12
buyer_6,Manuel,45,ES48209597376888441122,TRX_N-00156-17412488,2021-02-06T13:10:16,Vitoria-Gasteiz,Basic services,electricity,-141.02,-8579.14
buyer_6,Manuel,45,ES48209597376888441122,TRX_N-00157-36498514,2021-02-07T19:28:25,Vitoria-Gasteiz,Basic services,water,-70.24,-8649.38
buyer_6,Manuel,45,ES48209597376888441122,TRX_N-00158-28387355,2021-02-07T05:01:27,Vitoria-Gasteiz,Basic services,gas,-53.43,-8702.81
buyer_6,Manuel,45,ES48209597376888441122,TRX_N-00159-11460170,2021-02-14T21:11:10,Vitoria-Gasteiz,Expense,transport,-61.95,-8764.76
buyer_6,Manuel,45,ES48209597376888441122,TRX_N-00160-99386419,2021-02-20T23:33:47,Vitoria-Gasteiz,Expense,transport,-178.65,-8943.41
buyer_6,Manuel,45,ES48209597376888441122,TRX_N-00161-07264279,2021-03-01T11:40:23,Vitoria-Gasteiz,transfer,Salary,1795.63,-7147.78
buyer_6,Manuel,45,ES48209597376888441122,TRX_N-00162-55008445,2021-03-03T15:47:23,Vitoria-Gasteiz,Expense,repairs,-325.01,-7472.79
buyer_6,Manuel,45,ES48209597376888441122,TRX_N-00163-46998264,2021-03-05T22:53:05,Vitoria-Gasteiz,Housing,Rent,-1329.48,-8802.27
buyer_6,Manuel,45,ES48209597376888441122,TRX_N-00164-80422395,2021-03-05T18:15:25,Vitoria-Gasteiz,Basic services,water,-55.94,-8858.21
buyer_6,Manuel,45,ES48209597376888441122,TRX_N-00165-88628838,2021-03-05T20:25:28,Vitoria-Gasteiz,Basic services,gas,-84.72,-8942.93
buyer_6,Manuel,45,ES48209597376888441122,TRX_N-00166-94944311,2021-03-05T19:07:52,Vitoria-Gasteiz,Basic services,internet,-52.97,-8995.9
buyer_6,Manuel,45,ES48209597376888441122,TRX_N-00167-87952324,2021-03-05T09:08:33,Vitoria-Gasteiz,Basic services,phone,-76.22,-9072.12
buyer_6,Manuel,45,ES48209597376888441122,TRX_N-00168-45875412,2021-03-06T15:42:50,Vitoria-Gasteiz,Basic services,electricity,-61.66,-9133.78
buyer_6,Manuel,45,ES48209597376888441122,TRX_N-00169-99250520,2021-03-06T13:16:29,Vitoria-Gasteiz,Basic services,gas,-32.71,-9166.49
buyer_6,Manuel,45,ES48209597376888441122,TRX_N-00170-27756493,2021-03-06T12:22:35,Vitoria-Gasteiz,Basic services,internet,-65.72,-9232.21
buyer_6,Manuel,45,ES48209597376888441122,TRX_N-00171-35343678,2021-03-06T14:23:48,Vitoria-Gasteiz,Basic services,phone,-70.06,-9302.27
buyer_6,Manuel,45,ES48209597376888441122,TRX_N-00172-72853935,2021-03-07T07:51:33,Vitoria-Gasteiz,Basic services,water,-73.48,-9375.75
buyer_6,Manuel,45,ES48209597376888441122,TRX_N-00173-16825803,2021-03-07T11:55:30,Vitoria-Gasteiz,Basic services,internet,-34.21,-9409.96
buyer_6,Manuel,45,ES48209597376888441122,TRX_N-00174-21404979,2021-03-07T23:06:22,Vitoria-Gasteiz,Expense,leisure,-43.55,-9453.51
buyer_6,Manuel,45,ES48209597376888441122,TRX_N-00175-88493465,2021-03-12T15:02:22,Vitoria-Gasteiz,Expense,food,-133.35,-9586.86
buyer_6,Manuel,45,ES48209597376888441122,TRX_N-00176-90266492,2021-03-15T10:40:36,Vitoria-Gasteiz,Expense,clothing,-222.05,-9808.91
buyer_6,Manuel,45,ES48209597376888441122,TRX_N-00177-92623476,2021-04-01T09:23:59,Vitoria-Gasteiz,transfer,Salary,1795.63,-8013.28
buyer_6,Manuel,45,ES48209597376888441122,TRX_N-00178-18846567,2021-04-05T13:19:03,Vitoria-Gasteiz,Housing,Rent,-1329.48,-9342.76
buyer_6,Manuel,45,ES48209597376888441122,TRX_N-00179-62463708,2021-04-05T17:31:51,Vitoria-Gasteiz,Basic services,internet,-43.0,-9385.76
buyer_6,Manuel,45,ES48209597376888441122,TRX_N-00180-41308427,2021-04-06T09:09:04,Vitoria-Gasteiz,Basic services,internet,-52.14,-9437.9
buyer_6,Manuel,45,ES48209597376888441122,TRX_N-00181-30044549,2021-04-06T08:19:32,Vitoria-Gasteiz,Basic services,phone,-65.48,-9503.38
buyer_6,Manuel,45,ES48209597376888441122,TRX_N-00182-67710216,2021-04-07T11:11:55,Vitoria-Gasteiz,Basic services,water,-41.37,-9544.75
buyer_6,Manuel,45,ES48209597376888441122,TRX_N-00183-40603233,2021-04-08T12:05:07,Vitoria-Gasteiz,Expense,food,-552.44,-10097.19
buyer_6,Manuel,45,ES48209597376888441122,TRX_N-00184-73586207,2021-04-08T19:29:59,Vitoria-Gasteiz,Expense,gifts,-85.47,-10182.66
buyer_6,Manuel,45,ES48209597376888441122,TRX_N-00185-98803742,2021-04-14T19:59:42,Vitoria-Gasteiz,Expense,transport,-69.3,-10251.96
buyer_6,Manuel,45,ES48209597376888441122,TRX_N-00186-62183630,2021-04-22T21:54:39,Vitoria-Gasteiz,Expense,food,-115.33,-10367.29
buyer_6,Manuel,45,ES48209597376888441122,TRX_N-00187-26117465,2021-04-22T11:06:08,Vitoria-Gasteiz,Expense,leisure,-167.74,-10535.03
buyer_6,Manuel,45,ES48209597376888441122,TRX_N-00188-67192943,2021-04-26T20:30:56,Vitoria-Gasteiz,Expense,food,-116.25,-10651.28
buyer_6,Manuel,45,ES48209597376888441122,TRX_N-00189-98292493,2021-04-26T16:34:15,Vitoria-Gasteiz,Expense,transport,-171.58,-10822.86
buyer_6,Manuel,45,ES48209597376888441122,TRX_N-00190-24292691,2021-04-27T12:51:12,Vitoria-Gasteiz,Expense,leisure,-25.16,-10848.02
buyer_6,Manuel,45,ES48209597376888441122,TRX_N-00191-44048933,2021-05-01T18:06:24,Vitoria-Gasteiz,transfer,Salary,1795.63,-9052.39
buyer_6,Manuel,45,ES48209597376888441122,TRX_N-00192-97814872,2021-05-01T18:06:24,Vitoria-Gasteiz,transfer,Extra Income,179.56,-8872.83
buyer_6,Manuel,45,ES48209597376888441122,TRX_N-00193-69899856,2021-05-02T23:24:22,Vitoria-Gasteiz,Expense,food,-237.48,-9110.31
buyer_6,Manuel,45,ES48209597376888441122,TRX_N-00194-19094184,2021-05-05T03:57:18,Vitoria-Gasteiz,Housing,Rent,-1329.48,-10439.79
buyer_6,Manuel,45,ES48209597376888441122,TRX_N-00195-13040933,2021-05-05T17:48:53,Vitoria-Gasteiz,Basic services,water,-52.55,-10492.34
buyer_6,Manuel,45,ES48209597376888441122,TRX_N-00196-83865290,2021-05-05T18:19:54,Vitoria-Gasteiz,Basic services,electricity,-140.71,-10633.05
buyer_6,Manuel,45,ES48209597376888441122,TRX_N-00197-70008435,2021-05-05T12:25:50,Vitoria-Gasteiz,Basic services,internet,-39.9,-10672.95
buyer_6,Manuel,45,ES48209597376888441122,TRX_N-00198-52330038,2021-05-05T21:28:45,Vitoria-Gasteiz,Basic services,phone,-79.38,-10752.33
buyer_6,Manuel,45,ES48209597376888441122,TRX_N-00199-63341127,2021-05-06T00:25:18,Vitoria-Gasteiz,Basic services,water,-51.44,-10803.77
buyer_6,Manuel,45,ES48209597376888441122,TRX_N-00200-61673691,2021-05-06T18:42:52,Vitoria-Gasteiz,Expense,transport,-140.0,-10943.77
buyer_6,Manuel,45,ES48209597376888441122,TRX_N-00201-31898904,2021-05-07T11:42:39,Vitoria-Gasteiz,Basic services,water,-72.57,-11016.34
buyer_6,Manuel,45,ES48209597376888441122,TRX_N-00202-77780534,2021-05-07T20:15:47,Vitoria-Gasteiz,Basic services,gas,-69.69,-11086.03
buyer_6,Manuel,45,ES48209597376888441122,TRX_N-00203-37686357,2021-05-07T10:08:55,Vitoria-Gasteiz,Basic services,internet,-47.63,-11133.66
buyer_6,Manuel,45,ES48209597376888441122,TRX_N-00204-49432887,2021-05-07T18:03:00,Vitoria-Gasteiz,Basic services,phone,-32.19,-11165.85
buyer_6,Manuel,45,ES48209597376888441122,TRX_N-00205-05545803,2021-05-09T01:20:40,Vitoria-Gasteiz,Expense,food,-634.77,-11800.62
buyer_6,Manuel,45,ES48209597376888441122,TRX_N-00206-03903875,2021-05-15T13:40:32,Vitoria-Gasteiz,Expense,food,-494.43,-12295.05
buyer_6,Manuel,45,ES48209597376888441122,TRX_N-00207-05418578,2021-05-20T10:49:18,Eibar,Expense,food,-722.06,-13017.11
buyer_6,Manuel,45,ES48209597376888441122,TRX_N-00208-45082748,2021-05-22T15:31:28,Vitoria-Gasteiz,Expense,gifts,-135.88,-13152.99
buyer_6,Manuel,45,ES48209597376888441122,TRX_N-00209-35403504,2021-05-29T11:33:31,Vitoria-Gasteiz,Expense,transport,-30.3,-13183.29
buyer_6,Manuel,45,ES48209597376888441122,TRX_N-00210-68839364,2021-06-01T19:12:41,Vitoria-Gasteiz,transfer,Salary,1795.63,-11387.66
buyer_6,Manuel,45,ES48209597376888441122,TRX_N-00211-64727107,2021-06-01T19:12:41,Vitoria-Gasteiz,transfer,Bonus,1762.22,-9625.44
buyer_6,Manuel,45,ES48209597376888441122,TRX_N-00212-84917644,2021-06-05T19:37:39,Vitoria-Gasteiz,Housing,Rent,-1329.48,-10954.92
buyer_6,Manuel,45,ES48209597376888441122,TRX_N-00213-30615903,2021-06-05T11:55:14,Vitoria-Gasteiz,Basic services,gas,-24.02,-10978.94
buyer_6,Manuel,45,ES48209597376888441122,TRX_N-00214-05520433,2021-06-05T16:18:37,Vitoria-Gasteiz,Basic services,phone,-87.82,-11066.76
buyer_6,Manuel,45,ES48209597376888441122,TRX_N-00215-30243008,2021-06-06T12:17:41,Vitoria-Gasteiz,Expense,food,-121.59,-11188.35
buyer_6,Manuel,45,ES48209597376888441122,TRX_N-00216-20463203,2021-06-06T15:32:43,Vitoria-Gasteiz,Expense,transport,-115.93,-11304.28
buyer_6,Manuel,45,ES48209597376888441122,TRX_N-00217-32250701,2021-06-07T04:51:19,Vitoria-Gasteiz,Basic services,internet,-67.18,-11371.46
buyer_6,Manuel,45,ES48209597376888441122,TRX_N-00218-05070349,2021-06-07T13:33:48,Vitoria-Gasteiz,Basic services,phone,-83.03,-11454.49
buyer_6,Manuel,45,ES48209597376888441122,TRX_N-00219-90065975,2021-06-15T14:36:11,Sestao,Expense,transport,-107.33,-11561.82
buyer_6,Manuel,45,ES48209597376888441122,TRX_N-00220-87624817,2021-06-27T11:36:55,Vitoria-Gasteiz,Expense,food,-524.72,-12086.54
buyer_6,Manuel,45,ES48209597376888441122,TRX_N-00221-94613553,2021-07-01T15:56:21,Vitoria-Gasteiz,transfer,Salary,1795.63,-10290.91
buyer_6,Manuel,45,ES48209597376888441122,TRX_N-00222-94366347,2021-07-02T08:35:52,Erandio,Expense,leisure,-98.57,-10389.48
buyer_6,Manuel,45,ES48209597376888441122,TRX_N-00223-37174681,2021-07-03T23:18:35,Vitoria-Gasteiz,Expense,repairs,-982.03,-11371.51
buyer_6,Manuel,45,ES48209597376888441122,TRX_N-00224-63689250,2021-07-04T15:40:37,Vitoria-Gasteiz,Expense,food,-526.09,-11897.6
buyer_6,Manuel,45,ES48209597376888441122,TRX_N-00225-17904539,2021-07-05T09:55:05,Vitoria-Gasteiz,Housing,Rent,-1329.48,-13227.08
buyer_6,Manuel,45,ES48209597376888441122,TRX_N-00226-28586502,2021-07-05T18:55:15,Vitoria-Gasteiz,Basic services,electricity,-88.37,-13315.45
buyer_6,Manuel,45,ES48209597376888441122,TRX_N-00227-60232331,2021-07-05T21:06:09,Vitoria-Gasteiz,Basic services,gas,-64.95,-13380.4
buyer_6,Manuel,45,ES48209597376888441122,TRX_N-00228-58651272,2021-07-06T22:36:23,Vitoria-Gasteiz,Basic services,electricity,-140.68,-13521.08
buyer_6,Manuel,45,ES48209597376888441122,TRX_N-00229-91540004,2021-07-07T12:57:32,Vitoria-Gasteiz,Basic services,phone,-95.28,-13616.36
buyer_6,Manuel,45,ES48209597376888441122,TRX_N-00230-46426123,2021-07-15T19:57:58,Vitoria-Gasteiz,Expense,food,-301.92,-13918.28
buyer_6,Manuel,45,ES48209597376888441122,TRX_N-00231-38816965,2021-07-17T10:11:57,Vitoria-Gasteiz,Expense,food,-656.96,-14575.24
buyer_6,Manuel,45,ES48209597376888441122,TRX_N-00232-43054952,2021-07-26T19:37:45,Vitoria-Gasteiz,Expense,food,-790.04,-15365.28
buyer_6,Manuel,45,ES48209597376888441122,TRX_N-00233-17484921,2021-07-30T19:34:10,Vitoria-Gasteiz,Expense,gifts,-211.82,-15577.1
buyer_6,Manuel,45,ES48209597376888441122,TRX_N-00234-56130705,2021-08-01T11:38:47,Vitoria-Gasteiz,transfer,Salary,1795.63,-13781.47
buyer_6,Manuel,45,ES48209597376888441122,TRX_N-00235-01674122,2021-08-01T11:38:47,Vitoria-Gasteiz,transfer,Extra Income,179.56,-13601.91
buyer_6,Manuel,45,ES48209597376888441122,TRX_N-00236-61716519,2021-08-05T19:49:30,Vitoria-Gasteiz,Housing,Rent,-1329.48,-14931.39
buyer_6,Manuel,45,ES48209597376888441122,TRX_N-00237-34015011,2021-08-05T06:42:07,Vitoria-Gasteiz,Basic services,water,-68.78,-15000.17
buyer_6,Manuel,45,ES48209597376888441122,TRX_N-00238-70747547,2021-08-05T21:34:30,Vitoria-Gasteiz,Basic services,gas,-60.55,-15060.72
buyer_6,Manuel,45,ES48209597376888441122,TRX_N-00239-09196404,2021-08-05T13:05:19,Vitoria-Gasteiz,Basic services,internet,-39.73,-15100.45
buyer_6,Manuel,45,ES48209597376888441122,TRX_N-00240-21862119,2021-08-05T11:10:55,Vitoria-Gasteiz,Basic services,phone,-41.41,-15141.86
buyer_6,Manuel,45,ES48209597376888441122,TRX_N-00241-56595745,2021-08-06T12:04:28,Vitoria-Gasteiz,Basic services,gas,-83.54,-15225.4
buyer_6,Manuel,45,ES48209597376888441122,TRX_N-00242-44236723,2021-08-07T11:45:35,Vitoria-Gasteiz,Basic services,water,-49.96,-15275.36
buyer_6,Manuel,45,ES48209597376888441122,TRX_N-00243-32034364,2021-08-07T15:28:21,Vitoria-Gasteiz,Basic services,phone,-58.91,-15334.27
buyer_6,Manuel,45,ES48209597376888441122,TRX_N-00244-28455222,2021-08-28T14:07:51,Amurrio,Expense,transport,-190.97,-15525.24
buyer_6,Manuel,45,ES48209597376888441122,TRX_N-00245-12825021,2021-08-31T08:59:23,Vitoria-Gasteiz,Expense,repairs,-741.4,-16266.64
buyer_6,Manuel,45,ES48209597376888441122,TRX_N-00246-46771295,2021-09-01T09:56:02,Vitoria-Gasteiz,transfer,Salary,1795.63,-14471.01
buyer_6,Manuel,45,ES48209597376888441122,TRX_N-00247-16139833,2021-09-01T20:35:44,Vitoria-Gasteiz,Expense,food,-392.34,-14863.35
buyer_6,Manuel,45,ES48209597376888441122,TRX_N-00248-41920524,2021-09-05T10:49:27,Vitoria-Gasteiz,Housing,Rent,-1329.48,-16192.83
buyer_6,Manuel,45,ES48209597376888441122,TRX_N-00249-20637847,2021-09-05T17:28:34,Vitoria-Gasteiz,Basic services,gas,-53.45,-16246.28
buyer_6,Manuel,45,ES48209597376888441122,TRX_N-00250-34425382,2021-09-05T10:21:42,Vitoria-Gasteiz,Basic services,phone,-32.12,-16278.4
buyer_6,Manuel,45,ES48209597376888441122,TRX_N-00251-44875433,2021-09-06T19:02:46,Vitoria-Gasteiz,Basic services,internet,-47.68,-16326.08
buyer_6,Manuel,45,ES48209597376888441122,TRX_N-00252-43379710,2021-09-07T18:05:03,Vitoria-Gasteiz,Basic services,electricity,-116.0,-16442.08
buyer_6,Manuel,45,ES48209597376888441122,TRX_N-00253-26227388,2021-09-07T14:51:23,Vitoria-Gasteiz,Basic services,phone,-77.36,-16519.44
buyer_6,Manuel,45,ES48209597376888441122,TRX_N-00254-90688930,2021-10-01T13:59:17,Vitoria-Gasteiz,transfer,Salary,1795.63,-14723.81
buyer_6,Manuel,45,ES48209597376888441122,TRX_N-00255-26552632,2021-10-04T14:43:51,Vitoria-Gasteiz,Expense,healthcare,-146.78,-14870.59
buyer_6,Manuel,45,ES48209597376888441122,TRX_N-00256-61886598,2021-10-05T12:59:19,Vitoria-Gasteiz,Housing,Rent,-1329.48,-16200.07
buyer_6,Manuel,45,ES48209597376888441122,TRX_N-00257-11406428,2021-10-06T17:22:31,Vitoria-Gasteiz,Basic services,gas,-88.91,-16288.98
buyer_6,Manuel,45,ES48209597376888441122,TRX_N-00258-53935122,2021-10-06T11:44:57,Vitoria-Gasteiz,Expense,transport,-25.57,-16314.55
buyer_6,Manuel,45,ES48209597376888441122,TRX_N-00259-49950149,2021-10-07T11:03:14,Vitoria-Gasteiz,Basic services,gas,-33.96,-16348.51
buyer_6,Manuel,45,ES48209597376888441122,TRX_N-00260-99606844,2021-10-10T13:25:21,Eibar,Expense,healthcare,-66.58,-16415.09
buyer_6,Manuel,45,ES48209597376888441122,TRX_N-00261-39904093,2021-10-10T20:54:36,Vitoria-Gasteiz,Expense,education,-251.55,-16666.64
buyer_6,Manuel,45,ES48209597376888441122,TRX_N-00262-16021891,2021-10-17T09:27:15,Vitoria-Gasteiz,Expense,leisure,-237.04,-16903.68
buyer_6,Manuel,45,ES48209597376888441122,TRX_N-00263-64537103,2021-10-19T18:49:35,Vitoria-Gasteiz,Expense,leisure,-19.99,-16923.67
buyer_6,Manuel,45,ES48209597376888441122,TRX_N-00264-49883888,2021-10-24T23:49:03,Vitoria-Gasteiz,Expense,food,-302.11,-17225.78
buyer_6,Manuel,45,ES48209597376888441122,TRX_N-00265-32639648,2021-10-26T10:40:20,Vitoria-Gasteiz,Expense,transport,-66.85,-17292.63
buyer_6,Manuel,45,ES48209597376888441122,TRX_N-00266-29140034,2021-10-30T08:00:05,Vitoria-Gasteiz,Expense,food,-463.32,-17755.95
buyer_6,Manuel,45,ES48209597376888441122,TRX_N-00267-90147379,2021-10-31T17:38:59,Vitoria-Gasteiz,Expense,food,-467.1,-18223.05
buyer_6,Manuel,45,ES48209597376888441122,TRX_N-00268-05535504,2021-11-01T11:40:27,Vitoria-Gasteiz,transfer,Salary,1795.63,-16427.42
buyer_6,Manuel,45,ES48209597376888441122,TRX_N-00269-18928362,2021-11-01T11:40:27,Vitoria-Gasteiz,transfer,Extra Income,179.56,-16247.86
buyer_6,Manuel,45,ES48209597376888441122,TRX_N-00270-71336832,2021-11-05T13:50:05,Vitoria-Gasteiz,Housing,Rent,-1329.48,-17577.34
buyer_6,Manuel,45,ES48209597376888441122,TRX_N-00271-95216471,2021-11-05T22:01:19,Vitoria-Gasteiz,Basic services,electricity,-110.44,-17687.78
buyer_6,Manuel,45,ES48209597376888441122,TRX_N-00272-74084883,2021-11-06T16:31:47,Vitoria-Gasteiz,Basic services,gas,-81.76,-17769.54
buyer_6,Manuel,45,ES48209597376888441122,TRX_N-00273-90066167,2021-11-07T10:00:19,Vitoria-Gasteiz,Basic services,internet,-36.52,-17806.06
buyer_6,Manuel,45,ES48209597376888441122,TRX_N-00274-29846011,2021-11-13T09:34:51,Vitoria-Gasteiz,Expense,clothing,-404.3,-18210.36
buyer_6,Manuel,45,ES48209597376888441122,TRX_N-00275-00767277,2021-12-01T23:16:54,Vitoria-Gasteiz,transfer,Salary,1795.63,-16414.73
buyer_6,Manuel,45,ES48209597376888441122,TRX_N-00276-51743208,2021-12-01T23:16:54,Vitoria-Gasteiz,transfer,Bonus,1732.65,-14682.08
buyer_6,Manuel,45,ES48209597376888441122,TRX_N-00277-18856393,2021-12-01T13:32:49,Vitoria-Gasteiz,Expense,education,-293.15,-14975.23
buyer_6,Manuel,45,ES48209597376888441122,TRX_N-00278-04527861,2021-12-05T15:17:33,Vitoria-Gasteiz,Housing,Rent,-1329.48,-16304.71
buyer_6,Manuel,45,ES48209597376888441122,TRX_N-00279-15666307,2021-12-05T16:39:18,Vitoria-Gasteiz,Basic services,water,-58.23,-16362.94
buyer_6,Manuel,45,ES48209597376888441122,TRX_N-00280-85356236,2021-12-05T10:22:00,Vitoria-Gasteiz,Basic services,gas,-27.52,-16390.46
buyer_6,Manuel,45,ES48209597376888441122,TRX_N-00281-62171243,2021-12-06T11:13:07,Vitoria-Gasteiz,Basic services,water,-51.48,-16441.94
buyer_6,Manuel,45,ES48209597376888441122,TRX_N-00282-87359966,2021-12-06T15:15:10,Vitoria-Gasteiz,Basic services,internet,-34.61,-16476.55
buyer_6,Manuel,45,ES48209597376888441122,TRX_N-00283-79563056,2021-12-07T09:18:36,Vitoria-Gasteiz,Basic services,water,-49.49,-16526.04
buyer_6,Manuel,45,ES48209597376888441122,TRX_N-00284-72955711,2021-12-07T19:45:33,Vitoria-Gasteiz,Basic services,electricity,-97.06,-16623.1
buyer_6,Manuel,45,ES48209597376888441122,TRX_N-00285-31866316,2021-12-07T18:23:40,Vitoria-Gasteiz,Basic services,gas,-89.89,-16712.99
buyer_6,Manuel,45,ES48209597376888441122,TRX_N-00286-39920765,2021-12-07T19:33:20,Vitoria-Gasteiz,Basic services,phone,-59.62,-16772.61
buyer_6,Manuel,45,ES48209597376888441122,TRX_N-00287-82596341,2021-12-15T12:19:29,Vitoria-Gasteiz,Expense,food,-366.31,-17138.92
buyer_6,Manuel,45,ES48209597376888441122,TRX_N-00288-82326784,2021-12-19T08:58:51,Vitoria-Gasteiz,Expense,transport,-64.96,-17203.88
buyer_6,Manuel,45,ES48209597376888441122,TRX_N-00289-94724058,2021-12-29T15:06:59,Vitoria-Gasteiz,Expense,clothing,-465.13,-17669.01
buyer_6,Manuel,45,ES48209597376888441122,TRX_N-00290-91641390,2022-01-01T20:13:48,Vitoria-Gasteiz,transfer,Salary,1795.63,-15873.38
buyer_6,Manuel,45,ES48209597376888441122,TRX_N-00291-02758069,2022-01-01T20:13:48,Vitoria-Gasteiz,transfer,Extra Income,179.56,-15693.82
buyer_6,Manuel,45,ES48209597376888441122,TRX_N-00292-87210589,2022-01-05T01:43:39,Vitoria-Gasteiz,Housing,Rent,-1329.48,-17023.3
buyer_6,Manuel,45,ES48209597376888441122,TRX_N-00293-34057463,2022-01-06T14:09:31,Vitoria-Gasteiz,Basic services,water,-26.58,-17049.88
buyer_6,Manuel,45,ES48209597376888441122,TRX_N-00294-59313921,2022-01-06T13:48:16,Vitoria-Gasteiz,Basic services,electricity,-85.99,-17135.87
buyer_6,Manuel,45,ES48209597376888441122,TRX_N-00295-37395007,2022-01-06T15:56:48,Vitoria-Gasteiz,Basic services,phone,-69.48,-17205.35
buyer_6,Manuel,45,ES48209597376888441122,TRX_N-00296-94800989,2022-01-07T14:29:37,Vitoria-Gasteiz,Basic services,gas,-43.11,-17248.46
buyer_6,Manuel,45,ES48209597376888441122,TRX_N-00297-31836210,2022-01-07T08:28:47,Vitoria-Gasteiz,Basic services,internet,-35.85,-17284.31
buyer_6,Manuel,45,ES48209597376888441122,TRX_N-00298-66701011,2022-01-30T19:52:38,Vitoria-Gasteiz,Expense,repairs,-801.97,-18086.28
buyer_6,Manuel,45,ES48209597376888441122,TRX_N-00299-05280532,2022-02-01T10:14:24,Vitoria-Gasteiz,transfer,Salary,1795.63,-16290.65
buyer_6,Manuel,45,ES48209597376888441122,TRX_N-00300-99200877,2022-02-05T22:38:37,Vitoria-Gasteiz,Housing,Rent,-1329.48,-17620.13
buyer_6,Manuel,45,ES48209597376888441122,TRX_N-00301-62059761,2022-02-05T09:04:40,Vitoria-Gasteiz,Basic services,gas,-15.3,-17635.43
buyer_6,Manuel,45,ES48209597376888441122,TRX_N-00302-00618937,2022-02-05T22:58:37,Vitoria-Gasteiz,Basic services,internet,-59.28,-17694.71
buyer_6,Manuel,45,ES48209597376888441122,TRX_N-00303-55829842,2022-02-06T23:28:57,Vitoria-Gasteiz,Basic services,water,-57.53,-17752.24
buyer_6,Manuel,45,ES48209597376888441122,TRX_N-00304-16376588,2022-02-06T09:35:19,Vitoria-Gasteiz,Basic services,phone,-31.28,-17783.52
buyer_6,Manuel,45,ES48209597376888441122,TRX_N-00305-28390101,2022-02-07T04:24:41,Vitoria-Gasteiz,Basic services,gas,-40.94,-17824.46
buyer_6,Manuel,45,ES48209597376888441122,TRX_N-00306-25929540,2022-03-01T15:14:23,Vitoria-Gasteiz,transfer,Salary,1795.63,-16028.83
buyer_6,Manuel,45,ES48209597376888441122,TRX_N-00307-24099946,2022-03-01T15:14:23,Vitoria-Gasteiz,transfer,Extra Income,179.56,-15849.27
buyer_6,Manuel,45,ES48209597376888441122,TRX_N-00308-48515611,2022-03-03T14:44:31,Vitoria-Gasteiz,Expense,food,-608.74,-16458.01
buyer_6,Manuel,45,ES48209597376888441122,TRX_N-00309-01309502,2022-03-05T18:33:19,Vitoria-Gasteiz,Housing,Rent,-1329.48,-17787.49
buyer_6,Manuel,45,ES48209597376888441122,TRX_N-00310-09332779,2022-03-05T20:07:57,Vitoria-Gasteiz,Basic services,gas,-64.86,-17852.35
buyer_6,Manuel,45,ES48209597376888441122,TRX_N-00311-36424791,2022-03-05T14:16:56,Vitoria-Gasteiz,Basic services,internet,-78.73,-17931.08
buyer_6,Manuel,45,ES48209597376888441122,TRX_N-00312-69958190,2022-03-05T23:17:28,Vitoria-Gasteiz,Basic services,phone,-79.74,-18010.82
buyer_6,Manuel,45,ES48209597376888441122,TRX_N-00313-85765099,2022-03-07T15:19:58,Vitoria-Gasteiz,Basic services,water,-22.77,-18033.59
buyer_6,Manuel,45,ES48209597376888441122,TRX_N-00314-83631375,2022-03-07T19:08:47,Vitoria-Gasteiz,Basic services,gas,-45.58,-18079.17
buyer_6,Manuel,45,ES48209597376888441122,TRX_N-00315-07736307,2022-03-07T19:43:55,Vitoria-Gasteiz,Expense,leisure,-71.6,-18150.77
buyer_6,Manuel,45,ES48209597376888441122,TRX_N-00316-60250375,2022-03-07T12:47:10,Pasaia,Expense,repairs,-887.4,-19038.17
buyer_6,Manuel,45,ES48209597376888441122,TRX_N-00317-81695012,2022-03-12T11:49:14,Vitoria-Gasteiz,Expense,clothing,-450.96,-19489.13
buyer_6,Manuel,45,ES48209597376888441122,TRX_N-00318-28198518,2022-03-16T08:42:49,Basauri,Expense,leisure,-258.95,-19748.08
buyer_6,Manuel,45,ES48209597376888441122,TRX_N-00319-18010286,2022-03-20T13:09:17,Vitoria-Gasteiz,Expense,leisure,-169.69,-19917.77
buyer_6,Manuel,45,ES48209597376888441122,TRX_N-00320-74455051,2022-03-22T08:54:01,Vitoria-Gasteiz,Expense,healthcare,-365.31,-20283.08
buyer_6,Manuel,45,ES48209597376888441122,TRX_N-00321-53179494,2022-03-30T18:39:38,Vitoria-Gasteiz,Expense,food,-637.03,-20920.11
buyer_6,Manuel,45,ES48209597376888441122,TRX_N-00322-14664126,2022-04-01T09:52:09,Vitoria-Gasteiz,transfer,Salary,1795.63,-19124.48
buyer_6,Manuel,45,ES48209597376888441122,TRX_N-00323-79994297,2022-04-05T08:25:31,Vitoria-Gasteiz,Housing,Rent,-1329.48,-20453.96
buyer_6,Manuel,45,ES48209597376888441122,TRX_N-00324-49239023,2022-04-05T17:00:12,Vitoria-Gasteiz,Basic services,electricity,-46.83,-20500.79
buyer_6,Manuel,45,ES48209597376888441122,TRX_N-00325-73769383,2022-04-06T12:27:46,Vitoria-Gasteiz,Basic services,water,-12.87,-20513.66
buyer_6,Manuel,45,ES48209597376888441122,TRX_N-00326-01729110,2022-04-07T09:35:32,Vitoria-Gasteiz,Basic services,phone,-92.91,-20606.57
buyer_6,Manuel,45,ES48209597376888441122,TRX_N-00327-46137065,2022-04-09T09:21:43,Vitoria-Gasteiz,Expense,leisure,-255.29,-20861.86
buyer_6,Manuel,45,ES48209597376888441122,TRX_N-00328-71693357,2022-04-10T16:01:36,Vitoria-Gasteiz,Expense,clothing,-475.84,-21337.7
buyer_6,Manuel,45,ES48209597376888441122,TRX_N-00329-75714334,2022-04-11T15:43:46,Vitoria-Gasteiz,Expense,transport,-111.94,-21449.64
buyer_6,Manuel,45,ES48209597376888441122,TRX_N-00330-56436720,2022-05-01T18:04:24,Vitoria-Gasteiz,transfer,Salary,1795.63,-19654.01
buyer_6,Manuel,45,ES48209597376888441122,TRX_N-00331-04968149,2022-05-01T18:04:24,Vitoria-Gasteiz,transfer,Extra Income,179.56,-19474.45
buyer_6,Manuel,45,ES48209597376888441122,TRX_N-00332-05665267,2022-05-01T15:45:52,Vitoria-Gasteiz,Expense,leisure,-227.01,-19701.46
buyer_6,Manuel,45,ES48209597376888441122,TRX_N-00333-33751047,2022-05-04T15:50:26,Vitoria-Gasteiz,Expense,transport,-104.31,-19805.77
buyer_6,Manuel,45,ES48209597376888441122,TRX_N-00334-01977935,2022-05-05T19:18:35,Vitoria-Gasteiz,Housing,Rent,-1329.48,-21135.25
buyer_6,Manuel,45,ES48209597376888441122,TRX_N-00335-24389201,2022-05-05T11:36:39,Vitoria-Gasteiz,Basic services,water,-53.48,-21188.73
buyer_6,Manuel,45,ES48209597376888441122,TRX_N-00336-31289962,2022-05-05T17:00:20,Vitoria-Gasteiz,Basic services,electricity,-147.65,-21336.38
buyer_6,Manuel,45,ES48209597376888441122,TRX_N-00337-73949596,2022-05-05T14:31:49,Vitoria-Gasteiz,Basic services,internet,-71.73,-21408.11
buyer_6,Manuel,45,ES48209597376888441122,TRX_N-00338-73751561,2022-05-06T16:04:20,Vitoria-Gasteiz,Basic services,gas,-18.63,-21426.74
buyer_6,Manuel,45,ES48209597376888441122,TRX_N-00339-13587767,2022-05-07T09:47:43,Vitoria-Gasteiz,Basic services,gas,-32.09,-21458.83
buyer_6,Manuel,45,ES48209597376888441122,TRX_N-00340-58744854,2022-05-07T11:21:56,Vitoria-Gasteiz,Basic services,internet,-34.58,-21493.41
buyer_6,Manuel,45,ES48209597376888441122,TRX_N-00341-54088277,2022-05-24T08:11:45,Vitoria-Gasteiz,Expense,leisure,-173.39,-21666.8
buyer_6,Manuel,45,ES48209597376888441122,TRX_N-00342-58262379,2022-06-01T18:15:49,Vitoria-Gasteiz,transfer,Salary,1795.63,-19871.17
buyer_6,Manuel,45,ES48209597376888441122,TRX_N-00343-30294932,2022-06-01T18:15:49,Vitoria-Gasteiz,transfer,Bonus,1957.21,-17913.96
buyer_6,Manuel,45,ES48209597376888441122,TRX_N-00344-60446989,2022-06-03T14:04:34,Vitoria-Gasteiz,Expense,transport,-135.34,-18049.3
buyer_6,Manuel,45,ES48209597376888441122,TRX_N-00345-12813419,2022-06-05T13:10:29,Vitoria-Gasteiz,Housing,Rent,-1329.48,-19378.78
buyer_6,Manuel,45,ES48209597376888441122,TRX_N-00346-50745611,2022-06-05T13:33:46,Vitoria-Gasteiz,Basic services,internet,-78.35,-19457.13
buyer_6,Manuel,45,ES48209597376888441122,TRX_N-00347-78276462,2022-06-06T22:14:00,Vitoria-Gasteiz,Basic services,electricity,-55.32,-19512.45
buyer_6,Manuel,45,ES48209597376888441122,TRX_N-00348-32935383,2022-06-07T16:36:57,Vitoria-Gasteiz,Basic services,internet,-67.06,-19579.51
buyer_6,Manuel,45,ES48209597376888441122,TRX_N-00349-12451279,2022-06-21T13:03:00,Vitoria-Gasteiz,Expense,gifts,-22.86,-19602.37
buyer_6,Manuel,45,ES48209597376888441122,TRX_N-00350-91835693,2022-07-01T16:25:07,Vitoria-Gasteiz,transfer,Salary,1795.63,-17806.74
buyer_6,Manuel,45,ES48209597376888441122,TRX_N-00351-51190489,2022-07-05T16:14:16,Vitoria-Gasteiz,Housing,Rent,-1329.48,-19136.22
buyer_6,Manuel,45,ES48209597376888441122,TRX_N-00352-38166153,2022-07-05T12:46:33,Vitoria-Gasteiz,Basic services,internet,-68.55,-19204.77
buyer_6,Manuel,45,ES48209597376888441122,TRX_N-00353-10451468,2022-07-06T13:56:38,Vitoria-Gasteiz,Basic services,water,-22.46,-19227.23
buyer_6,Manuel,45,ES48209597376888441122,TRX_N-00354-60355067,2022-07-06T11:20:27,Vitoria-Gasteiz,Basic services,electricity,-145.06,-19372.29
buyer_6,Manuel,45,ES48209597376888441122,TRX_N-00355-41881967,2022-07-07T09:15:50,Vitoria-Gasteiz,Basic services,phone,-97.0,-19469.29
buyer_6,Manuel,45,ES48209597376888441122,TRX_N-00356-43395539,2022-07-09T18:20:15,Vitoria-Gasteiz,Expense,leisure,-258.22,-19727.51
buyer_6,Manuel,45,ES48209597376888441122,TRX_N-00357-53793451,2022-07-15T19:55:30,Vitoria-Gasteiz,Expense,leisure,-73.45,-19800.96
buyer_6,Manuel,45,ES48209597376888441122,TRX_N-00358-12894536,2022-07-20T21:30:46,Vitoria-Gasteiz,Expense,clothing,-161.57,-19962.53
buyer_6,Manuel,45,ES48209597376888441122,TRX_N-00359-62956057,2022-08-01T22:09:07,Vitoria-Gasteiz,transfer,Salary,1795.63,-18166.9
buyer_6,Manuel,45,ES48209597376888441122,TRX_N-00360-77972281,2022-08-01T22:09:07,Vitoria-Gasteiz,transfer,Extra Income,179.56,-17987.34
buyer_6,Manuel,45,ES48209597376888441122,TRX_N-00361-81974586,2022-08-04T16:01:07,Berango,Expense,education,-175.4,-18162.74
buyer_6,Manuel,45,ES48209597376888441122,TRX_N-00362-36630266,2022-08-05T17:35:15,Vitoria-Gasteiz,Housing,Rent,-1329.48,-19492.22
buyer_6,Manuel,45,ES48209597376888441122,TRX_N-00363-26571561,2022-08-05T11:19:43,Vitoria-Gasteiz,Basic services,water,-16.42,-19508.64
buyer_6,Manuel,45,ES48209597376888441122,TRX_N-00364-05774829,2022-08-05T18:19:21,Vitoria-Gasteiz,Basic services,electricity,-22.54,-19531.18
buyer_6,Manuel,45,ES48209597376888441122,TRX_N-00365-85562547,2022-08-05T12:24:18,Vitoria-Gasteiz,Basic services,phone,-54.46,-19585.64
buyer_6,Manuel,45,ES48209597376888441122,TRX_N-00366-22857830,2022-08-06T14:59:01,Vitoria-Gasteiz,Basic services,internet,-43.39,-19629.03
buyer_6,Manuel,45,ES48209597376888441122,TRX_N-00367-95448048,2022-08-06T13:38:38,Vitoria-Gasteiz,Expense,transport,-191.67,-19820.7
buyer_6,Manuel,45,ES48209597376888441122,TRX_N-00368-49943500,2022-08-07T18:04:41,Vitoria-Gasteiz,Basic services,internet,-42.51,-19863.21
buyer_6,Manuel,45,ES48209597376888441122,TRX_N-00369-62424402,2022-08-17T17:44:28,Vitoria-Gasteiz,Expense,education,-806.01,-20669.22
buyer_6,Manuel,45,ES48209597376888441122,TRX_N-00370-38020712,2022-09-01T22:05:43,Vitoria-Gasteiz,transfer,Salary,1795.63,-18873.59
buyer_6,Manuel,45,ES48209597376888441122,TRX_N-00371-26879275,2022-09-03T16:43:34,Vitoria-Gasteiz,Expense,leisure,-141.92,-19015.51
buyer_6,Manuel,45,ES48209597376888441122,TRX_N-00372-66881547,2022-09-05T06:12:25,Vitoria-Gasteiz,Housing,Rent,-1329.48,-20344.99
buyer_6,Manuel,45,ES48209597376888441122,TRX_N-00373-88825375,2022-09-06T18:32:15,Vitoria-Gasteiz,Basic services,electricity,-92.55,-20437.54
buyer_6,Manuel,45,ES48209597376888441122,TRX_N-00374-00771461,2022-09-07T21:58:06,Vitoria-Gasteiz,Basic services,water,-43.58,-20481.12
buyer_6,Manuel,45,ES48209597376888441122,TRX_N-00375-97988602,2022-09-07T09:21:53,Vitoria-Gasteiz,Basic services,electricity,-107.57,-20588.69
buyer_6,Manuel,45,ES48209597376888441122,TRX_N-00376-56161243,2022-09-07T16:31:26,Vitoria-Gasteiz,Basic services,gas,-78.58,-20667.27
buyer_6,Manuel,45,ES48209597376888441122,TRX_N-00377-32279606,2022-09-07T15:57:23,Vitoria-Gasteiz,Basic services,internet,-60.74,-20728.01
buyer_6,Manuel,45,ES48209597376888441122,TRX_N-00378-45674206,2022-09-13T16:42:12,Andoain,Expense,clothing,-477.98,-21205.99
buyer_6,Manuel,45,ES48209597376888441122,TRX_N-00379-08694348,2022-09-14T09:50:36,Vitoria-Gasteiz,Expense,leisure,-281.62,-21487.61
buyer_6,Manuel,45,ES48209597376888441122,TRX_N-00380-62371994,2022-09-16T01:08:30,Vitoria-Gasteiz,Expense,food,-162.4,-21650.01
buyer_6,Manuel,45,ES48209597376888441122,TRX_N-00381-52229935,2022-09-27T09:55:49,Vitoria-Gasteiz,Expense,healthcare,-124.18,-21774.19
buyer_6,Manuel,45,ES48209597376888441122,TRX_N-00382-26582483,2022-10-01T12:05:23,Vitoria-Gasteiz,transfer,Salary,1795.63,-19978.56
buyer_6,Manuel,45,ES48209597376888441122,TRX_N-00383-53757038,2022-10-05T15:52:19,Vitoria-Gasteiz,Housing,Rent,-1329.48,-21308.04
buyer_6,Manuel,45,ES48209597376888441122,TRX_N-00384-34855494,2022-10-05T08:12:24,Vitoria-Gasteiz,Basic services,gas,-67.05,-21375.09
buyer_6,Manuel,45,ES48209597376888441122,TRX_N-00385-85553469,2022-10-05T11:46:01,Vitoria-Gasteiz,Basic services,phone,-37.24,-21412.33
buyer_6,Manuel,45,ES48209597376888441122,TRX_N-00386-60594880,2022-10-05T10:03:02,Elciego,Expense,food,-253.97,-21666.3
buyer_6,Manuel,45,ES48209597376888441122,TRX_N-00387-12157598,2022-10-07T19:36:46,Vitoria-Gasteiz,Basic services,water,-32.72,-21699.02
buyer_6,Manuel,45,ES48209597376888441122,TRX_N-00388-47748878,2022-10-07T18:13:48,Vitoria-Gasteiz,Basic services,internet,-75.16,-21774.18
buyer_6,Manuel,45,ES48209597376888441122,TRX_N-00389-10807350,2022-10-07T19:17:27,Vitoria-Gasteiz,Basic services,phone,-72.02,-21846.2
buyer_6,Manuel,45,ES48209597376888441122,TRX_N-00390-49303334,2022-10-07T18:45:32,Vitoria-Gasteiz,Expense,gifts,-199.91,-22046.11
buyer_6,Manuel,45,ES48209597376888441122,TRX_N-00391-46682529,2022-10-10T10:11:45,Vitoria-Gasteiz,Expense,education,-133.94,-22180.05
buyer_6,Manuel,45,ES48209597376888441122,TRX_N-00392-62760655,2022-10-14T10:00:16,Vitoria-Gasteiz,Expense,clothing,-297.13,-22477.18
buyer_6,Manuel,45,ES48209597376888441122,TRX_N-00393-45886147,2022-10-19T20:25:26,Vitoria-Gasteiz,Expense,food,-477.66,-22954.84
buyer_6,Manuel,45,ES48209597376888441122,TRX_N-00394-78816473,2022-10-28T16:05:34,Vitoria-Gasteiz,Expense,education,-525.19,-23480.03
buyer_6,Manuel,45,ES48209597376888441122,TRX_N-00395-64486453,2022-11-01T12:28:58,Vitoria-Gasteiz,transfer,Salary,1795.63,-21684.4
buyer_6,Manuel,45,ES48209597376888441122,TRX_N-00396-90691427,2022-11-01T12:28:58,Vitoria-Gasteiz,transfer,Extra Income,179.56,-21504.84
buyer_6,Manuel,45,ES48209597376888441122,TRX_N-00397-79182940,2022-11-02T08:37:26,Vitoria-Gasteiz,Expense,leisure,-208.47,-21713.31
buyer_6,Manuel,45,ES48209597376888441122,TRX_N-00398-92752416,2022-11-05T12:55:23,Vitoria-Gasteiz,Housing,Rent,-1329.48,-23042.79
buyer_6,Manuel,45,ES48209597376888441122,TRX_N-00399-33585874,2022-11-05T11:37:57,Vitoria-Gasteiz,Basic services,water,-69.86,-23112.65
buyer_6,Manuel,45,ES48209597376888441122,TRX_N-00400-66773779,2022-11-05T11:10:16,Vitoria-Gasteiz,Basic services,electricity,-88.26,-23200.91
buyer_6,Manuel,45,ES48209597376888441122,TRX_N-00401-26162438,2022-11-05T17:27:55,Vitoria-Gasteiz,Basic services,gas,-32.2,-23233.11
buyer_6,Manuel,45,ES48209597376888441122,TRX_N-00402-37283142,2022-11-06T09:12:28,Vitoria-Gasteiz,Basic services,phone,-23.59,-23256.7
buyer_6,Manuel,45,ES48209597376888441122,TRX_N-00403-99216850,2022-11-18T16:33:21,Arrasate/Mondragon,Expense,food,-648.29,-23904.99
buyer_6,Manuel,45,ES48209597376888441122,TRX_N-00404-38648380,2022-11-19T06:14:16,Vitoria-Gasteiz,Expense,gifts,-198.98,-24103.97
buyer_6,Manuel,45,ES48209597376888441122,TRX_N-00405-01080464,2022-11-28T21:30:45,Vitoria-Gasteiz,Expense,leisure,-97.83,-24201.8
buyer_6,Manuel,45,ES48209597376888441122,TRX_N-00406-37306852,2022-11-29T10:46:30,Vitoria-Gasteiz,Expense,clothing,-205.36,-24407.16
buyer_6,Manuel,45,ES48209597376888441122,TRX_N-00407-48304305,2022-12-01T10:46:02,Vitoria-Gasteiz,transfer,Salary,1795.63,-22611.53
buyer_6,Manuel,45,ES48209597376888441122,TRX_N-00408-03419789,2022-12-01T10:46:02,Vitoria-Gasteiz,transfer,Bonus,1626.84,-20984.69
buyer_6,Manuel,45,ES48209597376888441122,TRX_N-00409-87086982,2022-12-05T13:40:02,Vitoria-Gasteiz,Housing,Rent,-1329.48,-22314.17
buyer_6,Manuel,45,ES48209597376888441122,TRX_N-00410-58836560,2022-12-05T13:52:36,Vitoria-Gasteiz,Basic services,gas,-35.88,-22350.05
buyer_6,Manuel,45,ES48209597376888441122,TRX_N-00411-54468388,2022-12-05T13:41:09,Vitoria-Gasteiz,Basic services,internet,-37.24,-22387.29
buyer_6,Manuel,45,ES48209597376888441122,TRX_N-00412-41346692,2022-12-05T11:43:58,Vitoria-Gasteiz,Basic services,phone,-76.47,-22463.76
buyer_6,Manuel,45,ES48209597376888441122,TRX_N-00413-51382934,2022-12-06T09:28:27,Vitoria-Gasteiz,Basic services,electricity,-121.87,-22585.63
buyer_6,Manuel,45,ES48209597376888441122,TRX_N-00414-94727951,2022-12-06T08:27:45,Vitoria-Gasteiz,Basic services,internet,-44.63,-22630.26
buyer_6,Manuel,45,ES48209597376888441122,TRX_N-00415-66438606,2022-12-10T12:04:23,Vitoria-Gasteiz,Expense,leisure,-286.64,-22916.9
buyer_6,Manuel,45,ES48209597376888441122,TRX_N-00416-59395941,2022-12-16T19:10:21,Vitoria-Gasteiz,Expense,transport,-172.26,-23089.16
buyer_6,Manuel,45,ES48209597376888441122,TRX_N-00417-36067238,2022-12-16T08:42:24,Vitoria-Gasteiz,Expense,clothing,-266.88,-23356.04
buyer_6,Manuel,45,ES48209597376888441122,TRX_N-00418-05778768,2022-12-28T06:00:05,Vitoria-Gasteiz,Expense,clothing,-133.32,-23489.36
buyer_6,Manuel,45,ES48209597376888441122,TRX_N-00419-05544480,2023-01-01T13:43:06,Vitoria-Gasteiz,transfer,Salary,1795.63,-21693.73
buyer_6,Manuel,45,ES48209597376888441122,TRX_N-00420-78521377,2023-01-01T13:43:06,Vitoria-Gasteiz,transfer,Extra Income,179.56,-21514.17
buyer_6,Manuel,45,ES48209597376888441122,TRX_N-00421-96256120,2023-01-03T13:48:59,Oyón-Oion,Expense,food,-758.38,-22272.55
buyer_6,Manuel,45,ES48209597376888441122,TRX_N-00422-37353202,2023-01-05T02:44:16,Vitoria-Gasteiz,Housing,Rent,-1329.48,-23602.03
buyer_6,Manuel,45,ES48209597376888441122,TRX_N-00423-12392542,2023-01-06T16:05:27,Vitoria-Gasteiz,Basic services,water,-19.7,-23621.73
buyer_6,Manuel,45,ES48209597376888441122,TRX_N-00424-40512940,2023-01-06T19:41:24,Vitoria-Gasteiz,Basic services,phone,-48.26,-23669.99
buyer_6,Manuel,45,ES48209597376888441122,TRX_N-00425-73566147,2023-01-07T07:23:12,Vitoria-Gasteiz,Basic services,internet,-78.82,-23748.81
buyer_6,Manuel,45,ES48209597376888441122,TRX_N-00426-70809905,2023-01-07T19:43:31,Vitoria-Gasteiz,Basic services,phone,-37.07,-23785.88
buyer_6,Manuel,45,ES48209597376888441122,TRX_N-00427-16538555,2023-01-11T12:41:34,Vitoria-Gasteiz,Expense,leisure,-142.83,-23928.71
buyer_6,Manuel,45,ES48209597376888441122,TRX_N-00428-09800901,2023-01-19T14:17:20,Vitoria-Gasteiz,Expense,food,-171.4,-24100.11
buyer_6,Manuel,45,ES48209597376888441122,TRX_N-00429-05375796,2023-01-27T14:00:21,Vitoria-Gasteiz,Expense,food,-362.46,-24462.57
buyer_6,Manuel,45,ES48209597376888441122,TRX_N-00430-07336615,2023-02-01T13:56:27,Vitoria-Gasteiz,transfer,Salary,1795.63,-22666.94
buyer_6,Manuel,45,ES48209597376888441122,TRX_N-00431-35281490,2023-02-05T22:44:31,Vitoria-Gasteiz,Housing,Rent,-1329.48,-23996.42
buyer_6,Manuel,45,ES48209597376888441122,TRX_N-00432-33521858,2023-02-06T15:20:06,Vitoria-Gasteiz,Basic services,water,-41.55,-24037.97
buyer_6,Manuel,45,ES48209597376888441122,TRX_N-00433-83355614,2023-02-06T03:36:02,Vitoria-Gasteiz,Basic services,phone,-48.89,-24086.86
buyer_6,Manuel,45,ES48209597376888441122,TRX_N-00434-08429165,2023-02-07T13:57:32,Vitoria-Gasteiz,Basic services,water,-60.73,-24147.59
buyer_6,Manuel,45,ES48209597376888441122,TRX_N-00435-18147583,2023-02-07T11:21:52,Vitoria-Gasteiz,Basic services,internet,-40.05,-24187.64
buyer_6,Manuel,45,ES48209597376888441122,TRX_N-00436-10912109,2023-02-07T20:52:42,Vitoria-Gasteiz,Basic services,phone,-55.3,-24242.94
buyer_6,Manuel,45,ES48209597376888441122,TRX_N-00437-83292887,2023-02-24T11:36:12,Vitoria-Gasteiz,Expense,food,-357.74,-24600.68
buyer_6,Manuel,45,ES48209597376888441122,TRX_N-00438-63027394,2023-03-01T19:19:08,Vitoria-Gasteiz,transfer,Salary,1795.63,-22805.05
buyer_6,Manuel,45,ES48209597376888441122,TRX_N-00439-58368863,2023-03-01T19:19:08,Vitoria-Gasteiz,transfer,Extra Income,179.56,-22625.49
buyer_6,Manuel,45,ES48209597376888441122,TRX_N-00440-65913789,2023-03-05T23:10:18,Vitoria-Gasteiz,Housing,Rent,-1329.48,-23954.97
buyer_6,Manuel,45,ES48209597376888441122,TRX_N-00441-93030599,2023-03-05T15:57:53,Vitoria-Gasteiz,Basic services,water,-31.07,-23986.04
buyer_6,Manuel,45,ES48209597376888441122,TRX_N-00442-61209644,2023-03-05T12:15:10,Vitoria-Gasteiz,Basic services,electricity,-149.25,-24135.29
buyer_6,Manuel,45,ES48209597376888441122,TRX_N-00443-34366210,2023-03-05T09:57:30,Vitoria-Gasteiz,Basic services,internet,-41.1,-24176.39
buyer_6,Manuel,45,ES48209597376888441122,TRX_N-00444-95642219,2023-03-06T19:19:17,Vitoria-Gasteiz,Basic services,internet,-41.51,-24217.9
buyer_6,Manuel,45,ES48209597376888441122,TRX_N-00445-34958636,2023-03-06T17:15:24,Vitoria-Gasteiz,Basic services,phone,-84.29,-24302.19
buyer_6,Manuel,45,ES48209597376888441122,TRX_N-00446-32267207,2023-03-07T17:42:34,Vitoria-Gasteiz,Basic services,electricity,-45.99,-24348.18
buyer_6,Manuel,45,ES48209597376888441122,TRX_N-00447-33384655,2023-03-07T17:12:58,Vitoria-Gasteiz,Basic services,internet,-78.96,-24427.14
buyer_6,Manuel,45,ES48209597376888441122,TRX_N-00448-05582161,2023-03-14T04:47:15,Vitoria-Gasteiz,Expense,leisure,-48.15,-24475.29
buyer_6,Manuel,45,ES48209597376888441122,TRX_N-00449-57527867,2023-04-01T15:19:05,Vitoria-Gasteiz,transfer,Salary,1795.63,-22679.66
buyer_6,Manuel,45,ES48209597376888441122,TRX_N-00450-42018171,2023-04-02T12:45:23,Vitoria-Gasteiz,Expense,transport,-39.55,-22719.21
buyer_6,Manuel,45,ES48209597376888441122,TRX_N-00451-76930617,2023-04-05T11:05:16,Vitoria-Gasteiz,Housing,Rent,-1329.48,-24048.69
buyer_6,Manuel,45,ES48209597376888441122,TRX_N-00452-03403763,2023-04-05T12:25:58,Vitoria-Gasteiz,Basic services,electricity,-109.07,-24157.76
buyer_6,Manuel,45,ES48209597376888441122,TRX_N-00453-85749943,2023-04-05T21:56:34,Vitoria-Gasteiz,Basic services,phone,-96.92,-24254.68
buyer_6,Manuel,45,ES48209597376888441122,TRX_N-00454-11863635,2023-04-06T10:59:33,Vitoria-Gasteiz,Basic services,phone,-39.04,-24293.72
buyer_6,Manuel,45,ES48209597376888441122,TRX_N-00455-15967701,2023-04-07T08:41:19,Vitoria-Gasteiz,Expense,food,-221.73,-24515.45
buyer_6,Manuel,45,ES48209597376888441122,TRX_N-00456-46329232,2023-04-17T16:24:29,Sestao,Expense,food,-447.75,-24963.2
buyer_6,Manuel,45,ES48209597376888441122,TRX_N-00457-50150297,2023-04-26T12:23:01,Salvatierra/Agurain,Expense,clothing,-469.14,-25432.34
buyer_6,Manuel,45,ES48209597376888441122,TRX_N-00458-78045882,2023-05-01T20:51:58,Vitoria-Gasteiz,transfer,Salary,1795.63,-23636.71
buyer_6,Manuel,45,ES48209597376888441122,TRX_N-00459-45253948,2023-05-05T16:40:47,Vitoria-Gasteiz,Housing,Rent,-1329.48,-24966.19
buyer_6,Manuel,45,ES48209597376888441122,TRX_N-00460-68637248,2023-05-05T18:56:38,Vitoria-Gasteiz,Basic services,water,-79.38,-25045.57
buyer_6,Manuel,45,ES48209597376888441122,TRX_N-00461-61251286,2023-05-05T22:04:10,Vitoria-Gasteiz,Basic services,gas,-43.97,-25089.54
buyer_6,Manuel,45,ES48209597376888441122,TRX_N-00462-98402452,2023-05-05T12:37:46,Vitoria-Gasteiz,Basic services,phone,-30.66,-25120.2
buyer_6,Manuel,45,ES48209597376888441122,TRX_N-00463-43888802,2023-05-06T12:20:29,Vitoria-Gasteiz,Basic services,water,-15.94,-25136.14
buyer_6,Manuel,45,ES48209597376888441122,TRX_N-00464-87916935,2023-05-07T19:18:33,Vitoria-Gasteiz,Basic services,gas,-99.85,-25235.99
buyer_6,Manuel,45,ES48209597376888441122,TRX_N-00465-69317173,2023-05-07T15:45:20,Vitoria-Gasteiz,Basic services,internet,-73.38,-25309.37
buyer_6,Manuel,45,ES48209597376888441122,TRX_N-00466-52427230,2023-05-07T11:42:21,Vitoria-Gasteiz,Basic services,phone,-32.7,-25342.07
buyer_6,Manuel,45,ES48209597376888441122,TRX_N-00467-68888026,2023-05-12T12:51:50,Vitoria-Gasteiz,Expense,leisure,-121.57,-25463.64
buyer_6,Manuel,45,ES48209597376888441122,TRX_N-00468-06386036,2023-05-15T20:15:34,Vitoria-Gasteiz,Expense,clothing,-239.36,-25703.0
buyer_6,Manuel,45,ES48209597376888441122,TRX_N-00469-88534608,2023-05-19T11:50:00,Vitoria-Gasteiz,Expense,appliances,-992.57,-26695.57
buyer_6,Manuel,45,ES48209597376888441122,TRX_N-00470-84633780,2023-05-21T20:17:11,Vitoria-Gasteiz,Expense,transport,-121.76,-26817.33
buyer_6,Manuel,45,ES48209597376888441122,TRX_N-00471-02056414,2023-06-01T09:18:11,Vitoria-Gasteiz,transfer,Salary,1795.63,-25021.7
buyer_6,Manuel,45,ES48209597376888441122,TRX_N-00472-64669732,2023-06-01T09:18:11,Vitoria-Gasteiz,transfer,Extra Income,179.56,-24842.14
buyer_6,Manuel,45,ES48209597376888441122,TRX_N-00473-88838283,2023-06-01T09:18:11,Vitoria-Gasteiz,transfer,Bonus,1647.79,-23194.35
buyer_6,Manuel,45,ES48209597376888441122,TRX_N-00474-93778662,2023-06-02T14:25:26,Vitoria-Gasteiz,Expense,healthcare,-150.77,-23345.12
buyer_6,Manuel,45,ES48209597376888441122,TRX_N-00475-92663341,2023-06-05T22:17:23,Vitoria-Gasteiz,Housing,Rent,-1329.48,-24674.6
buyer_6,Manuel,45,ES48209597376888441122,TRX_N-00476-59168133,2023-06-05T17:25:22,Vitoria-Gasteiz,Basic services,water,-39.09,-24713.69
buyer_6,Manuel,45,ES48209597376888441122,TRX_N-00477-52191789,2023-06-05T13:24:45,Vitoria-Gasteiz,Basic services,gas,-71.68,-24785.37
buyer_6,Manuel,45,ES48209597376888441122,TRX_N-00478-95513186,2023-06-05T20:35:44,Vitoria-Gasteiz,Basic services,phone,-92.64,-24878.01
buyer_6,Manuel,45,ES48209597376888441122,TRX_N-00479-28717374,2023-06-06T11:05:39,Vitoria-Gasteiz,Basic services,electricity,-45.93,-24923.94
buyer_6,Manuel,45,ES48209597376888441122,TRX_N-00480-18233981,2023-06-06T21:18:10,Vitoria-Gasteiz,Expense,education,-903.18,-25827.12
buyer_6,Manuel,45,ES48209597376888441122,TRX_N-00481-41991104,2023-06-07T22:17:20,Vitoria-Gasteiz,Basic services,electricity,-88.83,-25915.95
buyer_6,Manuel,45,ES48209597376888441122,TRX_N-00482-89044652,2023-06-07T10:42:39,Vitoria-Gasteiz,Basic services,phone,-92.96,-26008.91
buyer_6,Manuel,45,ES48209597376888441122,TRX_N-00483-88694089,2023-06-30T12:37:21,Vitoria-Gasteiz,Expense,gifts,-37.32,-26046.23
buyer_6,Manuel,45,ES48209597376888441122,TRX_N-00484-58006694,2023-07-01T19:37:51,Vitoria-Gasteiz,transfer,Salary,1795.63,-24250.6
buyer_6,Manuel,45,ES48209597376888441122,TRX_N-00485-03014610,2023-07-05T12:07:54,Vitoria-Gasteiz,Housing,Rent,-1329.48,-25580.08
buyer_6,Manuel,45,ES48209597376888441122,TRX_N-00486-53439138,2023-07-05T05:43:46,Vitoria-Gasteiz,Basic services,gas,-82.82,-25662.9
buyer_6,Manuel,45,ES48209597376888441122,TRX_N-00487-38900569,2023-07-05T12:57:57,Vitoria-Gasteiz,Basic services,internet,-66.0,-25728.9
buyer_6,Manuel,45,ES48209597376888441122,TRX_N-00488-45739262,2023-07-06T09:18:03,Vitoria-Gasteiz,Basic services,water,-32.8,-25761.7
buyer_6,Manuel,45,ES48209597376888441122,TRX_N-00489-67497312,2023-07-06T12:29:06,Vitoria-Gasteiz,Basic services,internet,-40.07,-25801.77
buyer_6,Manuel,45,ES48209597376888441122,TRX_N-00490-03695134,2023-07-06T19:06:27,Vitoria-Gasteiz,Expense,food,-541.31,-26343.08
buyer_6,Manuel,45,ES48209597376888441122,TRX_N-00491-79761960,2023-07-06T18:17:20,Vitoria-Gasteiz,Expense,leisure,-127.13,-26470.21
buyer_6,Manuel,45,ES48209597376888441122,TRX_N-00492-32609841,2023-07-07T13:15:40,Vitoria-Gasteiz,Basic services,water,-22.53,-26492.74
buyer_6,Manuel,45,ES48209597376888441122,TRX_N-00493-17838446,2023-07-07T11:36:20,Vitoria-Gasteiz,Basic services,electricity,-82.97,-26575.71
buyer_6,Manuel,45,ES48209597376888441122,TRX_N-00494-38172931,2023-07-07T12:19:21,Vitoria-Gasteiz,Basic services,gas,-49.99,-26625.7
buyer_6,Manuel,45,ES48209597376888441122,TRX_N-00495-26261388,2023-07-07T22:31:37,Vitoria-Gasteiz,Basic services,internet,-51.75,-26677.45
buyer_6,Manuel,45,ES48209597376888441122,TRX_N-00496-18620527,2023-07-07T13:57:24,Vitoria-Gasteiz,Basic services,phone,-21.13,-26698.58
buyer_6,Manuel,45,ES48209597376888441122,TRX_N-00497-12231864,2023-07-16T10:01:40,Vitoria-Gasteiz,Expense,clothing,-107.56,-26806.14
buyer_6,Manuel,45,ES48209597376888441122,TRX_N-00498-50054403,2023-07-27T09:12:19,Arrasate/Mondragon,Expense,food,-734.31,-27540.45
buyer_6,Manuel,45,ES48209597376888441122,TRX_N-00499-15943704,2023-07-27T11:51:58,Vitoria-Gasteiz,Expense,clothing,-203.69,-27744.14
buyer_6,Manuel,45,ES48209597376888441122,TRX_N-00500-41723535,2023-07-28T10:02:25,Vitoria-Gasteiz,Expense,healthcare,-223.45,-27967.59
buyer_6,Manuel,45,ES48209597376888441122,TRX_N-00501-86805255,2023-08-01T20:04:23,Vitoria-Gasteiz,transfer,Salary,1795.63,-26171.96
buyer_6,Manuel,45,ES48209597376888441122,TRX_N-00502-79108432,2023-08-05T18:41:32,Vitoria-Gasteiz,Housing,Rent,-1329.48,-27501.44
buyer_6,Manuel,45,ES48209597376888441122,TRX_N-00503-10945304,2023-08-05T20:30:25,Vitoria-Gasteiz,Basic services,electricity,-132.43,-27633.87
buyer_6,Manuel,45,ES48209597376888441122,TRX_N-00504-06620621,2023-08-05T09:05:11,Vitoria-Gasteiz,Basic services,internet,-70.69,-27704.56
buyer_6,Manuel,45,ES48209597376888441122,TRX_N-00505-99375902,2023-08-05T09:43:54,Vitoria-Gasteiz,Expense,gifts,-314.75,-28019.31
buyer_6,Manuel,45,ES48209597376888441122,TRX_N-00506-68870260,2023-08-06T22:33:29,Vitoria-Gasteiz,Basic services,water,-35.17,-28054.48
buyer_6,Manuel,45,ES48209597376888441122,TRX_N-00507-56055840,2023-08-06T12:46:47,Vitoria-Gasteiz,Basic services,phone,-77.94,-28132.42
buyer_6,Manuel,45,ES48209597376888441122,TRX_N-00508-89611253,2023-08-07T18:02:22,Vitoria-Gasteiz,Basic services,water,-77.28,-28209.7
buyer_6,Manuel,45,ES48209597376888441122,TRX_N-00509-13916820,2023-08-07T11:35:26,Vitoria-Gasteiz,Basic services,gas,-53.79,-28263.49
buyer_6,Manuel,45,ES48209597376888441122,TRX_N-00510-33381412,2023-08-07T09:24:25,Vitoria-Gasteiz,Basic services,internet,-46.81,-28310.3
buyer_6,Manuel,45,ES48209597376888441122,TRX_N-00511-88563736,2023-08-07T12:26:14,Getxo,Expense,food,-568.68,-28878.98
buyer_6,Manuel,45,ES48209597376888441122,TRX_N-00512-90020649,2023-08-19T10:23:12,Getxo,Expense,food,-439.99,-29318.97
buyer_6,Manuel,45,ES48209597376888441122,TRX_N-00513-50955906,2023-08-27T20:46:28,Vitoria-Gasteiz,Expense,clothing,-43.72,-29362.69
buyer_6,Manuel,45,ES48209597376888441122,TRX_N-00514-22656985,2023-09-01T01:37:28,Vitoria-Gasteiz,transfer,Salary,1795.63,-27567.06
buyer_6,Manuel,45,ES48209597376888441122,TRX_N-00515-61310948,2023-09-01T01:37:28,Vitoria-Gasteiz,transfer,Extra Income,179.56,-27387.5
buyer_6,Manuel,45,ES48209597376888441122,TRX_N-00516-41990868,2023-09-03T08:56:30,Vitoria-Gasteiz,Expense,healthcare,-195.44,-27582.94
buyer_6,Manuel,45,ES48209597376888441122,TRX_N-00517-64464809,2023-09-05T10:55:55,Vitoria-Gasteiz,Housing,Rent,-1329.48,-28912.42
buyer_6,Manuel,45,ES48209597376888441122,TRX_N-00518-15010382,2023-09-05T16:05:43,Vitoria-Gasteiz,Basic services,electricity,-82.81,-28995.23
buyer_6,Manuel,45,ES48209597376888441122,TRX_N-00519-99702719,2023-09-05T11:39:26,Vitoria-Gasteiz,Basic services,internet,-56.39,-29051.62
buyer_6,Manuel,45,ES48209597376888441122,TRX_N-00520-03857916,2023-09-07T02:47:53,Vitoria-Gasteiz,Basic services,electricity,-104.11,-29155.73
buyer_6,Manuel,45,ES48209597376888441122,TRX_N-00521-67157114,2023-09-07T15:15:27,Vitoria-Gasteiz,Basic services,phone,-22.25,-29177.98
buyer_6,Manuel,45,ES48209597376888441122,TRX_N-00522-33063829,2023-09-10T11:19:41,Vitoria-Gasteiz,Expense,leisure,-56.75,-29234.73
buyer_6,Manuel,45,ES48209597376888441122,TRX_N-00523-96721507,2023-09-11T10:01:07,Vitoria-Gasteiz,Expense,food,-207.66,-29442.39
buyer_6,Manuel,45,ES48209597376888441122,TRX_N-00524-28217998,2023-09-28T11:02:36,Vitoria-Gasteiz,Expense,transport,-143.49,-29585.88
buyer_6,Manuel,45,ES48209597376888441122,TRX_N-00525-10349969,2023-09-30T20:27:06,Vitoria-Gasteiz,Expense,clothing,-387.22,-29973.1
buyer_6,Manuel,45,ES48209597376888441122,TRX_N-00526-36433182,2023-10-01T16:24:58,Vitoria-Gasteiz,transfer,Salary,1795.63,-28177.47
buyer_6,Manuel,45,ES48209597376888441122,TRX_N-00527-74873152,2023-10-05T13:41:03,Vitoria-Gasteiz,Housing,Rent,-1329.48,-29506.95
buyer_6,Manuel,45,ES48209597376888441122,TRX_N-00528-04029728,2023-10-05T15:30:17,Vitoria-Gasteiz,Basic services,electricity,-108.38,-29615.33
buyer_6,Manuel,45,ES48209597376888441122,TRX_N-00529-05238878,2023-10-05T19:50:43,Vitoria-Gasteiz,Basic services,internet,-67.01,-29682.34
buyer_6,Manuel,45,ES48209597376888441122,TRX_N-00530-03942073,2023-10-07T13:52:54,Vitoria-Gasteiz,Basic services,electricity,-111.52,-29793.86
buyer_6,Manuel,45,ES48209597376888441122,TRX_N-00531-05779064,2023-10-22T20:23:07,Vitoria-Gasteiz,Expense,transport,-81.04,-29874.9
buyer_6,Manuel,45,ES48209597376888441122,TRX_N-00532-35752589,2023-10-24T13:10:54,Vitoria-Gasteiz,Expense,food,-598.15,-30473.05
buyer_6,Manuel,45,ES48209597376888441122,TRX_N-00533-92145026,2023-10-28T09:39:34,Vitoria-Gasteiz,Expense,leisure,-108.22,-30581.27
buyer_6,Manuel,45,ES48209597376888441122,TRX_N-00534-55385288,2023-10-31T22:58:39,Vitoria-Gasteiz,Expense,leisure,-212.4,-30793.67
buyer_6,Manuel,45,ES48209597376888441122,TRX_N-00535-00864641,2023-11-01T09:24:20,Vitoria-Gasteiz,transfer,Salary,1795.63,-28998.04
buyer_6,Manuel,45,ES48209597376888441122,TRX_N-00536-55649861,2023-11-03T02:21:07,Vitoria-Gasteiz,Expense,gifts,-119.52,-29117.56
buyer_6,Manuel,45,ES48209597376888441122,TRX_N-00537-25858161,2023-11-05T19:34:58,Vitoria-Gasteiz,Housing,Rent,-1329.48,-30447.04
buyer_6,Manuel,45,ES48209597376888441122,TRX_N-00538-15280294,2023-11-05T15:13:16,Vitoria-Gasteiz,Basic services,water,-73.04,-30520.08
buyer_6,Manuel,45,ES48209597376888441122,TRX_N-00539-65947659,2023-11-05T09:06:37,Vitoria-Gasteiz,Basic services,electricity,-87.48,-30607.56
buyer_6,Manuel,45,ES48209597376888441122,TRX_N-00540-89122983,2023-11-05T18:53:55,Vitoria-Gasteiz,Basic services,gas,-60.77,-30668.33
buyer_6,Manuel,45,ES48209597376888441122,TRX_N-00541-39960005,2023-11-06T15:48:06,Vitoria-Gasteiz,Basic services,gas,-34.2,-30702.53
buyer_6,Manuel,45,ES48209597376888441122,TRX_N-00542-24795764,2023-11-06T04:50:29,Vitoria-Gasteiz,Basic services,internet,-39.69,-30742.22
buyer_6,Manuel,45,ES48209597376888441122,TRX_N-00543-17495967,2023-11-07T08:39:14,Vitoria-Gasteiz,Basic services,electricity,-99.47,-30841.69
buyer_6,Manuel,45,ES48209597376888441122,TRX_N-00544-87190342,2023-11-07T13:24:18,Vitoria-Gasteiz,Basic services,gas,-64.8,-30906.49
buyer_6,Manuel,45,ES48209597376888441122,TRX_N-00545-60300889,2023-11-29T19:40:28,Vitoria-Gasteiz,Expense,food,-295.88,-31202.37
buyer_6,Manuel,45,ES48209597376888441122,TRX_N-00546-21039816,2023-12-01T14:54:20,Vitoria-Gasteiz,transfer,Salary,1795.63,-29406.74
buyer_6,Manuel,45,ES48209597376888441122,TRX_N-00547-29458623,2023-12-01T14:54:20,Vitoria-Gasteiz,transfer,Extra Income,179.56,-29227.18
buyer_6,Manuel,45,ES48209597376888441122,TRX_N-00548-84604536,2023-12-01T14:54:20,Vitoria-Gasteiz,transfer,Bonus,1668.83,-27558.35
buyer_6,Manuel,45,ES48209597376888441122,TRX_N-00549-26688478,2023-12-03T09:22:35,Elciego,Expense,transport,-175.06,-27733.41
buyer_6,Manuel,45,ES48209597376888441122,TRX_N-00550-07338225,2023-12-05T11:52:15,Vitoria-Gasteiz,Housing,Rent,-1329.48,-29062.89
buyer_6,Manuel,45,ES48209597376888441122,TRX_N-00551-32413473,2023-12-06T11:00:24,Vitoria-Gasteiz,Basic services,water,-10.53,-29073.42
buyer_6,Manuel,45,ES48209597376888441122,TRX_N-00552-86113775,2023-12-07T12:12:49,Vitoria-Gasteiz,Basic services,water,-62.39,-29135.81
buyer_6,Manuel,45,ES48209597376888441122,TRX_N-00553-98056825,2023-12-07T12:32:55,Vitoria-Gasteiz,Basic services,electricity,-37.63,-29173.44
buyer_6,Manuel,45,ES48209597376888441122,TRX_N-00554-38985578,2023-12-07T06:39:11,Vitoria-Gasteiz,Basic services,phone,-59.67,-29233.11
buyer_6,Manuel,45,ES48209597376888441122,TRX_N-00555-25033527,2023-12-09T17:32:23,Salvatierra/Agurain,Expense,repairs,-121.11,-29354.22
buyer_6,Manuel,45,ES48209597376888441122,TRX_N-00556-42369932,2023-12-16T22:51:01,Vitoria-Gasteiz,Expense,transport,-118.56,-29472.78
buyer_6,Manuel,45,ES48209597376888441122,TRX_N-00557-95740668,2023-12-17T18:36:40,Vitoria-Gasteiz,Expense,transport,-71.9,-29544.68
buyer_6,Manuel,45,ES48209597376888441122,TRX_N-00558-31235539,2023-12-21T12:49:30,Vitoria-Gasteiz,Expense,food,-463.45,-30008.13
buyer_6,Manuel,45,ES48209597376888441122,TRX_N-00559-81914681,2023-12-23T09:36:22,Vitoria-Gasteiz,Expense,leisure,-277.29,-30285.42
buyer_6,Manuel,45,ES48209597376888441122,TRX_N-00560-36243251,2023-12-24T11:56:08,Vitoria-Gasteiz,Expense,food,-693.82,-30979.24
buyer_6,Manuel,45,ES48209597376888441122,TRX_N-00561-81943597,2024-01-01T13:14:47,Vitoria-Gasteiz,transfer,Salary,1795.63,-29183.61
buyer_6,Manuel,45,ES48209597376888441122,TRX_N-00562-97394014,2024-01-05T10:16:32,Vitoria-Gasteiz,Housing,Rent,-1329.48,-30513.09
buyer_6,Manuel,45,ES48209597376888441122,TRX_N-00563-69161859,2024-01-06T08:24:11,Vitoria-Gasteiz,Basic services,water,-42.39,-30555.48
buyer_6,Manuel,45,ES48209597376888441122,TRX_N-00564-74274182,2024-01-06T12:28:18,Vitoria-Gasteiz,Basic services,gas,-22.76,-30578.24
buyer_6,Manuel,45,ES48209597376888441122,TRX_N-00565-33909874,2024-01-06T18:26:23,Vitoria-Gasteiz,Basic services,phone,-33.12,-30611.36
buyer_6,Manuel,45,ES48209597376888441122,TRX_N-00566-44115117,2024-01-07T16:00:25,Vitoria-Gasteiz,Basic services,water,-63.42,-30674.78
buyer_6,Manuel,45,ES48209597376888441122,TRX_N-00567-95084314,2024-01-07T14:58:03,Vitoria-Gasteiz,Basic services,gas,-41.0,-30715.78
buyer_6,Manuel,45,ES48209597376888441122,TRX_N-00568-09319184,2024-01-07T10:32:36,Vitoria-Gasteiz,Basic services,internet,-47.65,-30763.43
buyer_6,Manuel,45,ES48209597376888441122,TRX_N-00569-19791954,2024-01-14T15:16:44,Vitoria-Gasteiz,Expense,repairs,-557.3,-31320.73
buyer_6,Manuel,45,ES48209597376888441122,TRX_N-00570-22006444,2024-01-15T09:27:35,Santurtzi,Expense,education,-672.67,-31993.4
buyer_6,Manuel,45,ES48209597376888441122,TRX_N-00571-11346408,2024-01-26T20:44:12,Vitoria-Gasteiz,Expense,appliances,-477.8,-32471.2
buyer_6,Manuel,45,ES48209597376888441122,TRX_N-00572-90159817,2024-01-29T11:16:19,Iruña de Oca,Expense,clothing,-118.32,-32589.52
buyer_6,Manuel,45,ES48209597376888441122,TRX_N-00573-59768588,2024-01-31T22:03:30,Vitoria-Gasteiz,Expense,gifts,-380.89,-32970.41
buyer_6,Manuel,45,ES48209597376888441122,TRX_N-00574-56610482,2024-02-01T18:00:10,Vitoria-Gasteiz,transfer,Salary,1795.63,-31174.78
buyer_6,Manuel,45,ES48209597376888441122,TRX_N-00575-30498752,2024-02-01T18:00:10,Vitoria-Gasteiz,transfer,Extra Income,179.56,-30995.22
buyer_6,Manuel,45,ES48209597376888441122,TRX_N-00576-17606561,2024-02-05T18:47:40,Vitoria-Gasteiz,Housing,Rent,-1329.48,-32324.7
buyer_6,Manuel,45,ES48209597376888441122,TRX_N-00577-86637325,2024-02-06T01:03:27,Vitoria-Gasteiz,Basic services,water,-12.87,-32337.57
buyer_6,Manuel,45,ES48209597376888441122,TRX_N-00578-68403882,2024-02-06T18:32:54,Vitoria-Gasteiz,Basic services,electricity,-86.74,-32424.31
buyer_6,Manuel,45,ES48209597376888441122,TRX_N-00579-61449952,2024-02-07T19:44:00,Vitoria-Gasteiz,Basic services,electricity,-140.48,-32564.79
buyer_6,Manuel,45,ES48209597376888441122,TRX_N-00580-82618549,2024-02-13T11:19:10,Vitoria-Gasteiz,Expense,transport,-182.4,-32747.19
buyer_6,Manuel,45,ES48209597376888441122,TRX_N-00581-98662076,2024-02-18T21:13:03,Vitoria-Gasteiz,Expense,leisure,-188.44,-32935.63
buyer_6,Manuel,45,ES48209597376888441122,TRX_N-00582-45911915,2024-02-27T08:39:32,Vitoria-Gasteiz,Expense,food,-244.33,-33179.96
buyer_6,Manuel,45,ES48209597376888441122,TRX_N-00583-09870608,2024-03-01T19:17:25,Vitoria-Gasteiz,transfer,Salary,1795.63,-31384.33
buyer_6,Manuel,45,ES48209597376888441122,TRX_N-00584-27155250,2024-03-03T21:29:36,Vitoria-Gasteiz,Expense,transport,-170.86,-31555.19
buyer_6,Manuel,45,ES48209597376888441122,TRX_N-00585-77057871,2024-03-05T09:04:33,Vitoria-Gasteiz,Housing,Rent,-1329.48,-32884.67
buyer_6,Manuel,45,ES48209597376888441122,TRX_N-00586-88295415,2024-03-05T19:32:47,Vitoria-Gasteiz,Basic services,water,-74.47,-32959.14
buyer_6,Manuel,45,ES48209597376888441122,TRX_N-00587-74408639,2024-03-05T09:36:13,Vitoria-Gasteiz,Basic services,internet,-60.48,-33019.62
buyer_6,Manuel,45,ES48209597376888441122,TRX_N-00588-50715813,2024-03-05T16:07:46,Vitoria-Gasteiz,Basic services,phone,-92.06,-33111.68
buyer_6,Manuel,45,ES48209597376888441122,TRX_N-00589-53479927,2024-03-06T15:52:35,Vitoria-Gasteiz,Basic services,water,-30.34,-33142.02
buyer_6,Manuel,45,ES48209597376888441122,TRX_N-00590-78627990,2024-03-06T20:03:46,Vitoria-Gasteiz,Expense,transport,-157.29,-33299.31
buyer_6,Manuel,45,ES48209597376888441122,TRX_N-00591-36395475,2024-03-07T20:09:13,Vitoria-Gasteiz,Basic services,water,-16.73,-33316.04
buyer_6,Manuel,45,ES48209597376888441122,TRX_N-00592-54064312,2024-03-07T20:18:43,Vitoria-Gasteiz,Basic services,phone,-54.6,-33370.64
buyer_6,Manuel,45,ES48209597376888441122,TRX_N-00593-16009662,2024-03-10T18:30:00,Vitoria-Gasteiz,Expense,transport,-99.0,-33469.64
buyer_6,Manuel,45,ES48209597376888441122,TRX_N-00594-63362224,2024-03-18T16:52:40,Vitoria-Gasteiz,Expense,transport,-164.98,-33634.62
buyer_6,Manuel,45,ES48209597376888441122,TRX_N-00595-05784337,2024-03-18T20:09:27,Vitoria-Gasteiz,Expense,clothing,-392.29,-34026.91
buyer_6,Manuel,45,ES48209597376888441122,TRX_N-00596-36515523,2024-03-25T16:47:14,Vitoria-Gasteiz,Expense,food,-237.28,-34264.19
buyer_6,Manuel,45,ES48209597376888441122,TRX_N-00597-92672998,2024-04-01T19:29:06,Vitoria-Gasteiz,transfer,Salary,1795.63,-32468.56
buyer_6,Manuel,45,ES48209597376888441122,TRX_N-00598-00851836,2024-04-02T12:19:13,Labastida/Bastida,Expense,gifts,-431.95,-32900.51
buyer_6,Manuel,45,ES48209597376888441122,TRX_N-00599-45445012,2024-04-05T00:54:22,Vitoria-Gasteiz,Housing,Rent,-1329.48,-34229.99
buyer_6,Manuel,45,ES48209597376888441122,TRX_N-00600-87491930,2024-04-05T15:33:38,Vitoria-Gasteiz,Basic services,water,-24.78,-34254.77
buyer_6,Manuel,45,ES48209597376888441122,TRX_N-00601-73092123,2024-04-05T17:38:50,Vitoria-Gasteiz,Basic services,electricity,-112.55,-34367.32
buyer_6,Manuel,45,ES48209597376888441122,TRX_N-00602-23105539,2024-04-05T19:49:21,Vitoria-Gasteiz,Basic services,gas,-52.56,-34419.88
buyer_6,Manuel,45,ES48209597376888441122,TRX_N-00603-67060506,2024-04-05T19:31:36,Vitoria-Gasteiz,Basic services,phone,-40.57,-34460.45
buyer_6,Manuel,45,ES48209597376888441122,TRX_N-00604-26795230,2024-04-06T09:02:00,Vitoria-Gasteiz,Basic services,water,-33.22,-34493.67
buyer_6,Manuel,45,ES48209597376888441122,TRX_N-00605-04630831,2024-04-07T19:02:12,Vitoria-Gasteiz,Basic services,electricity,-89.41,-34583.08
buyer_6,Manuel,45,ES48209597376888441122,TRX_N-00606-72795261,2024-04-26T03:18:28,Lasarte-Oria,Expense,healthcare,-364.83,-34947.91
buyer_6,Manuel,45,ES48209597376888441122,TRX_N-00607-31515734,2024-04-30T12:56:17,Vitoria-Gasteiz,Expense,transport,-101.81,-35049.72
buyer_6,Manuel,45,ES48209597376888441122,TRX_N-00608-04053582,2024-05-01T08:12:33,Vitoria-Gasteiz,transfer,Salary,1795.63,-33254.09
buyer_6,Manuel,45,ES48209597376888441122,TRX_N-00609-62771011,2024-05-01T08:12:33,Vitoria-Gasteiz,transfer,Extra Income,179.56,-33074.53
buyer_6,Manuel,45,ES48209597376888441122,TRX_N-00610-59384971,2024-05-05T12:27:14,Vitoria-Gasteiz,Housing,Rent,-1329.48,-34404.01
buyer_6,Manuel,45,ES48209597376888441122,TRX_N-00611-28349064,2024-05-05T15:40:02,Vitoria-Gasteiz,Basic services,water,-57.33,-34461.34
buyer_6,Manuel,45,ES48209597376888441122,TRX_N-00612-16304104,2024-05-06T16:29:38,Vitoria-Gasteiz,Basic services,electricity,-122.38,-34583.72
buyer_6,Manuel,45,ES48209597376888441122,TRX_N-00613-79945434,2024-05-06T15:55:03,Vitoria-Gasteiz,Basic services,gas,-96.62,-34680.34
buyer_6,Manuel,45,ES48209597376888441122,TRX_N-00614-53724873,2024-05-06T14:25:44,Vitoria-Gasteiz,Basic services,phone,-91.51,-34771.85
buyer_6,Manuel,45,ES48209597376888441122,TRX_N-00615-67722861,2024-05-06T18:40:48,Vitoria-Gasteiz,Expense,leisure,-160.14,-34931.99
buyer_6,Manuel,45,ES48209597376888441122,TRX_N-00616-81630275,2024-05-07T02:16:42,Vitoria-Gasteiz,Basic services,internet,-49.14,-34981.13
buyer_6,Manuel,45,ES48209597376888441122,TRX_N-00617-90199654,2024-05-22T20:08:48,Vitoria-Gasteiz,Expense,travel,-2588.97,-37570.1
buyer_6,Manuel,45,ES48209597376888441122,TRX_N-00618-88870085,2024-05-28T18:44:58,Vitoria-Gasteiz,Expense,education,-811.97,-38382.07
buyer_6,Manuel,45,ES48209597376888441122,TRX_N-00619-29496842,2024-06-01T08:21:16,Vitoria-Gasteiz,transfer,Salary,1795.63,-36586.44
buyer_6,Manuel,45,ES48209597376888441122,TRX_N-00620-48001168,2024-06-01T08:21:16,Vitoria-Gasteiz,transfer,Bonus,1670.44,-34916.0
buyer_6,Manuel,45,ES48209597376888441122,TRX_N-00621-06144332,2024-06-05T21:02:41,Vitoria-Gasteiz,Housing,Rent,-1329.48,-36245.48
buyer_6,Manuel,45,ES48209597376888441122,TRX_N-00622-43909926,2024-06-05T10:37:02,Vitoria-Gasteiz,Basic services,gas,-73.26,-36318.74
buyer_6,Manuel,45,ES48209597376888441122,TRX_N-00623-33172084,2024-06-06T01:55:08,Vitoria-Gasteiz,Basic services,water,-21.46,-36340.2
buyer_6,Manuel,45,ES48209597376888441122,TRX_N-00624-73453062,2024-06-06T23:34:57,Vitoria-Gasteiz,Basic services,internet,-65.9,-36406.1
buyer_6,Manuel,45,ES48209597376888441122,TRX_N-00625-81050970,2024-06-06T11:07:58,Vitoria-Gasteiz,Basic services,phone,-24.11,-36430.21
buyer_6,Manuel,45,ES48209597376888441122,TRX_N-00626-83676698,2024-06-07T09:01:20,Vitoria-Gasteiz,Basic services,internet,-51.52,-36481.73
buyer_6,Manuel,45,ES48209597376888441122,TRX_N-00627-43277502,2024-06-13T23:25:22,Vitoria-Gasteiz,Expense,food,-205.62,-36687.35
buyer_6,Manuel,45,ES48209597376888441122,TRX_N-00628-41848458,2024-06-20T18:00:59,Vitoria-Gasteiz,Expense,transport,-160.4,-36847.75
buyer_6,Manuel,45,ES48209597376888441122,TRX_N-00629-91274611,2024-06-22T18:45:56,Vitoria-Gasteiz,Expense,food,-653.46,-37501.21
buyer_6,Manuel,45,ES48209597376888441122,TRX_N-00630-51879534,2024-07-01T10:02:18,Vitoria-Gasteiz,transfer,Salary,1795.63,-35705.58
buyer_6,Manuel,45,ES48209597376888441122,TRX_N-00631-01252711,2024-07-03T08:49:16,Vitoria-Gasteiz,Expense,leisure,-113.98,-35819.56
buyer_6,Manuel,45,ES48209597376888441122,TRX_N-00632-05134935,2024-07-05T15:08:55,Vitoria-Gasteiz,Housing,Rent,-1329.48,-37149.04
buyer_6,Manuel,45,ES48209597376888441122,TRX_N-00633-28810882,2024-07-05T08:15:55,Vitoria-Gasteiz,Basic services,electricity,-97.93,-37246.97
buyer_6,Manuel,45,ES48209597376888441122,TRX_N-00634-37363436,2024-07-05T14:13:27,Mungia,Expense,leisure,-49.57,-37296.54
buyer_6,Manuel,45,ES48209597376888441122,TRX_N-00635-18975011,2024-07-06T12:47:51,Vitoria-Gasteiz,Basic services,water,-24.2,-37320.74
buyer_6,Manuel,45,ES48209597376888441122,TRX_N-00636-38728732,2024-07-06T11:06:48,Vitoria-Gasteiz,Basic services,gas,-18.48,-37339.22
buyer_6,Manuel,45,ES48209597376888441122,TRX_N-00637-03411110,2024-07-07T13:28:00,Vitoria-Gasteiz,Basic services,electricity,-105.75,-37444.97
buyer_6,Manuel,45,ES48209597376888441122,TRX_N-00638-47739340,2024-07-07T22:43:56,Vitoria-Gasteiz,Basic services,gas,-65.84,-37510.81
buyer_6,Manuel,45,ES48209597376888441122,TRX_N-00639-48362424,2024-07-18T09:26:30,Vitoria-Gasteiz,Expense,healthcare,-81.0,-37591.81
buyer_6,Manuel,45,ES48209597376888441122,TRX_N-00640-87501744,2024-08-01T16:21:32,Vitoria-Gasteiz,transfer,Salary,1795.63,-35796.18
buyer_6,Manuel,45,ES48209597376888441122,TRX_N-00641-66884634,2024-08-01T16:21:32,Vitoria-Gasteiz,transfer,Extra Income,179.56,-35616.62
buyer_6,Manuel,45,ES48209597376888441122,TRX_N-00642-18078219,2024-08-05T15:51:07,Vitoria-Gasteiz,Housing,Rent,-1329.48,-36946.1
buyer_6,Manuel,45,ES48209597376888441122,TRX_N-00643-00362589,2024-08-05T19:27:49,Vitoria-Gasteiz,Basic services,electricity,-83.93,-37030.03
buyer_6,Manuel,45,ES48209597376888441122,TRX_N-00644-89448407,2024-08-05T12:21:06,Vitoria-Gasteiz,Basic services,internet,-45.08,-37075.11
buyer_6,Manuel,45,ES48209597376888441122,TRX_N-00645-57885118,2024-08-06T10:59:29,Vitoria-Gasteiz,Basic services,electricity,-122.28,-37197.39
buyer_6,Manuel,45,ES48209597376888441122,TRX_N-00646-03863385,2024-08-07T12:31:48,Vitoria-Gasteiz,Basic services,internet,-39.25,-37236.64
buyer_6,Manuel,45,ES48209597376888441122,TRX_N-00647-31415461,2024-08-07T16:56:21,Vitoria-Gasteiz,Expense,food,-791.91,-38028.55
buyer_6,Manuel,45,ES48209597376888441122,TRX_N-00648-46351500,2024-08-14T13:32:38,Leioa,Expense,transport,-135.66,-38164.21
buyer_6,Manuel,45,ES48209597376888441122,TRX_N-00649-15589697,2024-08-18T23:16:58,Donostia,Expense,food,-772.97,-38937.18
buyer_6,Manuel,45,ES48209597376888441122,TRX_N-00650-01291732,2024-08-22T09:51:36,Vitoria-Gasteiz,Expense,healthcare,-389.87,-39327.05
buyer_6,Manuel,45,ES48209597376888441122,TRX_N-00651-67365276,2024-08-24T08:17:08,Vitoria-Gasteiz,Expense,food,-316.05,-39643.1
buyer_6,Manuel,45,ES48209597376888441122,TRX_N-00652-32458012,2024-09-01T16:31:07,Vitoria-Gasteiz,transfer,Salary,1795.63,-37847.47
buyer_6,Manuel,45,ES48209597376888441122,TRX_N-00653-94257465,2024-09-05T21:04:02,Vitoria-Gasteiz,Housing,Rent,-1329.48,-39176.95
buyer_6,Manuel,45,ES48209597376888441122,TRX_N-00654-56472689,2024-09-05T20:46:09,Vitoria-Gasteiz,Expense,leisure,-68.95,-39245.9
buyer_6,Manuel,45,ES48209597376888441122,TRX_N-00655-96162829,2024-09-07T13:00:59,Vitoria-Gasteiz,Basic services,water,-12.31,-39258.21
buyer_6,Manuel,45,ES48209597376888441122,TRX_N-00656-22038673,2024-09-07T14:30:09,Vitoria-Gasteiz,Basic services,gas,-95.56,-39353.77
buyer_6,Manuel,45,ES48209597376888441122,TRX_N-00657-41421724,2024-09-20T17:37:59,Vitoria-Gasteiz,Expense,leisure,-21.07,-39374.84
buyer_6,Manuel,45,ES48209597376888441122,TRX_N-00658-68588923,2024-10-01T15:23:25,Vitoria-Gasteiz,transfer,Salary,1795.63,-37579.21
buyer_6,Manuel,45,ES48209597376888441122,TRX_N-00659-59888767,2024-10-01T16:30:46,Vitoria-Gasteiz,Expense,leisure,-28.06,-37607.27
buyer_6,Manuel,45,ES48209597376888441122,TRX_N-00660-14991263,2024-10-04T08:13:46,Vitoria-Gasteiz,Expense,clothing,-325.86,-37933.13
buyer_6,Manuel,45,ES48209597376888441122,TRX_N-00661-66618796,2024-10-05T17:07:42,Vitoria-Gasteiz,Housing,Rent,-1329.48,-39262.61
buyer_6,Manuel,45,ES48209597376888441122,TRX_N-00662-93965462,2024-10-06T17:13:43,Vitoria-Gasteiz,Basic services,electricity,-21.75,-39284.36
buyer_6,Manuel,45,ES48209597376888441122,TRX_N-00663-47064244,2024-10-06T08:22:45,Vitoria-Gasteiz,Expense,clothing,-271.76,-39556.12
buyer_6,Manuel,45,ES48209597376888441122,TRX_N-00664-70313092,2024-10-07T17:11:10,Vitoria-Gasteiz,Basic services,electricity,-118.22,-39674.34
buyer_6,Manuel,45,ES48209597376888441122,TRX_N-00665-99440852,2024-10-07T13:57:15,Vitoria-Gasteiz,Basic services,gas,-23.32,-39697.66
buyer_7,María,56,ES04209572462335411521,TRX_N-00001-37799419,2020-01-01T02:28:43,Portugalete,transfer,Salary,2932.42,7272.84
buyer_7,María,56,ES04209572462335411521,TRX_N-00002-96404097,2020-01-01T02:28:43,Portugalete,transfer,Partner Salary,3319.09,10591.93
buyer_7,María,56,ES04209572462335411521,TRX_N-00003-12790271,2020-01-05T12:55:55,Portugalete,Housing,Mortgage,-1096.11,9495.82
buyer_7,María,56,ES04209572462335411521,TRX_N-00004-92739021,2020-01-05T09:39:20,Portugalete,Basic services,water,-32.9,9462.92
buyer_7,María,56,ES04209572462335411521,TRX_N-00005-11461053,2020-01-05T14:52:40,Portugalete,Basic services,electricity,-38.51,9424.41
buyer_7,María,56,ES04209572462335411521,TRX_N-00006-51949162,2020-01-06T09:59:53,Portugalete,Basic services,phone,-72.76,9351.65
buyer_7,María,56,ES04209572462335411521,TRX_N-00007-29410619,2020-01-07T09:34:03,Portugalete,Basic services,electricity,-103.01,9248.64
buyer_7,María,56,ES04209572462335411521,TRX_N-00008-64705637,2020-01-07T12:55:44,Labastida/Bastida,Expense,transport,-45.2,9203.44
buyer_7,María,56,ES04209572462335411521,TRX_N-00009-54359758,2020-01-18T12:18:15,Portugalete,Expense,leisure,-262.71,8940.73
buyer_7,María,56,ES04209572462335411521,TRX_N-00010-97722577,2020-01-29T17:22:36,Portugalete,Expense,gifts,-448.07,8492.66
buyer_7,María,56,ES04209572462335411521,TRX_N-00011-74631624,2020-02-01T00:36:24,Portugalete,transfer,Salary,2932.42,11425.08
buyer_7,María,56,ES04209572462335411521,TRX_N-00012-54545797,2020-02-01T00:36:24,Portugalete,transfer,Partner Salary,3319.09,14744.17
buyer_7,María,56,ES04209572462335411521,TRX_N-00013-22338465,2020-02-01T00:36:24,Portugalete,transfer,Extra Income,293.24,15037.41
buyer_7,María,56,ES04209572462335411521,TRX_N-00014-78583691,2020-02-05T11:25:12,Portugalete,Housing,Mortgage,-1096.11,13941.3
buyer_7,María,56,ES04209572462335411521,TRX_N-00015-57536535,2020-02-06T12:40:17,Portugalete,Basic services,water,-12.6,13928.7
buyer_7,María,56,ES04209572462335411521,TRX_N-00016-13504953,2020-02-07T22:24:42,Portugalete,Basic services,phone,-39.49,13889.21
buyer_7,María,56,ES04209572462335411521,TRX_N-00017-25601746,2020-02-28T19:01:23,Portugalete,Expense,transport,-87.82,13801.39
buyer_7,María,56,ES04209572462335411521,TRX_N-00018-84759295,2020-03-01T18:18:56,Portugalete,transfer,Salary,2932.42,16733.81
buyer_7,María,56,ES04209572462335411521,TRX_N-00019-17365164,2020-03-01T18:18:56,Portugalete,transfer,Partner Salary,3319.09,20052.9
buyer_7,María,56,ES04209572462335411521,TRX_N-00020-26813922,2020-03-05T08:37:23,Portugalete,Housing,Mortgage,-1096.11,18956.79
buyer_7,María,56,ES04209572462335411521,TRX_N-00021-59309088,2020-03-05T22:33:07,Portugalete,Basic services,gas,-57.95,18898.84
buyer_7,María,56,ES04209572462335411521,TRX_N-00022-24107473,2020-03-05T18:56:41,Hernani,Expense,transport,-124.37,18774.47
buyer_7,María,56,ES04209572462335411521,TRX_N-00023-64857596,2020-03-06T08:55:42,Portugalete,Basic services,water,-70.85,18703.62
buyer_7,María,56,ES04209572462335411521,TRX_N-00024-56420205,2020-03-07T13:40:02,Portugalete,Basic services,water,-47.56,18656.06
buyer_7,María,56,ES04209572462335411521,TRX_N-00025-64211321,2020-03-07T12:36:54,Portugalete,Basic services,electricity,-60.93,18595.13
buyer_7,María,56,ES04209572462335411521,TRX_N-00026-15872307,2020-03-12T19:18:11,Portugalete,Expense,food,-425.69,18169.44
buyer_7,María,56,ES04209572462335411521,TRX_N-00027-01000229,2020-03-16T05:32:53,Portugalete,Expense,healthcare,-390.0,17779.44
buyer_7,María,56,ES04209572462335411521,TRX_N-00028-85887750,2020-04-01T17:42:07,Portugalete,transfer,Salary,2932.42,20711.86
buyer_7,María,56,ES04209572462335411521,TRX_N-00029-73134485,2020-04-01T17:42:07,Portugalete,transfer,Partner Salary,3319.09,24030.95
buyer_7,María,56,ES04209572462335411521,TRX_N-00030-42147853,2020-04-05T00:07:03,Portugalete,Housing,Mortgage,-1096.11,22934.84
buyer_7,María,56,ES04209572462335411521,TRX_N-00031-87779648,2020-04-05T10:04:20,Portugalete,Basic services,gas,-42.76,22892.08
buyer_7,María,56,ES04209572462335411521,TRX_N-00032-74803401,2020-04-05T03:08:07,Portugalete,Basic services,internet,-47.2,22844.88
buyer_7,María,56,ES04209572462335411521,TRX_N-00033-83962162,2020-04-05T14:56:46,Portugalete,Basic services,phone,-97.58,22747.3
buyer_7,María,56,ES04209572462335411521,TRX_N-00034-24849668,2020-04-06T15:46:39,Portugalete,Basic services,phone,-33.47,22713.83
buyer_7,María,56,ES04209572462335411521,TRX_N-00035-66024765,2020-04-07T19:30:23,Portugalete,Basic services,electricity,-130.3,22583.53
buyer_7,María,56,ES04209572462335411521,TRX_N-00036-10845394,2020-04-16T23:55:55,Portugalete,Expense,transport,-28.09,22555.44
buyer_7,María,56,ES04209572462335411521,TRX_N-00037-42232182,2020-04-17T09:04:38,Portugalete,Expense,transport,-57.74,22497.7
buyer_7,María,56,ES04209572462335411521,TRX_N-00038-93414412,2020-04-21T11:24:14,Portugalete,Expense,transport,-36.06,22461.64
buyer_7,María,56,ES04209572462335411521,TRX_N-00039-94075210,2020-04-24T10:03:38,Portugalete,Expense,transport,-35.65,22425.99
buyer_7,María,56,ES04209572462335411521,TRX_N-00040-89321006,2020-04-25T19:57:03,Portugalete,Expense,appliances,-1714.4,20711.59
buyer_7,María,56,ES04209572462335411521,TRX_N-00041-80049848,2020-05-01T22:34:58,Portugalete,transfer,Salary,2932.42,23644.01
buyer_7,María,56,ES04209572462335411521,TRX_N-00042-46554959,2020-05-01T22:34:58,Portugalete,transfer,Partner Salary,3319.09,26963.1
buyer_7,María,56,ES04209572462335411521,TRX_N-00043-55125233,2020-05-01T22:34:58,Portugalete,transfer,Extra Income,293.24,27256.34
buyer_7,María,56,ES04209572462335411521,TRX_N-00044-23313757,2020-05-05T08:25:00,Portugalete,Housing,Mortgage,-1096.11,26160.23
buyer_7,María,56,ES04209572462335411521,TRX_N-00045-75000497,2020-05-05T21:27:17,Portugalete,Basic services,gas,-61.23,26099.0
buyer_7,María,56,ES04209572462335411521,TRX_N-00046-21652363,2020-05-06T19:57:53,Portugalete,Basic services,electricity,-147.9,25951.1
buyer_7,María,56,ES04209572462335411521,TRX_N-00047-14227674,2020-05-06T12:19:21,Portugalete,Basic services,internet,-44.05,25907.05
buyer_7,María,56,ES04209572462335411521,TRX_N-00048-59583678,2020-05-06T16:06:07,Portugalete,Basic services,phone,-29.38,25877.67
buyer_7,María,56,ES04209572462335411521,TRX_N-00049-07549096,2020-05-06T20:14:14,Portugalete,Expense,leisure,-286.13,25591.54
buyer_7,María,56,ES04209572462335411521,TRX_N-00050-45375759,2020-05-07T22:38:18,Portugalete,Basic services,phone,-89.77,25501.77
buyer_7,María,56,ES04209572462335411521,TRX_N-00051-27805648,2020-05-13T19:25:52,Portugalete,Expense,leisure,-71.41,25430.36
buyer_7,María,56,ES04209572462335411521,TRX_N-00052-27893599,2020-06-01T17:58:17,Portugalete,transfer,Salary,2932.42,28362.78
buyer_7,María,56,ES04209572462335411521,TRX_N-00053-65819799,2020-06-01T17:58:17,Portugalete,transfer,Partner Salary,3319.09,31681.87
buyer_7,María,56,ES04209572462335411521,TRX_N-00054-98868412,2020-06-01T17:58:17,Portugalete,transfer,Bonus,2829.48,34511.35
buyer_7,María,56,ES04209572462335411521,TRX_N-00055-93416299,2020-06-03T08:27:42,Portugalete,Expense,food,-276.07,34235.28
buyer_7,María,56,ES04209572462335411521,TRX_N-00056-08702820,2020-06-05T17:51:37,Portugalete,Housing,Mortgage,-1096.11,33139.17
buyer_7,María,56,ES04209572462335411521,TRX_N-00057-14934841,2020-06-05T03:54:38,Portugalete,Basic services,water,-73.37,33065.8
buyer_7,María,56,ES04209572462335411521,TRX_N-00058-59734139,2020-06-06T08:56:33,Portugalete,Basic services,water,-21.84,33043.96
buyer_7,María,56,ES04209572462335411521,TRX_N-00059-34334679,2020-06-06T18:22:33,Portugalete,Basic services,gas,-54.72,32989.24
buyer_7,María,56,ES04209572462335411521,TRX_N-00060-68215599,2020-06-06T08:11:31,Portugalete,Basic services,phone,-72.24,32917.0
buyer_7,María,56,ES04209572462335411521,TRX_N-00061-01803344,2020-06-07T17:06:02,Portugalete,Basic services,water,-74.72,32842.28
buyer_7,María,56,ES04209572462335411521,TRX_N-00062-93620184,2020-06-07T20:12:42,Portugalete,Basic services,internet,-64.72,32777.56
buyer_7,María,56,ES04209572462335411521,TRX_N-00063-60021853,2020-06-07T13:54:35,Portugalete,Basic services,phone,-96.07,32681.49
buyer_7,María,56,ES04209572462335411521,TRX_N-00064-72916939,2020-06-13T10:20:37,Portugalete,Expense,transport,-169.17,32512.32
buyer_7,María,56,ES04209572462335411521,TRX_N-00065-78280909,2020-06-14T18:20:14,Portugalete,Expense,transport,-61.71,32450.61
buyer_7,María,56,ES04209572462335411521,TRX_N-00066-31883507,2020-06-19T00:25:25,Portugalete,Expense,education,-513.01,31937.6
buyer_7,María,56,ES04209572462335411521,TRX_N-00067-50827600,2020-06-23T11:48:06,Portugalete,Expense,leisure,-30.71,31906.89
buyer_7,María,56,ES04209572462335411521,TRX_N-00068-69602413,2020-06-26T20:21:46,Portugalete,Expense,leisure,-45.76,31861.13
buyer_7,María,56,ES04209572462335411521,TRX_N-00069-39546911,2020-06-30T13:10:14,Portugalete,Expense,food,-434.88,31426.25
buyer_7,María,56,ES04209572462335411521,TRX_N-00070-47949335,2020-07-01T10:27:13,Portugalete,transfer,Salary,2932.42,34358.67
buyer_7,María,56,ES04209572462335411521,TRX_N-00071-77910432,2020-07-01T10:27:13,Portugalete,transfer,Partner Salary,3319.09,37677.76
buyer_7,María,56,ES04209572462335411521,TRX_N-00072-19087624,2020-07-01T10:27:13,Portugalete,transfer,Extra Income,293.24,37971.0
buyer_7,María,56,ES04209572462335411521,TRX_N-00073-79508945,2020-07-05T10:47:05,Portugalete,Housing,Mortgage,-1096.11,36874.89
buyer_7,María,56,ES04209572462335411521,TRX_N-00074-86168953,2020-07-05T20:11:31,Portugalete,Basic services,electricity,-49.87,36825.02
buyer_7,María,56,ES04209572462335411521,TRX_N-00075-25473626,2020-07-06T09:15:28,Portugalete,Basic services,water,-19.98,36805.04
buyer_7,María,56,ES04209572462335411521,TRX_N-00076-28032182,2020-07-06T19:35:56,Portugalete,Basic services,electricity,-67.99,36737.05
buyer_7,María,56,ES04209572462335411521,TRX_N-00077-19709287,2020-07-06T18:33:00,Portugalete,Basic services,phone,-47.03,36690.02
buyer_7,María,56,ES04209572462335411521,TRX_N-00078-18617574,2020-07-06T11:04:32,Portugalete,Expense,food,-338.15,36351.87
buyer_7,María,56,ES04209572462335411521,TRX_N-00079-91387658,2020-07-07T08:59:44,Portugalete,Basic services,water,-70.55,36281.32
buyer_7,María,56,ES04209572462335411521,TRX_N-00080-74345541,2020-07-07T12:48:13,Portugalete,Basic services,gas,-59.93,36221.39
buyer_7,María,56,ES04209572462335411521,TRX_N-00081-63950263,2020-07-07T17:41:56,Portugalete,Basic services,phone,-64.68,36156.71
buyer_7,María,56,ES04209572462335411521,TRX_N-00082-17491172,2020-07-20T18:14:15,Portugalete,Expense,food,-448.94,35707.77
buyer_7,María,56,ES04209572462335411521,TRX_N-00083-76310086,2020-07-25T09:31:10,Portugalete,Expense,education,-446.66,35261.11
buyer_7,María,56,ES04209572462335411521,TRX_N-00084-49058089,2020-08-01T19:44:21,Portugalete,transfer,Salary,2932.42,38193.53
buyer_7,María,56,ES04209572462335411521,TRX_N-00085-24125357,2020-08-01T19:44:21,Portugalete,transfer,Partner Salary,3319.09,41512.62
buyer_7,María,56,ES04209572462335411521,TRX_N-00086-97964346,2020-08-05T03:13:57,Portugalete,Housing,Mortgage,-1096.11,40416.51
buyer_7,María,56,ES04209572462335411521,TRX_N-00087-92512784,2020-08-05T10:07:29,Portugalete,Basic services,water,-13.9,40402.61
buyer_7,María,56,ES04209572462335411521,TRX_N-00088-26145836,2020-08-05T11:29:19,Portugalete,Basic services,gas,-22.42,40380.19
buyer_7,María,56,ES04209572462335411521,TRX_N-00089-48322709,2020-08-06T16:27:10,Portugalete,Basic services,water,-25.78,40354.41
buyer_7,María,56,ES04209572462335411521,TRX_N-00090-68606510,2020-08-06T21:50:04,Portugalete,Basic services,electricity,-69.23,40285.18
buyer_7,María,56,ES04209572462335411521,TRX_N-00091-36274350,2020-08-06T20:52:50,Portugalete,Basic services,gas,-71.64,40213.54
buyer_7,María,56,ES04209572462335411521,TRX_N-00092-56661808,2020-08-11T09:04:18,Barakaldo,Expense,food,-416.49,39797.05
buyer_7,María,56,ES04209572462335411521,TRX_N-00093-68917582,2020-08-28T16:41:58,Portugalete,Expense,leisure,-64.68,39732.37
buyer_7,María,56,ES04209572462335411521,TRX_N-00094-92526841,2020-09-01T18:07:34,Portugalete,transfer,Salary,2932.42,42664.79
buyer_7,María,56,ES04209572462335411521,TRX_N-00095-07660475,2020-09-01T18:07:34,Portugalete,transfer,Partner Salary,3319.09,45983.88
buyer_7,María,56,ES04209572462335411521,TRX_N-00096-91888801,2020-09-01T18:07:34,Portugalete,transfer,Extra Income,293.24,46277.12
buyer_7,María,56,ES04209572462335411521,TRX_N-00097-86508544,2020-09-05T10:38:35,Portugalete,Housing,Mortgage,-1096.11,45181.01
buyer_7,María,56,ES04209572462335411521,TRX_N-00098-14755369,2020-09-06T07:43:47,Portugalete,Basic services,phone,-80.49,45100.52
buyer_7,María,56,ES04209572462335411521,TRX_N-00099-96708858,2020-09-07T10:56:49,Portugalete,Basic services,electricity,-100.88,44999.64
buyer_7,María,56,ES04209572462335411521,TRX_N-00100-32538166,2020-09-07T00:42:34,Portugalete,Basic services,phone,-92.15,44907.49
buyer_7,María,56,ES04209572462335411521,TRX_N-00101-08246947,2020-09-07T17:19:03,Errenteria,Expense,leisure,-259.35,44648.14
buyer_7,María,56,ES04209572462335411521,TRX_N-00102-95604890,2020-09-23T12:12:26,Portugalete,Expense,leisure,-55.11,44593.03
buyer_7,María,56,ES04209572462335411521,TRX_N-00103-62743451,2020-09-29T15:04:18,Portugalete,Expense,leisure,-75.34,44517.69
buyer_7,María,56,ES04209572462335411521,TRX_N-00104-56303615,2020-10-01T12:37:45,Portugalete,transfer,Salary,2932.42,47450.11
buyer_7,María,56,ES04209572462335411521,TRX_N-00105-72680667,2020-10-01T12:37:45,Portugalete,transfer,Partner Salary,3319.09,50769.2
buyer_7,María,56,ES04209572462335411521,TRX_N-00106-34694950,2020-10-01T09:58:26,Portugalete,Expense,leisure,-232.49,50536.71
buyer_7,María,56,ES04209572462335411521,TRX_N-00107-31654437,2020-10-05T16:01:43,Portugalete,Housing,Mortgage,-1096.11,49440.6
buyer_7,María,56,ES04209572462335411521,TRX_N-00108-36832541,2020-10-05T19:51:52,Portugalete,Basic services,internet,-44.51,49396.09
buyer_7,María,56,ES04209572462335411521,TRX_N-00109-27595746,2020-10-07T09:57:40,Portugalete,Basic services,internet,-70.63,49325.46
buyer_7,María,56,ES04209572462335411521,TRX_N-00110-94773484,2020-10-23T18:31:15,Portugalete,Expense,leisure,-112.67,49212.79
buyer_7,María,56,ES04209572462335411521,TRX_N-00111-62574849,2020-11-01T02:44:02,Portugalete,transfer,Salary,2932.42,52145.21
buyer_7,María,56,ES04209572462335411521,TRX_N-00112-77609786,2020-11-01T02:44:02,Portugalete,transfer,Partner Salary,3319.09,55464.3
buyer_7,María,56,ES04209572462335411521,TRX_N-00113-73578497,2020-11-02T15:41:48,Portugalete,Expense,food,-642.93,54821.37
buyer_7,María,56,ES04209572462335411521,TRX_N-00114-35484007,2020-11-02T21:06:07,Portugalete,Expense,transport,-40.16,54781.21
buyer_7,María,56,ES04209572462335411521,TRX_N-00115-52004121,2020-11-04T16:49:39,Portugalete,Expense,leisure,-114.31,54666.9
buyer_7,María,56,ES04209572462335411521,TRX_N-00116-27931922,2020-11-05T10:37:09,Portugalete,Housing,Mortgage,-1096.11,53570.79
buyer_7,María,56,ES04209572462335411521,TRX_N-00117-86701512,2020-11-05T08:40:25,Portugalete,Basic services,water,-18.12,53552.67
buyer_7,María,56,ES04209572462335411521,TRX_N-00118-63683162,2020-11-05T18:46:24,Portugalete,Basic services,gas,-96.57,53456.1
buyer_7,María,56,ES04209572462335411521,TRX_N-00119-57549180,2020-11-05T09:01:11,Portugalete,Basic services,internet,-67.84,53388.26
buyer_7,María,56,ES04209572462335411521,TRX_N-00120-96211693,2020-11-06T16:25:05,Portugalete,Basic services,electricity,-125.96,53262.3
buyer_7,María,56,ES04209572462335411521,TRX_N-00121-89126010,2020-11-06T20:19:26,Portugalete,Basic services,internet,-64.18,53198.12
buyer_7,María,56,ES04209572462335411521,TRX_N-00122-64457759,2020-11-07T19:51:56,Portugalete,Basic services,electricity,-105.23,53092.89
buyer_7,María,56,ES04209572462335411521,TRX_N-00123-05498537,2020-11-15T14:34:33,Portugalete,Expense,transport,-112.08,52980.81
buyer_7,María,56,ES04209572462335411521,TRX_N-00124-97361213,2020-11-23T16:36:13,Portugalete,Expense,education,-230.59,52750.22
buyer_7,María,56,ES04209572462335411521,TRX_N-00125-07604922,2020-11-29T16:08:56,Portugalete,Expense,food,-307.3,52442.92
buyer_7,María,56,ES04209572462335411521,TRX_N-00126-44178666,2020-12-01T09:28:53,Portugalete,transfer,Salary,2932.42,55375.34
buyer_7,María,56,ES04209572462335411521,TRX_N-00127-82489604,2020-12-01T09:28:53,Portugalete,transfer,Partner Salary,3319.09,58694.43
buyer_7,María,56,ES04209572462335411521,TRX_N-00128-92407747,2020-12-01T09:28:53,Portugalete,transfer,Extra Income,293.24,58987.67
buyer_7,María,56,ES04209572462335411521,TRX_N-00129-62104743,2020-12-01T09:28:53,Portugalete,transfer,Bonus,2823.4,61811.07
buyer_7,María,56,ES04209572462335411521,TRX_N-00130-05838526,2020-12-05T10:18:12,Portugalete,Housing,Mortgage,-1096.11,60714.96
buyer_7,María,56,ES04209572462335411521,TRX_N-00131-29883515,2020-12-05T22:20:59,Portugalete,Basic services,electricity,-131.93,60583.03
buyer_7,María,56,ES04209572462335411521,TRX_N-00132-33376823,2020-12-06T14:59:49,Portugalete,Basic services,gas,-59.09,60523.94
buyer_7,María,56,ES04209572462335411521,TRX_N-00133-89361310,2020-12-06T12:05:20,Portugalete,Basic services,phone,-38.93,60485.01
buyer_7,María,56,ES04209572462335411521,TRX_N-00134-58955223,2020-12-07T18:46:56,Portugalete,Basic services,water,-51.86,60433.15
buyer_7,María,56,ES04209572462335411521,TRX_N-00135-10433614,2020-12-07T21:10:25,Portugalete,Basic services,phone,-30.26,60402.89
buyer_7,María,56,ES04209572462335411521,TRX_N-00136-01322724,2020-12-13T09:01:09,Portugalete,Expense,gifts,-340.96,60061.93
buyer_7,María,56,ES04209572462335411521,TRX_N-00137-67899784,2020-12-19T11:43:27,Portugalete,Expense,clothing,-252.92,59809.01
buyer_7,María,56,ES04209572462335411521,TRX_N-00138-10908091,2020-12-27T11:42:36,Getxo,Expense,leisure,-258.88,59550.13
buyer_7,María,56,ES04209572462335411521,TRX_N-00139-83948797,2020-12-27T12:38:20,Portugalete,Expense,appliances,-1526.57,58023.56
buyer_7,María,56,ES04209572462335411521,TRX_N-00140-53913838,2020-12-28T09:21:51,Portugalete,Expense,food,-620.54,57403.02
buyer_7,María,56,ES04209572462335411521,TRX_N-00141-53416624,2021-01-01T13:25:21,Portugalete,transfer,Salary,2932.42,60335.44
buyer_7,María,56,ES04209572462335411521,TRX_N-00142-04904843,2021-01-01T13:25:21,Portugalete,transfer,Partner Salary,3319.09,63654.53
buyer_7,María,56,ES04209572462335411521,TRX_N-00143-03377559,2021-01-05T15:35:01,Portugalete,Housing,Mortgage,-1096.11,62558.42
buyer_7,María,56,ES04209572462335411521,TRX_N-00144-51316569,2021-01-05T12:17:55,Portugalete,Basic services,water,-30.03,62528.39
buyer_7,María,56,ES04209572462335411521,TRX_N-00145-65514817,2021-01-05T13:27:24,Portugalete,Basic services,internet,-68.61,62459.78
buyer_7,María,56,ES04209572462335411521,TRX_N-00146-89485563,2021-01-06T07:16:12,Portugalete,Basic services,water,-33.11,62426.67
buyer_7,María,56,ES04209572462335411521,TRX_N-00147-29464454,2021-01-06T14:22:38,Portugalete,Basic services,gas,-63.11,62363.56
buyer_7,María,56,ES04209572462335411521,TRX_N-00148-13703248,2021-01-07T16:30:07,Portugalete,Basic services,gas,-29.31,62334.25
buyer_7,María,56,ES04209572462335411521,TRX_N-00149-04771827,2021-01-09T18:38:30,Portugalete,Expense,leisure,-256.19,62078.06
buyer_7,María,56,ES04209572462335411521,TRX_N-00150-76002408,2021-01-26T09:05:53,Portugalete,Expense,food,-155.87,61922.19
buyer_7,María,56,ES04209572462335411521,TRX_N-00151-23008294,2021-02-01T18:24:48,Portugalete,transfer,Salary,2932.42,64854.61
buyer_7,María,56,ES04209572462335411521,TRX_N-00152-26848622,2021-02-01T18:24:48,Portugalete,transfer,Partner Salary,3319.09,68173.7
buyer_7,María,56,ES04209572462335411521,TRX_N-00153-87371894,2021-02-01T18:24:48,Portugalete,transfer,Extra Income,293.24,68466.94
buyer_7,María,56,ES04209572462335411521,TRX_N-00154-82691200,2021-02-05T11:32:33,Portugalete,Housing,Mortgage,-1096.11,67370.83
buyer_7,María,56,ES04209572462335411521,TRX_N-00155-70994160,2021-02-05T12:57:06,Portugalete,Basic services,water,-14.85,67355.98
buyer_7,María,56,ES04209572462335411521,TRX_N-00156-06536652,2021-02-06T18:22:40,Portugalete,Basic services,phone,-74.84,67281.14
buyer_7,María,56,ES04209572462335411521,TRX_N-00157-06978024,2021-02-07T20:03:36,Portugalete,Basic services,gas,-52.45,67228.69
buyer_7,María,56,ES04209572462335411521,TRX_N-00158-19813339,2021-02-23T19:52:55,Portugalete,Expense,food,-381.95,66846.74
buyer_7,María,56,ES04209572462335411521,TRX_N-00159-25284418,2021-03-01T11:07:36,Portugalete,transfer,Salary,2932.42,69779.16
buyer_7,María,56,ES04209572462335411521,TRX_N-00160-91125479,2021-03-01T11:07:36,Portugalete,transfer,Partner Salary,3319.09,73098.25
buyer_7,María,56,ES04209572462335411521,TRX_N-00161-34956487,2021-03-02T20:05:22,Portugalete,Expense,healthcare,-146.87,72951.38
buyer_7,María,56,ES04209572462335411521,TRX_N-00162-10907709,2021-03-05T18:34:37,Portugalete,Housing,Mortgage,-1096.11,71855.27
buyer_7,María,56,ES04209572462335411521,TRX_N-00163-96124192,2021-03-05T18:24:37,Portugalete,Basic services,electricity,-26.8,71828.47
buyer_7,María,56,ES04209572462335411521,TRX_N-00164-93659924,2021-03-05T04:37:50,Portugalete,Basic services,phone,-80.85,71747.62
buyer_7,María,56,ES04209572462335411521,TRX_N-00165-96362518,2021-03-06T08:41:28,Portugalete,Basic services,internet,-57.68,71689.94
buyer_7,María,56,ES04209572462335411521,TRX_N-00166-92682288,2021-03-07T16:19:35,Portugalete,Basic services,gas,-61.69,71628.25
buyer_7,María,56,ES04209572462335411521,TRX_N-00167-97772783,2021-03-08T08:46:02,Portugalete,Expense,transport,-49.73,71578.52
buyer_7,María,56,ES04209572462335411521,TRX_N-00168-17920511,2021-03-10T13:28:55,Lasarte-Oria,Expense,healthcare,-36.97,71541.55
buyer_7,María,56,ES04209572462335411521,TRX_N-00169-40255144,2021-03-24T12:50:57,Portugalete,Expense,food,-187.73,71353.82
buyer_7,María,56,ES04209572462335411521,TRX_N-00170-99857699,2021-03-25T18:16:53,Portugalete,Expense,transport,-137.53,71216.29
buyer_7,María,56,ES04209572462335411521,TRX_N-00171-15379781,2021-04-01T17:15:44,Portugalete,transfer,Salary,2932.42,74148.71
buyer_7,María,56,ES04209572462335411521,TRX_N-00172-86297938,2021-04-01T17:15:44,Portugalete,transfer,Partner Salary,3319.09,77467.8
buyer_7,María,56,ES04209572462335411521,TRX_N-00173-90233875,2021-04-05T13:01:41,Portugalete,Housing,Mortgage,-1096.11,76371.69
buyer_7,María,56,ES04209572462335411521,TRX_N-00174-11769440,2021-04-05T14:36:57,Portugalete,Basic services,water,-54.1,76317.59
buyer_7,María,56,ES04209572462335411521,TRX_N-00175-08386443,2021-04-05T08:31:12,Portugalete,Basic services,gas,-38.46,76279.13
buyer_7,María,56,ES04209572462335411521,TRX_N-00176-30106299,2021-04-05T14:07:41,Portugalete,Basic services,internet,-69.76,76209.37
buyer_7,María,56,ES04209572462335411521,TRX_N-00177-68182943,2021-04-06T21:51:39,Portugalete,Basic services,water,-27.78,76181.59
buyer_7,María,56,ES04209572462335411521,TRX_N-00178-54846575,2021-04-06T21:44:02,Portugalete,Basic services,electricity,-22.69,76158.9
buyer_7,María,56,ES04209572462335411521,TRX_N-00179-13986478,2021-04-06T16:22:52,Portugalete,Basic services,gas,-28.02,76130.88
buyer_7,María,56,ES04209572462335411521,TRX_N-00180-97155724,2021-04-07T14:20:43,Portugalete,Basic services,electricity,-75.63,76055.25
buyer_7,María,56,ES04209572462335411521,TRX_N-00181-94367076,2021-04-07T17:50:30,Portugalete,Basic services,gas,-98.69,75956.56
buyer_7,María,56,ES04209572462335411521,TRX_N-00182-91058436,2021-04-07T09:11:04,Portugalete,Basic services,internet,-34.28,75922.28
buyer_7,María,56,ES04209572462335411521,TRX_N-00183-17147118,2021-04-09T04:34:19,Portugalete,Expense,clothing,-372.82,75549.46
buyer_7,María,56,ES04209572462335411521,TRX_N-00184-57417776,2021-04-10T12:21:01,Errenteria,Expense,food,-133.75,75415.71
buyer_7,María,56,ES04209572462335411521,TRX_N-00185-01348882,2021-04-10T17:41:11,Andoain,Expense,leisure,-34.61,75381.1
buyer_7,María,56,ES04209572462335411521,TRX_N-00186-56870386,2021-04-16T18:53:03,Portugalete,Expense,education,-934.36,74446.74
buyer_7,María,56,ES04209572462335411521,TRX_N-00187-06310126,2021-04-24T16:30:51,Portugalete,Expense,leisure,-54.95,74391.79
buyer_7,María,56,ES04209572462335411521,TRX_N-00188-82598317,2021-05-01T22:16:12,Portugalete,transfer,Salary,2932.42,77324.21
buyer_7,María,56,ES04209572462335411521,TRX_N-00189-82710263,2021-05-01T22:16:12,Portugalete,transfer,Partner Salary,3319.09,80643.3
buyer_7,María,56,ES04209572462335411521,TRX_N-00190-21159984,2021-05-01T22:16:12,Portugalete,transfer,Extra Income,293.24,80936.54
buyer_7,María,56,ES04209572462335411521,TRX_N-00191-61367287,2021-05-05T03:23:56,Portugalete,Housing,Mortgage,-1096.11,79840.43
buyer_7,María,56,ES04209572462335411521,TRX_N-00192-00559628,2021-05-05T09:28:40,Portugalete,Basic services,water,-13.86,79826.57
buyer_7,María,56,ES04209572462335411521,TRX_N-00193-46851197,2021-05-06T08:10:17,Portugalete,Basic services,water,-74.18,79752.39
buyer_7,María,56,ES04209572462335411521,TRX_N-00194-19257410,2021-05-06T10:53:49,Portugalete,Basic services,electricity,-73.07,79679.32
buyer_7,María,56,ES04209572462335411521,TRX_N-00195-32476578,2021-05-07T12:16:03,Portugalete,Basic services,water,-70.08,79609.24
buyer_7,María,56,ES04209572462335411521,TRX_N-00196-06467922,2021-05-07T08:02:48,Portugalete,Basic services,gas,-76.37,79532.87
buyer_7,María,56,ES04209572462335411521,TRX_N-00197-88091001,2021-06-01T13:17:23,Portugalete,transfer,Salary,2932.42,82465.29
buyer_7,María,56,ES04209572462335411521,TRX_N-00198-92135931,2021-06-01T13:17:23,Portugalete,transfer,Partner Salary,3319.09,85784.38
buyer_7,María,56,ES04209572462335411521,TRX_N-00199-62477813,2021-06-01T13:17:23,Portugalete,transfer,Bonus,3116.09,88900.47
buyer_7,María,56,ES04209572462335411521,TRX_N-00200-93529942,2021-06-05T09:24:53,Portugalete,Housing,Mortgage,-1096.11,87804.36
buyer_7,María,56,ES04209572462335411521,TRX_N-00201-38210137,2021-06-05T10:45:08,Portugalete,Basic services,phone,-38.81,87765.55
buyer_7,María,56,ES04209572462335411521,TRX_N-00202-05126374,2021-06-07T14:25:32,Portugalete,Basic services,water,-21.48,87744.07
buyer_7,María,56,ES04209572462335411521,TRX_N-00203-29223366,2021-06-07T19:53:01,Portugalete,Basic services,gas,-37.24,87706.83
buyer_7,María,56,ES04209572462335411521,TRX_N-00204-49168480,2021-06-12T14:29:52,Portugalete,Expense,leisure,-297.68,87409.15
buyer_7,María,56,ES04209572462335411521,TRX_N-00205-23720576,2021-06-19T09:11:00,Portugalete,Expense,appliances,-797.35,86611.8
buyer_7,María,56,ES04209572462335411521,TRX_N-00206-43272884,2021-06-21T20:33:37,Portugalete,Expense,food,-287.12,86324.68
buyer_7,María,56,ES04209572462335411521,TRX_N-00207-97512751,2021-07-01T12:49:01,Portugalete,transfer,Salary,2932.42,89257.1
buyer_7,María,56,ES04209572462335411521,TRX_N-00208-25148248,2021-07-01T12:49:01,Portugalete,transfer,Partner Salary,3319.09,92576.19
buyer_7,María,56,ES04209572462335411521,TRX_N-00209-08379480,2021-07-01T12:49:01,Portugalete,transfer,Extra Income,293.24,92869.43
buyer_7,María,56,ES04209572462335411521,TRX_N-00210-16291864,2021-07-05T08:19:15,Portugalete,Housing,Mortgage,-1096.11,91773.32
buyer_7,María,56,ES04209572462335411521,TRX_N-00211-73772711,2021-07-05T16:12:16,Portugalete,Basic services,electricity,-31.95,91741.37
buyer_7,María,56,ES04209572462335411521,TRX_N-00212-87096132,2021-07-07T10:53:22,Portugalete,Basic services,gas,-94.24,91647.13
buyer_7,María,56,ES04209572462335411521,TRX_N-00213-98158999,2021-07-07T12:46:56,Portugalete,Basic services,phone,-90.12,91557.01
buyer_7,María,56,ES04209572462335411521,TRX_N-00214-28671193,2021-07-20T12:47:44,Portugalete,Expense,transport,-52.2,91504.81
buyer_7,María,56,ES04209572462335411521,TRX_N-00215-13858756,2021-07-26T16:12:02,Portugalete,Expense,transport,-97.05,91407.76
buyer_7,María,56,ES04209572462335411521,TRX_N-00216-18871014,2021-07-27T13:34:18,Portugalete,Expense,leisure,-192.4,91215.36
buyer_7,María,56,ES04209572462335411521,TRX_N-00217-70396361,2021-07-28T13:50:59,Portugalete,Expense,food,-391.0,90824.36
buyer_7,María,56,ES04209572462335411521,TRX_N-00218-80780340,2021-08-01T10:08:41,Portugalete,transfer,Salary,2932.42,93756.78
buyer_7,María,56,ES04209572462335411521,TRX_N-00219-33438544,2021-08-01T10:08:41,Portugalete,transfer,Partner Salary,3319.09,97075.87
buyer_7,María,56,ES04209572462335411521,TRX_N-00220-25036302,2021-08-05T19:41:51,Portugalete,Housing,Mortgage,-1096.11,95979.76
buyer_7,María,56,ES04209572462335411521,TRX_N-00221-72028638,2021-08-05T19:29:27,Portugalete,Basic services,water,-45.54,95934.22
buyer_7,María,56,ES04209572462335411521,TRX_N-00222-86430397,2021-08-05T13:43:24,Portugalete,Basic services,electricity,-43.57,95890.65
buyer_7,María,56,ES04209572462335411521,TRX_N-00223-96920623,2021-08-05T12:17:58,Portugalete,Basic services,internet,-47.95,95842.7
buyer_7,María,56,ES04209572462335411521,TRX_N-00224-69961698,2021-08-06T01:38:45,Portugalete,Basic services,electricity,-24.44,95818.26
buyer_7,María,56,ES04209572462335411521,TRX_N-00225-37230584,2021-08-06T02:17:19,Portugalete,Basic services,gas,-23.08,95795.18
buyer_7,María,56,ES04209572462335411521,TRX_N-00226-48097337,2021-08-07T09:32:32,Portugalete,Basic services,water,-60.26,95734.92
buyer_7,María,56,ES04209572462335411521,TRX_N-00227-76676698,2021-08-07T14:37:16,Portugalete,Basic services,electricity,-135.04,95599.88
buyer_7,María,56,ES04209572462335411521,TRX_N-00228-56948442,2021-08-07T20:37:44,Portugalete,Basic services,phone,-93.98,95505.9
buyer_7,María,56,ES04209572462335411521,TRX_N-00229-37002586,2021-08-15T16:15:43,Erandio,Expense,repairs,-212.08,95293.82
buyer_7,María,56,ES04209572462335411521,TRX_N-00230-05055792,2021-08-16T12:30:35,Portugalete,Expense,transport,-109.69,95184.13
buyer_7,María,56,ES04209572462335411521,TRX_N-00231-00312848,2021-08-20T11:22:55,Portugalete,Expense,leisure,-243.6,94940.53
buyer_7,María,56,ES04209572462335411521,TRX_N-00232-98779496,2021-08-22T10:59:29,Portugalete,Expense,clothing,-206.9,94733.63
buyer_7,María,56,ES04209572462335411521,TRX_N-00233-77283606,2021-08-23T14:09:53,Portugalete,Expense,food,-505.01,94228.62
buyer_7,María,56,ES04209572462335411521,TRX_N-00234-71452970,2021-08-23T10:29:52,Lasarte-Oria,Expense,transport,-179.79,94048.83
buyer_7,María,56,ES04209572462335411521,TRX_N-00235-97394185,2021-09-01T12:11:48,Portugalete,transfer,Salary,2932.42,96981.25
buyer_7,María,56,ES04209572462335411521,TRX_N-00236-21549131,2021-09-01T12:11:48,Portugalete,transfer,Partner Salary,3319.09,100300.34
buyer_7,María,56,ES04209572462335411521,TRX_N-00237-19177074,2021-09-04T12:20:59,Portugalete,Expense,gifts,-333.27,99967.07
buyer_7,María,56,ES04209572462335411521,TRX_N-00238-50118025,2021-09-05T12:21:32,Portugalete,Housing,Mortgage,-1096.11,98870.96
buyer_7,María,56,ES04209572462335411521,TRX_N-00239-42539524,2021-09-05T06:44:18,Portugalete,Basic services,gas,-68.21,98802.75
buyer_7,María,56,ES04209572462335411521,TRX_N-00240-59332164,2021-09-05T14:52:29,Portugalete,Basic services,internet,-67.55,98735.2
buyer_7,María,56,ES04209572462335411521,TRX_N-00241-61311613,2021-09-05T10:06:52,Portugalete,Basic services,phone,-66.4,98668.8
buyer_7,María,56,ES04209572462335411521,TRX_N-00242-47687244,2021-09-06T11:20:09,Portugalete,Basic services,water,-40.59,98628.21
buyer_7,María,56,ES04209572462335411521,TRX_N-00243-32728353,2021-09-06T11:45:21,Portugalete,Basic services,electricity,-144.94,98483.27
buyer_7,María,56,ES04209572462335411521,TRX_N-00244-88388190,2021-09-06T05:35:18,Portugalete,Basic services,gas,-32.39,98450.88
buyer_7,María,56,ES04209572462335411521,TRX_N-00245-56973541,2021-09-06T08:10:20,Portugalete,Basic services,internet,-69.11,98381.77
buyer_7,María,56,ES04209572462335411521,TRX_N-00246-73052451,2021-09-07T18:42:49,Portugalete,Basic services,water,-51.59,98330.18
buyer_7,María,56,ES04209572462335411521,TRX_N-00247-13605273,2021-09-07T11:10:13,Portugalete,Basic services,electricity,-36.02,98294.16
buyer_7,María,56,ES04209572462335411521,TRX_N-00248-96686608,2021-09-07T15:35:07,Portugalete,Basic services,internet,-54.94,98239.22
buyer_7,María,56,ES04209572462335411521,TRX_N-00249-54940440,2021-09-07T18:09:43,Portugalete,Basic services,phone,-58.94,98180.28
buyer_7,María,56,ES04209572462335411521,TRX_N-00250-75912341,2021-09-17T18:08:25,Labastida/Bastida,Expense,healthcare,-344.41,97835.87
buyer_7,María,56,ES04209572462335411521,TRX_N-00251-02281335,2021-10-01T06:10:57,Portugalete,transfer,Salary,2932.42,100768.29
buyer_7,María,56,ES04209572462335411521,TRX_N-00252-32971934,2021-10-01T06:10:57,Portugalete,transfer,Partner Salary,3319.09,104087.38
buyer_7,María,56,ES04209572462335411521,TRX_N-00253-97653914,2021-10-01T06:10:57,Portugalete,transfer,Extra Income,293.24,104380.62
buyer_7,María,56,ES04209572462335411521,TRX_N-00254-79669806,2021-10-05T20:41:39,Portugalete,Housing,Mortgage,-1096.11,103284.51
buyer_7,María,56,ES04209572462335411521,TRX_N-00255-22313509,2021-10-05T19:19:59,Portugalete,Basic services,water,-79.0,103205.51
buyer_7,María,56,ES04209572462335411521,TRX_N-00256-16564078,2021-10-06T21:09:02,Portugalete,Basic services,phone,-72.36,103133.15
buyer_7,María,56,ES04209572462335411521,TRX_N-00257-04047639,2021-11-01T09:06:52,Portugalete,transfer,Salary,2932.42,106065.57
buyer_7,María,56,ES04209572462335411521,TRX_N-00258-86770007,2021-11-01T09:06:52,Portugalete,transfer,Partner Salary,3319.09,109384.66
buyer_7,María,56,ES04209572462335411521,TRX_N-00259-02962848,2021-11-05T12:40:55,Portugalete,Housing,Mortgage,-1096.11,108288.55
buyer_7,María,56,ES04209572462335411521,TRX_N-00260-72009948,2021-11-05T17:59:49,Portugalete,Basic services,electricity,-131.04,108157.51
buyer_7,María,56,ES04209572462335411521,TRX_N-00261-24453946,2021-11-05T15:53:53,Portugalete,Basic services,phone,-58.57,108098.94
buyer_7,María,56,ES04209572462335411521,TRX_N-00262-54765583,2021-11-06T12:42:51,Portugalete,Basic services,electricity,-134.59,107964.35
buyer_7,María,56,ES04209572462335411521,TRX_N-00263-60082347,2021-11-06T23:13:59,Portugalete,Basic services,gas,-48.99,107915.36
buyer_7,María,56,ES04209572462335411521,TRX_N-00264-58005954,2021-11-06T15:25:30,Portugalete,Basic services,internet,-60.34,107855.02
buyer_7,María,56,ES04209572462335411521,TRX_N-00265-23849856,2021-11-06T22:43:01,Portugalete,Basic services,phone,-36.61,107818.41
buyer_7,María,56,ES04209572462335411521,TRX_N-00266-41186643,2021-11-07T18:03:33,Santurtzi,Expense,food,-357.27,107461.14
buyer_7,María,56,ES04209572462335411521,TRX_N-00267-90784455,2021-11-13T13:43:34,Portugalete,Expense,healthcare,-207.38,107253.76
buyer_7,María,56,ES04209572462335411521,TRX_N-00268-03963834,2021-11-18T18:02:38,Portugalete,Expense,food,-126.62,107127.14
buyer_7,María,56,ES04209572462335411521,TRX_N-00269-79321909,2021-11-20T09:55:55,Portugalete,Expense,food,-508.06,106619.08
buyer_7,María,56,ES04209572462335411521,TRX_N-00270-40641143,2021-12-01T15:31:45,Portugalete,transfer,Salary,2932.42,109551.5
buyer_7,María,56,ES04209572462335411521,TRX_N-00271-31806748,2021-12-01T15:31:45,Portugalete,transfer,Partner Salary,3319.09,112870.59
buyer_7,María,56,ES04209572462335411521,TRX_N-00272-42340518,2021-12-01T15:31:45,Portugalete,transfer,Extra Income,293.24,113163.83
buyer_7,María,56,ES04209572462335411521,TRX_N-00273-76546569,2021-12-01T15:31:45,Portugalete,transfer,Bonus,2911.56,116075.39
buyer_7,María,56,ES04209572462335411521,TRX_N-00274-08296550,2021-12-05T20:05:52,Portugalete,Housing,Mortgage,-1096.11,114979.28
buyer_7,María,56,ES04209572462335411521,TRX_N-00275-44134475,2021-12-07T11:52:02,Portugalete,Basic services,water,-75.84,114903.44
buyer_7,María,56,ES04209572462335411521,TRX_N-00276-39094052,2021-12-08T19:14:45,Portugalete,Expense,food,-145.16,114758.28
buyer_7,María,56,ES04209572462335411521,TRX_N-00277-59845100,2021-12-09T12:49:48,Portugalete,Expense,clothing,-63.04,114695.24
buyer_7,María,56,ES04209572462335411521,TRX_N-00278-61639087,2021-12-12T11:15:16,Portugalete,Expense,food,-549.33,114145.91
buyer_7,María,56,ES04209572462335411521,TRX_N-00279-55074696,2021-12-12T23:52:00,Portugalete,Expense,transport,-119.65,114026.26
buyer_7,María,56,ES04209572462335411521,TRX_N-00280-41999605,2021-12-25T12:01:59,Irun,Expense,leisure,-248.33,113777.93
buyer_7,María,56,ES04209572462335411521,TRX_N-00281-29388119,2022-01-01T09:33:15,Portugalete,transfer,Salary,2932.42,116710.35
buyer_7,María,56,ES04209572462335411521,TRX_N-00282-49621368,2022-01-01T09:33:15,Portugalete,transfer,Partner Salary,3319.09,120029.44
buyer_7,María,56,ES04209572462335411521,TRX_N-00283-68647392,2022-01-05T13:50:15,Portugalete,Housing,Mortgage,-1096.11,118933.33
buyer_7,María,56,ES04209572462335411521,TRX_N-00284-85522919,2022-01-06T18:30:42,Portugalete,Basic services,gas,-42.07,118891.26
buyer_7,María,56,ES04209572462335411521,TRX_N-00285-65709361,2022-01-06T12:02:55,Portugalete,Basic services,internet,-60.55,118830.71
buyer_7,María,56,ES04209572462335411521,TRX_N-00286-67173760,2022-01-07T19:22:58,Portugalete,Basic services,water,-58.4,118772.31
buyer_7,María,56,ES04209572462335411521,TRX_N-00287-73857554,2022-01-07T09:07:56,Portugalete,Basic services,electricity,-112.74,118659.57
buyer_7,María,56,ES04209572462335411521,TRX_N-00288-99662837,2022-01-07T13:22:54,Portugalete,Basic services,phone,-49.37,118610.2
buyer_7,María,56,ES04209572462335411521,TRX_N-00289-85238877,2022-01-16T15:13:25,Portugalete,Expense,food,-739.95,117870.25
buyer_7,María,56,ES04209572462335411521,TRX_N-00290-11849363,2022-01-20T16:52:59,Portugalete,Expense,gifts,-371.83,117498.42
buyer_7,María,56,ES04209572462335411521,TRX_N-00291-67125223,2022-01-22T21:48:05,Portugalete,Expense,healthcare,-28.93,117469.49
buyer_7,María,56,ES04209572462335411521,TRX_N-00292-01741463,2022-01-23T20:04:00,Portugalete,Expense,transport,-162.82,117306.67
buyer_7,María,56,ES04209572462335411521,TRX_N-00293-56228206,2022-01-27T08:27:22,Portugalete,Expense,food,-764.25,116542.42
buyer_7,María,56,ES04209572462335411521,TRX_N-00294-31196204,2022-02-01T12:27:29,Portugalete,transfer,Salary,2932.42,119474.84
buyer_7,María,56,ES04209572462335411521,TRX_N-00295-83148483,2022-02-01T12:27:29,Portugalete,transfer,Partner Salary,3319.09,122793.93
buyer_7,María,56,ES04209572462335411521,TRX_N-00296-45687480,2022-02-05T00:28:20,Portugalete,Housing,Mortgage,-1096.11,121697.82
buyer_7,María,56,ES04209572462335411521,TRX_N-00297-67832026,2022-02-05T08:58:01,Portugalete,Basic services,gas,-99.53,121598.29
buyer_7,María,56,ES04209572462335411521,TRX_N-00298-21857091,2022-02-05T17:58:27,Portugalete,Basic services,internet,-47.15,121551.14
buyer_7,María,56,ES04209572462335411521,TRX_N-00299-10382018,2022-02-06T17:06:12,Portugalete,Basic services,water,-64.97,121486.17
buyer_7,María,56,ES04209572462335411521,TRX_N-00300-12007399,2022-02-06T09:27:37,Portugalete,Basic services,internet,-65.78,121420.39
buyer_7,María,56,ES04209572462335411521,TRX_N-00301-60700917,2022-02-06T11:03:12,Portugalete,Expense,food,-478.17,120942.22
buyer_7,María,56,ES04209572462335411521,TRX_N-00302-42961603,2022-02-07T11:29:16,Portugalete,Basic services,internet,-41.52,120900.7
buyer_7,María,56,ES04209572462335411521,TRX_N-00303-76285734,2022-02-11T13:28:28,Portugalete,Expense,clothing,-447.97,120452.73
buyer_7,María,56,ES04209572462335411521,TRX_N-00304-48326273,2022-02-27T17:26:50,Portugalete,Expense,leisure,-212.95,120239.78
buyer_7,María,56,ES04209572462335411521,TRX_N-00305-61022005,2022-03-01T10:41:56,Portugalete,transfer,Salary,2932.42,123172.2
buyer_7,María,56,ES04209572462335411521,TRX_N-00306-75905415,2022-03-01T10:41:56,Portugalete,transfer,Partner Salary,3319.09,126491.29
buyer_7,María,56,ES04209572462335411521,TRX_N-00307-49014453,2022-03-01T10:41:56,Portugalete,transfer,Extra Income,293.24,126784.53
buyer_7,María,56,ES04209572462335411521,TRX_N-00308-99045273,2022-03-03T15:01:19,Portugalete,Expense,leisure,-287.57,126496.96
buyer_7,María,56,ES04209572462335411521,TRX_N-00309-05145002,2022-03-05T09:03:51,Portugalete,Housing,Mortgage,-1096.11,125400.85
buyer_7,María,56,ES04209572462335411521,TRX_N-00310-04871696,2022-03-05T22:23:34,Portugalete,Basic services,water,-62.0,125338.85
buyer_7,María,56,ES04209572462335411521,TRX_N-00311-09302391,2022-03-05T20:55:31,Portugalete,Basic services,gas,-72.56,125266.29
buyer_7,María,56,ES04209572462335411521,TRX_N-00312-38252826,2022-03-05T15:52:02,Portugalete,Basic services,phone,-22.31,125243.98
buyer_7,María,56,ES04209572462335411521,TRX_N-00313-53251651,2022-03-06T16:55:36,Portugalete,Basic services,gas,-79.68,125164.3
buyer_7,María,56,ES04209572462335411521,TRX_N-00314-01495928,2022-03-07T14:28:49,Portugalete,Basic services,gas,-98.47,125065.83
buyer_7,María,56,ES04209572462335411521,TRX_N-00315-88770742,2022-03-07T17:25:23,Portugalete,Basic services,internet,-42.59,125023.24
buyer_7,María,56,ES04209572462335411521,TRX_N-00316-93538806,2022-04-01T01:28:21,Portugalete,transfer,Salary,2932.42,127955.66
buyer_7,María,56,ES04209572462335411521,TRX_N-00317-55004456,2022-04-01T01:28:21,Portugalete,transfer,Partner Salary,3319.09,131274.75
buyer_7,María,56,ES04209572462335411521,TRX_N-00318-71756649,2022-04-05T20:32:40,Portugalete,Housing,Mortgage,-1096.11,130178.64
buyer_7,María,56,ES04209572462335411521,TRX_N-00319-17320381,2022-04-05T10:02:46,Portugalete,Basic services,phone,-61.55,130117.09
buyer_7,María,56,ES04209572462335411521,TRX_N-00320-15333160,2022-04-05T13:23:58,Portugalete,Expense,repairs,-895.01,129222.08
buyer_7,María,56,ES04209572462335411521,TRX_N-00321-29368805,2022-04-06T08:54:03,Portugalete,Basic services,internet,-60.2,129161.88
buyer_7,María,56,ES04209572462335411521,TRX_N-00322-61263587,2022-04-07T09:01:29,Portugalete,Basic services,water,-56.33,129105.55
buyer_7,María,56,ES04209572462335411521,TRX_N-00323-45282977,2022-04-07T05:47:44,Portugalete,Basic services,internet,-44.77,129060.78
buyer_7,María,56,ES04209572462335411521,TRX_N-00324-91596869,2022-04-08T19:23:54,Portugalete,Expense,transport,-160.33,128900.45
buyer_7,María,56,ES04209572462335411521,TRX_N-00325-13475871,2022-04-21T11:34:45,Portugalete,Expense,food,-215.52,128684.93
buyer_7,María,56,ES04209572462335411521,TRX_N-00326-57636895,2022-04-26T12:53:12,Portugalete,Expense,healthcare,-140.0,128544.93
buyer_7,María,56,ES04209572462335411521,TRX_N-00327-75254237,2022-04-29T23:37:22,Pasaia,Expense,clothing,-370.77,128174.16
buyer_7,María,56,ES04209572462335411521,TRX_N-00328-64724790,2022-04-30T11:31:40,Portugalete,Expense,transport,-194.4,127979.76
buyer_7,María,56,ES04209572462335411521,TRX_N-00329-92925157,2022-05-01T21:09:35,Portugalete,transfer,Salary,2932.42,130912.18
buyer_7,María,56,ES04209572462335411521,TRX_N-00330-70355409,2022-05-01T21:09:35,Portugalete,transfer,Partner Salary,3319.09,134231.27
buyer_7,María,56,ES04209572462335411521,TRX_N-00331-55878487,2022-05-05T13:33:00,Portugalete,Housing,Mortgage,-1096.11,133135.16
buyer_7,María,56,ES04209572462335411521,TRX_N-00332-10217937,2022-05-05T21:06:27,Portugalete,Basic services,water,-40.09,133095.07
buyer_7,María,56,ES04209572462335411521,TRX_N-00333-33867055,2022-05-05T09:14:49,Portugalete,Basic services,electricity,-84.09,133010.98
buyer_7,María,56,ES04209572462335411521,TRX_N-00334-01514469,2022-05-06T14:48:56,Portugalete,Basic services,gas,-62.44,132948.54
buyer_7,María,56,ES04209572462335411521,TRX_N-00335-58342416,2022-05-07T12:25:52,Portugalete,Basic services,internet,-55.07,132893.47
buyer_7,María,56,ES04209572462335411521,TRX_N-00336-45890492,2022-05-08T08:13:01,Portugalete,Expense,transport,-116.89,132776.58
buyer_7,María,56,ES04209572462335411521,TRX_N-00337-25886756,2022-05-19T13:32:14,Portugalete,Expense,repairs,-58.51,132718.07
buyer_7,María,56,ES04209572462335411521,TRX_N-00338-22183312,2022-05-31T15:09:57,Basauri,Expense,travel,-2095.34,130622.73
buyer_7,María,56,ES04209572462335411521,TRX_N-00339-35181470,2022-06-01T10:10:06,Portugalete,transfer,Salary,2932.42,133555.15
buyer_7,María,56,ES04209572462335411521,TRX_N-00340-48012087,2022-06-01T10:10:06,Portugalete,transfer,Partner Salary,3319.09,136874.24
buyer_7,María,56,ES04209572462335411521,TRX_N-00341-82571817,2022-06-01T10:10:06,Portugalete,transfer,Extra Income,293.24,137167.48
buyer_7,María,56,ES04209572462335411521,TRX_N-00342-84983220,2022-06-01T10:10:06,Portugalete,transfer,Bonus,2855.9,140023.38
buyer_7,María,56,ES04209572462335411521,TRX_N-00343-27790087,2022-06-02T15:35:35,Portugalete,Expense,food,-157.82,139865.56
buyer_7,María,56,ES04209572462335411521,TRX_N-00344-26110130,2022-06-05T14:07:21,Portugalete,Housing,Mortgage,-1096.11,138769.45
buyer_7,María,56,ES04209572462335411521,TRX_N-00345-15067731,2022-06-05T17:03:22,Portugalete,Basic services,water,-19.46,138749.99
buyer_7,María,56,ES04209572462335411521,TRX_N-00346-42450787,2022-06-05T10:49:16,Portugalete,Basic services,electricity,-52.84,138697.15
buyer_7,María,56,ES04209572462335411521,TRX_N-00347-90625527,2022-06-06T17:58:54,Portugalete,Basic services,electricity,-125.99,138571.16
buyer_7,María,56,ES04209572462335411521,TRX_N-00348-36346186,2022-06-06T12:02:45,Portugalete,Basic services,phone,-89.92,138481.24
buyer_7,María,56,ES04209572462335411521,TRX_N-00349-83876396,2022-06-07T06:45:29,Portugalete,Basic services,water,-22.62,138458.62
buyer_7,María,56,ES04209572462335411521,TRX_N-00350-64632284,2022-06-07T10:01:00,Portugalete,Basic services,phone,-28.39,138430.23
buyer_7,María,56,ES04209572462335411521,TRX_N-00351-16358207,2022-06-14T20:44:40,Portugalete,Expense,food,-688.09,137742.14
buyer_7,María,56,ES04209572462335411521,TRX_N-00352-92628062,2022-06-20T16:05:46,Portugalete,Expense,food,-320.03,137422.11
buyer_7,María,56,ES04209572462335411521,TRX_N-00353-34003486,2022-06-21T15:13:37,Portugalete,Expense,food,-474.14,136947.97
buyer_7,María,56,ES04209572462335411521,TRX_N-00354-91475577,2022-06-22T14:01:07,Portugalete,Expense,food,-143.38,136804.59
buyer_7,María,56,ES04209572462335411521,TRX_N-00355-63903922,2022-07-01T11:31:31,Portugalete,transfer,Salary,2932.42,139737.01
buyer_7,María,56,ES04209572462335411521,TRX_N-00356-97503583,2022-07-01T11:31:31,Portugalete,transfer,Partner Salary,3319.09,143056.1
buyer_7,María,56,ES04209572462335411521,TRX_N-00357-50893598,2022-07-05T19:31:33,Portugalete,Housing,Mortgage,-1096.11,141959.99
buyer_7,María,56,ES04209572462335411521,TRX_N-00358-60106898,2022-07-05T19:49:03,Portugalete,Basic services,gas,-54.57,141905.42
buyer_7,María,56,ES04209572462335411521,TRX_N-00359-91272529,2022-07-05T15:48:55,Portugalete,Basic services,internet,-44.14,141861.28
buyer_7,María,56,ES04209572462335411521,TRX_N-00360-74185575,2022-07-06T13:28:05,Portugalete,Basic services,gas,-70.97,141790.31
buyer_7,María,56,ES04209572462335411521,TRX_N-00361-65496956,2022-07-07T12:58:20,Portugalete,Basic services,internet,-30.4,141759.91
buyer_7,María,56,ES04209572462335411521,TRX_N-00362-27644019,2022-07-11T08:59:11,Portugalete,Expense,travel,-361.09,141398.82
buyer_7,María,56,ES04209572462335411521,TRX_N-00363-20562579,2022-07-20T23:49:32,Portugalete,Expense,healthcare,-136.99,141261.83
buyer_7,María,56,ES04209572462335411521,TRX_N-00364-29919163,2022-07-21T09:09:03,Portugalete,Expense,leisure,-223.51,141038.32
buyer_7,María,56,ES04209572462335411521,TRX_N-00365-78293108,2022-07-24T07:54:50,Portugalete,Expense,food,-332.49,140705.83
buyer_7,María,56,ES04209572462335411521,TRX_N-00366-70968021,2022-07-24T18:37:42,Portugalete,Expense,repairs,-745.02,139960.81
buyer_7,María,56,ES04209572462335411521,TRX_N-00367-02380620,2022-07-25T00:58:02,Portugalete,Expense,leisure,-275.39,139685.42
buyer_7,María,56,ES04209572462335411521,TRX_N-00368-15694479,2022-08-01T16:17:13,Portugalete,transfer,Salary,2932.42,142617.84
buyer_7,María,56,ES04209572462335411521,TRX_N-00369-70454839,2022-08-01T16:17:13,Portugalete,transfer,Partner Salary,3319.09,145936.93
buyer_7,María,56,ES04209572462335411521,TRX_N-00370-08652831,2022-08-01T16:17:13,Portugalete,transfer,Extra Income,293.24,146230.17
buyer_7,María,56,ES04209572462335411521,TRX_N-00371-10405491,2022-08-05T10:16:23,Portugalete,Housing,Mortgage,-1096.11,145134.06
buyer_7,María,56,ES04209572462335411521,TRX_N-00372-33816479,2022-08-06T13:13:54,Portugalete,Basic services,water,-49.88,145084.18
buyer_7,María,56,ES04209572462335411521,TRX_N-00373-47099767,2022-08-06T19:22:12,Portugalete,Basic services,gas,-98.15,144986.03
buyer_7,María,56,ES04209572462335411521,TRX_N-00374-16334082,2022-08-06T20:54:37,Portugalete,Basic services,phone,-33.9,144952.13
buyer_7,María,56,ES04209572462335411521,TRX_N-00375-63570768,2022-08-07T18:41:25,Portugalete,Basic services,electricity,-118.03,144834.1
buyer_7,María,56,ES04209572462335411521,TRX_N-00376-18777122,2022-08-07T12:57:16,Portugalete,Basic services,internet,-49.31,144784.79
buyer_7,María,56,ES04209572462335411521,TRX_N-00377-27348246,2022-08-07T14:23:31,Portugalete,Basic services,phone,-88.3,144696.49
buyer_7,María,56,ES04209572462335411521,TRX_N-00378-61019875,2022-08-15T16:38:37,Portugalete,Expense,transport,-58.95,144637.54
buyer_7,María,56,ES04209572462335411521,TRX_N-00379-30576071,2022-08-28T20:19:42,Oyón-Oion,Expense,healthcare,-311.04,144326.5
buyer_7,María,56,ES04209572462335411521,TRX_N-00380-00614208,2022-09-01T13:23:49,Portugalete,transfer,Salary,2932.42,147258.92
buyer_7,María,56,ES04209572462335411521,TRX_N-00381-09987762,2022-09-01T13:23:49,Portugalete,transfer,Partner Salary,3319.09,150578.01
buyer_7,María,56,ES04209572462335411521,TRX_N-00382-03271446,2022-09-05T20:49:02,Portugalete,Housing,Mortgage,-1096.11,149481.9
buyer_7,María,56,ES04209572462335411521,TRX_N-00383-53316868,2022-09-05T17:45:10,Portugalete,Basic services,water,-73.19,149408.71
buyer_7,María,56,ES04209572462335411521,TRX_N-00384-85709337,2022-09-06T05:21:50,Portugalete,Basic services,gas,-45.0,149363.71
buyer_7,María,56,ES04209572462335411521,TRX_N-00385-11375487,2022-09-06T14:50:00,Portugalete,Basic services,internet,-54.85,149308.86
buyer_7,María,56,ES04209572462335411521,TRX_N-00386-86480612,2022-09-06T18:55:29,Portugalete,Basic services,phone,-60.01,149248.85
buyer_7,María,56,ES04209572462335411521,TRX_N-00387-60751136,2022-09-07T15:31:43,Portugalete,Basic services,gas,-29.81,149219.04
buyer_7,María,56,ES04209572462335411521,TRX_N-00388-41335489,2022-09-07T10:14:15,Portugalete,Basic services,internet,-50.24,149168.8
buyer_7,María,56,ES04209572462335411521,TRX_N-00389-08775726,2022-09-07T19:27:05,Portugalete,Basic services,phone,-56.94,149111.86
buyer_7,María,56,ES04209572462335411521,TRX_N-00390-88711813,2022-09-19T13:08:03,Portugalete,Expense,food,-420.76,148691.1
buyer_7,María,56,ES04209572462335411521,TRX_N-00391-96786205,2022-09-21T09:49:50,Portugalete,Expense,gifts,-68.02,148623.08
buyer_7,María,56,ES04209572462335411521,TRX_N-00392-22911884,2022-09-23T15:01:49,Portugalete,Expense,clothing,-135.17,148487.91
buyer_7,María,56,ES04209572462335411521,TRX_N-00393-92166385,2022-10-01T22:03:28,Portugalete,transfer,Salary,2932.42,151420.33
buyer_7,María,56,ES04209572462335411521,TRX_N-00394-26460699,2022-10-01T22:03:28,Portugalete,transfer,Partner Salary,3319.09,154739.42
buyer_7,María,56,ES04209572462335411521,TRX_N-00395-21094061,2022-10-02T13:12:46,Portugalete,Expense,food,-297.47,154441.95
buyer_7,María,56,ES04209572462335411521,TRX_N-00396-16576180,2022-10-03T03:32:36,Salvatierra/Agurain,Expense,transport,-47.49,154394.46
buyer_7,María,56,ES04209572462335411521,TRX_N-00397-61132687,2022-10-05T20:29:39,Portugalete,Housing,Mortgage,-1096.11,153298.35
buyer_7,María,56,ES04209572462335411521,TRX_N-00398-12939979,2022-10-05T09:13:53,Portugalete,Basic services,water,-49.84,153248.51
buyer_7,María,56,ES04209572462335411521,TRX_N-00399-09990490,2022-10-05T10:43:14,Portugalete,Expense,food,-692.86,152555.65
buyer_7,María,56,ES04209572462335411521,TRX_N-00400-87176710,2022-10-06T19:49:49,Portugalete,Basic services,water,-76.06,152479.59
buyer_7,María,56,ES04209572462335411521,TRX_N-00401-46249813,2022-10-06T12:48:38,Portugalete,Basic services,phone,-43.73,152435.86
buyer_7,María,56,ES04209572462335411521,TRX_N-00402-35789755,2022-10-07T09:27:44,Portugalete,Basic services,electricity,-113.91,152321.95
buyer_7,María,56,ES04209572462335411521,TRX_N-00403-18206443,2022-10-07T14:25:48,Portugalete,Basic services,gas,-63.91,152258.04
buyer_7,María,56,ES04209572462335411521,TRX_N-00404-70833687,2022-10-07T19:32:12,Portugalete,Basic services,internet,-37.3,152220.74
buyer_7,María,56,ES04209572462335411521,TRX_N-00405-20285132,2022-10-07T17:46:04,Portugalete,Basic services,phone,-91.6,152129.14
buyer_7,María,56,ES04209572462335411521,TRX_N-00406-03033422,2022-10-10T09:03:43,Portugalete,Expense,clothing,-496.14,151633.0
buyer_7,María,56,ES04209572462335411521,TRX_N-00407-27343416,2022-10-25T19:24:28,Irun,Expense,transport,-190.87,151442.13
buyer_7,María,56,ES04209572462335411521,TRX_N-00408-70337445,2022-10-29T03:18:02,Portugalete,Expense,leisure,-59.8,151382.33
buyer_7,María,56,ES04209572462335411521,TRX_N-00409-12091480,2022-10-30T20:49:45,Portugalete,Expense,travel,-2730.39,148651.94
buyer_7,María,56,ES04209572462335411521,TRX_N-00410-46940025,2022-11-01T18:58:04,Portugalete,transfer,Salary,2932.42,151584.36
buyer_7,María,56,ES04209572462335411521,TRX_N-00411-04876472,2022-11-01T18:58:04,Portugalete,transfer,Partner Salary,3319.09,154903.45
buyer_7,María,56,ES04209572462335411521,TRX_N-00412-92687776,2022-11-01T18:58:04,Portugalete,transfer,Extra Income,293.24,155196.69
buyer_7,María,56,ES04209572462335411521,TRX_N-00413-22166760,2022-11-05T19:48:36,Portugalete,Housing,Mortgage,-1096.11,154100.58
buyer_7,María,56,ES04209572462335411521,TRX_N-00414-30545294,2022-11-05T08:44:53,Portugalete,Basic services,gas,-34.61,154065.97
buyer_7,María,56,ES04209572462335411521,TRX_N-00415-94746805,2022-11-05T14:46:59,Portugalete,Basic services,internet,-66.25,153999.72
buyer_7,María,56,ES04209572462335411521,TRX_N-00416-30938547,2022-11-06T08:50:04,Portugalete,Basic services,electricity,-26.62,153973.1
buyer_7,María,56,ES04209572462335411521,TRX_N-00417-36867358,2022-11-06T17:46:12,Portugalete,Basic services,gas,-15.01,153958.09
buyer_7,María,56,ES04209572462335411521,TRX_N-00418-75671240,2022-11-06T14:56:58,Portugalete,Expense,food,-363.0,153595.09
buyer_7,María,56,ES04209572462335411521,TRX_N-00419-32926771,2022-11-07T12:09:02,Portugalete,Basic services,phone,-76.62,153518.47
buyer_7,María,56,ES04209572462335411521,TRX_N-00420-75406979,2022-11-17T09:12:08,Leioa,Expense,clothing,-380.82,153137.65
buyer_7,María,56,ES04209572462335411521,TRX_N-00421-11351583,2022-11-29T10:12:57,Portugalete,Expense,clothing,-41.57,153096.08
buyer_7,María,56,ES04209572462335411521,TRX_N-00422-20503947,2022-12-01T11:56:47,Portugalete,transfer,Salary,2932.42,156028.5
buyer_7,María,56,ES04209572462335411521,TRX_N-00423-34692393,2022-12-01T11:56:47,Portugalete,transfer,Partner Salary,3319.09,159347.59
buyer_7,María,56,ES04209572462335411521,TRX_N-00424-89779907,2022-12-01T11:56:47,Portugalete,transfer,Bonus,2883.73,162231.32
buyer_7,María,56,ES04209572462335411521,TRX_N-00425-54766440,2022-12-05T20:20:01,Portugalete,Housing,Mortgage,-1096.11,161135.21
buyer_7,María,56,ES04209572462335411521,TRX_N-00426-52945129,2022-12-06T20:05:04,Portugalete,Basic services,internet,-68.72,161066.49
buyer_7,María,56,ES04209572462335411521,TRX_N-00427-99754846,2022-12-07T15:55:53,Portugalete,Basic services,gas,-86.53,160979.96
buyer_7,María,56,ES04209572462335411521,TRX_N-00428-08363620,2022-12-09T03:55:28,Portugalete,Expense,food,-349.08,160630.88
buyer_7,María,56,ES04209572462335411521,TRX_N-00429-13425208,2022-12-21T20:53:36,Portugalete,Expense,food,-109.59,160521.29
buyer_7,María,56,ES04209572462335411521,TRX_N-00430-49456874,2022-12-25T00:37:33,Portugalete,Expense,healthcare,-77.35,160443.94
buyer_7,María,56,ES04209572462335411521,TRX_N-00431-23027059,2022-12-31T18:28:59,Portugalete,Expense,food,-287.13,160156.81
buyer_7,María,56,ES04209572462335411521,TRX_N-00432-42868014,2023-01-01T14:47:38,Portugalete,transfer,Salary,2932.42,163089.23
buyer_7,María,56,ES04209572462335411521,TRX_N-00433-21164514,2023-01-01T14:47:38,Portugalete,transfer,Partner Salary,3319.09,166408.32
buyer_7,María,56,ES04209572462335411521,TRX_N-00434-43916996,2023-01-05T13:03:23,Portugalete,Housing,Mortgage,-1096.11,165312.21
buyer_7,María,56,ES04209572462335411521,TRX_N-00435-73419573,2023-01-05T11:38:32,Portugalete,Basic services,water,-47.79,165264.42
buyer_7,María,56,ES04209572462335411521,TRX_N-00436-45854340,2023-01-05T21:57:29,Portugalete,Basic services,internet,-78.19,165186.23
buyer_7,María,56,ES04209572462335411521,TRX_N-00437-80311167,2023-01-05T16:22:13,Portugalete,Basic services,phone,-61.14,165125.09
buyer_7,María,56,ES04209572462335411521,TRX_N-00438-37013498,2023-01-06T19:31:32,Portugalete,Basic services,gas,-73.25,165051.84
buyer_7,María,56,ES04209572462335411521,TRX_N-00439-50656566,2023-01-07T20:36:42,Portugalete,Basic services,phone,-97.3,164954.54
buyer_7,María,56,ES04209572462335411521,TRX_N-00440-74233224,2023-01-07T09:35:05,Portugalete,Expense,travel,-2281.97,162672.57
buyer_7,María,56,ES04209572462335411521,TRX_N-00441-93849960,2023-01-10T14:34:22,Mungia,Expense,healthcare,-201.7,162470.87
buyer_7,María,56,ES04209572462335411521,TRX_N-00442-62757847,2023-01-23T20:07:18,Portugalete,Expense,food,-207.18,162263.69
buyer_7,María,56,ES04209572462335411521,TRX_N-00443-01511268,2023-02-01T14:32:30,Portugalete,transfer,Salary,2932.42,165196.11
buyer_7,María,56,ES04209572462335411521,TRX_N-00444-93624860,2023-02-01T14:32:30,Portugalete,transfer,Partner Salary,3319.09,168515.2
buyer_7,María,56,ES04209572462335411521,TRX_N-00445-56016791,2023-02-01T14:32:30,Portugalete,transfer,Extra Income,293.24,168808.44
buyer_7,María,56,ES04209572462335411521,TRX_N-00446-47588742,2023-02-03T17:20:38,Portugalete,Expense,healthcare,-323.84,168484.6
buyer_7,María,56,ES04209572462335411521,TRX_N-00447-54705116,2023-02-05T01:55:21,Portugalete,Housing,Mortgage,-1096.11,167388.49
buyer_7,María,56,ES04209572462335411521,TRX_N-00448-51135109,2023-02-05T18:07:46,Portugalete,Basic services,electricity,-97.64,167290.85
buyer_7,María,56,ES04209572462335411521,TRX_N-00449-07338257,2023-02-05T06:51:15,Portugalete,Basic services,gas,-93.76,167197.09
buyer_7,María,56,ES04209572462335411521,TRX_N-00450-70547881,2023-02-05T11:37:45,Portugalete,Basic services,internet,-37.12,167159.97
buyer_7,María,56,ES04209572462335411521,TRX_N-00451-90252488,2023-02-06T18:47:21,Portugalete,Basic services,phone,-22.55,167137.42
buyer_7,María,56,ES04209572462335411521,TRX_N-00452-77335444,2023-02-07T16:16:04,Portugalete,Basic services,gas,-72.28,167065.14
buyer_7,María,56,ES04209572462335411521,TRX_N-00453-83723297,2023-02-07T17:27:58,Portugalete,Basic services,phone,-35.86,167029.28
buyer_7,María,56,ES04209572462335411521,TRX_N-00454-15857536,2023-02-07T21:05:25,Portugalete,Expense,healthcare,-224.78,166804.5
buyer_7,María,56,ES04209572462335411521,TRX_N-00455-62894065,2023-02-10T18:14:02,Portugalete,Expense,transport,-41.93,166762.57
buyer_7,María,56,ES04209572462335411521,TRX_N-00456-63999219,2023-03-01T20:40:30,Portugalete,transfer,Salary,2932.42,169694.99
buyer_7,María,56,ES04209572462335411521,TRX_N-00457-70498625,2023-03-01T20:40:30,Portugalete,transfer,Partner Salary,3319.09,173014.08
buyer_7,María,56,ES04209572462335411521,TRX_N-00458-58393417,2023-03-01T19:07:07,Mungia,Expense,food,-186.74,172827.34
buyer_7,María,56,ES04209572462335411521,TRX_N-00459-81522587,2023-03-04T20:03:02,Portugalete,Expense,food,-699.88,172127.46
buyer_7,María,56,ES04209572462335411521,TRX_N-00460-30674200,2023-03-05T08:40:24,Portugalete,Housing,Mortgage,-1096.11,171031.35
buyer_7,María,56,ES04209572462335411521,TRX_N-00461-58835815,2023-03-05T11:31:17,Portugalete,Basic services,electricity,-70.8,170960.55
buyer_7,María,56,ES04209572462335411521,TRX_N-00462-10112129,2023-03-05T16:01:37,Portugalete,Basic services,gas,-53.63,170906.92
buyer_7,María,56,ES04209572462335411521,TRX_N-00463-62210278,2023-03-06T20:04:47,Portugalete,Basic services,gas,-86.26,170820.66
buyer_7,María,56,ES04209572462335411521,TRX_N-00464-96021215,2023-03-06T22:31:50,Portugalete,Basic services,internet,-58.13,170762.53
buyer_7,María,56,ES04209572462335411521,TRX_N-00465-88272782,2023-03-07T17:55:30,Portugalete,Basic services,internet,-62.46,170700.07
buyer_7,María,56,ES04209572462335411521,TRX_N-00466-57424316,2023-03-20T16:30:08,Portugalete,Expense,food,-692.93,170007.14
buyer_7,María,56,ES04209572462335411521,TRX_N-00467-39544046,2023-03-22T14:46:01,Portugalete,Expense,clothing,-309.52,169697.62
buyer_7,María,56,ES04209572462335411521,TRX_N-00468-44877809,2023-04-01T20:56:07,Portugalete,transfer,Salary,2932.42,172630.04
buyer_7,María,56,ES04209572462335411521,TRX_N-00469-94573571,2023-04-01T20:56:07,Portugalete,transfer,Partner Salary,3319.09,175949.13
buyer_7,María,56,ES04209572462335411521,TRX_N-00470-48293369,2023-04-01T20:56:07,Portugalete,transfer,Extra Income,293.24,176242.37
buyer_7,María,56,ES04209572462335411521,TRX_N-00471-86672876,2023-04-05T13:44:39,Portugalete,Housing,Mortgage,-1096.11,175146.26
buyer_7,María,56,ES04209572462335411521,TRX_N-00472-24301519,2023-04-05T16:27:12,Portugalete,Basic services,water,-11.23,175135.03
buyer_7,María,56,ES04209572462335411521,TRX_N-00473-19668531,2023-04-06T18:33:46,Portugalete,Basic services,water,-21.68,175113.35
buyer_7,María,56,ES04209572462335411521,TRX_N-00474-85545505,2023-04-06T14:47:24,Portugalete,Basic services,gas,-81.59,175031.76
buyer_7,María,56,ES04209572462335411521,TRX_N-00475-87623881,2023-04-06T18:43:17,Portugalete,Basic services,internet,-40.78,174990.98
buyer_7,María,56,ES04209572462335411521,TRX_N-00476-55407834,2023-04-14T20:52:09,Portugalete,Expense,education,-923.06,174067.92
buyer_7,María,56,ES04209572462335411521,TRX_N-00477-75509501,2023-04-28T13:56:20,Portugalete,Expense,travel,-1689.28,172378.64
buyer_7,María,56,ES04209572462335411521,TRX_N-00478-35159677,2023-05-01T13:09:50,Portugalete,transfer,Salary,2932.42,175311.06
buyer_7,María,56,ES04209572462335411521,TRX_N-00479-33030298,2023-05-01T13:09:50,Portugalete,transfer,Partner Salary,3319.09,178630.15
buyer_7,María,56,ES04209572462335411521,TRX_N-00480-09211331,2023-05-05T20:22:38,Portugalete,Housing,Mortgage,-1096.11,177534.04
buyer_7,María,56,ES04209572462335411521,TRX_N-00481-10266066,2023-05-05T10:22:59,Portugalete,Basic services,gas,-90.16,177443.88
buyer_7,María,56,ES04209572462335411521,TRX_N-00482-19952039,2023-05-05T14:58:36,Portugalete,Basic services,internet,-53.35,177390.53
buyer_7,María,56,ES04209572462335411521,TRX_N-00483-72546928,2023-05-06T10:41:05,Portugalete,Basic services,water,-48.34,177342.19
buyer_7,María,56,ES04209572462335411521,TRX_N-00484-89261891,2023-05-06T17:25:13,Portugalete,Basic services,electricity,-90.24,177251.95
buyer_7,María,56,ES04209572462335411521,TRX_N-00485-95511882,2023-05-07T13:42:09,Portugalete,Basic services,electricity,-114.12,177137.83
buyer_7,María,56,ES04209572462335411521,TRX_N-00486-98779259,2023-05-07T10:43:58,Portugalete,Basic services,internet,-32.7,177105.13
buyer_7,María,56,ES04209572462335411521,TRX_N-00487-40525310,2023-05-07T13:41:55,Portugalete,Expense,leisure,-296.68,176808.45
buyer_7,María,56,ES04209572462335411521,TRX_N-00488-04208371,2023-05-16T23:50:33,Portugalete,Expense,food,-632.76,176175.69
buyer_7,María,56,ES04209572462335411521,TRX_N-00489-64097444,2023-06-01T13:53:46,Portugalete,transfer,Salary,2932.42,179108.11
buyer_7,María,56,ES04209572462335411521,TRX_N-00490-57756938,2023-06-01T13:53:46,Portugalete,transfer,Partner Salary,3319.09,182427.2
buyer_7,María,56,ES04209572462335411521,TRX_N-00491-63035163,2023-06-01T13:53:46,Portugalete,transfer,Bonus,2726.81,185154.01
buyer_7,María,56,ES04209572462335411521,TRX_N-00492-66596798,2023-06-05T15:47:52,Portugalete,Housing,Mortgage,-1096.11,184057.9
buyer_7,María,56,ES04209572462335411521,TRX_N-00493-41861656,2023-06-05T11:31:05,Portugalete,Basic services,water,-51.94,184005.96
buyer_7,María,56,ES04209572462335411521,TRX_N-00494-08698010,2023-06-05T15:50:21,Portugalete,Basic services,electricity,-34.83,183971.13
buyer_7,María,56,ES04209572462335411521,TRX_N-00495-80458879,2023-06-05T22:18:29,Portugalete,Basic services,internet,-41.92,183929.21
buyer_7,María,56,ES04209572462335411521,TRX_N-00496-58678663,2023-06-07T09:05:35,Portugalete,Basic services,electricity,-82.12,183847.09
buyer_7,María,56,ES04209572462335411521,TRX_N-00497-26081917,2023-06-19T13:59:07,Portugalete,Expense,clothing,-98.96,183748.13
buyer_7,María,56,ES04209572462335411521,TRX_N-00498-75765047,2023-06-22T03:43:24,Alegría-Dulantzi,Expense,food,-747.24,183000.89
buyer_7,María,56,ES04209572462335411521,TRX_N-00499-15056812,2023-07-01T10:10:13,Portugalete,transfer,Salary,2932.42,185933.31
buyer_7,María,56,ES04209572462335411521,TRX_N-00500-67690561,2023-07-01T10:10:13,Portugalete,transfer,Partner Salary,3319.09,189252.4
buyer_7,María,56,ES04209572462335411521,TRX_N-00501-18440774,2023-07-01T10:10:13,Portugalete,transfer,Extra Income,293.24,189545.64
buyer_7,María,56,ES04209572462335411521,TRX_N-00502-18180761,2023-07-04T20:44:40,Portugalete,Expense,food,-753.86,188791.78
buyer_7,María,56,ES04209572462335411521,TRX_N-00503-29302967,2023-07-05T21:24:50,Portugalete,Housing,Mortgage,-1096.11,187695.67
buyer_7,María,56,ES04209572462335411521,TRX_N-00504-07058702,2023-07-05T05:25:49,Portugalete,Basic services,gas,-29.07,187666.6
buyer_7,María,56,ES04209572462335411521,TRX_N-00505-83312584,2023-07-05T11:40:40,Portugalete,Basic services,phone,-48.52,187618.08
buyer_7,María,56,ES04209572462335411521,TRX_N-00506-06808542,2023-07-07T19:17:01,Portugalete,Basic services,water,-25.38,187592.7
buyer_7,María,56,ES04209572462335411521,TRX_N-00507-77808131,2023-07-07T14:07:39,Portugalete,Basic services,electricity,-139.47,187453.23
buyer_7,María,56,ES04209572462335411521,TRX_N-00508-25389917,2023-07-07T10:47:33,Portugalete,Basic services,internet,-61.58,187391.65
buyer_7,María,56,ES04209572462335411521,TRX_N-00509-76987989,2023-07-12T16:28:03,Portugalete,Expense,transport,-39.75,187351.9
buyer_7,María,56,ES04209572462335411521,TRX_N-00510-45182827,2023-07-13T13:26:01,Iruña de Oca,Expense,food,-650.55,186701.35
buyer_7,María,56,ES04209572462335411521,TRX_N-00511-63867868,2023-07-22T20:35:55,Portugalete,Expense,transport,-186.33,186515.02
buyer_7,María,56,ES04209572462335411521,TRX_N-00512-25139399,2023-07-29T09:49:24,Portugalete,Expense,food,-538.28,185976.74
buyer_7,María,56,ES04209572462335411521,TRX_N-00513-40103171,2023-07-29T11:17:01,Portugalete,Expense,leisure,-270.1,185706.64
buyer_7,María,56,ES04209572462335411521,TRX_N-00514-31086305,2023-08-01T18:21:04,Portugalete,transfer,Salary,2932.42,188639.06
buyer_7,María,56,ES04209572462335411521,TRX_N-00515-72485326,2023-08-01T18:21:04,Portugalete,transfer,Partner Salary,3319.09,191958.15
buyer_7,María,56,ES04209572462335411521,TRX_N-00516-82124257,2023-08-05T18:13:05,Portugalete,Housing,Mortgage,-1096.11,190862.04
buyer_7,María,56,ES04209572462335411521,TRX_N-00517-65949513,2023-08-05T07:10:24,Labastida/Bastida,Expense,food,-601.35,190260.69
buyer_7,María,56,ES04209572462335411521,TRX_N-00518-13061274,2023-08-05T07:52:35,Portugalete,Expense,clothing,-152.85,190107.84
buyer_7,María,56,ES04209572462335411521,TRX_N-00519-07926788,2023-08-06T17:23:09,Portugalete,Basic services,electricity,-100.89,190006.95
buyer_7,María,56,ES04209572462335411521,TRX_N-00520-35134341,2023-08-06T18:36:24,Portugalete,Basic services,internet,-60.72,189946.23
buyer_7,María,56,ES04209572462335411521,TRX_N-00521-98466201,2023-08-07T12:37:46,Portugalete,Basic services,water,-69.24,189876.99
buyer_7,María,56,ES04209572462335411521,TRX_N-00522-73596505,2023-08-07T19:47:45,Portugalete,Basic services,phone,-44.59,189832.4
buyer_7,María,56,ES04209572462335411521,TRX_N-00523-53229378,2023-08-07T18:27:51,Portugalete,Expense,food,-603.1,189229.3
buyer_7,María,56,ES04209572462335411521,TRX_N-00524-66761260,2023-08-09T14:50:29,Portugalete,Expense,leisure,-201.88,189027.42
buyer_7,María,56,ES04209572462335411521,TRX_N-00525-86225553,2023-08-20T17:13:15,Portugalete,Expense,transport,-66.7,188960.72
buyer_7,María,56,ES04209572462335411521,TRX_N-00526-00898884,2023-09-01T08:28:20,Portugalete,transfer,Salary,2932.42,191893.14
buyer_7,María,56,ES04209572462335411521,TRX_N-00527-85525825,2023-09-01T08:28:20,Portugalete,transfer,Partner Salary,3319.09,195212.23
buyer_7,María,56,ES04209572462335411521,TRX_N-00528-97498452,2023-09-05T00:46:16,Portugalete,Housing,Mortgage,-1096.11,194116.12
buyer_7,María,56,ES04209572462335411521,TRX_N-00529-44402406,2023-09-05T15:39:03,Portugalete,Basic services,gas,-91.6,194024.52
buyer_7,María,56,ES04209572462335411521,TRX_N-00530-82966234,2023-09-05T09:37:26,Portugalete,Basic services,phone,-33.04,193991.48
buyer_7,María,56,ES04209572462335411521,TRX_N-00531-88591884,2023-09-06T15:00:43,Portugalete,Basic services,water,-17.89,193973.59
buyer_7,María,56,ES04209572462335411521,TRX_N-00532-56656271,2023-09-07T08:00:09,Portugalete,Basic services,water,-22.1,193951.49
buyer_7,María,56,ES04209572462335411521,TRX_N-00533-47108753,2023-09-27T09:55:06,Portugalete,Expense,leisure,-221.62,193729.87
buyer_7,María,56,ES04209572462335411521,TRX_N-00534-10976570,2023-09-28T16:04:14,Portugalete,Expense,food,-311.81,193418.06
buyer_7,María,56,ES04209572462335411521,TRX_N-00535-00426206,2023-10-01T01:26:19,Portugalete,transfer,Salary,2932.42,196350.48
buyer_7,María,56,ES04209572462335411521,TRX_N-00536-84625438,2023-10-01T01:26:19,Portugalete,transfer,Partner Salary,3319.09,199669.57
buyer_7,María,56,ES04209572462335411521,TRX_N-00537-02962538,2023-10-01T01:26:19,Portugalete,transfer,Extra Income,293.24,199962.81
buyer_7,María,56,ES04209572462335411521,TRX_N-00538-79936905,2023-10-05T19:32:57,Portugalete,Housing,Mortgage,-1096.11,198866.7
buyer_7,María,56,ES04209572462335411521,TRX_N-00539-41591882,2023-10-05T17:50:27,Portugalete,Basic services,gas,-94.92,198771.78
buyer_7,María,56,ES04209572462335411521,TRX_N-00540-24673818,2023-10-05T20:21:31,Portugalete,Basic services,internet,-54.67,198717.11
buyer_7,María,56,ES04209572462335411521,TRX_N-00541-11466394,2023-10-06T10:52:33,Portugalete,Basic services,water,-32.97,198684.14
buyer_7,María,56,ES04209572462335411521,TRX_N-00542-87628137,2023-10-06T08:58:31,Portugalete,Basic services,phone,-36.47,198647.67
buyer_7,María,56,ES04209572462335411521,TRX_N-00543-45814351,2023-10-07T13:18:33,Portugalete,Basic services,internet,-30.78,198616.89
buyer_7,María,56,ES04209572462335411521,TRX_N-00544-24549084,2023-10-21T15:39:57,Portugalete,Expense,transport,-84.89,198532.0
buyer_7,María,56,ES04209572462335411521,TRX_N-00545-61684762,2023-10-26T13:30:58,Portugalete,Expense,repairs,-910.53,197621.47
buyer_7,María,56,ES04209572462335411521,TRX_N-00546-22321703,2023-10-29T13:19:31,Erandio,Expense,gifts,-299.47,197322.0
buyer_7,María,56,ES04209572462335411521,TRX_N-00547-68670406,2023-11-01T19:19:52,Portugalete,transfer,Salary,2932.42,200254.42
buyer_7,María,56,ES04209572462335411521,TRX_N-00548-46953767,2023-11-01T19:19:52,Portugalete,transfer,Partner Salary,3319.09,203573.51
buyer_7,María,56,ES04209572462335411521,TRX_N-00549-13191203,2023-11-05T12:39:45,Portugalete,Housing,Mortgage,-1096.11,202477.4
buyer_7,María,56,ES04209572462335411521,TRX_N-00550-87878444,2023-11-05T17:11:38,Portugalete,Basic services,water,-27.92,202449.48
buyer_7,María,56,ES04209572462335411521,TRX_N-00551-27504693,2023-11-05T23:46:29,Portugalete,Basic services,gas,-92.53,202356.95
buyer_7,María,56,ES04209572462335411521,TRX_N-00552-56082904,2023-11-05T17:37:47,Portugalete,Basic services,internet,-38.61,202318.34
buyer_7,María,56,ES04209572462335411521,TRX_N-00553-15448370,2023-11-06T23:39:11,Portugalete,Basic services,gas,-62.48,202255.86
buyer_7,María,56,ES04209572462335411521,TRX_N-00554-18253308,2023-11-07T12:55:06,Portugalete,Basic services,internet,-57.07,202198.79
buyer_7,María,56,ES04209572462335411521,TRX_N-00555-54421929,2023-11-20T10:35:44,Portugalete,Expense,transport,-124.59,202074.2
buyer_7,María,56,ES04209572462335411521,TRX_N-00556-55472640,2023-11-21T10:18:09,Portugalete,Expense,repairs,-588.61,201485.59
buyer_7,María,56,ES04209572462335411521,TRX_N-00557-75225441,2023-12-01T01:00:31,Portugalete,transfer,Salary,2932.42,204418.01
buyer_7,María,56,ES04209572462335411521,TRX_N-00558-25131440,2023-12-01T01:00:31,Portugalete,transfer,Partner Salary,3319.09,207737.1
buyer_7,María,56,ES04209572462335411521,TRX_N-00559-59724639,2023-12-01T01:00:31,Portugalete,transfer,Extra Income,293.24,208030.34
buyer_7,María,56,ES04209572462335411521,TRX_N-00560-87117356,2023-12-01T01:00:31,Portugalete,transfer,Bonus,3066.41,211096.75
buyer_7,María,56,ES04209572462335411521,TRX_N-00561-89542751,2023-12-05T16:27:48,Portugalete,Housing,Mortgage,-1096.11,210000.64
buyer_7,María,56,ES04209572462335411521,TRX_N-00562-77062201,2023-12-05T11:43:59,Portugalete,Basic services,electricity,-46.64,209954.0
buyer_7,María,56,ES04209572462335411521,TRX_N-00563-15372766,2023-12-05T20:46:38,Portugalete,Basic services,gas,-78.39,209875.61
buyer_7,María,56,ES04209572462335411521,TRX_N-00564-30218736,2023-12-05T10:09:27,Portugalete,Basic services,internet,-37.27,209838.34
buyer_7,María,56,ES04209572462335411521,TRX_N-00565-38062057,2023-12-06T15:07:47,Portugalete,Basic services,water,-57.29,209781.05
buyer_7,María,56,ES04209572462335411521,TRX_N-00566-85631486,2023-12-07T19:43:02,Portugalete,Basic services,electricity,-85.16,209695.89
buyer_7,María,56,ES04209572462335411521,TRX_N-00567-61465088,2023-12-07T03:05:10,Portugalete,Basic services,internet,-38.07,209657.82
buyer_7,María,56,ES04209572462335411521,TRX_N-00568-61882655,2023-12-07T09:57:49,Portugalete,Basic services,phone,-64.71,209593.11
buyer_7,María,56,ES04209572462335411521,TRX_N-00569-37511754,2023-12-08T13:00:53,Portugalete,Expense,food,-604.97,208988.14
buyer_7,María,56,ES04209572462335411521,TRX_N-00570-76655849,2023-12-10T19:00:49,Labastida/Bastida,Expense,repairs,-489.86,208498.28
buyer_7,María,56,ES04209572462335411521,TRX_N-00571-32055782,2024-01-01T09:22:40,Portugalete,transfer,Salary,2932.42,211430.7
buyer_7,María,56,ES04209572462335411521,TRX_N-00572-88142758,2024-01-01T09:22:40,Portugalete,transfer,Partner Salary,3319.09,214749.79
buyer_7,María,56,ES04209572462335411521,TRX_N-00573-95961737,2024-01-05T02:18:36,Portugalete,Housing,Mortgage,-1096.11,213653.68
buyer_7,María,56,ES04209572462335411521,TRX_N-00574-72027997,2024-01-05T17:41:10,Portugalete,Basic services,electricity,-74.34,213579.34
buyer_7,María,56,ES04209572462335411521,TRX_N-00575-48261554,2024-01-05T14:37:31,Portugalete,Basic services,gas,-58.22,213521.12
buyer_7,María,56,ES04209572462335411521,TRX_N-00576-95629935,2024-01-05T21:17:54,Portugalete,Basic services,phone,-64.72,213456.4
buyer_7,María,56,ES04209572462335411521,TRX_N-00577-68376159,2024-01-06T21:06:36,Portugalete,Basic services,water,-56.6,213399.8
buyer_7,María,56,ES04209572462335411521,TRX_N-00578-06268780,2024-01-07T11:20:51,Portugalete,Basic services,internet,-50.32,213349.48
buyer_7,María,56,ES04209572462335411521,TRX_N-00579-10040010,2024-02-01T13:28:02,Portugalete,transfer,Salary,2932.42,216281.9
buyer_7,María,56,ES04209572462335411521,TRX_N-00580-94341025,2024-02-01T13:28:02,Portugalete,transfer,Partner Salary,3319.09,219600.99
buyer_7,María,56,ES04209572462335411521,TRX_N-00581-05996050,2024-02-01T13:28:02,Portugalete,transfer,Extra Income,293.24,219894.23
buyer_7,María,56,ES04209572462335411521,TRX_N-00582-89714571,2024-02-05T01:16:21,Portugalete,Housing,Mortgage,-1096.11,218798.12
buyer_7,María,56,ES04209572462335411521,TRX_N-00583-34251117,2024-02-05T09:00:41,Portugalete,Basic services,water,-56.2,218741.92
buyer_7,María,56,ES04209572462335411521,TRX_N-00584-19032787,2024-02-05T12:04:21,Portugalete,Basic services,gas,-68.59,218673.33
buyer_7,María,56,ES04209572462335411521,TRX_N-00585-69102379,2024-02-06T23:10:27,Portugalete,Basic services,gas,-99.97,218573.36
buyer_7,María,56,ES04209572462335411521,TRX_N-00586-97159281,2024-02-06T20:43:22,Portugalete,Basic services,internet,-31.04,218542.32
buyer_7,María,56,ES04209572462335411521,TRX_N-00587-54400805,2024-02-07T10:47:42,Portugalete,Basic services,internet,-42.13,218500.19
buyer_7,María,56,ES04209572462335411521,TRX_N-00588-05859381,2024-02-07T19:38:20,Portugalete,Basic services,phone,-27.57,218472.62
buyer_7,María,56,ES04209572462335411521,TRX_N-00589-84316192,2024-02-07T12:47:55,Portugalete,Expense,clothing,-347.47,218125.15
buyer_7,María,56,ES04209572462335411521,TRX_N-00590-55317317,2024-02-20T12:27:24,Labastida/Bastida,Expense,clothing,-34.4,218090.75
buyer_7,María,56,ES04209572462335411521,TRX_N-00591-53540111,2024-02-21T03:25:55,Oyón-Oion,Expense,food,-481.85,217608.9
buyer_7,María,56,ES04209572462335411521,TRX_N-00592-58861625,2024-02-21T13:52:10,Portugalete,Expense,transport,-26.92,217581.98
buyer_7,María,56,ES04209572462335411521,TRX_N-00593-50599817,2024-02-24T17:42:12,Irun,Expense,transport,-142.12,217439.86
buyer_7,María,56,ES04209572462335411521,TRX_N-00594-46304066,2024-02-24T07:04:40,Portugalete,Expense,gifts,-171.13,217268.73
buyer_7,María,56,ES04209572462335411521,TRX_N-00595-03365936,2024-02-29T13:08:54,Portugalete,Expense,transport,-125.53,217143.2
buyer_7,María,56,ES04209572462335411521,TRX_N-00596-21643060,2024-03-01T10:58:43,Portugalete,transfer,Salary,2932.42,220075.62
buyer_7,María,56,ES04209572462335411521,TRX_N-00597-03204114,2024-03-01T10:58:43,Portugalete,transfer,Partner Salary,3319.09,223394.71
buyer_7,María,56,ES04209572462335411521,TRX_N-00598-65831890,2024-03-03T17:53:39,Portugalete,Expense,leisure,-229.64,223165.07
buyer_7,María,56,ES04209572462335411521,TRX_N-00599-49215702,2024-03-05T13:44:39,Portugalete,Housing,Mortgage,-1096.11,222068.96
buyer_7,María,56,ES04209572462335411521,TRX_N-00600-37296603,2024-03-05T14:54:13,Portugalete,Basic services,water,-60.59,222008.37
buyer_7,María,56,ES04209572462335411521,TRX_N-00601-28637391,2024-03-05T10:24:15,Portugalete,Basic services,electricity,-99.65,221908.72
buyer_7,María,56,ES04209572462335411521,TRX_N-00602-94948380,2024-03-05T16:27:35,Portugalete,Basic services,internet,-59.0,221849.72
buyer_7,María,56,ES04209572462335411521,TRX_N-00603-81086206,2024-03-05T16:12:49,Portugalete,Basic services,phone,-55.12,221794.6
buyer_7,María,56,ES04209572462335411521,TRX_N-00604-89095275,2024-03-06T03:28:26,Portugalete,Basic services,electricity,-75.48,221719.12
buyer_7,María,56,ES04209572462335411521,TRX_N-00605-87373829,2024-03-06T13:30:23,Portugalete,Basic services,internet,-46.93,221672.19
buyer_7,María,56,ES04209572462335411521,TRX_N-00606-67398594,2024-03-07T08:23:00,Portugalete,Basic services,phone,-76.88,221595.31
buyer_7,María,56,ES04209572462335411521,TRX_N-00607-74875854,2024-03-11T04:12:39,Portugalete,Expense,healthcare,-49.55,221545.76
buyer_7,María,56,ES04209572462335411521,TRX_N-00608-26996204,2024-03-20T13:36:14,Portugalete,Expense,healthcare,-253.73,221292.03
buyer_7,María,56,ES04209572462335411521,TRX_N-00609-68088714,2024-03-25T13:41:37,Portugalete,Expense,travel,-2121.23,219170.8
buyer_7,María,56,ES04209572462335411521,TRX_N-00610-11266447,2024-04-01T15:59:54,Portugalete,transfer,Salary,2932.42,222103.22
buyer_7,María,56,ES04209572462335411521,TRX_N-00611-45335569,2024-04-01T15:59:54,Portugalete,transfer,Partner Salary,3319.09,225422.31
buyer_7,María,56,ES04209572462335411521,TRX_N-00612-34521193,2024-04-03T09:20:31,Portugalete,Expense,food,-329.38,225092.93
buyer_7,María,56,ES04209572462335411521,TRX_N-00613-72955890,2024-04-05T17:49:51,Portugalete,Housing,Mortgage,-1096.11,223996.82
buyer_7,María,56,ES04209572462335411521,TRX_N-00614-58084129,2024-04-05T11:26:59,Portugalete,Basic services,electricity,-121.06,223875.76
buyer_7,María,56,ES04209572462335411521,TRX_N-00615-12040492,2024-04-05T11:39:43,Portugalete,Basic services,phone,-43.11,223832.65
buyer_7,María,56,ES04209572462335411521,TRX_N-00616-08100094,2024-04-06T17:25:39,Portugalete,Basic services,internet,-51.99,223780.66
buyer_7,María,56,ES04209572462335411521,TRX_N-00617-45745542,2024-04-06T15:26:32,Portugalete,Basic services,phone,-71.9,223708.76
buyer_7,María,56,ES04209572462335411521,TRX_N-00618-61155889,2024-04-07T20:23:48,Portugalete,Basic services,gas,-15.59,223693.17
buyer_7,María,56,ES04209572462335411521,TRX_N-00619-43246455,2024-04-20T08:42:45,Portugalete,Expense,leisure,-145.52,223547.65
buyer_7,María,56,ES04209572462335411521,TRX_N-00620-96583209,2024-04-22T09:11:31,Portugalete,Expense,leisure,-114.15,223433.5
buyer_7,María,56,ES04209572462335411521,TRX_N-00621-34756034,2024-05-01T08:25:41,Portugalete,transfer,Salary,2932.42,226365.92
buyer_7,María,56,ES04209572462335411521,TRX_N-00622-35286095,2024-05-01T08:25:41,Portugalete,transfer,Partner Salary,3319.09,229685.01
buyer_7,María,56,ES04209572462335411521,TRX_N-00623-84856146,2024-05-01T08:25:41,Portugalete,transfer,Extra Income,293.24,229978.25
buyer_7,María,56,ES04209572462335411521,TRX_N-00624-54952294,2024-05-05T20:59:54,Portugalete,Housing,Mortgage,-1096.11,228882.14
buyer_7,María,56,ES04209572462335411521,TRX_N-00625-24985661,2024-05-05T20:02:17,Portugalete,Basic services,water,-52.19,228829.95
buyer_7,María,56,ES04209572462335411521,TRX_N-00626-08965568,2024-05-07T08:09:32,Portugalete,Basic services,electricity,-59.76,228770.19
buyer_7,María,56,ES04209572462335411521,TRX_N-00627-03915593,2024-05-11T09:02:08,Portugalete,Expense,repairs,-626.5,228143.69
buyer_7,María,56,ES04209572462335411521,TRX_N-00628-11080299,2024-05-12T15:01:34,Portugalete,Expense,leisure,-115.04,228028.65
buyer_7,María,56,ES04209572462335411521,TRX_N-00629-44424815,2024-05-13T11:01:05,Portugalete,Expense,repairs,-935.2,227093.45
buyer_7,María,56,ES04209572462335411521,TRX_N-00630-97758669,2024-06-01T20:40:49,Portugalete,transfer,Salary,2932.42,230025.87
buyer_7,María,56,ES04209572462335411521,TRX_N-00631-43678062,2024-06-01T20:40:49,Portugalete,transfer,Partner Salary,3319.09,233344.96
buyer_7,María,56,ES04209572462335411521,TRX_N-00632-10707220,2024-06-01T20:40:49,Portugalete,transfer,Bonus,2688.3,236033.26
buyer_7,María,56,ES04209572462335411521,TRX_N-00633-89141116,2024-06-02T08:58:10,Portugalete,Expense,gifts,-366.49,235666.77
buyer_7,María,56,ES04209572462335411521,TRX_N-00634-54749374,2024-06-05T09:31:39,Portugalete,Housing,Mortgage,-1096.11,234570.66
buyer_7,María,56,ES04209572462335411521,TRX_N-00635-71312757,2024-06-05T16:13:19,Portugalete,Basic services,phone,-94.74,234475.92
buyer_7,María,56,ES04209572462335411521,TRX_N-00636-62072540,2024-06-05T16:21:01,Lasarte-Oria,Expense,leisure,-30.28,234445.64
buyer_7,María,56,ES04209572462335411521,TRX_N-00637-74777225,2024-06-06T22:43:16,Portugalete,Basic services,gas,-70.87,234374.77
buyer_7,María,56,ES04209572462335411521,TRX_N-00638-92095636,2024-06-07T17:54:56,Portugalete,Basic services,water,-44.85,234329.92
buyer_7,María,56,ES04209572462335411521,TRX_N-00639-17532388,2024-06-07T12:23:48,Portugalete,Expense,food,-122.41,234207.51
buyer_7,María,56,ES04209572462335411521,TRX_N-00640-01511959,2024-06-07T15:33:13,Portugalete,Expense,leisure,-251.74,233955.77
buyer_7,María,56,ES04209572462335411521,TRX_N-00641-43961827,2024-06-18T09:34:07,Pasaia,Expense,food,-157.67,233798.1
buyer_7,María,56,ES04209572462335411521,TRX_N-00642-45235698,2024-07-01T18:51:20,Portugalete,transfer,Salary,2932.42,236730.52
buyer_7,María,56,ES04209572462335411521,TRX_N-00643-47219825,2024-07-01T18:51:20,Portugalete,transfer,Partner Salary,3319.09,240049.61
buyer_7,María,56,ES04209572462335411521,TRX_N-00644-35930780,2024-07-04T10:45:41,Portugalete,Expense,transport,-48.69,240000.92
buyer_7,María,56,ES04209572462335411521,TRX_N-00645-01868356,2024-07-05T05:37:45,Portugalete,Housing,Mortgage,-1096.11,238904.81
buyer_7,María,56,ES04209572462335411521,TRX_N-00646-72445854,2024-07-05T10:04:45,Portugalete,Basic services,gas,-81.8,238823.01
buyer_7,María,56,ES04209572462335411521,TRX_N-00647-22866198,2024-07-05T13:12:53,Portugalete,Basic services,internet,-46.4,238776.61
buyer_7,María,56,ES04209572462335411521,TRX_N-00648-64360509,2024-07-06T09:29:35,Portugalete,Basic services,electricity,-147.7,238628.91
buyer_7,María,56,ES04209572462335411521,TRX_N-00649-15828393,2024-07-06T11:02:48,Portugalete,Basic services,gas,-24.14,238604.77
buyer_7,María,56,ES04209572462335411521,TRX_N-00650-67198923,2024-07-06T13:30:31,Portugalete,Basic services,internet,-73.23,238531.54
buyer_7,María,56,ES04209572462335411521,TRX_N-00651-23057243,2024-07-07T11:20:39,Portugalete,Basic services,water,-32.41,238499.13
buyer_7,María,56,ES04209572462335411521,TRX_N-00652-23048867,2024-07-07T19:39:03,Portugalete,Basic services,electricity,-25.08,238474.05
buyer_7,María,56,ES04209572462335411521,TRX_N-00653-49608639,2024-07-07T17:10:58,Portugalete,Basic services,internet,-76.38,238397.67
buyer_7,María,56,ES04209572462335411521,TRX_N-00654-45240520,2024-07-07T00:24:38,Portugalete,Basic services,phone,-90.4,238307.27
buyer_7,María,56,ES04209572462335411521,TRX_N-00655-85537496,2024-07-28T13:29:11,Portugalete,Expense,leisure,-11.93,238295.34
buyer_7,María,56,ES04209572462335411521,TRX_N-00656-73482806,2024-07-30T17:19:48,Galdakao,Expense,appliances,-1772.0,236523.34
buyer_7,María,56,ES04209572462335411521,TRX_N-00657-76788074,2024-08-01T03:59:39,Portugalete,transfer,Salary,2932.42,239455.76
buyer_7,María,56,ES04209572462335411521,TRX_N-00658-50181920,2024-08-01T03:59:39,Portugalete,transfer,Partner Salary,3319.09,242774.85
buyer_7,María,56,ES04209572462335411521,TRX_N-00659-02897047,2024-08-01T03:59:39,Portugalete,transfer,Extra Income,293.24,243068.09
buyer_7,María,56,ES04209572462335411521,TRX_N-00660-90797102,2024-08-04T23:29:22,Portugalete,Expense,education,-212.79,242855.3
buyer_7,María,56,ES04209572462335411521,TRX_N-00661-47834485,2024-08-05T14:50:46,Portugalete,Housing,Mortgage,-1096.11,241759.19
buyer_7,María,56,ES04209572462335411521,TRX_N-00662-23920089,2024-08-06T07:32:22,Portugalete,Basic services,water,-42.5,241716.69
buyer_7,María,56,ES04209572462335411521,TRX_N-00663-83779861,2024-08-06T15:22:26,Portugalete,Basic services,internet,-71.92,241644.77
buyer_7,María,56,ES04209572462335411521,TRX_N-00664-63601188,2024-08-07T17:54:19,Portugalete,Basic services,water,-34.78,241609.99
buyer_7,María,56,ES04209572462335411521,TRX_N-00665-37555983,2024-08-07T17:23:19,Portugalete,Basic services,electricity,-147.01,241462.98
buyer_7,María,56,ES04209572462335411521,TRX_N-00666-73172896,2024-08-11T18:36:44,Portugalete,Expense,food,-311.03,241151.95
buyer_7,María,56,ES04209572462335411521,TRX_N-00667-65163049,2024-08-28T16:00:22,Getxo,Expense,clothing,-234.3,240917.65
buyer_7,María,56,ES04209572462335411521,TRX_N-00668-80572898,2024-09-01T18:52:07,Portugalete,transfer,Salary,2932.42,243850.07
buyer_7,María,56,ES04209572462335411521,TRX_N-00669-14027788,2024-09-01T18:52:07,Portugalete,transfer,Partner Salary,3319.09,247169.16
buyer_7,María,56,ES04209572462335411521,TRX_N-00670-67271680,2024-09-02T19:08:45,Getxo,Expense,food,-464.87,246704.29
buyer_7,María,56,ES04209572462335411521,TRX_N-00671-67724303,2024-09-05T18:31:16,Portugalete,Housing,Mortgage,-1096.11,245608.18
buyer_7,María,56,ES04209572462335411521,TRX_N-00672-12231603,2024-09-05T08:26:33,Portugalete,Basic services,gas,-98.05,245510.13
buyer_7,María,56,ES04209572462335411521,TRX_N-00673-36147670,2024-09-05T11:39:48,Portugalete,Basic services,internet,-71.38,245438.75
buyer_7,María,56,ES04209572462335411521,TRX_N-00674-64767790,2024-09-06T20:47:03,Portugalete,Basic services,phone,-74.38,245364.37
buyer_7,María,56,ES04209572462335411521,TRX_N-00675-50627534,2024-09-07T19:11:02,Portugalete,Basic services,electricity,-139.27,245225.1
buyer_7,María,56,ES04209572462335411521,TRX_N-00676-28838033,2024-09-07T18:05:08,Portugalete,Basic services,gas,-46.4,245178.7
buyer_7,María,56,ES04209572462335411521,TRX_N-00677-62455138,2024-09-07T12:58:12,Portugalete,Basic services,phone,-71.06,245107.64
buyer_7,María,56,ES04209572462335411521,TRX_N-00678-94871189,2024-09-07T17:27:47,Portugalete,Expense,education,-93.71,245013.93
buyer_7,María,56,ES04209572462335411521,TRX_N-00679-00170781,2024-09-14T08:03:25,Hondarribia,Expense,transport,-125.7,244888.23
buyer_7,María,56,ES04209572462335411521,TRX_N-00680-77355193,2024-10-01T15:52:52,Portugalete,transfer,Salary,2932.42,247820.65
buyer_7,María,56,ES04209572462335411521,TRX_N-00681-77902453,2024-10-01T15:52:52,Portugalete,transfer,Partner Salary,3319.09,251139.74
buyer_7,María,56,ES04209572462335411521,TRX_N-00682-55749120,2024-10-01T15:52:52,Portugalete,transfer,Extra Income,293.24,251432.98
buyer_7,María,56,ES04209572462335411521,TRX_N-00683-93218582,2024-10-03T19:37:46,Portugalete,Expense,clothing,-114.83,251318.15
buyer_7,María,56,ES04209572462335411521,TRX_N-00684-27991326,2024-10-05T12:36:24,Portugalete,Housing,Mortgage,-1096.11,250222.04
buyer_7,María,56,ES04209572462335411521,TRX_N-00685-04150376,2024-10-05T14:36:09,Portugalete,Basic services,internet,-38.13,250183.91
buyer_7,María,56,ES04209572462335411521,TRX_N-00686-99944559,2024-10-06T10:13:24,Portugalete,Basic services,electricity,-50.57,250133.34
buyer_7,María,56,ES04209572462335411521,TRX_N-00687-15919646,2024-10-06T20:20:37,Portugalete,Basic services,phone,-69.97,250063.37
buyer_7,María,56,ES04209572462335411521,TRX_N-00688-78933088,2024-10-07T11:18:04,Portugalete,Basic services,water,-73.79,249989.58
buyer_7,María,56,ES04209572462335411521,TRX_N-00689-06859267,2024-10-07T11:31:27,Portugalete,Basic services,electricity,-52.55,249937.03
buyer_8,Antonio,45,ES81209592270525302184,TRX_N-00001-10136483,2020-01-01T11:16:01,Labastida,transfer,Salary,1912.39,4489.85
buyer_8,Antonio,45,ES81209592270525302184,TRX_N-00002-07776507,2020-01-05T19:01:19,Labastida,Housing,Mortgage,-978.24,3511.61
buyer_8,Antonio,45,ES81209592270525302184,TRX_N-00003-05976230,2020-01-05T15:19:05,Labastida,Basic services,electricity,-79.97,3431.64
buyer_8,Antonio,45,ES81209592270525302184,TRX_N-00004-05863967,2020-01-05T13:49:23,Labastida,Basic services,gas,-42.55,3389.09
buyer_8,Antonio,45,ES81209592270525302184,TRX_N-00005-47654633,2020-01-05T18:32:04,Labastida,Basic services,phone,-61.29,3327.8
buyer_8,Antonio,45,ES81209592270525302184,TRX_N-00006-25262234,2020-01-06T08:31:24,Labastida,Basic services,phone,-85.06,3242.74
buyer_8,Antonio,45,ES81209592270525302184,TRX_N-00007-02310571,2020-01-07T16:57:29,Labastida,Basic services,internet,-37.22,3205.52
buyer_8,Antonio,45,ES81209592270525302184,TRX_N-00008-78011624,2020-01-15T18:57:27,Labastida,Expense,food,-294.61,2910.91
buyer_8,Antonio,45,ES81209592270525302184,TRX_N-00009-37867325,2020-01-15T19:13:58,Labastida,Expense,transport,-166.54,2744.37
buyer_8,Antonio,45,ES81209592270525302184,TRX_N-00010-35462722,2020-01-23T10:37:24,Labastida,Expense,travel,-600.03,2144.34
buyer_8,Antonio,45,ES81209592270525302184,TRX_N-00011-58115830,2020-01-25T14:33:06,Labastida,Expense,leisure,-253.05,1891.29
buyer_8,Antonio,45,ES81209592270525302184,TRX_N-00012-50662747,2020-02-01T23:34:52,Labastida,transfer,Salary,1912.39,3803.68
buyer_8,Antonio,45,ES81209592270525302184,TRX_N-00013-13085314,2020-02-01T23:34:52,Labastida,transfer,Extra Income,191.24,3994.92
buyer_8,Antonio,45,ES81209592270525302184,TRX_N-00014-28916686,2020-02-04T12:53:51,Labastida,Expense,food,-715.46,3279.46
buyer_8,Antonio,45,ES81209592270525302184,TRX_N-00015-14782929,2020-02-05T18:37:36,Labastida,Housing,Mortgage,-978.24,2301.22
buyer_8,Antonio,45,ES81209592270525302184,TRX_N-00016-13838723,2020-02-05T23:44:40,Labastida,Basic services,water,-23.58,2277.64
buyer_8,Antonio,45,ES81209592270525302184,TRX_N-00017-89034192,2020-02-05T10:43:17,Labastida,Basic services,gas,-38.72,2238.92
buyer_8,Antonio,45,ES81209592270525302184,TRX_N-00018-37838785,2020-02-06T15:18:07,Labastida,Basic services,internet,-77.15,2161.77
buyer_8,Antonio,45,ES81209592270525302184,TRX_N-00019-71435868,2020-02-06T19:28:11,Labastida,Basic services,phone,-20.72,2141.05
buyer_8,Antonio,45,ES81209592270525302184,TRX_N-00020-92052169,2020-02-07T09:07:02,Labastida,Basic services,water,-28.88,2112.17
buyer_8,Antonio,45,ES81209592270525302184,TRX_N-00021-43788113,2020-02-07T06:40:30,Labastida,Basic services,gas,-76.67,2035.5
buyer_8,Antonio,45,ES81209592270525302184,TRX_N-00022-92537686,2020-02-08T12:42:19,Eibar,Expense,food,-676.81,1358.69
buyer_8,Antonio,45,ES81209592270525302184,TRX_N-00023-25786572,2020-03-01T20:55:41,Labastida,transfer,Salary,1912.39,3271.08
buyer_8,Antonio,45,ES81209592270525302184,TRX_N-00024-15312097,2020-03-01T08:53:11,Labastida,Expense,clothing,-83.06,3188.02
buyer_8,Antonio,45,ES81209592270525302184,TRX_N-00025-50045867,2020-03-05T12:42:02,Labastida,Housing,Mortgage,-978.24,2209.78
buyer_8,Antonio,45,ES81209592270525302184,TRX_N-00026-58472279,2020-03-05T08:50:29,Labastida,Basic services,phone,-24.03,2185.75
buyer_8,Antonio,45,ES81209592270525302184,TRX_N-00027-46160898,2020-03-10T15:11:10,Labastida,Expense,education,-891.07,1294.68
buyer_8,Antonio,45,ES81209592270525302184,TRX_N-00028-11162934,2020-03-19T16:39:23,Salvatierra/Agurain,Expense,food,-555.36,739.32
buyer_8,Antonio,45,ES81209592270525302184,TRX_N-00029-08879566,2020-03-21T10:40:18,Labastida,Expense,healthcare,-219.12,520.2
buyer_8,Antonio,45,ES81209592270525302184,TRX_N-00030-91264816,2020-03-25T14:56:46,Labastida,Expense,food,-404.84,115.36
buyer_8,Antonio,45,ES81209592270525302184,TRX_N-00031-77905184,2020-04-01T18:46:06,Labastida,transfer,Salary,1912.39,2027.75
buyer_8,Antonio,45,ES81209592270525302184,TRX_N-00032-08538133,2020-04-01T18:46:06,Labastida,transfer,Extra Income,191.24,2218.99
buyer_8,Antonio,45,ES81209592270525302184,TRX_N-00033-96592893,2020-04-01T16:20:29,Labastida,Expense,food,-673.06,1545.93
buyer_8,Antonio,45,ES81209592270525302184,TRX_N-00034-64244460,2020-04-05T18:00:02,Labastida,Housing,Mortgage,-978.24,567.69
buyer_8,Antonio,45,ES81209592270525302184,TRX_N-00035-89258176,2020-04-05T11:33:43,Labastida,Basic services,electricity,-90.71,476.98
buyer_8,Antonio,45,ES81209592270525302184,TRX_N-00036-13633171,2020-04-05T19:59:23,Labastida,Basic services,phone,-72.66,404.32
buyer_8,Antonio,45,ES81209592270525302184,TRX_N-00037-15694955,2020-04-06T20:40:25,Labastida,Basic services,gas,-98.96,305.36
buyer_8,Antonio,45,ES81209592270525302184,TRX_N-00038-17008048,2020-04-07T13:01:25,Labastida,Basic services,electricity,-89.38,215.98
buyer_8,Antonio,45,ES81209592270525302184,TRX_N-00039-07247774,2020-04-07T18:35:00,Labastida,Basic services,internet,-35.43,180.55
buyer_8,Antonio,45,ES81209592270525302184,TRX_N-00040-44257783,2020-04-07T17:20:09,Labastida,Basic services,phone,-29.98,150.57
buyer_8,Antonio,45,ES81209592270525302184,TRX_N-00041-68300015,2020-04-08T13:39:48,Labastida,Expense,food,-445.22,-294.65
buyer_8,Antonio,45,ES81209592270525302184,TRX_N-00042-75251219,2020-04-22T11:09:29,Labastida,Expense,leisure,-68.2,-362.85
buyer_8,Antonio,45,ES81209592270525302184,TRX_N-00043-08355616,2020-04-22T19:24:24,Labastida,Expense,gifts,-350.06,-712.91
buyer_8,Antonio,45,ES81209592270525302184,TRX_N-00044-50621939,2020-04-28T16:16:44,Labastida,Expense,healthcare,-132.39,-845.3
buyer_8,Antonio,45,ES81209592270525302184,TRX_N-00045-12457339,2020-04-30T07:41:42,Leioa,Expense,food,-211.44,-1056.74
buyer_8,Antonio,45,ES81209592270525302184,TRX_N-00046-00342021,2020-05-01T13:01:09,Labastida,transfer,Salary,1912.39,855.65
buyer_8,Antonio,45,ES81209592270525302184,TRX_N-00047-05381492,2020-05-02T15:35:36,Labastida,Expense,clothing,-207.46,648.19
buyer_8,Antonio,45,ES81209592270525302184,TRX_N-00048-93990318,2020-05-05T10:11:59,Labastida,Housing,Mortgage,-978.24,-330.05
buyer_8,Antonio,45,ES81209592270525302184,TRX_N-00049-70402584,2020-05-05T19:39:13,Labastida,Basic services,electricity,-36.28,-366.33
buyer_8,Antonio,45,ES81209592270525302184,TRX_N-00050-80226985,2020-05-05T19:15:09,Labastida,Basic services,internet,-79.91,-446.24
buyer_8,Antonio,45,ES81209592270525302184,TRX_N-00051-63596751,2020-05-05T20:29:16,Labastida,Basic services,phone,-47.32,-493.56
buyer_8,Antonio,45,ES81209592270525302184,TRX_N-00052-09726053,2020-05-06T14:49:04,Labastida,Basic services,gas,-47.73,-541.29
buyer_8,Antonio,45,ES81209592270525302184,TRX_N-00053-96831488,2020-06-01T10:36:07,Labastida,transfer,Salary,1912.39,1371.1
buyer_8,Antonio,45,ES81209592270525302184,TRX_N-00054-87913049,2020-06-01T10:36:07,Labastida,transfer,Bonus,2077.13,3448.23
buyer_8,Antonio,45,ES81209592270525302184,TRX_N-00055-53191745,2020-06-01T09:12:12,Labastida,Expense,healthcare,-84.16,3364.07
buyer_8,Antonio,45,ES81209592270525302184,TRX_N-00056-96287905,2020-06-03T11:44:37,Labastida,Expense,transport,-118.54,3245.53
buyer_8,Antonio,45,ES81209592270525302184,TRX_N-00057-45805928,2020-06-05T10:18:35,Labastida,Housing,Mortgage,-978.24,2267.29
buyer_8,Antonio,45,ES81209592270525302184,TRX_N-00058-96472251,2020-06-05T13:57:16,Labastida,Basic services,water,-15.62,2251.67
buyer_8,Antonio,45,ES81209592270525302184,TRX_N-00059-40121502,2020-06-05T09:43:08,Labastida,Basic services,gas,-25.44,2226.23
buyer_8,Antonio,45,ES81209592270525302184,TRX_N-00060-19235001,2020-06-05T16:00:36,Labastida,Basic services,internet,-74.11,2152.12
buyer_8,Antonio,45,ES81209592270525302184,TRX_N-00061-72388975,2020-06-06T08:43:08,Labastida,Basic services,water,-53.08,2099.04
buyer_8,Antonio,45,ES81209592270525302184,TRX_N-00062-36456884,2020-06-07T08:18:32,Basauri,Expense,education,-829.6,1269.44
buyer_8,Antonio,45,ES81209592270525302184,TRX_N-00063-44087402,2020-06-19T10:46:13,Labastida,Expense,leisure,-185.13,1084.31
buyer_8,Antonio,45,ES81209592270525302184,TRX_N-00064-79443147,2020-06-26T03:22:19,Labastida,Expense,transport,-172.25,912.06
buyer_8,Antonio,45,ES81209592270525302184,TRX_N-00065-66267083,2020-06-26T22:22:04,Bilbao,Expense,clothing,-347.15,564.91
buyer_8,Antonio,45,ES81209592270525302184,TRX_N-00066-40384737,2020-06-28T04:30:10,Vitoria-Gasteiz,Expense,transport,-56.84,508.07
buyer_8,Antonio,45,ES81209592270525302184,TRX_N-00067-98940688,2020-07-01T11:32:34,Labastida,transfer,Salary,1912.39,2420.46
buyer_8,Antonio,45,ES81209592270525302184,TRX_N-00068-78852084,2020-07-01T11:32:34,Labastida,transfer,Extra Income,191.24,2611.7
buyer_8,Antonio,45,ES81209592270525302184,TRX_N-00069-82036801,2020-07-01T17:46:14,Sopela,Expense,transport,-39.44,2572.26
buyer_8,Antonio,45,ES81209592270525302184,TRX_N-00070-96072047,2020-07-05T17:46:16,Labastida,Housing,Mortgage,-978.24,1594.02
buyer_8,Antonio,45,ES81209592270525302184,TRX_N-00071-31406524,2020-07-05T19:44:19,Labastida,Basic services,electricity,-87.38,1506.64
buyer_8,Antonio,45,ES81209592270525302184,TRX_N-00072-74612863,2020-07-05T18:52:14,Labastida,Basic services,internet,-48.84,1457.8
buyer_8,Antonio,45,ES81209592270525302184,TRX_N-00073-43823078,2020-07-06T14:23:31,Labastida,Basic services,water,-49.0,1408.8
buyer_8,Antonio,45,ES81209592270525302184,TRX_N-00074-51190277,2020-07-06T12:36:53,Labastida,Basic services,gas,-64.14,1344.66
buyer_8,Antonio,45,ES81209592270525302184,TRX_N-00075-27825896,2020-07-07T13:49:08,Labastida,Basic services,water,-77.05,1267.61
buyer_8,Antonio,45,ES81209592270525302184,TRX_N-00076-94552678,2020-07-07T18:32:22,Labastida,Basic services,internet,-39.57,1228.04
buyer_8,Antonio,45,ES81209592270525302184,TRX_N-00077-01954686,2020-07-24T22:48:28,Labastida,Expense,food,-639.28,588.76
buyer_8,Antonio,45,ES81209592270525302184,TRX_N-00078-64617873,2020-07-30T09:00:47,Labastida,Expense,transport,-71.86,516.9
buyer_8,Antonio,45,ES81209592270525302184,TRX_N-00079-43876981,2020-08-01T12:34:00,Labastida,transfer,Salary,1912.39,2429.29
buyer_8,Antonio,45,ES81209592270525302184,TRX_N-00080-60401722,2020-08-02T16:34:25,Elciego,Expense,transport,-163.27,2266.02
buyer_8,Antonio,45,ES81209592270525302184,TRX_N-00081-68994141,2020-08-02T11:35:41,Labastida,Expense,clothing,-495.74,1770.28
buyer_8,Antonio,45,ES81209592270525302184,TRX_N-00082-39143316,2020-08-05T19:29:09,Labastida,Housing,Mortgage,-978.24,792.04
buyer_8,Antonio,45,ES81209592270525302184,TRX_N-00083-76795850,2020-08-05T14:54:32,Labastida,Basic services,water,-33.88,758.16
buyer_8,Antonio,45,ES81209592270525302184,TRX_N-00084-86737132,2020-08-05T08:07:12,Labastida,Basic services,internet,-71.73,686.43
buyer_8,Antonio,45,ES81209592270525302184,TRX_N-00085-35560763,2020-08-06T10:21:19,Labastida,Expense,food,-573.51,112.92
buyer_8,Antonio,45,ES81209592270525302184,TRX_N-00086-29929671,2020-08-07T08:17:39,Labastida,Basic services,water,-28.2,84.72
buyer_8,Antonio,45,ES81209592270525302184,TRX_N-00087-70437959,2020-08-07T16:47:58,Labastida,Basic services,phone,-41.21,43.51
buyer_8,Antonio,45,ES81209592270525302184,TRX_N-00088-70968459,2020-08-10T17:14:51,Labastida,Expense,leisure,-138.22,-94.71
buyer_8,Antonio,45,ES81209592270525302184,TRX_N-00089-58335721,2020-09-01T17:21:46,Labastida,transfer,Salary,1912.39,1817.68
buyer_8,Antonio,45,ES81209592270525302184,TRX_N-00090-56246725,2020-09-05T14:54:01,Labastida,Housing,Mortgage,-978.24,839.44
buyer_8,Antonio,45,ES81209592270525302184,TRX_N-00091-28027403,2020-09-05T02:47:40,Labastida,Expense,leisure,-89.06,750.38
buyer_8,Antonio,45,ES81209592270525302184,TRX_N-00092-10882172,2020-09-06T21:06:17,Labastida,Basic services,water,-18.62,731.76
buyer_8,Antonio,45,ES81209592270525302184,TRX_N-00093-07959292,2020-09-06T23:36:55,Labastida,Basic services,internet,-66.52,665.24
buyer_8,Antonio,45,ES81209592270525302184,TRX_N-00094-58175933,2020-09-06T12:55:04,Labastida,Basic services,phone,-65.01,600.23
buyer_8,Antonio,45,ES81209592270525302184,TRX_N-00095-50387592,2020-09-07T20:23:43,Labastida,Basic services,internet,-65.12,535.11
buyer_8,Antonio,45,ES81209592270525302184,TRX_N-00096-84178410,2020-09-07T13:46:31,Getxo,Expense,food,-396.71,138.4
buyer_8,Antonio,45,ES81209592270525302184,TRX_N-00097-39231210,2020-09-11T04:51:20,Labastida,Expense,education,-487.31,-348.91
buyer_8,Antonio,45,ES81209592270525302184,TRX_N-00098-58000658,2020-09-15T22:14:38,Labastida,Expense,healthcare,-198.14,-547.05
buyer_8,Antonio,45,ES81209592270525302184,TRX_N-00099-16579131,2020-09-17T11:18:41,Labastida,Expense,gifts,-181.56,-728.61
buyer_8,Antonio,45,ES81209592270525302184,TRX_N-00100-66237982,2020-10-01T16:31:00,Labastida,transfer,Salary,1912.39,1183.78
buyer_8,Antonio,45,ES81209592270525302184,TRX_N-00101-41185806,2020-10-01T16:31:00,Labastida,transfer,Extra Income,191.24,1375.02
buyer_8,Antonio,45,ES81209592270525302184,TRX_N-00102-77067230,2020-10-05T20:59:12,Labastida,Housing,Mortgage,-978.24,396.78
buyer_8,Antonio,45,ES81209592270525302184,TRX_N-00103-02329902,2020-10-05T02:38:43,Labastida,Basic services,gas,-40.9,355.88
buyer_8,Antonio,45,ES81209592270525302184,TRX_N-00104-59435929,2020-10-05T11:33:54,Labastida,Basic services,internet,-38.24,317.64
buyer_8,Antonio,45,ES81209592270525302184,TRX_N-00105-96745271,2020-10-06T14:53:43,Labastida,Basic services,internet,-56.64,261.0
buyer_8,Antonio,45,ES81209592270525302184,TRX_N-00106-11693382,2020-10-06T16:58:20,Labastida,Basic services,phone,-95.55,165.45
buyer_8,Antonio,45,ES81209592270525302184,TRX_N-00107-69277246,2020-10-07T10:03:27,Labastida,Basic services,electricity,-84.92,80.53
buyer_8,Antonio,45,ES81209592270525302184,TRX_N-00108-04173999,2020-10-07T11:48:59,Labastida,Basic services,gas,-35.07,45.46
buyer_8,Antonio,45,ES81209592270525302184,TRX_N-00109-52601953,2020-10-12T10:13:10,Labastida,Expense,transport,-194.35,-148.89
buyer_8,Antonio,45,ES81209592270525302184,TRX_N-00110-19678346,2020-11-01T01:02:29,Labastida,transfer,Salary,1912.39,1763.5
buyer_8,Antonio,45,ES81209592270525302184,TRX_N-00111-74261837,2020-11-05T12:51:17,Labastida,Housing,Mortgage,-978.24,785.26
buyer_8,Antonio,45,ES81209592270525302184,TRX_N-00112-68242970,2020-11-05T16:47:02,Labastida,Basic services,electricity,-128.78,656.48
buyer_8,Antonio,45,ES81209592270525302184,TRX_N-00113-45863378,2020-11-05T20:05:45,Labastida,Basic services,gas,-20.73,635.75
buyer_8,Antonio,45,ES81209592270525302184,TRX_N-00114-74766414,2020-11-06T11:48:50,Labastida,Basic services,gas,-78.85,556.9
buyer_8,Antonio,45,ES81209592270525302184,TRX_N-00115-08775264,2020-11-07T02:03:42,Labastida,Basic services,internet,-51.48,505.42
buyer_8,Antonio,45,ES81209592270525302184,TRX_N-00116-06454075,2020-11-25T20:20:59,Labastida,Expense,transport,-41.55,463.87
buyer_8,Antonio,45,ES81209592270525302184,TRX_N-00117-57684051,2020-11-28T12:32:42,Labastida,Expense,transport,-127.99,335.88
buyer_8,Antonio,45,ES81209592270525302184,TRX_N-00118-72635804,2020-12-01T18:29:58,Labastida,transfer,Salary,1912.39,2248.27
buyer_8,Antonio,45,ES81209592270525302184,TRX_N-00119-64336092,2020-12-01T18:29:58,Labastida,transfer,Extra Income,191.24,2439.51
buyer_8,Antonio,45,ES81209592270525302184,TRX_N-00120-84907840,2020-12-01T18:29:58,Labastida,transfer,Bonus,2028.12,4467.63
buyer_8,Antonio,45,ES81209592270525302184,TRX_N-00121-66646324,2020-12-05T09:59:31,Labastida,Housing,Mortgage,-978.24,3489.39
buyer_8,Antonio,45,ES81209592270525302184,TRX_N-00122-19074866,2020-12-05T19:30:37,Labastida,Basic services,water,-61.04,3428.35
buyer_8,Antonio,45,ES81209592270525302184,TRX_N-00123-58329050,2020-12-05T14:16:54,Labastida,Basic services,electricity,-33.45,3394.9
buyer_8,Antonio,45,ES81209592270525302184,TRX_N-00124-37224897,2020-12-05T15:50:38,Labastida,Basic services,gas,-35.01,3359.89
buyer_8,Antonio,45,ES81209592270525302184,TRX_N-00125-84327888,2020-12-05T10:52:44,Labastida,Basic services,phone,-67.5,3292.39
buyer_8,Antonio,45,ES81209592270525302184,TRX_N-00126-49800129,2020-12-06T13:51:07,Labastida,Basic services,water,-14.38,3278.01
buyer_8,Antonio,45,ES81209592270525302184,TRX_N-00127-87700147,2020-12-06T23:43:18,Labastida,Basic services,gas,-25.82,3252.19
buyer_8,Antonio,45,ES81209592270525302184,TRX_N-00128-01593720,2020-12-07T21:48:34,Labastida,Basic services,phone,-65.24,3186.95
buyer_8,Antonio,45,ES81209592270525302184,TRX_N-00129-48794847,2020-12-07T14:04:28,Labastida,Expense,food,-631.46,2555.49
buyer_8,Antonio,45,ES81209592270525302184,TRX_N-00130-49833000,2020-12-17T10:49:40,Labastida,Expense,education,-679.05,1876.44
buyer_8,Antonio,45,ES81209592270525302184,TRX_N-00131-26432337,2020-12-18T09:32:09,Labastida,Expense,repairs,-350.76,1525.68
buyer_8,Antonio,45,ES81209592270525302184,TRX_N-00132-18403976,2020-12-24T12:03:07,Labastida,Expense,healthcare,-125.27,1400.41
buyer_8,Antonio,45,ES81209592270525302184,TRX_N-00133-61962012,2020-12-27T17:00:20,Labastida,Expense,leisure,-113.21,1287.2
buyer_8,Antonio,45,ES81209592270525302184,TRX_N-00134-21258281,2020-12-31T16:46:44,Labastida,Expense,food,-555.88,731.32
buyer_8,Antonio,45,ES81209592270525302184,TRX_N-00135-13325724,2021-01-01T11:25:35,Labastida,transfer,Salary,1912.39,2643.71
buyer_8,Antonio,45,ES81209592270525302184,TRX_N-00136-97560886,2021-01-04T09:54:43,Vitoria-Gasteiz,Expense,food,-687.77,1955.94
buyer_8,Antonio,45,ES81209592270525302184,TRX_N-00137-08362802,2021-01-05T16:01:21,Labastida,Housing,Mortgage,-978.24,977.7
buyer_8,Antonio,45,ES81209592270525302184,TRX_N-00138-40627186,2021-01-05T17:20:01,Labastida,Basic services,electricity,-115.23,862.47
buyer_8,Antonio,45,ES81209592270525302184,TRX_N-00139-71502885,2021-01-05T12:52:04,Labastida,Basic services,internet,-40.29,822.18
buyer_8,Antonio,45,ES81209592270525302184,TRX_N-00140-93462174,2021-01-05T18:12:02,Labastida,Basic services,phone,-66.65,755.53
buyer_8,Antonio,45,ES81209592270525302184,TRX_N-00141-79811806,2021-01-06T09:19:34,Labastida,Basic services,gas,-53.38,702.15
buyer_8,Antonio,45,ES81209592270525302184,TRX_N-00142-97547724,2021-01-07T19:53:59,Labastida,Basic services,electricity,-72.93,629.22
buyer_8,Antonio,45,ES81209592270525302184,TRX_N-00143-13335197,2021-01-15T20:47:37,Zarautz,Expense,transport,-82.3,546.92
buyer_8,Antonio,45,ES81209592270525302184,TRX_N-00144-27153156,2021-01-15T10:40:48,Labastida,Expense,leisure,-262.28,284.64
buyer_8,Antonio,45,ES81209592270525302184,TRX_N-00145-11044699,2021-01-15T14:49:01,Bermeo,Expense,travel,-2749.02,-2464.38
buyer_8,Antonio,45,ES81209592270525302184,TRX_N-00146-73109529,2021-01-26T04:04:19,Labastida,Expense,transport,-45.74,-2510.12
buyer_8,Antonio,45,ES81209592270525302184,TRX_N-00147-52508713,2021-01-27T23:11:59,Labastida,Expense,food,-257.84,-2767.96
buyer_8,Antonio,45,ES81209592270525302184,TRX_N-00148-33805190,2021-01-30T14:15:53,Llodio,Expense,repairs,-111.35,-2879.31
buyer_8,Antonio,45,ES81209592270525302184,TRX_N-00149-48239220,2021-02-01T12:16:41,Labastida,transfer,Salary,1912.39,-966.92
buyer_8,Antonio,45,ES81209592270525302184,TRX_N-00150-79229665,2021-02-01T12:16:41,Labastida,transfer,Extra Income,191.24,-775.68
buyer_8,Antonio,45,ES81209592270525302184,TRX_N-00151-65203671,2021-02-05T17:52:23,Labastida,Housing,Mortgage,-978.24,-1753.92
buyer_8,Antonio,45,ES81209592270525302184,TRX_N-00152-92817983,2021-02-06T13:55:04,Labastida,Basic services,water,-74.28,-1828.2
buyer_8,Antonio,45,ES81209592270525302184,TRX_N-00153-27412807,2021-02-06T17:42:04,Labastida,Basic services,electricity,-45.25,-1873.45
buyer_8,Antonio,45,ES81209592270525302184,TRX_N-00154-05464571,2021-02-06T12:34:14,Labastida,Expense,healthcare,-285.1,-2158.55
buyer_8,Antonio,45,ES81209592270525302184,TRX_N-00155-52581026,2021-02-07T10:55:24,Labastida,Basic services,water,-61.2,-2219.75
buyer_8,Antonio,45,ES81209592270525302184,TRX_N-00156-84610344,2021-02-07T21:35:50,Labastida,Basic services,gas,-68.63,-2288.38
buyer_8,Antonio,45,ES81209592270525302184,TRX_N-00157-43345885,2021-02-07T14:11:51,Labastida,Basic services,internet,-73.46,-2361.84
buyer_8,Antonio,45,ES81209592270525302184,TRX_N-00158-56176836,2021-02-07T16:21:30,Labastida,Basic services,phone,-86.36,-2448.2
buyer_8,Antonio,45,ES81209592270525302184,TRX_N-00159-64517152,2021-02-13T09:29:45,Labastida,Expense,food,-479.3,-2927.5
buyer_8,Antonio,45,ES81209592270525302184,TRX_N-00160-94455968,2021-02-13T20:22:28,Labastida,Expense,clothing,-386.67,-3314.17
buyer_8,Antonio,45,ES81209592270525302184,TRX_N-00161-10013491,2021-02-27T11:50:17,Mungia,Expense,food,-674.41,-3988.58
buyer_8,Antonio,45,ES81209592270525302184,TRX_N-00162-82223642,2021-03-01T11:32:07,Labastida,transfer,Salary,1912.39,-2076.19
buyer_8,Antonio,45,ES81209592270525302184,TRX_N-00163-32684929,2021-03-02T15:01:34,Labastida,Expense,clothing,-270.9,-2347.09
buyer_8,Antonio,45,ES81209592270525302184,TRX_N-00164-91314864,2021-03-05T14:23:20,Labastida,Housing,Mortgage,-978.24,-3325.33
buyer_8,Antonio,45,ES81209592270525302184,TRX_N-00165-59968239,2021-03-05T13:25:22,Labastida,Basic services,gas,-50.41,-3375.74
buyer_8,Antonio,45,ES81209592270525302184,TRX_N-00166-91794968,2021-03-07T17:22:57,Labastida,Basic services,water,-60.09,-3435.83
buyer_8,Antonio,45,ES81209592270525302184,TRX_N-00167-53237599,2021-03-07T13:42:38,Labastida,Basic services,gas,-73.64,-3509.47
buyer_8,Antonio,45,ES81209592270525302184,TRX_N-00168-44907618,2021-03-07T14:02:27,Labastida,Basic services,phone,-89.91,-3599.38
buyer_8,Antonio,45,ES81209592270525302184,TRX_N-00169-23933382,2021-03-17T09:17:04,Labastida,Expense,food,-647.53,-4246.91
buyer_8,Antonio,45,ES81209592270525302184,TRX_N-00170-50683784,2021-03-24T14:03:16,Oyón-Oion,Expense,food,-353.06,-4599.97
buyer_8,Antonio,45,ES81209592270525302184,TRX_N-00171-91678220,2021-03-26T12:59:32,Labastida,Expense,food,-153.5,-4753.47
buyer_8,Antonio,45,ES81209592270525302184,TRX_N-00172-93232631,2021-03-31T09:10:28,Arrasate/Mondragon,Expense,transport,-160.66,-4914.13
buyer_8,Antonio,45,ES81209592270525302184,TRX_N-00173-44954952,2021-04-01T08:06:49,Labastida,transfer,Salary,1912.39,-3001.74
buyer_8,Antonio,45,ES81209592270525302184,TRX_N-00174-13264892,2021-04-01T08:06:49,Labastida,transfer,Extra Income,191.24,-2810.5
buyer_8,Antonio,45,ES81209592270525302184,TRX_N-00175-07716297,2021-04-02T08:52:24,Labastida,Expense,transport,-182.2,-2992.7
buyer_8,Antonio,45,ES81209592270525302184,TRX_N-00176-36299671,2021-04-05T18:19:12,Labastida,Housing,Mortgage,-978.24,-3970.94
buyer_8,Antonio,45,ES81209592270525302184,TRX_N-00177-86150779,2021-04-06T10:05:09,Labastida,Basic services,internet,-47.33,-4018.27
buyer_8,Antonio,45,ES81209592270525302184,TRX_N-00178-74013865,2021-04-08T13:44:55,Labastida,Expense,leisure,-54.39,-4072.66
buyer_8,Antonio,45,ES81209592270525302184,TRX_N-00179-98947362,2021-04-10T19:42:22,Labastida,Expense,leisure,-168.06,-4240.72
buyer_8,Antonio,45,ES81209592270525302184,TRX_N-00180-03252141,2021-04-16T15:08:47,Labastida,Expense,transport,-74.55,-4315.27
buyer_8,Antonio,45,ES81209592270525302184,TRX_N-00181-57688683,2021-04-28T17:54:41,Labastida,Expense,food,-353.92,-4669.19
buyer_8,Antonio,45,ES81209592270525302184,TRX_N-00182-69930293,2021-05-01T09:58:53,Labastida,transfer,Salary,1912.39,-2756.8
buyer_8,Antonio,45,ES81209592270525302184,TRX_N-00183-04494589,2021-05-01T13:36:14,Labastida,Expense,transport,-126.12,-2882.92
buyer_8,Antonio,45,ES81209592270525302184,TRX_N-00184-34156191,2021-05-05T20:27:46,Labastida,Housing,Mortgage,-978.24,-3861.16
buyer_8,Antonio,45,ES81209592270525302184,TRX_N-00185-12362543,2021-05-05T11:13:30,Labastida,Basic services,gas,-85.14,-3946.3
buyer_8,Antonio,45,ES81209592270525302184,TRX_N-00186-14095284,2021-05-05T14:32:58,Labastida,Basic services,internet,-30.05,-3976.35
buyer_8,Antonio,45,ES81209592270525302184,TRX_N-00187-21134197,2021-05-06T14:34:40,Labastida,Basic services,water,-50.82,-4027.17
buyer_8,Antonio,45,ES81209592270525302184,TRX_N-00188-35883509,2021-05-06T17:23:43,Labastida,Basic services,gas,-18.8,-4045.97
buyer_8,Antonio,45,ES81209592270525302184,TRX_N-00189-88313838,2021-05-07T13:22:36,Labastida,Basic services,electricity,-114.59,-4160.56
buyer_8,Antonio,45,ES81209592270525302184,TRX_N-00190-35170964,2021-05-27T12:11:47,Zarautz,Expense,repairs,-533.23,-4693.79
buyer_8,Antonio,45,ES81209592270525302184,TRX_N-00191-52505738,2021-05-29T17:06:44,Basauri,Expense,transport,-73.55,-4767.34
buyer_8,Antonio,45,ES81209592270525302184,TRX_N-00192-78745895,2021-06-01T07:59:01,Labastida,transfer,Salary,1912.39,-2854.95
buyer_8,Antonio,45,ES81209592270525302184,TRX_N-00193-65625327,2021-06-01T07:59:01,Labastida,transfer,Bonus,1816.89,-1038.06
buyer_8,Antonio,45,ES81209592270525302184,TRX_N-00194-25906124,2021-06-01T18:13:09,Labastida,Expense,clothing,-369.31,-1407.37
buyer_8,Antonio,45,ES81209592270525302184,TRX_N-00195-31992878,2021-06-02T13:16:48,Labastida,Expense,transport,-81.15,-1488.52
buyer_8,Antonio,45,ES81209592270525302184,TRX_N-00196-31007347,2021-06-04T18:19:02,Labastida,Expense,education,-138.78,-1627.3
buyer_8,Antonio,45,ES81209592270525302184,TRX_N-00197-94453117,2021-06-05T17:53:32,Labastida,Housing,Mortgage,-978.24,-2605.54
buyer_8,Antonio,45,ES81209592270525302184,TRX_N-00198-29595798,2021-06-05T12:05:21,Labastida,Basic services,water,-52.51,-2658.05
buyer_8,Antonio,45,ES81209592270525302184,TRX_N-00199-98104070,2021-06-05T08:18:44,Hernani,Expense,education,-61.78,-2719.83
buyer_8,Antonio,45,ES81209592270525302184,TRX_N-00200-28685507,2021-06-17T18:08:28,Labastida,Expense,food,-328.08,-3047.91
buyer_8,Antonio,45,ES81209592270525302184,TRX_N-00201-65963052,2021-06-17T20:49:29,Labastida,Expense,repairs,-82.98,-3130.89
buyer_8,Antonio,45,ES81209592270525302184,TRX_N-00202-70311633,2021-06-18T21:50:16,Labastida,Expense,transport,-126.29,-3257.18
buyer_8,Antonio,45,ES81209592270525302184,TRX_N-00203-47884162,2021-06-19T22:44:24,Labastida,Expense,food,-266.71,-3523.89
buyer_8,Antonio,45,ES81209592270525302184,TRX_N-00204-83797192,2021-06-20T21:14:58,Labastida,Expense,transport,-99.08,-3622.97
buyer_8,Antonio,45,ES81209592270525302184,TRX_N-00205-07988105,2021-06-24T11:10:23,Labastida,Expense,clothing,-346.26,-3969.23
buyer_8,Antonio,45,ES81209592270525302184,TRX_N-00206-18942780,2021-06-27T18:41:26,Labastida,Expense,leisure,-290.91,-4260.14
buyer_8,Antonio,45,ES81209592270525302184,TRX_N-00207-80995888,2021-07-01T17:24:38,Labastida,transfer,Salary,1912.39,-2347.75
buyer_8,Antonio,45,ES81209592270525302184,TRX_N-00208-89206151,2021-07-01T17:24:38,Labastida,transfer,Extra Income,191.24,-2156.51
buyer_8,Antonio,45,ES81209592270525302184,TRX_N-00209-56247770,2021-07-04T21:03:13,Labastida,Expense,repairs,-376.44,-2532.95
buyer_8,Antonio,45,ES81209592270525302184,TRX_N-00210-61429197,2021-07-05T09:47:09,Labastida,Housing,Mortgage,-978.24,-3511.19
buyer_8,Antonio,45,ES81209592270525302184,TRX_N-00211-41506165,2021-07-05T16:53:59,Labastida,Basic services,internet,-36.93,-3548.12
buyer_8,Antonio,45,ES81209592270525302184,TRX_N-00212-04430216,2021-07-05T15:48:53,Labastida,Basic services,phone,-47.48,-3595.6
buyer_8,Antonio,45,ES81209592270525302184,TRX_N-00213-08875136,2021-07-06T17:02:55,Labastida,Basic services,electricity,-23.13,-3618.73
buyer_8,Antonio,45,ES81209592270525302184,TRX_N-00214-80670686,2021-07-07T18:22:31,Labastida,Basic services,electricity,-97.8,-3716.53
buyer_8,Antonio,45,ES81209592270525302184,TRX_N-00215-38030454,2021-07-15T19:50:11,Sopela,Expense,appliances,-1500.19,-5216.72
buyer_8,Antonio,45,ES81209592270525302184,TRX_N-00216-91323168,2021-07-24T10:20:37,Labastida,Expense,transport,-100.72,-5317.44
buyer_8,Antonio,45,ES81209592270525302184,TRX_N-00217-86993726,2021-08-01T11:41:42,Labastida,transfer,Salary,1912.39,-3405.05
buyer_8,Antonio,45,ES81209592270525302184,TRX_N-00218-90934401,2021-08-05T17:57:55,Labastida,Housing,Mortgage,-978.24,-4383.29
buyer_8,Antonio,45,ES81209592270525302184,TRX_N-00219-03788668,2021-08-05T10:27:11,Labastida,Basic services,electricity,-32.2,-4415.49
buyer_8,Antonio,45,ES81209592270525302184,TRX_N-00220-10479280,2021-08-05T16:27:27,Labastida,Basic services,phone,-51.63,-4467.12
buyer_8,Antonio,45,ES81209592270525302184,TRX_N-00221-94989356,2021-08-07T19:20:23,Labastida,Basic services,water,-56.95,-4524.07
buyer_8,Antonio,45,ES81209592270525302184,TRX_N-00222-77633642,2021-08-07T13:01:19,Labastida,Basic services,internet,-43.77,-4567.84
buyer_8,Antonio,45,ES81209592270525302184,TRX_N-00223-60531116,2021-08-07T23:03:10,Labastida,Basic services,phone,-72.84,-4640.68
buyer_8,Antonio,45,ES81209592270525302184,TRX_N-00224-27421845,2021-08-15T17:00:05,Labastida,Expense,clothing,-382.13,-5022.81
buyer_8,Antonio,45,ES81209592270525302184,TRX_N-00225-19647750,2021-09-01T13:18:15,Labastida,transfer,Salary,1912.39,-3110.42
buyer_8,Antonio,45,ES81209592270525302184,TRX_N-00226-16206975,2021-09-01T13:18:15,Labastida,transfer,Extra Income,191.24,-2919.18
buyer_8,Antonio,45,ES81209592270525302184,TRX_N-00227-64568887,2021-09-05T11:48:46,Labastida,Housing,Mortgage,-978.24,-3897.42
buyer_8,Antonio,45,ES81209592270525302184,TRX_N-00228-53268733,2021-09-05T08:18:20,Labastida,Basic services,water,-36.23,-3933.65
buyer_8,Antonio,45,ES81209592270525302184,TRX_N-00229-11796209,2021-09-05T18:41:38,Labastida,Basic services,internet,-68.84,-4002.49
buyer_8,Antonio,45,ES81209592270525302184,TRX_N-00230-38339635,2021-09-06T14:01:50,Labastida,Basic services,electricity,-78.52,-4081.01
buyer_8,Antonio,45,ES81209592270525302184,TRX_N-00231-39125075,2021-09-06T22:23:41,Labastida,Basic services,internet,-77.57,-4158.58
buyer_8,Antonio,45,ES81209592270525302184,TRX_N-00232-10302517,2021-09-06T14:10:23,Labastida,Basic services,phone,-87.08,-4245.66
buyer_8,Antonio,45,ES81209592270525302184,TRX_N-00233-16281948,2021-09-08T20:39:25,Getxo,Expense,leisure,-207.78,-4453.44
buyer_8,Antonio,45,ES81209592270525302184,TRX_N-00234-85970475,2021-10-01T17:08:11,Labastida,transfer,Salary,1912.39,-2541.05
buyer_8,Antonio,45,ES81209592270525302184,TRX_N-00235-41787270,2021-10-04T23:32:10,Labastida,Expense,food,-148.63,-2689.68
buyer_8,Antonio,45,ES81209592270525302184,TRX_N-00236-19015959,2021-10-04T23:12:00,Labastida,Expense,leisure,-50.1,-2739.78
buyer_8,Antonio,45,ES81209592270525302184,TRX_N-00237-03037128,2021-10-05T13:52:02,Labastida,Housing,Mortgage,-978.24,-3718.02
buyer_8,Antonio,45,ES81209592270525302184,TRX_N-00238-54028671,2021-10-06T12:54:55,Labastida,Basic services,gas,-51.81,-3769.83
buyer_8,Antonio,45,ES81209592270525302184,TRX_N-00239-23743459,2021-10-07T19:19:03,Labastida,Basic services,electricity,-70.24,-3840.07
buyer_8,Antonio,45,ES81209592270525302184,TRX_N-00240-41439398,2021-10-07T09:09:41,Labastida,Basic services,phone,-64.19,-3904.26
buyer_8,Antonio,45,ES81209592270525302184,TRX_N-00241-54090601,2021-10-07T06:56:02,Labastida,Expense,food,-588.1,-4492.36
buyer_8,Antonio,45,ES81209592270525302184,TRX_N-00242-21864422,2021-10-12T08:54:06,Bilbao,Expense,food,-273.6,-4765.96
buyer_8,Antonio,45,ES81209592270525302184,TRX_N-00243-41423351,2021-10-14T17:44:19,Labastida,Expense,leisure,-205.47,-4971.43
buyer_8,Antonio,45,ES81209592270525302184,TRX_N-00244-48856686,2021-10-25T09:01:48,Labastida,Expense,travel,-1444.04,-6415.47
buyer_8,Antonio,45,ES81209592270525302184,TRX_N-00245-09955804,2021-11-01T13:14:19,Labastida,transfer,Salary,1912.39,-4503.08
buyer_8,Antonio,45,ES81209592270525302184,TRX_N-00246-91281347,2021-11-01T13:14:19,Labastida,transfer,Extra Income,191.24,-4311.84
buyer_8,Antonio,45,ES81209592270525302184,TRX_N-00247-47667095,2021-11-01T17:42:21,Labastida,Expense,food,-379.16,-4691.0
buyer_8,Antonio,45,ES81209592270525302184,TRX_N-00248-49501466,2021-11-05T18:32:43,Labastida,Housing,Mortgage,-978.24,-5669.24
buyer_8,Antonio,45,ES81209592270525302184,TRX_N-00249-78018436,2021-11-05T20:26:55,Labastida,Basic services,internet,-37.53,-5706.77
buyer_8,Antonio,45,ES81209592270525302184,TRX_N-00250-63228695,2021-11-06T19:16:08,Labastida,Basic services,water,-30.47,-5737.24
buyer_8,Antonio,45,ES81209592270525302184,TRX_N-00251-22811318,2021-11-06T08:23:17,Labastida,Basic services,internet,-43.15,-5780.39
buyer_8,Antonio,45,ES81209592270525302184,TRX_N-00252-39788297,2021-11-07T11:46:06,Labastida,Basic services,water,-11.27,-5791.66
buyer_8,Antonio,45,ES81209592270525302184,TRX_N-00253-53756735,2021-11-07T08:22:37,Labastida,Basic services,gas,-44.66,-5836.32
buyer_8,Antonio,45,ES81209592270525302184,TRX_N-00254-45784412,2021-11-26T20:40:55,Labastida,Expense,food,-339.3,-6175.62
buyer_8,Antonio,45,ES81209592270525302184,TRX_N-00255-02158089,2021-11-26T17:26:58,Amurrio,Expense,healthcare,-116.79,-6292.41
buyer_8,Antonio,45,ES81209592270525302184,TRX_N-00256-76446530,2021-12-01T23:44:48,Labastida,transfer,Salary,1912.39,-4380.02
buyer_8,Antonio,45,ES81209592270525302184,TRX_N-00257-62826311,2021-12-01T23:44:48,Labastida,transfer,Bonus,1935.97,-2444.05
buyer_8,Antonio,45,ES81209592270525302184,TRX_N-00258-88931839,2021-12-05T09:41:51,Labastida,Housing,Mortgage,-978.24,-3422.29
buyer_8,Antonio,45,ES81209592270525302184,TRX_N-00259-16584355,2021-12-05T12:19:19,Labastida,Basic services,water,-34.62,-3456.91
buyer_8,Antonio,45,ES81209592270525302184,TRX_N-00260-89972053,2021-12-05T03:51:22,Labastida,Expense,food,-310.88,-3767.79
buyer_8,Antonio,45,ES81209592270525302184,TRX_N-00261-29190882,2021-12-06T14:35:06,Labastida,Basic services,electricity,-96.2,-3863.99
buyer_8,Antonio,45,ES81209592270525302184,TRX_N-00262-52959956,2021-12-07T13:37:09,Labastida,Basic services,phone,-52.79,-3916.78
buyer_8,Antonio,45,ES81209592270525302184,TRX_N-00263-06794727,2021-12-27T17:03:29,Labastida,Expense,repairs,-767.66,-4684.44
buyer_8,Antonio,45,ES81209592270525302184,TRX_N-00264-25356559,2021-12-31T20:56:29,Labastida,Expense,healthcare,-71.29,-4755.73
buyer_8,Antonio,45,ES81209592270525302184,TRX_N-00265-07306655,2022-01-01T19:14:36,Labastida,transfer,Salary,1912.39,-2843.34
buyer_8,Antonio,45,ES81209592270525302184,TRX_N-00266-97134323,2022-01-05T20:40:07,Labastida,Housing,Mortgage,-978.24,-3821.58
buyer_8,Antonio,45,ES81209592270525302184,TRX_N-00267-55676344,2022-01-05T08:08:15,Labastida,Basic services,electricity,-48.42,-3870.0
buyer_8,Antonio,45,ES81209592270525302184,TRX_N-00268-81578498,2022-01-05T06:55:19,Labastida,Basic services,internet,-41.57,-3911.57
buyer_8,Antonio,45,ES81209592270525302184,TRX_N-00269-52769459,2022-01-06T20:38:14,Labastida,Basic services,water,-32.21,-3943.78
buyer_8,Antonio,45,ES81209592270525302184,TRX_N-00270-62899943,2022-01-06T07:05:20,Labastida,Basic services,gas,-33.19,-3976.97
buyer_8,Antonio,45,ES81209592270525302184,TRX_N-00271-82229505,2022-01-07T10:47:48,Labastida,Basic services,gas,-48.66,-4025.63
buyer_8,Antonio,45,ES81209592270525302184,TRX_N-00272-17471156,2022-01-07T17:34:38,Labastida,Basic services,internet,-49.41,-4075.04
buyer_8,Antonio,45,ES81209592270525302184,TRX_N-00273-39520287,2022-01-07T16:47:15,Labastida,Basic services,phone,-80.75,-4155.79
buyer_8,Antonio,45,ES81209592270525302184,TRX_N-00274-46512853,2022-01-09T14:13:02,Arrasate/Mondragon,Expense,transport,-177.09,-4332.88
buyer_8,Antonio,45,ES81209592270525302184,TRX_N-00275-03900685,2022-01-13T13:11:50,Labastida,Expense,clothing,-276.51,-4609.39
buyer_8,Antonio,45,ES81209592270525302184,TRX_N-00276-34473065,2022-01-29T17:23:21,Labastida,Expense,clothing,-272.2,-4881.59
buyer_8,Antonio,45,ES81209592270525302184,TRX_N-00277-82140876,2022-02-01T10:05:39,Labastida,transfer,Salary,1912.39,-2969.2
buyer_8,Antonio,45,ES81209592270525302184,TRX_N-00278-04868229,2022-02-01T10:05:39,Labastida,transfer,Extra Income,191.24,-2777.96
buyer_8,Antonio,45,ES81209592270525302184,TRX_N-00279-10290950,2022-02-05T18:48:05,Labastida,Housing,Mortgage,-978.24,-3756.2
buyer_8,Antonio,45,ES81209592270525302184,TRX_N-00280-02564003,2022-02-06T09:42:18,Labastida,Basic services,electricity,-35.0,-3791.2
buyer_8,Antonio,45,ES81209592270525302184,TRX_N-00281-10087148,2022-02-07T19:13:07,Labastida,Basic services,water,-29.52,-3820.72
buyer_8,Antonio,45,ES81209592270525302184,TRX_N-00282-26053757,2022-02-07T18:57:25,Labastida,Basic services,gas,-48.93,-3869.65
buyer_8,Antonio,45,ES81209592270525302184,TRX_N-00283-85904661,2022-02-07T16:12:38,Labastida,Basic services,phone,-55.72,-3925.37
buyer_8,Antonio,45,ES81209592270525302184,TRX_N-00284-43283349,2022-02-08T17:32:38,Labastida,Expense,food,-290.11,-4215.48
buyer_8,Antonio,45,ES81209592270525302184,TRX_N-00285-91036145,2022-02-15T21:17:58,Labastida,Expense,food,-697.5,-4912.98
buyer_8,Antonio,45,ES81209592270525302184,TRX_N-00286-85487816,2022-02-27T08:19:57,Labastida,Expense,transport,-44.64,-4957.62
buyer_8,Antonio,45,ES81209592270525302184,TRX_N-00287-31577405,2022-03-01T02:08:30,Labastida,transfer,Salary,1912.39,-3045.23
buyer_8,Antonio,45,ES81209592270525302184,TRX_N-00288-14842300,2022-03-05T18:27:19,Labastida,Housing,Mortgage,-978.24,-4023.47
buyer_8,Antonio,45,ES81209592270525302184,TRX_N-00289-94625007,2022-03-06T10:35:30,Labastida,Basic services,internet,-58.22,-4081.69
buyer_8,Antonio,45,ES81209592270525302184,TRX_N-00290-96483376,2022-03-07T14:01:41,Labastida,Expense,appliances,-1767.64,-5849.33
buyer_8,Antonio,45,ES81209592270525302184,TRX_N-00291-74678682,2022-03-17T14:15:52,Labastida,Expense,transport,-96.15,-5945.48
buyer_8,Antonio,45,ES81209592270525302184,TRX_N-00292-04900119,2022-04-01T09:16:04,Labastida,transfer,Salary,1912.39,-4033.09
buyer_8,Antonio,45,ES81209592270525302184,TRX_N-00293-37521012,2022-04-01T09:16:04,Labastida,transfer,Extra Income,191.24,-3841.85
buyer_8,Antonio,45,ES81209592270525302184,TRX_N-00294-11545562,2022-04-05T18:02:04,Labastida,Housing,Mortgage,-978.24,-4820.09
buyer_8,Antonio,45,ES81209592270525302184,TRX_N-00295-50405434,2022-04-05T10:37:09,Labastida,Expense,transport,-55.56,-4875.65
buyer_8,Antonio,45,ES81209592270525302184,TRX_N-00296-59994688,2022-04-06T11:34:48,Labastida,Basic services,water,-13.42,-4889.07
buyer_8,Antonio,45,ES81209592270525302184,TRX_N-00297-99706575,2022-04-06T20:06:03,Labastida,Basic services,electricity,-41.02,-4930.09
buyer_8,Antonio,45,ES81209592270525302184,TRX_N-00298-07087094,2022-04-07T09:26:04,Labastida,Basic services,water,-52.68,-4982.77
buyer_8,Antonio,45,ES81209592270525302184,TRX_N-00299-15259048,2022-04-07T15:47:52,Labastida,Basic services,electricity,-47.83,-5030.6
buyer_8,Antonio,45,ES81209592270525302184,TRX_N-00300-02929429,2022-04-07T13:14:22,Labastida,Basic services,gas,-51.68,-5082.28
buyer_8,Antonio,45,ES81209592270525302184,TRX_N-00301-42304240,2022-04-10T20:52:54,Labastida,Expense,clothing,-104.28,-5186.56
buyer_8,Antonio,45,ES81209592270525302184,TRX_N-00302-00033807,2022-04-18T09:11:36,Labastida,Expense,travel,-1340.22,-6526.78
buyer_8,Antonio,45,ES81209592270525302184,TRX_N-00303-58484976,2022-04-20T10:18:10,Labastida,Expense,transport,-79.85,-6606.63
buyer_8,Antonio,45,ES81209592270525302184,TRX_N-00304-59975173,2022-04-30T09:55:51,Labastida,Expense,clothing,-412.1,-7018.73
buyer_8,Antonio,45,ES81209592270525302184,TRX_N-00305-62209742,2022-05-01T08:53:22,Labastida,transfer,Salary,1912.39,-5106.34
buyer_8,Antonio,45,ES81209592270525302184,TRX_N-00306-04759418,2022-05-03T17:21:47,Labastida,Expense,clothing,-77.81,-5184.15
buyer_8,Antonio,45,ES81209592270525302184,TRX_N-00307-57167935,2022-05-05T11:04:03,Labastida,Housing,Mortgage,-978.24,-6162.39
buyer_8,Antonio,45,ES81209592270525302184,TRX_N-00308-02939896,2022-05-05T10:15:23,Labastida,Basic services,internet,-69.88,-6232.27
buyer_8,Antonio,45,ES81209592270525302184,TRX_N-00309-79679987,2022-05-06T11:05:56,Labastida,Basic services,water,-63.84,-6296.11
buyer_8,Antonio,45,ES81209592270525302184,TRX_N-00310-96157528,2022-05-06T19:20:48,Labastida,Basic services,electricity,-147.07,-6443.18
buyer_8,Antonio,45,ES81209592270525302184,TRX_N-00311-02340825,2022-05-06T08:57:51,Labastida,Basic services,internet,-48.21,-6491.39
buyer_8,Antonio,45,ES81209592270525302184,TRX_N-00312-91459764,2022-05-07T15:19:06,Labastida,Basic services,electricity,-85.06,-6576.45
buyer_8,Antonio,45,ES81209592270525302184,TRX_N-00313-26607890,2022-05-07T18:16:17,Labastida,Basic services,gas,-16.77,-6593.22
buyer_8,Antonio,45,ES81209592270525302184,TRX_N-00314-59194669,2022-05-08T18:38:56,Labastida,Expense,transport,-30.81,-6624.03
buyer_8,Antonio,45,ES81209592270525302184,TRX_N-00315-34165388,2022-05-11T19:25:53,Labastida,Expense,gifts,-465.58,-7089.61
buyer_8,Antonio,45,ES81209592270525302184,TRX_N-00316-84200104,2022-05-13T20:59:55,Labastida,Expense,gifts,-388.0,-7477.61
buyer_8,Antonio,45,ES81209592270525302184,TRX_N-00317-11243711,2022-05-16T18:09:28,Labastida,Expense,transport,-188.77,-7666.38
buyer_8,Antonio,45,ES81209592270525302184,TRX_N-00318-43983100,2022-05-26T16:29:10,Labastida,Expense,transport,-143.79,-7810.17
buyer_8,Antonio,45,ES81209592270525302184,TRX_N-00319-75564497,2022-05-28T08:19:04,Labastida,Expense,food,-501.78,-8311.95
buyer_8,Antonio,45,ES81209592270525302184,TRX_N-00320-11935737,2022-05-30T23:34:07,Labastida,Expense,leisure,-178.68,-8490.63
buyer_8,Antonio,45,ES81209592270525302184,TRX_N-00321-76987958,2022-05-31T12:46:31,Labastida,Expense,healthcare,-235.46,-8726.09
buyer_8,Antonio,45,ES81209592270525302184,TRX_N-00322-67046579,2022-06-01T18:31:17,Labastida,transfer,Salary,1912.39,-6813.7
buyer_8,Antonio,45,ES81209592270525302184,TRX_N-00323-31274272,2022-06-01T18:31:17,Labastida,transfer,Extra Income,191.24,-6622.46
buyer_8,Antonio,45,ES81209592270525302184,TRX_N-00324-17540470,2022-06-01T18:31:17,Labastida,transfer,Bonus,1962.21,-4660.25
buyer_8,Antonio,45,ES81209592270525302184,TRX_N-00325-49648179,2022-06-01T10:23:40,Labastida,Expense,leisure,-143.37,-4803.62
buyer_8,Antonio,45,ES81209592270525302184,TRX_N-00326-39889285,2022-06-04T11:10:55,Oyón-Oion,Expense,clothing,-279.59,-5083.21
buyer_8,Antonio,45,ES81209592270525302184,TRX_N-00327-80865552,2022-06-05T20:10:53,Labastida,Housing,Mortgage,-978.24,-6061.45
buyer_8,Antonio,45,ES81209592270525302184,TRX_N-00328-90353622,2022-06-05T02:21:50,Labastida,Basic services,water,-79.92,-6141.37
buyer_8,Antonio,45,ES81209592270525302184,TRX_N-00329-17749080,2022-06-05T15:40:23,Labastida,Basic services,gas,-95.41,-6236.78
buyer_8,Antonio,45,ES81209592270525302184,TRX_N-00330-63210354,2022-06-06T22:23:02,Labastida,Basic services,internet,-66.23,-6303.01
buyer_8,Antonio,45,ES81209592270525302184,TRX_N-00331-89726660,2022-06-07T10:59:41,Labastida,Basic services,water,-15.85,-6318.86
buyer_8,Antonio,45,ES81209592270525302184,TRX_N-00332-26789950,2022-06-07T19:24:18,Labastida,Basic services,gas,-70.62,-6389.48
buyer_8,Antonio,45,ES81209592270525302184,TRX_N-00333-88480778,2022-06-17T11:26:24,Labastida,Expense,transport,-55.66,-6445.14
buyer_8,Antonio,45,ES81209592270525302184,TRX_N-00334-50147299,2022-06-22T14:12:08,Galdakao,Expense,transport,-159.98,-6605.12
buyer_8,Antonio,45,ES81209592270525302184,TRX_N-00335-91279084,2022-06-24T10:33:36,Bermeo,Expense,transport,-47.39,-6652.51
buyer_8,Antonio,45,ES81209592270525302184,TRX_N-00336-58973944,2022-06-25T22:23:49,Labastida,Expense,transport,-43.17,-6695.68
buyer_8,Antonio,45,ES81209592270525302184,TRX_N-00337-15083897,2022-06-28T16:38:38,Labastida,Expense,healthcare,-278.98,-6974.66
buyer_8,Antonio,45,ES81209592270525302184,TRX_N-00338-07490042,2022-07-01T10:57:19,Labastida,transfer,Salary,1912.39,-5062.27
buyer_8,Antonio,45,ES81209592270525302184,TRX_N-00339-67272836,2022-07-02T08:46:15,Labastida,Expense,transport,-173.55,-5235.82
buyer_8,Antonio,45,ES81209592270525302184,TRX_N-00340-71058127,2022-07-02T09:27:00,Getxo,Expense,leisure,-117.07,-5352.89
buyer_8,Antonio,45,ES81209592270525302184,TRX_N-00341-94108622,2022-07-04T11:52:09,Sestao,Expense,clothing,-309.07,-5661.96
buyer_8,Antonio,45,ES81209592270525302184,TRX_N-00342-32767989,2022-07-05T00:40:42,Labastida,Housing,Mortgage,-978.24,-6640.2
buyer_8,Antonio,45,ES81209592270525302184,TRX_N-00343-09605445,2022-07-05T11:36:48,Labastida,Basic services,water,-33.47,-6673.67
buyer_8,Antonio,45,ES81209592270525302184,TRX_N-00344-02573569,2022-07-05T09:28:56,Labastida,Basic services,internet,-46.18,-6719.85
buyer_8,Antonio,45,ES81209592270525302184,TRX_N-00345-32714466,2022-07-06T15:59:08,Labastida,Basic services,water,-76.57,-6796.42
buyer_8,Antonio,45,ES81209592270525302184,TRX_N-00346-64498978,2022-07-06T19:32:59,Labastida,Basic services,phone,-84.09,-6880.51
buyer_8,Antonio,45,ES81209592270525302184,TRX_N-00347-60478043,2022-07-07T11:20:07,Labastida,Basic services,electricity,-128.0,-7008.51
buyer_8,Antonio,45,ES81209592270525302184,TRX_N-00348-02675736,2022-07-07T12:15:04,Labastida,Basic services,gas,-82.62,-7091.13
buyer_8,Antonio,45,ES81209592270525302184,TRX_N-00349-29670673,2022-07-07T15:39:08,Labastida,Expense,transport,-158.85,-7249.98
buyer_8,Antonio,45,ES81209592270525302184,TRX_N-00350-96512017,2022-07-11T08:35:18,Labastida,Expense,leisure,-257.99,-7507.97
buyer_8,Antonio,45,ES81209592270525302184,TRX_N-00351-19889205,2022-07-14T11:25:23,Labastida,Expense,food,-114.98,-7622.95
buyer_8,Antonio,45,ES81209592270525302184,TRX_N-00352-49062201,2022-07-19T10:59:48,Labastida,Expense,food,-297.13,-7920.08
buyer_8,Antonio,45,ES81209592270525302184,TRX_N-00353-41043129,2022-07-31T06:02:54,Labastida,Expense,clothing,-140.24,-8060.32
buyer_8,Antonio,45,ES81209592270525302184,TRX_N-00354-29264892,2022-08-01T22:02:14,Labastida,transfer,Salary,1912.39,-6147.93
buyer_8,Antonio,45,ES81209592270525302184,TRX_N-00355-00041857,2022-08-05T23:19:30,Labastida,Housing,Mortgage,-978.24,-7126.17
buyer_8,Antonio,45,ES81209592270525302184,TRX_N-00356-38375016,2022-08-05T14:58:43,Labastida,Basic services,electricity,-46.45,-7172.62
buyer_8,Antonio,45,ES81209592270525302184,TRX_N-00357-63598875,2022-08-06T17:32:46,Labastida,Basic services,electricity,-60.72,-7233.34
buyer_8,Antonio,45,ES81209592270525302184,TRX_N-00358-50330315,2022-08-06T08:55:08,Labastida,Basic services,internet,-30.49,-7263.83
buyer_8,Antonio,45,ES81209592270525302184,TRX_N-00359-26857328,2022-08-06T11:03:14,Labastida,Basic services,phone,-89.49,-7353.32
buyer_8,Antonio,45,ES81209592270525302184,TRX_N-00360-11155748,2022-08-07T16:14:15,Labastida,Basic services,electricity,-139.05,-7492.37
buyer_8,Antonio,45,ES81209592270525302184,TRX_N-00361-31648927,2022-08-07T22:59:38,Labastida,Basic services,internet,-42.82,-7535.19
buyer_8,Antonio,45,ES81209592270525302184,TRX_N-00362-93117571,2022-08-07T11:16:35,Labastida,Expense,clothing,-498.18,-8033.37
buyer_8,Antonio,45,ES81209592270525302184,TRX_N-00363-17619260,2022-08-24T08:09:22,Labastida,Expense,transport,-89.78,-8123.15
buyer_8,Antonio,45,ES81209592270525302184,TRX_N-00364-82205794,2022-08-27T04:43:23,Vitoria-Gasteiz,Expense,transport,-97.08,-8220.23
buyer_8,Antonio,45,ES81209592270525302184,TRX_N-00365-19887565,2022-08-28T10:01:08,Labastida,Expense,education,-499.73,-8719.96
buyer_8,Antonio,45,ES81209592270525302184,TRX_N-00366-40310737,2022-08-29T17:46:52,Labastida,Expense,food,-507.06,-9227.02
buyer_8,Antonio,45,ES81209592270525302184,TRX_N-00367-62727323,2022-09-01T14:14:41,Labastida,transfer,Salary,1912.39,-7314.63
buyer_8,Antonio,45,ES81209592270525302184,TRX_N-00368-24539300,2022-09-01T14:14:41,Labastida,transfer,Extra Income,191.24,-7123.39
buyer_8,Antonio,45,ES81209592270525302184,TRX_N-00369-55231693,2022-09-05T21:13:27,Labastida,Housing,Mortgage,-978.24,-8101.63
buyer_8,Antonio,45,ES81209592270525302184,TRX_N-00370-02720003,2022-09-05T20:28:26,Labastida,Basic services,water,-25.23,-8126.86
buyer_8,Antonio,45,ES81209592270525302184,TRX_N-00371-84925584,2022-09-05T11:08:37,Labastida,Basic services,gas,-29.81,-8156.67
buyer_8,Antonio,45,ES81209592270525302184,TRX_N-00372-39820553,2022-09-06T14:15:09,Labastida,Basic services,water,-61.23,-8217.9
buyer_8,Antonio,45,ES81209592270525302184,TRX_N-00373-41920134,2022-09-06T20:30:16,Labastida,Basic services,gas,-58.73,-8276.63
buyer_8,Antonio,45,ES81209592270525302184,TRX_N-00374-54697393,2022-09-06T14:28:10,Labastida,Basic services,phone,-88.04,-8364.67
buyer_8,Antonio,45,ES81209592270525302184,TRX_N-00375-08124141,2022-09-06T16:58:07,Labastida,Expense,transport,-100.55,-8465.22
buyer_8,Antonio,45,ES81209592270525302184,TRX_N-00376-85604108,2022-09-07T19:36:00,Labastida,Basic services,electricity,-119.3,-8584.52
buyer_8,Antonio,45,ES81209592270525302184,TRX_N-00377-42334990,2022-09-07T07:10:45,Labastida,Basic services,gas,-77.54,-8662.06
buyer_8,Antonio,45,ES81209592270525302184,TRX_N-00378-13095798,2022-09-29T09:08:13,Labastida,Expense,education,-333.47,-8995.53
buyer_8,Antonio,45,ES81209592270525302184,TRX_N-00379-12873288,2022-10-01T16:22:56,Labastida,transfer,Salary,1912.39,-7083.14
buyer_8,Antonio,45,ES81209592270525302184,TRX_N-00380-26087042,2022-10-05T23:29:36,Labastida,Housing,Mortgage,-978.24,-8061.38
buyer_8,Antonio,45,ES81209592270525302184,TRX_N-00381-82860119,2022-10-06T18:58:49,Labastida,Basic services,water,-24.41,-8085.79
buyer_8,Antonio,45,ES81209592270525302184,TRX_N-00382-85907725,2022-10-06T16:21:12,Labastida,Basic services,electricity,-57.8,-8143.59
buyer_8,Antonio,45,ES81209592270525302184,TRX_N-00383-12797286,2022-10-06T16:11:35,Labastida,Basic services,internet,-62.22,-8205.81
buyer_8,Antonio,45,ES81209592270525302184,TRX_N-00384-96474912,2022-10-06T14:31:38,Labastida,Basic services,phone,-42.79,-8248.6
buyer_8,Antonio,45,ES81209592270525302184,TRX_N-00385-82331129,2022-10-07T14:19:18,Labastida,Basic services,gas,-16.94,-8265.54
buyer_8,Antonio,45,ES81209592270525302184,TRX_N-00386-82242468,2022-10-07T19:25:16,Labastida,Expense,gifts,-363.99,-8629.53
buyer_8,Antonio,45,ES81209592270525302184,TRX_N-00387-15016632,2022-10-22T11:54:16,Donostia,Expense,leisure,-12.27,-8641.8
buyer_8,Antonio,45,ES81209592270525302184,TRX_N-00388-04414824,2022-10-25T02:16:05,Labastida,Expense,leisure,-77.21,-8719.01
buyer_8,Antonio,45,ES81209592270525302184,TRX_N-00389-66149607,2022-11-01T09:46:24,Labastida,transfer,Salary,1912.39,-6806.62
buyer_8,Antonio,45,ES81209592270525302184,TRX_N-00390-54355445,2022-11-01T09:46:24,Labastida,transfer,Extra Income,191.24,-6615.38
buyer_8,Antonio,45,ES81209592270525302184,TRX_N-00391-98244155,2022-11-01T12:52:41,Labastida,Expense,gifts,-356.47,-6971.85
buyer_8,Antonio,45,ES81209592270525302184,TRX_N-00392-05456685,2022-11-05T09:16:06,Labastida,Housing,Mortgage,-978.24,-7950.09
buyer_8,Antonio,45,ES81209592270525302184,TRX_N-00393-56726759,2022-11-05T02:50:55,Labastida,Basic services,electricity,-26.87,-7976.96
buyer_8,Antonio,45,ES81209592270525302184,TRX_N-00394-72933605,2022-11-05T12:59:19,Labastida,Basic services,gas,-86.73,-8063.69
buyer_8,Antonio,45,ES81209592270525302184,TRX_N-00395-33387875,2022-11-06T01:51:04,Labastida,Basic services,water,-78.76,-8142.45
buyer_8,Antonio,45,ES81209592270525302184,TRX_N-00396-97494779,2022-11-06T11:23:05,Labastida,Basic services,phone,-97.39,-8239.84
buyer_8,Antonio,45,ES81209592270525302184,TRX_N-00397-13750436,2022-11-07T09:30:13,Labastida,Basic services,gas,-26.37,-8266.21
buyer_8,Antonio,45,ES81209592270525302184,TRX_N-00398-66230892,2022-11-07T02:05:44,Labastida,Basic services,phone,-31.97,-8298.18
buyer_8,Antonio,45,ES81209592270525302184,TRX_N-00399-97478743,2022-11-18T15:43:19,Labastida,Expense,appliances,-768.55,-9066.73
buyer_8,Antonio,45,ES81209592270525302184,TRX_N-00400-63689551,2022-12-01T12:01:05,Labastida,transfer,Salary,1912.39,-7154.34
buyer_8,Antonio,45,ES81209592270525302184,TRX_N-00401-27836909,2022-12-01T12:01:05,Labastida,transfer,Bonus,1893.8,-5260.54
buyer_8,Antonio,45,ES81209592270525302184,TRX_N-00402-05347422,2022-12-01T14:39:40,Labastida,Expense,food,-439.02,-5699.56
buyer_8,Antonio,45,ES81209592270525302184,TRX_N-00403-69971182,2022-12-05T18:27:52,Labastida,Housing,Mortgage,-978.24,-6677.8
buyer_8,Antonio,45,ES81209592270525302184,TRX_N-00404-55083160,2022-12-05T09:16:05,Labastida,Basic services,phone,-44.61,-6722.41
buyer_8,Antonio,45,ES81209592270525302184,TRX_N-00405-79960961,2022-12-06T12:07:22,Labastida,Basic services,electricity,-35.11,-6757.52
buyer_8,Antonio,45,ES81209592270525302184,TRX_N-00406-91229267,2022-12-06T19:20:12,Labastida,Basic services,gas,-85.69,-6843.21
buyer_8,Antonio,45,ES81209592270525302184,TRX_N-00407-63515247,2022-12-06T04:15:00,Labastida,Basic services,internet,-40.17,-6883.38
buyer_8,Antonio,45,ES81209592270525302184,TRX_N-00408-48053861,2022-12-07T20:08:58,Labastida,Basic services,gas,-52.64,-6936.02
buyer_8,Antonio,45,ES81209592270525302184,TRX_N-00409-06351812,2022-12-15T09:51:16,Donostia,Expense,leisure,-218.04,-7154.06
buyer_8,Antonio,45,ES81209592270525302184,TRX_N-00410-24630639,2022-12-26T14:08:53,Lasarte-Oria,Expense,food,-241.54,-7395.6
buyer_8,Antonio,45,ES81209592270525302184,TRX_N-00411-43141310,2022-12-28T20:33:07,Labastida,Expense,appliances,-1611.57,-9007.17
buyer_8,Antonio,45,ES81209592270525302184,TRX_N-00412-76764318,2023-01-01T11:44:04,Labastida,transfer,Salary,1912.39,-7094.78
buyer_8,Antonio,45,ES81209592270525302184,TRX_N-00413-54242896,2023-01-05T13:22:28,Labastida,Housing,Mortgage,-978.24,-8073.02
buyer_8,Antonio,45,ES81209592270525302184,TRX_N-00414-14924510,2023-01-05T10:59:10,Labastida,Basic services,water,-60.92,-8133.94
buyer_8,Antonio,45,ES81209592270525302184,TRX_N-00415-24506109,2023-01-05T03:42:41,Labastida,Basic services,gas,-39.64,-8173.58
buyer_8,Antonio,45,ES81209592270525302184,TRX_N-00416-81382152,2023-01-05T21:57:58,Labastida,Basic services,internet,-76.67,-8250.25
buyer_8,Antonio,45,ES81209592270525302184,TRX_N-00417-67330140,2023-01-05T10:11:39,Labastida,Basic services,phone,-33.09,-8283.34
buyer_8,Antonio,45,ES81209592270525302184,TRX_N-00418-30384808,2023-01-06T12:51:38,Labastida,Basic services,water,-16.79,-8300.13
buyer_8,Antonio,45,ES81209592270525302184,TRX_N-00419-15812559,2023-01-06T19:47:00,Labastida,Basic services,gas,-67.09,-8367.22
buyer_8,Antonio,45,ES81209592270525302184,TRX_N-00420-47976389,2023-01-06T13:04:59,Berango,Expense,healthcare,-58.28,-8425.5
buyer_8,Antonio,45,ES81209592270525302184,TRX_N-00421-22275386,2023-01-07T15:35:45,Labastida,Basic services,water,-75.16,-8500.66
buyer_8,Antonio,45,ES81209592270525302184,TRX_N-00422-84900560,2023-01-07T23:39:57,Labastida,Basic services,electricity,-79.74,-8580.4
buyer_8,Antonio,45,ES81209592270525302184,TRX_N-00423-31338515,2023-01-07T20:12:54,Labastida,Basic services,gas,-35.65,-8616.05
buyer_8,Antonio,45,ES81209592270525302184,TRX_N-00424-23119221,2023-01-07T08:21:57,Elciego,Expense,clothing,-130.66,-8746.71
buyer_8,Antonio,45,ES81209592270525302184,TRX_N-00425-91375411,2023-01-17T16:53:16,Labastida,Expense,leisure,-174.21,-8920.92
buyer_8,Antonio,45,ES81209592270525302184,TRX_N-00426-25569754,2023-01-27T12:18:32,Labastida,Expense,leisure,-92.16,-9013.08
buyer_8,Antonio,45,ES81209592270525302184,TRX_N-00427-98091354,2023-01-28T22:08:52,Labastida,Expense,gifts,-212.03,-9225.11
buyer_8,Antonio,45,ES81209592270525302184,TRX_N-00428-74160622,2023-02-01T20:26:16,Labastida,transfer,Salary,1912.39,-7312.72
buyer_8,Antonio,45,ES81209592270525302184,TRX_N-00429-92506000,2023-02-01T20:26:16,Labastida,transfer,Extra Income,191.24,-7121.48
buyer_8,Antonio,45,ES81209592270525302184,TRX_N-00430-99913286,2023-02-03T20:49:09,Labastida,Expense,transport,-144.09,-7265.57
buyer_8,Antonio,45,ES81209592270525302184,TRX_N-00431-10722549,2023-02-04T08:14:54,Basauri,Expense,transport,-180.62,-7446.19
buyer_8,Antonio,45,ES81209592270525302184,TRX_N-00432-51541070,2023-02-05T19:38:30,Labastida,Housing,Mortgage,-978.24,-8424.43
buyer_8,Antonio,45,ES81209592270525302184,TRX_N-00433-98050697,2023-02-05T12:37:42,Labastida,Basic services,water,-75.02,-8499.45
buyer_8,Antonio,45,ES81209592270525302184,TRX_N-00434-94220370,2023-02-05T15:28:04,Labastida,Basic services,electricity,-54.51,-8553.96
buyer_8,Antonio,45,ES81209592270525302184,TRX_N-00435-55783189,2023-02-05T11:22:35,Labastida,Basic services,gas,-79.62,-8633.58
buyer_8,Antonio,45,ES81209592270525302184,TRX_N-00436-32889693,2023-02-05T19:31:36,Labastida,Basic services,phone,-72.86,-8706.44
buyer_8,Antonio,45,ES81209592270525302184,TRX_N-00437-05354836,2023-02-06T17:59:05,Labastida,Basic services,electricity,-46.01,-8752.45
buyer_8,Antonio,45,ES81209592270525302184,TRX_N-00438-02126351,2023-02-06T22:21:19,Labastida,Basic services,phone,-96.43,-8848.88
buyer_8,Antonio,45,ES81209592270525302184,TRX_N-00439-03611551,2023-02-07T18:25:46,Labastida,Basic services,electricity,-32.13,-8881.01
buyer_8,Antonio,45,ES81209592270525302184,TRX_N-00440-24807301,2023-02-12T12:42:58,Labastida,Expense,food,-671.25,-9552.26
buyer_8,Antonio,45,ES81209592270525302184,TRX_N-00441-05099675,2023-03-01T20:29:29,Labastida,transfer,Salary,1912.39,-7639.87
buyer_8,Antonio,45,ES81209592270525302184,TRX_N-00442-50380322,2023-03-05T18:48:17,Labastida,Housing,Mortgage,-978.24,-8618.11
buyer_8,Antonio,45,ES81209592270525302184,TRX_N-00443-62118059,2023-03-06T10:12:13,Labastida,Basic services,internet,-62.59,-8680.7
buyer_8,Antonio,45,ES81209592270525302184,TRX_N-00444-54058127,2023-03-07T09:29:16,Labastida,Basic services,water,-78.24,-8758.94
buyer_8,Antonio,45,ES81209592270525302184,TRX_N-00445-39341952,2023-03-07T00:59:56,Labastida,Basic services,electricity,-83.84,-8842.78
buyer_8,Antonio,45,ES81209592270525302184,TRX_N-00446-41482807,2023-03-07T15:51:21,Labastida,Basic services,phone,-76.81,-8919.59
buyer_8,Antonio,45,ES81209592270525302184,TRX_N-00447-12051872,2023-03-10T07:21:07,Labastida,Expense,leisure,-39.26,-8958.85
buyer_8,Antonio,45,ES81209592270525302184,TRX_N-00448-84788460,2023-04-01T03:28:04,Labastida,transfer,Salary,1912.39,-7046.46
buyer_8,Antonio,45,ES81209592270525302184,TRX_N-00449-60130059,2023-04-01T23:46:55,Basauri,Expense,transport,-65.23,-7111.69
buyer_8,Antonio,45,ES81209592270525302184,TRX_N-00450-97891647,2023-04-05T09:00:59,Labastida,Housing,Mortgage,-978.24,-8089.93
buyer_8,Antonio,45,ES81209592270525302184,TRX_N-00451-27165604,2023-04-06T01:02:05,Labastida,Basic services,water,-30.1,-8120.03
buyer_8,Antonio,45,ES81209592270525302184,TRX_N-00452-05103660,2023-04-12T13:49:01,Labastida,Expense,food,-724.51,-8844.54
buyer_8,Antonio,45,ES81209592270525302184,TRX_N-00453-15193060,2023-04-25T13:36:10,Labastida,Expense,leisure,-178.01,-9022.55
buyer_8,Antonio,45,ES81209592270525302184,TRX_N-00454-40920951,2023-04-26T20:44:40,Labastida,Expense,food,-330.96,-9353.51
buyer_8,Antonio,45,ES81209592270525302184,TRX_N-00455-71612431,2023-04-26T11:37:05,Alegría-Dulantzi,Expense,appliances,-1842.95,-11196.46
buyer_8,Antonio,45,ES81209592270525302184,TRX_N-00456-70471705,2023-04-29T15:07:59,Oyón-Oion,Expense,repairs,-800.62,-11997.08
buyer_8,Antonio,45,ES81209592270525302184,TRX_N-00457-95467302,2023-04-30T18:27:20,Labastida,Expense,transport,-21.92,-12019.0
buyer_8,Antonio,45,ES81209592270525302184,TRX_N-00458-30937948,2023-05-01T09:41:53,Labastida,transfer,Salary,1912.39,-10106.61
buyer_8,Antonio,45,ES81209592270525302184,TRX_N-00459-37650065,2023-05-01T09:41:53,Labastida,transfer,Extra Income,191.24,-9915.37
buyer_8,Antonio,45,ES81209592270525302184,TRX_N-00460-95948629,2023-05-05T12:17:38,Labastida,Housing,Mortgage,-978.24,-10893.61
buyer_8,Antonio,45,ES81209592270525302184,TRX_N-00461-39559907,2023-05-05T19:13:02,Labastida,Basic services,water,-19.1,-10912.71
buyer_8,Antonio,45,ES81209592270525302184,TRX_N-00462-70167078,2023-05-05T02:17:29,Labastida,Basic services,internet,-69.68,-10982.39
buyer_8,Antonio,45,ES81209592270525302184,TRX_N-00463-05032203,2023-05-05T23:13:19,Labastida,Basic services,phone,-33.07,-11015.46
buyer_8,Antonio,45,ES81209592270525302184,TRX_N-00464-58943118,2023-05-06T14:36:20,Labastida,Basic services,water,-19.36,-11034.82
buyer_8,Antonio,45,ES81209592270525302184,TRX_N-00465-91605896,2023-05-06T11:39:35,Labastida,Basic services,electricity,-35.31,-11070.13
buyer_8,Antonio,45,ES81209592270525302184,TRX_N-00466-50356235,2023-05-06T03:41:38,Erandio,Expense,clothing,-164.64,-11234.77
buyer_8,Antonio,45,ES81209592270525302184,TRX_N-00467-63006175,2023-05-07T15:24:48,Labastida,Basic services,gas,-61.66,-11296.43
buyer_8,Antonio,45,ES81209592270525302184,TRX_N-00468-71939837,2023-05-19T17:40:35,Labastida,Expense,transport,-69.76,-11366.19
buyer_8,Antonio,45,ES81209592270525302184,TRX_N-00469-64660988,2023-05-28T06:59:32,Oyón-Oion,Expense,travel,-1182.58,-12548.77
buyer_8,Antonio,45,ES81209592270525302184,TRX_N-00470-36390065,2023-05-31T21:06:55,Labastida,Expense,food,-561.01,-13109.78
buyer_8,Antonio,45,ES81209592270525302184,TRX_N-00471-77767043,2023-06-01T22:14:26,Labastida,transfer,Salary,1912.39,-11197.39
buyer_8,Antonio,45,ES81209592270525302184,TRX_N-00472-19077856,2023-06-01T22:14:26,Labastida,transfer,Bonus,1874.45,-9322.94
buyer_8,Antonio,45,ES81209592270525302184,TRX_N-00473-11218680,2023-06-05T12:01:31,Labastida,Housing,Mortgage,-978.24,-10301.18
buyer_8,Antonio,45,ES81209592270525302184,TRX_N-00474-20975375,2023-06-05T16:05:20,Labastida,Basic services,water,-60.5,-10361.68
buyer_8,Antonio,45,ES81209592270525302184,TRX_N-00475-80298340,2023-06-05T08:53:23,Labastida,Basic services,electricity,-73.55,-10435.23
buyer_8,Antonio,45,ES81209592270525302184,TRX_N-00476-69168719,2023-06-07T02:03:46,Labastida,Basic services,electricity,-132.6,-10567.83
buyer_8,Antonio,45,ES81209592270525302184,TRX_N-00477-21084920,2023-06-07T08:44:33,Labastida,Basic services,phone,-48.59,-10616.42
buyer_8,Antonio,45,ES81209592270525302184,TRX_N-00478-00862906,2023-06-10T18:03:59,Labastida,Expense,healthcare,-305.44,-10921.86
buyer_8,Antonio,45,ES81209592270525302184,TRX_N-00479-36115468,2023-06-14T16:22:14,Elciego,Expense,healthcare,-207.94,-11129.8
buyer_8,Antonio,45,ES81209592270525302184,TRX_N-00480-79913215,2023-06-19T13:34:28,Labastida,Expense,food,-685.77,-11815.57
buyer_8,Antonio,45,ES81209592270525302184,TRX_N-00481-37869345,2023-06-20T18:46:19,Labastida,Expense,food,-649.61,-12465.18
buyer_8,Antonio,45,ES81209592270525302184,TRX_N-00482-97045200,2023-06-21T06:25:31,Labastida,Expense,food,-303.47,-12768.65
buyer_8,Antonio,45,ES81209592270525302184,TRX_N-00483-61689415,2023-06-24T08:47:56,Labastida,Expense,transport,-64.22,-12832.87
buyer_8,Antonio,45,ES81209592270525302184,TRX_N-00484-35890626,2023-07-01T11:16:00,Labastida,transfer,Salary,1912.39,-10920.48
buyer_8,Antonio,45,ES81209592270525302184,TRX_N-00485-41454240,2023-07-01T11:16:00,Labastida,transfer,Extra Income,191.24,-10729.24
buyer_8,Antonio,45,ES81209592270525302184,TRX_N-00486-28060957,2023-07-02T16:20:09,Hernani,Expense,food,-622.29,-11351.53
buyer_8,Antonio,45,ES81209592270525302184,TRX_N-00487-52138322,2023-07-02T10:45:35,Labastida/Bastida,Expense,transport,-139.11,-11490.64
buyer_8,Antonio,45,ES81209592270525302184,TRX_N-00488-87157026,2023-07-05T09:26:13,Labastida,Housing,Mortgage,-978.24,-12468.88
buyer_8,Antonio,45,ES81209592270525302184,TRX_N-00489-44611247,2023-07-05T14:13:43,Labastida,Basic services,electricity,-148.42,-12617.3
buyer_8,Antonio,45,ES81209592270525302184,TRX_N-00490-11621520,2023-07-06T10:53:52,Labastida,Basic services,water,-62.68,-12679.98
buyer_8,Antonio,45,ES81209592270525302184,TRX_N-00491-05965147,2023-07-06T11:31:06,Labastida,Basic services,electricity,-112.51,-12792.49
buyer_8,Antonio,45,ES81209592270525302184,TRX_N-00492-60343870,2023-07-06T12:48:56,Labastida,Basic services,gas,-80.83,-12873.32
buyer_8,Antonio,45,ES81209592270525302184,TRX_N-00493-42934107,2023-07-06T11:53:24,Labastida,Basic services,internet,-32.76,-12906.08
buyer_8,Antonio,45,ES81209592270525302184,TRX_N-00494-93104942,2023-07-06T08:35:06,Labastida,Basic services,phone,-63.75,-12969.83
buyer_8,Antonio,45,ES81209592270525302184,TRX_N-00495-42692586,2023-07-07T19:36:57,Labastida,Basic services,water,-72.92,-13042.75
buyer_8,Antonio,45,ES81209592270525302184,TRX_N-00496-56777057,2023-07-07T19:14:00,Labastida,Basic services,phone,-64.22,-13106.97
buyer_8,Antonio,45,ES81209592270525302184,TRX_N-00497-90399107,2023-07-22T15:36:46,Labastida,Expense,transport,-197.05,-13304.02
buyer_8,Antonio,45,ES81209592270525302184,TRX_N-00498-99949011,2023-07-31T17:22:45,Basauri,Expense,food,-222.7,-13526.72
buyer_8,Antonio,45,ES81209592270525302184,TRX_N-00499-99431023,2023-08-01T12:02:26,Labastida,transfer,Salary,1912.39,-11614.33
buyer_8,Antonio,45,ES81209592270525302184,TRX_N-00500-46105376,2023-08-01T05:59:14,Labastida,Expense,travel,-1712.88,-13327.21
buyer_8,Antonio,45,ES81209592270525302184,TRX_N-00501-84715212,2023-08-05T18:53:52,Labastida,Housing,Mortgage,-978.24,-14305.45
buyer_8,Antonio,45,ES81209592270525302184,TRX_N-00502-17184152,2023-08-05T01:25:15,Labastida,Basic services,electricity,-140.34,-14445.79
buyer_8,Antonio,45,ES81209592270525302184,TRX_N-00503-66047318,2023-08-05T10:16:28,Labastida,Basic services,gas,-27.62,-14473.41
buyer_8,Antonio,45,ES81209592270525302184,TRX_N-00504-39896060,2023-08-07T13:57:11,Labastida,Basic services,gas,-28.64,-14502.05
buyer_8,Antonio,45,ES81209592270525302184,TRX_N-00505-37735066,2023-08-14T10:59:57,Labastida,Expense,transport,-126.0,-14628.05
buyer_8,Antonio,45,ES81209592270525302184,TRX_N-00506-90125343,2023-08-15T12:16:34,Labastida,Expense,gifts,-188.37,-14816.42
buyer_8,Antonio,45,ES81209592270525302184,TRX_N-00507-15752524,2023-08-20T20:56:40,Labastida,Expense,transport,-116.19,-14932.61
buyer_8,Antonio,45,ES81209592270525302184,TRX_N-00508-84123652,2023-08-22T15:39:22,Labastida,Expense,transport,-190.74,-15123.35
buyer_8,Antonio,45,ES81209592270525302184,TRX_N-00509-31922287,2023-08-23T08:21:52,Labastida,Expense,appliances,-447.67,-15571.02
buyer_8,Antonio,45,ES81209592270525302184,TRX_N-00510-06704654,2023-09-01T10:26:37,Labastida,transfer,Salary,1912.39,-13658.63
buyer_8,Antonio,45,ES81209592270525302184,TRX_N-00511-58560766,2023-09-02T09:09:50,Labastida,Expense,transport,-69.98,-13728.61
buyer_8,Antonio,45,ES81209592270525302184,TRX_N-00512-96185078,2023-09-05T14:25:07,Labastida,Housing,Mortgage,-978.24,-14706.85
buyer_8,Antonio,45,ES81209592270525302184,TRX_N-00513-75918991,2023-09-05T15:36:31,Labastida,Basic services,internet,-65.36,-14772.21
buyer_8,Antonio,45,ES81209592270525302184,TRX_N-00514-51088210,2023-09-07T15:59:25,Labastida,Basic services,water,-12.04,-14784.25
buyer_8,Antonio,45,ES81209592270525302184,TRX_N-00515-75954478,2023-09-07T08:16:24,Labastida,Basic services,gas,-52.46,-14836.71
buyer_8,Antonio,45,ES81209592270525302184,TRX_N-00516-82903782,2023-09-07T21:27:52,Labastida,Basic services,internet,-32.72,-14869.43
buyer_8,Antonio,45,ES81209592270525302184,TRX_N-00517-96547197,2023-09-23T08:03:22,Labastida,Expense,education,-607.19,-15476.62
buyer_8,Antonio,45,ES81209592270525302184,TRX_N-00518-03986315,2023-09-25T05:46:45,Labastida,Expense,food,-524.42,-16001.04
buyer_8,Antonio,45,ES81209592270525302184,TRX_N-00519-02443470,2023-09-30T11:10:39,Donostia,Expense,food,-664.42,-16665.46
buyer_8,Antonio,45,ES81209592270525302184,TRX_N-00520-92464664,2023-10-01T13:50:37,Labastida,transfer,Salary,1912.39,-14753.07
buyer_8,Antonio,45,ES81209592270525302184,TRX_N-00521-64435295,2023-10-01T13:50:37,Labastida,transfer,Extra Income,191.24,-14561.83
buyer_8,Antonio,45,ES81209592270525302184,TRX_N-00522-49252480,2023-10-04T16:29:18,Labastida,Expense,travel,-1935.56,-16497.39
buyer_8,Antonio,45,ES81209592270525302184,TRX_N-00523-02601653,2023-10-05T16:13:23,Labastida,Housing,Mortgage,-978.24,-17475.63
buyer_8,Antonio,45,ES81209592270525302184,TRX_N-00524-69222265,2023-10-05T12:03:16,Labastida,Basic services,electricity,-29.99,-17505.62
buyer_8,Antonio,45,ES81209592270525302184,TRX_N-00525-39455416,2023-10-06T06:32:48,Labastida,Basic services,electricity,-112.64,-17618.26
buyer_8,Antonio,45,ES81209592270525302184,TRX_N-00526-63920427,2023-10-07T14:42:50,Labastida,Basic services,internet,-57.12,-17675.38
buyer_8,Antonio,45,ES81209592270525302184,TRX_N-00527-38254449,2023-10-16T22:00:32,Labastida,Expense,leisure,-210.19,-17885.57
buyer_8,Antonio,45,ES81209592270525302184,TRX_N-00528-76559265,2023-10-18T19:25:32,Labastida,Expense,food,-570.0,-18455.57
buyer_8,Antonio,45,ES81209592270525302184,TRX_N-00529-28309718,2023-10-22T21:08:01,Labastida,Expense,transport,-167.89,-18623.46
buyer_8,Antonio,45,ES81209592270525302184,TRX_N-00530-19179543,2023-11-01T14:15:03,Labastida,transfer,Salary,1912.39,-16711.07
buyer_8,Antonio,45,ES81209592270525302184,TRX_N-00531-15699959,2023-11-05T20:44:12,Labastida,Housing,Mortgage,-978.24,-17689.31
buyer_8,Antonio,45,ES81209592270525302184,TRX_N-00532-70451291,2023-11-05T18:23:42,Labastida,Basic services,water,-46.8,-17736.11
buyer_8,Antonio,45,ES81209592270525302184,TRX_N-00533-28440033,2023-11-05T14:49:28,Labastida,Basic services,electricity,-83.08,-17819.19
buyer_8,Antonio,45,ES81209592270525302184,TRX_N-00534-40313274,2023-11-05T05:44:55,Labastida,Basic services,internet,-77.46,-17896.65
buyer_8,Antonio,45,ES81209592270525302184,TRX_N-00535-13724962,2023-11-05T22:11:00,Labastida,Basic services,phone,-41.37,-17938.02
buyer_8,Antonio,45,ES81209592270525302184,TRX_N-00536-01451565,2023-11-06T11:55:03,Labastida,Basic services,electricity,-43.72,-17981.74
buyer_8,Antonio,45,ES81209592270525302184,TRX_N-00537-52217666,2023-11-06T20:18:12,Labastida,Basic services,phone,-56.62,-18038.36
buyer_8,Antonio,45,ES81209592270525302184,TRX_N-00538-58934685,2023-11-07T21:13:24,Labastida,Basic services,electricity,-142.84,-18181.2
buyer_8,Antonio,45,ES81209592270525302184,TRX_N-00539-32755667,2023-11-09T10:49:13,Labastida,Expense,gifts,-238.36,-18419.56
buyer_8,Antonio,45,ES81209592270525302184,TRX_N-00540-15165478,2023-11-10T15:57:42,Labastida,Expense,food,-334.08,-18753.64
buyer_8,Antonio,45,ES81209592270525302184,TRX_N-00541-13739772,2023-11-13T16:49:30,Labastida,Expense,food,-122.02,-18875.66
buyer_8,Antonio,45,ES81209592270525302184,TRX_N-00542-48385846,2023-11-18T18:03:28,Labastida,Expense,clothing,-81.39,-18957.05
buyer_8,Antonio,45,ES81209592270525302184,TRX_N-00543-73085458,2023-11-19T17:52:47,Labastida,Expense,food,-526.94,-19483.99
buyer_8,Antonio,45,ES81209592270525302184,TRX_N-00544-70421864,2023-11-26T18:02:12,Labastida,Expense,clothing,-283.42,-19767.41
buyer_8,Antonio,45,ES81209592270525302184,TRX_N-00545-66516199,2023-11-28T09:53:08,Labastida,Expense,food,-520.14,-20287.55
buyer_8,Antonio,45,ES81209592270525302184,TRX_N-00546-10710808,2023-12-01T16:43:59,Labastida,transfer,Salary,1912.39,-18375.16
buyer_8,Antonio,45,ES81209592270525302184,TRX_N-00547-90246958,2023-12-01T16:43:59,Labastida,transfer,Bonus,1827.86,-16547.3
buyer_8,Antonio,45,ES81209592270525302184,TRX_N-00548-14480359,2023-12-02T12:56:46,Labastida,Expense,clothing,-49.26,-16596.56
buyer_8,Antonio,45,ES81209592270525302184,TRX_N-00549-79694109,2023-12-05T23:00:58,Labastida,Housing,Mortgage,-978.24,-17574.8
buyer_8,Antonio,45,ES81209592270525302184,TRX_N-00550-90393420,2023-12-05T19:57:27,Labastida,Basic services,internet,-79.85,-17654.65
buyer_8,Antonio,45,ES81209592270525302184,TRX_N-00551-91220086,2023-12-06T23:26:24,Labastida,Basic services,electricity,-27.57,-17682.22
buyer_8,Antonio,45,ES81209592270525302184,TRX_N-00552-68766255,2023-12-06T10:35:22,Labastida,Basic services,gas,-44.71,-17726.93
buyer_8,Antonio,45,ES81209592270525302184,TRX_N-00553-21941865,2023-12-07T13:50:38,Labastida,Basic services,electricity,-38.06,-17764.99
buyer_8,Antonio,45,ES81209592270525302184,TRX_N-00554-74043213,2023-12-14T10:40:00,Durango,Expense,food,-280.14,-18045.13
buyer_8,Antonio,45,ES81209592270525302184,TRX_N-00555-09714091,2023-12-21T15:03:43,Labastida,Expense,transport,-185.21,-18230.34
buyer_8,Antonio,45,ES81209592270525302184,TRX_N-00556-12754180,2024-01-01T09:02:08,Labastida,transfer,Salary,1912.39,-16317.95
buyer_8,Antonio,45,ES81209592270525302184,TRX_N-00557-07189703,2024-01-01T09:02:08,Labastida,transfer,Extra Income,191.24,-16126.71
buyer_8,Antonio,45,ES81209592270525302184,TRX_N-00558-75080096,2024-01-05T16:54:15,Labastida,Housing,Mortgage,-978.24,-17104.95
buyer_8,Antonio,45,ES81209592270525302184,TRX_N-00559-56099230,2024-01-05T00:20:21,Labastida,Basic services,water,-26.74,-17131.69
buyer_8,Antonio,45,ES81209592270525302184,TRX_N-00560-14527643,2024-01-05T14:32:26,Labastida,Basic services,internet,-35.38,-17167.07
buyer_8,Antonio,45,ES81209592270525302184,TRX_N-00561-39163464,2024-01-06T20:38:32,Labastida,Basic services,electricity,-119.64,-17286.71
buyer_8,Antonio,45,ES81209592270525302184,TRX_N-00562-27002240,2024-01-06T12:36:32,Labastida,Basic services,gas,-51.77,-17338.48
buyer_8,Antonio,45,ES81209592270525302184,TRX_N-00563-98018432,2024-01-07T17:19:58,Labastida,Basic services,water,-11.51,-17349.99
buyer_8,Antonio,45,ES81209592270525302184,TRX_N-00564-58134955,2024-01-07T10:51:23,Labastida,Basic services,electricity,-64.83,-17414.82
buyer_8,Antonio,45,ES81209592270525302184,TRX_N-00565-69260007,2024-01-07T22:21:22,Labastida,Basic services,internet,-56.01,-17470.83
buyer_8,Antonio,45,ES81209592270525302184,TRX_N-00566-58623295,2024-01-10T22:47:29,Basauri,Expense,repairs,-257.89,-17728.72
buyer_8,Antonio,45,ES81209592270525302184,TRX_N-00567-62472042,2024-01-12T16:03:36,Labastida,Expense,leisure,-280.7,-18009.42
buyer_8,Antonio,45,ES81209592270525302184,TRX_N-00568-00447204,2024-01-13T18:46:37,Erandio,Expense,food,-474.29,-18483.71
buyer_8,Antonio,45,ES81209592270525302184,TRX_N-00569-01117049,2024-01-23T07:33:03,Getxo,Expense,leisure,-103.31,-18587.02
buyer_8,Antonio,45,ES81209592270525302184,TRX_N-00570-36458451,2024-01-25T20:48:46,Labastida,Expense,leisure,-285.65,-18872.67
buyer_8,Antonio,45,ES81209592270525302184,TRX_N-00571-50199316,2024-01-31T17:11:47,Labastida,Expense,transport,-42.83,-18915.5
buyer_8,Antonio,45,ES81209592270525302184,TRX_N-00572-41523311,2024-02-01T17:58:18,Labastida,transfer,Salary,1912.39,-17003.11
buyer_8,Antonio,45,ES81209592270525302184,TRX_N-00573-17096784,2024-02-05T10:28:44,Labastida,Housing,Mortgage,-978.24,-17981.35
buyer_8,Antonio,45,ES81209592270525302184,TRX_N-00574-91752977,2024-02-06T11:42:46,Labastida,Basic services,water,-73.97,-18055.32
buyer_8,Antonio,45,ES81209592270525302184,TRX_N-00575-56845117,2024-02-06T17:11:25,Labastida,Basic services,electricity,-61.21,-18116.53
buyer_8,Antonio,45,ES81209592270525302184,TRX_N-00576-06726660,2024-02-06T20:58:10,Labastida,Basic services,gas,-38.81,-18155.34
buyer_8,Antonio,45,ES81209592270525302184,TRX_N-00577-44313664,2024-02-06T12:02:44,Labastida,Basic services,phone,-36.67,-18192.01
buyer_8,Antonio,45,ES81209592270525302184,TRX_N-00578-12463043,2024-02-07T18:25:30,Labastida,Basic services,phone,-49.14,-18241.15
buyer_8,Antonio,45,ES81209592270525302184,TRX_N-00579-47880922,2024-02-18T12:40:27,Sestao,Expense,leisure,-92.11,-18333.26
buyer_8,Antonio,45,ES81209592270525302184,TRX_N-00580-05541270,2024-02-27T19:27:42,Labastida,Expense,transport,-95.69,-18428.95
buyer_8,Antonio,45,ES81209592270525302184,TRX_N-00581-31459793,2024-03-01T07:25:04,Labastida,transfer,Salary,1912.39,-16516.56
buyer_8,Antonio,45,ES81209592270525302184,TRX_N-00582-07905505,2024-03-01T04:57:36,Labastida,Expense,leisure,-214.62,-16731.18
buyer_8,Antonio,45,ES81209592270525302184,TRX_N-00583-68991504,2024-03-05T09:38:49,Labastida,Housing,Mortgage,-978.24,-17709.42
buyer_8,Antonio,45,ES81209592270525302184,TRX_N-00584-23536570,2024-03-05T18:26:46,Labastida,Basic services,gas,-17.43,-17726.85
buyer_8,Antonio,45,ES81209592270525302184,TRX_N-00585-81395688,2024-03-05T16:25:08,Labastida,Basic services,internet,-49.97,-17776.82
buyer_8,Antonio,45,ES81209592270525302184,TRX_N-00586-08130224,2024-03-05T10:48:42,Labastida,Basic services,phone,-54.28,-17831.1
buyer_8,Antonio,45,ES81209592270525302184,TRX_N-00587-50370368,2024-03-06T22:10:50,Labastida,Basic services,phone,-82.96,-17914.06
buyer_8,Antonio,45,ES81209592270525302184,TRX_N-00588-96176254,2024-03-07T22:56:03,Labastida,Basic services,water,-20.92,-17934.98
buyer_8,Antonio,45,ES81209592270525302184,TRX_N-00589-28804876,2024-04-01T18:33:26,Labastida,transfer,Salary,1912.39,-16022.59
buyer_8,Antonio,45,ES81209592270525302184,TRX_N-00590-36028423,2024-04-01T18:33:26,Labastida,transfer,Extra Income,191.24,-15831.35
buyer_8,Antonio,45,ES81209592270525302184,TRX_N-00591-77870932,2024-04-02T12:31:49,Labastida,Expense,healthcare,-389.15,-16220.5
buyer_8,Antonio,45,ES81209592270525302184,TRX_N-00592-22293808,2024-04-05T19:16:16,Labastida,Housing,Mortgage,-978.24,-17198.74
buyer_8,Antonio,45,ES81209592270525302184,TRX_N-00593-81227466,2024-04-05T16:21:48,Labastida,Basic services,electricity,-139.73,-17338.47
buyer_8,Antonio,45,ES81209592270525302184,TRX_N-00594-69897964,2024-04-05T09:17:27,Labastida,Basic services,internet,-56.49,-17394.96
buyer_8,Antonio,45,ES81209592270525302184,TRX_N-00595-28307409,2024-04-06T19:02:35,Labastida,Basic services,electricity,-23.65,-17418.61
buyer_8,Antonio,45,ES81209592270525302184,TRX_N-00596-12847749,2024-04-07T21:12:53,Labastida,Basic services,electricity,-142.83,-17561.44
buyer_8,Antonio,45,ES81209592270525302184,TRX_N-00597-50524477,2024-04-25T11:48:39,Erandio,Expense,food,-318.49,-17879.93
buyer_8,Antonio,45,ES81209592270525302184,TRX_N-00598-39593775,2024-05-01T10:00:27,Labastida,transfer,Salary,1912.39,-15967.54
buyer_8,Antonio,45,ES81209592270525302184,TRX_N-00599-88860243,2024-05-01T17:28:11,Labastida,Expense,transport,-130.69,-16098.23
buyer_8,Antonio,45,ES81209592270525302184,TRX_N-00600-77234579,2024-05-02T14:15:40,Labastida,Expense,leisure,-74.23,-16172.46
buyer_8,Antonio,45,ES81209592270525302184,TRX_N-00601-64710353,2024-05-03T21:39:20,Labastida,Expense,repairs,-933.02,-17105.48
buyer_8,Antonio,45,ES81209592270525302184,TRX_N-00602-39186627,2024-05-05T17:15:16,Labastida,Housing,Mortgage,-978.24,-18083.72
buyer_8,Antonio,45,ES81209592270525302184,TRX_N-00603-87591871,2024-05-05T13:53:00,Labastida,Basic services,water,-74.12,-18157.84
buyer_8,Antonio,45,ES81209592270525302184,TRX_N-00604-68728650,2024-05-05T12:36:14,Labastida,Basic services,phone,-71.74,-18229.58
buyer_8,Antonio,45,ES81209592270525302184,TRX_N-00605-42007469,2024-05-06T13:43:19,Labastida,Basic services,water,-37.41,-18266.99
buyer_8,Antonio,45,ES81209592270525302184,TRX_N-00606-22855150,2024-05-06T09:33:25,Labastida,Basic services,gas,-68.67,-18335.66
buyer_8,Antonio,45,ES81209592270525302184,TRX_N-00607-19004130,2024-05-06T10:06:19,Labastida,Basic services,internet,-74.82,-18410.48
buyer_8,Antonio,45,ES81209592270525302184,TRX_N-00608-88217002,2024-05-07T22:51:50,Labastida,Basic services,electricity,-65.23,-18475.71
buyer_8,Antonio,45,ES81209592270525302184,TRX_N-00609-75726675,2024-05-07T15:43:22,Labastida,Basic services,gas,-63.19,-18538.9
buyer_8,Antonio,45,ES81209592270525302184,TRX_N-00610-45085397,2024-05-07T12:54:59,Labastida,Basic services,phone,-56.63,-18595.53
buyer_8,Antonio,45,ES81209592270525302184,TRX_N-00611-09896563,2024-05-07T04:41:31,Labastida,Expense,leisure,-123.6,-18719.13
buyer_8,Antonio,45,ES81209592270525302184,TRX_N-00612-07953173,2024-05-12T15:08:52,Labastida,Expense,food,-188.66,-18907.79
buyer_8,Antonio,45,ES81209592270525302184,TRX_N-00613-02918149,2024-05-24T00:56:15,Labastida,Expense,food,-541.12,-19448.91
buyer_8,Antonio,45,ES81209592270525302184,TRX_N-00614-88822142,2024-05-28T15:53:27,Hernani,Expense,leisure,-168.59,-19617.5
buyer_8,Antonio,45,ES81209592270525302184,TRX_N-00615-21911195,2024-05-30T20:34:00,Labastida,Expense,healthcare,-67.89,-19685.39
buyer_8,Antonio,45,ES81209592270525302184,TRX_N-00616-59256030,2024-05-30T17:36:08,Labastida,Expense,travel,-1518.94,-21204.33
buyer_8,Antonio,45,ES81209592270525302184,TRX_N-00617-32009004,2024-06-01T15:01:16,Labastida,transfer,Salary,1912.39,-19291.94
buyer_8,Antonio,45,ES81209592270525302184,TRX_N-00618-99375404,2024-06-01T15:01:16,Labastida,transfer,Extra Income,191.24,-19100.7
buyer_8,Antonio,45,ES81209592270525302184,TRX_N-00619-25457163,2024-06-01T15:01:16,Labastida,transfer,Bonus,1726.75,-17373.95
buyer_8,Antonio,45,ES81209592270525302184,TRX_N-00620-54011772,2024-06-05T11:30:51,Labastida,Housing,Mortgage,-978.24,-18352.19
buyer_8,Antonio,45,ES81209592270525302184,TRX_N-00621-88935763,2024-06-05T15:59:42,Labastida,Basic services,water,-27.45,-18379.64
buyer_8,Antonio,45,ES81209592270525302184,TRX_N-00622-21281910,2024-06-05T21:33:29,Labastida,Basic services,electricity,-44.57,-18424.21
buyer_8,Antonio,45,ES81209592270525302184,TRX_N-00623-26866992,2024-06-05T13:08:30,Labastida,Basic services,internet,-71.83,-18496.04
buyer_8,Antonio,45,ES81209592270525302184,TRX_N-00624-63428003,2024-06-05T14:59:55,Labastida,Basic services,phone,-40.55,-18536.59
buyer_8,Antonio,45,ES81209592270525302184,TRX_N-00625-25764447,2024-06-06T14:37:28,Labastida,Basic services,gas,-90.58,-18627.17
buyer_8,Antonio,45,ES81209592270525302184,TRX_N-00626-17525160,2024-06-07T01:09:34,Labastida,Basic services,electricity,-110.26,-18737.43
buyer_8,Antonio,45,ES81209592270525302184,TRX_N-00627-85466584,2024-06-07T09:00:59,Labastida,Basic services,internet,-40.69,-18778.12
buyer_8,Antonio,45,ES81209592270525302184,TRX_N-00628-07750562,2024-06-08T20:13:15,Labastida,Expense,transport,-172.26,-18950.38
buyer_8,Antonio,45,ES81209592270525302184,TRX_N-00629-54341095,2024-06-16T18:04:04,Labastida,Expense,clothing,-273.14,-19223.52
buyer_8,Antonio,45,ES81209592270525302184,TRX_N-00630-84922619,2024-06-23T20:37:23,Labastida,Expense,gifts,-287.7,-19511.22
buyer_8,Antonio,45,ES81209592270525302184,TRX_N-00631-59104892,2024-06-24T19:11:16,Labastida,Expense,food,-736.96,-20248.18
buyer_8,Antonio,45,ES81209592270525302184,TRX_N-00632-74692944,2024-07-01T12:24:28,Labastida,transfer,Salary,1912.39,-18335.79
buyer_8,Antonio,45,ES81209592270525302184,TRX_N-00633-15128003,2024-07-04T15:30:44,Labastida,Expense,food,-515.21,-18851.0
buyer_8,Antonio,45,ES81209592270525302184,TRX_N-00634-89761803,2024-07-05T19:04:43,Labastida,Housing,Mortgage,-978.24,-19829.24
buyer_8,Antonio,45,ES81209592270525302184,TRX_N-00635-52996524,2024-07-05T04:35:49,Labastida,Basic services,phone,-23.56,-19852.8
buyer_8,Antonio,45,ES81209592270525302184,TRX_N-00636-77353265,2024-07-06T09:35:14,Labastida,Basic services,water,-73.99,-19926.79
buyer_8,Antonio,45,ES81209592270525302184,TRX_N-00637-04187683,2024-07-06T15:13:14,Labastida,Basic services,electricity,-49.08,-19975.87
buyer_8,Antonio,45,ES81209592270525302184,TRX_N-00638-57502047,2024-07-06T08:12:41,Labastida,Basic services,gas,-69.19,-20045.06
buyer_8,Antonio,45,ES81209592270525302184,TRX_N-00639-04763314,2024-07-06T16:48:37,Labastida,Basic services,internet,-64.84,-20109.9
buyer_8,Antonio,45,ES81209592270525302184,TRX_N-00640-31313145,2024-07-06T15:28:25,Labastida,Basic services,phone,-59.38,-20169.28
buyer_8,Antonio,45,ES81209592270525302184,TRX_N-00641-83734597,2024-07-06T10:58:33,Portugalete,Expense,transport,-107.56,-20276.84
buyer_8,Antonio,45,ES81209592270525302184,TRX_N-00642-72687569,2024-07-07T09:37:17,Labastida,Basic services,water,-69.44,-20346.28
buyer_8,Antonio,45,ES81209592270525302184,TRX_N-00643-60095544,2024-07-07T12:56:54,Labastida,Basic services,phone,-77.82,-20424.1
buyer_8,Antonio,45,ES81209592270525302184,TRX_N-00644-31798094,2024-07-11T15:38:26,Labastida,Expense,food,-292.38,-20716.48
buyer_8,Antonio,45,ES81209592270525302184,TRX_N-00645-88883379,2024-07-12T13:54:41,Labastida,Expense,leisure,-266.93,-20983.41
buyer_8,Antonio,45,ES81209592270525302184,TRX_N-00646-46139077,2024-07-28T20:15:23,Labastida,Expense,gifts,-366.23,-21349.64
buyer_8,Antonio,45,ES81209592270525302184,TRX_N-00647-04961430,2024-07-30T20:18:19,Labastida,Expense,healthcare,-304.78,-21654.42
buyer_8,Antonio,45,ES81209592270525302184,TRX_N-00648-52319086,2024-08-01T23:28:07,Labastida,transfer,Salary,1912.39,-19742.03
buyer_8,Antonio,45,ES81209592270525302184,TRX_N-00649-00616499,2024-08-03T09:45:46,Labastida,Expense,food,-369.37,-20111.4
buyer_8,Antonio,45,ES81209592270525302184,TRX_N-00650-32907654,2024-08-05T10:11:56,Labastida,Housing,Mortgage,-978.24,-21089.64
buyer_8,Antonio,45,ES81209592270525302184,TRX_N-00651-82781504,2024-08-05T10:01:04,Labastida,Basic services,gas,-30.63,-21120.27
buyer_8,Antonio,45,ES81209592270525302184,TRX_N-00652-67747212,2024-08-05T17:44:00,Labastida,Basic services,internet,-56.15,-21176.42
buyer_8,Antonio,45,ES81209592270525302184,TRX_N-00653-51474741,2024-08-06T20:05:49,Labastida,Basic services,water,-28.24,-21204.66
buyer_8,Antonio,45,ES81209592270525302184,TRX_N-00654-70366241,2024-08-06T16:06:59,Labastida,Basic services,gas,-95.48,-21300.14
buyer_8,Antonio,45,ES81209592270525302184,TRX_N-00655-61236301,2024-08-07T00:37:48,Labastida,Basic services,internet,-71.01,-21371.15
buyer_8,Antonio,45,ES81209592270525302184,TRX_N-00656-57694008,2024-08-20T15:37:27,Labastida,Expense,transport,-88.39,-21459.54
buyer_8,Antonio,45,ES81209592270525302184,TRX_N-00657-72301073,2024-09-01T12:53:58,Labastida,transfer,Salary,1912.39,-19547.15
buyer_8,Antonio,45,ES81209592270525302184,TRX_N-00658-48923928,2024-09-01T12:53:58,Labastida,transfer,Extra Income,191.24,-19355.91
buyer_8,Antonio,45,ES81209592270525302184,TRX_N-00659-72205317,2024-09-05T11:02:53,Labastida,Housing,Mortgage,-978.24,-20334.15
buyer_8,Antonio,45,ES81209592270525302184,TRX_N-00660-95745739,2024-09-05T04:27:31,Labastida,Basic services,phone,-68.34,-20402.49
buyer_8,Antonio,45,ES81209592270525302184,TRX_N-00661-57067471,2024-09-05T15:57:05,Labastida,Expense,travel,-1796.42,-22198.91
buyer_8,Antonio,45,ES81209592270525302184,TRX_N-00662-17382416,2024-09-06T10:01:10,Labastida,Basic services,water,-51.07,-22249.98
buyer_8,Antonio,45,ES81209592270525302184,TRX_N-00663-58869563,2024-09-06T12:18:02,Labastida,Basic services,electricity,-70.45,-22320.43
buyer_8,Antonio,45,ES81209592270525302184,TRX_N-00664-51404624,2024-09-06T23:26:39,Labastida,Basic services,internet,-58.51,-22378.94
buyer_8,Antonio,45,ES81209592270525302184,TRX_N-00665-96641626,2024-09-10T01:55:44,Labastida,Expense,food,-290.67,-22669.61
buyer_8,Antonio,45,ES81209592270525302184,TRX_N-00666-24185086,2024-09-11T03:32:18,Labastida,Expense,food,-706.7,-23376.31
buyer_8,Antonio,45,ES81209592270525302184,TRX_N-00667-78382610,2024-09-18T17:18:28,Berango,Expense,clothing,-70.54,-23446.85
buyer_8,Antonio,45,ES81209592270525302184,TRX_N-00668-10815909,2024-09-23T18:41:39,Labastida,Expense,healthcare,-146.89,-23593.74
buyer_8,Antonio,45,ES81209592270525302184,TRX_N-00669-47797044,2024-09-24T19:55:26,Labastida,Expense,travel,-2848.02,-26441.76
buyer_8,Antonio,45,ES81209592270525302184,TRX_N-00670-23621353,2024-10-01T20:01:24,Labastida,transfer,Salary,1912.39,-24529.37
buyer_8,Antonio,45,ES81209592270525302184,TRX_N-00671-56420020,2024-10-01T10:15:15,Labastida,Expense,clothing,-490.72,-25020.09
buyer_8,Antonio,45,ES81209592270525302184,TRX_N-00672-28672407,2024-10-03T16:03:35,Labastida,Expense,clothing,-417.28,-25437.37
buyer_8,Antonio,45,ES81209592270525302184,TRX_N-00673-44572739,2024-10-05T17:14:12,Labastida,Housing,Mortgage,-978.24,-26415.61
buyer_8,Antonio,45,ES81209592270525302184,TRX_N-00674-89416439,2024-10-05T13:01:08,Labastida,Basic services,electricity,-109.13,-26524.74
buyer_8,Antonio,45,ES81209592270525302184,TRX_N-00675-01372262,2024-10-05T19:38:00,Labastida,Basic services,phone,-62.46,-26587.2
buyer_8,Antonio,45,ES81209592270525302184,TRX_N-00676-41415838,2024-10-05T15:50:33,Erandio,Expense,repairs,-133.39,-26720.59
buyer_8,Antonio,45,ES81209592270525302184,TRX_N-00677-97804911,2024-10-06T12:31:06,Labastida,Basic services,electricity,-105.2,-26825.79
buyer_8,Antonio,45,ES81209592270525302184,TRX_N-00678-90615388,2024-10-07T09:26:50,Labastida,Basic services,water,-37.96,-26863.75
buyer_8,Antonio,45,ES81209592270525302184,TRX_N-00679-55452594,2024-10-07T12:32:30,Labastida,Basic services,gas,-32.68,-26896.43
buyer_8,Antonio,45,ES81209592270525302184,TRX_N-00680-63464276,2024-10-07T11:41:57,Labastida,Basic services,internet,-66.92,-26963.35
buyer_8,Antonio,45,ES81209592270525302184,TRX_N-00681-36104969,2024-10-07T17:18:30,Labastida,Basic services,phone,-61.83,-27025.18
