profile,name,surname,birth_date,dni,email,password,iban,assets,timestamp,city,type,category,amount,balance
buyer_1,Luis,Garay,1996-08-10,20670070Q,luis.garay@awesomedata.io,449238,ES57209552411520511223,3831.73,2022-01-01T20:14:25,Bilbao,incomes,salary,2656.82,6488.55
buyer_1,Luis,Garay,1996-08-10,20670070Q,luis.garay@awesomedata.io,449238,ES57209552411520511223,3831.73,2022-01-01T12:15:38,Bilbao,expenses,clothing,-77.28,6411.27
buyer_1,Luis,Garay,1996-08-10,20670070Q,luis.garay@awesomedata.io,449238,ES57209552411520511223,3831.73,2022-01-01T08:34:10,Bilbao,expenses,travel,-844.1,5567.17
buyer_1,Luis,Garay,1996-08-10,20670070Q,luis.garay@awesomedata.io,449238,ES57209552411520511223,3831.73,2022-01-01T23:19:18,Bilbao,expenses,gifts,-158.44,5408.73
buyer_1,Luis,Garay,1996-08-10,20670070Q,luis.garay@awesomedata.io,449238,ES57209552411520511223,3831.73,2022-01-02T10:00:33,Bilbao,expenses,leisure,-73.94,5334.79
buyer_1,Luis,Garay,1996-08-10,20670070Q,luis.garay@awesomedata.io,449238,ES57209552411520511223,3831.73,2022-01-03T12:39:11,Bilbao,expenses,clothing,-132.49,5202.3
buyer_1,Luis,Garay,1996-08-10,20670070Q,luis.garay@awesomedata.io,449238,ES57209552411520511223,3831.73,2022-01-03T14:56:21,Bilbao,expenses,cash,-100.0,5102.3
buyer_1,Luis,Garay,1996-08-10,20670070Q,luis.garay@awesomedata.io,449238,ES57209552411520511223,3831.73,2022-01-04T12:12:55,Bilbao,expenses,rent,-818.29,4284.01
buyer_1,Luis,Garay,1996-08-10,20670070Q,luis.garay@awesomedata.io,449238,ES57209552411520511223,3831.73,2022-01-05T11:38:54,Bilbao,expenses,water,-31.84,4252.17
buyer_1,Luis,Garay,1996-08-10,20670070Q,luis.garay@awesomedata.io,449238,ES57209552411520511223,3831.73,2022-01-05T11:55:12,Bilbao,expenses,transport,-83.88,4168.29
buyer_1,Luis,Garay,1996-08-10,20670070Q,luis.garay@awesomedata.io,449238,ES57209552411520511223,3831.73,2022-01-05T18:00:15,Bilbao,expenses,leisure,-29.73,4138.56
buyer_1,Luis,Garay,1996-08-10,20670070Q,luis.garay@awesomedata.io,449238,ES57209552411520511223,3831.73,2022-01-05T09:22:57,Bilbao,expenses,healthcare,-85.08,4053.48
buyer_1,Luis,Garay,1996-08-10,20670070Q,luis.garay@awesomedata.io,449238,ES57209552411520511223,3831.73,2022-01-06T20:48:23,Bilbao,expenses,water,-42.29,4011.19
buyer_1,Luis,Garay,1996-08-10,20670070Q,luis.garay@awesomedata.io,449238,ES57209552411520511223,3831.73,2022-01-06T20:13:14,Bilbao,expenses,electricity,-80.7,3930.49
buyer_1,Luis,Garay,1996-08-10,20670070Q,luis.garay@awesomedata.io,449238,ES57209552411520511223,3831.73,2022-01-06T12:35:56,Bilbao,expenses,gas,-53.72,3876.77
buyer_1,Luis,Garay,1996-08-10,20670070Q,luis.garay@awesomedata.io,449238,ES57209552411520511223,3831.73,2022-01-06T15:24:55,Bilbao,expenses,phone,-40.72,3836.05
buyer_1,Luis,Garay,1996-08-10,20670070Q,luis.garay@awesomedata.io,449238,ES57209552411520511223,3831.73,2022-01-06T21:50:11,Bilbao,expenses,food,-60.09,3775.96
buyer_1,Luis,Garay,1996-08-10,20670070Q,luis.garay@awesomedata.io,449238,ES57209552411520511223,3831.73,2022-01-07T19:42:40,Bilbao,expenses,water,-33.54,3742.42
buyer_1,Luis,Garay,1996-08-10,20670070Q,luis.garay@awesomedata.io,449238,ES57209552411520511223,3831.73,2022-01-07T23:23:47,Bilbao,expenses,repairs,-204.48,3537.94
buyer_1,Luis,Garay,1996-08-10,20670070Q,luis.garay@awesomedata.io,449238,ES57209552411520511223,3831.73,2022-01-08T11:36:41,Bilbao,expenses,water,-40.77,3497.17
buyer_1,Luis,Garay,1996-08-10,20670070Q,luis.garay@awesomedata.io,449238,ES57209552411520511223,3831.73,2022-01-08T15:00:39,Bilbao,expenses,electricity,-103.65,3393.52
buyer_1,Luis,Garay,1996-08-10,20670070Q,luis.garay@awesomedata.io,449238,ES57209552411520511223,3831.73,2022-01-08T16:56:56,Bilbao,expenses,education,-60.23,3333.29
buyer_1,Luis,Garay,1996-08-10,20670070Q,luis.garay@awesomedata.io,449238,ES57209552411520511223,3831.73,2022-01-09T11:15:37,Bilbao,expenses,clothing,-47.03,3286.26
buyer_1,Luis,Garay,1996-08-10,20670070Q,luis.garay@awesomedata.io,449238,ES57209552411520511223,3831.73,2022-01-10T08:40:48,Bilbao,expenses,leisure,-55.55,3230.71
buyer_1,Luis,Garay,1996-08-10,20670070Q,luis.garay@awesomedata.io,449238,ES57209552411520511223,3831.73,2022-01-11T09:59:12,Bilbao,expenses,repairs,-152.03,3078.68
buyer_1,Luis,Garay,1996-08-10,20670070Q,luis.garay@awesomedata.io,449238,ES57209552411520511223,3831.73,2022-01-12T10:50:25,Bilbao,expenses,leisure,-76.91,3001.77
buyer_1,Luis,Garay,1996-08-10,20670070Q,luis.garay@awesomedata.io,449238,ES57209552411520511223,3831.73,2022-01-14T15:52:49,Bilbao,expenses,leisure,-33.91,2967.86
buyer_1,Luis,Garay,1996-08-10,20670070Q,luis.garay@awesomedata.io,449238,ES57209552411520511223,3831.73,2022-01-15T21:41:08,Bilbao,expenses,food,-107.56,2860.3
buyer_1,Luis,Garay,1996-08-10,20670070Q,luis.garay@awesomedata.io,449238,ES57209552411520511223,3831.73,2022-01-16T09:35:01,Bilbao,expenses,food,-90.15,2770.15
buyer_1,Luis,Garay,1996-08-10,20670070Q,luis.garay@awesomedata.io,449238,ES57209552411520511223,3831.73,2022-01-16T19:23:38,Bilbao,expenses,clothing,-66.21,2703.94
buyer_1,Luis,Garay,1996-08-10,20670070Q,luis.garay@awesomedata.io,449238,ES57209552411520511223,3831.73,2022-01-20T15:00:06,Bilbao,expenses,transport,-72.15,2631.79
buyer_1,Luis,Garay,1996-08-10,20670070Q,luis.garay@awesomedata.io,449238,ES57209552411520511223,3831.73,2022-01-22T09:39:41,Bilbao,expenses,cash,-100.0,2531.79
buyer_1,Luis,Garay,1996-08-10,20670070Q,luis.garay@awesomedata.io,449238,ES57209552411520511223,3831.73,2022-01-22T14:12:59,Bilbao,expenses,gifts,-616.42,1915.37
buyer_1,Luis,Garay,1996-08-10,20670070Q,luis.garay@awesomedata.io,449238,ES57209552411520511223,3831.73,2022-01-25T12:34:52,Bilbao,expenses,leisure,-65.99,1849.38
buyer_1,Luis,Garay,1996-08-10,20670070Q,luis.garay@awesomedata.io,449238,ES57209552411520511223,3831.73,2022-01-26T10:50:33,Bilbao,expenses,leisure,-77.39,1771.99
buyer_1,Luis,Garay,1996-08-10,20670070Q,luis.garay@awesomedata.io,449238,ES57209552411520511223,3831.73,2022-01-27T08:55:10,Bilbao,expenses,transport,-52.8,1719.19
buyer_1,Luis,Garay,1996-08-10,20670070Q,luis.garay@awesomedata.io,449238,ES57209552411520511223,3831.73,2022-01-30T01:38:42,Bilbao,expenses,education,-69.35,1649.84
buyer_1,Luis,Garay,1996-08-10,20670070Q,luis.garay@awesomedata.io,449238,ES57209552411520511223,3831.73,2022-01-30T20:54:32,Bilbao,expenses,repairs,-267.18,1382.66
buyer_1,Luis,Garay,1996-08-10,20670070Q,luis.garay@awesomedata.io,449238,ES57209552411520511223,3831.73,2022-02-01T20:45:06,Bilbao,incomes,salary,2656.82,4039.48
buyer_1,Luis,Garay,1996-08-10,20670070Q,luis.garay@awesomedata.io,449238,ES57209552411520511223,3831.73,2022-02-01T09:37:20,Bilbao,expenses,travel,-487.94,3551.54
buyer_1,Luis,Garay,1996-08-10,20670070Q,luis.garay@awesomedata.io,449238,ES57209552411520511223,3831.73,2022-02-02T04:12:56,Bilbao,expenses,repairs,-242.99,3308.55
buyer_1,Luis,Garay,1996-08-10,20670070Q,luis.garay@awesomedata.io,449238,ES57209552411520511223,3831.73,2022-02-03T18:16:36,Bilbao,expenses,transport,-83.24,3225.31
buyer_1,Luis,Garay,1996-08-10,20670070Q,luis.garay@awesomedata.io,449238,ES57209552411520511223,3831.73,2022-02-04T13:45:20,Bilbao,expenses,rent,-818.29,2407.02
buyer_1,Luis,Garay,1996-08-10,20670070Q,luis.garay@awesomedata.io,449238,ES57209552411520511223,3831.73,2022-02-04T23:10:07,Bilbao,expenses,food,-93.24,2313.78
buyer_1,Luis,Garay,1996-08-10,20670070Q,luis.garay@awesomedata.io,449238,ES57209552411520511223,3831.73,2022-02-05T11:22:10,Bilbao,expenses,cash,-100.0,2213.78
buyer_1,Luis,Garay,1996-08-10,20670070Q,luis.garay@awesomedata.io,449238,ES57209552411520511223,3831.73,2022-02-06T13:13:55,Bilbao,expenses,leisure,-43.82,2169.96
buyer_1,Luis,Garay,1996-08-10,20670070Q,luis.garay@awesomedata.io,449238,ES57209552411520511223,3831.73,2022-02-06T10:16:04,Bilbao,expenses,cash,-100.0,2069.96
buyer_1,Luis,Garay,1996-08-10,20670070Q,luis.garay@awesomedata.io,449238,ES57209552411520511223,3831.73,2022-02-07T20:48:33,Bilbao,expenses,water,-55.21,2014.75
buyer_1,Luis,Garay,1996-08-10,20670070Q,luis.garay@awesomedata.io,449238,ES57209552411520511223,3831.73,2022-02-07T17:45:00,Bilbao,expenses,electricity,-99.05,1915.7
buyer_1,Luis,Garay,1996-08-10,20670070Q,luis.garay@awesomedata.io,449238,ES57209552411520511223,3831.73,2022-02-08T18:15:52,Bilbao,expenses,water,-47.71,1867.99
buyer_1,Luis,Garay,1996-08-10,20670070Q,luis.garay@awesomedata.io,449238,ES57209552411520511223,3831.73,2022-02-08T04:24:07,Bilbao,expenses,gas,-122.72,1745.27
buyer_1,Luis,Garay,1996-08-10,20670070Q,luis.garay@awesomedata.io,449238,ES57209552411520511223,3831.73,2022-02-08T09:16:32,Bilbao,expenses,phone,-51.86,1693.41
buyer_1,Luis,Garay,1996-08-10,20670070Q,luis.garay@awesomedata.io,449238,ES57209552411520511223,3831.73,2022-02-10T15:36:13,Bilbao,expenses,food,-118.59,1574.82
buyer_1,Luis,Garay,1996-08-10,20670070Q,luis.garay@awesomedata.io,449238,ES57209552411520511223,3831.73,2022-02-10T20:52:53,Bilbao,expenses,leisure,-74.82,1500.0
buyer_1,Luis,Garay,1996-08-10,20670070Q,luis.garay@awesomedata.io,449238,ES57209552411520511223,3831.73,2022-02-10T12:30:18,Bilbao,expenses,cash,-100.0,1400.0
buyer_1,Luis,Garay,1996-08-10,20670070Q,luis.garay@awesomedata.io,449238,ES57209552411520511223,3831.73,2022-02-10T10:40:08,Bilbao,expenses,travel,-798.06,601.94
buyer_1,Luis,Garay,1996-08-10,20670070Q,luis.garay@awesomedata.io,449238,ES57209552411520511223,3831.73,2022-02-11T15:18:31,Bilbao,expenses,gifts,-217.35,384.59
buyer_1,Luis,Garay,1996-08-10,20670070Q,luis.garay@awesomedata.io,449238,ES57209552411520511223,3831.73,2022-02-12T10:22:32,Bilbao,expenses,cash,-100.0,284.59
buyer_1,Luis,Garay,1996-08-10,20670070Q,luis.garay@awesomedata.io,449238,ES57209552411520511223,3831.73,2022-02-15T16:37:13,Bilbao,expenses,food,-78.83,205.76
buyer_1,Luis,Garay,1996-08-10,20670070Q,luis.garay@awesomedata.io,449238,ES57209552411520511223,3831.73,2022-02-15T16:20:49,Bilbao,expenses,transport,-85.14,120.62
buyer_1,Luis,Garay,1996-08-10,20670070Q,luis.garay@awesomedata.io,449238,ES57209552411520511223,3831.73,2022-02-15T12:40:21,Bilbao,expenses,cash,-100.0,20.62
buyer_1,Luis,Garay,1996-08-10,20670070Q,luis.garay@awesomedata.io,449238,ES57209552411520511223,3831.73,2022-02-15T15:14:42,Bilbao,expenses,repairs,-67.61,-46.99
buyer_1,Luis,Garay,1996-08-10,20670070Q,luis.garay@awesomedata.io,449238,ES57209552411520511223,3831.73,2022-02-19T19:56:52,Bilbao,expenses,education,-66.91,-113.9
buyer_1,Luis,Garay,1996-08-10,20670070Q,luis.garay@awesomedata.io,449238,ES57209552411520511223,3831.73,2022-02-19T08:17:26,Bilbao,expenses,repairs,-310.49,-424.39
buyer_1,Luis,Garay,1996-08-10,20670070Q,luis.garay@awesomedata.io,449238,ES57209552411520511223,3831.73,2022-02-22T08:38:57,Bilbao,expenses,food,-105.41,-529.8
buyer_1,Luis,Garay,1996-08-10,20670070Q,luis.garay@awesomedata.io,449238,ES57209552411520511223,3831.73,2022-02-23T19:01:12,Bilbao,expenses,transport,-59.83,-589.63
buyer_1,Luis,Garay,1996-08-10,20670070Q,luis.garay@awesomedata.io,449238,ES57209552411520511223,3831.73,2022-02-24T10:07:38,Bilbao,expenses,food,-87.99,-677.62
buyer_1,Luis,Garay,1996-08-10,20670070Q,luis.garay@awesomedata.io,449238,ES57209552411520511223,3831.73,2022-02-24T05:21:14,Bilbao,expenses,cash,-100.0,-777.62
buyer_1,Luis,Garay,1996-08-10,20670070Q,luis.garay@awesomedata.io,449238,ES57209552411520511223,3831.73,2022-02-25T20:28:25,Bilbao,expenses,cash,-100.0,-877.62
buyer_1,Luis,Garay,1996-08-10,20670070Q,luis.garay@awesomedata.io,449238,ES57209552411520511223,3831.73,2022-02-26T16:13:01,Bilbao,expenses,cash,-100.0,-977.62
buyer_1,Luis,Garay,1996-08-10,20670070Q,luis.garay@awesomedata.io,449238,ES57209552411520511223,3831.73,2022-02-28T15:34:17,Bilbao,expenses,clothing,-89.99,-1067.61
buyer_1,Luis,Garay,1996-08-10,20670070Q,luis.garay@awesomedata.io,449238,ES57209552411520511223,3831.73,2022-02-28T17:30:58,Bilbao,expenses,cash,-100.0,-1167.61
buyer_1,Luis,Garay,1996-08-10,20670070Q,luis.garay@awesomedata.io,449238,ES57209552411520511223,3831.73,2022-03-01T17:25:09,Bilbao,incomes,salary,2656.82,1489.21
buyer_1,Luis,Garay,1996-08-10,20670070Q,luis.garay@awesomedata.io,449238,ES57209552411520511223,3831.73,2022-03-01T13:23:17,Bilbao,expenses,leisure,-70.67,1418.54
buyer_1,Luis,Garay,1996-08-10,20670070Q,luis.garay@awesomedata.io,449238,ES57209552411520511223,3831.73,2022-03-01T08:50:59,Bilbao,expenses,gifts,-459.09,959.45
buyer_1,Luis,Garay,1996-08-10,20670070Q,luis.garay@awesomedata.io,449238,ES57209552411520511223,3831.73,2022-03-03T18:47:17,Bilbao,expenses,food,-109.48,849.97
buyer_1,Luis,Garay,1996-08-10,20670070Q,luis.garay@awesomedata.io,449238,ES57209552411520511223,3831.73,2022-03-04T22:29:24,Bilbao,expenses,rent,-818.29,31.68
buyer_1,Luis,Garay,1996-08-10,20670070Q,luis.garay@awesomedata.io,449238,ES57209552411520511223,3831.73,2022-03-05T17:51:50,Bilbao,expenses,food,-94.36,-62.68
buyer_1,Luis,Garay,1996-08-10,20670070Q,luis.garay@awesomedata.io,449238,ES57209552411520511223,3831.73,2022-03-06T10:26:07,Bilbao,expenses,gas,-49.09,-111.77
buyer_1,Luis,Garay,1996-08-10,20670070Q,luis.garay@awesomedata.io,449238,ES57209552411520511223,3831.73,2022-03-08T15:30:40,Bilbao,expenses,appliances,-399.64,-511.41
buyer_1,Luis,Garay,1996-08-10,20670070Q,luis.garay@awesomedata.io,449238,ES57209552411520511223,3831.73,2022-03-10T12:12:20,Bilbao,expenses,food,-123.94,-635.35
buyer_1,Luis,Garay,1996-08-10,20670070Q,luis.garay@awesomedata.io,449238,ES57209552411520511223,3831.73,2022-03-10T20:27:36,Bilbao,expenses,leisure,-32.84,-668.19
buyer_1,Luis,Garay,1996-08-10,20670070Q,luis.garay@awesomedata.io,449238,ES57209552411520511223,3831.73,2022-03-11T14:11:59,Bilbao,expenses,appliances,-386.38,-1054.57
buyer_1,Luis,Garay,1996-08-10,20670070Q,luis.garay@awesomedata.io,449238,ES57209552411520511223,3831.73,2022-03-11T23:52:48,Bilbao,expenses,repairs,-182.63,-1237.2
buyer_1,Luis,Garay,1996-08-10,20670070Q,luis.garay@awesomedata.io,449238,ES57209552411520511223,3831.73,2022-03-12T06:28:09,Bilbao,expenses,food,-80.15,-1317.35
buyer_1,Luis,Garay,1996-08-10,20670070Q,luis.garay@awesomedata.io,449238,ES57209552411520511223,3831.73,2022-03-12T14:09:31,Bilbao,expenses,leisure,-37.65,-1355.0
buyer_1,Luis,Garay,1996-08-10,20670070Q,luis.garay@awesomedata.io,449238,ES57209552411520511223,3831.73,2022-03-13T21:24:54,Bilbao,expenses,cash,-100.0,-1455.0
buyer_1,Luis,Garay,1996-08-10,20670070Q,luis.garay@awesomedata.io,449238,ES57209552411520511223,3831.73,2022-03-14T23:13:48,Bilbao,expenses,food,-117.01,-1572.01
buyer_1,Luis,Garay,1996-08-10,20670070Q,luis.garay@awesomedata.io,449238,ES57209552411520511223,3831.73,2022-03-15T17:10:05,Bilbao,expenses,food,-107.26,-1679.27
buyer_1,Luis,Garay,1996-08-10,20670070Q,luis.garay@awesomedata.io,449238,ES57209552411520511223,3831.73,2022-03-16T15:20:45,Bilbao,expenses,food,-62.26,-1741.53
buyer_1,Luis,Garay,1996-08-10,20670070Q,luis.garay@awesomedata.io,449238,ES57209552411520511223,3831.73,2022-03-16T14:28:10,Bilbao,expenses,leisure,-77.2,-1818.73
buyer_1,Luis,Garay,1996-08-10,20670070Q,luis.garay@awesomedata.io,449238,ES57209552411520511223,3831.73,2022-03-17T16:45:15,Bilbao,expenses,healthcare,-48.67,-1867.4
buyer_1,Luis,Garay,1996-08-10,20670070Q,luis.garay@awesomedata.io,449238,ES57209552411520511223,3831.73,2022-03-18T13:20:55,Bilbao,expenses,transport,-86.27,-1953.67
buyer_1,Luis,Garay,1996-08-10,20670070Q,luis.garay@awesomedata.io,449238,ES57209552411520511223,3831.73,2022-03-19T11:48:58,Bilbao,expenses,cash,-100.0,-2053.67
buyer_1,Luis,Garay,1996-08-10,20670070Q,luis.garay@awesomedata.io,449238,ES57209552411520511223,3831.73,2022-03-20T16:01:35,Bilbao,expenses,food,-102.97,-2156.64
buyer_1,Luis,Garay,1996-08-10,20670070Q,luis.garay@awesomedata.io,449238,ES57209552411520511223,3831.73,2022-03-25T13:49:05,Bilbao,expenses,transport,-72.67,-2229.31
buyer_1,Luis,Garay,1996-08-10,20670070Q,luis.garay@awesomedata.io,449238,ES57209552411520511223,3831.73,2022-03-25T16:11:44,Bilbao,expenses,travel,-282.06,-2511.37
buyer_1,Luis,Garay,1996-08-10,20670070Q,luis.garay@awesomedata.io,449238,ES57209552411520511223,3831.73,2022-03-26T16:47:02,Bilbao,expenses,leisure,-75.63,-2587.0
buyer_1,Luis,Garay,1996-08-10,20670070Q,luis.garay@awesomedata.io,449238,ES57209552411520511223,3831.73,2022-03-27T10:32:49,Bilbao,expenses,cash,-100.0,-2687.0
buyer_1,Luis,Garay,1996-08-10,20670070Q,luis.garay@awesomedata.io,449238,ES57209552411520511223,3831.73,2022-03-27T14:41:19,Bilbao,expenses,appliances,-126.88,-2813.88
buyer_1,Luis,Garay,1996-08-10,20670070Q,luis.garay@awesomedata.io,449238,ES57209552411520511223,3831.73,2022-03-28T20:08:31,Bilbao,expenses,cash,-100.0,-2913.88
buyer_1,Luis,Garay,1996-08-10,20670070Q,luis.garay@awesomedata.io,449238,ES57209552411520511223,3831.73,2022-03-29T14:18:41,Bilbao,expenses,leisure,-50.03,-2963.91
buyer_1,Luis,Garay,1996-08-10,20670070Q,luis.garay@awesomedata.io,449238,ES57209552411520511223,3831.73,2022-03-29T10:22:00,Bilbao,expenses,education,-69.34,-3033.25
buyer_1,Luis,Garay,1996-08-10,20670070Q,luis.garay@awesomedata.io,449238,ES57209552411520511223,3831.73,2022-03-29T17:00:15,Bilbao,expenses,cash,-100.0,-3133.25
buyer_1,Luis,Garay,1996-08-10,20670070Q,luis.garay@awesomedata.io,449238,ES57209552411520511223,3831.73,2022-03-30T12:04:12,Bilbao,expenses,food,-97.47,-3230.72
buyer_1,Luis,Garay,1996-08-10,20670070Q,luis.garay@awesomedata.io,449238,ES57209552411520511223,3831.73,2022-03-30T11:34:46,Bilbao,expenses,leisure,-33.71,-3264.43
buyer_1,Luis,Garay,1996-08-10,20670070Q,luis.garay@awesomedata.io,449238,ES57209552411520511223,3831.73,2022-04-01T23:58:06,Bilbao,incomes,salary,2656.82,-607.61
buyer_1,Luis,Garay,1996-08-10,20670070Q,luis.garay@awesomedata.io,449238,ES57209552411520511223,3831.73,2022-04-01T23:58:06,Bilbao,incomes,extra_income,264.61,-343.0
buyer_1,Luis,Garay,1996-08-10,20670070Q,luis.garay@awesomedata.io,449238,ES57209552411520511223,3831.73,2022-04-02T16:03:01,Bilbao,expenses,car,-280.95,-623.95
buyer_1,Luis,Garay,1996-08-10,20670070Q,luis.garay@awesomedata.io,449238,ES57209552411520511223,3831.73,2022-04-04T23:00:20,Bilbao,expenses,rent,-818.29,-1442.24
buyer_1,Luis,Garay,1996-08-10,20670070Q,luis.garay@awesomedata.io,449238,ES57209552411520511223,3831.73,2022-04-04T18:26:40,Bilbao,expenses,education,-42.57,-1484.81
buyer_1,Luis,Garay,1996-08-10,20670070Q,luis.garay@awesomedata.io,449238,ES57209552411520511223,3831.73,2022-04-04T19:57:29,Bilbao,expenses,appliances,-331.69,-1816.5
buyer_1,Luis,Garay,1996-08-10,20670070Q,luis.garay@awesomedata.io,449238,ES57209552411520511223,3831.73,2022-04-05T23:50:17,Bilbao,expenses,food,-63.99,-1880.49
buyer_1,Luis,Garay,1996-08-10,20670070Q,luis.garay@awesomedata.io,449238,ES57209552411520511223,3831.73,2022-04-06T19:43:01,Bilbao,expenses,phone,-52.24,-1932.73
buyer_1,Luis,Garay,1996-08-10,20670070Q,luis.garay@awesomedata.io,449238,ES57209552411520511223,3831.73,2022-04-07T17:34:52,Bilbao,expenses,water,-43.96,-1976.69
buyer_1,Luis,Garay,1996-08-10,20670070Q,luis.garay@awesomedata.io,449238,ES57209552411520511223,3831.73,2022-04-07T18:22:23,Bilbao,expenses,electricity,-83.87,-2060.56
buyer_1,Luis,Garay,1996-08-10,20670070Q,luis.garay@awesomedata.io,449238,ES57209552411520511223,3831.73,2022-04-07T09:40:21,Bilbao,expenses,gas,-49.06,-2109.62
buyer_1,Luis,Garay,1996-08-10,20670070Q,luis.garay@awesomedata.io,449238,ES57209552411520511223,3831.73,2022-04-07T19:52:14,Bilbao,expenses,transport,-69.57,-2179.19
buyer_1,Luis,Garay,1996-08-10,20670070Q,luis.garay@awesomedata.io,449238,ES57209552411520511223,3831.73,2022-04-08T20:31:09,Bilbao,expenses,internet,-55.79,-2234.98
buyer_1,Luis,Garay,1996-08-10,20670070Q,luis.garay@awesomedata.io,449238,ES57209552411520511223,3831.73,2022-04-09T13:52:39,Bilbao,expenses,food,-121.8,-2356.78
buyer_1,Luis,Garay,1996-08-10,20670070Q,luis.garay@awesomedata.io,449238,ES57209552411520511223,3831.73,2022-04-10T16:22:45,Bilbao,expenses,cash,-100.0,-2456.78
buyer_1,Luis,Garay,1996-08-10,20670070Q,luis.garay@awesomedata.io,449238,ES57209552411520511223,3831.73,2022-04-12T12:23:34,Bilbao,expenses,food,-99.59,-2556.37
buyer_1,Luis,Garay,1996-08-10,20670070Q,luis.garay@awesomedata.io,449238,ES57209552411520511223,3831.73,2022-04-12T11:26:54,Bilbao,expenses,leisure,-84.21,-2640.58
buyer_1,Luis,Garay,1996-08-10,20670070Q,luis.garay@awesomedata.io,449238,ES57209552411520511223,3831.73,2022-04-12T18:49:24,Bilbao,expenses,cash,-100.0,-2740.58
buyer_1,Luis,Garay,1996-08-10,20670070Q,luis.garay@awesomedata.io,449238,ES57209552411520511223,3831.73,2022-04-13T10:59:09,Bilbao,expenses,food,-68.58,-2809.16
buyer_1,Luis,Garay,1996-08-10,20670070Q,luis.garay@awesomedata.io,449238,ES57209552411520511223,3831.73,2022-04-13T04:53:28,Bilbao,expenses,transport,-63.15,-2872.31
buyer_1,Luis,Garay,1996-08-10,20670070Q,luis.garay@awesomedata.io,449238,ES57209552411520511223,3831.73,2022-04-15T13:13:12,Bilbao,expenses,repairs,-307.32,-3179.63
buyer_1,Luis,Garay,1996-08-10,20670070Q,luis.garay@awesomedata.io,449238,ES57209552411520511223,3831.73,2022-04-16T20:09:17,Bilbao,expenses,food,-63.72,-3243.35
buyer_1,Luis,Garay,1996-08-10,20670070Q,luis.garay@awesomedata.io,449238,ES57209552411520511223,3831.73,2022-04-17T22:09:28,Bilbao,expenses,transport,-85.09,-3328.44
buyer_1,Luis,Garay,1996-08-10,20670070Q,luis.garay@awesomedata.io,449238,ES57209552411520511223,3831.73,2022-04-18T12:26:41,Bilbao,expenses,transport,-73.19,-3401.63
buyer_1,Luis,Garay,1996-08-10,20670070Q,luis.garay@awesomedata.io,449238,ES57209552411520511223,3831.73,2022-04-20T03:11:40,Bilbao,expenses,leisure,-53.52,-3455.15
buyer_1,Luis,Garay,1996-08-10,20670070Q,luis.garay@awesomedata.io,449238,ES57209552411520511223,3831.73,2022-04-21T17:33:45,Bilbao,expenses,leisure,-58.17,-3513.32
buyer_1,Luis,Garay,1996-08-10,20670070Q,luis.garay@awesomedata.io,449238,ES57209552411520511223,3831.73,2022-04-21T15:48:16,Bilbao,expenses,education,-48.29,-3561.61
buyer_1,Luis,Garay,1996-08-10,20670070Q,luis.garay@awesomedata.io,449238,ES57209552411520511223,3831.73,2022-04-22T12:29:09,Bilbao,expenses,repairs,-132.06,-3693.67
buyer_1,Luis,Garay,1996-08-10,20670070Q,luis.garay@awesomedata.io,449238,ES57209552411520511223,3831.73,2022-04-23T15:24:33,Bilbao,expenses,cash,-100.0,-3793.67
buyer_1,Luis,Garay,1996-08-10,20670070Q,luis.garay@awesomedata.io,449238,ES57209552411520511223,3831.73,2022-04-25T10:18:26,Bilbao,expenses,healthcare,-80.3,-3873.97
buyer_1,Luis,Garay,1996-08-10,20670070Q,luis.garay@awesomedata.io,449238,ES57209552411520511223,3831.73,2022-04-28T19:32:04,Bilbao,expenses,transport,-56.51,-3930.48
buyer_1,Luis,Garay,1996-08-10,20670070Q,luis.garay@awesomedata.io,449238,ES57209552411520511223,3831.73,2022-04-28T04:03:33,Bilbao,expenses,leisure,-31.38,-3961.86
buyer_1,Luis,Garay,1996-08-10,20670070Q,luis.garay@awesomedata.io,449238,ES57209552411520511223,3831.73,2022-04-28T14:17:59,Bilbao,expenses,repairs,-66.04,-4027.9
buyer_1,Luis,Garay,1996-08-10,20670070Q,luis.garay@awesomedata.io,449238,ES57209552411520511223,3831.73,2022-04-29T03:56:05,Bilbao,expenses,education,-63.52,-4091.42
buyer_1,Luis,Garay,1996-08-10,20670070Q,luis.garay@awesomedata.io,449238,ES57209552411520511223,3831.73,2022-04-29T13:02:48,Bilbao,expenses,travel,-797.97,-4889.39
buyer_1,Luis,Garay,1996-08-10,20670070Q,luis.garay@awesomedata.io,449238,ES57209552411520511223,3831.73,2022-05-01T12:51:35,Bilbao,incomes,salary,2656.82,-2232.57
buyer_1,Luis,Garay,1996-08-10,20670070Q,luis.garay@awesomedata.io,449238,ES57209552411520511223,3831.73,2022-05-01T09:00:04,Bilbao,expenses,leisure,-53.74,-2286.31
buyer_1,Luis,Garay,1996-08-10,20670070Q,luis.garay@awesomedata.io,449238,ES57209552411520511223,3831.73,2022-05-01T19:39:57,Bilbao,expenses,clothing,-103.3,-2389.61
buyer_1,Luis,Garay,1996-08-10,20670070Q,luis.garay@awesomedata.io,449238,ES57209552411520511223,3831.73,2022-05-04T13:10:20,Bilbao,expenses,rent,-818.29,-3207.9
buyer_1,Luis,Garay,1996-08-10,20670070Q,luis.garay@awesomedata.io,449238,ES57209552411520511223,3831.73,2022-05-04T18:58:30,Bilbao,expenses,food,-91.63,-3299.53
buyer_1,Luis,Garay,1996-08-10,20670070Q,luis.garay@awesomedata.io,449238,ES57209552411520511223,3831.73,2022-05-05T14:29:04,Bilbao,expenses,water,-37.62,-3337.15
buyer_1,Luis,Garay,1996-08-10,20670070Q,luis.garay@awesomedata.io,449238,ES57209552411520511223,3831.73,2022-05-05T16:00:54,Bilbao,expenses,food,-68.23,-3405.38
buyer_1,Luis,Garay,1996-08-10,20670070Q,luis.garay@awesomedata.io,449238,ES57209552411520511223,3831.73,2022-05-06T11:37:18,Bilbao,expenses,internet,-55.79,-3461.17
buyer_1,Luis,Garay,1996-08-10,20670070Q,luis.garay@awesomedata.io,449238,ES57209552411520511223,3831.73,2022-05-06T09:28:15,Bilbao,expenses,transport,-84.78,-3545.95
buyer_1,Luis,Garay,1996-08-10,20670070Q,luis.garay@awesomedata.io,449238,ES57209552411520511223,3831.73,2022-05-08T13:02:57,Bilbao,expenses,cash,-100.0,-3645.95
buyer_1,Luis,Garay,1996-08-10,20670070Q,luis.garay@awesomedata.io,449238,ES57209552411520511223,3831.73,2022-05-09T14:01:26,Bilbao,expenses,food,-88.15,-3734.1
buyer_1,Luis,Garay,1996-08-10,20670070Q,luis.garay@awesomedata.io,449238,ES57209552411520511223,3831.73,2022-05-10T12:12:21,Bilbao,expenses,education,-63.49,-3797.59
buyer_1,Luis,Garay,1996-08-10,20670070Q,luis.garay@awesomedata.io,449238,ES57209552411520511223,3831.73,2022-05-11T08:34:04,Bilbao,expenses,food,-93.59,-3891.18
buyer_1,Luis,Garay,1996-08-10,20670070Q,luis.garay@awesomedata.io,449238,ES57209552411520511223,3831.73,2022-05-11T11:32:10,Bilbao,expenses,gifts,-191.98,-4083.16
buyer_1,Luis,Garay,1996-08-10,20670070Q,luis.garay@awesomedata.io,449238,ES57209552411520511223,3831.73,2022-05-12T09:04:12,Bilbao,expenses,education,-50.15,-4133.31
buyer_1,Luis,Garay,1996-08-10,20670070Q,luis.garay@awesomedata.io,449238,ES57209552411520511223,3831.73,2022-05-13T17:15:39,Bilbao,expenses,healthcare,-129.36,-4262.67
buyer_1,Luis,Garay,1996-08-10,20670070Q,luis.garay@awesomedata.io,449238,ES57209552411520511223,3831.73,2022-05-13T13:00:02,Bilbao,expenses,cash,-100.0,-4362.67
buyer_1,Luis,Garay,1996-08-10,20670070Q,luis.garay@awesomedata.io,449238,ES57209552411520511223,3831.73,2022-05-13T14:12:14,Bilbao,expenses,repairs,-326.32,-4688.99
buyer_1,Luis,Garay,1996-08-10,20670070Q,luis.garay@awesomedata.io,449238,ES57209552411520511223,3831.73,2022-05-15T07:23:39,Bilbao,expenses,food,-119.32,-4808.31
buyer_1,Luis,Garay,1996-08-10,20670070Q,luis.garay@awesomedata.io,449238,ES57209552411520511223,3831.73,2022-05-15T09:17:47,Bilbao,expenses,transport,-53.96,-4862.27
buyer_1,Luis,Garay,1996-08-10,20670070Q,luis.garay@awesomedata.io,449238,ES57209552411520511223,3831.73,2022-05-17T09:39:51,Bilbao,expenses,appliances,-115.19,-4977.46
buyer_1,Luis,Garay,1996-08-10,20670070Q,luis.garay@awesomedata.io,449238,ES57209552411520511223,3831.73,2022-05-18T02:42:27,Bilbao,expenses,leisure,-78.59,-5056.05
buyer_1,Luis,Garay,1996-08-10,20670070Q,luis.garay@awesomedata.io,449238,ES57209552411520511223,3831.73,2022-05-20T16:23:47,Bilbao,expenses,leisure,-80.78,-5136.83
buyer_1,Luis,Garay,1996-08-10,20670070Q,luis.garay@awesomedata.io,449238,ES57209552411520511223,3831.73,2022-05-21T14:39:18,Bilbao,expenses,food,-69.85,-5206.68
buyer_1,Luis,Garay,1996-08-10,20670070Q,luis.garay@awesomedata.io,449238,ES57209552411520511223,3831.73,2022-05-22T08:25:56,Bilbao,expenses,clothing,-49.44,-5256.12
buyer_1,Luis,Garay,1996-08-10,20670070Q,luis.garay@awesomedata.io,449238,ES57209552411520511223,3831.73,2022-05-23T08:44:29,Bilbao,expenses,cash,-100.0,-5356.12
buyer_1,Luis,Garay,1996-08-10,20670070Q,luis.garay@awesomedata.io,449238,ES57209552411520511223,3831.73,2022-05-24T08:14:21,Bilbao,expenses,transport,-83.67,-5439.79
buyer_1,Luis,Garay,1996-08-10,20670070Q,luis.garay@awesomedata.io,449238,ES57209552411520511223,3831.73,2022-05-24T20:29:57,Bilbao,expenses,leisure,-20.0,-5459.79
buyer_1,Luis,Garay,1996-08-10,20670070Q,luis.garay@awesomedata.io,449238,ES57209552411520511223,3831.73,2022-05-24T20:23:58,Bilbao,expenses,cash,-100.0,-5559.79
buyer_1,Luis,Garay,1996-08-10,20670070Q,luis.garay@awesomedata.io,449238,ES57209552411520511223,3831.73,2022-05-25T09:19:40,Bilbao,expenses,food,-80.53,-5640.32
buyer_1,Luis,Garay,1996-08-10,20670070Q,luis.garay@awesomedata.io,449238,ES57209552411520511223,3831.73,2022-05-27T14:21:10,Bilbao,expenses,clothing,-130.49,-5770.81
buyer_1,Luis,Garay,1996-08-10,20670070Q,luis.garay@awesomedata.io,449238,ES57209552411520511223,3831.73,2022-05-28T17:05:26,Bilbao,expenses,cash,-100.0,-5870.81
buyer_1,Luis,Garay,1996-08-10,20670070Q,luis.garay@awesomedata.io,449238,ES57209552411520511223,3831.73,2022-05-30T17:00:30,Bilbao,expenses,cash,-100.0,-5970.81
buyer_1,Luis,Garay,1996-08-10,20670070Q,luis.garay@awesomedata.io,449238,ES57209552411520511223,3831.73,2022-05-30T09:48:52,Bilbao,expenses,repairs,-169.95,-6140.76
buyer_1,Luis,Garay,1996-08-10,20670070Q,luis.garay@awesomedata.io,449238,ES57209552411520511223,3831.73,2022-05-31T16:01:44,Bilbao,expenses,leisure,-51.2,-6191.96
buyer_1,Luis,Garay,1996-08-10,20670070Q,luis.garay@awesomedata.io,449238,ES57209552411520511223,3831.73,2022-05-31T15:30:07,Bilbao,expenses,cash,-100.0,-6291.96
buyer_1,Luis,Garay,1996-08-10,20670070Q,luis.garay@awesomedata.io,449238,ES57209552411520511223,3831.73,2022-06-01T08:27:21,Bilbao,incomes,salary,2656.82,-3635.14
buyer_1,Luis,Garay,1996-08-10,20670070Q,luis.garay@awesomedata.io,449238,ES57209552411520511223,3831.73,2022-06-01T08:27:21,Bilbao,incomes,salary_bonus,2098.68,-1536.46
buyer_1,Luis,Garay,1996-08-10,20670070Q,luis.garay@awesomedata.io,449238,ES57209552411520511223,3831.73,2022-06-01T09:59:10,Bilbao,expenses,taxes,-1606.88,-3143.34
buyer_1,Luis,Garay,1996-08-10,20670070Q,luis.garay@awesomedata.io,449238,ES57209552411520511223,3831.73,2022-06-01T15:55:41,Bilbao,expenses,insurance,-608.86,-3752.2
buyer_1,Luis,Garay,1996-08-10,20670070Q,luis.garay@awesomedata.io,449238,ES57209552411520511223,3831.73,2022-06-01T11:00:06,Bilbao,expenses,leisure,-30.59,-3782.79
buyer_1,Luis,Garay,1996-08-10,20670070Q,luis.garay@awesomedata.io,449238,ES57209552411520511223,3831.73,2022-06-01T15:35:21,Bilbao,expenses,gifts,-384.21,-4167.0
buyer_1,Luis,Garay,1996-08-10,20670070Q,luis.garay@awesomedata.io,449238,ES57209552411520511223,3831.73,2022-06-02T18:18:10,Bilbao,expenses,appliances,-299.3,-4466.3
buyer_1,Luis,Garay,1996-08-10,20670070Q,luis.garay@awesomedata.io,449238,ES57209552411520511223,3831.73,2022-06-03T14:06:59,Bilbao,expenses,food,-66.79,-4533.09
buyer_1,Luis,Garay,1996-08-10,20670070Q,luis.garay@awesomedata.io,449238,ES57209552411520511223,3831.73,2022-06-03T10:20:02,Bilbao,expenses,transport,-88.3,-4621.39
buyer_1,Luis,Garay,1996-08-10,20670070Q,luis.garay@awesomedata.io,449238,ES57209552411520511223,3831.73,2022-06-04T20:19:04,Bilbao,expenses,rent,-818.29,-5439.68
buyer_1,Luis,Garay,1996-08-10,20670070Q,luis.garay@awesomedata.io,449238,ES57209552411520511223,3831.73,2022-06-04T21:01:41,Bilbao,expenses,food,-117.62,-5557.3
buyer_1,Luis,Garay,1996-08-10,20670070Q,luis.garay@awesomedata.io,449238,ES57209552411520511223,3831.73,2022-06-04T14:35:40,Bilbao,expenses,leisure,-62.74,-5620.04
buyer_1,Luis,Garay,1996-08-10,20670070Q,luis.garay@awesomedata.io,449238,ES57209552411520511223,3831.73,2022-06-04T21:12:21,Bilbao,expenses,repairs,-241.21,-5861.25
buyer_1,Luis,Garay,1996-08-10,20670070Q,luis.garay@awesomedata.io,449238,ES57209552411520511223,3831.73,2022-06-05T11:20:01,Bilbao,expenses,internet,-55.79,-5917.04
buyer_1,Luis,Garay,1996-08-10,20670070Q,luis.garay@awesomedata.io,449238,ES57209552411520511223,3831.73,2022-06-05T09:46:50,Bilbao,expenses,phone,-59.57,-5976.61
buyer_1,Luis,Garay,1996-08-10,20670070Q,luis.garay@awesomedata.io,449238,ES57209552411520511223,3831.73,2022-06-06T17:25:29,Bilbao,expenses,internet,-55.79,-6032.4
buyer_1,Luis,Garay,1996-08-10,20670070Q,luis.garay@awesomedata.io,449238,ES57209552411520511223,3831.73,2022-06-06T13:08:18,Bilbao,expenses,cash,-100.0,-6132.4
buyer_1,Luis,Garay,1996-08-10,20670070Q,luis.garay@awesomedata.io,449238,ES57209552411520511223,3831.73,2022-06-07T07:44:44,Bilbao,expenses,internet,-55.79,-6188.19
buyer_1,Luis,Garay,1996-08-10,20670070Q,luis.garay@awesomedata.io,449238,ES57209552411520511223,3831.73,2022-06-08T20:58:16,Bilbao,expenses,gas,-82.53,-6270.72
buyer_1,Luis,Garay,1996-08-10,20670070Q,luis.garay@awesomedata.io,449238,ES57209552411520511223,3831.73,2022-06-08T00:43:10,Bilbao,expenses,internet,-55.79,-6326.51
buyer_1,Luis,Garay,1996-08-10,20670070Q,luis.garay@awesomedata.io,449238,ES57209552411520511223,3831.73,2022-06-10T18:59:58,Bilbao,expenses,cash,-100.0,-6426.51
buyer_1,Luis,Garay,1996-08-10,20670070Q,luis.garay@awesomedata.io,449238,ES57209552411520511223,3831.73,2022-06-11T13:30:03,Bilbao,expenses,leisure,-45.11,-6471.62
buyer_1,Luis,Garay,1996-08-10,20670070Q,luis.garay@awesomedata.io,449238,ES57209552411520511223,3831.73,2022-06-14T09:07:05,Bilbao,expenses,transport,-83.89,-6555.51
buyer_1,Luis,Garay,1996-08-10,20670070Q,luis.garay@awesomedata.io,449238,ES57209552411520511223,3831.73,2022-06-14T20:53:11,Bilbao,expenses,cash,-100.0,-6655.51
buyer_1,Luis,Garay,1996-08-10,20670070Q,luis.garay@awesomedata.io,449238,ES57209552411520511223,3831.73,2022-06-15T14:03:49,Bilbao,expenses,gifts,-348.11,-7003.62
buyer_1,Luis,Garay,1996-08-10,20670070Q,luis.garay@awesomedata.io,449238,ES57209552411520511223,3831.73,2022-06-19T05:05:38,Bilbao,expenses,food,-85.89,-7089.51
buyer_1,Luis,Garay,1996-08-10,20670070Q,luis.garay@awesomedata.io,449238,ES57209552411520511223,3831.73,2022-06-19T21:39:50,Bilbao,expenses,cash,-100.0,-7189.51
buyer_1,Luis,Garay,1996-08-10,20670070Q,luis.garay@awesomedata.io,449238,ES57209552411520511223,3831.73,2022-06-20T19:34:00,Bilbao,expenses,appliances,-342.47,-7531.98
buyer_1,Luis,Garay,1996-08-10,20670070Q,luis.garay@awesomedata.io,449238,ES57209552411520511223,3831.73,2022-06-22T09:23:16,Bilbao,expenses,cash,-100.0,-7631.98
buyer_1,Luis,Garay,1996-08-10,20670070Q,luis.garay@awesomedata.io,449238,ES57209552411520511223,3831.73,2022-06-22T19:00:04,Bilbao,expenses,appliances,-107.8,-7739.78
buyer_1,Luis,Garay,1996-08-10,20670070Q,luis.garay@awesomedata.io,449238,ES57209552411520511223,3831.73,2022-06-23T15:16:05,Bilbao,expenses,transport,-89.58,-7829.36
buyer_1,Luis,Garay,1996-08-10,20670070Q,luis.garay@awesomedata.io,449238,ES57209552411520511223,3831.73,2022-06-23T09:33:49,Bilbao,expenses,leisure,-69.38,-7898.74
buyer_1,Luis,Garay,1996-08-10,20670070Q,luis.garay@awesomedata.io,449238,ES57209552411520511223,3831.73,2022-06-23T09:04:45,Bilbao,expenses,cash,-100.0,-7998.74
buyer_1,Luis,Garay,1996-08-10,20670070Q,luis.garay@awesomedata.io,449238,ES57209552411520511223,3831.73,2022-06-24T13:27:59,Bilbao,expenses,leisure,-46.66,-8045.4
buyer_1,Luis,Garay,1996-08-10,20670070Q,luis.garay@awesomedata.io,449238,ES57209552411520511223,3831.73,2022-06-26T20:38:25,Bilbao,expenses,cash,-100.0,-8145.4
buyer_1,Luis,Garay,1996-08-10,20670070Q,luis.garay@awesomedata.io,449238,ES57209552411520511223,3831.73,2022-06-27T08:42:42,Bilbao,expenses,leisure,-21.51,-8166.91
buyer_1,Luis,Garay,1996-08-10,20670070Q,luis.garay@awesomedata.io,449238,ES57209552411520511223,3831.73,2022-06-30T01:19:19,Bilbao,expenses,transport,-43.84,-8210.75
buyer_1,Luis,Garay,1996-08-10,20670070Q,luis.garay@awesomedata.io,449238,ES57209552411520511223,3831.73,2022-07-01T12:38:24,Bilbao,incomes,salary,2656.82,-5553.93
buyer_1,Luis,Garay,1996-08-10,20670070Q,luis.garay@awesomedata.io,449238,ES57209552411520511223,3831.73,2022-07-01T12:38:24,Bilbao,incomes,extra_income,264.61,-5289.32
buyer_1,Luis,Garay,1996-08-10,20670070Q,luis.garay@awesomedata.io,449238,ES57209552411520511223,3831.73,2022-07-01T10:58:31,Bilbao,expenses,food,-87.55,-5376.87
buyer_1,Luis,Garay,1996-08-10,20670070Q,luis.garay@awesomedata.io,449238,ES57209552411520511223,3831.73,2022-07-02T20:15:38,Bilbao,expenses,food,-65.87,-5442.74
buyer_1,Luis,Garay,1996-08-10,20670070Q,luis.garay@awesomedata.io,449238,ES57209552411520511223,3831.73,2022-07-02T09:21:46,Bilbao,expenses,cash,-100.0,-5542.74
buyer_1,Luis,Garay,1996-08-10,20670070Q,luis.garay@awesomedata.io,449238,ES57209552411520511223,3831.73,2022-07-04T11:21:59,Bilbao,expenses,rent,-818.29,-6361.03
buyer_1,Luis,Garay,1996-08-10,20670070Q,luis.garay@awesomedata.io,449238,ES57209552411520511223,3831.73,2022-07-04T22:05:21,Bilbao,expenses,cash,-100.0,-6461.03
buyer_1,Luis,Garay,1996-08-10,20670070Q,luis.garay@awesomedata.io,449238,ES57209552411520511223,3831.73,2022-07-05T13:04:01,Bilbao,expenses,electricity,-66.66,-6527.69
buyer_1,Luis,Garay,1996-08-10,20670070Q,luis.garay@awesomedata.io,449238,ES57209552411520511223,3831.73,2022-07-06T23:47:57,Bilbao,expenses,water,-53.26,-6580.95
buyer_1,Luis,Garay,1996-08-10,20670070Q,luis.garay@awesomedata.io,449238,ES57209552411520511223,3831.73,2022-07-06T12:29:51,Bilbao,expenses,internet,-55.79,-6636.74
buyer_1,Luis,Garay,1996-08-10,20670070Q,luis.garay@awesomedata.io,449238,ES57209552411520511223,3831.73,2022-07-06T15:42:11,Bilbao,expenses,phone,-41.8,-6678.54
buyer_1,Luis,Garay,1996-08-10,20670070Q,luis.garay@awesomedata.io,449238,ES57209552411520511223,3831.73,2022-07-06T10:56:04,Bilbao,expenses,food,-80.29,-6758.83
buyer_1,Luis,Garay,1996-08-10,20670070Q,luis.garay@awesomedata.io,449238,ES57209552411520511223,3831.73,2022-07-07T15:53:37,Bilbao,expenses,electricity,-94.84,-6853.67
buyer_1,Luis,Garay,1996-08-10,20670070Q,luis.garay@awesomedata.io,449238,ES57209552411520511223,3831.73,2022-07-07T14:28:25,Bilbao,expenses,transport,-86.15,-6939.82
buyer_1,Luis,Garay,1996-08-10,20670070Q,luis.garay@awesomedata.io,449238,ES57209552411520511223,3831.73,2022-07-07T19:58:22,Bilbao,expenses,clothing,-100.8,-7040.62
buyer_1,Luis,Garay,1996-08-10,20670070Q,luis.garay@awesomedata.io,449238,ES57209552411520511223,3831.73,2022-07-07T10:39:49,Bilbao,expenses,healthcare,-93.4,-7134.02
buyer_1,Luis,Garay,1996-08-10,20670070Q,luis.garay@awesomedata.io,449238,ES57209552411520511223,3831.73,2022-07-08T09:32:25,Bilbao,expenses,healthcare,-183.95,-7317.97
buyer_1,Luis,Garay,1996-08-10,20670070Q,luis.garay@awesomedata.io,449238,ES57209552411520511223,3831.73,2022-07-08T14:48:59,Bilbao,expenses,gifts,-562.31,-7880.28
buyer_1,Luis,Garay,1996-08-10,20670070Q,luis.garay@awesomedata.io,449238,ES57209552411520511223,3831.73,2022-07-12T10:31:25,Bilbao,expenses,cash,-100.0,-7980.28
buyer_1,Luis,Garay,1996-08-10,20670070Q,luis.garay@awesomedata.io,449238,ES57209552411520511223,3831.73,2022-07-13T18:18:21,Bilbao,expenses,leisure,-42.04,-8022.32
buyer_1,Luis,Garay,1996-08-10,20670070Q,luis.garay@awesomedata.io,449238,ES57209552411520511223,3831.73,2022-07-13T16:28:54,Bilbao,expenses,repairs,-191.57,-8213.89
buyer_1,Luis,Garay,1996-08-10,20670070Q,luis.garay@awesomedata.io,449238,ES57209552411520511223,3831.73,2022-07-15T18:54:44,Bilbao,expenses,food,-123.59,-8337.48
buyer_1,Luis,Garay,1996-08-10,20670070Q,luis.garay@awesomedata.io,449238,ES57209552411520511223,3831.73,2022-07-19T14:10:52,Bilbao,expenses,transport,-62.32,-8399.8
buyer_1,Luis,Garay,1996-08-10,20670070Q,luis.garay@awesomedata.io,449238,ES57209552411520511223,3831.73,2022-07-20T15:34:38,Bilbao,expenses,leisure,-33.53,-8433.33
buyer_1,Luis,Garay,1996-08-10,20670070Q,luis.garay@awesomedata.io,449238,ES57209552411520511223,3831.73,2022-07-21T09:05:39,Bilbao,expenses,leisure,-77.75,-8511.08
buyer_1,Luis,Garay,1996-08-10,20670070Q,luis.garay@awesomedata.io,449238,ES57209552411520511223,3831.73,2022-07-23T11:54:52,Bilbao,expenses,cash,-100.0,-8611.08
buyer_1,Luis,Garay,1996-08-10,20670070Q,luis.garay@awesomedata.io,449238,ES57209552411520511223,3831.73,2022-07-23T13:49:09,Bilbao,expenses,appliances,-115.53,-8726.61
buyer_1,Luis,Garay,1996-08-10,20670070Q,luis.garay@awesomedata.io,449238,ES57209552411520511223,3831.73,2022-07-24T12:29:12,Bilbao,expenses,transport,-42.36,-8768.97
buyer_1,Luis,Garay,1996-08-10,20670070Q,luis.garay@awesomedata.io,449238,ES57209552411520511223,3831.73,2022-07-24T14:42:34,Bilbao,expenses,cash,-100.0,-8868.97
buyer_1,Luis,Garay,1996-08-10,20670070Q,luis.garay@awesomedata.io,449238,ES57209552411520511223,3831.73,2022-07-25T06:35:04,Bilbao,expenses,transport,-88.18,-8957.15
buyer_1,Luis,Garay,1996-08-10,20670070Q,luis.garay@awesomedata.io,449238,ES57209552411520511223,3831.73,2022-07-26T13:49:30,Bilbao,expenses,cash,-100.0,-9057.15
buyer_1,Luis,Garay,1996-08-10,20670070Q,luis.garay@awesomedata.io,449238,ES57209552411520511223,3831.73,2022-07-27T16:11:23,Bilbao,expenses,food,-104.02,-9161.17
buyer_1,Luis,Garay,1996-08-10,20670070Q,luis.garay@awesomedata.io,449238,ES57209552411520511223,3831.73,2022-07-28T01:40:08,Bilbao,expenses,food,-82.04,-9243.21
buyer_1,Luis,Garay,1996-08-10,20670070Q,luis.garay@awesomedata.io,449238,ES57209552411520511223,3831.73,2022-07-28T20:31:47,Bilbao,expenses,transport,-55.45,-9298.66
buyer_1,Luis,Garay,1996-08-10,20670070Q,luis.garay@awesomedata.io,449238,ES57209552411520511223,3831.73,2022-07-28T15:23:12,Bilbao,expenses,education,-48.18,-9346.84
buyer_1,Luis,Garay,1996-08-10,20670070Q,luis.garay@awesomedata.io,449238,ES57209552411520511223,3831.73,2022-07-28T12:48:51,Bilbao,expenses,gifts,-458.99,-9805.83
buyer_1,Luis,Garay,1996-08-10,20670070Q,luis.garay@awesomedata.io,449238,ES57209552411520511223,3831.73,2022-07-29T15:43:34,Bilbao,expenses,repairs,-268.6,-10074.43
buyer_1,Luis,Garay,1996-08-10,20670070Q,luis.garay@awesomedata.io,449238,ES57209552411520511223,3831.73,2022-07-31T10:29:34,Bilbao,expenses,education,-57.99,-10132.42
buyer_1,Luis,Garay,1996-08-10,20670070Q,luis.garay@awesomedata.io,449238,ES57209552411520511223,3831.73,2022-08-01T16:17:44,Bilbao,incomes,salary,2656.82,-7475.6
buyer_1,Luis,Garay,1996-08-10,20670070Q,luis.garay@awesomedata.io,449238,ES57209552411520511223,3831.73,2022-08-01T19:59:23,Bilbao,expenses,repairs,-325.66,-7801.26
buyer_1,Luis,Garay,1996-08-10,20670070Q,luis.garay@awesomedata.io,449238,ES57209552411520511223,3831.73,2022-08-02T09:34:08,Bilbao,expenses,repairs,-114.4,-7915.66
buyer_1,Luis,Garay,1996-08-10,20670070Q,luis.garay@awesomedata.io,449238,ES57209552411520511223,3831.73,2022-08-03T21:33:11,Bilbao,expenses,food,-81.2,-7996.86
buyer_1,Luis,Garay,1996-08-10,20670070Q,luis.garay@awesomedata.io,449238,ES57209552411520511223,3831.73,2022-08-03T19:34:33,Bilbao,expenses,cash,-100.0,-8096.86
buyer_1,Luis,Garay,1996-08-10,20670070Q,luis.garay@awesomedata.io,449238,ES57209552411520511223,3831.73,2022-08-04T09:42:39,Bilbao,expenses,rent,-818.29,-8915.15
buyer_1,Luis,Garay,1996-08-10,20670070Q,luis.garay@awesomedata.io,449238,ES57209552411520511223,3831.73,2022-08-04T16:51:09,Bilbao,expenses,cash,-100.0,-9015.15
buyer_1,Luis,Garay,1996-08-10,20670070Q,luis.garay@awesomedata.io,449238,ES57209552411520511223,3831.73,2022-08-05T14:43:49,Bilbao,expenses,water,-52.37,-9067.52
buyer_1,Luis,Garay,1996-08-10,20670070Q,luis.garay@awesomedata.io,449238,ES57209552411520511223,3831.73,2022-08-05T14:30:11,Bilbao,expenses,internet,-55.79,-9123.31
buyer_1,Luis,Garay,1996-08-10,20670070Q,luis.garay@awesomedata.io,449238,ES57209552411520511223,3831.73,2022-08-05T19:34:47,Bilbao,expenses,cash,-100.0,-9223.31
buyer_1,Luis,Garay,1996-08-10,20670070Q,luis.garay@awesomedata.io,449238,ES57209552411520511223,3831.73,2022-08-07T10:46:29,Bilbao,expenses,gas,-115.02,-9338.33
buyer_1,Luis,Garay,1996-08-10,20670070Q,luis.garay@awesomedata.io,449238,ES57209552411520511223,3831.73,2022-08-07T10:24:22,Bilbao,expenses,phone,-51.28,-9389.61
buyer_1,Luis,Garay,1996-08-10,20670070Q,luis.garay@awesomedata.io,449238,ES57209552411520511223,3831.73,2022-08-07T14:15:39,Bilbao,expenses,food,-89.76,-9479.37
buyer_1,Luis,Garay,1996-08-10,20670070Q,luis.garay@awesomedata.io,449238,ES57209552411520511223,3831.73,2022-08-08T22:01:11,Bilbao,expenses,phone,-43.49,-9522.86
buyer_1,Luis,Garay,1996-08-10,20670070Q,luis.garay@awesomedata.io,449238,ES57209552411520511223,3831.73,2022-08-08T21:42:18,Bilbao,expenses,clothing,-116.38,-9639.24
buyer_1,Luis,Garay,1996-08-10,20670070Q,luis.garay@awesomedata.io,449238,ES57209552411520511223,3831.73,2022-08-09T11:23:11,Bilbao,expenses,food,-89.56,-9728.8
buyer_1,Luis,Garay,1996-08-10,20670070Q,luis.garay@awesomedata.io,449238,ES57209552411520511223,3831.73,2022-08-09T20:04:50,Bilbao,expenses,travel,-498.87,-10227.67
buyer_1,Luis,Garay,1996-08-10,20670070Q,luis.garay@awesomedata.io,449238,ES57209552411520511223,3831.73,2022-08-09T12:19:51,Bilbao,expenses,appliances,-208.15,-10435.82
buyer_1,Luis,Garay,1996-08-10,20670070Q,luis.garay@awesomedata.io,449238,ES57209552411520511223,3831.73,2022-08-10T19:01:22,Bilbao,expenses,food,-95.79,-10531.61
buyer_1,Luis,Garay,1996-08-10,20670070Q,luis.garay@awesomedata.io,449238,ES57209552411520511223,3831.73,2022-08-11T16:34:05,Bilbao,expenses,leisure,-33.67,-10565.28
buyer_1,Luis,Garay,1996-08-10,20670070Q,luis.garay@awesomedata.io,449238,ES57209552411520511223,3831.73,2022-08-12T22:29:56,Bilbao,expenses,clothing,-60.95,-10626.23
buyer_1,Luis,Garay,1996-08-10,20670070Q,luis.garay@awesomedata.io,449238,ES57209552411520511223,3831.73,2022-08-12T13:17:37,Bilbao,expenses,cash,-100.0,-10726.23
buyer_1,Luis,Garay,1996-08-10,20670070Q,luis.garay@awesomedata.io,449238,ES57209552411520511223,3831.73,2022-08-13T17:18:27,Bilbao,expenses,cash,-100.0,-10826.23
buyer_1,Luis,Garay,1996-08-10,20670070Q,luis.garay@awesomedata.io,449238,ES57209552411520511223,3831.73,2022-08-17T18:21:55,Bilbao,expenses,transport,-84.0,-10910.23
buyer_1,Luis,Garay,1996-08-10,20670070Q,luis.garay@awesomedata.io,449238,ES57209552411520511223,3831.73,2022-08-18T14:35:23,Bilbao,expenses,food,-122.06,-11032.29
buyer_1,Luis,Garay,1996-08-10,20670070Q,luis.garay@awesomedata.io,449238,ES57209552411520511223,3831.73,2022-08-18T16:58:04,Bilbao,expenses,cash,-100.0,-11132.29
buyer_1,Luis,Garay,1996-08-10,20670070Q,luis.garay@awesomedata.io,449238,ES57209552411520511223,3831.73,2022-08-18T09:49:28,Bilbao,expenses,appliances,-330.42,-11462.71
buyer_1,Luis,Garay,1996-08-10,20670070Q,luis.garay@awesomedata.io,449238,ES57209552411520511223,3831.73,2022-08-19T13:54:52,Bilbao,expenses,food,-73.42,-11536.13
buyer_1,Luis,Garay,1996-08-10,20670070Q,luis.garay@awesomedata.io,449238,ES57209552411520511223,3831.73,2022-08-20T22:21:59,Bilbao,expenses,gifts,-327.58,-11863.71
buyer_1,Luis,Garay,1996-08-10,20670070Q,luis.garay@awesomedata.io,449238,ES57209552411520511223,3831.73,2022-08-21T19:30:47,Bilbao,expenses,leisure,-62.68,-11926.39
buyer_1,Luis,Garay,1996-08-10,20670070Q,luis.garay@awesomedata.io,449238,ES57209552411520511223,3831.73,2022-08-21T08:41:56,Bilbao,expenses,repairs,-43.47,-11969.86
buyer_1,Luis,Garay,1996-08-10,20670070Q,luis.garay@awesomedata.io,449238,ES57209552411520511223,3831.73,2022-08-22T14:15:08,Bilbao,expenses,leisure,-21.69,-11991.55
buyer_1,Luis,Garay,1996-08-10,20670070Q,luis.garay@awesomedata.io,449238,ES57209552411520511223,3831.73,2022-08-22T08:51:31,Bilbao,expenses,cash,-100.0,-12091.55
buyer_1,Luis,Garay,1996-08-10,20670070Q,luis.garay@awesomedata.io,449238,ES57209552411520511223,3831.73,2022-08-23T09:24:59,Bilbao,expenses,transport,-43.3,-12134.85
buyer_1,Luis,Garay,1996-08-10,20670070Q,luis.garay@awesomedata.io,449238,ES57209552411520511223,3831.73,2022-08-27T16:54:32,Bilbao,expenses,gifts,-470.31,-12605.16
buyer_1,Luis,Garay,1996-08-10,20670070Q,luis.garay@awesomedata.io,449238,ES57209552411520511223,3831.73,2022-08-28T19:39:53,Bilbao,expenses,leisure,-70.52,-12675.68
buyer_1,Luis,Garay,1996-08-10,20670070Q,luis.garay@awesomedata.io,449238,ES57209552411520511223,3831.73,2022-08-28T09:58:57,Bilbao,expenses,healthcare,-135.84,-12811.52
buyer_1,Luis,Garay,1996-08-10,20670070Q,luis.garay@awesomedata.io,449238,ES57209552411520511223,3831.73,2022-08-29T14:45:40,Bilbao,expenses,repairs,-86.57,-12898.09
buyer_1,Luis,Garay,1996-08-10,20670070Q,luis.garay@awesomedata.io,449238,ES57209552411520511223,3831.73,2022-09-01T16:50:47,Bilbao,incomes,salary,2656.82,-10241.27
buyer_1,Luis,Garay,1996-08-10,20670070Q,luis.garay@awesomedata.io,449238,ES57209552411520511223,3831.73,2022-09-01T05:21:17,Bilbao,expenses,clothing,-154.06,-10395.33
buyer_1,Luis,Garay,1996-08-10,20670070Q,luis.garay@awesomedata.io,449238,ES57209552411520511223,3831.73,2022-09-03T10:05:47,Bilbao,expenses,transport,-87.32,-10482.65
buyer_1,Luis,Garay,1996-08-10,20670070Q,luis.garay@awesomedata.io,449238,ES57209552411520511223,3831.73,2022-09-03T19:47:11,Bilbao,expenses,gifts,-845.28,-11327.93
buyer_1,Luis,Garay,1996-08-10,20670070Q,luis.garay@awesomedata.io,449238,ES57209552411520511223,3831.73,2022-09-04T16:15:49,Bilbao,expenses,rent,-818.29,-12146.22
buyer_1,Luis,Garay,1996-08-10,20670070Q,luis.garay@awesomedata.io,449238,ES57209552411520511223,3831.73,2022-09-05T22:49:10,Bilbao,expenses,gas,-67.48,-12213.7
buyer_1,Luis,Garay,1996-08-10,20670070Q,luis.garay@awesomedata.io,449238,ES57209552411520511223,3831.73,2022-09-05T10:26:59,Bilbao,expenses,internet,-55.79,-12269.49
buyer_1,Luis,Garay,1996-08-10,20670070Q,luis.garay@awesomedata.io,449238,ES57209552411520511223,3831.73,2022-09-05T18:33:39,Bilbao,expenses,food,-92.6,-12362.09
buyer_1,Luis,Garay,1996-08-10,20670070Q,luis.garay@awesomedata.io,449238,ES57209552411520511223,3831.73,2022-09-05T18:14:51,Bilbao,expenses,transport,-57.99,-12420.08
buyer_1,Luis,Garay,1996-08-10,20670070Q,luis.garay@awesomedata.io,449238,ES57209552411520511223,3831.73,2022-09-05T11:17:45,Bilbao,expenses,leisure,-56.48,-12476.56
buyer_1,Luis,Garay,1996-08-10,20670070Q,luis.garay@awesomedata.io,449238,ES57209552411520511223,3831.73,2022-09-06T13:35:24,Bilbao,expenses,food,-95.56,-12572.12
buyer_1,Luis,Garay,1996-08-10,20670070Q,luis.garay@awesomedata.io,449238,ES57209552411520511223,3831.73,2022-09-07T17:08:20,Bilbao,expenses,internet,-55.79,-12627.91
buyer_1,Luis,Garay,1996-08-10,20670070Q,luis.garay@awesomedata.io,449238,ES57209552411520511223,3831.73,2022-09-07T08:20:11,Bilbao,expenses,food,-120.39,-12748.3
buyer_1,Luis,Garay,1996-08-10,20670070Q,luis.garay@awesomedata.io,449238,ES57209552411520511223,3831.73,2022-09-07T23:56:48,Bilbao,expenses,clothing,-74.66,-12822.96
buyer_1,Luis,Garay,1996-08-10,20670070Q,luis.garay@awesomedata.io,449238,ES57209552411520511223,3831.73,2022-09-08T19:51:12,Bilbao,expenses,electricity,-104.93,-12927.89
buyer_1,Luis,Garay,1996-08-10,20670070Q,luis.garay@awesomedata.io,449238,ES57209552411520511223,3831.73,2022-09-08T18:28:05,Bilbao,expenses,gas,-118.57,-13046.46
buyer_1,Luis,Garay,1996-08-10,20670070Q,luis.garay@awesomedata.io,449238,ES57209552411520511223,3831.73,2022-09-08T13:34:17,Bilbao,expenses,phone,-57.85,-13104.31
buyer_1,Luis,Garay,1996-08-10,20670070Q,luis.garay@awesomedata.io,449238,ES57209552411520511223,3831.73,2022-09-10T08:14:44,Bilbao,expenses,leisure,-26.52,-13130.83
buyer_1,Luis,Garay,1996-08-10,20670070Q,luis.garay@awesomedata.io,449238,ES57209552411520511223,3831.73,2022-09-10T12:20:22,Bilbao,expenses,appliances,-99.52,-13230.35
buyer_1,Luis,Garay,1996-08-10,20670070Q,luis.garay@awesomedata.io,449238,ES57209552411520511223,3831.73,2022-09-12T11:21:22,Bilbao,expenses,food,-76.18,-13306.53
buyer_1,Luis,Garay,1996-08-10,20670070Q,luis.garay@awesomedata.io,449238,ES57209552411520511223,3831.73,2022-09-14T19:17:17,Bilbao,expenses,clothing,-55.38,-13361.91
buyer_1,Luis,Garay,1996-08-10,20670070Q,luis.garay@awesomedata.io,449238,ES57209552411520511223,3831.73,2022-09-16T08:35:56,Bilbao,expenses,clothing,-78.61,-13440.52
buyer_1,Luis,Garay,1996-08-10,20670070Q,luis.garay@awesomedata.io,449238,ES57209552411520511223,3831.73,2022-09-16T12:19:34,Bilbao,expenses,cash,-100.0,-13540.52
buyer_1,Luis,Garay,1996-08-10,20670070Q,luis.garay@awesomedata.io,449238,ES57209552411520511223,3831.73,2022-09-16T07:21:01,Bilbao,expenses,gifts,-350.36,-13890.88
buyer_1,Luis,Garay,1996-08-10,20670070Q,luis.garay@awesomedata.io,449238,ES57209552411520511223,3831.73,2022-09-17T18:08:00,Bilbao,expenses,transport,-40.57,-13931.45
buyer_1,Luis,Garay,1996-08-10,20670070Q,luis.garay@awesomedata.io,449238,ES57209552411520511223,3831.73,2022-09-22T09:12:35,Bilbao,expenses,food,-115.64,-14047.09
buyer_1,Luis,Garay,1996-08-10,20670070Q,luis.garay@awesomedata.io,449238,ES57209552411520511223,3831.73,2022-09-22T23:46:27,Bilbao,expenses,leisure,-79.14,-14126.23
buyer_1,Luis,Garay,1996-08-10,20670070Q,luis.garay@awesomedata.io,449238,ES57209552411520511223,3831.73,2022-09-22T17:44:58,Bilbao,expenses,gifts,-503.5,-14629.73
buyer_1,Luis,Garay,1996-08-10,20670070Q,luis.garay@awesomedata.io,449238,ES57209552411520511223,3831.73,2022-09-23T13:31:24,Bilbao,expenses,clothing,-151.93,-14781.66
buyer_1,Luis,Garay,1996-08-10,20670070Q,luis.garay@awesomedata.io,449238,ES57209552411520511223,3831.73,2022-09-26T21:58:59,Bilbao,expenses,cash,-100.0,-14881.66
buyer_1,Luis,Garay,1996-08-10,20670070Q,luis.garay@awesomedata.io,449238,ES57209552411520511223,3831.73,2022-09-27T17:18:05,Bilbao,expenses,food,-83.0,-14964.66
buyer_1,Luis,Garay,1996-08-10,20670070Q,luis.garay@awesomedata.io,449238,ES57209552411520511223,3831.73,2022-09-28T18:14:12,Bilbao,expenses,leisure,-20.06,-14984.72
buyer_1,Luis,Garay,1996-08-10,20670070Q,luis.garay@awesomedata.io,449238,ES57209552411520511223,3831.73,2022-09-28T08:38:14,Bilbao,expenses,repairs,-139.69,-15124.41
buyer_1,Luis,Garay,1996-08-10,20670070Q,luis.garay@awesomedata.io,449238,ES57209552411520511223,3831.73,2022-09-29T18:21:12,Bilbao,expenses,leisure,-76.2,-15200.61
buyer_1,Luis,Garay,1996-08-10,20670070Q,luis.garay@awesomedata.io,449238,ES57209552411520511223,3831.73,2022-09-30T19:07:01,Bilbao,expenses,food,-79.46,-15280.07
buyer_1,Luis,Garay,1996-08-10,20670070Q,luis.garay@awesomedata.io,449238,ES57209552411520511223,3831.73,2022-09-30T16:11:49,Bilbao,expenses,cash,-100.0,-15380.07
buyer_1,Luis,Garay,1996-08-10,20670070Q,luis.garay@awesomedata.io,449238,ES57209552411520511223,3831.73,2022-10-01T17:02:06,Bilbao,incomes,salary,2656.82,-12723.25
buyer_1,Luis,Garay,1996-08-10,20670070Q,luis.garay@awesomedata.io,449238,ES57209552411520511223,3831.73,2022-10-01T22:33:26,Bilbao,expenses,gifts,-714.76,-13438.01
buyer_1,Luis,Garay,1996-08-10,20670070Q,luis.garay@awesomedata.io,449238,ES57209552411520511223,3831.73,2022-10-03T06:20:43,Bilbao,expenses,leisure,-52.01,-13490.02
buyer_1,Luis,Garay,1996-08-10,20670070Q,luis.garay@awesomedata.io,449238,ES57209552411520511223,3831.73,2022-10-04T11:33:19,Bilbao,expenses,rent,-818.29,-14308.31
buyer_1,Luis,Garay,1996-08-10,20670070Q,luis.garay@awesomedata.io,449238,ES57209552411520511223,3831.73,2022-10-05T14:33:05,Bilbao,expenses,electricity,-92.35,-14400.66
buyer_1,Luis,Garay,1996-08-10,20670070Q,luis.garay@awesomedata.io,449238,ES57209552411520511223,3831.73,2022-10-05T09:34:18,Bilbao,expenses,cash,-100.0,-14500.66
buyer_1,Luis,Garay,1996-08-10,20670070Q,luis.garay@awesomedata.io,449238,ES57209552411520511223,3831.73,2022-10-06T10:24:43,Bilbao,expenses,water,-39.37,-14540.03
buyer_1,Luis,Garay,1996-08-10,20670070Q,luis.garay@awesomedata.io,449238,ES57209552411520511223,3831.73,2022-10-06T04:05:04,Bilbao,expenses,electricity,-87.42,-14627.45
buyer_1,Luis,Garay,1996-08-10,20670070Q,luis.garay@awesomedata.io,449238,ES57209552411520511223,3831.73,2022-10-06T10:22:06,Bilbao,expenses,gas,-139.79,-14767.24
buyer_1,Luis,Garay,1996-08-10,20670070Q,luis.garay@awesomedata.io,449238,ES57209552411520511223,3831.73,2022-10-06T16:55:14,Bilbao,expenses,cash,-100.0,-14867.24
buyer_1,Luis,Garay,1996-08-10,20670070Q,luis.garay@awesomedata.io,449238,ES57209552411520511223,3831.73,2022-10-07T13:41:54,Bilbao,expenses,electricity,-83.27,-14950.51
buyer_1,Luis,Garay,1996-08-10,20670070Q,luis.garay@awesomedata.io,449238,ES57209552411520511223,3831.73,2022-10-08T15:34:16,Bilbao,expenses,internet,-55.79,-15006.3
buyer_1,Luis,Garay,1996-08-10,20670070Q,luis.garay@awesomedata.io,449238,ES57209552411520511223,3831.73,2022-10-08T00:21:09,Bilbao,expenses,leisure,-25.05,-15031.35
buyer_1,Luis,Garay,1996-08-10,20670070Q,luis.garay@awesomedata.io,449238,ES57209552411520511223,3831.73,2022-10-12T14:26:18,Bilbao,expenses,transport,-54.36,-15085.71
buyer_1,Luis,Garay,1996-08-10,20670070Q,luis.garay@awesomedata.io,449238,ES57209552411520511223,3831.73,2022-10-14T20:40:55,Bilbao,expenses,clothing,-142.39,-15228.1
buyer_1,Luis,Garay,1996-08-10,20670070Q,luis.garay@awesomedata.io,449238,ES57209552411520511223,3831.73,2022-10-16T09:18:07,Bilbao,expenses,leisure,-62.75,-15290.85
buyer_1,Luis,Garay,1996-08-10,20670070Q,luis.garay@awesomedata.io,449238,ES57209552411520511223,3831.73,2022-10-17T15:18:12,Bilbao,expenses,cash,-100.0,-15390.85
buyer_1,Luis,Garay,1996-08-10,20670070Q,luis.garay@awesomedata.io,449238,ES57209552411520511223,3831.73,2022-10-19T15:39:27,Bilbao,expenses,appliances,-349.35,-15740.2
buyer_1,Luis,Garay,1996-08-10,20670070Q,luis.garay@awesomedata.io,449238,ES57209552411520511223,3831.73,2022-10-25T19:59:14,Bilbao,expenses,food,-73.64,-15813.84
buyer_1,Luis,Garay,1996-08-10,20670070Q,luis.garay@awesomedata.io,449238,ES57209552411520511223,3831.73,2022-10-25T19:10:11,Bilbao,expenses,transport,-43.69,-15857.53
buyer_1,Luis,Garay,1996-08-10,20670070Q,luis.garay@awesomedata.io,449238,ES57209552411520511223,3831.73,2022-10-26T16:16:52,Bilbao,expenses,repairs,-141.58,-15999.11
buyer_1,Luis,Garay,1996-08-10,20670070Q,luis.garay@awesomedata.io,449238,ES57209552411520511223,3831.73,2022-10-27T15:30:03,Bilbao,expenses,cash,-100.0,-16099.11
buyer_1,Luis,Garay,1996-08-10,20670070Q,luis.garay@awesomedata.io,449238,ES57209552411520511223,3831.73,2022-10-28T20:08:30,Bilbao,expenses,leisure,-67.28,-16166.39
buyer_1,Luis,Garay,1996-08-10,20670070Q,luis.garay@awesomedata.io,449238,ES57209552411520511223,3831.73,2022-10-29T13:15:02,Bilbao,expenses,cash,-100.0,-16266.39
buyer_1,Luis,Garay,1996-08-10,20670070Q,luis.garay@awesomedata.io,449238,ES57209552411520511223,3831.73,2022-10-30T12:47:47,Bilbao,expenses,transport,-45.6,-16311.99
buyer_1,Luis,Garay,1996-08-10,20670070Q,luis.garay@awesomedata.io,449238,ES57209552411520511223,3831.73,2022-10-30T23:48:27,Bilbao,expenses,gifts,-60.92,-16372.91
buyer_1,Luis,Garay,1996-08-10,20670070Q,luis.garay@awesomedata.io,449238,ES57209552411520511223,3831.73,2022-11-01T15:25:04,Bilbao,incomes,salary,2656.82,-13716.09
buyer_1,Luis,Garay,1996-08-10,20670070Q,luis.garay@awesomedata.io,449238,ES57209552411520511223,3831.73,2022-11-01T15:25:04,Bilbao,incomes,extra_income,264.61,-13451.48
buyer_1,Luis,Garay,1996-08-10,20670070Q,luis.garay@awesomedata.io,449238,ES57209552411520511223,3831.73,2022-11-02T13:49:40,Bilbao,expenses,cash,-100.0,-13551.48
buyer_1,Luis,Garay,1996-08-10,20670070Q,luis.garay@awesomedata.io,449238,ES57209552411520511223,3831.73,2022-11-02T10:39:12,Bilbao,expenses,gifts,-583.38,-14134.86
buyer_1,Luis,Garay,1996-08-10,20670070Q,luis.garay@awesomedata.io,449238,ES57209552411520511223,3831.73,2022-11-03T11:38:02,Bilbao,expenses,clothing,-59.29,-14194.15
buyer_1,Luis,Garay,1996-08-10,20670070Q,luis.garay@awesomedata.io,449238,ES57209552411520511223,3831.73,2022-11-03T19:47:27,Bilbao,expenses,healthcare,-184.96,-14379.11
buyer_1,Luis,Garay,1996-08-10,20670070Q,luis.garay@awesomedata.io,449238,ES57209552411520511223,3831.73,2022-11-04T08:53:53,Bilbao,expenses,rent,-818.29,-15197.4
buyer_1,Luis,Garay,1996-08-10,20670070Q,luis.garay@awesomedata.io,449238,ES57209552411520511223,3831.73,2022-11-05T09:34:31,Bilbao,expenses,water,-48.51,-15245.91
buyer_1,Luis,Garay,1996-08-10,20670070Q,luis.garay@awesomedata.io,449238,ES57209552411520511223,3831.73,2022-11-05T20:56:41,Bilbao,expenses,electricity,-112.38,-15358.29
buyer_1,Luis,Garay,1996-08-10,20670070Q,luis.garay@awesomedata.io,449238,ES57209552411520511223,3831.73,2022-11-05T08:13:02,Bilbao,expenses,internet,-55.79,-15414.08
buyer_1,Luis,Garay,1996-08-10,20670070Q,luis.garay@awesomedata.io,449238,ES57209552411520511223,3831.73,2022-11-05T09:15:47,Bilbao,expenses,phone,-47.67,-15461.75
buyer_1,Luis,Garay,1996-08-10,20670070Q,luis.garay@awesomedata.io,449238,ES57209552411520511223,3831.73,2022-11-06T14:20:03,Bilbao,expenses,electricity,-82.62,-15544.37
buyer_1,Luis,Garay,1996-08-10,20670070Q,luis.garay@awesomedata.io,449238,ES57209552411520511223,3831.73,2022-11-06T13:53:27,Bilbao,expenses,phone,-57.42,-15601.79
buyer_1,Luis,Garay,1996-08-10,20670070Q,luis.garay@awesomedata.io,449238,ES57209552411520511223,3831.73,2022-11-07T10:57:47,Bilbao,expenses,food,-89.66,-15691.45
buyer_1,Luis,Garay,1996-08-10,20670070Q,luis.garay@awesomedata.io,449238,ES57209552411520511223,3831.73,2022-11-08T20:15:07,Bilbao,expenses,internet,-55.79,-15747.24
buyer_1,Luis,Garay,1996-08-10,20670070Q,luis.garay@awesomedata.io,449238,ES57209552411520511223,3831.73,2022-11-08T19:38:27,Bilbao,expenses,cash,-100.0,-15847.24
buyer_1,Luis,Garay,1996-08-10,20670070Q,luis.garay@awesomedata.io,449238,ES57209552411520511223,3831.73,2022-11-10T17:27:11,Bilbao,expenses,cash,-100.0,-15947.24
buyer_1,Luis,Garay,1996-08-10,20670070Q,luis.garay@awesomedata.io,449238,ES57209552411520511223,3831.73,2022-11-14T09:13:40,Bilbao,expenses,appliances,-140.8,-16088.04
buyer_1,Luis,Garay,1996-08-10,20670070Q,luis.garay@awesomedata.io,449238,ES57209552411520511223,3831.73,2022-11-17T09:33:03,Bilbao,expenses,food,-74.94,-16162.98
buyer_1,Luis,Garay,1996-08-10,20670070Q,luis.garay@awesomedata.io,449238,ES57209552411520511223,3831.73,2022-11-17T15:30:00,Bilbao,expenses,gifts,-285.24,-16448.22
buyer_1,Luis,Garay,1996-08-10,20670070Q,luis.garay@awesomedata.io,449238,ES57209552411520511223,3831.73,2022-11-18T14:06:48,Bilbao,expenses,cash,-100.0,-16548.22
buyer_1,Luis,Garay,1996-08-10,20670070Q,luis.garay@awesomedata.io,449238,ES57209552411520511223,3831.73,2022-11-18T16:05:19,Bilbao,expenses,repairs,-143.38,-16691.6
buyer_1,Luis,Garay,1996-08-10,20670070Q,luis.garay@awesomedata.io,449238,ES57209552411520511223,3831.73,2022-11-18T21:25:26,Bilbao,expenses,gifts,-139.31,-16830.91
buyer_1,Luis,Garay,1996-08-10,20670070Q,luis.garay@awesomedata.io,449238,ES57209552411520511223,3831.73,2022-11-21T19:32:40,Bilbao,expenses,repairs,-325.81,-17156.72
buyer_1,Luis,Garay,1996-08-10,20670070Q,luis.garay@awesomedata.io,449238,ES57209552411520511223,3831.73,2022-11-22T12:08:25,Bilbao,expenses,transport,-62.87,-17219.59
buyer_1,Luis,Garay,1996-08-10,20670070Q,luis.garay@awesomedata.io,449238,ES57209552411520511223,3831.73,2022-11-22T22:11:49,Bilbao,expenses,repairs,-225.9,-17445.49
buyer_1,Luis,Garay,1996-08-10,20670070Q,luis.garay@awesomedata.io,449238,ES57209552411520511223,3831.73,2022-11-23T20:13:58,Bilbao,expenses,food,-105.25,-17550.74
buyer_1,Luis,Garay,1996-08-10,20670070Q,luis.garay@awesomedata.io,449238,ES57209552411520511223,3831.73,2022-11-24T19:51:19,Bilbao,expenses,education,-67.35,-17618.09
buyer_1,Luis,Garay,1996-08-10,20670070Q,luis.garay@awesomedata.io,449238,ES57209552411520511223,3831.73,2022-11-24T16:47:54,Bilbao,expenses,cash,-100.0,-17718.09
buyer_1,Luis,Garay,1996-08-10,20670070Q,luis.garay@awesomedata.io,449238,ES57209552411520511223,3831.73,2022-11-25T23:37:49,Bilbao,expenses,food,-101.48,-17819.57
buyer_1,Luis,Garay,1996-08-10,20670070Q,luis.garay@awesomedata.io,449238,ES57209552411520511223,3831.73,2022-11-25T19:24:11,Bilbao,expenses,cash,-100.0,-17919.57
buyer_1,Luis,Garay,1996-08-10,20670070Q,luis.garay@awesomedata.io,449238,ES57209552411520511223,3831.73,2022-11-27T17:56:53,Bilbao,expenses,appliances,-187.61,-18107.18
buyer_1,Luis,Garay,1996-08-10,20670070Q,luis.garay@awesomedata.io,449238,ES57209552411520511223,3831.73,2022-11-27T15:34:30,Bilbao,expenses,gifts,-218.81,-18325.99
buyer_1,Luis,Garay,1996-08-10,20670070Q,luis.garay@awesomedata.io,449238,ES57209552411520511223,3831.73,2022-11-28T14:52:12,Bilbao,expenses,transport,-79.8,-18405.79
buyer_1,Luis,Garay,1996-08-10,20670070Q,luis.garay@awesomedata.io,449238,ES57209552411520511223,3831.73,2022-11-29T15:02:11,Bilbao,expenses,healthcare,-91.98,-18497.77
buyer_1,Luis,Garay,1996-08-10,20670070Q,luis.garay@awesomedata.io,449238,ES57209552411520511223,3831.73,2022-12-01T19:15:32,Bilbao,incomes,salary,2656.82,-15840.95
buyer_1,Luis,Garay,1996-08-10,20670070Q,luis.garay@awesomedata.io,449238,ES57209552411520511223,3831.73,2022-12-01T19:15:32,Bilbao,incomes,salary_bonus,2097.5,-13743.45
buyer_1,Luis,Garay,1996-08-10,20670070Q,luis.garay@awesomedata.io,449238,ES57209552411520511223,3831.73,2022-12-01T12:58:16,Bilbao,expenses,clothing,-113.39,-13856.84
buyer_1,Luis,Garay,1996-08-10,20670070Q,luis.garay@awesomedata.io,449238,ES57209552411520511223,3831.73,2022-12-03T17:40:21,Bilbao,expenses,food,-94.2,-13951.04
buyer_1,Luis,Garay,1996-08-10,20670070Q,luis.garay@awesomedata.io,449238,ES57209552411520511223,3831.73,2022-12-03T08:39:57,Bilbao,expenses,cash,-100.0,-14051.04
buyer_1,Luis,Garay,1996-08-10,20670070Q,luis.garay@awesomedata.io,449238,ES57209552411520511223,3831.73,2022-12-03T14:33:14,Bilbao,expenses,gifts,-454.15,-14505.19
buyer_1,Luis,Garay,1996-08-10,20670070Q,luis.garay@awesomedata.io,449238,ES57209552411520511223,3831.73,2022-12-04T16:06:30,Bilbao,expenses,rent,-818.29,-15323.48
buyer_1,Luis,Garay,1996-08-10,20670070Q,luis.garay@awesomedata.io,449238,ES57209552411520511223,3831.73,2022-12-04T16:26:09,Bilbao,expenses,leisure,-47.91,-15371.39
buyer_1,Luis,Garay,1996-08-10,20670070Q,luis.garay@awesomedata.io,449238,ES57209552411520511223,3831.73,2022-12-05T16:09:18,Bilbao,expenses,water,-58.55,-15429.94
buyer_1,Luis,Garay,1996-08-10,20670070Q,luis.garay@awesomedata.io,449238,ES57209552411520511223,3831.73,2022-12-06T20:18:41,Bilbao,expenses,water,-57.5,-15487.44
buyer_1,Luis,Garay,1996-08-10,20670070Q,luis.garay@awesomedata.io,449238,ES57209552411520511223,3831.73,2022-12-06T13:00:20,Bilbao,expenses,internet,-55.79,-15543.23
buyer_1,Luis,Garay,1996-08-10,20670070Q,luis.garay@awesomedata.io,449238,ES57209552411520511223,3831.73,2022-12-07T16:38:04,Bilbao,expenses,electricity,-106.96,-15650.19
buyer_1,Luis,Garay,1996-08-10,20670070Q,luis.garay@awesomedata.io,449238,ES57209552411520511223,3831.73,2022-12-07T03:59:57,Bilbao,expenses,food,-101.76,-15751.95
buyer_1,Luis,Garay,1996-08-10,20670070Q,luis.garay@awesomedata.io,449238,ES57209552411520511223,3831.73,2022-12-07T09:39:00,Bilbao,expenses,transport,-44.67,-15796.62
buyer_1,Luis,Garay,1996-08-10,20670070Q,luis.garay@awesomedata.io,449238,ES57209552411520511223,3831.73,2022-12-07T09:12:49,Bilbao,expenses,clothing,-137.29,-15933.91
buyer_1,Luis,Garay,1996-08-10,20670070Q,luis.garay@awesomedata.io,449238,ES57209552411520511223,3831.73,2022-12-08T17:22:50,Bilbao,expenses,water,-40.95,-15974.86
buyer_1,Luis,Garay,1996-08-10,20670070Q,luis.garay@awesomedata.io,449238,ES57209552411520511223,3831.73,2022-12-08T14:32:17,Bilbao,expenses,gas,-72.95,-16047.81
buyer_1,Luis,Garay,1996-08-10,20670070Q,luis.garay@awesomedata.io,449238,ES57209552411520511223,3831.73,2022-12-08T20:34:31,Bilbao,expenses,leisure,-35.06,-16082.87
buyer_1,Luis,Garay,1996-08-10,20670070Q,luis.garay@awesomedata.io,449238,ES57209552411520511223,3831.73,2022-12-09T16:15:53,Bilbao,expenses,leisure,-21.8,-16104.67
buyer_1,Luis,Garay,1996-08-10,20670070Q,luis.garay@awesomedata.io,449238,ES57209552411520511223,3831.73,2022-12-10T23:32:20,Bilbao,expenses,gifts,-338.55,-16443.22
buyer_1,Luis,Garay,1996-08-10,20670070Q,luis.garay@awesomedata.io,449238,ES57209552411520511223,3831.73,2022-12-12T14:05:13,Bilbao,expenses,transport,-54.06,-16497.28
buyer_1,Luis,Garay,1996-08-10,20670070Q,luis.garay@awesomedata.io,449238,ES57209552411520511223,3831.73,2022-12-14T01:21:12,Bilbao,expenses,appliances,-285.29,-16782.57
buyer_1,Luis,Garay,1996-08-10,20670070Q,luis.garay@awesomedata.io,449238,ES57209552411520511223,3831.73,2022-12-18T12:02:16,Bilbao,expenses,gifts,-417.15,-17199.72
buyer_1,Luis,Garay,1996-08-10,20670070Q,luis.garay@awesomedata.io,449238,ES57209552411520511223,3831.73,2022-12-19T12:29:12,Bilbao,expenses,repairs,-65.41,-17265.13
buyer_1,Luis,Garay,1996-08-10,20670070Q,luis.garay@awesomedata.io,449238,ES57209552411520511223,3831.73,2022-12-20T08:36:09,Bilbao,expenses,food,-100.13,-17365.26
buyer_1,Luis,Garay,1996-08-10,20670070Q,luis.garay@awesomedata.io,449238,ES57209552411520511223,3831.73,2022-12-22T17:28:07,Bilbao,expenses,food,-83.25,-17448.51
buyer_1,Luis,Garay,1996-08-10,20670070Q,luis.garay@awesomedata.io,449238,ES57209552411520511223,3831.73,2022-12-22T23:22:12,Bilbao,expenses,leisure,-21.24,-17469.75
buyer_1,Luis,Garay,1996-08-10,20670070Q,luis.garay@awesomedata.io,449238,ES57209552411520511223,3831.73,2022-12-23T08:11:34,Bilbao,expenses,cash,-100.0,-17569.75
buyer_1,Luis,Garay,1996-08-10,20670070Q,luis.garay@awesomedata.io,449238,ES57209552411520511223,3831.73,2022-12-26T20:52:12,Bilbao,expenses,appliances,-123.96,-17693.71
buyer_1,Luis,Garay,1996-08-10,20670070Q,luis.garay@awesomedata.io,449238,ES57209552411520511223,3831.73,2022-12-27T14:55:00,Bilbao,expenses,cash,-100.0,-17793.71
buyer_1,Luis,Garay,1996-08-10,20670070Q,luis.garay@awesomedata.io,449238,ES57209552411520511223,3831.73,2022-12-29T16:53:38,Bilbao,expenses,food,-118.51,-17912.22
buyer_1,Luis,Garay,1996-08-10,20670070Q,luis.garay@awesomedata.io,449238,ES57209552411520511223,3831.73,2022-12-31T19:21:54,Bilbao,expenses,food,-122.89,-18035.11
buyer_1,Luis,Garay,1996-08-10,20670070Q,luis.garay@awesomedata.io,449238,ES57209552411520511223,3831.73,2022-12-31T16:43:38,Bilbao,expenses,leisure,-81.75,-18116.86
buyer_1,Luis,Garay,1996-08-10,20670070Q,luis.garay@awesomedata.io,449238,ES57209552411520511223,3831.73,2023-01-01T10:00:06,Bilbao,incomes,salary,2711.02,-15405.84
buyer_1,Luis,Garay,1996-08-10,20670070Q,luis.garay@awesomedata.io,449238,ES57209552411520511223,3831.73,2023-01-01T16:06:27,Bilbao,expenses,clothing,-95.77,-15501.61
buyer_1,Luis,Garay,1996-08-10,20670070Q,luis.garay@awesomedata.io,449238,ES57209552411520511223,3831.73,2023-01-02T10:14:54,Bilbao,expenses,leisure,-44.68,-15546.29
buyer_1,Luis,Garay,1996-08-10,20670070Q,luis.garay@awesomedata.io,449238,ES57209552411520511223,3831.73,2023-01-03T09:00:20,Bilbao,expenses,cash,-100.0,-15646.29
buyer_1,Luis,Garay,1996-08-10,20670070Q,luis.garay@awesomedata.io,449238,ES57209552411520511223,3831.73,2023-01-03T19:01:37,Bilbao,expenses,gifts,-664.08,-16310.37
buyer_1,Luis,Garay,1996-08-10,20670070Q,luis.garay@awesomedata.io,449238,ES57209552411520511223,3831.73,2023-01-04T08:10:26,Bilbao,expenses,rent,-997.88,-17308.25
buyer_1,Luis,Garay,1996-08-10,20670070Q,luis.garay@awesomedata.io,449238,ES57209552411520511223,3831.73,2023-01-04T11:19:50,Bilbao,expenses,repairs,-109.42,-17417.67
buyer_1,Luis,Garay,1996-08-10,20670070Q,luis.garay@awesomedata.io,449238,ES57209552411520511223,3831.73,2023-01-05T20:58:11,Bilbao,expenses,water,-55.14,-17472.81
buyer_1,Luis,Garay,1996-08-10,20670070Q,luis.garay@awesomedata.io,449238,ES57209552411520511223,3831.73,2023-01-05T09:20:01,Bilbao,expenses,electricity,-39.61,-17512.42
buyer_1,Luis,Garay,1996-08-10,20670070Q,luis.garay@awesomedata.io,449238,ES57209552411520511223,3831.73,2023-01-05T20:57:45,Bilbao,expenses,gas,-65.42,-17577.84
buyer_1,Luis,Garay,1996-08-10,20670070Q,luis.garay@awesomedata.io,449238,ES57209552411520511223,3831.73,2023-01-05T21:50:34,Bilbao,expenses,internet,-56.93,-17634.77
buyer_1,Luis,Garay,1996-08-10,20670070Q,luis.garay@awesomedata.io,449238,ES57209552411520511223,3831.73,2023-01-05T12:24:55,Bilbao,expenses,healthcare,-155.51,-17790.28
buyer_1,Luis,Garay,1996-08-10,20670070Q,luis.garay@awesomedata.io,449238,ES57209552411520511223,3831.73,2023-01-05T19:58:49,Bilbao,expenses,gifts,-623.16,-18413.44
buyer_1,Luis,Garay,1996-08-10,20670070Q,luis.garay@awesomedata.io,449238,ES57209552411520511223,3831.73,2023-01-06T09:35:21,Bilbao,expenses,phone,-43.38,-18456.82
buyer_1,Luis,Garay,1996-08-10,20670070Q,luis.garay@awesomedata.io,449238,ES57209552411520511223,3831.73,2023-01-07T20:41:20,Bilbao,expenses,gas,-53.58,-18510.4
buyer_1,Luis,Garay,1996-08-10,20670070Q,luis.garay@awesomedata.io,449238,ES57209552411520511223,3831.73,2023-01-07T11:32:20,Bilbao,expenses,repairs,-290.06,-18800.46
buyer_1,Luis,Garay,1996-08-10,20670070Q,luis.garay@awesomedata.io,449238,ES57209552411520511223,3831.73,2023-01-07T08:53:58,Bilbao,expenses,gifts,-570.73,-19371.19
buyer_1,Luis,Garay,1996-08-10,20670070Q,luis.garay@awesomedata.io,449238,ES57209552411520511223,3831.73,2023-01-10T19:04:16,Bilbao,expenses,transport,-52.15,-19423.34
buyer_1,Luis,Garay,1996-08-10,20670070Q,luis.garay@awesomedata.io,449238,ES57209552411520511223,3831.73,2023-01-10T17:16:58,Bilbao,expenses,gifts,-826.22,-20249.56
buyer_1,Luis,Garay,1996-08-10,20670070Q,luis.garay@awesomedata.io,449238,ES57209552411520511223,3831.73,2023-01-15T09:50:27,Bilbao,expenses,leisure,-58.61,-20308.17
buyer_1,Luis,Garay,1996-08-10,20670070Q,luis.garay@awesomedata.io,449238,ES57209552411520511223,3831.73,2023-01-16T17:58:10,Bilbao,expenses,leisure,-56.5,-20364.67
buyer_1,Luis,Garay,1996-08-10,20670070Q,luis.garay@awesomedata.io,449238,ES57209552411520511223,3831.73,2023-01-17T17:01:43,Bilbao,expenses,food,-93.35,-20458.02
buyer_1,Luis,Garay,1996-08-10,20670070Q,luis.garay@awesomedata.io,449238,ES57209552411520511223,3831.73,2023-01-18T19:04:09,Bilbao,expenses,food,-69.84,-20527.86
buyer_1,Luis,Garay,1996-08-10,20670070Q,luis.garay@awesomedata.io,449238,ES57209552411520511223,3831.73,2023-01-20T13:15:28,Bilbao,expenses,food,-76.64,-20604.5
buyer_1,Luis,Garay,1996-08-10,20670070Q,luis.garay@awesomedata.io,449238,ES57209552411520511223,3831.73,2023-01-20T14:53:03,Bilbao,expenses,healthcare,-106.35,-20710.85
buyer_1,Luis,Garay,1996-08-10,20670070Q,luis.garay@awesomedata.io,449238,ES57209552411520511223,3831.73,2023-01-20T00:22:31,Bilbao,expenses,cash,-100.0,-20810.85
buyer_1,Luis,Garay,1996-08-10,20670070Q,luis.garay@awesomedata.io,449238,ES57209552411520511223,3831.73,2023-01-21T17:03:59,Bilbao,expenses,education,-74.61,-20885.46
buyer_1,Luis,Garay,1996-08-10,20670070Q,luis.garay@awesomedata.io,449238,ES57209552411520511223,3831.73,2023-01-21T18:49:17,Bilbao,expenses,cash,-100.0,-20985.46
buyer_1,Luis,Garay,1996-08-10,20670070Q,luis.garay@awesomedata.io,449238,ES57209552411520511223,3831.73,2023-01-22T15:35:04,Bilbao,expenses,transport,-43.77,-21029.23
buyer_1,Luis,Garay,1996-08-10,20670070Q,luis.garay@awesomedata.io,449238,ES57209552411520511223,3831.73,2023-01-22T09:18:58,Bilbao,expenses,cash,-100.0,-21129.23
buyer_1,Luis,Garay,1996-08-10,20670070Q,luis.garay@awesomedata.io,449238,ES57209552411520511223,3831.73,2023-01-22T23:30:59,Bilbao,expenses,repairs,-44.36,-21173.59
buyer_1,Luis,Garay,1996-08-10,20670070Q,luis.garay@awesomedata.io,449238,ES57209552411520511223,3831.73,2023-01-23T18:30:42,Bilbao,expenses,healthcare,-69.16,-21242.75
buyer_1,Luis,Garay,1996-08-10,20670070Q,luis.garay@awesomedata.io,449238,ES57209552411520511223,3831.73,2023-01-24T16:13:29,Bilbao,expenses,transport,-85.75,-21328.5
buyer_1,Luis,Garay,1996-08-10,20670070Q,luis.garay@awesomedata.io,449238,ES57209552411520511223,3831.73,2023-01-25T10:04:16,Bilbao,expenses,cash,-100.0,-21428.5
buyer_1,Luis,Garay,1996-08-10,20670070Q,luis.garay@awesomedata.io,449238,ES57209552411520511223,3831.73,2023-01-27T15:22:54,Bilbao,expenses,education,-60.53,-21489.03
buyer_1,Luis,Garay,1996-08-10,20670070Q,luis.garay@awesomedata.io,449238,ES57209552411520511223,3831.73,2023-01-27T09:28:11,Bilbao,expenses,cash,-100.0,-21589.03
buyer_1,Luis,Garay,1996-08-10,20670070Q,luis.garay@awesomedata.io,449238,ES57209552411520511223,3831.73,2023-01-27T21:42:58,Bilbao,expenses,appliances,-95.72,-21684.75
buyer_1,Luis,Garay,1996-08-10,20670070Q,luis.garay@awesomedata.io,449238,ES57209552411520511223,3831.73,2023-01-28T19:52:53,Bilbao,expenses,clothing,-87.38,-21772.13
buyer_1,Luis,Garay,1996-08-10,20670070Q,luis.garay@awesomedata.io,449238,ES57209552411520511223,3831.73,2023-01-30T16:03:56,Bilbao,expenses,cash,-100.0,-21872.13
buyer_1,Luis,Garay,1996-08-10,20670070Q,luis.garay@awesomedata.io,449238,ES57209552411520511223,3831.73,2023-01-31T20:51:49,Bilbao,expenses,transport,-76.44,-21948.57
buyer_1,Luis,Garay,1996-08-10,20670070Q,luis.garay@awesomedata.io,449238,ES57209552411520511223,3831.73,2023-01-31T12:03:08,Bilbao,expenses,appliances,-250.77,-22199.34
buyer_1,Luis,Garay,1996-08-10,20670070Q,luis.garay@awesomedata.io,449238,ES57209552411520511223,3831.73,2023-02-01T18:56:22,Bilbao,incomes,salary,2711.02,-19488.32
buyer_1,Luis,Garay,1996-08-10,20670070Q,luis.garay@awesomedata.io,449238,ES57209552411520511223,3831.73,2023-02-03T13:34:11,Bilbao,expenses,leisure,-53.12,-19541.44
buyer_1,Luis,Garay,1996-08-10,20670070Q,luis.garay@awesomedata.io,449238,ES57209552411520511223,3831.73,2023-02-03T13:28:58,Bilbao,expenses,cash,-100.0,-19641.44
buyer_1,Luis,Garay,1996-08-10,20670070Q,luis.garay@awesomedata.io,449238,ES57209552411520511223,3831.73,2023-02-04T14:07:29,Bilbao,expenses,rent,-997.88,-20639.32
buyer_1,Luis,Garay,1996-08-10,20670070Q,luis.garay@awesomedata.io,449238,ES57209552411520511223,3831.73,2023-02-05T18:01:01,Bilbao,expenses,internet,-56.93,-20696.25
buyer_1,Luis,Garay,1996-08-10,20670070Q,luis.garay@awesomedata.io,449238,ES57209552411520511223,3831.73,2023-02-05T09:14:24,Bilbao,expenses,leisure,-48.56,-20744.81
buyer_1,Luis,Garay,1996-08-10,20670070Q,luis.garay@awesomedata.io,449238,ES57209552411520511223,3831.73,2023-02-06T15:56:17,Bilbao,expenses,phone,-48.83,-20793.64
buyer_1,Luis,Garay,1996-08-10,20670070Q,luis.garay@awesomedata.io,449238,ES57209552411520511223,3831.73,2023-02-06T15:15:39,Bilbao,expenses,transport,-67.88,-20861.52
buyer_1,Luis,Garay,1996-08-10,20670070Q,luis.garay@awesomedata.io,449238,ES57209552411520511223,3831.73,2023-02-07T18:51:09,Bilbao,expenses,water,-30.19,-20891.71
buyer_1,Luis,Garay,1996-08-10,20670070Q,luis.garay@awesomedata.io,449238,ES57209552411520511223,3831.73,2023-02-07T16:10:02,Bilbao,expenses,leisure,-38.04,-20929.75
buyer_1,Luis,Garay,1996-08-10,20670070Q,luis.garay@awesomedata.io,449238,ES57209552411520511223,3831.73,2023-02-08T02:45:58,Bilbao,expenses,electricity,-88.84,-21018.59
buyer_1,Luis,Garay,1996-08-10,20670070Q,luis.garay@awesomedata.io,449238,ES57209552411520511223,3831.73,2023-02-08T18:56:42,Bilbao,expenses,transport,-80.65,-21099.24
buyer_1,Luis,Garay,1996-08-10,20670070Q,luis.garay@awesomedata.io,449238,ES57209552411520511223,3831.73,2023-02-11T18:58:44,Bilbao,expenses,food,-69.37,-21168.61
buyer_1,Luis,Garay,1996-08-10,20670070Q,luis.garay@awesomedata.io,449238,ES57209552411520511223,3831.73,2023-02-12T11:37:56,Bilbao,expenses,transport,-52.68,-21221.29
buyer_1,Luis,Garay,1996-08-10,20670070Q,luis.garay@awesomedata.io,449238,ES57209552411520511223,3831.73,2023-02-12T18:21:14,Bilbao,expenses,cash,-100.0,-21321.29
buyer_1,Luis,Garay,1996-08-10,20670070Q,luis.garay@awesomedata.io,449238,ES57209552411520511223,3831.73,2023-02-15T19:10:31,Bilbao,expenses,food,-121.48,-21442.77
buyer_1,Luis,Garay,1996-08-10,20670070Q,luis.garay@awesomedata.io,449238,ES57209552411520511223,3831.73,2023-02-15T20:38:02,Bilbao,expenses,healthcare,-119.78,-21562.55
buyer_1,Luis,Garay,1996-08-10,20670070Q,luis.garay@awesomedata.io,449238,ES57209552411520511223,3831.73,2023-02-15T17:31:39,Bilbao,expenses,education,-48.74,-21611.29
buyer_1,Luis,Garay,1996-08-10,20670070Q,luis.garay@awesomedata.io,449238,ES57209552411520511223,3831.73,2023-02-15T15:08:55,Bilbao,expenses,cash,-100.0,-21711.29
buyer_1,Luis,Garay,1996-08-10,20670070Q,luis.garay@awesomedata.io,449238,ES57209552411520511223,3831.73,2023-02-16T19:22:15,Bilbao,expenses,cash,-100.0,-21811.29
buyer_1,Luis,Garay,1996-08-10,20670070Q,luis.garay@awesomedata.io,449238,ES57209552411520511223,3831.73,2023-02-17T03:38:28,Bilbao,expenses,leisure,-53.33,-21864.62
buyer_1,Luis,Garay,1996-08-10,20670070Q,luis.garay@awesomedata.io,449238,ES57209552411520511223,3831.73,2023-02-20T11:36:52,Bilbao,expenses,food,-75.31,-21939.93
buyer_1,Luis,Garay,1996-08-10,20670070Q,luis.garay@awesomedata.io,449238,ES57209552411520511223,3831.73,2023-02-20T14:23:00,Bilbao,expenses,transport,-75.25,-22015.18
buyer_1,Luis,Garay,1996-08-10,20670070Q,luis.garay@awesomedata.io,449238,ES57209552411520511223,3831.73,2023-02-20T15:16:39,Bilbao,expenses,clothing,-86.65,-22101.83
buyer_1,Luis,Garay,1996-08-10,20670070Q,luis.garay@awesomedata.io,449238,ES57209552411520511223,3831.73,2023-02-20T10:43:26,Bilbao,expenses,cash,-100.0,-22201.83
buyer_1,Luis,Garay,1996-08-10,20670070Q,luis.garay@awesomedata.io,449238,ES57209552411520511223,3831.73,2023-02-21T17:06:55,Bilbao,expenses,cash,-100.0,-22301.83
buyer_1,Luis,Garay,1996-08-10,20670070Q,luis.garay@awesomedata.io,449238,ES57209552411520511223,3831.73,2023-02-22T12:27:01,Bilbao,expenses,gifts,-303.81,-22605.64
buyer_1,Luis,Garay,1996-08-10,20670070Q,luis.garay@awesomedata.io,449238,ES57209552411520511223,3831.73,2023-02-23T09:51:22,Bilbao,expenses,repairs,-114.79,-22720.43
buyer_1,Luis,Garay,1996-08-10,20670070Q,luis.garay@awesomedata.io,449238,ES57209552411520511223,3831.73,2023-02-24T14:39:59,Bilbao,expenses,leisure,-34.83,-22755.26
buyer_1,Luis,Garay,1996-08-10,20670070Q,luis.garay@awesomedata.io,449238,ES57209552411520511223,3831.73,2023-02-24T20:29:07,Bilbao,expenses,cash,-100.0,-22855.26
buyer_1,Luis,Garay,1996-08-10,20670070Q,luis.garay@awesomedata.io,449238,ES57209552411520511223,3831.73,2023-02-28T20:24:17,Bilbao,expenses,transport,-57.08,-22912.34
buyer_1,Luis,Garay,1996-08-10,20670070Q,luis.garay@awesomedata.io,449238,ES57209552411520511223,3831.73,2023-02-28T13:41:42,Bilbao,expenses,leisure,-25.47,-22937.81
buyer_1,Luis,Garay,1996-08-10,20670070Q,luis.garay@awesomedata.io,449238,ES57209552411520511223,3831.73,2023-02-28T14:43:55,Bilbao,expenses,healthcare,-133.31,-23071.12
buyer_1,Luis,Garay,1996-08-10,20670070Q,luis.garay@awesomedata.io,449238,ES57209552411520511223,3831.73,2023-03-01T17:26:30,Bilbao,incomes,salary,2711.02,-20360.1
buyer_1,Luis,Garay,1996-08-10,20670070Q,luis.garay@awesomedata.io,449238,ES57209552411520511223,3831.73,2023-03-01T17:26:30,Bilbao,incomes,extra_income,264.61,-20095.49
buyer_1,Luis,Garay,1996-08-10,20670070Q,luis.garay@awesomedata.io,449238,ES57209552411520511223,3831.73,2023-03-02T11:18:59,Bilbao,expenses,gifts,-385.79,-20481.28
buyer_1,Luis,Garay,1996-08-10,20670070Q,luis.garay@awesomedata.io,449238,ES57209552411520511223,3831.73,2023-03-04T07:03:25,Bilbao,expenses,rent,-997.88,-21479.16
buyer_1,Luis,Garay,1996-08-10,20670070Q,luis.garay@awesomedata.io,449238,ES57209552411520511223,3831.73,2023-03-05T10:14:07,Bilbao,expenses,internet,-56.93,-21536.09
buyer_1,Luis,Garay,1996-08-10,20670070Q,luis.garay@awesomedata.io,449238,ES57209552411520511223,3831.73,2023-03-05T12:49:36,Bilbao,expenses,food,-89.9,-21625.99
buyer_1,Luis,Garay,1996-08-10,20670070Q,luis.garay@awesomedata.io,449238,ES57209552411520511223,3831.73,2023-03-05T19:42:29,Bilbao,expenses,repairs,-98.19,-21724.18
buyer_1,Luis,Garay,1996-08-10,20670070Q,luis.garay@awesomedata.io,449238,ES57209552411520511223,3831.73,2023-03-06T23:59:36,Bilbao,expenses,electricity,-82.63,-21806.81
buyer_1,Luis,Garay,1996-08-10,20670070Q,luis.garay@awesomedata.io,449238,ES57209552411520511223,3831.73,2023-03-06T15:55:30,Bilbao,expenses,gas,-125.73,-21932.54
buyer_1,Luis,Garay,1996-08-10,20670070Q,luis.garay@awesomedata.io,449238,ES57209552411520511223,3831.73,2023-03-06T10:04:09,Bilbao,expenses,phone,-53.07,-21985.61
buyer_1,Luis,Garay,1996-08-10,20670070Q,luis.garay@awesomedata.io,449238,ES57209552411520511223,3831.73,2023-03-06T20:34:51,Bilbao,expenses,transport,-79.15,-22064.76
buyer_1,Luis,Garay,1996-08-10,20670070Q,luis.garay@awesomedata.io,449238,ES57209552411520511223,3831.73,2023-03-07T12:25:45,Bilbao,expenses,electricity,-107.65,-22172.41
buyer_1,Luis,Garay,1996-08-10,20670070Q,luis.garay@awesomedata.io,449238,ES57209552411520511223,3831.73,2023-03-07T15:31:58,Bilbao,expenses,cash,-100.0,-22272.41
buyer_1,Luis,Garay,1996-08-10,20670070Q,luis.garay@awesomedata.io,449238,ES57209552411520511223,3831.73,2023-03-08T15:20:41,Bilbao,expenses,water,-46.44,-22318.85
buyer_1,Luis,Garay,1996-08-10,20670070Q,luis.garay@awesomedata.io,449238,ES57209552411520511223,3831.73,2023-03-08T08:03:10,Bilbao,expenses,food,-124.89,-22443.74
buyer_1,Luis,Garay,1996-08-10,20670070Q,luis.garay@awesomedata.io,449238,ES57209552411520511223,3831.73,2023-03-08T22:52:26,Bilbao,expenses,cash,-100.0,-22543.74
buyer_1,Luis,Garay,1996-08-10,20670070Q,luis.garay@awesomedata.io,449238,ES57209552411520511223,3831.73,2023-03-11T21:09:32,Bilbao,expenses,food,-94.54,-22638.28
buyer_1,Luis,Garay,1996-08-10,20670070Q,luis.garay@awesomedata.io,449238,ES57209552411520511223,3831.73,2023-03-11T18:30:53,Bilbao,expenses,leisure,-23.62,-22661.9
buyer_1,Luis,Garay,1996-08-10,20670070Q,luis.garay@awesomedata.io,449238,ES57209552411520511223,3831.73,2023-03-12T03:14:34,Bilbao,expenses,healthcare,-95.21,-22757.11
buyer_1,Luis,Garay,1996-08-10,20670070Q,luis.garay@awesomedata.io,449238,ES57209552411520511223,3831.73,2023-03-12T16:10:44,Bilbao,expenses,repairs,-250.17,-23007.28
buyer_1,Luis,Garay,1996-08-10,20670070Q,luis.garay@awesomedata.io,449238,ES57209552411520511223,3831.73,2023-03-13T18:46:02,Bilbao,expenses,cash,-100.0,-23107.28
buyer_1,Luis,Garay,1996-08-10,20670070Q,luis.garay@awesomedata.io,449238,ES57209552411520511223,3831.73,2023-03-14T20:30:59,Bilbao,expenses,cash,-100.0,-23207.28
buyer_1,Luis,Garay,1996-08-10,20670070Q,luis.garay@awesomedata.io,449238,ES57209552411520511223,3831.73,2023-03-15T19:38:10,Bilbao,expenses,travel,-581.34,-23788.62
buyer_1,Luis,Garay,1996-08-10,20670070Q,luis.garay@awesomedata.io,449238,ES57209552411520511223,3831.73,2023-03-16T12:52:34,Bilbao,expenses,food,-124.73,-23913.35
buyer_1,Luis,Garay,1996-08-10,20670070Q,luis.garay@awesomedata.io,449238,ES57209552411520511223,3831.73,2023-03-17T08:28:59,Bilbao,expenses,cash,-100.0,-24013.35
buyer_1,Luis,Garay,1996-08-10,20670070Q,luis.garay@awesomedata.io,449238,ES57209552411520511223,3831.73,2023-03-19T11:04:33,Bilbao,expenses,appliances,-310.06,-24323.41
buyer_1,Luis,Garay,1996-08-10,20670070Q,luis.garay@awesomedata.io,449238,ES57209552411520511223,3831.73,2023-03-21T08:55:02,Bilbao,expenses,food,-116.88,-24440.29
buyer_1,Luis,Garay,1996-08-10,20670070Q,luis.garay@awesomedata.io,449238,ES57209552411520511223,3831.73,2023-03-23T14:41:37,Bilbao,expenses,food,-66.84,-24507.13
buyer_1,Luis,Garay,1996-08-10,20670070Q,luis.garay@awesomedata.io,449238,ES57209552411520511223,3831.73,2023-03-24T10:27:16,Bilbao,expenses,gifts,-372.73,-24879.86
buyer_1,Luis,Garay,1996-08-10,20670070Q,luis.garay@awesomedata.io,449238,ES57209552411520511223,3831.73,2023-03-30T08:57:44,Bilbao,expenses,food,-88.77,-24968.63
buyer_1,Luis,Garay,1996-08-10,20670070Q,luis.garay@awesomedata.io,449238,ES57209552411520511223,3831.73,2023-03-31T01:15:04,Bilbao,expenses,transport,-89.27,-25057.9
buyer_1,Luis,Garay,1996-08-10,20670070Q,luis.garay@awesomedata.io,449238,ES57209552411520511223,3831.73,2023-03-31T20:19:46,Bilbao,expenses,clothing,-70.26,-25128.16
buyer_1,Luis,Garay,1996-08-10,20670070Q,luis.garay@awesomedata.io,449238,ES57209552411520511223,3831.73,2023-03-31T02:10:21,Bilbao,expenses,appliances,-333.98,-25462.14
buyer_1,Luis,Garay,1996-08-10,20670070Q,luis.garay@awesomedata.io,449238,ES57209552411520511223,3831.73,2023-04-01T12:08:22,Bilbao,incomes,salary,2711.02,-22751.12
buyer_1,Luis,Garay,1996-08-10,20670070Q,luis.garay@awesomedata.io,449238,ES57209552411520511223,3831.73,2023-04-02T11:22:43,Bilbao,expenses,leisure,-49.72,-22800.84
buyer_1,Luis,Garay,1996-08-10,20670070Q,luis.garay@awesomedata.io,449238,ES57209552411520511223,3831.73,2023-04-02T19:26:03,Bilbao,expenses,cash,-100.0,-22900.84
buyer_1,Luis,Garay,1996-08-10,20670070Q,luis.garay@awesomedata.io,449238,ES57209552411520511223,3831.73,2023-04-02T11:34:12,Bilbao,expenses,gifts,-209.99,-23110.83
buyer_1,Luis,Garay,1996-08-10,20670070Q,luis.garay@awesomedata.io,449238,ES57209552411520511223,3831.73,2023-04-03T05:09:04,Bilbao,expenses,transport,-45.51,-23156.34
buyer_1,Luis,Garay,1996-08-10,20670070Q,luis.garay@awesomedata.io,449238,ES57209552411520511223,3831.73,2023-04-03T14:19:41,Bilbao,expenses,healthcare,-57.31,-23213.65
buyer_1,Luis,Garay,1996-08-10,20670070Q,luis.garay@awesomedata.io,449238,ES57209552411520511223,3831.73,2023-04-03T09:00:07,Bilbao,expenses,cash,-100.0,-23313.65
buyer_1,Luis,Garay,1996-08-10,20670070Q,luis.garay@awesomedata.io,449238,ES57209552411520511223,3831.73,2023-04-04T21:45:27,Bilbao,expenses,rent,-997.88,-24311.53
buyer_1,Luis,Garay,1996-08-10,20670070Q,luis.garay@awesomedata.io,449238,ES57209552411520511223,3831.73,2023-04-04T14:56:04,Bilbao,expenses,food,-123.9,-24435.43
buyer_1,Luis,Garay,1996-08-10,20670070Q,luis.garay@awesomedata.io,449238,ES57209552411520511223,3831.73,2023-04-05T10:27:13,Bilbao,expenses,electricity,-49.19,-24484.62
buyer_1,Luis,Garay,1996-08-10,20670070Q,luis.garay@awesomedata.io,449238,ES57209552411520511223,3831.73,2023-04-05T08:35:36,Bilbao,expenses,internet,-56.93,-24541.55
buyer_1,Luis,Garay,1996-08-10,20670070Q,luis.garay@awesomedata.io,449238,ES57209552411520511223,3831.73,2023-04-07T19:41:17,Bilbao,expenses,gas,-57.27,-24598.82
buyer_1,Luis,Garay,1996-08-10,20670070Q,luis.garay@awesomedata.io,449238,ES57209552411520511223,3831.73,2023-04-07T14:55:22,Bilbao,expenses,food,-88.87,-24687.69
buyer_1,Luis,Garay,1996-08-10,20670070Q,luis.garay@awesomedata.io,449238,ES57209552411520511223,3831.73,2023-04-07T21:09:02,Bilbao,expenses,cash,-100.0,-24787.69
buyer_1,Luis,Garay,1996-08-10,20670070Q,luis.garay@awesomedata.io,449238,ES57209552411520511223,3831.73,2023-04-08T02:31:29,Bilbao,expenses,electricity,-84.51,-24872.2
buyer_1,Luis,Garay,1996-08-10,20670070Q,luis.garay@awesomedata.io,449238,ES57209552411520511223,3831.73,2023-04-08T04:02:16,Bilbao,expenses,phone,-53.18,-24925.38
buyer_1,Luis,Garay,1996-08-10,20670070Q,luis.garay@awesomedata.io,449238,ES57209552411520511223,3831.73,2023-04-08T10:22:15,Bilbao,expenses,food,-78.25,-25003.63
buyer_1,Luis,Garay,1996-08-10,20670070Q,luis.garay@awesomedata.io,449238,ES57209552411520511223,3831.73,2023-04-08T11:29:59,Bilbao,expenses,transport,-59.1,-25062.73
buyer_1,Luis,Garay,1996-08-10,20670070Q,luis.garay@awesomedata.io,449238,ES57209552411520511223,3831.73,2023-04-11T18:49:20,Bilbao,expenses,clothing,-132.31,-25195.04
buyer_1,Luis,Garay,1996-08-10,20670070Q,luis.garay@awesomedata.io,449238,ES57209552411520511223,3831.73,2023-04-13T22:08:27,Bilbao,expenses,leisure,-73.36,-25268.4
buyer_1,Luis,Garay,1996-08-10,20670070Q,luis.garay@awesomedata.io,449238,ES57209552411520511223,3831.73,2023-04-13T14:13:06,Bilbao,expenses,clothing,-59.85,-25328.25
buyer_1,Luis,Garay,1996-08-10,20670070Q,luis.garay@awesomedata.io,449238,ES57209552411520511223,3831.73,2023-04-15T10:04:55,Bilbao,expenses,food,-114.51,-25442.76
buyer_1,Luis,Garay,1996-08-10,20670070Q,luis.garay@awesomedata.io,449238,ES57209552411520511223,3831.73,2023-04-15T11:11:50,Bilbao,expenses,transport,-81.15,-25523.91
buyer_1,Luis,Garay,1996-08-10,20670070Q,luis.garay@awesomedata.io,449238,ES57209552411520511223,3831.73,2023-04-17T12:12:19,Bilbao,expenses,food,-73.69,-25597.6
buyer_1,Luis,Garay,1996-08-10,20670070Q,luis.garay@awesomedata.io,449238,ES57209552411520511223,3831.73,2023-04-17T07:31:42,Bilbao,expenses,cash,-100.0,-25697.6
buyer_1,Luis,Garay,1996-08-10,20670070Q,luis.garay@awesomedata.io,449238,ES57209552411520511223,3831.73,2023-04-18T13:08:00,Bilbao,expenses,food,-107.51,-25805.11
buyer_1,Luis,Garay,1996-08-10,20670070Q,luis.garay@awesomedata.io,449238,ES57209552411520511223,3831.73,2023-04-21T04:52:12,Bilbao,expenses,food,-104.6,-25909.71
buyer_1,Luis,Garay,1996-08-10,20670070Q,luis.garay@awesomedata.io,449238,ES57209552411520511223,3831.73,2023-04-23T08:33:13,Bilbao,expenses,food,-82.13,-25991.84
buyer_1,Luis,Garay,1996-08-10,20670070Q,luis.garay@awesomedata.io,449238,ES57209552411520511223,3831.73,2023-04-23T13:27:04,Bilbao,expenses,clothing,-66.74,-26058.58
buyer_1,Luis,Garay,1996-08-10,20670070Q,luis.garay@awesomedata.io,449238,ES57209552411520511223,3831.73,2023-04-24T21:33:30,Bilbao,expenses,cash,-100.0,-26158.58
buyer_1,Luis,Garay,1996-08-10,20670070Q,luis.garay@awesomedata.io,449238,ES57209552411520511223,3831.73,2023-04-24T11:06:04,Bilbao,expenses,travel,-509.78,-26668.36
buyer_1,Luis,Garay,1996-08-10,20670070Q,luis.garay@awesomedata.io,449238,ES57209552411520511223,3831.73,2023-04-27T08:13:59,Bilbao,expenses,food,-104.23,-26772.59
buyer_1,Luis,Garay,1996-08-10,20670070Q,luis.garay@awesomedata.io,449238,ES57209552411520511223,3831.73,2023-04-28T14:23:07,Bilbao,expenses,leisure,-68.53,-26841.12
buyer_1,Luis,Garay,1996-08-10,20670070Q,luis.garay@awesomedata.io,449238,ES57209552411520511223,3831.73,2023-04-28T14:50:31,Bilbao,expenses,cash,-100.0,-26941.12
buyer_1,Luis,Garay,1996-08-10,20670070Q,luis.garay@awesomedata.io,449238,ES57209552411520511223,3831.73,2023-04-29T14:34:22,Bilbao,expenses,cash,-100.0,-27041.12
buyer_1,Luis,Garay,1996-08-10,20670070Q,luis.garay@awesomedata.io,449238,ES57209552411520511223,3831.73,2023-04-30T22:28:39,Bilbao,expenses,clothing,-61.83,-27102.95
buyer_1,Luis,Garay,1996-08-10,20670070Q,luis.garay@awesomedata.io,449238,ES57209552411520511223,3831.73,2023-05-01T14:40:17,Bilbao,incomes,salary,2711.02,-24391.93
buyer_1,Luis,Garay,1996-08-10,20670070Q,luis.garay@awesomedata.io,449238,ES57209552411520511223,3831.73,2023-05-01T13:11:24,Bilbao,expenses,cash,-100.0,-24491.93
buyer_1,Luis,Garay,1996-08-10,20670070Q,luis.garay@awesomedata.io,449238,ES57209552411520511223,3831.73,2023-05-01T15:27:37,Bilbao,expenses,repairs,-27.67,-24519.6
buyer_1,Luis,Garay,1996-08-10,20670070Q,luis.garay@awesomedata.io,449238,ES57209552411520511223,3831.73,2023-05-02T23:36:51,Bilbao,expenses,cash,-100.0,-24619.6
buyer_1,Luis,Garay,1996-08-10,20670070Q,luis.garay@awesomedata.io,449238,ES57209552411520511223,3831.73,2023-05-03T19:17:41,Bilbao,expenses,repairs,-104.66,-24724.26
buyer_1,Luis,Garay,1996-08-10,20670070Q,luis.garay@awesomedata.io,449238,ES57209552411520511223,3831.73,2023-05-04T15:38:42,Bilbao,expenses,rent,-997.88,-25722.14
buyer_1,Luis,Garay,1996-08-10,20670070Q,luis.garay@awesomedata.io,449238,ES57209552411520511223,3831.73,2023-05-04T15:47:55,Bilbao,expenses,healthcare,-126.34,-25848.48
buyer_1,Luis,Garay,1996-08-10,20670070Q,luis.garay@awesomedata.io,449238,ES57209552411520511223,3831.73,2023-05-06T12:20:45,Bilbao,expenses,internet,-56.93,-25905.41
buyer_1,Luis,Garay,1996-08-10,20670070Q,luis.garay@awesomedata.io,449238,ES57209552411520511223,3831.73,2023-05-06T20:35:47,Bilbao,expenses,food,-79.13,-25984.54
buyer_1,Luis,Garay,1996-08-10,20670070Q,luis.garay@awesomedata.io,449238,ES57209552411520511223,3831.73,2023-05-06T20:25:02,Bilbao,expenses,repairs,-170.81,-26155.35
buyer_1,Luis,Garay,1996-08-10,20670070Q,luis.garay@awesomedata.io,449238,ES57209552411520511223,3831.73,2023-05-07T20:11:29,Bilbao,expenses,gas,-110.79,-26266.14
buyer_1,Luis,Garay,1996-08-10,20670070Q,luis.garay@awesomedata.io,449238,ES57209552411520511223,3831.73,2023-05-08T09:03:11,Bilbao,expenses,electricity,-38.8,-26304.94
buyer_1,Luis,Garay,1996-08-10,20670070Q,luis.garay@awesomedata.io,449238,ES57209552411520511223,3831.73,2023-05-08T16:29:42,Bilbao,expenses,food,-106.48,-26411.42
buyer_1,Luis,Garay,1996-08-10,20670070Q,luis.garay@awesomedata.io,449238,ES57209552411520511223,3831.73,2023-05-14T12:08:48,Bilbao,expenses,food,-104.74,-26516.16
buyer_1,Luis,Garay,1996-08-10,20670070Q,luis.garay@awesomedata.io,449238,ES57209552411520511223,3831.73,2023-05-14T11:43:38,Bilbao,expenses,transport,-69.7,-26585.86
buyer_1,Luis,Garay,1996-08-10,20670070Q,luis.garay@awesomedata.io,449238,ES57209552411520511223,3831.73,2023-05-15T10:35:28,Bilbao,expenses,leisure,-72.27,-26658.13
buyer_1,Luis,Garay,1996-08-10,20670070Q,luis.garay@awesomedata.io,449238,ES57209552411520511223,3831.73,2023-05-16T09:37:30,Bilbao,expenses,food,-75.22,-26733.35
buyer_1,Luis,Garay,1996-08-10,20670070Q,luis.garay@awesomedata.io,449238,ES57209552411520511223,3831.73,2023-05-16T09:33:29,Bilbao,expenses,transport,-78.02,-26811.37
buyer_1,Luis,Garay,1996-08-10,20670070Q,luis.garay@awesomedata.io,449238,ES57209552411520511223,3831.73,2023-05-16T19:48:48,Bilbao,expenses,leisure,-63.36,-26874.73
buyer_1,Luis,Garay,1996-08-10,20670070Q,luis.garay@awesomedata.io,449238,ES57209552411520511223,3831.73,2023-05-16T00:42:37,Bilbao,expenses,clothing,-62.04,-26936.77
buyer_1,Luis,Garay,1996-08-10,20670070Q,luis.garay@awesomedata.io,449238,ES57209552411520511223,3831.73,2023-05-16T13:22:00,Bilbao,expenses,repairs,-109.83,-27046.6
buyer_1,Luis,Garay,1996-08-10,20670070Q,luis.garay@awesomedata.io,449238,ES57209552411520511223,3831.73,2023-05-17T09:53:18,Bilbao,expenses,transport,-69.05,-27115.65
buyer_1,Luis,Garay,1996-08-10,20670070Q,luis.garay@awesomedata.io,449238,ES57209552411520511223,3831.73,2023-05-19T23:05:38,Bilbao,expenses,transport,-70.64,-27186.29
buyer_1,Luis,Garay,1996-08-10,20670070Q,luis.garay@awesomedata.io,449238,ES57209552411520511223,3831.73,2023-05-22T09:33:24,Bilbao,expenses,food,-61.25,-27247.54
buyer_1,Luis,Garay,1996-08-10,20670070Q,luis.garay@awesomedata.io,449238,ES57209552411520511223,3831.73,2023-05-24T17:02:01,Bilbao,expenses,education,-77.48,-27325.02
buyer_1,Luis,Garay,1996-08-10,20670070Q,luis.garay@awesomedata.io,449238,ES57209552411520511223,3831.73,2023-05-24T16:05:41,Bilbao,expenses,travel,-848.67,-28173.69
buyer_1,Luis,Garay,1996-08-10,20670070Q,luis.garay@awesomedata.io,449238,ES57209552411520511223,3831.73,2023-05-25T11:07:00,Bilbao,expenses,transport,-70.01,-28243.7
buyer_1,Luis,Garay,1996-08-10,20670070Q,luis.garay@awesomedata.io,449238,ES57209552411520511223,3831.73,2023-05-26T02:45:25,Bilbao,expenses,leisure,-62.17,-28305.87
buyer_1,Luis,Garay,1996-08-10,20670070Q,luis.garay@awesomedata.io,449238,ES57209552411520511223,3831.73,2023-05-26T08:47:55,Bilbao,expenses,healthcare,-100.61,-28406.48
buyer_1,Luis,Garay,1996-08-10,20670070Q,luis.garay@awesomedata.io,449238,ES57209552411520511223,3831.73,2023-05-26T18:26:27,Bilbao,expenses,repairs,-123.79,-28530.27
buyer_1,Luis,Garay,1996-08-10,20670070Q,luis.garay@awesomedata.io,449238,ES57209552411520511223,3831.73,2023-05-29T10:14:56,Bilbao,expenses,transport,-55.94,-28586.21
buyer_1,Luis,Garay,1996-08-10,20670070Q,luis.garay@awesomedata.io,449238,ES57209552411520511223,3831.73,2023-05-31T17:35:10,Bilbao,expenses,food,-85.91,-28672.12
buyer_1,Luis,Garay,1996-08-10,20670070Q,luis.garay@awesomedata.io,449238,ES57209552411520511223,3831.73,2023-06-01T14:41:29,Bilbao,incomes,salary,2711.02,-25961.1
buyer_1,Luis,Garay,1996-08-10,20670070Q,luis.garay@awesomedata.io,449238,ES57209552411520511223,3831.73,2023-06-01T14:41:29,Bilbao,incomes,extra_income,264.61,-25696.49
buyer_1,Luis,Garay,1996-08-10,20670070Q,luis.garay@awesomedata.io,449238,ES57209552411520511223,3831.73,2023-06-01T14:41:29,Bilbao,incomes,salary_bonus,2134.05,-23562.44
buyer_1,Luis,Garay,1996-08-10,20670070Q,luis.garay@awesomedata.io,449238,ES57209552411520511223,3831.73,2023-06-01T18:59:39,Bilbao,expenses,food,-89.11,-23651.55
buyer_1,Luis,Garay,1996-08-10,20670070Q,luis.garay@awesomedata.io,449238,ES57209552411520511223,3831.73,2023-06-01T12:58:03,Bilbao,expenses,education,-50.35,-23701.9
buyer_1,Luis,Garay,1996-08-10,20670070Q,luis.garay@awesomedata.io,449238,ES57209552411520511223,3831.73,2023-06-01T10:15:46,Bilbao,expenses,cash,-100.0,-23801.9
buyer_1,Luis,Garay,1996-08-10,20670070Q,luis.garay@awesomedata.io,449238,ES57209552411520511223,3831.73,2023-06-02T18:48:00,Bilbao,expenses,taxes,-2083.47,-25885.37
buyer_1,Luis,Garay,1996-08-10,20670070Q,luis.garay@awesomedata.io,449238,ES57209552411520511223,3831.73,2023-06-02T08:11:29,Bilbao,expenses,insurance,-583.53,-26468.9
buyer_1,Luis,Garay,1996-08-10,20670070Q,luis.garay@awesomedata.io,449238,ES57209552411520511223,3831.73,2023-06-02T14:01:25,Bilbao,expenses,leisure,-58.36,-26527.26
buyer_1,Luis,Garay,1996-08-10,20670070Q,luis.garay@awesomedata.io,449238,ES57209552411520511223,3831.73,2023-06-02T04:59:52,Bilbao,expenses,gifts,-468.35,-26995.61
buyer_1,Luis,Garay,1996-08-10,20670070Q,luis.garay@awesomedata.io,449238,ES57209552411520511223,3831.73,2023-06-03T20:01:14,Bilbao,expenses,leisure,-68.32,-27063.93
buyer_1,Luis,Garay,1996-08-10,20670070Q,luis.garay@awesomedata.io,449238,ES57209552411520511223,3831.73,2023-06-04T17:25:23,Bilbao,expenses,rent,-997.88,-28061.81
buyer_1,Luis,Garay,1996-08-10,20670070Q,luis.garay@awesomedata.io,449238,ES57209552411520511223,3831.73,2023-06-05T19:19:58,Bilbao,expenses,phone,-55.13,-28116.94
buyer_1,Luis,Garay,1996-08-10,20670070Q,luis.garay@awesomedata.io,449238,ES57209552411520511223,3831.73,2023-06-05T22:09:40,Bilbao,expenses,food,-74.86,-28191.8
buyer_1,Luis,Garay,1996-08-10,20670070Q,luis.garay@awesomedata.io,449238,ES57209552411520511223,3831.73,2023-06-06T15:11:06,Bilbao,expenses,water,-56.04,-28247.84
buyer_1,Luis,Garay,1996-08-10,20670070Q,luis.garay@awesomedata.io,449238,ES57209552411520511223,3831.73,2023-06-07T20:50:24,Bilbao,expenses,gas,-143.91,-28391.75
buyer_1,Luis,Garay,1996-08-10,20670070Q,luis.garay@awesomedata.io,449238,ES57209552411520511223,3831.73,2023-06-08T10:18:44,Bilbao,expenses,gas,-66.79,-28458.54
buyer_1,Luis,Garay,1996-08-10,20670070Q,luis.garay@awesomedata.io,449238,ES57209552411520511223,3831.73,2023-06-08T22:41:52,Bilbao,expenses,repairs,-90.49,-28549.03
buyer_1,Luis,Garay,1996-08-10,20670070Q,luis.garay@awesomedata.io,449238,ES57209552411520511223,3831.73,2023-06-11T15:58:21,Bilbao,expenses,leisure,-73.21,-28622.24
buyer_1,Luis,Garay,1996-08-10,20670070Q,luis.garay@awesomedata.io,449238,ES57209552411520511223,3831.73,2023-06-11T12:16:04,Bilbao,expenses,cash,-100.0,-28722.24
buyer_1,Luis,Garay,1996-08-10,20670070Q,luis.garay@awesomedata.io,449238,ES57209552411520511223,3831.73,2023-06-12T13:38:41,Bilbao,expenses,healthcare,-68.0,-28790.24
buyer_1,Luis,Garay,1996-08-10,20670070Q,luis.garay@awesomedata.io,449238,ES57209552411520511223,3831.73,2023-06-12T17:30:57,Bilbao,expenses,education,-42.09,-28832.33
buyer_1,Luis,Garay,1996-08-10,20670070Q,luis.garay@awesomedata.io,449238,ES57209552411520511223,3831.73,2023-06-13T18:19:34,Bilbao,expenses,food,-72.17,-28904.5
buyer_1,Luis,Garay,1996-08-10,20670070Q,luis.garay@awesomedata.io,449238,ES57209552411520511223,3831.73,2023-06-14T08:36:09,Bilbao,expenses,leisure,-20.83,-28925.33
buyer_1,Luis,Garay,1996-08-10,20670070Q,luis.garay@awesomedata.io,449238,ES57209552411520511223,3831.73,2023-06-14T13:59:04,Bilbao,expenses,cash,-100.0,-29025.33
buyer_1,Luis,Garay,1996-08-10,20670070Q,luis.garay@awesomedata.io,449238,ES57209552411520511223,3831.73,2023-06-19T18:32:15,Bilbao,expenses,food,-89.85,-29115.18
buyer_1,Luis,Garay,1996-08-10,20670070Q,luis.garay@awesomedata.io,449238,ES57209552411520511223,3831.73,2023-06-19T17:38:23,Bilbao,expenses,clothing,-99.32,-29214.5
buyer_1,Luis,Garay,1996-08-10,20670070Q,luis.garay@awesomedata.io,449238,ES57209552411520511223,3831.73,2023-06-23T20:49:51,Bilbao,expenses,food,-117.92,-29332.42
buyer_1,Luis,Garay,1996-08-10,20670070Q,luis.garay@awesomedata.io,449238,ES57209552411520511223,3831.73,2023-06-23T09:15:54,Bilbao,expenses,transport,-58.91,-29391.33
buyer_1,Luis,Garay,1996-08-10,20670070Q,luis.garay@awesomedata.io,449238,ES57209552411520511223,3831.73,2023-06-23T12:21:09,Bilbao,expenses,healthcare,-99.46,-29490.79
buyer_1,Luis,Garay,1996-08-10,20670070Q,luis.garay@awesomedata.io,449238,ES57209552411520511223,3831.73,2023-06-27T13:14:58,Bilbao,expenses,appliances,-251.3,-29742.09
buyer_1,Luis,Garay,1996-08-10,20670070Q,luis.garay@awesomedata.io,449238,ES57209552411520511223,3831.73,2023-06-29T09:17:23,Bilbao,expenses,transport,-67.36,-29809.45
buyer_1,Luis,Garay,1996-08-10,20670070Q,luis.garay@awesomedata.io,449238,ES57209552411520511223,3831.73,2023-06-30T19:18:57,Bilbao,expenses,cash,-100.0,-29909.45
buyer_1,Luis,Garay,1996-08-10,20670070Q,luis.garay@awesomedata.io,449238,ES57209552411520511223,3831.73,2023-06-30T14:07:17,Bilbao,expenses,appliances,-343.64,-30253.09
buyer_1,Luis,Garay,1996-08-10,20670070Q,luis.garay@awesomedata.io,449238,ES57209552411520511223,3831.73,2023-07-01T07:44:33,Bilbao,incomes,salary,2711.02,-27542.07
buyer_1,Luis,Garay,1996-08-10,20670070Q,luis.garay@awesomedata.io,449238,ES57209552411520511223,3831.73,2023-07-02T15:50:29,Bilbao,expenses,leisure,-33.79,-27575.86
buyer_1,Luis,Garay,1996-08-10,20670070Q,luis.garay@awesomedata.io,449238,ES57209552411520511223,3831.73,2023-07-04T20:53:45,Bilbao,expenses,rent,-997.88,-28573.74
buyer_1,Luis,Garay,1996-08-10,20670070Q,luis.garay@awesomedata.io,449238,ES57209552411520511223,3831.73,2023-07-04T11:35:06,Bilbao,expenses,transport,-66.36,-28640.1
buyer_1,Luis,Garay,1996-08-10,20670070Q,luis.garay@awesomedata.io,449238,ES57209552411520511223,3831.73,2023-07-06T16:15:56,Bilbao,expenses,transport,-80.63,-28720.73
buyer_1,Luis,Garay,1996-08-10,20670070Q,luis.garay@awesomedata.io,449238,ES57209552411520511223,3831.73,2023-07-07T10:29:27,Bilbao,expenses,gas,-78.53,-28799.26
buyer_1,Luis,Garay,1996-08-10,20670070Q,luis.garay@awesomedata.io,449238,ES57209552411520511223,3831.73,2023-07-07T20:10:12,Bilbao,expenses,internet,-56.93,-28856.19
buyer_1,Luis,Garay,1996-08-10,20670070Q,luis.garay@awesomedata.io,449238,ES57209552411520511223,3831.73,2023-07-07T11:11:25,Bilbao,expenses,phone,-54.08,-28910.27
buyer_1,Luis,Garay,1996-08-10,20670070Q,luis.garay@awesomedata.io,449238,ES57209552411520511223,3831.73,2023-07-07T08:13:40,Bilbao,expenses,leisure,-46.27,-28956.54
buyer_1,Luis,Garay,1996-08-10,20670070Q,luis.garay@awesomedata.io,449238,ES57209552411520511223,3831.73,2023-07-08T16:55:29,Bilbao,expenses,water,-48.14,-29004.68
buyer_1,Luis,Garay,1996-08-10,20670070Q,luis.garay@awesomedata.io,449238,ES57209552411520511223,3831.73,2023-07-08T09:29:51,Bilbao,expenses,gas,-90.6,-29095.28
buyer_1,Luis,Garay,1996-08-10,20670070Q,luis.garay@awesomedata.io,449238,ES57209552411520511223,3831.73,2023-07-08T14:49:32,Bilbao,expenses,phone,-53.47,-29148.75
buyer_1,Luis,Garay,1996-08-10,20670070Q,luis.garay@awesomedata.io,449238,ES57209552411520511223,3831.73,2023-07-08T10:39:14,Bilbao,expenses,transport,-64.63,-29213.38
buyer_1,Luis,Garay,1996-08-10,20670070Q,luis.garay@awesomedata.io,449238,ES57209552411520511223,3831.73,2023-07-08T14:25:09,Bilbao,expenses,cash,-100.0,-29313.38
buyer_1,Luis,Garay,1996-08-10,20670070Q,luis.garay@awesomedata.io,449238,ES57209552411520511223,3831.73,2023-07-09T09:28:04,Bilbao,expenses,cash,-100.0,-29413.38
buyer_1,Luis,Garay,1996-08-10,20670070Q,luis.garay@awesomedata.io,449238,ES57209552411520511223,3831.73,2023-07-10T02:35:35,Bilbao,expenses,leisure,-36.22,-29449.6
buyer_1,Luis,Garay,1996-08-10,20670070Q,luis.garay@awesomedata.io,449238,ES57209552411520511223,3831.73,2023-07-11T20:02:20,Bilbao,expenses,food,-66.18,-29515.78
buyer_1,Luis,Garay,1996-08-10,20670070Q,luis.garay@awesomedata.io,449238,ES57209552411520511223,3831.73,2023-07-14T09:58:47,Bilbao,expenses,leisure,-82.71,-29598.49
buyer_1,Luis,Garay,1996-08-10,20670070Q,luis.garay@awesomedata.io,449238,ES57209552411520511223,3831.73,2023-07-14T22:04:00,Bilbao,expenses,gifts,-328.73,-29927.22
buyer_1,Luis,Garay,1996-08-10,20670070Q,luis.garay@awesomedata.io,449238,ES57209552411520511223,3831.73,2023-07-15T21:10:15,Bilbao,expenses,food,-81.31,-30008.53
buyer_1,Luis,Garay,1996-08-10,20670070Q,luis.garay@awesomedata.io,449238,ES57209552411520511223,3831.73,2023-07-15T08:27:48,Bilbao,expenses,cash,-100.0,-30108.53
buyer_1,Luis,Garay,1996-08-10,20670070Q,luis.garay@awesomedata.io,449238,ES57209552411520511223,3831.73,2023-07-16T19:45:47,Bilbao,expenses,transport,-53.37,-30161.9
buyer_1,Luis,Garay,1996-08-10,20670070Q,luis.garay@awesomedata.io,449238,ES57209552411520511223,3831.73,2023-07-17T15:08:01,Bilbao,expenses,travel,-976.22,-31138.12
buyer_1,Luis,Garay,1996-08-10,20670070Q,luis.garay@awesomedata.io,449238,ES57209552411520511223,3831.73,2023-07-18T09:06:44,Bilbao,expenses,food,-93.33,-31231.45
buyer_1,Luis,Garay,1996-08-10,20670070Q,luis.garay@awesomedata.io,449238,ES57209552411520511223,3831.73,2023-07-18T16:16:57,Bilbao,expenses,repairs,-30.22,-31261.67
buyer_1,Luis,Garay,1996-08-10,20670070Q,luis.garay@awesomedata.io,449238,ES57209552411520511223,3831.73,2023-07-19T16:21:09,Bilbao,expenses,cash,-100.0,-31361.67
buyer_1,Luis,Garay,1996-08-10,20670070Q,luis.garay@awesomedata.io,449238,ES57209552411520511223,3831.73,2023-07-21T09:28:06,Bilbao,expenses,food,-90.71,-31452.38
buyer_1,Luis,Garay,1996-08-10,20670070Q,luis.garay@awesomedata.io,449238,ES57209552411520511223,3831.73,2023-07-23T08:46:00,Bilbao,expenses,healthcare,-74.42,-31526.8
buyer_1,Luis,Garay,1996-08-10,20670070Q,luis.garay@awesomedata.io,449238,ES57209552411520511223,3831.73,2023-07-24T08:40:24,Bilbao,expenses,transport,-79.42,-31606.22
buyer_1,Luis,Garay,1996-08-10,20670070Q,luis.garay@awesomedata.io,449238,ES57209552411520511223,3831.73,2023-07-27T21:33:12,Bilbao,expenses,leisure,-26.18,-31632.4
buyer_1,Luis,Garay,1996-08-10,20670070Q,luis.garay@awesomedata.io,449238,ES57209552411520511223,3831.73,2023-07-27T12:03:45,Bilbao,expenses,cash,-100.0,-31732.4
buyer_1,Luis,Garay,1996-08-10,20670070Q,luis.garay@awesomedata.io,449238,ES57209552411520511223,3831.73,2023-07-28T15:22:37,Bilbao,expenses,gifts,-398.59,-32130.99
buyer_1,Luis,Garay,1996-08-10,20670070Q,luis.garay@awesomedata.io,449238,ES57209552411520511223,3831.73,2023-07-29T09:15:52,Bilbao,expenses,leisure,-39.35,-32170.34
buyer_1,Luis,Garay,1996-08-10,20670070Q,luis.garay@awesomedata.io,449238,ES57209552411520511223,3831.73,2023-07-29T15:33:13,Bilbao,expenses,education,-67.52,-32237.86
buyer_1,Luis,Garay,1996-08-10,20670070Q,luis.garay@awesomedata.io,449238,ES57209552411520511223,3831.73,2023-07-29T16:39:14,Bilbao,expenses,gifts,-605.5,-32843.36
buyer_1,Luis,Garay,1996-08-10,20670070Q,luis.garay@awesomedata.io,449238,ES57209552411520511223,3831.73,2023-07-30T02:27:44,Bilbao,expenses,gifts,-229.7,-33073.06
buyer_1,Luis,Garay,1996-08-10,20670070Q,luis.garay@awesomedata.io,449238,ES57209552411520511223,3831.73,2023-07-31T18:03:20,Bilbao,expenses,food,-97.77,-33170.83
buyer_1,Luis,Garay,1996-08-10,20670070Q,luis.garay@awesomedata.io,449238,ES57209552411520511223,3831.73,2023-07-31T20:48:03,Bilbao,expenses,repairs,-312.82,-33483.65
buyer_1,Luis,Garay,1996-08-10,20670070Q,luis.garay@awesomedata.io,449238,ES57209552411520511223,3831.73,2023-08-01T20:51:30,Bilbao,incomes,salary,2711.02,-30772.63
buyer_1,Luis,Garay,1996-08-10,20670070Q,luis.garay@awesomedata.io,449238,ES57209552411520511223,3831.73,2023-08-01T09:31:56,Bilbao,expenses,food,-120.84,-30893.47
buyer_1,Luis,Garay,1996-08-10,20670070Q,luis.garay@awesomedata.io,449238,ES57209552411520511223,3831.73,2023-08-04T11:36:36,Bilbao,expenses,rent,-997.88,-31891.35
buyer_1,Luis,Garay,1996-08-10,20670070Q,luis.garay@awesomedata.io,449238,ES57209552411520511223,3831.73,2023-08-04T01:40:00,Bilbao,expenses,gifts,-655.48,-32546.83
buyer_1,Luis,Garay,1996-08-10,20670070Q,luis.garay@awesomedata.io,449238,ES57209552411520511223,3831.73,2023-08-05T19:18:07,Bilbao,expenses,food,-75.86,-32622.69
buyer_1,Luis,Garay,1996-08-10,20670070Q,luis.garay@awesomedata.io,449238,ES57209552411520511223,3831.73,2023-08-06T17:14:03,Bilbao,expenses,internet,-56.93,-32679.62
buyer_1,Luis,Garay,1996-08-10,20670070Q,luis.garay@awesomedata.io,449238,ES57209552411520511223,3831.73,2023-08-08T15:11:11,Bilbao,expenses,phone,-43.76,-32723.38
buyer_1,Luis,Garay,1996-08-10,20670070Q,luis.garay@awesomedata.io,449238,ES57209552411520511223,3831.73,2023-08-08T13:19:33,Bilbao,expenses,gifts,-724.05,-33447.43
buyer_1,Luis,Garay,1996-08-10,20670070Q,luis.garay@awesomedata.io,449238,ES57209552411520511223,3831.73,2023-08-10T00:23:20,Bilbao,expenses,cash,-100.0,-33547.43
buyer_1,Luis,Garay,1996-08-10,20670070Q,luis.garay@awesomedata.io,449238,ES57209552411520511223,3831.73,2023-08-10T14:32:56,Bilbao,expenses,repairs,-126.62,-33674.05
buyer_1,Luis,Garay,1996-08-10,20670070Q,luis.garay@awesomedata.io,449238,ES57209552411520511223,3831.73,2023-08-14T20:50:18,Bilbao,expenses,education,-65.84,-33739.89
buyer_1,Luis,Garay,1996-08-10,20670070Q,luis.garay@awesomedata.io,449238,ES57209552411520511223,3831.73,2023-08-14T10:20:52,Bilbao,expenses,gifts,-503.49,-34243.38
buyer_1,Luis,Garay,1996-08-10,20670070Q,luis.garay@awesomedata.io,449238,ES57209552411520511223,3831.73,2023-08-15T19:03:07,Bilbao,expenses,food,-115.76,-34359.14
buyer_1,Luis,Garay,1996-08-10,20670070Q,luis.garay@awesomedata.io,449238,ES57209552411520511223,3831.73,2023-08-15T17:20:36,Bilbao,expenses,leisure,-60.45,-34419.59
buyer_1,Luis,Garay,1996-08-10,20670070Q,luis.garay@awesomedata.io,449238,ES57209552411520511223,3831.73,2023-08-16T19:41:49,Bilbao,expenses,transport,-76.61,-34496.2
buyer_1,Luis,Garay,1996-08-10,20670070Q,luis.garay@awesomedata.io,449238,ES57209552411520511223,3831.73,2023-08-17T08:13:49,Bilbao,expenses,transport,-87.75,-34583.95
buyer_1,Luis,Garay,1996-08-10,20670070Q,luis.garay@awesomedata.io,449238,ES57209552411520511223,3831.73,2023-08-20T10:17:55,Bilbao,expenses,repairs,-332.02,-34915.97
buyer_1,Luis,Garay,1996-08-10,20670070Q,luis.garay@awesomedata.io,449238,ES57209552411520511223,3831.73,2023-08-21T14:20:40,Bilbao,expenses,education,-66.12,-34982.09
buyer_1,Luis,Garay,1996-08-10,20670070Q,luis.garay@awesomedata.io,449238,ES57209552411520511223,3831.73,2023-08-25T15:39:44,Bilbao,expenses,food,-86.76,-35068.85
buyer_1,Luis,Garay,1996-08-10,20670070Q,luis.garay@awesomedata.io,449238,ES57209552411520511223,3831.73,2023-08-26T16:10:55,Bilbao,expenses,cash,-100.0,-35168.85
buyer_1,Luis,Garay,1996-08-10,20670070Q,luis.garay@awesomedata.io,449238,ES57209552411520511223,3831.73,2023-08-26T19:02:43,Bilbao,expenses,travel,-516.76,-35685.61
buyer_1,Luis,Garay,1996-08-10,20670070Q,luis.garay@awesomedata.io,449238,ES57209552411520511223,3831.73,2023-08-27T13:13:47,Bilbao,expenses,gifts,-539.34,-36224.95
buyer_1,Luis,Garay,1996-08-10,20670070Q,luis.garay@awesomedata.io,449238,ES57209552411520511223,3831.73,2023-08-28T11:27:04,Bilbao,expenses,repairs,-240.04,-36464.99
buyer_1,Luis,Garay,1996-08-10,20670070Q,luis.garay@awesomedata.io,449238,ES57209552411520511223,3831.73,2023-08-29T22:14:07,Bilbao,expenses,healthcare,-158.05,-36623.04
buyer_1,Luis,Garay,1996-08-10,20670070Q,luis.garay@awesomedata.io,449238,ES57209552411520511223,3831.73,2023-08-30T02:28:23,Bilbao,expenses,healthcare,-140.86,-36763.9
buyer_1,Luis,Garay,1996-08-10,20670070Q,luis.garay@awesomedata.io,449238,ES57209552411520511223,3831.73,2023-09-01T10:58:17,Bilbao,incomes,salary,2711.02,-34052.88
buyer_1,Luis,Garay,1996-08-10,20670070Q,luis.garay@awesomedata.io,449238,ES57209552411520511223,3831.73,2023-09-01T10:58:17,Bilbao,incomes,extra_income,264.61,-33788.27
buyer_1,Luis,Garay,1996-08-10,20670070Q,luis.garay@awesomedata.io,449238,ES57209552411520511223,3831.73,2023-09-02T16:26:09,Bilbao,expenses,repairs,-36.6,-33824.87
buyer_1,Luis,Garay,1996-08-10,20670070Q,luis.garay@awesomedata.io,449238,ES57209552411520511223,3831.73,2023-09-04T09:17:40,Bilbao,expenses,rent,-997.88,-34822.75
buyer_1,Luis,Garay,1996-08-10,20670070Q,luis.garay@awesomedata.io,449238,ES57209552411520511223,3831.73,2023-09-05T15:00:13,Bilbao,expenses,leisure,-32.96,-34855.71
buyer_1,Luis,Garay,1996-08-10,20670070Q,luis.garay@awesomedata.io,449238,ES57209552411520511223,3831.73,2023-09-06T12:56:44,Bilbao,expenses,water,-43.43,-34899.14
buyer_1,Luis,Garay,1996-08-10,20670070Q,luis.garay@awesomedata.io,449238,ES57209552411520511223,3831.73,2023-09-06T19:43:36,Bilbao,expenses,gas,-56.92,-34956.06
buyer_1,Luis,Garay,1996-08-10,20670070Q,luis.garay@awesomedata.io,449238,ES57209552411520511223,3831.73,2023-09-07T08:24:26,Bilbao,expenses,leisure,-26.53,-34982.59
buyer_1,Luis,Garay,1996-08-10,20670070Q,luis.garay@awesomedata.io,449238,ES57209552411520511223,3831.73,2023-09-08T15:04:28,Bilbao,expenses,water,-37.24,-35019.83
buyer_1,Luis,Garay,1996-08-10,20670070Q,luis.garay@awesomedata.io,449238,ES57209552411520511223,3831.73,2023-09-08T10:23:37,Bilbao,expenses,electricity,-81.1,-35100.93
buyer_1,Luis,Garay,1996-08-10,20670070Q,luis.garay@awesomedata.io,449238,ES57209552411520511223,3831.73,2023-09-08T17:48:56,Bilbao,expenses,gifts,-824.55,-35925.48
buyer_1,Luis,Garay,1996-08-10,20670070Q,luis.garay@awesomedata.io,449238,ES57209552411520511223,3831.73,2023-09-09T00:12:53,Bilbao,expenses,leisure,-57.04,-35982.52
buyer_1,Luis,Garay,1996-08-10,20670070Q,luis.garay@awesomedata.io,449238,ES57209552411520511223,3831.73,2023-09-12T18:19:39,Bilbao,expenses,food,-78.71,-36061.23
buyer_1,Luis,Garay,1996-08-10,20670070Q,luis.garay@awesomedata.io,449238,ES57209552411520511223,3831.73,2023-09-12T19:06:50,Bilbao,expenses,clothing,-151.92,-36213.15
buyer_1,Luis,Garay,1996-08-10,20670070Q,luis.garay@awesomedata.io,449238,ES57209552411520511223,3831.73,2023-09-13T18:54:32,Bilbao,expenses,leisure,-21.39,-36234.54
buyer_1,Luis,Garay,1996-08-10,20670070Q,luis.garay@awesomedata.io,449238,ES57209552411520511223,3831.73,2023-09-13T11:18:14,Bilbao,expenses,clothing,-106.35,-36340.89
buyer_1,Luis,Garay,1996-08-10,20670070Q,luis.garay@awesomedata.io,449238,ES57209552411520511223,3831.73,2023-09-14T12:10:44,Bilbao,expenses,food,-107.6,-36448.49
buyer_1,Luis,Garay,1996-08-10,20670070Q,luis.garay@awesomedata.io,449238,ES57209552411520511223,3831.73,2023-09-14T15:03:38,Bilbao,expenses,gifts,-53.32,-36501.81
buyer_1,Luis,Garay,1996-08-10,20670070Q,luis.garay@awesomedata.io,449238,ES57209552411520511223,3831.73,2023-09-15T23:01:43,Bilbao,expenses,repairs,-294.82,-36796.63
buyer_1,Luis,Garay,1996-08-10,20670070Q,luis.garay@awesomedata.io,449238,ES57209552411520511223,3831.73,2023-09-16T08:30:28,Bilbao,expenses,clothing,-110.19,-36906.82
buyer_1,Luis,Garay,1996-08-10,20670070Q,luis.garay@awesomedata.io,449238,ES57209552411520511223,3831.73,2023-09-16T17:33:05,Bilbao,expenses,repairs,-124.09,-37030.91
buyer_1,Luis,Garay,1996-08-10,20670070Q,luis.garay@awesomedata.io,449238,ES57209552411520511223,3831.73,2023-09-17T17:39:28,Bilbao,expenses,repairs,-267.51,-37298.42
buyer_1,Luis,Garay,1996-08-10,20670070Q,luis.garay@awesomedata.io,449238,ES57209552411520511223,3831.73,2023-09-18T13:27:11,Bilbao,expenses,cash,-100.0,-37398.42
buyer_1,Luis,Garay,1996-08-10,20670070Q,luis.garay@awesomedata.io,449238,ES57209552411520511223,3831.73,2023-09-18T15:37:49,Bilbao,expenses,repairs,-111.08,-37509.5
buyer_1,Luis,Garay,1996-08-10,20670070Q,luis.garay@awesomedata.io,449238,ES57209552411520511223,3831.73,2023-09-20T18:12:09,Bilbao,expenses,cash,-100.0,-37609.5
buyer_1,Luis,Garay,1996-08-10,20670070Q,luis.garay@awesomedata.io,449238,ES57209552411520511223,3831.73,2023-09-21T16:32:34,Bilbao,expenses,gifts,-819.79,-38429.29
buyer_1,Luis,Garay,1996-08-10,20670070Q,luis.garay@awesomedata.io,449238,ES57209552411520511223,3831.73,2023-09-22T09:59:17,Bilbao,expenses,food,-116.92,-38546.21
buyer_1,Luis,Garay,1996-08-10,20670070Q,luis.garay@awesomedata.io,449238,ES57209552411520511223,3831.73,2023-09-25T11:48:04,Bilbao,expenses,travel,-785.82,-39332.03
buyer_1,Luis,Garay,1996-08-10,20670070Q,luis.garay@awesomedata.io,449238,ES57209552411520511223,3831.73,2023-09-25T13:01:24,Bilbao,expenses,gifts,-195.45,-39527.48
buyer_1,Luis,Garay,1996-08-10,20670070Q,luis.garay@awesomedata.io,449238,ES57209552411520511223,3831.73,2023-09-27T16:32:03,Bilbao,expenses,cash,-100.0,-39627.48
buyer_1,Luis,Garay,1996-08-10,20670070Q,luis.garay@awesomedata.io,449238,ES57209552411520511223,3831.73,2023-09-28T12:32:03,Bilbao,expenses,cash,-100.0,-39727.48
buyer_1,Luis,Garay,1996-08-10,20670070Q,luis.garay@awesomedata.io,449238,ES57209552411520511223,3831.73,2023-09-30T10:39:18,Bilbao,expenses,transport,-75.98,-39803.46
buyer_1,Luis,Garay,1996-08-10,20670070Q,luis.garay@awesomedata.io,449238,ES57209552411520511223,3831.73,2023-10-01T15:12:40,Bilbao,incomes,salary,2711.02,-37092.44
buyer_1,Luis,Garay,1996-08-10,20670070Q,luis.garay@awesomedata.io,449238,ES57209552411520511223,3831.73,2023-10-04T09:18:18,Bilbao,expenses,rent,-997.88,-38090.32
buyer_1,Luis,Garay,1996-08-10,20670070Q,luis.garay@awesomedata.io,449238,ES57209552411520511223,3831.73,2023-10-05T16:37:21,Bilbao,expenses,gas,-144.27,-38234.59
buyer_1,Luis,Garay,1996-08-10,20670070Q,luis.garay@awesomedata.io,449238,ES57209552411520511223,3831.73,2023-10-05T09:54:57,Bilbao,expenses,phone,-53.15,-38287.74
buyer_1,Luis,Garay,1996-08-10,20670070Q,luis.garay@awesomedata.io,449238,ES57209552411520511223,3831.73,2023-10-06T15:08:18,Bilbao,expenses,internet,-56.93,-38344.67
buyer_1,Luis,Garay,1996-08-10,20670070Q,luis.garay@awesomedata.io,449238,ES57209552411520511223,3831.73,2023-10-06T06:56:19,Bilbao,expenses,food,-70.55,-38415.22
buyer_1,Luis,Garay,1996-08-10,20670070Q,luis.garay@awesomedata.io,449238,ES57209552411520511223,3831.73,2023-10-07T10:06:31,Bilbao,expenses,electricity,-92.1,-38507.32
buyer_1,Luis,Garay,1996-08-10,20670070Q,luis.garay@awesomedata.io,449238,ES57209552411520511223,3831.73,2023-10-07T11:52:36,Bilbao,expenses,gas,-66.73,-38574.05
buyer_1,Luis,Garay,1996-08-10,20670070Q,luis.garay@awesomedata.io,449238,ES57209552411520511223,3831.73,2023-10-07T20:48:03,Bilbao,expenses,food,-111.4,-38685.45
buyer_1,Luis,Garay,1996-08-10,20670070Q,luis.garay@awesomedata.io,449238,ES57209552411520511223,3831.73,2023-10-08T13:26:56,Bilbao,expenses,internet,-56.93,-38742.38
buyer_1,Luis,Garay,1996-08-10,20670070Q,luis.garay@awesomedata.io,449238,ES57209552411520511223,3831.73,2023-10-10T18:18:34,Bilbao,expenses,food,-97.59,-38839.97
buyer_1,Luis,Garay,1996-08-10,20670070Q,luis.garay@awesomedata.io,449238,ES57209552411520511223,3831.73,2023-10-10T12:08:54,Bilbao,expenses,clothing,-55.19,-38895.16
buyer_1,Luis,Garay,1996-08-10,20670070Q,luis.garay@awesomedata.io,449238,ES57209552411520511223,3831.73,2023-10-10T04:33:02,Bilbao,expenses,cash,-100.0,-38995.16
buyer_1,Luis,Garay,1996-08-10,20670070Q,luis.garay@awesomedata.io,449238,ES57209552411520511223,3831.73,2023-10-14T17:01:41,Bilbao,expenses,food,-65.91,-39061.07
buyer_1,Luis,Garay,1996-08-10,20670070Q,luis.garay@awesomedata.io,449238,ES57209552411520511223,3831.73,2023-10-14T08:49:09,Bilbao,expenses,cash,-100.0,-39161.07
buyer_1,Luis,Garay,1996-08-10,20670070Q,luis.garay@awesomedata.io,449238,ES57209552411520511223,3831.73,2023-10-16T11:06:33,Bilbao,expenses,transport,-88.83,-39249.9
buyer_1,Luis,Garay,1996-08-10,20670070Q,luis.garay@awesomedata.io,449238,ES57209552411520511223,3831.73,2023-10-16T10:08:30,Bilbao,expenses,leisure,-30.5,-39280.4
buyer_1,Luis,Garay,1996-08-10,20670070Q,luis.garay@awesomedata.io,449238,ES57209552411520511223,3831.73,2023-10-16T19:15:50,Bilbao,expenses,repairs,-68.06,-39348.46
buyer_1,Luis,Garay,1996-08-10,20670070Q,luis.garay@awesomedata.io,449238,ES57209552411520511223,3831.73,2023-10-18T18:55:53,Bilbao,expenses,gifts,-612.77,-39961.23
buyer_1,Luis,Garay,1996-08-10,20670070Q,luis.garay@awesomedata.io,449238,ES57209552411520511223,3831.73,2023-10-19T17:51:24,Bilbao,expenses,cash,-100.0,-40061.23
buyer_1,Luis,Garay,1996-08-10,20670070Q,luis.garay@awesomedata.io,449238,ES57209552411520511223,3831.73,2023-10-22T08:49:04,Bilbao,expenses,gifts,-71.25,-40132.48
buyer_1,Luis,Garay,1996-08-10,20670070Q,luis.garay@awesomedata.io,449238,ES57209552411520511223,3831.73,2023-10-25T14:20:29,Bilbao,expenses,food,-81.48,-40213.96
buyer_1,Luis,Garay,1996-08-10,20670070Q,luis.garay@awesomedata.io,449238,ES57209552411520511223,3831.73,2023-10-26T13:31:04,Bilbao,expenses,appliances,-120.04,-40334.0
buyer_1,Luis,Garay,1996-08-10,20670070Q,luis.garay@awesomedata.io,449238,ES57209552411520511223,3831.73,2023-10-27T18:51:51,Bilbao,expenses,healthcare,-82.67,-40416.67
buyer_1,Luis,Garay,1996-08-10,20670070Q,luis.garay@awesomedata.io,449238,ES57209552411520511223,3831.73,2023-10-28T11:20:54,Bilbao,expenses,leisure,-43.53,-40460.2
buyer_1,Luis,Garay,1996-08-10,20670070Q,luis.garay@awesomedata.io,449238,ES57209552411520511223,3831.73,2023-10-30T21:04:54,Bilbao,expenses,repairs,-193.89,-40654.09
buyer_1,Luis,Garay,1996-08-10,20670070Q,luis.garay@awesomedata.io,449238,ES57209552411520511223,3831.73,2023-11-01T18:26:33,Bilbao,incomes,salary,2711.02,-37943.07
buyer_1,Luis,Garay,1996-08-10,20670070Q,luis.garay@awesomedata.io,449238,ES57209552411520511223,3831.73,2023-11-02T21:30:58,Bilbao,expenses,food,-121.92,-38064.99
buyer_1,Luis,Garay,1996-08-10,20670070Q,luis.garay@awesomedata.io,449238,ES57209552411520511223,3831.73,2023-11-04T20:48:03,Bilbao,expenses,rent,-997.88,-39062.87
buyer_1,Luis,Garay,1996-08-10,20670070Q,luis.garay@awesomedata.io,449238,ES57209552411520511223,3831.73,2023-11-05T16:11:16,Bilbao,expenses,phone,-51.96,-39114.83
buyer_1,Luis,Garay,1996-08-10,20670070Q,luis.garay@awesomedata.io,449238,ES57209552411520511223,3831.73,2023-11-05T20:31:21,Bilbao,expenses,repairs,-255.94,-39370.77
buyer_1,Luis,Garay,1996-08-10,20670070Q,luis.garay@awesomedata.io,449238,ES57209552411520511223,3831.73,2023-11-06T14:43:49,Bilbao,expenses,water,-32.66,-39403.43
buyer_1,Luis,Garay,1996-08-10,20670070Q,luis.garay@awesomedata.io,449238,ES57209552411520511223,3831.73,2023-11-06T16:04:03,Bilbao,expenses,internet,-56.93,-39460.36
buyer_1,Luis,Garay,1996-08-10,20670070Q,luis.garay@awesomedata.io,449238,ES57209552411520511223,3831.73,2023-11-06T12:01:37,Bilbao,expenses,phone,-57.62,-39517.98
buyer_1,Luis,Garay,1996-08-10,20670070Q,luis.garay@awesomedata.io,449238,ES57209552411520511223,3831.73,2023-11-06T17:59:10,Bilbao,expenses,transport,-65.28,-39583.26
buyer_1,Luis,Garay,1996-08-10,20670070Q,luis.garay@awesomedata.io,449238,ES57209552411520511223,3831.73,2023-11-07T10:44:32,Bilbao,expenses,gas,-86.81,-39670.07
buyer_1,Luis,Garay,1996-08-10,20670070Q,luis.garay@awesomedata.io,449238,ES57209552411520511223,3831.73,2023-11-07T10:21:00,Bilbao,expenses,internet,-56.93,-39727.0
buyer_1,Luis,Garay,1996-08-10,20670070Q,luis.garay@awesomedata.io,449238,ES57209552411520511223,3831.73,2023-11-07T11:20:08,Bilbao,expenses,food,-97.73,-39824.73
buyer_1,Luis,Garay,1996-08-10,20670070Q,luis.garay@awesomedata.io,449238,ES57209552411520511223,3831.73,2023-11-07T09:12:35,Bilbao,expenses,cash,-100.0,-39924.73
buyer_1,Luis,Garay,1996-08-10,20670070Q,luis.garay@awesomedata.io,449238,ES57209552411520511223,3831.73,2023-11-08T14:35:40,Bilbao,expenses,electricity,-94.16,-40018.89
buyer_1,Luis,Garay,1996-08-10,20670070Q,luis.garay@awesomedata.io,449238,ES57209552411520511223,3831.73,2023-11-08T15:01:03,Bilbao,expenses,internet,-56.93,-40075.82
buyer_1,Luis,Garay,1996-08-10,20670070Q,luis.garay@awesomedata.io,449238,ES57209552411520511223,3831.73,2023-11-10T05:23:56,Bilbao,expenses,food,-78.43,-40154.25
buyer_1,Luis,Garay,1996-08-10,20670070Q,luis.garay@awesomedata.io,449238,ES57209552411520511223,3831.73,2023-11-11T02:46:46,Bilbao,expenses,gifts,-136.29,-40290.54
buyer_1,Luis,Garay,1996-08-10,20670070Q,luis.garay@awesomedata.io,449238,ES57209552411520511223,3831.73,2023-11-12T20:08:17,Bilbao,expenses,leisure,-47.71,-40338.25
buyer_1,Luis,Garay,1996-08-10,20670070Q,luis.garay@awesomedata.io,449238,ES57209552411520511223,3831.73,2023-11-13T09:02:28,Bilbao,expenses,cash,-100.0,-40438.25
buyer_1,Luis,Garay,1996-08-10,20670070Q,luis.garay@awesomedata.io,449238,ES57209552411520511223,3831.73,2023-11-13T11:20:50,Bilbao,expenses,appliances,-306.15,-40744.4
buyer_1,Luis,Garay,1996-08-10,20670070Q,luis.garay@awesomedata.io,449238,ES57209552411520511223,3831.73,2023-11-15T18:37:42,Bilbao,expenses,food,-76.59,-40820.99
buyer_1,Luis,Garay,1996-08-10,20670070Q,luis.garay@awesomedata.io,449238,ES57209552411520511223,3831.73,2023-11-19T20:55:06,Bilbao,expenses,food,-94.83,-40915.82
buyer_1,Luis,Garay,1996-08-10,20670070Q,luis.garay@awesomedata.io,449238,ES57209552411520511223,3831.73,2023-11-19T14:25:02,Bilbao,expenses,gifts,-224.64,-41140.46
buyer_1,Luis,Garay,1996-08-10,20670070Q,luis.garay@awesomedata.io,449238,ES57209552411520511223,3831.73,2023-11-20T18:16:55,Bilbao,expenses,clothing,-83.75,-41224.21
buyer_1,Luis,Garay,1996-08-10,20670070Q,luis.garay@awesomedata.io,449238,ES57209552411520511223,3831.73,2023-11-22T11:30:33,Bilbao,expenses,leisure,-64.92,-41289.13
buyer_1,Luis,Garay,1996-08-10,20670070Q,luis.garay@awesomedata.io,449238,ES57209552411520511223,3831.73,2023-11-24T06:47:35,Bilbao,expenses,education,-42.06,-41331.19
buyer_1,Luis,Garay,1996-08-10,20670070Q,luis.garay@awesomedata.io,449238,ES57209552411520511223,3831.73,2023-11-26T08:56:39,Bilbao,expenses,food,-98.9,-41430.09
buyer_1,Luis,Garay,1996-08-10,20670070Q,luis.garay@awesomedata.io,449238,ES57209552411520511223,3831.73,2023-11-26T18:46:55,Bilbao,expenses,cash,-100.0,-41530.09
buyer_1,Luis,Garay,1996-08-10,20670070Q,luis.garay@awesomedata.io,449238,ES57209552411520511223,3831.73,2023-11-26T22:14:37,Bilbao,expenses,gifts,-201.58,-41731.67
buyer_1,Luis,Garay,1996-08-10,20670070Q,luis.garay@awesomedata.io,449238,ES57209552411520511223,3831.73,2023-11-28T10:50:57,Bilbao,expenses,clothing,-103.42,-41835.09
buyer_1,Luis,Garay,1996-08-10,20670070Q,luis.garay@awesomedata.io,449238,ES57209552411520511223,3831.73,2023-11-29T20:10:10,Bilbao,expenses,cash,-100.0,-41935.09
buyer_1,Luis,Garay,1996-08-10,20670070Q,luis.garay@awesomedata.io,449238,ES57209552411520511223,3831.73,2023-11-30T08:47:27,Bilbao,expenses,cash,-100.0,-42035.09
buyer_1,Luis,Garay,1996-08-10,20670070Q,luis.garay@awesomedata.io,449238,ES57209552411520511223,3831.73,2023-11-30T10:30:07,Bilbao,expenses,gifts,-787.32,-42822.41
buyer_1,Luis,Garay,1996-08-10,20670070Q,luis.garay@awesomedata.io,449238,ES57209552411520511223,3831.73,2023-12-01T14:31:37,Bilbao,incomes,salary,2711.02,-40111.39
buyer_1,Luis,Garay,1996-08-10,20670070Q,luis.garay@awesomedata.io,449238,ES57209552411520511223,3831.73,2023-12-01T14:31:37,Bilbao,incomes,extra_income,264.61,-39846.78
buyer_1,Luis,Garay,1996-08-10,20670070Q,luis.garay@awesomedata.io,449238,ES57209552411520511223,3831.73,2023-12-01T14:31:37,Bilbao,incomes,salary_bonus,2039.86,-37806.92
buyer_1,Luis,Garay,1996-08-10,20670070Q,luis.garay@awesomedata.io,449238,ES57209552411520511223,3831.73,2023-12-01T13:43:31,Bilbao,expenses,food,-104.17,-37911.09
buyer_1,Luis,Garay,1996-08-10,20670070Q,luis.garay@awesomedata.io,449238,ES57209552411520511223,3831.73,2023-12-01T11:57:28,Bilbao,expenses,leisure,-66.52,-37977.61
buyer_1,Luis,Garay,1996-08-10,20670070Q,luis.garay@awesomedata.io,449238,ES57209552411520511223,3831.73,2023-12-01T13:13:42,Bilbao,expenses,cash,-100.0,-38077.61
buyer_1,Luis,Garay,1996-08-10,20670070Q,luis.garay@awesomedata.io,449238,ES57209552411520511223,3831.73,2023-12-02T09:43:29,Bilbao,expenses,leisure,-39.5,-38117.11
buyer_1,Luis,Garay,1996-08-10,20670070Q,luis.garay@awesomedata.io,449238,ES57209552411520511223,3831.73,2023-12-04T23:18:50,Bilbao,expenses,rent,-997.88,-39114.99
buyer_1,Luis,Garay,1996-08-10,20670070Q,luis.garay@awesomedata.io,449238,ES57209552411520511223,3831.73,2023-12-04T17:55:32,Bilbao,expenses,food,-119.81,-39234.8
buyer_1,Luis,Garay,1996-08-10,20670070Q,luis.garay@awesomedata.io,449238,ES57209552411520511223,3831.73,2023-12-05T15:55:10,Bilbao,expenses,gas,-111.5,-39346.3
buyer_1,Luis,Garay,1996-08-10,20670070Q,luis.garay@awesomedata.io,449238,ES57209552411520511223,3831.73,2023-12-06T08:58:23,Bilbao,expenses,transport,-77.66,-39423.96
buyer_1,Luis,Garay,1996-08-10,20670070Q,luis.garay@awesomedata.io,449238,ES57209552411520511223,3831.73,2023-12-06T20:16:57,Bilbao,expenses,cash,-100.0,-39523.96
buyer_1,Luis,Garay,1996-08-10,20670070Q,luis.garay@awesomedata.io,449238,ES57209552411520511223,3831.73,2023-12-06T12:07:56,Bilbao,expenses,appliances,-289.39,-39813.35
buyer_1,Luis,Garay,1996-08-10,20670070Q,luis.garay@awesomedata.io,449238,ES57209552411520511223,3831.73,2023-12-06T19:32:25,Bilbao,expenses,repairs,-83.63,-39896.98
buyer_1,Luis,Garay,1996-08-10,20670070Q,luis.garay@awesomedata.io,449238,ES57209552411520511223,3831.73,2023-12-08T09:41:36,Bilbao,expenses,internet,-56.93,-39953.91
buyer_1,Luis,Garay,1996-08-10,20670070Q,luis.garay@awesomedata.io,449238,ES57209552411520511223,3831.73,2023-12-08T07:30:52,Bilbao,expenses,cash,-100.0,-40053.91
buyer_1,Luis,Garay,1996-08-10,20670070Q,luis.garay@awesomedata.io,449238,ES57209552411520511223,3831.73,2023-12-10T13:38:03,Bilbao,expenses,cash,-100.0,-40153.91
buyer_1,Luis,Garay,1996-08-10,20670070Q,luis.garay@awesomedata.io,449238,ES57209552411520511223,3831.73,2023-12-12T20:02:05,Bilbao,expenses,food,-116.03,-40269.94
buyer_1,Luis,Garay,1996-08-10,20670070Q,luis.garay@awesomedata.io,449238,ES57209552411520511223,3831.73,2023-12-13T15:42:11,Bilbao,expenses,leisure,-41.12,-40311.06
buyer_1,Luis,Garay,1996-08-10,20670070Q,luis.garay@awesomedata.io,449238,ES57209552411520511223,3831.73,2023-12-14T15:02:34,Bilbao,expenses,leisure,-20.03,-40331.09
buyer_1,Luis,Garay,1996-08-10,20670070Q,luis.garay@awesomedata.io,449238,ES57209552411520511223,3831.73,2023-12-16T14:13:02,Bilbao,expenses,food,-66.07,-40397.16
buyer_1,Luis,Garay,1996-08-10,20670070Q,luis.garay@awesomedata.io,449238,ES57209552411520511223,3831.73,2023-12-16T20:47:18,Bilbao,expenses,cash,-100.0,-40497.16
buyer_1,Luis,Garay,1996-08-10,20670070Q,luis.garay@awesomedata.io,449238,ES57209552411520511223,3831.73,2023-12-17T08:00:26,Bilbao,expenses,food,-92.67,-40589.83
buyer_1,Luis,Garay,1996-08-10,20670070Q,luis.garay@awesomedata.io,449238,ES57209552411520511223,3831.73,2023-12-17T03:36:27,Bilbao,expenses,car,-196.59,-40786.42
buyer_1,Luis,Garay,1996-08-10,20670070Q,luis.garay@awesomedata.io,449238,ES57209552411520511223,3831.73,2023-12-18T11:00:45,Bilbao,expenses,food,-98.88,-40885.3
buyer_1,Luis,Garay,1996-08-10,20670070Q,luis.garay@awesomedata.io,449238,ES57209552411520511223,3831.73,2023-12-18T15:42:06,Bilbao,expenses,repairs,-32.53,-40917.83
buyer_1,Luis,Garay,1996-08-10,20670070Q,luis.garay@awesomedata.io,449238,ES57209552411520511223,3831.73,2023-12-18T17:48:47,Bilbao,expenses,gifts,-498.9,-41416.73
buyer_1,Luis,Garay,1996-08-10,20670070Q,luis.garay@awesomedata.io,449238,ES57209552411520511223,3831.73,2023-12-19T08:58:11,Bilbao,expenses,food,-85.07,-41501.8
buyer_1,Luis,Garay,1996-08-10,20670070Q,luis.garay@awesomedata.io,449238,ES57209552411520511223,3831.73,2023-12-22T09:46:13,Bilbao,expenses,food,-76.67,-41578.47
buyer_1,Luis,Garay,1996-08-10,20670070Q,luis.garay@awesomedata.io,449238,ES57209552411520511223,3831.73,2023-12-22T06:29:17,Bilbao,expenses,leisure,-50.95,-41629.42
buyer_1,Luis,Garay,1996-08-10,20670070Q,luis.garay@awesomedata.io,449238,ES57209552411520511223,3831.73,2023-12-23T09:03:37,Bilbao,expenses,travel,-807.64,-42437.06
buyer_1,Luis,Garay,1996-08-10,20670070Q,luis.garay@awesomedata.io,449238,ES57209552411520511223,3831.73,2023-12-24T08:25:39,Bilbao,expenses,food,-70.86,-42507.92
buyer_1,Luis,Garay,1996-08-10,20670070Q,luis.garay@awesomedata.io,449238,ES57209552411520511223,3831.73,2023-12-24T14:59:11,Bilbao,expenses,leisure,-44.24,-42552.16
buyer_1,Luis,Garay,1996-08-10,20670070Q,luis.garay@awesomedata.io,449238,ES57209552411520511223,3831.73,2023-12-25T10:57:17,Bilbao,expenses,transport,-52.35,-42604.51
buyer_1,Luis,Garay,1996-08-10,20670070Q,luis.garay@awesomedata.io,449238,ES57209552411520511223,3831.73,2023-12-27T19:33:17,Bilbao,expenses,food,-95.2,-42699.71
buyer_1,Luis,Garay,1996-08-10,20670070Q,luis.garay@awesomedata.io,449238,ES57209552411520511223,3831.73,2023-12-27T04:52:57,Bilbao,expenses,repairs,-121.5,-42821.21
buyer_1,Luis,Garay,1996-08-10,20670070Q,luis.garay@awesomedata.io,449238,ES57209552411520511223,3831.73,2023-12-29T21:28:10,Bilbao,expenses,leisure,-18.8,-42840.01
buyer_1,Luis,Garay,1996-08-10,20670070Q,luis.garay@awesomedata.io,449238,ES57209552411520511223,3831.73,2024-01-01T16:01:14,Bilbao,incomes,salary,2777.32,-40062.69
buyer_1,Luis,Garay,1996-08-10,20670070Q,luis.garay@awesomedata.io,449238,ES57209552411520511223,3831.73,2024-01-01T13:46:34,Bilbao,expenses,repairs,-220.84,-40283.53
buyer_1,Luis,Garay,1996-08-10,20670070Q,luis.garay@awesomedata.io,449238,ES57209552411520511223,3831.73,2024-01-03T18:50:39,Bilbao,expenses,food,-110.47,-40394.0
buyer_1,Luis,Garay,1996-08-10,20670070Q,luis.garay@awesomedata.io,449238,ES57209552411520511223,3831.73,2024-01-03T16:13:36,Bilbao,expenses,clothing,-80.82,-40474.82
buyer_1,Luis,Garay,1996-08-10,20670070Q,luis.garay@awesomedata.io,449238,ES57209552411520511223,3831.73,2024-01-04T23:14:54,Bilbao,expenses,rent,-900.12,-41374.94
buyer_1,Luis,Garay,1996-08-10,20670070Q,luis.garay@awesomedata.io,449238,ES57209552411520511223,3831.73,2024-01-04T20:35:21,Bilbao,expenses,clothing,-95.64,-41470.58
buyer_1,Luis,Garay,1996-08-10,20670070Q,luis.garay@awesomedata.io,449238,ES57209552411520511223,3831.73,2024-01-04T15:54:14,Bilbao,expenses,cash,-100.0,-41570.58
buyer_1,Luis,Garay,1996-08-10,20670070Q,luis.garay@awesomedata.io,449238,ES57209552411520511223,3831.73,2024-01-05T08:50:30,Bilbao,expenses,electricity,-28.76,-41599.34
buyer_1,Luis,Garay,1996-08-10,20670070Q,luis.garay@awesomedata.io,449238,ES57209552411520511223,3831.73,2024-01-05T14:31:35,Bilbao,expenses,gas,-128.39,-41727.73
buyer_1,Luis,Garay,1996-08-10,20670070Q,luis.garay@awesomedata.io,449238,ES57209552411520511223,3831.73,2024-01-05T00:42:00,Bilbao,expenses,transport,-56.49,-41784.22
buyer_1,Luis,Garay,1996-08-10,20670070Q,luis.garay@awesomedata.io,449238,ES57209552411520511223,3831.73,2024-01-05T15:41:56,Bilbao,expenses,leisure,-76.55,-41860.77
buyer_1,Luis,Garay,1996-08-10,20670070Q,luis.garay@awesomedata.io,449238,ES57209552411520511223,3831.73,2024-01-05T21:13:33,Bilbao,expenses,cash,-100.0,-41960.77
buyer_1,Luis,Garay,1996-08-10,20670070Q,luis.garay@awesomedata.io,449238,ES57209552411520511223,3831.73,2024-01-06T16:17:31,Bilbao,expenses,water,-43.23,-42004.0
buyer_1,Luis,Garay,1996-08-10,20670070Q,luis.garay@awesomedata.io,449238,ES57209552411520511223,3831.73,2024-01-06T20:03:14,Bilbao,expenses,electricity,-51.99,-42055.99
buyer_1,Luis,Garay,1996-08-10,20670070Q,luis.garay@awesomedata.io,449238,ES57209552411520511223,3831.73,2024-01-06T23:16:14,Bilbao,expenses,cash,-100.0,-42155.99
buyer_1,Luis,Garay,1996-08-10,20670070Q,luis.garay@awesomedata.io,449238,ES57209552411520511223,3831.73,2024-01-07T03:22:37,Bilbao,expenses,electricity,-109.58,-42265.57
buyer_1,Luis,Garay,1996-08-10,20670070Q,luis.garay@awesomedata.io,449238,ES57209552411520511223,3831.73,2024-01-07T10:09:27,Bilbao,expenses,phone,-62.23,-42327.8
buyer_1,Luis,Garay,1996-08-10,20670070Q,luis.garay@awesomedata.io,449238,ES57209552411520511223,3831.73,2024-01-08T14:55:29,Bilbao,expenses,electricity,-76.41,-42404.21
buyer_1,Luis,Garay,1996-08-10,20670070Q,luis.garay@awesomedata.io,449238,ES57209552411520511223,3831.73,2024-01-08T18:36:06,Bilbao,expenses,gas,-118.9,-42523.11
buyer_1,Luis,Garay,1996-08-10,20670070Q,luis.garay@awesomedata.io,449238,ES57209552411520511223,3831.73,2024-01-08T15:24:21,Bilbao,expenses,internet,-58.32,-42581.43
buyer_1,Luis,Garay,1996-08-10,20670070Q,luis.garay@awesomedata.io,449238,ES57209552411520511223,3831.73,2024-01-12T10:00:18,Bilbao,expenses,transport,-44.8,-42626.23
buyer_1,Luis,Garay,1996-08-10,20670070Q,luis.garay@awesomedata.io,449238,ES57209552411520511223,3831.73,2024-01-13T14:18:02,Bilbao,expenses,transport,-87.11,-42713.34
buyer_1,Luis,Garay,1996-08-10,20670070Q,luis.garay@awesomedata.io,449238,ES57209552411520511223,3831.73,2024-01-13T02:06:51,Bilbao,expenses,cash,-100.0,-42813.34
buyer_1,Luis,Garay,1996-08-10,20670070Q,luis.garay@awesomedata.io,449238,ES57209552411520511223,3831.73,2024-01-15T19:30:34,Bilbao,expenses,food,-84.97,-42898.31
buyer_1,Luis,Garay,1996-08-10,20670070Q,luis.garay@awesomedata.io,449238,ES57209552411520511223,3831.73,2024-01-16T11:06:25,Bilbao,expenses,food,-70.58,-42968.89
buyer_1,Luis,Garay,1996-08-10,20670070Q,luis.garay@awesomedata.io,449238,ES57209552411520511223,3831.73,2024-01-16T20:49:06,Bilbao,expenses,leisure,-20.26,-42989.15
buyer_1,Luis,Garay,1996-08-10,20670070Q,luis.garay@awesomedata.io,449238,ES57209552411520511223,3831.73,2024-01-18T11:04:55,Bilbao,expenses,cash,-100.0,-43089.15
buyer_1,Luis,Garay,1996-08-10,20670070Q,luis.garay@awesomedata.io,449238,ES57209552411520511223,3831.73,2024-01-20T20:14:02,Bilbao,expenses,gifts,-396.25,-43485.4
buyer_1,Luis,Garay,1996-08-10,20670070Q,luis.garay@awesomedata.io,449238,ES57209552411520511223,3831.73,2024-01-21T09:45:27,Bilbao,expenses,food,-110.3,-43595.7
buyer_1,Luis,Garay,1996-08-10,20670070Q,luis.garay@awesomedata.io,449238,ES57209552411520511223,3831.73,2024-01-21T16:39:21,Bilbao,expenses,transport,-44.62,-43640.32
buyer_1,Luis,Garay,1996-08-10,20670070Q,luis.garay@awesomedata.io,449238,ES57209552411520511223,3831.73,2024-01-22T09:01:56,Bilbao,expenses,food,-112.27,-43752.59
buyer_1,Luis,Garay,1996-08-10,20670070Q,luis.garay@awesomedata.io,449238,ES57209552411520511223,3831.73,2024-01-22T15:35:04,Bilbao,expenses,transport,-87.42,-43840.01
buyer_1,Luis,Garay,1996-08-10,20670070Q,luis.garay@awesomedata.io,449238,ES57209552411520511223,3831.73,2024-01-23T14:40:50,Bilbao,expenses,food,-72.62,-43912.63
buyer_1,Luis,Garay,1996-08-10,20670070Q,luis.garay@awesomedata.io,449238,ES57209552411520511223,3831.73,2024-01-26T13:34:14,Bilbao,expenses,appliances,-129.03,-44041.66
buyer_1,Luis,Garay,1996-08-10,20670070Q,luis.garay@awesomedata.io,449238,ES57209552411520511223,3831.73,2024-01-27T07:23:18,Bilbao,expenses,travel,-327.07,-44368.73
buyer_1,Luis,Garay,1996-08-10,20670070Q,luis.garay@awesomedata.io,449238,ES57209552411520511223,3831.73,2024-01-29T11:35:47,Bilbao,expenses,cash,-100.0,-44468.73
buyer_1,Luis,Garay,1996-08-10,20670070Q,luis.garay@awesomedata.io,449238,ES57209552411520511223,3831.73,2024-01-29T11:03:12,Bilbao,expenses,gifts,-177.6,-44646.33
buyer_1,Luis,Garay,1996-08-10,20670070Q,luis.garay@awesomedata.io,449238,ES57209552411520511223,3831.73,2024-01-30T11:06:58,Bilbao,expenses,repairs,-188.9,-44835.23
buyer_1,Luis,Garay,1996-08-10,20670070Q,luis.garay@awesomedata.io,449238,ES57209552411520511223,3831.73,2024-02-01T12:04:34,Bilbao,incomes,salary,2777.32,-42057.91
buyer_1,Luis,Garay,1996-08-10,20670070Q,luis.garay@awesomedata.io,449238,ES57209552411520511223,3831.73,2024-02-01T16:16:24,Bilbao,expenses,clothing,-124.77,-42182.68
buyer_1,Luis,Garay,1996-08-10,20670070Q,luis.garay@awesomedata.io,449238,ES57209552411520511223,3831.73,2024-02-04T18:27:32,Bilbao,expenses,rent,-900.12,-43082.8
buyer_1,Luis,Garay,1996-08-10,20670070Q,luis.garay@awesomedata.io,449238,ES57209552411520511223,3831.73,2024-02-04T08:42:15,Bilbao,expenses,transport,-50.36,-43133.16
buyer_1,Luis,Garay,1996-08-10,20670070Q,luis.garay@awesomedata.io,449238,ES57209552411520511223,3831.73,2024-02-04T11:15:19,Bilbao,expenses,clothing,-90.76,-43223.92
buyer_1,Luis,Garay,1996-08-10,20670070Q,luis.garay@awesomedata.io,449238,ES57209552411520511223,3831.73,2024-02-06T10:04:43,Bilbao,expenses,electricity,-106.49,-43330.41
buyer_1,Luis,Garay,1996-08-10,20670070Q,luis.garay@awesomedata.io,449238,ES57209552411520511223,3831.73,2024-02-06T16:24:46,Bilbao,expenses,gas,-97.81,-43428.22
buyer_1,Luis,Garay,1996-08-10,20670070Q,luis.garay@awesomedata.io,449238,ES57209552411520511223,3831.73,2024-02-06T08:06:39,Bilbao,expenses,transport,-74.34,-43502.56
buyer_1,Luis,Garay,1996-08-10,20670070Q,luis.garay@awesomedata.io,449238,ES57209552411520511223,3831.73,2024-02-06T20:18:39,Bilbao,expenses,healthcare,-116.45,-43619.01
buyer_1,Luis,Garay,1996-08-10,20670070Q,luis.garay@awesomedata.io,449238,ES57209552411520511223,3831.73,2024-02-07T16:33:46,Bilbao,expenses,gas,-107.27,-43726.28
buyer_1,Luis,Garay,1996-08-10,20670070Q,luis.garay@awesomedata.io,449238,ES57209552411520511223,3831.73,2024-02-07T01:37:09,Bilbao,expenses,cash,-100.0,-43826.28
buyer_1,Luis,Garay,1996-08-10,20670070Q,luis.garay@awesomedata.io,449238,ES57209552411520511223,3831.73,2024-02-08T15:43:22,Bilbao,expenses,gas,-76.29,-43902.57
buyer_1,Luis,Garay,1996-08-10,20670070Q,luis.garay@awesomedata.io,449238,ES57209552411520511223,3831.73,2024-02-08T21:37:29,Bilbao,expenses,phone,-45.89,-43948.46
buyer_1,Luis,Garay,1996-08-10,20670070Q,luis.garay@awesomedata.io,449238,ES57209552411520511223,3831.73,2024-02-08T22:20:48,Bilbao,expenses,leisure,-26.97,-43975.43
buyer_1,Luis,Garay,1996-08-10,20670070Q,luis.garay@awesomedata.io,449238,ES57209552411520511223,3831.73,2024-02-09T20:18:35,Bilbao,expenses,leisure,-78.47,-44053.9
buyer_1,Luis,Garay,1996-08-10,20670070Q,luis.garay@awesomedata.io,449238,ES57209552411520511223,3831.73,2024-02-10T12:59:21,Bilbao,expenses,leisure,-68.27,-44122.17
buyer_1,Luis,Garay,1996-08-10,20670070Q,luis.garay@awesomedata.io,449238,ES57209552411520511223,3831.73,2024-02-13T05:42:36,Bilbao,expenses,appliances,-186.77,-44308.94
buyer_1,Luis,Garay,1996-08-10,20670070Q,luis.garay@awesomedata.io,449238,ES57209552411520511223,3831.73,2024-02-16T09:42:54,Bilbao,expenses,cash,-100.0,-44408.94
buyer_1,Luis,Garay,1996-08-10,20670070Q,luis.garay@awesomedata.io,449238,ES57209552411520511223,3831.73,2024-02-17T08:32:11,Bilbao,expenses,food,-98.88,-44507.82
buyer_1,Luis,Garay,1996-08-10,20670070Q,luis.garay@awesomedata.io,449238,ES57209552411520511223,3831.73,2024-02-18T19:49:52,Bilbao,expenses,transport,-55.19,-44563.01
buyer_1,Luis,Garay,1996-08-10,20670070Q,luis.garay@awesomedata.io,449238,ES57209552411520511223,3831.73,2024-02-22T08:48:44,Bilbao,expenses,education,-43.81,-44606.82
buyer_1,Luis,Garay,1996-08-10,20670070Q,luis.garay@awesomedata.io,449238,ES57209552411520511223,3831.73,2024-02-22T20:26:14,Bilbao,expenses,repairs,-145.78,-44752.6
buyer_1,Luis,Garay,1996-08-10,20670070Q,luis.garay@awesomedata.io,449238,ES57209552411520511223,3831.73,2024-02-24T10:32:16,Bilbao,expenses,healthcare,-158.09,-44910.69
buyer_1,Luis,Garay,1996-08-10,20670070Q,luis.garay@awesomedata.io,449238,ES57209552411520511223,3831.73,2024-02-24T22:33:53,Bilbao,expenses,travel,-296.26,-45206.95
buyer_1,Luis,Garay,1996-08-10,20670070Q,luis.garay@awesomedata.io,449238,ES57209552411520511223,3831.73,2024-02-25T17:19:30,Bilbao,expenses,healthcare,-52.94,-45259.89
buyer_1,Luis,Garay,1996-08-10,20670070Q,luis.garay@awesomedata.io,449238,ES57209552411520511223,3831.73,2024-02-25T19:28:55,Bilbao,expenses,cash,-100.0,-45359.89
buyer_1,Luis,Garay,1996-08-10,20670070Q,luis.garay@awesomedata.io,449238,ES57209552411520511223,3831.73,2024-02-26T08:51:54,Bilbao,expenses,transport,-48.0,-45407.89
buyer_1,Luis,Garay,1996-08-10,20670070Q,luis.garay@awesomedata.io,449238,ES57209552411520511223,3831.73,2024-02-26T15:40:42,Bilbao,expenses,gifts,-720.85,-46128.74
buyer_1,Luis,Garay,1996-08-10,20670070Q,luis.garay@awesomedata.io,449238,ES57209552411520511223,3831.73,2024-03-01T08:41:45,Bilbao,incomes,salary,2777.32,-43351.42
buyer_1,Luis,Garay,1996-08-10,20670070Q,luis.garay@awesomedata.io,449238,ES57209552411520511223,3831.73,2024-03-04T18:30:39,Bilbao,expenses,rent,-900.12,-44251.54
buyer_1,Luis,Garay,1996-08-10,20670070Q,luis.garay@awesomedata.io,449238,ES57209552411520511223,3831.73,2024-03-05T11:58:36,Bilbao,expenses,electricity,-38.04,-44289.58
buyer_1,Luis,Garay,1996-08-10,20670070Q,luis.garay@awesomedata.io,449238,ES57209552411520511223,3831.73,2024-03-05T18:01:30,Bilbao,expenses,leisure,-74.76,-44364.34
buyer_1,Luis,Garay,1996-08-10,20670070Q,luis.garay@awesomedata.io,449238,ES57209552411520511223,3831.73,2024-03-05T16:45:43,Bilbao,expenses,cash,-100.0,-44464.34
buyer_1,Luis,Garay,1996-08-10,20670070Q,luis.garay@awesomedata.io,449238,ES57209552411520511223,3831.73,2024-03-06T23:34:39,Bilbao,expenses,water,-29.99,-44494.33
buyer_1,Luis,Garay,1996-08-10,20670070Q,luis.garay@awesomedata.io,449238,ES57209552411520511223,3831.73,2024-03-06T10:49:51,Bilbao,expenses,internet,-58.32,-44552.65
buyer_1,Luis,Garay,1996-08-10,20670070Q,luis.garay@awesomedata.io,449238,ES57209552411520511223,3831.73,2024-03-06T23:44:41,Bilbao,expenses,repairs,-225.21,-44777.86
buyer_1,Luis,Garay,1996-08-10,20670070Q,luis.garay@awesomedata.io,449238,ES57209552411520511223,3831.73,2024-03-07T18:10:19,Bilbao,expenses,electricity,-30.91,-44808.77
buyer_1,Luis,Garay,1996-08-10,20670070Q,luis.garay@awesomedata.io,449238,ES57209552411520511223,3831.73,2024-03-07T16:54:04,Bilbao,expenses,leisure,-80.08,-44888.85
buyer_1,Luis,Garay,1996-08-10,20670070Q,luis.garay@awesomedata.io,449238,ES57209552411520511223,3831.73,2024-03-07T11:56:28,Bilbao,expenses,cash,-100.0,-44988.85
buyer_1,Luis,Garay,1996-08-10,20670070Q,luis.garay@awesomedata.io,449238,ES57209552411520511223,3831.73,2024-03-08T18:12:45,Bilbao,expenses,electricity,-56.14,-45044.99
buyer_1,Luis,Garay,1996-08-10,20670070Q,luis.garay@awesomedata.io,449238,ES57209552411520511223,3831.73,2024-03-08T23:00:13,Bilbao,expenses,gas,-77.58,-45122.57
buyer_1,Luis,Garay,1996-08-10,20670070Q,luis.garay@awesomedata.io,449238,ES57209552411520511223,3831.73,2024-03-08T11:50:51,Bilbao,expenses,leisure,-27.73,-45150.3
buyer_1,Luis,Garay,1996-08-10,20670070Q,luis.garay@awesomedata.io,449238,ES57209552411520511223,3831.73,2024-03-09T19:27:42,Bilbao,expenses,food,-78.14,-45228.44
buyer_1,Luis,Garay,1996-08-10,20670070Q,luis.garay@awesomedata.io,449238,ES57209552411520511223,3831.73,2024-03-09T16:24:16,Bilbao,expenses,transport,-47.83,-45276.27
buyer_1,Luis,Garay,1996-08-10,20670070Q,luis.garay@awesomedata.io,449238,ES57209552411520511223,3831.73,2024-03-10T00:42:55,Bilbao,expenses,food,-74.24,-45350.51
buyer_1,Luis,Garay,1996-08-10,20670070Q,luis.garay@awesomedata.io,449238,ES57209552411520511223,3831.73,2024-03-11T16:36:33,Bilbao,expenses,leisure,-37.65,-45388.16
buyer_1,Luis,Garay,1996-08-10,20670070Q,luis.garay@awesomedata.io,449238,ES57209552411520511223,3831.73,2024-03-12T18:45:51,Bilbao,expenses,healthcare,-132.62,-45520.78
buyer_1,Luis,Garay,1996-08-10,20670070Q,luis.garay@awesomedata.io,449238,ES57209552411520511223,3831.73,2024-03-15T13:50:42,Bilbao,expenses,repairs,-270.64,-45791.42
buyer_1,Luis,Garay,1996-08-10,20670070Q,luis.garay@awesomedata.io,449238,ES57209552411520511223,3831.73,2024-03-16T19:02:14,Bilbao,expenses,cash,-100.0,-45891.42
buyer_1,Luis,Garay,1996-08-10,20670070Q,luis.garay@awesomedata.io,449238,ES57209552411520511223,3831.73,2024-03-16T17:01:13,Bilbao,expenses,gifts,-600.95,-46492.37
buyer_1,Luis,Garay,1996-08-10,20670070Q,luis.garay@awesomedata.io,449238,ES57209552411520511223,3831.73,2024-03-17T09:30:26,Bilbao,expenses,transport,-59.47,-46551.84
buyer_1,Luis,Garay,1996-08-10,20670070Q,luis.garay@awesomedata.io,449238,ES57209552411520511223,3831.73,2024-03-18T14:57:44,Bilbao,expenses,appliances,-111.72,-46663.56
buyer_1,Luis,Garay,1996-08-10,20670070Q,luis.garay@awesomedata.io,449238,ES57209552411520511223,3831.73,2024-03-19T17:23:19,Bilbao,expenses,transport,-51.77,-46715.33
buyer_1,Luis,Garay,1996-08-10,20670070Q,luis.garay@awesomedata.io,449238,ES57209552411520511223,3831.73,2024-03-20T11:06:29,Bilbao,expenses,repairs,-310.22,-47025.55
buyer_1,Luis,Garay,1996-08-10,20670070Q,luis.garay@awesomedata.io,449238,ES57209552411520511223,3831.73,2024-03-21T08:57:55,Bilbao,expenses,food,-103.2,-47128.75
buyer_1,Luis,Garay,1996-08-10,20670070Q,luis.garay@awesomedata.io,449238,ES57209552411520511223,3831.73,2024-03-23T06:27:25,Bilbao,expenses,transport,-50.74,-47179.49
buyer_1,Luis,Garay,1996-08-10,20670070Q,luis.garay@awesomedata.io,449238,ES57209552411520511223,3831.73,2024-03-25T08:00:20,Bilbao,expenses,leisure,-21.46,-47200.95
buyer_1,Luis,Garay,1996-08-10,20670070Q,luis.garay@awesomedata.io,449238,ES57209552411520511223,3831.73,2024-03-28T04:38:04,Bilbao,expenses,leisure,-62.49,-47263.44
buyer_1,Luis,Garay,1996-08-10,20670070Q,luis.garay@awesomedata.io,449238,ES57209552411520511223,3831.73,2024-03-28T08:12:32,Bilbao,expenses,healthcare,-155.3,-47418.74
buyer_1,Luis,Garay,1996-08-10,20670070Q,luis.garay@awesomedata.io,449238,ES57209552411520511223,3831.73,2024-04-01T16:12:19,Bilbao,incomes,salary,2777.32,-44641.42
buyer_1,Luis,Garay,1996-08-10,20670070Q,luis.garay@awesomedata.io,449238,ES57209552411520511223,3831.73,2024-04-01T16:12:19,Bilbao,incomes,extra_income,264.61,-44376.81
buyer_1,Luis,Garay,1996-08-10,20670070Q,luis.garay@awesomedata.io,449238,ES57209552411520511223,3831.73,2024-04-02T14:30:07,Bilbao,expenses,cash,-100.0,-44476.81
buyer_1,Luis,Garay,1996-08-10,20670070Q,luis.garay@awesomedata.io,449238,ES57209552411520511223,3831.73,2024-04-03T20:07:44,Bilbao,expenses,food,-64.2,-44541.01
buyer_1,Luis,Garay,1996-08-10,20670070Q,luis.garay@awesomedata.io,449238,ES57209552411520511223,3831.73,2024-04-03T20:17:25,Bilbao,expenses,repairs,-78.53,-44619.54
buyer_1,Luis,Garay,1996-08-10,20670070Q,luis.garay@awesomedata.io,449238,ES57209552411520511223,3831.73,2024-04-04T19:19:00,Bilbao,expenses,rent,-900.12,-45519.66
buyer_1,Luis,Garay,1996-08-10,20670070Q,luis.garay@awesomedata.io,449238,ES57209552411520511223,3831.73,2024-04-04T14:19:22,Bilbao,expenses,leisure,-47.08,-45566.74
buyer_1,Luis,Garay,1996-08-10,20670070Q,luis.garay@awesomedata.io,449238,ES57209552411520511223,3831.73,2024-04-04T11:50:18,Bilbao,expenses,repairs,-125.31,-45692.05
buyer_1,Luis,Garay,1996-08-10,20670070Q,luis.garay@awesomedata.io,449238,ES57209552411520511223,3831.73,2024-04-05T09:40:01,Bilbao,expenses,water,-47.12,-45739.17
buyer_1,Luis,Garay,1996-08-10,20670070Q,luis.garay@awesomedata.io,449238,ES57209552411520511223,3831.73,2024-04-05T12:40:52,Bilbao,expenses,food,-86.71,-45825.88
buyer_1,Luis,Garay,1996-08-10,20670070Q,luis.garay@awesomedata.io,449238,ES57209552411520511223,3831.73,2024-04-05T19:38:56,Bilbao,expenses,leisure,-34.26,-45860.14
buyer_1,Luis,Garay,1996-08-10,20670070Q,luis.garay@awesomedata.io,449238,ES57209552411520511223,3831.73,2024-04-06T20:01:29,Bilbao,expenses,internet,-58.32,-45918.46
buyer_1,Luis,Garay,1996-08-10,20670070Q,luis.garay@awesomedata.io,449238,ES57209552411520511223,3831.73,2024-04-07T19:18:33,Bilbao,expenses,water,-36.68,-45955.14
buyer_1,Luis,Garay,1996-08-10,20670070Q,luis.garay@awesomedata.io,449238,ES57209552411520511223,3831.73,2024-04-07T16:31:11,Bilbao,expenses,education,-48.82,-46003.96
buyer_1,Luis,Garay,1996-08-10,20670070Q,luis.garay@awesomedata.io,449238,ES57209552411520511223,3831.73,2024-04-07T09:01:32,Bilbao,expenses,gifts,-712.28,-46716.24
buyer_1,Luis,Garay,1996-08-10,20670070Q,luis.garay@awesomedata.io,449238,ES57209552411520511223,3831.73,2024-04-08T08:22:51,Bilbao,expenses,gas,-53.35,-46769.59
buyer_1,Luis,Garay,1996-08-10,20670070Q,luis.garay@awesomedata.io,449238,ES57209552411520511223,3831.73,2024-04-08T09:23:01,Bilbao,expenses,internet,-58.32,-46827.91
buyer_1,Luis,Garay,1996-08-10,20670070Q,luis.garay@awesomedata.io,449238,ES57209552411520511223,3831.73,2024-04-08T09:13:45,Bilbao,expenses,phone,-56.31,-46884.22
buyer_1,Luis,Garay,1996-08-10,20670070Q,luis.garay@awesomedata.io,449238,ES57209552411520511223,3831.73,2024-04-10T09:19:29,Bilbao,expenses,food,-97.35,-46981.57
buyer_1,Luis,Garay,1996-08-10,20670070Q,luis.garay@awesomedata.io,449238,ES57209552411520511223,3831.73,2024-04-11T19:24:16,Bilbao,expenses,leisure,-33.39,-47014.96
buyer_1,Luis,Garay,1996-08-10,20670070Q,luis.garay@awesomedata.io,449238,ES57209552411520511223,3831.73,2024-04-12T23:07:12,Bilbao,expenses,transport,-75.36,-47090.32
buyer_1,Luis,Garay,1996-08-10,20670070Q,luis.garay@awesomedata.io,449238,ES57209552411520511223,3831.73,2024-04-12T17:27:33,Bilbao,expenses,leisure,-29.53,-47119.85
buyer_1,Luis,Garay,1996-08-10,20670070Q,luis.garay@awesomedata.io,449238,ES57209552411520511223,3831.73,2024-04-12T19:28:11,Bilbao,expenses,clothing,-107.58,-47227.43
buyer_1,Luis,Garay,1996-08-10,20670070Q,luis.garay@awesomedata.io,449238,ES57209552411520511223,3831.73,2024-04-13T20:06:07,Bilbao,expenses,food,-105.09,-47332.52
buyer_1,Luis,Garay,1996-08-10,20670070Q,luis.garay@awesomedata.io,449238,ES57209552411520511223,3831.73,2024-04-13T18:15:22,Bilbao,expenses,repairs,-173.84,-47506.36
buyer_1,Luis,Garay,1996-08-10,20670070Q,luis.garay@awesomedata.io,449238,ES57209552411520511223,3831.73,2024-04-14T20:41:06,Bilbao,expenses,food,-114.13,-47620.49
buyer_1,Luis,Garay,1996-08-10,20670070Q,luis.garay@awesomedata.io,449238,ES57209552411520511223,3831.73,2024-04-14T10:32:57,Bilbao,expenses,transport,-57.39,-47677.88
buyer_1,Luis,Garay,1996-08-10,20670070Q,luis.garay@awesomedata.io,449238,ES57209552411520511223,3831.73,2024-04-14T14:20:49,Bilbao,expenses,repairs,-227.91,-47905.79
buyer_1,Luis,Garay,1996-08-10,20670070Q,luis.garay@awesomedata.io,449238,ES57209552411520511223,3831.73,2024-04-16T20:05:25,Bilbao,expenses,cash,-100.0,-48005.79
buyer_1,Luis,Garay,1996-08-10,20670070Q,luis.garay@awesomedata.io,449238,ES57209552411520511223,3831.73,2024-04-17T12:08:38,Bilbao,expenses,transport,-53.0,-48058.79
buyer_1,Luis,Garay,1996-08-10,20670070Q,luis.garay@awesomedata.io,449238,ES57209552411520511223,3831.73,2024-04-20T19:50:08,Bilbao,expenses,food,-102.71,-48161.5
buyer_1,Luis,Garay,1996-08-10,20670070Q,luis.garay@awesomedata.io,449238,ES57209552411520511223,3831.73,2024-04-20T09:11:56,Bilbao,expenses,repairs,-54.59,-48216.09
buyer_1,Luis,Garay,1996-08-10,20670070Q,luis.garay@awesomedata.io,449238,ES57209552411520511223,3831.73,2024-04-21T11:52:57,Bilbao,expenses,repairs,-254.06,-48470.15
buyer_1,Luis,Garay,1996-08-10,20670070Q,luis.garay@awesomedata.io,449238,ES57209552411520511223,3831.73,2024-04-23T18:05:32,Bilbao,expenses,transport,-61.29,-48531.44
buyer_1,Luis,Garay,1996-08-10,20670070Q,luis.garay@awesomedata.io,449238,ES57209552411520511223,3831.73,2024-04-23T20:30:22,Bilbao,expenses,leisure,-70.12,-48601.56
buyer_1,Luis,Garay,1996-08-10,20670070Q,luis.garay@awesomedata.io,449238,ES57209552411520511223,3831.73,2024-04-25T23:32:21,Bilbao,expenses,food,-121.62,-48723.18
buyer_1,Luis,Garay,1996-08-10,20670070Q,luis.garay@awesomedata.io,449238,ES57209552411520511223,3831.73,2024-04-25T22:23:18,Bilbao,expenses,cash,-100.0,-48823.18
buyer_1,Luis,Garay,1996-08-10,20670070Q,luis.garay@awesomedata.io,449238,ES57209552411520511223,3831.73,2024-04-26T19:35:18,Bilbao,expenses,repairs,-158.48,-48981.66
buyer_1,Luis,Garay,1996-08-10,20670070Q,luis.garay@awesomedata.io,449238,ES57209552411520511223,3831.73,2024-04-27T18:22:55,Bilbao,expenses,cash,-100.0,-49081.66
buyer_1,Luis,Garay,1996-08-10,20670070Q,luis.garay@awesomedata.io,449238,ES57209552411520511223,3831.73,2024-04-28T16:52:06,Bilbao,expenses,cash,-100.0,-49181.66
buyer_1,Luis,Garay,1996-08-10,20670070Q,luis.garay@awesomedata.io,449238,ES57209552411520511223,3831.73,2024-04-28T11:34:14,Bilbao,expenses,repairs,-316.02,-49497.68
buyer_1,Luis,Garay,1996-08-10,20670070Q,luis.garay@awesomedata.io,449238,ES57209552411520511223,3831.73,2024-04-29T08:20:50,Bilbao,expenses,food,-75.41,-49573.09
buyer_1,Luis,Garay,1996-08-10,20670070Q,luis.garay@awesomedata.io,449238,ES57209552411520511223,3831.73,2024-04-30T20:40:51,Bilbao,expenses,leisure,-47.84,-49620.93
buyer_1,Luis,Garay,1996-08-10,20670070Q,luis.garay@awesomedata.io,449238,ES57209552411520511223,3831.73,2024-04-30T13:23:29,Bilbao,expenses,repairs,-109.92,-49730.85
buyer_1,Luis,Garay,1996-08-10,20670070Q,luis.garay@awesomedata.io,449238,ES57209552411520511223,3831.73,2024-05-01T20:14:02,Bilbao,incomes,salary,2777.32,-46953.53
buyer_1,Luis,Garay,1996-08-10,20670070Q,luis.garay@awesomedata.io,449238,ES57209552411520511223,3831.73,2024-05-03T19:14:02,Bilbao,expenses,food,-87.65,-47041.18
buyer_1,Luis,Garay,1996-08-10,20670070Q,luis.garay@awesomedata.io,449238,ES57209552411520511223,3831.73,2024-05-03T20:06:00,Bilbao,expenses,leisure,-35.02,-47076.2
buyer_1,Luis,Garay,1996-08-10,20670070Q,luis.garay@awesomedata.io,449238,ES57209552411520511223,3831.73,2024-05-04T04:21:44,Bilbao,expenses,rent,-900.12,-47976.32
buyer_1,Luis,Garay,1996-08-10,20670070Q,luis.garay@awesomedata.io,449238,ES57209552411520511223,3831.73,2024-05-05T17:44:00,Bilbao,expenses,electricity,-86.35,-48062.67
buyer_1,Luis,Garay,1996-08-10,20670070Q,luis.garay@awesomedata.io,449238,ES57209552411520511223,3831.73,2024-05-05T15:51:34,Bilbao,expenses,gas,-56.61,-48119.28
buyer_1,Luis,Garay,1996-08-10,20670070Q,luis.garay@awesomedata.io,449238,ES57209552411520511223,3831.73,2024-05-05T16:16:07,Bilbao,expenses,internet,-58.32,-48177.6
buyer_1,Luis,Garay,1996-08-10,20670070Q,luis.garay@awesomedata.io,449238,ES57209552411520511223,3831.73,2024-05-06T11:33:13,Bilbao,expenses,electricity,-97.85,-48275.45
buyer_1,Luis,Garay,1996-08-10,20670070Q,luis.garay@awesomedata.io,449238,ES57209552411520511223,3831.73,2024-05-06T19:50:12,Bilbao,expenses,internet,-58.32,-48333.77
buyer_1,Luis,Garay,1996-08-10,20670070Q,luis.garay@awesomedata.io,449238,ES57209552411520511223,3831.73,2024-05-07T13:48:07,Bilbao,expenses,electricity,-120.55,-48454.32
buyer_1,Luis,Garay,1996-08-10,20670070Q,luis.garay@awesomedata.io,449238,ES57209552411520511223,3831.73,2024-05-07T19:07:55,Bilbao,expenses,gas,-57.93,-48512.25
buyer_1,Luis,Garay,1996-08-10,20670070Q,luis.garay@awesomedata.io,449238,ES57209552411520511223,3831.73,2024-05-07T13:06:16,Bilbao,expenses,phone,-60.33,-48572.58
buyer_1,Luis,Garay,1996-08-10,20670070Q,luis.garay@awesomedata.io,449238,ES57209552411520511223,3831.73,2024-05-07T19:52:35,Bilbao,expenses,food,-79.77,-48652.35
buyer_1,Luis,Garay,1996-08-10,20670070Q,luis.garay@awesomedata.io,449238,ES57209552411520511223,3831.73,2024-05-07T20:53:28,Bilbao,expenses,cash,-100.0,-48752.35
buyer_1,Luis,Garay,1996-08-10,20670070Q,luis.garay@awesomedata.io,449238,ES57209552411520511223,3831.73,2024-05-08T08:27:51,Bilbao,expenses,water,-48.18,-48800.53
buyer_1,Luis,Garay,1996-08-10,20670070Q,luis.garay@awesomedata.io,449238,ES57209552411520511223,3831.73,2024-05-08T09:30:48,Bilbao,expenses,cash,-100.0,-48900.53
buyer_1,Luis,Garay,1996-08-10,20670070Q,luis.garay@awesomedata.io,449238,ES57209552411520511223,3831.73,2024-05-11T16:06:58,Bilbao,expenses,food,-93.7,-48994.23
buyer_1,Luis,Garay,1996-08-10,20670070Q,luis.garay@awesomedata.io,449238,ES57209552411520511223,3831.73,2024-05-12T18:40:21,Bilbao,expenses,cash,-100.0,-49094.23
buyer_1,Luis,Garay,1996-08-10,20670070Q,luis.garay@awesomedata.io,449238,ES57209552411520511223,3831.73,2024-05-13T10:24:12,Bilbao,expenses,cash,-100.0,-49194.23
buyer_1,Luis,Garay,1996-08-10,20670070Q,luis.garay@awesomedata.io,449238,ES57209552411520511223,3831.73,2024-05-14T18:44:24,Bilbao,expenses,food,-62.15,-49256.38
buyer_1,Luis,Garay,1996-08-10,20670070Q,luis.garay@awesomedata.io,449238,ES57209552411520511223,3831.73,2024-05-14T11:39:19,Bilbao,expenses,leisure,-56.98,-49313.36
buyer_1,Luis,Garay,1996-08-10,20670070Q,luis.garay@awesomedata.io,449238,ES57209552411520511223,3831.73,2024-05-15T16:41:16,Bilbao,expenses,repairs,-281.18,-49594.54
buyer_1,Luis,Garay,1996-08-10,20670070Q,luis.garay@awesomedata.io,449238,ES57209552411520511223,3831.73,2024-05-16T14:50:17,Bilbao,expenses,travel,-1000.01,-50594.55
buyer_1,Luis,Garay,1996-08-10,20670070Q,luis.garay@awesomedata.io,449238,ES57209552411520511223,3831.73,2024-05-16T15:03:19,Bilbao,expenses,appliances,-198.02,-50792.57
buyer_1,Luis,Garay,1996-08-10,20670070Q,luis.garay@awesomedata.io,449238,ES57209552411520511223,3831.73,2024-05-17T13:49:59,Bilbao,expenses,education,-67.71,-50860.28
buyer_1,Luis,Garay,1996-08-10,20670070Q,luis.garay@awesomedata.io,449238,ES57209552411520511223,3831.73,2024-05-17T20:41:14,Bilbao,expenses,gifts,-630.14,-51490.42
buyer_1,Luis,Garay,1996-08-10,20670070Q,luis.garay@awesomedata.io,449238,ES57209552411520511223,3831.73,2024-05-24T14:32:52,Bilbao,expenses,cash,-100.0,-51590.42
buyer_1,Luis,Garay,1996-08-10,20670070Q,luis.garay@awesomedata.io,449238,ES57209552411520511223,3831.73,2024-05-25T10:03:47,Bilbao,expenses,leisure,-55.33,-51645.75
buyer_1,Luis,Garay,1996-08-10,20670070Q,luis.garay@awesomedata.io,449238,ES57209552411520511223,3831.73,2024-05-27T13:49:40,Bilbao,expenses,cash,-100.0,-51745.75
buyer_1,Luis,Garay,1996-08-10,20670070Q,luis.garay@awesomedata.io,449238,ES57209552411520511223,3831.73,2024-05-27T12:17:14,Bilbao,expenses,appliances,-86.67,-51832.42
buyer_1,Luis,Garay,1996-08-10,20670070Q,luis.garay@awesomedata.io,449238,ES57209552411520511223,3831.73,2024-05-28T20:47:56,Bilbao,expenses,cash,-100.0,-51932.42
buyer_1,Luis,Garay,1996-08-10,20670070Q,luis.garay@awesomedata.io,449238,ES57209552411520511223,3831.73,2024-05-28T10:47:22,Bilbao,expenses,repairs,-327.0,-52259.42
buyer_1,Luis,Garay,1996-08-10,20670070Q,luis.garay@awesomedata.io,449238,ES57209552411520511223,3831.73,2024-06-01T08:49:56,Bilbao,incomes,salary,2777.32,-49482.1
buyer_1,Luis,Garay,1996-08-10,20670070Q,luis.garay@awesomedata.io,449238,ES57209552411520511223,3831.73,2024-06-01T08:49:56,Bilbao,incomes,salary_bonus,2134.8,-47347.3
buyer_1,Luis,Garay,1996-08-10,20670070Q,luis.garay@awesomedata.io,449238,ES57209552411520511223,3831.73,2024-06-01T15:02:47,Bilbao,expenses,taxes,-1673.21,-49020.51
buyer_1,Luis,Garay,1996-08-10,20670070Q,luis.garay@awesomedata.io,449238,ES57209552411520511223,3831.73,2024-06-01T12:56:53,Bilbao,expenses,insurance,-697.28,-49717.79
buyer_1,Luis,Garay,1996-08-10,20670070Q,luis.garay@awesomedata.io,449238,ES57209552411520511223,3831.73,2024-06-03T10:40:15,Bilbao,expenses,cash,-100.0,-49817.79
buyer_1,Luis,Garay,1996-08-10,20670070Q,luis.garay@awesomedata.io,449238,ES57209552411520511223,3831.73,2024-06-04T17:59:28,Bilbao,expenses,rent,-900.12,-50717.91
buyer_1,Luis,Garay,1996-08-10,20670070Q,luis.garay@awesomedata.io,449238,ES57209552411520511223,3831.73,2024-06-05T11:55:24,Bilbao,expenses,water,-29.6,-50747.51
buyer_1,Luis,Garay,1996-08-10,20670070Q,luis.garay@awesomedata.io,449238,ES57209552411520511223,3831.73,2024-06-05T08:49:29,Bilbao,expenses,phone,-57.01,-50804.52
buyer_1,Luis,Garay,1996-08-10,20670070Q,luis.garay@awesomedata.io,449238,ES57209552411520511223,3831.73,2024-06-05T13:58:03,Bilbao,expenses,healthcare,-143.8,-50948.32
buyer_1,Luis,Garay,1996-08-10,20670070Q,luis.garay@awesomedata.io,449238,ES57209552411520511223,3831.73,2024-06-05T23:53:50,Bilbao,expenses,education,-74.16,-51022.48
buyer_1,Luis,Garay,1996-08-10,20670070Q,luis.garay@awesomedata.io,449238,ES57209552411520511223,3831.73,2024-06-06T20:54:57,Bilbao,expenses,gas,-89.27,-51111.75
buyer_1,Luis,Garay,1996-08-10,20670070Q,luis.garay@awesomedata.io,449238,ES57209552411520511223,3831.73,2024-06-06T13:57:33,Bilbao,expenses,internet,-58.32,-51170.07
buyer_1,Luis,Garay,1996-08-10,20670070Q,luis.garay@awesomedata.io,449238,ES57209552411520511223,3831.73,2024-06-06T22:04:44,Bilbao,expenses,phone,-54.57,-51224.64
buyer_1,Luis,Garay,1996-08-10,20670070Q,luis.garay@awesomedata.io,449238,ES57209552411520511223,3831.73,2024-06-06T08:35:07,Bilbao,expenses,healthcare,-91.54,-51316.18
buyer_1,Luis,Garay,1996-08-10,20670070Q,luis.garay@awesomedata.io,449238,ES57209552411520511223,3831.73,2024-06-07T08:14:29,Bilbao,expenses,electricity,-118.91,-51435.09
buyer_1,Luis,Garay,1996-08-10,20670070Q,luis.garay@awesomedata.io,449238,ES57209552411520511223,3831.73,2024-06-07T14:32:53,Bilbao,expenses,phone,-59.58,-51494.67
buyer_1,Luis,Garay,1996-08-10,20670070Q,luis.garay@awesomedata.io,449238,ES57209552411520511223,3831.73,2024-06-08T16:55:09,Bilbao,expenses,food,-101.24,-51595.91
buyer_1,Luis,Garay,1996-08-10,20670070Q,luis.garay@awesomedata.io,449238,ES57209552411520511223,3831.73,2024-06-09T12:33:30,Bilbao,expenses,leisure,-63.38,-51659.29
buyer_1,Luis,Garay,1996-08-10,20670070Q,luis.garay@awesomedata.io,449238,ES57209552411520511223,3831.73,2024-06-09T02:52:51,Bilbao,expenses,repairs,-220.01,-51879.3
buyer_1,Luis,Garay,1996-08-10,20670070Q,luis.garay@awesomedata.io,449238,ES57209552411520511223,3831.73,2024-06-13T16:12:07,Bilbao,expenses,leisure,-32.81,-51912.11
buyer_1,Luis,Garay,1996-08-10,20670070Q,luis.garay@awesomedata.io,449238,ES57209552411520511223,3831.73,2024-06-13T16:04:48,Bilbao,expenses,cash,-100.0,-52012.11
buyer_1,Luis,Garay,1996-08-10,20670070Q,luis.garay@awesomedata.io,449238,ES57209552411520511223,3831.73,2024-06-15T08:44:43,Bilbao,expenses,cash,-100.0,-52112.11
buyer_1,Luis,Garay,1996-08-10,20670070Q,luis.garay@awesomedata.io,449238,ES57209552411520511223,3831.73,2024-06-16T05:27:31,Bilbao,expenses,leisure,-52.85,-52164.96
buyer_1,Luis,Garay,1996-08-10,20670070Q,luis.garay@awesomedata.io,449238,ES57209552411520511223,3831.73,2024-06-17T18:53:55,Bilbao,expenses,food,-115.65,-52280.61
buyer_1,Luis,Garay,1996-08-10,20670070Q,luis.garay@awesomedata.io,449238,ES57209552411520511223,3831.73,2024-06-17T11:41:16,Bilbao,expenses,education,-74.31,-52354.92
buyer_1,Luis,Garay,1996-08-10,20670070Q,luis.garay@awesomedata.io,449238,ES57209552411520511223,3831.73,2024-06-19T19:45:54,Bilbao,expenses,gifts,-241.23,-52596.15
buyer_1,Luis,Garay,1996-08-10,20670070Q,luis.garay@awesomedata.io,449238,ES57209552411520511223,3831.73,2024-06-20T15:59:54,Bilbao,expenses,leisure,-31.57,-52627.72
buyer_1,Luis,Garay,1996-08-10,20670070Q,luis.garay@awesomedata.io,449238,ES57209552411520511223,3831.73,2024-06-21T17:54:53,Bilbao,expenses,education,-76.81,-52704.53
buyer_1,Luis,Garay,1996-08-10,20670070Q,luis.garay@awesomedata.io,449238,ES57209552411520511223,3831.73,2024-06-22T11:41:48,Bilbao,expenses,food,-84.33,-52788.86
buyer_1,Luis,Garay,1996-08-10,20670070Q,luis.garay@awesomedata.io,449238,ES57209552411520511223,3831.73,2024-06-25T19:23:34,Bilbao,expenses,leisure,-66.26,-52855.12
buyer_1,Luis,Garay,1996-08-10,20670070Q,luis.garay@awesomedata.io,449238,ES57209552411520511223,3831.73,2024-06-25T13:40:49,Bilbao,expenses,cash,-100.0,-52955.12
buyer_1,Luis,Garay,1996-08-10,20670070Q,luis.garay@awesomedata.io,449238,ES57209552411520511223,3831.73,2024-06-25T22:22:37,Bilbao,expenses,gifts,-513.96,-53469.08
buyer_1,Luis,Garay,1996-08-10,20670070Q,luis.garay@awesomedata.io,449238,ES57209552411520511223,3831.73,2024-06-28T09:03:05,Bilbao,expenses,transport,-86.02,-53555.1
buyer_1,Luis,Garay,1996-08-10,20670070Q,luis.garay@awesomedata.io,449238,ES57209552411520511223,3831.73,2024-06-30T18:53:41,Bilbao,expenses,appliances,-95.18,-53650.28
buyer_1,Luis,Garay,1996-08-10,20670070Q,luis.garay@awesomedata.io,449238,ES57209552411520511223,3831.73,2024-07-01T11:46:38,Bilbao,incomes,salary,2777.32,-50872.96
buyer_1,Luis,Garay,1996-08-10,20670070Q,luis.garay@awesomedata.io,449238,ES57209552411520511223,3831.73,2024-07-01T12:02:34,Bilbao,expenses,transport,-60.43,-50933.39
buyer_1,Luis,Garay,1996-08-10,20670070Q,luis.garay@awesomedata.io,449238,ES57209552411520511223,3831.73,2024-07-02T20:19:24,Bilbao,expenses,clothing,-136.41,-51069.8
buyer_1,Luis,Garay,1996-08-10,20670070Q,luis.garay@awesomedata.io,449238,ES57209552411520511223,3831.73,2024-07-03T14:57:23,Bilbao,expenses,leisure,-60.97,-51130.77
buyer_1,Luis,Garay,1996-08-10,20670070Q,luis.garay@awesomedata.io,449238,ES57209552411520511223,3831.73,2024-07-04T08:39:04,Bilbao,expenses,rent,-900.12,-52030.89
buyer_1,Luis,Garay,1996-08-10,20670070Q,luis.garay@awesomedata.io,449238,ES57209552411520511223,3831.73,2024-07-04T13:36:16,Bilbao,expenses,transport,-58.33,-52089.22
buyer_1,Luis,Garay,1996-08-10,20670070Q,luis.garay@awesomedata.io,449238,ES57209552411520511223,3831.73,2024-07-05T20:00:47,Bilbao,expenses,electricity,-80.04,-52169.26
buyer_1,Luis,Garay,1996-08-10,20670070Q,luis.garay@awesomedata.io,449238,ES57209552411520511223,3831.73,2024-07-05T08:02:35,Bilbao,expenses,gas,-98.83,-52268.09
buyer_1,Luis,Garay,1996-08-10,20670070Q,luis.garay@awesomedata.io,449238,ES57209552411520511223,3831.73,2024-07-05T03:08:33,Bilbao,expenses,internet,-58.32,-52326.41
buyer_1,Luis,Garay,1996-08-10,20670070Q,luis.garay@awesomedata.io,449238,ES57209552411520511223,3831.73,2024-07-05T00:24:52,Bilbao,expenses,leisure,-20.52,-52346.93
buyer_1,Luis,Garay,1996-08-10,20670070Q,luis.garay@awesomedata.io,449238,ES57209552411520511223,3831.73,2024-07-05T12:33:08,Bilbao,expenses,cash,-100.0,-52446.93
buyer_1,Luis,Garay,1996-08-10,20670070Q,luis.garay@awesomedata.io,449238,ES57209552411520511223,3831.73,2024-07-06T23:40:38,Bilbao,expenses,clothing,-151.0,-52597.93
buyer_1,Luis,Garay,1996-08-10,20670070Q,luis.garay@awesomedata.io,449238,ES57209552411520511223,3831.73,2024-07-07T15:28:21,Bilbao,expenses,internet,-58.32,-52656.25
buyer_1,Luis,Garay,1996-08-10,20670070Q,luis.garay@awesomedata.io,449238,ES57209552411520511223,3831.73,2024-07-08T20:33:45,Bilbao,expenses,electricity,-80.4,-52736.65
buyer_1,Luis,Garay,1996-08-10,20670070Q,luis.garay@awesomedata.io,449238,ES57209552411520511223,3831.73,2024-07-08T01:19:24,Bilbao,expenses,internet,-58.32,-52794.97
buyer_1,Luis,Garay,1996-08-10,20670070Q,luis.garay@awesomedata.io,449238,ES57209552411520511223,3831.73,2024-07-09T15:09:03,Bilbao,expenses,cash,-100.0,-52894.97
buyer_1,Luis,Garay,1996-08-10,20670070Q,luis.garay@awesomedata.io,449238,ES57209552411520511223,3831.73,2024-07-12T14:13:27,Bilbao,expenses,transport,-62.13,-52957.1
buyer_1,Luis,Garay,1996-08-10,20670070Q,luis.garay@awesomedata.io,449238,ES57209552411520511223,3831.73,2024-07-12T15:07:47,Bilbao,expenses,travel,-373.44,-53330.54
buyer_1,Luis,Garay,1996-08-10,20670070Q,luis.garay@awesomedata.io,449238,ES57209552411520511223,3831.73,2024-07-13T17:30:53,Bilbao,expenses,clothing,-110.54,-53441.08
buyer_1,Luis,Garay,1996-08-10,20670070Q,luis.garay@awesomedata.io,449238,ES57209552411520511223,3831.73,2024-07-14T19:36:04,Bilbao,expenses,food,-73.46,-53514.54
buyer_1,Luis,Garay,1996-08-10,20670070Q,luis.garay@awesomedata.io,449238,ES57209552411520511223,3831.73,2024-07-17T20:29:57,Bilbao,expenses,healthcare,-57.81,-53572.35
buyer_1,Luis,Garay,1996-08-10,20670070Q,luis.garay@awesomedata.io,449238,ES57209552411520511223,3831.73,2024-07-18T14:54:27,Bilbao,expenses,repairs,-200.6,-53772.95
buyer_1,Luis,Garay,1996-08-10,20670070Q,luis.garay@awesomedata.io,449238,ES57209552411520511223,3831.73,2024-07-19T12:30:30,Bilbao,expenses,clothing,-114.87,-53887.82
buyer_1,Luis,Garay,1996-08-10,20670070Q,luis.garay@awesomedata.io,449238,ES57209552411520511223,3831.73,2024-07-20T15:47:38,Bilbao,expenses,food,-68.51,-53956.33
buyer_1,Luis,Garay,1996-08-10,20670070Q,luis.garay@awesomedata.io,449238,ES57209552411520511223,3831.73,2024-07-21T14:13:43,Bilbao,expenses,food,-97.39,-54053.72
buyer_1,Luis,Garay,1996-08-10,20670070Q,luis.garay@awesomedata.io,449238,ES57209552411520511223,3831.73,2024-07-23T23:18:39,Bilbao,expenses,leisure,-60.55,-54114.27
buyer_1,Luis,Garay,1996-08-10,20670070Q,luis.garay@awesomedata.io,449238,ES57209552411520511223,3831.73,2024-07-25T09:48:42,Bilbao,expenses,food,-81.22,-54195.49
buyer_1,Luis,Garay,1996-08-10,20670070Q,luis.garay@awesomedata.io,449238,ES57209552411520511223,3831.73,2024-07-27T18:19:11,Bilbao,expenses,food,-87.91,-54283.4
buyer_1,Luis,Garay,1996-08-10,20670070Q,luis.garay@awesomedata.io,449238,ES57209552411520511223,3831.73,2024-08-01T14:56:00,Bilbao,incomes,salary,2777.32,-51506.08
buyer_1,Luis,Garay,1996-08-10,20670070Q,luis.garay@awesomedata.io,449238,ES57209552411520511223,3831.73,2024-08-01T14:56:00,Bilbao,incomes,extra_income,264.61,-51241.47
buyer_1,Luis,Garay,1996-08-10,20670070Q,luis.garay@awesomedata.io,449238,ES57209552411520511223,3831.73,2024-08-01T15:24:59,Bilbao,expenses,transport,-45.34,-51286.81
buyer_1,Luis,Garay,1996-08-10,20670070Q,luis.garay@awesomedata.io,449238,ES57209552411520511223,3831.73,2024-08-01T09:25:21,Bilbao,expenses,cash,-100.0,-51386.81
buyer_1,Luis,Garay,1996-08-10,20670070Q,luis.garay@awesomedata.io,449238,ES57209552411520511223,3831.73,2024-08-03T11:43:22,Bilbao,expenses,leisure,-41.93,-51428.74
buyer_1,Luis,Garay,1996-08-10,20670070Q,luis.garay@awesomedata.io,449238,ES57209552411520511223,3831.73,2024-08-04T16:02:14,Bilbao,expenses,rent,-900.12,-52328.86
buyer_1,Luis,Garay,1996-08-10,20670070Q,luis.garay@awesomedata.io,449238,ES57209552411520511223,3831.73,2024-08-05T19:17:00,Bilbao,expenses,internet,-58.32,-52387.18
buyer_1,Luis,Garay,1996-08-10,20670070Q,luis.garay@awesomedata.io,449238,ES57209552411520511223,3831.73,2024-08-06T22:18:20,Bilbao,expenses,water,-57.75,-52444.93
buyer_1,Luis,Garay,1996-08-10,20670070Q,luis.garay@awesomedata.io,449238,ES57209552411520511223,3831.73,2024-08-06T09:54:53,Bilbao,expenses,cash,-100.0,-52544.93
buyer_1,Luis,Garay,1996-08-10,20670070Q,luis.garay@awesomedata.io,449238,ES57209552411520511223,3831.73,2024-08-08T12:40:09,Bilbao,expenses,clothing,-52.29,-52597.22
buyer_1,Luis,Garay,1996-08-10,20670070Q,luis.garay@awesomedata.io,449238,ES57209552411520511223,3831.73,2024-08-08T10:16:12,Bilbao,expenses,repairs,-99.86,-52697.08
buyer_1,Luis,Garay,1996-08-10,20670070Q,luis.garay@awesomedata.io,449238,ES57209552411520511223,3831.73,2024-08-09T09:08:45,Bilbao,expenses,cash,-100.0,-52797.08
buyer_1,Luis,Garay,1996-08-10,20670070Q,luis.garay@awesomedata.io,449238,ES57209552411520511223,3831.73,2024-08-11T19:17:53,Bilbao,expenses,food,-91.0,-52888.08
buyer_1,Luis,Garay,1996-08-10,20670070Q,luis.garay@awesomedata.io,449238,ES57209552411520511223,3831.73,2024-08-12T09:23:39,Bilbao,expenses,cash,-100.0,-52988.08
buyer_1,Luis,Garay,1996-08-10,20670070Q,luis.garay@awesomedata.io,449238,ES57209552411520511223,3831.73,2024-08-13T21:23:55,Bilbao,expenses,leisure,-20.08,-53008.16
buyer_1,Luis,Garay,1996-08-10,20670070Q,luis.garay@awesomedata.io,449238,ES57209552411520511223,3831.73,2024-08-13T03:19:59,Bilbao,expenses,cash,-100.0,-53108.16
buyer_1,Luis,Garay,1996-08-10,20670070Q,luis.garay@awesomedata.io,449238,ES57209552411520511223,3831.73,2024-08-14T13:15:45,Bilbao,expenses,transport,-56.63,-53164.79
buyer_1,Luis,Garay,1996-08-10,20670070Q,luis.garay@awesomedata.io,449238,ES57209552411520511223,3831.73,2024-08-15T17:43:02,Bilbao,expenses,cash,-100.0,-53264.79
buyer_1,Luis,Garay,1996-08-10,20670070Q,luis.garay@awesomedata.io,449238,ES57209552411520511223,3831.73,2024-08-16T10:05:43,Bilbao,expenses,transport,-55.58,-53320.37
buyer_1,Luis,Garay,1996-08-10,20670070Q,luis.garay@awesomedata.io,449238,ES57209552411520511223,3831.73,2024-08-17T19:34:59,Bilbao,expenses,gifts,-462.35,-53782.72
buyer_1,Luis,Garay,1996-08-10,20670070Q,luis.garay@awesomedata.io,449238,ES57209552411520511223,3831.73,2024-08-21T19:40:52,Bilbao,expenses,food,-103.3,-53886.02
buyer_1,Luis,Garay,1996-08-10,20670070Q,luis.garay@awesomedata.io,449238,ES57209552411520511223,3831.73,2024-08-21T13:59:42,Bilbao,expenses,education,-77.59,-53963.61
buyer_1,Luis,Garay,1996-08-10,20670070Q,luis.garay@awesomedata.io,449238,ES57209552411520511223,3831.73,2024-08-21T08:30:06,Bilbao,expenses,cash,-100.0,-54063.61
buyer_1,Luis,Garay,1996-08-10,20670070Q,luis.garay@awesomedata.io,449238,ES57209552411520511223,3831.73,2024-08-21T00:56:38,Bilbao,expenses,repairs,-109.32,-54172.93
buyer_1,Luis,Garay,1996-08-10,20670070Q,luis.garay@awesomedata.io,449238,ES57209552411520511223,3831.73,2024-08-22T17:25:36,Bilbao,expenses,cash,-100.0,-54272.93
buyer_1,Luis,Garay,1996-08-10,20670070Q,luis.garay@awesomedata.io,449238,ES57209552411520511223,3831.73,2024-08-24T10:30:45,Bilbao,expenses,clothing,-55.09,-54328.02
buyer_1,Luis,Garay,1996-08-10,20670070Q,luis.garay@awesomedata.io,449238,ES57209552411520511223,3831.73,2024-08-26T08:17:14,Bilbao,expenses,repairs,-77.71,-54405.73
buyer_1,Luis,Garay,1996-08-10,20670070Q,luis.garay@awesomedata.io,449238,ES57209552411520511223,3831.73,2024-08-28T21:42:59,Bilbao,expenses,repairs,-159.3,-54565.03
buyer_1,Luis,Garay,1996-08-10,20670070Q,luis.garay@awesomedata.io,449238,ES57209552411520511223,3831.73,2024-08-29T21:25:06,Bilbao,expenses,food,-107.19,-54672.22
buyer_1,Luis,Garay,1996-08-10,20670070Q,luis.garay@awesomedata.io,449238,ES57209552411520511223,3831.73,2024-08-30T11:05:51,Bilbao,expenses,leisure,-80.73,-54752.95
buyer_1,Luis,Garay,1996-08-10,20670070Q,luis.garay@awesomedata.io,449238,ES57209552411520511223,3831.73,2024-08-30T22:45:58,Bilbao,expenses,appliances,-178.99,-54931.94
buyer_1,Luis,Garay,1996-08-10,20670070Q,luis.garay@awesomedata.io,449238,ES57209552411520511223,3831.73,2024-08-31T16:35:31,Bilbao,expenses,food,-61.89,-54993.83
buyer_1,Luis,Garay,1996-08-10,20670070Q,luis.garay@awesomedata.io,449238,ES57209552411520511223,3831.73,2024-09-01T00:00:48,Bilbao,incomes,salary,2777.32,-52216.51
buyer_1,Luis,Garay,1996-08-10,20670070Q,luis.garay@awesomedata.io,449238,ES57209552411520511223,3831.73,2024-09-02T16:29:07,Bilbao,expenses,food,-99.29,-52315.8
buyer_1,Luis,Garay,1996-08-10,20670070Q,luis.garay@awesomedata.io,449238,ES57209552411520511223,3831.73,2024-09-02T19:48:25,Bilbao,expenses,leisure,-74.97,-52390.77
buyer_1,Luis,Garay,1996-08-10,20670070Q,luis.garay@awesomedata.io,449238,ES57209552411520511223,3831.73,2024-09-04T15:06:21,Bilbao,expenses,rent,-900.12,-53290.89
buyer_1,Luis,Garay,1996-08-10,20670070Q,luis.garay@awesomedata.io,449238,ES57209552411520511223,3831.73,2024-09-04T03:45:37,Bilbao,expenses,leisure,-64.9,-53355.79
buyer_1,Luis,Garay,1996-08-10,20670070Q,luis.garay@awesomedata.io,449238,ES57209552411520511223,3831.73,2024-09-05T17:34:29,Bilbao,expenses,water,-31.19,-53386.98
buyer_1,Luis,Garay,1996-08-10,20670070Q,luis.garay@awesomedata.io,449238,ES57209552411520511223,3831.73,2024-09-05T18:17:56,Bilbao,expenses,gas,-111.68,-53498.66
buyer_1,Luis,Garay,1996-08-10,20670070Q,luis.garay@awesomedata.io,449238,ES57209552411520511223,3831.73,2024-09-06T09:57:15,Bilbao,expenses,water,-49.49,-53548.15
buyer_1,Luis,Garay,1996-08-10,20670070Q,luis.garay@awesomedata.io,449238,ES57209552411520511223,3831.73,2024-09-06T17:20:42,Bilbao,expenses,electricity,-61.65,-53609.8
buyer_1,Luis,Garay,1996-08-10,20670070Q,luis.garay@awesomedata.io,449238,ES57209552411520511223,3831.73,2024-09-06T09:51:38,Bilbao,expenses,phone,-55.83,-53665.63
buyer_1,Luis,Garay,1996-08-10,20670070Q,luis.garay@awesomedata.io,449238,ES57209552411520511223,3831.73,2024-09-06T16:50:00,Bilbao,expenses,food,-97.22,-53762.85
buyer_1,Luis,Garay,1996-08-10,20670070Q,luis.garay@awesomedata.io,449238,ES57209552411520511223,3831.73,2024-09-07T06:43:13,Bilbao,expenses,water,-61.85,-53824.7
buyer_1,Luis,Garay,1996-08-10,20670070Q,luis.garay@awesomedata.io,449238,ES57209552411520511223,3831.73,2024-09-07T14:03:30,Bilbao,expenses,gas,-62.55,-53887.25
buyer_1,Luis,Garay,1996-08-10,20670070Q,luis.garay@awesomedata.io,449238,ES57209552411520511223,3831.73,2024-09-08T08:46:54,Bilbao,expenses,phone,-60.37,-53947.62
buyer_1,Luis,Garay,1996-08-10,20670070Q,luis.garay@awesomedata.io,449238,ES57209552411520511223,3831.73,2024-09-11T17:58:31,Bilbao,expenses,education,-49.25,-53996.87
buyer_1,Luis,Garay,1996-08-10,20670070Q,luis.garay@awesomedata.io,449238,ES57209552411520511223,3831.73,2024-09-14T15:09:55,Bilbao,expenses,gifts,-761.59,-54758.46
buyer_1,Luis,Garay,1996-08-10,20670070Q,luis.garay@awesomedata.io,449238,ES57209552411520511223,3831.73,2024-09-16T08:46:42,Bilbao,expenses,cash,-100.0,-54858.46
buyer_1,Luis,Garay,1996-08-10,20670070Q,luis.garay@awesomedata.io,449238,ES57209552411520511223,3831.73,2024-09-18T15:29:24,Bilbao,expenses,cash,-100.0,-54958.46
buyer_1,Luis,Garay,1996-08-10,20670070Q,luis.garay@awesomedata.io,449238,ES57209552411520511223,3831.73,2024-09-19T17:48:54,Bilbao,expenses,cash,-100.0,-55058.46
buyer_1,Luis,Garay,1996-08-10,20670070Q,luis.garay@awesomedata.io,449238,ES57209552411520511223,3831.73,2024-09-20T15:39:03,Bilbao,expenses,gifts,-254.59,-55313.05
buyer_1,Luis,Garay,1996-08-10,20670070Q,luis.garay@awesomedata.io,449238,ES57209552411520511223,3831.73,2024-09-23T09:43:30,Bilbao,expenses,transport,-87.0,-55400.05
buyer_1,Luis,Garay,1996-08-10,20670070Q,luis.garay@awesomedata.io,449238,ES57209552411520511223,3831.73,2024-09-23T17:27:43,Bilbao,expenses,repairs,-273.88,-55673.93
buyer_1,Luis,Garay,1996-08-10,20670070Q,luis.garay@awesomedata.io,449238,ES57209552411520511223,3831.73,2024-09-24T09:41:07,Bilbao,expenses,appliances,-357.17,-56031.1
buyer_1,Luis,Garay,1996-08-10,20670070Q,luis.garay@awesomedata.io,449238,ES57209552411520511223,3831.73,2024-09-25T12:46:30,Bilbao,expenses,food,-103.68,-56134.78
buyer_1,Luis,Garay,1996-08-10,20670070Q,luis.garay@awesomedata.io,449238,ES57209552411520511223,3831.73,2024-09-30T08:08:00,Bilbao,expenses,leisure,-72.58,-56207.36
buyer_1,Luis,Garay,1996-08-10,20670070Q,luis.garay@awesomedata.io,449238,ES57209552411520511223,3831.73,2024-10-01T18:36:04,Bilbao,incomes,salary,2777.32,-53430.04
buyer_1,Luis,Garay,1996-08-10,20670070Q,luis.garay@awesomedata.io,449238,ES57209552411520511223,3831.73,2024-10-02T10:01:06,Bilbao,expenses,cash,-100.0,-53530.04
buyer_1,Luis,Garay,1996-08-10,20670070Q,luis.garay@awesomedata.io,449238,ES57209552411520511223,3831.73,2024-10-03T18:38:49,Bilbao,expenses,leisure,-39.97,-53570.01
buyer_1,Luis,Garay,1996-08-10,20670070Q,luis.garay@awesomedata.io,449238,ES57209552411520511223,3831.73,2024-10-03T20:18:54,Bilbao,expenses,cash,-100.0,-53670.01
buyer_1,Luis,Garay,1996-08-10,20670070Q,luis.garay@awesomedata.io,449238,ES57209552411520511223,3831.73,2024-10-04T12:04:04,Bilbao,expenses,rent,-900.12,-54570.13
buyer_1,Luis,Garay,1996-08-10,20670070Q,luis.garay@awesomedata.io,449238,ES57209552411520511223,3831.73,2024-10-05T11:05:08,Bilbao,expenses,water,-53.76,-54623.89
buyer_1,Luis,Garay,1996-08-10,20670070Q,luis.garay@awesomedata.io,449238,ES57209552411520511223,3831.73,2024-10-05T23:35:40,Bilbao,expenses,electricity,-83.17,-54707.06
buyer_1,Luis,Garay,1996-08-10,20670070Q,luis.garay@awesomedata.io,449238,ES57209552411520511223,3831.73,2024-10-05T13:05:21,Bilbao,expenses,phone,-50.83,-54757.89
buyer_1,Luis,Garay,1996-08-10,20670070Q,luis.garay@awesomedata.io,449238,ES57209552411520511223,3831.73,2024-10-06T11:10:27,Bilbao,expenses,gifts,-687.02,-55444.91
buyer_1,Luis,Garay,1996-08-10,20670070Q,luis.garay@awesomedata.io,449238,ES57209552411520511223,3831.73,2024-10-08T20:06:51,Bilbao,expenses,cash,-100.0,-55544.91
buyer_1,Luis,Garay,1996-08-10,20670070Q,luis.garay@awesomedata.io,449238,ES57209552411520511223,3831.73,2024-10-10T18:09:31,Bilbao,expenses,food,-97.19,-55642.1
buyer_1,Luis,Garay,1996-08-10,20670070Q,luis.garay@awesomedata.io,449238,ES57209552411520511223,3831.73,2024-10-10T10:34:58,Bilbao,expenses,leisure,-44.39,-55686.49
buyer_2,Carmen,Lozano,1984-09-05,54021274R,carmen.lozano@cleverdev.app,959998,ES63209535234862100767,1682.49,2022-01-01T15:10:10,Zarautz,incomes,salary,2037.7,3720.19
buyer_2,Carmen,Lozano,1984-09-05,54021274R,carmen.lozano@cleverdev.app,959998,ES63209535234862100767,1682.49,2022-01-03T09:12:20,Zarautz,expenses,food,-100.01,3620.18
buyer_2,Carmen,Lozano,1984-09-05,54021274R,carmen.lozano@cleverdev.app,959998,ES63209535234862100767,1682.49,2022-01-04T09:36:12,Zarautz,expenses,mortgage,-932.39,2687.79
buyer_2,Carmen,Lozano,1984-09-05,54021274R,carmen.lozano@cleverdev.app,959998,ES63209535234862100767,1682.49,2022-01-05T11:38:32,Zarautz,expenses,electricity,-80.32,2607.47
buyer_2,Carmen,Lozano,1984-09-05,54021274R,carmen.lozano@cleverdev.app,959998,ES63209535234862100767,1682.49,2022-01-05T08:55:41,Zarautz,expenses,gas,-113.44,2494.03
buyer_2,Carmen,Lozano,1984-09-05,54021274R,carmen.lozano@cleverdev.app,959998,ES63209535234862100767,1682.49,2022-01-05T20:35:48,Zarautz,expenses,clothing,-74.89,2419.14
buyer_2,Carmen,Lozano,1984-09-05,54021274R,carmen.lozano@cleverdev.app,959998,ES63209535234862100767,1682.49,2022-01-05T15:10:58,Zarautz,expenses,repairs,-106.14,2313.0
buyer_2,Carmen,Lozano,1984-09-05,54021274R,carmen.lozano@cleverdev.app,959998,ES63209535234862100767,1682.49,2022-01-06T15:31:33,Zarautz,expenses,electricity,-52.95,2260.05
buyer_2,Carmen,Lozano,1984-09-05,54021274R,carmen.lozano@cleverdev.app,959998,ES63209535234862100767,1682.49,2022-01-06T11:47:32,Zarautz,expenses,cash,-100.0,2160.05
buyer_2,Carmen,Lozano,1984-09-05,54021274R,carmen.lozano@cleverdev.app,959998,ES63209535234862100767,1682.49,2022-01-07T01:17:02,Zarautz,expenses,water,-35.14,2124.91
buyer_2,Carmen,Lozano,1984-09-05,54021274R,carmen.lozano@cleverdev.app,959998,ES63209535234862100767,1682.49,2022-01-07T18:59:22,Zarautz,expenses,electricity,-62.17,2062.74
buyer_2,Carmen,Lozano,1984-09-05,54021274R,carmen.lozano@cleverdev.app,959998,ES63209535234862100767,1682.49,2022-01-07T15:18:08,Zarautz,expenses,leisure,-72.99,1989.75
buyer_2,Carmen,Lozano,1984-09-05,54021274R,carmen.lozano@cleverdev.app,959998,ES63209535234862100767,1682.49,2022-01-07T20:22:41,Zarautz,expenses,clothing,-154.18,1835.57
buyer_2,Carmen,Lozano,1984-09-05,54021274R,carmen.lozano@cleverdev.app,959998,ES63209535234862100767,1682.49,2022-01-08T20:47:26,Zarautz,expenses,water,-38.27,1797.3
buyer_2,Carmen,Lozano,1984-09-05,54021274R,carmen.lozano@cleverdev.app,959998,ES63209535234862100767,1682.49,2022-01-08T19:45:38,Zarautz,expenses,gas,-93.99,1703.31
buyer_2,Carmen,Lozano,1984-09-05,54021274R,carmen.lozano@cleverdev.app,959998,ES63209535234862100767,1682.49,2022-01-08T21:45:41,Zarautz,expenses,leisure,-54.88,1648.43
buyer_2,Carmen,Lozano,1984-09-05,54021274R,carmen.lozano@cleverdev.app,959998,ES63209535234862100767,1682.49,2022-01-08T08:29:07,Zarautz,expenses,cash,-100.0,1548.43
buyer_2,Carmen,Lozano,1984-09-05,54021274R,carmen.lozano@cleverdev.app,959998,ES63209535234862100767,1682.49,2022-01-10T11:38:34,Zarautz,expenses,cash,-100.0,1448.43
buyer_2,Carmen,Lozano,1984-09-05,54021274R,carmen.lozano@cleverdev.app,959998,ES63209535234862100767,1682.49,2022-01-12T20:23:42,Zarautz,expenses,food,-119.64,1328.79
buyer_2,Carmen,Lozano,1984-09-05,54021274R,carmen.lozano@cleverdev.app,959998,ES63209535234862100767,1682.49,2022-01-12T21:14:20,Zarautz,expenses,repairs,-67.33,1261.46
buyer_2,Carmen,Lozano,1984-09-05,54021274R,carmen.lozano@cleverdev.app,959998,ES63209535234862100767,1682.49,2022-01-13T10:27:35,Zarautz,expenses,food,-88.37,1173.09
buyer_2,Carmen,Lozano,1984-09-05,54021274R,carmen.lozano@cleverdev.app,959998,ES63209535234862100767,1682.49,2022-01-14T10:04:50,Zarautz,expenses,leisure,-35.56,1137.53
buyer_2,Carmen,Lozano,1984-09-05,54021274R,carmen.lozano@cleverdev.app,959998,ES63209535234862100767,1682.49,2022-01-15T15:59:00,Zarautz,expenses,cash,-100.0,1037.53
buyer_2,Carmen,Lozano,1984-09-05,54021274R,carmen.lozano@cleverdev.app,959998,ES63209535234862100767,1682.49,2022-01-15T17:17:53,Zarautz,expenses,appliances,-268.69,768.84
buyer_2,Carmen,Lozano,1984-09-05,54021274R,carmen.lozano@cleverdev.app,959998,ES63209535234862100767,1682.49,2022-01-15T21:35:55,Zarautz,expenses,gifts,-85.26,683.58
buyer_2,Carmen,Lozano,1984-09-05,54021274R,carmen.lozano@cleverdev.app,959998,ES63209535234862100767,1682.49,2022-01-19T14:58:46,Zarautz,expenses,transport,-48.4,635.18
buyer_2,Carmen,Lozano,1984-09-05,54021274R,carmen.lozano@cleverdev.app,959998,ES63209535234862100767,1682.49,2022-01-20T12:17:27,Zarautz,expenses,cash,-100.0,535.18
buyer_2,Carmen,Lozano,1984-09-05,54021274R,carmen.lozano@cleverdev.app,959998,ES63209535234862100767,1682.49,2022-01-22T13:51:45,Zarautz,expenses,food,-74.93,460.25
buyer_2,Carmen,Lozano,1984-09-05,54021274R,carmen.lozano@cleverdev.app,959998,ES63209535234862100767,1682.49,2022-01-22T22:05:10,Zarautz,expenses,leisure,-59.3,400.95
buyer_2,Carmen,Lozano,1984-09-05,54021274R,carmen.lozano@cleverdev.app,959998,ES63209535234862100767,1682.49,2022-01-23T23:28:18,Zarautz,expenses,food,-114.8,286.15
buyer_2,Carmen,Lozano,1984-09-05,54021274R,carmen.lozano@cleverdev.app,959998,ES63209535234862100767,1682.49,2022-01-24T14:08:32,Zarautz,expenses,food,-81.08,205.07
buyer_2,Carmen,Lozano,1984-09-05,54021274R,carmen.lozano@cleverdev.app,959998,ES63209535234862100767,1682.49,2022-01-24T19:18:35,Zarautz,expenses,cash,-100.0,105.07
buyer_2,Carmen,Lozano,1984-09-05,54021274R,carmen.lozano@cleverdev.app,959998,ES63209535234862100767,1682.49,2022-01-26T08:38:51,Zarautz,expenses,cash,-100.0,5.07
buyer_2,Carmen,Lozano,1984-09-05,54021274R,carmen.lozano@cleverdev.app,959998,ES63209535234862100767,1682.49,2022-01-27T16:03:35,Zarautz,expenses,clothing,-79.98,-74.91
buyer_2,Carmen,Lozano,1984-09-05,54021274R,carmen.lozano@cleverdev.app,959998,ES63209535234862100767,1682.49,2022-01-27T09:39:04,Zarautz,expenses,repairs,-74.61,-149.52
buyer_2,Carmen,Lozano,1984-09-05,54021274R,carmen.lozano@cleverdev.app,959998,ES63209535234862100767,1682.49,2022-01-27T12:43:18,Zarautz,expenses,children,-289.9,-439.42
buyer_2,Carmen,Lozano,1984-09-05,54021274R,carmen.lozano@cleverdev.app,959998,ES63209535234862100767,1682.49,2022-01-29T19:57:46,Zarautz,expenses,travel,-507.45,-946.87
buyer_2,Carmen,Lozano,1984-09-05,54021274R,carmen.lozano@cleverdev.app,959998,ES63209535234862100767,1682.49,2022-01-30T19:35:55,Zarautz,expenses,leisure,-60.06,-1006.93
buyer_2,Carmen,Lozano,1984-09-05,54021274R,carmen.lozano@cleverdev.app,959998,ES63209535234862100767,1682.49,2022-01-30T17:24:20,Zarautz,expenses,clothing,-71.26,-1078.19
buyer_2,Carmen,Lozano,1984-09-05,54021274R,carmen.lozano@cleverdev.app,959998,ES63209535234862100767,1682.49,2022-01-30T11:05:05,Zarautz,expenses,travel,-515.45,-1593.64
buyer_2,Carmen,Lozano,1984-09-05,54021274R,carmen.lozano@cleverdev.app,959998,ES63209535234862100767,1682.49,2022-02-01T18:47:03,Zarautz,incomes,salary,2037.7,444.06
buyer_2,Carmen,Lozano,1984-09-05,54021274R,carmen.lozano@cleverdev.app,959998,ES63209535234862100767,1682.49,2022-02-02T11:46:22,Zarautz,expenses,food,-120.1,323.96
buyer_2,Carmen,Lozano,1984-09-05,54021274R,carmen.lozano@cleverdev.app,959998,ES63209535234862100767,1682.49,2022-02-02T23:11:58,Zarautz,expenses,clothing,-92.78,231.18
buyer_2,Carmen,Lozano,1984-09-05,54021274R,carmen.lozano@cleverdev.app,959998,ES63209535234862100767,1682.49,2022-02-02T13:42:30,Zarautz,expenses,gifts,-250.6,-19.42
buyer_2,Carmen,Lozano,1984-09-05,54021274R,carmen.lozano@cleverdev.app,959998,ES63209535234862100767,1682.49,2022-02-03T10:20:22,Zarautz,expenses,food,-98.07,-117.49
buyer_2,Carmen,Lozano,1984-09-05,54021274R,carmen.lozano@cleverdev.app,959998,ES63209535234862100767,1682.49,2022-02-03T14:24:53,Zarautz,expenses,transport,-43.62,-161.11
buyer_2,Carmen,Lozano,1984-09-05,54021274R,carmen.lozano@cleverdev.app,959998,ES63209535234862100767,1682.49,2022-02-03T05:41:29,Zarautz,expenses,leisure,-48.29,-209.4
buyer_2,Carmen,Lozano,1984-09-05,54021274R,carmen.lozano@cleverdev.app,959998,ES63209535234862100767,1682.49,2022-02-04T13:46:09,Zarautz,expenses,mortgage,-932.39,-1141.79
buyer_2,Carmen,Lozano,1984-09-05,54021274R,carmen.lozano@cleverdev.app,959998,ES63209535234862100767,1682.49,2022-02-05T04:19:54,Zarautz,expenses,cash,-100.0,-1241.79
buyer_2,Carmen,Lozano,1984-09-05,54021274R,carmen.lozano@cleverdev.app,959998,ES63209535234862100767,1682.49,2022-02-07T15:02:45,Zarautz,expenses,water,-22.96,-1264.75
buyer_2,Carmen,Lozano,1984-09-05,54021274R,carmen.lozano@cleverdev.app,959998,ES63209535234862100767,1682.49,2022-02-07T10:51:46,Zarautz,expenses,electricity,-36.53,-1301.28
buyer_2,Carmen,Lozano,1984-09-05,54021274R,carmen.lozano@cleverdev.app,959998,ES63209535234862100767,1682.49,2022-02-07T08:09:05,Zarautz,expenses,gas,-48.11,-1349.39
buyer_2,Carmen,Lozano,1984-09-05,54021274R,carmen.lozano@cleverdev.app,959998,ES63209535234862100767,1682.49,2022-02-07T10:42:50,Zarautz,expenses,transport,-49.14,-1398.53
buyer_2,Carmen,Lozano,1984-09-05,54021274R,carmen.lozano@cleverdev.app,959998,ES63209535234862100767,1682.49,2022-02-08T09:14:54,Zarautz,expenses,electricity,-84.48,-1483.01
buyer_2,Carmen,Lozano,1984-09-05,54021274R,carmen.lozano@cleverdev.app,959998,ES63209535234862100767,1682.49,2022-02-08T18:02:26,Zarautz,expenses,gas,-36.03,-1519.04
buyer_2,Carmen,Lozano,1984-09-05,54021274R,carmen.lozano@cleverdev.app,959998,ES63209535234862100767,1682.49,2022-02-08T22:47:43,Zarautz,expenses,internet,-42.79,-1561.83
buyer_2,Carmen,Lozano,1984-09-05,54021274R,carmen.lozano@cleverdev.app,959998,ES63209535234862100767,1682.49,2022-02-08T09:57:45,Zarautz,expenses,food,-106.19,-1668.02
buyer_2,Carmen,Lozano,1984-09-05,54021274R,carmen.lozano@cleverdev.app,959998,ES63209535234862100767,1682.49,2022-02-08T12:27:59,Zarautz,expenses,transport,-72.88,-1740.9
buyer_2,Carmen,Lozano,1984-09-05,54021274R,carmen.lozano@cleverdev.app,959998,ES63209535234862100767,1682.49,2022-02-09T12:17:47,Zarautz,expenses,cash,-100.0,-1840.9
buyer_2,Carmen,Lozano,1984-09-05,54021274R,carmen.lozano@cleverdev.app,959998,ES63209535234862100767,1682.49,2022-02-09T15:19:04,Zarautz,expenses,repairs,-203.3,-2044.2
buyer_2,Carmen,Lozano,1984-09-05,54021274R,carmen.lozano@cleverdev.app,959998,ES63209535234862100767,1682.49,2022-02-10T16:46:03,Zarautz,expenses,leisure,-55.59,-2099.79
buyer_2,Carmen,Lozano,1984-09-05,54021274R,carmen.lozano@cleverdev.app,959998,ES63209535234862100767,1682.49,2022-02-11T17:19:32,Zarautz,expenses,cash,-100.0,-2199.79
buyer_2,Carmen,Lozano,1984-09-05,54021274R,carmen.lozano@cleverdev.app,959998,ES63209535234862100767,1682.49,2022-02-11T22:12:30,Zarautz,expenses,repairs,-98.34,-2298.13
buyer_2,Carmen,Lozano,1984-09-05,54021274R,carmen.lozano@cleverdev.app,959998,ES63209535234862100767,1682.49,2022-02-12T22:50:34,Zarautz,expenses,transport,-83.26,-2381.39
buyer_2,Carmen,Lozano,1984-09-05,54021274R,carmen.lozano@cleverdev.app,959998,ES63209535234862100767,1682.49,2022-02-13T20:54:58,Zarautz,expenses,transport,-55.44,-2436.83
buyer_2,Carmen,Lozano,1984-09-05,54021274R,carmen.lozano@cleverdev.app,959998,ES63209535234862100767,1682.49,2022-02-13T08:28:51,Zarautz,expenses,leisure,-81.95,-2518.78
buyer_2,Carmen,Lozano,1984-09-05,54021274R,carmen.lozano@cleverdev.app,959998,ES63209535234862100767,1682.49,2022-02-14T18:08:48,Zarautz,expenses,leisure,-39.34,-2558.12
buyer_2,Carmen,Lozano,1984-09-05,54021274R,carmen.lozano@cleverdev.app,959998,ES63209535234862100767,1682.49,2022-02-17T17:52:06,Zarautz,expenses,cash,-100.0,-2658.12
buyer_2,Carmen,Lozano,1984-09-05,54021274R,carmen.lozano@cleverdev.app,959998,ES63209535234862100767,1682.49,2022-02-17T15:38:10,Zarautz,expenses,travel,-290.37,-2948.49
buyer_2,Carmen,Lozano,1984-09-05,54021274R,carmen.lozano@cleverdev.app,959998,ES63209535234862100767,1682.49,2022-02-18T14:56:33,Zarautz,expenses,leisure,-19.26,-2967.75
buyer_2,Carmen,Lozano,1984-09-05,54021274R,carmen.lozano@cleverdev.app,959998,ES63209535234862100767,1682.49,2022-02-18T09:31:49,Zarautz,expenses,gifts,-802.1,-3769.85
buyer_2,Carmen,Lozano,1984-09-05,54021274R,carmen.lozano@cleverdev.app,959998,ES63209535234862100767,1682.49,2022-02-19T21:29:02,Zarautz,expenses,food,-64.79,-3834.64
buyer_2,Carmen,Lozano,1984-09-05,54021274R,carmen.lozano@cleverdev.app,959998,ES63209535234862100767,1682.49,2022-02-19T01:54:20,Zarautz,expenses,gifts,-351.06,-4185.7
buyer_2,Carmen,Lozano,1984-09-05,54021274R,carmen.lozano@cleverdev.app,959998,ES63209535234862100767,1682.49,2022-02-20T02:44:27,Zarautz,expenses,clothing,-108.35,-4294.05
buyer_2,Carmen,Lozano,1984-09-05,54021274R,carmen.lozano@cleverdev.app,959998,ES63209535234862100767,1682.49,2022-02-24T17:14:00,Zarautz,expenses,food,-82.15,-4376.2
buyer_2,Carmen,Lozano,1984-09-05,54021274R,carmen.lozano@cleverdev.app,959998,ES63209535234862100767,1682.49,2022-02-24T14:46:04,Zarautz,expenses,transport,-62.36,-4438.56
buyer_2,Carmen,Lozano,1984-09-05,54021274R,carmen.lozano@cleverdev.app,959998,ES63209535234862100767,1682.49,2022-02-24T18:04:42,Zarautz,expenses,children,-192.63,-4631.19
buyer_2,Carmen,Lozano,1984-09-05,54021274R,carmen.lozano@cleverdev.app,959998,ES63209535234862100767,1682.49,2022-02-26T18:23:26,Zarautz,expenses,leisure,-57.08,-4688.27
buyer_2,Carmen,Lozano,1984-09-05,54021274R,carmen.lozano@cleverdev.app,959998,ES63209535234862100767,1682.49,2022-02-28T12:04:18,Zarautz,expenses,leisure,-59.23,-4747.5
buyer_2,Carmen,Lozano,1984-09-05,54021274R,carmen.lozano@cleverdev.app,959998,ES63209535234862100767,1682.49,2022-02-28T08:01:54,Zarautz,expenses,cash,-100.0,-4847.5
buyer_2,Carmen,Lozano,1984-09-05,54021274R,carmen.lozano@cleverdev.app,959998,ES63209535234862100767,1682.49,2022-03-01T10:26:17,Zarautz,incomes,salary,2037.7,-2809.8
buyer_2,Carmen,Lozano,1984-09-05,54021274R,carmen.lozano@cleverdev.app,959998,ES63209535234862100767,1682.49,2022-03-01T17:24:34,Zarautz,expenses,cash,-100.0,-2909.8
buyer_2,Carmen,Lozano,1984-09-05,54021274R,carmen.lozano@cleverdev.app,959998,ES63209535234862100767,1682.49,2022-03-01T16:02:19,Zarautz,expenses,travel,-328.16,-3237.96
buyer_2,Carmen,Lozano,1984-09-05,54021274R,carmen.lozano@cleverdev.app,959998,ES63209535234862100767,1682.49,2022-03-02T18:07:53,Zarautz,expenses,repairs,-125.86,-3363.82
buyer_2,Carmen,Lozano,1984-09-05,54021274R,carmen.lozano@cleverdev.app,959998,ES63209535234862100767,1682.49,2022-03-03T02:32:46,Zarautz,expenses,transport,-74.11,-3437.93
buyer_2,Carmen,Lozano,1984-09-05,54021274R,carmen.lozano@cleverdev.app,959998,ES63209535234862100767,1682.49,2022-03-03T14:45:04,Zarautz,expenses,healthcare,-108.43,-3546.36
buyer_2,Carmen,Lozano,1984-09-05,54021274R,carmen.lozano@cleverdev.app,959998,ES63209535234862100767,1682.49,2022-03-04T16:39:02,Zarautz,expenses,mortgage,-932.39,-4478.75
buyer_2,Carmen,Lozano,1984-09-05,54021274R,carmen.lozano@cleverdev.app,959998,ES63209535234862100767,1682.49,2022-03-04T09:22:05,Zarautz,expenses,children,-221.78,-4700.53
buyer_2,Carmen,Lozano,1984-09-05,54021274R,carmen.lozano@cleverdev.app,959998,ES63209535234862100767,1682.49,2022-03-05T03:55:59,Zarautz,expenses,internet,-42.79,-4743.32
buyer_2,Carmen,Lozano,1984-09-05,54021274R,carmen.lozano@cleverdev.app,959998,ES63209535234862100767,1682.49,2022-03-06T20:24:42,Zarautz,expenses,gas,-114.51,-4857.83
buyer_2,Carmen,Lozano,1984-09-05,54021274R,carmen.lozano@cleverdev.app,959998,ES63209535234862100767,1682.49,2022-03-06T22:56:54,Zarautz,expenses,internet,-42.79,-4900.62
buyer_2,Carmen,Lozano,1984-09-05,54021274R,carmen.lozano@cleverdev.app,959998,ES63209535234862100767,1682.49,2022-03-06T11:21:21,Zarautz,expenses,cash,-100.0,-5000.62
buyer_2,Carmen,Lozano,1984-09-05,54021274R,carmen.lozano@cleverdev.app,959998,ES63209535234862100767,1682.49,2022-03-07T10:33:27,Zarautz,expenses,electricity,-67.25,-5067.87
buyer_2,Carmen,Lozano,1984-09-05,54021274R,carmen.lozano@cleverdev.app,959998,ES63209535234862100767,1682.49,2022-03-07T13:00:29,Zarautz,expenses,internet,-42.79,-5110.66
buyer_2,Carmen,Lozano,1984-09-05,54021274R,carmen.lozano@cleverdev.app,959998,ES63209535234862100767,1682.49,2022-03-08T19:56:28,Zarautz,expenses,repairs,-247.2,-5357.86
buyer_2,Carmen,Lozano,1984-09-05,54021274R,carmen.lozano@cleverdev.app,959998,ES63209535234862100767,1682.49,2022-03-10T16:15:58,Zarautz,expenses,transport,-63.38,-5421.24
buyer_2,Carmen,Lozano,1984-09-05,54021274R,carmen.lozano@cleverdev.app,959998,ES63209535234862100767,1682.49,2022-03-11T05:46:08,Zarautz,expenses,leisure,-33.2,-5454.44
buyer_2,Carmen,Lozano,1984-09-05,54021274R,carmen.lozano@cleverdev.app,959998,ES63209535234862100767,1682.49,2022-03-12T13:11:12,Zarautz,expenses,education,-48.49,-5502.93
buyer_2,Carmen,Lozano,1984-09-05,54021274R,carmen.lozano@cleverdev.app,959998,ES63209535234862100767,1682.49,2022-03-13T19:38:56,Zarautz,expenses,cash,-100.0,-5602.93
buyer_2,Carmen,Lozano,1984-09-05,54021274R,carmen.lozano@cleverdev.app,959998,ES63209535234862100767,1682.49,2022-03-14T18:59:05,Zarautz,expenses,food,-84.32,-5687.25
buyer_2,Carmen,Lozano,1984-09-05,54021274R,carmen.lozano@cleverdev.app,959998,ES63209535234862100767,1682.49,2022-03-14T12:24:24,Zarautz,expenses,leisure,-40.77,-5728.02
buyer_2,Carmen,Lozano,1984-09-05,54021274R,carmen.lozano@cleverdev.app,959998,ES63209535234862100767,1682.49,2022-03-14T17:16:48,Zarautz,expenses,cash,-100.0,-5828.02
buyer_2,Carmen,Lozano,1984-09-05,54021274R,carmen.lozano@cleverdev.app,959998,ES63209535234862100767,1682.49,2022-03-15T08:33:36,Zarautz,expenses,food,-97.04,-5925.06
buyer_2,Carmen,Lozano,1984-09-05,54021274R,carmen.lozano@cleverdev.app,959998,ES63209535234862100767,1682.49,2022-03-15T14:20:26,Zarautz,expenses,transport,-74.77,-5999.83
buyer_2,Carmen,Lozano,1984-09-05,54021274R,carmen.lozano@cleverdev.app,959998,ES63209535234862100767,1682.49,2022-03-15T19:00:10,Zarautz,expenses,leisure,-34.1,-6033.93
buyer_2,Carmen,Lozano,1984-09-05,54021274R,carmen.lozano@cleverdev.app,959998,ES63209535234862100767,1682.49,2022-03-16T19:34:18,Zarautz,expenses,transport,-52.93,-6086.86
buyer_2,Carmen,Lozano,1984-09-05,54021274R,carmen.lozano@cleverdev.app,959998,ES63209535234862100767,1682.49,2022-03-16T15:07:32,Zarautz,expenses,cash,-100.0,-6186.86
buyer_2,Carmen,Lozano,1984-09-05,54021274R,carmen.lozano@cleverdev.app,959998,ES63209535234862100767,1682.49,2022-03-17T18:56:20,Zarautz,expenses,transport,-81.73,-6268.59
buyer_2,Carmen,Lozano,1984-09-05,54021274R,carmen.lozano@cleverdev.app,959998,ES63209535234862100767,1682.49,2022-03-18T17:29:25,Zarautz,expenses,food,-82.81,-6351.4
buyer_2,Carmen,Lozano,1984-09-05,54021274R,carmen.lozano@cleverdev.app,959998,ES63209535234862100767,1682.49,2022-03-20T10:06:02,Zarautz,expenses,leisure,-32.6,-6384.0
buyer_2,Carmen,Lozano,1984-09-05,54021274R,carmen.lozano@cleverdev.app,959998,ES63209535234862100767,1682.49,2022-03-23T09:02:19,Zarautz,expenses,food,-68.7,-6452.7
buyer_2,Carmen,Lozano,1984-09-05,54021274R,carmen.lozano@cleverdev.app,959998,ES63209535234862100767,1682.49,2022-03-25T16:25:15,Zarautz,expenses,food,-113.81,-6566.51
buyer_2,Carmen,Lozano,1984-09-05,54021274R,carmen.lozano@cleverdev.app,959998,ES63209535234862100767,1682.49,2022-03-25T20:45:26,Zarautz,expenses,cash,-100.0,-6666.51
buyer_2,Carmen,Lozano,1984-09-05,54021274R,carmen.lozano@cleverdev.app,959998,ES63209535234862100767,1682.49,2022-03-26T18:27:39,Zarautz,expenses,education,-78.82,-6745.33
buyer_2,Carmen,Lozano,1984-09-05,54021274R,carmen.lozano@cleverdev.app,959998,ES63209535234862100767,1682.49,2022-03-27T18:54:35,Zarautz,expenses,food,-117.37,-6862.7
buyer_2,Carmen,Lozano,1984-09-05,54021274R,carmen.lozano@cleverdev.app,959998,ES63209535234862100767,1682.49,2022-03-27T18:20:53,Zarautz,expenses,cash,-100.0,-6962.7
buyer_2,Carmen,Lozano,1984-09-05,54021274R,carmen.lozano@cleverdev.app,959998,ES63209535234862100767,1682.49,2022-03-28T15:04:38,Zarautz,expenses,repairs,-84.49,-7047.19
buyer_2,Carmen,Lozano,1984-09-05,54021274R,carmen.lozano@cleverdev.app,959998,ES63209535234862100767,1682.49,2022-03-29T13:35:21,Zarautz,expenses,leisure,-74.07,-7121.26
buyer_2,Carmen,Lozano,1984-09-05,54021274R,carmen.lozano@cleverdev.app,959998,ES63209535234862100767,1682.49,2022-03-29T08:28:34,Zarautz,expenses,children,-199.21,-7320.47
buyer_2,Carmen,Lozano,1984-09-05,54021274R,carmen.lozano@cleverdev.app,959998,ES63209535234862100767,1682.49,2022-03-31T19:49:22,Zarautz,expenses,food,-101.53,-7422.0
buyer_2,Carmen,Lozano,1984-09-05,54021274R,carmen.lozano@cleverdev.app,959998,ES63209535234862100767,1682.49,2022-03-31T15:01:28,Zarautz,expenses,appliances,-375.39,-7797.39
buyer_2,Carmen,Lozano,1984-09-05,54021274R,carmen.lozano@cleverdev.app,959998,ES63209535234862100767,1682.49,2022-04-01T19:28:19,Zarautz,incomes,salary,2037.7,-5759.69
buyer_2,Carmen,Lozano,1984-09-05,54021274R,carmen.lozano@cleverdev.app,959998,ES63209535234862100767,1682.49,2022-04-01T19:28:19,Zarautz,incomes,extra_income,358.06,-5401.63
buyer_2,Carmen,Lozano,1984-09-05,54021274R,carmen.lozano@cleverdev.app,959998,ES63209535234862100767,1682.49,2022-04-01T13:11:18,Zarautz,expenses,food,-107.23,-5508.86
buyer_2,Carmen,Lozano,1984-09-05,54021274R,carmen.lozano@cleverdev.app,959998,ES63209535234862100767,1682.49,2022-04-01T20:46:54,Zarautz,expenses,healthcare,-148.24,-5657.1
buyer_2,Carmen,Lozano,1984-09-05,54021274R,carmen.lozano@cleverdev.app,959998,ES63209535234862100767,1682.49,2022-04-01T16:50:18,Zarautz,expenses,gifts,-290.77,-5947.87
buyer_2,Carmen,Lozano,1984-09-05,54021274R,carmen.lozano@cleverdev.app,959998,ES63209535234862100767,1682.49,2022-04-03T08:17:35,Zarautz,expenses,cash,-100.0,-6047.87
buyer_2,Carmen,Lozano,1984-09-05,54021274R,carmen.lozano@cleverdev.app,959998,ES63209535234862100767,1682.49,2022-04-04T09:28:33,Zarautz,expenses,mortgage,-932.39,-6980.26
buyer_2,Carmen,Lozano,1984-09-05,54021274R,carmen.lozano@cleverdev.app,959998,ES63209535234862100767,1682.49,2022-04-05T13:42:13,Zarautz,expenses,electricity,-69.96,-7050.22
buyer_2,Carmen,Lozano,1984-09-05,54021274R,carmen.lozano@cleverdev.app,959998,ES63209535234862100767,1682.49,2022-04-05T13:53:14,Zarautz,expenses,gas,-85.97,-7136.19
buyer_2,Carmen,Lozano,1984-09-05,54021274R,carmen.lozano@cleverdev.app,959998,ES63209535234862100767,1682.49,2022-04-06T18:17:26,Zarautz,expenses,electricity,-74.46,-7210.65
buyer_2,Carmen,Lozano,1984-09-05,54021274R,carmen.lozano@cleverdev.app,959998,ES63209535234862100767,1682.49,2022-04-06T12:15:45,Zarautz,expenses,cash,-100.0,-7310.65
buyer_2,Carmen,Lozano,1984-09-05,54021274R,carmen.lozano@cleverdev.app,959998,ES63209535234862100767,1682.49,2022-04-07T11:32:57,Zarautz,expenses,phone,-31.33,-7341.98
buyer_2,Carmen,Lozano,1984-09-05,54021274R,carmen.lozano@cleverdev.app,959998,ES63209535234862100767,1682.49,2022-04-08T20:05:32,Zarautz,expenses,electricity,-47.48,-7389.46
buyer_2,Carmen,Lozano,1984-09-05,54021274R,carmen.lozano@cleverdev.app,959998,ES63209535234862100767,1682.49,2022-04-10T15:21:17,Zarautz,expenses,food,-120.31,-7509.77
buyer_2,Carmen,Lozano,1984-09-05,54021274R,carmen.lozano@cleverdev.app,959998,ES63209535234862100767,1682.49,2022-04-10T10:28:45,Zarautz,expenses,cash,-100.0,-7609.77
buyer_2,Carmen,Lozano,1984-09-05,54021274R,carmen.lozano@cleverdev.app,959998,ES63209535234862100767,1682.49,2022-04-11T18:07:17,Zarautz,expenses,transport,-70.38,-7680.15
buyer_2,Carmen,Lozano,1984-09-05,54021274R,carmen.lozano@cleverdev.app,959998,ES63209535234862100767,1682.49,2022-04-11T14:12:01,Zarautz,expenses,healthcare,-109.42,-7789.57
buyer_2,Carmen,Lozano,1984-09-05,54021274R,carmen.lozano@cleverdev.app,959998,ES63209535234862100767,1682.49,2022-04-11T13:15:09,Zarautz,expenses,children,-419.25,-8208.82
buyer_2,Carmen,Lozano,1984-09-05,54021274R,carmen.lozano@cleverdev.app,959998,ES63209535234862100767,1682.49,2022-04-13T15:41:53,Zarautz,expenses,leisure,-32.05,-8240.87
buyer_2,Carmen,Lozano,1984-09-05,54021274R,carmen.lozano@cleverdev.app,959998,ES63209535234862100767,1682.49,2022-04-14T11:05:08,Zarautz,expenses,transport,-59.88,-8300.75
buyer_2,Carmen,Lozano,1984-09-05,54021274R,carmen.lozano@cleverdev.app,959998,ES63209535234862100767,1682.49,2022-04-15T01:57:59,Zarautz,expenses,appliances,-202.16,-8502.91
buyer_2,Carmen,Lozano,1984-09-05,54021274R,carmen.lozano@cleverdev.app,959998,ES63209535234862100767,1682.49,2022-04-16T13:08:01,Zarautz,expenses,clothing,-134.06,-8636.97
buyer_2,Carmen,Lozano,1984-09-05,54021274R,carmen.lozano@cleverdev.app,959998,ES63209535234862100767,1682.49,2022-04-17T08:34:39,Zarautz,expenses,food,-122.66,-8759.63
buyer_2,Carmen,Lozano,1984-09-05,54021274R,carmen.lozano@cleverdev.app,959998,ES63209535234862100767,1682.49,2022-04-18T13:08:09,Zarautz,expenses,food,-75.93,-8835.56
buyer_2,Carmen,Lozano,1984-09-05,54021274R,carmen.lozano@cleverdev.app,959998,ES63209535234862100767,1682.49,2022-04-20T10:21:20,Zarautz,expenses,leisure,-34.51,-8870.07
buyer_2,Carmen,Lozano,1984-09-05,54021274R,carmen.lozano@cleverdev.app,959998,ES63209535234862100767,1682.49,2022-04-22T20:01:16,Zarautz,expenses,children,-231.4,-9101.47
buyer_2,Carmen,Lozano,1984-09-05,54021274R,carmen.lozano@cleverdev.app,959998,ES63209535234862100767,1682.49,2022-04-24T15:56:45,Zarautz,expenses,leisure,-30.56,-9132.03
buyer_2,Carmen,Lozano,1984-09-05,54021274R,carmen.lozano@cleverdev.app,959998,ES63209535234862100767,1682.49,2022-04-25T14:17:50,Zarautz,expenses,transport,-63.72,-9195.75
buyer_2,Carmen,Lozano,1984-09-05,54021274R,carmen.lozano@cleverdev.app,959998,ES63209535234862100767,1682.49,2022-04-25T18:42:09,Zarautz,expenses,cash,-100.0,-9295.75
buyer_2,Carmen,Lozano,1984-09-05,54021274R,carmen.lozano@cleverdev.app,959998,ES63209535234862100767,1682.49,2022-04-25T13:01:05,Zarautz,expenses,repairs,-132.24,-9427.99
buyer_2,Carmen,Lozano,1984-09-05,54021274R,carmen.lozano@cleverdev.app,959998,ES63209535234862100767,1682.49,2022-04-27T09:26:21,Zarautz,expenses,transport,-48.13,-9476.12
buyer_2,Carmen,Lozano,1984-09-05,54021274R,carmen.lozano@cleverdev.app,959998,ES63209535234862100767,1682.49,2022-04-29T13:44:38,Zarautz,expenses,food,-118.17,-9594.29
buyer_2,Carmen,Lozano,1984-09-05,54021274R,carmen.lozano@cleverdev.app,959998,ES63209535234862100767,1682.49,2022-04-30T07:58:17,Zarautz,expenses,leisure,-43.58,-9637.87
buyer_2,Carmen,Lozano,1984-09-05,54021274R,carmen.lozano@cleverdev.app,959998,ES63209535234862100767,1682.49,2022-04-30T09:08:03,Zarautz,expenses,cash,-100.0,-9737.87
buyer_2,Carmen,Lozano,1984-09-05,54021274R,carmen.lozano@cleverdev.app,959998,ES63209535234862100767,1682.49,2022-05-01T20:50:04,Zarautz,incomes,salary,2037.7,-7700.17
buyer_2,Carmen,Lozano,1984-09-05,54021274R,carmen.lozano@cleverdev.app,959998,ES63209535234862100767,1682.49,2022-05-01T22:36:49,Zarautz,expenses,cash,-100.0,-7800.17
buyer_2,Carmen,Lozano,1984-09-05,54021274R,carmen.lozano@cleverdev.app,959998,ES63209535234862100767,1682.49,2022-05-02T15:44:12,Zarautz,expenses,food,-66.28,-7866.45
buyer_2,Carmen,Lozano,1984-09-05,54021274R,carmen.lozano@cleverdev.app,959998,ES63209535234862100767,1682.49,2022-05-04T09:20:06,Zarautz,expenses,mortgage,-932.39,-8798.84
buyer_2,Carmen,Lozano,1984-09-05,54021274R,carmen.lozano@cleverdev.app,959998,ES63209535234862100767,1682.49,2022-05-05T09:30:18,Zarautz,expenses,water,-31.66,-8830.5
buyer_2,Carmen,Lozano,1984-09-05,54021274R,carmen.lozano@cleverdev.app,959998,ES63209535234862100767,1682.49,2022-05-05T12:32:20,Zarautz,expenses,phone,-35.28,-8865.78
buyer_2,Carmen,Lozano,1984-09-05,54021274R,carmen.lozano@cleverdev.app,959998,ES63209535234862100767,1682.49,2022-05-05T20:52:12,Zarautz,expenses,healthcare,-82.72,-8948.5
buyer_2,Carmen,Lozano,1984-09-05,54021274R,carmen.lozano@cleverdev.app,959998,ES63209535234862100767,1682.49,2022-05-05T09:19:10,Zarautz,expenses,cash,-100.0,-9048.5
buyer_2,Carmen,Lozano,1984-09-05,54021274R,carmen.lozano@cleverdev.app,959998,ES63209535234862100767,1682.49,2022-05-07T18:21:52,Zarautz,expenses,water,-34.83,-9083.33
buyer_2,Carmen,Lozano,1984-09-05,54021274R,carmen.lozano@cleverdev.app,959998,ES63209535234862100767,1682.49,2022-05-07T09:57:52,Zarautz,expenses,gas,-107.31,-9190.64
buyer_2,Carmen,Lozano,1984-09-05,54021274R,carmen.lozano@cleverdev.app,959998,ES63209535234862100767,1682.49,2022-05-08T17:09:08,Zarautz,expenses,gifts,-97.08,-9287.72
buyer_2,Carmen,Lozano,1984-09-05,54021274R,carmen.lozano@cleverdev.app,959998,ES63209535234862100767,1682.49,2022-05-09T19:12:33,Zarautz,expenses,cash,-100.0,-9387.72
buyer_2,Carmen,Lozano,1984-09-05,54021274R,carmen.lozano@cleverdev.app,959998,ES63209535234862100767,1682.49,2022-05-09T07:29:21,Zarautz,expenses,repairs,-220.44,-9608.16
buyer_2,Carmen,Lozano,1984-09-05,54021274R,carmen.lozano@cleverdev.app,959998,ES63209535234862100767,1682.49,2022-05-11T05:28:07,Zarautz,expenses,repairs,-288.96,-9897.12
buyer_2,Carmen,Lozano,1984-09-05,54021274R,carmen.lozano@cleverdev.app,959998,ES63209535234862100767,1682.49,2022-05-13T18:11:22,Zarautz,expenses,cash,-100.0,-9997.12
buyer_2,Carmen,Lozano,1984-09-05,54021274R,carmen.lozano@cleverdev.app,959998,ES63209535234862100767,1682.49,2022-05-13T14:54:44,Zarautz,expenses,repairs,-210.7,-10207.82
buyer_2,Carmen,Lozano,1984-09-05,54021274R,carmen.lozano@cleverdev.app,959998,ES63209535234862100767,1682.49,2022-05-15T10:09:52,Zarautz,expenses,food,-108.62,-10316.44
buyer_2,Carmen,Lozano,1984-09-05,54021274R,carmen.lozano@cleverdev.app,959998,ES63209535234862100767,1682.49,2022-05-16T17:28:21,Zarautz,expenses,cash,-100.0,-10416.44
buyer_2,Carmen,Lozano,1984-09-05,54021274R,carmen.lozano@cleverdev.app,959998,ES63209535234862100767,1682.49,2022-05-17T09:25:12,Zarautz,expenses,leisure,-25.61,-10442.05
buyer_2,Carmen,Lozano,1984-09-05,54021274R,carmen.lozano@cleverdev.app,959998,ES63209535234862100767,1682.49,2022-05-17T15:52:52,Zarautz,expenses,clothing,-139.23,-10581.28
buyer_2,Carmen,Lozano,1984-09-05,54021274R,carmen.lozano@cleverdev.app,959998,ES63209535234862100767,1682.49,2022-05-17T09:47:28,Zarautz,expenses,healthcare,-170.37,-10751.65
buyer_2,Carmen,Lozano,1984-09-05,54021274R,carmen.lozano@cleverdev.app,959998,ES63209535234862100767,1682.49,2022-05-17T19:27:36,Zarautz,expenses,cash,-100.0,-10851.65
buyer_2,Carmen,Lozano,1984-09-05,54021274R,carmen.lozano@cleverdev.app,959998,ES63209535234862100767,1682.49,2022-05-17T19:43:13,Zarautz,expenses,repairs,-217.34,-11068.99
buyer_2,Carmen,Lozano,1984-09-05,54021274R,carmen.lozano@cleverdev.app,959998,ES63209535234862100767,1682.49,2022-05-18T11:45:28,Zarautz,expenses,cash,-100.0,-11168.99
buyer_2,Carmen,Lozano,1984-09-05,54021274R,carmen.lozano@cleverdev.app,959998,ES63209535234862100767,1682.49,2022-05-18T14:32:51,Zarautz,expenses,appliances,-280.87,-11449.86
buyer_2,Carmen,Lozano,1984-09-05,54021274R,carmen.lozano@cleverdev.app,959998,ES63209535234862100767,1682.49,2022-05-20T20:26:46,Zarautz,expenses,gifts,-126.02,-11575.88
buyer_2,Carmen,Lozano,1984-09-05,54021274R,carmen.lozano@cleverdev.app,959998,ES63209535234862100767,1682.49,2022-05-21T11:19:15,Zarautz,expenses,leisure,-47.81,-11623.69
buyer_2,Carmen,Lozano,1984-09-05,54021274R,carmen.lozano@cleverdev.app,959998,ES63209535234862100767,1682.49,2022-05-22T18:11:11,Zarautz,expenses,education,-66.79,-11690.48
buyer_2,Carmen,Lozano,1984-09-05,54021274R,carmen.lozano@cleverdev.app,959998,ES63209535234862100767,1682.49,2022-05-22T09:16:09,Zarautz,expenses,cash,-100.0,-11790.48
buyer_2,Carmen,Lozano,1984-09-05,54021274R,carmen.lozano@cleverdev.app,959998,ES63209535234862100767,1682.49,2022-05-23T18:39:06,Zarautz,expenses,transport,-89.82,-11880.3
buyer_2,Carmen,Lozano,1984-09-05,54021274R,carmen.lozano@cleverdev.app,959998,ES63209535234862100767,1682.49,2022-05-24T21:08:24,Zarautz,expenses,cash,-100.0,-11980.3
buyer_2,Carmen,Lozano,1984-09-05,54021274R,carmen.lozano@cleverdev.app,959998,ES63209535234862100767,1682.49,2022-05-26T10:11:48,Zarautz,expenses,education,-51.28,-12031.58
buyer_2,Carmen,Lozano,1984-09-05,54021274R,carmen.lozano@cleverdev.app,959998,ES63209535234862100767,1682.49,2022-05-27T19:08:18,Zarautz,expenses,food,-86.19,-12117.77
buyer_2,Carmen,Lozano,1984-09-05,54021274R,carmen.lozano@cleverdev.app,959998,ES63209535234862100767,1682.49,2022-05-28T11:00:45,Zarautz,expenses,food,-72.48,-12190.25
buyer_2,Carmen,Lozano,1984-09-05,54021274R,carmen.lozano@cleverdev.app,959998,ES63209535234862100767,1682.49,2022-05-30T14:29:49,Zarautz,expenses,repairs,-72.4,-12262.65
buyer_2,Carmen,Lozano,1984-09-05,54021274R,carmen.lozano@cleverdev.app,959998,ES63209535234862100767,1682.49,2022-06-01T14:07:55,Zarautz,incomes,salary,2037.7,-10224.95
buyer_2,Carmen,Lozano,1984-09-05,54021274R,carmen.lozano@cleverdev.app,959998,ES63209535234862100767,1682.49,2022-06-01T14:07:55,Zarautz,incomes,salary_bonus,1620.98,-8603.97
buyer_2,Carmen,Lozano,1984-09-05,54021274R,carmen.lozano@cleverdev.app,959998,ES63209535234862100767,1682.49,2022-06-01T13:46:46,Zarautz,expenses,taxes,-1533.16,-10137.13
buyer_2,Carmen,Lozano,1984-09-05,54021274R,carmen.lozano@cleverdev.app,959998,ES63209535234862100767,1682.49,2022-06-01T18:35:00,Zarautz,expenses,insurance,-481.8,-10618.93
buyer_2,Carmen,Lozano,1984-09-05,54021274R,carmen.lozano@cleverdev.app,959998,ES63209535234862100767,1682.49,2022-06-04T17:32:40,Zarautz,expenses,mortgage,-932.39,-11551.32
buyer_2,Carmen,Lozano,1984-09-05,54021274R,carmen.lozano@cleverdev.app,959998,ES63209535234862100767,1682.49,2022-06-04T23:26:00,Zarautz,expenses,transport,-70.49,-11621.81
buyer_2,Carmen,Lozano,1984-09-05,54021274R,carmen.lozano@cleverdev.app,959998,ES63209535234862100767,1682.49,2022-06-04T15:49:36,Zarautz,expenses,cash,-100.0,-11721.81
buyer_2,Carmen,Lozano,1984-09-05,54021274R,carmen.lozano@cleverdev.app,959998,ES63209535234862100767,1682.49,2022-06-05T19:52:10,Zarautz,expenses,internet,-42.79,-11764.6
buyer_2,Carmen,Lozano,1984-09-05,54021274R,carmen.lozano@cleverdev.app,959998,ES63209535234862100767,1682.49,2022-06-05T14:33:20,Zarautz,expenses,transport,-73.09,-11837.69
buyer_2,Carmen,Lozano,1984-09-05,54021274R,carmen.lozano@cleverdev.app,959998,ES63209535234862100767,1682.49,2022-06-06T13:55:18,Zarautz,expenses,gas,-57.28,-11894.97
buyer_2,Carmen,Lozano,1984-09-05,54021274R,carmen.lozano@cleverdev.app,959998,ES63209535234862100767,1682.49,2022-06-06T19:35:19,Zarautz,expenses,phone,-36.25,-11931.22
buyer_2,Carmen,Lozano,1984-09-05,54021274R,carmen.lozano@cleverdev.app,959998,ES63209535234862100767,1682.49,2022-06-07T07:46:29,Zarautz,expenses,internet,-42.79,-11974.01
buyer_2,Carmen,Lozano,1984-09-05,54021274R,carmen.lozano@cleverdev.app,959998,ES63209535234862100767,1682.49,2022-06-07T13:20:06,Zarautz,expenses,transport,-60.87,-12034.88
buyer_2,Carmen,Lozano,1984-09-05,54021274R,carmen.lozano@cleverdev.app,959998,ES63209535234862100767,1682.49,2022-06-07T15:37:47,Zarautz,expenses,cash,-100.0,-12134.88
buyer_2,Carmen,Lozano,1984-09-05,54021274R,carmen.lozano@cleverdev.app,959998,ES63209535234862100767,1682.49,2022-06-08T09:17:33,Zarautz,expenses,electricity,-37.34,-12172.22
buyer_2,Carmen,Lozano,1984-09-05,54021274R,carmen.lozano@cleverdev.app,959998,ES63209535234862100767,1682.49,2022-06-09T21:19:36,Zarautz,expenses,travel,-757.14,-12929.36
buyer_2,Carmen,Lozano,1984-09-05,54021274R,carmen.lozano@cleverdev.app,959998,ES63209535234862100767,1682.49,2022-06-11T16:12:24,Zarautz,expenses,repairs,-225.81,-13155.17
buyer_2,Carmen,Lozano,1984-09-05,54021274R,carmen.lozano@cleverdev.app,959998,ES63209535234862100767,1682.49,2022-06-12T13:03:02,Zarautz,expenses,transport,-83.5,-13238.67
buyer_2,Carmen,Lozano,1984-09-05,54021274R,carmen.lozano@cleverdev.app,959998,ES63209535234862100767,1682.49,2022-06-12T20:27:20,Zarautz,expenses,leisure,-58.05,-13296.72
buyer_2,Carmen,Lozano,1984-09-05,54021274R,carmen.lozano@cleverdev.app,959998,ES63209535234862100767,1682.49,2022-06-12T18:52:45,Zarautz,expenses,children,-569.76,-13866.48
buyer_2,Carmen,Lozano,1984-09-05,54021274R,carmen.lozano@cleverdev.app,959998,ES63209535234862100767,1682.49,2022-06-13T23:48:17,Zarautz,expenses,healthcare,-170.65,-14037.13
buyer_2,Carmen,Lozano,1984-09-05,54021274R,carmen.lozano@cleverdev.app,959998,ES63209535234862100767,1682.49,2022-06-14T15:31:04,Zarautz,expenses,children,-512.67,-14549.8
buyer_2,Carmen,Lozano,1984-09-05,54021274R,carmen.lozano@cleverdev.app,959998,ES63209535234862100767,1682.49,2022-06-15T15:49:49,Zarautz,expenses,food,-75.65,-14625.45
buyer_2,Carmen,Lozano,1984-09-05,54021274R,carmen.lozano@cleverdev.app,959998,ES63209535234862100767,1682.49,2022-06-15T09:35:49,Zarautz,expenses,healthcare,-55.91,-14681.36
buyer_2,Carmen,Lozano,1984-09-05,54021274R,carmen.lozano@cleverdev.app,959998,ES63209535234862100767,1682.49,2022-06-15T10:58:13,Zarautz,expenses,cash,-100.0,-14781.36
buyer_2,Carmen,Lozano,1984-09-05,54021274R,carmen.lozano@cleverdev.app,959998,ES63209535234862100767,1682.49,2022-06-16T19:37:12,Zarautz,expenses,clothing,-114.42,-14895.78
buyer_2,Carmen,Lozano,1984-09-05,54021274R,carmen.lozano@cleverdev.app,959998,ES63209535234862100767,1682.49,2022-06-17T01:22:05,Zarautz,expenses,food,-97.1,-14992.88
buyer_2,Carmen,Lozano,1984-09-05,54021274R,carmen.lozano@cleverdev.app,959998,ES63209535234862100767,1682.49,2022-06-19T09:54:36,Zarautz,expenses,leisure,-44.51,-15037.39
buyer_2,Carmen,Lozano,1984-09-05,54021274R,carmen.lozano@cleverdev.app,959998,ES63209535234862100767,1682.49,2022-06-20T10:47:02,Zarautz,expenses,gifts,-635.75,-15673.14
buyer_2,Carmen,Lozano,1984-09-05,54021274R,carmen.lozano@cleverdev.app,959998,ES63209535234862100767,1682.49,2022-06-25T12:27:05,Zarautz,expenses,food,-116.65,-15789.79
buyer_2,Carmen,Lozano,1984-09-05,54021274R,carmen.lozano@cleverdev.app,959998,ES63209535234862100767,1682.49,2022-06-25T04:21:23,Zarautz,expenses,cash,-100.0,-15889.79
buyer_2,Carmen,Lozano,1984-09-05,54021274R,carmen.lozano@cleverdev.app,959998,ES63209535234862100767,1682.49,2022-06-26T19:18:24,Zarautz,expenses,repairs,-242.23,-16132.02
buyer_2,Carmen,Lozano,1984-09-05,54021274R,carmen.lozano@cleverdev.app,959998,ES63209535234862100767,1682.49,2022-06-27T15:51:46,Zarautz,expenses,food,-78.27,-16210.29
buyer_2,Carmen,Lozano,1984-09-05,54021274R,carmen.lozano@cleverdev.app,959998,ES63209535234862100767,1682.49,2022-06-29T21:29:14,Zarautz,expenses,appliances,-392.21,-16602.5
buyer_2,Carmen,Lozano,1984-09-05,54021274R,carmen.lozano@cleverdev.app,959998,ES63209535234862100767,1682.49,2022-06-29T20:05:13,Zarautz,expenses,gifts,-137.45,-16739.95
buyer_2,Carmen,Lozano,1984-09-05,54021274R,carmen.lozano@cleverdev.app,959998,ES63209535234862100767,1682.49,2022-07-01T12:19:21,Zarautz,incomes,salary,2037.7,-14702.25
buyer_2,Carmen,Lozano,1984-09-05,54021274R,carmen.lozano@cleverdev.app,959998,ES63209535234862100767,1682.49,2022-07-01T01:16:03,Zarautz,expenses,cash,-100.0,-14802.25
buyer_2,Carmen,Lozano,1984-09-05,54021274R,carmen.lozano@cleverdev.app,959998,ES63209535234862100767,1682.49,2022-07-03T11:26:41,Zarautz,expenses,repairs,-329.69,-15131.94
buyer_2,Carmen,Lozano,1984-09-05,54021274R,carmen.lozano@cleverdev.app,959998,ES63209535234862100767,1682.49,2022-07-03T08:42:25,Zarautz,expenses,gifts,-64.22,-15196.16
buyer_2,Carmen,Lozano,1984-09-05,54021274R,carmen.lozano@cleverdev.app,959998,ES63209535234862100767,1682.49,2022-07-04T05:56:08,Zarautz,expenses,mortgage,-932.39,-16128.55
buyer_2,Carmen,Lozano,1984-09-05,54021274R,carmen.lozano@cleverdev.app,959998,ES63209535234862100767,1682.49,2022-07-04T14:45:05,Zarautz,expenses,education,-44.23,-16172.78
buyer_2,Carmen,Lozano,1984-09-05,54021274R,carmen.lozano@cleverdev.app,959998,ES63209535234862100767,1682.49,2022-07-04T11:54:50,Zarautz,expenses,gifts,-670.6,-16843.38
buyer_2,Carmen,Lozano,1984-09-05,54021274R,carmen.lozano@cleverdev.app,959998,ES63209535234862100767,1682.49,2022-07-06T08:34:51,Zarautz,expenses,internet,-42.79,-16886.17
buyer_2,Carmen,Lozano,1984-09-05,54021274R,carmen.lozano@cleverdev.app,959998,ES63209535234862100767,1682.49,2022-07-06T12:16:20,Zarautz,expenses,cash,-100.0,-16986.17
buyer_2,Carmen,Lozano,1984-09-05,54021274R,carmen.lozano@cleverdev.app,959998,ES63209535234862100767,1682.49,2022-07-07T13:31:24,Zarautz,expenses,gas,-99.56,-17085.73
buyer_2,Carmen,Lozano,1984-09-05,54021274R,carmen.lozano@cleverdev.app,959998,ES63209535234862100767,1682.49,2022-07-07T09:58:37,Zarautz,expenses,phone,-34.39,-17120.12
buyer_2,Carmen,Lozano,1984-09-05,54021274R,carmen.lozano@cleverdev.app,959998,ES63209535234862100767,1682.49,2022-07-08T23:16:14,Zarautz,expenses,internet,-42.79,-17162.91
buyer_2,Carmen,Lozano,1984-09-05,54021274R,carmen.lozano@cleverdev.app,959998,ES63209535234862100767,1682.49,2022-07-08T15:41:18,Zarautz,expenses,phone,-36.03,-17198.94
buyer_2,Carmen,Lozano,1984-09-05,54021274R,carmen.lozano@cleverdev.app,959998,ES63209535234862100767,1682.49,2022-07-08T20:35:21,Zarautz,expenses,leisure,-71.85,-17270.79
buyer_2,Carmen,Lozano,1984-09-05,54021274R,carmen.lozano@cleverdev.app,959998,ES63209535234862100767,1682.49,2022-07-08T09:10:40,Zarautz,expenses,education,-49.36,-17320.15
buyer_2,Carmen,Lozano,1984-09-05,54021274R,carmen.lozano@cleverdev.app,959998,ES63209535234862100767,1682.49,2022-07-08T13:50:03,Zarautz,expenses,cash,-100.0,-17420.15
buyer_2,Carmen,Lozano,1984-09-05,54021274R,carmen.lozano@cleverdev.app,959998,ES63209535234862100767,1682.49,2022-07-08T20:14:52,Zarautz,expenses,gifts,-197.82,-17617.97
buyer_2,Carmen,Lozano,1984-09-05,54021274R,carmen.lozano@cleverdev.app,959998,ES63209535234862100767,1682.49,2022-07-09T14:14:17,Zarautz,expenses,leisure,-66.02,-17683.99
buyer_2,Carmen,Lozano,1984-09-05,54021274R,carmen.lozano@cleverdev.app,959998,ES63209535234862100767,1682.49,2022-07-09T15:28:00,Zarautz,expenses,education,-74.26,-17758.25
buyer_2,Carmen,Lozano,1984-09-05,54021274R,carmen.lozano@cleverdev.app,959998,ES63209535234862100767,1682.49,2022-07-10T15:22:18,Zarautz,expenses,leisure,-70.56,-17828.81
buyer_2,Carmen,Lozano,1984-09-05,54021274R,carmen.lozano@cleverdev.app,959998,ES63209535234862100767,1682.49,2022-07-13T13:00:20,Zarautz,expenses,healthcare,-43.34,-17872.15
buyer_2,Carmen,Lozano,1984-09-05,54021274R,carmen.lozano@cleverdev.app,959998,ES63209535234862100767,1682.49,2022-07-14T10:59:50,Zarautz,expenses,transport,-84.58,-17956.73
buyer_2,Carmen,Lozano,1984-09-05,54021274R,carmen.lozano@cleverdev.app,959998,ES63209535234862100767,1682.49,2022-07-14T00:20:09,Zarautz,expenses,cash,-100.0,-18056.73
buyer_2,Carmen,Lozano,1984-09-05,54021274R,carmen.lozano@cleverdev.app,959998,ES63209535234862100767,1682.49,2022-07-15T07:29:30,Zarautz,expenses,leisure,-48.89,-18105.62
buyer_2,Carmen,Lozano,1984-09-05,54021274R,carmen.lozano@cleverdev.app,959998,ES63209535234862100767,1682.49,2022-07-16T15:29:16,Zarautz,expenses,leisure,-20.17,-18125.79
buyer_2,Carmen,Lozano,1984-09-05,54021274R,carmen.lozano@cleverdev.app,959998,ES63209535234862100767,1682.49,2022-07-17T12:10:47,Zarautz,expenses,children,-657.77,-18783.56
buyer_2,Carmen,Lozano,1984-09-05,54021274R,carmen.lozano@cleverdev.app,959998,ES63209535234862100767,1682.49,2022-07-18T11:53:18,Zarautz,expenses,food,-63.89,-18847.45
buyer_2,Carmen,Lozano,1984-09-05,54021274R,carmen.lozano@cleverdev.app,959998,ES63209535234862100767,1682.49,2022-07-18T00:24:48,Zarautz,expenses,transport,-45.81,-18893.26
buyer_2,Carmen,Lozano,1984-09-05,54021274R,carmen.lozano@cleverdev.app,959998,ES63209535234862100767,1682.49,2022-07-20T22:17:22,Zarautz,expenses,children,-682.37,-19575.63
buyer_2,Carmen,Lozano,1984-09-05,54021274R,carmen.lozano@cleverdev.app,959998,ES63209535234862100767,1682.49,2022-07-23T20:26:31,Zarautz,expenses,leisure,-65.04,-19640.67
buyer_2,Carmen,Lozano,1984-09-05,54021274R,carmen.lozano@cleverdev.app,959998,ES63209535234862100767,1682.49,2022-07-25T17:34:27,Zarautz,expenses,clothing,-71.39,-19712.06
buyer_2,Carmen,Lozano,1984-09-05,54021274R,carmen.lozano@cleverdev.app,959998,ES63209535234862100767,1682.49,2022-07-25T08:31:53,Zarautz,expenses,healthcare,-93.55,-19805.61
buyer_2,Carmen,Lozano,1984-09-05,54021274R,carmen.lozano@cleverdev.app,959998,ES63209535234862100767,1682.49,2022-07-27T20:02:59,Zarautz,expenses,transport,-47.32,-19852.93
buyer_2,Carmen,Lozano,1984-09-05,54021274R,carmen.lozano@cleverdev.app,959998,ES63209535234862100767,1682.49,2022-08-01T20:07:10,Zarautz,incomes,salary,2037.7,-17815.23
buyer_2,Carmen,Lozano,1984-09-05,54021274R,carmen.lozano@cleverdev.app,959998,ES63209535234862100767,1682.49,2022-08-01T20:07:10,Zarautz,incomes,extra_income,358.06,-17457.17
buyer_2,Carmen,Lozano,1984-09-05,54021274R,carmen.lozano@cleverdev.app,959998,ES63209535234862100767,1682.49,2022-08-01T04:38:38,Zarautz,expenses,transport,-51.64,-17508.81
buyer_2,Carmen,Lozano,1984-09-05,54021274R,carmen.lozano@cleverdev.app,959998,ES63209535234862100767,1682.49,2022-08-02T13:01:19,Zarautz,expenses,leisure,-70.58,-17579.39
buyer_2,Carmen,Lozano,1984-09-05,54021274R,carmen.lozano@cleverdev.app,959998,ES63209535234862100767,1682.49,2022-08-03T19:17:54,Zarautz,expenses,repairs,-193.38,-17772.77
buyer_2,Carmen,Lozano,1984-09-05,54021274R,carmen.lozano@cleverdev.app,959998,ES63209535234862100767,1682.49,2022-08-04T09:11:58,Zarautz,expenses,mortgage,-932.39,-18705.16
buyer_2,Carmen,Lozano,1984-09-05,54021274R,carmen.lozano@cleverdev.app,959998,ES63209535234862100767,1682.49,2022-08-06T19:26:28,Zarautz,expenses,gas,-92.53,-18797.69
buyer_2,Carmen,Lozano,1984-09-05,54021274R,carmen.lozano@cleverdev.app,959998,ES63209535234862100767,1682.49,2022-08-06T20:26:48,Zarautz,expenses,phone,-39.14,-18836.83
buyer_2,Carmen,Lozano,1984-09-05,54021274R,carmen.lozano@cleverdev.app,959998,ES63209535234862100767,1682.49,2022-08-07T16:49:50,Zarautz,expenses,water,-33.47,-18870.3
buyer_2,Carmen,Lozano,1984-09-05,54021274R,carmen.lozano@cleverdev.app,959998,ES63209535234862100767,1682.49,2022-08-07T08:14:59,Zarautz,expenses,gas,-88.13,-18958.43
buyer_2,Carmen,Lozano,1984-09-05,54021274R,carmen.lozano@cleverdev.app,959998,ES63209535234862100767,1682.49,2022-08-07T14:41:00,Zarautz,expenses,food,-82.58,-19041.01
buyer_2,Carmen,Lozano,1984-09-05,54021274R,carmen.lozano@cleverdev.app,959998,ES63209535234862100767,1682.49,2022-08-08T15:41:35,Zarautz,expenses,electricity,-86.39,-19127.4
buyer_2,Carmen,Lozano,1984-09-05,54021274R,carmen.lozano@cleverdev.app,959998,ES63209535234862100767,1682.49,2022-08-08T13:21:15,Zarautz,expenses,gas,-101.0,-19228.4
buyer_2,Carmen,Lozano,1984-09-05,54021274R,carmen.lozano@cleverdev.app,959998,ES63209535234862100767,1682.49,2022-08-10T00:11:41,Zarautz,expenses,children,-418.96,-19647.36
buyer_2,Carmen,Lozano,1984-09-05,54021274R,carmen.lozano@cleverdev.app,959998,ES63209535234862100767,1682.49,2022-08-11T17:35:52,Zarautz,expenses,transport,-86.58,-19733.94
buyer_2,Carmen,Lozano,1984-09-05,54021274R,carmen.lozano@cleverdev.app,959998,ES63209535234862100767,1682.49,2022-08-11T22:28:51,Zarautz,expenses,gifts,-487.37,-20221.31
buyer_2,Carmen,Lozano,1984-09-05,54021274R,carmen.lozano@cleverdev.app,959998,ES63209535234862100767,1682.49,2022-08-13T16:17:39,Zarautz,expenses,leisure,-44.07,-20265.38
buyer_2,Carmen,Lozano,1984-09-05,54021274R,carmen.lozano@cleverdev.app,959998,ES63209535234862100767,1682.49,2022-08-15T09:47:59,Zarautz,expenses,leisure,-44.8,-20310.18
buyer_2,Carmen,Lozano,1984-09-05,54021274R,carmen.lozano@cleverdev.app,959998,ES63209535234862100767,1682.49,2022-08-18T15:07:17,Zarautz,expenses,food,-109.72,-20419.9
buyer_2,Carmen,Lozano,1984-09-05,54021274R,carmen.lozano@cleverdev.app,959998,ES63209535234862100767,1682.49,2022-08-18T14:01:19,Zarautz,expenses,appliances,-337.17,-20757.07
buyer_2,Carmen,Lozano,1984-09-05,54021274R,carmen.lozano@cleverdev.app,959998,ES63209535234862100767,1682.49,2022-08-19T08:15:23,Zarautz,expenses,clothing,-75.82,-20832.89
buyer_2,Carmen,Lozano,1984-09-05,54021274R,carmen.lozano@cleverdev.app,959998,ES63209535234862100767,1682.49,2022-08-19T13:47:28,Zarautz,expenses,gifts,-97.31,-20930.2
buyer_2,Carmen,Lozano,1984-09-05,54021274R,carmen.lozano@cleverdev.app,959998,ES63209535234862100767,1682.49,2022-08-20T17:39:04,Zarautz,expenses,food,-108.18,-21038.38
buyer_2,Carmen,Lozano,1984-09-05,54021274R,carmen.lozano@cleverdev.app,959998,ES63209535234862100767,1682.49,2022-08-21T15:10:55,Zarautz,expenses,cash,-100.0,-21138.38
buyer_2,Carmen,Lozano,1984-09-05,54021274R,carmen.lozano@cleverdev.app,959998,ES63209535234862100767,1682.49,2022-08-23T12:47:30,Zarautz,expenses,food,-104.39,-21242.77
buyer_2,Carmen,Lozano,1984-09-05,54021274R,carmen.lozano@cleverdev.app,959998,ES63209535234862100767,1682.49,2022-08-24T06:12:34,Zarautz,expenses,education,-62.65,-21305.42
buyer_2,Carmen,Lozano,1984-09-05,54021274R,carmen.lozano@cleverdev.app,959998,ES63209535234862100767,1682.49,2022-08-26T09:53:55,Zarautz,expenses,transport,-43.16,-21348.58
buyer_2,Carmen,Lozano,1984-09-05,54021274R,carmen.lozano@cleverdev.app,959998,ES63209535234862100767,1682.49,2022-08-26T08:18:05,Zarautz,expenses,cash,-100.0,-21448.58
buyer_2,Carmen,Lozano,1984-09-05,54021274R,carmen.lozano@cleverdev.app,959998,ES63209535234862100767,1682.49,2022-08-31T14:38:33,Zarautz,expenses,transport,-86.4,-21534.98
buyer_2,Carmen,Lozano,1984-09-05,54021274R,carmen.lozano@cleverdev.app,959998,ES63209535234862100767,1682.49,2022-09-01T19:12:01,Zarautz,incomes,salary,2037.7,-19497.28
buyer_2,Carmen,Lozano,1984-09-05,54021274R,carmen.lozano@cleverdev.app,959998,ES63209535234862100767,1682.49,2022-09-01T10:08:10,Zarautz,expenses,leisure,-20.5,-19517.78
buyer_2,Carmen,Lozano,1984-09-05,54021274R,carmen.lozano@cleverdev.app,959998,ES63209535234862100767,1682.49,2022-09-01T17:05:31,Zarautz,expenses,gifts,-521.96,-20039.74
buyer_2,Carmen,Lozano,1984-09-05,54021274R,carmen.lozano@cleverdev.app,959998,ES63209535234862100767,1682.49,2022-09-02T21:41:06,Zarautz,expenses,gifts,-78.87,-20118.61
buyer_2,Carmen,Lozano,1984-09-05,54021274R,carmen.lozano@cleverdev.app,959998,ES63209535234862100767,1682.49,2022-09-04T12:50:12,Zarautz,expenses,mortgage,-932.39,-21051.0
buyer_2,Carmen,Lozano,1984-09-05,54021274R,carmen.lozano@cleverdev.app,959998,ES63209535234862100767,1682.49,2022-09-04T19:11:57,Zarautz,expenses,leisure,-37.26,-21088.26
buyer_2,Carmen,Lozano,1984-09-05,54021274R,carmen.lozano@cleverdev.app,959998,ES63209535234862100767,1682.49,2022-09-05T13:12:22,Zarautz,expenses,gas,-56.95,-21145.21
buyer_2,Carmen,Lozano,1984-09-05,54021274R,carmen.lozano@cleverdev.app,959998,ES63209535234862100767,1682.49,2022-09-05T14:03:31,Zarautz,expenses,phone,-32.96,-21178.17
buyer_2,Carmen,Lozano,1984-09-05,54021274R,carmen.lozano@cleverdev.app,959998,ES63209535234862100767,1682.49,2022-09-06T18:28:54,Zarautz,expenses,appliances,-184.12,-21362.29
buyer_2,Carmen,Lozano,1984-09-05,54021274R,carmen.lozano@cleverdev.app,959998,ES63209535234862100767,1682.49,2022-09-06T11:28:12,Zarautz,expenses,repairs,-60.63,-21422.92
buyer_2,Carmen,Lozano,1984-09-05,54021274R,carmen.lozano@cleverdev.app,959998,ES63209535234862100767,1682.49,2022-09-07T10:56:50,Zarautz,expenses,water,-27.54,-21450.46
buyer_2,Carmen,Lozano,1984-09-05,54021274R,carmen.lozano@cleverdev.app,959998,ES63209535234862100767,1682.49,2022-09-07T12:23:46,Zarautz,expenses,education,-60.04,-21510.5
buyer_2,Carmen,Lozano,1984-09-05,54021274R,carmen.lozano@cleverdev.app,959998,ES63209535234862100767,1682.49,2022-09-08T15:42:42,Zarautz,expenses,phone,-32.07,-21542.57
buyer_2,Carmen,Lozano,1984-09-05,54021274R,carmen.lozano@cleverdev.app,959998,ES63209535234862100767,1682.49,2022-09-09T23:27:11,Zarautz,expenses,leisure,-48.84,-21591.41
buyer_2,Carmen,Lozano,1984-09-05,54021274R,carmen.lozano@cleverdev.app,959998,ES63209535234862100767,1682.49,2022-09-09T21:06:12,Zarautz,expenses,cash,-100.0,-21691.41
buyer_2,Carmen,Lozano,1984-09-05,54021274R,carmen.lozano@cleverdev.app,959998,ES63209535234862100767,1682.49,2022-09-11T09:14:58,Zarautz,expenses,food,-123.02,-21814.43
buyer_2,Carmen,Lozano,1984-09-05,54021274R,carmen.lozano@cleverdev.app,959998,ES63209535234862100767,1682.49,2022-09-12T19:54:59,Zarautz,expenses,cash,-100.0,-21914.43
buyer_2,Carmen,Lozano,1984-09-05,54021274R,carmen.lozano@cleverdev.app,959998,ES63209535234862100767,1682.49,2022-09-13T22:14:34,Zarautz,expenses,clothing,-93.32,-22007.75
buyer_2,Carmen,Lozano,1984-09-05,54021274R,carmen.lozano@cleverdev.app,959998,ES63209535234862100767,1682.49,2022-09-15T02:15:37,Zarautz,expenses,food,-107.11,-22114.86
buyer_2,Carmen,Lozano,1984-09-05,54021274R,carmen.lozano@cleverdev.app,959998,ES63209535234862100767,1682.49,2022-09-15T11:27:19,Zarautz,expenses,transport,-83.18,-22198.04
buyer_2,Carmen,Lozano,1984-09-05,54021274R,carmen.lozano@cleverdev.app,959998,ES63209535234862100767,1682.49,2022-09-15T09:49:30,Zarautz,expenses,cash,-100.0,-22298.04
buyer_2,Carmen,Lozano,1984-09-05,54021274R,carmen.lozano@cleverdev.app,959998,ES63209535234862100767,1682.49,2022-09-18T11:20:35,Zarautz,expenses,transport,-50.52,-22348.56
buyer_2,Carmen,Lozano,1984-09-05,54021274R,carmen.lozano@cleverdev.app,959998,ES63209535234862100767,1682.49,2022-09-18T17:46:24,Zarautz,expenses,repairs,-31.5,-22380.06
buyer_2,Carmen,Lozano,1984-09-05,54021274R,carmen.lozano@cleverdev.app,959998,ES63209535234862100767,1682.49,2022-09-19T14:58:51,Zarautz,expenses,cash,-100.0,-22480.06
buyer_2,Carmen,Lozano,1984-09-05,54021274R,carmen.lozano@cleverdev.app,959998,ES63209535234862100767,1682.49,2022-09-20T10:40:58,Zarautz,expenses,repairs,-319.67,-22799.73
buyer_2,Carmen,Lozano,1984-09-05,54021274R,carmen.lozano@cleverdev.app,959998,ES63209535234862100767,1682.49,2022-09-22T14:33:00,Zarautz,expenses,transport,-52.23,-22851.96
buyer_2,Carmen,Lozano,1984-09-05,54021274R,carmen.lozano@cleverdev.app,959998,ES63209535234862100767,1682.49,2022-09-22T22:04:31,Zarautz,expenses,appliances,-86.06,-22938.02
buyer_2,Carmen,Lozano,1984-09-05,54021274R,carmen.lozano@cleverdev.app,959998,ES63209535234862100767,1682.49,2022-09-23T12:01:26,Zarautz,expenses,cash,-100.0,-23038.02
buyer_2,Carmen,Lozano,1984-09-05,54021274R,carmen.lozano@cleverdev.app,959998,ES63209535234862100767,1682.49,2022-09-25T13:26:30,Zarautz,expenses,repairs,-107.82,-23145.84
buyer_2,Carmen,Lozano,1984-09-05,54021274R,carmen.lozano@cleverdev.app,959998,ES63209535234862100767,1682.49,2022-09-26T06:44:03,Zarautz,expenses,leisure,-41.96,-23187.8
buyer_2,Carmen,Lozano,1984-09-05,54021274R,carmen.lozano@cleverdev.app,959998,ES63209535234862100767,1682.49,2022-09-29T23:00:03,Zarautz,expenses,transport,-53.27,-23241.07
buyer_2,Carmen,Lozano,1984-09-05,54021274R,carmen.lozano@cleverdev.app,959998,ES63209535234862100767,1682.49,2022-09-30T10:51:53,Zarautz,expenses,clothing,-58.95,-23300.02
buyer_2,Carmen,Lozano,1984-09-05,54021274R,carmen.lozano@cleverdev.app,959998,ES63209535234862100767,1682.49,2022-09-30T10:13:45,Zarautz,expenses,cash,-100.0,-23400.02
buyer_2,Carmen,Lozano,1984-09-05,54021274R,carmen.lozano@cleverdev.app,959998,ES63209535234862100767,1682.49,2022-10-01T16:07:16,Zarautz,incomes,salary,2037.7,-21362.32
buyer_2,Carmen,Lozano,1984-09-05,54021274R,carmen.lozano@cleverdev.app,959998,ES63209535234862100767,1682.49,2022-10-01T19:13:34,Zarautz,expenses,transport,-45.05,-21407.37
buyer_2,Carmen,Lozano,1984-09-05,54021274R,carmen.lozano@cleverdev.app,959998,ES63209535234862100767,1682.49,2022-10-01T04:12:46,Zarautz,expenses,leisure,-66.87,-21474.24
buyer_2,Carmen,Lozano,1984-09-05,54021274R,carmen.lozano@cleverdev.app,959998,ES63209535234862100767,1682.49,2022-10-03T19:07:25,Zarautz,expenses,leisure,-52.41,-21526.65
buyer_2,Carmen,Lozano,1984-09-05,54021274R,carmen.lozano@cleverdev.app,959998,ES63209535234862100767,1682.49,2022-10-03T15:01:07,Zarautz,expenses,healthcare,-143.57,-21670.22
buyer_2,Carmen,Lozano,1984-09-05,54021274R,carmen.lozano@cleverdev.app,959998,ES63209535234862100767,1682.49,2022-10-04T12:52:50,Zarautz,expenses,mortgage,-932.39,-22602.61
buyer_2,Carmen,Lozano,1984-09-05,54021274R,carmen.lozano@cleverdev.app,959998,ES63209535234862100767,1682.49,2022-10-04T18:17:37,Zarautz,expenses,cash,-100.0,-22702.61
buyer_2,Carmen,Lozano,1984-09-05,54021274R,carmen.lozano@cleverdev.app,959998,ES63209535234862100767,1682.49,2022-10-05T14:16:23,Zarautz,expenses,gifts,-401.14,-23103.75
buyer_2,Carmen,Lozano,1984-09-05,54021274R,carmen.lozano@cleverdev.app,959998,ES63209535234862100767,1682.49,2022-10-06T10:43:07,Zarautz,expenses,electricity,-74.52,-23178.27
buyer_2,Carmen,Lozano,1984-09-05,54021274R,carmen.lozano@cleverdev.app,959998,ES63209535234862100767,1682.49,2022-10-07T14:59:48,Zarautz,expenses,gas,-103.03,-23281.3
buyer_2,Carmen,Lozano,1984-09-05,54021274R,carmen.lozano@cleverdev.app,959998,ES63209535234862100767,1682.49,2022-10-08T20:56:19,Zarautz,expenses,gas,-107.37,-23388.67
buyer_2,Carmen,Lozano,1984-09-05,54021274R,carmen.lozano@cleverdev.app,959998,ES63209535234862100767,1682.49,2022-10-09T17:41:54,Zarautz,expenses,food,-114.63,-23503.3
buyer_2,Carmen,Lozano,1984-09-05,54021274R,carmen.lozano@cleverdev.app,959998,ES63209535234862100767,1682.49,2022-10-12T17:19:02,Zarautz,expenses,food,-72.04,-23575.34
buyer_2,Carmen,Lozano,1984-09-05,54021274R,carmen.lozano@cleverdev.app,959998,ES63209535234862100767,1682.49,2022-10-14T20:19:16,Zarautz,expenses,repairs,-87.2,-23662.54
buyer_2,Carmen,Lozano,1984-09-05,54021274R,carmen.lozano@cleverdev.app,959998,ES63209535234862100767,1682.49,2022-10-16T10:48:16,Zarautz,expenses,cash,-100.0,-23762.54
buyer_2,Carmen,Lozano,1984-09-05,54021274R,carmen.lozano@cleverdev.app,959998,ES63209535234862100767,1682.49,2022-10-17T16:59:20,Zarautz,expenses,appliances,-228.4,-23990.94
buyer_2,Carmen,Lozano,1984-09-05,54021274R,carmen.lozano@cleverdev.app,959998,ES63209535234862100767,1682.49,2022-10-17T20:30:16,Zarautz,expenses,repairs,-205.93,-24196.87
buyer_2,Carmen,Lozano,1984-09-05,54021274R,carmen.lozano@cleverdev.app,959998,ES63209535234862100767,1682.49,2022-10-18T08:40:37,Zarautz,expenses,repairs,-71.27,-24268.14
buyer_2,Carmen,Lozano,1984-09-05,54021274R,carmen.lozano@cleverdev.app,959998,ES63209535234862100767,1682.49,2022-10-19T12:36:21,Zarautz,expenses,transport,-71.56,-24339.7
buyer_2,Carmen,Lozano,1984-09-05,54021274R,carmen.lozano@cleverdev.app,959998,ES63209535234862100767,1682.49,2022-10-20T12:23:09,Zarautz,expenses,gifts,-179.18,-24518.88
buyer_2,Carmen,Lozano,1984-09-05,54021274R,carmen.lozano@cleverdev.app,959998,ES63209535234862100767,1682.49,2022-10-21T13:36:53,Zarautz,expenses,leisure,-42.98,-24561.86
buyer_2,Carmen,Lozano,1984-09-05,54021274R,carmen.lozano@cleverdev.app,959998,ES63209535234862100767,1682.49,2022-10-22T23:32:11,Zarautz,expenses,cash,-100.0,-24661.86
buyer_2,Carmen,Lozano,1984-09-05,54021274R,carmen.lozano@cleverdev.app,959998,ES63209535234862100767,1682.49,2022-10-23T20:49:58,Zarautz,expenses,cash,-100.0,-24761.86
buyer_2,Carmen,Lozano,1984-09-05,54021274R,carmen.lozano@cleverdev.app,959998,ES63209535234862100767,1682.49,2022-10-26T20:20:15,Zarautz,expenses,repairs,-99.99,-24861.85
buyer_2,Carmen,Lozano,1984-09-05,54021274R,carmen.lozano@cleverdev.app,959998,ES63209535234862100767,1682.49,2022-10-28T09:22:21,Zarautz,expenses,transport,-68.77,-24930.62
buyer_2,Carmen,Lozano,1984-09-05,54021274R,carmen.lozano@cleverdev.app,959998,ES63209535234862100767,1682.49,2022-10-28T21:57:08,Zarautz,expenses,repairs,-284.66,-25215.28
buyer_2,Carmen,Lozano,1984-09-05,54021274R,carmen.lozano@cleverdev.app,959998,ES63209535234862100767,1682.49,2022-10-30T19:03:55,Zarautz,expenses,transport,-75.75,-25291.03
buyer_2,Carmen,Lozano,1984-09-05,54021274R,carmen.lozano@cleverdev.app,959998,ES63209535234862100767,1682.49,2022-11-01T12:36:09,Zarautz,incomes,salary,2037.7,-23253.33
buyer_2,Carmen,Lozano,1984-09-05,54021274R,carmen.lozano@cleverdev.app,959998,ES63209535234862100767,1682.49,2022-11-01T12:36:09,Zarautz,incomes,extra_income,358.06,-22895.27
buyer_2,Carmen,Lozano,1984-09-05,54021274R,carmen.lozano@cleverdev.app,959998,ES63209535234862100767,1682.49,2022-11-02T13:51:09,Zarautz,expenses,food,-100.99,-22996.26
buyer_2,Carmen,Lozano,1984-09-05,54021274R,carmen.lozano@cleverdev.app,959998,ES63209535234862100767,1682.49,2022-11-03T11:44:38,Zarautz,expenses,leisure,-30.53,-23026.79
buyer_2,Carmen,Lozano,1984-09-05,54021274R,carmen.lozano@cleverdev.app,959998,ES63209535234862100767,1682.49,2022-11-04T08:46:38,Zarautz,expenses,mortgage,-932.39,-23959.18
buyer_2,Carmen,Lozano,1984-09-05,54021274R,carmen.lozano@cleverdev.app,959998,ES63209535234862100767,1682.49,2022-11-04T20:17:58,Zarautz,expenses,food,-100.42,-24059.6
buyer_2,Carmen,Lozano,1984-09-05,54021274R,carmen.lozano@cleverdev.app,959998,ES63209535234862100767,1682.49,2022-11-05T08:27:25,Zarautz,expenses,gas,-59.07,-24118.67
buyer_2,Carmen,Lozano,1984-09-05,54021274R,carmen.lozano@cleverdev.app,959998,ES63209535234862100767,1682.49,2022-11-05T08:45:33,Zarautz,expenses,phone,-39.95,-24158.62
buyer_2,Carmen,Lozano,1984-09-05,54021274R,carmen.lozano@cleverdev.app,959998,ES63209535234862100767,1682.49,2022-11-05T11:55:04,Zarautz,expenses,food,-97.37,-24255.99
buyer_2,Carmen,Lozano,1984-09-05,54021274R,carmen.lozano@cleverdev.app,959998,ES63209535234862100767,1682.49,2022-11-05T12:36:29,Zarautz,expenses,education,-50.19,-24306.18
buyer_2,Carmen,Lozano,1984-09-05,54021274R,carmen.lozano@cleverdev.app,959998,ES63209535234862100767,1682.49,2022-11-06T10:43:31,Zarautz,expenses,gas,-58.74,-24364.92
buyer_2,Carmen,Lozano,1984-09-05,54021274R,carmen.lozano@cleverdev.app,959998,ES63209535234862100767,1682.49,2022-11-06T09:18:40,Zarautz,expenses,phone,-37.64,-24402.56
buyer_2,Carmen,Lozano,1984-09-05,54021274R,carmen.lozano@cleverdev.app,959998,ES63209535234862100767,1682.49,2022-11-07T17:17:23,Zarautz,expenses,electricity,-27.58,-24430.14
buyer_2,Carmen,Lozano,1984-09-05,54021274R,carmen.lozano@cleverdev.app,959998,ES63209535234862100767,1682.49,2022-11-08T14:47:09,Zarautz,expenses,electricity,-22.06,-24452.2
buyer_2,Carmen,Lozano,1984-09-05,54021274R,carmen.lozano@cleverdev.app,959998,ES63209535234862100767,1682.49,2022-11-08T12:03:41,Zarautz,expenses,gas,-73.56,-24525.76
buyer_2,Carmen,Lozano,1984-09-05,54021274R,carmen.lozano@cleverdev.app,959998,ES63209535234862100767,1682.49,2022-11-08T17:03:55,Zarautz,expenses,internet,-42.79,-24568.55
buyer_2,Carmen,Lozano,1984-09-05,54021274R,carmen.lozano@cleverdev.app,959998,ES63209535234862100767,1682.49,2022-11-08T16:44:03,Zarautz,expenses,food,-102.62,-24671.17
buyer_2,Carmen,Lozano,1984-09-05,54021274R,carmen.lozano@cleverdev.app,959998,ES63209535234862100767,1682.49,2022-11-08T19:03:25,Zarautz,expenses,leisure,-64.59,-24735.76
buyer_2,Carmen,Lozano,1984-09-05,54021274R,carmen.lozano@cleverdev.app,959998,ES63209535234862100767,1682.49,2022-11-08T08:19:58,Zarautz,expenses,gifts,-323.26,-25059.02
buyer_2,Carmen,Lozano,1984-09-05,54021274R,carmen.lozano@cleverdev.app,959998,ES63209535234862100767,1682.49,2022-11-09T20:33:54,Zarautz,expenses,food,-76.19,-25135.21
buyer_2,Carmen,Lozano,1984-09-05,54021274R,carmen.lozano@cleverdev.app,959998,ES63209535234862100767,1682.49,2022-11-09T18:58:58,Zarautz,expenses,healthcare,-134.88,-25270.09
buyer_2,Carmen,Lozano,1984-09-05,54021274R,carmen.lozano@cleverdev.app,959998,ES63209535234862100767,1682.49,2022-11-09T12:35:12,Zarautz,expenses,repairs,-139.02,-25409.11
buyer_2,Carmen,Lozano,1984-09-05,54021274R,carmen.lozano@cleverdev.app,959998,ES63209535234862100767,1682.49,2022-11-13T09:10:23,Zarautz,expenses,gifts,-580.71,-25989.82
buyer_2,Carmen,Lozano,1984-09-05,54021274R,carmen.lozano@cleverdev.app,959998,ES63209535234862100767,1682.49,2022-11-14T09:53:16,Zarautz,expenses,leisure,-74.71,-26064.53
buyer_2,Carmen,Lozano,1984-09-05,54021274R,carmen.lozano@cleverdev.app,959998,ES63209535234862100767,1682.49,2022-11-15T23:49:10,Zarautz,expenses,leisure,-60.06,-26124.59
buyer_2,Carmen,Lozano,1984-09-05,54021274R,carmen.lozano@cleverdev.app,959998,ES63209535234862100767,1682.49,2022-11-15T13:41:42,Zarautz,expenses,clothing,-103.01,-26227.6
buyer_2,Carmen,Lozano,1984-09-05,54021274R,carmen.lozano@cleverdev.app,959998,ES63209535234862100767,1682.49,2022-11-16T16:45:11,Zarautz,expenses,food,-87.88,-26315.48
buyer_2,Carmen,Lozano,1984-09-05,54021274R,carmen.lozano@cleverdev.app,959998,ES63209535234862100767,1682.49,2022-11-16T23:24:20,Zarautz,expenses,children,-709.33,-27024.81
buyer_2,Carmen,Lozano,1984-09-05,54021274R,carmen.lozano@cleverdev.app,959998,ES63209535234862100767,1682.49,2022-11-17T16:43:19,Zarautz,expenses,cash,-100.0,-27124.81
buyer_2,Carmen,Lozano,1984-09-05,54021274R,carmen.lozano@cleverdev.app,959998,ES63209535234862100767,1682.49,2022-11-19T15:18:05,Zarautz,expenses,healthcare,-75.1,-27199.91
buyer_2,Carmen,Lozano,1984-09-05,54021274R,carmen.lozano@cleverdev.app,959998,ES63209535234862100767,1682.49,2022-11-19T18:51:50,Zarautz,expenses,education,-54.48,-27254.39
buyer_2,Carmen,Lozano,1984-09-05,54021274R,carmen.lozano@cleverdev.app,959998,ES63209535234862100767,1682.49,2022-11-20T10:37:03,Zarautz,expenses,clothing,-92.29,-27346.68
buyer_2,Carmen,Lozano,1984-09-05,54021274R,carmen.lozano@cleverdev.app,959998,ES63209535234862100767,1682.49,2022-11-21T12:09:17,Zarautz,expenses,cash,-100.0,-27446.68
buyer_2,Carmen,Lozano,1984-09-05,54021274R,carmen.lozano@cleverdev.app,959998,ES63209535234862100767,1682.49,2022-11-24T18:18:14,Zarautz,expenses,food,-73.31,-27519.99
buyer_2,Carmen,Lozano,1984-09-05,54021274R,carmen.lozano@cleverdev.app,959998,ES63209535234862100767,1682.49,2022-11-24T16:52:30,Zarautz,expenses,transport,-52.59,-27572.58
buyer_2,Carmen,Lozano,1984-09-05,54021274R,carmen.lozano@cleverdev.app,959998,ES63209535234862100767,1682.49,2022-11-24T09:39:45,Zarautz,expenses,education,-48.62,-27621.2
buyer_2,Carmen,Lozano,1984-09-05,54021274R,carmen.lozano@cleverdev.app,959998,ES63209535234862100767,1682.49,2022-11-25T08:10:35,Zarautz,expenses,leisure,-65.91,-27687.11
buyer_2,Carmen,Lozano,1984-09-05,54021274R,carmen.lozano@cleverdev.app,959998,ES63209535234862100767,1682.49,2022-11-25T19:12:16,Zarautz,expenses,cash,-100.0,-27787.11
buyer_2,Carmen,Lozano,1984-09-05,54021274R,carmen.lozano@cleverdev.app,959998,ES63209535234862100767,1682.49,2022-11-26T20:13:06,Zarautz,expenses,food,-111.93,-27899.04
buyer_2,Carmen,Lozano,1984-09-05,54021274R,carmen.lozano@cleverdev.app,959998,ES63209535234862100767,1682.49,2022-11-27T10:15:40,Zarautz,expenses,repairs,-250.69,-28149.73
buyer_2,Carmen,Lozano,1984-09-05,54021274R,carmen.lozano@cleverdev.app,959998,ES63209535234862100767,1682.49,2022-11-29T10:03:27,Zarautz,expenses,food,-100.91,-28250.64
buyer_2,Carmen,Lozano,1984-09-05,54021274R,carmen.lozano@cleverdev.app,959998,ES63209535234862100767,1682.49,2022-11-30T02:47:02,Zarautz,expenses,food,-69.37,-28320.01
buyer_2,Carmen,Lozano,1984-09-05,54021274R,carmen.lozano@cleverdev.app,959998,ES63209535234862100767,1682.49,2022-12-01T10:03:18,Zarautz,incomes,salary,2037.7,-26282.31
buyer_2,Carmen,Lozano,1984-09-05,54021274R,carmen.lozano@cleverdev.app,959998,ES63209535234862100767,1682.49,2022-12-01T10:03:18,Zarautz,incomes,salary_bonus,1615.8,-24666.51
buyer_2,Carmen,Lozano,1984-09-05,54021274R,carmen.lozano@cleverdev.app,959998,ES63209535234862100767,1682.49,2022-12-02T13:04:15,Zarautz,expenses,repairs,-149.26,-24815.77
buyer_2,Carmen,Lozano,1984-09-05,54021274R,carmen.lozano@cleverdev.app,959998,ES63209535234862100767,1682.49,2022-12-04T18:19:42,Zarautz,expenses,mortgage,-932.39,-25748.16
buyer_2,Carmen,Lozano,1984-09-05,54021274R,carmen.lozano@cleverdev.app,959998,ES63209535234862100767,1682.49,2022-12-04T14:18:51,Zarautz,expenses,gifts,-334.75,-26082.91
buyer_2,Carmen,Lozano,1984-09-05,54021274R,carmen.lozano@cleverdev.app,959998,ES63209535234862100767,1682.49,2022-12-05T21:35:16,Zarautz,expenses,children,-210.29,-26293.2
buyer_2,Carmen,Lozano,1984-09-05,54021274R,carmen.lozano@cleverdev.app,959998,ES63209535234862100767,1682.49,2022-12-07T18:37:28,Zarautz,expenses,gas,-79.66,-26372.86
buyer_2,Carmen,Lozano,1984-09-05,54021274R,carmen.lozano@cleverdev.app,959998,ES63209535234862100767,1682.49,2022-12-07T08:49:52,Zarautz,expenses,food,-115.49,-26488.35
buyer_2,Carmen,Lozano,1984-09-05,54021274R,carmen.lozano@cleverdev.app,959998,ES63209535234862100767,1682.49,2022-12-08T08:12:23,Zarautz,expenses,electricity,-36.69,-26525.04
buyer_2,Carmen,Lozano,1984-09-05,54021274R,carmen.lozano@cleverdev.app,959998,ES63209535234862100767,1682.49,2022-12-08T19:16:41,Zarautz,expenses,gas,-58.83,-26583.87
buyer_2,Carmen,Lozano,1984-09-05,54021274R,carmen.lozano@cleverdev.app,959998,ES63209535234862100767,1682.49,2022-12-08T22:20:01,Zarautz,expenses,cash,-100.0,-26683.87
buyer_2,Carmen,Lozano,1984-09-05,54021274R,carmen.lozano@cleverdev.app,959998,ES63209535234862100767,1682.49,2022-12-08T16:17:14,Zarautz,expenses,repairs,-228.27,-26912.14
buyer_2,Carmen,Lozano,1984-09-05,54021274R,carmen.lozano@cleverdev.app,959998,ES63209535234862100767,1682.49,2022-12-08T20:31:39,Zarautz,expenses,gifts,-408.13,-27320.27
buyer_2,Carmen,Lozano,1984-09-05,54021274R,carmen.lozano@cleverdev.app,959998,ES63209535234862100767,1682.49,2022-12-11T04:35:47,Zarautz,expenses,clothing,-90.7,-27410.97
buyer_2,Carmen,Lozano,1984-09-05,54021274R,carmen.lozano@cleverdev.app,959998,ES63209535234862100767,1682.49,2022-12-12T23:23:35,Zarautz,expenses,food,-64.78,-27475.75
buyer_2,Carmen,Lozano,1984-09-05,54021274R,carmen.lozano@cleverdev.app,959998,ES63209535234862100767,1682.49,2022-12-12T15:04:41,Zarautz,expenses,clothing,-122.61,-27598.36
buyer_2,Carmen,Lozano,1984-09-05,54021274R,carmen.lozano@cleverdev.app,959998,ES63209535234862100767,1682.49,2022-12-13T18:04:36,Zarautz,expenses,transport,-44.11,-27642.47
buyer_2,Carmen,Lozano,1984-09-05,54021274R,carmen.lozano@cleverdev.app,959998,ES63209535234862100767,1682.49,2022-12-13T13:08:31,Zarautz,expenses,leisure,-21.27,-27663.74
buyer_2,Carmen,Lozano,1984-09-05,54021274R,carmen.lozano@cleverdev.app,959998,ES63209535234862100767,1682.49,2022-12-15T19:35:34,Zarautz,expenses,food,-66.05,-27729.79
buyer_2,Carmen,Lozano,1984-09-05,54021274R,carmen.lozano@cleverdev.app,959998,ES63209535234862100767,1682.49,2022-12-15T12:13:33,Zarautz,expenses,children,-761.23,-28491.02
buyer_2,Carmen,Lozano,1984-09-05,54021274R,carmen.lozano@cleverdev.app,959998,ES63209535234862100767,1682.49,2022-12-16T09:43:49,Zarautz,expenses,food,-93.04,-28584.06
buyer_2,Carmen,Lozano,1984-09-05,54021274R,carmen.lozano@cleverdev.app,959998,ES63209535234862100767,1682.49,2022-12-17T20:27:25,Zarautz,expenses,transport,-66.84,-28650.9
buyer_2,Carmen,Lozano,1984-09-05,54021274R,carmen.lozano@cleverdev.app,959998,ES63209535234862100767,1682.49,2022-12-17T11:25:39,Zarautz,expenses,cash,-100.0,-28750.9
buyer_2,Carmen,Lozano,1984-09-05,54021274R,carmen.lozano@cleverdev.app,959998,ES63209535234862100767,1682.49,2022-12-18T08:02:11,Zarautz,expenses,education,-68.93,-28819.83
buyer_2,Carmen,Lozano,1984-09-05,54021274R,carmen.lozano@cleverdev.app,959998,ES63209535234862100767,1682.49,2022-12-19T12:05:48,Zarautz,expenses,repairs,-33.09,-28852.92
buyer_2,Carmen,Lozano,1984-09-05,54021274R,carmen.lozano@cleverdev.app,959998,ES63209535234862100767,1682.49,2022-12-19T20:51:02,Zarautz,expenses,gifts,-777.41,-29630.33
buyer_2,Carmen,Lozano,1984-09-05,54021274R,carmen.lozano@cleverdev.app,959998,ES63209535234862100767,1682.49,2022-12-21T23:56:07,Zarautz,expenses,transport,-57.94,-29688.27
buyer_2,Carmen,Lozano,1984-09-05,54021274R,carmen.lozano@cleverdev.app,959998,ES63209535234862100767,1682.49,2022-12-21T02:49:56,Zarautz,expenses,cash,-100.0,-29788.27
buyer_2,Carmen,Lozano,1984-09-05,54021274R,carmen.lozano@cleverdev.app,959998,ES63209535234862100767,1682.49,2022-12-22T14:27:06,Zarautz,expenses,food,-123.26,-29911.53
buyer_2,Carmen,Lozano,1984-09-05,54021274R,carmen.lozano@cleverdev.app,959998,ES63209535234862100767,1682.49,2022-12-25T18:48:59,Zarautz,expenses,clothing,-50.29,-29961.82
buyer_2,Carmen,Lozano,1984-09-05,54021274R,carmen.lozano@cleverdev.app,959998,ES63209535234862100767,1682.49,2022-12-29T08:18:03,Zarautz,expenses,leisure,-80.03,-30041.85
buyer_2,Carmen,Lozano,1984-09-05,54021274R,carmen.lozano@cleverdev.app,959998,ES63209535234862100767,1682.49,2022-12-29T18:11:23,Zarautz,expenses,cash,-100.0,-30141.85
buyer_2,Carmen,Lozano,1984-09-05,54021274R,carmen.lozano@cleverdev.app,959998,ES63209535234862100767,1682.49,2022-12-31T13:00:56,Zarautz,expenses,food,-103.7,-30245.55
buyer_2,Carmen,Lozano,1984-09-05,54021274R,carmen.lozano@cleverdev.app,959998,ES63209535234862100767,1682.49,2023-01-01T14:22:21,Zarautz,incomes,salary,2092.91,-28152.64
buyer_2,Carmen,Lozano,1984-09-05,54021274R,carmen.lozano@cleverdev.app,959998,ES63209535234862100767,1682.49,2023-01-01T19:25:30,Zarautz,expenses,leisure,-58.31,-28210.95
buyer_2,Carmen,Lozano,1984-09-05,54021274R,carmen.lozano@cleverdev.app,959998,ES63209535234862100767,1682.49,2023-01-03T17:24:29,Zarautz,expenses,gifts,-647.96,-28858.91
buyer_2,Carmen,Lozano,1984-09-05,54021274R,carmen.lozano@cleverdev.app,959998,ES63209535234862100767,1682.49,2023-01-04T12:18:05,Zarautz,expenses,mortgage,-859.88,-29718.79
buyer_2,Carmen,Lozano,1984-09-05,54021274R,carmen.lozano@cleverdev.app,959998,ES63209535234862100767,1682.49,2023-01-06T11:09:58,Zarautz,expenses,water,-25.57,-29744.36
buyer_2,Carmen,Lozano,1984-09-05,54021274R,carmen.lozano@cleverdev.app,959998,ES63209535234862100767,1682.49,2023-01-06T18:49:23,Zarautz,expenses,internet,-43.95,-29788.31
buyer_2,Carmen,Lozano,1984-09-05,54021274R,carmen.lozano@cleverdev.app,959998,ES63209535234862100767,1682.49,2023-01-06T16:27:26,Zarautz,expenses,leisure,-44.61,-29832.92
buyer_2,Carmen,Lozano,1984-09-05,54021274R,carmen.lozano@cleverdev.app,959998,ES63209535234862100767,1682.49,2023-01-06T14:06:17,Zarautz,expenses,children,-451.18,-30284.1
buyer_2,Carmen,Lozano,1984-09-05,54021274R,carmen.lozano@cleverdev.app,959998,ES63209535234862100767,1682.49,2023-01-07T18:27:32,Zarautz,expenses,travel,-312.17,-30596.27
buyer_2,Carmen,Lozano,1984-09-05,54021274R,carmen.lozano@cleverdev.app,959998,ES63209535234862100767,1682.49,2023-01-07T19:22:28,Zarautz,expenses,gifts,-181.44,-30777.71
buyer_2,Carmen,Lozano,1984-09-05,54021274R,carmen.lozano@cleverdev.app,959998,ES63209535234862100767,1682.49,2023-01-08T15:55:11,Zarautz,expenses,water,-27.48,-30805.19
buyer_2,Carmen,Lozano,1984-09-05,54021274R,carmen.lozano@cleverdev.app,959998,ES63209535234862100767,1682.49,2023-01-08T01:37:59,Zarautz,expenses,internet,-43.95,-30849.14
buyer_2,Carmen,Lozano,1984-09-05,54021274R,carmen.lozano@cleverdev.app,959998,ES63209535234862100767,1682.49,2023-01-10T23:09:05,Zarautz,expenses,clothing,-124.23,-30973.37
buyer_2,Carmen,Lozano,1984-09-05,54021274R,carmen.lozano@cleverdev.app,959998,ES63209535234862100767,1682.49,2023-01-10T19:04:10,Zarautz,expenses,cash,-100.0,-31073.37
buyer_2,Carmen,Lozano,1984-09-05,54021274R,carmen.lozano@cleverdev.app,959998,ES63209535234862100767,1682.49,2023-01-11T09:52:36,Zarautz,expenses,leisure,-47.41,-31120.78
buyer_2,Carmen,Lozano,1984-09-05,54021274R,carmen.lozano@cleverdev.app,959998,ES63209535234862100767,1682.49,2023-01-12T10:46:59,Zarautz,expenses,food,-123.64,-31244.42
buyer_2,Carmen,Lozano,1984-09-05,54021274R,carmen.lozano@cleverdev.app,959998,ES63209535234862100767,1682.49,2023-01-12T15:56:47,Zarautz,expenses,transport,-52.1,-31296.52
buyer_2,Carmen,Lozano,1984-09-05,54021274R,carmen.lozano@cleverdev.app,959998,ES63209535234862100767,1682.49,2023-01-14T16:27:18,Zarautz,expenses,transport,-42.27,-31338.79
buyer_2,Carmen,Lozano,1984-09-05,54021274R,carmen.lozano@cleverdev.app,959998,ES63209535234862100767,1682.49,2023-01-14T09:09:25,Zarautz,expenses,cash,-100.0,-31438.79
buyer_2,Carmen,Lozano,1984-09-05,54021274R,carmen.lozano@cleverdev.app,959998,ES63209535234862100767,1682.49,2023-01-16T19:40:14,Zarautz,expenses,food,-85.67,-31524.46
buyer_2,Carmen,Lozano,1984-09-05,54021274R,carmen.lozano@cleverdev.app,959998,ES63209535234862100767,1682.49,2023-01-17T09:34:51,Zarautz,expenses,food,-118.34,-31642.8
buyer_2,Carmen,Lozano,1984-09-05,54021274R,carmen.lozano@cleverdev.app,959998,ES63209535234862100767,1682.49,2023-01-18T14:28:56,Zarautz,expenses,transport,-75.85,-31718.65
buyer_2,Carmen,Lozano,1984-09-05,54021274R,carmen.lozano@cleverdev.app,959998,ES63209535234862100767,1682.49,2023-01-18T23:18:06,Zarautz,expenses,cash,-100.0,-31818.65
buyer_2,Carmen,Lozano,1984-09-05,54021274R,carmen.lozano@cleverdev.app,959998,ES63209535234862100767,1682.49,2023-01-20T23:23:39,Zarautz,expenses,food,-69.43,-31888.08
buyer_2,Carmen,Lozano,1984-09-05,54021274R,carmen.lozano@cleverdev.app,959998,ES63209535234862100767,1682.49,2023-01-20T17:44:47,Zarautz,expenses,education,-49.38,-31937.46
buyer_2,Carmen,Lozano,1984-09-05,54021274R,carmen.lozano@cleverdev.app,959998,ES63209535234862100767,1682.49,2023-01-20T10:21:08,Zarautz,expenses,children,-508.72,-32446.18
buyer_2,Carmen,Lozano,1984-09-05,54021274R,carmen.lozano@cleverdev.app,959998,ES63209535234862100767,1682.49,2023-01-22T11:12:09,Zarautz,expenses,leisure,-54.73,-32500.91
buyer_2,Carmen,Lozano,1984-09-05,54021274R,carmen.lozano@cleverdev.app,959998,ES63209535234862100767,1682.49,2023-01-25T20:28:24,Zarautz,expenses,cash,-100.0,-32600.91
buyer_2,Carmen,Lozano,1984-09-05,54021274R,carmen.lozano@cleverdev.app,959998,ES63209535234862100767,1682.49,2023-01-27T10:17:39,Zarautz,expenses,leisure,-32.88,-32633.79
buyer_2,Carmen,Lozano,1984-09-05,54021274R,carmen.lozano@cleverdev.app,959998,ES63209535234862100767,1682.49,2023-01-27T21:44:49,Zarautz,expenses,appliances,-228.13,-32861.92
buyer_2,Carmen,Lozano,1984-09-05,54021274R,carmen.lozano@cleverdev.app,959998,ES63209535234862100767,1682.49,2023-01-27T12:05:13,Zarautz,expenses,repairs,-299.0,-33160.92
buyer_2,Carmen,Lozano,1984-09-05,54021274R,carmen.lozano@cleverdev.app,959998,ES63209535234862100767,1682.49,2023-01-29T23:21:10,Zarautz,expenses,food,-72.38,-33233.3
buyer_2,Carmen,Lozano,1984-09-05,54021274R,carmen.lozano@cleverdev.app,959998,ES63209535234862100767,1682.49,2023-01-30T18:43:36,Zarautz,expenses,food,-88.37,-33321.67
buyer_2,Carmen,Lozano,1984-09-05,54021274R,carmen.lozano@cleverdev.app,959998,ES63209535234862100767,1682.49,2023-01-31T18:06:00,Zarautz,expenses,healthcare,-103.93,-33425.6
buyer_2,Carmen,Lozano,1984-09-05,54021274R,carmen.lozano@cleverdev.app,959998,ES63209535234862100767,1682.49,2023-02-01T16:01:16,Zarautz,incomes,salary,2092.91,-31332.69
buyer_2,Carmen,Lozano,1984-09-05,54021274R,carmen.lozano@cleverdev.app,959998,ES63209535234862100767,1682.49,2023-02-01T16:01:16,Zarautz,incomes,extra_income,358.06,-30974.63
buyer_2,Carmen,Lozano,1984-09-05,54021274R,carmen.lozano@cleverdev.app,959998,ES63209535234862100767,1682.49,2023-02-01T11:35:23,Zarautz,expenses,education,-46.58,-31021.21
buyer_2,Carmen,Lozano,1984-09-05,54021274R,carmen.lozano@cleverdev.app,959998,ES63209535234862100767,1682.49,2023-02-02T14:02:19,Zarautz,expenses,clothing,-89.86,-31111.07
buyer_2,Carmen,Lozano,1984-09-05,54021274R,carmen.lozano@cleverdev.app,959998,ES63209535234862100767,1682.49,2023-02-02T17:47:45,Zarautz,expenses,repairs,-95.06,-31206.13
buyer_2,Carmen,Lozano,1984-09-05,54021274R,carmen.lozano@cleverdev.app,959998,ES63209535234862100767,1682.49,2023-02-03T11:17:14,Zarautz,expenses,appliances,-408.64,-31614.77
buyer_2,Carmen,Lozano,1984-09-05,54021274R,carmen.lozano@cleverdev.app,959998,ES63209535234862100767,1682.49,2023-02-04T13:39:40,Zarautz,expenses,mortgage,-859.88,-32474.65
buyer_2,Carmen,Lozano,1984-09-05,54021274R,carmen.lozano@cleverdev.app,959998,ES63209535234862100767,1682.49,2023-02-04T17:21:58,Zarautz,expenses,leisure,-18.28,-32492.93
buyer_2,Carmen,Lozano,1984-09-05,54021274R,carmen.lozano@cleverdev.app,959998,ES63209535234862100767,1682.49,2023-02-04T17:05:39,Zarautz,expenses,gifts,-617.19,-33110.12
buyer_2,Carmen,Lozano,1984-09-05,54021274R,carmen.lozano@cleverdev.app,959998,ES63209535234862100767,1682.49,2023-02-05T15:32:32,Zarautz,expenses,electricity,-70.47,-33180.59
buyer_2,Carmen,Lozano,1984-09-05,54021274R,carmen.lozano@cleverdev.app,959998,ES63209535234862100767,1682.49,2023-02-05T14:41:24,Zarautz,expenses,gas,-113.69,-33294.28
buyer_2,Carmen,Lozano,1984-09-05,54021274R,carmen.lozano@cleverdev.app,959998,ES63209535234862100767,1682.49,2023-02-05T15:55:30,Zarautz,expenses,leisure,-19.23,-33313.51
buyer_2,Carmen,Lozano,1984-09-05,54021274R,carmen.lozano@cleverdev.app,959998,ES63209535234862100767,1682.49,2023-02-06T09:28:04,Zarautz,expenses,electricity,-77.85,-33391.36
buyer_2,Carmen,Lozano,1984-09-05,54021274R,carmen.lozano@cleverdev.app,959998,ES63209535234862100767,1682.49,2023-02-06T13:33:07,Zarautz,expenses,phone,-43.25,-33434.61
buyer_2,Carmen,Lozano,1984-09-05,54021274R,carmen.lozano@cleverdev.app,959998,ES63209535234862100767,1682.49,2023-02-07T15:28:57,Zarautz,expenses,electricity,-62.7,-33497.31
buyer_2,Carmen,Lozano,1984-09-05,54021274R,carmen.lozano@cleverdev.app,959998,ES63209535234862100767,1682.49,2023-02-07T17:43:30,Zarautz,expenses,repairs,-258.73,-33756.04
buyer_2,Carmen,Lozano,1984-09-05,54021274R,carmen.lozano@cleverdev.app,959998,ES63209535234862100767,1682.49,2023-02-08T16:31:10,Zarautz,expenses,internet,-43.95,-33799.99
buyer_2,Carmen,Lozano,1984-09-05,54021274R,carmen.lozano@cleverdev.app,959998,ES63209535234862100767,1682.49,2023-02-08T15:49:56,Zarautz,expenses,phone,-36.13,-33836.12
buyer_2,Carmen,Lozano,1984-09-05,54021274R,carmen.lozano@cleverdev.app,959998,ES63209535234862100767,1682.49,2023-02-08T09:41:13,Zarautz,expenses,healthcare,-103.89,-33940.01
buyer_2,Carmen,Lozano,1984-09-05,54021274R,carmen.lozano@cleverdev.app,959998,ES63209535234862100767,1682.49,2023-02-10T20:47:23,Zarautz,expenses,children,-242.06,-34182.07
buyer_2,Carmen,Lozano,1984-09-05,54021274R,carmen.lozano@cleverdev.app,959998,ES63209535234862100767,1682.49,2023-02-11T16:25:12,Zarautz,expenses,transport,-40.74,-34222.81
buyer_2,Carmen,Lozano,1984-09-05,54021274R,carmen.lozano@cleverdev.app,959998,ES63209535234862100767,1682.49,2023-02-11T11:45:38,Zarautz,expenses,repairs,-96.95,-34319.76
buyer_2,Carmen,Lozano,1984-09-05,54021274R,carmen.lozano@cleverdev.app,959998,ES63209535234862100767,1682.49,2023-02-12T10:59:40,Zarautz,expenses,appliances,-409.27,-34729.03
buyer_2,Carmen,Lozano,1984-09-05,54021274R,carmen.lozano@cleverdev.app,959998,ES63209535234862100767,1682.49,2023-02-16T16:21:57,Zarautz,expenses,children,-834.6,-35563.63
buyer_2,Carmen,Lozano,1984-09-05,54021274R,carmen.lozano@cleverdev.app,959998,ES63209535234862100767,1682.49,2023-02-17T20:37:22,Zarautz,expenses,travel,-403.15,-35966.78
buyer_2,Carmen,Lozano,1984-09-05,54021274R,carmen.lozano@cleverdev.app,959998,ES63209535234862100767,1682.49,2023-02-18T17:33:34,Zarautz,expenses,transport,-43.68,-36010.46
buyer_2,Carmen,Lozano,1984-09-05,54021274R,carmen.lozano@cleverdev.app,959998,ES63209535234862100767,1682.49,2023-02-18T13:10:11,Zarautz,expenses,cash,-100.0,-36110.46
buyer_2,Carmen,Lozano,1984-09-05,54021274R,carmen.lozano@cleverdev.app,959998,ES63209535234862100767,1682.49,2023-02-19T14:00:35,Zarautz,expenses,clothing,-116.32,-36226.78
buyer_2,Carmen,Lozano,1984-09-05,54021274R,carmen.lozano@cleverdev.app,959998,ES63209535234862100767,1682.49,2023-02-19T17:00:18,Zarautz,expenses,gifts,-669.24,-36896.02
buyer_2,Carmen,Lozano,1984-09-05,54021274R,carmen.lozano@cleverdev.app,959998,ES63209535234862100767,1682.49,2023-02-21T17:23:04,Zarautz,expenses,transport,-82.67,-36978.69
buyer_2,Carmen,Lozano,1984-09-05,54021274R,carmen.lozano@cleverdev.app,959998,ES63209535234862100767,1682.49,2023-02-21T14:48:46,Zarautz,expenses,leisure,-20.99,-36999.68
buyer_2,Carmen,Lozano,1984-09-05,54021274R,carmen.lozano@cleverdev.app,959998,ES63209535234862100767,1682.49,2023-02-22T12:36:29,Zarautz,expenses,repairs,-136.03,-37135.71
buyer_2,Carmen,Lozano,1984-09-05,54021274R,carmen.lozano@cleverdev.app,959998,ES63209535234862100767,1682.49,2023-02-23T19:44:02,Zarautz,expenses,cash,-100.0,-37235.71
buyer_2,Carmen,Lozano,1984-09-05,54021274R,carmen.lozano@cleverdev.app,959998,ES63209535234862100767,1682.49,2023-02-24T13:09:43,Zarautz,expenses,cash,-100.0,-37335.71
buyer_2,Carmen,Lozano,1984-09-05,54021274R,carmen.lozano@cleverdev.app,959998,ES63209535234862100767,1682.49,2023-02-25T01:26:36,Zarautz,expenses,children,-536.85,-37872.56
buyer_2,Carmen,Lozano,1984-09-05,54021274R,carmen.lozano@cleverdev.app,959998,ES63209535234862100767,1682.49,2023-02-26T15:15:11,Zarautz,expenses,transport,-84.56,-37957.12
buyer_2,Carmen,Lozano,1984-09-05,54021274R,carmen.lozano@cleverdev.app,959998,ES63209535234862100767,1682.49,2023-02-27T13:10:37,Zarautz,expenses,repairs,-295.84,-38252.96
buyer_2,Carmen,Lozano,1984-09-05,54021274R,carmen.lozano@cleverdev.app,959998,ES63209535234862100767,1682.49,2023-02-28T15:49:50,Zarautz,expenses,food,-114.11,-38367.07
buyer_2,Carmen,Lozano,1984-09-05,54021274R,carmen.lozano@cleverdev.app,959998,ES63209535234862100767,1682.49,2023-03-01T10:31:21,Zarautz,incomes,salary,2092.91,-36274.16
buyer_2,Carmen,Lozano,1984-09-05,54021274R,carmen.lozano@cleverdev.app,959998,ES63209535234862100767,1682.49,2023-03-01T12:36:10,Zarautz,expenses,leisure,-21.9,-36296.06
buyer_2,Carmen,Lozano,1984-09-05,54021274R,carmen.lozano@cleverdev.app,959998,ES63209535234862100767,1682.49,2023-03-02T12:41:33,Zarautz,expenses,repairs,-272.95,-36569.01
buyer_2,Carmen,Lozano,1984-09-05,54021274R,carmen.lozano@cleverdev.app,959998,ES63209535234862100767,1682.49,2023-03-03T13:50:43,Zarautz,expenses,food,-91.7,-36660.71
buyer_2,Carmen,Lozano,1984-09-05,54021274R,carmen.lozano@cleverdev.app,959998,ES63209535234862100767,1682.49,2023-03-03T20:57:52,Zarautz,expenses,transport,-74.39,-36735.1
buyer_2,Carmen,Lozano,1984-09-05,54021274R,carmen.lozano@cleverdev.app,959998,ES63209535234862100767,1682.49,2023-03-03T09:10:29,Zarautz,expenses,cash,-100.0,-36835.1
buyer_2,Carmen,Lozano,1984-09-05,54021274R,carmen.lozano@cleverdev.app,959998,ES63209535234862100767,1682.49,2023-03-04T15:13:28,Zarautz,expenses,mortgage,-859.88,-37694.98
buyer_2,Carmen,Lozano,1984-09-05,54021274R,carmen.lozano@cleverdev.app,959998,ES63209535234862100767,1682.49,2023-03-04T18:58:16,Zarautz,expenses,transport,-41.86,-37736.84
buyer_2,Carmen,Lozano,1984-09-05,54021274R,carmen.lozano@cleverdev.app,959998,ES63209535234862100767,1682.49,2023-03-04T11:20:49,Zarautz,expenses,children,-530.22,-38267.06
buyer_2,Carmen,Lozano,1984-09-05,54021274R,carmen.lozano@cleverdev.app,959998,ES63209535234862100767,1682.49,2023-03-05T10:47:43,Zarautz,expenses,water,-39.82,-38306.88
buyer_2,Carmen,Lozano,1984-09-05,54021274R,carmen.lozano@cleverdev.app,959998,ES63209535234862100767,1682.49,2023-03-05T09:38:40,Zarautz,expenses,electricity,-28.73,-38335.61
buyer_2,Carmen,Lozano,1984-09-05,54021274R,carmen.lozano@cleverdev.app,959998,ES63209535234862100767,1682.49,2023-03-05T17:41:00,Zarautz,expenses,children,-782.52,-39118.13
buyer_2,Carmen,Lozano,1984-09-05,54021274R,carmen.lozano@cleverdev.app,959998,ES63209535234862100767,1682.49,2023-03-06T14:36:14,Zarautz,expenses,gas,-114.14,-39232.27
buyer_2,Carmen,Lozano,1984-09-05,54021274R,carmen.lozano@cleverdev.app,959998,ES63209535234862100767,1682.49,2023-03-07T05:34:33,Zarautz,expenses,water,-23.62,-39255.89
buyer_2,Carmen,Lozano,1984-09-05,54021274R,carmen.lozano@cleverdev.app,959998,ES63209535234862100767,1682.49,2023-03-07T21:51:35,Zarautz,expenses,phone,-33.87,-39289.76
buyer_2,Carmen,Lozano,1984-09-05,54021274R,carmen.lozano@cleverdev.app,959998,ES63209535234862100767,1682.49,2023-03-07T12:57:04,Zarautz,expenses,repairs,-165.49,-39455.25
buyer_2,Carmen,Lozano,1984-09-05,54021274R,carmen.lozano@cleverdev.app,959998,ES63209535234862100767,1682.49,2023-03-07T16:54:00,Zarautz,expenses,gifts,-370.31,-39825.56
buyer_2,Carmen,Lozano,1984-09-05,54021274R,carmen.lozano@cleverdev.app,959998,ES63209535234862100767,1682.49,2023-03-08T10:07:57,Zarautz,expenses,water,-27.14,-39852.7
buyer_2,Carmen,Lozano,1984-09-05,54021274R,carmen.lozano@cleverdev.app,959998,ES63209535234862100767,1682.49,2023-03-08T07:27:59,Zarautz,expenses,gas,-38.42,-39891.12
buyer_2,Carmen,Lozano,1984-09-05,54021274R,carmen.lozano@cleverdev.app,959998,ES63209535234862100767,1682.49,2023-03-08T07:23:06,Zarautz,expenses,food,-114.11,-40005.23
buyer_2,Carmen,Lozano,1984-09-05,54021274R,carmen.lozano@cleverdev.app,959998,ES63209535234862100767,1682.49,2023-03-08T20:20:28,Zarautz,expenses,repairs,-218.0,-40223.23
buyer_2,Carmen,Lozano,1984-09-05,54021274R,carmen.lozano@cleverdev.app,959998,ES63209535234862100767,1682.49,2023-03-13T20:20:41,Zarautz,expenses,repairs,-129.93,-40353.16
buyer_2,Carmen,Lozano,1984-09-05,54021274R,carmen.lozano@cleverdev.app,959998,ES63209535234862100767,1682.49,2023-03-19T20:07:11,Zarautz,expenses,leisure,-83.1,-40436.26
buyer_2,Carmen,Lozano,1984-09-05,54021274R,carmen.lozano@cleverdev.app,959998,ES63209535234862100767,1682.49,2023-03-20T08:32:18,Zarautz,expenses,cash,-100.0,-40536.26
buyer_2,Carmen,Lozano,1984-09-05,54021274R,carmen.lozano@cleverdev.app,959998,ES63209535234862100767,1682.49,2023-03-20T08:14:04,Zarautz,expenses,appliances,-104.32,-40640.58
buyer_2,Carmen,Lozano,1984-09-05,54021274R,carmen.lozano@cleverdev.app,959998,ES63209535234862100767,1682.49,2023-03-23T13:57:59,Zarautz,expenses,travel,-282.32,-40922.9
buyer_2,Carmen,Lozano,1984-09-05,54021274R,carmen.lozano@cleverdev.app,959998,ES63209535234862100767,1682.49,2023-03-24T12:57:32,Zarautz,expenses,food,-94.69,-41017.59
buyer_2,Carmen,Lozano,1984-09-05,54021274R,carmen.lozano@cleverdev.app,959998,ES63209535234862100767,1682.49,2023-03-27T03:05:13,Zarautz,expenses,appliances,-375.4,-41392.99
buyer_2,Carmen,Lozano,1984-09-05,54021274R,carmen.lozano@cleverdev.app,959998,ES63209535234862100767,1682.49,2023-03-28T20:37:50,Zarautz,expenses,food,-84.42,-41477.41
buyer_2,Carmen,Lozano,1984-09-05,54021274R,carmen.lozano@cleverdev.app,959998,ES63209535234862100767,1682.49,2023-03-28T14:24:58,Zarautz,expenses,cash,-100.0,-41577.41
buyer_2,Carmen,Lozano,1984-09-05,54021274R,carmen.lozano@cleverdev.app,959998,ES63209535234862100767,1682.49,2023-03-29T13:52:58,Zarautz,expenses,transport,-67.32,-41644.73
buyer_2,Carmen,Lozano,1984-09-05,54021274R,carmen.lozano@cleverdev.app,959998,ES63209535234862100767,1682.49,2023-03-29T23:24:39,Zarautz,expenses,cash,-100.0,-41744.73
buyer_2,Carmen,Lozano,1984-09-05,54021274R,carmen.lozano@cleverdev.app,959998,ES63209535234862100767,1682.49,2023-03-29T04:19:32,Zarautz,expenses,appliances,-317.89,-42062.62
buyer_2,Carmen,Lozano,1984-09-05,54021274R,carmen.lozano@cleverdev.app,959998,ES63209535234862100767,1682.49,2023-03-30T00:24:21,Zarautz,expenses,food,-99.2,-42161.82
buyer_2,Carmen,Lozano,1984-09-05,54021274R,carmen.lozano@cleverdev.app,959998,ES63209535234862100767,1682.49,2023-03-30T11:47:37,Zarautz,expenses,cash,-100.0,-42261.82
buyer_2,Carmen,Lozano,1984-09-05,54021274R,carmen.lozano@cleverdev.app,959998,ES63209535234862100767,1682.49,2023-03-30T13:40:13,Zarautz,expenses,gifts,-688.0,-42949.82
buyer_2,Carmen,Lozano,1984-09-05,54021274R,carmen.lozano@cleverdev.app,959998,ES63209535234862100767,1682.49,2023-04-01T13:18:07,Zarautz,incomes,salary,2092.91,-40856.91
buyer_2,Carmen,Lozano,1984-09-05,54021274R,carmen.lozano@cleverdev.app,959998,ES63209535234862100767,1682.49,2023-04-03T16:21:49,Zarautz,expenses,food,-120.83,-40977.74
buyer_2,Carmen,Lozano,1984-09-05,54021274R,carmen.lozano@cleverdev.app,959998,ES63209535234862100767,1682.49,2023-04-03T15:29:56,Zarautz,expenses,leisure,-59.4,-41037.14
buyer_2,Carmen,Lozano,1984-09-05,54021274R,carmen.lozano@cleverdev.app,959998,ES63209535234862100767,1682.49,2023-04-03T12:25:27,Zarautz,expenses,repairs,-284.93,-41322.07
buyer_2,Carmen,Lozano,1984-09-05,54021274R,carmen.lozano@cleverdev.app,959998,ES63209535234862100767,1682.49,2023-04-04T15:11:14,Zarautz,expenses,mortgage,-859.88,-42181.95
buyer_2,Carmen,Lozano,1984-09-05,54021274R,carmen.lozano@cleverdev.app,959998,ES63209535234862100767,1682.49,2023-04-04T05:39:58,Zarautz,expenses,leisure,-61.83,-42243.78
buyer_2,Carmen,Lozano,1984-09-05,54021274R,carmen.lozano@cleverdev.app,959998,ES63209535234862100767,1682.49,2023-04-04T12:49:21,Zarautz,expenses,gifts,-232.47,-42476.25
buyer_2,Carmen,Lozano,1984-09-05,54021274R,carmen.lozano@cleverdev.app,959998,ES63209535234862100767,1682.49,2023-04-06T15:37:39,Zarautz,expenses,phone,-46.04,-42522.29
buyer_2,Carmen,Lozano,1984-09-05,54021274R,carmen.lozano@cleverdev.app,959998,ES63209535234862100767,1682.49,2023-04-06T18:06:30,Zarautz,expenses,leisure,-33.88,-42556.17
buyer_2,Carmen,Lozano,1984-09-05,54021274R,carmen.lozano@cleverdev.app,959998,ES63209535234862100767,1682.49,2023-04-06T13:15:27,Zarautz,expenses,cash,-100.0,-42656.17
buyer_2,Carmen,Lozano,1984-09-05,54021274R,carmen.lozano@cleverdev.app,959998,ES63209535234862100767,1682.49,2023-04-07T10:08:11,Zarautz,expenses,electricity,-26.92,-42683.09
buyer_2,Carmen,Lozano,1984-09-05,54021274R,carmen.lozano@cleverdev.app,959998,ES63209535234862100767,1682.49,2023-04-07T11:54:34,Zarautz,expenses,gas,-119.79,-42802.88
buyer_2,Carmen,Lozano,1984-09-05,54021274R,carmen.lozano@cleverdev.app,959998,ES63209535234862100767,1682.49,2023-04-07T13:23:14,Zarautz,expenses,phone,-37.74,-42840.62
buyer_2,Carmen,Lozano,1984-09-05,54021274R,carmen.lozano@cleverdev.app,959998,ES63209535234862100767,1682.49,2023-04-07T14:04:02,Zarautz,expenses,travel,-833.65,-43674.27
buyer_2,Carmen,Lozano,1984-09-05,54021274R,carmen.lozano@cleverdev.app,959998,ES63209535234862100767,1682.49,2023-04-08T19:13:41,Zarautz,expenses,transport,-57.73,-43732.0
buyer_2,Carmen,Lozano,1984-09-05,54021274R,carmen.lozano@cleverdev.app,959998,ES63209535234862100767,1682.49,2023-04-09T11:23:08,Zarautz,expenses,children,-585.42,-44317.42
buyer_2,Carmen,Lozano,1984-09-05,54021274R,carmen.lozano@cleverdev.app,959998,ES63209535234862100767,1682.49,2023-04-11T12:00:57,Zarautz,expenses,travel,-878.68,-45196.1
buyer_2,Carmen,Lozano,1984-09-05,54021274R,carmen.lozano@cleverdev.app,959998,ES63209535234862100767,1682.49,2023-04-12T21:10:02,Zarautz,expenses,leisure,-77.94,-45274.04
buyer_2,Carmen,Lozano,1984-09-05,54021274R,carmen.lozano@cleverdev.app,959998,ES63209535234862100767,1682.49,2023-04-13T15:43:29,Zarautz,expenses,transport,-60.85,-45334.89
buyer_2,Carmen,Lozano,1984-09-05,54021274R,carmen.lozano@cleverdev.app,959998,ES63209535234862100767,1682.49,2023-04-15T14:26:13,Zarautz,expenses,leisure,-83.86,-45418.75
buyer_2,Carmen,Lozano,1984-09-05,54021274R,carmen.lozano@cleverdev.app,959998,ES63209535234862100767,1682.49,2023-04-16T23:57:50,Zarautz,expenses,clothing,-125.27,-45544.02
buyer_2,Carmen,Lozano,1984-09-05,54021274R,carmen.lozano@cleverdev.app,959998,ES63209535234862100767,1682.49,2023-04-18T11:29:17,Zarautz,expenses,children,-527.15,-46071.17
buyer_2,Carmen,Lozano,1984-09-05,54021274R,carmen.lozano@cleverdev.app,959998,ES63209535234862100767,1682.49,2023-04-19T14:34:34,Zarautz,expenses,transport,-65.98,-46137.15
buyer_2,Carmen,Lozano,1984-09-05,54021274R,carmen.lozano@cleverdev.app,959998,ES63209535234862100767,1682.49,2023-04-22T14:23:54,Zarautz,expenses,leisure,-60.9,-46198.05
buyer_2,Carmen,Lozano,1984-09-05,54021274R,carmen.lozano@cleverdev.app,959998,ES63209535234862100767,1682.49,2023-04-23T18:00:02,Zarautz,expenses,food,-93.56,-46291.61
buyer_2,Carmen,Lozano,1984-09-05,54021274R,carmen.lozano@cleverdev.app,959998,ES63209535234862100767,1682.49,2023-04-23T16:43:56,Zarautz,expenses,healthcare,-47.64,-46339.25
buyer_2,Carmen,Lozano,1984-09-05,54021274R,carmen.lozano@cleverdev.app,959998,ES63209535234862100767,1682.49,2023-04-24T11:44:15,Zarautz,expenses,gifts,-762.59,-47101.84
buyer_2,Carmen,Lozano,1984-09-05,54021274R,carmen.lozano@cleverdev.app,959998,ES63209535234862100767,1682.49,2023-04-25T16:33:18,Zarautz,expenses,transport,-79.54,-47181.38
buyer_2,Carmen,Lozano,1984-09-05,54021274R,carmen.lozano@cleverdev.app,959998,ES63209535234862100767,1682.49,2023-04-26T15:55:20,Zarautz,expenses,healthcare,-73.08,-47254.46
buyer_2,Carmen,Lozano,1984-09-05,54021274R,carmen.lozano@cleverdev.app,959998,ES63209535234862100767,1682.49,2023-04-27T17:51:12,Zarautz,expenses,repairs,-286.7,-47541.16
buyer_2,Carmen,Lozano,1984-09-05,54021274R,carmen.lozano@cleverdev.app,959998,ES63209535234862100767,1682.49,2023-04-28T20:03:40,Zarautz,expenses,cash,-100.0,-47641.16
buyer_2,Carmen,Lozano,1984-09-05,54021274R,carmen.lozano@cleverdev.app,959998,ES63209535234862100767,1682.49,2023-04-28T09:25:27,Zarautz,expenses,repairs,-120.49,-47761.65
buyer_2,Carmen,Lozano,1984-09-05,54021274R,carmen.lozano@cleverdev.app,959998,ES63209535234862100767,1682.49,2023-04-30T20:11:47,Zarautz,expenses,leisure,-84.54,-47846.19
buyer_2,Carmen,Lozano,1984-09-05,54021274R,carmen.lozano@cleverdev.app,959998,ES63209535234862100767,1682.49,2023-04-30T11:46:35,Zarautz,expenses,repairs,-277.47,-48123.66
buyer_2,Carmen,Lozano,1984-09-05,54021274R,carmen.lozano@cleverdev.app,959998,ES63209535234862100767,1682.49,2023-05-01T14:44:33,Zarautz,incomes,salary,2092.91,-46030.75
buyer_2,Carmen,Lozano,1984-09-05,54021274R,carmen.lozano@cleverdev.app,959998,ES63209535234862100767,1682.49,2023-05-02T22:16:13,Zarautz,expenses,transport,-88.66,-46119.41
buyer_2,Carmen,Lozano,1984-09-05,54021274R,carmen.lozano@cleverdev.app,959998,ES63209535234862100767,1682.49,2023-05-03T15:10:03,Zarautz,expenses,cash,-100.0,-46219.41
buyer_2,Carmen,Lozano,1984-09-05,54021274R,carmen.lozano@cleverdev.app,959998,ES63209535234862100767,1682.49,2023-05-04T09:52:44,Zarautz,expenses,mortgage,-859.88,-47079.29
buyer_2,Carmen,Lozano,1984-09-05,54021274R,carmen.lozano@cleverdev.app,959998,ES63209535234862100767,1682.49,2023-05-05T04:08:43,Zarautz,expenses,gas,-99.13,-47178.42
buyer_2,Carmen,Lozano,1984-09-05,54021274R,carmen.lozano@cleverdev.app,959998,ES63209535234862100767,1682.49,2023-05-08T11:13:22,Zarautz,expenses,gas,-41.98,-47220.4
buyer_2,Carmen,Lozano,1984-09-05,54021274R,carmen.lozano@cleverdev.app,959998,ES63209535234862100767,1682.49,2023-05-09T07:22:23,Zarautz,expenses,repairs,-238.96,-47459.36
buyer_2,Carmen,Lozano,1984-09-05,54021274R,carmen.lozano@cleverdev.app,959998,ES63209535234862100767,1682.49,2023-05-10T21:25:27,Zarautz,expenses,gifts,-111.4,-47570.76
buyer_2,Carmen,Lozano,1984-09-05,54021274R,carmen.lozano@cleverdev.app,959998,ES63209535234862100767,1682.49,2023-05-12T13:50:42,Zarautz,expenses,travel,-481.36,-48052.12
buyer_2,Carmen,Lozano,1984-09-05,54021274R,carmen.lozano@cleverdev.app,959998,ES63209535234862100767,1682.49,2023-05-13T21:01:27,Zarautz,expenses,cash,-100.0,-48152.12
buyer_2,Carmen,Lozano,1984-09-05,54021274R,carmen.lozano@cleverdev.app,959998,ES63209535234862100767,1682.49,2023-05-19T11:39:33,Zarautz,expenses,food,-85.57,-48237.69
buyer_2,Carmen,Lozano,1984-09-05,54021274R,carmen.lozano@cleverdev.app,959998,ES63209535234862100767,1682.49,2023-05-20T11:53:41,Zarautz,expenses,cash,-100.0,-48337.69
buyer_2,Carmen,Lozano,1984-09-05,54021274R,carmen.lozano@cleverdev.app,959998,ES63209535234862100767,1682.49,2023-05-20T18:04:21,Zarautz,expenses,children,-288.24,-48625.93
buyer_2,Carmen,Lozano,1984-09-05,54021274R,carmen.lozano@cleverdev.app,959998,ES63209535234862100767,1682.49,2023-05-22T09:43:06,Zarautz,expenses,children,-200.04,-48825.97
buyer_2,Carmen,Lozano,1984-09-05,54021274R,carmen.lozano@cleverdev.app,959998,ES63209535234862100767,1682.49,2023-05-23T11:49:23,Zarautz,expenses,education,-59.02,-48884.99
buyer_2,Carmen,Lozano,1984-09-05,54021274R,carmen.lozano@cleverdev.app,959998,ES63209535234862100767,1682.49,2023-05-24T04:51:18,Zarautz,expenses,cash,-100.0,-48984.99
buyer_2,Carmen,Lozano,1984-09-05,54021274R,carmen.lozano@cleverdev.app,959998,ES63209535234862100767,1682.49,2023-05-25T21:03:14,Zarautz,expenses,leisure,-82.36,-49067.35
buyer_2,Carmen,Lozano,1984-09-05,54021274R,carmen.lozano@cleverdev.app,959998,ES63209535234862100767,1682.49,2023-05-25T17:00:19,Zarautz,expenses,cash,-100.0,-49167.35
buyer_2,Carmen,Lozano,1984-09-05,54021274R,carmen.lozano@cleverdev.app,959998,ES63209535234862100767,1682.49,2023-05-26T16:42:22,Zarautz,expenses,transport,-77.66,-49245.01
buyer_2,Carmen,Lozano,1984-09-05,54021274R,carmen.lozano@cleverdev.app,959998,ES63209535234862100767,1682.49,2023-05-26T18:59:54,Zarautz,expenses,leisure,-72.69,-49317.7
buyer_2,Carmen,Lozano,1984-09-05,54021274R,carmen.lozano@cleverdev.app,959998,ES63209535234862100767,1682.49,2023-05-26T02:34:40,Zarautz,expenses,cash,-100.0,-49417.7
buyer_2,Carmen,Lozano,1984-09-05,54021274R,carmen.lozano@cleverdev.app,959998,ES63209535234862100767,1682.49,2023-05-29T20:49:52,Zarautz,expenses,food,-121.01,-49538.71
buyer_2,Carmen,Lozano,1984-09-05,54021274R,carmen.lozano@cleverdev.app,959998,ES63209535234862100767,1682.49,2023-05-29T08:33:11,Zarautz,expenses,leisure,-21.18,-49559.89
buyer_2,Carmen,Lozano,1984-09-05,54021274R,carmen.lozano@cleverdev.app,959998,ES63209535234862100767,1682.49,2023-05-30T10:19:52,Zarautz,expenses,food,-72.73,-49632.62
buyer_2,Carmen,Lozano,1984-09-05,54021274R,carmen.lozano@cleverdev.app,959998,ES63209535234862100767,1682.49,2023-05-30T14:59:30,Zarautz,expenses,transport,-66.08,-49698.7
buyer_2,Carmen,Lozano,1984-09-05,54021274R,carmen.lozano@cleverdev.app,959998,ES63209535234862100767,1682.49,2023-06-01T19:54:52,Zarautz,incomes,salary,2092.91,-47605.79
buyer_2,Carmen,Lozano,1984-09-05,54021274R,carmen.lozano@cleverdev.app,959998,ES63209535234862100767,1682.49,2023-06-01T19:54:52,Zarautz,incomes,extra_income,358.06,-47247.73
buyer_2,Carmen,Lozano,1984-09-05,54021274R,carmen.lozano@cleverdev.app,959998,ES63209535234862100767,1682.49,2023-06-01T19:54:52,Zarautz,incomes,salary_bonus,1525.29,-45722.44
buyer_2,Carmen,Lozano,1984-09-05,54021274R,carmen.lozano@cleverdev.app,959998,ES63209535234862100767,1682.49,2023-06-01T07:50:09,Zarautz,expenses,taxes,-1549.98,-47272.42
buyer_2,Carmen,Lozano,1984-09-05,54021274R,carmen.lozano@cleverdev.app,959998,ES63209535234862100767,1682.49,2023-06-01T18:03:31,Zarautz,expenses,insurance,-374.3,-47646.72
buyer_2,Carmen,Lozano,1984-09-05,54021274R,carmen.lozano@cleverdev.app,959998,ES63209535234862100767,1682.49,2023-06-04T14:45:42,Zarautz,expenses,mortgage,-859.88,-48506.6
buyer_2,Carmen,Lozano,1984-09-05,54021274R,carmen.lozano@cleverdev.app,959998,ES63209535234862100767,1682.49,2023-06-05T16:38:31,Zarautz,expenses,water,-46.94,-48553.54
buyer_2,Carmen,Lozano,1984-09-05,54021274R,carmen.lozano@cleverdev.app,959998,ES63209535234862100767,1682.49,2023-06-05T14:16:00,Zarautz,expenses,transport,-73.92,-48627.46
buyer_2,Carmen,Lozano,1984-09-05,54021274R,carmen.lozano@cleverdev.app,959998,ES63209535234862100767,1682.49,2023-06-05T18:55:16,Zarautz,expenses,leisure,-31.62,-48659.08
buyer_2,Carmen,Lozano,1984-09-05,54021274R,carmen.lozano@cleverdev.app,959998,ES63209535234862100767,1682.49,2023-06-06T17:01:32,Zarautz,expenses,water,-35.88,-48694.96
buyer_2,Carmen,Lozano,1984-09-05,54021274R,carmen.lozano@cleverdev.app,959998,ES63209535234862100767,1682.49,2023-06-06T08:20:01,Zarautz,expenses,education,-70.32,-48765.28
buyer_2,Carmen,Lozano,1984-09-05,54021274R,carmen.lozano@cleverdev.app,959998,ES63209535234862100767,1682.49,2023-06-06T14:17:43,Zarautz,expenses,gifts,-608.93,-49374.21
buyer_2,Carmen,Lozano,1984-09-05,54021274R,carmen.lozano@cleverdev.app,959998,ES63209535234862100767,1682.49,2023-06-07T20:34:54,Zarautz,expenses,water,-23.44,-49397.65
buyer_2,Carmen,Lozano,1984-09-05,54021274R,carmen.lozano@cleverdev.app,959998,ES63209535234862100767,1682.49,2023-06-08T14:33:57,Zarautz,expenses,healthcare,-41.5,-49439.15
buyer_2,Carmen,Lozano,1984-09-05,54021274R,carmen.lozano@cleverdev.app,959998,ES63209535234862100767,1682.49,2023-06-08T01:51:57,Zarautz,expenses,appliances,-252.07,-49691.22
buyer_2,Carmen,Lozano,1984-09-05,54021274R,carmen.lozano@cleverdev.app,959998,ES63209535234862100767,1682.49,2023-06-10T13:53:37,Zarautz,expenses,leisure,-51.44,-49742.66
buyer_2,Carmen,Lozano,1984-09-05,54021274R,carmen.lozano@cleverdev.app,959998,ES63209535234862100767,1682.49,2023-06-11T14:01:31,Zarautz,expenses,gifts,-35.64,-49778.3
buyer_2,Carmen,Lozano,1984-09-05,54021274R,carmen.lozano@cleverdev.app,959998,ES63209535234862100767,1682.49,2023-06-12T02:32:06,Zarautz,expenses,leisure,-49.57,-49827.87
buyer_2,Carmen,Lozano,1984-09-05,54021274R,carmen.lozano@cleverdev.app,959998,ES63209535234862100767,1682.49,2023-06-13T23:56:32,Zarautz,expenses,leisure,-80.66,-49908.53
buyer_2,Carmen,Lozano,1984-09-05,54021274R,carmen.lozano@cleverdev.app,959998,ES63209535234862100767,1682.49,2023-06-14T21:55:56,Zarautz,expenses,leisure,-60.86,-49969.39
buyer_2,Carmen,Lozano,1984-09-05,54021274R,carmen.lozano@cleverdev.app,959998,ES63209535234862100767,1682.49,2023-06-15T17:00:46,Zarautz,expenses,food,-82.05,-50051.44
buyer_2,Carmen,Lozano,1984-09-05,54021274R,carmen.lozano@cleverdev.app,959998,ES63209535234862100767,1682.49,2023-06-15T16:05:11,Zarautz,expenses,cash,-100.0,-50151.44
buyer_2,Carmen,Lozano,1984-09-05,54021274R,carmen.lozano@cleverdev.app,959998,ES63209535234862100767,1682.49,2023-06-18T03:10:07,Zarautz,expenses,food,-90.19,-50241.63
buyer_2,Carmen,Lozano,1984-09-05,54021274R,carmen.lozano@cleverdev.app,959998,ES63209535234862100767,1682.49,2023-06-18T20:43:30,Zarautz,expenses,transport,-54.63,-50296.26
buyer_2,Carmen,Lozano,1984-09-05,54021274R,carmen.lozano@cleverdev.app,959998,ES63209535234862100767,1682.49,2023-06-18T03:29:12,Zarautz,expenses,gifts,-565.32,-50861.58
buyer_2,Carmen,Lozano,1984-09-05,54021274R,carmen.lozano@cleverdev.app,959998,ES63209535234862100767,1682.49,2023-06-20T20:41:19,Zarautz,expenses,transport,-55.69,-50917.27
buyer_2,Carmen,Lozano,1984-09-05,54021274R,carmen.lozano@cleverdev.app,959998,ES63209535234862100767,1682.49,2023-06-21T11:50:37,Zarautz,expenses,healthcare,-176.81,-51094.08
buyer_2,Carmen,Lozano,1984-09-05,54021274R,carmen.lozano@cleverdev.app,959998,ES63209535234862100767,1682.49,2023-06-21T11:21:57,Zarautz,expenses,cash,-100.0,-51194.08
buyer_2,Carmen,Lozano,1984-09-05,54021274R,carmen.lozano@cleverdev.app,959998,ES63209535234862100767,1682.49,2023-06-21T20:29:14,Zarautz,expenses,gifts,-500.96,-51695.04
buyer_2,Carmen,Lozano,1984-09-05,54021274R,carmen.lozano@cleverdev.app,959998,ES63209535234862100767,1682.49,2023-06-23T08:07:50,Zarautz,expenses,cash,-100.0,-51795.04
buyer_2,Carmen,Lozano,1984-09-05,54021274R,carmen.lozano@cleverdev.app,959998,ES63209535234862100767,1682.49,2023-06-24T04:49:10,Zarautz,expenses,leisure,-40.24,-51835.28
buyer_2,Carmen,Lozano,1984-09-05,54021274R,carmen.lozano@cleverdev.app,959998,ES63209535234862100767,1682.49,2023-06-24T11:12:07,Zarautz,expenses,clothing,-59.15,-51894.43
buyer_2,Carmen,Lozano,1984-09-05,54021274R,carmen.lozano@cleverdev.app,959998,ES63209535234862100767,1682.49,2023-06-25T22:56:37,Zarautz,expenses,clothing,-117.13,-52011.56
buyer_2,Carmen,Lozano,1984-09-05,54021274R,carmen.lozano@cleverdev.app,959998,ES63209535234862100767,1682.49,2023-06-25T17:49:48,Zarautz,expenses,cash,-100.0,-52111.56
buyer_2,Carmen,Lozano,1984-09-05,54021274R,carmen.lozano@cleverdev.app,959998,ES63209535234862100767,1682.49,2023-06-28T17:52:55,Zarautz,expenses,leisure,-35.32,-52146.88
buyer_2,Carmen,Lozano,1984-09-05,54021274R,carmen.lozano@cleverdev.app,959998,ES63209535234862100767,1682.49,2023-06-29T09:38:44,Zarautz,expenses,transport,-69.06,-52215.94
buyer_2,Carmen,Lozano,1984-09-05,54021274R,carmen.lozano@cleverdev.app,959998,ES63209535234862100767,1682.49,2023-06-29T08:54:30,Zarautz,expenses,gifts,-537.33,-52753.27
buyer_2,Carmen,Lozano,1984-09-05,54021274R,carmen.lozano@cleverdev.app,959998,ES63209535234862100767,1682.49,2023-07-01T21:13:14,Zarautz,incomes,salary,2092.91,-50660.36
buyer_2,Carmen,Lozano,1984-09-05,54021274R,carmen.lozano@cleverdev.app,959998,ES63209535234862100767,1682.49,2023-07-01T10:45:29,Zarautz,expenses,food,-82.06,-50742.42
buyer_2,Carmen,Lozano,1984-09-05,54021274R,carmen.lozano@cleverdev.app,959998,ES63209535234862100767,1682.49,2023-07-01T22:54:24,Zarautz,expenses,transport,-60.5,-50802.92
buyer_2,Carmen,Lozano,1984-09-05,54021274R,carmen.lozano@cleverdev.app,959998,ES63209535234862100767,1682.49,2023-07-01T18:25:16,Zarautz,expenses,cash,-100.0,-50902.92
buyer_2,Carmen,Lozano,1984-09-05,54021274R,carmen.lozano@cleverdev.app,959998,ES63209535234862100767,1682.49,2023-07-02T16:58:45,Zarautz,expenses,leisure,-29.72,-50932.64
buyer_2,Carmen,Lozano,1984-09-05,54021274R,carmen.lozano@cleverdev.app,959998,ES63209535234862100767,1682.49,2023-07-03T13:05:19,Zarautz,expenses,cash,-100.0,-51032.64
buyer_2,Carmen,Lozano,1984-09-05,54021274R,carmen.lozano@cleverdev.app,959998,ES63209535234862100767,1682.49,2023-07-04T05:55:59,Zarautz,expenses,mortgage,-859.88,-51892.52
buyer_2,Carmen,Lozano,1984-09-05,54021274R,carmen.lozano@cleverdev.app,959998,ES63209535234862100767,1682.49,2023-07-04T19:11:34,Zarautz,expenses,clothing,-125.63,-52018.15
buyer_2,Carmen,Lozano,1984-09-05,54021274R,carmen.lozano@cleverdev.app,959998,ES63209535234862100767,1682.49,2023-07-04T18:21:16,Zarautz,expenses,education,-68.56,-52086.71
buyer_2,Carmen,Lozano,1984-09-05,54021274R,carmen.lozano@cleverdev.app,959998,ES63209535234862100767,1682.49,2023-07-05T17:04:25,Zarautz,expenses,water,-37.36,-52124.07
buyer_2,Carmen,Lozano,1984-09-05,54021274R,carmen.lozano@cleverdev.app,959998,ES63209535234862100767,1682.49,2023-07-05T11:02:25,Zarautz,expenses,electricity,-67.4,-52191.47
buyer_2,Carmen,Lozano,1984-09-05,54021274R,carmen.lozano@cleverdev.app,959998,ES63209535234862100767,1682.49,2023-07-06T07:08:27,Zarautz,expenses,food,-67.93,-52259.4
buyer_2,Carmen,Lozano,1984-09-05,54021274R,carmen.lozano@cleverdev.app,959998,ES63209535234862100767,1682.49,2023-07-07T18:20:02,Zarautz,expenses,gas,-80.45,-52339.85
buyer_2,Carmen,Lozano,1984-09-05,54021274R,carmen.lozano@cleverdev.app,959998,ES63209535234862100767,1682.49,2023-07-07T19:27:09,Zarautz,expenses,phone,-41.17,-52381.02
buyer_2,Carmen,Lozano,1984-09-05,54021274R,carmen.lozano@cleverdev.app,959998,ES63209535234862100767,1682.49,2023-07-09T20:49:45,Zarautz,expenses,clothing,-102.86,-52483.88
buyer_2,Carmen,Lozano,1984-09-05,54021274R,carmen.lozano@cleverdev.app,959998,ES63209535234862100767,1682.49,2023-07-10T01:57:32,Zarautz,expenses,leisure,-81.74,-52565.62
buyer_2,Carmen,Lozano,1984-09-05,54021274R,carmen.lozano@cleverdev.app,959998,ES63209535234862100767,1682.49,2023-07-10T10:23:38,Zarautz,expenses,clothing,-134.64,-52700.26
buyer_2,Carmen,Lozano,1984-09-05,54021274R,carmen.lozano@cleverdev.app,959998,ES63209535234862100767,1682.49,2023-07-10T19:46:52,Zarautz,expenses,cash,-100.0,-52800.26
buyer_2,Carmen,Lozano,1984-09-05,54021274R,carmen.lozano@cleverdev.app,959998,ES63209535234862100767,1682.49,2023-07-11T13:16:17,Zarautz,expenses,transport,-56.45,-52856.71
buyer_2,Carmen,Lozano,1984-09-05,54021274R,carmen.lozano@cleverdev.app,959998,ES63209535234862100767,1682.49,2023-07-13T12:24:20,Zarautz,expenses,leisure,-55.48,-52912.19
buyer_2,Carmen,Lozano,1984-09-05,54021274R,carmen.lozano@cleverdev.app,959998,ES63209535234862100767,1682.49,2023-07-15T17:10:55,Zarautz,expenses,transport,-76.63,-52988.82
buyer_2,Carmen,Lozano,1984-09-05,54021274R,carmen.lozano@cleverdev.app,959998,ES63209535234862100767,1682.49,2023-07-16T22:41:44,Zarautz,expenses,cash,-100.0,-53088.82
buyer_2,Carmen,Lozano,1984-09-05,54021274R,carmen.lozano@cleverdev.app,959998,ES63209535234862100767,1682.49,2023-07-17T19:10:34,Zarautz,expenses,clothing,-67.74,-53156.56
buyer_2,Carmen,Lozano,1984-09-05,54021274R,carmen.lozano@cleverdev.app,959998,ES63209535234862100767,1682.49,2023-07-17T20:09:49,Zarautz,expenses,healthcare,-137.8,-53294.36
buyer_2,Carmen,Lozano,1984-09-05,54021274R,carmen.lozano@cleverdev.app,959998,ES63209535234862100767,1682.49,2023-07-19T20:08:18,Zarautz,expenses,travel,-319.54,-53613.9
buyer_2,Carmen,Lozano,1984-09-05,54021274R,carmen.lozano@cleverdev.app,959998,ES63209535234862100767,1682.49,2023-07-20T05:20:33,Zarautz,expenses,food,-80.57,-53694.47
buyer_2,Carmen,Lozano,1984-09-05,54021274R,carmen.lozano@cleverdev.app,959998,ES63209535234862100767,1682.49,2023-07-20T20:53:03,Zarautz,expenses,leisure,-44.6,-53739.07
buyer_2,Carmen,Lozano,1984-09-05,54021274R,carmen.lozano@cleverdev.app,959998,ES63209535234862100767,1682.49,2023-07-22T19:28:47,Zarautz,expenses,leisure,-70.1,-53809.17
buyer_2,Carmen,Lozano,1984-09-05,54021274R,carmen.lozano@cleverdev.app,959998,ES63209535234862100767,1682.49,2023-07-24T21:49:57,Zarautz,expenses,repairs,-281.85,-54091.02
buyer_2,Carmen,Lozano,1984-09-05,54021274R,carmen.lozano@cleverdev.app,959998,ES63209535234862100767,1682.49,2023-07-26T12:53:01,Zarautz,expenses,food,-107.22,-54198.24
buyer_2,Carmen,Lozano,1984-09-05,54021274R,carmen.lozano@cleverdev.app,959998,ES63209535234862100767,1682.49,2023-07-28T08:10:17,Zarautz,expenses,cash,-100.0,-54298.24
buyer_2,Carmen,Lozano,1984-09-05,54021274R,carmen.lozano@cleverdev.app,959998,ES63209535234862100767,1682.49,2023-07-28T16:45:23,Zarautz,expenses,gifts,-456.86,-54755.1
buyer_2,Carmen,Lozano,1984-09-05,54021274R,carmen.lozano@cleverdev.app,959998,ES63209535234862100767,1682.49,2023-08-01T06:49:10,Zarautz,incomes,salary,2092.91,-52662.19
buyer_2,Carmen,Lozano,1984-09-05,54021274R,carmen.lozano@cleverdev.app,959998,ES63209535234862100767,1682.49,2023-08-02T03:21:56,Zarautz,expenses,food,-97.39,-52759.58
buyer_2,Carmen,Lozano,1984-09-05,54021274R,carmen.lozano@cleverdev.app,959998,ES63209535234862100767,1682.49,2023-08-03T20:47:09,Zarautz,expenses,cash,-100.0,-52859.58
buyer_2,Carmen,Lozano,1984-09-05,54021274R,carmen.lozano@cleverdev.app,959998,ES63209535234862100767,1682.49,2023-08-03T15:12:28,Zarautz,expenses,gifts,-354.39,-53213.97
buyer_2,Carmen,Lozano,1984-09-05,54021274R,carmen.lozano@cleverdev.app,959998,ES63209535234862100767,1682.49,2023-08-04T07:45:20,Zarautz,expenses,mortgage,-859.88,-54073.85
buyer_2,Carmen,Lozano,1984-09-05,54021274R,carmen.lozano@cleverdev.app,959998,ES63209535234862100767,1682.49,2023-08-04T10:33:21,Zarautz,expenses,food,-78.42,-54152.27
buyer_2,Carmen,Lozano,1984-09-05,54021274R,carmen.lozano@cleverdev.app,959998,ES63209535234862100767,1682.49,2023-08-05T14:22:21,Zarautz,expenses,electricity,-36.31,-54188.58
buyer_2,Carmen,Lozano,1984-09-05,54021274R,carmen.lozano@cleverdev.app,959998,ES63209535234862100767,1682.49,2023-08-05T19:01:33,Zarautz,expenses,gas,-48.05,-54236.63
buyer_2,Carmen,Lozano,1984-09-05,54021274R,carmen.lozano@cleverdev.app,959998,ES63209535234862100767,1682.49,2023-08-07T20:02:11,Zarautz,expenses,phone,-40.03,-54276.66
buyer_2,Carmen,Lozano,1984-09-05,54021274R,carmen.lozano@cleverdev.app,959998,ES63209535234862100767,1682.49,2023-08-07T16:45:16,Zarautz,expenses,cash,-100.0,-54376.66
buyer_2,Carmen,Lozano,1984-09-05,54021274R,carmen.lozano@cleverdev.app,959998,ES63209535234862100767,1682.49,2023-08-08T15:35:01,Zarautz,expenses,water,-31.12,-54407.78
buyer_2,Carmen,Lozano,1984-09-05,54021274R,carmen.lozano@cleverdev.app,959998,ES63209535234862100767,1682.49,2023-08-08T14:48:07,Zarautz,expenses,electricity,-57.0,-54464.78
buyer_2,Carmen,Lozano,1984-09-05,54021274R,carmen.lozano@cleverdev.app,959998,ES63209535234862100767,1682.49,2023-08-11T17:06:34,Zarautz,expenses,food,-76.28,-54541.06
buyer_2,Carmen,Lozano,1984-09-05,54021274R,carmen.lozano@cleverdev.app,959998,ES63209535234862100767,1682.49,2023-08-12T16:07:16,Zarautz,expenses,transport,-48.98,-54590.04
buyer_2,Carmen,Lozano,1984-09-05,54021274R,carmen.lozano@cleverdev.app,959998,ES63209535234862100767,1682.49,2023-08-12T16:55:51,Zarautz,expenses,cash,-100.0,-54690.04
buyer_2,Carmen,Lozano,1984-09-05,54021274R,carmen.lozano@cleverdev.app,959998,ES63209535234862100767,1682.49,2023-08-14T13:51:17,Zarautz,expenses,transport,-51.37,-54741.41
buyer_2,Carmen,Lozano,1984-09-05,54021274R,carmen.lozano@cleverdev.app,959998,ES63209535234862100767,1682.49,2023-08-15T12:37:00,Zarautz,expenses,food,-82.85,-54824.26
buyer_2,Carmen,Lozano,1984-09-05,54021274R,carmen.lozano@cleverdev.app,959998,ES63209535234862100767,1682.49,2023-08-16T19:49:25,Zarautz,expenses,food,-66.57,-54890.83
buyer_2,Carmen,Lozano,1984-09-05,54021274R,carmen.lozano@cleverdev.app,959998,ES63209535234862100767,1682.49,2023-08-16T11:17:10,Zarautz,expenses,travel,-443.98,-55334.81
buyer_2,Carmen,Lozano,1984-09-05,54021274R,carmen.lozano@cleverdev.app,959998,ES63209535234862100767,1682.49,2023-08-17T20:24:26,Zarautz,expenses,leisure,-63.99,-55398.8
buyer_2,Carmen,Lozano,1984-09-05,54021274R,carmen.lozano@cleverdev.app,959998,ES63209535234862100767,1682.49,2023-08-17T15:30:20,Zarautz,expenses,cash,-100.0,-55498.8
buyer_2,Carmen,Lozano,1984-09-05,54021274R,carmen.lozano@cleverdev.app,959998,ES63209535234862100767,1682.49,2023-08-18T18:00:56,Zarautz,expenses,education,-63.66,-55562.46
buyer_2,Carmen,Lozano,1984-09-05,54021274R,carmen.lozano@cleverdev.app,959998,ES63209535234862100767,1682.49,2023-08-19T22:33:59,Zarautz,expenses,cash,-100.0,-55662.46
buyer_2,Carmen,Lozano,1984-09-05,54021274R,carmen.lozano@cleverdev.app,959998,ES63209535234862100767,1682.49,2023-08-20T17:20:29,Zarautz,expenses,transport,-54.19,-55716.65
buyer_2,Carmen,Lozano,1984-09-05,54021274R,carmen.lozano@cleverdev.app,959998,ES63209535234862100767,1682.49,2023-08-20T17:45:38,Zarautz,expenses,leisure,-18.2,-55734.85
buyer_2,Carmen,Lozano,1984-09-05,54021274R,carmen.lozano@cleverdev.app,959998,ES63209535234862100767,1682.49,2023-08-21T22:39:41,Zarautz,expenses,food,-120.0,-55854.85
buyer_2,Carmen,Lozano,1984-09-05,54021274R,carmen.lozano@cleverdev.app,959998,ES63209535234862100767,1682.49,2023-08-21T20:49:26,Zarautz,expenses,transport,-72.8,-55927.65
buyer_2,Carmen,Lozano,1984-09-05,54021274R,carmen.lozano@cleverdev.app,959998,ES63209535234862100767,1682.49,2023-08-23T23:28:45,Zarautz,expenses,leisure,-60.69,-55988.34
buyer_2,Carmen,Lozano,1984-09-05,54021274R,carmen.lozano@cleverdev.app,959998,ES63209535234862100767,1682.49,2023-08-23T08:47:50,Zarautz,expenses,cash,-100.0,-56088.34
buyer_2,Carmen,Lozano,1984-09-05,54021274R,carmen.lozano@cleverdev.app,959998,ES63209535234862100767,1682.49,2023-08-27T13:04:30,Zarautz,expenses,food,-89.16,-56177.5
buyer_2,Carmen,Lozano,1984-09-05,54021274R,carmen.lozano@cleverdev.app,959998,ES63209535234862100767,1682.49,2023-08-27T15:22:55,Zarautz,expenses,repairs,-278.74,-56456.24
buyer_2,Carmen,Lozano,1984-09-05,54021274R,carmen.lozano@cleverdev.app,959998,ES63209535234862100767,1682.49,2023-08-28T19:03:18,Zarautz,expenses,travel,-819.42,-57275.66
buyer_2,Carmen,Lozano,1984-09-05,54021274R,carmen.lozano@cleverdev.app,959998,ES63209535234862100767,1682.49,2023-08-29T13:38:27,Zarautz,expenses,food,-117.64,-57393.3
buyer_2,Carmen,Lozano,1984-09-05,54021274R,carmen.lozano@cleverdev.app,959998,ES63209535234862100767,1682.49,2023-09-01T09:39:20,Zarautz,incomes,salary,2092.91,-55300.39
buyer_2,Carmen,Lozano,1984-09-05,54021274R,carmen.lozano@cleverdev.app,959998,ES63209535234862100767,1682.49,2023-09-01T09:38:39,Zarautz,expenses,food,-61.27,-55361.66
buyer_2,Carmen,Lozano,1984-09-05,54021274R,carmen.lozano@cleverdev.app,959998,ES63209535234862100767,1682.49,2023-09-01T14:48:24,Zarautz,expenses,transport,-43.54,-55405.2
buyer_2,Carmen,Lozano,1984-09-05,54021274R,carmen.lozano@cleverdev.app,959998,ES63209535234862100767,1682.49,2023-09-02T16:32:19,Zarautz,expenses,cash,-100.0,-55505.2
buyer_2,Carmen,Lozano,1984-09-05,54021274R,carmen.lozano@cleverdev.app,959998,ES63209535234862100767,1682.49,2023-09-02T22:23:46,Zarautz,expenses,travel,-592.97,-56098.17
buyer_2,Carmen,Lozano,1984-09-05,54021274R,carmen.lozano@cleverdev.app,959998,ES63209535234862100767,1682.49,2023-09-04T19:05:18,Zarautz,expenses,mortgage,-859.88,-56958.05
buyer_2,Carmen,Lozano,1984-09-05,54021274R,carmen.lozano@cleverdev.app,959998,ES63209535234862100767,1682.49,2023-09-05T16:12:24,Zarautz,expenses,phone,-40.97,-56999.02
buyer_2,Carmen,Lozano,1984-09-05,54021274R,carmen.lozano@cleverdev.app,959998,ES63209535234862100767,1682.49,2023-09-08T20:52:16,Zarautz,expenses,water,-22.01,-57021.03
buyer_2,Carmen,Lozano,1984-09-05,54021274R,carmen.lozano@cleverdev.app,959998,ES63209535234862100767,1682.49,2023-09-11T16:42:00,Zarautz,expenses,transport,-83.09,-57104.12
buyer_2,Carmen,Lozano,1984-09-05,54021274R,carmen.lozano@cleverdev.app,959998,ES63209535234862100767,1682.49,2023-09-12T14:04:00,Zarautz,expenses,food,-89.65,-57193.77
buyer_2,Carmen,Lozano,1984-09-05,54021274R,carmen.lozano@cleverdev.app,959998,ES63209535234862100767,1682.49,2023-09-13T22:32:46,Zarautz,expenses,food,-85.9,-57279.67
buyer_2,Carmen,Lozano,1984-09-05,54021274R,carmen.lozano@cleverdev.app,959998,ES63209535234862100767,1682.49,2023-09-14T14:01:01,Zarautz,expenses,cash,-100.0,-57379.67
buyer_2,Carmen,Lozano,1984-09-05,54021274R,carmen.lozano@cleverdev.app,959998,ES63209535234862100767,1682.49,2023-09-15T10:38:54,Zarautz,expenses,leisure,-51.28,-57430.95
buyer_2,Carmen,Lozano,1984-09-05,54021274R,carmen.lozano@cleverdev.app,959998,ES63209535234862100767,1682.49,2023-09-19T16:31:54,Zarautz,expenses,transport,-78.29,-57509.24
buyer_2,Carmen,Lozano,1984-09-05,54021274R,carmen.lozano@cleverdev.app,959998,ES63209535234862100767,1682.49,2023-09-19T03:13:00,Zarautz,expenses,children,-277.84,-57787.08
buyer_2,Carmen,Lozano,1984-09-05,54021274R,carmen.lozano@cleverdev.app,959998,ES63209535234862100767,1682.49,2023-09-20T21:37:23,Zarautz,expenses,food,-93.2,-57880.28
buyer_2,Carmen,Lozano,1984-09-05,54021274R,carmen.lozano@cleverdev.app,959998,ES63209535234862100767,1682.49,2023-09-20T09:49:42,Zarautz,expenses,children,-751.66,-58631.94
buyer_2,Carmen,Lozano,1984-09-05,54021274R,carmen.lozano@cleverdev.app,959998,ES63209535234862100767,1682.49,2023-09-22T14:33:33,Zarautz,expenses,repairs,-50.51,-58682.45
buyer_2,Carmen,Lozano,1984-09-05,54021274R,carmen.lozano@cleverdev.app,959998,ES63209535234862100767,1682.49,2023-09-23T12:00:31,Zarautz,expenses,cash,-100.0,-58782.45
buyer_2,Carmen,Lozano,1984-09-05,54021274R,carmen.lozano@cleverdev.app,959998,ES63209535234862100767,1682.49,2023-09-26T03:09:41,Zarautz,expenses,travel,-357.84,-59140.29
buyer_2,Carmen,Lozano,1984-09-05,54021274R,carmen.lozano@cleverdev.app,959998,ES63209535234862100767,1682.49,2023-09-27T18:27:56,Zarautz,expenses,leisure,-68.95,-59209.24
buyer_2,Carmen,Lozano,1984-09-05,54021274R,carmen.lozano@cleverdev.app,959998,ES63209535234862100767,1682.49,2023-09-27T11:30:35,Zarautz,expenses,healthcare,-92.26,-59301.5
buyer_2,Carmen,Lozano,1984-09-05,54021274R,carmen.lozano@cleverdev.app,959998,ES63209535234862100767,1682.49,2023-09-28T19:01:54,Zarautz,expenses,cash,-100.0,-59401.5
buyer_2,Carmen,Lozano,1984-09-05,54021274R,carmen.lozano@cleverdev.app,959998,ES63209535234862100767,1682.49,2023-10-01T08:10:31,Zarautz,incomes,salary,2092.91,-57308.59
buyer_2,Carmen,Lozano,1984-09-05,54021274R,carmen.lozano@cleverdev.app,959998,ES63209535234862100767,1682.49,2023-10-01T08:10:31,Zarautz,incomes,extra_income,358.06,-56950.53
buyer_2,Carmen,Lozano,1984-09-05,54021274R,carmen.lozano@cleverdev.app,959998,ES63209535234862100767,1682.49,2023-10-01T22:07:25,Zarautz,expenses,food,-68.09,-57018.62
buyer_2,Carmen,Lozano,1984-09-05,54021274R,carmen.lozano@cleverdev.app,959998,ES63209535234862100767,1682.49,2023-10-01T18:17:32,Zarautz,expenses,healthcare,-58.85,-57077.47
buyer_2,Carmen,Lozano,1984-09-05,54021274R,carmen.lozano@cleverdev.app,959998,ES63209535234862100767,1682.49,2023-10-02T16:37:32,Zarautz,expenses,education,-65.54,-57143.01
buyer_2,Carmen,Lozano,1984-09-05,54021274R,carmen.lozano@cleverdev.app,959998,ES63209535234862100767,1682.49,2023-10-03T09:42:33,Zarautz,expenses,repairs,-327.7,-57470.71
buyer_2,Carmen,Lozano,1984-09-05,54021274R,carmen.lozano@cleverdev.app,959998,ES63209535234862100767,1682.49,2023-10-04T11:10:48,Zarautz,expenses,mortgage,-859.88,-58330.59
buyer_2,Carmen,Lozano,1984-09-05,54021274R,carmen.lozano@cleverdev.app,959998,ES63209535234862100767,1682.49,2023-10-04T16:15:47,Zarautz,expenses,healthcare,-92.4,-58422.99
buyer_2,Carmen,Lozano,1984-09-05,54021274R,carmen.lozano@cleverdev.app,959998,ES63209535234862100767,1682.49,2023-10-05T21:11:52,Zarautz,expenses,internet,-43.95,-58466.94
buyer_2,Carmen,Lozano,1984-09-05,54021274R,carmen.lozano@cleverdev.app,959998,ES63209535234862100767,1682.49,2023-10-06T20:15:15,Zarautz,expenses,gas,-102.09,-58569.03
buyer_2,Carmen,Lozano,1984-09-05,54021274R,carmen.lozano@cleverdev.app,959998,ES63209535234862100767,1682.49,2023-10-06T06:01:31,Zarautz,expenses,food,-112.36,-58681.39
buyer_2,Carmen,Lozano,1984-09-05,54021274R,carmen.lozano@cleverdev.app,959998,ES63209535234862100767,1682.49,2023-10-06T11:52:53,Zarautz,expenses,leisure,-55.57,-58736.96
buyer_2,Carmen,Lozano,1984-09-05,54021274R,carmen.lozano@cleverdev.app,959998,ES63209535234862100767,1682.49,2023-10-07T07:44:24,Zarautz,expenses,electricity,-42.16,-58779.12
buyer_2,Carmen,Lozano,1984-09-05,54021274R,carmen.lozano@cleverdev.app,959998,ES63209535234862100767,1682.49,2023-10-07T09:02:47,Zarautz,expenses,internet,-43.95,-58823.07
buyer_2,Carmen,Lozano,1984-09-05,54021274R,carmen.lozano@cleverdev.app,959998,ES63209535234862100767,1682.49,2023-10-07T19:11:51,Zarautz,expenses,phone,-33.79,-58856.86
buyer_2,Carmen,Lozano,1984-09-05,54021274R,carmen.lozano@cleverdev.app,959998,ES63209535234862100767,1682.49,2023-10-07T12:30:26,Zarautz,expenses,transport,-58.26,-58915.12
buyer_2,Carmen,Lozano,1984-09-05,54021274R,carmen.lozano@cleverdev.app,959998,ES63209535234862100767,1682.49,2023-10-07T18:18:39,Zarautz,expenses,leisure,-78.36,-58993.48
buyer_2,Carmen,Lozano,1984-09-05,54021274R,carmen.lozano@cleverdev.app,959998,ES63209535234862100767,1682.49,2023-10-08T20:56:19,Zarautz,expenses,water,-30.75,-59024.23
buyer_2,Carmen,Lozano,1984-09-05,54021274R,carmen.lozano@cleverdev.app,959998,ES63209535234862100767,1682.49,2023-10-08T11:03:51,Zarautz,expenses,internet,-43.95,-59068.18
buyer_2,Carmen,Lozano,1984-09-05,54021274R,carmen.lozano@cleverdev.app,959998,ES63209535234862100767,1682.49,2023-10-09T23:32:59,Zarautz,expenses,repairs,-226.44,-59294.62
buyer_2,Carmen,Lozano,1984-09-05,54021274R,carmen.lozano@cleverdev.app,959998,ES63209535234862100767,1682.49,2023-10-18T19:27:07,Zarautz,expenses,cash,-100.0,-59394.62
buyer_2,Carmen,Lozano,1984-09-05,54021274R,carmen.lozano@cleverdev.app,959998,ES63209535234862100767,1682.49,2023-10-19T18:15:29,Zarautz,expenses,food,-94.52,-59489.14
buyer_2,Carmen,Lozano,1984-09-05,54021274R,carmen.lozano@cleverdev.app,959998,ES63209535234862100767,1682.49,2023-10-23T16:13:46,Zarautz,expenses,cash,-100.0,-59589.14
buyer_2,Carmen,Lozano,1984-09-05,54021274R,carmen.lozano@cleverdev.app,959998,ES63209535234862100767,1682.49,2023-10-24T07:16:42,Zarautz,expenses,clothing,-111.88,-59701.02
buyer_2,Carmen,Lozano,1984-09-05,54021274R,carmen.lozano@cleverdev.app,959998,ES63209535234862100767,1682.49,2023-10-24T20:34:50,Zarautz,expenses,gifts,-28.22,-59729.24
buyer_2,Carmen,Lozano,1984-09-05,54021274R,carmen.lozano@cleverdev.app,959998,ES63209535234862100767,1682.49,2023-10-27T10:46:57,Zarautz,expenses,food,-77.02,-59806.26
buyer_2,Carmen,Lozano,1984-09-05,54021274R,carmen.lozano@cleverdev.app,959998,ES63209535234862100767,1682.49,2023-10-27T05:12:29,Zarautz,expenses,transport,-61.53,-59867.79
buyer_2,Carmen,Lozano,1984-09-05,54021274R,carmen.lozano@cleverdev.app,959998,ES63209535234862100767,1682.49,2023-10-27T14:33:22,Zarautz,expenses,leisure,-55.04,-59922.83
buyer_2,Carmen,Lozano,1984-09-05,54021274R,carmen.lozano@cleverdev.app,959998,ES63209535234862100767,1682.49,2023-10-28T18:30:14,Zarautz,expenses,transport,-64.27,-59987.1
buyer_2,Carmen,Lozano,1984-09-05,54021274R,carmen.lozano@cleverdev.app,959998,ES63209535234862100767,1682.49,2023-10-28T20:04:38,Zarautz,expenses,healthcare,-166.48,-60153.58
buyer_2,Carmen,Lozano,1984-09-05,54021274R,carmen.lozano@cleverdev.app,959998,ES63209535234862100767,1682.49,2023-10-29T15:07:31,Zarautz,expenses,education,-71.69,-60225.27
buyer_2,Carmen,Lozano,1984-09-05,54021274R,carmen.lozano@cleverdev.app,959998,ES63209535234862100767,1682.49,2023-10-29T14:24:33,Zarautz,expenses,cash,-100.0,-60325.27
buyer_2,Carmen,Lozano,1984-09-05,54021274R,carmen.lozano@cleverdev.app,959998,ES63209535234862100767,1682.49,2023-10-30T08:07:16,Zarautz,expenses,gifts,-782.79,-61108.06
buyer_2,Carmen,Lozano,1984-09-05,54021274R,carmen.lozano@cleverdev.app,959998,ES63209535234862100767,1682.49,2023-10-31T12:41:01,Zarautz,expenses,food,-102.31,-61210.37
buyer_2,Carmen,Lozano,1984-09-05,54021274R,carmen.lozano@cleverdev.app,959998,ES63209535234862100767,1682.49,2023-10-31T16:26:48,Zarautz,expenses,healthcare,-161.51,-61371.88
buyer_2,Carmen,Lozano,1984-09-05,54021274R,carmen.lozano@cleverdev.app,959998,ES63209535234862100767,1682.49,2023-11-01T11:29:06,Zarautz,incomes,salary,2092.91,-59278.97
buyer_2,Carmen,Lozano,1984-09-05,54021274R,carmen.lozano@cleverdev.app,959998,ES63209535234862100767,1682.49,2023-11-02T15:04:15,Zarautz,expenses,transport,-87.49,-59366.46
buyer_2,Carmen,Lozano,1984-09-05,54021274R,carmen.lozano@cleverdev.app,959998,ES63209535234862100767,1682.49,2023-11-02T17:57:54,Zarautz,expenses,education,-71.98,-59438.44
buyer_2,Carmen,Lozano,1984-09-05,54021274R,carmen.lozano@cleverdev.app,959998,ES63209535234862100767,1682.49,2023-11-04T10:57:43,Zarautz,expenses,mortgage,-859.88,-60298.32
buyer_2,Carmen,Lozano,1984-09-05,54021274R,carmen.lozano@cleverdev.app,959998,ES63209535234862100767,1682.49,2023-11-04T10:33:33,Zarautz,expenses,food,-118.82,-60417.14
buyer_2,Carmen,Lozano,1984-09-05,54021274R,carmen.lozano@cleverdev.app,959998,ES63209535234862100767,1682.49,2023-11-04T11:54:03,Zarautz,expenses,children,-284.99,-60702.13
buyer_2,Carmen,Lozano,1984-09-05,54021274R,carmen.lozano@cleverdev.app,959998,ES63209535234862100767,1682.49,2023-11-05T15:05:22,Zarautz,expenses,gifts,-591.1,-61293.23
buyer_2,Carmen,Lozano,1984-09-05,54021274R,carmen.lozano@cleverdev.app,959998,ES63209535234862100767,1682.49,2023-11-06T13:02:54,Zarautz,expenses,electricity,-46.5,-61339.73
buyer_2,Carmen,Lozano,1984-09-05,54021274R,carmen.lozano@cleverdev.app,959998,ES63209535234862100767,1682.49,2023-11-06T18:26:58,Zarautz,expenses,food,-80.4,-61420.13
buyer_2,Carmen,Lozano,1984-09-05,54021274R,carmen.lozano@cleverdev.app,959998,ES63209535234862100767,1682.49,2023-11-07T15:02:03,Zarautz,expenses,electricity,-26.75,-61446.88
buyer_2,Carmen,Lozano,1984-09-05,54021274R,carmen.lozano@cleverdev.app,959998,ES63209535234862100767,1682.49,2023-11-07T15:19:18,Zarautz,expenses,internet,-43.95,-61490.83
buyer_2,Carmen,Lozano,1984-09-05,54021274R,carmen.lozano@cleverdev.app,959998,ES63209535234862100767,1682.49,2023-11-07T12:53:32,Zarautz,expenses,repairs,-208.01,-61698.84
buyer_2,Carmen,Lozano,1984-09-05,54021274R,carmen.lozano@cleverdev.app,959998,ES63209535234862100767,1682.49,2023-11-08T09:20:03,Zarautz,expenses,electricity,-91.12,-61789.96
buyer_2,Carmen,Lozano,1984-09-05,54021274R,carmen.lozano@cleverdev.app,959998,ES63209535234862100767,1682.49,2023-11-08T20:16:34,Zarautz,expenses,gas,-61.04,-61851.0
buyer_2,Carmen,Lozano,1984-09-05,54021274R,carmen.lozano@cleverdev.app,959998,ES63209535234862100767,1682.49,2023-11-08T15:26:04,Zarautz,expenses,food,-75.17,-61926.17
buyer_2,Carmen,Lozano,1984-09-05,54021274R,carmen.lozano@cleverdev.app,959998,ES63209535234862100767,1682.49,2023-11-09T12:04:01,Zarautz,expenses,food,-72.19,-61998.36
buyer_2,Carmen,Lozano,1984-09-05,54021274R,carmen.lozano@cleverdev.app,959998,ES63209535234862100767,1682.49,2023-11-10T09:34:38,Zarautz,expenses,cash,-100.0,-62098.36
buyer_2,Carmen,Lozano,1984-09-05,54021274R,carmen.lozano@cleverdev.app,959998,ES63209535234862100767,1682.49,2023-11-12T15:31:31,Zarautz,expenses,transport,-88.06,-62186.42
buyer_2,Carmen,Lozano,1984-09-05,54021274R,carmen.lozano@cleverdev.app,959998,ES63209535234862100767,1682.49,2023-11-13T17:45:20,Zarautz,expenses,leisure,-61.67,-62248.09
buyer_2,Carmen,Lozano,1984-09-05,54021274R,carmen.lozano@cleverdev.app,959998,ES63209535234862100767,1682.49,2023-11-13T08:44:11,Zarautz,expenses,healthcare,-170.86,-62418.95
buyer_2,Carmen,Lozano,1984-09-05,54021274R,carmen.lozano@cleverdev.app,959998,ES63209535234862100767,1682.49,2023-11-13T13:52:07,Zarautz,expenses,cash,-100.0,-62518.95
buyer_2,Carmen,Lozano,1984-09-05,54021274R,carmen.lozano@cleverdev.app,959998,ES63209535234862100767,1682.49,2023-11-16T09:24:35,Zarautz,expenses,healthcare,-93.3,-62612.25
buyer_2,Carmen,Lozano,1984-09-05,54021274R,carmen.lozano@cleverdev.app,959998,ES63209535234862100767,1682.49,2023-11-16T13:28:13,Zarautz,expenses,education,-63.08,-62675.33
buyer_2,Carmen,Lozano,1984-09-05,54021274R,carmen.lozano@cleverdev.app,959998,ES63209535234862100767,1682.49,2023-11-17T19:54:13,Zarautz,expenses,education,-42.47,-62717.8
buyer_2,Carmen,Lozano,1984-09-05,54021274R,carmen.lozano@cleverdev.app,959998,ES63209535234862100767,1682.49,2023-11-18T20:56:56,Zarautz,expenses,healthcare,-137.54,-62855.34
buyer_2,Carmen,Lozano,1984-09-05,54021274R,carmen.lozano@cleverdev.app,959998,ES63209535234862100767,1682.49,2023-11-19T08:07:56,Zarautz,expenses,cash,-100.0,-62955.34
buyer_2,Carmen,Lozano,1984-09-05,54021274R,carmen.lozano@cleverdev.app,959998,ES63209535234862100767,1682.49,2023-11-20T19:12:35,Zarautz,expenses,gifts,-569.25,-63524.59
buyer_2,Carmen,Lozano,1984-09-05,54021274R,carmen.lozano@cleverdev.app,959998,ES63209535234862100767,1682.49,2023-11-21T02:23:52,Zarautz,expenses,repairs,-36.26,-63560.85
buyer_2,Carmen,Lozano,1984-09-05,54021274R,carmen.lozano@cleverdev.app,959998,ES63209535234862100767,1682.49,2023-11-22T14:33:21,Zarautz,expenses,cash,-100.0,-63660.85
buyer_2,Carmen,Lozano,1984-09-05,54021274R,carmen.lozano@cleverdev.app,959998,ES63209535234862100767,1682.49,2023-11-24T09:19:30,Zarautz,expenses,education,-54.62,-63715.47
buyer_2,Carmen,Lozano,1984-09-05,54021274R,carmen.lozano@cleverdev.app,959998,ES63209535234862100767,1682.49,2023-11-25T08:43:07,Zarautz,expenses,clothing,-113.62,-63829.09
buyer_2,Carmen,Lozano,1984-09-05,54021274R,carmen.lozano@cleverdev.app,959998,ES63209535234862100767,1682.49,2023-11-26T15:08:25,Zarautz,expenses,transport,-70.14,-63899.23
buyer_2,Carmen,Lozano,1984-09-05,54021274R,carmen.lozano@cleverdev.app,959998,ES63209535234862100767,1682.49,2023-11-26T11:50:33,Zarautz,expenses,clothing,-143.3,-64042.53
buyer_2,Carmen,Lozano,1984-09-05,54021274R,carmen.lozano@cleverdev.app,959998,ES63209535234862100767,1682.49,2023-11-27T11:44:07,Zarautz,expenses,transport,-49.5,-64092.03
buyer_2,Carmen,Lozano,1984-09-05,54021274R,carmen.lozano@cleverdev.app,959998,ES63209535234862100767,1682.49,2023-11-27T20:09:05,Zarautz,expenses,cash,-100.0,-64192.03
buyer_2,Carmen,Lozano,1984-09-05,54021274R,carmen.lozano@cleverdev.app,959998,ES63209535234862100767,1682.49,2023-11-28T01:10:57,Zarautz,expenses,cash,-100.0,-64292.03
buyer_2,Carmen,Lozano,1984-09-05,54021274R,carmen.lozano@cleverdev.app,959998,ES63209535234862100767,1682.49,2023-11-30T20:12:09,Zarautz,expenses,children,-602.94,-64894.97
buyer_2,Carmen,Lozano,1984-09-05,54021274R,carmen.lozano@cleverdev.app,959998,ES63209535234862100767,1682.49,2023-12-01T14:26:01,Zarautz,incomes,salary,2092.91,-62802.06
buyer_2,Carmen,Lozano,1984-09-05,54021274R,carmen.lozano@cleverdev.app,959998,ES63209535234862100767,1682.49,2023-12-01T14:26:01,Zarautz,incomes,salary_bonus,1493.29,-61308.77
buyer_2,Carmen,Lozano,1984-09-05,54021274R,carmen.lozano@cleverdev.app,959998,ES63209535234862100767,1682.49,2023-12-04T11:27:59,Zarautz,expenses,mortgage,-859.88,-62168.65
buyer_2,Carmen,Lozano,1984-09-05,54021274R,carmen.lozano@cleverdev.app,959998,ES63209535234862100767,1682.49,2023-12-05T04:45:49,Zarautz,expenses,electricity,-31.21,-62199.86
buyer_2,Carmen,Lozano,1984-09-05,54021274R,carmen.lozano@cleverdev.app,959998,ES63209535234862100767,1682.49,2023-12-05T08:17:12,Zarautz,expenses,internet,-43.95,-62243.81
buyer_2,Carmen,Lozano,1984-09-05,54021274R,carmen.lozano@cleverdev.app,959998,ES63209535234862100767,1682.49,2023-12-06T08:46:59,Zarautz,expenses,water,-44.37,-62288.18
buyer_2,Carmen,Lozano,1984-09-05,54021274R,carmen.lozano@cleverdev.app,959998,ES63209535234862100767,1682.49,2023-12-06T00:48:10,Zarautz,expenses,leisure,-23.12,-62311.3
buyer_2,Carmen,Lozano,1984-09-05,54021274R,carmen.lozano@cleverdev.app,959998,ES63209535234862100767,1682.49,2023-12-08T11:49:39,Zarautz,expenses,electricity,-75.41,-62386.71
buyer_2,Carmen,Lozano,1984-09-05,54021274R,carmen.lozano@cleverdev.app,959998,ES63209535234862100767,1682.49,2023-12-08T12:16:18,Zarautz,expenses,internet,-43.95,-62430.66
buyer_2,Carmen,Lozano,1984-09-05,54021274R,carmen.lozano@cleverdev.app,959998,ES63209535234862100767,1682.49,2023-12-13T23:18:39,Zarautz,expenses,food,-109.53,-62540.19
buyer_2,Carmen,Lozano,1984-09-05,54021274R,carmen.lozano@cleverdev.app,959998,ES63209535234862100767,1682.49,2023-12-13T09:32:33,Zarautz,expenses,transport,-42.3,-62582.49
buyer_2,Carmen,Lozano,1984-09-05,54021274R,carmen.lozano@cleverdev.app,959998,ES63209535234862100767,1682.49,2023-12-13T17:00:05,Zarautz,expenses,appliances,-358.41,-62940.9
buyer_2,Carmen,Lozano,1984-09-05,54021274R,carmen.lozano@cleverdev.app,959998,ES63209535234862100767,1682.49,2023-12-17T08:45:58,Zarautz,expenses,food,-105.88,-63046.78
buyer_2,Carmen,Lozano,1984-09-05,54021274R,carmen.lozano@cleverdev.app,959998,ES63209535234862100767,1682.49,2023-12-19T11:41:31,Zarautz,expenses,cash,-100.0,-63146.78
buyer_2,Carmen,Lozano,1984-09-05,54021274R,carmen.lozano@cleverdev.app,959998,ES63209535234862100767,1682.49,2023-12-21T17:40:17,Zarautz,expenses,food,-114.17,-63260.95
buyer_2,Carmen,Lozano,1984-09-05,54021274R,carmen.lozano@cleverdev.app,959998,ES63209535234862100767,1682.49,2023-12-22T20:24:17,Zarautz,expenses,transport,-77.63,-63338.58
buyer_2,Carmen,Lozano,1984-09-05,54021274R,carmen.lozano@cleverdev.app,959998,ES63209535234862100767,1682.49,2023-12-22T09:34:36,Zarautz,expenses,leisure,-74.46,-63413.04
buyer_2,Carmen,Lozano,1984-09-05,54021274R,carmen.lozano@cleverdev.app,959998,ES63209535234862100767,1682.49,2023-12-23T11:31:07,Zarautz,expenses,clothing,-83.48,-63496.52
buyer_2,Carmen,Lozano,1984-09-05,54021274R,carmen.lozano@cleverdev.app,959998,ES63209535234862100767,1682.49,2023-12-26T13:19:38,Zarautz,expenses,food,-88.47,-63584.99
buyer_2,Carmen,Lozano,1984-09-05,54021274R,carmen.lozano@cleverdev.app,959998,ES63209535234862100767,1682.49,2023-12-28T12:50:36,Zarautz,expenses,food,-122.85,-63707.84
buyer_2,Carmen,Lozano,1984-09-05,54021274R,carmen.lozano@cleverdev.app,959998,ES63209535234862100767,1682.49,2023-12-28T23:53:55,Zarautz,expenses,transport,-82.94,-63790.78
buyer_2,Carmen,Lozano,1984-09-05,54021274R,carmen.lozano@cleverdev.app,959998,ES63209535234862100767,1682.49,2023-12-28T00:08:55,Zarautz,expenses,cash,-100.0,-63890.78
buyer_2,Carmen,Lozano,1984-09-05,54021274R,carmen.lozano@cleverdev.app,959998,ES63209535234862100767,1682.49,2023-12-29T12:04:57,Zarautz,expenses,transport,-49.27,-63940.05
buyer_2,Carmen,Lozano,1984-09-05,54021274R,carmen.lozano@cleverdev.app,959998,ES63209535234862100767,1682.49,2023-12-29T14:59:40,Zarautz,expenses,appliances,-97.58,-64037.63
buyer_2,Carmen,Lozano,1984-09-05,54021274R,carmen.lozano@cleverdev.app,959998,ES63209535234862100767,1682.49,2023-12-30T17:43:42,Zarautz,expenses,food,-79.04,-64116.67
buyer_2,Carmen,Lozano,1984-09-05,54021274R,carmen.lozano@cleverdev.app,959998,ES63209535234862100767,1682.49,2023-12-30T16:07:35,Zarautz,expenses,leisure,-79.31,-64195.98
buyer_2,Carmen,Lozano,1984-09-05,54021274R,carmen.lozano@cleverdev.app,959998,ES63209535234862100767,1682.49,2023-12-31T09:06:33,Zarautz,expenses,transport,-67.12,-64263.1
buyer_2,Carmen,Lozano,1984-09-05,54021274R,carmen.lozano@cleverdev.app,959998,ES63209535234862100767,1682.49,2024-01-01T19:54:07,Zarautz,incomes,salary,2170.01,-62093.09
buyer_2,Carmen,Lozano,1984-09-05,54021274R,carmen.lozano@cleverdev.app,959998,ES63209535234862100767,1682.49,2024-01-01T19:54:07,Zarautz,incomes,extra_income,358.06,-61735.03
buyer_2,Carmen,Lozano,1984-09-05,54021274R,carmen.lozano@cleverdev.app,959998,ES63209535234862100767,1682.49,2024-01-01T12:45:06,Zarautz,expenses,leisure,-55.2,-61790.23
buyer_2,Carmen,Lozano,1984-09-05,54021274R,carmen.lozano@cleverdev.app,959998,ES63209535234862100767,1682.49,2024-01-02T03:30:14,Zarautz,expenses,repairs,-238.43,-62028.66
buyer_2,Carmen,Lozano,1984-09-05,54021274R,carmen.lozano@cleverdev.app,959998,ES63209535234862100767,1682.49,2024-01-04T13:45:26,Zarautz,expenses,mortgage,-891.69,-62920.35
buyer_2,Carmen,Lozano,1984-09-05,54021274R,carmen.lozano@cleverdev.app,959998,ES63209535234862100767,1682.49,2024-01-04T13:07:54,Zarautz,expenses,food,-114.06,-63034.41
buyer_2,Carmen,Lozano,1984-09-05,54021274R,carmen.lozano@cleverdev.app,959998,ES63209535234862100767,1682.49,2024-01-05T12:11:20,Zarautz,expenses,electricity,-25.57,-63059.98
buyer_2,Carmen,Lozano,1984-09-05,54021274R,carmen.lozano@cleverdev.app,959998,ES63209535234862100767,1682.49,2024-01-05T02:42:41,Zarautz,expenses,internet,-45.57,-63105.55
buyer_2,Carmen,Lozano,1984-09-05,54021274R,carmen.lozano@cleverdev.app,959998,ES63209535234862100767,1682.49,2024-01-06T20:25:25,Zarautz,expenses,appliances,-390.35,-63495.9
buyer_2,Carmen,Lozano,1984-09-05,54021274R,carmen.lozano@cleverdev.app,959998,ES63209535234862100767,1682.49,2024-01-06T15:14:47,Zarautz,expenses,gifts,-48.38,-63544.28
buyer_2,Carmen,Lozano,1984-09-05,54021274R,carmen.lozano@cleverdev.app,959998,ES63209535234862100767,1682.49,2024-01-07T08:57:03,Zarautz,expenses,electricity,-97.41,-63641.69
buyer_2,Carmen,Lozano,1984-09-05,54021274R,carmen.lozano@cleverdev.app,959998,ES63209535234862100767,1682.49,2024-01-07T20:41:50,Zarautz,expenses,internet,-45.57,-63687.26
buyer_2,Carmen,Lozano,1984-09-05,54021274R,carmen.lozano@cleverdev.app,959998,ES63209535234862100767,1682.49,2024-01-07T19:34:33,Zarautz,expenses,phone,-42.13,-63729.39
buyer_2,Carmen,Lozano,1984-09-05,54021274R,carmen.lozano@cleverdev.app,959998,ES63209535234862100767,1682.49,2024-01-07T14:16:24,Zarautz,expenses,food,-117.81,-63847.2
buyer_2,Carmen,Lozano,1984-09-05,54021274R,carmen.lozano@cleverdev.app,959998,ES63209535234862100767,1682.49,2024-01-08T19:39:52,Zarautz,expenses,water,-23.21,-63870.41
buyer_2,Carmen,Lozano,1984-09-05,54021274R,carmen.lozano@cleverdev.app,959998,ES63209535234862100767,1682.49,2024-01-08T17:46:55,Zarautz,expenses,electricity,-87.45,-63957.86
buyer_2,Carmen,Lozano,1984-09-05,54021274R,carmen.lozano@cleverdev.app,959998,ES63209535234862100767,1682.49,2024-01-08T14:02:39,Zarautz,expenses,travel,-373.67,-64331.53
buyer_2,Carmen,Lozano,1984-09-05,54021274R,carmen.lozano@cleverdev.app,959998,ES63209535234862100767,1682.49,2024-01-08T13:44:53,Zarautz,expenses,repairs,-327.9,-64659.43
buyer_2,Carmen,Lozano,1984-09-05,54021274R,carmen.lozano@cleverdev.app,959998,ES63209535234862100767,1682.49,2024-01-09T09:13:55,Zarautz,expenses,leisure,-47.03,-64706.46
buyer_2,Carmen,Lozano,1984-09-05,54021274R,carmen.lozano@cleverdev.app,959998,ES63209535234862100767,1682.49,2024-01-10T00:53:23,Zarautz,expenses,transport,-85.83,-64792.29
buyer_2,Carmen,Lozano,1984-09-05,54021274R,carmen.lozano@cleverdev.app,959998,ES63209535234862100767,1682.49,2024-01-10T08:20:20,Zarautz,expenses,leisure,-66.73,-64859.02
buyer_2,Carmen,Lozano,1984-09-05,54021274R,carmen.lozano@cleverdev.app,959998,ES63209535234862100767,1682.49,2024-01-11T08:15:37,Zarautz,expenses,travel,-674.62,-65533.64
buyer_2,Carmen,Lozano,1984-09-05,54021274R,carmen.lozano@cleverdev.app,959998,ES63209535234862100767,1682.49,2024-01-13T14:34:20,Zarautz,expenses,healthcare,-179.45,-65713.09
buyer_2,Carmen,Lozano,1984-09-05,54021274R,carmen.lozano@cleverdev.app,959998,ES63209535234862100767,1682.49,2024-01-14T17:54:47,Zarautz,expenses,leisure,-27.53,-65740.62
buyer_2,Carmen,Lozano,1984-09-05,54021274R,carmen.lozano@cleverdev.app,959998,ES63209535234862100767,1682.49,2024-01-14T19:05:21,Zarautz,expenses,education,-72.2,-65812.82
buyer_2,Carmen,Lozano,1984-09-05,54021274R,carmen.lozano@cleverdev.app,959998,ES63209535234862100767,1682.49,2024-01-16T07:46:03,Zarautz,expenses,leisure,-62.75,-65875.57
buyer_2,Carmen,Lozano,1984-09-05,54021274R,carmen.lozano@cleverdev.app,959998,ES63209535234862100767,1682.49,2024-01-17T17:31:28,Zarautz,expenses,gifts,-272.87,-66148.44
buyer_2,Carmen,Lozano,1984-09-05,54021274R,carmen.lozano@cleverdev.app,959998,ES63209535234862100767,1682.49,2024-01-18T18:17:03,Zarautz,expenses,food,-108.77,-66257.21
buyer_2,Carmen,Lozano,1984-09-05,54021274R,carmen.lozano@cleverdev.app,959998,ES63209535234862100767,1682.49,2024-01-18T09:42:36,Zarautz,expenses,cash,-100.0,-66357.21
buyer_2,Carmen,Lozano,1984-09-05,54021274R,carmen.lozano@cleverdev.app,959998,ES63209535234862100767,1682.49,2024-01-19T18:44:19,Zarautz,expenses,repairs,-293.74,-66650.95
buyer_2,Carmen,Lozano,1984-09-05,54021274R,carmen.lozano@cleverdev.app,959998,ES63209535234862100767,1682.49,2024-01-20T14:16:27,Zarautz,expenses,leisure,-57.13,-66708.08
buyer_2,Carmen,Lozano,1984-09-05,54021274R,carmen.lozano@cleverdev.app,959998,ES63209535234862100767,1682.49,2024-01-21T11:15:35,Zarautz,expenses,food,-63.36,-66771.44
buyer_2,Carmen,Lozano,1984-09-05,54021274R,carmen.lozano@cleverdev.app,959998,ES63209535234862100767,1682.49,2024-01-23T18:12:23,Zarautz,expenses,cash,-100.0,-66871.44
buyer_2,Carmen,Lozano,1984-09-05,54021274R,carmen.lozano@cleverdev.app,959998,ES63209535234862100767,1682.49,2024-01-29T19:54:10,Zarautz,expenses,gifts,-278.75,-67150.19
buyer_2,Carmen,Lozano,1984-09-05,54021274R,carmen.lozano@cleverdev.app,959998,ES63209535234862100767,1682.49,2024-01-30T20:15:21,Zarautz,expenses,food,-110.05,-67260.24
buyer_2,Carmen,Lozano,1984-09-05,54021274R,carmen.lozano@cleverdev.app,959998,ES63209535234862100767,1682.49,2024-01-30T22:14:01,Zarautz,expenses,appliances,-372.83,-67633.07
buyer_2,Carmen,Lozano,1984-09-05,54021274R,carmen.lozano@cleverdev.app,959998,ES63209535234862100767,1682.49,2024-01-30T08:40:39,Zarautz,expenses,repairs,-301.24,-67934.31
buyer_2,Carmen,Lozano,1984-09-05,54021274R,carmen.lozano@cleverdev.app,959998,ES63209535234862100767,1682.49,2024-01-31T18:05:32,Zarautz,expenses,cash,-100.0,-68034.31
buyer_2,Carmen,Lozano,1984-09-05,54021274R,carmen.lozano@cleverdev.app,959998,ES63209535234862100767,1682.49,2024-01-31T09:46:15,Zarautz,expenses,repairs,-118.36,-68152.67
buyer_2,Carmen,Lozano,1984-09-05,54021274R,carmen.lozano@cleverdev.app,959998,ES63209535234862100767,1682.49,2024-02-01T09:10:33,Zarautz,incomes,salary,2170.01,-65982.66
buyer_2,Carmen,Lozano,1984-09-05,54021274R,carmen.lozano@cleverdev.app,959998,ES63209535234862100767,1682.49,2024-02-02T15:21:06,Zarautz,expenses,repairs,-272.47,-66255.13
buyer_2,Carmen,Lozano,1984-09-05,54021274R,carmen.lozano@cleverdev.app,959998,ES63209535234862100767,1682.49,2024-02-03T13:59:40,Zarautz,expenses,food,-76.15,-66331.28
buyer_2,Carmen,Lozano,1984-09-05,54021274R,carmen.lozano@cleverdev.app,959998,ES63209535234862100767,1682.49,2024-02-04T10:17:01,Zarautz,expenses,mortgage,-891.69,-67222.97
buyer_2,Carmen,Lozano,1984-09-05,54021274R,carmen.lozano@cleverdev.app,959998,ES63209535234862100767,1682.49,2024-02-04T14:35:49,Zarautz,expenses,leisure,-28.79,-67251.76
buyer_2,Carmen,Lozano,1984-09-05,54021274R,carmen.lozano@cleverdev.app,959998,ES63209535234862100767,1682.49,2024-02-06T09:24:22,Zarautz,expenses,gas,-51.36,-67303.12
buyer_2,Carmen,Lozano,1984-09-05,54021274R,carmen.lozano@cleverdev.app,959998,ES63209535234862100767,1682.49,2024-02-06T17:12:59,Zarautz,expenses,internet,-45.57,-67348.69
buyer_2,Carmen,Lozano,1984-09-05,54021274R,carmen.lozano@cleverdev.app,959998,ES63209535234862100767,1682.49,2024-02-06T14:55:31,Zarautz,expenses,leisure,-23.08,-67371.77
buyer_2,Carmen,Lozano,1984-09-05,54021274R,carmen.lozano@cleverdev.app,959998,ES63209535234862100767,1682.49,2024-02-08T08:07:35,Zarautz,expenses,leisure,-34.13,-67405.9
buyer_2,Carmen,Lozano,1984-09-05,54021274R,carmen.lozano@cleverdev.app,959998,ES63209535234862100767,1682.49,2024-02-10T10:38:29,Zarautz,expenses,transport,-59.83,-67465.73
buyer_2,Carmen,Lozano,1984-09-05,54021274R,carmen.lozano@cleverdev.app,959998,ES63209535234862100767,1682.49,2024-02-10T04:20:28,Zarautz,expenses,leisure,-22.88,-67488.61
buyer_2,Carmen,Lozano,1984-09-05,54021274R,carmen.lozano@cleverdev.app,959998,ES63209535234862100767,1682.49,2024-02-10T01:29:19,Zarautz,expenses,gifts,-220.88,-67709.49
buyer_2,Carmen,Lozano,1984-09-05,54021274R,carmen.lozano@cleverdev.app,959998,ES63209535234862100767,1682.49,2024-02-12T17:09:08,Zarautz,expenses,cash,-100.0,-67809.49
buyer_2,Carmen,Lozano,1984-09-05,54021274R,carmen.lozano@cleverdev.app,959998,ES63209535234862100767,1682.49,2024-02-13T13:11:47,Zarautz,expenses,repairs,-207.66,-68017.15
buyer_2,Carmen,Lozano,1984-09-05,54021274R,carmen.lozano@cleverdev.app,959998,ES63209535234862100767,1682.49,2024-02-14T18:27:11,Zarautz,expenses,clothing,-61.42,-68078.57
buyer_2,Carmen,Lozano,1984-09-05,54021274R,carmen.lozano@cleverdev.app,959998,ES63209535234862100767,1682.49,2024-02-14T09:30:49,Zarautz,expenses,travel,-814.13,-68892.7
buyer_2,Carmen,Lozano,1984-09-05,54021274R,carmen.lozano@cleverdev.app,959998,ES63209535234862100767,1682.49,2024-02-16T11:45:42,Zarautz,expenses,transport,-78.68,-68971.38
buyer_2,Carmen,Lozano,1984-09-05,54021274R,carmen.lozano@cleverdev.app,959998,ES63209535234862100767,1682.49,2024-02-16T18:34:42,Zarautz,expenses,cash,-100.0,-69071.38
buyer_2,Carmen,Lozano,1984-09-05,54021274R,carmen.lozano@cleverdev.app,959998,ES63209535234862100767,1682.49,2024-02-16T16:05:24,Zarautz,expenses,repairs,-89.02,-69160.4
buyer_2,Carmen,Lozano,1984-09-05,54021274R,carmen.lozano@cleverdev.app,959998,ES63209535234862100767,1682.49,2024-02-16T12:40:11,Zarautz,expenses,children,-666.3,-69826.7
buyer_2,Carmen,Lozano,1984-09-05,54021274R,carmen.lozano@cleverdev.app,959998,ES63209535234862100767,1682.49,2024-02-17T15:55:06,Zarautz,expenses,transport,-86.26,-69912.96
buyer_2,Carmen,Lozano,1984-09-05,54021274R,carmen.lozano@cleverdev.app,959998,ES63209535234862100767,1682.49,2024-02-20T09:50:11,Zarautz,expenses,leisure,-69.79,-69982.75
buyer_2,Carmen,Lozano,1984-09-05,54021274R,carmen.lozano@cleverdev.app,959998,ES63209535234862100767,1682.49,2024-02-20T22:05:30,Zarautz,expenses,clothing,-59.11,-70041.86
buyer_2,Carmen,Lozano,1984-09-05,54021274R,carmen.lozano@cleverdev.app,959998,ES63209535234862100767,1682.49,2024-02-21T08:24:15,Zarautz,expenses,leisure,-26.59,-70068.45
buyer_2,Carmen,Lozano,1984-09-05,54021274R,carmen.lozano@cleverdev.app,959998,ES63209535234862100767,1682.49,2024-02-23T21:25:38,Zarautz,expenses,food,-96.32,-70164.77
buyer_2,Carmen,Lozano,1984-09-05,54021274R,carmen.lozano@cleverdev.app,959998,ES63209535234862100767,1682.49,2024-02-26T10:51:15,Zarautz,expenses,food,-80.28,-70245.05
buyer_2,Carmen,Lozano,1984-09-05,54021274R,carmen.lozano@cleverdev.app,959998,ES63209535234862100767,1682.49,2024-02-26T05:47:07,Zarautz,expenses,gifts,-672.27,-70917.32
buyer_2,Carmen,Lozano,1984-09-05,54021274R,carmen.lozano@cleverdev.app,959998,ES63209535234862100767,1682.49,2024-02-27T18:15:06,Zarautz,expenses,children,-398.45,-71315.77
buyer_2,Carmen,Lozano,1984-09-05,54021274R,carmen.lozano@cleverdev.app,959998,ES63209535234862100767,1682.49,2024-02-28T10:54:12,Zarautz,expenses,leisure,-20.12,-71335.89
buyer_2,Carmen,Lozano,1984-09-05,54021274R,carmen.lozano@cleverdev.app,959998,ES63209535234862100767,1682.49,2024-02-28T12:24:55,Zarautz,expenses,cash,-100.0,-71435.89
buyer_2,Carmen,Lozano,1984-09-05,54021274R,carmen.lozano@cleverdev.app,959998,ES63209535234862100767,1682.49,2024-02-29T11:06:38,Zarautz,expenses,cash,-100.0,-71535.89
buyer_2,Carmen,Lozano,1984-09-05,54021274R,carmen.lozano@cleverdev.app,959998,ES63209535234862100767,1682.49,2024-03-01T19:40:53,Zarautz,incomes,salary,2170.01,-69365.88
buyer_2,Carmen,Lozano,1984-09-05,54021274R,carmen.lozano@cleverdev.app,959998,ES63209535234862100767,1682.49,2024-03-01T19:25:55,Zarautz,expenses,transport,-58.56,-69424.44
buyer_2,Carmen,Lozano,1984-09-05,54021274R,carmen.lozano@cleverdev.app,959998,ES63209535234862100767,1682.49,2024-03-01T14:20:34,Zarautz,expenses,cash,-100.0,-69524.44
buyer_2,Carmen,Lozano,1984-09-05,54021274R,carmen.lozano@cleverdev.app,959998,ES63209535234862100767,1682.49,2024-03-03T17:04:44,Zarautz,expenses,gifts,-635.68,-70160.12
buyer_2,Carmen,Lozano,1984-09-05,54021274R,carmen.lozano@cleverdev.app,959998,ES63209535234862100767,1682.49,2024-03-04T08:04:33,Zarautz,expenses,mortgage,-891.69,-71051.81
buyer_2,Carmen,Lozano,1984-09-05,54021274R,carmen.lozano@cleverdev.app,959998,ES63209535234862100767,1682.49,2024-03-05T18:14:26,Zarautz,expenses,electricity,-63.07,-71114.88
buyer_2,Carmen,Lozano,1984-09-05,54021274R,carmen.lozano@cleverdev.app,959998,ES63209535234862100767,1682.49,2024-03-05T15:59:44,Zarautz,expenses,phone,-48.07,-71162.95
buyer_2,Carmen,Lozano,1984-09-05,54021274R,carmen.lozano@cleverdev.app,959998,ES63209535234862100767,1682.49,2024-03-05T20:21:53,Zarautz,expenses,clothing,-90.69,-71253.64
buyer_2,Carmen,Lozano,1984-09-05,54021274R,carmen.lozano@cleverdev.app,959998,ES63209535234862100767,1682.49,2024-03-05T16:26:56,Zarautz,expenses,healthcare,-142.52,-71396.16
buyer_2,Carmen,Lozano,1984-09-05,54021274R,carmen.lozano@cleverdev.app,959998,ES63209535234862100767,1682.49,2024-03-06T16:01:35,Zarautz,expenses,gas,-65.96,-71462.12
buyer_2,Carmen,Lozano,1984-09-05,54021274R,carmen.lozano@cleverdev.app,959998,ES63209535234862100767,1682.49,2024-03-06T13:03:45,Zarautz,expenses,internet,-45.57,-71507.69
buyer_2,Carmen,Lozano,1984-09-05,54021274R,carmen.lozano@cleverdev.app,959998,ES63209535234862100767,1682.49,2024-03-07T09:02:17,Zarautz,expenses,internet,-45.57,-71553.26
buyer_2,Carmen,Lozano,1984-09-05,54021274R,carmen.lozano@cleverdev.app,959998,ES63209535234862100767,1682.49,2024-03-08T16:48:35,Zarautz,expenses,internet,-45.57,-71598.83
buyer_2,Carmen,Lozano,1984-09-05,54021274R,carmen.lozano@cleverdev.app,959998,ES63209535234862100767,1682.49,2024-03-08T18:01:18,Zarautz,expenses,appliances,-403.32,-72002.15
buyer_2,Carmen,Lozano,1984-09-05,54021274R,carmen.lozano@cleverdev.app,959998,ES63209535234862100767,1682.49,2024-03-09T23:21:40,Zarautz,expenses,gifts,-191.43,-72193.58
buyer_2,Carmen,Lozano,1984-09-05,54021274R,carmen.lozano@cleverdev.app,959998,ES63209535234862100767,1682.49,2024-03-11T08:42:39,Zarautz,expenses,leisure,-28.53,-72222.11
buyer_2,Carmen,Lozano,1984-09-05,54021274R,carmen.lozano@cleverdev.app,959998,ES63209535234862100767,1682.49,2024-03-11T13:28:44,Zarautz,expenses,gifts,-786.53,-73008.64
buyer_2,Carmen,Lozano,1984-09-05,54021274R,carmen.lozano@cleverdev.app,959998,ES63209535234862100767,1682.49,2024-03-16T14:18:11,Zarautz,expenses,repairs,-269.01,-73277.65
buyer_2,Carmen,Lozano,1984-09-05,54021274R,carmen.lozano@cleverdev.app,959998,ES63209535234862100767,1682.49,2024-03-17T20:39:16,Zarautz,expenses,transport,-55.16,-73332.81
buyer_2,Carmen,Lozano,1984-09-05,54021274R,carmen.lozano@cleverdev.app,959998,ES63209535234862100767,1682.49,2024-03-18T20:18:11,Zarautz,expenses,food,-107.56,-73440.37
buyer_2,Carmen,Lozano,1984-09-05,54021274R,carmen.lozano@cleverdev.app,959998,ES63209535234862100767,1682.49,2024-03-18T12:38:55,Zarautz,expenses,cash,-100.0,-73540.37
buyer_2,Carmen,Lozano,1984-09-05,54021274R,carmen.lozano@cleverdev.app,959998,ES63209535234862100767,1682.49,2024-03-19T18:20:02,Zarautz,expenses,transport,-45.87,-73586.24
buyer_2,Carmen,Lozano,1984-09-05,54021274R,carmen.lozano@cleverdev.app,959998,ES63209535234862100767,1682.49,2024-03-20T21:44:59,Zarautz,expenses,food,-99.16,-73685.4
buyer_2,Carmen,Lozano,1984-09-05,54021274R,carmen.lozano@cleverdev.app,959998,ES63209535234862100767,1682.49,2024-03-20T19:16:50,Zarautz,expenses,repairs,-303.74,-73989.14
buyer_2,Carmen,Lozano,1984-09-05,54021274R,carmen.lozano@cleverdev.app,959998,ES63209535234862100767,1682.49,2024-03-22T20:57:02,Zarautz,expenses,transport,-88.35,-74077.49
buyer_2,Carmen,Lozano,1984-09-05,54021274R,carmen.lozano@cleverdev.app,959998,ES63209535234862100767,1682.49,2024-03-22T10:02:13,Zarautz,expenses,repairs,-291.14,-74368.63
buyer_2,Carmen,Lozano,1984-09-05,54021274R,carmen.lozano@cleverdev.app,959998,ES63209535234862100767,1682.49,2024-03-23T12:47:17,Zarautz,expenses,food,-116.24,-74484.87
buyer_2,Carmen,Lozano,1984-09-05,54021274R,carmen.lozano@cleverdev.app,959998,ES63209535234862100767,1682.49,2024-03-24T15:06:01,Zarautz,expenses,healthcare,-78.18,-74563.05
buyer_2,Carmen,Lozano,1984-09-05,54021274R,carmen.lozano@cleverdev.app,959998,ES63209535234862100767,1682.49,2024-03-26T22:41:39,Zarautz,expenses,food,-85.64,-74648.69
buyer_2,Carmen,Lozano,1984-09-05,54021274R,carmen.lozano@cleverdev.app,959998,ES63209535234862100767,1682.49,2024-03-27T12:02:34,Zarautz,expenses,cash,-100.0,-74748.69
buyer_2,Carmen,Lozano,1984-09-05,54021274R,carmen.lozano@cleverdev.app,959998,ES63209535234862100767,1682.49,2024-03-27T19:23:40,Zarautz,expenses,children,-837.8489999999999,-75586.54
buyer_2,Carmen,Lozano,1984-09-05,54021274R,carmen.lozano@cleverdev.app,959998,ES63209535234862100767,1682.49,2024-03-29T18:16:03,Zarautz,expenses,healthcare,-52.5,-75639.04
buyer_2,Carmen,Lozano,1984-09-05,54021274R,carmen.lozano@cleverdev.app,959998,ES63209535234862100767,1682.49,2024-03-30T11:31:01,Zarautz,expenses,food,-90.31,-75729.35
buyer_2,Carmen,Lozano,1984-09-05,54021274R,carmen.lozano@cleverdev.app,959998,ES63209535234862100767,1682.49,2024-03-30T21:53:46,Zarautz,expenses,leisure,-31.61,-75760.96
buyer_2,Carmen,Lozano,1984-09-05,54021274R,carmen.lozano@cleverdev.app,959998,ES63209535234862100767,1682.49,2024-04-01T22:46:48,Zarautz,incomes,salary,2170.01,-73590.95
buyer_2,Carmen,Lozano,1984-09-05,54021274R,carmen.lozano@cleverdev.app,959998,ES63209535234862100767,1682.49,2024-04-01T04:19:55,Zarautz,expenses,education,-70.93,-73661.88
buyer_2,Carmen,Lozano,1984-09-05,54021274R,carmen.lozano@cleverdev.app,959998,ES63209535234862100767,1682.49,2024-04-02T08:50:48,Zarautz,expenses,cash,-100.0,-73761.88
buyer_2,Carmen,Lozano,1984-09-05,54021274R,carmen.lozano@cleverdev.app,959998,ES63209535234862100767,1682.49,2024-04-04T00:21:50,Zarautz,expenses,mortgage,-891.69,-74653.57
buyer_2,Carmen,Lozano,1984-09-05,54021274R,carmen.lozano@cleverdev.app,959998,ES63209535234862100767,1682.49,2024-04-04T21:44:20,Zarautz,expenses,leisure,-52.91,-74706.48
buyer_2,Carmen,Lozano,1984-09-05,54021274R,carmen.lozano@cleverdev.app,959998,ES63209535234862100767,1682.49,2024-04-05T16:51:32,Zarautz,expenses,internet,-45.57,-74752.05
buyer_2,Carmen,Lozano,1984-09-05,54021274R,carmen.lozano@cleverdev.app,959998,ES63209535234862100767,1682.49,2024-04-05T14:52:57,Zarautz,expenses,food,-108.51,-74860.56
buyer_2,Carmen,Lozano,1984-09-05,54021274R,carmen.lozano@cleverdev.app,959998,ES63209535234862100767,1682.49,2024-04-06T09:01:29,Zarautz,expenses,gas,-76.63,-74937.19
buyer_2,Carmen,Lozano,1984-09-05,54021274R,carmen.lozano@cleverdev.app,959998,ES63209535234862100767,1682.49,2024-04-07T15:26:37,Zarautz,expenses,electricity,-63.2,-75000.39
buyer_2,Carmen,Lozano,1984-09-05,54021274R,carmen.lozano@cleverdev.app,959998,ES63209535234862100767,1682.49,2024-04-07T13:07:25,Zarautz,expenses,internet,-45.57,-75045.96
buyer_2,Carmen,Lozano,1984-09-05,54021274R,carmen.lozano@cleverdev.app,959998,ES63209535234862100767,1682.49,2024-04-07T06:21:12,Zarautz,expenses,phone,-34.47,-75080.43
buyer_2,Carmen,Lozano,1984-09-05,54021274R,carmen.lozano@cleverdev.app,959998,ES63209535234862100767,1682.49,2024-04-08T21:45:31,Zarautz,expenses,electricity,-75.59,-75156.02
buyer_2,Carmen,Lozano,1984-09-05,54021274R,carmen.lozano@cleverdev.app,959998,ES63209535234862100767,1682.49,2024-04-08T09:29:33,Zarautz,expenses,internet,-45.57,-75201.59
buyer_2,Carmen,Lozano,1984-09-05,54021274R,carmen.lozano@cleverdev.app,959998,ES63209535234862100767,1682.49,2024-04-08T11:46:41,Zarautz,expenses,phone,-46.71,-75248.3
buyer_2,Carmen,Lozano,1984-09-05,54021274R,carmen.lozano@cleverdev.app,959998,ES63209535234862100767,1682.49,2024-04-08T18:31:02,Zarautz,expenses,food,-96.24,-75344.54
buyer_2,Carmen,Lozano,1984-09-05,54021274R,carmen.lozano@cleverdev.app,959998,ES63209535234862100767,1682.49,2024-04-09T11:32:56,Zarautz,expenses,education,-42.83,-75387.37
buyer_2,Carmen,Lozano,1984-09-05,54021274R,carmen.lozano@cleverdev.app,959998,ES63209535234862100767,1682.49,2024-04-10T16:54:11,Zarautz,expenses,cash,-100.0,-75487.37
buyer_2,Carmen,Lozano,1984-09-05,54021274R,carmen.lozano@cleverdev.app,959998,ES63209535234862100767,1682.49,2024-04-12T08:33:56,Zarautz,expenses,transport,-61.34,-75548.71
buyer_2,Carmen,Lozano,1984-09-05,54021274R,carmen.lozano@cleverdev.app,959998,ES63209535234862100767,1682.49,2024-04-12T07:43:07,Zarautz,expenses,repairs,-39.6,-75588.31
buyer_2,Carmen,Lozano,1984-09-05,54021274R,carmen.lozano@cleverdev.app,959998,ES63209535234862100767,1682.49,2024-04-13T18:53:40,Zarautz,expenses,leisure,-33.22,-75621.53
buyer_2,Carmen,Lozano,1984-09-05,54021274R,carmen.lozano@cleverdev.app,959998,ES63209535234862100767,1682.49,2024-04-14T14:30:26,Zarautz,expenses,repairs,-294.68,-75916.21
buyer_2,Carmen,Lozano,1984-09-05,54021274R,carmen.lozano@cleverdev.app,959998,ES63209535234862100767,1682.49,2024-04-15T11:16:52,Zarautz,expenses,food,-80.46,-75996.67
buyer_2,Carmen,Lozano,1984-09-05,54021274R,carmen.lozano@cleverdev.app,959998,ES63209535234862100767,1682.49,2024-04-16T11:33:57,Zarautz,expenses,repairs,-69.97,-76066.64
buyer_2,Carmen,Lozano,1984-09-05,54021274R,carmen.lozano@cleverdev.app,959998,ES63209535234862100767,1682.49,2024-04-17T18:09:22,Zarautz,expenses,gifts,-135.0,-76201.64
buyer_2,Carmen,Lozano,1984-09-05,54021274R,carmen.lozano@cleverdev.app,959998,ES63209535234862100767,1682.49,2024-04-18T19:56:27,Zarautz,expenses,appliances,-366.26,-76567.9
buyer_2,Carmen,Lozano,1984-09-05,54021274R,carmen.lozano@cleverdev.app,959998,ES63209535234862100767,1682.49,2024-04-23T13:37:42,Zarautz,expenses,cash,-100.0,-76667.9
buyer_2,Carmen,Lozano,1984-09-05,54021274R,carmen.lozano@cleverdev.app,959998,ES63209535234862100767,1682.49,2024-04-25T19:28:48,Zarautz,expenses,gifts,-368.21,-77036.11
buyer_2,Carmen,Lozano,1984-09-05,54021274R,carmen.lozano@cleverdev.app,959998,ES63209535234862100767,1682.49,2024-04-26T08:43:07,Zarautz,expenses,leisure,-48.4,-77084.51
buyer_2,Carmen,Lozano,1984-09-05,54021274R,carmen.lozano@cleverdev.app,959998,ES63209535234862100767,1682.49,2024-04-27T09:24:13,Zarautz,expenses,education,-48.51,-77133.02
buyer_2,Carmen,Lozano,1984-09-05,54021274R,carmen.lozano@cleverdev.app,959998,ES63209535234862100767,1682.49,2024-04-29T04:20:28,Zarautz,expenses,cash,-100.0,-77233.02
buyer_2,Carmen,Lozano,1984-09-05,54021274R,carmen.lozano@cleverdev.app,959998,ES63209535234862100767,1682.49,2024-04-30T20:05:07,Zarautz,expenses,cash,-100.0,-77333.02
buyer_2,Carmen,Lozano,1984-09-05,54021274R,carmen.lozano@cleverdev.app,959998,ES63209535234862100767,1682.49,2024-04-30T21:27:55,Zarautz,expenses,children,-159.85,-77492.87
buyer_2,Carmen,Lozano,1984-09-05,54021274R,carmen.lozano@cleverdev.app,959998,ES63209535234862100767,1682.49,2024-05-01T14:06:36,Zarautz,incomes,salary,2170.01,-75322.86
buyer_2,Carmen,Lozano,1984-09-05,54021274R,carmen.lozano@cleverdev.app,959998,ES63209535234862100767,1682.49,2024-05-01T14:06:36,Zarautz,incomes,extra_income,358.06,-74964.8
buyer_2,Carmen,Lozano,1984-09-05,54021274R,carmen.lozano@cleverdev.app,959998,ES63209535234862100767,1682.49,2024-05-03T15:34:26,Zarautz,expenses,appliances,-406.28,-75371.08
buyer_2,Carmen,Lozano,1984-09-05,54021274R,carmen.lozano@cleverdev.app,959998,ES63209535234862100767,1682.49,2024-05-04T12:00:15,Zarautz,expenses,mortgage,-891.69,-76262.77
buyer_2,Carmen,Lozano,1984-09-05,54021274R,carmen.lozano@cleverdev.app,959998,ES63209535234862100767,1682.49,2024-05-05T08:21:24,Zarautz,expenses,internet,-45.57,-76308.34
buyer_2,Carmen,Lozano,1984-09-05,54021274R,carmen.lozano@cleverdev.app,959998,ES63209535234862100767,1682.49,2024-05-05T08:47:22,Zarautz,expenses,phone,-42.82,-76351.16
buyer_2,Carmen,Lozano,1984-09-05,54021274R,carmen.lozano@cleverdev.app,959998,ES63209535234862100767,1682.49,2024-05-05T16:58:20,Zarautz,expenses,transport,-79.3,-76430.46
buyer_2,Carmen,Lozano,1984-09-05,54021274R,carmen.lozano@cleverdev.app,959998,ES63209535234862100767,1682.49,2024-05-05T12:33:47,Zarautz,expenses,leisure,-72.65,-76503.11
buyer_2,Carmen,Lozano,1984-09-05,54021274R,carmen.lozano@cleverdev.app,959998,ES63209535234862100767,1682.49,2024-05-07T08:49:06,Zarautz,expenses,electricity,-43.76,-76546.87
buyer_2,Carmen,Lozano,1984-09-05,54021274R,carmen.lozano@cleverdev.app,959998,ES63209535234862100767,1682.49,2024-05-07T16:56:34,Zarautz,expenses,internet,-45.57,-76592.44
buyer_2,Carmen,Lozano,1984-09-05,54021274R,carmen.lozano@cleverdev.app,959998,ES63209535234862100767,1682.49,2024-05-08T17:59:30,Zarautz,expenses,water,-33.65,-76626.09
buyer_2,Carmen,Lozano,1984-09-05,54021274R,carmen.lozano@cleverdev.app,959998,ES63209535234862100767,1682.49,2024-05-08T17:36:16,Zarautz,expenses,gas,-55.87,-76681.96
buyer_2,Carmen,Lozano,1984-09-05,54021274R,carmen.lozano@cleverdev.app,959998,ES63209535234862100767,1682.49,2024-05-08T18:13:11,Zarautz,expenses,phone,-37.81,-76719.77
buyer_2,Carmen,Lozano,1984-09-05,54021274R,carmen.lozano@cleverdev.app,959998,ES63209535234862100767,1682.49,2024-05-08T11:33:53,Zarautz,expenses,cash,-100.0,-76819.77
buyer_2,Carmen,Lozano,1984-09-05,54021274R,carmen.lozano@cleverdev.app,959998,ES63209535234862100767,1682.49,2024-05-10T09:54:44,Zarautz,expenses,leisure,-27.47,-76847.24
buyer_2,Carmen,Lozano,1984-09-05,54021274R,carmen.lozano@cleverdev.app,959998,ES63209535234862100767,1682.49,2024-05-10T10:54:41,Zarautz,expenses,repairs,-60.87,-76908.11
buyer_2,Carmen,Lozano,1984-09-05,54021274R,carmen.lozano@cleverdev.app,959998,ES63209535234862100767,1682.49,2024-05-11T14:24:45,Zarautz,expenses,food,-79.89,-76988.0
buyer_2,Carmen,Lozano,1984-09-05,54021274R,carmen.lozano@cleverdev.app,959998,ES63209535234862100767,1682.49,2024-05-11T08:25:25,Zarautz,expenses,cash,-100.0,-77088.0
buyer_2,Carmen,Lozano,1984-09-05,54021274R,carmen.lozano@cleverdev.app,959998,ES63209535234862100767,1682.49,2024-05-11T21:08:46,Zarautz,expenses,repairs,-77.6,-77165.6
buyer_2,Carmen,Lozano,1984-09-05,54021274R,carmen.lozano@cleverdev.app,959998,ES63209535234862100767,1682.49,2024-05-11T12:41:02,Zarautz,expenses,gifts,-392.59,-77558.19
buyer_2,Carmen,Lozano,1984-09-05,54021274R,carmen.lozano@cleverdev.app,959998,ES63209535234862100767,1682.49,2024-05-12T09:24:36,Zarautz,expenses,cash,-100.0,-77658.19
buyer_2,Carmen,Lozano,1984-09-05,54021274R,carmen.lozano@cleverdev.app,959998,ES63209535234862100767,1682.49,2024-05-15T18:10:48,Zarautz,expenses,food,-77.57,-77735.76
buyer_2,Carmen,Lozano,1984-09-05,54021274R,carmen.lozano@cleverdev.app,959998,ES63209535234862100767,1682.49,2024-05-15T17:38:44,Zarautz,expenses,leisure,-44.95,-77780.71
buyer_2,Carmen,Lozano,1984-09-05,54021274R,carmen.lozano@cleverdev.app,959998,ES63209535234862100767,1682.49,2024-05-16T22:36:07,Zarautz,expenses,food,-63.53,-77844.24
buyer_2,Carmen,Lozano,1984-09-05,54021274R,carmen.lozano@cleverdev.app,959998,ES63209535234862100767,1682.49,2024-05-16T16:20:56,Zarautz,expenses,gifts,-756.96,-78601.2
buyer_2,Carmen,Lozano,1984-09-05,54021274R,carmen.lozano@cleverdev.app,959998,ES63209535234862100767,1682.49,2024-05-17T08:37:47,Zarautz,expenses,cash,-100.0,-78701.2
buyer_2,Carmen,Lozano,1984-09-05,54021274R,carmen.lozano@cleverdev.app,959998,ES63209535234862100767,1682.49,2024-05-17T03:56:29,Zarautz,expenses,children,-165.07,-78866.27
buyer_2,Carmen,Lozano,1984-09-05,54021274R,carmen.lozano@cleverdev.app,959998,ES63209535234862100767,1682.49,2024-05-18T08:24:16,Zarautz,expenses,food,-88.16,-78954.43
buyer_2,Carmen,Lozano,1984-09-05,54021274R,carmen.lozano@cleverdev.app,959998,ES63209535234862100767,1682.49,2024-05-18T11:18:54,Zarautz,expenses,appliances,-381.49,-79335.92
buyer_2,Carmen,Lozano,1984-09-05,54021274R,carmen.lozano@cleverdev.app,959998,ES63209535234862100767,1682.49,2024-05-20T08:03:09,Zarautz,expenses,transport,-87.12,-79423.04
buyer_2,Carmen,Lozano,1984-09-05,54021274R,carmen.lozano@cleverdev.app,959998,ES63209535234862100767,1682.49,2024-05-20T10:58:39,Zarautz,expenses,repairs,-50.01,-79473.05
buyer_2,Carmen,Lozano,1984-09-05,54021274R,carmen.lozano@cleverdev.app,959998,ES63209535234862100767,1682.49,2024-05-20T17:29:30,Zarautz,expenses,gifts,-110.33,-79583.38
buyer_2,Carmen,Lozano,1984-09-05,54021274R,carmen.lozano@cleverdev.app,959998,ES63209535234862100767,1682.49,2024-05-22T21:01:04,Zarautz,expenses,cash,-100.0,-79683.38
buyer_2,Carmen,Lozano,1984-09-05,54021274R,carmen.lozano@cleverdev.app,959998,ES63209535234862100767,1682.49,2024-05-23T13:01:10,Zarautz,expenses,cash,-100.0,-79783.38
buyer_2,Carmen,Lozano,1984-09-05,54021274R,carmen.lozano@cleverdev.app,959998,ES63209535234862100767,1682.49,2024-05-24T15:14:46,Zarautz,expenses,food,-102.98,-79886.36
buyer_2,Carmen,Lozano,1984-09-05,54021274R,carmen.lozano@cleverdev.app,959998,ES63209535234862100767,1682.49,2024-05-29T13:45:08,Zarautz,expenses,transport,-47.95,-79934.31
buyer_2,Carmen,Lozano,1984-09-05,54021274R,carmen.lozano@cleverdev.app,959998,ES63209535234862100767,1682.49,2024-05-29T10:28:43,Zarautz,expenses,cash,-100.0,-80034.31
buyer_2,Carmen,Lozano,1984-09-05,54021274R,carmen.lozano@cleverdev.app,959998,ES63209535234862100767,1682.49,2024-05-30T13:44:34,Zarautz,expenses,transport,-52.82,-80087.13
buyer_2,Carmen,Lozano,1984-09-05,54021274R,carmen.lozano@cleverdev.app,959998,ES63209535234862100767,1682.49,2024-06-01T14:59:01,Zarautz,incomes,salary,2170.01,-77917.12
buyer_2,Carmen,Lozano,1984-09-05,54021274R,carmen.lozano@cleverdev.app,959998,ES63209535234862100767,1682.49,2024-06-01T14:59:01,Zarautz,incomes,salary_bonus,1615.84,-76301.28
buyer_2,Carmen,Lozano,1984-09-05,54021274R,carmen.lozano@cleverdev.app,959998,ES63209535234862100767,1682.49,2024-06-01T15:05:18,Zarautz,expenses,food,-91.45,-76392.73
buyer_2,Carmen,Lozano,1984-09-05,54021274R,carmen.lozano@cleverdev.app,959998,ES63209535234862100767,1682.49,2024-06-02T22:25:44,Zarautz,expenses,leisure,-76.72,-76469.45
buyer_2,Carmen,Lozano,1984-09-05,54021274R,carmen.lozano@cleverdev.app,959998,ES63209535234862100767,1682.49,2024-06-02T12:06:00,Zarautz,expenses,children,-681.8,-77151.25
buyer_2,Carmen,Lozano,1984-09-05,54021274R,carmen.lozano@cleverdev.app,959998,ES63209535234862100767,1682.49,2024-06-04T02:13:03,Zarautz,expenses,mortgage,-891.69,-78042.94
buyer_2,Carmen,Lozano,1984-09-05,54021274R,carmen.lozano@cleverdev.app,959998,ES63209535234862100767,1682.49,2024-06-04T15:29:59,Zarautz,expenses,appliances,-310.38,-78353.32
buyer_2,Carmen,Lozano,1984-09-05,54021274R,carmen.lozano@cleverdev.app,959998,ES63209535234862100767,1682.49,2024-06-04T22:11:59,Zarautz,expenses,repairs,-262.1,-78615.42
buyer_2,Carmen,Lozano,1984-09-05,54021274R,carmen.lozano@cleverdev.app,959998,ES63209535234862100767,1682.49,2024-06-05T17:02:55,Zarautz,expenses,water,-30.27,-78645.69
buyer_2,Carmen,Lozano,1984-09-05,54021274R,carmen.lozano@cleverdev.app,959998,ES63209535234862100767,1682.49,2024-06-05T20:58:57,Zarautz,expenses,electricity,-81.13,-78726.82
buyer_2,Carmen,Lozano,1984-09-05,54021274R,carmen.lozano@cleverdev.app,959998,ES63209535234862100767,1682.49,2024-06-06T17:28:44,Zarautz,expenses,taxes,-1715.51,-80442.33
buyer_2,Carmen,Lozano,1984-09-05,54021274R,carmen.lozano@cleverdev.app,959998,ES63209535234862100767,1682.49,2024-06-06T14:25:55,Zarautz,expenses,insurance,-632.01,-81074.34
buyer_2,Carmen,Lozano,1984-09-05,54021274R,carmen.lozano@cleverdev.app,959998,ES63209535234862100767,1682.49,2024-06-06T21:03:54,Zarautz,expenses,water,-45.13,-81119.47
buyer_2,Carmen,Lozano,1984-09-05,54021274R,carmen.lozano@cleverdev.app,959998,ES63209535234862100767,1682.49,2024-06-06T22:50:20,Zarautz,expenses,phone,-37.48,-81156.95
buyer_2,Carmen,Lozano,1984-09-05,54021274R,carmen.lozano@cleverdev.app,959998,ES63209535234862100767,1682.49,2024-06-06T13:37:31,Zarautz,expenses,transport,-44.18,-81201.13
buyer_2,Carmen,Lozano,1984-09-05,54021274R,carmen.lozano@cleverdev.app,959998,ES63209535234862100767,1682.49,2024-06-07T11:06:36,Zarautz,expenses,internet,-45.57,-81246.7
buyer_2,Carmen,Lozano,1984-09-05,54021274R,carmen.lozano@cleverdev.app,959998,ES63209535234862100767,1682.49,2024-06-07T16:36:56,Zarautz,expenses,food,-67.0,-81313.7
buyer_2,Carmen,Lozano,1984-09-05,54021274R,carmen.lozano@cleverdev.app,959998,ES63209535234862100767,1682.49,2024-06-07T08:36:41,Zarautz,expenses,children,-449.12,-81762.82
buyer_2,Carmen,Lozano,1984-09-05,54021274R,carmen.lozano@cleverdev.app,959998,ES63209535234862100767,1682.49,2024-06-08T13:22:54,Zarautz,expenses,internet,-45.57,-81808.39
buyer_2,Carmen,Lozano,1984-09-05,54021274R,carmen.lozano@cleverdev.app,959998,ES63209535234862100767,1682.49,2024-06-09T14:02:24,Zarautz,expenses,food,-92.6,-81900.99
buyer_2,Carmen,Lozano,1984-09-05,54021274R,carmen.lozano@cleverdev.app,959998,ES63209535234862100767,1682.49,2024-06-11T09:09:55,Zarautz,expenses,cash,-100.0,-82000.99
buyer_2,Carmen,Lozano,1984-09-05,54021274R,carmen.lozano@cleverdev.app,959998,ES63209535234862100767,1682.49,2024-06-11T11:30:31,Zarautz,expenses,children,-680.24,-82681.23
buyer_2,Carmen,Lozano,1984-09-05,54021274R,carmen.lozano@cleverdev.app,959998,ES63209535234862100767,1682.49,2024-06-12T08:41:58,Zarautz,expenses,leisure,-81.32,-82762.55
buyer_2,Carmen,Lozano,1984-09-05,54021274R,carmen.lozano@cleverdev.app,959998,ES63209535234862100767,1682.49,2024-06-14T20:51:19,Zarautz,expenses,appliances,-354.07,-83116.62
buyer_2,Carmen,Lozano,1984-09-05,54021274R,carmen.lozano@cleverdev.app,959998,ES63209535234862100767,1682.49,2024-06-16T11:41:04,Zarautz,expenses,cash,-100.0,-83216.62
buyer_2,Carmen,Lozano,1984-09-05,54021274R,carmen.lozano@cleverdev.app,959998,ES63209535234862100767,1682.49,2024-06-19T23:56:32,Zarautz,expenses,repairs,-147.51,-83364.13
buyer_2,Carmen,Lozano,1984-09-05,54021274R,carmen.lozano@cleverdev.app,959998,ES63209535234862100767,1682.49,2024-06-20T19:41:13,Zarautz,expenses,food,-105.14,-83469.27
buyer_2,Carmen,Lozano,1984-09-05,54021274R,carmen.lozano@cleverdev.app,959998,ES63209535234862100767,1682.49,2024-06-22T18:55:18,Zarautz,expenses,education,-46.0,-83515.27
buyer_2,Carmen,Lozano,1984-09-05,54021274R,carmen.lozano@cleverdev.app,959998,ES63209535234862100767,1682.49,2024-06-22T11:48:44,Zarautz,expenses,appliances,-277.38,-83792.65
buyer_2,Carmen,Lozano,1984-09-05,54021274R,carmen.lozano@cleverdev.app,959998,ES63209535234862100767,1682.49,2024-06-23T10:16:51,Zarautz,expenses,food,-79.74,-83872.39
buyer_2,Carmen,Lozano,1984-09-05,54021274R,carmen.lozano@cleverdev.app,959998,ES63209535234862100767,1682.49,2024-06-27T08:35:18,Zarautz,expenses,cash,-100.0,-83972.39
buyer_2,Carmen,Lozano,1984-09-05,54021274R,carmen.lozano@cleverdev.app,959998,ES63209535234862100767,1682.49,2024-06-28T14:16:53,Zarautz,expenses,food,-95.57,-84067.96
buyer_2,Carmen,Lozano,1984-09-05,54021274R,carmen.lozano@cleverdev.app,959998,ES63209535234862100767,1682.49,2024-06-28T13:30:38,Zarautz,expenses,gifts,-165.11,-84233.07
buyer_2,Carmen,Lozano,1984-09-05,54021274R,carmen.lozano@cleverdev.app,959998,ES63209535234862100767,1682.49,2024-06-29T10:11:50,Zarautz,expenses,food,-74.78,-84307.85
buyer_2,Carmen,Lozano,1984-09-05,54021274R,carmen.lozano@cleverdev.app,959998,ES63209535234862100767,1682.49,2024-06-29T16:37:47,Zarautz,expenses,leisure,-74.97,-84382.82
buyer_2,Carmen,Lozano,1984-09-05,54021274R,carmen.lozano@cleverdev.app,959998,ES63209535234862100767,1682.49,2024-06-30T13:39:55,Zarautz,expenses,repairs,-177.35,-84560.17
buyer_2,Carmen,Lozano,1984-09-05,54021274R,carmen.lozano@cleverdev.app,959998,ES63209535234862100767,1682.49,2024-07-01T10:36:53,Zarautz,incomes,salary,2170.01,-82390.16
buyer_2,Carmen,Lozano,1984-09-05,54021274R,carmen.lozano@cleverdev.app,959998,ES63209535234862100767,1682.49,2024-07-02T14:18:37,Zarautz,expenses,gifts,-213.59,-82603.75
buyer_2,Carmen,Lozano,1984-09-05,54021274R,carmen.lozano@cleverdev.app,959998,ES63209535234862100767,1682.49,2024-07-04T13:49:45,Zarautz,expenses,mortgage,-891.69,-83495.44
buyer_2,Carmen,Lozano,1984-09-05,54021274R,carmen.lozano@cleverdev.app,959998,ES63209535234862100767,1682.49,2024-07-04T09:28:28,Zarautz,expenses,clothing,-77.76,-83573.2
buyer_2,Carmen,Lozano,1984-09-05,54021274R,carmen.lozano@cleverdev.app,959998,ES63209535234862100767,1682.49,2024-07-04T11:15:49,Zarautz,expenses,cash,-100.0,-83673.2
buyer_2,Carmen,Lozano,1984-09-05,54021274R,carmen.lozano@cleverdev.app,959998,ES63209535234862100767,1682.49,2024-07-05T23:35:53,Zarautz,expenses,gas,-35.55,-83708.75
buyer_2,Carmen,Lozano,1984-09-05,54021274R,carmen.lozano@cleverdev.app,959998,ES63209535234862100767,1682.49,2024-07-05T04:13:45,Zarautz,expenses,food,-124.39,-83833.14
buyer_2,Carmen,Lozano,1984-09-05,54021274R,carmen.lozano@cleverdev.app,959998,ES63209535234862100767,1682.49,2024-07-06T08:13:16,Zarautz,expenses,phone,-45.86,-83879.0
buyer_2,Carmen,Lozano,1984-09-05,54021274R,carmen.lozano@cleverdev.app,959998,ES63209535234862100767,1682.49,2024-07-07T20:02:51,Zarautz,expenses,internet,-45.57,-83924.57
buyer_2,Carmen,Lozano,1984-09-05,54021274R,carmen.lozano@cleverdev.app,959998,ES63209535234862100767,1682.49,2024-07-07T11:55:57,Zarautz,expenses,leisure,-58.83,-83983.4
buyer_2,Carmen,Lozano,1984-09-05,54021274R,carmen.lozano@cleverdev.app,959998,ES63209535234862100767,1682.49,2024-07-07T10:27:53,Zarautz,expenses,cash,-100.0,-84083.4
buyer_2,Carmen,Lozano,1984-09-05,54021274R,carmen.lozano@cleverdev.app,959998,ES63209535234862100767,1682.49,2024-07-08T18:05:57,Zarautz,expenses,clothing,-69.85,-84153.25
buyer_2,Carmen,Lozano,1984-09-05,54021274R,carmen.lozano@cleverdev.app,959998,ES63209535234862100767,1682.49,2024-07-09T01:43:45,Zarautz,expenses,repairs,-162.88,-84316.13
buyer_2,Carmen,Lozano,1984-09-05,54021274R,carmen.lozano@cleverdev.app,959998,ES63209535234862100767,1682.49,2024-07-11T15:41:54,Zarautz,expenses,food,-82.72,-84398.85
buyer_2,Carmen,Lozano,1984-09-05,54021274R,carmen.lozano@cleverdev.app,959998,ES63209535234862100767,1682.49,2024-07-11T22:38:54,Zarautz,expenses,transport,-52.85,-84451.7
buyer_2,Carmen,Lozano,1984-09-05,54021274R,carmen.lozano@cleverdev.app,959998,ES63209535234862100767,1682.49,2024-07-12T15:36:35,Zarautz,expenses,food,-122.44,-84574.14
buyer_2,Carmen,Lozano,1984-09-05,54021274R,carmen.lozano@cleverdev.app,959998,ES63209535234862100767,1682.49,2024-07-13T21:00:42,Zarautz,expenses,transport,-78.57,-84652.71
buyer_2,Carmen,Lozano,1984-09-05,54021274R,carmen.lozano@cleverdev.app,959998,ES63209535234862100767,1682.49,2024-07-15T21:05:02,Zarautz,expenses,food,-79.94,-84732.65
buyer_2,Carmen,Lozano,1984-09-05,54021274R,carmen.lozano@cleverdev.app,959998,ES63209535234862100767,1682.49,2024-07-16T16:32:45,Zarautz,expenses,appliances,-361.48,-85094.13
buyer_2,Carmen,Lozano,1984-09-05,54021274R,carmen.lozano@cleverdev.app,959998,ES63209535234862100767,1682.49,2024-07-23T22:08:34,Zarautz,expenses,leisure,-84.7,-85178.83
buyer_2,Carmen,Lozano,1984-09-05,54021274R,carmen.lozano@cleverdev.app,959998,ES63209535234862100767,1682.49,2024-07-23T08:36:33,Zarautz,expenses,cash,-100.0,-85278.83
buyer_2,Carmen,Lozano,1984-09-05,54021274R,carmen.lozano@cleverdev.app,959998,ES63209535234862100767,1682.49,2024-07-24T09:19:08,Zarautz,expenses,repairs,-277.77,-85556.6
buyer_2,Carmen,Lozano,1984-09-05,54021274R,carmen.lozano@cleverdev.app,959998,ES63209535234862100767,1682.49,2024-07-25T09:23:20,Zarautz,expenses,leisure,-67.85,-85624.45
buyer_2,Carmen,Lozano,1984-09-05,54021274R,carmen.lozano@cleverdev.app,959998,ES63209535234862100767,1682.49,2024-07-25T08:58:15,Zarautz,expenses,repairs,-285.17,-85909.62
buyer_2,Carmen,Lozano,1984-09-05,54021274R,carmen.lozano@cleverdev.app,959998,ES63209535234862100767,1682.49,2024-07-26T19:51:52,Zarautz,expenses,food,-87.88,-85997.5
buyer_2,Carmen,Lozano,1984-09-05,54021274R,carmen.lozano@cleverdev.app,959998,ES63209535234862100767,1682.49,2024-07-27T15:24:58,Zarautz,expenses,cash,-100.0,-86097.5
buyer_2,Carmen,Lozano,1984-09-05,54021274R,carmen.lozano@cleverdev.app,959998,ES63209535234862100767,1682.49,2024-07-30T11:59:46,Zarautz,expenses,transport,-67.69,-86165.19
buyer_2,Carmen,Lozano,1984-09-05,54021274R,carmen.lozano@cleverdev.app,959998,ES63209535234862100767,1682.49,2024-07-30T08:52:34,Zarautz,expenses,gifts,-386.29,-86551.48
buyer_2,Carmen,Lozano,1984-09-05,54021274R,carmen.lozano@cleverdev.app,959998,ES63209535234862100767,1682.49,2024-07-31T09:58:52,Zarautz,expenses,education,-53.52,-86605.0
buyer_2,Carmen,Lozano,1984-09-05,54021274R,carmen.lozano@cleverdev.app,959998,ES63209535234862100767,1682.49,2024-08-01T20:36:04,Zarautz,incomes,salary,2170.01,-84434.99
buyer_2,Carmen,Lozano,1984-09-05,54021274R,carmen.lozano@cleverdev.app,959998,ES63209535234862100767,1682.49,2024-08-01T20:36:04,Zarautz,incomes,extra_income,358.06,-84076.93
buyer_2,Carmen,Lozano,1984-09-05,54021274R,carmen.lozano@cleverdev.app,959998,ES63209535234862100767,1682.49,2024-08-03T22:12:56,Zarautz,expenses,healthcare,-102.5,-84179.43
buyer_2,Carmen,Lozano,1984-09-05,54021274R,carmen.lozano@cleverdev.app,959998,ES63209535234862100767,1682.49,2024-08-04T17:09:10,Zarautz,expenses,mortgage,-891.69,-85071.12
buyer_2,Carmen,Lozano,1984-09-05,54021274R,carmen.lozano@cleverdev.app,959998,ES63209535234862100767,1682.49,2024-08-05T23:36:11,Zarautz,expenses,phone,-39.62,-85110.74
buyer_2,Carmen,Lozano,1984-09-05,54021274R,carmen.lozano@cleverdev.app,959998,ES63209535234862100767,1682.49,2024-08-05T14:27:52,Zarautz,expenses,transport,-85.61,-85196.35
buyer_2,Carmen,Lozano,1984-09-05,54021274R,carmen.lozano@cleverdev.app,959998,ES63209535234862100767,1682.49,2024-08-06T09:49:11,Zarautz,expenses,water,-45.65,-85242.0
buyer_2,Carmen,Lozano,1984-09-05,54021274R,carmen.lozano@cleverdev.app,959998,ES63209535234862100767,1682.49,2024-08-06T09:20:44,Zarautz,expenses,electricity,-55.63,-85297.63
buyer_2,Carmen,Lozano,1984-09-05,54021274R,carmen.lozano@cleverdev.app,959998,ES63209535234862100767,1682.49,2024-08-08T19:40:49,Zarautz,expenses,electricity,-38.21,-85335.84
buyer_2,Carmen,Lozano,1984-09-05,54021274R,carmen.lozano@cleverdev.app,959998,ES63209535234862100767,1682.49,2024-08-08T20:21:10,Zarautz,expenses,internet,-45.57,-85381.41
buyer_2,Carmen,Lozano,1984-09-05,54021274R,carmen.lozano@cleverdev.app,959998,ES63209535234862100767,1682.49,2024-08-08T12:41:04,Zarautz,expenses,phone,-44.88,-85426.29
buyer_2,Carmen,Lozano,1984-09-05,54021274R,carmen.lozano@cleverdev.app,959998,ES63209535234862100767,1682.49,2024-08-10T08:59:36,Zarautz,expenses,food,-83.72,-85510.01
buyer_2,Carmen,Lozano,1984-09-05,54021274R,carmen.lozano@cleverdev.app,959998,ES63209535234862100767,1682.49,2024-08-10T16:17:57,Zarautz,expenses,education,-72.75,-85582.76
buyer_2,Carmen,Lozano,1984-09-05,54021274R,carmen.lozano@cleverdev.app,959998,ES63209535234862100767,1682.49,2024-08-11T10:25:27,Zarautz,expenses,food,-100.41,-85683.17
buyer_2,Carmen,Lozano,1984-09-05,54021274R,carmen.lozano@cleverdev.app,959998,ES63209535234862100767,1682.49,2024-08-13T02:17:24,Zarautz,expenses,cash,-100.0,-85783.17
buyer_2,Carmen,Lozano,1984-09-05,54021274R,carmen.lozano@cleverdev.app,959998,ES63209535234862100767,1682.49,2024-08-14T21:13:01,Zarautz,expenses,healthcare,-153.0,-85936.17
buyer_2,Carmen,Lozano,1984-09-05,54021274R,carmen.lozano@cleverdev.app,959998,ES63209535234862100767,1682.49,2024-08-15T21:26:58,Zarautz,expenses,leisure,-29.15,-85965.32
buyer_2,Carmen,Lozano,1984-09-05,54021274R,carmen.lozano@cleverdev.app,959998,ES63209535234862100767,1682.49,2024-08-15T15:09:33,Zarautz,expenses,education,-78.82,-86044.14
buyer_2,Carmen,Lozano,1984-09-05,54021274R,carmen.lozano@cleverdev.app,959998,ES63209535234862100767,1682.49,2024-08-16T10:22:00,Zarautz,expenses,transport,-82.81,-86126.95
buyer_2,Carmen,Lozano,1984-09-05,54021274R,carmen.lozano@cleverdev.app,959998,ES63209535234862100767,1682.49,2024-08-16T10:29:21,Zarautz,expenses,education,-44.51,-86171.46
buyer_2,Carmen,Lozano,1984-09-05,54021274R,carmen.lozano@cleverdev.app,959998,ES63209535234862100767,1682.49,2024-08-16T12:41:41,Zarautz,expenses,repairs,-36.9,-86208.36
buyer_2,Carmen,Lozano,1984-09-05,54021274R,carmen.lozano@cleverdev.app,959998,ES63209535234862100767,1682.49,2024-08-18T14:46:25,Zarautz,expenses,transport,-54.15,-86262.51
buyer_2,Carmen,Lozano,1984-09-05,54021274R,carmen.lozano@cleverdev.app,959998,ES63209535234862100767,1682.49,2024-08-18T14:09:18,Zarautz,expenses,cash,-100.0,-86362.51
buyer_2,Carmen,Lozano,1984-09-05,54021274R,carmen.lozano@cleverdev.app,959998,ES63209535234862100767,1682.49,2024-08-20T16:47:27,Zarautz,expenses,repairs,-156.21,-86518.72
buyer_2,Carmen,Lozano,1984-09-05,54021274R,carmen.lozano@cleverdev.app,959998,ES63209535234862100767,1682.49,2024-08-22T16:47:38,Zarautz,expenses,food,-78.65,-86597.37
buyer_2,Carmen,Lozano,1984-09-05,54021274R,carmen.lozano@cleverdev.app,959998,ES63209535234862100767,1682.49,2024-08-22T03:54:53,Zarautz,expenses,leisure,-47.49,-86644.86
buyer_2,Carmen,Lozano,1984-09-05,54021274R,carmen.lozano@cleverdev.app,959998,ES63209535234862100767,1682.49,2024-08-23T15:29:17,Zarautz,expenses,healthcare,-183.72,-86828.58
buyer_2,Carmen,Lozano,1984-09-05,54021274R,carmen.lozano@cleverdev.app,959998,ES63209535234862100767,1682.49,2024-08-23T12:13:25,Zarautz,expenses,appliances,-397.01,-87225.59
buyer_2,Carmen,Lozano,1984-09-05,54021274R,carmen.lozano@cleverdev.app,959998,ES63209535234862100767,1682.49,2024-08-26T08:59:45,Zarautz,expenses,food,-69.1,-87294.69
buyer_2,Carmen,Lozano,1984-09-05,54021274R,carmen.lozano@cleverdev.app,959998,ES63209535234862100767,1682.49,2024-08-26T05:25:09,Zarautz,expenses,transport,-67.9,-87362.59
buyer_2,Carmen,Lozano,1984-09-05,54021274R,carmen.lozano@cleverdev.app,959998,ES63209535234862100767,1682.49,2024-08-26T09:57:44,Zarautz,expenses,cash,-100.0,-87462.59
buyer_2,Carmen,Lozano,1984-09-05,54021274R,carmen.lozano@cleverdev.app,959998,ES63209535234862100767,1682.49,2024-08-27T15:30:48,Zarautz,expenses,appliances,-194.12,-87656.71
buyer_2,Carmen,Lozano,1984-09-05,54021274R,carmen.lozano@cleverdev.app,959998,ES63209535234862100767,1682.49,2024-08-28T17:34:17,Zarautz,expenses,clothing,-47.52,-87704.23
buyer_2,Carmen,Lozano,1984-09-05,54021274R,carmen.lozano@cleverdev.app,959998,ES63209535234862100767,1682.49,2024-08-28T15:27:46,Zarautz,expenses,gifts,-697.53,-88401.76
buyer_2,Carmen,Lozano,1984-09-05,54021274R,carmen.lozano@cleverdev.app,959998,ES63209535234862100767,1682.49,2024-08-29T10:43:44,Zarautz,expenses,children,-271.23,-88672.99
buyer_2,Carmen,Lozano,1984-09-05,54021274R,carmen.lozano@cleverdev.app,959998,ES63209535234862100767,1682.49,2024-08-30T00:41:13,Zarautz,expenses,cash,-100.0,-88772.99
buyer_2,Carmen,Lozano,1984-09-05,54021274R,carmen.lozano@cleverdev.app,959998,ES63209535234862100767,1682.49,2024-08-31T20:28:28,Zarautz,expenses,repairs,-227.76,-89000.75
buyer_2,Carmen,Lozano,1984-09-05,54021274R,carmen.lozano@cleverdev.app,959998,ES63209535234862100767,1682.49,2024-09-01T23:34:53,Zarautz,incomes,salary,2170.01,-86830.74
buyer_2,Carmen,Lozano,1984-09-05,54021274R,carmen.lozano@cleverdev.app,959998,ES63209535234862100767,1682.49,2024-09-04T08:37:29,Zarautz,expenses,mortgage,-891.69,-87722.43
buyer_2,Carmen,Lozano,1984-09-05,54021274R,carmen.lozano@cleverdev.app,959998,ES63209535234862100767,1682.49,2024-09-04T21:34:24,Zarautz,expenses,cash,-100.0,-87822.43
buyer_2,Carmen,Lozano,1984-09-05,54021274R,carmen.lozano@cleverdev.app,959998,ES63209535234862100767,1682.49,2024-09-04T21:55:54,Zarautz,expenses,repairs,-116.09,-87938.52
buyer_2,Carmen,Lozano,1984-09-05,54021274R,carmen.lozano@cleverdev.app,959998,ES63209535234862100767,1682.49,2024-09-06T08:08:57,Zarautz,expenses,electricity,-60.1,-87998.62
buyer_2,Carmen,Lozano,1984-09-05,54021274R,carmen.lozano@cleverdev.app,959998,ES63209535234862100767,1682.49,2024-09-06T18:36:22,Zarautz,expenses,internet,-45.57,-88044.19
buyer_2,Carmen,Lozano,1984-09-05,54021274R,carmen.lozano@cleverdev.app,959998,ES63209535234862100767,1682.49,2024-09-06T10:38:13,Zarautz,expenses,phone,-43.75,-88087.94
buyer_2,Carmen,Lozano,1984-09-05,54021274R,carmen.lozano@cleverdev.app,959998,ES63209535234862100767,1682.49,2024-09-07T17:33:50,Zarautz,expenses,phone,-48.29,-88136.23
buyer_2,Carmen,Lozano,1984-09-05,54021274R,carmen.lozano@cleverdev.app,959998,ES63209535234862100767,1682.49,2024-09-07T12:46:45,Zarautz,expenses,transport,-78.08,-88214.31
buyer_2,Carmen,Lozano,1984-09-05,54021274R,carmen.lozano@cleverdev.app,959998,ES63209535234862100767,1682.49,2024-09-08T16:20:06,Zarautz,expenses,food,-72.23,-88286.54
buyer_2,Carmen,Lozano,1984-09-05,54021274R,carmen.lozano@cleverdev.app,959998,ES63209535234862100767,1682.49,2024-09-09T19:35:24,Zarautz,expenses,healthcare,-159.26,-88445.8
buyer_2,Carmen,Lozano,1984-09-05,54021274R,carmen.lozano@cleverdev.app,959998,ES63209535234862100767,1682.49,2024-09-09T14:57:42,Zarautz,expenses,repairs,-86.83,-88532.63
buyer_2,Carmen,Lozano,1984-09-05,54021274R,carmen.lozano@cleverdev.app,959998,ES63209535234862100767,1682.49,2024-09-10T10:06:00,Zarautz,expenses,cash,-100.0,-88632.63
buyer_2,Carmen,Lozano,1984-09-05,54021274R,carmen.lozano@cleverdev.app,959998,ES63209535234862100767,1682.49,2024-09-11T15:11:18,Zarautz,expenses,cash,-100.0,-88732.63
buyer_2,Carmen,Lozano,1984-09-05,54021274R,carmen.lozano@cleverdev.app,959998,ES63209535234862100767,1682.49,2024-09-11T15:29:35,Zarautz,expenses,repairs,-94.86,-88827.49
buyer_2,Carmen,Lozano,1984-09-05,54021274R,carmen.lozano@cleverdev.app,959998,ES63209535234862100767,1682.49,2024-09-13T11:40:12,Zarautz,expenses,cash,-100.0,-88927.49
buyer_2,Carmen,Lozano,1984-09-05,54021274R,carmen.lozano@cleverdev.app,959998,ES63209535234862100767,1682.49,2024-09-14T16:43:00,Zarautz,expenses,leisure,-38.75,-88966.24
buyer_2,Carmen,Lozano,1984-09-05,54021274R,carmen.lozano@cleverdev.app,959998,ES63209535234862100767,1682.49,2024-09-15T16:06:02,Zarautz,expenses,food,-107.96,-89074.2
buyer_2,Carmen,Lozano,1984-09-05,54021274R,carmen.lozano@cleverdev.app,959998,ES63209535234862100767,1682.49,2024-09-16T19:20:03,Zarautz,expenses,food,-89.46,-89163.66
buyer_2,Carmen,Lozano,1984-09-05,54021274R,carmen.lozano@cleverdev.app,959998,ES63209535234862100767,1682.49,2024-09-17T18:51:35,Zarautz,expenses,transport,-83.17,-89246.83
buyer_2,Carmen,Lozano,1984-09-05,54021274R,carmen.lozano@cleverdev.app,959998,ES63209535234862100767,1682.49,2024-09-18T08:47:20,Zarautz,expenses,repairs,-40.08,-89286.91
buyer_2,Carmen,Lozano,1984-09-05,54021274R,carmen.lozano@cleverdev.app,959998,ES63209535234862100767,1682.49,2024-09-19T15:07:44,Zarautz,expenses,transport,-69.12,-89356.03
buyer_2,Carmen,Lozano,1984-09-05,54021274R,carmen.lozano@cleverdev.app,959998,ES63209535234862100767,1682.49,2024-09-19T17:31:38,Zarautz,expenses,leisure,-74.11,-89430.14
buyer_2,Carmen,Lozano,1984-09-05,54021274R,carmen.lozano@cleverdev.app,959998,ES63209535234862100767,1682.49,2024-09-20T17:52:25,Zarautz,expenses,leisure,-53.79,-89483.93
buyer_2,Carmen,Lozano,1984-09-05,54021274R,carmen.lozano@cleverdev.app,959998,ES63209535234862100767,1682.49,2024-09-24T14:58:31,Zarautz,expenses,cash,-100.0,-89583.93
buyer_2,Carmen,Lozano,1984-09-05,54021274R,carmen.lozano@cleverdev.app,959998,ES63209535234862100767,1682.49,2024-09-25T09:17:59,Zarautz,expenses,transport,-55.84,-89639.77
buyer_2,Carmen,Lozano,1984-09-05,54021274R,carmen.lozano@cleverdev.app,959998,ES63209535234862100767,1682.49,2024-09-28T17:27:03,Zarautz,expenses,gifts,-187.34,-89827.11
buyer_2,Carmen,Lozano,1984-09-05,54021274R,carmen.lozano@cleverdev.app,959998,ES63209535234862100767,1682.49,2024-10-01T09:23:08,Zarautz,incomes,salary,2170.01,-87657.1
buyer_2,Carmen,Lozano,1984-09-05,54021274R,carmen.lozano@cleverdev.app,959998,ES63209535234862100767,1682.49,2024-10-01T12:50:27,Zarautz,expenses,children,-818.35,-88475.45
buyer_2,Carmen,Lozano,1984-09-05,54021274R,carmen.lozano@cleverdev.app,959998,ES63209535234862100767,1682.49,2024-10-04T10:29:03,Zarautz,expenses,mortgage,-891.69,-89367.14
buyer_2,Carmen,Lozano,1984-09-05,54021274R,carmen.lozano@cleverdev.app,959998,ES63209535234862100767,1682.49,2024-10-04T19:51:41,Zarautz,expenses,education,-66.55,-89433.69
buyer_2,Carmen,Lozano,1984-09-05,54021274R,carmen.lozano@cleverdev.app,959998,ES63209535234862100767,1682.49,2024-10-04T13:43:01,Zarautz,expenses,repairs,-318.77,-89752.46
buyer_2,Carmen,Lozano,1984-09-05,54021274R,carmen.lozano@cleverdev.app,959998,ES63209535234862100767,1682.49,2024-10-05T18:21:57,Zarautz,expenses,phone,-41.25,-89793.71
buyer_2,Carmen,Lozano,1984-09-05,54021274R,carmen.lozano@cleverdev.app,959998,ES63209535234862100767,1682.49,2024-10-05T16:02:32,Zarautz,expenses,food,-66.35,-89860.06
buyer_2,Carmen,Lozano,1984-09-05,54021274R,carmen.lozano@cleverdev.app,959998,ES63209535234862100767,1682.49,2024-10-05T10:31:17,Zarautz,expenses,cash,-100.0,-89960.06
buyer_2,Carmen,Lozano,1984-09-05,54021274R,carmen.lozano@cleverdev.app,959998,ES63209535234862100767,1682.49,2024-10-06T23:06:55,Zarautz,expenses,internet,-45.57,-90005.63
buyer_2,Carmen,Lozano,1984-09-05,54021274R,carmen.lozano@cleverdev.app,959998,ES63209535234862100767,1682.49,2024-10-06T11:40:24,Zarautz,expenses,cash,-100.0,-90105.63
buyer_2,Carmen,Lozano,1984-09-05,54021274R,carmen.lozano@cleverdev.app,959998,ES63209535234862100767,1682.49,2024-10-07T10:06:23,Zarautz,expenses,appliances,-96.36,-90201.99
buyer_2,Carmen,Lozano,1984-09-05,54021274R,carmen.lozano@cleverdev.app,959998,ES63209535234862100767,1682.49,2024-10-08T12:41:29,Zarautz,expenses,internet,-45.57,-90247.56
buyer_2,Carmen,Lozano,1984-09-05,54021274R,carmen.lozano@cleverdev.app,959998,ES63209535234862100767,1682.49,2024-10-09T14:39:17,Zarautz,expenses,leisure,-19.74,-90267.3
buyer_2,Carmen,Lozano,1984-09-05,54021274R,carmen.lozano@cleverdev.app,959998,ES63209535234862100767,1682.49,2024-10-10T12:26:48,Zarautz,expenses,transport,-65.81,-90333.11
buyer_3,Ana,Piñeiro,1989-08-23,43610689K,ana.piñeiro@awesomenet.io,074110,ES50209546216055661299,7157.03,2022-01-01T21:56:04,Amurrio,incomes,salary,3312.4,10469.43
buyer_3,Ana,Piñeiro,1989-08-23,43610689K,ana.piñeiro@awesomenet.io,074110,ES50209546216055661299,7157.03,2022-01-01T21:56:04,Amurrio,incomes,salary_partner,3068.13,13537.56
buyer_3,Ana,Piñeiro,1989-08-23,43610689K,ana.piñeiro@awesomenet.io,074110,ES50209546216055661299,7157.03,2022-01-01T09:23:49,Amurrio,expenses,cash,-100.0,13437.56
buyer_3,Ana,Piñeiro,1989-08-23,43610689K,ana.piñeiro@awesomenet.io,074110,ES50209546216055661299,7157.03,2022-01-02T10:21:21,Amurrio,expenses,cash,-100.0,13337.56
buyer_3,Ana,Piñeiro,1989-08-23,43610689K,ana.piñeiro@awesomenet.io,074110,ES50209546216055661299,7157.03,2022-01-04T21:24:45,Amurrio,expenses,mortgage,-2389.79,10947.77
buyer_3,Ana,Piñeiro,1989-08-23,43610689K,ana.piñeiro@awesomenet.io,074110,ES50209546216055661299,7157.03,2022-01-04T17:25:31,Amurrio,expenses,leisure,-52.95,10894.82
buyer_3,Ana,Piñeiro,1989-08-23,43610689K,ana.piñeiro@awesomenet.io,074110,ES50209546216055661299,7157.03,2022-01-05T03:18:04,Amurrio,expenses,electricity,-142.87,10751.95
buyer_3,Ana,Piñeiro,1989-08-23,43610689K,ana.piñeiro@awesomenet.io,074110,ES50209546216055661299,7157.03,2022-01-05T13:32:31,Amurrio,expenses,food,-87.3,10664.65
buyer_3,Ana,Piñeiro,1989-08-23,43610689K,ana.piñeiro@awesomenet.io,074110,ES50209546216055661299,7157.03,2022-01-05T14:25:23,Amurrio,expenses,car,-343.23,10321.42
buyer_3,Ana,Piñeiro,1989-08-23,43610689K,ana.piñeiro@awesomenet.io,074110,ES50209546216055661299,7157.03,2022-01-06T16:34:08,Amurrio,expenses,gas,-152.95,10168.47
buyer_3,Ana,Piñeiro,1989-08-23,43610689K,ana.piñeiro@awesomenet.io,074110,ES50209546216055661299,7157.03,2022-01-06T10:28:18,Amurrio,expenses,leisure,-76.61,10091.86
buyer_3,Ana,Piñeiro,1989-08-23,43610689K,ana.piñeiro@awesomenet.io,074110,ES50209546216055661299,7157.03,2022-01-07T10:26:53,Amurrio,expenses,internet,-133.99,9957.87
buyer_3,Ana,Piñeiro,1989-08-23,43610689K,ana.piñeiro@awesomenet.io,074110,ES50209546216055661299,7157.03,2022-01-08T14:42:59,Amurrio,expenses,food,-86.59,9871.28
buyer_3,Ana,Piñeiro,1989-08-23,43610689K,ana.piñeiro@awesomenet.io,074110,ES50209546216055661299,7157.03,2022-01-09T22:35:48,Amurrio,expenses,cash,-100.0,9771.28
buyer_3,Ana,Piñeiro,1989-08-23,43610689K,ana.piñeiro@awesomenet.io,074110,ES50209546216055661299,7157.03,2022-01-09T08:34:25,Amurrio,expenses,gifts,-336.96,9434.32
buyer_3,Ana,Piñeiro,1989-08-23,43610689K,ana.piñeiro@awesomenet.io,074110,ES50209546216055661299,7157.03,2022-01-10T16:03:59,Amurrio,expenses,education,-64.96,9369.36
buyer_3,Ana,Piñeiro,1989-08-23,43610689K,ana.piñeiro@awesomenet.io,074110,ES50209546216055661299,7157.03,2022-01-11T13:04:51,Amurrio,expenses,food,-124.06,9245.3
buyer_3,Ana,Piñeiro,1989-08-23,43610689K,ana.piñeiro@awesomenet.io,074110,ES50209546216055661299,7157.03,2022-01-12T14:54:59,Amurrio,expenses,cash,-100.0,9145.3
buyer_3,Ana,Piñeiro,1989-08-23,43610689K,ana.piñeiro@awesomenet.io,074110,ES50209546216055661299,7157.03,2022-01-16T14:35:11,Amurrio,expenses,food,-62.48,9082.82
buyer_3,Ana,Piñeiro,1989-08-23,43610689K,ana.piñeiro@awesomenet.io,074110,ES50209546216055661299,7157.03,2022-01-18T19:48:52,Amurrio,expenses,transport,-64.43,9018.39
buyer_3,Ana,Piñeiro,1989-08-23,43610689K,ana.piñeiro@awesomenet.io,074110,ES50209546216055661299,7157.03,2022-01-19T14:45:34,Amurrio,expenses,leisure,-23.26,8995.13
buyer_3,Ana,Piñeiro,1989-08-23,43610689K,ana.piñeiro@awesomenet.io,074110,ES50209546216055661299,7157.03,2022-01-20T11:02:15,Amurrio,expenses,cash,-100.0,8895.13
buyer_3,Ana,Piñeiro,1989-08-23,43610689K,ana.piñeiro@awesomenet.io,074110,ES50209546216055661299,7157.03,2022-01-21T13:49:58,Amurrio,expenses,food,-88.29,8806.84
buyer_3,Ana,Piñeiro,1989-08-23,43610689K,ana.piñeiro@awesomenet.io,074110,ES50209546216055661299,7157.03,2022-01-27T18:21:26,Amurrio,expenses,food,-113.74,8693.1
buyer_3,Ana,Piñeiro,1989-08-23,43610689K,ana.piñeiro@awesomenet.io,074110,ES50209546216055661299,7157.03,2022-01-28T16:23:25,Amurrio,expenses,food,-60.06,8633.04
buyer_3,Ana,Piñeiro,1989-08-23,43610689K,ana.piñeiro@awesomenet.io,074110,ES50209546216055661299,7157.03,2022-01-30T20:06:10,Amurrio,expenses,clothing,-71.39,8561.65
buyer_3,Ana,Piñeiro,1989-08-23,43610689K,ana.piñeiro@awesomenet.io,074110,ES50209546216055661299,7157.03,2022-02-01T15:28:45,Amurrio,incomes,salary,3312.4,11874.05
buyer_3,Ana,Piñeiro,1989-08-23,43610689K,ana.piñeiro@awesomenet.io,074110,ES50209546216055661299,7157.03,2022-02-01T15:28:45,Amurrio,incomes,salary_partner,3068.13,14942.18
buyer_3,Ana,Piñeiro,1989-08-23,43610689K,ana.piñeiro@awesomenet.io,074110,ES50209546216055661299,7157.03,2022-02-03T14:09:32,Amurrio,expenses,food,-66.63,14875.55
buyer_3,Ana,Piñeiro,1989-08-23,43610689K,ana.piñeiro@awesomenet.io,074110,ES50209546216055661299,7157.03,2022-02-04T22:27:29,Amurrio,expenses,mortgage,-2389.79,12485.76
buyer_3,Ana,Piñeiro,1989-08-23,43610689K,ana.piñeiro@awesomenet.io,074110,ES50209546216055661299,7157.03,2022-02-05T12:20:52,Amurrio,expenses,internet,-133.99,12351.77
buyer_3,Ana,Piñeiro,1989-08-23,43610689K,ana.piñeiro@awesomenet.io,074110,ES50209546216055661299,7157.03,2022-02-06T20:37:04,Amurrio,expenses,electricity,-170.24,12181.53
buyer_3,Ana,Piñeiro,1989-08-23,43610689K,ana.piñeiro@awesomenet.io,074110,ES50209546216055661299,7157.03,2022-02-06T13:38:25,Amurrio,expenses,gas,-178.23,12003.3
buyer_3,Ana,Piñeiro,1989-08-23,43610689K,ana.piñeiro@awesomenet.io,074110,ES50209546216055661299,7157.03,2022-02-06T20:38:59,Amurrio,expenses,internet,-133.99,11869.31
buyer_3,Ana,Piñeiro,1989-08-23,43610689K,ana.piñeiro@awesomenet.io,074110,ES50209546216055661299,7157.03,2022-02-06T09:19:43,Amurrio,expenses,phone,-108.37,11760.94
buyer_3,Ana,Piñeiro,1989-08-23,43610689K,ana.piñeiro@awesomenet.io,074110,ES50209546216055661299,7157.03,2022-02-06T13:07:41,Amurrio,expenses,gifts,-533.98,11226.96
buyer_3,Ana,Piñeiro,1989-08-23,43610689K,ana.piñeiro@awesomenet.io,074110,ES50209546216055661299,7157.03,2022-02-08T18:49:14,Amurrio,expenses,water,-139.79,11087.17
buyer_3,Ana,Piñeiro,1989-08-23,43610689K,ana.piñeiro@awesomenet.io,074110,ES50209546216055661299,7157.03,2022-02-08T20:02:13,Amurrio,expenses,gas,-132.62,10954.55
buyer_3,Ana,Piñeiro,1989-08-23,43610689K,ana.piñeiro@awesomenet.io,074110,ES50209546216055661299,7157.03,2022-02-08T07:29:05,Amurrio,expenses,phone,-133.3,10821.25
buyer_3,Ana,Piñeiro,1989-08-23,43610689K,ana.piñeiro@awesomenet.io,074110,ES50209546216055661299,7157.03,2022-02-08T18:55:30,Amurrio,expenses,food,-112.31,10708.94
buyer_3,Ana,Piñeiro,1989-08-23,43610689K,ana.piñeiro@awesomenet.io,074110,ES50209546216055661299,7157.03,2022-02-08T13:54:17,Amurrio,expenses,leisure,-29.67,10679.27
buyer_3,Ana,Piñeiro,1989-08-23,43610689K,ana.piñeiro@awesomenet.io,074110,ES50209546216055661299,7157.03,2022-02-08T10:01:12,Amurrio,expenses,cash,-100.0,10579.27
buyer_3,Ana,Piñeiro,1989-08-23,43610689K,ana.piñeiro@awesomenet.io,074110,ES50209546216055661299,7157.03,2022-02-11T11:47:37,Amurrio,expenses,cash,-100.0,10479.27
buyer_3,Ana,Piñeiro,1989-08-23,43610689K,ana.piñeiro@awesomenet.io,074110,ES50209546216055661299,7157.03,2022-02-15T10:29:59,Amurrio,expenses,transport,-43.11,10436.16
buyer_3,Ana,Piñeiro,1989-08-23,43610689K,ana.piñeiro@awesomenet.io,074110,ES50209546216055661299,7157.03,2022-02-15T15:19:30,Amurrio,expenses,gifts,-846.24,9589.92
buyer_3,Ana,Piñeiro,1989-08-23,43610689K,ana.piñeiro@awesomenet.io,074110,ES50209546216055661299,7157.03,2022-02-16T13:21:11,Amurrio,expenses,travel,-1083.62,8506.3
buyer_3,Ana,Piñeiro,1989-08-23,43610689K,ana.piñeiro@awesomenet.io,074110,ES50209546216055661299,7157.03,2022-02-17T08:48:07,Amurrio,expenses,leisure,-35.36,8470.94
buyer_3,Ana,Piñeiro,1989-08-23,43610689K,ana.piñeiro@awesomenet.io,074110,ES50209546216055661299,7157.03,2022-02-18T09:52:14,Amurrio,expenses,food,-123.89,8347.05
buyer_3,Ana,Piñeiro,1989-08-23,43610689K,ana.piñeiro@awesomenet.io,074110,ES50209546216055661299,7157.03,2022-02-21T13:32:34,Amurrio,expenses,education,-59.89,8287.16
buyer_3,Ana,Piñeiro,1989-08-23,43610689K,ana.piñeiro@awesomenet.io,074110,ES50209546216055661299,7157.03,2022-02-26T07:09:44,Amurrio,expenses,food,-79.86,8207.3
buyer_3,Ana,Piñeiro,1989-08-23,43610689K,ana.piñeiro@awesomenet.io,074110,ES50209546216055661299,7157.03,2022-02-28T21:18:38,Amurrio,expenses,cash,-100.0,8107.3
buyer_3,Ana,Piñeiro,1989-08-23,43610689K,ana.piñeiro@awesomenet.io,074110,ES50209546216055661299,7157.03,2022-03-01T15:32:49,Amurrio,incomes,salary,3312.4,11419.7
buyer_3,Ana,Piñeiro,1989-08-23,43610689K,ana.piñeiro@awesomenet.io,074110,ES50209546216055661299,7157.03,2022-03-01T15:32:49,Amurrio,incomes,salary_partner,3068.13,14487.83
buyer_3,Ana,Piñeiro,1989-08-23,43610689K,ana.piñeiro@awesomenet.io,074110,ES50209546216055661299,7157.03,2022-03-01T15:32:49,Amurrio,incomes,extra_income,346.04,14833.87
buyer_3,Ana,Piñeiro,1989-08-23,43610689K,ana.piñeiro@awesomenet.io,074110,ES50209546216055661299,7157.03,2022-03-02T11:38:43,Amurrio,expenses,cash,-100.0,14733.87
buyer_3,Ana,Piñeiro,1989-08-23,43610689K,ana.piñeiro@awesomenet.io,074110,ES50209546216055661299,7157.03,2022-03-02T12:06:06,Amurrio,expenses,gifts,-679.86,14054.01
buyer_3,Ana,Piñeiro,1989-08-23,43610689K,ana.piñeiro@awesomenet.io,074110,ES50209546216055661299,7157.03,2022-03-03T13:24:40,Amurrio,expenses,transport,-84.29,13969.72
buyer_3,Ana,Piñeiro,1989-08-23,43610689K,ana.piñeiro@awesomenet.io,074110,ES50209546216055661299,7157.03,2022-03-04T19:51:26,Amurrio,expenses,mortgage,-2389.79,11579.93
buyer_3,Ana,Piñeiro,1989-08-23,43610689K,ana.piñeiro@awesomenet.io,074110,ES50209546216055661299,7157.03,2022-03-05T13:59:16,Amurrio,expenses,water,-97.11,11482.82
buyer_3,Ana,Piñeiro,1989-08-23,43610689K,ana.piñeiro@awesomenet.io,074110,ES50209546216055661299,7157.03,2022-03-05T00:14:50,Amurrio,expenses,cash,-100.0,11382.82
buyer_3,Ana,Piñeiro,1989-08-23,43610689K,ana.piñeiro@awesomenet.io,074110,ES50209546216055661299,7157.03,2022-03-06T10:47:29,Amurrio,expenses,water,-93.12,11289.7
buyer_3,Ana,Piñeiro,1989-08-23,43610689K,ana.piñeiro@awesomenet.io,074110,ES50209546216055661299,7157.03,2022-03-07T19:47:36,Amurrio,expenses,internet,-133.99,11155.71
buyer_3,Ana,Piñeiro,1989-08-23,43610689K,ana.piñeiro@awesomenet.io,074110,ES50209546216055661299,7157.03,2022-03-07T09:08:17,Amurrio,expenses,clothing,-138.56,11017.15
buyer_3,Ana,Piñeiro,1989-08-23,43610689K,ana.piñeiro@awesomenet.io,074110,ES50209546216055661299,7157.03,2022-03-07T17:21:20,Amurrio,expenses,healthcare,-76.67,10940.48
buyer_3,Ana,Piñeiro,1989-08-23,43610689K,ana.piñeiro@awesomenet.io,074110,ES50209546216055661299,7157.03,2022-03-08T19:38:02,Amurrio,expenses,electricity,-124.19,10816.29
buyer_3,Ana,Piñeiro,1989-08-23,43610689K,ana.piñeiro@awesomenet.io,074110,ES50209546216055661299,7157.03,2022-03-08T11:53:04,Amurrio,expenses,gas,-235.08,10581.21
buyer_3,Ana,Piñeiro,1989-08-23,43610689K,ana.piñeiro@awesomenet.io,074110,ES50209546216055661299,7157.03,2022-03-08T09:48:22,Amurrio,expenses,internet,-133.99,10447.22
buyer_3,Ana,Piñeiro,1989-08-23,43610689K,ana.piñeiro@awesomenet.io,074110,ES50209546216055661299,7157.03,2022-03-09T12:37:49,Amurrio,expenses,travel,-1333.02,9114.2
buyer_3,Ana,Piñeiro,1989-08-23,43610689K,ana.piñeiro@awesomenet.io,074110,ES50209546216055661299,7157.03,2022-03-10T08:15:27,Amurrio,expenses,education,-78.04,9036.16
buyer_3,Ana,Piñeiro,1989-08-23,43610689K,ana.piñeiro@awesomenet.io,074110,ES50209546216055661299,7157.03,2022-03-10T20:53:04,Amurrio,expenses,repairs,-135.01,8901.15
buyer_3,Ana,Piñeiro,1989-08-23,43610689K,ana.piñeiro@awesomenet.io,074110,ES50209546216055661299,7157.03,2022-03-14T17:52:10,Amurrio,expenses,leisure,-84.73,8816.42
buyer_3,Ana,Piñeiro,1989-08-23,43610689K,ana.piñeiro@awesomenet.io,074110,ES50209546216055661299,7157.03,2022-03-14T10:05:53,Amurrio,expenses,cash,-100.0,8716.42
buyer_3,Ana,Piñeiro,1989-08-23,43610689K,ana.piñeiro@awesomenet.io,074110,ES50209546216055661299,7157.03,2022-03-15T18:24:51,Amurrio,expenses,food,-72.22,8644.2
buyer_3,Ana,Piñeiro,1989-08-23,43610689K,ana.piñeiro@awesomenet.io,074110,ES50209546216055661299,7157.03,2022-03-15T19:26:52,Amurrio,expenses,gifts,-388.72,8255.48
buyer_3,Ana,Piñeiro,1989-08-23,43610689K,ana.piñeiro@awesomenet.io,074110,ES50209546216055661299,7157.03,2022-03-16T19:12:09,Amurrio,expenses,clothing,-152.03,8103.45
buyer_3,Ana,Piñeiro,1989-08-23,43610689K,ana.piñeiro@awesomenet.io,074110,ES50209546216055661299,7157.03,2022-03-18T16:08:27,Amurrio,expenses,food,-79.44,8024.01
buyer_3,Ana,Piñeiro,1989-08-23,43610689K,ana.piñeiro@awesomenet.io,074110,ES50209546216055661299,7157.03,2022-03-19T19:38:51,Amurrio,expenses,transport,-50.85,7973.16
buyer_3,Ana,Piñeiro,1989-08-23,43610689K,ana.piñeiro@awesomenet.io,074110,ES50209546216055661299,7157.03,2022-03-23T16:16:32,Amurrio,expenses,food,-85.54,7887.62
buyer_3,Ana,Piñeiro,1989-08-23,43610689K,ana.piñeiro@awesomenet.io,074110,ES50209546216055661299,7157.03,2022-03-23T13:02:43,Amurrio,expenses,cash,-100.0,7787.62
buyer_3,Ana,Piñeiro,1989-08-23,43610689K,ana.piñeiro@awesomenet.io,074110,ES50209546216055661299,7157.03,2022-03-24T08:42:49,Amurrio,expenses,food,-116.62,7671.0
buyer_3,Ana,Piñeiro,1989-08-23,43610689K,ana.piñeiro@awesomenet.io,074110,ES50209546216055661299,7157.03,2022-03-24T20:02:49,Amurrio,expenses,cash,-100.0,7571.0
buyer_3,Ana,Piñeiro,1989-08-23,43610689K,ana.piñeiro@awesomenet.io,074110,ES50209546216055661299,7157.03,2022-03-25T20:29:43,Amurrio,expenses,leisure,-35.86,7535.14
buyer_3,Ana,Piñeiro,1989-08-23,43610689K,ana.piñeiro@awesomenet.io,074110,ES50209546216055661299,7157.03,2022-03-25T20:20:03,Amurrio,expenses,education,-68.74,7466.4
buyer_3,Ana,Piñeiro,1989-08-23,43610689K,ana.piñeiro@awesomenet.io,074110,ES50209546216055661299,7157.03,2022-03-26T18:05:25,Amurrio,expenses,cash,-100.0,7366.4
buyer_3,Ana,Piñeiro,1989-08-23,43610689K,ana.piñeiro@awesomenet.io,074110,ES50209546216055661299,7157.03,2022-03-26T09:10:01,Amurrio,expenses,gifts,-184.41,7181.99
buyer_3,Ana,Piñeiro,1989-08-23,43610689K,ana.piñeiro@awesomenet.io,074110,ES50209546216055661299,7157.03,2022-03-28T08:07:12,Amurrio,expenses,repairs,-146.24,7035.75
buyer_3,Ana,Piñeiro,1989-08-23,43610689K,ana.piñeiro@awesomenet.io,074110,ES50209546216055661299,7157.03,2022-03-30T15:58:21,Amurrio,expenses,food,-118.37,6917.38
buyer_3,Ana,Piñeiro,1989-08-23,43610689K,ana.piñeiro@awesomenet.io,074110,ES50209546216055661299,7157.03,2022-03-31T14:09:07,Amurrio,expenses,cash,-100.0,6817.38
buyer_3,Ana,Piñeiro,1989-08-23,43610689K,ana.piñeiro@awesomenet.io,074110,ES50209546216055661299,7157.03,2022-04-01T15:29:08,Amurrio,incomes,salary,3312.4,10129.78
buyer_3,Ana,Piñeiro,1989-08-23,43610689K,ana.piñeiro@awesomenet.io,074110,ES50209546216055661299,7157.03,2022-04-01T15:29:08,Amurrio,incomes,salary_partner,3068.13,13197.91
buyer_3,Ana,Piñeiro,1989-08-23,43610689K,ana.piñeiro@awesomenet.io,074110,ES50209546216055661299,7157.03,2022-04-01T22:28:52,Amurrio,expenses,food,-117.47,13080.44
buyer_3,Ana,Piñeiro,1989-08-23,43610689K,ana.piñeiro@awesomenet.io,074110,ES50209546216055661299,7157.03,2022-04-02T11:13:12,Amurrio,expenses,gifts,-64.97,13015.47
buyer_3,Ana,Piñeiro,1989-08-23,43610689K,ana.piñeiro@awesomenet.io,074110,ES50209546216055661299,7157.03,2022-04-03T16:29:35,Amurrio,expenses,leisure,-53.92,12961.55
buyer_3,Ana,Piñeiro,1989-08-23,43610689K,ana.piñeiro@awesomenet.io,074110,ES50209546216055661299,7157.03,2022-04-04T10:04:26,Amurrio,expenses,mortgage,-2389.79,10571.76
buyer_3,Ana,Piñeiro,1989-08-23,43610689K,ana.piñeiro@awesomenet.io,074110,ES50209546216055661299,7157.03,2022-04-04T16:42:34,Amurrio,expenses,leisure,-36.22,10535.54
buyer_3,Ana,Piñeiro,1989-08-23,43610689K,ana.piñeiro@awesomenet.io,074110,ES50209546216055661299,7157.03,2022-04-04T14:52:59,Amurrio,expenses,healthcare,-188.15,10347.39
buyer_3,Ana,Piñeiro,1989-08-23,43610689K,ana.piñeiro@awesomenet.io,074110,ES50209546216055661299,7157.03,2022-04-04T17:13:36,Amurrio,expenses,cash,-100.0,10247.39
buyer_3,Ana,Piñeiro,1989-08-23,43610689K,ana.piñeiro@awesomenet.io,074110,ES50209546216055661299,7157.03,2022-04-05T12:14:58,Amurrio,expenses,electricity,-271.29,9976.1
buyer_3,Ana,Piñeiro,1989-08-23,43610689K,ana.piñeiro@awesomenet.io,074110,ES50209546216055661299,7157.03,2022-04-05T03:43:47,Amurrio,expenses,gas,-350.11,9625.99
buyer_3,Ana,Piñeiro,1989-08-23,43610689K,ana.piñeiro@awesomenet.io,074110,ES50209546216055661299,7157.03,2022-04-05T10:58:53,Amurrio,expenses,internet,-133.99,9492.0
buyer_3,Ana,Piñeiro,1989-08-23,43610689K,ana.piñeiro@awesomenet.io,074110,ES50209546216055661299,7157.03,2022-04-05T09:33:03,Amurrio,expenses,education,-73.29,9418.71
buyer_3,Ana,Piñeiro,1989-08-23,43610689K,ana.piñeiro@awesomenet.io,074110,ES50209546216055661299,7157.03,2022-04-06T20:52:57,Amurrio,expenses,food,-117.67,9301.04
buyer_3,Ana,Piñeiro,1989-08-23,43610689K,ana.piñeiro@awesomenet.io,074110,ES50209546216055661299,7157.03,2022-04-06T14:46:44,Amurrio,expenses,healthcare,-180.44,9120.6
buyer_3,Ana,Piñeiro,1989-08-23,43610689K,ana.piñeiro@awesomenet.io,074110,ES50209546216055661299,7157.03,2022-04-07T11:16:47,Amurrio,expenses,gas,-140.42,8980.18
buyer_3,Ana,Piñeiro,1989-08-23,43610689K,ana.piñeiro@awesomenet.io,074110,ES50209546216055661299,7157.03,2022-04-08T11:32:19,Amurrio,expenses,cash,-100.0,8880.18
buyer_3,Ana,Piñeiro,1989-08-23,43610689K,ana.piñeiro@awesomenet.io,074110,ES50209546216055661299,7157.03,2022-04-09T20:23:05,Amurrio,expenses,appliances,-123.52,8756.66
buyer_3,Ana,Piñeiro,1989-08-23,43610689K,ana.piñeiro@awesomenet.io,074110,ES50209546216055661299,7157.03,2022-04-10T13:39:27,Amurrio,expenses,transport,-68.95,8687.71
buyer_3,Ana,Piñeiro,1989-08-23,43610689K,ana.piñeiro@awesomenet.io,074110,ES50209546216055661299,7157.03,2022-04-10T11:21:59,Amurrio,expenses,leisure,-38.6,8649.11
buyer_3,Ana,Piñeiro,1989-08-23,43610689K,ana.piñeiro@awesomenet.io,074110,ES50209546216055661299,7157.03,2022-04-10T12:34:06,Amurrio,expenses,cash,-100.0,8549.11
buyer_3,Ana,Piñeiro,1989-08-23,43610689K,ana.piñeiro@awesomenet.io,074110,ES50209546216055661299,7157.03,2022-04-10T15:27:56,Amurrio,expenses,repairs,-112.71,8436.4
buyer_3,Ana,Piñeiro,1989-08-23,43610689K,ana.piñeiro@awesomenet.io,074110,ES50209546216055661299,7157.03,2022-04-11T11:41:23,Amurrio,expenses,leisure,-51.34,8385.06
buyer_3,Ana,Piñeiro,1989-08-23,43610689K,ana.piñeiro@awesomenet.io,074110,ES50209546216055661299,7157.03,2022-04-12T08:27:13,Amurrio,expenses,transport,-58.41,8326.65
buyer_3,Ana,Piñeiro,1989-08-23,43610689K,ana.piñeiro@awesomenet.io,074110,ES50209546216055661299,7157.03,2022-04-13T11:53:45,Amurrio,expenses,transport,-83.07,8243.58
buyer_3,Ana,Piñeiro,1989-08-23,43610689K,ana.piñeiro@awesomenet.io,074110,ES50209546216055661299,7157.03,2022-04-13T17:12:55,Amurrio,expenses,cash,-100.0,8143.58
buyer_3,Ana,Piñeiro,1989-08-23,43610689K,ana.piñeiro@awesomenet.io,074110,ES50209546216055661299,7157.03,2022-04-13T22:15:11,Amurrio,expenses,repairs,-155.78,7987.8
buyer_3,Ana,Piñeiro,1989-08-23,43610689K,ana.piñeiro@awesomenet.io,074110,ES50209546216055661299,7157.03,2022-04-14T19:23:46,Amurrio,expenses,transport,-86.95,7900.85
buyer_3,Ana,Piñeiro,1989-08-23,43610689K,ana.piñeiro@awesomenet.io,074110,ES50209546216055661299,7157.03,2022-04-14T10:38:28,Amurrio,expenses,clothing,-80.33,7820.52
buyer_3,Ana,Piñeiro,1989-08-23,43610689K,ana.piñeiro@awesomenet.io,074110,ES50209546216055661299,7157.03,2022-04-16T11:12:21,Amurrio,expenses,education,-75.86,7744.66
buyer_3,Ana,Piñeiro,1989-08-23,43610689K,ana.piñeiro@awesomenet.io,074110,ES50209546216055661299,7157.03,2022-04-16T19:07:59,Amurrio,expenses,cash,-100.0,7644.66
buyer_3,Ana,Piñeiro,1989-08-23,43610689K,ana.piñeiro@awesomenet.io,074110,ES50209546216055661299,7157.03,2022-04-17T20:38:39,Amurrio,expenses,cash,-100.0,7544.66
buyer_3,Ana,Piñeiro,1989-08-23,43610689K,ana.piñeiro@awesomenet.io,074110,ES50209546216055661299,7157.03,2022-04-18T18:13:32,Amurrio,expenses,repairs,-99.21,7445.45
buyer_3,Ana,Piñeiro,1989-08-23,43610689K,ana.piñeiro@awesomenet.io,074110,ES50209546216055661299,7157.03,2022-04-20T16:21:44,Amurrio,expenses,cash,-100.0,7345.45
buyer_3,Ana,Piñeiro,1989-08-23,43610689K,ana.piñeiro@awesomenet.io,074110,ES50209546216055661299,7157.03,2022-04-21T16:14:55,Amurrio,expenses,appliances,-135.65,7209.8
buyer_3,Ana,Piñeiro,1989-08-23,43610689K,ana.piñeiro@awesomenet.io,074110,ES50209546216055661299,7157.03,2022-04-22T18:54:33,Amurrio,expenses,food,-74.64,7135.16
buyer_3,Ana,Piñeiro,1989-08-23,43610689K,ana.piñeiro@awesomenet.io,074110,ES50209546216055661299,7157.03,2022-04-22T07:26:03,Amurrio,expenses,transport,-62.44,7072.72
buyer_3,Ana,Piñeiro,1989-08-23,43610689K,ana.piñeiro@awesomenet.io,074110,ES50209546216055661299,7157.03,2022-04-22T19:49:44,Amurrio,expenses,cash,-100.0,6972.72
buyer_3,Ana,Piñeiro,1989-08-23,43610689K,ana.piñeiro@awesomenet.io,074110,ES50209546216055661299,7157.03,2022-04-24T07:24:22,Amurrio,expenses,leisure,-49.52,6923.2
buyer_3,Ana,Piñeiro,1989-08-23,43610689K,ana.piñeiro@awesomenet.io,074110,ES50209546216055661299,7157.03,2022-04-25T13:26:19,Amurrio,expenses,transport,-62.11,6861.09
buyer_3,Ana,Piñeiro,1989-08-23,43610689K,ana.piñeiro@awesomenet.io,074110,ES50209546216055661299,7157.03,2022-04-27T14:54:09,Amurrio,expenses,leisure,-49.44,6811.65
buyer_3,Ana,Piñeiro,1989-08-23,43610689K,ana.piñeiro@awesomenet.io,074110,ES50209546216055661299,7157.03,2022-04-29T17:37:42,Amurrio,expenses,leisure,-81.58,6730.07
buyer_3,Ana,Piñeiro,1989-08-23,43610689K,ana.piñeiro@awesomenet.io,074110,ES50209546216055661299,7157.03,2022-04-30T18:13:43,Amurrio,expenses,cash,-100.0,6630.07
buyer_3,Ana,Piñeiro,1989-08-23,43610689K,ana.piñeiro@awesomenet.io,074110,ES50209546216055661299,7157.03,2022-05-01T12:44:15,Amurrio,incomes,salary,3312.4,9942.47
buyer_3,Ana,Piñeiro,1989-08-23,43610689K,ana.piñeiro@awesomenet.io,074110,ES50209546216055661299,7157.03,2022-05-01T12:44:15,Amurrio,incomes,salary_partner,3068.13,13010.6
buyer_3,Ana,Piñeiro,1989-08-23,43610689K,ana.piñeiro@awesomenet.io,074110,ES50209546216055661299,7157.03,2022-05-01T11:24:59,Amurrio,expenses,leisure,-42.2,12968.4
buyer_3,Ana,Piñeiro,1989-08-23,43610689K,ana.piñeiro@awesomenet.io,074110,ES50209546216055661299,7157.03,2022-05-02T08:52:55,Amurrio,expenses,gifts,-81.04,12887.36
buyer_3,Ana,Piñeiro,1989-08-23,43610689K,ana.piñeiro@awesomenet.io,074110,ES50209546216055661299,7157.03,2022-05-04T15:42:39,Amurrio,expenses,mortgage,-2389.79,10497.57
buyer_3,Ana,Piñeiro,1989-08-23,43610689K,ana.piñeiro@awesomenet.io,074110,ES50209546216055661299,7157.03,2022-05-05T16:36:18,Amurrio,expenses,water,-81.15,10416.42
buyer_3,Ana,Piñeiro,1989-08-23,43610689K,ana.piñeiro@awesomenet.io,074110,ES50209546216055661299,7157.03,2022-05-05T16:32:44,Amurrio,expenses,gas,-127.96,10288.46
buyer_3,Ana,Piñeiro,1989-08-23,43610689K,ana.piñeiro@awesomenet.io,074110,ES50209546216055661299,7157.03,2022-05-05T12:29:51,Amurrio,expenses,cash,-100.0,10188.46
buyer_3,Ana,Piñeiro,1989-08-23,43610689K,ana.piñeiro@awesomenet.io,074110,ES50209546216055661299,7157.03,2022-05-06T16:13:51,Amurrio,expenses,water,-84.1,10104.36
buyer_3,Ana,Piñeiro,1989-08-23,43610689K,ana.piñeiro@awesomenet.io,074110,ES50209546216055661299,7157.03,2022-05-06T08:11:33,Amurrio,expenses,food,-103.19,10001.17
buyer_3,Ana,Piñeiro,1989-08-23,43610689K,ana.piñeiro@awesomenet.io,074110,ES50209546216055661299,7157.03,2022-05-06T09:13:26,Amurrio,expenses,transport,-72.9,9928.27
buyer_3,Ana,Piñeiro,1989-08-23,43610689K,ana.piñeiro@awesomenet.io,074110,ES50209546216055661299,7157.03,2022-05-06T11:04:48,Amurrio,expenses,repairs,-42.39,9885.88
buyer_3,Ana,Piñeiro,1989-08-23,43610689K,ana.piñeiro@awesomenet.io,074110,ES50209546216055661299,7157.03,2022-05-07T12:48:46,Amurrio,expenses,transport,-48.26,9837.62
buyer_3,Ana,Piñeiro,1989-08-23,43610689K,ana.piñeiro@awesomenet.io,074110,ES50209546216055661299,7157.03,2022-05-07T17:56:06,Amurrio,expenses,leisure,-52.85,9784.77
buyer_3,Ana,Piñeiro,1989-08-23,43610689K,ana.piñeiro@awesomenet.io,074110,ES50209546216055661299,7157.03,2022-05-08T10:09:04,Amurrio,expenses,electricity,-74.92,9709.85
buyer_3,Ana,Piñeiro,1989-08-23,43610689K,ana.piñeiro@awesomenet.io,074110,ES50209546216055661299,7157.03,2022-05-08T14:11:20,Amurrio,expenses,cash,-100.0,9609.85
buyer_3,Ana,Piñeiro,1989-08-23,43610689K,ana.piñeiro@awesomenet.io,074110,ES50209546216055661299,7157.03,2022-05-10T22:57:39,Amurrio,expenses,food,-118.77,9491.08
buyer_3,Ana,Piñeiro,1989-08-23,43610689K,ana.piñeiro@awesomenet.io,074110,ES50209546216055661299,7157.03,2022-05-10T09:12:28,Amurrio,expenses,leisure,-35.35,9455.73
buyer_3,Ana,Piñeiro,1989-08-23,43610689K,ana.piñeiro@awesomenet.io,074110,ES50209546216055661299,7157.03,2022-05-10T09:30:38,Amurrio,expenses,education,-64.2,9391.53
buyer_3,Ana,Piñeiro,1989-08-23,43610689K,ana.piñeiro@awesomenet.io,074110,ES50209546216055661299,7157.03,2022-05-10T18:32:15,Amurrio,expenses,appliances,-140.13,9251.4
buyer_3,Ana,Piñeiro,1989-08-23,43610689K,ana.piñeiro@awesomenet.io,074110,ES50209546216055661299,7157.03,2022-05-11T14:04:57,Amurrio,expenses,leisure,-79.77,9171.63
buyer_3,Ana,Piñeiro,1989-08-23,43610689K,ana.piñeiro@awesomenet.io,074110,ES50209546216055661299,7157.03,2022-05-11T17:09:16,Amurrio,expenses,cash,-100.0,9071.63
buyer_3,Ana,Piñeiro,1989-08-23,43610689K,ana.piñeiro@awesomenet.io,074110,ES50209546216055661299,7157.03,2022-05-12T18:20:55,Amurrio,expenses,cash,-100.0,8971.63
buyer_3,Ana,Piñeiro,1989-08-23,43610689K,ana.piñeiro@awesomenet.io,074110,ES50209546216055661299,7157.03,2022-05-14T23:52:06,Amurrio,expenses,food,-77.86,8893.77
buyer_3,Ana,Piñeiro,1989-08-23,43610689K,ana.piñeiro@awesomenet.io,074110,ES50209546216055661299,7157.03,2022-05-14T15:14:28,Amurrio,expenses,leisure,-23.94,8869.83
buyer_3,Ana,Piñeiro,1989-08-23,43610689K,ana.piñeiro@awesomenet.io,074110,ES50209546216055661299,7157.03,2022-05-14T11:19:01,Amurrio,expenses,cash,-100.0,8769.83
buyer_3,Ana,Piñeiro,1989-08-23,43610689K,ana.piñeiro@awesomenet.io,074110,ES50209546216055661299,7157.03,2022-05-15T13:41:36,Amurrio,expenses,transport,-71.11,8698.72
buyer_3,Ana,Piñeiro,1989-08-23,43610689K,ana.piñeiro@awesomenet.io,074110,ES50209546216055661299,7157.03,2022-05-16T20:27:27,Amurrio,expenses,leisure,-57.99,8640.73
buyer_3,Ana,Piñeiro,1989-08-23,43610689K,ana.piñeiro@awesomenet.io,074110,ES50209546216055661299,7157.03,2022-05-17T11:32:19,Amurrio,expenses,leisure,-29.88,8610.85
buyer_3,Ana,Piñeiro,1989-08-23,43610689K,ana.piñeiro@awesomenet.io,074110,ES50209546216055661299,7157.03,2022-05-20T10:01:06,Amurrio,expenses,cash,-100.0,8510.85
buyer_3,Ana,Piñeiro,1989-08-23,43610689K,ana.piñeiro@awesomenet.io,074110,ES50209546216055661299,7157.03,2022-05-22T06:51:35,Amurrio,expenses,gifts,-826.95,7683.9
buyer_3,Ana,Piñeiro,1989-08-23,43610689K,ana.piñeiro@awesomenet.io,074110,ES50209546216055661299,7157.03,2022-05-23T15:55:25,Amurrio,expenses,repairs,-213.54,7470.36
buyer_3,Ana,Piñeiro,1989-08-23,43610689K,ana.piñeiro@awesomenet.io,074110,ES50209546216055661299,7157.03,2022-05-23T08:50:17,Amurrio,expenses,gifts,-242.59,7227.77
buyer_3,Ana,Piñeiro,1989-08-23,43610689K,ana.piñeiro@awesomenet.io,074110,ES50209546216055661299,7157.03,2022-05-24T13:17:01,Amurrio,expenses,cash,-100.0,7127.77
buyer_3,Ana,Piñeiro,1989-08-23,43610689K,ana.piñeiro@awesomenet.io,074110,ES50209546216055661299,7157.03,2022-05-25T18:54:56,Amurrio,expenses,food,-69.29,7058.48
buyer_3,Ana,Piñeiro,1989-08-23,43610689K,ana.piñeiro@awesomenet.io,074110,ES50209546216055661299,7157.03,2022-05-26T19:51:29,Amurrio,expenses,food,-67.75,6990.73
buyer_3,Ana,Piñeiro,1989-08-23,43610689K,ana.piñeiro@awesomenet.io,074110,ES50209546216055661299,7157.03,2022-05-27T15:41:16,Amurrio,expenses,food,-98.2,6892.53
buyer_3,Ana,Piñeiro,1989-08-23,43610689K,ana.piñeiro@awesomenet.io,074110,ES50209546216055661299,7157.03,2022-05-27T19:12:42,Amurrio,expenses,cash,-100.0,6792.53
buyer_3,Ana,Piñeiro,1989-08-23,43610689K,ana.piñeiro@awesomenet.io,074110,ES50209546216055661299,7157.03,2022-05-29T13:26:53,Amurrio,expenses,transport,-72.89,6719.64
buyer_3,Ana,Piñeiro,1989-08-23,43610689K,ana.piñeiro@awesomenet.io,074110,ES50209546216055661299,7157.03,2022-05-29T10:07:53,Amurrio,expenses,leisure,-73.3,6646.34
buyer_3,Ana,Piñeiro,1989-08-23,43610689K,ana.piñeiro@awesomenet.io,074110,ES50209546216055661299,7157.03,2022-05-30T17:06:39,Amurrio,expenses,clothing,-134.19,6512.15
buyer_3,Ana,Piñeiro,1989-08-23,43610689K,ana.piñeiro@awesomenet.io,074110,ES50209546216055661299,7157.03,2022-05-31T20:40:17,Amurrio,expenses,leisure,-30.43,6481.72
buyer_3,Ana,Piñeiro,1989-08-23,43610689K,ana.piñeiro@awesomenet.io,074110,ES50209546216055661299,7157.03,2022-06-01T12:00:28,Amurrio,incomes,salary,3312.4,9794.12
buyer_3,Ana,Piñeiro,1989-08-23,43610689K,ana.piñeiro@awesomenet.io,074110,ES50209546216055661299,7157.03,2022-06-01T12:00:28,Amurrio,incomes,salary_partner,3068.13,12862.25
buyer_3,Ana,Piñeiro,1989-08-23,43610689K,ana.piñeiro@awesomenet.io,074110,ES50209546216055661299,7157.03,2022-06-01T12:00:28,Amurrio,incomes,salary_bonus,2587.93,15450.18
buyer_3,Ana,Piñeiro,1989-08-23,43610689K,ana.piñeiro@awesomenet.io,074110,ES50209546216055661299,7157.03,2022-06-01T12:00:28,Amurrio,incomes,salary_partner_bonus,2437.18,17887.36
buyer_3,Ana,Piñeiro,1989-08-23,43610689K,ana.piñeiro@awesomenet.io,074110,ES50209546216055661299,7157.03,2022-06-01T14:41:29,Amurrio,expenses,taxes,-4781.76,13105.6
buyer_3,Ana,Piñeiro,1989-08-23,43610689K,ana.piñeiro@awesomenet.io,074110,ES50209546216055661299,7157.03,2022-06-01T08:04:00,Amurrio,expenses,insurance,-1398.01,11707.59
buyer_3,Ana,Piñeiro,1989-08-23,43610689K,ana.piñeiro@awesomenet.io,074110,ES50209546216055661299,7157.03,2022-06-04T10:58:29,Amurrio,expenses,mortgage,-2389.79,9317.8
buyer_3,Ana,Piñeiro,1989-08-23,43610689K,ana.piñeiro@awesomenet.io,074110,ES50209546216055661299,7157.03,2022-06-04T10:54:24,Amurrio,expenses,gifts,-704.74,8613.06
buyer_3,Ana,Piñeiro,1989-08-23,43610689K,ana.piñeiro@awesomenet.io,074110,ES50209546216055661299,7157.03,2022-06-05T11:07:43,Amurrio,expenses,gas,-226.84,8386.22
buyer_3,Ana,Piñeiro,1989-08-23,43610689K,ana.piñeiro@awesomenet.io,074110,ES50209546216055661299,7157.03,2022-06-06T15:59:24,Amurrio,expenses,clothing,-73.23,8312.99
buyer_3,Ana,Piñeiro,1989-08-23,43610689K,ana.piñeiro@awesomenet.io,074110,ES50209546216055661299,7157.03,2022-06-06T18:09:11,Amurrio,expenses,cash,-100.0,8212.99
buyer_3,Ana,Piñeiro,1989-08-23,43610689K,ana.piñeiro@awesomenet.io,074110,ES50209546216055661299,7157.03,2022-06-08T12:26:03,Amurrio,expenses,phone,-106.35,8106.64
buyer_3,Ana,Piñeiro,1989-08-23,43610689K,ana.piñeiro@awesomenet.io,074110,ES50209546216055661299,7157.03,2022-06-09T12:57:06,Amurrio,expenses,education,-51.96,8054.68
buyer_3,Ana,Piñeiro,1989-08-23,43610689K,ana.piñeiro@awesomenet.io,074110,ES50209546216055661299,7157.03,2022-06-10T13:44:36,Amurrio,expenses,food,-124.15,7930.53
buyer_3,Ana,Piñeiro,1989-08-23,43610689K,ana.piñeiro@awesomenet.io,074110,ES50209546216055661299,7157.03,2022-06-11T19:46:03,Amurrio,expenses,leisure,-35.05,7895.48
buyer_3,Ana,Piñeiro,1989-08-23,43610689K,ana.piñeiro@awesomenet.io,074110,ES50209546216055661299,7157.03,2022-06-13T19:59:37,Amurrio,expenses,cash,-100.0,7795.48
buyer_3,Ana,Piñeiro,1989-08-23,43610689K,ana.piñeiro@awesomenet.io,074110,ES50209546216055661299,7157.03,2022-06-13T20:54:35,Amurrio,expenses,travel,-285.72,7509.76
buyer_3,Ana,Piñeiro,1989-08-23,43610689K,ana.piñeiro@awesomenet.io,074110,ES50209546216055661299,7157.03,2022-06-14T20:46:42,Amurrio,expenses,cash,-100.0,7409.76
buyer_3,Ana,Piñeiro,1989-08-23,43610689K,ana.piñeiro@awesomenet.io,074110,ES50209546216055661299,7157.03,2022-06-15T20:59:51,Amurrio,expenses,leisure,-71.25,7338.51
buyer_3,Ana,Piñeiro,1989-08-23,43610689K,ana.piñeiro@awesomenet.io,074110,ES50209546216055661299,7157.03,2022-06-18T09:00:50,Amurrio,expenses,leisure,-36.71,7301.8
buyer_3,Ana,Piñeiro,1989-08-23,43610689K,ana.piñeiro@awesomenet.io,074110,ES50209546216055661299,7157.03,2022-06-18T18:51:46,Amurrio,expenses,clothing,-45.41,7256.39
buyer_3,Ana,Piñeiro,1989-08-23,43610689K,ana.piñeiro@awesomenet.io,074110,ES50209546216055661299,7157.03,2022-06-18T03:47:37,Amurrio,expenses,appliances,-361.58,6894.81
buyer_3,Ana,Piñeiro,1989-08-23,43610689K,ana.piñeiro@awesomenet.io,074110,ES50209546216055661299,7157.03,2022-06-19T11:23:04,Amurrio,expenses,leisure,-83.27,6811.54
buyer_3,Ana,Piñeiro,1989-08-23,43610689K,ana.piñeiro@awesomenet.io,074110,ES50209546216055661299,7157.03,2022-06-19T11:08:26,Amurrio,expenses,cash,-100.0,6711.54
buyer_3,Ana,Piñeiro,1989-08-23,43610689K,ana.piñeiro@awesomenet.io,074110,ES50209546216055661299,7157.03,2022-06-20T20:12:06,Amurrio,expenses,cash,-100.0,6611.54
buyer_3,Ana,Piñeiro,1989-08-23,43610689K,ana.piñeiro@awesomenet.io,074110,ES50209546216055661299,7157.03,2022-06-20T23:15:05,Amurrio,expenses,gifts,-657.11,5954.43
buyer_3,Ana,Piñeiro,1989-08-23,43610689K,ana.piñeiro@awesomenet.io,074110,ES50209546216055661299,7157.03,2022-06-21T13:51:40,Amurrio,expenses,cash,-100.0,5854.43
buyer_3,Ana,Piñeiro,1989-08-23,43610689K,ana.piñeiro@awesomenet.io,074110,ES50209546216055661299,7157.03,2022-06-24T11:58:06,Amurrio,expenses,food,-70.65,5783.78
buyer_3,Ana,Piñeiro,1989-08-23,43610689K,ana.piñeiro@awesomenet.io,074110,ES50209546216055661299,7157.03,2022-06-27T23:18:15,Amurrio,expenses,food,-90.22,5693.56
buyer_3,Ana,Piñeiro,1989-08-23,43610689K,ana.piñeiro@awesomenet.io,074110,ES50209546216055661299,7157.03,2022-06-28T06:45:05,Amurrio,expenses,education,-63.15,5630.41
buyer_3,Ana,Piñeiro,1989-08-23,43610689K,ana.piñeiro@awesomenet.io,074110,ES50209546216055661299,7157.03,2022-06-29T07:37:17,Amurrio,expenses,repairs,-247.7,5382.71
buyer_3,Ana,Piñeiro,1989-08-23,43610689K,ana.piñeiro@awesomenet.io,074110,ES50209546216055661299,7157.03,2022-06-30T08:20:39,Amurrio,expenses,leisure,-47.98,5334.73
buyer_3,Ana,Piñeiro,1989-08-23,43610689K,ana.piñeiro@awesomenet.io,074110,ES50209546216055661299,7157.03,2022-06-30T16:29:59,Amurrio,expenses,gifts,-227.47,5107.26
buyer_3,Ana,Piñeiro,1989-08-23,43610689K,ana.piñeiro@awesomenet.io,074110,ES50209546216055661299,7157.03,2022-07-01T12:58:18,Amurrio,incomes,salary,3312.4,8419.66
buyer_3,Ana,Piñeiro,1989-08-23,43610689K,ana.piñeiro@awesomenet.io,074110,ES50209546216055661299,7157.03,2022-07-01T12:58:18,Amurrio,incomes,salary_partner,3068.13,11487.79
buyer_3,Ana,Piñeiro,1989-08-23,43610689K,ana.piñeiro@awesomenet.io,074110,ES50209546216055661299,7157.03,2022-07-01T12:58:18,Amurrio,incomes,extra_income,346.04,11833.83
buyer_3,Ana,Piñeiro,1989-08-23,43610689K,ana.piñeiro@awesomenet.io,074110,ES50209546216055661299,7157.03,2022-07-01T16:57:59,Amurrio,expenses,leisure,-18.48,11815.35
buyer_3,Ana,Piñeiro,1989-08-23,43610689K,ana.piñeiro@awesomenet.io,074110,ES50209546216055661299,7157.03,2022-07-04T15:31:24,Amurrio,expenses,mortgage,-2389.79,9425.56
buyer_3,Ana,Piñeiro,1989-08-23,43610689K,ana.piñeiro@awesomenet.io,074110,ES50209546216055661299,7157.03,2022-07-04T13:29:36,Amurrio,expenses,cash,-100.0,9325.56
buyer_3,Ana,Piñeiro,1989-08-23,43610689K,ana.piñeiro@awesomenet.io,074110,ES50209546216055661299,7157.03,2022-07-05T10:37:41,Amurrio,expenses,water,-126.86,9198.7
buyer_3,Ana,Piñeiro,1989-08-23,43610689K,ana.piñeiro@awesomenet.io,074110,ES50209546216055661299,7157.03,2022-07-06T23:31:24,Amurrio,expenses,phone,-133.17,9065.53
buyer_3,Ana,Piñeiro,1989-08-23,43610689K,ana.piñeiro@awesomenet.io,074110,ES50209546216055661299,7157.03,2022-07-06T06:07:23,Amurrio,expenses,cash,-100.0,8965.53
buyer_3,Ana,Piñeiro,1989-08-23,43610689K,ana.piñeiro@awesomenet.io,074110,ES50209546216055661299,7157.03,2022-07-07T16:51:29,Amurrio,expenses,phone,-137.25,8828.28
buyer_3,Ana,Piñeiro,1989-08-23,43610689K,ana.piñeiro@awesomenet.io,074110,ES50209546216055661299,7157.03,2022-07-07T16:01:13,Amurrio,expenses,clothing,-154.39,8673.89
buyer_3,Ana,Piñeiro,1989-08-23,43610689K,ana.piñeiro@awesomenet.io,074110,ES50209546216055661299,7157.03,2022-07-08T09:12:24,Amurrio,expenses,leisure,-52.83,8621.06
buyer_3,Ana,Piñeiro,1989-08-23,43610689K,ana.piñeiro@awesomenet.io,074110,ES50209546216055661299,7157.03,2022-07-08T10:27:34,Amurrio,expenses,cash,-100.0,8521.06
buyer_3,Ana,Piñeiro,1989-08-23,43610689K,ana.piñeiro@awesomenet.io,074110,ES50209546216055661299,7157.03,2022-07-10T22:59:29,Amurrio,expenses,repairs,-38.26,8482.8
buyer_3,Ana,Piñeiro,1989-08-23,43610689K,ana.piñeiro@awesomenet.io,074110,ES50209546216055661299,7157.03,2022-07-11T10:58:43,Amurrio,expenses,cash,-100.0,8382.8
buyer_3,Ana,Piñeiro,1989-08-23,43610689K,ana.piñeiro@awesomenet.io,074110,ES50209546216055661299,7157.03,2022-07-13T10:15:09,Amurrio,expenses,leisure,-31.29,8351.51
buyer_3,Ana,Piñeiro,1989-08-23,43610689K,ana.piñeiro@awesomenet.io,074110,ES50209546216055661299,7157.03,2022-07-14T21:31:55,Amurrio,expenses,transport,-41.42,8310.09
buyer_3,Ana,Piñeiro,1989-08-23,43610689K,ana.piñeiro@awesomenet.io,074110,ES50209546216055661299,7157.03,2022-07-14T08:24:40,Amurrio,expenses,gifts,-500.48,7809.61
buyer_3,Ana,Piñeiro,1989-08-23,43610689K,ana.piñeiro@awesomenet.io,074110,ES50209546216055661299,7157.03,2022-07-15T16:09:04,Amurrio,expenses,transport,-71.48,7738.13
buyer_3,Ana,Piñeiro,1989-08-23,43610689K,ana.piñeiro@awesomenet.io,074110,ES50209546216055661299,7157.03,2022-07-15T19:17:05,Amurrio,expenses,gifts,-588.31,7149.82
buyer_3,Ana,Piñeiro,1989-08-23,43610689K,ana.piñeiro@awesomenet.io,074110,ES50209546216055661299,7157.03,2022-07-18T08:35:12,Amurrio,expenses,education,-51.28,7098.54
buyer_3,Ana,Piñeiro,1989-08-23,43610689K,ana.piñeiro@awesomenet.io,074110,ES50209546216055661299,7157.03,2022-07-19T11:45:34,Amurrio,expenses,leisure,-40.26,7058.28
buyer_3,Ana,Piñeiro,1989-08-23,43610689K,ana.piñeiro@awesomenet.io,074110,ES50209546216055661299,7157.03,2022-07-21T19:16:16,Amurrio,expenses,clothing,-66.02,6992.26
buyer_3,Ana,Piñeiro,1989-08-23,43610689K,ana.piñeiro@awesomenet.io,074110,ES50209546216055661299,7157.03,2022-07-23T09:56:50,Amurrio,expenses,gifts,-600.28,6391.98
buyer_3,Ana,Piñeiro,1989-08-23,43610689K,ana.piñeiro@awesomenet.io,074110,ES50209546216055661299,7157.03,2022-07-25T19:11:41,Amurrio,expenses,transport,-78.45,6313.53
buyer_3,Ana,Piñeiro,1989-08-23,43610689K,ana.piñeiro@awesomenet.io,074110,ES50209546216055661299,7157.03,2022-07-26T08:00:40,Amurrio,expenses,cash,-100.0,6213.53
buyer_3,Ana,Piñeiro,1989-08-23,43610689K,ana.piñeiro@awesomenet.io,074110,ES50209546216055661299,7157.03,2022-07-30T16:29:07,Amurrio,expenses,leisure,-74.56,6138.97
buyer_3,Ana,Piñeiro,1989-08-23,43610689K,ana.piñeiro@awesomenet.io,074110,ES50209546216055661299,7157.03,2022-07-30T09:41:47,Amurrio,expenses,cash,-100.0,6038.97
buyer_3,Ana,Piñeiro,1989-08-23,43610689K,ana.piñeiro@awesomenet.io,074110,ES50209546216055661299,7157.03,2022-07-31T17:41:11,Amurrio,expenses,repairs,-218.14,5820.83
buyer_3,Ana,Piñeiro,1989-08-23,43610689K,ana.piñeiro@awesomenet.io,074110,ES50209546216055661299,7157.03,2022-08-01T20:16:22,Amurrio,incomes,salary,3312.4,9133.23
buyer_3,Ana,Piñeiro,1989-08-23,43610689K,ana.piñeiro@awesomenet.io,074110,ES50209546216055661299,7157.03,2022-08-01T20:16:22,Amurrio,incomes,salary_partner,3068.13,12201.36
buyer_3,Ana,Piñeiro,1989-08-23,43610689K,ana.piñeiro@awesomenet.io,074110,ES50209546216055661299,7157.03,2022-08-01T18:15:17,Amurrio,expenses,transport,-84.21,12117.15
buyer_3,Ana,Piñeiro,1989-08-23,43610689K,ana.piñeiro@awesomenet.io,074110,ES50209546216055661299,7157.03,2022-08-03T08:59:25,Amurrio,expenses,transport,-80.07,12037.08
buyer_3,Ana,Piñeiro,1989-08-23,43610689K,ana.piñeiro@awesomenet.io,074110,ES50209546216055661299,7157.03,2022-08-04T17:21:53,Amurrio,expenses,mortgage,-2389.79,9647.29
buyer_3,Ana,Piñeiro,1989-08-23,43610689K,ana.piñeiro@awesomenet.io,074110,ES50209546216055661299,7157.03,2022-08-04T19:47:21,Amurrio,expenses,leisure,-56.53,9590.76
buyer_3,Ana,Piñeiro,1989-08-23,43610689K,ana.piñeiro@awesomenet.io,074110,ES50209546216055661299,7157.03,2022-08-05T13:18:05,Amurrio,expenses,food,-99.57,9491.19
buyer_3,Ana,Piñeiro,1989-08-23,43610689K,ana.piñeiro@awesomenet.io,074110,ES50209546216055661299,7157.03,2022-08-06T08:59:43,Amurrio,expenses,transport,-41.61,9449.58
buyer_3,Ana,Piñeiro,1989-08-23,43610689K,ana.piñeiro@awesomenet.io,074110,ES50209546216055661299,7157.03,2022-08-06T10:28:26,Amurrio,expenses,leisure,-30.71,9418.87
buyer_3,Ana,Piñeiro,1989-08-23,43610689K,ana.piñeiro@awesomenet.io,074110,ES50209546216055661299,7157.03,2022-08-06T07:59:34,Amurrio,expenses,clothing,-111.42,9307.45
buyer_3,Ana,Piñeiro,1989-08-23,43610689K,ana.piñeiro@awesomenet.io,074110,ES50209546216055661299,7157.03,2022-08-07T08:33:22,Amurrio,expenses,water,-123.22,9184.23
buyer_3,Ana,Piñeiro,1989-08-23,43610689K,ana.piñeiro@awesomenet.io,074110,ES50209546216055661299,7157.03,2022-08-07T08:18:38,Amurrio,expenses,internet,-133.99,9050.24
buyer_3,Ana,Piñeiro,1989-08-23,43610689K,ana.piñeiro@awesomenet.io,074110,ES50209546216055661299,7157.03,2022-08-07T11:09:18,Amurrio,expenses,food,-71.93,8978.31
buyer_3,Ana,Piñeiro,1989-08-23,43610689K,ana.piñeiro@awesomenet.io,074110,ES50209546216055661299,7157.03,2022-08-07T13:51:25,Amurrio,expenses,cash,-100.0,8878.31
buyer_3,Ana,Piñeiro,1989-08-23,43610689K,ana.piñeiro@awesomenet.io,074110,ES50209546216055661299,7157.03,2022-08-08T06:43:29,Amurrio,expenses,phone,-115.46,8762.85
buyer_3,Ana,Piñeiro,1989-08-23,43610689K,ana.piñeiro@awesomenet.io,074110,ES50209546216055661299,7157.03,2022-08-08T10:33:18,Amurrio,expenses,leisure,-29.26,8733.59
buyer_3,Ana,Piñeiro,1989-08-23,43610689K,ana.piñeiro@awesomenet.io,074110,ES50209546216055661299,7157.03,2022-08-08T14:02:36,Amurrio,expenses,gifts,-314.01,8419.58
buyer_3,Ana,Piñeiro,1989-08-23,43610689K,ana.piñeiro@awesomenet.io,074110,ES50209546216055661299,7157.03,2022-08-10T18:45:26,Amurrio,expenses,cash,-100.0,8319.58
buyer_3,Ana,Piñeiro,1989-08-23,43610689K,ana.piñeiro@awesomenet.io,074110,ES50209546216055661299,7157.03,2022-08-10T04:05:26,Amurrio,expenses,repairs,-254.08,8065.5
buyer_3,Ana,Piñeiro,1989-08-23,43610689K,ana.piñeiro@awesomenet.io,074110,ES50209546216055661299,7157.03,2022-08-11T14:30:21,Amurrio,expenses,food,-75.71,7989.79
buyer_3,Ana,Piñeiro,1989-08-23,43610689K,ana.piñeiro@awesomenet.io,074110,ES50209546216055661299,7157.03,2022-08-11T20:46:44,Amurrio,expenses,leisure,-80.62,7909.17
buyer_3,Ana,Piñeiro,1989-08-23,43610689K,ana.piñeiro@awesomenet.io,074110,ES50209546216055661299,7157.03,2022-08-12T14:43:05,Amurrio,expenses,transport,-67.79,7841.38
buyer_3,Ana,Piñeiro,1989-08-23,43610689K,ana.piñeiro@awesomenet.io,074110,ES50209546216055661299,7157.03,2022-08-16T15:34:45,Amurrio,expenses,leisure,-20.75,7820.63
buyer_3,Ana,Piñeiro,1989-08-23,43610689K,ana.piñeiro@awesomenet.io,074110,ES50209546216055661299,7157.03,2022-08-17T15:53:41,Amurrio,expenses,food,-84.92,7735.71
buyer_3,Ana,Piñeiro,1989-08-23,43610689K,ana.piñeiro@awesomenet.io,074110,ES50209546216055661299,7157.03,2022-08-17T09:04:03,Amurrio,expenses,leisure,-40.38,7695.33
buyer_3,Ana,Piñeiro,1989-08-23,43610689K,ana.piñeiro@awesomenet.io,074110,ES50209546216055661299,7157.03,2022-08-17T04:54:51,Amurrio,expenses,travel,-701.59,6993.74
buyer_3,Ana,Piñeiro,1989-08-23,43610689K,ana.piñeiro@awesomenet.io,074110,ES50209546216055661299,7157.03,2022-08-18T22:37:50,Amurrio,expenses,healthcare,-67.0,6926.74
buyer_3,Ana,Piñeiro,1989-08-23,43610689K,ana.piñeiro@awesomenet.io,074110,ES50209546216055661299,7157.03,2022-08-18T15:28:38,Amurrio,expenses,appliances,-104.78,6821.96
buyer_3,Ana,Piñeiro,1989-08-23,43610689K,ana.piñeiro@awesomenet.io,074110,ES50209546216055661299,7157.03,2022-08-20T14:36:29,Amurrio,expenses,transport,-61.62,6760.34
buyer_3,Ana,Piñeiro,1989-08-23,43610689K,ana.piñeiro@awesomenet.io,074110,ES50209546216055661299,7157.03,2022-08-23T18:06:26,Amurrio,expenses,transport,-80.93,6679.41
buyer_3,Ana,Piñeiro,1989-08-23,43610689K,ana.piñeiro@awesomenet.io,074110,ES50209546216055661299,7157.03,2022-08-23T14:24:50,Amurrio,expenses,cash,-100.0,6579.41
buyer_3,Ana,Piñeiro,1989-08-23,43610689K,ana.piñeiro@awesomenet.io,074110,ES50209546216055661299,7157.03,2022-08-27T18:45:12,Amurrio,expenses,food,-67.74,6511.67
buyer_3,Ana,Piñeiro,1989-08-23,43610689K,ana.piñeiro@awesomenet.io,074110,ES50209546216055661299,7157.03,2022-08-27T19:30:11,Amurrio,expenses,gifts,-166.57,6345.1
buyer_3,Ana,Piñeiro,1989-08-23,43610689K,ana.piñeiro@awesomenet.io,074110,ES50209546216055661299,7157.03,2022-08-28T17:12:22,Amurrio,expenses,food,-115.67,6229.43
buyer_3,Ana,Piñeiro,1989-08-23,43610689K,ana.piñeiro@awesomenet.io,074110,ES50209546216055661299,7157.03,2022-08-30T13:25:32,Amurrio,expenses,food,-62.19,6167.24
buyer_3,Ana,Piñeiro,1989-08-23,43610689K,ana.piñeiro@awesomenet.io,074110,ES50209546216055661299,7157.03,2022-08-31T09:18:28,Amurrio,expenses,leisure,-71.36,6095.88
buyer_3,Ana,Piñeiro,1989-08-23,43610689K,ana.piñeiro@awesomenet.io,074110,ES50209546216055661299,7157.03,2022-09-01T19:16:43,Amurrio,incomes,salary,3312.4,9408.28
buyer_3,Ana,Piñeiro,1989-08-23,43610689K,ana.piñeiro@awesomenet.io,074110,ES50209546216055661299,7157.03,2022-09-01T19:16:43,Amurrio,incomes,salary_partner,3068.13,12476.41
buyer_3,Ana,Piñeiro,1989-08-23,43610689K,ana.piñeiro@awesomenet.io,074110,ES50209546216055661299,7157.03,2022-09-01T16:32:15,Amurrio,expenses,food,-124.83,12351.58
buyer_3,Ana,Piñeiro,1989-08-23,43610689K,ana.piñeiro@awesomenet.io,074110,ES50209546216055661299,7157.03,2022-09-03T08:56:18,Amurrio,expenses,food,-117.24,12234.34
buyer_3,Ana,Piñeiro,1989-08-23,43610689K,ana.piñeiro@awesomenet.io,074110,ES50209546216055661299,7157.03,2022-09-03T12:50:29,Amurrio,expenses,leisure,-27.0,12207.34
buyer_3,Ana,Piñeiro,1989-08-23,43610689K,ana.piñeiro@awesomenet.io,074110,ES50209546216055661299,7157.03,2022-09-04T17:50:34,Amurrio,expenses,mortgage,-2389.79,9817.55
buyer_3,Ana,Piñeiro,1989-08-23,43610689K,ana.piñeiro@awesomenet.io,074110,ES50209546216055661299,7157.03,2022-09-04T19:29:17,Amurrio,expenses,food,-74.83,9742.72
buyer_3,Ana,Piñeiro,1989-08-23,43610689K,ana.piñeiro@awesomenet.io,074110,ES50209546216055661299,7157.03,2022-09-04T04:15:37,Amurrio,expenses,leisure,-39.16,9703.56
buyer_3,Ana,Piñeiro,1989-08-23,43610689K,ana.piñeiro@awesomenet.io,074110,ES50209546216055661299,7157.03,2022-09-04T21:51:03,Amurrio,expenses,gifts,-623.38,9080.18
buyer_3,Ana,Piñeiro,1989-08-23,43610689K,ana.piñeiro@awesomenet.io,074110,ES50209546216055661299,7157.03,2022-09-05T20:10:04,Amurrio,expenses,internet,-133.99,8946.19
buyer_3,Ana,Piñeiro,1989-08-23,43610689K,ana.piñeiro@awesomenet.io,074110,ES50209546216055661299,7157.03,2022-09-05T08:15:43,Amurrio,expenses,phone,-118.61,8827.58
buyer_3,Ana,Piñeiro,1989-08-23,43610689K,ana.piñeiro@awesomenet.io,074110,ES50209546216055661299,7157.03,2022-09-06T11:06:28,Amurrio,expenses,water,-101.08,8726.5
buyer_3,Ana,Piñeiro,1989-08-23,43610689K,ana.piñeiro@awesomenet.io,074110,ES50209546216055661299,7157.03,2022-09-06T18:03:11,Amurrio,expenses,food,-109.85,8616.65
buyer_3,Ana,Piñeiro,1989-08-23,43610689K,ana.piñeiro@awesomenet.io,074110,ES50209546216055661299,7157.03,2022-09-07T10:04:26,Amurrio,expenses,water,-103.53,8513.12
buyer_3,Ana,Piñeiro,1989-08-23,43610689K,ana.piñeiro@awesomenet.io,074110,ES50209546216055661299,7157.03,2022-09-07T10:44:10,Amurrio,expenses,electricity,-173.43,8339.69
buyer_3,Ana,Piñeiro,1989-08-23,43610689K,ana.piñeiro@awesomenet.io,074110,ES50209546216055661299,7157.03,2022-09-07T17:34:58,Amurrio,expenses,appliances,-215.38,8124.31
buyer_3,Ana,Piñeiro,1989-08-23,43610689K,ana.piñeiro@awesomenet.io,074110,ES50209546216055661299,7157.03,2022-09-08T16:20:26,Amurrio,expenses,phone,-112.32,8011.99
buyer_3,Ana,Piñeiro,1989-08-23,43610689K,ana.piñeiro@awesomenet.io,074110,ES50209546216055661299,7157.03,2022-09-08T09:17:53,Amurrio,expenses,transport,-83.68,7928.31
buyer_3,Ana,Piñeiro,1989-08-23,43610689K,ana.piñeiro@awesomenet.io,074110,ES50209546216055661299,7157.03,2022-09-11T17:10:30,Amurrio,expenses,clothing,-57.77,7870.54
buyer_3,Ana,Piñeiro,1989-08-23,43610689K,ana.piñeiro@awesomenet.io,074110,ES50209546216055661299,7157.03,2022-09-12T12:17:23,Amurrio,expenses,clothing,-132.38,7738.16
buyer_3,Ana,Piñeiro,1989-08-23,43610689K,ana.piñeiro@awesomenet.io,074110,ES50209546216055661299,7157.03,2022-09-14T08:18:07,Amurrio,expenses,repairs,-110.22,7627.94
buyer_3,Ana,Piñeiro,1989-08-23,43610689K,ana.piñeiro@awesomenet.io,074110,ES50209546216055661299,7157.03,2022-09-14T17:09:23,Amurrio,expenses,car,-383.59,7244.35
buyer_3,Ana,Piñeiro,1989-08-23,43610689K,ana.piñeiro@awesomenet.io,074110,ES50209546216055661299,7157.03,2022-09-15T21:04:59,Amurrio,expenses,food,-95.63,7148.72
buyer_3,Ana,Piñeiro,1989-08-23,43610689K,ana.piñeiro@awesomenet.io,074110,ES50209546216055661299,7157.03,2022-09-16T13:54:58,Amurrio,expenses,food,-65.78,7082.94
buyer_3,Ana,Piñeiro,1989-08-23,43610689K,ana.piñeiro@awesomenet.io,074110,ES50209546216055661299,7157.03,2022-09-16T10:46:34,Amurrio,expenses,healthcare,-132.88,6950.06
buyer_3,Ana,Piñeiro,1989-08-23,43610689K,ana.piñeiro@awesomenet.io,074110,ES50209546216055661299,7157.03,2022-09-19T20:31:46,Amurrio,expenses,transport,-58.9,6891.16
buyer_3,Ana,Piñeiro,1989-08-23,43610689K,ana.piñeiro@awesomenet.io,074110,ES50209546216055661299,7157.03,2022-09-19T22:52:26,Amurrio,expenses,leisure,-18.51,6872.65
buyer_3,Ana,Piñeiro,1989-08-23,43610689K,ana.piñeiro@awesomenet.io,074110,ES50209546216055661299,7157.03,2022-09-19T09:22:10,Amurrio,expenses,gifts,-320.41,6552.24
buyer_3,Ana,Piñeiro,1989-08-23,43610689K,ana.piñeiro@awesomenet.io,074110,ES50209546216055661299,7157.03,2022-09-20T09:12:30,Amurrio,expenses,food,-97.59,6454.65
buyer_3,Ana,Piñeiro,1989-08-23,43610689K,ana.piñeiro@awesomenet.io,074110,ES50209546216055661299,7157.03,2022-09-22T11:21:30,Amurrio,expenses,cash,-100.0,6354.65
buyer_3,Ana,Piñeiro,1989-08-23,43610689K,ana.piñeiro@awesomenet.io,074110,ES50209546216055661299,7157.03,2022-09-23T01:56:56,Amurrio,expenses,food,-94.45,6260.2
buyer_3,Ana,Piñeiro,1989-08-23,43610689K,ana.piñeiro@awesomenet.io,074110,ES50209546216055661299,7157.03,2022-09-24T03:49:08,Amurrio,expenses,food,-122.81,6137.39
buyer_3,Ana,Piñeiro,1989-08-23,43610689K,ana.piñeiro@awesomenet.io,074110,ES50209546216055661299,7157.03,2022-09-25T22:12:58,Amurrio,expenses,education,-47.56,6089.83
buyer_3,Ana,Piñeiro,1989-08-23,43610689K,ana.piñeiro@awesomenet.io,074110,ES50209546216055661299,7157.03,2022-09-26T15:07:59,Amurrio,expenses,clothing,-141.57,5948.26
buyer_3,Ana,Piñeiro,1989-08-23,43610689K,ana.piñeiro@awesomenet.io,074110,ES50209546216055661299,7157.03,2022-09-27T18:00:23,Amurrio,expenses,leisure,-18.95,5929.31
buyer_3,Ana,Piñeiro,1989-08-23,43610689K,ana.piñeiro@awesomenet.io,074110,ES50209546216055661299,7157.03,2022-09-28T19:53:45,Amurrio,expenses,food,-92.99,5836.32
buyer_3,Ana,Piñeiro,1989-08-23,43610689K,ana.piñeiro@awesomenet.io,074110,ES50209546216055661299,7157.03,2022-09-29T16:26:31,Amurrio,expenses,cash,-100.0,5736.32
buyer_3,Ana,Piñeiro,1989-08-23,43610689K,ana.piñeiro@awesomenet.io,074110,ES50209546216055661299,7157.03,2022-10-01T12:36:48,Amurrio,incomes,salary,3312.4,9048.72
buyer_3,Ana,Piñeiro,1989-08-23,43610689K,ana.piñeiro@awesomenet.io,074110,ES50209546216055661299,7157.03,2022-10-01T12:36:48,Amurrio,incomes,salary_partner,3068.13,12116.85
buyer_3,Ana,Piñeiro,1989-08-23,43610689K,ana.piñeiro@awesomenet.io,074110,ES50209546216055661299,7157.03,2022-10-01T12:36:48,Amurrio,incomes,extra_income,346.04,12462.89
buyer_3,Ana,Piñeiro,1989-08-23,43610689K,ana.piñeiro@awesomenet.io,074110,ES50209546216055661299,7157.03,2022-10-03T11:07:37,Amurrio,expenses,clothing,-156.89,12306.0
buyer_3,Ana,Piñeiro,1989-08-23,43610689K,ana.piñeiro@awesomenet.io,074110,ES50209546216055661299,7157.03,2022-10-04T13:20:23,Amurrio,expenses,mortgage,-2389.79,9916.21
buyer_3,Ana,Piñeiro,1989-08-23,43610689K,ana.piñeiro@awesomenet.io,074110,ES50209546216055661299,7157.03,2022-10-05T16:59:55,Amurrio,expenses,water,-64.28,9851.93
buyer_3,Ana,Piñeiro,1989-08-23,43610689K,ana.piñeiro@awesomenet.io,074110,ES50209546216055661299,7157.03,2022-10-05T22:40:51,Amurrio,expenses,cash,-100.0,9751.93
buyer_3,Ana,Piñeiro,1989-08-23,43610689K,ana.piñeiro@awesomenet.io,074110,ES50209546216055661299,7157.03,2022-10-05T12:25:54,Amurrio,expenses,gifts,-627.76,9124.17
buyer_3,Ana,Piñeiro,1989-08-23,43610689K,ana.piñeiro@awesomenet.io,074110,ES50209546216055661299,7157.03,2022-10-06T17:09:12,Amurrio,expenses,water,-110.46,9013.71
buyer_3,Ana,Piñeiro,1989-08-23,43610689K,ana.piñeiro@awesomenet.io,074110,ES50209546216055661299,7157.03,2022-10-06T15:24:49,Amurrio,expenses,electricity,-188.98,8824.73
buyer_3,Ana,Piñeiro,1989-08-23,43610689K,ana.piñeiro@awesomenet.io,074110,ES50209546216055661299,7157.03,2022-10-06T11:10:15,Amurrio,expenses,internet,-133.99,8690.74
buyer_3,Ana,Piñeiro,1989-08-23,43610689K,ana.piñeiro@awesomenet.io,074110,ES50209546216055661299,7157.03,2022-10-07T12:05:16,Amurrio,expenses,food,-105.91,8584.83
buyer_3,Ana,Piñeiro,1989-08-23,43610689K,ana.piñeiro@awesomenet.io,074110,ES50209546216055661299,7157.03,2022-10-07T00:39:53,Amurrio,expenses,gifts,-438.79,8146.04
buyer_3,Ana,Piñeiro,1989-08-23,43610689K,ana.piñeiro@awesomenet.io,074110,ES50209546216055661299,7157.03,2022-10-08T11:01:08,Amurrio,expenses,electricity,-97.16,8048.88
buyer_3,Ana,Piñeiro,1989-08-23,43610689K,ana.piñeiro@awesomenet.io,074110,ES50209546216055661299,7157.03,2022-10-08T17:54:20,Amurrio,expenses,phone,-129.38,7919.5
buyer_3,Ana,Piñeiro,1989-08-23,43610689K,ana.piñeiro@awesomenet.io,074110,ES50209546216055661299,7157.03,2022-10-08T08:18:30,Amurrio,expenses,clothing,-106.48,7813.02
buyer_3,Ana,Piñeiro,1989-08-23,43610689K,ana.piñeiro@awesomenet.io,074110,ES50209546216055661299,7157.03,2022-10-09T13:50:49,Amurrio,expenses,clothing,-114.14,7698.88
buyer_3,Ana,Piñeiro,1989-08-23,43610689K,ana.piñeiro@awesomenet.io,074110,ES50209546216055661299,7157.03,2022-10-11T15:47:28,Amurrio,expenses,cash,-100.0,7598.88
buyer_3,Ana,Piñeiro,1989-08-23,43610689K,ana.piñeiro@awesomenet.io,074110,ES50209546216055661299,7157.03,2022-10-13T06:23:47,Amurrio,expenses,education,-49.16,7549.72
buyer_3,Ana,Piñeiro,1989-08-23,43610689K,ana.piñeiro@awesomenet.io,074110,ES50209546216055661299,7157.03,2022-10-14T20:13:38,Amurrio,expenses,cash,-100.0,7449.72
buyer_3,Ana,Piñeiro,1989-08-23,43610689K,ana.piñeiro@awesomenet.io,074110,ES50209546216055661299,7157.03,2022-10-14T18:32:10,Amurrio,expenses,repairs,-91.32,7358.4
buyer_3,Ana,Piñeiro,1989-08-23,43610689K,ana.piñeiro@awesomenet.io,074110,ES50209546216055661299,7157.03,2022-10-15T13:24:03,Amurrio,expenses,repairs,-310.79,7047.61
buyer_3,Ana,Piñeiro,1989-08-23,43610689K,ana.piñeiro@awesomenet.io,074110,ES50209546216055661299,7157.03,2022-10-16T19:57:26,Amurrio,expenses,gifts,-447.34,6600.27
buyer_3,Ana,Piñeiro,1989-08-23,43610689K,ana.piñeiro@awesomenet.io,074110,ES50209546216055661299,7157.03,2022-10-17T20:15:59,Amurrio,expenses,leisure,-43.15,6557.12
buyer_3,Ana,Piñeiro,1989-08-23,43610689K,ana.piñeiro@awesomenet.io,074110,ES50209546216055661299,7157.03,2022-10-18T15:50:52,Amurrio,expenses,cash,-100.0,6457.12
buyer_3,Ana,Piñeiro,1989-08-23,43610689K,ana.piñeiro@awesomenet.io,074110,ES50209546216055661299,7157.03,2022-10-19T15:02:08,Amurrio,expenses,food,-124.84,6332.28
buyer_3,Ana,Piñeiro,1989-08-23,43610689K,ana.piñeiro@awesomenet.io,074110,ES50209546216055661299,7157.03,2022-10-20T14:19:56,Amurrio,expenses,transport,-89.57,6242.71
buyer_3,Ana,Piñeiro,1989-08-23,43610689K,ana.piñeiro@awesomenet.io,074110,ES50209546216055661299,7157.03,2022-10-20T21:16:55,Amurrio,expenses,appliances,-120.38,6122.33
buyer_3,Ana,Piñeiro,1989-08-23,43610689K,ana.piñeiro@awesomenet.io,074110,ES50209546216055661299,7157.03,2022-10-20T23:41:33,Amurrio,expenses,gifts,-152.04,5970.29
buyer_3,Ana,Piñeiro,1989-08-23,43610689K,ana.piñeiro@awesomenet.io,074110,ES50209546216055661299,7157.03,2022-10-21T10:46:26,Amurrio,expenses,food,-103.83,5866.46
buyer_3,Ana,Piñeiro,1989-08-23,43610689K,ana.piñeiro@awesomenet.io,074110,ES50209546216055661299,7157.03,2022-10-21T20:41:14,Amurrio,expenses,repairs,-260.1,5606.36
buyer_3,Ana,Piñeiro,1989-08-23,43610689K,ana.piñeiro@awesomenet.io,074110,ES50209546216055661299,7157.03,2022-10-22T15:12:55,Amurrio,expenses,clothing,-96.45,5509.91
buyer_3,Ana,Piñeiro,1989-08-23,43610689K,ana.piñeiro@awesomenet.io,074110,ES50209546216055661299,7157.03,2022-10-23T02:53:55,Amurrio,expenses,food,-119.24,5390.67
buyer_3,Ana,Piñeiro,1989-08-23,43610689K,ana.piñeiro@awesomenet.io,074110,ES50209546216055661299,7157.03,2022-10-24T15:58:28,Amurrio,expenses,leisure,-22.78,5367.89
buyer_3,Ana,Piñeiro,1989-08-23,43610689K,ana.piñeiro@awesomenet.io,074110,ES50209546216055661299,7157.03,2022-10-25T16:36:34,Amurrio,expenses,food,-86.07,5281.82
buyer_3,Ana,Piñeiro,1989-08-23,43610689K,ana.piñeiro@awesomenet.io,074110,ES50209546216055661299,7157.03,2022-10-26T17:35:30,Amurrio,expenses,cash,-100.0,5181.82
buyer_3,Ana,Piñeiro,1989-08-23,43610689K,ana.piñeiro@awesomenet.io,074110,ES50209546216055661299,7157.03,2022-10-27T15:36:35,Amurrio,expenses,appliances,-342.38,4839.44
buyer_3,Ana,Piñeiro,1989-08-23,43610689K,ana.piñeiro@awesomenet.io,074110,ES50209546216055661299,7157.03,2022-10-28T09:36:14,Amurrio,expenses,leisure,-29.49,4809.95
buyer_3,Ana,Piñeiro,1989-08-23,43610689K,ana.piñeiro@awesomenet.io,074110,ES50209546216055661299,7157.03,2022-10-29T09:12:16,Amurrio,expenses,cash,-100.0,4709.95
buyer_3,Ana,Piñeiro,1989-08-23,43610689K,ana.piñeiro@awesomenet.io,074110,ES50209546216055661299,7157.03,2022-10-29T09:41:22,Amurrio,expenses,gifts,-531.93,4178.02
buyer_3,Ana,Piñeiro,1989-08-23,43610689K,ana.piñeiro@awesomenet.io,074110,ES50209546216055661299,7157.03,2022-10-30T05:09:40,Amurrio,expenses,cash,-100.0,4078.02
buyer_3,Ana,Piñeiro,1989-08-23,43610689K,ana.piñeiro@awesomenet.io,074110,ES50209546216055661299,7157.03,2022-11-01T21:12:35,Amurrio,incomes,salary,3312.4,7390.42
buyer_3,Ana,Piñeiro,1989-08-23,43610689K,ana.piñeiro@awesomenet.io,074110,ES50209546216055661299,7157.03,2022-11-01T21:12:35,Amurrio,incomes,salary_partner,3068.13,10458.55
buyer_3,Ana,Piñeiro,1989-08-23,43610689K,ana.piñeiro@awesomenet.io,074110,ES50209546216055661299,7157.03,2022-11-02T16:45:44,Amurrio,expenses,repairs,-300.07,10158.48
buyer_3,Ana,Piñeiro,1989-08-23,43610689K,ana.piñeiro@awesomenet.io,074110,ES50209546216055661299,7157.03,2022-11-03T15:44:33,Amurrio,expenses,transport,-43.03,10115.45
buyer_3,Ana,Piñeiro,1989-08-23,43610689K,ana.piñeiro@awesomenet.io,074110,ES50209546216055661299,7157.03,2022-11-04T09:14:48,Amurrio,expenses,mortgage,-2389.79,7725.66
buyer_3,Ana,Piñeiro,1989-08-23,43610689K,ana.piñeiro@awesomenet.io,074110,ES50209546216055661299,7157.03,2022-11-04T08:08:45,Amurrio,expenses,repairs,-66.22,7659.44
buyer_3,Ana,Piñeiro,1989-08-23,43610689K,ana.piñeiro@awesomenet.io,074110,ES50209546216055661299,7157.03,2022-11-04T16:59:08,Amurrio,expenses,car,-221.32,7438.12
buyer_3,Ana,Piñeiro,1989-08-23,43610689K,ana.piñeiro@awesomenet.io,074110,ES50209546216055661299,7157.03,2022-11-05T09:31:34,Amurrio,expenses,water,-66.68,7371.44
buyer_3,Ana,Piñeiro,1989-08-23,43610689K,ana.piñeiro@awesomenet.io,074110,ES50209546216055661299,7157.03,2022-11-05T14:31:07,Amurrio,expenses,transport,-78.42,7293.02
buyer_3,Ana,Piñeiro,1989-08-23,43610689K,ana.piñeiro@awesomenet.io,074110,ES50209546216055661299,7157.03,2022-11-06T14:31:55,Amurrio,expenses,phone,-139.12,7153.9
buyer_3,Ana,Piñeiro,1989-08-23,43610689K,ana.piñeiro@awesomenet.io,074110,ES50209546216055661299,7157.03,2022-11-07T10:11:40,Amurrio,expenses,gas,-348.44,6805.46
buyer_3,Ana,Piñeiro,1989-08-23,43610689K,ana.piñeiro@awesomenet.io,074110,ES50209546216055661299,7157.03,2022-11-07T07:19:19,Amurrio,expenses,leisure,-65.95,6739.51
buyer_3,Ana,Piñeiro,1989-08-23,43610689K,ana.piñeiro@awesomenet.io,074110,ES50209546216055661299,7157.03,2022-11-08T14:01:33,Amurrio,expenses,food,-98.54,6640.97
buyer_3,Ana,Piñeiro,1989-08-23,43610689K,ana.piñeiro@awesomenet.io,074110,ES50209546216055661299,7157.03,2022-11-08T00:00:48,Amurrio,expenses,repairs,-220.62,6420.35
buyer_3,Ana,Piñeiro,1989-08-23,43610689K,ana.piñeiro@awesomenet.io,074110,ES50209546216055661299,7157.03,2022-11-11T08:16:48,Amurrio,expenses,leisure,-29.83,6390.52
buyer_3,Ana,Piñeiro,1989-08-23,43610689K,ana.piñeiro@awesomenet.io,074110,ES50209546216055661299,7157.03,2022-11-12T14:36:23,Amurrio,expenses,leisure,-34.29,6356.23
buyer_3,Ana,Piñeiro,1989-08-23,43610689K,ana.piñeiro@awesomenet.io,074110,ES50209546216055661299,7157.03,2022-11-13T06:41:38,Amurrio,expenses,gifts,-117.85,6238.38
buyer_3,Ana,Piñeiro,1989-08-23,43610689K,ana.piñeiro@awesomenet.io,074110,ES50209546216055661299,7157.03,2022-11-14T04:11:10,Amurrio,expenses,transport,-73.55,6164.83
buyer_3,Ana,Piñeiro,1989-08-23,43610689K,ana.piñeiro@awesomenet.io,074110,ES50209546216055661299,7157.03,2022-11-14T16:49:58,Amurrio,expenses,leisure,-31.55,6133.28
buyer_3,Ana,Piñeiro,1989-08-23,43610689K,ana.piñeiro@awesomenet.io,074110,ES50209546216055661299,7157.03,2022-11-16T20:25:46,Amurrio,expenses,food,-95.26,6038.02
buyer_3,Ana,Piñeiro,1989-08-23,43610689K,ana.piñeiro@awesomenet.io,074110,ES50209546216055661299,7157.03,2022-11-17T13:38:34,Amurrio,expenses,cash,-100.0,5938.02
buyer_3,Ana,Piñeiro,1989-08-23,43610689K,ana.piñeiro@awesomenet.io,074110,ES50209546216055661299,7157.03,2022-11-17T18:37:34,Amurrio,expenses,gifts,-313.38,5624.64
buyer_3,Ana,Piñeiro,1989-08-23,43610689K,ana.piñeiro@awesomenet.io,074110,ES50209546216055661299,7157.03,2022-11-18T10:09:06,Amurrio,expenses,cash,-100.0,5524.64
buyer_3,Ana,Piñeiro,1989-08-23,43610689K,ana.piñeiro@awesomenet.io,074110,ES50209546216055661299,7157.03,2022-11-18T23:06:46,Amurrio,expenses,appliances,-224.55,5300.09
buyer_3,Ana,Piñeiro,1989-08-23,43610689K,ana.piñeiro@awesomenet.io,074110,ES50209546216055661299,7157.03,2022-11-21T15:11:52,Amurrio,expenses,cash,-100.0,5200.09
buyer_3,Ana,Piñeiro,1989-08-23,43610689K,ana.piñeiro@awesomenet.io,074110,ES50209546216055661299,7157.03,2022-11-22T20:32:11,Amurrio,expenses,transport,-85.04,5115.05
buyer_3,Ana,Piñeiro,1989-08-23,43610689K,ana.piñeiro@awesomenet.io,074110,ES50209546216055661299,7157.03,2022-11-22T09:59:20,Amurrio,expenses,cash,-100.0,5015.05
buyer_3,Ana,Piñeiro,1989-08-23,43610689K,ana.piñeiro@awesomenet.io,074110,ES50209546216055661299,7157.03,2022-11-23T13:28:04,Amurrio,expenses,cash,-100.0,4915.05
buyer_3,Ana,Piñeiro,1989-08-23,43610689K,ana.piñeiro@awesomenet.io,074110,ES50209546216055661299,7157.03,2022-11-24T10:30:30,Amurrio,expenses,food,-72.35,4842.7
buyer_3,Ana,Piñeiro,1989-08-23,43610689K,ana.piñeiro@awesomenet.io,074110,ES50209546216055661299,7157.03,2022-11-24T20:20:11,Amurrio,expenses,clothing,-97.3,4745.4
buyer_3,Ana,Piñeiro,1989-08-23,43610689K,ana.piñeiro@awesomenet.io,074110,ES50209546216055661299,7157.03,2022-11-25T20:01:53,Amurrio,expenses,food,-83.59,4661.81
buyer_3,Ana,Piñeiro,1989-08-23,43610689K,ana.piñeiro@awesomenet.io,074110,ES50209546216055661299,7157.03,2022-11-25T10:21:04,Amurrio,expenses,repairs,-293.26,4368.55
buyer_3,Ana,Piñeiro,1989-08-23,43610689K,ana.piñeiro@awesomenet.io,074110,ES50209546216055661299,7157.03,2022-11-26T08:31:06,Amurrio,expenses,food,-114.45,4254.1
buyer_3,Ana,Piñeiro,1989-08-23,43610689K,ana.piñeiro@awesomenet.io,074110,ES50209546216055661299,7157.03,2022-11-27T09:34:05,Amurrio,expenses,cash,-100.0,4154.1
buyer_3,Ana,Piñeiro,1989-08-23,43610689K,ana.piñeiro@awesomenet.io,074110,ES50209546216055661299,7157.03,2022-11-30T08:15:36,Amurrio,expenses,leisure,-44.34,4109.76
buyer_3,Ana,Piñeiro,1989-08-23,43610689K,ana.piñeiro@awesomenet.io,074110,ES50209546216055661299,7157.03,2022-12-01T16:03:25,Amurrio,incomes,salary,3312.4,7422.16
buyer_3,Ana,Piñeiro,1989-08-23,43610689K,ana.piñeiro@awesomenet.io,074110,ES50209546216055661299,7157.03,2022-12-01T16:03:25,Amurrio,incomes,salary_partner,3068.13,10490.29
buyer_3,Ana,Piñeiro,1989-08-23,43610689K,ana.piñeiro@awesomenet.io,074110,ES50209546216055661299,7157.03,2022-12-01T16:03:25,Amurrio,incomes,salary_bonus,2365.05,12855.34
buyer_3,Ana,Piñeiro,1989-08-23,43610689K,ana.piñeiro@awesomenet.io,074110,ES50209546216055661299,7157.03,2022-12-01T16:03:25,Amurrio,incomes,salary_partner_bonus,2167.08,15022.42
buyer_3,Ana,Piñeiro,1989-08-23,43610689K,ana.piñeiro@awesomenet.io,074110,ES50209546216055661299,7157.03,2022-12-03T12:52:43,Amurrio,expenses,clothing,-134.86,14887.56
buyer_3,Ana,Piñeiro,1989-08-23,43610689K,ana.piñeiro@awesomenet.io,074110,ES50209546216055661299,7157.03,2022-12-04T12:37:28,Amurrio,expenses,mortgage,-2389.79,12497.77
buyer_3,Ana,Piñeiro,1989-08-23,43610689K,ana.piñeiro@awesomenet.io,074110,ES50209546216055661299,7157.03,2022-12-04T08:41:07,Amurrio,expenses,food,-78.12,12419.65
buyer_3,Ana,Piñeiro,1989-08-23,43610689K,ana.piñeiro@awesomenet.io,074110,ES50209546216055661299,7157.03,2022-12-05T16:32:26,Amurrio,expenses,internet,-133.99,12285.66
buyer_3,Ana,Piñeiro,1989-08-23,43610689K,ana.piñeiro@awesomenet.io,074110,ES50209546216055661299,7157.03,2022-12-06T22:12:55,Amurrio,expenses,gas,-162.57,12123.09
buyer_3,Ana,Piñeiro,1989-08-23,43610689K,ana.piñeiro@awesomenet.io,074110,ES50209546216055661299,7157.03,2022-12-06T11:35:54,Amurrio,expenses,phone,-126.63,11996.46
buyer_3,Ana,Piñeiro,1989-08-23,43610689K,ana.piñeiro@awesomenet.io,074110,ES50209546216055661299,7157.03,2022-12-06T20:06:13,Amurrio,expenses,cash,-100.0,11896.46
buyer_3,Ana,Piñeiro,1989-08-23,43610689K,ana.piñeiro@awesomenet.io,074110,ES50209546216055661299,7157.03,2022-12-07T18:24:23,Amurrio,expenses,water,-66.37,11830.09
buyer_3,Ana,Piñeiro,1989-08-23,43610689K,ana.piñeiro@awesomenet.io,074110,ES50209546216055661299,7157.03,2022-12-07T13:51:38,Amurrio,expenses,electricity,-198.92,11631.17
buyer_3,Ana,Piñeiro,1989-08-23,43610689K,ana.piñeiro@awesomenet.io,074110,ES50209546216055661299,7157.03,2022-12-07T19:12:09,Amurrio,expenses,phone,-123.96,11507.21
buyer_3,Ana,Piñeiro,1989-08-23,43610689K,ana.piñeiro@awesomenet.io,074110,ES50209546216055661299,7157.03,2022-12-07T11:14:37,Amurrio,expenses,leisure,-66.64,11440.57
buyer_3,Ana,Piñeiro,1989-08-23,43610689K,ana.piñeiro@awesomenet.io,074110,ES50209546216055661299,7157.03,2022-12-07T10:19:59,Amurrio,expenses,education,-54.0,11386.57
buyer_3,Ana,Piñeiro,1989-08-23,43610689K,ana.piñeiro@awesomenet.io,074110,ES50209546216055661299,7157.03,2022-12-08T21:02:25,Amurrio,expenses,phone,-116.71,11269.86
buyer_3,Ana,Piñeiro,1989-08-23,43610689K,ana.piñeiro@awesomenet.io,074110,ES50209546216055661299,7157.03,2022-12-08T20:54:39,Amurrio,expenses,leisure,-43.26,11226.6
buyer_3,Ana,Piñeiro,1989-08-23,43610689K,ana.piñeiro@awesomenet.io,074110,ES50209546216055661299,7157.03,2022-12-09T08:01:51,Amurrio,expenses,food,-72.22,11154.38
buyer_3,Ana,Piñeiro,1989-08-23,43610689K,ana.piñeiro@awesomenet.io,074110,ES50209546216055661299,7157.03,2022-12-09T17:03:19,Amurrio,expenses,cash,-100.0,11054.38
buyer_3,Ana,Piñeiro,1989-08-23,43610689K,ana.piñeiro@awesomenet.io,074110,ES50209546216055661299,7157.03,2022-12-10T23:36:38,Amurrio,expenses,leisure,-39.52,11014.86
buyer_3,Ana,Piñeiro,1989-08-23,43610689K,ana.piñeiro@awesomenet.io,074110,ES50209546216055661299,7157.03,2022-12-10T12:44:38,Amurrio,expenses,repairs,-137.24,10877.62
buyer_3,Ana,Piñeiro,1989-08-23,43610689K,ana.piñeiro@awesomenet.io,074110,ES50209546216055661299,7157.03,2022-12-11T11:35:09,Amurrio,expenses,cash,-100.0,10777.62
buyer_3,Ana,Piñeiro,1989-08-23,43610689K,ana.piñeiro@awesomenet.io,074110,ES50209546216055661299,7157.03,2022-12-13T08:52:25,Amurrio,expenses,transport,-52.55,10725.07
buyer_3,Ana,Piñeiro,1989-08-23,43610689K,ana.piñeiro@awesomenet.io,074110,ES50209546216055661299,7157.03,2022-12-13T13:08:03,Amurrio,expenses,leisure,-29.37,10695.7
buyer_3,Ana,Piñeiro,1989-08-23,43610689K,ana.piñeiro@awesomenet.io,074110,ES50209546216055661299,7157.03,2022-12-15T14:33:30,Amurrio,expenses,food,-73.84,10621.86
buyer_3,Ana,Piñeiro,1989-08-23,43610689K,ana.piñeiro@awesomenet.io,074110,ES50209546216055661299,7157.03,2022-12-15T10:20:49,Amurrio,expenses,repairs,-319.44,10302.42
buyer_3,Ana,Piñeiro,1989-08-23,43610689K,ana.piñeiro@awesomenet.io,074110,ES50209546216055661299,7157.03,2022-12-16T08:51:11,Amurrio,expenses,leisure,-70.55,10231.87
buyer_3,Ana,Piñeiro,1989-08-23,43610689K,ana.piñeiro@awesomenet.io,074110,ES50209546216055661299,7157.03,2022-12-16T22:08:39,Amurrio,expenses,repairs,-66.54,10165.33
buyer_3,Ana,Piñeiro,1989-08-23,43610689K,ana.piñeiro@awesomenet.io,074110,ES50209546216055661299,7157.03,2022-12-18T09:37:00,Amurrio,expenses,food,-68.93,10096.4
buyer_3,Ana,Piñeiro,1989-08-23,43610689K,ana.piñeiro@awesomenet.io,074110,ES50209546216055661299,7157.03,2022-12-18T08:17:28,Amurrio,expenses,transport,-53.27,10043.13
buyer_3,Ana,Piñeiro,1989-08-23,43610689K,ana.piñeiro@awesomenet.io,074110,ES50209546216055661299,7157.03,2022-12-18T14:12:26,Amurrio,expenses,healthcare,-165.09,9878.04
buyer_3,Ana,Piñeiro,1989-08-23,43610689K,ana.piñeiro@awesomenet.io,074110,ES50209546216055661299,7157.03,2022-12-18T10:41:27,Amurrio,expenses,repairs,-277.37,9600.67
buyer_3,Ana,Piñeiro,1989-08-23,43610689K,ana.piñeiro@awesomenet.io,074110,ES50209546216055661299,7157.03,2022-12-19T20:20:13,Amurrio,expenses,transport,-50.97,9549.7
buyer_3,Ana,Piñeiro,1989-08-23,43610689K,ana.piñeiro@awesomenet.io,074110,ES50209546216055661299,7157.03,2022-12-19T14:43:28,Amurrio,expenses,gifts,-207.0,9342.7
buyer_3,Ana,Piñeiro,1989-08-23,43610689K,ana.piñeiro@awesomenet.io,074110,ES50209546216055661299,7157.03,2022-12-20T11:16:26,Amurrio,expenses,gifts,-560.56,8782.14
buyer_3,Ana,Piñeiro,1989-08-23,43610689K,ana.piñeiro@awesomenet.io,074110,ES50209546216055661299,7157.03,2022-12-21T11:23:01,Amurrio,expenses,leisure,-80.09,8702.05
buyer_3,Ana,Piñeiro,1989-08-23,43610689K,ana.piñeiro@awesomenet.io,074110,ES50209546216055661299,7157.03,2022-12-22T13:18:31,Amurrio,expenses,gifts,-366.72,8335.33
buyer_3,Ana,Piñeiro,1989-08-23,43610689K,ana.piñeiro@awesomenet.io,074110,ES50209546216055661299,7157.03,2022-12-24T14:19:42,Amurrio,expenses,cash,-100.0,8235.33
buyer_3,Ana,Piñeiro,1989-08-23,43610689K,ana.piñeiro@awesomenet.io,074110,ES50209546216055661299,7157.03,2022-12-25T11:41:10,Amurrio,expenses,cash,-100.0,8135.33
buyer_3,Ana,Piñeiro,1989-08-23,43610689K,ana.piñeiro@awesomenet.io,074110,ES50209546216055661299,7157.03,2022-12-26T18:19:25,Amurrio,expenses,food,-120.27,8015.06
buyer_3,Ana,Piñeiro,1989-08-23,43610689K,ana.piñeiro@awesomenet.io,074110,ES50209546216055661299,7157.03,2022-12-27T08:28:52,Amurrio,expenses,leisure,-50.99,7964.07
buyer_3,Ana,Piñeiro,1989-08-23,43610689K,ana.piñeiro@awesomenet.io,074110,ES50209546216055661299,7157.03,2022-12-27T17:19:42,Amurrio,expenses,appliances,-258.44,7705.63
buyer_3,Ana,Piñeiro,1989-08-23,43610689K,ana.piñeiro@awesomenet.io,074110,ES50209546216055661299,7157.03,2022-12-28T12:13:34,Amurrio,expenses,food,-93.42,7612.21
buyer_3,Ana,Piñeiro,1989-08-23,43610689K,ana.piñeiro@awesomenet.io,074110,ES50209546216055661299,7157.03,2022-12-28T10:53:33,Amurrio,expenses,cash,-100.0,7512.21
buyer_3,Ana,Piñeiro,1989-08-23,43610689K,ana.piñeiro@awesomenet.io,074110,ES50209546216055661299,7157.03,2022-12-29T17:16:02,Amurrio,expenses,gifts,-567.05,6945.16
buyer_3,Ana,Piñeiro,1989-08-23,43610689K,ana.piñeiro@awesomenet.io,074110,ES50209546216055661299,7157.03,2022-12-30T02:43:54,Amurrio,expenses,leisure,-54.68,6890.48
buyer_3,Ana,Piñeiro,1989-08-23,43610689K,ana.piñeiro@awesomenet.io,074110,ES50209546216055661299,7157.03,2022-12-30T13:17:50,Amurrio,expenses,cash,-100.0,6790.48
buyer_3,Ana,Piñeiro,1989-08-23,43610689K,ana.piñeiro@awesomenet.io,074110,ES50209546216055661299,7157.03,2022-12-31T15:05:12,Amurrio,expenses,transport,-76.92,6713.56
buyer_3,Ana,Piñeiro,1989-08-23,43610689K,ana.piñeiro@awesomenet.io,074110,ES50209546216055661299,7157.03,2023-01-01T10:37:46,Amurrio,incomes,salary,3430.52,10144.08
buyer_3,Ana,Piñeiro,1989-08-23,43610689K,ana.piñeiro@awesomenet.io,074110,ES50209546216055661299,7157.03,2023-01-01T10:37:46,Amurrio,incomes,salary_partner,3177.54,13321.62
buyer_3,Ana,Piñeiro,1989-08-23,43610689K,ana.piñeiro@awesomenet.io,074110,ES50209546216055661299,7157.03,2023-01-01T10:37:46,Amurrio,incomes,extra_income,346.04,13667.66
buyer_3,Ana,Piñeiro,1989-08-23,43610689K,ana.piñeiro@awesomenet.io,074110,ES50209546216055661299,7157.03,2023-01-01T23:17:43,Amurrio,expenses,cash,-100.0,13567.66
buyer_3,Ana,Piñeiro,1989-08-23,43610689K,ana.piñeiro@awesomenet.io,074110,ES50209546216055661299,7157.03,2023-01-01T12:21:09,Amurrio,expenses,travel,-1071.1,12496.56
buyer_3,Ana,Piñeiro,1989-08-23,43610689K,ana.piñeiro@awesomenet.io,074110,ES50209546216055661299,7157.03,2023-01-02T10:25:09,Amurrio,expenses,healthcare,-74.53,12422.03
buyer_3,Ana,Piñeiro,1989-08-23,43610689K,ana.piñeiro@awesomenet.io,074110,ES50209546216055661299,7157.03,2023-01-02T20:29:38,Amurrio,expenses,repairs,-291.84,12130.19
buyer_3,Ana,Piñeiro,1989-08-23,43610689K,ana.piñeiro@awesomenet.io,074110,ES50209546216055661299,7157.03,2023-01-04T16:57:32,Amurrio,expenses,mortgage,-2728.24,9401.95
buyer_3,Ana,Piñeiro,1989-08-23,43610689K,ana.piñeiro@awesomenet.io,074110,ES50209546216055661299,7157.03,2023-01-05T13:15:17,Amurrio,expenses,water,-144.11,9257.84
buyer_3,Ana,Piñeiro,1989-08-23,43610689K,ana.piñeiro@awesomenet.io,074110,ES50209546216055661299,7157.03,2023-01-05T16:51:00,Amurrio,expenses,transport,-72.17,9185.67
buyer_3,Ana,Piñeiro,1989-08-23,43610689K,ana.piñeiro@awesomenet.io,074110,ES50209546216055661299,7157.03,2023-01-07T15:54:11,Amurrio,expenses,water,-133.96,9051.71
buyer_3,Ana,Piñeiro,1989-08-23,43610689K,ana.piñeiro@awesomenet.io,074110,ES50209546216055661299,7157.03,2023-01-07T10:08:04,Amurrio,expenses,gifts,-126.78,8924.93
buyer_3,Ana,Piñeiro,1989-08-23,43610689K,ana.piñeiro@awesomenet.io,074110,ES50209546216055661299,7157.03,2023-01-08T21:05:26,Amurrio,expenses,water,-142.45,8782.48
buyer_3,Ana,Piñeiro,1989-08-23,43610689K,ana.piñeiro@awesomenet.io,074110,ES50209546216055661299,7157.03,2023-01-08T00:47:45,Amurrio,expenses,gas,-253.6,8528.88
buyer_3,Ana,Piñeiro,1989-08-23,43610689K,ana.piñeiro@awesomenet.io,074110,ES50209546216055661299,7157.03,2023-01-08T23:45:57,Amurrio,expenses,cash,-100.0,8428.88
buyer_3,Ana,Piñeiro,1989-08-23,43610689K,ana.piñeiro@awesomenet.io,074110,ES50209546216055661299,7157.03,2023-01-10T20:23:56,Amurrio,expenses,cash,-100.0,8328.88
buyer_3,Ana,Piñeiro,1989-08-23,43610689K,ana.piñeiro@awesomenet.io,074110,ES50209546216055661299,7157.03,2023-01-11T15:36:16,Amurrio,expenses,food,-75.19,8253.69
buyer_3,Ana,Piñeiro,1989-08-23,43610689K,ana.piñeiro@awesomenet.io,074110,ES50209546216055661299,7157.03,2023-01-11T08:35:46,Amurrio,expenses,clothing,-143.26,8110.43
buyer_3,Ana,Piñeiro,1989-08-23,43610689K,ana.piñeiro@awesomenet.io,074110,ES50209546216055661299,7157.03,2023-01-13T02:14:39,Amurrio,expenses,transport,-48.49,8061.94
buyer_3,Ana,Piñeiro,1989-08-23,43610689K,ana.piñeiro@awesomenet.io,074110,ES50209546216055661299,7157.03,2023-01-14T15:20:53,Amurrio,expenses,cash,-100.0,7961.94
buyer_3,Ana,Piñeiro,1989-08-23,43610689K,ana.piñeiro@awesomenet.io,074110,ES50209546216055661299,7157.03,2023-01-15T14:24:40,Amurrio,expenses,cash,-100.0,7861.94
buyer_3,Ana,Piñeiro,1989-08-23,43610689K,ana.piñeiro@awesomenet.io,074110,ES50209546216055661299,7157.03,2023-01-15T16:31:58,Amurrio,expenses,repairs,-175.54,7686.4
buyer_3,Ana,Piñeiro,1989-08-23,43610689K,ana.piñeiro@awesomenet.io,074110,ES50209546216055661299,7157.03,2023-01-22T15:35:02,Amurrio,expenses,gifts,-448.48,7237.92
buyer_3,Ana,Piñeiro,1989-08-23,43610689K,ana.piñeiro@awesomenet.io,074110,ES50209546216055661299,7157.03,2023-01-23T14:59:37,Amurrio,expenses,education,-51.41,7186.51
buyer_3,Ana,Piñeiro,1989-08-23,43610689K,ana.piñeiro@awesomenet.io,074110,ES50209546216055661299,7157.03,2023-01-24T09:44:29,Amurrio,expenses,cash,-100.0,7086.51
buyer_3,Ana,Piñeiro,1989-08-23,43610689K,ana.piñeiro@awesomenet.io,074110,ES50209546216055661299,7157.03,2023-01-24T13:18:31,Amurrio,expenses,gifts,-554.0,6532.51
buyer_3,Ana,Piñeiro,1989-08-23,43610689K,ana.piñeiro@awesomenet.io,074110,ES50209546216055661299,7157.03,2023-01-25T18:25:19,Amurrio,expenses,travel,-741.15,5791.36
buyer_3,Ana,Piñeiro,1989-08-23,43610689K,ana.piñeiro@awesomenet.io,074110,ES50209546216055661299,7157.03,2023-01-26T19:06:04,Amurrio,expenses,cash,-100.0,5691.36
buyer_3,Ana,Piñeiro,1989-08-23,43610689K,ana.piñeiro@awesomenet.io,074110,ES50209546216055661299,7157.03,2023-01-28T12:20:36,Amurrio,expenses,repairs,-249.36,5442.0
buyer_3,Ana,Piñeiro,1989-08-23,43610689K,ana.piñeiro@awesomenet.io,074110,ES50209546216055661299,7157.03,2023-01-31T19:08:13,Amurrio,expenses,food,-69.61,5372.39
buyer_3,Ana,Piñeiro,1989-08-23,43610689K,ana.piñeiro@awesomenet.io,074110,ES50209546216055661299,7157.03,2023-02-01T10:16:28,Amurrio,incomes,salary,3430.52,8802.91
buyer_3,Ana,Piñeiro,1989-08-23,43610689K,ana.piñeiro@awesomenet.io,074110,ES50209546216055661299,7157.03,2023-02-01T10:16:28,Amurrio,incomes,salary_partner,3177.54,11980.45
buyer_3,Ana,Piñeiro,1989-08-23,43610689K,ana.piñeiro@awesomenet.io,074110,ES50209546216055661299,7157.03,2023-02-01T17:43:39,Amurrio,expenses,transport,-68.39,11912.06
buyer_3,Ana,Piñeiro,1989-08-23,43610689K,ana.piñeiro@awesomenet.io,074110,ES50209546216055661299,7157.03,2023-02-01T09:15:30,Amurrio,expenses,cash,-100.0,11812.06
buyer_3,Ana,Piñeiro,1989-08-23,43610689K,ana.piñeiro@awesomenet.io,074110,ES50209546216055661299,7157.03,2023-02-04T16:15:14,Amurrio,expenses,mortgage,-2728.24,9083.82
buyer_3,Ana,Piñeiro,1989-08-23,43610689K,ana.piñeiro@awesomenet.io,074110,ES50209546216055661299,7157.03,2023-02-05T17:37:38,Amurrio,expenses,water,-139.61,8944.21
buyer_3,Ana,Piñeiro,1989-08-23,43610689K,ana.piñeiro@awesomenet.io,074110,ES50209546216055661299,7157.03,2023-02-06T11:41:18,Amurrio,expenses,electricity,-100.2,8844.01
buyer_3,Ana,Piñeiro,1989-08-23,43610689K,ana.piñeiro@awesomenet.io,074110,ES50209546216055661299,7157.03,2023-02-06T19:57:17,Amurrio,expenses,repairs,-148.5,8695.51
buyer_3,Ana,Piñeiro,1989-08-23,43610689K,ana.piñeiro@awesomenet.io,074110,ES50209546216055661299,7157.03,2023-02-07T20:35:11,Amurrio,expenses,water,-69.61,8625.9
buyer_3,Ana,Piñeiro,1989-08-23,43610689K,ana.piñeiro@awesomenet.io,074110,ES50209546216055661299,7157.03,2023-02-07T19:00:03,Amurrio,expenses,cash,-100.0,8525.9
buyer_3,Ana,Piñeiro,1989-08-23,43610689K,ana.piñeiro@awesomenet.io,074110,ES50209546216055661299,7157.03,2023-02-08T13:01:32,Amurrio,expenses,internet,-138.77,8387.13
buyer_3,Ana,Piñeiro,1989-08-23,43610689K,ana.piñeiro@awesomenet.io,074110,ES50209546216055661299,7157.03,2023-02-08T10:39:43,Amurrio,expenses,gifts,-77.34,8309.79
buyer_3,Ana,Piñeiro,1989-08-23,43610689K,ana.piñeiro@awesomenet.io,074110,ES50209546216055661299,7157.03,2023-02-09T06:04:55,Amurrio,expenses,gifts,-735.62,7574.17
buyer_3,Ana,Piñeiro,1989-08-23,43610689K,ana.piñeiro@awesomenet.io,074110,ES50209546216055661299,7157.03,2023-02-10T09:23:31,Amurrio,expenses,transport,-59.11,7515.06
buyer_3,Ana,Piñeiro,1989-08-23,43610689K,ana.piñeiro@awesomenet.io,074110,ES50209546216055661299,7157.03,2023-02-11T15:21:00,Amurrio,expenses,food,-114.06,7401.0
buyer_3,Ana,Piñeiro,1989-08-23,43610689K,ana.piñeiro@awesomenet.io,074110,ES50209546216055661299,7157.03,2023-02-14T10:08:48,Amurrio,expenses,food,-98.42,7302.58
buyer_3,Ana,Piñeiro,1989-08-23,43610689K,ana.piñeiro@awesomenet.io,074110,ES50209546216055661299,7157.03,2023-02-14T12:21:02,Amurrio,expenses,leisure,-47.55,7255.03
buyer_3,Ana,Piñeiro,1989-08-23,43610689K,ana.piñeiro@awesomenet.io,074110,ES50209546216055661299,7157.03,2023-02-17T08:34:36,Amurrio,expenses,food,-88.24,7166.79
buyer_3,Ana,Piñeiro,1989-08-23,43610689K,ana.piñeiro@awesomenet.io,074110,ES50209546216055661299,7157.03,2023-02-18T14:51:51,Amurrio,expenses,repairs,-319.62,6847.17
buyer_3,Ana,Piñeiro,1989-08-23,43610689K,ana.piñeiro@awesomenet.io,074110,ES50209546216055661299,7157.03,2023-02-21T13:16:10,Amurrio,expenses,appliances,-95.96,6751.21
buyer_3,Ana,Piñeiro,1989-08-23,43610689K,ana.piñeiro@awesomenet.io,074110,ES50209546216055661299,7157.03,2023-02-21T17:35:07,Amurrio,expenses,repairs,-258.59,6492.62
buyer_3,Ana,Piñeiro,1989-08-23,43610689K,ana.piñeiro@awesomenet.io,074110,ES50209546216055661299,7157.03,2023-02-23T13:31:37,Amurrio,expenses,appliances,-164.37,6328.25
buyer_3,Ana,Piñeiro,1989-08-23,43610689K,ana.piñeiro@awesomenet.io,074110,ES50209546216055661299,7157.03,2023-02-23T15:46:13,Amurrio,expenses,repairs,-127.08,6201.17
buyer_3,Ana,Piñeiro,1989-08-23,43610689K,ana.piñeiro@awesomenet.io,074110,ES50209546216055661299,7157.03,2023-02-26T20:59:59,Amurrio,expenses,cash,-100.0,6101.17
buyer_3,Ana,Piñeiro,1989-08-23,43610689K,ana.piñeiro@awesomenet.io,074110,ES50209546216055661299,7157.03,2023-02-27T14:11:53,Amurrio,expenses,food,-105.5,5995.67
buyer_3,Ana,Piñeiro,1989-08-23,43610689K,ana.piñeiro@awesomenet.io,074110,ES50209546216055661299,7157.03,2023-02-27T14:23:18,Amurrio,expenses,cash,-100.0,5895.67
buyer_3,Ana,Piñeiro,1989-08-23,43610689K,ana.piñeiro@awesomenet.io,074110,ES50209546216055661299,7157.03,2023-02-28T02:20:15,Amurrio,expenses,cash,-100.0,5795.67
buyer_3,Ana,Piñeiro,1989-08-23,43610689K,ana.piñeiro@awesomenet.io,074110,ES50209546216055661299,7157.03,2023-03-01T15:45:32,Amurrio,incomes,salary,3430.52,9226.19
buyer_3,Ana,Piñeiro,1989-08-23,43610689K,ana.piñeiro@awesomenet.io,074110,ES50209546216055661299,7157.03,2023-03-01T15:45:32,Amurrio,incomes,salary_partner,3177.54,12403.73
buyer_3,Ana,Piñeiro,1989-08-23,43610689K,ana.piñeiro@awesomenet.io,074110,ES50209546216055661299,7157.03,2023-03-01T13:36:39,Amurrio,expenses,transport,-83.31,12320.42
buyer_3,Ana,Piñeiro,1989-08-23,43610689K,ana.piñeiro@awesomenet.io,074110,ES50209546216055661299,7157.03,2023-03-02T07:50:32,Amurrio,expenses,repairs,-204.47,12115.95
buyer_3,Ana,Piñeiro,1989-08-23,43610689K,ana.piñeiro@awesomenet.io,074110,ES50209546216055661299,7157.03,2023-03-02T11:47:20,Amurrio,expenses,gifts,-213.77,11902.18
buyer_3,Ana,Piñeiro,1989-08-23,43610689K,ana.piñeiro@awesomenet.io,074110,ES50209546216055661299,7157.03,2023-03-03T10:53:44,Amurrio,expenses,leisure,-44.19,11857.99
buyer_3,Ana,Piñeiro,1989-08-23,43610689K,ana.piñeiro@awesomenet.io,074110,ES50209546216055661299,7157.03,2023-03-03T01:23:40,Amurrio,expenses,cash,-100.0,11757.99
buyer_3,Ana,Piñeiro,1989-08-23,43610689K,ana.piñeiro@awesomenet.io,074110,ES50209546216055661299,7157.03,2023-03-04T21:56:24,Amurrio,expenses,mortgage,-2728.24,9029.75
buyer_3,Ana,Piñeiro,1989-08-23,43610689K,ana.piñeiro@awesomenet.io,074110,ES50209546216055661299,7157.03,2023-03-05T20:28:13,Amurrio,expenses,appliances,-182.68,8847.07
buyer_3,Ana,Piñeiro,1989-08-23,43610689K,ana.piñeiro@awesomenet.io,074110,ES50209546216055661299,7157.03,2023-03-06T02:22:02,Amurrio,expenses,gas,-348.67,8498.4
buyer_3,Ana,Piñeiro,1989-08-23,43610689K,ana.piñeiro@awesomenet.io,074110,ES50209546216055661299,7157.03,2023-03-06T23:41:50,Amurrio,expenses,phone,-114.23,8384.17
buyer_3,Ana,Piñeiro,1989-08-23,43610689K,ana.piñeiro@awesomenet.io,074110,ES50209546216055661299,7157.03,2023-03-06T18:17:24,Amurrio,expenses,food,-69.62,8314.55
buyer_3,Ana,Piñeiro,1989-08-23,43610689K,ana.piñeiro@awesomenet.io,074110,ES50209546216055661299,7157.03,2023-03-07T08:13:19,Amurrio,expenses,electricity,-72.79,8241.76
buyer_3,Ana,Piñeiro,1989-08-23,43610689K,ana.piñeiro@awesomenet.io,074110,ES50209546216055661299,7157.03,2023-03-07T09:58:53,Amurrio,expenses,cash,-100.0,8141.76
buyer_3,Ana,Piñeiro,1989-08-23,43610689K,ana.piñeiro@awesomenet.io,074110,ES50209546216055661299,7157.03,2023-03-07T20:27:46,Amurrio,expenses,repairs,-301.55,7840.21
buyer_3,Ana,Piñeiro,1989-08-23,43610689K,ana.piñeiro@awesomenet.io,074110,ES50209546216055661299,7157.03,2023-03-08T10:03:48,Amurrio,expenses,gas,-280.72,7559.49
buyer_3,Ana,Piñeiro,1989-08-23,43610689K,ana.piñeiro@awesomenet.io,074110,ES50209546216055661299,7157.03,2023-03-08T14:27:55,Amurrio,expenses,healthcare,-164.44,7395.05
buyer_3,Ana,Piñeiro,1989-08-23,43610689K,ana.piñeiro@awesomenet.io,074110,ES50209546216055661299,7157.03,2023-03-10T12:02:45,Amurrio,expenses,transport,-85.44,7309.61
buyer_3,Ana,Piñeiro,1989-08-23,43610689K,ana.piñeiro@awesomenet.io,074110,ES50209546216055661299,7157.03,2023-03-10T21:12:31,Amurrio,expenses,cash,-100.0,7209.61
buyer_3,Ana,Piñeiro,1989-08-23,43610689K,ana.piñeiro@awesomenet.io,074110,ES50209546216055661299,7157.03,2023-03-12T10:00:02,Amurrio,expenses,food,-115.7,7093.91
buyer_3,Ana,Piñeiro,1989-08-23,43610689K,ana.piñeiro@awesomenet.io,074110,ES50209546216055661299,7157.03,2023-03-13T08:34:11,Amurrio,expenses,healthcare,-108.07,6985.84
buyer_3,Ana,Piñeiro,1989-08-23,43610689K,ana.piñeiro@awesomenet.io,074110,ES50209546216055661299,7157.03,2023-03-14T12:29:31,Amurrio,expenses,leisure,-56.32,6929.52
buyer_3,Ana,Piñeiro,1989-08-23,43610689K,ana.piñeiro@awesomenet.io,074110,ES50209546216055661299,7157.03,2023-03-15T10:18:50,Amurrio,expenses,gifts,-543.55,6385.97
buyer_3,Ana,Piñeiro,1989-08-23,43610689K,ana.piñeiro@awesomenet.io,074110,ES50209546216055661299,7157.03,2023-03-16T00:34:26,Amurrio,expenses,leisure,-76.09,6309.88
buyer_3,Ana,Piñeiro,1989-08-23,43610689K,ana.piñeiro@awesomenet.io,074110,ES50209546216055661299,7157.03,2023-03-18T17:02:37,Amurrio,expenses,gifts,-211.13,6098.75
buyer_3,Ana,Piñeiro,1989-08-23,43610689K,ana.piñeiro@awesomenet.io,074110,ES50209546216055661299,7157.03,2023-03-22T19:48:22,Amurrio,expenses,food,-90.04,6008.71
buyer_3,Ana,Piñeiro,1989-08-23,43610689K,ana.piñeiro@awesomenet.io,074110,ES50209546216055661299,7157.03,2023-03-23T14:59:03,Amurrio,expenses,travel,-802.46,5206.25
buyer_3,Ana,Piñeiro,1989-08-23,43610689K,ana.piñeiro@awesomenet.io,074110,ES50209546216055661299,7157.03,2023-03-25T18:09:45,Amurrio,expenses,food,-92.88,5113.37
buyer_3,Ana,Piñeiro,1989-08-23,43610689K,ana.piñeiro@awesomenet.io,074110,ES50209546216055661299,7157.03,2023-03-27T20:54:31,Amurrio,expenses,food,-97.38,5015.99
buyer_3,Ana,Piñeiro,1989-08-23,43610689K,ana.piñeiro@awesomenet.io,074110,ES50209546216055661299,7157.03,2023-03-27T15:51:28,Amurrio,expenses,education,-57.45,4958.54
buyer_3,Ana,Piñeiro,1989-08-23,43610689K,ana.piñeiro@awesomenet.io,074110,ES50209546216055661299,7157.03,2023-03-28T05:27:09,Amurrio,expenses,transport,-60.65,4897.89
buyer_3,Ana,Piñeiro,1989-08-23,43610689K,ana.piñeiro@awesomenet.io,074110,ES50209546216055661299,7157.03,2023-03-29T11:21:43,Amurrio,expenses,repairs,-116.48,4781.41
buyer_3,Ana,Piñeiro,1989-08-23,43610689K,ana.piñeiro@awesomenet.io,074110,ES50209546216055661299,7157.03,2023-03-30T09:51:59,Amurrio,expenses,food,-71.39,4710.02
buyer_3,Ana,Piñeiro,1989-08-23,43610689K,ana.piñeiro@awesomenet.io,074110,ES50209546216055661299,7157.03,2023-03-30T10:17:46,Amurrio,expenses,gifts,-456.08,4253.94
buyer_3,Ana,Piñeiro,1989-08-23,43610689K,ana.piñeiro@awesomenet.io,074110,ES50209546216055661299,7157.03,2023-03-31T17:27:53,Amurrio,expenses,cash,-100.0,4153.94
buyer_3,Ana,Piñeiro,1989-08-23,43610689K,ana.piñeiro@awesomenet.io,074110,ES50209546216055661299,7157.03,2023-04-01T12:34:32,Amurrio,incomes,salary,3430.52,7584.46
buyer_3,Ana,Piñeiro,1989-08-23,43610689K,ana.piñeiro@awesomenet.io,074110,ES50209546216055661299,7157.03,2023-04-01T12:34:32,Amurrio,incomes,salary_partner,3177.54,10762.0
buyer_3,Ana,Piñeiro,1989-08-23,43610689K,ana.piñeiro@awesomenet.io,074110,ES50209546216055661299,7157.03,2023-04-02T12:35:24,Amurrio,expenses,healthcare,-159.02,10602.98
buyer_3,Ana,Piñeiro,1989-08-23,43610689K,ana.piñeiro@awesomenet.io,074110,ES50209546216055661299,7157.03,2023-04-04T18:43:44,Amurrio,expenses,mortgage,-2728.24,7874.74
buyer_3,Ana,Piñeiro,1989-08-23,43610689K,ana.piñeiro@awesomenet.io,074110,ES50209546216055661299,7157.03,2023-04-04T13:36:17,Amurrio,expenses,clothing,-116.76,7757.98
buyer_3,Ana,Piñeiro,1989-08-23,43610689K,ana.piñeiro@awesomenet.io,074110,ES50209546216055661299,7157.03,2023-04-05T21:07:13,Amurrio,expenses,phone,-126.04,7631.94
buyer_3,Ana,Piñeiro,1989-08-23,43610689K,ana.piñeiro@awesomenet.io,074110,ES50209546216055661299,7157.03,2023-04-05T19:10:08,Amurrio,expenses,food,-62.18,7569.76
buyer_3,Ana,Piñeiro,1989-08-23,43610689K,ana.piñeiro@awesomenet.io,074110,ES50209546216055661299,7157.03,2023-04-05T15:34:16,Amurrio,expenses,cash,-100.0,7469.76
buyer_3,Ana,Piñeiro,1989-08-23,43610689K,ana.piñeiro@awesomenet.io,074110,ES50209546216055661299,7157.03,2023-04-06T20:02:17,Amurrio,expenses,electricity,-228.62,7241.14
buyer_3,Ana,Piñeiro,1989-08-23,43610689K,ana.piñeiro@awesomenet.io,074110,ES50209546216055661299,7157.03,2023-04-06T01:13:32,Amurrio,expenses,food,-63.95,7177.19
buyer_3,Ana,Piñeiro,1989-08-23,43610689K,ana.piñeiro@awesomenet.io,074110,ES50209546216055661299,7157.03,2023-04-07T08:01:34,Amurrio,expenses,electricity,-139.41,7037.78
buyer_3,Ana,Piñeiro,1989-08-23,43610689K,ana.piñeiro@awesomenet.io,074110,ES50209546216055661299,7157.03,2023-04-07T10:51:51,Amurrio,expenses,transport,-60.15,6977.63
buyer_3,Ana,Piñeiro,1989-08-23,43610689K,ana.piñeiro@awesomenet.io,074110,ES50209546216055661299,7157.03,2023-04-08T17:58:11,Amurrio,expenses,electricity,-111.05,6866.58
buyer_3,Ana,Piñeiro,1989-08-23,43610689K,ana.piñeiro@awesomenet.io,074110,ES50209546216055661299,7157.03,2023-04-08T11:04:24,Amurrio,expenses,gas,-324.52,6542.06
buyer_3,Ana,Piñeiro,1989-08-23,43610689K,ana.piñeiro@awesomenet.io,074110,ES50209546216055661299,7157.03,2023-04-08T14:05:20,Amurrio,expenses,phone,-135.96,6406.1
buyer_3,Ana,Piñeiro,1989-08-23,43610689K,ana.piñeiro@awesomenet.io,074110,ES50209546216055661299,7157.03,2023-04-10T19:01:30,Amurrio,expenses,healthcare,-189.5,6216.6
buyer_3,Ana,Piñeiro,1989-08-23,43610689K,ana.piñeiro@awesomenet.io,074110,ES50209546216055661299,7157.03,2023-04-14T13:24:41,Amurrio,expenses,cash,-100.0,6116.6
buyer_3,Ana,Piñeiro,1989-08-23,43610689K,ana.piñeiro@awesomenet.io,074110,ES50209546216055661299,7157.03,2023-04-15T17:00:23,Amurrio,expenses,food,-76.17,6040.43
buyer_3,Ana,Piñeiro,1989-08-23,43610689K,ana.piñeiro@awesomenet.io,074110,ES50209546216055661299,7157.03,2023-04-15T08:47:37,Amurrio,expenses,cash,-100.0,5940.43
buyer_3,Ana,Piñeiro,1989-08-23,43610689K,ana.piñeiro@awesomenet.io,074110,ES50209546216055661299,7157.03,2023-04-16T12:05:58,Amurrio,expenses,education,-68.67,5871.76
buyer_3,Ana,Piñeiro,1989-08-23,43610689K,ana.piñeiro@awesomenet.io,074110,ES50209546216055661299,7157.03,2023-04-16T13:10:28,Amurrio,expenses,cash,-100.0,5771.76
buyer_3,Ana,Piñeiro,1989-08-23,43610689K,ana.piñeiro@awesomenet.io,074110,ES50209546216055661299,7157.03,2023-04-17T19:16:58,Amurrio,expenses,transport,-78.9,5692.86
buyer_3,Ana,Piñeiro,1989-08-23,43610689K,ana.piñeiro@awesomenet.io,074110,ES50209546216055661299,7157.03,2023-04-18T17:57:15,Amurrio,expenses,clothing,-95.14,5597.72
buyer_3,Ana,Piñeiro,1989-08-23,43610689K,ana.piñeiro@awesomenet.io,074110,ES50209546216055661299,7157.03,2023-04-19T20:29:28,Amurrio,expenses,food,-60.44,5537.28
buyer_3,Ana,Piñeiro,1989-08-23,43610689K,ana.piñeiro@awesomenet.io,074110,ES50209546216055661299,7157.03,2023-04-19T20:35:35,Amurrio,expenses,gifts,-558.61,4978.67
buyer_3,Ana,Piñeiro,1989-08-23,43610689K,ana.piñeiro@awesomenet.io,074110,ES50209546216055661299,7157.03,2023-04-20T20:38:15,Amurrio,expenses,transport,-63.52,4915.15
buyer_3,Ana,Piñeiro,1989-08-23,43610689K,ana.piñeiro@awesomenet.io,074110,ES50209546216055661299,7157.03,2023-04-20T15:27:53,Amurrio,expenses,leisure,-79.6,4835.55
buyer_3,Ana,Piñeiro,1989-08-23,43610689K,ana.piñeiro@awesomenet.io,074110,ES50209546216055661299,7157.03,2023-04-21T05:52:02,Amurrio,expenses,transport,-46.69,4788.86
buyer_3,Ana,Piñeiro,1989-08-23,43610689K,ana.piñeiro@awesomenet.io,074110,ES50209546216055661299,7157.03,2023-04-22T06:43:28,Amurrio,expenses,healthcare,-79.29,4709.57
buyer_3,Ana,Piñeiro,1989-08-23,43610689K,ana.piñeiro@awesomenet.io,074110,ES50209546216055661299,7157.03,2023-04-23T09:49:56,Amurrio,expenses,leisure,-31.13,4678.44
buyer_3,Ana,Piñeiro,1989-08-23,43610689K,ana.piñeiro@awesomenet.io,074110,ES50209546216055661299,7157.03,2023-04-23T23:56:23,Amurrio,expenses,cash,-100.0,4578.44
buyer_3,Ana,Piñeiro,1989-08-23,43610689K,ana.piñeiro@awesomenet.io,074110,ES50209546216055661299,7157.03,2023-04-24T14:33:50,Amurrio,expenses,cash,-100.0,4478.44
buyer_3,Ana,Piñeiro,1989-08-23,43610689K,ana.piñeiro@awesomenet.io,074110,ES50209546216055661299,7157.03,2023-04-25T17:03:53,Amurrio,expenses,healthcare,-146.48,4331.96
buyer_3,Ana,Piñeiro,1989-08-23,43610689K,ana.piñeiro@awesomenet.io,074110,ES50209546216055661299,7157.03,2023-04-25T21:09:44,Amurrio,expenses,cash,-100.0,4231.96
buyer_3,Ana,Piñeiro,1989-08-23,43610689K,ana.piñeiro@awesomenet.io,074110,ES50209546216055661299,7157.03,2023-04-26T15:36:49,Amurrio,expenses,cash,-100.0,4131.96
buyer_3,Ana,Piñeiro,1989-08-23,43610689K,ana.piñeiro@awesomenet.io,074110,ES50209546216055661299,7157.03,2023-04-28T10:23:10,Amurrio,expenses,transport,-52.07,4079.89
buyer_3,Ana,Piñeiro,1989-08-23,43610689K,ana.piñeiro@awesomenet.io,074110,ES50209546216055661299,7157.03,2023-04-28T19:54:29,Amurrio,expenses,travel,-471.52,3608.37
buyer_3,Ana,Piñeiro,1989-08-23,43610689K,ana.piñeiro@awesomenet.io,074110,ES50209546216055661299,7157.03,2023-04-30T12:23:19,Amurrio,expenses,cash,-100.0,3508.37
buyer_3,Ana,Piñeiro,1989-08-23,43610689K,ana.piñeiro@awesomenet.io,074110,ES50209546216055661299,7157.03,2023-05-01T22:54:38,Amurrio,incomes,salary,3430.52,6938.89
buyer_3,Ana,Piñeiro,1989-08-23,43610689K,ana.piñeiro@awesomenet.io,074110,ES50209546216055661299,7157.03,2023-05-01T22:54:38,Amurrio,incomes,salary_partner,3177.54,10116.43
buyer_3,Ana,Piñeiro,1989-08-23,43610689K,ana.piñeiro@awesomenet.io,074110,ES50209546216055661299,7157.03,2023-05-01T22:54:38,Amurrio,incomes,extra_income,346.04,10462.47
buyer_3,Ana,Piñeiro,1989-08-23,43610689K,ana.piñeiro@awesomenet.io,074110,ES50209546216055661299,7157.03,2023-05-01T19:18:29,Amurrio,expenses,leisure,-83.77,10378.7
buyer_3,Ana,Piñeiro,1989-08-23,43610689K,ana.piñeiro@awesomenet.io,074110,ES50209546216055661299,7157.03,2023-05-02T19:14:35,Amurrio,expenses,food,-117.0,10261.7
buyer_3,Ana,Piñeiro,1989-08-23,43610689K,ana.piñeiro@awesomenet.io,074110,ES50209546216055661299,7157.03,2023-05-02T11:04:30,Amurrio,expenses,cash,-100.0,10161.7
buyer_3,Ana,Piñeiro,1989-08-23,43610689K,ana.piñeiro@awesomenet.io,074110,ES50209546216055661299,7157.03,2023-05-02T15:25:33,Amurrio,expenses,gifts,-232.48,9929.22
buyer_3,Ana,Piñeiro,1989-08-23,43610689K,ana.piñeiro@awesomenet.io,074110,ES50209546216055661299,7157.03,2023-05-04T20:00:23,Amurrio,expenses,mortgage,-2728.24,7200.98
buyer_3,Ana,Piñeiro,1989-08-23,43610689K,ana.piñeiro@awesomenet.io,074110,ES50209546216055661299,7157.03,2023-05-06T15:13:47,Amurrio,expenses,gas,-326.88,6874.1
buyer_3,Ana,Piñeiro,1989-08-23,43610689K,ana.piñeiro@awesomenet.io,074110,ES50209546216055661299,7157.03,2023-05-06T14:42:04,Amurrio,expenses,cash,-100.0,6774.1
buyer_3,Ana,Piñeiro,1989-08-23,43610689K,ana.piñeiro@awesomenet.io,074110,ES50209546216055661299,7157.03,2023-05-07T08:23:14,Amurrio,expenses,water,-111.72,6662.38
buyer_3,Ana,Piñeiro,1989-08-23,43610689K,ana.piñeiro@awesomenet.io,074110,ES50209546216055661299,7157.03,2023-05-07T12:18:33,Amurrio,expenses,gas,-102.25,6560.13
buyer_3,Ana,Piñeiro,1989-08-23,43610689K,ana.piñeiro@awesomenet.io,074110,ES50209546216055661299,7157.03,2023-05-07T08:20:05,Amurrio,expenses,transport,-50.64,6509.49
buyer_3,Ana,Piñeiro,1989-08-23,43610689K,ana.piñeiro@awesomenet.io,074110,ES50209546216055661299,7157.03,2023-05-08T16:22:10,Amurrio,expenses,phone,-145.11,6364.38
buyer_3,Ana,Piñeiro,1989-08-23,43610689K,ana.piñeiro@awesomenet.io,074110,ES50209546216055661299,7157.03,2023-05-08T18:46:13,Amurrio,expenses,clothing,-109.51,6254.87
buyer_3,Ana,Piñeiro,1989-08-23,43610689K,ana.piñeiro@awesomenet.io,074110,ES50209546216055661299,7157.03,2023-05-12T21:24:59,Amurrio,expenses,healthcare,-155.72,6099.15
buyer_3,Ana,Piñeiro,1989-08-23,43610689K,ana.piñeiro@awesomenet.io,074110,ES50209546216055661299,7157.03,2023-05-12T14:09:23,Amurrio,expenses,appliances,-121.15,5978.0
buyer_3,Ana,Piñeiro,1989-08-23,43610689K,ana.piñeiro@awesomenet.io,074110,ES50209546216055661299,7157.03,2023-05-14T17:04:25,Amurrio,expenses,cash,-100.0,5878.0
buyer_3,Ana,Piñeiro,1989-08-23,43610689K,ana.piñeiro@awesomenet.io,074110,ES50209546216055661299,7157.03,2023-05-16T08:06:47,Amurrio,expenses,repairs,-164.93,5713.07
buyer_3,Ana,Piñeiro,1989-08-23,43610689K,ana.piñeiro@awesomenet.io,074110,ES50209546216055661299,7157.03,2023-05-17T19:34:10,Amurrio,expenses,cash,-100.0,5613.07
buyer_3,Ana,Piñeiro,1989-08-23,43610689K,ana.piñeiro@awesomenet.io,074110,ES50209546216055661299,7157.03,2023-05-17T13:33:31,Amurrio,expenses,gifts,-662.81,4950.26
buyer_3,Ana,Piñeiro,1989-08-23,43610689K,ana.piñeiro@awesomenet.io,074110,ES50209546216055661299,7157.03,2023-05-18T20:56:41,Amurrio,expenses,leisure,-70.54,4879.72
buyer_3,Ana,Piñeiro,1989-08-23,43610689K,ana.piñeiro@awesomenet.io,074110,ES50209546216055661299,7157.03,2023-05-20T09:11:46,Amurrio,expenses,transport,-51.03,4828.69
buyer_3,Ana,Piñeiro,1989-08-23,43610689K,ana.piñeiro@awesomenet.io,074110,ES50209546216055661299,7157.03,2023-05-20T12:00:41,Amurrio,expenses,cash,-100.0,4728.69
buyer_3,Ana,Piñeiro,1989-08-23,43610689K,ana.piñeiro@awesomenet.io,074110,ES50209546216055661299,7157.03,2023-05-20T11:25:24,Amurrio,expenses,travel,-693.88,4034.81
buyer_3,Ana,Piñeiro,1989-08-23,43610689K,ana.piñeiro@awesomenet.io,074110,ES50209546216055661299,7157.03,2023-05-22T22:21:47,Amurrio,expenses,leisure,-44.89,3989.92
buyer_3,Ana,Piñeiro,1989-08-23,43610689K,ana.piñeiro@awesomenet.io,074110,ES50209546216055661299,7157.03,2023-05-22T10:14:12,Amurrio,expenses,appliances,-257.1,3732.82
buyer_3,Ana,Piñeiro,1989-08-23,43610689K,ana.piñeiro@awesomenet.io,074110,ES50209546216055661299,7157.03,2023-05-24T23:09:10,Amurrio,expenses,leisure,-61.43,3671.39
buyer_3,Ana,Piñeiro,1989-08-23,43610689K,ana.piñeiro@awesomenet.io,074110,ES50209546216055661299,7157.03,2023-05-24T14:27:07,Amurrio,expenses,cash,-100.0,3571.39
buyer_3,Ana,Piñeiro,1989-08-23,43610689K,ana.piñeiro@awesomenet.io,074110,ES50209546216055661299,7157.03,2023-05-25T06:25:39,Amurrio,expenses,appliances,-366.45,3204.94
buyer_3,Ana,Piñeiro,1989-08-23,43610689K,ana.piñeiro@awesomenet.io,074110,ES50209546216055661299,7157.03,2023-05-26T16:53:24,Amurrio,expenses,transport,-66.67,3138.27
buyer_3,Ana,Piñeiro,1989-08-23,43610689K,ana.piñeiro@awesomenet.io,074110,ES50209546216055661299,7157.03,2023-05-27T10:50:07,Amurrio,expenses,transport,-48.52,3089.75
buyer_3,Ana,Piñeiro,1989-08-23,43610689K,ana.piñeiro@awesomenet.io,074110,ES50209546216055661299,7157.03,2023-05-27T17:15:40,Amurrio,expenses,clothing,-97.95,2991.8
buyer_3,Ana,Piñeiro,1989-08-23,43610689K,ana.piñeiro@awesomenet.io,074110,ES50209546216055661299,7157.03,2023-05-28T19:32:42,Amurrio,expenses,repairs,-197.59,2794.21
buyer_3,Ana,Piñeiro,1989-08-23,43610689K,ana.piñeiro@awesomenet.io,074110,ES50209546216055661299,7157.03,2023-05-29T18:08:58,Amurrio,expenses,food,-122.4,2671.81
buyer_3,Ana,Piñeiro,1989-08-23,43610689K,ana.piñeiro@awesomenet.io,074110,ES50209546216055661299,7157.03,2023-05-29T08:33:39,Amurrio,expenses,cash,-100.0,2571.81
buyer_3,Ana,Piñeiro,1989-08-23,43610689K,ana.piñeiro@awesomenet.io,074110,ES50209546216055661299,7157.03,2023-05-30T03:09:39,Amurrio,expenses,education,-54.93,2516.88
buyer_3,Ana,Piñeiro,1989-08-23,43610689K,ana.piñeiro@awesomenet.io,074110,ES50209546216055661299,7157.03,2023-05-31T11:46:58,Amurrio,expenses,food,-88.35,2428.53
buyer_3,Ana,Piñeiro,1989-08-23,43610689K,ana.piñeiro@awesomenet.io,074110,ES50209546216055661299,7157.03,2023-05-31T16:05:56,Amurrio,expenses,clothing,-62.54,2365.99
buyer_3,Ana,Piñeiro,1989-08-23,43610689K,ana.piñeiro@awesomenet.io,074110,ES50209546216055661299,7157.03,2023-06-01T10:15:32,Amurrio,incomes,salary,3430.52,5796.51
buyer_3,Ana,Piñeiro,1989-08-23,43610689K,ana.piñeiro@awesomenet.io,074110,ES50209546216055661299,7157.03,2023-06-01T10:15:32,Amurrio,incomes,salary_partner,3177.54,8974.05
buyer_3,Ana,Piñeiro,1989-08-23,43610689K,ana.piñeiro@awesomenet.io,074110,ES50209546216055661299,7157.03,2023-06-01T10:15:32,Amurrio,incomes,salary_bonus,2732.06,11706.11
buyer_3,Ana,Piñeiro,1989-08-23,43610689K,ana.piñeiro@awesomenet.io,074110,ES50209546216055661299,7157.03,2023-06-01T10:15:32,Amurrio,incomes,salary_partner_bonus,2305.73,14011.84
buyer_3,Ana,Piñeiro,1989-08-23,43610689K,ana.piñeiro@awesomenet.io,074110,ES50209546216055661299,7157.03,2023-06-01T19:18:24,Amurrio,expenses,taxes,-5198.87,8812.97
buyer_3,Ana,Piñeiro,1989-08-23,43610689K,ana.piñeiro@awesomenet.io,074110,ES50209546216055661299,7157.03,2023-06-01T11:56:48,Amurrio,expenses,insurance,-1762.67,7050.3
buyer_3,Ana,Piñeiro,1989-08-23,43610689K,ana.piñeiro@awesomenet.io,074110,ES50209546216055661299,7157.03,2023-06-01T09:03:32,Amurrio,expenses,clothing,-105.73,6944.57
buyer_3,Ana,Piñeiro,1989-08-23,43610689K,ana.piñeiro@awesomenet.io,074110,ES50209546216055661299,7157.03,2023-06-03T10:53:46,Amurrio,expenses,leisure,-42.59,6901.98
buyer_3,Ana,Piñeiro,1989-08-23,43610689K,ana.piñeiro@awesomenet.io,074110,ES50209546216055661299,7157.03,2023-06-04T16:35:18,Amurrio,expenses,mortgage,-2728.24,4173.74
buyer_3,Ana,Piñeiro,1989-08-23,43610689K,ana.piñeiro@awesomenet.io,074110,ES50209546216055661299,7157.03,2023-06-04T17:38:11,Amurrio,expenses,education,-65.36,4108.38
buyer_3,Ana,Piñeiro,1989-08-23,43610689K,ana.piñeiro@awesomenet.io,074110,ES50209546216055661299,7157.03,2023-06-05T13:38:30,Amurrio,expenses,electricity,-130.44,3977.94
buyer_3,Ana,Piñeiro,1989-08-23,43610689K,ana.piñeiro@awesomenet.io,074110,ES50209546216055661299,7157.03,2023-06-05T18:18:02,Amurrio,expenses,internet,-138.77,3839.17
buyer_3,Ana,Piñeiro,1989-08-23,43610689K,ana.piñeiro@awesomenet.io,074110,ES50209546216055661299,7157.03,2023-06-05T23:45:52,Amurrio,expenses,phone,-144.18,3694.99
buyer_3,Ana,Piñeiro,1989-08-23,43610689K,ana.piñeiro@awesomenet.io,074110,ES50209546216055661299,7157.03,2023-06-05T14:58:11,Amurrio,expenses,food,-84.31,3610.68
buyer_3,Ana,Piñeiro,1989-08-23,43610689K,ana.piñeiro@awesomenet.io,074110,ES50209546216055661299,7157.03,2023-06-05T21:32:42,Amurrio,expenses,clothing,-77.56,3533.12
buyer_3,Ana,Piñeiro,1989-08-23,43610689K,ana.piñeiro@awesomenet.io,074110,ES50209546216055661299,7157.03,2023-06-06T09:27:11,Amurrio,expenses,water,-104.66,3428.46
buyer_3,Ana,Piñeiro,1989-08-23,43610689K,ana.piñeiro@awesomenet.io,074110,ES50209546216055661299,7157.03,2023-06-06T16:13:45,Amurrio,expenses,internet,-138.77,3289.69
buyer_3,Ana,Piñeiro,1989-08-23,43610689K,ana.piñeiro@awesomenet.io,074110,ES50209546216055661299,7157.03,2023-06-07T11:07:06,Amurrio,expenses,electricity,-130.13,3159.56
buyer_3,Ana,Piñeiro,1989-08-23,43610689K,ana.piñeiro@awesomenet.io,074110,ES50209546216055661299,7157.03,2023-06-07T23:16:14,Amurrio,expenses,gas,-327.21,2832.35
buyer_3,Ana,Piñeiro,1989-08-23,43610689K,ana.piñeiro@awesomenet.io,074110,ES50209546216055661299,7157.03,2023-06-07T10:21:54,Amurrio,expenses,leisure,-33.95,2798.4
buyer_3,Ana,Piñeiro,1989-08-23,43610689K,ana.piñeiro@awesomenet.io,074110,ES50209546216055661299,7157.03,2023-06-07T11:31:34,Amurrio,expenses,gifts,-208.45,2589.95
buyer_3,Ana,Piñeiro,1989-08-23,43610689K,ana.piñeiro@awesomenet.io,074110,ES50209546216055661299,7157.03,2023-06-08T18:28:23,Amurrio,expenses,water,-112.01,2477.94
buyer_3,Ana,Piñeiro,1989-08-23,43610689K,ana.piñeiro@awesomenet.io,074110,ES50209546216055661299,7157.03,2023-06-08T16:49:55,Amurrio,expenses,electricity,-278.35,2199.59
buyer_3,Ana,Piñeiro,1989-08-23,43610689K,ana.piñeiro@awesomenet.io,074110,ES50209546216055661299,7157.03,2023-06-08T17:52:10,Amurrio,expenses,internet,-138.77,2060.82
buyer_3,Ana,Piñeiro,1989-08-23,43610689K,ana.piñeiro@awesomenet.io,074110,ES50209546216055661299,7157.03,2023-06-08T23:59:37,Amurrio,expenses,cash,-100.0,1960.82
buyer_3,Ana,Piñeiro,1989-08-23,43610689K,ana.piñeiro@awesomenet.io,074110,ES50209546216055661299,7157.03,2023-06-11T03:49:21,Amurrio,expenses,food,-122.45,1838.37
buyer_3,Ana,Piñeiro,1989-08-23,43610689K,ana.piñeiro@awesomenet.io,074110,ES50209546216055661299,7157.03,2023-06-12T12:02:52,Amurrio,expenses,food,-72.25,1766.12
buyer_3,Ana,Piñeiro,1989-08-23,43610689K,ana.piñeiro@awesomenet.io,074110,ES50209546216055661299,7157.03,2023-06-12T11:32:30,Amurrio,expenses,transport,-65.5,1700.62
buyer_3,Ana,Piñeiro,1989-08-23,43610689K,ana.piñeiro@awesomenet.io,074110,ES50209546216055661299,7157.03,2023-06-14T17:08:18,Amurrio,expenses,food,-120.85,1579.77
buyer_3,Ana,Piñeiro,1989-08-23,43610689K,ana.piñeiro@awesomenet.io,074110,ES50209546216055661299,7157.03,2023-06-15T19:59:26,Amurrio,expenses,transport,-66.0,1513.77
buyer_3,Ana,Piñeiro,1989-08-23,43610689K,ana.piñeiro@awesomenet.io,074110,ES50209546216055661299,7157.03,2023-06-15T21:20:04,Amurrio,expenses,leisure,-73.68,1440.09
buyer_3,Ana,Piñeiro,1989-08-23,43610689K,ana.piñeiro@awesomenet.io,074110,ES50209546216055661299,7157.03,2023-06-16T23:22:16,Amurrio,expenses,leisure,-82.04,1358.05
buyer_3,Ana,Piñeiro,1989-08-23,43610689K,ana.piñeiro@awesomenet.io,074110,ES50209546216055661299,7157.03,2023-06-16T16:42:51,Amurrio,expenses,education,-73.58,1284.47
buyer_3,Ana,Piñeiro,1989-08-23,43610689K,ana.piñeiro@awesomenet.io,074110,ES50209546216055661299,7157.03,2023-06-16T18:17:40,Amurrio,expenses,cash,-100.0,1184.47
buyer_3,Ana,Piñeiro,1989-08-23,43610689K,ana.piñeiro@awesomenet.io,074110,ES50209546216055661299,7157.03,2023-06-17T04:52:31,Amurrio,expenses,transport,-61.55,1122.92
buyer_3,Ana,Piñeiro,1989-08-23,43610689K,ana.piñeiro@awesomenet.io,074110,ES50209546216055661299,7157.03,2023-06-21T12:12:26,Amurrio,expenses,transport,-40.21,1082.71
buyer_3,Ana,Piñeiro,1989-08-23,43610689K,ana.piñeiro@awesomenet.io,074110,ES50209546216055661299,7157.03,2023-06-22T17:45:27,Amurrio,expenses,leisure,-68.56,1014.15
buyer_3,Ana,Piñeiro,1989-08-23,43610689K,ana.piñeiro@awesomenet.io,074110,ES50209546216055661299,7157.03,2023-06-22T12:04:50,Amurrio,expenses,gifts,-567.38,446.77
buyer_3,Ana,Piñeiro,1989-08-23,43610689K,ana.piñeiro@awesomenet.io,074110,ES50209546216055661299,7157.03,2023-06-23T12:56:08,Amurrio,expenses,clothing,-82.58,364.19
buyer_3,Ana,Piñeiro,1989-08-23,43610689K,ana.piñeiro@awesomenet.io,074110,ES50209546216055661299,7157.03,2023-06-24T23:44:22,Amurrio,expenses,cash,-100.0,264.19
buyer_3,Ana,Piñeiro,1989-08-23,43610689K,ana.piñeiro@awesomenet.io,074110,ES50209546216055661299,7157.03,2023-06-25T15:14:51,Amurrio,expenses,appliances,-99.76,164.43
buyer_3,Ana,Piñeiro,1989-08-23,43610689K,ana.piñeiro@awesomenet.io,074110,ES50209546216055661299,7157.03,2023-06-26T11:41:28,Amurrio,expenses,transport,-65.44,98.99
buyer_3,Ana,Piñeiro,1989-08-23,43610689K,ana.piñeiro@awesomenet.io,074110,ES50209546216055661299,7157.03,2023-06-26T16:28:20,Amurrio,expenses,healthcare,-50.74,48.25
buyer_3,Ana,Piñeiro,1989-08-23,43610689K,ana.piñeiro@awesomenet.io,074110,ES50209546216055661299,7157.03,2023-06-28T11:04:19,Amurrio,expenses,cash,-100.0,-51.75
buyer_3,Ana,Piñeiro,1989-08-23,43610689K,ana.piñeiro@awesomenet.io,074110,ES50209546216055661299,7157.03,2023-06-28T19:22:06,Amurrio,expenses,travel,-582.85,-634.6
buyer_3,Ana,Piñeiro,1989-08-23,43610689K,ana.piñeiro@awesomenet.io,074110,ES50209546216055661299,7157.03,2023-06-29T20:54:48,Amurrio,expenses,cash,-100.0,-734.6
buyer_3,Ana,Piñeiro,1989-08-23,43610689K,ana.piñeiro@awesomenet.io,074110,ES50209546216055661299,7157.03,2023-06-30T13:12:09,Amurrio,expenses,food,-81.22,-815.82
buyer_3,Ana,Piñeiro,1989-08-23,43610689K,ana.piñeiro@awesomenet.io,074110,ES50209546216055661299,7157.03,2023-06-30T15:02:13,Amurrio,expenses,cash,-100.0,-915.82
buyer_3,Ana,Piñeiro,1989-08-23,43610689K,ana.piñeiro@awesomenet.io,074110,ES50209546216055661299,7157.03,2023-07-01T12:21:22,Amurrio,incomes,salary,3430.52,2514.7
buyer_3,Ana,Piñeiro,1989-08-23,43610689K,ana.piñeiro@awesomenet.io,074110,ES50209546216055661299,7157.03,2023-07-01T12:21:22,Amurrio,incomes,salary_partner,3177.54,5692.24
buyer_3,Ana,Piñeiro,1989-08-23,43610689K,ana.piñeiro@awesomenet.io,074110,ES50209546216055661299,7157.03,2023-07-04T08:40:34,Amurrio,expenses,mortgage,-2728.24,2964.0
buyer_3,Ana,Piñeiro,1989-08-23,43610689K,ana.piñeiro@awesomenet.io,074110,ES50209546216055661299,7157.03,2023-07-04T12:32:03,Amurrio,expenses,food,-65.56,2898.44
buyer_3,Ana,Piñeiro,1989-08-23,43610689K,ana.piñeiro@awesomenet.io,074110,ES50209546216055661299,7157.03,2023-07-04T17:13:04,Amurrio,expenses,cash,-100.0,2798.44
buyer_3,Ana,Piñeiro,1989-08-23,43610689K,ana.piñeiro@awesomenet.io,074110,ES50209546216055661299,7157.03,2023-07-05T14:31:04,Amurrio,expenses,water,-107.79,2690.65
buyer_3,Ana,Piñeiro,1989-08-23,43610689K,ana.piñeiro@awesomenet.io,074110,ES50209546216055661299,7157.03,2023-07-06T20:29:31,Amurrio,expenses,food,-104.31,2586.34
buyer_3,Ana,Piñeiro,1989-08-23,43610689K,ana.piñeiro@awesomenet.io,074110,ES50209546216055661299,7157.03,2023-07-07T21:28:28,Amurrio,expenses,water,-81.24,2505.1
buyer_3,Ana,Piñeiro,1989-08-23,43610689K,ana.piñeiro@awesomenet.io,074110,ES50209546216055661299,7157.03,2023-07-07T04:46:27,Amurrio,expenses,gas,-334.95,2170.15
buyer_3,Ana,Piñeiro,1989-08-23,43610689K,ana.piñeiro@awesomenet.io,074110,ES50209546216055661299,7157.03,2023-07-07T11:08:44,Amurrio,expenses,food,-76.35,2093.8
buyer_3,Ana,Piñeiro,1989-08-23,43610689K,ana.piñeiro@awesomenet.io,074110,ES50209546216055661299,7157.03,2023-07-07T11:29:35,Amurrio,expenses,clothing,-67.45,2026.35
buyer_3,Ana,Piñeiro,1989-08-23,43610689K,ana.piñeiro@awesomenet.io,074110,ES50209546216055661299,7157.03,2023-07-07T02:28:10,Amurrio,expenses,appliances,-194.19,1832.16
buyer_3,Ana,Piñeiro,1989-08-23,43610689K,ana.piñeiro@awesomenet.io,074110,ES50209546216055661299,7157.03,2023-07-08T15:51:10,Amurrio,expenses,water,-118.02,1714.14
buyer_3,Ana,Piñeiro,1989-08-23,43610689K,ana.piñeiro@awesomenet.io,074110,ES50209546216055661299,7157.03,2023-07-08T21:55:13,Amurrio,expenses,electricity,-208.18,1505.96
buyer_3,Ana,Piñeiro,1989-08-23,43610689K,ana.piñeiro@awesomenet.io,074110,ES50209546216055661299,7157.03,2023-07-08T13:08:16,Amurrio,expenses,appliances,-389.47,1116.49
buyer_3,Ana,Piñeiro,1989-08-23,43610689K,ana.piñeiro@awesomenet.io,074110,ES50209546216055661299,7157.03,2023-07-13T19:26:19,Amurrio,expenses,transport,-62.4,1054.09
buyer_3,Ana,Piñeiro,1989-08-23,43610689K,ana.piñeiro@awesomenet.io,074110,ES50209546216055661299,7157.03,2023-07-13T13:16:27,Amurrio,expenses,cash,-100.0,954.09
buyer_3,Ana,Piñeiro,1989-08-23,43610689K,ana.piñeiro@awesomenet.io,074110,ES50209546216055661299,7157.03,2023-07-14T22:57:41,Amurrio,expenses,food,-115.97,838.12
buyer_3,Ana,Piñeiro,1989-08-23,43610689K,ana.piñeiro@awesomenet.io,074110,ES50209546216055661299,7157.03,2023-07-14T05:48:18,Amurrio,expenses,cash,-100.0,738.12
buyer_3,Ana,Piñeiro,1989-08-23,43610689K,ana.piñeiro@awesomenet.io,074110,ES50209546216055661299,7157.03,2023-07-19T16:18:00,Amurrio,expenses,repairs,-310.43,427.69
buyer_3,Ana,Piñeiro,1989-08-23,43610689K,ana.piñeiro@awesomenet.io,074110,ES50209546216055661299,7157.03,2023-07-19T11:12:30,Amurrio,expenses,gifts,-586.45,-158.76
buyer_3,Ana,Piñeiro,1989-08-23,43610689K,ana.piñeiro@awesomenet.io,074110,ES50209546216055661299,7157.03,2023-07-20T12:10:06,Amurrio,expenses,repairs,-153.11,-311.87
buyer_3,Ana,Piñeiro,1989-08-23,43610689K,ana.piñeiro@awesomenet.io,074110,ES50209546216055661299,7157.03,2023-07-22T15:57:56,Amurrio,expenses,transport,-40.18,-352.05
buyer_3,Ana,Piñeiro,1989-08-23,43610689K,ana.piñeiro@awesomenet.io,074110,ES50209546216055661299,7157.03,2023-07-22T20:55:28,Amurrio,expenses,gifts,-849.24,-1201.29
buyer_3,Ana,Piñeiro,1989-08-23,43610689K,ana.piñeiro@awesomenet.io,074110,ES50209546216055661299,7157.03,2023-07-23T10:34:11,Amurrio,expenses,clothing,-159.87,-1361.16
buyer_3,Ana,Piñeiro,1989-08-23,43610689K,ana.piñeiro@awesomenet.io,074110,ES50209546216055661299,7157.03,2023-07-24T12:22:12,Amurrio,expenses,food,-122.44,-1483.6
buyer_3,Ana,Piñeiro,1989-08-23,43610689K,ana.piñeiro@awesomenet.io,074110,ES50209546216055661299,7157.03,2023-07-25T13:05:09,Amurrio,expenses,transport,-69.05,-1552.65
buyer_3,Ana,Piñeiro,1989-08-23,43610689K,ana.piñeiro@awesomenet.io,074110,ES50209546216055661299,7157.03,2023-07-25T03:31:52,Amurrio,expenses,cash,-100.0,-1652.65
buyer_3,Ana,Piñeiro,1989-08-23,43610689K,ana.piñeiro@awesomenet.io,074110,ES50209546216055661299,7157.03,2023-07-27T19:18:36,Amurrio,expenses,cash,-100.0,-1752.65
buyer_3,Ana,Piñeiro,1989-08-23,43610689K,ana.piñeiro@awesomenet.io,074110,ES50209546216055661299,7157.03,2023-07-29T12:03:21,Amurrio,expenses,leisure,-84.59,-1837.24
buyer_3,Ana,Piñeiro,1989-08-23,43610689K,ana.piñeiro@awesomenet.io,074110,ES50209546216055661299,7157.03,2023-07-30T04:05:58,Amurrio,expenses,cash,-100.0,-1937.24
buyer_3,Ana,Piñeiro,1989-08-23,43610689K,ana.piñeiro@awesomenet.io,074110,ES50209546216055661299,7157.03,2023-07-30T19:30:59,Amurrio,expenses,repairs,-236.14,-2173.38
buyer_3,Ana,Piñeiro,1989-08-23,43610689K,ana.piñeiro@awesomenet.io,074110,ES50209546216055661299,7157.03,2023-08-01T19:48:03,Amurrio,incomes,salary,3430.52,1257.14
buyer_3,Ana,Piñeiro,1989-08-23,43610689K,ana.piñeiro@awesomenet.io,074110,ES50209546216055661299,7157.03,2023-08-01T19:48:03,Amurrio,incomes,salary_partner,3177.54,4434.68
buyer_3,Ana,Piñeiro,1989-08-23,43610689K,ana.piñeiro@awesomenet.io,074110,ES50209546216055661299,7157.03,2023-08-01T19:48:03,Amurrio,incomes,extra_income,346.04,4780.72
buyer_3,Ana,Piñeiro,1989-08-23,43610689K,ana.piñeiro@awesomenet.io,074110,ES50209546216055661299,7157.03,2023-08-02T11:08:39,Amurrio,expenses,gifts,-222.03,4558.69
buyer_3,Ana,Piñeiro,1989-08-23,43610689K,ana.piñeiro@awesomenet.io,074110,ES50209546216055661299,7157.03,2023-08-04T13:11:18,Amurrio,expenses,mortgage,-2728.24,1830.45
buyer_3,Ana,Piñeiro,1989-08-23,43610689K,ana.piñeiro@awesomenet.io,074110,ES50209546216055661299,7157.03,2023-08-05T15:01:11,Amurrio,expenses,food,-101.9,1728.55
buyer_3,Ana,Piñeiro,1989-08-23,43610689K,ana.piñeiro@awesomenet.io,074110,ES50209546216055661299,7157.03,2023-08-05T19:44:10,Amurrio,expenses,education,-49.9,1678.65
buyer_3,Ana,Piñeiro,1989-08-23,43610689K,ana.piñeiro@awesomenet.io,074110,ES50209546216055661299,7157.03,2023-08-05T11:29:05,Amurrio,expenses,repairs,-227.87,1450.78
buyer_3,Ana,Piñeiro,1989-08-23,43610689K,ana.piñeiro@awesomenet.io,074110,ES50209546216055661299,7157.03,2023-08-06T20:49:24,Amurrio,expenses,internet,-138.77,1312.01
buyer_3,Ana,Piñeiro,1989-08-23,43610689K,ana.piñeiro@awesomenet.io,074110,ES50209546216055661299,7157.03,2023-08-06T13:15:35,Amurrio,expenses,phone,-145.92,1166.09
buyer_3,Ana,Piñeiro,1989-08-23,43610689K,ana.piñeiro@awesomenet.io,074110,ES50209546216055661299,7157.03,2023-08-07T23:01:51,Amurrio,expenses,internet,-138.77,1027.32
buyer_3,Ana,Piñeiro,1989-08-23,43610689K,ana.piñeiro@awesomenet.io,074110,ES50209546216055661299,7157.03,2023-08-07T11:30:56,Amurrio,expenses,cash,-100.0,927.32
buyer_3,Ana,Piñeiro,1989-08-23,43610689K,ana.piñeiro@awesomenet.io,074110,ES50209546216055661299,7157.03,2023-08-08T09:26:42,Amurrio,expenses,phone,-110.83,816.49
buyer_3,Ana,Piñeiro,1989-08-23,43610689K,ana.piñeiro@awesomenet.io,074110,ES50209546216055661299,7157.03,2023-08-08T19:28:47,Amurrio,expenses,food,-74.46,742.03
buyer_3,Ana,Piñeiro,1989-08-23,43610689K,ana.piñeiro@awesomenet.io,074110,ES50209546216055661299,7157.03,2023-08-09T15:37:03,Amurrio,expenses,repairs,-79.99,662.04
buyer_3,Ana,Piñeiro,1989-08-23,43610689K,ana.piñeiro@awesomenet.io,074110,ES50209546216055661299,7157.03,2023-08-10T14:03:53,Amurrio,expenses,food,-60.84,601.2
buyer_3,Ana,Piñeiro,1989-08-23,43610689K,ana.piñeiro@awesomenet.io,074110,ES50209546216055661299,7157.03,2023-08-14T10:47:34,Amurrio,expenses,food,-108.13,493.07
buyer_3,Ana,Piñeiro,1989-08-23,43610689K,ana.piñeiro@awesomenet.io,074110,ES50209546216055661299,7157.03,2023-08-15T23:57:29,Amurrio,expenses,food,-66.46,426.61
buyer_3,Ana,Piñeiro,1989-08-23,43610689K,ana.piñeiro@awesomenet.io,074110,ES50209546216055661299,7157.03,2023-08-17T09:11:58,Amurrio,expenses,food,-87.23,339.38
buyer_3,Ana,Piñeiro,1989-08-23,43610689K,ana.piñeiro@awesomenet.io,074110,ES50209546216055661299,7157.03,2023-08-18T08:11:24,Amurrio,expenses,food,-119.81,219.57
buyer_3,Ana,Piñeiro,1989-08-23,43610689K,ana.piñeiro@awesomenet.io,074110,ES50209546216055661299,7157.03,2023-08-19T02:43:06,Amurrio,expenses,healthcare,-169.21,50.36
buyer_3,Ana,Piñeiro,1989-08-23,43610689K,ana.piñeiro@awesomenet.io,074110,ES50209546216055661299,7157.03,2023-08-20T15:58:50,Amurrio,expenses,food,-72.47,-22.11
buyer_3,Ana,Piñeiro,1989-08-23,43610689K,ana.piñeiro@awesomenet.io,074110,ES50209546216055661299,7157.03,2023-08-20T11:28:40,Amurrio,expenses,transport,-40.34,-62.45
buyer_3,Ana,Piñeiro,1989-08-23,43610689K,ana.piñeiro@awesomenet.io,074110,ES50209546216055661299,7157.03,2023-08-23T10:22:44,Amurrio,expenses,repairs,-157.98,-220.43
buyer_3,Ana,Piñeiro,1989-08-23,43610689K,ana.piñeiro@awesomenet.io,074110,ES50209546216055661299,7157.03,2023-08-26T15:41:49,Amurrio,expenses,transport,-60.94,-281.37
buyer_3,Ana,Piñeiro,1989-08-23,43610689K,ana.piñeiro@awesomenet.io,074110,ES50209546216055661299,7157.03,2023-08-26T10:12:31,Amurrio,expenses,leisure,-27.5,-308.87
buyer_3,Ana,Piñeiro,1989-08-23,43610689K,ana.piñeiro@awesomenet.io,074110,ES50209546216055661299,7157.03,2023-08-26T15:28:14,Amurrio,expenses,repairs,-256.03,-564.9
buyer_3,Ana,Piñeiro,1989-08-23,43610689K,ana.piñeiro@awesomenet.io,074110,ES50209546216055661299,7157.03,2023-08-27T20:13:57,Amurrio,expenses,food,-115.41,-680.31
buyer_3,Ana,Piñeiro,1989-08-23,43610689K,ana.piñeiro@awesomenet.io,074110,ES50209546216055661299,7157.03,2023-08-28T08:12:10,Amurrio,expenses,cash,-100.0,-780.31
buyer_3,Ana,Piñeiro,1989-08-23,43610689K,ana.piñeiro@awesomenet.io,074110,ES50209546216055661299,7157.03,2023-08-30T19:09:16,Amurrio,expenses,clothing,-142.79,-923.1
buyer_3,Ana,Piñeiro,1989-08-23,43610689K,ana.piñeiro@awesomenet.io,074110,ES50209546216055661299,7157.03,2023-09-01T16:46:54,Amurrio,incomes,salary,3430.52,2507.42
buyer_3,Ana,Piñeiro,1989-08-23,43610689K,ana.piñeiro@awesomenet.io,074110,ES50209546216055661299,7157.03,2023-09-01T16:46:54,Amurrio,incomes,salary_partner,3177.54,5684.96
buyer_3,Ana,Piñeiro,1989-08-23,43610689K,ana.piñeiro@awesomenet.io,074110,ES50209546216055661299,7157.03,2023-09-02T12:19:32,Amurrio,expenses,leisure,-76.89,5608.07
buyer_3,Ana,Piñeiro,1989-08-23,43610689K,ana.piñeiro@awesomenet.io,074110,ES50209546216055661299,7157.03,2023-09-02T14:51:01,Amurrio,expenses,cash,-100.0,5508.07
buyer_3,Ana,Piñeiro,1989-08-23,43610689K,ana.piñeiro@awesomenet.io,074110,ES50209546216055661299,7157.03,2023-09-04T12:47:35,Amurrio,expenses,mortgage,-2728.24,2779.83
buyer_3,Ana,Piñeiro,1989-08-23,43610689K,ana.piñeiro@awesomenet.io,074110,ES50209546216055661299,7157.03,2023-09-04T21:03:05,Amurrio,expenses,cash,-100.0,2679.83
buyer_3,Ana,Piñeiro,1989-08-23,43610689K,ana.piñeiro@awesomenet.io,074110,ES50209546216055661299,7157.03,2023-09-04T14:03:02,Amurrio,expenses,gifts,-145.85,2533.98
buyer_3,Ana,Piñeiro,1989-08-23,43610689K,ana.piñeiro@awesomenet.io,074110,ES50209546216055661299,7157.03,2023-09-05T22:06:46,Amurrio,expenses,phone,-130.56,2403.42
buyer_3,Ana,Piñeiro,1989-08-23,43610689K,ana.piñeiro@awesomenet.io,074110,ES50209546216055661299,7157.03,2023-09-06T22:54:27,Amurrio,expenses,water,-118.94,2284.48
buyer_3,Ana,Piñeiro,1989-08-23,43610689K,ana.piñeiro@awesomenet.io,074110,ES50209546216055661299,7157.03,2023-09-06T21:17:26,Amurrio,expenses,gas,-220.45,2064.03
buyer_3,Ana,Piñeiro,1989-08-23,43610689K,ana.piñeiro@awesomenet.io,074110,ES50209546216055661299,7157.03,2023-09-06T08:21:27,Amurrio,expenses,cash,-100.0,1964.03
buyer_3,Ana,Piñeiro,1989-08-23,43610689K,ana.piñeiro@awesomenet.io,074110,ES50209546216055661299,7157.03,2023-09-07T19:55:47,Amurrio,expenses,electricity,-215.29,1748.74
buyer_3,Ana,Piñeiro,1989-08-23,43610689K,ana.piñeiro@awesomenet.io,074110,ES50209546216055661299,7157.03,2023-09-07T17:52:23,Amurrio,expenses,cash,-100.0,1648.74
buyer_3,Ana,Piñeiro,1989-08-23,43610689K,ana.piñeiro@awesomenet.io,074110,ES50209546216055661299,7157.03,2023-09-08T15:28:39,Amurrio,expenses,gifts,-656.38,992.36
buyer_3,Ana,Piñeiro,1989-08-23,43610689K,ana.piñeiro@awesomenet.io,074110,ES50209546216055661299,7157.03,2023-09-11T21:06:49,Amurrio,expenses,repairs,-301.94,690.42
buyer_3,Ana,Piñeiro,1989-08-23,43610689K,ana.piñeiro@awesomenet.io,074110,ES50209546216055661299,7157.03,2023-09-11T16:58:02,Amurrio,expenses,gifts,-352.47,337.95
buyer_3,Ana,Piñeiro,1989-08-23,43610689K,ana.piñeiro@awesomenet.io,074110,ES50209546216055661299,7157.03,2023-09-12T08:48:49,Amurrio,expenses,food,-60.61,277.34
buyer_3,Ana,Piñeiro,1989-08-23,43610689K,ana.piñeiro@awesomenet.io,074110,ES50209546216055661299,7157.03,2023-09-13T10:17:45,Amurrio,expenses,cash,-100.0,177.34
buyer_3,Ana,Piñeiro,1989-08-23,43610689K,ana.piñeiro@awesomenet.io,074110,ES50209546216055661299,7157.03,2023-09-14T09:28:02,Amurrio,expenses,transport,-67.47,109.87
buyer_3,Ana,Piñeiro,1989-08-23,43610689K,ana.piñeiro@awesomenet.io,074110,ES50209546216055661299,7157.03,2023-09-14T20:45:55,Amurrio,expenses,appliances,-361.84,-251.97
buyer_3,Ana,Piñeiro,1989-08-23,43610689K,ana.piñeiro@awesomenet.io,074110,ES50209546216055661299,7157.03,2023-09-15T08:50:13,Amurrio,expenses,repairs,-273.69,-525.66
buyer_3,Ana,Piñeiro,1989-08-23,43610689K,ana.piñeiro@awesomenet.io,074110,ES50209546216055661299,7157.03,2023-09-15T19:25:48,Amurrio,expenses,gifts,-763.4,-1289.06
buyer_3,Ana,Piñeiro,1989-08-23,43610689K,ana.piñeiro@awesomenet.io,074110,ES50209546216055661299,7157.03,2023-09-16T09:15:19,Amurrio,expenses,leisure,-41.82,-1330.88
buyer_3,Ana,Piñeiro,1989-08-23,43610689K,ana.piñeiro@awesomenet.io,074110,ES50209546216055661299,7157.03,2023-09-16T04:38:50,Amurrio,expenses,cash,-100.0,-1430.88
buyer_3,Ana,Piñeiro,1989-08-23,43610689K,ana.piñeiro@awesomenet.io,074110,ES50209546216055661299,7157.03,2023-09-17T16:38:20,Amurrio,expenses,food,-102.81,-1533.69
buyer_3,Ana,Piñeiro,1989-08-23,43610689K,ana.piñeiro@awesomenet.io,074110,ES50209546216055661299,7157.03,2023-09-18T19:46:37,Amurrio,expenses,cash,-100.0,-1633.69
buyer_3,Ana,Piñeiro,1989-08-23,43610689K,ana.piñeiro@awesomenet.io,074110,ES50209546216055661299,7157.03,2023-09-19T20:30:24,Amurrio,expenses,cash,-100.0,-1733.69
buyer_3,Ana,Piñeiro,1989-08-23,43610689K,ana.piñeiro@awesomenet.io,074110,ES50209546216055661299,7157.03,2023-09-20T14:42:11,Amurrio,expenses,food,-102.12,-1835.81
buyer_3,Ana,Piñeiro,1989-08-23,43610689K,ana.piñeiro@awesomenet.io,074110,ES50209546216055661299,7157.03,2023-09-21T17:34:52,Amurrio,expenses,appliances,-353.02,-2188.83
buyer_3,Ana,Piñeiro,1989-08-23,43610689K,ana.piñeiro@awesomenet.io,074110,ES50209546216055661299,7157.03,2023-09-26T19:18:29,Amurrio,expenses,food,-62.61,-2251.44
buyer_3,Ana,Piñeiro,1989-08-23,43610689K,ana.piñeiro@awesomenet.io,074110,ES50209546216055661299,7157.03,2023-09-26T20:48:22,Amurrio,expenses,leisure,-41.67,-2293.11
buyer_3,Ana,Piñeiro,1989-08-23,43610689K,ana.piñeiro@awesomenet.io,074110,ES50209546216055661299,7157.03,2023-09-27T09:59:07,Amurrio,expenses,appliances,-126.43,-2419.54
buyer_3,Ana,Piñeiro,1989-08-23,43610689K,ana.piñeiro@awesomenet.io,074110,ES50209546216055661299,7157.03,2023-09-27T13:54:28,Amurrio,expenses,gifts,-420.96,-2840.5
buyer_3,Ana,Piñeiro,1989-08-23,43610689K,ana.piñeiro@awesomenet.io,074110,ES50209546216055661299,7157.03,2023-10-01T15:18:58,Amurrio,incomes,salary,3430.52,590.02
buyer_3,Ana,Piñeiro,1989-08-23,43610689K,ana.piñeiro@awesomenet.io,074110,ES50209546216055661299,7157.03,2023-10-01T15:18:58,Amurrio,incomes,salary_partner,3177.54,3767.56
buyer_3,Ana,Piñeiro,1989-08-23,43610689K,ana.piñeiro@awesomenet.io,074110,ES50209546216055661299,7157.03,2023-10-02T15:15:23,Amurrio,expenses,transport,-73.27,3694.29
buyer_3,Ana,Piñeiro,1989-08-23,43610689K,ana.piñeiro@awesomenet.io,074110,ES50209546216055661299,7157.03,2023-10-02T09:35:23,Amurrio,expenses,cash,-100.0,3594.29
buyer_3,Ana,Piñeiro,1989-08-23,43610689K,ana.piñeiro@awesomenet.io,074110,ES50209546216055661299,7157.03,2023-10-03T17:13:44,Amurrio,expenses,cash,-100.0,3494.29
buyer_3,Ana,Piñeiro,1989-08-23,43610689K,ana.piñeiro@awesomenet.io,074110,ES50209546216055661299,7157.03,2023-10-04T08:59:39,Amurrio,expenses,mortgage,-2728.24,766.05
buyer_3,Ana,Piñeiro,1989-08-23,43610689K,ana.piñeiro@awesomenet.io,074110,ES50209546216055661299,7157.03,2023-10-05T08:34:43,Amurrio,expenses,internet,-138.77,627.28
buyer_3,Ana,Piñeiro,1989-08-23,43610689K,ana.piñeiro@awesomenet.io,074110,ES50209546216055661299,7157.03,2023-10-05T20:13:23,Amurrio,expenses,phone,-133.85,493.43
buyer_3,Ana,Piñeiro,1989-08-23,43610689K,ana.piñeiro@awesomenet.io,074110,ES50209546216055661299,7157.03,2023-10-05T08:46:43,Amurrio,expenses,gifts,-171.96,321.47
buyer_3,Ana,Piñeiro,1989-08-23,43610689K,ana.piñeiro@awesomenet.io,074110,ES50209546216055661299,7157.03,2023-10-07T14:24:40,Amurrio,expenses,electricity,-232.65,88.82
buyer_3,Ana,Piñeiro,1989-08-23,43610689K,ana.piñeiro@awesomenet.io,074110,ES50209546216055661299,7157.03,2023-10-07T17:58:57,Amurrio,expenses,internet,-138.77,-49.95
buyer_3,Ana,Piñeiro,1989-08-23,43610689K,ana.piñeiro@awesomenet.io,074110,ES50209546216055661299,7157.03,2023-10-08T17:44:39,Amurrio,expenses,water,-119.62,-169.57
buyer_3,Ana,Piñeiro,1989-08-23,43610689K,ana.piñeiro@awesomenet.io,074110,ES50209546216055661299,7157.03,2023-10-08T23:47:45,Amurrio,expenses,electricity,-288.21,-457.78
buyer_3,Ana,Piñeiro,1989-08-23,43610689K,ana.piñeiro@awesomenet.io,074110,ES50209546216055661299,7157.03,2023-10-08T21:34:00,Amurrio,expenses,leisure,-55.29,-513.07
buyer_3,Ana,Piñeiro,1989-08-23,43610689K,ana.piñeiro@awesomenet.io,074110,ES50209546216055661299,7157.03,2023-10-08T03:47:26,Amurrio,expenses,repairs,-60.75,-573.82
buyer_3,Ana,Piñeiro,1989-08-23,43610689K,ana.piñeiro@awesomenet.io,074110,ES50209546216055661299,7157.03,2023-10-11T10:09:35,Amurrio,expenses,leisure,-84.91,-658.73
buyer_3,Ana,Piñeiro,1989-08-23,43610689K,ana.piñeiro@awesomenet.io,074110,ES50209546216055661299,7157.03,2023-10-12T17:31:25,Amurrio,expenses,transport,-64.4,-723.13
buyer_3,Ana,Piñeiro,1989-08-23,43610689K,ana.piñeiro@awesomenet.io,074110,ES50209546216055661299,7157.03,2023-10-15T12:26:16,Amurrio,expenses,transport,-60.08,-783.21
buyer_3,Ana,Piñeiro,1989-08-23,43610689K,ana.piñeiro@awesomenet.io,074110,ES50209546216055661299,7157.03,2023-10-19T10:57:51,Amurrio,expenses,education,-77.11,-860.32
buyer_3,Ana,Piñeiro,1989-08-23,43610689K,ana.piñeiro@awesomenet.io,074110,ES50209546216055661299,7157.03,2023-10-22T16:18:49,Amurrio,expenses,repairs,-119.39,-979.71
buyer_3,Ana,Piñeiro,1989-08-23,43610689K,ana.piñeiro@awesomenet.io,074110,ES50209546216055661299,7157.03,2023-10-24T16:42:26,Amurrio,expenses,leisure,-34.81,-1014.52
buyer_3,Ana,Piñeiro,1989-08-23,43610689K,ana.piñeiro@awesomenet.io,074110,ES50209546216055661299,7157.03,2023-10-25T11:23:56,Amurrio,expenses,cash,-100.0,-1114.52
buyer_3,Ana,Piñeiro,1989-08-23,43610689K,ana.piñeiro@awesomenet.io,074110,ES50209546216055661299,7157.03,2023-10-25T09:04:23,Amurrio,expenses,repairs,-186.14,-1300.66
buyer_3,Ana,Piñeiro,1989-08-23,43610689K,ana.piñeiro@awesomenet.io,074110,ES50209546216055661299,7157.03,2023-10-31T18:34:48,Amurrio,expenses,education,-52.22,-1352.88
buyer_3,Ana,Piñeiro,1989-08-23,43610689K,ana.piñeiro@awesomenet.io,074110,ES50209546216055661299,7157.03,2023-11-01T20:32:40,Amurrio,incomes,salary,3430.52,2077.64
buyer_3,Ana,Piñeiro,1989-08-23,43610689K,ana.piñeiro@awesomenet.io,074110,ES50209546216055661299,7157.03,2023-11-01T20:32:40,Amurrio,incomes,salary_partner,3177.54,5255.18
buyer_3,Ana,Piñeiro,1989-08-23,43610689K,ana.piñeiro@awesomenet.io,074110,ES50209546216055661299,7157.03,2023-11-01T10:52:53,Amurrio,expenses,gifts,-52.75,5202.43
buyer_3,Ana,Piñeiro,1989-08-23,43610689K,ana.piñeiro@awesomenet.io,074110,ES50209546216055661299,7157.03,2023-11-02T11:40:38,Amurrio,expenses,healthcare,-127.92,5074.51
buyer_3,Ana,Piñeiro,1989-08-23,43610689K,ana.piñeiro@awesomenet.io,074110,ES50209546216055661299,7157.03,2023-11-02T13:19:51,Amurrio,expenses,cash,-100.0,4974.51
buyer_3,Ana,Piñeiro,1989-08-23,43610689K,ana.piñeiro@awesomenet.io,074110,ES50209546216055661299,7157.03,2023-11-04T18:41:36,Amurrio,expenses,mortgage,-2728.24,2246.27
buyer_3,Ana,Piñeiro,1989-08-23,43610689K,ana.piñeiro@awesomenet.io,074110,ES50209546216055661299,7157.03,2023-11-05T16:20:22,Amurrio,expenses,gas,-305.0,1941.27
buyer_3,Ana,Piñeiro,1989-08-23,43610689K,ana.piñeiro@awesomenet.io,074110,ES50209546216055661299,7157.03,2023-11-05T18:06:19,Amurrio,expenses,transport,-41.78,1899.49
buyer_3,Ana,Piñeiro,1989-08-23,43610689K,ana.piñeiro@awesomenet.io,074110,ES50209546216055661299,7157.03,2023-11-05T13:25:28,Amurrio,expenses,leisure,-47.91,1851.58
buyer_3,Ana,Piñeiro,1989-08-23,43610689K,ana.piñeiro@awesomenet.io,074110,ES50209546216055661299,7157.03,2023-11-06T14:06:46,Amurrio,expenses,electricity,-176.29,1675.29
buyer_3,Ana,Piñeiro,1989-08-23,43610689K,ana.piñeiro@awesomenet.io,074110,ES50209546216055661299,7157.03,2023-11-06T21:17:25,Amurrio,expenses,repairs,-313.34,1361.95
buyer_3,Ana,Piñeiro,1989-08-23,43610689K,ana.piñeiro@awesomenet.io,074110,ES50209546216055661299,7157.03,2023-11-07T08:09:30,Amurrio,expenses,food,-87.86,1274.09
buyer_3,Ana,Piñeiro,1989-08-23,43610689K,ana.piñeiro@awesomenet.io,074110,ES50209546216055661299,7157.03,2023-11-07T11:24:31,Amurrio,expenses,cash,-100.0,1174.09
buyer_3,Ana,Piñeiro,1989-08-23,43610689K,ana.piñeiro@awesomenet.io,074110,ES50209546216055661299,7157.03,2023-11-08T14:37:12,Amurrio,expenses,leisure,-74.16,1099.93
buyer_3,Ana,Piñeiro,1989-08-23,43610689K,ana.piñeiro@awesomenet.io,074110,ES50209546216055661299,7157.03,2023-11-09T09:58:05,Amurrio,expenses,leisure,-21.96,1077.97
buyer_3,Ana,Piñeiro,1989-08-23,43610689K,ana.piñeiro@awesomenet.io,074110,ES50209546216055661299,7157.03,2023-11-09T20:23:12,Amurrio,expenses,cash,-100.0,977.97
buyer_3,Ana,Piñeiro,1989-08-23,43610689K,ana.piñeiro@awesomenet.io,074110,ES50209546216055661299,7157.03,2023-11-09T00:08:37,Amurrio,expenses,repairs,-124.98,852.99
buyer_3,Ana,Piñeiro,1989-08-23,43610689K,ana.piñeiro@awesomenet.io,074110,ES50209546216055661299,7157.03,2023-11-10T20:42:01,Amurrio,expenses,leisure,-46.65,806.34
buyer_3,Ana,Piñeiro,1989-08-23,43610689K,ana.piñeiro@awesomenet.io,074110,ES50209546216055661299,7157.03,2023-11-11T19:48:26,Amurrio,expenses,cash,-100.0,706.34
buyer_3,Ana,Piñeiro,1989-08-23,43610689K,ana.piñeiro@awesomenet.io,074110,ES50209546216055661299,7157.03,2023-11-13T18:55:43,Amurrio,expenses,leisure,-74.04,632.3
buyer_3,Ana,Piñeiro,1989-08-23,43610689K,ana.piñeiro@awesomenet.io,074110,ES50209546216055661299,7157.03,2023-11-14T15:19:38,Amurrio,expenses,clothing,-138.98,493.32
buyer_3,Ana,Piñeiro,1989-08-23,43610689K,ana.piñeiro@awesomenet.io,074110,ES50209546216055661299,7157.03,2023-11-14T16:56:13,Amurrio,expenses,cash,-100.0,393.32
buyer_3,Ana,Piñeiro,1989-08-23,43610689K,ana.piñeiro@awesomenet.io,074110,ES50209546216055661299,7157.03,2023-11-15T08:21:55,Amurrio,expenses,cash,-100.0,293.32
buyer_3,Ana,Piñeiro,1989-08-23,43610689K,ana.piñeiro@awesomenet.io,074110,ES50209546216055661299,7157.03,2023-11-16T10:57:30,Amurrio,expenses,food,-88.3,205.02
buyer_3,Ana,Piñeiro,1989-08-23,43610689K,ana.piñeiro@awesomenet.io,074110,ES50209546216055661299,7157.03,2023-11-18T16:23:05,Amurrio,expenses,cash,-100.0,105.02
buyer_3,Ana,Piñeiro,1989-08-23,43610689K,ana.piñeiro@awesomenet.io,074110,ES50209546216055661299,7157.03,2023-11-19T13:29:09,Amurrio,expenses,repairs,-76.76,28.26
buyer_3,Ana,Piñeiro,1989-08-23,43610689K,ana.piñeiro@awesomenet.io,074110,ES50209546216055661299,7157.03,2023-11-22T13:05:41,Amurrio,expenses,transport,-56.25,-27.99
buyer_3,Ana,Piñeiro,1989-08-23,43610689K,ana.piñeiro@awesomenet.io,074110,ES50209546216055661299,7157.03,2023-11-22T12:35:18,Amurrio,expenses,cash,-100.0,-127.99
buyer_3,Ana,Piñeiro,1989-08-23,43610689K,ana.piñeiro@awesomenet.io,074110,ES50209546216055661299,7157.03,2023-11-24T17:36:38,Amurrio,expenses,cash,-100.0,-227.99
buyer_3,Ana,Piñeiro,1989-08-23,43610689K,ana.piñeiro@awesomenet.io,074110,ES50209546216055661299,7157.03,2023-11-24T19:06:04,Amurrio,expenses,repairs,-206.01,-434.0
buyer_3,Ana,Piñeiro,1989-08-23,43610689K,ana.piñeiro@awesomenet.io,074110,ES50209546216055661299,7157.03,2023-11-25T02:03:26,Amurrio,expenses,transport,-54.84,-488.84
buyer_3,Ana,Piñeiro,1989-08-23,43610689K,ana.piñeiro@awesomenet.io,074110,ES50209546216055661299,7157.03,2023-11-27T14:19:53,Amurrio,expenses,food,-68.69,-557.53
buyer_3,Ana,Piñeiro,1989-08-23,43610689K,ana.piñeiro@awesomenet.io,074110,ES50209546216055661299,7157.03,2023-11-27T12:46:42,Amurrio,expenses,transport,-45.9,-603.43
buyer_3,Ana,Piñeiro,1989-08-23,43610689K,ana.piñeiro@awesomenet.io,074110,ES50209546216055661299,7157.03,2023-11-28T11:47:23,Amurrio,expenses,education,-58.68,-662.11
buyer_3,Ana,Piñeiro,1989-08-23,43610689K,ana.piñeiro@awesomenet.io,074110,ES50209546216055661299,7157.03,2023-11-29T17:19:07,Amurrio,expenses,food,-64.41,-726.52
buyer_3,Ana,Piñeiro,1989-08-23,43610689K,ana.piñeiro@awesomenet.io,074110,ES50209546216055661299,7157.03,2023-11-29T17:57:08,Amurrio,expenses,cash,-100.0,-826.52
buyer_3,Ana,Piñeiro,1989-08-23,43610689K,ana.piñeiro@awesomenet.io,074110,ES50209546216055661299,7157.03,2023-12-01T02:46:06,Amurrio,incomes,salary,3430.52,2604.0
buyer_3,Ana,Piñeiro,1989-08-23,43610689K,ana.piñeiro@awesomenet.io,074110,ES50209546216055661299,7157.03,2023-12-01T02:46:06,Amurrio,incomes,salary_partner,3177.54,5781.54
buyer_3,Ana,Piñeiro,1989-08-23,43610689K,ana.piñeiro@awesomenet.io,074110,ES50209546216055661299,7157.03,2023-12-01T02:46:06,Amurrio,incomes,extra_income,346.04,6127.58
buyer_3,Ana,Piñeiro,1989-08-23,43610689K,ana.piñeiro@awesomenet.io,074110,ES50209546216055661299,7157.03,2023-12-01T02:46:06,Amurrio,incomes,salary_bonus,2657.94,8785.52
buyer_3,Ana,Piñeiro,1989-08-23,43610689K,ana.piñeiro@awesomenet.io,074110,ES50209546216055661299,7157.03,2023-12-01T02:46:06,Amurrio,incomes,salary_partner_bonus,2239.57,11025.09
buyer_3,Ana,Piñeiro,1989-08-23,43610689K,ana.piñeiro@awesomenet.io,074110,ES50209546216055661299,7157.03,2023-12-04T14:37:37,Amurrio,expenses,mortgage,-2728.24,8296.85
buyer_3,Ana,Piñeiro,1989-08-23,43610689K,ana.piñeiro@awesomenet.io,074110,ES50209546216055661299,7157.03,2023-12-04T15:14:00,Amurrio,expenses,leisure,-44.81,8252.04
buyer_3,Ana,Piñeiro,1989-08-23,43610689K,ana.piñeiro@awesomenet.io,074110,ES50209546216055661299,7157.03,2023-12-06T13:38:06,Amurrio,expenses,water,-104.88,8147.16
buyer_3,Ana,Piñeiro,1989-08-23,43610689K,ana.piñeiro@awesomenet.io,074110,ES50209546216055661299,7157.03,2023-12-06T16:41:27,Amurrio,expenses,gas,-119.53,8027.63
buyer_3,Ana,Piñeiro,1989-08-23,43610689K,ana.piñeiro@awesomenet.io,074110,ES50209546216055661299,7157.03,2023-12-06T09:40:15,Amurrio,expenses,phone,-136.05,7891.58
buyer_3,Ana,Piñeiro,1989-08-23,43610689K,ana.piñeiro@awesomenet.io,074110,ES50209546216055661299,7157.03,2023-12-07T20:25:50,Amurrio,expenses,phone,-114.61,7776.97
buyer_3,Ana,Piñeiro,1989-08-23,43610689K,ana.piñeiro@awesomenet.io,074110,ES50209546216055661299,7157.03,2023-12-08T17:21:02,Amurrio,expenses,gas,-375.14,7401.83
buyer_3,Ana,Piñeiro,1989-08-23,43610689K,ana.piñeiro@awesomenet.io,074110,ES50209546216055661299,7157.03,2023-12-08T10:07:46,Amurrio,expenses,phone,-147.67,7254.16
buyer_3,Ana,Piñeiro,1989-08-23,43610689K,ana.piñeiro@awesomenet.io,074110,ES50209546216055661299,7157.03,2023-12-10T11:57:43,Amurrio,expenses,food,-87.71,7166.45
buyer_3,Ana,Piñeiro,1989-08-23,43610689K,ana.piñeiro@awesomenet.io,074110,ES50209546216055661299,7157.03,2023-12-16T17:10:13,Amurrio,expenses,repairs,-118.56,7047.89
buyer_3,Ana,Piñeiro,1989-08-23,43610689K,ana.piñeiro@awesomenet.io,074110,ES50209546216055661299,7157.03,2023-12-17T14:33:29,Amurrio,expenses,transport,-79.51,6968.38
buyer_3,Ana,Piñeiro,1989-08-23,43610689K,ana.piñeiro@awesomenet.io,074110,ES50209546216055661299,7157.03,2023-12-19T16:58:10,Amurrio,expenses,repairs,-217.49,6750.89
buyer_3,Ana,Piñeiro,1989-08-23,43610689K,ana.piñeiro@awesomenet.io,074110,ES50209546216055661299,7157.03,2023-12-20T10:03:50,Amurrio,expenses,transport,-87.59,6663.3
buyer_3,Ana,Piñeiro,1989-08-23,43610689K,ana.piñeiro@awesomenet.io,074110,ES50209546216055661299,7157.03,2023-12-20T17:27:42,Amurrio,expenses,clothing,-55.58,6607.72
buyer_3,Ana,Piñeiro,1989-08-23,43610689K,ana.piñeiro@awesomenet.io,074110,ES50209546216055661299,7157.03,2023-12-22T19:24:46,Amurrio,expenses,transport,-88.46,6519.26
buyer_3,Ana,Piñeiro,1989-08-23,43610689K,ana.piñeiro@awesomenet.io,074110,ES50209546216055661299,7157.03,2023-12-22T08:18:55,Amurrio,expenses,cash,-100.0,6419.26
buyer_3,Ana,Piñeiro,1989-08-23,43610689K,ana.piñeiro@awesomenet.io,074110,ES50209546216055661299,7157.03,2023-12-23T09:43:16,Amurrio,expenses,leisure,-31.56,6387.7
buyer_3,Ana,Piñeiro,1989-08-23,43610689K,ana.piñeiro@awesomenet.io,074110,ES50209546216055661299,7157.03,2023-12-24T12:38:58,Amurrio,expenses,cash,-100.0,6287.7
buyer_3,Ana,Piñeiro,1989-08-23,43610689K,ana.piñeiro@awesomenet.io,074110,ES50209546216055661299,7157.03,2023-12-25T20:42:53,Amurrio,expenses,cash,-100.0,6187.7
buyer_3,Ana,Piñeiro,1989-08-23,43610689K,ana.piñeiro@awesomenet.io,074110,ES50209546216055661299,7157.03,2023-12-26T10:37:33,Amurrio,expenses,food,-114.51,6073.19
buyer_3,Ana,Piñeiro,1989-08-23,43610689K,ana.piñeiro@awesomenet.io,074110,ES50209546216055661299,7157.03,2023-12-26T14:10:07,Amurrio,expenses,repairs,-331.0,5742.19
buyer_3,Ana,Piñeiro,1989-08-23,43610689K,ana.piñeiro@awesomenet.io,074110,ES50209546216055661299,7157.03,2023-12-27T08:54:47,Amurrio,expenses,transport,-86.29,5655.9
buyer_3,Ana,Piñeiro,1989-08-23,43610689K,ana.piñeiro@awesomenet.io,074110,ES50209546216055661299,7157.03,2023-12-28T08:15:43,Amurrio,expenses,clothing,-100.13,5555.77
buyer_3,Ana,Piñeiro,1989-08-23,43610689K,ana.piñeiro@awesomenet.io,074110,ES50209546216055661299,7157.03,2023-12-28T15:44:28,Amurrio,expenses,cash,-100.0,5455.77
buyer_3,Ana,Piñeiro,1989-08-23,43610689K,ana.piñeiro@awesomenet.io,074110,ES50209546216055661299,7157.03,2023-12-29T10:43:49,Amurrio,expenses,food,-114.36,5341.41
buyer_3,Ana,Piñeiro,1989-08-23,43610689K,ana.piñeiro@awesomenet.io,074110,ES50209546216055661299,7157.03,2023-12-30T16:07:15,Amurrio,expenses,cash,-100.0,5241.41
buyer_3,Ana,Piñeiro,1989-08-23,43610689K,ana.piñeiro@awesomenet.io,074110,ES50209546216055661299,7157.03,2023-12-31T18:46:12,Amurrio,expenses,food,-63.58,5177.83
buyer_3,Ana,Piñeiro,1989-08-23,43610689K,ana.piñeiro@awesomenet.io,074110,ES50209546216055661299,7157.03,2024-01-01T16:10:27,Amurrio,incomes,salary,3550.17,8728.0
buyer_3,Ana,Piñeiro,1989-08-23,43610689K,ana.piñeiro@awesomenet.io,074110,ES50209546216055661299,7157.03,2024-01-01T16:10:27,Amurrio,incomes,salary_partner,3288.36,12016.36
buyer_3,Ana,Piñeiro,1989-08-23,43610689K,ana.piñeiro@awesomenet.io,074110,ES50209546216055661299,7157.03,2024-01-01T19:43:31,Amurrio,expenses,transport,-70.8,11945.56
buyer_3,Ana,Piñeiro,1989-08-23,43610689K,ana.piñeiro@awesomenet.io,074110,ES50209546216055661299,7157.03,2024-01-01T16:09:40,Amurrio,expenses,clothing,-48.69,11896.87
buyer_3,Ana,Piñeiro,1989-08-23,43610689K,ana.piñeiro@awesomenet.io,074110,ES50209546216055661299,7157.03,2024-01-03T09:37:07,Amurrio,expenses,food,-120.85,11776.02
buyer_3,Ana,Piñeiro,1989-08-23,43610689K,ana.piñeiro@awesomenet.io,074110,ES50209546216055661299,7157.03,2024-01-04T16:45:19,Amurrio,expenses,mortgage,-3421.84,8354.18
buyer_3,Ana,Piñeiro,1989-08-23,43610689K,ana.piñeiro@awesomenet.io,074110,ES50209546216055661299,7157.03,2024-01-04T14:53:27,Amurrio,expenses,food,-85.51,8268.67
buyer_3,Ana,Piñeiro,1989-08-23,43610689K,ana.piñeiro@awesomenet.io,074110,ES50209546216055661299,7157.03,2024-01-05T14:35:50,Amurrio,expenses,water,-151.87,8116.8
buyer_3,Ana,Piñeiro,1989-08-23,43610689K,ana.piñeiro@awesomenet.io,074110,ES50209546216055661299,7157.03,2024-01-06T12:16:01,Amurrio,expenses,water,-100.5,8016.3
buyer_3,Ana,Piñeiro,1989-08-23,43610689K,ana.piñeiro@awesomenet.io,074110,ES50209546216055661299,7157.03,2024-01-06T05:39:30,Amurrio,expenses,electricity,-243.86,7772.44
buyer_3,Ana,Piñeiro,1989-08-23,43610689K,ana.piñeiro@awesomenet.io,074110,ES50209546216055661299,7157.03,2024-01-06T20:30:19,Amurrio,expenses,phone,-132.24,7640.2
buyer_3,Ana,Piñeiro,1989-08-23,43610689K,ana.piñeiro@awesomenet.io,074110,ES50209546216055661299,7157.03,2024-01-07T22:26:50,Amurrio,expenses,phone,-143.18,7497.02
buyer_3,Ana,Piñeiro,1989-08-23,43610689K,ana.piñeiro@awesomenet.io,074110,ES50209546216055661299,7157.03,2024-01-07T20:52:48,Amurrio,expenses,leisure,-40.9,7456.12
buyer_3,Ana,Piñeiro,1989-08-23,43610689K,ana.piñeiro@awesomenet.io,074110,ES50209546216055661299,7157.03,2024-01-07T19:20:56,Amurrio,expenses,healthcare,-52.71,7403.41
buyer_3,Ana,Piñeiro,1989-08-23,43610689K,ana.piñeiro@awesomenet.io,074110,ES50209546216055661299,7157.03,2024-01-08T09:52:45,Amurrio,expenses,electricity,-247.95,7155.46
buyer_3,Ana,Piñeiro,1989-08-23,43610689K,ana.piñeiro@awesomenet.io,074110,ES50209546216055661299,7157.03,2024-01-08T09:02:15,Amurrio,expenses,gas,-192.01,6963.45
buyer_3,Ana,Piñeiro,1989-08-23,43610689K,ana.piñeiro@awesomenet.io,074110,ES50209546216055661299,7157.03,2024-01-08T20:55:56,Amurrio,expenses,internet,-143.61,6819.84
buyer_3,Ana,Piñeiro,1989-08-23,43610689K,ana.piñeiro@awesomenet.io,074110,ES50209546216055661299,7157.03,2024-01-08T19:34:30,Amurrio,expenses,transport,-64.76,6755.08
buyer_3,Ana,Piñeiro,1989-08-23,43610689K,ana.piñeiro@awesomenet.io,074110,ES50209546216055661299,7157.03,2024-01-09T12:45:25,Amurrio,expenses,gifts,-734.69,6020.39
buyer_3,Ana,Piñeiro,1989-08-23,43610689K,ana.piñeiro@awesomenet.io,074110,ES50209546216055661299,7157.03,2024-01-10T13:31:50,Amurrio,expenses,food,-111.37,5909.02
buyer_3,Ana,Piñeiro,1989-08-23,43610689K,ana.piñeiro@awesomenet.io,074110,ES50209546216055661299,7157.03,2024-01-11T08:37:13,Amurrio,expenses,gifts,-204.76,5704.26
buyer_3,Ana,Piñeiro,1989-08-23,43610689K,ana.piñeiro@awesomenet.io,074110,ES50209546216055661299,7157.03,2024-01-12T18:52:37,Amurrio,expenses,transport,-78.32,5625.94
buyer_3,Ana,Piñeiro,1989-08-23,43610689K,ana.piñeiro@awesomenet.io,074110,ES50209546216055661299,7157.03,2024-01-12T18:14:01,Amurrio,expenses,cash,-100.0,5525.94
buyer_3,Ana,Piñeiro,1989-08-23,43610689K,ana.piñeiro@awesomenet.io,074110,ES50209546216055661299,7157.03,2024-01-13T20:14:20,Amurrio,expenses,food,-81.07,5444.87
buyer_3,Ana,Piñeiro,1989-08-23,43610689K,ana.piñeiro@awesomenet.io,074110,ES50209546216055661299,7157.03,2024-01-14T15:30:46,Amurrio,expenses,transport,-66.57,5378.3
buyer_3,Ana,Piñeiro,1989-08-23,43610689K,ana.piñeiro@awesomenet.io,074110,ES50209546216055661299,7157.03,2024-01-14T08:21:30,Amurrio,expenses,cash,-100.0,5278.3
buyer_3,Ana,Piñeiro,1989-08-23,43610689K,ana.piñeiro@awesomenet.io,074110,ES50209546216055661299,7157.03,2024-01-15T20:43:10,Amurrio,expenses,transport,-58.53,5219.77
buyer_3,Ana,Piñeiro,1989-08-23,43610689K,ana.piñeiro@awesomenet.io,074110,ES50209546216055661299,7157.03,2024-01-16T13:05:28,Amurrio,expenses,transport,-73.03,5146.74
buyer_3,Ana,Piñeiro,1989-08-23,43610689K,ana.piñeiro@awesomenet.io,074110,ES50209546216055661299,7157.03,2024-01-17T10:42:15,Amurrio,expenses,leisure,-74.39,5072.35
buyer_3,Ana,Piñeiro,1989-08-23,43610689K,ana.piñeiro@awesomenet.io,074110,ES50209546216055661299,7157.03,2024-01-19T13:19:28,Amurrio,expenses,leisure,-63.18,5009.17
buyer_3,Ana,Piñeiro,1989-08-23,43610689K,ana.piñeiro@awesomenet.io,074110,ES50209546216055661299,7157.03,2024-01-19T11:59:32,Amurrio,expenses,cash,-100.0,4909.17
buyer_3,Ana,Piñeiro,1989-08-23,43610689K,ana.piñeiro@awesomenet.io,074110,ES50209546216055661299,7157.03,2024-01-20T09:27:05,Amurrio,expenses,education,-78.65,4830.52
buyer_3,Ana,Piñeiro,1989-08-23,43610689K,ana.piñeiro@awesomenet.io,074110,ES50209546216055661299,7157.03,2024-01-20T08:59:38,Amurrio,expenses,gifts,-438.06,4392.46
buyer_3,Ana,Piñeiro,1989-08-23,43610689K,ana.piñeiro@awesomenet.io,074110,ES50209546216055661299,7157.03,2024-01-22T14:34:26,Amurrio,expenses,travel,-541.98,3850.48
buyer_3,Ana,Piñeiro,1989-08-23,43610689K,ana.piñeiro@awesomenet.io,074110,ES50209546216055661299,7157.03,2024-01-24T21:52:33,Amurrio,expenses,clothing,-66.93,3783.55
buyer_3,Ana,Piñeiro,1989-08-23,43610689K,ana.piñeiro@awesomenet.io,074110,ES50209546216055661299,7157.03,2024-01-25T22:50:35,Amurrio,expenses,leisure,-76.16,3707.39
buyer_3,Ana,Piñeiro,1989-08-23,43610689K,ana.piñeiro@awesomenet.io,074110,ES50209546216055661299,7157.03,2024-01-26T10:38:54,Amurrio,expenses,leisure,-75.43,3631.96
buyer_3,Ana,Piñeiro,1989-08-23,43610689K,ana.piñeiro@awesomenet.io,074110,ES50209546216055661299,7157.03,2024-01-29T21:04:52,Amurrio,expenses,cash,-100.0,3531.96
buyer_3,Ana,Piñeiro,1989-08-23,43610689K,ana.piñeiro@awesomenet.io,074110,ES50209546216055661299,7157.03,2024-01-29T06:04:47,Amurrio,expenses,gifts,-106.84,3425.12
buyer_3,Ana,Piñeiro,1989-08-23,43610689K,ana.piñeiro@awesomenet.io,074110,ES50209546216055661299,7157.03,2024-01-30T17:13:18,Amurrio,expenses,gifts,-645.22,2779.9
buyer_3,Ana,Piñeiro,1989-08-23,43610689K,ana.piñeiro@awesomenet.io,074110,ES50209546216055661299,7157.03,2024-02-01T14:51:25,Amurrio,incomes,salary,3550.17,6330.07
buyer_3,Ana,Piñeiro,1989-08-23,43610689K,ana.piñeiro@awesomenet.io,074110,ES50209546216055661299,7157.03,2024-02-01T14:51:25,Amurrio,incomes,salary_partner,3288.36,9618.43
buyer_3,Ana,Piñeiro,1989-08-23,43610689K,ana.piñeiro@awesomenet.io,074110,ES50209546216055661299,7157.03,2024-02-01T02:59:08,Amurrio,expenses,transport,-74.8,9543.63
buyer_3,Ana,Piñeiro,1989-08-23,43610689K,ana.piñeiro@awesomenet.io,074110,ES50209546216055661299,7157.03,2024-02-01T22:15:38,Amurrio,expenses,cash,-100.0,9443.63
buyer_3,Ana,Piñeiro,1989-08-23,43610689K,ana.piñeiro@awesomenet.io,074110,ES50209546216055661299,7157.03,2024-02-03T11:45:48,Amurrio,expenses,repairs,-134.71,9308.92
buyer_3,Ana,Piñeiro,1989-08-23,43610689K,ana.piñeiro@awesomenet.io,074110,ES50209546216055661299,7157.03,2024-02-04T22:24:41,Amurrio,expenses,mortgage,-3421.84,5887.08
buyer_3,Ana,Piñeiro,1989-08-23,43610689K,ana.piñeiro@awesomenet.io,074110,ES50209546216055661299,7157.03,2024-02-04T20:29:43,Amurrio,expenses,transport,-40.04,5847.04
buyer_3,Ana,Piñeiro,1989-08-23,43610689K,ana.piñeiro@awesomenet.io,074110,ES50209546216055661299,7157.03,2024-02-05T15:01:26,Amurrio,expenses,water,-75.0,5772.04
buyer_3,Ana,Piñeiro,1989-08-23,43610689K,ana.piñeiro@awesomenet.io,074110,ES50209546216055661299,7157.03,2024-02-05T10:51:40,Amurrio,expenses,gas,-274.92,5497.12
buyer_3,Ana,Piñeiro,1989-08-23,43610689K,ana.piñeiro@awesomenet.io,074110,ES50209546216055661299,7157.03,2024-02-06T09:41:24,Amurrio,expenses,internet,-143.61,5353.51
buyer_3,Ana,Piñeiro,1989-08-23,43610689K,ana.piñeiro@awesomenet.io,074110,ES50209546216055661299,7157.03,2024-02-06T13:17:54,Amurrio,expenses,cash,-100.0,5253.51
buyer_3,Ana,Piñeiro,1989-08-23,43610689K,ana.piñeiro@awesomenet.io,074110,ES50209546216055661299,7157.03,2024-02-07T10:13:30,Amurrio,expenses,internet,-143.61,5109.9
buyer_3,Ana,Piñeiro,1989-08-23,43610689K,ana.piñeiro@awesomenet.io,074110,ES50209546216055661299,7157.03,2024-02-08T16:02:32,Amurrio,expenses,phone,-153.11,4956.79
buyer_3,Ana,Piñeiro,1989-08-23,43610689K,ana.piñeiro@awesomenet.io,074110,ES50209546216055661299,7157.03,2024-02-08T21:30:45,Amurrio,expenses,food,-106.4,4850.39
buyer_3,Ana,Piñeiro,1989-08-23,43610689K,ana.piñeiro@awesomenet.io,074110,ES50209546216055661299,7157.03,2024-02-08T20:19:22,Amurrio,expenses,transport,-74.59,4775.8
buyer_3,Ana,Piñeiro,1989-08-23,43610689K,ana.piñeiro@awesomenet.io,074110,ES50209546216055661299,7157.03,2024-02-13T21:04:50,Amurrio,expenses,cash,-100.0,4675.8
buyer_3,Ana,Piñeiro,1989-08-23,43610689K,ana.piñeiro@awesomenet.io,074110,ES50209546216055661299,7157.03,2024-02-20T00:26:12,Amurrio,expenses,food,-86.28,4589.52
buyer_3,Ana,Piñeiro,1989-08-23,43610689K,ana.piñeiro@awesomenet.io,074110,ES50209546216055661299,7157.03,2024-02-23T17:52:58,Amurrio,expenses,transport,-81.61,4507.91
buyer_3,Ana,Piñeiro,1989-08-23,43610689K,ana.piñeiro@awesomenet.io,074110,ES50209546216055661299,7157.03,2024-02-23T16:23:31,Amurrio,expenses,leisure,-51.4,4456.51
buyer_3,Ana,Piñeiro,1989-08-23,43610689K,ana.piñeiro@awesomenet.io,074110,ES50209546216055661299,7157.03,2024-02-25T13:37:08,Amurrio,expenses,cash,-100.0,4356.51
buyer_3,Ana,Piñeiro,1989-08-23,43610689K,ana.piñeiro@awesomenet.io,074110,ES50209546216055661299,7157.03,2024-02-26T14:20:43,Amurrio,expenses,cash,-100.0,4256.51
buyer_3,Ana,Piñeiro,1989-08-23,43610689K,ana.piñeiro@awesomenet.io,074110,ES50209546216055661299,7157.03,2024-02-26T13:26:58,Amurrio,expenses,repairs,-160.76,4095.75
buyer_3,Ana,Piñeiro,1989-08-23,43610689K,ana.piñeiro@awesomenet.io,074110,ES50209546216055661299,7157.03,2024-02-27T23:26:39,Amurrio,expenses,education,-71.76,4023.99
buyer_3,Ana,Piñeiro,1989-08-23,43610689K,ana.piñeiro@awesomenet.io,074110,ES50209546216055661299,7157.03,2024-02-27T15:57:19,Amurrio,expenses,cash,-100.0,3923.99
buyer_3,Ana,Piñeiro,1989-08-23,43610689K,ana.piñeiro@awesomenet.io,074110,ES50209546216055661299,7157.03,2024-02-29T10:24:09,Amurrio,expenses,repairs,-311.95,3612.04
buyer_3,Ana,Piñeiro,1989-08-23,43610689K,ana.piñeiro@awesomenet.io,074110,ES50209546216055661299,7157.03,2024-03-01T13:54:22,Amurrio,incomes,salary,3550.17,7162.21
buyer_3,Ana,Piñeiro,1989-08-23,43610689K,ana.piñeiro@awesomenet.io,074110,ES50209546216055661299,7157.03,2024-03-01T13:54:22,Amurrio,incomes,salary_partner,3288.36,10450.57
buyer_3,Ana,Piñeiro,1989-08-23,43610689K,ana.piñeiro@awesomenet.io,074110,ES50209546216055661299,7157.03,2024-03-01T13:54:22,Amurrio,incomes,extra_income,346.04,10796.61
buyer_3,Ana,Piñeiro,1989-08-23,43610689K,ana.piñeiro@awesomenet.io,074110,ES50209546216055661299,7157.03,2024-03-04T17:44:02,Amurrio,expenses,mortgage,-3421.84,7374.77
buyer_3,Ana,Piñeiro,1989-08-23,43610689K,ana.piñeiro@awesomenet.io,074110,ES50209546216055661299,7157.03,2024-03-04T02:12:05,Amurrio,expenses,food,-87.46,7287.31
buyer_3,Ana,Piñeiro,1989-08-23,43610689K,ana.piñeiro@awesomenet.io,074110,ES50209546216055661299,7157.03,2024-03-04T14:07:29,Amurrio,expenses,transport,-86.58,7200.73
buyer_3,Ana,Piñeiro,1989-08-23,43610689K,ana.piñeiro@awesomenet.io,074110,ES50209546216055661299,7157.03,2024-03-04T20:04:45,Amurrio,expenses,leisure,-45.26,7155.47
buyer_3,Ana,Piñeiro,1989-08-23,43610689K,ana.piñeiro@awesomenet.io,074110,ES50209546216055661299,7157.03,2024-03-04T22:08:47,Amurrio,expenses,gifts,-459.45,6696.02
buyer_3,Ana,Piñeiro,1989-08-23,43610689K,ana.piñeiro@awesomenet.io,074110,ES50209546216055661299,7157.03,2024-03-05T12:28:44,Amurrio,expenses,food,-89.14,6606.88
buyer_3,Ana,Piñeiro,1989-08-23,43610689K,ana.piñeiro@awesomenet.io,074110,ES50209546216055661299,7157.03,2024-03-05T10:19:45,Amurrio,expenses,healthcare,-148.99,6457.89
buyer_3,Ana,Piñeiro,1989-08-23,43610689K,ana.piñeiro@awesomenet.io,074110,ES50209546216055661299,7157.03,2024-03-06T10:44:20,Amurrio,expenses,gas,-261.48,6196.41
buyer_3,Ana,Piñeiro,1989-08-23,43610689K,ana.piñeiro@awesomenet.io,074110,ES50209546216055661299,7157.03,2024-03-06T11:27:14,Amurrio,expenses,internet,-143.61,6052.8
buyer_3,Ana,Piñeiro,1989-08-23,43610689K,ana.piñeiro@awesomenet.io,074110,ES50209546216055661299,7157.03,2024-03-06T18:47:25,Amurrio,expenses,food,-96.24,5956.56
buyer_3,Ana,Piñeiro,1989-08-23,43610689K,ana.piñeiro@awesomenet.io,074110,ES50209546216055661299,7157.03,2024-03-07T23:33:55,Amurrio,expenses,electricity,-219.29,5737.27
buyer_3,Ana,Piñeiro,1989-08-23,43610689K,ana.piñeiro@awesomenet.io,074110,ES50209546216055661299,7157.03,2024-03-07T13:48:57,Amurrio,expenses,leisure,-25.9,5711.37
buyer_3,Ana,Piñeiro,1989-08-23,43610689K,ana.piñeiro@awesomenet.io,074110,ES50209546216055661299,7157.03,2024-03-08T18:15:04,Amurrio,expenses,water,-112.52,5598.85
buyer_3,Ana,Piñeiro,1989-08-23,43610689K,ana.piñeiro@awesomenet.io,074110,ES50209546216055661299,7157.03,2024-03-08T18:22:57,Amurrio,expenses,internet,-143.61,5455.24
buyer_3,Ana,Piñeiro,1989-08-23,43610689K,ana.piñeiro@awesomenet.io,074110,ES50209546216055661299,7157.03,2024-03-08T07:54:51,Amurrio,expenses,cash,-100.0,5355.24
buyer_3,Ana,Piñeiro,1989-08-23,43610689K,ana.piñeiro@awesomenet.io,074110,ES50209546216055661299,7157.03,2024-03-08T20:23:05,Amurrio,expenses,repairs,-31.28,5323.96
buyer_3,Ana,Piñeiro,1989-08-23,43610689K,ana.piñeiro@awesomenet.io,074110,ES50209546216055661299,7157.03,2024-03-09T22:20:12,Amurrio,expenses,healthcare,-95.62,5228.34
buyer_3,Ana,Piñeiro,1989-08-23,43610689K,ana.piñeiro@awesomenet.io,074110,ES50209546216055661299,7157.03,2024-03-09T21:25:09,Amurrio,expenses,gifts,-409.94,4818.4
buyer_3,Ana,Piñeiro,1989-08-23,43610689K,ana.piñeiro@awesomenet.io,074110,ES50209546216055661299,7157.03,2024-03-13T08:59:04,Amurrio,expenses,clothing,-127.37,4691.03
buyer_3,Ana,Piñeiro,1989-08-23,43610689K,ana.piñeiro@awesomenet.io,074110,ES50209546216055661299,7157.03,2024-03-13T15:57:07,Amurrio,expenses,appliances,-320.66,4370.37
buyer_3,Ana,Piñeiro,1989-08-23,43610689K,ana.piñeiro@awesomenet.io,074110,ES50209546216055661299,7157.03,2024-03-14T10:35:36,Amurrio,expenses,transport,-52.71,4317.66
buyer_3,Ana,Piñeiro,1989-08-23,43610689K,ana.piñeiro@awesomenet.io,074110,ES50209546216055661299,7157.03,2024-03-15T09:48:43,Amurrio,expenses,transport,-78.0,4239.66
buyer_3,Ana,Piñeiro,1989-08-23,43610689K,ana.piñeiro@awesomenet.io,074110,ES50209546216055661299,7157.03,2024-03-15T13:32:25,Amurrio,expenses,appliances,-355.13,3884.53
buyer_3,Ana,Piñeiro,1989-08-23,43610689K,ana.piñeiro@awesomenet.io,074110,ES50209546216055661299,7157.03,2024-03-17T18:03:56,Amurrio,expenses,leisure,-82.29,3802.24
buyer_3,Ana,Piñeiro,1989-08-23,43610689K,ana.piñeiro@awesomenet.io,074110,ES50209546216055661299,7157.03,2024-03-18T17:14:10,Amurrio,expenses,cash,-100.0,3702.24
buyer_3,Ana,Piñeiro,1989-08-23,43610689K,ana.piñeiro@awesomenet.io,074110,ES50209546216055661299,7157.03,2024-03-19T18:06:52,Amurrio,expenses,transport,-86.91,3615.33
buyer_3,Ana,Piñeiro,1989-08-23,43610689K,ana.piñeiro@awesomenet.io,074110,ES50209546216055661299,7157.03,2024-03-19T21:10:34,Amurrio,expenses,gifts,-342.49,3272.84
buyer_3,Ana,Piñeiro,1989-08-23,43610689K,ana.piñeiro@awesomenet.io,074110,ES50209546216055661299,7157.03,2024-03-21T09:16:10,Amurrio,expenses,transport,-73.69,3199.15
buyer_3,Ana,Piñeiro,1989-08-23,43610689K,ana.piñeiro@awesomenet.io,074110,ES50209546216055661299,7157.03,2024-03-22T10:58:16,Amurrio,expenses,cash,-100.0,3099.15
buyer_3,Ana,Piñeiro,1989-08-23,43610689K,ana.piñeiro@awesomenet.io,074110,ES50209546216055661299,7157.03,2024-03-24T15:47:39,Amurrio,expenses,appliances,-389.49,2709.66
buyer_3,Ana,Piñeiro,1989-08-23,43610689K,ana.piñeiro@awesomenet.io,074110,ES50209546216055661299,7157.03,2024-03-25T20:02:41,Amurrio,expenses,food,-82.75,2626.91
buyer_3,Ana,Piñeiro,1989-08-23,43610689K,ana.piñeiro@awesomenet.io,074110,ES50209546216055661299,7157.03,2024-03-25T10:33:47,Amurrio,expenses,transport,-83.19,2543.72
buyer_3,Ana,Piñeiro,1989-08-23,43610689K,ana.piñeiro@awesomenet.io,074110,ES50209546216055661299,7157.03,2024-03-25T08:25:04,Amurrio,expenses,clothing,-117.49,2426.23
buyer_3,Ana,Piñeiro,1989-08-23,43610689K,ana.piñeiro@awesomenet.io,074110,ES50209546216055661299,7157.03,2024-03-27T15:42:55,Amurrio,expenses,education,-73.96,2352.27
buyer_3,Ana,Piñeiro,1989-08-23,43610689K,ana.piñeiro@awesomenet.io,074110,ES50209546216055661299,7157.03,2024-03-29T16:18:45,Amurrio,expenses,transport,-54.85,2297.42
buyer_3,Ana,Piñeiro,1989-08-23,43610689K,ana.piñeiro@awesomenet.io,074110,ES50209546216055661299,7157.03,2024-04-01T19:45:25,Amurrio,incomes,salary,3550.17,5847.59
buyer_3,Ana,Piñeiro,1989-08-23,43610689K,ana.piñeiro@awesomenet.io,074110,ES50209546216055661299,7157.03,2024-04-01T19:45:25,Amurrio,incomes,salary_partner,3288.36,9135.95
buyer_3,Ana,Piñeiro,1989-08-23,43610689K,ana.piñeiro@awesomenet.io,074110,ES50209546216055661299,7157.03,2024-04-01T15:59:19,Amurrio,expenses,transport,-65.85,9070.1
buyer_3,Ana,Piñeiro,1989-08-23,43610689K,ana.piñeiro@awesomenet.io,074110,ES50209546216055661299,7157.03,2024-04-02T17:24:14,Amurrio,expenses,leisure,-33.75,9036.35
buyer_3,Ana,Piñeiro,1989-08-23,43610689K,ana.piñeiro@awesomenet.io,074110,ES50209546216055661299,7157.03,2024-04-04T13:19:48,Amurrio,expenses,mortgage,-3421.84,5614.51
buyer_3,Ana,Piñeiro,1989-08-23,43610689K,ana.piñeiro@awesomenet.io,074110,ES50209546216055661299,7157.03,2024-04-04T19:30:25,Amurrio,expenses,leisure,-59.87,5554.64
buyer_3,Ana,Piñeiro,1989-08-23,43610689K,ana.piñeiro@awesomenet.io,074110,ES50209546216055661299,7157.03,2024-04-04T18:23:12,Amurrio,expenses,clothing,-109.82,5444.82
buyer_3,Ana,Piñeiro,1989-08-23,43610689K,ana.piñeiro@awesomenet.io,074110,ES50209546216055661299,7157.03,2024-04-05T13:32:08,Amurrio,expenses,internet,-143.61,5301.21
buyer_3,Ana,Piñeiro,1989-08-23,43610689K,ana.piñeiro@awesomenet.io,074110,ES50209546216055661299,7157.03,2024-04-05T04:39:13,Amurrio,expenses,phone,-107.33,5193.88
buyer_3,Ana,Piñeiro,1989-08-23,43610689K,ana.piñeiro@awesomenet.io,074110,ES50209546216055661299,7157.03,2024-04-05T14:43:30,Amurrio,expenses,food,-69.95,5123.93
buyer_3,Ana,Piñeiro,1989-08-23,43610689K,ana.piñeiro@awesomenet.io,074110,ES50209546216055661299,7157.03,2024-04-06T15:59:55,Amurrio,expenses,water,-140.76,4983.17
buyer_3,Ana,Piñeiro,1989-08-23,43610689K,ana.piñeiro@awesomenet.io,074110,ES50209546216055661299,7157.03,2024-04-06T17:01:42,Amurrio,expenses,internet,-143.61,4839.56
buyer_3,Ana,Piñeiro,1989-08-23,43610689K,ana.piñeiro@awesomenet.io,074110,ES50209546216055661299,7157.03,2024-04-06T10:10:24,Amurrio,expenses,transport,-62.2,4777.36
buyer_3,Ana,Piñeiro,1989-08-23,43610689K,ana.piñeiro@awesomenet.io,074110,ES50209546216055661299,7157.03,2024-04-09T12:30:04,Amurrio,expenses,food,-99.17,4678.19
buyer_3,Ana,Piñeiro,1989-08-23,43610689K,ana.piñeiro@awesomenet.io,074110,ES50209546216055661299,7157.03,2024-04-12T13:19:29,Amurrio,expenses,transport,-83.05,4595.14
buyer_3,Ana,Piñeiro,1989-08-23,43610689K,ana.piñeiro@awesomenet.io,074110,ES50209546216055661299,7157.03,2024-04-14T11:30:00,Amurrio,expenses,cash,-100.0,4495.14
buyer_3,Ana,Piñeiro,1989-08-23,43610689K,ana.piñeiro@awesomenet.io,074110,ES50209546216055661299,7157.03,2024-04-21T12:53:29,Amurrio,expenses,cash,-100.0,4395.14
buyer_3,Ana,Piñeiro,1989-08-23,43610689K,ana.piñeiro@awesomenet.io,074110,ES50209546216055661299,7157.03,2024-04-22T01:29:47,Amurrio,expenses,food,-83.12,4312.02
buyer_3,Ana,Piñeiro,1989-08-23,43610689K,ana.piñeiro@awesomenet.io,074110,ES50209546216055661299,7157.03,2024-04-22T17:43:30,Amurrio,expenses,leisure,-57.36,4254.66
buyer_3,Ana,Piñeiro,1989-08-23,43610689K,ana.piñeiro@awesomenet.io,074110,ES50209546216055661299,7157.03,2024-04-23T13:39:13,Amurrio,expenses,transport,-55.92,4198.74
buyer_3,Ana,Piñeiro,1989-08-23,43610689K,ana.piñeiro@awesomenet.io,074110,ES50209546216055661299,7157.03,2024-04-25T14:41:25,Amurrio,expenses,repairs,-170.45,4028.29
buyer_3,Ana,Piñeiro,1989-08-23,43610689K,ana.piñeiro@awesomenet.io,074110,ES50209546216055661299,7157.03,2024-04-27T17:42:01,Amurrio,expenses,gifts,-308.85,3719.44
buyer_3,Ana,Piñeiro,1989-08-23,43610689K,ana.piñeiro@awesomenet.io,074110,ES50209546216055661299,7157.03,2024-04-28T11:20:02,Amurrio,expenses,appliances,-293.49,3425.95
buyer_3,Ana,Piñeiro,1989-08-23,43610689K,ana.piñeiro@awesomenet.io,074110,ES50209546216055661299,7157.03,2024-04-30T17:15:13,Amurrio,expenses,education,-57.46,3368.49
buyer_3,Ana,Piñeiro,1989-08-23,43610689K,ana.piñeiro@awesomenet.io,074110,ES50209546216055661299,7157.03,2024-05-01T16:24:38,Amurrio,incomes,salary,3550.17,6918.66
buyer_3,Ana,Piñeiro,1989-08-23,43610689K,ana.piñeiro@awesomenet.io,074110,ES50209546216055661299,7157.03,2024-05-01T16:24:38,Amurrio,incomes,salary_partner,3288.36,10207.02
buyer_3,Ana,Piñeiro,1989-08-23,43610689K,ana.piñeiro@awesomenet.io,074110,ES50209546216055661299,7157.03,2024-05-03T09:20:47,Amurrio,expenses,food,-70.94,10136.08
buyer_3,Ana,Piñeiro,1989-08-23,43610689K,ana.piñeiro@awesomenet.io,074110,ES50209546216055661299,7157.03,2024-05-03T10:38:24,Amurrio,expenses,repairs,-154.64,9981.44
buyer_3,Ana,Piñeiro,1989-08-23,43610689K,ana.piñeiro@awesomenet.io,074110,ES50209546216055661299,7157.03,2024-05-04T09:08:04,Amurrio,expenses,mortgage,-3421.84,6559.6
buyer_3,Ana,Piñeiro,1989-08-23,43610689K,ana.piñeiro@awesomenet.io,074110,ES50209546216055661299,7157.03,2024-05-04T12:50:11,Amurrio,expenses,food,-88.05,6471.55
buyer_3,Ana,Piñeiro,1989-08-23,43610689K,ana.piñeiro@awesomenet.io,074110,ES50209546216055661299,7157.03,2024-05-05T09:56:58,Amurrio,expenses,gas,-224.71,6246.84
buyer_3,Ana,Piñeiro,1989-08-23,43610689K,ana.piñeiro@awesomenet.io,074110,ES50209546216055661299,7157.03,2024-05-06T15:43:37,Amurrio,expenses,clothing,-54.35,6192.49
buyer_3,Ana,Piñeiro,1989-08-23,43610689K,ana.piñeiro@awesomenet.io,074110,ES50209546216055661299,7157.03,2024-05-07T08:06:10,Amurrio,expenses,water,-143.28,6049.21
buyer_3,Ana,Piñeiro,1989-08-23,43610689K,ana.piñeiro@awesomenet.io,074110,ES50209546216055661299,7157.03,2024-05-07T04:05:37,Amurrio,expenses,gas,-241.77,5807.44
buyer_3,Ana,Piñeiro,1989-08-23,43610689K,ana.piñeiro@awesomenet.io,074110,ES50209546216055661299,7157.03,2024-05-08T08:03:41,Amurrio,expenses,internet,-143.61,5663.83
buyer_3,Ana,Piñeiro,1989-08-23,43610689K,ana.piñeiro@awesomenet.io,074110,ES50209546216055661299,7157.03,2024-05-08T14:59:12,Amurrio,expenses,phone,-147.6,5516.23
buyer_3,Ana,Piñeiro,1989-08-23,43610689K,ana.piñeiro@awesomenet.io,074110,ES50209546216055661299,7157.03,2024-05-10T17:25:14,Amurrio,expenses,education,-44.19,5472.04
buyer_3,Ana,Piñeiro,1989-08-23,43610689K,ana.piñeiro@awesomenet.io,074110,ES50209546216055661299,7157.03,2024-05-10T12:49:56,Amurrio,expenses,cash,-100.0,5372.04
buyer_3,Ana,Piñeiro,1989-08-23,43610689K,ana.piñeiro@awesomenet.io,074110,ES50209546216055661299,7157.03,2024-05-11T15:19:05,Amurrio,expenses,education,-43.38,5328.66
buyer_3,Ana,Piñeiro,1989-08-23,43610689K,ana.piñeiro@awesomenet.io,074110,ES50209546216055661299,7157.03,2024-05-12T17:53:29,Amurrio,expenses,cash,-100.0,5228.66
buyer_3,Ana,Piñeiro,1989-08-23,43610689K,ana.piñeiro@awesomenet.io,074110,ES50209546216055661299,7157.03,2024-05-14T10:27:23,Amurrio,expenses,repairs,-258.35,4970.31
buyer_3,Ana,Piñeiro,1989-08-23,43610689K,ana.piñeiro@awesomenet.io,074110,ES50209546216055661299,7157.03,2024-05-15T16:42:06,Amurrio,expenses,healthcare,-147.33,4822.98
buyer_3,Ana,Piñeiro,1989-08-23,43610689K,ana.piñeiro@awesomenet.io,074110,ES50209546216055661299,7157.03,2024-05-17T02:34:15,Amurrio,expenses,leisure,-52.59,4770.39
buyer_3,Ana,Piñeiro,1989-08-23,43610689K,ana.piñeiro@awesomenet.io,074110,ES50209546216055661299,7157.03,2024-05-19T13:16:09,Amurrio,expenses,cash,-100.0,4670.39
buyer_3,Ana,Piñeiro,1989-08-23,43610689K,ana.piñeiro@awesomenet.io,074110,ES50209546216055661299,7157.03,2024-05-20T18:19:18,Amurrio,expenses,cash,-100.0,4570.39
buyer_3,Ana,Piñeiro,1989-08-23,43610689K,ana.piñeiro@awesomenet.io,074110,ES50209546216055661299,7157.03,2024-05-21T13:29:33,Amurrio,expenses,leisure,-24.47,4545.92
buyer_3,Ana,Piñeiro,1989-08-23,43610689K,ana.piñeiro@awesomenet.io,074110,ES50209546216055661299,7157.03,2024-05-21T21:47:32,Amurrio,expenses,cash,-100.0,4445.92
buyer_3,Ana,Piñeiro,1989-08-23,43610689K,ana.piñeiro@awesomenet.io,074110,ES50209546216055661299,7157.03,2024-05-21T09:28:08,Amurrio,expenses,gifts,-603.63,3842.29
buyer_3,Ana,Piñeiro,1989-08-23,43610689K,ana.piñeiro@awesomenet.io,074110,ES50209546216055661299,7157.03,2024-05-23T10:13:41,Amurrio,expenses,cash,-100.0,3742.29
buyer_3,Ana,Piñeiro,1989-08-23,43610689K,ana.piñeiro@awesomenet.io,074110,ES50209546216055661299,7157.03,2024-05-24T10:53:35,Amurrio,expenses,food,-72.17,3670.12
buyer_3,Ana,Piñeiro,1989-08-23,43610689K,ana.piñeiro@awesomenet.io,074110,ES50209546216055661299,7157.03,2024-05-24T10:31:36,Amurrio,expenses,leisure,-24.35,3645.77
buyer_3,Ana,Piñeiro,1989-08-23,43610689K,ana.piñeiro@awesomenet.io,074110,ES50209546216055661299,7157.03,2024-05-24T18:59:35,Amurrio,expenses,education,-71.11,3574.66
buyer_3,Ana,Piñeiro,1989-08-23,43610689K,ana.piñeiro@awesomenet.io,074110,ES50209546216055661299,7157.03,2024-05-25T11:56:59,Amurrio,expenses,transport,-61.96,3512.7
buyer_3,Ana,Piñeiro,1989-08-23,43610689K,ana.piñeiro@awesomenet.io,074110,ES50209546216055661299,7157.03,2024-05-25T20:30:48,Amurrio,expenses,leisure,-56.45,3456.25
buyer_3,Ana,Piñeiro,1989-08-23,43610689K,ana.piñeiro@awesomenet.io,074110,ES50209546216055661299,7157.03,2024-05-25T16:39:45,Amurrio,expenses,education,-55.72,3400.53
buyer_3,Ana,Piñeiro,1989-08-23,43610689K,ana.piñeiro@awesomenet.io,074110,ES50209546216055661299,7157.03,2024-05-25T12:25:06,Amurrio,expenses,gifts,-388.72,3011.81
buyer_3,Ana,Piñeiro,1989-08-23,43610689K,ana.piñeiro@awesomenet.io,074110,ES50209546216055661299,7157.03,2024-05-26T11:36:58,Amurrio,expenses,cash,-100.0,2911.81
buyer_3,Ana,Piñeiro,1989-08-23,43610689K,ana.piñeiro@awesomenet.io,074110,ES50209546216055661299,7157.03,2024-05-31T13:36:19,Amurrio,expenses,food,-121.97,2789.84
buyer_3,Ana,Piñeiro,1989-08-23,43610689K,ana.piñeiro@awesomenet.io,074110,ES50209546216055661299,7157.03,2024-06-01T18:02:16,Amurrio,incomes,salary,3550.17,6340.01
buyer_3,Ana,Piñeiro,1989-08-23,43610689K,ana.piñeiro@awesomenet.io,074110,ES50209546216055661299,7157.03,2024-06-01T18:02:16,Amurrio,incomes,salary_partner,3288.36,9628.37
buyer_3,Ana,Piñeiro,1989-08-23,43610689K,ana.piñeiro@awesomenet.io,074110,ES50209546216055661299,7157.03,2024-06-01T18:02:16,Amurrio,incomes,extra_income,346.04,9974.41
buyer_3,Ana,Piñeiro,1989-08-23,43610689K,ana.piñeiro@awesomenet.io,074110,ES50209546216055661299,7157.03,2024-06-01T18:02:16,Amurrio,incomes,salary_bonus,2541.32,12515.73
buyer_3,Ana,Piñeiro,1989-08-23,43610689K,ana.piñeiro@awesomenet.io,074110,ES50209546216055661299,7157.03,2024-06-01T18:02:16,Amurrio,incomes,salary_partner_bonus,2333.21,14848.94
buyer_3,Ana,Piñeiro,1989-08-23,43610689K,ana.piñeiro@awesomenet.io,074110,ES50209546216055661299,7157.03,2024-06-01T14:10:20,Amurrio,expenses,taxes,-5540.42,9308.52
buyer_3,Ana,Piñeiro,1989-08-23,43610689K,ana.piñeiro@awesomenet.io,074110,ES50209546216055661299,7157.03,2024-06-01T22:19:18,Amurrio,expenses,insurance,-1204.09,8104.43
buyer_3,Ana,Piñeiro,1989-08-23,43610689K,ana.piñeiro@awesomenet.io,074110,ES50209546216055661299,7157.03,2024-06-03T14:54:31,Amurrio,expenses,food,-105.29,7999.14
buyer_3,Ana,Piñeiro,1989-08-23,43610689K,ana.piñeiro@awesomenet.io,074110,ES50209546216055661299,7157.03,2024-06-04T14:22:11,Amurrio,expenses,mortgage,-3421.84,4577.3
buyer_3,Ana,Piñeiro,1989-08-23,43610689K,ana.piñeiro@awesomenet.io,074110,ES50209546216055661299,7157.03,2024-06-04T11:54:05,Amurrio,expenses,transport,-61.04,4516.26
buyer_3,Ana,Piñeiro,1989-08-23,43610689K,ana.piñeiro@awesomenet.io,074110,ES50209546216055661299,7157.03,2024-06-04T16:09:42,Amurrio,expenses,leisure,-56.7,4459.56
buyer_3,Ana,Piñeiro,1989-08-23,43610689K,ana.piñeiro@awesomenet.io,074110,ES50209546216055661299,7157.03,2024-06-05T20:38:30,Amurrio,expenses,water,-125.4,4334.16
buyer_3,Ana,Piñeiro,1989-08-23,43610689K,ana.piñeiro@awesomenet.io,074110,ES50209546216055661299,7157.03,2024-06-05T19:41:59,Amurrio,expenses,phone,-142.03,4192.13
buyer_3,Ana,Piñeiro,1989-08-23,43610689K,ana.piñeiro@awesomenet.io,074110,ES50209546216055661299,7157.03,2024-06-05T06:04:42,Amurrio,expenses,food,-78.85,4113.28
buyer_3,Ana,Piñeiro,1989-08-23,43610689K,ana.piñeiro@awesomenet.io,074110,ES50209546216055661299,7157.03,2024-06-05T13:06:10,Amurrio,expenses,transport,-40.45,4072.83
buyer_3,Ana,Piñeiro,1989-08-23,43610689K,ana.piñeiro@awesomenet.io,074110,ES50209546216055661299,7157.03,2024-06-05T23:25:16,Amurrio,expenses,cash,-100.0,3972.83
buyer_3,Ana,Piñeiro,1989-08-23,43610689K,ana.piñeiro@awesomenet.io,074110,ES50209546216055661299,7157.03,2024-06-06T13:50:22,Amurrio,expenses,internet,-143.61,3829.22
buyer_3,Ana,Piñeiro,1989-08-23,43610689K,ana.piñeiro@awesomenet.io,074110,ES50209546216055661299,7157.03,2024-06-06T20:04:20,Amurrio,expenses,food,-92.48,3736.74
buyer_3,Ana,Piñeiro,1989-08-23,43610689K,ana.piñeiro@awesomenet.io,074110,ES50209546216055661299,7157.03,2024-06-06T23:24:25,Amurrio,expenses,cash,-100.0,3636.74
buyer_3,Ana,Piñeiro,1989-08-23,43610689K,ana.piñeiro@awesomenet.io,074110,ES50209546216055661299,7157.03,2024-06-07T16:55:48,Amurrio,expenses,cash,-100.0,3536.74
buyer_3,Ana,Piñeiro,1989-08-23,43610689K,ana.piñeiro@awesomenet.io,074110,ES50209546216055661299,7157.03,2024-06-07T17:38:53,Amurrio,expenses,repairs,-140.1,3396.64
buyer_3,Ana,Piñeiro,1989-08-23,43610689K,ana.piñeiro@awesomenet.io,074110,ES50209546216055661299,7157.03,2024-06-08T13:08:54,Amurrio,expenses,internet,-143.61,3253.03
buyer_3,Ana,Piñeiro,1989-08-23,43610689K,ana.piñeiro@awesomenet.io,074110,ES50209546216055661299,7157.03,2024-06-08T19:59:39,Amurrio,expenses,repairs,-271.78,2981.25
buyer_3,Ana,Piñeiro,1989-08-23,43610689K,ana.piñeiro@awesomenet.io,074110,ES50209546216055661299,7157.03,2024-06-09T08:30:33,Amurrio,expenses,food,-94.51,2886.74
buyer_3,Ana,Piñeiro,1989-08-23,43610689K,ana.piñeiro@awesomenet.io,074110,ES50209546216055661299,7157.03,2024-06-09T23:34:29,Amurrio,expenses,cash,-100.0,2786.74
buyer_3,Ana,Piñeiro,1989-08-23,43610689K,ana.piñeiro@awesomenet.io,074110,ES50209546216055661299,7157.03,2024-06-09T19:42:41,Amurrio,expenses,gifts,-431.85,2354.89
buyer_3,Ana,Piñeiro,1989-08-23,43610689K,ana.piñeiro@awesomenet.io,074110,ES50209546216055661299,7157.03,2024-06-10T22:34:41,Amurrio,expenses,leisure,-20.35,2334.54
buyer_3,Ana,Piñeiro,1989-08-23,43610689K,ana.piñeiro@awesomenet.io,074110,ES50209546216055661299,7157.03,2024-06-11T12:30:09,Amurrio,expenses,repairs,-244.52,2090.02
buyer_3,Ana,Piñeiro,1989-08-23,43610689K,ana.piñeiro@awesomenet.io,074110,ES50209546216055661299,7157.03,2024-06-14T09:17:09,Amurrio,expenses,cash,-100.0,1990.02
buyer_3,Ana,Piñeiro,1989-08-23,43610689K,ana.piñeiro@awesomenet.io,074110,ES50209546216055661299,7157.03,2024-06-15T12:31:09,Amurrio,expenses,transport,-66.3,1923.72
buyer_3,Ana,Piñeiro,1989-08-23,43610689K,ana.piñeiro@awesomenet.io,074110,ES50209546216055661299,7157.03,2024-06-16T23:15:06,Amurrio,expenses,gifts,-348.33,1575.39
buyer_3,Ana,Piñeiro,1989-08-23,43610689K,ana.piñeiro@awesomenet.io,074110,ES50209546216055661299,7157.03,2024-06-17T16:09:44,Amurrio,expenses,transport,-87.6,1487.79
buyer_3,Ana,Piñeiro,1989-08-23,43610689K,ana.piñeiro@awesomenet.io,074110,ES50209546216055661299,7157.03,2024-06-17T19:24:37,Amurrio,expenses,cash,-100.0,1387.79
buyer_3,Ana,Piñeiro,1989-08-23,43610689K,ana.piñeiro@awesomenet.io,074110,ES50209546216055661299,7157.03,2024-06-18T17:48:33,Amurrio,expenses,healthcare,-131.19,1256.6
buyer_3,Ana,Piñeiro,1989-08-23,43610689K,ana.piñeiro@awesomenet.io,074110,ES50209546216055661299,7157.03,2024-06-19T10:34:50,Amurrio,expenses,cash,-100.0,1156.6
buyer_3,Ana,Piñeiro,1989-08-23,43610689K,ana.piñeiro@awesomenet.io,074110,ES50209546216055661299,7157.03,2024-06-20T17:37:38,Amurrio,expenses,gifts,-671.65,484.95
buyer_3,Ana,Piñeiro,1989-08-23,43610689K,ana.piñeiro@awesomenet.io,074110,ES50209546216055661299,7157.03,2024-06-21T12:22:17,Amurrio,expenses,clothing,-154.87,330.08
buyer_3,Ana,Piñeiro,1989-08-23,43610689K,ana.piñeiro@awesomenet.io,074110,ES50209546216055661299,7157.03,2024-06-22T15:45:05,Amurrio,expenses,transport,-77.98,252.1
buyer_3,Ana,Piñeiro,1989-08-23,43610689K,ana.piñeiro@awesomenet.io,074110,ES50209546216055661299,7157.03,2024-06-22T20:41:14,Amurrio,expenses,leisure,-65.97,186.13
buyer_3,Ana,Piñeiro,1989-08-23,43610689K,ana.piñeiro@awesomenet.io,074110,ES50209546216055661299,7157.03,2024-06-25T17:59:34,Amurrio,expenses,transport,-71.33,114.8
buyer_3,Ana,Piñeiro,1989-08-23,43610689K,ana.piñeiro@awesomenet.io,074110,ES50209546216055661299,7157.03,2024-06-25T14:58:39,Amurrio,expenses,clothing,-112.88,1.92
buyer_3,Ana,Piñeiro,1989-08-23,43610689K,ana.piñeiro@awesomenet.io,074110,ES50209546216055661299,7157.03,2024-06-26T08:36:59,Amurrio,expenses,transport,-63.9,-61.98
buyer_3,Ana,Piñeiro,1989-08-23,43610689K,ana.piñeiro@awesomenet.io,074110,ES50209546216055661299,7157.03,2024-06-26T22:50:19,Amurrio,expenses,appliances,-141.42,-203.4
buyer_3,Ana,Piñeiro,1989-08-23,43610689K,ana.piñeiro@awesomenet.io,074110,ES50209546216055661299,7157.03,2024-06-28T11:16:41,Amurrio,expenses,transport,-67.61,-271.01
buyer_3,Ana,Piñeiro,1989-08-23,43610689K,ana.piñeiro@awesomenet.io,074110,ES50209546216055661299,7157.03,2024-06-28T10:58:55,Amurrio,expenses,repairs,-256.85,-527.86
buyer_3,Ana,Piñeiro,1989-08-23,43610689K,ana.piñeiro@awesomenet.io,074110,ES50209546216055661299,7157.03,2024-06-29T08:32:08,Amurrio,expenses,transport,-85.38,-613.24
buyer_3,Ana,Piñeiro,1989-08-23,43610689K,ana.piñeiro@awesomenet.io,074110,ES50209546216055661299,7157.03,2024-06-29T15:51:26,Amurrio,expenses,education,-77.67,-690.91
buyer_3,Ana,Piñeiro,1989-08-23,43610689K,ana.piñeiro@awesomenet.io,074110,ES50209546216055661299,7157.03,2024-06-29T11:05:18,Amurrio,expenses,appliances,-219.56,-910.47
buyer_3,Ana,Piñeiro,1989-08-23,43610689K,ana.piñeiro@awesomenet.io,074110,ES50209546216055661299,7157.03,2024-07-01T14:43:54,Amurrio,incomes,salary,3550.17,2639.7
buyer_3,Ana,Piñeiro,1989-08-23,43610689K,ana.piñeiro@awesomenet.io,074110,ES50209546216055661299,7157.03,2024-07-01T14:43:54,Amurrio,incomes,salary_partner,3288.36,5928.06
buyer_3,Ana,Piñeiro,1989-08-23,43610689K,ana.piñeiro@awesomenet.io,074110,ES50209546216055661299,7157.03,2024-07-01T09:23:10,Amurrio,expenses,leisure,-23.61,5904.45
buyer_3,Ana,Piñeiro,1989-08-23,43610689K,ana.piñeiro@awesomenet.io,074110,ES50209546216055661299,7157.03,2024-07-02T18:02:17,Amurrio,expenses,leisure,-52.42,5852.03
buyer_3,Ana,Piñeiro,1989-08-23,43610689K,ana.piñeiro@awesomenet.io,074110,ES50209546216055661299,7157.03,2024-07-03T11:29:27,Amurrio,expenses,food,-109.55,5742.48
buyer_3,Ana,Piñeiro,1989-08-23,43610689K,ana.piñeiro@awesomenet.io,074110,ES50209546216055661299,7157.03,2024-07-04T15:16:41,Amurrio,expenses,mortgage,-3421.84,2320.64
buyer_3,Ana,Piñeiro,1989-08-23,43610689K,ana.piñeiro@awesomenet.io,074110,ES50209546216055661299,7157.03,2024-07-04T22:30:06,Amurrio,expenses,healthcare,-149.71,2170.93
buyer_3,Ana,Piñeiro,1989-08-23,43610689K,ana.piñeiro@awesomenet.io,074110,ES50209546216055661299,7157.03,2024-07-05T19:57:10,Amurrio,expenses,gas,-257.65,1913.28
buyer_3,Ana,Piñeiro,1989-08-23,43610689K,ana.piñeiro@awesomenet.io,074110,ES50209546216055661299,7157.03,2024-07-05T12:34:51,Amurrio,expenses,clothing,-152.51,1760.77
buyer_3,Ana,Piñeiro,1989-08-23,43610689K,ana.piñeiro@awesomenet.io,074110,ES50209546216055661299,7157.03,2024-07-06T14:21:39,Amurrio,expenses,electricity,-247.54,1513.23
buyer_3,Ana,Piñeiro,1989-08-23,43610689K,ana.piñeiro@awesomenet.io,074110,ES50209546216055661299,7157.03,2024-07-06T19:37:33,Amurrio,expenses,gas,-298.86,1214.37
buyer_3,Ana,Piñeiro,1989-08-23,43610689K,ana.piñeiro@awesomenet.io,074110,ES50209546216055661299,7157.03,2024-07-06T11:47:01,Amurrio,expenses,phone,-117.14,1097.23
buyer_3,Ana,Piñeiro,1989-08-23,43610689K,ana.piñeiro@awesomenet.io,074110,ES50209546216055661299,7157.03,2024-07-07T20:29:38,Amurrio,expenses,cash,-100.0,997.23
buyer_3,Ana,Piñeiro,1989-08-23,43610689K,ana.piñeiro@awesomenet.io,074110,ES50209546216055661299,7157.03,2024-07-08T09:57:54,Amurrio,expenses,electricity,-284.06,713.17
buyer_3,Ana,Piñeiro,1989-08-23,43610689K,ana.piñeiro@awesomenet.io,074110,ES50209546216055661299,7157.03,2024-07-08T13:37:39,Amurrio,expenses,food,-111.22,601.95
buyer_3,Ana,Piñeiro,1989-08-23,43610689K,ana.piñeiro@awesomenet.io,074110,ES50209546216055661299,7157.03,2024-07-08T11:36:08,Amurrio,expenses,leisure,-81.23,520.72
buyer_3,Ana,Piñeiro,1989-08-23,43610689K,ana.piñeiro@awesomenet.io,074110,ES50209546216055661299,7157.03,2024-07-09T11:02:42,Amurrio,expenses,healthcare,-78.43,442.29
buyer_3,Ana,Piñeiro,1989-08-23,43610689K,ana.piñeiro@awesomenet.io,074110,ES50209546216055661299,7157.03,2024-07-09T15:06:19,Amurrio,expenses,cash,-100.0,342.29
buyer_3,Ana,Piñeiro,1989-08-23,43610689K,ana.piñeiro@awesomenet.io,074110,ES50209546216055661299,7157.03,2024-07-11T08:30:03,Amurrio,expenses,healthcare,-84.35,257.94
buyer_3,Ana,Piñeiro,1989-08-23,43610689K,ana.piñeiro@awesomenet.io,074110,ES50209546216055661299,7157.03,2024-07-12T15:14:02,Amurrio,expenses,leisure,-63.16,194.78
buyer_3,Ana,Piñeiro,1989-08-23,43610689K,ana.piñeiro@awesomenet.io,074110,ES50209546216055661299,7157.03,2024-07-12T23:52:21,Amurrio,expenses,repairs,-205.41,-10.63
buyer_3,Ana,Piñeiro,1989-08-23,43610689K,ana.piñeiro@awesomenet.io,074110,ES50209546216055661299,7157.03,2024-07-14T08:38:09,Amurrio,expenses,food,-77.88,-88.51
buyer_3,Ana,Piñeiro,1989-08-23,43610689K,ana.piñeiro@awesomenet.io,074110,ES50209546216055661299,7157.03,2024-07-15T08:01:24,Amurrio,expenses,cash,-100.0,-188.51
buyer_3,Ana,Piñeiro,1989-08-23,43610689K,ana.piñeiro@awesomenet.io,074110,ES50209546216055661299,7157.03,2024-07-17T15:48:59,Amurrio,expenses,transport,-69.28,-257.79
buyer_3,Ana,Piñeiro,1989-08-23,43610689K,ana.piñeiro@awesomenet.io,074110,ES50209546216055661299,7157.03,2024-07-18T03:47:44,Amurrio,expenses,leisure,-54.78,-312.57
buyer_3,Ana,Piñeiro,1989-08-23,43610689K,ana.piñeiro@awesomenet.io,074110,ES50209546216055661299,7157.03,2024-07-19T11:44:55,Amurrio,expenses,leisure,-29.02,-341.59
buyer_3,Ana,Piñeiro,1989-08-23,43610689K,ana.piñeiro@awesomenet.io,074110,ES50209546216055661299,7157.03,2024-07-19T17:57:22,Amurrio,expenses,repairs,-175.28,-516.87
buyer_3,Ana,Piñeiro,1989-08-23,43610689K,ana.piñeiro@awesomenet.io,074110,ES50209546216055661299,7157.03,2024-07-21T09:26:23,Amurrio,expenses,food,-84.87,-601.74
buyer_3,Ana,Piñeiro,1989-08-23,43610689K,ana.piñeiro@awesomenet.io,074110,ES50209546216055661299,7157.03,2024-07-21T00:11:44,Amurrio,expenses,appliances,-302.35,-904.09
buyer_3,Ana,Piñeiro,1989-08-23,43610689K,ana.piñeiro@awesomenet.io,074110,ES50209546216055661299,7157.03,2024-07-22T11:41:26,Amurrio,expenses,food,-112.56,-1016.65
buyer_3,Ana,Piñeiro,1989-08-23,43610689K,ana.piñeiro@awesomenet.io,074110,ES50209546216055661299,7157.03,2024-07-22T07:09:44,Amurrio,expenses,transport,-72.24,-1088.89
buyer_3,Ana,Piñeiro,1989-08-23,43610689K,ana.piñeiro@awesomenet.io,074110,ES50209546216055661299,7157.03,2024-07-22T15:37:41,Amurrio,expenses,clothing,-83.49,-1172.38
buyer_3,Ana,Piñeiro,1989-08-23,43610689K,ana.piñeiro@awesomenet.io,074110,ES50209546216055661299,7157.03,2024-07-22T20:23:35,Amurrio,expenses,healthcare,-115.09,-1287.47
buyer_3,Ana,Piñeiro,1989-08-23,43610689K,ana.piñeiro@awesomenet.io,074110,ES50209546216055661299,7157.03,2024-07-23T09:35:01,Amurrio,expenses,leisure,-41.15,-1328.62
buyer_3,Ana,Piñeiro,1989-08-23,43610689K,ana.piñeiro@awesomenet.io,074110,ES50209546216055661299,7157.03,2024-07-25T16:33:48,Amurrio,expenses,cash,-100.0,-1428.62
buyer_3,Ana,Piñeiro,1989-08-23,43610689K,ana.piñeiro@awesomenet.io,074110,ES50209546216055661299,7157.03,2024-07-27T10:14:02,Amurrio,expenses,leisure,-24.53,-1453.15
buyer_3,Ana,Piñeiro,1989-08-23,43610689K,ana.piñeiro@awesomenet.io,074110,ES50209546216055661299,7157.03,2024-07-29T17:28:31,Amurrio,expenses,food,-120.75,-1573.9
buyer_3,Ana,Piñeiro,1989-08-23,43610689K,ana.piñeiro@awesomenet.io,074110,ES50209546216055661299,7157.03,2024-07-29T00:46:10,Amurrio,expenses,leisure,-62.47,-1636.37
buyer_3,Ana,Piñeiro,1989-08-23,43610689K,ana.piñeiro@awesomenet.io,074110,ES50209546216055661299,7157.03,2024-07-31T17:31:15,Amurrio,expenses,leisure,-81.27,-1717.64
buyer_3,Ana,Piñeiro,1989-08-23,43610689K,ana.piñeiro@awesomenet.io,074110,ES50209546216055661299,7157.03,2024-08-01T20:09:19,Amurrio,incomes,salary,3550.17,1832.53
buyer_3,Ana,Piñeiro,1989-08-23,43610689K,ana.piñeiro@awesomenet.io,074110,ES50209546216055661299,7157.03,2024-08-01T20:09:19,Amurrio,incomes,salary_partner,3288.36,5120.89
buyer_3,Ana,Piñeiro,1989-08-23,43610689K,ana.piñeiro@awesomenet.io,074110,ES50209546216055661299,7157.03,2024-08-01T18:37:17,Amurrio,expenses,cash,-100.0,5020.89
buyer_3,Ana,Piñeiro,1989-08-23,43610689K,ana.piñeiro@awesomenet.io,074110,ES50209546216055661299,7157.03,2024-08-03T11:46:53,Amurrio,expenses,cash,-100.0,4920.89
buyer_3,Ana,Piñeiro,1989-08-23,43610689K,ana.piñeiro@awesomenet.io,074110,ES50209546216055661299,7157.03,2024-08-04T15:31:17,Amurrio,expenses,mortgage,-3421.84,1499.05
buyer_3,Ana,Piñeiro,1989-08-23,43610689K,ana.piñeiro@awesomenet.io,074110,ES50209546216055661299,7157.03,2024-08-04T10:05:28,Amurrio,expenses,cash,-100.0,1399.05
buyer_3,Ana,Piñeiro,1989-08-23,43610689K,ana.piñeiro@awesomenet.io,074110,ES50209546216055661299,7157.03,2024-08-04T13:56:29,Amurrio,expenses,repairs,-32.42,1366.63
buyer_3,Ana,Piñeiro,1989-08-23,43610689K,ana.piñeiro@awesomenet.io,074110,ES50209546216055661299,7157.03,2024-08-05T13:27:48,Amurrio,expenses,phone,-139.88,1226.75
buyer_3,Ana,Piñeiro,1989-08-23,43610689K,ana.piñeiro@awesomenet.io,074110,ES50209546216055661299,7157.03,2024-08-05T19:27:23,Amurrio,expenses,repairs,-263.19,963.56
buyer_3,Ana,Piñeiro,1989-08-23,43610689K,ana.piñeiro@awesomenet.io,074110,ES50209546216055661299,7157.03,2024-08-06T09:47:16,Amurrio,expenses,water,-140.93,822.63
buyer_3,Ana,Piñeiro,1989-08-23,43610689K,ana.piñeiro@awesomenet.io,074110,ES50209546216055661299,7157.03,2024-08-06T13:26:02,Amurrio,expenses,gas,-272.58,550.05
buyer_3,Ana,Piñeiro,1989-08-23,43610689K,ana.piñeiro@awesomenet.io,074110,ES50209546216055661299,7157.03,2024-08-06T21:01:08,Amurrio,expenses,internet,-143.61,406.44
buyer_3,Ana,Piñeiro,1989-08-23,43610689K,ana.piñeiro@awesomenet.io,074110,ES50209546216055661299,7157.03,2024-08-06T12:54:09,Amurrio,expenses,food,-98.24,308.2
buyer_3,Ana,Piñeiro,1989-08-23,43610689K,ana.piñeiro@awesomenet.io,074110,ES50209546216055661299,7157.03,2024-08-06T09:48:48,Amurrio,expenses,cash,-100.0,208.2
buyer_3,Ana,Piñeiro,1989-08-23,43610689K,ana.piñeiro@awesomenet.io,074110,ES50209546216055661299,7157.03,2024-08-07T10:05:40,Amurrio,expenses,gas,-213.85,-5.65
buyer_3,Ana,Piñeiro,1989-08-23,43610689K,ana.piñeiro@awesomenet.io,074110,ES50209546216055661299,7157.03,2024-08-07T16:08:23,Amurrio,expenses,internet,-143.61,-149.26
buyer_3,Ana,Piñeiro,1989-08-23,43610689K,ana.piñeiro@awesomenet.io,074110,ES50209546216055661299,7157.03,2024-08-08T10:44:03,Amurrio,expenses,phone,-105.73,-254.99
buyer_3,Ana,Piñeiro,1989-08-23,43610689K,ana.piñeiro@awesomenet.io,074110,ES50209546216055661299,7157.03,2024-08-08T10:23:02,Amurrio,expenses,repairs,-219.41,-474.4
buyer_3,Ana,Piñeiro,1989-08-23,43610689K,ana.piñeiro@awesomenet.io,074110,ES50209546216055661299,7157.03,2024-08-09T13:53:44,Amurrio,expenses,transport,-81.63,-556.03
buyer_3,Ana,Piñeiro,1989-08-23,43610689K,ana.piñeiro@awesomenet.io,074110,ES50209546216055661299,7157.03,2024-08-11T13:27:15,Amurrio,expenses,travel,-783.81,-1339.84
buyer_3,Ana,Piñeiro,1989-08-23,43610689K,ana.piñeiro@awesomenet.io,074110,ES50209546216055661299,7157.03,2024-08-12T18:51:53,Amurrio,expenses,transport,-68.67,-1408.51
buyer_3,Ana,Piñeiro,1989-08-23,43610689K,ana.piñeiro@awesomenet.io,074110,ES50209546216055661299,7157.03,2024-08-12T16:30:15,Amurrio,expenses,leisure,-43.71,-1452.22
buyer_3,Ana,Piñeiro,1989-08-23,43610689K,ana.piñeiro@awesomenet.io,074110,ES50209546216055661299,7157.03,2024-08-13T10:37:37,Amurrio,expenses,leisure,-19.47,-1471.69
buyer_3,Ana,Piñeiro,1989-08-23,43610689K,ana.piñeiro@awesomenet.io,074110,ES50209546216055661299,7157.03,2024-08-13T09:40:21,Amurrio,expenses,repairs,-128.7,-1600.39
buyer_3,Ana,Piñeiro,1989-08-23,43610689K,ana.piñeiro@awesomenet.io,074110,ES50209546216055661299,7157.03,2024-08-14T04:54:49,Amurrio,expenses,leisure,-21.03,-1621.42
buyer_3,Ana,Piñeiro,1989-08-23,43610689K,ana.piñeiro@awesomenet.io,074110,ES50209546216055661299,7157.03,2024-08-15T08:34:47,Amurrio,expenses,transport,-75.83,-1697.25
buyer_3,Ana,Piñeiro,1989-08-23,43610689K,ana.piñeiro@awesomenet.io,074110,ES50209546216055661299,7157.03,2024-08-16T17:42:19,Amurrio,expenses,food,-70.77,-1768.02
buyer_3,Ana,Piñeiro,1989-08-23,43610689K,ana.piñeiro@awesomenet.io,074110,ES50209546216055661299,7157.03,2024-08-16T17:19:09,Amurrio,expenses,leisure,-32.38,-1800.4
buyer_3,Ana,Piñeiro,1989-08-23,43610689K,ana.piñeiro@awesomenet.io,074110,ES50209546216055661299,7157.03,2024-08-16T03:26:00,Amurrio,expenses,clothing,-146.86,-1947.26
buyer_3,Ana,Piñeiro,1989-08-23,43610689K,ana.piñeiro@awesomenet.io,074110,ES50209546216055661299,7157.03,2024-08-18T20:45:09,Amurrio,expenses,cash,-100.0,-2047.26
buyer_3,Ana,Piñeiro,1989-08-23,43610689K,ana.piñeiro@awesomenet.io,074110,ES50209546216055661299,7157.03,2024-08-19T19:37:40,Amurrio,expenses,gifts,-832.82,-2880.08
buyer_3,Ana,Piñeiro,1989-08-23,43610689K,ana.piñeiro@awesomenet.io,074110,ES50209546216055661299,7157.03,2024-08-21T08:03:24,Amurrio,expenses,clothing,-124.94,-3005.02
buyer_3,Ana,Piñeiro,1989-08-23,43610689K,ana.piñeiro@awesomenet.io,074110,ES50209546216055661299,7157.03,2024-08-21T17:53:58,Amurrio,expenses,gifts,-847.79,-3852.81
buyer_3,Ana,Piñeiro,1989-08-23,43610689K,ana.piñeiro@awesomenet.io,074110,ES50209546216055661299,7157.03,2024-08-22T08:19:29,Amurrio,expenses,food,-66.34,-3919.15
buyer_3,Ana,Piñeiro,1989-08-23,43610689K,ana.piñeiro@awesomenet.io,074110,ES50209546216055661299,7157.03,2024-08-25T17:32:20,Amurrio,expenses,transport,-65.91,-3985.06
buyer_3,Ana,Piñeiro,1989-08-23,43610689K,ana.piñeiro@awesomenet.io,074110,ES50209546216055661299,7157.03,2024-08-25T04:51:31,Amurrio,expenses,cash,-100.0,-4085.06
buyer_3,Ana,Piñeiro,1989-08-23,43610689K,ana.piñeiro@awesomenet.io,074110,ES50209546216055661299,7157.03,2024-08-26T19:03:24,Amurrio,expenses,food,-63.38,-4148.44
buyer_3,Ana,Piñeiro,1989-08-23,43610689K,ana.piñeiro@awesomenet.io,074110,ES50209546216055661299,7157.03,2024-08-28T20:33:39,Amurrio,expenses,appliances,-202.06,-4350.5
buyer_3,Ana,Piñeiro,1989-08-23,43610689K,ana.piñeiro@awesomenet.io,074110,ES50209546216055661299,7157.03,2024-08-29T13:50:27,Amurrio,expenses,transport,-65.09,-4415.59
buyer_3,Ana,Piñeiro,1989-08-23,43610689K,ana.piñeiro@awesomenet.io,074110,ES50209546216055661299,7157.03,2024-08-29T19:41:51,Amurrio,expenses,gifts,-337.9,-4753.49
buyer_3,Ana,Piñeiro,1989-08-23,43610689K,ana.piñeiro@awesomenet.io,074110,ES50209546216055661299,7157.03,2024-08-30T06:26:41,Amurrio,expenses,gifts,-560.26,-5313.75
buyer_3,Ana,Piñeiro,1989-08-23,43610689K,ana.piñeiro@awesomenet.io,074110,ES50209546216055661299,7157.03,2024-08-31T17:57:10,Amurrio,expenses,food,-113.98,-5427.73
buyer_3,Ana,Piñeiro,1989-08-23,43610689K,ana.piñeiro@awesomenet.io,074110,ES50209546216055661299,7157.03,2024-09-01T17:34:19,Amurrio,incomes,salary,3550.17,-1877.56
buyer_3,Ana,Piñeiro,1989-08-23,43610689K,ana.piñeiro@awesomenet.io,074110,ES50209546216055661299,7157.03,2024-09-01T17:34:19,Amurrio,incomes,salary_partner,3288.36,1410.8
buyer_3,Ana,Piñeiro,1989-08-23,43610689K,ana.piñeiro@awesomenet.io,074110,ES50209546216055661299,7157.03,2024-09-02T18:45:51,Amurrio,expenses,food,-85.05,1325.75
buyer_3,Ana,Piñeiro,1989-08-23,43610689K,ana.piñeiro@awesomenet.io,074110,ES50209546216055661299,7157.03,2024-09-02T15:35:08,Amurrio,expenses,clothing,-113.69,1212.06
buyer_3,Ana,Piñeiro,1989-08-23,43610689K,ana.piñeiro@awesomenet.io,074110,ES50209546216055661299,7157.03,2024-09-03T20:06:53,Amurrio,expenses,cash,-100.0,1112.06
buyer_3,Ana,Piñeiro,1989-08-23,43610689K,ana.piñeiro@awesomenet.io,074110,ES50209546216055661299,7157.03,2024-09-04T11:11:59,Amurrio,expenses,mortgage,-3421.84,-2309.78
buyer_3,Ana,Piñeiro,1989-08-23,43610689K,ana.piñeiro@awesomenet.io,074110,ES50209546216055661299,7157.03,2024-09-04T10:18:09,Amurrio,expenses,food,-119.69,-2429.47
buyer_3,Ana,Piñeiro,1989-08-23,43610689K,ana.piñeiro@awesomenet.io,074110,ES50209546216055661299,7157.03,2024-09-04T11:21:34,Amurrio,expenses,healthcare,-158.38,-2587.85
buyer_3,Ana,Piñeiro,1989-08-23,43610689K,ana.piñeiro@awesomenet.io,074110,ES50209546216055661299,7157.03,2024-09-05T15:47:32,Amurrio,expenses,phone,-121.97,-2709.82
buyer_3,Ana,Piñeiro,1989-08-23,43610689K,ana.piñeiro@awesomenet.io,074110,ES50209546216055661299,7157.03,2024-09-05T19:09:26,Amurrio,expenses,food,-63.81,-2773.63
buyer_3,Ana,Piñeiro,1989-08-23,43610689K,ana.piñeiro@awesomenet.io,074110,ES50209546216055661299,7157.03,2024-09-06T10:03:27,Amurrio,expenses,electricity,-298.01,-3071.64
buyer_3,Ana,Piñeiro,1989-08-23,43610689K,ana.piñeiro@awesomenet.io,074110,ES50209546216055661299,7157.03,2024-09-08T21:54:18,Amurrio,expenses,water,-130.38,-3202.02
buyer_3,Ana,Piñeiro,1989-08-23,43610689K,ana.piñeiro@awesomenet.io,074110,ES50209546216055661299,7157.03,2024-09-08T16:07:54,Amurrio,expenses,gas,-132.61,-3334.63
buyer_3,Ana,Piñeiro,1989-08-23,43610689K,ana.piñeiro@awesomenet.io,074110,ES50209546216055661299,7157.03,2024-09-08T12:33:51,Amurrio,expenses,phone,-109.98,-3444.61
buyer_3,Ana,Piñeiro,1989-08-23,43610689K,ana.piñeiro@awesomenet.io,074110,ES50209546216055661299,7157.03,2024-09-10T16:23:34,Amurrio,expenses,cash,-100.0,-3544.61
buyer_3,Ana,Piñeiro,1989-08-23,43610689K,ana.piñeiro@awesomenet.io,074110,ES50209546216055661299,7157.03,2024-09-11T10:20:59,Amurrio,expenses,leisure,-61.39,-3606.0
buyer_3,Ana,Piñeiro,1989-08-23,43610689K,ana.piñeiro@awesomenet.io,074110,ES50209546216055661299,7157.03,2024-09-11T20:26:37,Amurrio,expenses,healthcare,-102.91,-3708.91
buyer_3,Ana,Piñeiro,1989-08-23,43610689K,ana.piñeiro@awesomenet.io,074110,ES50209546216055661299,7157.03,2024-09-13T18:12:37,Amurrio,expenses,food,-86.21,-3795.12
buyer_3,Ana,Piñeiro,1989-08-23,43610689K,ana.piñeiro@awesomenet.io,074110,ES50209546216055661299,7157.03,2024-09-14T09:43:35,Amurrio,expenses,leisure,-44.3,-3839.42
buyer_3,Ana,Piñeiro,1989-08-23,43610689K,ana.piñeiro@awesomenet.io,074110,ES50209546216055661299,7157.03,2024-09-15T20:15:33,Amurrio,expenses,transport,-81.12,-3920.54
buyer_3,Ana,Piñeiro,1989-08-23,43610689K,ana.piñeiro@awesomenet.io,074110,ES50209546216055661299,7157.03,2024-09-16T08:11:26,Amurrio,expenses,leisure,-45.16,-3965.7
buyer_3,Ana,Piñeiro,1989-08-23,43610689K,ana.piñeiro@awesomenet.io,074110,ES50209546216055661299,7157.03,2024-09-17T08:37:53,Amurrio,expenses,education,-67.35,-4033.05
buyer_3,Ana,Piñeiro,1989-08-23,43610689K,ana.piñeiro@awesomenet.io,074110,ES50209546216055661299,7157.03,2024-09-18T15:47:46,Amurrio,expenses,transport,-43.19,-4076.24
buyer_3,Ana,Piñeiro,1989-08-23,43610689K,ana.piñeiro@awesomenet.io,074110,ES50209546216055661299,7157.03,2024-09-20T12:11:18,Amurrio,expenses,cash,-100.0,-4176.24
buyer_3,Ana,Piñeiro,1989-08-23,43610689K,ana.piñeiro@awesomenet.io,074110,ES50209546216055661299,7157.03,2024-09-21T13:01:21,Amurrio,expenses,food,-62.66,-4238.9
buyer_3,Ana,Piñeiro,1989-08-23,43610689K,ana.piñeiro@awesomenet.io,074110,ES50209546216055661299,7157.03,2024-09-26T16:52:30,Amurrio,expenses,cash,-100.0,-4338.9
buyer_3,Ana,Piñeiro,1989-08-23,43610689K,ana.piñeiro@awesomenet.io,074110,ES50209546216055661299,7157.03,2024-09-26T19:00:02,Amurrio,expenses,travel,-364.38,-4703.28
buyer_3,Ana,Piñeiro,1989-08-23,43610689K,ana.piñeiro@awesomenet.io,074110,ES50209546216055661299,7157.03,2024-09-29T10:56:29,Amurrio,expenses,travel,-534.75,-5238.03
buyer_3,Ana,Piñeiro,1989-08-23,43610689K,ana.piñeiro@awesomenet.io,074110,ES50209546216055661299,7157.03,2024-09-30T19:49:32,Amurrio,expenses,food,-117.14,-5355.17
buyer_3,Ana,Piñeiro,1989-08-23,43610689K,ana.piñeiro@awesomenet.io,074110,ES50209546216055661299,7157.03,2024-09-30T16:32:32,Amurrio,expenses,healthcare,-56.46,-5411.63
buyer_3,Ana,Piñeiro,1989-08-23,43610689K,ana.piñeiro@awesomenet.io,074110,ES50209546216055661299,7157.03,2024-10-01T13:57:04,Amurrio,incomes,salary,3550.17,-1861.46
buyer_3,Ana,Piñeiro,1989-08-23,43610689K,ana.piñeiro@awesomenet.io,074110,ES50209546216055661299,7157.03,2024-10-01T13:57:04,Amurrio,incomes,salary_partner,3288.36,1426.9
buyer_3,Ana,Piñeiro,1989-08-23,43610689K,ana.piñeiro@awesomenet.io,074110,ES50209546216055661299,7157.03,2024-10-01T13:57:04,Amurrio,incomes,extra_income,346.04,1772.94
buyer_3,Ana,Piñeiro,1989-08-23,43610689K,ana.piñeiro@awesomenet.io,074110,ES50209546216055661299,7157.03,2024-10-01T19:02:14,Amurrio,expenses,healthcare,-175.22,1597.72
buyer_3,Ana,Piñeiro,1989-08-23,43610689K,ana.piñeiro@awesomenet.io,074110,ES50209546216055661299,7157.03,2024-10-03T19:27:58,Amurrio,expenses,education,-62.47,1535.25
buyer_3,Ana,Piñeiro,1989-08-23,43610689K,ana.piñeiro@awesomenet.io,074110,ES50209546216055661299,7157.03,2024-10-04T09:13:50,Amurrio,expenses,mortgage,-3421.84,-1886.59
buyer_3,Ana,Piñeiro,1989-08-23,43610689K,ana.piñeiro@awesomenet.io,074110,ES50209546216055661299,7157.03,2024-10-05T13:25:53,Amurrio,expenses,electricity,-300.88,-2187.47
buyer_3,Ana,Piñeiro,1989-08-23,43610689K,ana.piñeiro@awesomenet.io,074110,ES50209546216055661299,7157.03,2024-10-05T16:42:56,Amurrio,expenses,leisure,-25.71,-2213.18
buyer_3,Ana,Piñeiro,1989-08-23,43610689K,ana.piñeiro@awesomenet.io,074110,ES50209546216055661299,7157.03,2024-10-05T15:22:45,Amurrio,expenses,repairs,-117.03,-2330.21
buyer_3,Ana,Piñeiro,1989-08-23,43610689K,ana.piñeiro@awesomenet.io,074110,ES50209546216055661299,7157.03,2024-10-06T21:11:47,Amurrio,expenses,clothing,-88.99,-2419.2
buyer_3,Ana,Piñeiro,1989-08-23,43610689K,ana.piñeiro@awesomenet.io,074110,ES50209546216055661299,7157.03,2024-10-07T21:00:05,Amurrio,expenses,internet,-143.61,-2562.81
buyer_3,Ana,Piñeiro,1989-08-23,43610689K,ana.piñeiro@awesomenet.io,074110,ES50209546216055661299,7157.03,2024-10-07T07:37:43,Amurrio,expenses,phone,-111.04,-2673.85
buyer_3,Ana,Piñeiro,1989-08-23,43610689K,ana.piñeiro@awesomenet.io,074110,ES50209546216055661299,7157.03,2024-10-07T18:05:57,Amurrio,expenses,gifts,-510.37,-3184.22
buyer_3,Ana,Piñeiro,1989-08-23,43610689K,ana.piñeiro@awesomenet.io,074110,ES50209546216055661299,7157.03,2024-10-08T13:15:26,Amurrio,expenses,transport,-51.85,-3236.07
buyer_3,Ana,Piñeiro,1989-08-23,43610689K,ana.piñeiro@awesomenet.io,074110,ES50209546216055661299,7157.03,2024-10-08T00:38:21,Amurrio,expenses,cash,-100.0,-3336.07
buyer_3,Ana,Piñeiro,1989-08-23,43610689K,ana.piñeiro@awesomenet.io,074110,ES50209546216055661299,7157.03,2024-10-09T09:05:46,Amurrio,expenses,clothing,-125.54,-3461.61
buyer_4,Jorge,Moreno,1974-05-23,40441389Y,jorge.moreno@superapp.digital,216601,ES46209505951516573022,5874.73,2022-01-01T17:41:51,Galdakao,incomes,salary,2415.31,8290.04
buyer_4,Jorge,Moreno,1974-05-23,40441389Y,jorge.moreno@superapp.digital,216601,ES46209505951516573022,5874.73,2022-01-01T19:46:46,Galdakao,expenses,cash,-100.0,8190.04
buyer_4,Jorge,Moreno,1974-05-23,40441389Y,jorge.moreno@superapp.digital,216601,ES46209505951516573022,5874.73,2022-01-02T19:39:53,Galdakao,expenses,travel,-625.41,7564.63
buyer_4,Jorge,Moreno,1974-05-23,40441389Y,jorge.moreno@superapp.digital,216601,ES46209505951516573022,5874.73,2022-01-03T14:03:45,Galdakao,expenses,cash,-100.0,7464.63
buyer_4,Jorge,Moreno,1974-05-23,40441389Y,jorge.moreno@superapp.digital,216601,ES46209505951516573022,5874.73,2022-01-04T16:35:50,Galdakao,expenses,mortgage,-1279.96,6184.67
buyer_4,Jorge,Moreno,1974-05-23,40441389Y,jorge.moreno@superapp.digital,216601,ES46209505951516573022,5874.73,2022-01-04T19:29:33,Galdakao,expenses,children,-739.3549166666666,5445.32
buyer_4,Jorge,Moreno,1974-05-23,40441389Y,jorge.moreno@superapp.digital,216601,ES46209505951516573022,5874.73,2022-01-05T14:43:26,Galdakao,expenses,water,-34.81,5410.51
buyer_4,Jorge,Moreno,1974-05-23,40441389Y,jorge.moreno@superapp.digital,216601,ES46209505951516573022,5874.73,2022-01-05T12:56:27,Galdakao,expenses,internet,-50.72,5359.79
buyer_4,Jorge,Moreno,1974-05-23,40441389Y,jorge.moreno@superapp.digital,216601,ES46209505951516573022,5874.73,2022-01-05T15:27:21,Galdakao,expenses,phone,-53.53,5306.26
buyer_4,Jorge,Moreno,1974-05-23,40441389Y,jorge.moreno@superapp.digital,216601,ES46209505951516573022,5874.73,2022-01-06T15:26:28,Galdakao,expenses,internet,-50.72,5255.54
buyer_4,Jorge,Moreno,1974-05-23,40441389Y,jorge.moreno@superapp.digital,216601,ES46209505951516573022,5874.73,2022-01-06T05:08:21,Galdakao,expenses,food,-116.62,5138.92
buyer_4,Jorge,Moreno,1974-05-23,40441389Y,jorge.moreno@superapp.digital,216601,ES46209505951516573022,5874.73,2022-01-06T23:12:04,Galdakao,expenses,leisure,-37.08,5101.84
buyer_4,Jorge,Moreno,1974-05-23,40441389Y,jorge.moreno@superapp.digital,216601,ES46209505951516573022,5874.73,2022-01-07T22:06:02,Galdakao,expenses,gas,-119.22,4982.62
buyer_4,Jorge,Moreno,1974-05-23,40441389Y,jorge.moreno@superapp.digital,216601,ES46209505951516573022,5874.73,2022-01-07T13:35:02,Galdakao,expenses,phone,-51.53,4931.09
buyer_4,Jorge,Moreno,1974-05-23,40441389Y,jorge.moreno@superapp.digital,216601,ES46209505951516573022,5874.73,2022-01-08T00:41:53,Galdakao,expenses,water,-28.18,4902.91
buyer_4,Jorge,Moreno,1974-05-23,40441389Y,jorge.moreno@superapp.digital,216601,ES46209505951516573022,5874.73,2022-01-08T13:36:06,Galdakao,expenses,internet,-50.72,4852.19
buyer_4,Jorge,Moreno,1974-05-23,40441389Y,jorge.moreno@superapp.digital,216601,ES46209505951516573022,5874.73,2022-01-08T17:06:35,Galdakao,expenses,cash,-100.0,4752.19
buyer_4,Jorge,Moreno,1974-05-23,40441389Y,jorge.moreno@superapp.digital,216601,ES46209505951516573022,5874.73,2022-01-11T20:26:42,Galdakao,expenses,food,-118.44,4633.75
buyer_4,Jorge,Moreno,1974-05-23,40441389Y,jorge.moreno@superapp.digital,216601,ES46209505951516573022,5874.73,2022-01-11T00:16:47,Galdakao,expenses,leisure,-22.55,4611.2
buyer_4,Jorge,Moreno,1974-05-23,40441389Y,jorge.moreno@superapp.digital,216601,ES46209505951516573022,5874.73,2022-01-12T10:30:54,Galdakao,expenses,leisure,-34.54,4576.66
buyer_4,Jorge,Moreno,1974-05-23,40441389Y,jorge.moreno@superapp.digital,216601,ES46209505951516573022,5874.73,2022-01-13T05:51:48,Galdakao,expenses,travel,-568.95,4007.71
buyer_4,Jorge,Moreno,1974-05-23,40441389Y,jorge.moreno@superapp.digital,216601,ES46209505951516573022,5874.73,2022-01-14T08:11:36,Galdakao,expenses,gifts,-435.61,3572.1
buyer_4,Jorge,Moreno,1974-05-23,40441389Y,jorge.moreno@superapp.digital,216601,ES46209505951516573022,5874.73,2022-01-18T13:23:46,Galdakao,expenses,cash,-100.0,3472.1
buyer_4,Jorge,Moreno,1974-05-23,40441389Y,jorge.moreno@superapp.digital,216601,ES46209505951516573022,5874.73,2022-01-19T06:18:10,Galdakao,expenses,leisure,-79.34,3392.76
buyer_4,Jorge,Moreno,1974-05-23,40441389Y,jorge.moreno@superapp.digital,216601,ES46209505951516573022,5874.73,2022-01-20T17:05:24,Galdakao,expenses,food,-103.59,3289.17
buyer_4,Jorge,Moreno,1974-05-23,40441389Y,jorge.moreno@superapp.digital,216601,ES46209505951516573022,5874.73,2022-01-23T11:28:55,Galdakao,expenses,healthcare,-111.94,3177.23
buyer_4,Jorge,Moreno,1974-05-23,40441389Y,jorge.moreno@superapp.digital,216601,ES46209505951516573022,5874.73,2022-01-24T17:49:39,Galdakao,expenses,gifts,-87.88,3089.35
buyer_4,Jorge,Moreno,1974-05-23,40441389Y,jorge.moreno@superapp.digital,216601,ES46209505951516573022,5874.73,2022-01-25T11:17:42,Galdakao,expenses,food,-101.5,2987.85
buyer_4,Jorge,Moreno,1974-05-23,40441389Y,jorge.moreno@superapp.digital,216601,ES46209505951516573022,5874.73,2022-01-26T16:55:55,Galdakao,expenses,cash,-100.0,2887.85
buyer_4,Jorge,Moreno,1974-05-23,40441389Y,jorge.moreno@superapp.digital,216601,ES46209505951516573022,5874.73,2022-01-27T09:15:25,Galdakao,expenses,food,-82.2,2805.65
buyer_4,Jorge,Moreno,1974-05-23,40441389Y,jorge.moreno@superapp.digital,216601,ES46209505951516573022,5874.73,2022-01-27T18:43:31,Galdakao,expenses,clothing,-107.74,2697.91
buyer_4,Jorge,Moreno,1974-05-23,40441389Y,jorge.moreno@superapp.digital,216601,ES46209505951516573022,5874.73,2022-01-27T14:11:35,Galdakao,expenses,cash,-100.0,2597.91
buyer_4,Jorge,Moreno,1974-05-23,40441389Y,jorge.moreno@superapp.digital,216601,ES46209505951516573022,5874.73,2022-01-28T01:53:16,Galdakao,expenses,food,-86.27,2511.64
buyer_4,Jorge,Moreno,1974-05-23,40441389Y,jorge.moreno@superapp.digital,216601,ES46209505951516573022,5874.73,2022-01-29T11:41:55,Galdakao,expenses,education,-70.31,2441.33
buyer_4,Jorge,Moreno,1974-05-23,40441389Y,jorge.moreno@superapp.digital,216601,ES46209505951516573022,5874.73,2022-01-31T18:31:32,Galdakao,expenses,food,-101.87,2339.46
buyer_4,Jorge,Moreno,1974-05-23,40441389Y,jorge.moreno@superapp.digital,216601,ES46209505951516573022,5874.73,2022-01-31T16:02:29,Galdakao,expenses,cash,-100.0,2239.46
buyer_4,Jorge,Moreno,1974-05-23,40441389Y,jorge.moreno@superapp.digital,216601,ES46209505951516573022,5874.73,2022-02-01T07:54:56,Galdakao,incomes,salary,2415.31,4654.77
buyer_4,Jorge,Moreno,1974-05-23,40441389Y,jorge.moreno@superapp.digital,216601,ES46209505951516573022,5874.73,2022-02-01T03:58:30,Galdakao,expenses,transport,-52.81,4601.96
buyer_4,Jorge,Moreno,1974-05-23,40441389Y,jorge.moreno@superapp.digital,216601,ES46209505951516573022,5874.73,2022-02-01T16:46:27,Galdakao,expenses,leisure,-38.53,4563.43
buyer_4,Jorge,Moreno,1974-05-23,40441389Y,jorge.moreno@superapp.digital,216601,ES46209505951516573022,5874.73,2022-02-01T14:08:21,Galdakao,expenses,appliances,-150.02,4413.41
buyer_4,Jorge,Moreno,1974-05-23,40441389Y,jorge.moreno@superapp.digital,216601,ES46209505951516573022,5874.73,2022-02-04T23:33:42,Galdakao,expenses,mortgage,-1279.96,3133.45
buyer_4,Jorge,Moreno,1974-05-23,40441389Y,jorge.moreno@superapp.digital,216601,ES46209505951516573022,5874.73,2022-02-04T16:35:07,Galdakao,expenses,repairs,-27.12,3106.33
buyer_4,Jorge,Moreno,1974-05-23,40441389Y,jorge.moreno@superapp.digital,216601,ES46209505951516573022,5874.73,2022-02-05T13:36:14,Galdakao,expenses,electricity,-93.52,3012.81
buyer_4,Jorge,Moreno,1974-05-23,40441389Y,jorge.moreno@superapp.digital,216601,ES46209505951516573022,5874.73,2022-02-05T00:31:32,Galdakao,expenses,gifts,-650.74,2362.07
buyer_4,Jorge,Moreno,1974-05-23,40441389Y,jorge.moreno@superapp.digital,216601,ES46209505951516573022,5874.73,2022-02-06T14:21:06,Galdakao,expenses,water,-52.46,2309.61
buyer_4,Jorge,Moreno,1974-05-23,40441389Y,jorge.moreno@superapp.digital,216601,ES46209505951516573022,5874.73,2022-02-06T09:38:05,Galdakao,expenses,electricity,-35.32,2274.29
buyer_4,Jorge,Moreno,1974-05-23,40441389Y,jorge.moreno@superapp.digital,216601,ES46209505951516573022,5874.73,2022-02-07T08:29:27,Galdakao,expenses,water,-25.26,2249.03
buyer_4,Jorge,Moreno,1974-05-23,40441389Y,jorge.moreno@superapp.digital,216601,ES46209505951516573022,5874.73,2022-02-07T22:43:00,Galdakao,expenses,travel,-709.0,1540.03
buyer_4,Jorge,Moreno,1974-05-23,40441389Y,jorge.moreno@superapp.digital,216601,ES46209505951516573022,5874.73,2022-02-08T15:18:09,Galdakao,expenses,water,-51.62,1488.41
buyer_4,Jorge,Moreno,1974-05-23,40441389Y,jorge.moreno@superapp.digital,216601,ES46209505951516573022,5874.73,2022-02-08T19:41:55,Galdakao,expenses,gas,-70.07,1418.34
buyer_4,Jorge,Moreno,1974-05-23,40441389Y,jorge.moreno@superapp.digital,216601,ES46209505951516573022,5874.73,2022-02-08T16:24:19,Galdakao,expenses,phone,-48.37,1369.97
buyer_4,Jorge,Moreno,1974-05-23,40441389Y,jorge.moreno@superapp.digital,216601,ES46209505951516573022,5874.73,2022-02-09T18:51:29,Galdakao,expenses,appliances,-279.03,1090.94
buyer_4,Jorge,Moreno,1974-05-23,40441389Y,jorge.moreno@superapp.digital,216601,ES46209505951516573022,5874.73,2022-02-10T06:56:42,Galdakao,expenses,food,-77.13,1013.81
buyer_4,Jorge,Moreno,1974-05-23,40441389Y,jorge.moreno@superapp.digital,216601,ES46209505951516573022,5874.73,2022-02-14T10:31:53,Galdakao,expenses,cash,-100.0,913.81
buyer_4,Jorge,Moreno,1974-05-23,40441389Y,jorge.moreno@superapp.digital,216601,ES46209505951516573022,5874.73,2022-02-15T12:31:25,Galdakao,expenses,repairs,-313.01,600.8
buyer_4,Jorge,Moreno,1974-05-23,40441389Y,jorge.moreno@superapp.digital,216601,ES46209505951516573022,5874.73,2022-02-16T09:18:05,Galdakao,expenses,repairs,-242.82,357.98
buyer_4,Jorge,Moreno,1974-05-23,40441389Y,jorge.moreno@superapp.digital,216601,ES46209505951516573022,5874.73,2022-02-17T14:09:11,Galdakao,expenses,food,-89.82,268.16
buyer_4,Jorge,Moreno,1974-05-23,40441389Y,jorge.moreno@superapp.digital,216601,ES46209505951516573022,5874.73,2022-02-18T10:30:47,Galdakao,expenses,clothing,-56.92,211.24
buyer_4,Jorge,Moreno,1974-05-23,40441389Y,jorge.moreno@superapp.digital,216601,ES46209505951516573022,5874.73,2022-02-19T20:47:31,Galdakao,expenses,food,-73.87,137.37
buyer_4,Jorge,Moreno,1974-05-23,40441389Y,jorge.moreno@superapp.digital,216601,ES46209505951516573022,5874.73,2022-02-22T19:16:37,Galdakao,expenses,cash,-100.0,37.37
buyer_4,Jorge,Moreno,1974-05-23,40441389Y,jorge.moreno@superapp.digital,216601,ES46209505951516573022,5874.73,2022-02-23T09:22:32,Galdakao,expenses,transport,-70.44,-33.07
buyer_4,Jorge,Moreno,1974-05-23,40441389Y,jorge.moreno@superapp.digital,216601,ES46209505951516573022,5874.73,2022-02-24T14:18:51,Galdakao,expenses,children,-739.3549166666666,-772.42
buyer_4,Jorge,Moreno,1974-05-23,40441389Y,jorge.moreno@superapp.digital,216601,ES46209505951516573022,5874.73,2022-02-28T05:32:20,Galdakao,expenses,repairs,-289.12,-1061.54
buyer_4,Jorge,Moreno,1974-05-23,40441389Y,jorge.moreno@superapp.digital,216601,ES46209505951516573022,5874.73,2022-03-01T15:17:31,Galdakao,incomes,salary,2415.31,1353.77
buyer_4,Jorge,Moreno,1974-05-23,40441389Y,jorge.moreno@superapp.digital,216601,ES46209505951516573022,5874.73,2022-03-01T15:17:31,Galdakao,incomes,extra_income,385.48,1739.25
buyer_4,Jorge,Moreno,1974-05-23,40441389Y,jorge.moreno@superapp.digital,216601,ES46209505951516573022,5874.73,2022-03-01T15:08:11,Galdakao,expenses,healthcare,-68.14,1671.11
buyer_4,Jorge,Moreno,1974-05-23,40441389Y,jorge.moreno@superapp.digital,216601,ES46209505951516573022,5874.73,2022-03-01T18:33:55,Galdakao,expenses,cash,-100.0,1571.11
buyer_4,Jorge,Moreno,1974-05-23,40441389Y,jorge.moreno@superapp.digital,216601,ES46209505951516573022,5874.73,2022-03-03T11:37:43,Galdakao,expenses,leisure,-55.1,1516.01
buyer_4,Jorge,Moreno,1974-05-23,40441389Y,jorge.moreno@superapp.digital,216601,ES46209505951516573022,5874.73,2022-03-04T08:48:56,Galdakao,expenses,mortgage,-1279.96,236.05
buyer_4,Jorge,Moreno,1974-05-23,40441389Y,jorge.moreno@superapp.digital,216601,ES46209505951516573022,5874.73,2022-03-04T13:21:16,Galdakao,expenses,clothing,-156.6,79.45
buyer_4,Jorge,Moreno,1974-05-23,40441389Y,jorge.moreno@superapp.digital,216601,ES46209505951516573022,5874.73,2022-03-05T21:15:13,Galdakao,expenses,gas,-65.7,13.75
buyer_4,Jorge,Moreno,1974-05-23,40441389Y,jorge.moreno@superapp.digital,216601,ES46209505951516573022,5874.73,2022-03-05T11:53:49,Galdakao,expenses,phone,-37.45,-23.7
buyer_4,Jorge,Moreno,1974-05-23,40441389Y,jorge.moreno@superapp.digital,216601,ES46209505951516573022,5874.73,2022-03-05T09:00:19,Galdakao,expenses,cash,-100.0,-123.7
buyer_4,Jorge,Moreno,1974-05-23,40441389Y,jorge.moreno@superapp.digital,216601,ES46209505951516573022,5874.73,2022-03-05T16:01:01,Galdakao,expenses,children,-517.44,-641.14
buyer_4,Jorge,Moreno,1974-05-23,40441389Y,jorge.moreno@superapp.digital,216601,ES46209505951516573022,5874.73,2022-03-06T20:53:20,Galdakao,expenses,electricity,-34.86,-676.0
buyer_4,Jorge,Moreno,1974-05-23,40441389Y,jorge.moreno@superapp.digital,216601,ES46209505951516573022,5874.73,2022-03-07T13:18:00,Galdakao,expenses,electricity,-100.73,-776.73
buyer_4,Jorge,Moreno,1974-05-23,40441389Y,jorge.moreno@superapp.digital,216601,ES46209505951516573022,5874.73,2022-03-07T13:51:32,Galdakao,expenses,gas,-59.6,-836.33
buyer_4,Jorge,Moreno,1974-05-23,40441389Y,jorge.moreno@superapp.digital,216601,ES46209505951516573022,5874.73,2022-03-08T21:32:58,Galdakao,expenses,phone,-36.34,-872.67
buyer_4,Jorge,Moreno,1974-05-23,40441389Y,jorge.moreno@superapp.digital,216601,ES46209505951516573022,5874.73,2022-03-09T14:09:19,Galdakao,expenses,food,-98.56,-971.23
buyer_4,Jorge,Moreno,1974-05-23,40441389Y,jorge.moreno@superapp.digital,216601,ES46209505951516573022,5874.73,2022-03-09T17:28:21,Galdakao,expenses,leisure,-35.56,-1006.79
buyer_4,Jorge,Moreno,1974-05-23,40441389Y,jorge.moreno@superapp.digital,216601,ES46209505951516573022,5874.73,2022-03-11T09:14:55,Galdakao,expenses,food,-117.89,-1124.68
buyer_4,Jorge,Moreno,1974-05-23,40441389Y,jorge.moreno@superapp.digital,216601,ES46209505951516573022,5874.73,2022-03-11T12:34:46,Galdakao,expenses,healthcare,-155.77,-1280.45
buyer_4,Jorge,Moreno,1974-05-23,40441389Y,jorge.moreno@superapp.digital,216601,ES46209505951516573022,5874.73,2022-03-11T12:03:03,Galdakao,expenses,education,-78.07,-1358.52
buyer_4,Jorge,Moreno,1974-05-23,40441389Y,jorge.moreno@superapp.digital,216601,ES46209505951516573022,5874.73,2022-03-12T13:23:02,Galdakao,expenses,leisure,-20.96,-1379.48
buyer_4,Jorge,Moreno,1974-05-23,40441389Y,jorge.moreno@superapp.digital,216601,ES46209505951516573022,5874.73,2022-03-12T02:08:29,Galdakao,expenses,clothing,-114.13,-1493.61
buyer_4,Jorge,Moreno,1974-05-23,40441389Y,jorge.moreno@superapp.digital,216601,ES46209505951516573022,5874.73,2022-03-12T09:25:54,Galdakao,expenses,cash,-100.0,-1593.61
buyer_4,Jorge,Moreno,1974-05-23,40441389Y,jorge.moreno@superapp.digital,216601,ES46209505951516573022,5874.73,2022-03-13T16:15:41,Galdakao,expenses,repairs,-213.11,-1806.72
buyer_4,Jorge,Moreno,1974-05-23,40441389Y,jorge.moreno@superapp.digital,216601,ES46209505951516573022,5874.73,2022-03-15T12:19:25,Galdakao,expenses,leisure,-64.27,-1870.99
buyer_4,Jorge,Moreno,1974-05-23,40441389Y,jorge.moreno@superapp.digital,216601,ES46209505951516573022,5874.73,2022-03-16T13:42:21,Galdakao,expenses,healthcare,-81.34,-1952.33
buyer_4,Jorge,Moreno,1974-05-23,40441389Y,jorge.moreno@superapp.digital,216601,ES46209505951516573022,5874.73,2022-03-17T08:11:26,Galdakao,expenses,children,-490.37,-2442.7
buyer_4,Jorge,Moreno,1974-05-23,40441389Y,jorge.moreno@superapp.digital,216601,ES46209505951516573022,5874.73,2022-03-18T08:26:32,Galdakao,expenses,food,-65.0,-2507.7
buyer_4,Jorge,Moreno,1974-05-23,40441389Y,jorge.moreno@superapp.digital,216601,ES46209505951516573022,5874.73,2022-03-18T14:51:07,Galdakao,expenses,repairs,-158.35,-2666.05
buyer_4,Jorge,Moreno,1974-05-23,40441389Y,jorge.moreno@superapp.digital,216601,ES46209505951516573022,5874.73,2022-03-20T06:47:16,Galdakao,expenses,appliances,-406.83,-3072.88
buyer_4,Jorge,Moreno,1974-05-23,40441389Y,jorge.moreno@superapp.digital,216601,ES46209505951516573022,5874.73,2022-03-24T23:35:43,Galdakao,expenses,cash,-100.0,-3172.88
buyer_4,Jorge,Moreno,1974-05-23,40441389Y,jorge.moreno@superapp.digital,216601,ES46209505951516573022,5874.73,2022-03-25T12:25:20,Galdakao,expenses,leisure,-72.48,-3245.36
buyer_4,Jorge,Moreno,1974-05-23,40441389Y,jorge.moreno@superapp.digital,216601,ES46209505951516573022,5874.73,2022-03-27T17:14:59,Galdakao,expenses,leisure,-81.05,-3326.41
buyer_4,Jorge,Moreno,1974-05-23,40441389Y,jorge.moreno@superapp.digital,216601,ES46209505951516573022,5874.73,2022-03-28T15:33:10,Galdakao,expenses,cash,-100.0,-3426.41
buyer_4,Jorge,Moreno,1974-05-23,40441389Y,jorge.moreno@superapp.digital,216601,ES46209505951516573022,5874.73,2022-03-29T05:49:21,Galdakao,expenses,cash,-100.0,-3526.41
buyer_4,Jorge,Moreno,1974-05-23,40441389Y,jorge.moreno@superapp.digital,216601,ES46209505951516573022,5874.73,2022-03-31T14:54:11,Galdakao,expenses,food,-113.65,-3640.06
buyer_4,Jorge,Moreno,1974-05-23,40441389Y,jorge.moreno@superapp.digital,216601,ES46209505951516573022,5874.73,2022-03-31T08:11:13,Galdakao,expenses,leisure,-77.46,-3717.52
buyer_4,Jorge,Moreno,1974-05-23,40441389Y,jorge.moreno@superapp.digital,216601,ES46209505951516573022,5874.73,2022-04-01T21:23:36,Galdakao,incomes,salary,2415.31,-1302.21
buyer_4,Jorge,Moreno,1974-05-23,40441389Y,jorge.moreno@superapp.digital,216601,ES46209505951516573022,5874.73,2022-04-04T12:16:52,Galdakao,expenses,mortgage,-1279.96,-2582.17
buyer_4,Jorge,Moreno,1974-05-23,40441389Y,jorge.moreno@superapp.digital,216601,ES46209505951516573022,5874.73,2022-04-05T20:45:50,Galdakao,expenses,electricity,-64.33,-2646.5
buyer_4,Jorge,Moreno,1974-05-23,40441389Y,jorge.moreno@superapp.digital,216601,ES46209505951516573022,5874.73,2022-04-05T11:08:08,Galdakao,expenses,internet,-50.72,-2697.22
buyer_4,Jorge,Moreno,1974-05-23,40441389Y,jorge.moreno@superapp.digital,216601,ES46209505951516573022,5874.73,2022-04-05T10:12:44,Galdakao,expenses,phone,-40.39,-2737.61
buyer_4,Jorge,Moreno,1974-05-23,40441389Y,jorge.moreno@superapp.digital,216601,ES46209505951516573022,5874.73,2022-04-05T18:45:50,Galdakao,expenses,leisure,-44.49,-2782.1
buyer_4,Jorge,Moreno,1974-05-23,40441389Y,jorge.moreno@superapp.digital,216601,ES46209505951516573022,5874.73,2022-04-05T15:53:45,Galdakao,expenses,healthcare,-110.14,-2892.24
buyer_4,Jorge,Moreno,1974-05-23,40441389Y,jorge.moreno@superapp.digital,216601,ES46209505951516573022,5874.73,2022-04-06T18:41:18,Galdakao,expenses,electricity,-97.45,-2989.69
buyer_4,Jorge,Moreno,1974-05-23,40441389Y,jorge.moreno@superapp.digital,216601,ES46209505951516573022,5874.73,2022-04-06T22:19:36,Galdakao,expenses,internet,-50.72,-3040.41
buyer_4,Jorge,Moreno,1974-05-23,40441389Y,jorge.moreno@superapp.digital,216601,ES46209505951516573022,5874.73,2022-04-06T22:55:51,Galdakao,expenses,transport,-79.45,-3119.86
buyer_4,Jorge,Moreno,1974-05-23,40441389Y,jorge.moreno@superapp.digital,216601,ES46209505951516573022,5874.73,2022-04-07T11:58:27,Galdakao,expenses,water,-39.91,-3159.77
buyer_4,Jorge,Moreno,1974-05-23,40441389Y,jorge.moreno@superapp.digital,216601,ES46209505951516573022,5874.73,2022-04-07T19:47:56,Galdakao,expenses,electricity,-85.98,-3245.75
buyer_4,Jorge,Moreno,1974-05-23,40441389Y,jorge.moreno@superapp.digital,216601,ES46209505951516573022,5874.73,2022-04-07T12:47:04,Galdakao,expenses,phone,-51.89,-3297.64
buyer_4,Jorge,Moreno,1974-05-23,40441389Y,jorge.moreno@superapp.digital,216601,ES46209505951516573022,5874.73,2022-04-07T12:01:17,Galdakao,expenses,gifts,-670.03,-3967.67
buyer_4,Jorge,Moreno,1974-05-23,40441389Y,jorge.moreno@superapp.digital,216601,ES46209505951516573022,5874.73,2022-04-08T08:11:17,Galdakao,expenses,internet,-50.72,-4018.39
buyer_4,Jorge,Moreno,1974-05-23,40441389Y,jorge.moreno@superapp.digital,216601,ES46209505951516573022,5874.73,2022-04-08T20:08:33,Galdakao,expenses,appliances,-307.7,-4326.09
buyer_4,Jorge,Moreno,1974-05-23,40441389Y,jorge.moreno@superapp.digital,216601,ES46209505951516573022,5874.73,2022-04-10T19:33:09,Galdakao,expenses,repairs,-301.7,-4627.79
buyer_4,Jorge,Moreno,1974-05-23,40441389Y,jorge.moreno@superapp.digital,216601,ES46209505951516573022,5874.73,2022-04-12T08:44:30,Galdakao,expenses,food,-78.52,-4706.31
buyer_4,Jorge,Moreno,1974-05-23,40441389Y,jorge.moreno@superapp.digital,216601,ES46209505951516573022,5874.73,2022-04-13T10:43:38,Galdakao,expenses,transport,-65.48,-4771.79
buyer_4,Jorge,Moreno,1974-05-23,40441389Y,jorge.moreno@superapp.digital,216601,ES46209505951516573022,5874.73,2022-04-13T09:25:24,Galdakao,expenses,repairs,-110.89,-4882.68
buyer_4,Jorge,Moreno,1974-05-23,40441389Y,jorge.moreno@superapp.digital,216601,ES46209505951516573022,5874.73,2022-04-15T14:34:00,Galdakao,expenses,car,-281.33,-5164.01
buyer_4,Jorge,Moreno,1974-05-23,40441389Y,jorge.moreno@superapp.digital,216601,ES46209505951516573022,5874.73,2022-04-16T08:22:16,Galdakao,expenses,appliances,-210.79,-5374.8
buyer_4,Jorge,Moreno,1974-05-23,40441389Y,jorge.moreno@superapp.digital,216601,ES46209505951516573022,5874.73,2022-04-16T19:47:25,Galdakao,expenses,children,-528.5649166666666,-5903.36
buyer_4,Jorge,Moreno,1974-05-23,40441389Y,jorge.moreno@superapp.digital,216601,ES46209505951516573022,5874.73,2022-04-17T12:56:17,Galdakao,expenses,education,-77.3,-5980.66
buyer_4,Jorge,Moreno,1974-05-23,40441389Y,jorge.moreno@superapp.digital,216601,ES46209505951516573022,5874.73,2022-04-18T19:23:36,Galdakao,expenses,cash,-100.0,-6080.66
buyer_4,Jorge,Moreno,1974-05-23,40441389Y,jorge.moreno@superapp.digital,216601,ES46209505951516573022,5874.73,2022-04-20T10:34:57,Galdakao,expenses,repairs,-227.47,-6308.13
buyer_4,Jorge,Moreno,1974-05-23,40441389Y,jorge.moreno@superapp.digital,216601,ES46209505951516573022,5874.73,2022-04-23T06:01:16,Galdakao,expenses,repairs,-211.86,-6519.99
buyer_4,Jorge,Moreno,1974-05-23,40441389Y,jorge.moreno@superapp.digital,216601,ES46209505951516573022,5874.73,2022-04-25T09:05:02,Galdakao,expenses,appliances,-175.37,-6695.36
buyer_4,Jorge,Moreno,1974-05-23,40441389Y,jorge.moreno@superapp.digital,216601,ES46209505951516573022,5874.73,2022-04-26T20:54:25,Galdakao,expenses,clothing,-45.18,-6740.54
buyer_4,Jorge,Moreno,1974-05-23,40441389Y,jorge.moreno@superapp.digital,216601,ES46209505951516573022,5874.73,2022-04-26T10:37:28,Galdakao,expenses,travel,-583.37,-7323.91
buyer_4,Jorge,Moreno,1974-05-23,40441389Y,jorge.moreno@superapp.digital,216601,ES46209505951516573022,5874.73,2022-04-27T23:19:54,Galdakao,expenses,food,-82.85,-7406.76
buyer_4,Jorge,Moreno,1974-05-23,40441389Y,jorge.moreno@superapp.digital,216601,ES46209505951516573022,5874.73,2022-04-28T19:56:24,Galdakao,expenses,transport,-55.1,-7461.86
buyer_4,Jorge,Moreno,1974-05-23,40441389Y,jorge.moreno@superapp.digital,216601,ES46209505951516573022,5874.73,2022-04-29T08:53:56,Galdakao,expenses,leisure,-38.87,-7500.73
buyer_4,Jorge,Moreno,1974-05-23,40441389Y,jorge.moreno@superapp.digital,216601,ES46209505951516573022,5874.73,2022-04-29T08:01:24,Galdakao,expenses,cash,-100.0,-7600.73
buyer_4,Jorge,Moreno,1974-05-23,40441389Y,jorge.moreno@superapp.digital,216601,ES46209505951516573022,5874.73,2022-05-01T10:34:56,Galdakao,incomes,salary,2415.31,-5185.42
buyer_4,Jorge,Moreno,1974-05-23,40441389Y,jorge.moreno@superapp.digital,216601,ES46209505951516573022,5874.73,2022-05-01T15:47:51,Galdakao,expenses,clothing,-155.37,-5340.79
buyer_4,Jorge,Moreno,1974-05-23,40441389Y,jorge.moreno@superapp.digital,216601,ES46209505951516573022,5874.73,2022-05-02T12:37:54,Galdakao,expenses,cash,-100.0,-5440.79
buyer_4,Jorge,Moreno,1974-05-23,40441389Y,jorge.moreno@superapp.digital,216601,ES46209505951516573022,5874.73,2022-05-04T11:58:00,Galdakao,expenses,mortgage,-1279.96,-6720.75
buyer_4,Jorge,Moreno,1974-05-23,40441389Y,jorge.moreno@superapp.digital,216601,ES46209505951516573022,5874.73,2022-05-04T21:35:00,Galdakao,expenses,education,-47.88,-6768.63
buyer_4,Jorge,Moreno,1974-05-23,40441389Y,jorge.moreno@superapp.digital,216601,ES46209505951516573022,5874.73,2022-05-05T11:47:20,Galdakao,expenses,electricity,-51.61,-6820.24
buyer_4,Jorge,Moreno,1974-05-23,40441389Y,jorge.moreno@superapp.digital,216601,ES46209505951516573022,5874.73,2022-05-05T13:24:12,Galdakao,expenses,food,-75.92,-6896.16
buyer_4,Jorge,Moreno,1974-05-23,40441389Y,jorge.moreno@superapp.digital,216601,ES46209505951516573022,5874.73,2022-05-05T12:08:33,Galdakao,expenses,cash,-100.0,-6996.16
buyer_4,Jorge,Moreno,1974-05-23,40441389Y,jorge.moreno@superapp.digital,216601,ES46209505951516573022,5874.73,2022-05-05T23:43:45,Galdakao,expenses,gifts,-349.55,-7345.71
buyer_4,Jorge,Moreno,1974-05-23,40441389Y,jorge.moreno@superapp.digital,216601,ES46209505951516573022,5874.73,2022-05-06T23:55:48,Galdakao,expenses,transport,-75.92,-7421.63
buyer_4,Jorge,Moreno,1974-05-23,40441389Y,jorge.moreno@superapp.digital,216601,ES46209505951516573022,5874.73,2022-05-06T18:45:36,Galdakao,expenses,appliances,-262.01,-7683.64
buyer_4,Jorge,Moreno,1974-05-23,40441389Y,jorge.moreno@superapp.digital,216601,ES46209505951516573022,5874.73,2022-05-08T11:25:03,Galdakao,expenses,phone,-46.37,-7730.01
buyer_4,Jorge,Moreno,1974-05-23,40441389Y,jorge.moreno@superapp.digital,216601,ES46209505951516573022,5874.73,2022-05-08T09:24:36,Galdakao,expenses,education,-67.44,-7797.45
buyer_4,Jorge,Moreno,1974-05-23,40441389Y,jorge.moreno@superapp.digital,216601,ES46209505951516573022,5874.73,2022-05-10T19:30:49,Galdakao,expenses,cash,-100.0,-7897.45
buyer_4,Jorge,Moreno,1974-05-23,40441389Y,jorge.moreno@superapp.digital,216601,ES46209505951516573022,5874.73,2022-05-11T11:10:22,Galdakao,expenses,food,-80.03,-7977.48
buyer_4,Jorge,Moreno,1974-05-23,40441389Y,jorge.moreno@superapp.digital,216601,ES46209505951516573022,5874.73,2022-05-12T16:14:31,Galdakao,expenses,food,-119.37,-8096.85
buyer_4,Jorge,Moreno,1974-05-23,40441389Y,jorge.moreno@superapp.digital,216601,ES46209505951516573022,5874.73,2022-05-12T08:26:23,Galdakao,expenses,clothing,-147.67,-8244.52
buyer_4,Jorge,Moreno,1974-05-23,40441389Y,jorge.moreno@superapp.digital,216601,ES46209505951516573022,5874.73,2022-05-14T07:22:08,Galdakao,expenses,clothing,-80.64,-8325.16
buyer_4,Jorge,Moreno,1974-05-23,40441389Y,jorge.moreno@superapp.digital,216601,ES46209505951516573022,5874.73,2022-05-14T16:42:18,Galdakao,expenses,repairs,-252.29,-8577.45
buyer_4,Jorge,Moreno,1974-05-23,40441389Y,jorge.moreno@superapp.digital,216601,ES46209505951516573022,5874.73,2022-05-14T19:07:19,Galdakao,expenses,children,-406.42491666666655,-8983.87
buyer_4,Jorge,Moreno,1974-05-23,40441389Y,jorge.moreno@superapp.digital,216601,ES46209505951516573022,5874.73,2022-05-16T23:47:57,Galdakao,expenses,repairs,-277.07,-9260.94
buyer_4,Jorge,Moreno,1974-05-23,40441389Y,jorge.moreno@superapp.digital,216601,ES46209505951516573022,5874.73,2022-05-17T02:54:49,Galdakao,expenses,food,-78.32,-9339.26
buyer_4,Jorge,Moreno,1974-05-23,40441389Y,jorge.moreno@superapp.digital,216601,ES46209505951516573022,5874.73,2022-05-17T14:43:43,Galdakao,expenses,education,-67.13,-9406.39
buyer_4,Jorge,Moreno,1974-05-23,40441389Y,jorge.moreno@superapp.digital,216601,ES46209505951516573022,5874.73,2022-05-17T10:16:48,Galdakao,expenses,cash,-100.0,-9506.39
buyer_4,Jorge,Moreno,1974-05-23,40441389Y,jorge.moreno@superapp.digital,216601,ES46209505951516573022,5874.73,2022-05-21T16:39:05,Galdakao,expenses,food,-88.87,-9595.26
buyer_4,Jorge,Moreno,1974-05-23,40441389Y,jorge.moreno@superapp.digital,216601,ES46209505951516573022,5874.73,2022-05-23T19:46:04,Galdakao,expenses,food,-105.73,-9700.99
buyer_4,Jorge,Moreno,1974-05-23,40441389Y,jorge.moreno@superapp.digital,216601,ES46209505951516573022,5874.73,2022-05-25T12:19:18,Galdakao,expenses,food,-112.62,-9813.61
buyer_4,Jorge,Moreno,1974-05-23,40441389Y,jorge.moreno@superapp.digital,216601,ES46209505951516573022,5874.73,2022-05-25T09:20:06,Galdakao,expenses,leisure,-41.14,-9854.75
buyer_4,Jorge,Moreno,1974-05-23,40441389Y,jorge.moreno@superapp.digital,216601,ES46209505951516573022,5874.73,2022-05-25T03:48:16,Galdakao,expenses,clothing,-101.15,-9955.9
buyer_4,Jorge,Moreno,1974-05-23,40441389Y,jorge.moreno@superapp.digital,216601,ES46209505951516573022,5874.73,2022-05-25T18:57:16,Galdakao,expenses,cash,-100.0,-10055.9
buyer_4,Jorge,Moreno,1974-05-23,40441389Y,jorge.moreno@superapp.digital,216601,ES46209505951516573022,5874.73,2022-05-27T09:48:24,Galdakao,expenses,transport,-68.8,-10124.7
buyer_4,Jorge,Moreno,1974-05-23,40441389Y,jorge.moreno@superapp.digital,216601,ES46209505951516573022,5874.73,2022-05-27T10:08:07,Galdakao,expenses,leisure,-47.83,-10172.53
buyer_4,Jorge,Moreno,1974-05-23,40441389Y,jorge.moreno@superapp.digital,216601,ES46209505951516573022,5874.73,2022-05-27T16:32:15,Galdakao,expenses,repairs,-196.08,-10368.61
buyer_4,Jorge,Moreno,1974-05-23,40441389Y,jorge.moreno@superapp.digital,216601,ES46209505951516573022,5874.73,2022-05-28T22:23:39,Galdakao,expenses,transport,-51.46,-10420.07
buyer_4,Jorge,Moreno,1974-05-23,40441389Y,jorge.moreno@superapp.digital,216601,ES46209505951516573022,5874.73,2022-05-29T23:50:06,Galdakao,expenses,transport,-79.84,-10499.91
buyer_4,Jorge,Moreno,1974-05-23,40441389Y,jorge.moreno@superapp.digital,216601,ES46209505951516573022,5874.73,2022-05-31T14:55:02,Galdakao,expenses,food,-71.54,-10571.45
buyer_4,Jorge,Moreno,1974-05-23,40441389Y,jorge.moreno@superapp.digital,216601,ES46209505951516573022,5874.73,2022-05-31T01:36:46,Galdakao,expenses,leisure,-74.79,-10646.24
buyer_4,Jorge,Moreno,1974-05-23,40441389Y,jorge.moreno@superapp.digital,216601,ES46209505951516573022,5874.73,2022-06-01T13:16:50,Galdakao,incomes,salary,2415.31,-8230.93
buyer_4,Jorge,Moreno,1974-05-23,40441389Y,jorge.moreno@superapp.digital,216601,ES46209505951516573022,5874.73,2022-06-01T13:16:50,Galdakao,incomes,salary_bonus,1802.25,-6428.68
buyer_4,Jorge,Moreno,1974-05-23,40441389Y,jorge.moreno@superapp.digital,216601,ES46209505951516573022,5874.73,2022-06-01T18:59:09,Galdakao,expenses,taxes,-1508.33,-7937.01
buyer_4,Jorge,Moreno,1974-05-23,40441389Y,jorge.moreno@superapp.digital,216601,ES46209505951516573022,5874.73,2022-06-01T14:20:50,Galdakao,expenses,insurance,-502.78,-8439.79
buyer_4,Jorge,Moreno,1974-05-23,40441389Y,jorge.moreno@superapp.digital,216601,ES46209505951516573022,5874.73,2022-06-04T09:33:07,Galdakao,expenses,mortgage,-1279.96,-9719.75
buyer_4,Jorge,Moreno,1974-05-23,40441389Y,jorge.moreno@superapp.digital,216601,ES46209505951516573022,5874.73,2022-06-04T18:04:45,Galdakao,expenses,cash,-100.0,-9819.75
buyer_4,Jorge,Moreno,1974-05-23,40441389Y,jorge.moreno@superapp.digital,216601,ES46209505951516573022,5874.73,2022-06-04T13:51:14,Galdakao,expenses,appliances,-393.08,-10212.83
buyer_4,Jorge,Moreno,1974-05-23,40441389Y,jorge.moreno@superapp.digital,216601,ES46209505951516573022,5874.73,2022-06-05T09:50:23,Galdakao,expenses,transport,-57.63,-10270.46
buyer_4,Jorge,Moreno,1974-05-23,40441389Y,jorge.moreno@superapp.digital,216601,ES46209505951516573022,5874.73,2022-06-05T18:56:09,Galdakao,expenses,clothing,-155.44,-10425.9
buyer_4,Jorge,Moreno,1974-05-23,40441389Y,jorge.moreno@superapp.digital,216601,ES46209505951516573022,5874.73,2022-06-05T10:50:19,Galdakao,expenses,cash,-100.0,-10525.9
buyer_4,Jorge,Moreno,1974-05-23,40441389Y,jorge.moreno@superapp.digital,216601,ES46209505951516573022,5874.73,2022-06-06T11:34:33,Galdakao,expenses,electricity,-60.74,-10586.64
buyer_4,Jorge,Moreno,1974-05-23,40441389Y,jorge.moreno@superapp.digital,216601,ES46209505951516573022,5874.73,2022-06-06T20:16:38,Galdakao,expenses,gas,-78.83,-10665.47
buyer_4,Jorge,Moreno,1974-05-23,40441389Y,jorge.moreno@superapp.digital,216601,ES46209505951516573022,5874.73,2022-06-06T08:10:23,Galdakao,expenses,phone,-49.92,-10715.39
buyer_4,Jorge,Moreno,1974-05-23,40441389Y,jorge.moreno@superapp.digital,216601,ES46209505951516573022,5874.73,2022-06-06T14:30:07,Galdakao,expenses,food,-60.23,-10775.62
buyer_4,Jorge,Moreno,1974-05-23,40441389Y,jorge.moreno@superapp.digital,216601,ES46209505951516573022,5874.73,2022-06-07T08:59:49,Galdakao,expenses,phone,-39.86,-10815.48
buyer_4,Jorge,Moreno,1974-05-23,40441389Y,jorge.moreno@superapp.digital,216601,ES46209505951516573022,5874.73,2022-06-07T10:18:59,Galdakao,expenses,gifts,-603.69,-11419.17
buyer_4,Jorge,Moreno,1974-05-23,40441389Y,jorge.moreno@superapp.digital,216601,ES46209505951516573022,5874.73,2022-06-08T19:48:37,Galdakao,expenses,gas,-132.44,-11551.61
buyer_4,Jorge,Moreno,1974-05-23,40441389Y,jorge.moreno@superapp.digital,216601,ES46209505951516573022,5874.73,2022-06-08T19:44:42,Galdakao,expenses,food,-62.37,-11613.98
buyer_4,Jorge,Moreno,1974-05-23,40441389Y,jorge.moreno@superapp.digital,216601,ES46209505951516573022,5874.73,2022-06-08T16:38:02,Galdakao,expenses,leisure,-84.31,-11698.29
buyer_4,Jorge,Moreno,1974-05-23,40441389Y,jorge.moreno@superapp.digital,216601,ES46209505951516573022,5874.73,2022-06-10T13:15:37,Galdakao,expenses,travel,-576.64,-12274.93
buyer_4,Jorge,Moreno,1974-05-23,40441389Y,jorge.moreno@superapp.digital,216601,ES46209505951516573022,5874.73,2022-06-14T11:42:38,Galdakao,expenses,food,-69.51,-12344.44
buyer_4,Jorge,Moreno,1974-05-23,40441389Y,jorge.moreno@superapp.digital,216601,ES46209505951516573022,5874.73,2022-06-14T07:39:28,Galdakao,expenses,appliances,-346.43,-12690.87
buyer_4,Jorge,Moreno,1974-05-23,40441389Y,jorge.moreno@superapp.digital,216601,ES46209505951516573022,5874.73,2022-06-15T20:34:12,Galdakao,expenses,food,-70.25,-12761.12
buyer_4,Jorge,Moreno,1974-05-23,40441389Y,jorge.moreno@superapp.digital,216601,ES46209505951516573022,5874.73,2022-06-16T10:20:55,Galdakao,expenses,cash,-100.0,-12861.12
buyer_4,Jorge,Moreno,1974-05-23,40441389Y,jorge.moreno@superapp.digital,216601,ES46209505951516573022,5874.73,2022-06-19T20:09:58,Galdakao,expenses,food,-68.12,-12929.24
buyer_4,Jorge,Moreno,1974-05-23,40441389Y,jorge.moreno@superapp.digital,216601,ES46209505951516573022,5874.73,2022-06-20T09:00:52,Galdakao,expenses,leisure,-82.49,-13011.73
buyer_4,Jorge,Moreno,1974-05-23,40441389Y,jorge.moreno@superapp.digital,216601,ES46209505951516573022,5874.73,2022-06-21T18:15:31,Galdakao,expenses,education,-44.88,-13056.61
buyer_4,Jorge,Moreno,1974-05-23,40441389Y,jorge.moreno@superapp.digital,216601,ES46209505951516573022,5874.73,2022-06-22T11:33:04,Galdakao,expenses,cash,-100.0,-13156.61
buyer_4,Jorge,Moreno,1974-05-23,40441389Y,jorge.moreno@superapp.digital,216601,ES46209505951516573022,5874.73,2022-06-25T12:38:51,Galdakao,expenses,children,-739.3549166666666,-13895.96
buyer_4,Jorge,Moreno,1974-05-23,40441389Y,jorge.moreno@superapp.digital,216601,ES46209505951516573022,5874.73,2022-06-26T10:28:33,Galdakao,expenses,food,-113.29,-14009.25
buyer_4,Jorge,Moreno,1974-05-23,40441389Y,jorge.moreno@superapp.digital,216601,ES46209505951516573022,5874.73,2022-06-26T20:55:19,Galdakao,expenses,transport,-49.14,-14058.39
buyer_4,Jorge,Moreno,1974-05-23,40441389Y,jorge.moreno@superapp.digital,216601,ES46209505951516573022,5874.73,2022-06-29T02:44:38,Galdakao,expenses,food,-116.42,-14174.81
buyer_4,Jorge,Moreno,1974-05-23,40441389Y,jorge.moreno@superapp.digital,216601,ES46209505951516573022,5874.73,2022-06-29T10:03:15,Galdakao,expenses,leisure,-56.83,-14231.64
buyer_4,Jorge,Moreno,1974-05-23,40441389Y,jorge.moreno@superapp.digital,216601,ES46209505951516573022,5874.73,2022-07-01T16:23:13,Galdakao,incomes,salary,2415.31,-11816.33
buyer_4,Jorge,Moreno,1974-05-23,40441389Y,jorge.moreno@superapp.digital,216601,ES46209505951516573022,5874.73,2022-07-01T16:23:13,Galdakao,incomes,extra_income,385.48,-11430.85
buyer_4,Jorge,Moreno,1974-05-23,40441389Y,jorge.moreno@superapp.digital,216601,ES46209505951516573022,5874.73,2022-07-01T08:43:56,Galdakao,expenses,food,-89.29,-11520.14
buyer_4,Jorge,Moreno,1974-05-23,40441389Y,jorge.moreno@superapp.digital,216601,ES46209505951516573022,5874.73,2022-07-01T13:22:59,Galdakao,expenses,transport,-77.11,-11597.25
buyer_4,Jorge,Moreno,1974-05-23,40441389Y,jorge.moreno@superapp.digital,216601,ES46209505951516573022,5874.73,2022-07-01T20:21:33,Galdakao,expenses,cash,-100.0,-11697.25
buyer_4,Jorge,Moreno,1974-05-23,40441389Y,jorge.moreno@superapp.digital,216601,ES46209505951516573022,5874.73,2022-07-02T16:20:40,Galdakao,expenses,leisure,-21.01,-11718.26
buyer_4,Jorge,Moreno,1974-05-23,40441389Y,jorge.moreno@superapp.digital,216601,ES46209505951516573022,5874.73,2022-07-03T19:23:50,Galdakao,expenses,appliances,-345.05,-12063.31
buyer_4,Jorge,Moreno,1974-05-23,40441389Y,jorge.moreno@superapp.digital,216601,ES46209505951516573022,5874.73,2022-07-04T18:34:55,Galdakao,expenses,mortgage,-1279.96,-13343.27
buyer_4,Jorge,Moreno,1974-05-23,40441389Y,jorge.moreno@superapp.digital,216601,ES46209505951516573022,5874.73,2022-07-05T09:24:55,Galdakao,expenses,electricity,-54.99,-13398.26
buyer_4,Jorge,Moreno,1974-05-23,40441389Y,jorge.moreno@superapp.digital,216601,ES46209505951516573022,5874.73,2022-07-05T10:29:57,Galdakao,expenses,phone,-42.86,-13441.12
buyer_4,Jorge,Moreno,1974-05-23,40441389Y,jorge.moreno@superapp.digital,216601,ES46209505951516573022,5874.73,2022-07-06T04:39:27,Galdakao,expenses,gas,-133.83,-13574.95
buyer_4,Jorge,Moreno,1974-05-23,40441389Y,jorge.moreno@superapp.digital,216601,ES46209505951516573022,5874.73,2022-07-06T17:24:42,Galdakao,expenses,internet,-50.72,-13625.67
buyer_4,Jorge,Moreno,1974-05-23,40441389Y,jorge.moreno@superapp.digital,216601,ES46209505951516573022,5874.73,2022-07-06T16:26:30,Galdakao,expenses,phone,-41.66,-13667.33
buyer_4,Jorge,Moreno,1974-05-23,40441389Y,jorge.moreno@superapp.digital,216601,ES46209505951516573022,5874.73,2022-07-06T21:30:21,Galdakao,expenses,transport,-68.84,-13736.17
buyer_4,Jorge,Moreno,1974-05-23,40441389Y,jorge.moreno@superapp.digital,216601,ES46209505951516573022,5874.73,2022-07-06T11:37:34,Galdakao,expenses,cash,-100.0,-13836.17
buyer_4,Jorge,Moreno,1974-05-23,40441389Y,jorge.moreno@superapp.digital,216601,ES46209505951516573022,5874.73,2022-07-06T22:12:45,Galdakao,expenses,gifts,-463.85,-14300.02
buyer_4,Jorge,Moreno,1974-05-23,40441389Y,jorge.moreno@superapp.digital,216601,ES46209505951516573022,5874.73,2022-07-07T11:33:25,Galdakao,expenses,phone,-46.67,-14346.69
buyer_4,Jorge,Moreno,1974-05-23,40441389Y,jorge.moreno@superapp.digital,216601,ES46209505951516573022,5874.73,2022-07-07T15:40:00,Galdakao,expenses,education,-64.64,-14411.33
buyer_4,Jorge,Moreno,1974-05-23,40441389Y,jorge.moreno@superapp.digital,216601,ES46209505951516573022,5874.73,2022-07-08T21:16:39,Galdakao,expenses,gas,-39.37,-14450.7
buyer_4,Jorge,Moreno,1974-05-23,40441389Y,jorge.moreno@superapp.digital,216601,ES46209505951516573022,5874.73,2022-07-09T15:15:19,Galdakao,expenses,transport,-48.54,-14499.24
buyer_4,Jorge,Moreno,1974-05-23,40441389Y,jorge.moreno@superapp.digital,216601,ES46209505951516573022,5874.73,2022-07-10T09:08:27,Galdakao,expenses,transport,-84.97,-14584.21
buyer_4,Jorge,Moreno,1974-05-23,40441389Y,jorge.moreno@superapp.digital,216601,ES46209505951516573022,5874.73,2022-07-11T18:17:05,Galdakao,expenses,food,-99.02,-14683.23
buyer_4,Jorge,Moreno,1974-05-23,40441389Y,jorge.moreno@superapp.digital,216601,ES46209505951516573022,5874.73,2022-07-11T19:57:41,Galdakao,expenses,leisure,-42.2,-14725.43
buyer_4,Jorge,Moreno,1974-05-23,40441389Y,jorge.moreno@superapp.digital,216601,ES46209505951516573022,5874.73,2022-07-15T16:31:10,Galdakao,expenses,food,-94.88,-14820.31
buyer_4,Jorge,Moreno,1974-05-23,40441389Y,jorge.moreno@superapp.digital,216601,ES46209505951516573022,5874.73,2022-07-16T22:41:00,Galdakao,expenses,food,-124.7,-14945.01
buyer_4,Jorge,Moreno,1974-05-23,40441389Y,jorge.moreno@superapp.digital,216601,ES46209505951516573022,5874.73,2022-07-18T20:05:32,Galdakao,expenses,cash,-100.0,-15045.01
buyer_4,Jorge,Moreno,1974-05-23,40441389Y,jorge.moreno@superapp.digital,216601,ES46209505951516573022,5874.73,2022-07-20T08:00:33,Galdakao,expenses,transport,-60.96,-15105.97
buyer_4,Jorge,Moreno,1974-05-23,40441389Y,jorge.moreno@superapp.digital,216601,ES46209505951516573022,5874.73,2022-07-21T21:21:17,Galdakao,expenses,healthcare,-65.99,-15171.96
buyer_4,Jorge,Moreno,1974-05-23,40441389Y,jorge.moreno@superapp.digital,216601,ES46209505951516573022,5874.73,2022-07-21T18:12:57,Galdakao,expenses,appliances,-287.79,-15459.75
buyer_4,Jorge,Moreno,1974-05-23,40441389Y,jorge.moreno@superapp.digital,216601,ES46209505951516573022,5874.73,2022-07-21T19:59:59,Galdakao,expenses,repairs,-150.57,-15610.32
buyer_4,Jorge,Moreno,1974-05-23,40441389Y,jorge.moreno@superapp.digital,216601,ES46209505951516573022,5874.73,2022-07-22T12:43:25,Galdakao,expenses,transport,-60.9,-15671.22
buyer_4,Jorge,Moreno,1974-05-23,40441389Y,jorge.moreno@superapp.digital,216601,ES46209505951516573022,5874.73,2022-07-22T23:46:36,Galdakao,expenses,clothing,-127.24,-15798.46
buyer_4,Jorge,Moreno,1974-05-23,40441389Y,jorge.moreno@superapp.digital,216601,ES46209505951516573022,5874.73,2022-07-24T21:19:10,Galdakao,expenses,children,-739.3549166666666,-16537.81
buyer_4,Jorge,Moreno,1974-05-23,40441389Y,jorge.moreno@superapp.digital,216601,ES46209505951516573022,5874.73,2022-07-25T16:47:12,Galdakao,expenses,cash,-100.0,-16637.81
buyer_4,Jorge,Moreno,1974-05-23,40441389Y,jorge.moreno@superapp.digital,216601,ES46209505951516573022,5874.73,2022-07-26T19:30:07,Galdakao,expenses,food,-83.81,-16721.62
buyer_4,Jorge,Moreno,1974-05-23,40441389Y,jorge.moreno@superapp.digital,216601,ES46209505951516573022,5874.73,2022-07-27T08:39:24,Galdakao,expenses,cash,-100.0,-16821.62
buyer_4,Jorge,Moreno,1974-05-23,40441389Y,jorge.moreno@superapp.digital,216601,ES46209505951516573022,5874.73,2022-07-30T16:54:51,Galdakao,expenses,cash,-100.0,-16921.62
buyer_4,Jorge,Moreno,1974-05-23,40441389Y,jorge.moreno@superapp.digital,216601,ES46209505951516573022,5874.73,2022-08-01T21:47:56,Galdakao,incomes,salary,2415.31,-14506.31
buyer_4,Jorge,Moreno,1974-05-23,40441389Y,jorge.moreno@superapp.digital,216601,ES46209505951516573022,5874.73,2022-08-01T17:20:19,Galdakao,expenses,transport,-81.49,-14587.8
buyer_4,Jorge,Moreno,1974-05-23,40441389Y,jorge.moreno@superapp.digital,216601,ES46209505951516573022,5874.73,2022-08-03T20:19:07,Galdakao,expenses,food,-102.86,-14690.66
buyer_4,Jorge,Moreno,1974-05-23,40441389Y,jorge.moreno@superapp.digital,216601,ES46209505951516573022,5874.73,2022-08-03T08:03:48,Galdakao,expenses,travel,-573.44,-15264.1
buyer_4,Jorge,Moreno,1974-05-23,40441389Y,jorge.moreno@superapp.digital,216601,ES46209505951516573022,5874.73,2022-08-04T10:47:50,Galdakao,expenses,mortgage,-1279.96,-16544.06
buyer_4,Jorge,Moreno,1974-05-23,40441389Y,jorge.moreno@superapp.digital,216601,ES46209505951516573022,5874.73,2022-08-04T12:43:09,Galdakao,expenses,leisure,-66.64,-16610.7
buyer_4,Jorge,Moreno,1974-05-23,40441389Y,jorge.moreno@superapp.digital,216601,ES46209505951516573022,5874.73,2022-08-06T13:20:19,Galdakao,expenses,phone,-49.02,-16659.72
buyer_4,Jorge,Moreno,1974-05-23,40441389Y,jorge.moreno@superapp.digital,216601,ES46209505951516573022,5874.73,2022-08-07T14:03:11,Galdakao,expenses,food,-68.0,-16727.72
buyer_4,Jorge,Moreno,1974-05-23,40441389Y,jorge.moreno@superapp.digital,216601,ES46209505951516573022,5874.73,2022-08-08T13:06:29,Galdakao,expenses,cash,-100.0,-16827.72
buyer_4,Jorge,Moreno,1974-05-23,40441389Y,jorge.moreno@superapp.digital,216601,ES46209505951516573022,5874.73,2022-08-10T12:53:54,Galdakao,expenses,food,-87.9,-16915.62
buyer_4,Jorge,Moreno,1974-05-23,40441389Y,jorge.moreno@superapp.digital,216601,ES46209505951516573022,5874.73,2022-08-11T20:51:57,Galdakao,expenses,food,-71.17,-16986.79
buyer_4,Jorge,Moreno,1974-05-23,40441389Y,jorge.moreno@superapp.digital,216601,ES46209505951516573022,5874.73,2022-08-13T16:21:39,Galdakao,expenses,food,-61.48,-17048.27
buyer_4,Jorge,Moreno,1974-05-23,40441389Y,jorge.moreno@superapp.digital,216601,ES46209505951516573022,5874.73,2022-08-13T16:27:07,Galdakao,expenses,travel,-388.07,-17436.34
buyer_4,Jorge,Moreno,1974-05-23,40441389Y,jorge.moreno@superapp.digital,216601,ES46209505951516573022,5874.73,2022-08-15T16:41:04,Galdakao,expenses,cash,-100.0,-17536.34
buyer_4,Jorge,Moreno,1974-05-23,40441389Y,jorge.moreno@superapp.digital,216601,ES46209505951516573022,5874.73,2022-08-16T13:10:23,Galdakao,expenses,clothing,-118.54,-17654.88
buyer_4,Jorge,Moreno,1974-05-23,40441389Y,jorge.moreno@superapp.digital,216601,ES46209505951516573022,5874.73,2022-08-17T09:38:24,Galdakao,expenses,leisure,-41.28,-17696.16
buyer_4,Jorge,Moreno,1974-05-23,40441389Y,jorge.moreno@superapp.digital,216601,ES46209505951516573022,5874.73,2022-08-18T19:46:37,Galdakao,expenses,cash,-100.0,-17796.16
buyer_4,Jorge,Moreno,1974-05-23,40441389Y,jorge.moreno@superapp.digital,216601,ES46209505951516573022,5874.73,2022-08-19T14:22:27,Galdakao,expenses,education,-53.88,-17850.04
buyer_4,Jorge,Moreno,1974-05-23,40441389Y,jorge.moreno@superapp.digital,216601,ES46209505951516573022,5874.73,2022-08-20T15:45:26,Galdakao,expenses,gifts,-738.85,-18588.89
buyer_4,Jorge,Moreno,1974-05-23,40441389Y,jorge.moreno@superapp.digital,216601,ES46209505951516573022,5874.73,2022-08-21T22:49:30,Galdakao,expenses,transport,-76.06,-18664.95
buyer_4,Jorge,Moreno,1974-05-23,40441389Y,jorge.moreno@superapp.digital,216601,ES46209505951516573022,5874.73,2022-08-21T09:26:13,Galdakao,expenses,leisure,-26.09,-18691.04
buyer_4,Jorge,Moreno,1974-05-23,40441389Y,jorge.moreno@superapp.digital,216601,ES46209505951516573022,5874.73,2022-08-21T10:41:36,Galdakao,expenses,cash,-100.0,-18791.04
buyer_4,Jorge,Moreno,1974-05-23,40441389Y,jorge.moreno@superapp.digital,216601,ES46209505951516573022,5874.73,2022-08-21T09:26:50,Galdakao,expenses,repairs,-116.4,-18907.44
buyer_4,Jorge,Moreno,1974-05-23,40441389Y,jorge.moreno@superapp.digital,216601,ES46209505951516573022,5874.73,2022-08-23T13:39:41,Galdakao,expenses,transport,-64.56,-18972.0
buyer_4,Jorge,Moreno,1974-05-23,40441389Y,jorge.moreno@superapp.digital,216601,ES46209505951516573022,5874.73,2022-08-23T18:22:34,Galdakao,expenses,healthcare,-59.61,-19031.61
buyer_4,Jorge,Moreno,1974-05-23,40441389Y,jorge.moreno@superapp.digital,216601,ES46209505951516573022,5874.73,2022-08-27T10:23:09,Galdakao,expenses,transport,-87.25,-19118.86
buyer_4,Jorge,Moreno,1974-05-23,40441389Y,jorge.moreno@superapp.digital,216601,ES46209505951516573022,5874.73,2022-08-28T08:30:01,Galdakao,expenses,food,-103.05,-19221.91
buyer_4,Jorge,Moreno,1974-05-23,40441389Y,jorge.moreno@superapp.digital,216601,ES46209505951516573022,5874.73,2022-08-29T20:55:53,Galdakao,expenses,food,-71.76,-19293.67
buyer_4,Jorge,Moreno,1974-05-23,40441389Y,jorge.moreno@superapp.digital,216601,ES46209505951516573022,5874.73,2022-08-31T00:30:46,Galdakao,expenses,cash,-100.0,-19393.67
buyer_4,Jorge,Moreno,1974-05-23,40441389Y,jorge.moreno@superapp.digital,216601,ES46209505951516573022,5874.73,2022-09-01T21:02:49,Galdakao,incomes,salary,2415.31,-16978.36
buyer_4,Jorge,Moreno,1974-05-23,40441389Y,jorge.moreno@superapp.digital,216601,ES46209505951516573022,5874.73,2022-09-01T23:14:47,Galdakao,expenses,leisure,-45.0,-17023.36
buyer_4,Jorge,Moreno,1974-05-23,40441389Y,jorge.moreno@superapp.digital,216601,ES46209505951516573022,5874.73,2022-09-01T13:12:13,Galdakao,expenses,repairs,-213.01,-17236.37
buyer_4,Jorge,Moreno,1974-05-23,40441389Y,jorge.moreno@superapp.digital,216601,ES46209505951516573022,5874.73,2022-09-01T14:14:21,Galdakao,expenses,gifts,-256.23,-17492.6
buyer_4,Jorge,Moreno,1974-05-23,40441389Y,jorge.moreno@superapp.digital,216601,ES46209505951516573022,5874.73,2022-09-02T08:25:24,Galdakao,expenses,food,-77.03,-17569.63
buyer_4,Jorge,Moreno,1974-05-23,40441389Y,jorge.moreno@superapp.digital,216601,ES46209505951516573022,5874.73,2022-09-02T16:18:44,Galdakao,expenses,appliances,-165.78,-17735.41
buyer_4,Jorge,Moreno,1974-05-23,40441389Y,jorge.moreno@superapp.digital,216601,ES46209505951516573022,5874.73,2022-09-02T19:12:22,Galdakao,expenses,children,-496.54491666666655,-18231.95
buyer_4,Jorge,Moreno,1974-05-23,40441389Y,jorge.moreno@superapp.digital,216601,ES46209505951516573022,5874.73,2022-09-04T23:27:33,Galdakao,expenses,mortgage,-1279.96,-19511.91
buyer_4,Jorge,Moreno,1974-05-23,40441389Y,jorge.moreno@superapp.digital,216601,ES46209505951516573022,5874.73,2022-09-05T04:39:10,Galdakao,expenses,gas,-55.89,-19567.8
buyer_4,Jorge,Moreno,1974-05-23,40441389Y,jorge.moreno@superapp.digital,216601,ES46209505951516573022,5874.73,2022-09-05T19:26:39,Galdakao,expenses,food,-124.99,-19692.79
buyer_4,Jorge,Moreno,1974-05-23,40441389Y,jorge.moreno@superapp.digital,216601,ES46209505951516573022,5874.73,2022-09-05T11:33:18,Galdakao,expenses,leisure,-19.38,-19712.17
buyer_4,Jorge,Moreno,1974-05-23,40441389Y,jorge.moreno@superapp.digital,216601,ES46209505951516573022,5874.73,2022-09-06T18:30:59,Galdakao,expenses,internet,-50.72,-19762.89
buyer_4,Jorge,Moreno,1974-05-23,40441389Y,jorge.moreno@superapp.digital,216601,ES46209505951516573022,5874.73,2022-09-07T19:12:26,Galdakao,expenses,internet,-50.72,-19813.61
buyer_4,Jorge,Moreno,1974-05-23,40441389Y,jorge.moreno@superapp.digital,216601,ES46209505951516573022,5874.73,2022-09-08T16:24:18,Galdakao,expenses,water,-48.33,-19861.94
buyer_4,Jorge,Moreno,1974-05-23,40441389Y,jorge.moreno@superapp.digital,216601,ES46209505951516573022,5874.73,2022-09-08T18:05:06,Galdakao,expenses,electricity,-49.72,-19911.66
buyer_4,Jorge,Moreno,1974-05-23,40441389Y,jorge.moreno@superapp.digital,216601,ES46209505951516573022,5874.73,2022-09-08T09:09:07,Galdakao,expenses,phone,-51.1,-19962.76
buyer_4,Jorge,Moreno,1974-05-23,40441389Y,jorge.moreno@superapp.digital,216601,ES46209505951516573022,5874.73,2022-09-08T18:42:39,Galdakao,expenses,food,-81.98,-20044.74
buyer_4,Jorge,Moreno,1974-05-23,40441389Y,jorge.moreno@superapp.digital,216601,ES46209505951516573022,5874.73,2022-09-08T14:53:46,Galdakao,expenses,cash,-100.0,-20144.74
buyer_4,Jorge,Moreno,1974-05-23,40441389Y,jorge.moreno@superapp.digital,216601,ES46209505951516573022,5874.73,2022-09-09T16:44:50,Galdakao,expenses,food,-82.58,-20227.32
buyer_4,Jorge,Moreno,1974-05-23,40441389Y,jorge.moreno@superapp.digital,216601,ES46209505951516573022,5874.73,2022-09-13T20:10:51,Galdakao,expenses,education,-61.39,-20288.71
buyer_4,Jorge,Moreno,1974-05-23,40441389Y,jorge.moreno@superapp.digital,216601,ES46209505951516573022,5874.73,2022-09-14T15:14:37,Galdakao,expenses,food,-113.47,-20402.18
buyer_4,Jorge,Moreno,1974-05-23,40441389Y,jorge.moreno@superapp.digital,216601,ES46209505951516573022,5874.73,2022-09-14T14:19:52,Galdakao,expenses,repairs,-68.6,-20470.78
buyer_4,Jorge,Moreno,1974-05-23,40441389Y,jorge.moreno@superapp.digital,216601,ES46209505951516573022,5874.73,2022-09-16T22:51:34,Galdakao,expenses,leisure,-47.42,-20518.2
buyer_4,Jorge,Moreno,1974-05-23,40441389Y,jorge.moreno@superapp.digital,216601,ES46209505951516573022,5874.73,2022-09-17T08:25:44,Galdakao,expenses,transport,-55.72,-20573.92
buyer_4,Jorge,Moreno,1974-05-23,40441389Y,jorge.moreno@superapp.digital,216601,ES46209505951516573022,5874.73,2022-09-17T13:54:54,Galdakao,expenses,clothing,-158.12,-20732.04
buyer_4,Jorge,Moreno,1974-05-23,40441389Y,jorge.moreno@superapp.digital,216601,ES46209505951516573022,5874.73,2022-09-19T15:19:50,Galdakao,expenses,food,-81.57,-20813.61
buyer_4,Jorge,Moreno,1974-05-23,40441389Y,jorge.moreno@superapp.digital,216601,ES46209505951516573022,5874.73,2022-09-19T10:04:36,Galdakao,expenses,leisure,-32.9,-20846.51
buyer_4,Jorge,Moreno,1974-05-23,40441389Y,jorge.moreno@superapp.digital,216601,ES46209505951516573022,5874.73,2022-09-19T14:22:55,Galdakao,expenses,children,-624.8849166666665,-21471.39
buyer_4,Jorge,Moreno,1974-05-23,40441389Y,jorge.moreno@superapp.digital,216601,ES46209505951516573022,5874.73,2022-09-21T08:39:46,Galdakao,expenses,cash,-100.0,-21571.39
buyer_4,Jorge,Moreno,1974-05-23,40441389Y,jorge.moreno@superapp.digital,216601,ES46209505951516573022,5874.73,2022-09-24T13:58:39,Galdakao,expenses,cash,-100.0,-21671.39
buyer_4,Jorge,Moreno,1974-05-23,40441389Y,jorge.moreno@superapp.digital,216601,ES46209505951516573022,5874.73,2022-09-26T17:46:19,Galdakao,expenses,leisure,-53.05,-21724.44
buyer_4,Jorge,Moreno,1974-05-23,40441389Y,jorge.moreno@superapp.digital,216601,ES46209505951516573022,5874.73,2022-09-27T17:37:34,Galdakao,expenses,repairs,-282.99,-22007.43
buyer_4,Jorge,Moreno,1974-05-23,40441389Y,jorge.moreno@superapp.digital,216601,ES46209505951516573022,5874.73,2022-09-28T12:28:09,Galdakao,expenses,gifts,-200.76,-22208.19
buyer_4,Jorge,Moreno,1974-05-23,40441389Y,jorge.moreno@superapp.digital,216601,ES46209505951516573022,5874.73,2022-09-29T14:22:56,Galdakao,expenses,transport,-55.1,-22263.29
buyer_4,Jorge,Moreno,1974-05-23,40441389Y,jorge.moreno@superapp.digital,216601,ES46209505951516573022,5874.73,2022-09-29T00:00:54,Galdakao,expenses,repairs,-220.69,-22483.98
buyer_4,Jorge,Moreno,1974-05-23,40441389Y,jorge.moreno@superapp.digital,216601,ES46209505951516573022,5874.73,2022-09-29T12:51:18,Galdakao,expenses,gifts,-418.75,-22902.73
buyer_4,Jorge,Moreno,1974-05-23,40441389Y,jorge.moreno@superapp.digital,216601,ES46209505951516573022,5874.73,2022-09-30T14:01:47,Galdakao,expenses,cash,-100.0,-23002.73
buyer_4,Jorge,Moreno,1974-05-23,40441389Y,jorge.moreno@superapp.digital,216601,ES46209505951516573022,5874.73,2022-10-01T17:46:44,Galdakao,incomes,salary,2415.31,-20587.42
buyer_4,Jorge,Moreno,1974-05-23,40441389Y,jorge.moreno@superapp.digital,216601,ES46209505951516573022,5874.73,2022-10-01T17:46:44,Galdakao,incomes,extra_income,385.48,-20201.94
buyer_4,Jorge,Moreno,1974-05-23,40441389Y,jorge.moreno@superapp.digital,216601,ES46209505951516573022,5874.73,2022-10-02T21:22:21,Galdakao,expenses,transport,-48.01,-20249.95
buyer_4,Jorge,Moreno,1974-05-23,40441389Y,jorge.moreno@superapp.digital,216601,ES46209505951516573022,5874.73,2022-10-04T22:42:37,Galdakao,expenses,mortgage,-1279.96,-21529.91
buyer_4,Jorge,Moreno,1974-05-23,40441389Y,jorge.moreno@superapp.digital,216601,ES46209505951516573022,5874.73,2022-10-04T01:36:04,Galdakao,expenses,food,-75.88,-21605.79
buyer_4,Jorge,Moreno,1974-05-23,40441389Y,jorge.moreno@superapp.digital,216601,ES46209505951516573022,5874.73,2022-10-05T21:15:51,Galdakao,expenses,gas,-107.78,-21713.57
buyer_4,Jorge,Moreno,1974-05-23,40441389Y,jorge.moreno@superapp.digital,216601,ES46209505951516573022,5874.73,2022-10-05T17:55:44,Galdakao,expenses,food,-67.3,-21780.87
buyer_4,Jorge,Moreno,1974-05-23,40441389Y,jorge.moreno@superapp.digital,216601,ES46209505951516573022,5874.73,2022-10-05T15:18:31,Galdakao,expenses,leisure,-39.33,-21820.2
buyer_4,Jorge,Moreno,1974-05-23,40441389Y,jorge.moreno@superapp.digital,216601,ES46209505951516573022,5874.73,2022-10-06T16:59:44,Galdakao,expenses,water,-31.15,-21851.35
buyer_4,Jorge,Moreno,1974-05-23,40441389Y,jorge.moreno@superapp.digital,216601,ES46209505951516573022,5874.73,2022-10-06T12:53:10,Galdakao,expenses,gas,-59.39,-21910.74
buyer_4,Jorge,Moreno,1974-05-23,40441389Y,jorge.moreno@superapp.digital,216601,ES46209505951516573022,5874.73,2022-10-07T09:32:10,Galdakao,expenses,electricity,-96.08,-22006.82
buyer_4,Jorge,Moreno,1974-05-23,40441389Y,jorge.moreno@superapp.digital,216601,ES46209505951516573022,5874.73,2022-10-07T13:11:13,Galdakao,expenses,phone,-41.33,-22048.15
buyer_4,Jorge,Moreno,1974-05-23,40441389Y,jorge.moreno@superapp.digital,216601,ES46209505951516573022,5874.73,2022-10-07T08:55:17,Galdakao,expenses,leisure,-28.26,-22076.41
buyer_4,Jorge,Moreno,1974-05-23,40441389Y,jorge.moreno@superapp.digital,216601,ES46209505951516573022,5874.73,2022-10-07T12:55:14,Galdakao,expenses,cash,-100.0,-22176.41
buyer_4,Jorge,Moreno,1974-05-23,40441389Y,jorge.moreno@superapp.digital,216601,ES46209505951516573022,5874.73,2022-10-08T06:52:10,Galdakao,expenses,water,-31.6,-22208.01
buyer_4,Jorge,Moreno,1974-05-23,40441389Y,jorge.moreno@superapp.digital,216601,ES46209505951516573022,5874.73,2022-10-08T20:07:00,Galdakao,expenses,internet,-50.72,-22258.73
buyer_4,Jorge,Moreno,1974-05-23,40441389Y,jorge.moreno@superapp.digital,216601,ES46209505951516573022,5874.73,2022-10-08T15:42:23,Galdakao,expenses,education,-53.52,-22312.25
buyer_4,Jorge,Moreno,1974-05-23,40441389Y,jorge.moreno@superapp.digital,216601,ES46209505951516573022,5874.73,2022-10-08T09:19:34,Galdakao,expenses,travel,-302.28,-22614.53
buyer_4,Jorge,Moreno,1974-05-23,40441389Y,jorge.moreno@superapp.digital,216601,ES46209505951516573022,5874.73,2022-10-09T01:22:39,Galdakao,expenses,repairs,-160.44,-22774.97
buyer_4,Jorge,Moreno,1974-05-23,40441389Y,jorge.moreno@superapp.digital,216601,ES46209505951516573022,5874.73,2022-10-11T13:23:41,Galdakao,expenses,cash,-100.0,-22874.97
buyer_4,Jorge,Moreno,1974-05-23,40441389Y,jorge.moreno@superapp.digital,216601,ES46209505951516573022,5874.73,2022-10-12T15:50:43,Galdakao,expenses,food,-99.57,-22974.54
buyer_4,Jorge,Moreno,1974-05-23,40441389Y,jorge.moreno@superapp.digital,216601,ES46209505951516573022,5874.73,2022-10-12T11:32:19,Galdakao,expenses,transport,-42.96,-23017.5
buyer_4,Jorge,Moreno,1974-05-23,40441389Y,jorge.moreno@superapp.digital,216601,ES46209505951516573022,5874.73,2022-10-15T09:15:02,Galdakao,expenses,education,-60.9,-23078.4
buyer_4,Jorge,Moreno,1974-05-23,40441389Y,jorge.moreno@superapp.digital,216601,ES46209505951516573022,5874.73,2022-10-16T13:50:06,Galdakao,expenses,food,-85.58,-23163.98
buyer_4,Jorge,Moreno,1974-05-23,40441389Y,jorge.moreno@superapp.digital,216601,ES46209505951516573022,5874.73,2022-10-19T09:09:46,Galdakao,expenses,food,-109.87,-23273.85
buyer_4,Jorge,Moreno,1974-05-23,40441389Y,jorge.moreno@superapp.digital,216601,ES46209505951516573022,5874.73,2022-10-21T22:49:34,Galdakao,expenses,leisure,-45.38,-23319.23
buyer_4,Jorge,Moreno,1974-05-23,40441389Y,jorge.moreno@superapp.digital,216601,ES46209505951516573022,5874.73,2022-10-21T14:55:47,Galdakao,expenses,gifts,-121.08,-23440.31
buyer_4,Jorge,Moreno,1974-05-23,40441389Y,jorge.moreno@superapp.digital,216601,ES46209505951516573022,5874.73,2022-10-23T13:45:18,Galdakao,expenses,food,-84.59,-23524.9
buyer_4,Jorge,Moreno,1974-05-23,40441389Y,jorge.moreno@superapp.digital,216601,ES46209505951516573022,5874.73,2022-10-24T13:13:10,Galdakao,expenses,cash,-100.0,-23624.9
buyer_4,Jorge,Moreno,1974-05-23,40441389Y,jorge.moreno@superapp.digital,216601,ES46209505951516573022,5874.73,2022-10-27T09:20:54,Galdakao,expenses,leisure,-32.18,-23657.08
buyer_4,Jorge,Moreno,1974-05-23,40441389Y,jorge.moreno@superapp.digital,216601,ES46209505951516573022,5874.73,2022-10-28T10:38:00,Galdakao,expenses,leisure,-23.98,-23681.06
buyer_4,Jorge,Moreno,1974-05-23,40441389Y,jorge.moreno@superapp.digital,216601,ES46209505951516573022,5874.73,2022-10-30T17:04:44,Galdakao,expenses,cash,-100.0,-23781.06
buyer_4,Jorge,Moreno,1974-05-23,40441389Y,jorge.moreno@superapp.digital,216601,ES46209505951516573022,5874.73,2022-11-01T16:55:29,Galdakao,incomes,salary,2415.31,-21365.75
buyer_4,Jorge,Moreno,1974-05-23,40441389Y,jorge.moreno@superapp.digital,216601,ES46209505951516573022,5874.73,2022-11-02T13:30:14,Galdakao,expenses,cash,-100.0,-21465.75
buyer_4,Jorge,Moreno,1974-05-23,40441389Y,jorge.moreno@superapp.digital,216601,ES46209505951516573022,5874.73,2022-11-03T22:08:38,Galdakao,expenses,transport,-82.69,-21548.44
buyer_4,Jorge,Moreno,1974-05-23,40441389Y,jorge.moreno@superapp.digital,216601,ES46209505951516573022,5874.73,2022-11-04T12:12:32,Galdakao,expenses,mortgage,-1279.96,-22828.4
buyer_4,Jorge,Moreno,1974-05-23,40441389Y,jorge.moreno@superapp.digital,216601,ES46209505951516573022,5874.73,2022-11-05T12:33:35,Galdakao,expenses,electricity,-33.19,-22861.59
buyer_4,Jorge,Moreno,1974-05-23,40441389Y,jorge.moreno@superapp.digital,216601,ES46209505951516573022,5874.73,2022-11-05T20:30:35,Galdakao,expenses,gas,-93.08,-22954.67
buyer_4,Jorge,Moreno,1974-05-23,40441389Y,jorge.moreno@superapp.digital,216601,ES46209505951516573022,5874.73,2022-11-06T19:43:51,Galdakao,expenses,water,-37.1,-22991.77
buyer_4,Jorge,Moreno,1974-05-23,40441389Y,jorge.moreno@superapp.digital,216601,ES46209505951516573022,5874.73,2022-11-07T19:21:10,Galdakao,expenses,cash,-100.0,-23091.77
buyer_4,Jorge,Moreno,1974-05-23,40441389Y,jorge.moreno@superapp.digital,216601,ES46209505951516573022,5874.73,2022-11-07T02:31:20,Galdakao,expenses,children,-639.3549166666666,-23731.12
buyer_4,Jorge,Moreno,1974-05-23,40441389Y,jorge.moreno@superapp.digital,216601,ES46209505951516573022,5874.73,2022-11-08T17:26:48,Galdakao,expenses,leisure,-44.51,-23775.63
buyer_4,Jorge,Moreno,1974-05-23,40441389Y,jorge.moreno@superapp.digital,216601,ES46209505951516573022,5874.73,2022-11-10T15:49:25,Galdakao,expenses,food,-119.24,-23894.87
buyer_4,Jorge,Moreno,1974-05-23,40441389Y,jorge.moreno@superapp.digital,216601,ES46209505951516573022,5874.73,2022-11-10T19:45:47,Galdakao,expenses,children,-502.51,-24397.38
buyer_4,Jorge,Moreno,1974-05-23,40441389Y,jorge.moreno@superapp.digital,216601,ES46209505951516573022,5874.73,2022-11-11T19:41:48,Galdakao,expenses,food,-64.03,-24461.41
buyer_4,Jorge,Moreno,1974-05-23,40441389Y,jorge.moreno@superapp.digital,216601,ES46209505951516573022,5874.73,2022-11-11T14:00:04,Galdakao,expenses,leisure,-78.44,-24539.85
buyer_4,Jorge,Moreno,1974-05-23,40441389Y,jorge.moreno@superapp.digital,216601,ES46209505951516573022,5874.73,2022-11-11T05:15:21,Galdakao,expenses,cash,-100.0,-24639.85
buyer_4,Jorge,Moreno,1974-05-23,40441389Y,jorge.moreno@superapp.digital,216601,ES46209505951516573022,5874.73,2022-11-12T09:16:05,Galdakao,expenses,cash,-100.0,-24739.85
buyer_4,Jorge,Moreno,1974-05-23,40441389Y,jorge.moreno@superapp.digital,216601,ES46209505951516573022,5874.73,2022-11-14T08:34:47,Galdakao,expenses,cash,-100.0,-24839.85
buyer_4,Jorge,Moreno,1974-05-23,40441389Y,jorge.moreno@superapp.digital,216601,ES46209505951516573022,5874.73,2022-11-14T19:41:33,Galdakao,expenses,gifts,-412.41,-25252.26
buyer_4,Jorge,Moreno,1974-05-23,40441389Y,jorge.moreno@superapp.digital,216601,ES46209505951516573022,5874.73,2022-11-15T08:20:40,Galdakao,expenses,food,-99.86,-25352.12
buyer_4,Jorge,Moreno,1974-05-23,40441389Y,jorge.moreno@superapp.digital,216601,ES46209505951516573022,5874.73,2022-11-15T19:56:48,Galdakao,expenses,cash,-100.0,-25452.12
buyer_4,Jorge,Moreno,1974-05-23,40441389Y,jorge.moreno@superapp.digital,216601,ES46209505951516573022,5874.73,2022-11-16T11:43:50,Galdakao,expenses,cash,-100.0,-25552.12
buyer_4,Jorge,Moreno,1974-05-23,40441389Y,jorge.moreno@superapp.digital,216601,ES46209505951516573022,5874.73,2022-11-20T10:06:38,Galdakao,expenses,transport,-86.58,-25638.7
buyer_4,Jorge,Moreno,1974-05-23,40441389Y,jorge.moreno@superapp.digital,216601,ES46209505951516573022,5874.73,2022-11-22T18:14:25,Galdakao,expenses,leisure,-72.41,-25711.11
buyer_4,Jorge,Moreno,1974-05-23,40441389Y,jorge.moreno@superapp.digital,216601,ES46209505951516573022,5874.73,2022-11-22T14:20:50,Galdakao,expenses,healthcare,-92.52,-25803.63
buyer_4,Jorge,Moreno,1974-05-23,40441389Y,jorge.moreno@superapp.digital,216601,ES46209505951516573022,5874.73,2022-11-22T20:47:38,Galdakao,expenses,cash,-100.0,-25903.63
buyer_4,Jorge,Moreno,1974-05-23,40441389Y,jorge.moreno@superapp.digital,216601,ES46209505951516573022,5874.73,2022-11-23T00:22:43,Galdakao,expenses,food,-116.8,-26020.43
buyer_4,Jorge,Moreno,1974-05-23,40441389Y,jorge.moreno@superapp.digital,216601,ES46209505951516573022,5874.73,2022-11-23T20:24:46,Galdakao,expenses,repairs,-131.87,-26152.3
buyer_4,Jorge,Moreno,1974-05-23,40441389Y,jorge.moreno@superapp.digital,216601,ES46209505951516573022,5874.73,2022-11-24T19:56:25,Galdakao,expenses,transport,-60.22,-26212.52
buyer_4,Jorge,Moreno,1974-05-23,40441389Y,jorge.moreno@superapp.digital,216601,ES46209505951516573022,5874.73,2022-11-26T08:33:46,Galdakao,expenses,healthcare,-179.45,-26391.97
buyer_4,Jorge,Moreno,1974-05-23,40441389Y,jorge.moreno@superapp.digital,216601,ES46209505951516573022,5874.73,2022-11-26T08:00:19,Galdakao,expenses,children,-559.9049166666666,-26951.87
buyer_4,Jorge,Moreno,1974-05-23,40441389Y,jorge.moreno@superapp.digital,216601,ES46209505951516573022,5874.73,2022-11-28T14:14:12,Galdakao,expenses,clothing,-110.95,-27062.82
buyer_4,Jorge,Moreno,1974-05-23,40441389Y,jorge.moreno@superapp.digital,216601,ES46209505951516573022,5874.73,2022-11-28T20:51:49,Galdakao,expenses,cash,-100.0,-27162.82
buyer_4,Jorge,Moreno,1974-05-23,40441389Y,jorge.moreno@superapp.digital,216601,ES46209505951516573022,5874.73,2022-11-29T15:49:07,Galdakao,expenses,healthcare,-145.1,-27307.92
buyer_4,Jorge,Moreno,1974-05-23,40441389Y,jorge.moreno@superapp.digital,216601,ES46209505951516573022,5874.73,2022-12-01T18:25:48,Galdakao,incomes,salary,2415.31,-24892.61
buyer_4,Jorge,Moreno,1974-05-23,40441389Y,jorge.moreno@superapp.digital,216601,ES46209505951516573022,5874.73,2022-12-01T18:25:48,Galdakao,incomes,salary_bonus,1896.44,-22996.17
buyer_4,Jorge,Moreno,1974-05-23,40441389Y,jorge.moreno@superapp.digital,216601,ES46209505951516573022,5874.73,2022-12-01T11:25:52,Galdakao,expenses,repairs,-280.25,-23276.42
buyer_4,Jorge,Moreno,1974-05-23,40441389Y,jorge.moreno@superapp.digital,216601,ES46209505951516573022,5874.73,2022-12-02T22:34:06,Galdakao,expenses,leisure,-49.07,-23325.49
buyer_4,Jorge,Moreno,1974-05-23,40441389Y,jorge.moreno@superapp.digital,216601,ES46209505951516573022,5874.73,2022-12-02T16:38:22,Galdakao,expenses,children,-690.2849166666665,-24015.77
buyer_4,Jorge,Moreno,1974-05-23,40441389Y,jorge.moreno@superapp.digital,216601,ES46209505951516573022,5874.73,2022-12-03T23:32:48,Galdakao,expenses,leisure,-61.49,-24077.26
buyer_4,Jorge,Moreno,1974-05-23,40441389Y,jorge.moreno@superapp.digital,216601,ES46209505951516573022,5874.73,2022-12-03T10:30:56,Galdakao,expenses,cash,-100.0,-24177.26
buyer_4,Jorge,Moreno,1974-05-23,40441389Y,jorge.moreno@superapp.digital,216601,ES46209505951516573022,5874.73,2022-12-03T08:35:19,Galdakao,expenses,repairs,-164.74,-24342.0
buyer_4,Jorge,Moreno,1974-05-23,40441389Y,jorge.moreno@superapp.digital,216601,ES46209505951516573022,5874.73,2022-12-03T08:10:27,Galdakao,expenses,gifts,-158.71,-24500.71
buyer_4,Jorge,Moreno,1974-05-23,40441389Y,jorge.moreno@superapp.digital,216601,ES46209505951516573022,5874.73,2022-12-04T18:27:29,Galdakao,expenses,mortgage,-1279.96,-25780.67
buyer_4,Jorge,Moreno,1974-05-23,40441389Y,jorge.moreno@superapp.digital,216601,ES46209505951516573022,5874.73,2022-12-05T03:38:47,Galdakao,expenses,electricity,-32.8,-25813.47
buyer_4,Jorge,Moreno,1974-05-23,40441389Y,jorge.moreno@superapp.digital,216601,ES46209505951516573022,5874.73,2022-12-06T10:55:34,Galdakao,expenses,water,-42.23,-25855.7
buyer_4,Jorge,Moreno,1974-05-23,40441389Y,jorge.moreno@superapp.digital,216601,ES46209505951516573022,5874.73,2022-12-06T16:33:33,Galdakao,expenses,electricity,-70.45,-25926.15
buyer_4,Jorge,Moreno,1974-05-23,40441389Y,jorge.moreno@superapp.digital,216601,ES46209505951516573022,5874.73,2022-12-06T12:36:58,Galdakao,expenses,internet,-50.72,-25976.87
buyer_4,Jorge,Moreno,1974-05-23,40441389Y,jorge.moreno@superapp.digital,216601,ES46209505951516573022,5874.73,2022-12-07T20:59:56,Galdakao,expenses,electricity,-58.23,-26035.1
buyer_4,Jorge,Moreno,1974-05-23,40441389Y,jorge.moreno@superapp.digital,216601,ES46209505951516573022,5874.73,2022-12-07T11:02:40,Galdakao,expenses,gas,-112.17,-26147.27
buyer_4,Jorge,Moreno,1974-05-23,40441389Y,jorge.moreno@superapp.digital,216601,ES46209505951516573022,5874.73,2022-12-07T18:15:03,Galdakao,expenses,food,-98.22,-26245.49
buyer_4,Jorge,Moreno,1974-05-23,40441389Y,jorge.moreno@superapp.digital,216601,ES46209505951516573022,5874.73,2022-12-08T18:07:10,Galdakao,expenses,gas,-91.52,-26337.01
buyer_4,Jorge,Moreno,1974-05-23,40441389Y,jorge.moreno@superapp.digital,216601,ES46209505951516573022,5874.73,2022-12-08T18:24:17,Galdakao,expenses,cash,-100.0,-26437.01
buyer_4,Jorge,Moreno,1974-05-23,40441389Y,jorge.moreno@superapp.digital,216601,ES46209505951516573022,5874.73,2022-12-10T18:12:36,Galdakao,expenses,cash,-100.0,-26537.01
buyer_4,Jorge,Moreno,1974-05-23,40441389Y,jorge.moreno@superapp.digital,216601,ES46209505951516573022,5874.73,2022-12-10T17:05:39,Galdakao,expenses,repairs,-59.04,-26596.05
buyer_4,Jorge,Moreno,1974-05-23,40441389Y,jorge.moreno@superapp.digital,216601,ES46209505951516573022,5874.73,2022-12-14T08:03:06,Galdakao,expenses,clothing,-137.79,-26733.84
buyer_4,Jorge,Moreno,1974-05-23,40441389Y,jorge.moreno@superapp.digital,216601,ES46209505951516573022,5874.73,2022-12-15T18:57:09,Galdakao,expenses,repairs,-153.53,-26887.37
buyer_4,Jorge,Moreno,1974-05-23,40441389Y,jorge.moreno@superapp.digital,216601,ES46209505951516573022,5874.73,2022-12-16T14:03:30,Galdakao,expenses,travel,-565.38,-27452.75
buyer_4,Jorge,Moreno,1974-05-23,40441389Y,jorge.moreno@superapp.digital,216601,ES46209505951516573022,5874.73,2022-12-17T16:00:00,Galdakao,expenses,cash,-100.0,-27552.75
buyer_4,Jorge,Moreno,1974-05-23,40441389Y,jorge.moreno@superapp.digital,216601,ES46209505951516573022,5874.73,2022-12-18T23:12:03,Galdakao,expenses,food,-107.12,-27659.87
buyer_4,Jorge,Moreno,1974-05-23,40441389Y,jorge.moreno@superapp.digital,216601,ES46209505951516573022,5874.73,2022-12-20T14:04:33,Galdakao,expenses,cash,-100.0,-27759.87
buyer_4,Jorge,Moreno,1974-05-23,40441389Y,jorge.moreno@superapp.digital,216601,ES46209505951516573022,5874.73,2022-12-21T18:32:45,Galdakao,expenses,cash,-100.0,-27859.87
buyer_4,Jorge,Moreno,1974-05-23,40441389Y,jorge.moreno@superapp.digital,216601,ES46209505951516573022,5874.73,2022-12-21T19:00:54,Galdakao,expenses,repairs,-78.25,-27938.12
buyer_4,Jorge,Moreno,1974-05-23,40441389Y,jorge.moreno@superapp.digital,216601,ES46209505951516573022,5874.73,2022-12-22T18:15:49,Galdakao,expenses,leisure,-59.22,-27997.34
buyer_4,Jorge,Moreno,1974-05-23,40441389Y,jorge.moreno@superapp.digital,216601,ES46209505951516573022,5874.73,2022-12-22T18:38:56,Galdakao,expenses,clothing,-130.81,-28128.15
buyer_4,Jorge,Moreno,1974-05-23,40441389Y,jorge.moreno@superapp.digital,216601,ES46209505951516573022,5874.73,2022-12-22T11:55:21,Galdakao,expenses,cash,-100.0,-28228.15
buyer_4,Jorge,Moreno,1974-05-23,40441389Y,jorge.moreno@superapp.digital,216601,ES46209505951516573022,5874.73,2022-12-25T18:10:56,Galdakao,expenses,food,-115.23,-28343.38
buyer_4,Jorge,Moreno,1974-05-23,40441389Y,jorge.moreno@superapp.digital,216601,ES46209505951516573022,5874.73,2022-12-26T09:54:52,Galdakao,expenses,food,-89.28,-28432.66
buyer_4,Jorge,Moreno,1974-05-23,40441389Y,jorge.moreno@superapp.digital,216601,ES46209505951516573022,5874.73,2022-12-28T08:49:15,Galdakao,expenses,cash,-100.0,-28532.66
buyer_4,Jorge,Moreno,1974-05-23,40441389Y,jorge.moreno@superapp.digital,216601,ES46209505951516573022,5874.73,2022-12-30T16:57:10,Galdakao,expenses,food,-119.28,-28651.94
buyer_4,Jorge,Moreno,1974-05-23,40441389Y,jorge.moreno@superapp.digital,216601,ES46209505951516573022,5874.73,2022-12-31T11:44:24,Galdakao,expenses,healthcare,-52.67,-28704.61
buyer_4,Jorge,Moreno,1974-05-23,40441389Y,jorge.moreno@superapp.digital,216601,ES46209505951516573022,5874.73,2022-12-31T13:25:53,Galdakao,expenses,education,-59.11,-28763.72
buyer_4,Jorge,Moreno,1974-05-23,40441389Y,jorge.moreno@superapp.digital,216601,ES46209505951516573022,5874.73,2022-12-31T14:43:10,Galdakao,expenses,cash,-100.0,-28863.72
buyer_4,Jorge,Moreno,1974-05-23,40441389Y,jorge.moreno@superapp.digital,216601,ES46209505951516573022,5874.73,2023-01-01T10:28:40,Galdakao,incomes,salary,2466.94,-26396.78
buyer_4,Jorge,Moreno,1974-05-23,40441389Y,jorge.moreno@superapp.digital,216601,ES46209505951516573022,5874.73,2023-01-01T14:16:58,Galdakao,expenses,food,-95.65,-26492.43
buyer_4,Jorge,Moreno,1974-05-23,40441389Y,jorge.moreno@superapp.digital,216601,ES46209505951516573022,5874.73,2023-01-02T11:15:02,Galdakao,expenses,healthcare,-127.94,-26620.37
buyer_4,Jorge,Moreno,1974-05-23,40441389Y,jorge.moreno@superapp.digital,216601,ES46209505951516573022,5874.73,2023-01-02T16:12:16,Galdakao,expenses,children,-706.8582500000005,-27327.23
buyer_4,Jorge,Moreno,1974-05-23,40441389Y,jorge.moreno@superapp.digital,216601,ES46209505951516573022,5874.73,2023-01-03T14:26:03,Galdakao,expenses,leisure,-61.15,-27388.38
buyer_4,Jorge,Moreno,1974-05-23,40441389Y,jorge.moreno@superapp.digital,216601,ES46209505951516573022,5874.73,2023-01-03T10:46:35,Galdakao,expenses,gifts,-322.45,-27710.83
buyer_4,Jorge,Moreno,1974-05-23,40441389Y,jorge.moreno@superapp.digital,216601,ES46209505951516573022,5874.73,2023-01-04T03:06:30,Galdakao,expenses,mortgage,-1154.88,-28865.71
buyer_4,Jorge,Moreno,1974-05-23,40441389Y,jorge.moreno@superapp.digital,216601,ES46209505951516573022,5874.73,2023-01-05T19:02:00,Galdakao,expenses,water,-32.05,-28897.76
buyer_4,Jorge,Moreno,1974-05-23,40441389Y,jorge.moreno@superapp.digital,216601,ES46209505951516573022,5874.73,2023-01-05T08:47:31,Galdakao,expenses,internet,-51.81,-28949.57
buyer_4,Jorge,Moreno,1974-05-23,40441389Y,jorge.moreno@superapp.digital,216601,ES46209505951516573022,5874.73,2023-01-05T19:42:42,Galdakao,expenses,repairs,-64.54,-29014.11
buyer_4,Jorge,Moreno,1974-05-23,40441389Y,jorge.moreno@superapp.digital,216601,ES46209505951516573022,5874.73,2023-01-06T16:32:14,Galdakao,expenses,water,-33.18,-29047.29
buyer_4,Jorge,Moreno,1974-05-23,40441389Y,jorge.moreno@superapp.digital,216601,ES46209505951516573022,5874.73,2023-01-06T13:04:13,Galdakao,expenses,internet,-51.81,-29099.1
buyer_4,Jorge,Moreno,1974-05-23,40441389Y,jorge.moreno@superapp.digital,216601,ES46209505951516573022,5874.73,2023-01-06T16:02:24,Galdakao,expenses,travel,-739.31,-29838.41
buyer_4,Jorge,Moreno,1974-05-23,40441389Y,jorge.moreno@superapp.digital,216601,ES46209505951516573022,5874.73,2023-01-07T08:35:55,Galdakao,expenses,leisure,-44.73,-29883.14
buyer_4,Jorge,Moreno,1974-05-23,40441389Y,jorge.moreno@superapp.digital,216601,ES46209505951516573022,5874.73,2023-01-07T17:23:05,Galdakao,expenses,healthcare,-177.31,-30060.45
buyer_4,Jorge,Moreno,1974-05-23,40441389Y,jorge.moreno@superapp.digital,216601,ES46209505951516573022,5874.73,2023-01-07T23:49:41,Galdakao,expenses,repairs,-285.55,-30346.0
buyer_4,Jorge,Moreno,1974-05-23,40441389Y,jorge.moreno@superapp.digital,216601,ES46209505951516573022,5874.73,2023-01-07T11:36:20,Galdakao,expenses,gifts,-25.69,-30371.69
buyer_4,Jorge,Moreno,1974-05-23,40441389Y,jorge.moreno@superapp.digital,216601,ES46209505951516573022,5874.73,2023-01-08T12:44:09,Galdakao,expenses,water,-26.63,-30398.32
buyer_4,Jorge,Moreno,1974-05-23,40441389Y,jorge.moreno@superapp.digital,216601,ES46209505951516573022,5874.73,2023-01-08T08:41:40,Galdakao,expenses,internet,-51.81,-30450.13
buyer_4,Jorge,Moreno,1974-05-23,40441389Y,jorge.moreno@superapp.digital,216601,ES46209505951516573022,5874.73,2023-01-08T20:06:26,Galdakao,expenses,phone,-49.69,-30499.82
buyer_4,Jorge,Moreno,1974-05-23,40441389Y,jorge.moreno@superapp.digital,216601,ES46209505951516573022,5874.73,2023-01-08T11:50:08,Galdakao,expenses,repairs,-56.11,-30555.93
buyer_4,Jorge,Moreno,1974-05-23,40441389Y,jorge.moreno@superapp.digital,216601,ES46209505951516573022,5874.73,2023-01-08T14:21:31,Galdakao,expenses,gifts,-108.51,-30664.44
buyer_4,Jorge,Moreno,1974-05-23,40441389Y,jorge.moreno@superapp.digital,216601,ES46209505951516573022,5874.73,2023-01-09T02:56:11,Galdakao,expenses,repairs,-52.31,-30716.75
buyer_4,Jorge,Moreno,1974-05-23,40441389Y,jorge.moreno@superapp.digital,216601,ES46209505951516573022,5874.73,2023-01-10T05:10:23,Galdakao,expenses,gifts,-459.1,-31175.85
buyer_4,Jorge,Moreno,1974-05-23,40441389Y,jorge.moreno@superapp.digital,216601,ES46209505951516573022,5874.73,2023-01-11T09:40:56,Galdakao,expenses,travel,-777.05,-31952.9
buyer_4,Jorge,Moreno,1974-05-23,40441389Y,jorge.moreno@superapp.digital,216601,ES46209505951516573022,5874.73,2023-01-15T19:39:02,Galdakao,expenses,cash,-100.0,-32052.9
buyer_4,Jorge,Moreno,1974-05-23,40441389Y,jorge.moreno@superapp.digital,216601,ES46209505951516573022,5874.73,2023-01-15T09:02:07,Galdakao,expenses,travel,-398.85,-32451.75
buyer_4,Jorge,Moreno,1974-05-23,40441389Y,jorge.moreno@superapp.digital,216601,ES46209505951516573022,5874.73,2023-01-16T10:46:29,Galdakao,expenses,leisure,-38.44,-32490.19
buyer_4,Jorge,Moreno,1974-05-23,40441389Y,jorge.moreno@superapp.digital,216601,ES46209505951516573022,5874.73,2023-01-17T15:10:54,Galdakao,expenses,transport,-50.54,-32540.73
buyer_4,Jorge,Moreno,1974-05-23,40441389Y,jorge.moreno@superapp.digital,216601,ES46209505951516573022,5874.73,2023-01-17T12:41:23,Galdakao,expenses,education,-57.65,-32598.38
buyer_4,Jorge,Moreno,1974-05-23,40441389Y,jorge.moreno@superapp.digital,216601,ES46209505951516573022,5874.73,2023-01-19T16:10:45,Galdakao,expenses,education,-69.87,-32668.25
buyer_4,Jorge,Moreno,1974-05-23,40441389Y,jorge.moreno@superapp.digital,216601,ES46209505951516573022,5874.73,2023-01-20T18:04:04,Galdakao,expenses,gifts,-661.99,-33330.24
buyer_4,Jorge,Moreno,1974-05-23,40441389Y,jorge.moreno@superapp.digital,216601,ES46209505951516573022,5874.73,2023-01-21T19:47:05,Galdakao,expenses,food,-91.77,-33422.01
buyer_4,Jorge,Moreno,1974-05-23,40441389Y,jorge.moreno@superapp.digital,216601,ES46209505951516573022,5874.73,2023-01-21T16:09:24,Galdakao,expenses,clothing,-109.8,-33531.81
buyer_4,Jorge,Moreno,1974-05-23,40441389Y,jorge.moreno@superapp.digital,216601,ES46209505951516573022,5874.73,2023-01-21T16:51:54,Galdakao,expenses,cash,-100.0,-33631.81
buyer_4,Jorge,Moreno,1974-05-23,40441389Y,jorge.moreno@superapp.digital,216601,ES46209505951516573022,5874.73,2023-01-23T02:22:32,Galdakao,expenses,transport,-42.6,-33674.41
buyer_4,Jorge,Moreno,1974-05-23,40441389Y,jorge.moreno@superapp.digital,216601,ES46209505951516573022,5874.73,2023-01-24T13:31:12,Galdakao,expenses,food,-87.57,-33761.98
buyer_4,Jorge,Moreno,1974-05-23,40441389Y,jorge.moreno@superapp.digital,216601,ES46209505951516573022,5874.73,2023-01-24T10:11:01,Galdakao,expenses,cash,-100.0,-33861.98
buyer_4,Jorge,Moreno,1974-05-23,40441389Y,jorge.moreno@superapp.digital,216601,ES46209505951516573022,5874.73,2023-01-24T07:51:59,Galdakao,expenses,repairs,-261.61,-34123.59
buyer_4,Jorge,Moreno,1974-05-23,40441389Y,jorge.moreno@superapp.digital,216601,ES46209505951516573022,5874.73,2023-01-26T13:03:11,Galdakao,expenses,food,-86.8,-34210.39
buyer_4,Jorge,Moreno,1974-05-23,40441389Y,jorge.moreno@superapp.digital,216601,ES46209505951516573022,5874.73,2023-01-26T11:59:33,Galdakao,expenses,transport,-61.78,-34272.17
buyer_4,Jorge,Moreno,1974-05-23,40441389Y,jorge.moreno@superapp.digital,216601,ES46209505951516573022,5874.73,2023-01-26T21:26:30,Galdakao,expenses,education,-57.03,-34329.2
buyer_4,Jorge,Moreno,1974-05-23,40441389Y,jorge.moreno@superapp.digital,216601,ES46209505951516573022,5874.73,2023-01-27T20:27:25,Galdakao,expenses,food,-72.78,-34401.98
buyer_4,Jorge,Moreno,1974-05-23,40441389Y,jorge.moreno@superapp.digital,216601,ES46209505951516573022,5874.73,2023-01-27T10:41:49,Galdakao,expenses,leisure,-83.99,-34485.97
buyer_4,Jorge,Moreno,1974-05-23,40441389Y,jorge.moreno@superapp.digital,216601,ES46209505951516573022,5874.73,2023-01-29T08:14:58,Galdakao,expenses,cash,-100.0,-34585.97
buyer_4,Jorge,Moreno,1974-05-23,40441389Y,jorge.moreno@superapp.digital,216601,ES46209505951516573022,5874.73,2023-01-30T13:32:27,Galdakao,expenses,food,-93.27,-34679.24
buyer_4,Jorge,Moreno,1974-05-23,40441389Y,jorge.moreno@superapp.digital,216601,ES46209505951516573022,5874.73,2023-01-30T18:13:50,Galdakao,expenses,transport,-69.65,-34748.89
buyer_4,Jorge,Moreno,1974-05-23,40441389Y,jorge.moreno@superapp.digital,216601,ES46209505951516573022,5874.73,2023-01-30T16:22:51,Galdakao,expenses,leisure,-46.0,-34794.89
buyer_4,Jorge,Moreno,1974-05-23,40441389Y,jorge.moreno@superapp.digital,216601,ES46209505951516573022,5874.73,2023-01-31T08:32:17,Galdakao,expenses,clothing,-118.57,-34913.46
buyer_4,Jorge,Moreno,1974-05-23,40441389Y,jorge.moreno@superapp.digital,216601,ES46209505951516573022,5874.73,2023-02-01T10:51:46,Galdakao,incomes,salary,2466.94,-32446.52
buyer_4,Jorge,Moreno,1974-05-23,40441389Y,jorge.moreno@superapp.digital,216601,ES46209505951516573022,5874.73,2023-02-01T10:51:46,Galdakao,incomes,extra_income,385.48,-32061.04
buyer_4,Jorge,Moreno,1974-05-23,40441389Y,jorge.moreno@superapp.digital,216601,ES46209505951516573022,5874.73,2023-02-01T09:39:58,Galdakao,expenses,food,-110.44,-32171.48
buyer_4,Jorge,Moreno,1974-05-23,40441389Y,jorge.moreno@superapp.digital,216601,ES46209505951516573022,5874.73,2023-02-02T18:36:42,Galdakao,expenses,cash,-100.0,-32271.48
buyer_4,Jorge,Moreno,1974-05-23,40441389Y,jorge.moreno@superapp.digital,216601,ES46209505951516573022,5874.73,2023-02-03T17:46:35,Galdakao,expenses,transport,-40.08,-32311.56
buyer_4,Jorge,Moreno,1974-05-23,40441389Y,jorge.moreno@superapp.digital,216601,ES46209505951516573022,5874.73,2023-02-03T13:27:24,Galdakao,expenses,repairs,-185.76,-32497.32
buyer_4,Jorge,Moreno,1974-05-23,40441389Y,jorge.moreno@superapp.digital,216601,ES46209505951516573022,5874.73,2023-02-04T17:11:15,Galdakao,expenses,mortgage,-1154.88,-33652.2
buyer_4,Jorge,Moreno,1974-05-23,40441389Y,jorge.moreno@superapp.digital,216601,ES46209505951516573022,5874.73,2023-02-04T19:58:37,Galdakao,expenses,leisure,-33.81,-33686.01
buyer_4,Jorge,Moreno,1974-05-23,40441389Y,jorge.moreno@superapp.digital,216601,ES46209505951516573022,5874.73,2023-02-05T15:59:58,Galdakao,expenses,water,-51.22,-33737.23
buyer_4,Jorge,Moreno,1974-05-23,40441389Y,jorge.moreno@superapp.digital,216601,ES46209505951516573022,5874.73,2023-02-05T11:38:02,Galdakao,expenses,electricity,-39.29,-33776.52
buyer_4,Jorge,Moreno,1974-05-23,40441389Y,jorge.moreno@superapp.digital,216601,ES46209505951516573022,5874.73,2023-02-05T20:57:45,Galdakao,expenses,clothing,-92.77,-33869.29
buyer_4,Jorge,Moreno,1974-05-23,40441389Y,jorge.moreno@superapp.digital,216601,ES46209505951516573022,5874.73,2023-02-05T00:58:13,Galdakao,expenses,repairs,-145.76,-34015.05
buyer_4,Jorge,Moreno,1974-05-23,40441389Y,jorge.moreno@superapp.digital,216601,ES46209505951516573022,5874.73,2023-02-06T20:25:34,Galdakao,expenses,electricity,-103.93,-34118.98
buyer_4,Jorge,Moreno,1974-05-23,40441389Y,jorge.moreno@superapp.digital,216601,ES46209505951516573022,5874.73,2023-02-06T07:16:32,Galdakao,expenses,gas,-56.9,-34175.88
buyer_4,Jorge,Moreno,1974-05-23,40441389Y,jorge.moreno@superapp.digital,216601,ES46209505951516573022,5874.73,2023-02-06T10:20:06,Galdakao,expenses,cash,-100.0,-34275.88
buyer_4,Jorge,Moreno,1974-05-23,40441389Y,jorge.moreno@superapp.digital,216601,ES46209505951516573022,5874.73,2023-02-06T00:37:52,Galdakao,expenses,repairs,-311.53,-34587.41
buyer_4,Jorge,Moreno,1974-05-23,40441389Y,jorge.moreno@superapp.digital,216601,ES46209505951516573022,5874.73,2023-02-07T09:11:15,Galdakao,expenses,food,-113.61,-34701.02
buyer_4,Jorge,Moreno,1974-05-23,40441389Y,jorge.moreno@superapp.digital,216601,ES46209505951516573022,5874.73,2023-02-08T19:32:06,Galdakao,expenses,gas,-51.94,-34752.96
buyer_4,Jorge,Moreno,1974-05-23,40441389Y,jorge.moreno@superapp.digital,216601,ES46209505951516573022,5874.73,2023-02-09T10:52:13,Galdakao,expenses,food,-92.44,-34845.4
buyer_4,Jorge,Moreno,1974-05-23,40441389Y,jorge.moreno@superapp.digital,216601,ES46209505951516573022,5874.73,2023-02-09T19:27:47,Galdakao,expenses,repairs,-305.68,-35151.08
buyer_4,Jorge,Moreno,1974-05-23,40441389Y,jorge.moreno@superapp.digital,216601,ES46209505951516573022,5874.73,2023-02-10T17:43:04,Galdakao,expenses,transport,-41.65,-35192.73
buyer_4,Jorge,Moreno,1974-05-23,40441389Y,jorge.moreno@superapp.digital,216601,ES46209505951516573022,5874.73,2023-02-10T09:13:50,Galdakao,expenses,repairs,-147.94,-35340.67
buyer_4,Jorge,Moreno,1974-05-23,40441389Y,jorge.moreno@superapp.digital,216601,ES46209505951516573022,5874.73,2023-02-11T11:14:12,Galdakao,expenses,food,-91.88,-35432.55
buyer_4,Jorge,Moreno,1974-05-23,40441389Y,jorge.moreno@superapp.digital,216601,ES46209505951516573022,5874.73,2023-02-11T08:14:08,Galdakao,expenses,cash,-100.0,-35532.55
buyer_4,Jorge,Moreno,1974-05-23,40441389Y,jorge.moreno@superapp.digital,216601,ES46209505951516573022,5874.73,2023-02-11T20:40:56,Galdakao,expenses,gifts,-640.56,-36173.11
buyer_4,Jorge,Moreno,1974-05-23,40441389Y,jorge.moreno@superapp.digital,216601,ES46209505951516573022,5874.73,2023-02-12T18:48:14,Galdakao,expenses,transport,-62.16,-36235.27
buyer_4,Jorge,Moreno,1974-05-23,40441389Y,jorge.moreno@superapp.digital,216601,ES46209505951516573022,5874.73,2023-02-12T10:48:42,Galdakao,expenses,leisure,-48.98,-36284.25
buyer_4,Jorge,Moreno,1974-05-23,40441389Y,jorge.moreno@superapp.digital,216601,ES46209505951516573022,5874.73,2023-02-13T16:02:40,Galdakao,expenses,leisure,-36.52,-36320.77
buyer_4,Jorge,Moreno,1974-05-23,40441389Y,jorge.moreno@superapp.digital,216601,ES46209505951516573022,5874.73,2023-02-14T13:14:20,Galdakao,expenses,food,-81.56,-36402.33
buyer_4,Jorge,Moreno,1974-05-23,40441389Y,jorge.moreno@superapp.digital,216601,ES46209505951516573022,5874.73,2023-02-14T04:21:37,Galdakao,expenses,transport,-51.56,-36453.89
buyer_4,Jorge,Moreno,1974-05-23,40441389Y,jorge.moreno@superapp.digital,216601,ES46209505951516573022,5874.73,2023-02-15T20:24:21,Galdakao,expenses,cash,-100.0,-36553.89
buyer_4,Jorge,Moreno,1974-05-23,40441389Y,jorge.moreno@superapp.digital,216601,ES46209505951516573022,5874.73,2023-02-16T19:28:38,Galdakao,expenses,gifts,-234.35,-36788.24
buyer_4,Jorge,Moreno,1974-05-23,40441389Y,jorge.moreno@superapp.digital,216601,ES46209505951516573022,5874.73,2023-02-17T09:54:00,Galdakao,expenses,cash,-100.0,-36888.24
buyer_4,Jorge,Moreno,1974-05-23,40441389Y,jorge.moreno@superapp.digital,216601,ES46209505951516573022,5874.73,2023-02-19T11:48:33,Galdakao,expenses,food,-65.64,-36953.88
buyer_4,Jorge,Moreno,1974-05-23,40441389Y,jorge.moreno@superapp.digital,216601,ES46209505951516573022,5874.73,2023-02-19T11:27:02,Galdakao,expenses,leisure,-65.34,-37019.22
buyer_4,Jorge,Moreno,1974-05-23,40441389Y,jorge.moreno@superapp.digital,216601,ES46209505951516573022,5874.73,2023-02-19T23:01:47,Galdakao,expenses,cash,-100.0,-37119.22
buyer_4,Jorge,Moreno,1974-05-23,40441389Y,jorge.moreno@superapp.digital,216601,ES46209505951516573022,5874.73,2023-02-20T19:52:28,Galdakao,expenses,education,-65.9,-37185.12
buyer_4,Jorge,Moreno,1974-05-23,40441389Y,jorge.moreno@superapp.digital,216601,ES46209505951516573022,5874.73,2023-02-21T06:37:16,Galdakao,expenses,food,-95.84,-37280.96
buyer_4,Jorge,Moreno,1974-05-23,40441389Y,jorge.moreno@superapp.digital,216601,ES46209505951516573022,5874.73,2023-02-21T19:46:43,Galdakao,expenses,cash,-100.0,-37380.96
buyer_4,Jorge,Moreno,1974-05-23,40441389Y,jorge.moreno@superapp.digital,216601,ES46209505951516573022,5874.73,2023-02-24T20:11:26,Galdakao,expenses,food,-115.19,-37496.15
buyer_4,Jorge,Moreno,1974-05-23,40441389Y,jorge.moreno@superapp.digital,216601,ES46209505951516573022,5874.73,2023-02-25T23:39:51,Galdakao,expenses,education,-72.34,-37568.49
buyer_4,Jorge,Moreno,1974-05-23,40441389Y,jorge.moreno@superapp.digital,216601,ES46209505951516573022,5874.73,2023-02-27T13:06:10,Galdakao,expenses,healthcare,-65.97,-37634.46
buyer_4,Jorge,Moreno,1974-05-23,40441389Y,jorge.moreno@superapp.digital,216601,ES46209505951516573022,5874.73,2023-02-28T10:20:04,Galdakao,expenses,transport,-76.43,-37710.89
buyer_4,Jorge,Moreno,1974-05-23,40441389Y,jorge.moreno@superapp.digital,216601,ES46209505951516573022,5874.73,2023-03-01T13:50:37,Galdakao,incomes,salary,2466.94,-35243.95
buyer_4,Jorge,Moreno,1974-05-23,40441389Y,jorge.moreno@superapp.digital,216601,ES46209505951516573022,5874.73,2023-03-01T02:50:04,Galdakao,expenses,leisure,-21.74,-35265.69
buyer_4,Jorge,Moreno,1974-05-23,40441389Y,jorge.moreno@superapp.digital,216601,ES46209505951516573022,5874.73,2023-03-01T08:57:24,Galdakao,expenses,education,-50.72,-35316.41
buyer_4,Jorge,Moreno,1974-05-23,40441389Y,jorge.moreno@superapp.digital,216601,ES46209505951516573022,5874.73,2023-03-02T14:10:06,Galdakao,expenses,clothing,-112.77,-35429.18
buyer_4,Jorge,Moreno,1974-05-23,40441389Y,jorge.moreno@superapp.digital,216601,ES46209505951516573022,5874.73,2023-03-02T21:53:27,Galdakao,expenses,children,-722.0282500000004,-36151.21
buyer_4,Jorge,Moreno,1974-05-23,40441389Y,jorge.moreno@superapp.digital,216601,ES46209505951516573022,5874.73,2023-03-04T11:20:05,Galdakao,expenses,mortgage,-1154.88,-37306.09
buyer_4,Jorge,Moreno,1974-05-23,40441389Y,jorge.moreno@superapp.digital,216601,ES46209505951516573022,5874.73,2023-03-05T14:29:24,Galdakao,expenses,water,-28.19,-37334.28
buyer_4,Jorge,Moreno,1974-05-23,40441389Y,jorge.moreno@superapp.digital,216601,ES46209505951516573022,5874.73,2023-03-05T11:58:02,Galdakao,expenses,electricity,-40.56,-37374.84
buyer_4,Jorge,Moreno,1974-05-23,40441389Y,jorge.moreno@superapp.digital,216601,ES46209505951516573022,5874.73,2023-03-05T12:15:33,Galdakao,expenses,phone,-51.53,-37426.37
buyer_4,Jorge,Moreno,1974-05-23,40441389Y,jorge.moreno@superapp.digital,216601,ES46209505951516573022,5874.73,2023-03-05T16:24:59,Galdakao,expenses,food,-107.81,-37534.18
buyer_4,Jorge,Moreno,1974-05-23,40441389Y,jorge.moreno@superapp.digital,216601,ES46209505951516573022,5874.73,2023-03-07T18:17:12,Galdakao,expenses,water,-49.83,-37584.01
buyer_4,Jorge,Moreno,1974-05-23,40441389Y,jorge.moreno@superapp.digital,216601,ES46209505951516573022,5874.73,2023-03-07T12:33:32,Galdakao,expenses,electricity,-72.64,-37656.65
buyer_4,Jorge,Moreno,1974-05-23,40441389Y,jorge.moreno@superapp.digital,216601,ES46209505951516573022,5874.73,2023-03-07T08:45:49,Galdakao,expenses,cash,-100.0,-37756.65
buyer_4,Jorge,Moreno,1974-05-23,40441389Y,jorge.moreno@superapp.digital,216601,ES46209505951516573022,5874.73,2023-03-08T20:53:18,Galdakao,expenses,water,-26.14,-37782.79
buyer_4,Jorge,Moreno,1974-05-23,40441389Y,jorge.moreno@superapp.digital,216601,ES46209505951516573022,5874.73,2023-03-08T20:08:19,Galdakao,expenses,electricity,-72.51,-37855.3
buyer_4,Jorge,Moreno,1974-05-23,40441389Y,jorge.moreno@superapp.digital,216601,ES46209505951516573022,5874.73,2023-03-08T11:40:21,Galdakao,expenses,cash,-100.0,-37955.3
buyer_4,Jorge,Moreno,1974-05-23,40441389Y,jorge.moreno@superapp.digital,216601,ES46209505951516573022,5874.73,2023-03-10T08:36:08,Galdakao,expenses,repairs,-271.13,-38226.43
buyer_4,Jorge,Moreno,1974-05-23,40441389Y,jorge.moreno@superapp.digital,216601,ES46209505951516573022,5874.73,2023-03-11T17:32:57,Galdakao,expenses,transport,-88.81,-38315.24
buyer_4,Jorge,Moreno,1974-05-23,40441389Y,jorge.moreno@superapp.digital,216601,ES46209505951516573022,5874.73,2023-03-11T11:18:04,Galdakao,expenses,education,-50.22,-38365.46
buyer_4,Jorge,Moreno,1974-05-23,40441389Y,jorge.moreno@superapp.digital,216601,ES46209505951516573022,5874.73,2023-03-12T13:59:22,Galdakao,expenses,transport,-78.73,-38444.19
buyer_4,Jorge,Moreno,1974-05-23,40441389Y,jorge.moreno@superapp.digital,216601,ES46209505951516573022,5874.73,2023-03-13T03:08:41,Galdakao,expenses,leisure,-49.74,-38493.93
buyer_4,Jorge,Moreno,1974-05-23,40441389Y,jorge.moreno@superapp.digital,216601,ES46209505951516573022,5874.73,2023-03-13T20:38:29,Galdakao,expenses,cash,-100.0,-38593.93
buyer_4,Jorge,Moreno,1974-05-23,40441389Y,jorge.moreno@superapp.digital,216601,ES46209505951516573022,5874.73,2023-03-14T14:52:53,Galdakao,expenses,repairs,-60.85,-38654.78
buyer_4,Jorge,Moreno,1974-05-23,40441389Y,jorge.moreno@superapp.digital,216601,ES46209505951516573022,5874.73,2023-03-17T02:33:48,Galdakao,expenses,clothing,-142.87,-38797.65
buyer_4,Jorge,Moreno,1974-05-23,40441389Y,jorge.moreno@superapp.digital,216601,ES46209505951516573022,5874.73,2023-03-17T12:40:58,Galdakao,expenses,gifts,-170.34,-38967.99
buyer_4,Jorge,Moreno,1974-05-23,40441389Y,jorge.moreno@superapp.digital,216601,ES46209505951516573022,5874.73,2023-03-18T10:03:28,Galdakao,expenses,clothing,-92.66,-39060.65
buyer_4,Jorge,Moreno,1974-05-23,40441389Y,jorge.moreno@superapp.digital,216601,ES46209505951516573022,5874.73,2023-03-18T22:24:31,Galdakao,expenses,healthcare,-142.67,-39203.32
buyer_4,Jorge,Moreno,1974-05-23,40441389Y,jorge.moreno@superapp.digital,216601,ES46209505951516573022,5874.73,2023-03-24T16:22:28,Galdakao,expenses,food,-68.34,-39271.66
buyer_4,Jorge,Moreno,1974-05-23,40441389Y,jorge.moreno@superapp.digital,216601,ES46209505951516573022,5874.73,2023-03-24T19:19:21,Galdakao,expenses,clothing,-154.57,-39426.23
buyer_4,Jorge,Moreno,1974-05-23,40441389Y,jorge.moreno@superapp.digital,216601,ES46209505951516573022,5874.73,2023-03-25T15:02:09,Galdakao,expenses,leisure,-75.74,-39501.97
buyer_4,Jorge,Moreno,1974-05-23,40441389Y,jorge.moreno@superapp.digital,216601,ES46209505951516573022,5874.73,2023-03-26T11:51:43,Galdakao,expenses,healthcare,-51.88,-39553.85
buyer_4,Jorge,Moreno,1974-05-23,40441389Y,jorge.moreno@superapp.digital,216601,ES46209505951516573022,5874.73,2023-03-26T21:06:28,Galdakao,expenses,cash,-100.0,-39653.85
buyer_4,Jorge,Moreno,1974-05-23,40441389Y,jorge.moreno@superapp.digital,216601,ES46209505951516573022,5874.73,2023-03-28T11:37:49,Galdakao,expenses,food,-110.53,-39764.38
buyer_4,Jorge,Moreno,1974-05-23,40441389Y,jorge.moreno@superapp.digital,216601,ES46209505951516573022,5874.73,2023-03-28T11:03:36,Galdakao,expenses,gifts,-303.14,-40067.52
buyer_4,Jorge,Moreno,1974-05-23,40441389Y,jorge.moreno@superapp.digital,216601,ES46209505951516573022,5874.73,2023-03-29T12:26:18,Galdakao,expenses,children,-834.7982500000004,-40902.32
buyer_4,Jorge,Moreno,1974-05-23,40441389Y,jorge.moreno@superapp.digital,216601,ES46209505951516573022,5874.73,2023-03-31T11:43:52,Galdakao,expenses,food,-84.7,-40987.02
buyer_4,Jorge,Moreno,1974-05-23,40441389Y,jorge.moreno@superapp.digital,216601,ES46209505951516573022,5874.73,2023-04-01T17:18:29,Galdakao,incomes,salary,2466.94,-38520.08
buyer_4,Jorge,Moreno,1974-05-23,40441389Y,jorge.moreno@superapp.digital,216601,ES46209505951516573022,5874.73,2023-04-01T18:16:57,Galdakao,expenses,leisure,-36.15,-38556.23
buyer_4,Jorge,Moreno,1974-05-23,40441389Y,jorge.moreno@superapp.digital,216601,ES46209505951516573022,5874.73,2023-04-01T10:59:52,Galdakao,expenses,repairs,-290.69,-38846.92
buyer_4,Jorge,Moreno,1974-05-23,40441389Y,jorge.moreno@superapp.digital,216601,ES46209505951516573022,5874.73,2023-04-02T20:25:00,Galdakao,expenses,food,-70.35,-38917.27
buyer_4,Jorge,Moreno,1974-05-23,40441389Y,jorge.moreno@superapp.digital,216601,ES46209505951516573022,5874.73,2023-04-04T17:59:42,Galdakao,expenses,mortgage,-1154.88,-40072.15
buyer_4,Jorge,Moreno,1974-05-23,40441389Y,jorge.moreno@superapp.digital,216601,ES46209505951516573022,5874.73,2023-04-04T05:27:59,Galdakao,expenses,food,-77.39,-40149.54
buyer_4,Jorge,Moreno,1974-05-23,40441389Y,jorge.moreno@superapp.digital,216601,ES46209505951516573022,5874.73,2023-04-05T02:12:47,Galdakao,expenses,water,-36.52,-40186.06
buyer_4,Jorge,Moreno,1974-05-23,40441389Y,jorge.moreno@superapp.digital,216601,ES46209505951516573022,5874.73,2023-04-05T20:36:31,Galdakao,expenses,gas,-74.84,-40260.9
buyer_4,Jorge,Moreno,1974-05-23,40441389Y,jorge.moreno@superapp.digital,216601,ES46209505951516573022,5874.73,2023-04-05T20:41:08,Galdakao,expenses,internet,-51.81,-40312.71
buyer_4,Jorge,Moreno,1974-05-23,40441389Y,jorge.moreno@superapp.digital,216601,ES46209505951516573022,5874.73,2023-04-05T12:06:27,Galdakao,expenses,food,-67.16,-40379.87
buyer_4,Jorge,Moreno,1974-05-23,40441389Y,jorge.moreno@superapp.digital,216601,ES46209505951516573022,5874.73,2023-04-05T20:12:28,Galdakao,expenses,cash,-100.0,-40479.87
buyer_4,Jorge,Moreno,1974-05-23,40441389Y,jorge.moreno@superapp.digital,216601,ES46209505951516573022,5874.73,2023-04-07T07:45:00,Galdakao,expenses,electricity,-97.01,-40576.88
buyer_4,Jorge,Moreno,1974-05-23,40441389Y,jorge.moreno@superapp.digital,216601,ES46209505951516573022,5874.73,2023-04-07T22:53:25,Galdakao,expenses,gas,-135.05,-40711.93
buyer_4,Jorge,Moreno,1974-05-23,40441389Y,jorge.moreno@superapp.digital,216601,ES46209505951516573022,5874.73,2023-04-07T17:22:28,Galdakao,expenses,clothing,-112.42,-40824.35
buyer_4,Jorge,Moreno,1974-05-23,40441389Y,jorge.moreno@superapp.digital,216601,ES46209505951516573022,5874.73,2023-04-07T10:16:10,Galdakao,expenses,gifts,-541.06,-41365.41
buyer_4,Jorge,Moreno,1974-05-23,40441389Y,jorge.moreno@superapp.digital,216601,ES46209505951516573022,5874.73,2023-04-08T14:39:44,Galdakao,expenses,electricity,-98.88,-41464.29
buyer_4,Jorge,Moreno,1974-05-23,40441389Y,jorge.moreno@superapp.digital,216601,ES46209505951516573022,5874.73,2023-04-08T09:50:16,Galdakao,expenses,leisure,-71.29,-41535.58
buyer_4,Jorge,Moreno,1974-05-23,40441389Y,jorge.moreno@superapp.digital,216601,ES46209505951516573022,5874.73,2023-04-08T21:35:33,Galdakao,expenses,education,-47.84,-41583.42
buyer_4,Jorge,Moreno,1974-05-23,40441389Y,jorge.moreno@superapp.digital,216601,ES46209505951516573022,5874.73,2023-04-11T20:24:03,Galdakao,expenses,repairs,-94.47,-41677.89
buyer_4,Jorge,Moreno,1974-05-23,40441389Y,jorge.moreno@superapp.digital,216601,ES46209505951516573022,5874.73,2023-04-11T10:49:28,Galdakao,expenses,gifts,-309.9,-41987.79
buyer_4,Jorge,Moreno,1974-05-23,40441389Y,jorge.moreno@superapp.digital,216601,ES46209505951516573022,5874.73,2023-04-12T09:13:47,Galdakao,expenses,food,-117.82,-42105.61
buyer_4,Jorge,Moreno,1974-05-23,40441389Y,jorge.moreno@superapp.digital,216601,ES46209505951516573022,5874.73,2023-04-14T20:39:55,Galdakao,expenses,leisure,-22.04,-42127.65
buyer_4,Jorge,Moreno,1974-05-23,40441389Y,jorge.moreno@superapp.digital,216601,ES46209505951516573022,5874.73,2023-04-16T16:51:43,Galdakao,expenses,leisure,-78.38,-42206.03
buyer_4,Jorge,Moreno,1974-05-23,40441389Y,jorge.moreno@superapp.digital,216601,ES46209505951516573022,5874.73,2023-04-17T13:30:35,Galdakao,expenses,leisure,-34.85,-42240.88
buyer_4,Jorge,Moreno,1974-05-23,40441389Y,jorge.moreno@superapp.digital,216601,ES46209505951516573022,5874.73,2023-04-17T12:27:40,Galdakao,expenses,gifts,-374.51,-42615.39
buyer_4,Jorge,Moreno,1974-05-23,40441389Y,jorge.moreno@superapp.digital,216601,ES46209505951516573022,5874.73,2023-04-18T16:39:44,Galdakao,expenses,cash,-100.0,-42715.39
buyer_4,Jorge,Moreno,1974-05-23,40441389Y,jorge.moreno@superapp.digital,216601,ES46209505951516573022,5874.73,2023-04-20T17:07:06,Galdakao,expenses,education,-44.64,-42760.03
buyer_4,Jorge,Moreno,1974-05-23,40441389Y,jorge.moreno@superapp.digital,216601,ES46209505951516573022,5874.73,2023-04-21T21:22:13,Galdakao,expenses,transport,-69.13,-42829.16
buyer_4,Jorge,Moreno,1974-05-23,40441389Y,jorge.moreno@superapp.digital,216601,ES46209505951516573022,5874.73,2023-04-22T13:26:21,Galdakao,expenses,leisure,-42.96,-42872.12
buyer_4,Jorge,Moreno,1974-05-23,40441389Y,jorge.moreno@superapp.digital,216601,ES46209505951516573022,5874.73,2023-04-22T08:57:57,Galdakao,expenses,appliances,-315.9,-43188.02
buyer_4,Jorge,Moreno,1974-05-23,40441389Y,jorge.moreno@superapp.digital,216601,ES46209505951516573022,5874.73,2023-04-23T21:19:51,Galdakao,expenses,leisure,-71.01,-43259.03
buyer_4,Jorge,Moreno,1974-05-23,40441389Y,jorge.moreno@superapp.digital,216601,ES46209505951516573022,5874.73,2023-04-25T05:25:22,Galdakao,expenses,healthcare,-189.39,-43448.42
buyer_4,Jorge,Moreno,1974-05-23,40441389Y,jorge.moreno@superapp.digital,216601,ES46209505951516573022,5874.73,2023-04-25T13:37:25,Galdakao,expenses,education,-67.12,-43515.54
buyer_4,Jorge,Moreno,1974-05-23,40441389Y,jorge.moreno@superapp.digital,216601,ES46209505951516573022,5874.73,2023-04-26T10:04:09,Galdakao,expenses,food,-92.13,-43607.67
buyer_4,Jorge,Moreno,1974-05-23,40441389Y,jorge.moreno@superapp.digital,216601,ES46209505951516573022,5874.73,2023-04-27T15:11:56,Galdakao,expenses,cash,-100.0,-43707.67
buyer_4,Jorge,Moreno,1974-05-23,40441389Y,jorge.moreno@superapp.digital,216601,ES46209505951516573022,5874.73,2023-04-27T09:43:18,Galdakao,expenses,gifts,-318.61,-44026.28
buyer_4,Jorge,Moreno,1974-05-23,40441389Y,jorge.moreno@superapp.digital,216601,ES46209505951516573022,5874.73,2023-05-01T10:45:23,Galdakao,incomes,salary,2466.94,-41559.34
buyer_4,Jorge,Moreno,1974-05-23,40441389Y,jorge.moreno@superapp.digital,216601,ES46209505951516573022,5874.73,2023-05-01T10:48:03,Galdakao,expenses,clothing,-96.92,-41656.26
buyer_4,Jorge,Moreno,1974-05-23,40441389Y,jorge.moreno@superapp.digital,216601,ES46209505951516573022,5874.73,2023-05-02T17:02:27,Galdakao,expenses,clothing,-126.06,-41782.32
buyer_4,Jorge,Moreno,1974-05-23,40441389Y,jorge.moreno@superapp.digital,216601,ES46209505951516573022,5874.73,2023-05-03T18:27:29,Galdakao,expenses,transport,-80.38,-41862.7
buyer_4,Jorge,Moreno,1974-05-23,40441389Y,jorge.moreno@superapp.digital,216601,ES46209505951516573022,5874.73,2023-05-04T11:40:59,Galdakao,expenses,mortgage,-1154.88,-43017.58
buyer_4,Jorge,Moreno,1974-05-23,40441389Y,jorge.moreno@superapp.digital,216601,ES46209505951516573022,5874.73,2023-05-04T08:58:28,Galdakao,expenses,clothing,-112.65,-43130.23
buyer_4,Jorge,Moreno,1974-05-23,40441389Y,jorge.moreno@superapp.digital,216601,ES46209505951516573022,5874.73,2023-05-05T09:31:57,Galdakao,expenses,phone,-51.33,-43181.56
buyer_4,Jorge,Moreno,1974-05-23,40441389Y,jorge.moreno@superapp.digital,216601,ES46209505951516573022,5874.73,2023-05-05T18:52:18,Galdakao,expenses,food,-100.98,-43282.54
buyer_4,Jorge,Moreno,1974-05-23,40441389Y,jorge.moreno@superapp.digital,216601,ES46209505951516573022,5874.73,2023-05-06T23:16:06,Galdakao,expenses,gas,-58.89,-43341.43
buyer_4,Jorge,Moreno,1974-05-23,40441389Y,jorge.moreno@superapp.digital,216601,ES46209505951516573022,5874.73,2023-05-07T11:33:34,Galdakao,expenses,gas,-48.7,-43390.13
buyer_4,Jorge,Moreno,1974-05-23,40441389Y,jorge.moreno@superapp.digital,216601,ES46209505951516573022,5874.73,2023-05-07T23:15:29,Galdakao,expenses,internet,-51.81,-43441.94
buyer_4,Jorge,Moreno,1974-05-23,40441389Y,jorge.moreno@superapp.digital,216601,ES46209505951516573022,5874.73,2023-05-07T13:23:50,Galdakao,expenses,gifts,-68.53,-43510.47
buyer_4,Jorge,Moreno,1974-05-23,40441389Y,jorge.moreno@superapp.digital,216601,ES46209505951516573022,5874.73,2023-05-10T18:19:08,Galdakao,expenses,leisure,-27.78,-43538.25
buyer_4,Jorge,Moreno,1974-05-23,40441389Y,jorge.moreno@superapp.digital,216601,ES46209505951516573022,5874.73,2023-05-11T07:33:44,Galdakao,expenses,clothing,-66.96,-43605.21
buyer_4,Jorge,Moreno,1974-05-23,40441389Y,jorge.moreno@superapp.digital,216601,ES46209505951516573022,5874.73,2023-05-11T12:45:25,Galdakao,expenses,cash,-100.0,-43705.21
buyer_4,Jorge,Moreno,1974-05-23,40441389Y,jorge.moreno@superapp.digital,216601,ES46209505951516573022,5874.73,2023-05-12T19:26:44,Galdakao,expenses,clothing,-159.17,-43864.38
buyer_4,Jorge,Moreno,1974-05-23,40441389Y,jorge.moreno@superapp.digital,216601,ES46209505951516573022,5874.73,2023-05-13T19:15:39,Galdakao,expenses,cash,-100.0,-43964.38
buyer_4,Jorge,Moreno,1974-05-23,40441389Y,jorge.moreno@superapp.digital,216601,ES46209505951516573022,5874.73,2023-05-14T17:29:46,Galdakao,expenses,repairs,-185.88,-44150.26
buyer_4,Jorge,Moreno,1974-05-23,40441389Y,jorge.moreno@superapp.digital,216601,ES46209505951516573022,5874.73,2023-05-15T14:36:14,Galdakao,expenses,transport,-40.73,-44190.99
buyer_4,Jorge,Moreno,1974-05-23,40441389Y,jorge.moreno@superapp.digital,216601,ES46209505951516573022,5874.73,2023-05-16T16:28:09,Galdakao,expenses,food,-104.69,-44295.68
buyer_4,Jorge,Moreno,1974-05-23,40441389Y,jorge.moreno@superapp.digital,216601,ES46209505951516573022,5874.73,2023-05-16T15:15:19,Galdakao,expenses,gifts,-269.97,-44565.65
buyer_4,Jorge,Moreno,1974-05-23,40441389Y,jorge.moreno@superapp.digital,216601,ES46209505951516573022,5874.73,2023-05-17T01:06:37,Galdakao,expenses,transport,-86.1,-44651.75
buyer_4,Jorge,Moreno,1974-05-23,40441389Y,jorge.moreno@superapp.digital,216601,ES46209505951516573022,5874.73,2023-05-17T13:15:57,Galdakao,expenses,cash,-100.0,-44751.75
buyer_4,Jorge,Moreno,1974-05-23,40441389Y,jorge.moreno@superapp.digital,216601,ES46209505951516573022,5874.73,2023-05-17T09:00:21,Galdakao,expenses,travel,-555.54,-45307.29
buyer_4,Jorge,Moreno,1974-05-23,40441389Y,jorge.moreno@superapp.digital,216601,ES46209505951516573022,5874.73,2023-05-19T10:12:43,Galdakao,expenses,leisure,-56.59,-45363.88
buyer_4,Jorge,Moreno,1974-05-23,40441389Y,jorge.moreno@superapp.digital,216601,ES46209505951516573022,5874.73,2023-05-23T16:11:35,Galdakao,expenses,food,-94.31,-45458.19
buyer_4,Jorge,Moreno,1974-05-23,40441389Y,jorge.moreno@superapp.digital,216601,ES46209505951516573022,5874.73,2023-05-23T19:08:28,Galdakao,expenses,cash,-100.0,-45558.19
buyer_4,Jorge,Moreno,1974-05-23,40441389Y,jorge.moreno@superapp.digital,216601,ES46209505951516573022,5874.73,2023-05-25T12:23:59,Galdakao,expenses,gifts,-367.59,-45925.78
buyer_4,Jorge,Moreno,1974-05-23,40441389Y,jorge.moreno@superapp.digital,216601,ES46209505951516573022,5874.73,2023-05-26T12:28:30,Galdakao,expenses,food,-100.93,-46026.71
buyer_4,Jorge,Moreno,1974-05-23,40441389Y,jorge.moreno@superapp.digital,216601,ES46209505951516573022,5874.73,2023-05-27T18:27:40,Galdakao,expenses,gifts,-704.82,-46731.53
buyer_4,Jorge,Moreno,1974-05-23,40441389Y,jorge.moreno@superapp.digital,216601,ES46209505951516573022,5874.73,2023-05-31T09:34:15,Galdakao,expenses,gifts,-368.06,-47099.59
buyer_4,Jorge,Moreno,1974-05-23,40441389Y,jorge.moreno@superapp.digital,216601,ES46209505951516573022,5874.73,2023-06-01T14:36:44,Galdakao,incomes,salary,2466.94,-44632.65
buyer_4,Jorge,Moreno,1974-05-23,40441389Y,jorge.moreno@superapp.digital,216601,ES46209505951516573022,5874.73,2023-06-01T14:36:44,Galdakao,incomes,extra_income,385.48,-44247.17
buyer_4,Jorge,Moreno,1974-05-23,40441389Y,jorge.moreno@superapp.digital,216601,ES46209505951516573022,5874.73,2023-06-01T14:36:44,Galdakao,incomes,salary_bonus,1906.57,-42340.6
buyer_4,Jorge,Moreno,1974-05-23,40441389Y,jorge.moreno@superapp.digital,216601,ES46209505951516573022,5874.73,2023-06-01T06:33:28,Galdakao,expenses,taxes,-2101.53,-44442.13
buyer_4,Jorge,Moreno,1974-05-23,40441389Y,jorge.moreno@superapp.digital,216601,ES46209505951516573022,5874.73,2023-06-01T19:52:19,Galdakao,expenses,insurance,-482.89,-44925.02
buyer_4,Jorge,Moreno,1974-05-23,40441389Y,jorge.moreno@superapp.digital,216601,ES46209505951516573022,5874.73,2023-06-01T18:34:11,Galdakao,expenses,food,-85.53,-45010.55
buyer_4,Jorge,Moreno,1974-05-23,40441389Y,jorge.moreno@superapp.digital,216601,ES46209505951516573022,5874.73,2023-06-01T08:34:03,Galdakao,expenses,leisure,-36.95,-45047.5
buyer_4,Jorge,Moreno,1974-05-23,40441389Y,jorge.moreno@superapp.digital,216601,ES46209505951516573022,5874.73,2023-06-03T18:43:35,Galdakao,expenses,leisure,-43.28,-45090.78
buyer_4,Jorge,Moreno,1974-05-23,40441389Y,jorge.moreno@superapp.digital,216601,ES46209505951516573022,5874.73,2023-06-04T14:34:58,Galdakao,expenses,mortgage,-1154.88,-46245.66
buyer_4,Jorge,Moreno,1974-05-23,40441389Y,jorge.moreno@superapp.digital,216601,ES46209505951516573022,5874.73,2023-06-05T13:44:11,Galdakao,expenses,water,-53.25,-46298.91
buyer_4,Jorge,Moreno,1974-05-23,40441389Y,jorge.moreno@superapp.digital,216601,ES46209505951516573022,5874.73,2023-06-05T15:16:23,Galdakao,expenses,internet,-51.81,-46350.72
buyer_4,Jorge,Moreno,1974-05-23,40441389Y,jorge.moreno@superapp.digital,216601,ES46209505951516573022,5874.73,2023-06-05T19:33:56,Galdakao,expenses,healthcare,-175.44,-46526.16
buyer_4,Jorge,Moreno,1974-05-23,40441389Y,jorge.moreno@superapp.digital,216601,ES46209505951516573022,5874.73,2023-06-05T09:41:39,Galdakao,expenses,education,-61.76,-46587.92
buyer_4,Jorge,Moreno,1974-05-23,40441389Y,jorge.moreno@superapp.digital,216601,ES46209505951516573022,5874.73,2023-06-06T12:30:01,Galdakao,expenses,water,-50.12,-46638.04
buyer_4,Jorge,Moreno,1974-05-23,40441389Y,jorge.moreno@superapp.digital,216601,ES46209505951516573022,5874.73,2023-06-06T07:28:34,Galdakao,expenses,gas,-56.34,-46694.38
buyer_4,Jorge,Moreno,1974-05-23,40441389Y,jorge.moreno@superapp.digital,216601,ES46209505951516573022,5874.73,2023-06-06T15:12:09,Galdakao,expenses,clothing,-142.58,-46836.96
buyer_4,Jorge,Moreno,1974-05-23,40441389Y,jorge.moreno@superapp.digital,216601,ES46209505951516573022,5874.73,2023-06-07T15:41:31,Galdakao,expenses,internet,-51.81,-46888.77
buyer_4,Jorge,Moreno,1974-05-23,40441389Y,jorge.moreno@superapp.digital,216601,ES46209505951516573022,5874.73,2023-06-08T19:01:43,Galdakao,expenses,water,-25.61,-46914.38
buyer_4,Jorge,Moreno,1974-05-23,40441389Y,jorge.moreno@superapp.digital,216601,ES46209505951516573022,5874.73,2023-06-08T14:37:31,Galdakao,expenses,food,-65.06,-46979.44
buyer_4,Jorge,Moreno,1974-05-23,40441389Y,jorge.moreno@superapp.digital,216601,ES46209505951516573022,5874.73,2023-06-09T04:26:12,Galdakao,expenses,food,-65.44,-47044.88
buyer_4,Jorge,Moreno,1974-05-23,40441389Y,jorge.moreno@superapp.digital,216601,ES46209505951516573022,5874.73,2023-06-10T14:18:59,Galdakao,expenses,food,-72.65,-47117.53
buyer_4,Jorge,Moreno,1974-05-23,40441389Y,jorge.moreno@superapp.digital,216601,ES46209505951516573022,5874.73,2023-06-11T17:54:52,Galdakao,expenses,transport,-52.78,-47170.31
buyer_4,Jorge,Moreno,1974-05-23,40441389Y,jorge.moreno@superapp.digital,216601,ES46209505951516573022,5874.73,2023-06-11T16:26:02,Galdakao,expenses,cash,-100.0,-47270.31
buyer_4,Jorge,Moreno,1974-05-23,40441389Y,jorge.moreno@superapp.digital,216601,ES46209505951516573022,5874.73,2023-06-11T00:09:42,Galdakao,expenses,gifts,-225.57,-47495.88
buyer_4,Jorge,Moreno,1974-05-23,40441389Y,jorge.moreno@superapp.digital,216601,ES46209505951516573022,5874.73,2023-06-16T10:40:59,Galdakao,expenses,leisure,-54.56,-47550.44
buyer_4,Jorge,Moreno,1974-05-23,40441389Y,jorge.moreno@superapp.digital,216601,ES46209505951516573022,5874.73,2023-06-17T14:23:00,Galdakao,expenses,food,-122.75,-47673.19
buyer_4,Jorge,Moreno,1974-05-23,40441389Y,jorge.moreno@superapp.digital,216601,ES46209505951516573022,5874.73,2023-06-17T14:18:39,Galdakao,expenses,transport,-60.38,-47733.57
buyer_4,Jorge,Moreno,1974-05-23,40441389Y,jorge.moreno@superapp.digital,216601,ES46209505951516573022,5874.73,2023-06-17T15:52:00,Galdakao,expenses,leisure,-74.0,-47807.57
buyer_4,Jorge,Moreno,1974-05-23,40441389Y,jorge.moreno@superapp.digital,216601,ES46209505951516573022,5874.73,2023-06-18T12:29:43,Galdakao,expenses,cash,-100.0,-47907.57
buyer_4,Jorge,Moreno,1974-05-23,40441389Y,jorge.moreno@superapp.digital,216601,ES46209505951516573022,5874.73,2023-06-20T17:03:26,Galdakao,expenses,clothing,-141.9,-48049.47
buyer_4,Jorge,Moreno,1974-05-23,40441389Y,jorge.moreno@superapp.digital,216601,ES46209505951516573022,5874.73,2023-06-20T11:29:09,Galdakao,expenses,gifts,-176.81,-48226.28
buyer_4,Jorge,Moreno,1974-05-23,40441389Y,jorge.moreno@superapp.digital,216601,ES46209505951516573022,5874.73,2023-06-21T11:38:52,Galdakao,expenses,cash,-100.0,-48326.28
buyer_4,Jorge,Moreno,1974-05-23,40441389Y,jorge.moreno@superapp.digital,216601,ES46209505951516573022,5874.73,2023-06-21T03:00:46,Galdakao,expenses,gifts,-403.18,-48729.46
buyer_4,Jorge,Moreno,1974-05-23,40441389Y,jorge.moreno@superapp.digital,216601,ES46209505951516573022,5874.73,2023-06-24T09:04:49,Galdakao,expenses,cash,-100.0,-48829.46
buyer_4,Jorge,Moreno,1974-05-23,40441389Y,jorge.moreno@superapp.digital,216601,ES46209505951516573022,5874.73,2023-06-26T09:42:00,Galdakao,expenses,transport,-86.59,-48916.05
buyer_4,Jorge,Moreno,1974-05-23,40441389Y,jorge.moreno@superapp.digital,216601,ES46209505951516573022,5874.73,2023-06-26T19:20:16,Galdakao,expenses,leisure,-42.56,-48958.61
buyer_4,Jorge,Moreno,1974-05-23,40441389Y,jorge.moreno@superapp.digital,216601,ES46209505951516573022,5874.73,2023-06-27T08:55:24,Galdakao,expenses,cash,-100.0,-49058.61
buyer_4,Jorge,Moreno,1974-05-23,40441389Y,jorge.moreno@superapp.digital,216601,ES46209505951516573022,5874.73,2023-06-28T14:54:37,Galdakao,expenses,leisure,-35.34,-49093.95
buyer_4,Jorge,Moreno,1974-05-23,40441389Y,jorge.moreno@superapp.digital,216601,ES46209505951516573022,5874.73,2023-06-29T16:40:45,Galdakao,expenses,cash,-100.0,-49193.95
buyer_4,Jorge,Moreno,1974-05-23,40441389Y,jorge.moreno@superapp.digital,216601,ES46209505951516573022,5874.73,2023-07-01T19:29:46,Galdakao,incomes,salary,2466.94,-46727.01
buyer_4,Jorge,Moreno,1974-05-23,40441389Y,jorge.moreno@superapp.digital,216601,ES46209505951516573022,5874.73,2023-07-01T12:51:59,Galdakao,expenses,education,-72.86,-46799.87
buyer_4,Jorge,Moreno,1974-05-23,40441389Y,jorge.moreno@superapp.digital,216601,ES46209505951516573022,5874.73,2023-07-03T16:05:03,Galdakao,expenses,food,-88.14,-46888.01
buyer_4,Jorge,Moreno,1974-05-23,40441389Y,jorge.moreno@superapp.digital,216601,ES46209505951516573022,5874.73,2023-07-04T09:38:03,Galdakao,expenses,mortgage,-1154.88,-48042.89
buyer_4,Jorge,Moreno,1974-05-23,40441389Y,jorge.moreno@superapp.digital,216601,ES46209505951516573022,5874.73,2023-07-05T22:53:59,Galdakao,expenses,internet,-51.81,-48094.7
buyer_4,Jorge,Moreno,1974-05-23,40441389Y,jorge.moreno@superapp.digital,216601,ES46209505951516573022,5874.73,2023-07-05T09:42:14,Galdakao,expenses,appliances,-85.12,-48179.82
buyer_4,Jorge,Moreno,1974-05-23,40441389Y,jorge.moreno@superapp.digital,216601,ES46209505951516573022,5874.73,2023-07-06T17:11:13,Galdakao,expenses,water,-43.19,-48223.01
buyer_4,Jorge,Moreno,1974-05-23,40441389Y,jorge.moreno@superapp.digital,216601,ES46209505951516573022,5874.73,2023-07-06T14:40:23,Galdakao,expenses,transport,-47.35,-48270.36
buyer_4,Jorge,Moreno,1974-05-23,40441389Y,jorge.moreno@superapp.digital,216601,ES46209505951516573022,5874.73,2023-07-06T09:42:36,Galdakao,expenses,leisure,-65.28,-48335.64
buyer_4,Jorge,Moreno,1974-05-23,40441389Y,jorge.moreno@superapp.digital,216601,ES46209505951516573022,5874.73,2023-07-07T11:57:50,Galdakao,expenses,electricity,-41.65,-48377.29
buyer_4,Jorge,Moreno,1974-05-23,40441389Y,jorge.moreno@superapp.digital,216601,ES46209505951516573022,5874.73,2023-07-07T12:51:05,Galdakao,expenses,gas,-68.25,-48445.54
buyer_4,Jorge,Moreno,1974-05-23,40441389Y,jorge.moreno@superapp.digital,216601,ES46209505951516573022,5874.73,2023-07-07T13:30:20,Galdakao,expenses,phone,-37.46,-48483.0
buyer_4,Jorge,Moreno,1974-05-23,40441389Y,jorge.moreno@superapp.digital,216601,ES46209505951516573022,5874.73,2023-07-09T01:14:22,Galdakao,expenses,repairs,-198.77,-48681.77
buyer_4,Jorge,Moreno,1974-05-23,40441389Y,jorge.moreno@superapp.digital,216601,ES46209505951516573022,5874.73,2023-07-10T15:39:24,Galdakao,expenses,education,-65.53,-48747.3
buyer_4,Jorge,Moreno,1974-05-23,40441389Y,jorge.moreno@superapp.digital,216601,ES46209505951516573022,5874.73,2023-07-11T07:31:51,Galdakao,expenses,food,-101.87,-48849.17
buyer_4,Jorge,Moreno,1974-05-23,40441389Y,jorge.moreno@superapp.digital,216601,ES46209505951516573022,5874.73,2023-07-11T13:48:19,Galdakao,expenses,transport,-62.27,-48911.44
buyer_4,Jorge,Moreno,1974-05-23,40441389Y,jorge.moreno@superapp.digital,216601,ES46209505951516573022,5874.73,2023-07-16T16:33:42,Galdakao,expenses,cash,-100.0,-49011.44
buyer_4,Jorge,Moreno,1974-05-23,40441389Y,jorge.moreno@superapp.digital,216601,ES46209505951516573022,5874.73,2023-07-18T08:43:59,Galdakao,expenses,food,-99.94,-49111.38
buyer_4,Jorge,Moreno,1974-05-23,40441389Y,jorge.moreno@superapp.digital,216601,ES46209505951516573022,5874.73,2023-07-18T14:12:46,Galdakao,expenses,repairs,-176.7,-49288.08
buyer_4,Jorge,Moreno,1974-05-23,40441389Y,jorge.moreno@superapp.digital,216601,ES46209505951516573022,5874.73,2023-07-18T14:17:42,Galdakao,expenses,gifts,-523.56,-49811.64
buyer_4,Jorge,Moreno,1974-05-23,40441389Y,jorge.moreno@superapp.digital,216601,ES46209505951516573022,5874.73,2023-07-19T17:01:06,Galdakao,expenses,transport,-61.4,-49873.04
buyer_4,Jorge,Moreno,1974-05-23,40441389Y,jorge.moreno@superapp.digital,216601,ES46209505951516573022,5874.73,2023-07-20T09:19:02,Galdakao,expenses,transport,-61.54,-49934.58
buyer_4,Jorge,Moreno,1974-05-23,40441389Y,jorge.moreno@superapp.digital,216601,ES46209505951516573022,5874.73,2023-07-20T16:37:16,Galdakao,expenses,cash,-100.0,-50034.58
buyer_4,Jorge,Moreno,1974-05-23,40441389Y,jorge.moreno@superapp.digital,216601,ES46209505951516573022,5874.73,2023-07-21T18:10:38,Galdakao,expenses,leisure,-46.24,-50080.82
buyer_4,Jorge,Moreno,1974-05-23,40441389Y,jorge.moreno@superapp.digital,216601,ES46209505951516573022,5874.73,2023-07-21T19:41:14,Galdakao,expenses,repairs,-331.1,-50411.92
buyer_4,Jorge,Moreno,1974-05-23,40441389Y,jorge.moreno@superapp.digital,216601,ES46209505951516573022,5874.73,2023-07-22T15:23:54,Galdakao,expenses,food,-109.33,-50521.25
buyer_4,Jorge,Moreno,1974-05-23,40441389Y,jorge.moreno@superapp.digital,216601,ES46209505951516573022,5874.73,2023-07-25T09:04:20,Galdakao,expenses,clothing,-132.05,-50653.3
buyer_4,Jorge,Moreno,1974-05-23,40441389Y,jorge.moreno@superapp.digital,216601,ES46209505951516573022,5874.73,2023-07-25T10:25:58,Galdakao,expenses,cash,-100.0,-50753.3
buyer_4,Jorge,Moreno,1974-05-23,40441389Y,jorge.moreno@superapp.digital,216601,ES46209505951516573022,5874.73,2023-07-27T14:55:24,Galdakao,expenses,food,-108.51,-50861.81
buyer_4,Jorge,Moreno,1974-05-23,40441389Y,jorge.moreno@superapp.digital,216601,ES46209505951516573022,5874.73,2023-07-27T22:11:12,Galdakao,expenses,transport,-46.72,-50908.53
buyer_4,Jorge,Moreno,1974-05-23,40441389Y,jorge.moreno@superapp.digital,216601,ES46209505951516573022,5874.73,2023-07-28T09:18:37,Galdakao,expenses,children,-834.7982500000004,-51743.33
buyer_4,Jorge,Moreno,1974-05-23,40441389Y,jorge.moreno@superapp.digital,216601,ES46209505951516573022,5874.73,2023-07-29T15:36:51,Galdakao,expenses,car,-265.34,-52008.67
buyer_4,Jorge,Moreno,1974-05-23,40441389Y,jorge.moreno@superapp.digital,216601,ES46209505951516573022,5874.73,2023-07-30T23:14:54,Galdakao,expenses,food,-79.19,-52087.86
buyer_4,Jorge,Moreno,1974-05-23,40441389Y,jorge.moreno@superapp.digital,216601,ES46209505951516573022,5874.73,2023-07-30T16:13:40,Galdakao,expenses,gifts,-742.61,-52830.47
buyer_4,Jorge,Moreno,1974-05-23,40441389Y,jorge.moreno@superapp.digital,216601,ES46209505951516573022,5874.73,2023-07-31T18:33:47,Galdakao,expenses,cash,-100.0,-52930.47
buyer_4,Jorge,Moreno,1974-05-23,40441389Y,jorge.moreno@superapp.digital,216601,ES46209505951516573022,5874.73,2023-08-01T22:50:29,Galdakao,incomes,salary,2466.94,-50463.53
buyer_4,Jorge,Moreno,1974-05-23,40441389Y,jorge.moreno@superapp.digital,216601,ES46209505951516573022,5874.73,2023-08-02T09:53:45,Galdakao,expenses,education,-62.77,-50526.3
buyer_4,Jorge,Moreno,1974-05-23,40441389Y,jorge.moreno@superapp.digital,216601,ES46209505951516573022,5874.73,2023-08-04T12:19:09,Galdakao,expenses,mortgage,-1154.88,-51681.18
buyer_4,Jorge,Moreno,1974-05-23,40441389Y,jorge.moreno@superapp.digital,216601,ES46209505951516573022,5874.73,2023-08-04T19:27:00,Galdakao,expenses,cash,-100.0,-51781.18
buyer_4,Jorge,Moreno,1974-05-23,40441389Y,jorge.moreno@superapp.digital,216601,ES46209505951516573022,5874.73,2023-08-05T09:25:10,Galdakao,expenses,gas,-100.32,-51881.5
buyer_4,Jorge,Moreno,1974-05-23,40441389Y,jorge.moreno@superapp.digital,216601,ES46209505951516573022,5874.73,2023-08-06T12:44:11,Galdakao,expenses,internet,-51.81,-51933.31
buyer_4,Jorge,Moreno,1974-05-23,40441389Y,jorge.moreno@superapp.digital,216601,ES46209505951516573022,5874.73,2023-08-07T23:04:17,Galdakao,expenses,internet,-51.81,-51985.12
buyer_4,Jorge,Moreno,1974-05-23,40441389Y,jorge.moreno@superapp.digital,216601,ES46209505951516573022,5874.73,2023-08-08T19:34:00,Galdakao,expenses,phone,-48.48,-52033.6
buyer_4,Jorge,Moreno,1974-05-23,40441389Y,jorge.moreno@superapp.digital,216601,ES46209505951516573022,5874.73,2023-08-08T12:30:07,Galdakao,expenses,food,-103.12,-52136.72
buyer_4,Jorge,Moreno,1974-05-23,40441389Y,jorge.moreno@superapp.digital,216601,ES46209505951516573022,5874.73,2023-08-08T20:46:19,Galdakao,expenses,clothing,-142.91,-52279.63
buyer_4,Jorge,Moreno,1974-05-23,40441389Y,jorge.moreno@superapp.digital,216601,ES46209505951516573022,5874.73,2023-08-09T19:42:15,Galdakao,expenses,leisure,-19.51,-52299.14
buyer_4,Jorge,Moreno,1974-05-23,40441389Y,jorge.moreno@superapp.digital,216601,ES46209505951516573022,5874.73,2023-08-11T14:15:36,Galdakao,expenses,repairs,-174.83,-52473.97
buyer_4,Jorge,Moreno,1974-05-23,40441389Y,jorge.moreno@superapp.digital,216601,ES46209505951516573022,5874.73,2023-08-12T07:51:12,Galdakao,expenses,food,-97.63,-52571.6
buyer_4,Jorge,Moreno,1974-05-23,40441389Y,jorge.moreno@superapp.digital,216601,ES46209505951516573022,5874.73,2023-08-13T15:28:10,Galdakao,expenses,transport,-82.81,-52654.41
buyer_4,Jorge,Moreno,1974-05-23,40441389Y,jorge.moreno@superapp.digital,216601,ES46209505951516573022,5874.73,2023-08-13T10:08:35,Galdakao,expenses,gifts,-25.17,-52679.58
buyer_4,Jorge,Moreno,1974-05-23,40441389Y,jorge.moreno@superapp.digital,216601,ES46209505951516573022,5874.73,2023-08-15T08:29:34,Galdakao,expenses,leisure,-57.05,-52736.63
buyer_4,Jorge,Moreno,1974-05-23,40441389Y,jorge.moreno@superapp.digital,216601,ES46209505951516573022,5874.73,2023-08-20T10:29:18,Galdakao,expenses,cash,-100.0,-52836.63
buyer_4,Jorge,Moreno,1974-05-23,40441389Y,jorge.moreno@superapp.digital,216601,ES46209505951516573022,5874.73,2023-08-21T09:40:24,Galdakao,expenses,leisure,-70.66,-52907.29
buyer_4,Jorge,Moreno,1974-05-23,40441389Y,jorge.moreno@superapp.digital,216601,ES46209505951516573022,5874.73,2023-08-22T14:54:08,Galdakao,expenses,leisure,-72.15,-52979.44
buyer_4,Jorge,Moreno,1974-05-23,40441389Y,jorge.moreno@superapp.digital,216601,ES46209505951516573022,5874.73,2023-08-24T20:12:14,Galdakao,expenses,cash,-100.0,-53079.44
buyer_4,Jorge,Moreno,1974-05-23,40441389Y,jorge.moreno@superapp.digital,216601,ES46209505951516573022,5874.73,2023-08-26T02:44:44,Galdakao,expenses,cash,-100.0,-53179.44
buyer_4,Jorge,Moreno,1974-05-23,40441389Y,jorge.moreno@superapp.digital,216601,ES46209505951516573022,5874.73,2023-08-29T15:50:59,Galdakao,expenses,healthcare,-67.51,-53246.95
buyer_4,Jorge,Moreno,1974-05-23,40441389Y,jorge.moreno@superapp.digital,216601,ES46209505951516573022,5874.73,2023-08-29T11:55:29,Galdakao,expenses,gifts,-419.21,-53666.16
buyer_4,Jorge,Moreno,1974-05-23,40441389Y,jorge.moreno@superapp.digital,216601,ES46209505951516573022,5874.73,2023-08-29T18:06:31,Galdakao,expenses,children,-348.0782500000004,-54014.24
buyer_4,Jorge,Moreno,1974-05-23,40441389Y,jorge.moreno@superapp.digital,216601,ES46209505951516573022,5874.73,2023-08-30T10:39:36,Galdakao,expenses,leisure,-43.05,-54057.29
buyer_4,Jorge,Moreno,1974-05-23,40441389Y,jorge.moreno@superapp.digital,216601,ES46209505951516573022,5874.73,2023-09-01T12:49:37,Galdakao,incomes,salary,2466.94,-51590.35
buyer_4,Jorge,Moreno,1974-05-23,40441389Y,jorge.moreno@superapp.digital,216601,ES46209505951516573022,5874.73,2023-09-01T16:31:45,Galdakao,expenses,leisure,-45.67,-51636.02
buyer_4,Jorge,Moreno,1974-05-23,40441389Y,jorge.moreno@superapp.digital,216601,ES46209505951516573022,5874.73,2023-09-02T17:17:45,Galdakao,expenses,clothing,-48.43,-51684.45
buyer_4,Jorge,Moreno,1974-05-23,40441389Y,jorge.moreno@superapp.digital,216601,ES46209505951516573022,5874.73,2023-09-03T08:41:55,Galdakao,expenses,cash,-100.0,-51784.45
buyer_4,Jorge,Moreno,1974-05-23,40441389Y,jorge.moreno@superapp.digital,216601,ES46209505951516573022,5874.73,2023-09-04T17:41:52,Galdakao,expenses,mortgage,-1154.88,-52939.33
buyer_4,Jorge,Moreno,1974-05-23,40441389Y,jorge.moreno@superapp.digital,216601,ES46209505951516573022,5874.73,2023-09-05T13:52:06,Galdakao,expenses,internet,-51.81,-52991.14
buyer_4,Jorge,Moreno,1974-05-23,40441389Y,jorge.moreno@superapp.digital,216601,ES46209505951516573022,5874.73,2023-09-05T10:25:10,Galdakao,expenses,cash,-100.0,-53091.14
buyer_4,Jorge,Moreno,1974-05-23,40441389Y,jorge.moreno@superapp.digital,216601,ES46209505951516573022,5874.73,2023-09-06T21:56:46,Galdakao,expenses,water,-43.14,-53134.28
buyer_4,Jorge,Moreno,1974-05-23,40441389Y,jorge.moreno@superapp.digital,216601,ES46209505951516573022,5874.73,2023-09-06T19:36:00,Galdakao,expenses,electricity,-33.33,-53167.61
buyer_4,Jorge,Moreno,1974-05-23,40441389Y,jorge.moreno@superapp.digital,216601,ES46209505951516573022,5874.73,2023-09-07T04:08:29,Galdakao,expenses,water,-50.36,-53217.97
buyer_4,Jorge,Moreno,1974-05-23,40441389Y,jorge.moreno@superapp.digital,216601,ES46209505951516573022,5874.73,2023-09-07T12:29:55,Galdakao,expenses,electricity,-69.94,-53287.91
buyer_4,Jorge,Moreno,1974-05-23,40441389Y,jorge.moreno@superapp.digital,216601,ES46209505951516573022,5874.73,2023-09-07T12:41:04,Galdakao,expenses,phone,-46.27,-53334.18
buyer_4,Jorge,Moreno,1974-05-23,40441389Y,jorge.moreno@superapp.digital,216601,ES46209505951516573022,5874.73,2023-09-07T05:33:05,Galdakao,expenses,leisure,-24.68,-53358.86
buyer_4,Jorge,Moreno,1974-05-23,40441389Y,jorge.moreno@superapp.digital,216601,ES46209505951516573022,5874.73,2023-09-08T16:29:42,Galdakao,expenses,water,-28.31,-53387.17
buyer_4,Jorge,Moreno,1974-05-23,40441389Y,jorge.moreno@superapp.digital,216601,ES46209505951516573022,5874.73,2023-09-08T19:47:50,Galdakao,expenses,gas,-127.27,-53514.44
buyer_4,Jorge,Moreno,1974-05-23,40441389Y,jorge.moreno@superapp.digital,216601,ES46209505951516573022,5874.73,2023-09-08T10:30:39,Galdakao,expenses,food,-117.78,-53632.22
buyer_4,Jorge,Moreno,1974-05-23,40441389Y,jorge.moreno@superapp.digital,216601,ES46209505951516573022,5874.73,2023-09-08T15:06:56,Galdakao,expenses,repairs,-47.93,-53680.15
buyer_4,Jorge,Moreno,1974-05-23,40441389Y,jorge.moreno@superapp.digital,216601,ES46209505951516573022,5874.73,2023-09-09T17:40:40,Galdakao,expenses,food,-121.52,-53801.67
buyer_4,Jorge,Moreno,1974-05-23,40441389Y,jorge.moreno@superapp.digital,216601,ES46209505951516573022,5874.73,2023-09-10T12:36:13,Galdakao,expenses,food,-90.99,-53892.66
buyer_4,Jorge,Moreno,1974-05-23,40441389Y,jorge.moreno@superapp.digital,216601,ES46209505951516573022,5874.73,2023-09-12T18:34:26,Galdakao,expenses,food,-121.25,-54013.91
buyer_4,Jorge,Moreno,1974-05-23,40441389Y,jorge.moreno@superapp.digital,216601,ES46209505951516573022,5874.73,2023-09-12T12:25:18,Galdakao,expenses,cash,-100.0,-54113.91
buyer_4,Jorge,Moreno,1974-05-23,40441389Y,jorge.moreno@superapp.digital,216601,ES46209505951516573022,5874.73,2023-09-12T15:33:24,Galdakao,expenses,children,-613.5482500000004,-54727.46
buyer_4,Jorge,Moreno,1974-05-23,40441389Y,jorge.moreno@superapp.digital,216601,ES46209505951516573022,5874.73,2023-09-13T20:23:11,Galdakao,expenses,leisure,-68.2,-54795.66
buyer_4,Jorge,Moreno,1974-05-23,40441389Y,jorge.moreno@superapp.digital,216601,ES46209505951516573022,5874.73,2023-09-13T11:28:18,Galdakao,expenses,repairs,-217.4,-55013.06
buyer_4,Jorge,Moreno,1974-05-23,40441389Y,jorge.moreno@superapp.digital,216601,ES46209505951516573022,5874.73,2023-09-14T09:14:46,Galdakao,expenses,cash,-100.0,-55113.06
buyer_4,Jorge,Moreno,1974-05-23,40441389Y,jorge.moreno@superapp.digital,216601,ES46209505951516573022,5874.73,2023-09-15T20:34:58,Galdakao,expenses,transport,-66.4,-55179.46
buyer_4,Jorge,Moreno,1974-05-23,40441389Y,jorge.moreno@superapp.digital,216601,ES46209505951516573022,5874.73,2023-09-15T13:26:38,Galdakao,expenses,cash,-100.0,-55279.46
buyer_4,Jorge,Moreno,1974-05-23,40441389Y,jorge.moreno@superapp.digital,216601,ES46209505951516573022,5874.73,2023-09-16T10:54:51,Galdakao,expenses,appliances,-271.73,-55551.19
buyer_4,Jorge,Moreno,1974-05-23,40441389Y,jorge.moreno@superapp.digital,216601,ES46209505951516573022,5874.73,2023-09-18T09:48:15,Galdakao,expenses,food,-79.92,-55631.11
buyer_4,Jorge,Moreno,1974-05-23,40441389Y,jorge.moreno@superapp.digital,216601,ES46209505951516573022,5874.73,2023-09-20T01:46:34,Galdakao,expenses,cash,-100.0,-55731.11
buyer_4,Jorge,Moreno,1974-05-23,40441389Y,jorge.moreno@superapp.digital,216601,ES46209505951516573022,5874.73,2023-09-21T20:00:18,Galdakao,expenses,transport,-57.46,-55788.57
buyer_4,Jorge,Moreno,1974-05-23,40441389Y,jorge.moreno@superapp.digital,216601,ES46209505951516573022,5874.73,2023-09-21T10:35:47,Galdakao,expenses,leisure,-82.11,-55870.68
buyer_4,Jorge,Moreno,1974-05-23,40441389Y,jorge.moreno@superapp.digital,216601,ES46209505951516573022,5874.73,2023-09-23T11:24:48,Galdakao,expenses,transport,-89.57,-55960.25
buyer_4,Jorge,Moreno,1974-05-23,40441389Y,jorge.moreno@superapp.digital,216601,ES46209505951516573022,5874.73,2023-09-23T18:51:29,Galdakao,expenses,cash,-100.0,-56060.25
buyer_4,Jorge,Moreno,1974-05-23,40441389Y,jorge.moreno@superapp.digital,216601,ES46209505951516573022,5874.73,2023-09-23T07:06:11,Galdakao,expenses,gifts,-152.82,-56213.07
buyer_4,Jorge,Moreno,1974-05-23,40441389Y,jorge.moreno@superapp.digital,216601,ES46209505951516573022,5874.73,2023-09-24T20:41:43,Galdakao,expenses,cash,-100.0,-56313.07
buyer_4,Jorge,Moreno,1974-05-23,40441389Y,jorge.moreno@superapp.digital,216601,ES46209505951516573022,5874.73,2023-09-25T13:16:04,Galdakao,expenses,food,-85.77,-56398.84
buyer_4,Jorge,Moreno,1974-05-23,40441389Y,jorge.moreno@superapp.digital,216601,ES46209505951516573022,5874.73,2023-09-26T23:38:26,Galdakao,expenses,transport,-45.38,-56444.22
buyer_4,Jorge,Moreno,1974-05-23,40441389Y,jorge.moreno@superapp.digital,216601,ES46209505951516573022,5874.73,2023-09-26T19:55:50,Galdakao,expenses,leisure,-51.7,-56495.92
buyer_4,Jorge,Moreno,1974-05-23,40441389Y,jorge.moreno@superapp.digital,216601,ES46209505951516573022,5874.73,2023-09-28T10:11:48,Galdakao,expenses,food,-93.61,-56589.53
buyer_4,Jorge,Moreno,1974-05-23,40441389Y,jorge.moreno@superapp.digital,216601,ES46209505951516573022,5874.73,2023-10-01T20:25:54,Galdakao,incomes,salary,2466.94,-54122.59
buyer_4,Jorge,Moreno,1974-05-23,40441389Y,jorge.moreno@superapp.digital,216601,ES46209505951516573022,5874.73,2023-10-01T20:25:54,Galdakao,incomes,extra_income,385.48,-53737.11
buyer_4,Jorge,Moreno,1974-05-23,40441389Y,jorge.moreno@superapp.digital,216601,ES46209505951516573022,5874.73,2023-10-02T19:09:16,Galdakao,expenses,children,-834.7982500000004,-54571.91
buyer_4,Jorge,Moreno,1974-05-23,40441389Y,jorge.moreno@superapp.digital,216601,ES46209505951516573022,5874.73,2023-10-04T19:01:20,Galdakao,expenses,mortgage,-1154.88,-55726.79
buyer_4,Jorge,Moreno,1974-05-23,40441389Y,jorge.moreno@superapp.digital,216601,ES46209505951516573022,5874.73,2023-10-05T08:19:21,Galdakao,expenses,gas,-84.9,-55811.69
buyer_4,Jorge,Moreno,1974-05-23,40441389Y,jorge.moreno@superapp.digital,216601,ES46209505951516573022,5874.73,2023-10-05T08:49:28,Galdakao,expenses,leisure,-51.83,-55863.52
buyer_4,Jorge,Moreno,1974-05-23,40441389Y,jorge.moreno@superapp.digital,216601,ES46209505951516573022,5874.73,2023-10-06T19:54:21,Galdakao,expenses,internet,-51.81,-55915.33
buyer_4,Jorge,Moreno,1974-05-23,40441389Y,jorge.moreno@superapp.digital,216601,ES46209505951516573022,5874.73,2023-10-09T18:56:39,Galdakao,expenses,clothing,-55.16,-55970.49
buyer_4,Jorge,Moreno,1974-05-23,40441389Y,jorge.moreno@superapp.digital,216601,ES46209505951516573022,5874.73,2023-10-12T19:37:56,Galdakao,expenses,clothing,-147.38,-56117.87
buyer_4,Jorge,Moreno,1974-05-23,40441389Y,jorge.moreno@superapp.digital,216601,ES46209505951516573022,5874.73,2023-10-12T11:50:08,Galdakao,expenses,cash,-100.0,-56217.87
buyer_4,Jorge,Moreno,1974-05-23,40441389Y,jorge.moreno@superapp.digital,216601,ES46209505951516573022,5874.73,2023-10-13T20:51:40,Galdakao,expenses,children,-834.7982500000004,-57052.67
buyer_4,Jorge,Moreno,1974-05-23,40441389Y,jorge.moreno@superapp.digital,216601,ES46209505951516573022,5874.73,2023-10-14T08:51:55,Galdakao,expenses,gifts,-363.53,-57416.2
buyer_4,Jorge,Moreno,1974-05-23,40441389Y,jorge.moreno@superapp.digital,216601,ES46209505951516573022,5874.73,2023-10-17T23:48:03,Galdakao,expenses,food,-120.82,-57537.02
buyer_4,Jorge,Moreno,1974-05-23,40441389Y,jorge.moreno@superapp.digital,216601,ES46209505951516573022,5874.73,2023-10-17T16:55:13,Galdakao,expenses,leisure,-33.73,-57570.75
buyer_4,Jorge,Moreno,1974-05-23,40441389Y,jorge.moreno@superapp.digital,216601,ES46209505951516573022,5874.73,2023-10-18T16:13:54,Galdakao,expenses,leisure,-33.75,-57604.5
buyer_4,Jorge,Moreno,1974-05-23,40441389Y,jorge.moreno@superapp.digital,216601,ES46209505951516573022,5874.73,2023-10-19T12:06:20,Galdakao,expenses,cash,-100.0,-57704.5
buyer_4,Jorge,Moreno,1974-05-23,40441389Y,jorge.moreno@superapp.digital,216601,ES46209505951516573022,5874.73,2023-10-20T15:57:09,Galdakao,expenses,leisure,-68.84,-57773.34
buyer_4,Jorge,Moreno,1974-05-23,40441389Y,jorge.moreno@superapp.digital,216601,ES46209505951516573022,5874.73,2023-10-21T19:28:08,Galdakao,expenses,transport,-66.89,-57840.23
buyer_4,Jorge,Moreno,1974-05-23,40441389Y,jorge.moreno@superapp.digital,216601,ES46209505951516573022,5874.73,2023-10-21T15:05:32,Galdakao,expenses,cash,-100.0,-57940.23
buyer_4,Jorge,Moreno,1974-05-23,40441389Y,jorge.moreno@superapp.digital,216601,ES46209505951516573022,5874.73,2023-10-21T09:57:05,Galdakao,expenses,gifts,-108.5,-58048.73
buyer_4,Jorge,Moreno,1974-05-23,40441389Y,jorge.moreno@superapp.digital,216601,ES46209505951516573022,5874.73,2023-10-24T19:35:26,Galdakao,expenses,cash,-100.0,-58148.73
buyer_4,Jorge,Moreno,1974-05-23,40441389Y,jorge.moreno@superapp.digital,216601,ES46209505951516573022,5874.73,2023-10-27T18:13:04,Galdakao,expenses,travel,-788.3,-58937.03
buyer_4,Jorge,Moreno,1974-05-23,40441389Y,jorge.moreno@superapp.digital,216601,ES46209505951516573022,5874.73,2023-10-28T19:03:36,Galdakao,expenses,repairs,-71.31,-59008.34
buyer_4,Jorge,Moreno,1974-05-23,40441389Y,jorge.moreno@superapp.digital,216601,ES46209505951516573022,5874.73,2023-10-29T12:37:19,Galdakao,expenses,cash,-100.0,-59108.34
buyer_4,Jorge,Moreno,1974-05-23,40441389Y,jorge.moreno@superapp.digital,216601,ES46209505951516573022,5874.73,2023-10-30T15:10:38,Galdakao,expenses,food,-111.58,-59219.92
buyer_4,Jorge,Moreno,1974-05-23,40441389Y,jorge.moreno@superapp.digital,216601,ES46209505951516573022,5874.73,2023-11-01T21:02:18,Galdakao,incomes,salary,2466.94,-56752.98
buyer_4,Jorge,Moreno,1974-05-23,40441389Y,jorge.moreno@superapp.digital,216601,ES46209505951516573022,5874.73,2023-11-01T15:46:51,Galdakao,expenses,transport,-54.24,-56807.22
buyer_4,Jorge,Moreno,1974-05-23,40441389Y,jorge.moreno@superapp.digital,216601,ES46209505951516573022,5874.73,2023-11-01T15:33:54,Galdakao,expenses,repairs,-159.26,-56966.48
buyer_4,Jorge,Moreno,1974-05-23,40441389Y,jorge.moreno@superapp.digital,216601,ES46209505951516573022,5874.73,2023-11-02T08:32:00,Galdakao,expenses,repairs,-57.69,-57024.17
buyer_4,Jorge,Moreno,1974-05-23,40441389Y,jorge.moreno@superapp.digital,216601,ES46209505951516573022,5874.73,2023-11-03T15:30:17,Galdakao,expenses,food,-77.65,-57101.82
buyer_4,Jorge,Moreno,1974-05-23,40441389Y,jorge.moreno@superapp.digital,216601,ES46209505951516573022,5874.73,2023-11-03T08:05:15,Galdakao,expenses,cash,-100.0,-57201.82
buyer_4,Jorge,Moreno,1974-05-23,40441389Y,jorge.moreno@superapp.digital,216601,ES46209505951516573022,5874.73,2023-11-04T08:21:03,Galdakao,expenses,mortgage,-1154.88,-58356.7
buyer_4,Jorge,Moreno,1974-05-23,40441389Y,jorge.moreno@superapp.digital,216601,ES46209505951516573022,5874.73,2023-11-04T19:35:35,Galdakao,expenses,education,-71.72,-58428.42
buyer_4,Jorge,Moreno,1974-05-23,40441389Y,jorge.moreno@superapp.digital,216601,ES46209505951516573022,5874.73,2023-11-05T10:46:26,Galdakao,expenses,water,-51.08,-58479.5
buyer_4,Jorge,Moreno,1974-05-23,40441389Y,jorge.moreno@superapp.digital,216601,ES46209505951516573022,5874.73,2023-11-05T16:17:47,Galdakao,expenses,internet,-51.81,-58531.31
buyer_4,Jorge,Moreno,1974-05-23,40441389Y,jorge.moreno@superapp.digital,216601,ES46209505951516573022,5874.73,2023-11-06T21:29:06,Galdakao,expenses,internet,-51.81,-58583.12
buyer_4,Jorge,Moreno,1974-05-23,40441389Y,jorge.moreno@superapp.digital,216601,ES46209505951516573022,5874.73,2023-11-06T16:29:54,Galdakao,expenses,transport,-64.88,-58648.0
buyer_4,Jorge,Moreno,1974-05-23,40441389Y,jorge.moreno@superapp.digital,216601,ES46209505951516573022,5874.73,2023-11-06T18:54:55,Galdakao,expenses,cash,-100.0,-58748.0
buyer_4,Jorge,Moreno,1974-05-23,40441389Y,jorge.moreno@superapp.digital,216601,ES46209505951516573022,5874.73,2023-11-07T19:34:47,Galdakao,expenses,phone,-54.72,-58802.72
buyer_4,Jorge,Moreno,1974-05-23,40441389Y,jorge.moreno@superapp.digital,216601,ES46209505951516573022,5874.73,2023-11-08T22:04:43,Galdakao,expenses,cash,-100.0,-58902.72
buyer_4,Jorge,Moreno,1974-05-23,40441389Y,jorge.moreno@superapp.digital,216601,ES46209505951516573022,5874.73,2023-11-10T21:32:58,Galdakao,expenses,cash,-100.0,-59002.72
buyer_4,Jorge,Moreno,1974-05-23,40441389Y,jorge.moreno@superapp.digital,216601,ES46209505951516573022,5874.73,2023-11-11T21:28:37,Galdakao,expenses,cash,-100.0,-59102.72
buyer_4,Jorge,Moreno,1974-05-23,40441389Y,jorge.moreno@superapp.digital,216601,ES46209505951516573022,5874.73,2023-11-12T16:58:55,Galdakao,expenses,gifts,-97.7,-59200.42
buyer_4,Jorge,Moreno,1974-05-23,40441389Y,jorge.moreno@superapp.digital,216601,ES46209505951516573022,5874.73,2023-11-13T10:03:28,Galdakao,expenses,clothing,-97.03,-59297.45
buyer_4,Jorge,Moreno,1974-05-23,40441389Y,jorge.moreno@superapp.digital,216601,ES46209505951516573022,5874.73,2023-11-14T10:05:32,Galdakao,expenses,children,-834.7982500000004,-60132.25
buyer_4,Jorge,Moreno,1974-05-23,40441389Y,jorge.moreno@superapp.digital,216601,ES46209505951516573022,5874.73,2023-11-15T01:11:54,Galdakao,expenses,repairs,-179.35,-60311.6
buyer_4,Jorge,Moreno,1974-05-23,40441389Y,jorge.moreno@superapp.digital,216601,ES46209505951516573022,5874.73,2023-11-16T11:51:25,Galdakao,expenses,food,-114.7,-60426.3
buyer_4,Jorge,Moreno,1974-05-23,40441389Y,jorge.moreno@superapp.digital,216601,ES46209505951516573022,5874.73,2023-11-16T22:59:58,Galdakao,expenses,healthcare,-85.67,-60511.97
buyer_4,Jorge,Moreno,1974-05-23,40441389Y,jorge.moreno@superapp.digital,216601,ES46209505951516573022,5874.73,2023-11-16T18:00:16,Galdakao,expenses,cash,-100.0,-60611.97
buyer_4,Jorge,Moreno,1974-05-23,40441389Y,jorge.moreno@superapp.digital,216601,ES46209505951516573022,5874.73,2023-11-18T15:53:54,Galdakao,expenses,food,-61.57,-60673.54
buyer_4,Jorge,Moreno,1974-05-23,40441389Y,jorge.moreno@superapp.digital,216601,ES46209505951516573022,5874.73,2023-11-20T19:34:47,Galdakao,expenses,leisure,-40.29,-60713.83
buyer_4,Jorge,Moreno,1974-05-23,40441389Y,jorge.moreno@superapp.digital,216601,ES46209505951516573022,5874.73,2023-11-20T14:01:57,Galdakao,expenses,cash,-100.0,-60813.83
buyer_4,Jorge,Moreno,1974-05-23,40441389Y,jorge.moreno@superapp.digital,216601,ES46209505951516573022,5874.73,2023-11-24T08:09:50,Galdakao,expenses,transport,-89.72,-60903.55
buyer_4,Jorge,Moreno,1974-05-23,40441389Y,jorge.moreno@superapp.digital,216601,ES46209505951516573022,5874.73,2023-11-24T11:26:29,Galdakao,expenses,leisure,-26.54,-60930.09
buyer_4,Jorge,Moreno,1974-05-23,40441389Y,jorge.moreno@superapp.digital,216601,ES46209505951516573022,5874.73,2023-11-26T13:38:50,Galdakao,expenses,education,-69.92,-61000.01
buyer_4,Jorge,Moreno,1974-05-23,40441389Y,jorge.moreno@superapp.digital,216601,ES46209505951516573022,5874.73,2023-11-27T11:28:25,Galdakao,expenses,clothing,-112.15,-61112.16
buyer_4,Jorge,Moreno,1974-05-23,40441389Y,jorge.moreno@superapp.digital,216601,ES46209505951516573022,5874.73,2023-11-29T14:01:38,Galdakao,expenses,food,-86.24,-61198.4
buyer_4,Jorge,Moreno,1974-05-23,40441389Y,jorge.moreno@superapp.digital,216601,ES46209505951516573022,5874.73,2023-11-29T10:32:25,Galdakao,expenses,education,-75.09,-61273.49
buyer_4,Jorge,Moreno,1974-05-23,40441389Y,jorge.moreno@superapp.digital,216601,ES46209505951516573022,5874.73,2023-11-30T04:32:02,Galdakao,expenses,leisure,-51.27,-61324.76
buyer_4,Jorge,Moreno,1974-05-23,40441389Y,jorge.moreno@superapp.digital,216601,ES46209505951516573022,5874.73,2023-12-01T15:03:05,Galdakao,incomes,salary,2466.94,-58857.82
buyer_4,Jorge,Moreno,1974-05-23,40441389Y,jorge.moreno@superapp.digital,216601,ES46209505951516573022,5874.73,2023-12-01T15:03:05,Galdakao,incomes,salary_bonus,1930.04,-56927.78
buyer_4,Jorge,Moreno,1974-05-23,40441389Y,jorge.moreno@superapp.digital,216601,ES46209505951516573022,5874.73,2023-12-02T19:37:10,Galdakao,expenses,leisure,-25.65,-56953.43
buyer_4,Jorge,Moreno,1974-05-23,40441389Y,jorge.moreno@superapp.digital,216601,ES46209505951516573022,5874.73,2023-12-03T19:24:29,Galdakao,expenses,appliances,-270.69,-57224.12
buyer_4,Jorge,Moreno,1974-05-23,40441389Y,jorge.moreno@superapp.digital,216601,ES46209505951516573022,5874.73,2023-12-04T19:26:04,Galdakao,expenses,mortgage,-1154.88,-58379.0
buyer_4,Jorge,Moreno,1974-05-23,40441389Y,jorge.moreno@superapp.digital,216601,ES46209505951516573022,5874.73,2023-12-04T11:43:24,Galdakao,expenses,leisure,-66.46,-58445.46
buyer_4,Jorge,Moreno,1974-05-23,40441389Y,jorge.moreno@superapp.digital,216601,ES46209505951516573022,5874.73,2023-12-04T17:58:24,Galdakao,expenses,healthcare,-62.11,-58507.57
buyer_4,Jorge,Moreno,1974-05-23,40441389Y,jorge.moreno@superapp.digital,216601,ES46209505951516573022,5874.73,2023-12-05T08:03:48,Galdakao,expenses,internet,-51.81,-58559.38
buyer_4,Jorge,Moreno,1974-05-23,40441389Y,jorge.moreno@superapp.digital,216601,ES46209505951516573022,5874.73,2023-12-06T22:00:09,Galdakao,expenses,electricity,-87.26,-58646.64
buyer_4,Jorge,Moreno,1974-05-23,40441389Y,jorge.moreno@superapp.digital,216601,ES46209505951516573022,5874.73,2023-12-06T20:12:08,Galdakao,expenses,internet,-51.81,-58698.45
buyer_4,Jorge,Moreno,1974-05-23,40441389Y,jorge.moreno@superapp.digital,216601,ES46209505951516573022,5874.73,2023-12-06T15:31:36,Galdakao,expenses,education,-49.55,-58748.0
buyer_4,Jorge,Moreno,1974-05-23,40441389Y,jorge.moreno@superapp.digital,216601,ES46209505951516573022,5874.73,2023-12-06T21:19:04,Galdakao,expenses,repairs,-299.9,-59047.9
buyer_4,Jorge,Moreno,1974-05-23,40441389Y,jorge.moreno@superapp.digital,216601,ES46209505951516573022,5874.73,2023-12-07T13:44:36,Galdakao,expenses,electricity,-82.99,-59130.89
buyer_4,Jorge,Moreno,1974-05-23,40441389Y,jorge.moreno@superapp.digital,216601,ES46209505951516573022,5874.73,2023-12-07T14:12:58,Galdakao,expenses,leisure,-32.65,-59163.54
buyer_4,Jorge,Moreno,1974-05-23,40441389Y,jorge.moreno@superapp.digital,216601,ES46209505951516573022,5874.73,2023-12-07T17:00:01,Galdakao,expenses,cash,-100.0,-59263.54
buyer_4,Jorge,Moreno,1974-05-23,40441389Y,jorge.moreno@superapp.digital,216601,ES46209505951516573022,5874.73,2023-12-08T18:23:13,Galdakao,expenses,gas,-94.89,-59358.43
buyer_4,Jorge,Moreno,1974-05-23,40441389Y,jorge.moreno@superapp.digital,216601,ES46209505951516573022,5874.73,2023-12-08T14:31:55,Galdakao,expenses,travel,-408.59,-59767.02
buyer_4,Jorge,Moreno,1974-05-23,40441389Y,jorge.moreno@superapp.digital,216601,ES46209505951516573022,5874.73,2023-12-09T08:43:10,Galdakao,expenses,appliances,-163.29,-59930.31
buyer_4,Jorge,Moreno,1974-05-23,40441389Y,jorge.moreno@superapp.digital,216601,ES46209505951516573022,5874.73,2023-12-10T13:00:39,Galdakao,expenses,transport,-54.3,-59984.61
buyer_4,Jorge,Moreno,1974-05-23,40441389Y,jorge.moreno@superapp.digital,216601,ES46209505951516573022,5874.73,2023-12-10T19:11:58,Galdakao,expenses,repairs,-52.06,-60036.67
buyer_4,Jorge,Moreno,1974-05-23,40441389Y,jorge.moreno@superapp.digital,216601,ES46209505951516573022,5874.73,2023-12-12T17:40:53,Galdakao,expenses,food,-118.87,-60155.54
buyer_4,Jorge,Moreno,1974-05-23,40441389Y,jorge.moreno@superapp.digital,216601,ES46209505951516573022,5874.73,2023-12-13T23:00:33,Galdakao,expenses,cash,-100.0,-60255.54
buyer_4,Jorge,Moreno,1974-05-23,40441389Y,jorge.moreno@superapp.digital,216601,ES46209505951516573022,5874.73,2023-12-14T17:40:21,Galdakao,expenses,repairs,-28.18,-60283.72
buyer_4,Jorge,Moreno,1974-05-23,40441389Y,jorge.moreno@superapp.digital,216601,ES46209505951516573022,5874.73,2023-12-16T15:39:34,Galdakao,expenses,cash,-100.0,-60383.72
buyer_4,Jorge,Moreno,1974-05-23,40441389Y,jorge.moreno@superapp.digital,216601,ES46209505951516573022,5874.73,2023-12-18T17:46:45,Galdakao,expenses,food,-98.92,-60482.64
buyer_4,Jorge,Moreno,1974-05-23,40441389Y,jorge.moreno@superapp.digital,216601,ES46209505951516573022,5874.73,2023-12-18T03:17:59,Galdakao,expenses,cash,-100.0,-60582.64
buyer_4,Jorge,Moreno,1974-05-23,40441389Y,jorge.moreno@superapp.digital,216601,ES46209505951516573022,5874.73,2023-12-18T10:01:26,Galdakao,expenses,gifts,-178.83,-60761.47
buyer_4,Jorge,Moreno,1974-05-23,40441389Y,jorge.moreno@superapp.digital,216601,ES46209505951516573022,5874.73,2023-12-18T15:31:42,Galdakao,expenses,children,-457.0482500000004,-61218.52
buyer_4,Jorge,Moreno,1974-05-23,40441389Y,jorge.moreno@superapp.digital,216601,ES46209505951516573022,5874.73,2023-12-20T12:13:36,Galdakao,expenses,food,-100.22,-61318.74
buyer_4,Jorge,Moreno,1974-05-23,40441389Y,jorge.moreno@superapp.digital,216601,ES46209505951516573022,5874.73,2023-12-20T17:22:19,Galdakao,expenses,transport,-51.49,-61370.23
buyer_4,Jorge,Moreno,1974-05-23,40441389Y,jorge.moreno@superapp.digital,216601,ES46209505951516573022,5874.73,2023-12-20T17:53:06,Galdakao,expenses,leisure,-66.14,-61436.37
buyer_4,Jorge,Moreno,1974-05-23,40441389Y,jorge.moreno@superapp.digital,216601,ES46209505951516573022,5874.73,2023-12-21T09:14:17,Galdakao,expenses,gifts,-325.38,-61761.75
buyer_4,Jorge,Moreno,1974-05-23,40441389Y,jorge.moreno@superapp.digital,216601,ES46209505951516573022,5874.73,2023-12-22T16:12:29,Galdakao,expenses,leisure,-25.57,-61787.32
buyer_4,Jorge,Moreno,1974-05-23,40441389Y,jorge.moreno@superapp.digital,216601,ES46209505951516573022,5874.73,2023-12-23T15:25:25,Galdakao,expenses,cash,-100.0,-61887.32
buyer_4,Jorge,Moreno,1974-05-23,40441389Y,jorge.moreno@superapp.digital,216601,ES46209505951516573022,5874.73,2023-12-29T16:48:40,Galdakao,expenses,repairs,-93.22,-61980.54
buyer_4,Jorge,Moreno,1974-05-23,40441389Y,jorge.moreno@superapp.digital,216601,ES46209505951516573022,5874.73,2023-12-30T21:48:08,Galdakao,expenses,food,-78.55,-62059.09
buyer_4,Jorge,Moreno,1974-05-23,40441389Y,jorge.moreno@superapp.digital,216601,ES46209505951516573022,5874.73,2024-01-01T20:16:50,Galdakao,incomes,salary,2549.68,-59509.41
buyer_4,Jorge,Moreno,1974-05-23,40441389Y,jorge.moreno@superapp.digital,216601,ES46209505951516573022,5874.73,2024-01-01T09:16:19,Galdakao,expenses,healthcare,-152.91,-59662.32
buyer_4,Jorge,Moreno,1974-05-23,40441389Y,jorge.moreno@superapp.digital,216601,ES46209505951516573022,5874.73,2024-01-01T16:02:07,Galdakao,expenses,cash,-100.0,-59762.32
buyer_4,Jorge,Moreno,1974-05-23,40441389Y,jorge.moreno@superapp.digital,216601,ES46209505951516573022,5874.73,2024-01-02T18:35:43,Galdakao,expenses,food,-111.96,-59874.28
buyer_4,Jorge,Moreno,1974-05-23,40441389Y,jorge.moreno@superapp.digital,216601,ES46209505951516573022,5874.73,2024-01-04T10:13:25,Galdakao,expenses,mortgage,-1034.67,-60908.95
buyer_4,Jorge,Moreno,1974-05-23,40441389Y,jorge.moreno@superapp.digital,216601,ES46209505951516573022,5874.73,2024-01-05T18:59:28,Galdakao,expenses,electricity,-100.15,-61009.1
buyer_4,Jorge,Moreno,1974-05-23,40441389Y,jorge.moreno@superapp.digital,216601,ES46209505951516573022,5874.73,2024-01-05T02:46:31,Galdakao,expenses,internet,-53.54,-61062.64
buyer_4,Jorge,Moreno,1974-05-23,40441389Y,jorge.moreno@superapp.digital,216601,ES46209505951516573022,5874.73,2024-01-05T15:03:47,Galdakao,expenses,cash,-100.0,-61162.64
buyer_4,Jorge,Moreno,1974-05-23,40441389Y,jorge.moreno@superapp.digital,216601,ES46209505951516573022,5874.73,2024-01-06T11:42:57,Galdakao,expenses,gas,-66.93,-61229.57
buyer_4,Jorge,Moreno,1974-05-23,40441389Y,jorge.moreno@superapp.digital,216601,ES46209505951516573022,5874.73,2024-01-06T23:32:19,Galdakao,expenses,food,-103.93,-61333.5
buyer_4,Jorge,Moreno,1974-05-23,40441389Y,jorge.moreno@superapp.digital,216601,ES46209505951516573022,5874.73,2024-01-06T20:51:58,Galdakao,expenses,children,-425.04,-61758.54
buyer_4,Jorge,Moreno,1974-05-23,40441389Y,jorge.moreno@superapp.digital,216601,ES46209505951516573022,5874.73,2024-01-07T23:59:04,Galdakao,expenses,internet,-53.54,-61812.08
buyer_4,Jorge,Moreno,1974-05-23,40441389Y,jorge.moreno@superapp.digital,216601,ES46209505951516573022,5874.73,2024-01-07T19:06:53,Galdakao,expenses,phone,-48.86,-61860.94
buyer_4,Jorge,Moreno,1974-05-23,40441389Y,jorge.moreno@superapp.digital,216601,ES46209505951516573022,5874.73,2024-01-07T11:51:53,Galdakao,expenses,food,-94.78,-61955.72
buyer_4,Jorge,Moreno,1974-05-23,40441389Y,jorge.moreno@superapp.digital,216601,ES46209505951516573022,5874.73,2024-01-07T18:47:33,Galdakao,expenses,leisure,-62.53,-62018.25
buyer_4,Jorge,Moreno,1974-05-23,40441389Y,jorge.moreno@superapp.digital,216601,ES46209505951516573022,5874.73,2024-01-07T08:16:08,Galdakao,expenses,education,-51.93,-62070.18
buyer_4,Jorge,Moreno,1974-05-23,40441389Y,jorge.moreno@superapp.digital,216601,ES46209505951516573022,5874.73,2024-01-08T11:08:44,Galdakao,expenses,education,-49.77,-62119.95
buyer_4,Jorge,Moreno,1974-05-23,40441389Y,jorge.moreno@superapp.digital,216601,ES46209505951516573022,5874.73,2024-01-08T12:01:20,Galdakao,expenses,cash,-100.0,-62219.95
buyer_4,Jorge,Moreno,1974-05-23,40441389Y,jorge.moreno@superapp.digital,216601,ES46209505951516573022,5874.73,2024-01-11T15:49:42,Galdakao,expenses,children,-974.78,-63194.73
buyer_4,Jorge,Moreno,1974-05-23,40441389Y,jorge.moreno@superapp.digital,216601,ES46209505951516573022,5874.73,2024-01-13T09:33:20,Galdakao,expenses,appliances,-127.16,-63321.89
buyer_4,Jorge,Moreno,1974-05-23,40441389Y,jorge.moreno@superapp.digital,216601,ES46209505951516573022,5874.73,2024-01-17T10:37:12,Galdakao,expenses,food,-123.15,-63445.04
buyer_4,Jorge,Moreno,1974-05-23,40441389Y,jorge.moreno@superapp.digital,216601,ES46209505951516573022,5874.73,2024-01-18T20:14:06,Galdakao,expenses,gifts,-688.92,-64133.96
buyer_4,Jorge,Moreno,1974-05-23,40441389Y,jorge.moreno@superapp.digital,216601,ES46209505951516573022,5874.73,2024-01-20T15:45:49,Galdakao,expenses,food,-89.07,-64223.03
buyer_4,Jorge,Moreno,1974-05-23,40441389Y,jorge.moreno@superapp.digital,216601,ES46209505951516573022,5874.73,2024-01-21T10:13:22,Galdakao,expenses,food,-71.6,-64294.63
buyer_4,Jorge,Moreno,1974-05-23,40441389Y,jorge.moreno@superapp.digital,216601,ES46209505951516573022,5874.73,2024-01-21T10:18:57,Galdakao,expenses,cash,-100.0,-64394.63
buyer_4,Jorge,Moreno,1974-05-23,40441389Y,jorge.moreno@superapp.digital,216601,ES46209505951516573022,5874.73,2024-01-22T11:45:29,Galdakao,expenses,repairs,-289.79,-64684.42
buyer_4,Jorge,Moreno,1974-05-23,40441389Y,jorge.moreno@superapp.digital,216601,ES46209505951516573022,5874.73,2024-01-22T14:06:32,Galdakao,expenses,gifts,-165.23,-64849.65
buyer_4,Jorge,Moreno,1974-05-23,40441389Y,jorge.moreno@superapp.digital,216601,ES46209505951516573022,5874.73,2024-01-23T09:25:15,Galdakao,expenses,cash,-100.0,-64949.65
buyer_4,Jorge,Moreno,1974-05-23,40441389Y,jorge.moreno@superapp.digital,216601,ES46209505951516573022,5874.73,2024-01-24T20:28:04,Galdakao,expenses,clothing,-107.23,-65056.88
buyer_4,Jorge,Moreno,1974-05-23,40441389Y,jorge.moreno@superapp.digital,216601,ES46209505951516573022,5874.73,2024-01-24T21:01:59,Galdakao,expenses,cash,-100.0,-65156.88
buyer_4,Jorge,Moreno,1974-05-23,40441389Y,jorge.moreno@superapp.digital,216601,ES46209505951516573022,5874.73,2024-01-24T17:04:10,Galdakao,expenses,appliances,-258.42,-65415.3
buyer_4,Jorge,Moreno,1974-05-23,40441389Y,jorge.moreno@superapp.digital,216601,ES46209505951516573022,5874.73,2024-01-24T06:23:57,Galdakao,expenses,repairs,-63.36,-65478.66
buyer_4,Jorge,Moreno,1974-05-23,40441389Y,jorge.moreno@superapp.digital,216601,ES46209505951516573022,5874.73,2024-01-26T15:11:43,Galdakao,expenses,cash,-100.0,-65578.66
buyer_4,Jorge,Moreno,1974-05-23,40441389Y,jorge.moreno@superapp.digital,216601,ES46209505951516573022,5874.73,2024-01-27T15:16:41,Galdakao,expenses,appliances,-282.87,-65861.53
buyer_4,Jorge,Moreno,1974-05-23,40441389Y,jorge.moreno@superapp.digital,216601,ES46209505951516573022,5874.73,2024-01-28T15:32:10,Galdakao,expenses,food,-122.89,-65984.42
buyer_4,Jorge,Moreno,1974-05-23,40441389Y,jorge.moreno@superapp.digital,216601,ES46209505951516573022,5874.73,2024-01-28T11:05:18,Galdakao,expenses,leisure,-42.49,-66026.91
buyer_4,Jorge,Moreno,1974-05-23,40441389Y,jorge.moreno@superapp.digital,216601,ES46209505951516573022,5874.73,2024-01-28T11:32:45,Galdakao,expenses,cash,-100.0,-66126.91
buyer_4,Jorge,Moreno,1974-05-23,40441389Y,jorge.moreno@superapp.digital,216601,ES46209505951516573022,5874.73,2024-01-30T13:25:55,Galdakao,expenses,clothing,-153.66,-66280.57
buyer_4,Jorge,Moreno,1974-05-23,40441389Y,jorge.moreno@superapp.digital,216601,ES46209505951516573022,5874.73,2024-02-01T11:47:53,Galdakao,incomes,salary,2549.68,-63730.89
buyer_4,Jorge,Moreno,1974-05-23,40441389Y,jorge.moreno@superapp.digital,216601,ES46209505951516573022,5874.73,2024-02-01T11:47:53,Galdakao,incomes,extra_income,385.48,-63345.41
buyer_4,Jorge,Moreno,1974-05-23,40441389Y,jorge.moreno@superapp.digital,216601,ES46209505951516573022,5874.73,2024-02-03T19:27:13,Galdakao,expenses,food,-69.24,-63414.65
buyer_4,Jorge,Moreno,1974-05-23,40441389Y,jorge.moreno@superapp.digital,216601,ES46209505951516573022,5874.73,2024-02-04T10:39:23,Galdakao,expenses,mortgage,-1034.67,-64449.32
buyer_4,Jorge,Moreno,1974-05-23,40441389Y,jorge.moreno@superapp.digital,216601,ES46209505951516573022,5874.73,2024-02-04T18:40:30,Galdakao,expenses,leisure,-81.69,-64531.01
buyer_4,Jorge,Moreno,1974-05-23,40441389Y,jorge.moreno@superapp.digital,216601,ES46209505951516573022,5874.73,2024-02-04T11:20:55,Galdakao,expenses,cash,-100.0,-64631.01
buyer_4,Jorge,Moreno,1974-05-23,40441389Y,jorge.moreno@superapp.digital,216601,ES46209505951516573022,5874.73,2024-02-06T09:19:41,Galdakao,expenses,water,-29.99,-64661.0
buyer_4,Jorge,Moreno,1974-05-23,40441389Y,jorge.moreno@superapp.digital,216601,ES46209505951516573022,5874.73,2024-02-06T18:22:52,Galdakao,expenses,electricity,-57.6,-64718.6
buyer_4,Jorge,Moreno,1974-05-23,40441389Y,jorge.moreno@superapp.digital,216601,ES46209505951516573022,5874.73,2024-02-06T17:59:46,Galdakao,expenses,internet,-53.54,-64772.14
buyer_4,Jorge,Moreno,1974-05-23,40441389Y,jorge.moreno@superapp.digital,216601,ES46209505951516573022,5874.73,2024-02-06T08:56:52,Galdakao,expenses,leisure,-50.04,-64822.18
buyer_4,Jorge,Moreno,1974-05-23,40441389Y,jorge.moreno@superapp.digital,216601,ES46209505951516573022,5874.73,2024-02-07T18:30:01,Galdakao,expenses,food,-65.91,-64888.09
buyer_4,Jorge,Moreno,1974-05-23,40441389Y,jorge.moreno@superapp.digital,216601,ES46209505951516573022,5874.73,2024-02-08T16:01:27,Galdakao,expenses,electricity,-40.76,-64928.85
buyer_4,Jorge,Moreno,1974-05-23,40441389Y,jorge.moreno@superapp.digital,216601,ES46209505951516573022,5874.73,2024-02-08T21:17:55,Galdakao,expenses,phone,-50.05,-64978.9
buyer_4,Jorge,Moreno,1974-05-23,40441389Y,jorge.moreno@superapp.digital,216601,ES46209505951516573022,5874.73,2024-02-08T12:46:51,Galdakao,expenses,food,-95.81,-65074.71
buyer_4,Jorge,Moreno,1974-05-23,40441389Y,jorge.moreno@superapp.digital,216601,ES46209505951516573022,5874.73,2024-02-08T11:41:01,Galdakao,expenses,transport,-44.82,-65119.53
buyer_4,Jorge,Moreno,1974-05-23,40441389Y,jorge.moreno@superapp.digital,216601,ES46209505951516573022,5874.73,2024-02-09T20:42:44,Galdakao,expenses,transport,-87.49,-65207.02
buyer_4,Jorge,Moreno,1974-05-23,40441389Y,jorge.moreno@superapp.digital,216601,ES46209505951516573022,5874.73,2024-02-11T07:23:33,Galdakao,expenses,food,-79.98,-65287.0
buyer_4,Jorge,Moreno,1974-05-23,40441389Y,jorge.moreno@superapp.digital,216601,ES46209505951516573022,5874.73,2024-02-11T08:06:16,Galdakao,expenses,cash,-100.0,-65387.0
buyer_4,Jorge,Moreno,1974-05-23,40441389Y,jorge.moreno@superapp.digital,216601,ES46209505951516573022,5874.73,2024-02-11T20:53:42,Galdakao,expenses,children,-944.308,-66331.31
buyer_4,Jorge,Moreno,1974-05-23,40441389Y,jorge.moreno@superapp.digital,216601,ES46209505951516573022,5874.73,2024-02-15T10:31:33,Galdakao,expenses,leisure,-46.29,-66377.6
buyer_4,Jorge,Moreno,1974-05-23,40441389Y,jorge.moreno@superapp.digital,216601,ES46209505951516573022,5874.73,2024-02-16T08:35:34,Galdakao,expenses,food,-82.95,-66460.55
buyer_4,Jorge,Moreno,1974-05-23,40441389Y,jorge.moreno@superapp.digital,216601,ES46209505951516573022,5874.73,2024-02-16T21:58:32,Galdakao,expenses,clothing,-90.82,-66551.37
buyer_4,Jorge,Moreno,1974-05-23,40441389Y,jorge.moreno@superapp.digital,216601,ES46209505951516573022,5874.73,2024-02-16T20:23:52,Galdakao,expenses,gifts,-565.19,-67116.56
buyer_4,Jorge,Moreno,1974-05-23,40441389Y,jorge.moreno@superapp.digital,216601,ES46209505951516573022,5874.73,2024-02-20T19:30:13,Galdakao,expenses,education,-47.98,-67164.54
buyer_4,Jorge,Moreno,1974-05-23,40441389Y,jorge.moreno@superapp.digital,216601,ES46209505951516573022,5874.73,2024-02-22T17:20:43,Galdakao,expenses,leisure,-60.34,-67224.88
buyer_4,Jorge,Moreno,1974-05-23,40441389Y,jorge.moreno@superapp.digital,216601,ES46209505951516573022,5874.73,2024-02-22T08:24:57,Galdakao,expenses,education,-44.81,-67269.69
buyer_4,Jorge,Moreno,1974-05-23,40441389Y,jorge.moreno@superapp.digital,216601,ES46209505951516573022,5874.73,2024-02-23T16:57:53,Galdakao,expenses,leisure,-35.27,-67304.96
buyer_4,Jorge,Moreno,1974-05-23,40441389Y,jorge.moreno@superapp.digital,216601,ES46209505951516573022,5874.73,2024-02-24T14:33:50,Galdakao,expenses,cash,-100.0,-67404.96
buyer_4,Jorge,Moreno,1974-05-23,40441389Y,jorge.moreno@superapp.digital,216601,ES46209505951516573022,5874.73,2024-02-25T08:50:08,Galdakao,expenses,food,-99.92,-67504.88
buyer_4,Jorge,Moreno,1974-05-23,40441389Y,jorge.moreno@superapp.digital,216601,ES46209505951516573022,5874.73,2024-02-25T16:18:39,Galdakao,expenses,leisure,-73.96,-67578.84
buyer_4,Jorge,Moreno,1974-05-23,40441389Y,jorge.moreno@superapp.digital,216601,ES46209505951516573022,5874.73,2024-02-25T20:29:27,Galdakao,expenses,appliances,-220.3,-67799.14
buyer_4,Jorge,Moreno,1974-05-23,40441389Y,jorge.moreno@superapp.digital,216601,ES46209505951516573022,5874.73,2024-02-26T06:03:17,Galdakao,expenses,food,-84.31,-67883.45
buyer_4,Jorge,Moreno,1974-05-23,40441389Y,jorge.moreno@superapp.digital,216601,ES46209505951516573022,5874.73,2024-02-29T16:53:45,Galdakao,expenses,leisure,-51.53,-67934.98
buyer_4,Jorge,Moreno,1974-05-23,40441389Y,jorge.moreno@superapp.digital,216601,ES46209505951516573022,5874.73,2024-02-29T04:05:17,Galdakao,expenses,children,-1072.758,-69007.74
buyer_4,Jorge,Moreno,1974-05-23,40441389Y,jorge.moreno@superapp.digital,216601,ES46209505951516573022,5874.73,2024-03-01T13:18:30,Galdakao,incomes,salary,2549.68,-66458.06
buyer_4,Jorge,Moreno,1974-05-23,40441389Y,jorge.moreno@superapp.digital,216601,ES46209505951516573022,5874.73,2024-03-01T17:23:34,Galdakao,expenses,appliances,-398.26,-66856.32
buyer_4,Jorge,Moreno,1974-05-23,40441389Y,jorge.moreno@superapp.digital,216601,ES46209505951516573022,5874.73,2024-03-02T11:37:55,Galdakao,expenses,transport,-69.92,-66926.24
buyer_4,Jorge,Moreno,1974-05-23,40441389Y,jorge.moreno@superapp.digital,216601,ES46209505951516573022,5874.73,2024-03-03T15:24:46,Galdakao,expenses,food,-60.02,-66986.26
buyer_4,Jorge,Moreno,1974-05-23,40441389Y,jorge.moreno@superapp.digital,216601,ES46209505951516573022,5874.73,2024-03-03T19:51:57,Galdakao,expenses,clothing,-58.56,-67044.82
buyer_4,Jorge,Moreno,1974-05-23,40441389Y,jorge.moreno@superapp.digital,216601,ES46209505951516573022,5874.73,2024-03-04T23:17:50,Galdakao,expenses,mortgage,-1034.67,-68079.49
buyer_4,Jorge,Moreno,1974-05-23,40441389Y,jorge.moreno@superapp.digital,216601,ES46209505951516573022,5874.73,2024-03-05T18:18:36,Galdakao,expenses,repairs,-165.51,-68245.0
buyer_4,Jorge,Moreno,1974-05-23,40441389Y,jorge.moreno@superapp.digital,216601,ES46209505951516573022,5874.73,2024-03-05T18:34:44,Galdakao,expenses,gifts,-649.54,-68894.54
buyer_4,Jorge,Moreno,1974-05-23,40441389Y,jorge.moreno@superapp.digital,216601,ES46209505951516573022,5874.73,2024-03-06T14:11:25,Galdakao,expenses,water,-55.61,-68950.15
buyer_4,Jorge,Moreno,1974-05-23,40441389Y,jorge.moreno@superapp.digital,216601,ES46209505951516573022,5874.73,2024-03-06T10:30:03,Galdakao,expenses,phone,-47.65,-68997.8
buyer_4,Jorge,Moreno,1974-05-23,40441389Y,jorge.moreno@superapp.digital,216601,ES46209505951516573022,5874.73,2024-03-06T08:22:52,Galdakao,expenses,food,-95.76,-69093.56
buyer_4,Jorge,Moreno,1974-05-23,40441389Y,jorge.moreno@superapp.digital,216601,ES46209505951516573022,5874.73,2024-03-06T08:11:01,Galdakao,expenses,cash,-100.0,-69193.56
buyer_4,Jorge,Moreno,1974-05-23,40441389Y,jorge.moreno@superapp.digital,216601,ES46209505951516573022,5874.73,2024-03-07T12:47:16,Galdakao,expenses,leisure,-32.33,-69225.89
buyer_4,Jorge,Moreno,1974-05-23,40441389Y,jorge.moreno@superapp.digital,216601,ES46209505951516573022,5874.73,2024-03-07T09:53:50,Galdakao,expenses,repairs,-227.08,-69452.97
buyer_4,Jorge,Moreno,1974-05-23,40441389Y,jorge.moreno@superapp.digital,216601,ES46209505951516573022,5874.73,2024-03-08T09:14:59,Galdakao,expenses,water,-38.05,-69491.02
buyer_4,Jorge,Moreno,1974-05-23,40441389Y,jorge.moreno@superapp.digital,216601,ES46209505951516573022,5874.73,2024-03-08T23:06:32,Galdakao,expenses,food,-69.15,-69560.17
buyer_4,Jorge,Moreno,1974-05-23,40441389Y,jorge.moreno@superapp.digital,216601,ES46209505951516573022,5874.73,2024-03-08T16:14:42,Galdakao,expenses,education,-47.36,-69607.53
buyer_4,Jorge,Moreno,1974-05-23,40441389Y,jorge.moreno@superapp.digital,216601,ES46209505951516573022,5874.73,2024-03-09T20:29:23,Galdakao,expenses,food,-87.86,-69695.39
buyer_4,Jorge,Moreno,1974-05-23,40441389Y,jorge.moreno@superapp.digital,216601,ES46209505951516573022,5874.73,2024-03-10T10:36:35,Galdakao,expenses,cash,-100.0,-69795.39
buyer_4,Jorge,Moreno,1974-05-23,40441389Y,jorge.moreno@superapp.digital,216601,ES46209505951516573022,5874.73,2024-03-13T15:31:38,Galdakao,expenses,food,-64.22,-69859.61
buyer_4,Jorge,Moreno,1974-05-23,40441389Y,jorge.moreno@superapp.digital,216601,ES46209505951516573022,5874.73,2024-03-13T11:22:17,Galdakao,expenses,transport,-86.92,-69946.53
buyer_4,Jorge,Moreno,1974-05-23,40441389Y,jorge.moreno@superapp.digital,216601,ES46209505951516573022,5874.73,2024-03-13T08:39:11,Galdakao,expenses,cash,-100.0,-70046.53
buyer_4,Jorge,Moreno,1974-05-23,40441389Y,jorge.moreno@superapp.digital,216601,ES46209505951516573022,5874.73,2024-03-14T16:32:52,Galdakao,expenses,transport,-86.1,-70132.63
buyer_4,Jorge,Moreno,1974-05-23,40441389Y,jorge.moreno@superapp.digital,216601,ES46209505951516573022,5874.73,2024-03-15T13:29:26,Galdakao,expenses,cash,-100.0,-70232.63
buyer_4,Jorge,Moreno,1974-05-23,40441389Y,jorge.moreno@superapp.digital,216601,ES46209505951516573022,5874.73,2024-03-15T12:42:10,Galdakao,expenses,repairs,-159.92,-70392.55
buyer_4,Jorge,Moreno,1974-05-23,40441389Y,jorge.moreno@superapp.digital,216601,ES46209505951516573022,5874.73,2024-03-15T08:44:24,Galdakao,expenses,gifts,-44.15,-70436.7
buyer_4,Jorge,Moreno,1974-05-23,40441389Y,jorge.moreno@superapp.digital,216601,ES46209505951516573022,5874.73,2024-03-15T20:14:20,Galdakao,expenses,children,-820.2180000000001,-71256.92
buyer_4,Jorge,Moreno,1974-05-23,40441389Y,jorge.moreno@superapp.digital,216601,ES46209505951516573022,5874.73,2024-03-21T08:26:16,Galdakao,expenses,cash,-100.0,-71356.92
buyer_4,Jorge,Moreno,1974-05-23,40441389Y,jorge.moreno@superapp.digital,216601,ES46209505951516573022,5874.73,2024-03-22T14:39:43,Galdakao,expenses,leisure,-28.11,-71385.03
buyer_4,Jorge,Moreno,1974-05-23,40441389Y,jorge.moreno@superapp.digital,216601,ES46209505951516573022,5874.73,2024-03-22T16:07:58,Galdakao,expenses,education,-54.95,-71439.98
buyer_4,Jorge,Moreno,1974-05-23,40441389Y,jorge.moreno@superapp.digital,216601,ES46209505951516573022,5874.73,2024-03-23T10:55:00,Galdakao,expenses,gifts,-178.18,-71618.16
buyer_4,Jorge,Moreno,1974-05-23,40441389Y,jorge.moreno@superapp.digital,216601,ES46209505951516573022,5874.73,2024-03-24T10:59:12,Galdakao,expenses,repairs,-75.59,-71693.75
buyer_4,Jorge,Moreno,1974-05-23,40441389Y,jorge.moreno@superapp.digital,216601,ES46209505951516573022,5874.73,2024-03-26T10:55:12,Galdakao,expenses,food,-111.75,-71805.5
buyer_4,Jorge,Moreno,1974-05-23,40441389Y,jorge.moreno@superapp.digital,216601,ES46209505951516573022,5874.73,2024-03-27T10:54:23,Galdakao,expenses,food,-70.19,-71875.69
buyer_4,Jorge,Moreno,1974-05-23,40441389Y,jorge.moreno@superapp.digital,216601,ES46209505951516573022,5874.73,2024-03-27T05:59:45,Galdakao,expenses,repairs,-272.49,-72148.18
buyer_4,Jorge,Moreno,1974-05-23,40441389Y,jorge.moreno@superapp.digital,216601,ES46209505951516573022,5874.73,2024-03-29T12:20:25,Galdakao,expenses,transport,-74.88,-72223.06
buyer_4,Jorge,Moreno,1974-05-23,40441389Y,jorge.moreno@superapp.digital,216601,ES46209505951516573022,5874.73,2024-04-01T08:49:48,Galdakao,incomes,salary,2549.68,-69673.38
buyer_4,Jorge,Moreno,1974-05-23,40441389Y,jorge.moreno@superapp.digital,216601,ES46209505951516573022,5874.73,2024-04-01T01:19:18,Galdakao,expenses,cash,-100.0,-69773.38
buyer_4,Jorge,Moreno,1974-05-23,40441389Y,jorge.moreno@superapp.digital,216601,ES46209505951516573022,5874.73,2024-04-02T16:37:28,Galdakao,expenses,education,-58.59,-69831.97
buyer_4,Jorge,Moreno,1974-05-23,40441389Y,jorge.moreno@superapp.digital,216601,ES46209505951516573022,5874.73,2024-04-02T19:05:08,Galdakao,expenses,gifts,-208.38,-70040.35
buyer_4,Jorge,Moreno,1974-05-23,40441389Y,jorge.moreno@superapp.digital,216601,ES46209505951516573022,5874.73,2024-04-04T11:45:43,Galdakao,expenses,mortgage,-1034.67,-71075.02
buyer_4,Jorge,Moreno,1974-05-23,40441389Y,jorge.moreno@superapp.digital,216601,ES46209505951516573022,5874.73,2024-04-04T18:25:14,Galdakao,expenses,gifts,-220.88,-71295.9
buyer_4,Jorge,Moreno,1974-05-23,40441389Y,jorge.moreno@superapp.digital,216601,ES46209505951516573022,5874.73,2024-04-05T16:28:15,Galdakao,expenses,internet,-53.54,-71349.44
buyer_4,Jorge,Moreno,1974-05-23,40441389Y,jorge.moreno@superapp.digital,216601,ES46209505951516573022,5874.73,2024-04-05T15:48:41,Galdakao,expenses,cash,-100.0,-71449.44
buyer_4,Jorge,Moreno,1974-05-23,40441389Y,jorge.moreno@superapp.digital,216601,ES46209505951516573022,5874.73,2024-04-06T14:10:28,Galdakao,expenses,gas,-58.02,-71507.46
buyer_4,Jorge,Moreno,1974-05-23,40441389Y,jorge.moreno@superapp.digital,216601,ES46209505951516573022,5874.73,2024-04-06T13:40:03,Galdakao,expenses,internet,-53.54,-71561.0
buyer_4,Jorge,Moreno,1974-05-23,40441389Y,jorge.moreno@superapp.digital,216601,ES46209505951516573022,5874.73,2024-04-06T11:00:14,Galdakao,expenses,phone,-41.11,-71602.11
buyer_4,Jorge,Moreno,1974-05-23,40441389Y,jorge.moreno@superapp.digital,216601,ES46209505951516573022,5874.73,2024-04-07T09:25:03,Galdakao,expenses,gas,-50.12,-71652.23
buyer_4,Jorge,Moreno,1974-05-23,40441389Y,jorge.moreno@superapp.digital,216601,ES46209505951516573022,5874.73,2024-04-07T11:37:04,Galdakao,expenses,internet,-53.54,-71705.77
buyer_4,Jorge,Moreno,1974-05-23,40441389Y,jorge.moreno@superapp.digital,216601,ES46209505951516573022,5874.73,2024-04-07T05:23:02,Galdakao,expenses,phone,-56.14,-71761.91
buyer_4,Jorge,Moreno,1974-05-23,40441389Y,jorge.moreno@superapp.digital,216601,ES46209505951516573022,5874.73,2024-04-08T19:09:03,Galdakao,expenses,gas,-86.24,-71848.15
buyer_4,Jorge,Moreno,1974-05-23,40441389Y,jorge.moreno@superapp.digital,216601,ES46209505951516573022,5874.73,2024-04-10T21:18:36,Galdakao,expenses,cash,-100.0,-71948.15
buyer_4,Jorge,Moreno,1974-05-23,40441389Y,jorge.moreno@superapp.digital,216601,ES46209505951516573022,5874.73,2024-04-11T15:40:04,Galdakao,expenses,transport,-54.37,-72002.52
buyer_4,Jorge,Moreno,1974-05-23,40441389Y,jorge.moreno@superapp.digital,216601,ES46209505951516573022,5874.73,2024-04-13T20:15:06,Galdakao,expenses,food,-79.29,-72081.81
buyer_4,Jorge,Moreno,1974-05-23,40441389Y,jorge.moreno@superapp.digital,216601,ES46209505951516573022,5874.73,2024-04-13T18:37:26,Galdakao,expenses,leisure,-63.05,-72144.86
buyer_4,Jorge,Moreno,1974-05-23,40441389Y,jorge.moreno@superapp.digital,216601,ES46209505951516573022,5874.73,2024-04-13T20:54:24,Galdakao,expenses,cash,-100.0,-72244.86
buyer_4,Jorge,Moreno,1974-05-23,40441389Y,jorge.moreno@superapp.digital,216601,ES46209505951516573022,5874.73,2024-04-14T19:26:40,Galdakao,expenses,cash,-100.0,-72344.86
buyer_4,Jorge,Moreno,1974-05-23,40441389Y,jorge.moreno@superapp.digital,216601,ES46209505951516573022,5874.73,2024-04-15T11:36:13,Galdakao,expenses,transport,-81.84,-72426.7
buyer_4,Jorge,Moreno,1974-05-23,40441389Y,jorge.moreno@superapp.digital,216601,ES46209505951516573022,5874.73,2024-04-15T08:36:40,Galdakao,expenses,clothing,-54.02,-72480.72
buyer_4,Jorge,Moreno,1974-05-23,40441389Y,jorge.moreno@superapp.digital,216601,ES46209505951516573022,5874.73,2024-04-17T18:04:48,Galdakao,expenses,transport,-89.07,-72569.79
buyer_4,Jorge,Moreno,1974-05-23,40441389Y,jorge.moreno@superapp.digital,216601,ES46209505951516573022,5874.73,2024-04-18T09:00:52,Galdakao,expenses,food,-101.62,-72671.41
buyer_4,Jorge,Moreno,1974-05-23,40441389Y,jorge.moreno@superapp.digital,216601,ES46209505951516573022,5874.73,2024-04-18T15:04:47,Galdakao,expenses,cash,-100.0,-72771.41
buyer_4,Jorge,Moreno,1974-05-23,40441389Y,jorge.moreno@superapp.digital,216601,ES46209505951516573022,5874.73,2024-04-18T18:16:09,Galdakao,expenses,children,-922.668,-73694.08
buyer_4,Jorge,Moreno,1974-05-23,40441389Y,jorge.moreno@superapp.digital,216601,ES46209505951516573022,5874.73,2024-04-22T11:37:07,Galdakao,expenses,repairs,-258.37,-73952.45
buyer_4,Jorge,Moreno,1974-05-23,40441389Y,jorge.moreno@superapp.digital,216601,ES46209505951516573022,5874.73,2024-04-23T19:28:10,Galdakao,expenses,leisure,-30.03,-73982.48
buyer_4,Jorge,Moreno,1974-05-23,40441389Y,jorge.moreno@superapp.digital,216601,ES46209505951516573022,5874.73,2024-04-24T18:18:31,Galdakao,expenses,education,-69.78,-74052.26
buyer_4,Jorge,Moreno,1974-05-23,40441389Y,jorge.moreno@superapp.digital,216601,ES46209505951516573022,5874.73,2024-04-24T19:37:49,Galdakao,expenses,cash,-100.0,-74152.26
buyer_4,Jorge,Moreno,1974-05-23,40441389Y,jorge.moreno@superapp.digital,216601,ES46209505951516573022,5874.73,2024-04-25T15:42:00,Galdakao,expenses,healthcare,-87.19,-74239.45
buyer_4,Jorge,Moreno,1974-05-23,40441389Y,jorge.moreno@superapp.digital,216601,ES46209505951516573022,5874.73,2024-04-26T03:20:47,Galdakao,expenses,food,-64.29,-74303.74
buyer_4,Jorge,Moreno,1974-05-23,40441389Y,jorge.moreno@superapp.digital,216601,ES46209505951516573022,5874.73,2024-04-27T13:37:20,Galdakao,expenses,cash,-100.0,-74403.74
buyer_4,Jorge,Moreno,1974-05-23,40441389Y,jorge.moreno@superapp.digital,216601,ES46209505951516573022,5874.73,2024-04-29T09:43:50,Galdakao,expenses,food,-84.99,-74488.73
buyer_4,Jorge,Moreno,1974-05-23,40441389Y,jorge.moreno@superapp.digital,216601,ES46209505951516573022,5874.73,2024-04-29T11:56:06,Galdakao,expenses,education,-47.68,-74536.41
buyer_4,Jorge,Moreno,1974-05-23,40441389Y,jorge.moreno@superapp.digital,216601,ES46209505951516573022,5874.73,2024-04-30T14:21:10,Galdakao,expenses,clothing,-56.02,-74592.43
buyer_4,Jorge,Moreno,1974-05-23,40441389Y,jorge.moreno@superapp.digital,216601,ES46209505951516573022,5874.73,2024-04-30T15:05:43,Galdakao,expenses,children,-420.86,-75013.29
buyer_4,Jorge,Moreno,1974-05-23,40441389Y,jorge.moreno@superapp.digital,216601,ES46209505951516573022,5874.73,2024-05-01T12:07:29,Galdakao,incomes,salary,2549.68,-72463.61
buyer_4,Jorge,Moreno,1974-05-23,40441389Y,jorge.moreno@superapp.digital,216601,ES46209505951516573022,5874.73,2024-05-01T12:07:29,Galdakao,incomes,extra_income,385.48,-72078.13
buyer_4,Jorge,Moreno,1974-05-23,40441389Y,jorge.moreno@superapp.digital,216601,ES46209505951516573022,5874.73,2024-05-01T17:07:33,Galdakao,expenses,transport,-70.17,-72148.3
buyer_4,Jorge,Moreno,1974-05-23,40441389Y,jorge.moreno@superapp.digital,216601,ES46209505951516573022,5874.73,2024-05-02T12:14:31,Galdakao,expenses,leisure,-40.41,-72188.71
buyer_4,Jorge,Moreno,1974-05-23,40441389Y,jorge.moreno@superapp.digital,216601,ES46209505951516573022,5874.73,2024-05-04T09:15:55,Galdakao,expenses,mortgage,-1034.67,-73223.38
buyer_4,Jorge,Moreno,1974-05-23,40441389Y,jorge.moreno@superapp.digital,216601,ES46209505951516573022,5874.73,2024-05-05T11:20:21,Galdakao,expenses,water,-31.06,-73254.44
buyer_4,Jorge,Moreno,1974-05-23,40441389Y,jorge.moreno@superapp.digital,216601,ES46209505951516573022,5874.73,2024-05-05T11:06:31,Galdakao,expenses,transport,-67.33,-73321.77
buyer_4,Jorge,Moreno,1974-05-23,40441389Y,jorge.moreno@superapp.digital,216601,ES46209505951516573022,5874.73,2024-05-05T22:38:37,Galdakao,expenses,gifts,-328.17,-73649.94
buyer_4,Jorge,Moreno,1974-05-23,40441389Y,jorge.moreno@superapp.digital,216601,ES46209505951516573022,5874.73,2024-05-06T11:00:43,Galdakao,expenses,internet,-53.54,-73703.48
buyer_4,Jorge,Moreno,1974-05-23,40441389Y,jorge.moreno@superapp.digital,216601,ES46209505951516573022,5874.73,2024-05-06T14:50:52,Galdakao,expenses,transport,-48.06,-73751.54
buyer_4,Jorge,Moreno,1974-05-23,40441389Y,jorge.moreno@superapp.digital,216601,ES46209505951516573022,5874.73,2024-05-06T08:54:36,Galdakao,expenses,cash,-100.0,-73851.54
buyer_4,Jorge,Moreno,1974-05-23,40441389Y,jorge.moreno@superapp.digital,216601,ES46209505951516573022,5874.73,2024-05-07T15:48:38,Galdakao,expenses,electricity,-56.63,-73908.17
buyer_4,Jorge,Moreno,1974-05-23,40441389Y,jorge.moreno@superapp.digital,216601,ES46209505951516573022,5874.73,2024-05-07T01:48:14,Galdakao,expenses,gas,-46.97,-73955.14
buyer_4,Jorge,Moreno,1974-05-23,40441389Y,jorge.moreno@superapp.digital,216601,ES46209505951516573022,5874.73,2024-05-07T09:57:10,Galdakao,expenses,travel,-644.5,-74599.64
buyer_4,Jorge,Moreno,1974-05-23,40441389Y,jorge.moreno@superapp.digital,216601,ES46209505951516573022,5874.73,2024-05-08T12:45:34,Galdakao,expenses,electricity,-109.48,-74709.12
buyer_4,Jorge,Moreno,1974-05-23,40441389Y,jorge.moreno@superapp.digital,216601,ES46209505951516573022,5874.73,2024-05-08T08:34:55,Galdakao,expenses,food,-85.9,-74795.02
buyer_4,Jorge,Moreno,1974-05-23,40441389Y,jorge.moreno@superapp.digital,216601,ES46209505951516573022,5874.73,2024-05-08T01:14:22,Galdakao,expenses,transport,-48.96,-74843.98
buyer_4,Jorge,Moreno,1974-05-23,40441389Y,jorge.moreno@superapp.digital,216601,ES46209505951516573022,5874.73,2024-05-10T17:55:15,Galdakao,expenses,cash,-100.0,-74943.98
buyer_4,Jorge,Moreno,1974-05-23,40441389Y,jorge.moreno@superapp.digital,216601,ES46209505951516573022,5874.73,2024-05-10T23:28:04,Galdakao,expenses,repairs,-302.67,-75246.65
buyer_4,Jorge,Moreno,1974-05-23,40441389Y,jorge.moreno@superapp.digital,216601,ES46209505951516573022,5874.73,2024-05-11T22:26:29,Galdakao,expenses,children,-1078.51,-76325.16
buyer_4,Jorge,Moreno,1974-05-23,40441389Y,jorge.moreno@superapp.digital,216601,ES46209505951516573022,5874.73,2024-05-13T16:47:54,Galdakao,expenses,food,-76.72,-76401.88
buyer_4,Jorge,Moreno,1974-05-23,40441389Y,jorge.moreno@superapp.digital,216601,ES46209505951516573022,5874.73,2024-05-15T08:46:38,Galdakao,expenses,transport,-65.12,-76467.0
buyer_4,Jorge,Moreno,1974-05-23,40441389Y,jorge.moreno@superapp.digital,216601,ES46209505951516573022,5874.73,2024-05-18T11:38:59,Galdakao,expenses,transport,-82.35,-76549.35
buyer_4,Jorge,Moreno,1974-05-23,40441389Y,jorge.moreno@superapp.digital,216601,ES46209505951516573022,5874.73,2024-05-20T15:01:43,Galdakao,expenses,food,-104.77,-76654.12
buyer_4,Jorge,Moreno,1974-05-23,40441389Y,jorge.moreno@superapp.digital,216601,ES46209505951516573022,5874.73,2024-05-21T05:08:08,Galdakao,expenses,appliances,-77.44,-76731.56
buyer_4,Jorge,Moreno,1974-05-23,40441389Y,jorge.moreno@superapp.digital,216601,ES46209505951516573022,5874.73,2024-05-22T10:58:48,Galdakao,expenses,gifts,-549.42,-77280.98
buyer_4,Jorge,Moreno,1974-05-23,40441389Y,jorge.moreno@superapp.digital,216601,ES46209505951516573022,5874.73,2024-05-24T09:20:53,Galdakao,expenses,cash,-100.0,-77380.98
buyer_4,Jorge,Moreno,1974-05-23,40441389Y,jorge.moreno@superapp.digital,216601,ES46209505951516573022,5874.73,2024-05-31T12:10:14,Galdakao,expenses,food,-86.42,-77467.4
buyer_4,Jorge,Moreno,1974-05-23,40441389Y,jorge.moreno@superapp.digital,216601,ES46209505951516573022,5874.73,2024-05-31T19:03:22,Galdakao,expenses,transport,-77.01,-77544.41
buyer_4,Jorge,Moreno,1974-05-23,40441389Y,jorge.moreno@superapp.digital,216601,ES46209505951516573022,5874.73,2024-06-01T09:44:32,Galdakao,incomes,salary,2549.68,-74994.73
buyer_4,Jorge,Moreno,1974-05-23,40441389Y,jorge.moreno@superapp.digital,216601,ES46209505951516573022,5874.73,2024-06-01T09:44:32,Galdakao,incomes,salary_bonus,1891.85,-73102.88
buyer_4,Jorge,Moreno,1974-05-23,40441389Y,jorge.moreno@superapp.digital,216601,ES46209505951516573022,5874.73,2024-06-01T09:34:40,Galdakao,expenses,transport,-86.02,-73188.9
buyer_4,Jorge,Moreno,1974-05-23,40441389Y,jorge.moreno@superapp.digital,216601,ES46209505951516573022,5874.73,2024-06-02T15:39:36,Galdakao,expenses,taxes,-2114.68,-75303.58
buyer_4,Jorge,Moreno,1974-05-23,40441389Y,jorge.moreno@superapp.digital,216601,ES46209505951516573022,5874.73,2024-06-02T11:45:26,Galdakao,expenses,insurance,-651.93,-75955.51
buyer_4,Jorge,Moreno,1974-05-23,40441389Y,jorge.moreno@superapp.digital,216601,ES46209505951516573022,5874.73,2024-06-02T20:50:09,Galdakao,expenses,food,-117.83,-76073.34
buyer_4,Jorge,Moreno,1974-05-23,40441389Y,jorge.moreno@superapp.digital,216601,ES46209505951516573022,5874.73,2024-06-02T22:43:32,Galdakao,expenses,cash,-100.0,-76173.34
buyer_4,Jorge,Moreno,1974-05-23,40441389Y,jorge.moreno@superapp.digital,216601,ES46209505951516573022,5874.73,2024-06-03T01:35:20,Galdakao,expenses,cash,-100.0,-76273.34
buyer_4,Jorge,Moreno,1974-05-23,40441389Y,jorge.moreno@superapp.digital,216601,ES46209505951516573022,5874.73,2024-06-03T10:12:11,Galdakao,expenses,travel,-373.56,-76646.9
buyer_4,Jorge,Moreno,1974-05-23,40441389Y,jorge.moreno@superapp.digital,216601,ES46209505951516573022,5874.73,2024-06-04T11:36:48,Galdakao,expenses,mortgage,-1034.67,-77681.57
buyer_4,Jorge,Moreno,1974-05-23,40441389Y,jorge.moreno@superapp.digital,216601,ES46209505951516573022,5874.73,2024-06-04T18:30:49,Galdakao,expenses,food,-87.34,-77768.91
buyer_4,Jorge,Moreno,1974-05-23,40441389Y,jorge.moreno@superapp.digital,216601,ES46209505951516573022,5874.73,2024-06-05T22:20:14,Galdakao,expenses,internet,-53.54,-77822.45
buyer_4,Jorge,Moreno,1974-05-23,40441389Y,jorge.moreno@superapp.digital,216601,ES46209505951516573022,5874.73,2024-06-05T20:20:43,Galdakao,expenses,cash,-100.0,-77922.45
buyer_4,Jorge,Moreno,1974-05-23,40441389Y,jorge.moreno@superapp.digital,216601,ES46209505951516573022,5874.73,2024-06-06T19:23:23,Galdakao,expenses,clothing,-132.07,-78054.52
buyer_4,Jorge,Moreno,1974-05-23,40441389Y,jorge.moreno@superapp.digital,216601,ES46209505951516573022,5874.73,2024-06-06T03:56:51,Galdakao,expenses,gifts,-227.88,-78282.4
buyer_4,Jorge,Moreno,1974-05-23,40441389Y,jorge.moreno@superapp.digital,216601,ES46209505951516573022,5874.73,2024-06-08T18:44:07,Galdakao,expenses,phone,-47.02,-78329.42
buyer_4,Jorge,Moreno,1974-05-23,40441389Y,jorge.moreno@superapp.digital,216601,ES46209505951516573022,5874.73,2024-06-08T11:01:13,Galdakao,expenses,education,-62.72,-78392.14
buyer_4,Jorge,Moreno,1974-05-23,40441389Y,jorge.moreno@superapp.digital,216601,ES46209505951516573022,5874.73,2024-06-08T13:00:25,Galdakao,expenses,cash,-100.0,-78492.14
buyer_4,Jorge,Moreno,1974-05-23,40441389Y,jorge.moreno@superapp.digital,216601,ES46209505951516573022,5874.73,2024-06-10T09:47:27,Galdakao,expenses,children,-1124.288,-79616.43
buyer_4,Jorge,Moreno,1974-05-23,40441389Y,jorge.moreno@superapp.digital,216601,ES46209505951516573022,5874.73,2024-06-13T10:16:06,Galdakao,expenses,leisure,-57.35,-79673.78
buyer_4,Jorge,Moreno,1974-05-23,40441389Y,jorge.moreno@superapp.digital,216601,ES46209505951516573022,5874.73,2024-06-14T15:02:32,Galdakao,expenses,gifts,-667.71,-80341.49
buyer_4,Jorge,Moreno,1974-05-23,40441389Y,jorge.moreno@superapp.digital,216601,ES46209505951516573022,5874.73,2024-06-17T23:08:27,Galdakao,expenses,transport,-51.6,-80393.09
buyer_4,Jorge,Moreno,1974-05-23,40441389Y,jorge.moreno@superapp.digital,216601,ES46209505951516573022,5874.73,2024-06-18T12:55:13,Galdakao,expenses,cash,-100.0,-80493.09
buyer_4,Jorge,Moreno,1974-05-23,40441389Y,jorge.moreno@superapp.digital,216601,ES46209505951516573022,5874.73,2024-06-18T08:51:27,Galdakao,expenses,appliances,-151.99,-80645.08
buyer_4,Jorge,Moreno,1974-05-23,40441389Y,jorge.moreno@superapp.digital,216601,ES46209505951516573022,5874.73,2024-06-19T11:02:44,Galdakao,expenses,cash,-100.0,-80745.08
buyer_4,Jorge,Moreno,1974-05-23,40441389Y,jorge.moreno@superapp.digital,216601,ES46209505951516573022,5874.73,2024-06-19T16:40:31,Galdakao,expenses,repairs,-185.89,-80930.97
buyer_4,Jorge,Moreno,1974-05-23,40441389Y,jorge.moreno@superapp.digital,216601,ES46209505951516573022,5874.73,2024-06-21T17:29:47,Galdakao,expenses,food,-106.65,-81037.62
buyer_4,Jorge,Moreno,1974-05-23,40441389Y,jorge.moreno@superapp.digital,216601,ES46209505951516573022,5874.73,2024-06-22T10:57:03,Galdakao,expenses,transport,-47.07,-81084.69
buyer_4,Jorge,Moreno,1974-05-23,40441389Y,jorge.moreno@superapp.digital,216601,ES46209505951516573022,5874.73,2024-06-24T14:17:09,Galdakao,expenses,transport,-67.93,-81152.62
buyer_4,Jorge,Moreno,1974-05-23,40441389Y,jorge.moreno@superapp.digital,216601,ES46209505951516573022,5874.73,2024-06-24T16:26:03,Galdakao,expenses,leisure,-64.65,-81217.27
buyer_4,Jorge,Moreno,1974-05-23,40441389Y,jorge.moreno@superapp.digital,216601,ES46209505951516573022,5874.73,2024-06-24T20:02:11,Galdakao,expenses,clothing,-97.11,-81314.38
buyer_4,Jorge,Moreno,1974-05-23,40441389Y,jorge.moreno@superapp.digital,216601,ES46209505951516573022,5874.73,2024-06-26T08:58:56,Galdakao,expenses,clothing,-65.2,-81379.58
buyer_4,Jorge,Moreno,1974-05-23,40441389Y,jorge.moreno@superapp.digital,216601,ES46209505951516573022,5874.73,2024-06-26T08:09:18,Galdakao,expenses,education,-66.78,-81446.36
buyer_4,Jorge,Moreno,1974-05-23,40441389Y,jorge.moreno@superapp.digital,216601,ES46209505951516573022,5874.73,2024-06-28T05:00:10,Galdakao,expenses,food,-106.0,-81552.36
buyer_4,Jorge,Moreno,1974-05-23,40441389Y,jorge.moreno@superapp.digital,216601,ES46209505951516573022,5874.73,2024-07-01T19:04:04,Galdakao,incomes,salary,2549.68,-79002.68
buyer_4,Jorge,Moreno,1974-05-23,40441389Y,jorge.moreno@superapp.digital,216601,ES46209505951516573022,5874.73,2024-07-03T08:25:29,Galdakao,expenses,education,-58.18,-79060.86
buyer_4,Jorge,Moreno,1974-05-23,40441389Y,jorge.moreno@superapp.digital,216601,ES46209505951516573022,5874.73,2024-07-04T16:38:32,Galdakao,expenses,mortgage,-1034.67,-80095.53
buyer_4,Jorge,Moreno,1974-05-23,40441389Y,jorge.moreno@superapp.digital,216601,ES46209505951516573022,5874.73,2024-07-04T14:34:03,Galdakao,expenses,clothing,-79.8,-80175.33
buyer_4,Jorge,Moreno,1974-05-23,40441389Y,jorge.moreno@superapp.digital,216601,ES46209505951516573022,5874.73,2024-07-04T20:11:44,Galdakao,expenses,appliances,-354.38,-80529.71
buyer_4,Jorge,Moreno,1974-05-23,40441389Y,jorge.moreno@superapp.digital,216601,ES46209505951516573022,5874.73,2024-07-05T18:29:04,Galdakao,expenses,gas,-125.56,-80655.27
buyer_4,Jorge,Moreno,1974-05-23,40441389Y,jorge.moreno@superapp.digital,216601,ES46209505951516573022,5874.73,2024-07-05T16:04:52,Galdakao,expenses,internet,-53.54,-80708.81
buyer_4,Jorge,Moreno,1974-05-23,40441389Y,jorge.moreno@superapp.digital,216601,ES46209505951516573022,5874.73,2024-07-06T20:23:11,Galdakao,expenses,water,-44.79,-80753.6
buyer_4,Jorge,Moreno,1974-05-23,40441389Y,jorge.moreno@superapp.digital,216601,ES46209505951516573022,5874.73,2024-07-06T08:24:40,Galdakao,expenses,electricity,-70.33,-80823.93
buyer_4,Jorge,Moreno,1974-05-23,40441389Y,jorge.moreno@superapp.digital,216601,ES46209505951516573022,5874.73,2024-07-06T20:10:23,Galdakao,expenses,internet,-53.54,-80877.47
buyer_4,Jorge,Moreno,1974-05-23,40441389Y,jorge.moreno@superapp.digital,216601,ES46209505951516573022,5874.73,2024-07-07T23:41:05,Galdakao,expenses,water,-29.56,-80907.03
buyer_4,Jorge,Moreno,1974-05-23,40441389Y,jorge.moreno@superapp.digital,216601,ES46209505951516573022,5874.73,2024-07-07T10:31:16,Galdakao,expenses,electricity,-27.51,-80934.54
buyer_4,Jorge,Moreno,1974-05-23,40441389Y,jorge.moreno@superapp.digital,216601,ES46209505951516573022,5874.73,2024-07-07T12:33:44,Galdakao,expenses,phone,-47.44,-80981.98
buyer_4,Jorge,Moreno,1974-05-23,40441389Y,jorge.moreno@superapp.digital,216601,ES46209505951516573022,5874.73,2024-07-07T18:14:04,Galdakao,expenses,transport,-59.94,-81041.92
buyer_4,Jorge,Moreno,1974-05-23,40441389Y,jorge.moreno@superapp.digital,216601,ES46209505951516573022,5874.73,2024-07-08T13:40:17,Galdakao,expenses,cash,-100.0,-81141.92
buyer_4,Jorge,Moreno,1974-05-23,40441389Y,jorge.moreno@superapp.digital,216601,ES46209505951516573022,5874.73,2024-07-12T09:36:30,Galdakao,expenses,leisure,-41.3,-81183.22
buyer_4,Jorge,Moreno,1974-05-23,40441389Y,jorge.moreno@superapp.digital,216601,ES46209505951516573022,5874.73,2024-07-12T16:48:21,Galdakao,expenses,appliances,-129.21,-81312.43
buyer_4,Jorge,Moreno,1974-05-23,40441389Y,jorge.moreno@superapp.digital,216601,ES46209505951516573022,5874.73,2024-07-13T18:30:45,Galdakao,expenses,leisure,-27.42,-81339.85
buyer_4,Jorge,Moreno,1974-05-23,40441389Y,jorge.moreno@superapp.digital,216601,ES46209505951516573022,5874.73,2024-07-13T09:52:34,Galdakao,expenses,cash,-100.0,-81439.85
buyer_4,Jorge,Moreno,1974-05-23,40441389Y,jorge.moreno@superapp.digital,216601,ES46209505951516573022,5874.73,2024-07-16T08:21:48,Galdakao,expenses,cash,-100.0,-81539.85
buyer_4,Jorge,Moreno,1974-05-23,40441389Y,jorge.moreno@superapp.digital,216601,ES46209505951516573022,5874.73,2024-07-16T15:19:53,Galdakao,expenses,children,-1024.288,-82564.14
buyer_4,Jorge,Moreno,1974-05-23,40441389Y,jorge.moreno@superapp.digital,216601,ES46209505951516573022,5874.73,2024-07-17T02:08:04,Galdakao,expenses,transport,-56.88,-82621.02
buyer_4,Jorge,Moreno,1974-05-23,40441389Y,jorge.moreno@superapp.digital,216601,ES46209505951516573022,5874.73,2024-07-17T19:31:40,Galdakao,expenses,repairs,-275.08,-82896.1
buyer_4,Jorge,Moreno,1974-05-23,40441389Y,jorge.moreno@superapp.digital,216601,ES46209505951516573022,5874.73,2024-07-18T18:02:09,Galdakao,expenses,transport,-76.86,-82972.96
buyer_4,Jorge,Moreno,1974-05-23,40441389Y,jorge.moreno@superapp.digital,216601,ES46209505951516573022,5874.73,2024-07-18T19:47:02,Galdakao,expenses,clothing,-78.39,-83051.35
buyer_4,Jorge,Moreno,1974-05-23,40441389Y,jorge.moreno@superapp.digital,216601,ES46209505951516573022,5874.73,2024-07-20T06:27:36,Galdakao,expenses,appliances,-367.64,-83418.99
buyer_4,Jorge,Moreno,1974-05-23,40441389Y,jorge.moreno@superapp.digital,216601,ES46209505951516573022,5874.73,2024-07-20T08:37:17,Galdakao,expenses,repairs,-192.4,-83611.39
buyer_4,Jorge,Moreno,1974-05-23,40441389Y,jorge.moreno@superapp.digital,216601,ES46209505951516573022,5874.73,2024-07-21T17:12:06,Galdakao,expenses,repairs,-186.74,-83798.13
buyer_4,Jorge,Moreno,1974-05-23,40441389Y,jorge.moreno@superapp.digital,216601,ES46209505951516573022,5874.73,2024-07-21T19:26:35,Galdakao,expenses,gifts,-589.68,-84387.81
buyer_4,Jorge,Moreno,1974-05-23,40441389Y,jorge.moreno@superapp.digital,216601,ES46209505951516573022,5874.73,2024-07-21T10:27:22,Galdakao,expenses,children,-347.86800000000005,-84735.68
buyer_4,Jorge,Moreno,1974-05-23,40441389Y,jorge.moreno@superapp.digital,216601,ES46209505951516573022,5874.73,2024-07-22T18:18:44,Galdakao,expenses,appliances,-418.43,-85154.11
buyer_4,Jorge,Moreno,1974-05-23,40441389Y,jorge.moreno@superapp.digital,216601,ES46209505951516573022,5874.73,2024-07-22T12:45:38,Galdakao,expenses,gifts,-576.75,-85730.86
buyer_4,Jorge,Moreno,1974-05-23,40441389Y,jorge.moreno@superapp.digital,216601,ES46209505951516573022,5874.73,2024-07-23T17:18:22,Galdakao,expenses,leisure,-30.03,-85760.89
buyer_4,Jorge,Moreno,1974-05-23,40441389Y,jorge.moreno@superapp.digital,216601,ES46209505951516573022,5874.73,2024-07-24T20:04:18,Galdakao,expenses,transport,-82.34,-85843.23
buyer_4,Jorge,Moreno,1974-05-23,40441389Y,jorge.moreno@superapp.digital,216601,ES46209505951516573022,5874.73,2024-07-25T20:57:54,Galdakao,expenses,gifts,-410.71,-86253.94
buyer_4,Jorge,Moreno,1974-05-23,40441389Y,jorge.moreno@superapp.digital,216601,ES46209505951516573022,5874.73,2024-07-26T19:29:38,Galdakao,expenses,cash,-100.0,-86353.94
buyer_4,Jorge,Moreno,1974-05-23,40441389Y,jorge.moreno@superapp.digital,216601,ES46209505951516573022,5874.73,2024-07-27T19:49:20,Galdakao,expenses,food,-90.0,-86443.94
buyer_4,Jorge,Moreno,1974-05-23,40441389Y,jorge.moreno@superapp.digital,216601,ES46209505951516573022,5874.73,2024-07-28T10:18:06,Galdakao,expenses,cash,-100.0,-86543.94
buyer_4,Jorge,Moreno,1974-05-23,40441389Y,jorge.moreno@superapp.digital,216601,ES46209505951516573022,5874.73,2024-07-29T16:33:09,Galdakao,expenses,gifts,-145.54,-86689.48
buyer_4,Jorge,Moreno,1974-05-23,40441389Y,jorge.moreno@superapp.digital,216601,ES46209505951516573022,5874.73,2024-07-31T20:39:35,Galdakao,expenses,leisure,-26.61,-86716.09
buyer_4,Jorge,Moreno,1974-05-23,40441389Y,jorge.moreno@superapp.digital,216601,ES46209505951516573022,5874.73,2024-08-01T17:49:08,Galdakao,incomes,salary,2549.68,-84166.41
buyer_4,Jorge,Moreno,1974-05-23,40441389Y,jorge.moreno@superapp.digital,216601,ES46209505951516573022,5874.73,2024-08-01T21:52:28,Galdakao,expenses,leisure,-60.82,-84227.23
buyer_4,Jorge,Moreno,1974-05-23,40441389Y,jorge.moreno@superapp.digital,216601,ES46209505951516573022,5874.73,2024-08-01T18:21:48,Galdakao,expenses,children,-1063.468,-85290.7
buyer_4,Jorge,Moreno,1974-05-23,40441389Y,jorge.moreno@superapp.digital,216601,ES46209505951516573022,5874.73,2024-08-02T08:39:06,Galdakao,expenses,transport,-43.47,-85334.17
buyer_4,Jorge,Moreno,1974-05-23,40441389Y,jorge.moreno@superapp.digital,216601,ES46209505951516573022,5874.73,2024-08-04T19:03:49,Galdakao,expenses,mortgage,-1034.67,-86368.84
buyer_4,Jorge,Moreno,1974-05-23,40441389Y,jorge.moreno@superapp.digital,216601,ES46209505951516573022,5874.73,2024-08-04T16:32:09,Galdakao,expenses,clothing,-70.43,-86439.27
buyer_4,Jorge,Moreno,1974-05-23,40441389Y,jorge.moreno@superapp.digital,216601,ES46209505951516573022,5874.73,2024-08-05T00:42:05,Galdakao,expenses,electricity,-99.95,-86539.22
buyer_4,Jorge,Moreno,1974-05-23,40441389Y,jorge.moreno@superapp.digital,216601,ES46209505951516573022,5874.73,2024-08-05T15:11:12,Galdakao,expenses,gas,-93.66,-86632.88
buyer_4,Jorge,Moreno,1974-05-23,40441389Y,jorge.moreno@superapp.digital,216601,ES46209505951516573022,5874.73,2024-08-05T12:42:32,Galdakao,expenses,healthcare,-155.59,-86788.47
buyer_4,Jorge,Moreno,1974-05-23,40441389Y,jorge.moreno@superapp.digital,216601,ES46209505951516573022,5874.73,2024-08-06T09:58:23,Galdakao,expenses,water,-47.58,-86836.05
buyer_4,Jorge,Moreno,1974-05-23,40441389Y,jorge.moreno@superapp.digital,216601,ES46209505951516573022,5874.73,2024-08-06T12:46:33,Galdakao,expenses,gas,-58.73,-86894.78
buyer_4,Jorge,Moreno,1974-05-23,40441389Y,jorge.moreno@superapp.digital,216601,ES46209505951516573022,5874.73,2024-08-06T10:46:52,Galdakao,expenses,food,-61.01,-86955.79
buyer_4,Jorge,Moreno,1974-05-23,40441389Y,jorge.moreno@superapp.digital,216601,ES46209505951516573022,5874.73,2024-08-06T12:48:35,Galdakao,expenses,appliances,-178.17,-87133.96
buyer_4,Jorge,Moreno,1974-05-23,40441389Y,jorge.moreno@superapp.digital,216601,ES46209505951516573022,5874.73,2024-08-07T18:39:51,Galdakao,expenses,electricity,-113.32,-87247.28
buyer_4,Jorge,Moreno,1974-05-23,40441389Y,jorge.moreno@superapp.digital,216601,ES46209505951516573022,5874.73,2024-08-07T08:50:13,Galdakao,expenses,internet,-53.54,-87300.82
buyer_4,Jorge,Moreno,1974-05-23,40441389Y,jorge.moreno@superapp.digital,216601,ES46209505951516573022,5874.73,2024-08-07T18:06:18,Galdakao,expenses,cash,-100.0,-87400.82
buyer_4,Jorge,Moreno,1974-05-23,40441389Y,jorge.moreno@superapp.digital,216601,ES46209505951516573022,5874.73,2024-08-08T14:52:03,Galdakao,expenses,electricity,-105.78,-87506.6
buyer_4,Jorge,Moreno,1974-05-23,40441389Y,jorge.moreno@superapp.digital,216601,ES46209505951516573022,5874.73,2024-08-08T21:53:52,Galdakao,expenses,phone,-51.74,-87558.34
buyer_4,Jorge,Moreno,1974-05-23,40441389Y,jorge.moreno@superapp.digital,216601,ES46209505951516573022,5874.73,2024-08-08T21:12:43,Galdakao,expenses,cash,-100.0,-87658.34
buyer_4,Jorge,Moreno,1974-05-23,40441389Y,jorge.moreno@superapp.digital,216601,ES46209505951516573022,5874.73,2024-08-11T20:55:39,Galdakao,expenses,transport,-61.34,-87719.68
buyer_4,Jorge,Moreno,1974-05-23,40441389Y,jorge.moreno@superapp.digital,216601,ES46209505951516573022,5874.73,2024-08-11T11:15:08,Galdakao,expenses,appliances,-146.21,-87865.89
buyer_4,Jorge,Moreno,1974-05-23,40441389Y,jorge.moreno@superapp.digital,216601,ES46209505951516573022,5874.73,2024-08-12T15:34:07,Galdakao,expenses,leisure,-34.63,-87900.52
buyer_4,Jorge,Moreno,1974-05-23,40441389Y,jorge.moreno@superapp.digital,216601,ES46209505951516573022,5874.73,2024-08-13T13:05:38,Galdakao,expenses,leisure,-18.48,-87919.0
buyer_4,Jorge,Moreno,1974-05-23,40441389Y,jorge.moreno@superapp.digital,216601,ES46209505951516573022,5874.73,2024-08-15T05:28:49,Galdakao,expenses,food,-102.49,-88021.49
buyer_4,Jorge,Moreno,1974-05-23,40441389Y,jorge.moreno@superapp.digital,216601,ES46209505951516573022,5874.73,2024-08-15T22:17:13,Galdakao,expenses,clothing,-112.11,-88133.6
buyer_4,Jorge,Moreno,1974-05-23,40441389Y,jorge.moreno@superapp.digital,216601,ES46209505951516573022,5874.73,2024-08-15T12:29:43,Galdakao,expenses,cash,-100.0,-88233.6
buyer_4,Jorge,Moreno,1974-05-23,40441389Y,jorge.moreno@superapp.digital,216601,ES46209505951516573022,5874.73,2024-08-17T12:06:35,Galdakao,expenses,appliances,-87.0,-88320.6
buyer_4,Jorge,Moreno,1974-05-23,40441389Y,jorge.moreno@superapp.digital,216601,ES46209505951516573022,5874.73,2024-08-18T18:36:48,Galdakao,expenses,gifts,-80.53,-88401.13
buyer_4,Jorge,Moreno,1974-05-23,40441389Y,jorge.moreno@superapp.digital,216601,ES46209505951516573022,5874.73,2024-08-20T07:16:41,Galdakao,expenses,cash,-100.0,-88501.13
buyer_4,Jorge,Moreno,1974-05-23,40441389Y,jorge.moreno@superapp.digital,216601,ES46209505951516573022,5874.73,2024-08-23T17:59:16,Galdakao,expenses,healthcare,-54.55,-88555.68
buyer_4,Jorge,Moreno,1974-05-23,40441389Y,jorge.moreno@superapp.digital,216601,ES46209505951516573022,5874.73,2024-08-26T09:19:58,Galdakao,expenses,children,-648.96,-89204.64
buyer_4,Jorge,Moreno,1974-05-23,40441389Y,jorge.moreno@superapp.digital,216601,ES46209505951516573022,5874.73,2024-08-29T15:37:13,Galdakao,expenses,leisure,-72.85,-89277.49
buyer_4,Jorge,Moreno,1974-05-23,40441389Y,jorge.moreno@superapp.digital,216601,ES46209505951516573022,5874.73,2024-08-29T20:54:44,Galdakao,expenses,appliances,-274.51,-89552.0
buyer_4,Jorge,Moreno,1974-05-23,40441389Y,jorge.moreno@superapp.digital,216601,ES46209505951516573022,5874.73,2024-08-30T05:33:12,Galdakao,expenses,food,-106.03,-89658.03
buyer_4,Jorge,Moreno,1974-05-23,40441389Y,jorge.moreno@superapp.digital,216601,ES46209505951516573022,5874.73,2024-08-30T11:03:31,Galdakao,expenses,leisure,-40.97,-89699.0
buyer_4,Jorge,Moreno,1974-05-23,40441389Y,jorge.moreno@superapp.digital,216601,ES46209505951516573022,5874.73,2024-08-31T19:14:58,Galdakao,expenses,food,-67.05,-89766.05
buyer_4,Jorge,Moreno,1974-05-23,40441389Y,jorge.moreno@superapp.digital,216601,ES46209505951516573022,5874.73,2024-08-31T10:05:00,Galdakao,expenses,leisure,-84.76,-89850.81
buyer_4,Jorge,Moreno,1974-05-23,40441389Y,jorge.moreno@superapp.digital,216601,ES46209505951516573022,5874.73,2024-08-31T18:04:43,Galdakao,expenses,repairs,-227.68,-90078.49
buyer_4,Jorge,Moreno,1974-05-23,40441389Y,jorge.moreno@superapp.digital,216601,ES46209505951516573022,5874.73,2024-09-01T00:30:39,Galdakao,incomes,salary,2549.68,-87528.81
buyer_4,Jorge,Moreno,1974-05-23,40441389Y,jorge.moreno@superapp.digital,216601,ES46209505951516573022,5874.73,2024-09-01T00:30:39,Galdakao,incomes,extra_income,385.48,-87143.33
buyer_4,Jorge,Moreno,1974-05-23,40441389Y,jorge.moreno@superapp.digital,216601,ES46209505951516573022,5874.73,2024-09-02T09:14:35,Galdakao,expenses,clothing,-131.36,-87274.69
buyer_4,Jorge,Moreno,1974-05-23,40441389Y,jorge.moreno@superapp.digital,216601,ES46209505951516573022,5874.73,2024-09-02T23:06:47,Galdakao,expenses,appliances,-338.26,-87612.95
buyer_4,Jorge,Moreno,1974-05-23,40441389Y,jorge.moreno@superapp.digital,216601,ES46209505951516573022,5874.73,2024-09-02T23:21:31,Galdakao,expenses,gifts,-215.08,-87828.03
buyer_4,Jorge,Moreno,1974-05-23,40441389Y,jorge.moreno@superapp.digital,216601,ES46209505951516573022,5874.73,2024-09-03T18:40:03,Galdakao,expenses,appliances,-256.71,-88084.74
buyer_4,Jorge,Moreno,1974-05-23,40441389Y,jorge.moreno@superapp.digital,216601,ES46209505951516573022,5874.73,2024-09-04T12:12:50,Galdakao,expenses,mortgage,-1034.67,-89119.41
buyer_4,Jorge,Moreno,1974-05-23,40441389Y,jorge.moreno@superapp.digital,216601,ES46209505951516573022,5874.73,2024-09-05T10:30:54,Galdakao,expenses,phone,-51.19,-89170.6
buyer_4,Jorge,Moreno,1974-05-23,40441389Y,jorge.moreno@superapp.digital,216601,ES46209505951516573022,5874.73,2024-09-05T08:47:41,Galdakao,expenses,gifts,-674.42,-89845.02
buyer_4,Jorge,Moreno,1974-05-23,40441389Y,jorge.moreno@superapp.digital,216601,ES46209505951516573022,5874.73,2024-09-06T15:30:40,Galdakao,expenses,gas,-91.17,-89936.19
buyer_4,Jorge,Moreno,1974-05-23,40441389Y,jorge.moreno@superapp.digital,216601,ES46209505951516573022,5874.73,2024-09-06T13:31:39,Galdakao,expenses,internet,-53.54,-89989.73
buyer_4,Jorge,Moreno,1974-05-23,40441389Y,jorge.moreno@superapp.digital,216601,ES46209505951516573022,5874.73,2024-09-06T16:01:17,Galdakao,expenses,education,-48.21,-90037.94
buyer_4,Jorge,Moreno,1974-05-23,40441389Y,jorge.moreno@superapp.digital,216601,ES46209505951516573022,5874.73,2024-09-08T14:29:17,Galdakao,expenses,gas,-66.3,-90104.24
buyer_4,Jorge,Moreno,1974-05-23,40441389Y,jorge.moreno@superapp.digital,216601,ES46209505951516573022,5874.73,2024-09-08T11:39:13,Galdakao,expenses,cash,-100.0,-90204.24
buyer_4,Jorge,Moreno,1974-05-23,40441389Y,jorge.moreno@superapp.digital,216601,ES46209505951516573022,5874.73,2024-09-09T14:44:41,Galdakao,expenses,cash,-100.0,-90304.24
buyer_4,Jorge,Moreno,1974-05-23,40441389Y,jorge.moreno@superapp.digital,216601,ES46209505951516573022,5874.73,2024-09-11T10:29:26,Galdakao,expenses,cash,-100.0,-90404.24
buyer_4,Jorge,Moreno,1974-05-23,40441389Y,jorge.moreno@superapp.digital,216601,ES46209505951516573022,5874.73,2024-09-14T16:52:08,Galdakao,expenses,education,-75.11,-90479.35
buyer_4,Jorge,Moreno,1974-05-23,40441389Y,jorge.moreno@superapp.digital,216601,ES46209505951516573022,5874.73,2024-09-14T13:47:48,Galdakao,expenses,repairs,-113.85,-90593.2
buyer_4,Jorge,Moreno,1974-05-23,40441389Y,jorge.moreno@superapp.digital,216601,ES46209505951516573022,5874.73,2024-09-14T09:56:04,Galdakao,expenses,gifts,-843.35,-91436.55
buyer_4,Jorge,Moreno,1974-05-23,40441389Y,jorge.moreno@superapp.digital,216601,ES46209505951516573022,5874.73,2024-09-15T11:27:29,Galdakao,expenses,cash,-100.0,-91536.55
buyer_4,Jorge,Moreno,1974-05-23,40441389Y,jorge.moreno@superapp.digital,216601,ES46209505951516573022,5874.73,2024-09-16T05:57:54,Galdakao,expenses,leisure,-57.96,-91594.51
buyer_4,Jorge,Moreno,1974-05-23,40441389Y,jorge.moreno@superapp.digital,216601,ES46209505951516573022,5874.73,2024-09-17T17:18:48,Galdakao,expenses,leisure,-63.98,-91658.49
buyer_4,Jorge,Moreno,1974-05-23,40441389Y,jorge.moreno@superapp.digital,216601,ES46209505951516573022,5874.73,2024-09-19T04:46:34,Galdakao,expenses,transport,-77.78,-91736.27
buyer_4,Jorge,Moreno,1974-05-23,40441389Y,jorge.moreno@superapp.digital,216601,ES46209505951516573022,5874.73,2024-09-23T15:44:50,Galdakao,expenses,children,-983.04,-92719.31
buyer_4,Jorge,Moreno,1974-05-23,40441389Y,jorge.moreno@superapp.digital,216601,ES46209505951516573022,5874.73,2024-09-24T15:23:39,Galdakao,expenses,food,-119.39,-92838.7
buyer_4,Jorge,Moreno,1974-05-23,40441389Y,jorge.moreno@superapp.digital,216601,ES46209505951516573022,5874.73,2024-09-25T19:31:49,Galdakao,expenses,cash,-100.0,-92938.7
buyer_4,Jorge,Moreno,1974-05-23,40441389Y,jorge.moreno@superapp.digital,216601,ES46209505951516573022,5874.73,2024-09-26T15:11:57,Galdakao,expenses,children,-664.27,-93602.97
buyer_4,Jorge,Moreno,1974-05-23,40441389Y,jorge.moreno@superapp.digital,216601,ES46209505951516573022,5874.73,2024-09-27T00:08:37,Galdakao,expenses,healthcare,-76.17,-93679.14
buyer_4,Jorge,Moreno,1974-05-23,40441389Y,jorge.moreno@superapp.digital,216601,ES46209505951516573022,5874.73,2024-09-27T09:17:42,Galdakao,expenses,cash,-100.0,-93779.14
buyer_4,Jorge,Moreno,1974-05-23,40441389Y,jorge.moreno@superapp.digital,216601,ES46209505951516573022,5874.73,2024-09-28T14:06:50,Galdakao,expenses,gifts,-498.07,-94277.21
buyer_4,Jorge,Moreno,1974-05-23,40441389Y,jorge.moreno@superapp.digital,216601,ES46209505951516573022,5874.73,2024-09-30T12:43:44,Galdakao,expenses,transport,-61.98,-94339.19
buyer_4,Jorge,Moreno,1974-05-23,40441389Y,jorge.moreno@superapp.digital,216601,ES46209505951516573022,5874.73,2024-10-01T03:59:36,Galdakao,incomes,salary,2549.68,-91789.51
buyer_4,Jorge,Moreno,1974-05-23,40441389Y,jorge.moreno@superapp.digital,216601,ES46209505951516573022,5874.73,2024-10-01T13:05:02,Galdakao,expenses,cash,-100.0,-91889.51
buyer_4,Jorge,Moreno,1974-05-23,40441389Y,jorge.moreno@superapp.digital,216601,ES46209505951516573022,5874.73,2024-10-04T17:52:43,Galdakao,expenses,mortgage,-1034.67,-92924.18
buyer_4,Jorge,Moreno,1974-05-23,40441389Y,jorge.moreno@superapp.digital,216601,ES46209505951516573022,5874.73,2024-10-04T19:28:59,Galdakao,expenses,food,-67.46,-92991.64
buyer_4,Jorge,Moreno,1974-05-23,40441389Y,jorge.moreno@superapp.digital,216601,ES46209505951516573022,5874.73,2024-10-04T19:18:50,Galdakao,expenses,leisure,-81.06,-93072.7
buyer_4,Jorge,Moreno,1974-05-23,40441389Y,jorge.moreno@superapp.digital,216601,ES46209505951516573022,5874.73,2024-10-06T15:35:16,Galdakao,expenses,water,-45.26,-93117.96
buyer_4,Jorge,Moreno,1974-05-23,40441389Y,jorge.moreno@superapp.digital,216601,ES46209505951516573022,5874.73,2024-10-06T10:45:38,Galdakao,expenses,electricity,-72.33,-93190.29
buyer_4,Jorge,Moreno,1974-05-23,40441389Y,jorge.moreno@superapp.digital,216601,ES46209505951516573022,5874.73,2024-10-06T10:49:06,Galdakao,expenses,phone,-42.16,-93232.45
buyer_4,Jorge,Moreno,1974-05-23,40441389Y,jorge.moreno@superapp.digital,216601,ES46209505951516573022,5874.73,2024-10-06T20:35:01,Galdakao,expenses,food,-68.68,-93301.13
buyer_4,Jorge,Moreno,1974-05-23,40441389Y,jorge.moreno@superapp.digital,216601,ES46209505951516573022,5874.73,2024-10-06T10:05:13,Galdakao,expenses,cash,-100.0,-93401.13
buyer_4,Jorge,Moreno,1974-05-23,40441389Y,jorge.moreno@superapp.digital,216601,ES46209505951516573022,5874.73,2024-10-07T09:49:35,Galdakao,expenses,food,-111.69,-93512.82
buyer_4,Jorge,Moreno,1974-05-23,40441389Y,jorge.moreno@superapp.digital,216601,ES46209505951516573022,5874.73,2024-10-07T20:39:03,Galdakao,expenses,cash,-100.0,-93612.82
buyer_4,Jorge,Moreno,1974-05-23,40441389Y,jorge.moreno@superapp.digital,216601,ES46209505951516573022,5874.73,2024-10-07T20:13:06,Galdakao,expenses,repairs,-282.37,-93895.19
buyer_4,Jorge,Moreno,1974-05-23,40441389Y,jorge.moreno@superapp.digital,216601,ES46209505951516573022,5874.73,2024-10-08T10:32:19,Galdakao,expenses,water,-34.89,-93930.08
buyer_4,Jorge,Moreno,1974-05-23,40441389Y,jorge.moreno@superapp.digital,216601,ES46209505951516573022,5874.73,2024-10-08T17:25:57,Galdakao,expenses,cash,-100.0,-94030.08
buyer_4,Jorge,Moreno,1974-05-23,40441389Y,jorge.moreno@superapp.digital,216601,ES46209505951516573022,5874.73,2024-10-09T18:43:50,Galdakao,expenses,transport,-62.75,-94092.83
buyer_4,Jorge,Moreno,1974-05-23,40441389Y,jorge.moreno@superapp.digital,216601,ES46209505951516573022,5874.73,2024-10-09T08:20:09,Galdakao,expenses,cash,-100.0,-94192.83
buyer_4,Jorge,Moreno,1974-05-23,40441389Y,jorge.moreno@superapp.digital,216601,ES46209505951516573022,5874.73,2024-10-10T14:55:09,Galdakao,expenses,appliances,-254.86,-94447.69
buyer_5,Sara,Gurrutxaga,1994-03-12,40616649Y,sara.gurrutxaga@extremecloud.com,093529,ES94209525837524276640,1768.53,2022-01-01T13:38:42,Donostia,incomes,salary,2531.24,4299.77
buyer_5,Sara,Gurrutxaga,1994-03-12,40616649Y,sara.gurrutxaga@extremecloud.com,093529,ES94209525837524276640,1768.53,2022-01-01T13:38:42,Donostia,incomes,salary_partner,2972.21,7271.98
buyer_5,Sara,Gurrutxaga,1994-03-12,40616649Y,sara.gurrutxaga@extremecloud.com,093529,ES94209525837524276640,1768.53,2022-01-03T20:23:23,Donostia,expenses,healthcare,-170.04,7101.94
buyer_5,Sara,Gurrutxaga,1994-03-12,40616649Y,sara.gurrutxaga@extremecloud.com,093529,ES94209525837524276640,1768.53,2022-01-04T21:03:45,Donostia,expenses,mortgage,-2381.78,4720.16
buyer_5,Sara,Gurrutxaga,1994-03-12,40616649Y,sara.gurrutxaga@extremecloud.com,093529,ES94209525837524276640,1768.53,2022-01-05T16:38:10,Donostia,expenses,electricity,-169.84,4550.32
buyer_5,Sara,Gurrutxaga,1994-03-12,40616649Y,sara.gurrutxaga@extremecloud.com,093529,ES94209525837524276640,1768.53,2022-01-05T20:35:07,Donostia,expenses,food,-62.23,4488.09
buyer_5,Sara,Gurrutxaga,1994-03-12,40616649Y,sara.gurrutxaga@extremecloud.com,093529,ES94209525837524276640,1768.53,2022-01-05T13:13:05,Donostia,expenses,leisure,-43.73,4444.36
buyer_5,Sara,Gurrutxaga,1994-03-12,40616649Y,sara.gurrutxaga@extremecloud.com,093529,ES94209525837524276640,1768.53,2022-01-06T11:27:39,Donostia,expenses,internet,-115.57,4328.79
buyer_5,Sara,Gurrutxaga,1994-03-12,40616649Y,sara.gurrutxaga@extremecloud.com,093529,ES94209525837524276640,1768.53,2022-01-08T17:04:35,Donostia,expenses,water,-80.92,4247.87
buyer_5,Sara,Gurrutxaga,1994-03-12,40616649Y,sara.gurrutxaga@extremecloud.com,093529,ES94209525837524276640,1768.53,2022-01-08T17:28:58,Donostia,expenses,internet,-115.57,4132.3
buyer_5,Sara,Gurrutxaga,1994-03-12,40616649Y,sara.gurrutxaga@extremecloud.com,093529,ES94209525837524276640,1768.53,2022-01-08T04:11:06,Donostia,expenses,repairs,-64.77,4067.53
buyer_5,Sara,Gurrutxaga,1994-03-12,40616649Y,sara.gurrutxaga@extremecloud.com,093529,ES94209525837524276640,1768.53,2022-01-09T18:20:17,Donostia,expenses,gifts,-770.62,3296.91
buyer_5,Sara,Gurrutxaga,1994-03-12,40616649Y,sara.gurrutxaga@extremecloud.com,093529,ES94209525837524276640,1768.53,2022-01-10T11:21:06,Donostia,expenses,transport,-51.07,3245.84
buyer_5,Sara,Gurrutxaga,1994-03-12,40616649Y,sara.gurrutxaga@extremecloud.com,093529,ES94209525837524276640,1768.53,2022-01-10T21:29:53,Donostia,expenses,repairs,-147.38,3098.46
buyer_5,Sara,Gurrutxaga,1994-03-12,40616649Y,sara.gurrutxaga@extremecloud.com,093529,ES94209525837524276640,1768.53,2022-01-11T12:42:00,Donostia,expenses,food,-104.5,2993.96
buyer_5,Sara,Gurrutxaga,1994-03-12,40616649Y,sara.gurrutxaga@extremecloud.com,093529,ES94209525837524276640,1768.53,2022-01-12T21:22:14,Donostia,expenses,cash,-100.0,2893.96
buyer_5,Sara,Gurrutxaga,1994-03-12,40616649Y,sara.gurrutxaga@extremecloud.com,093529,ES94209525837524276640,1768.53,2022-01-13T21:37:42,Donostia,expenses,food,-106.25,2787.71
buyer_5,Sara,Gurrutxaga,1994-03-12,40616649Y,sara.gurrutxaga@extremecloud.com,093529,ES94209525837524276640,1768.53,2022-01-14T10:18:43,Donostia,expenses,food,-82.63,2705.08
buyer_5,Sara,Gurrutxaga,1994-03-12,40616649Y,sara.gurrutxaga@extremecloud.com,093529,ES94209525837524276640,1768.53,2022-01-14T01:24:43,Donostia,expenses,healthcare,-94.43,2610.65
buyer_5,Sara,Gurrutxaga,1994-03-12,40616649Y,sara.gurrutxaga@extremecloud.com,093529,ES94209525837524276640,1768.53,2022-01-15T20:53:27,Donostia,expenses,cash,-100.0,2510.65
buyer_5,Sara,Gurrutxaga,1994-03-12,40616649Y,sara.gurrutxaga@extremecloud.com,093529,ES94209525837524276640,1768.53,2022-01-16T21:24:28,Donostia,expenses,leisure,-74.73,2435.92
buyer_5,Sara,Gurrutxaga,1994-03-12,40616649Y,sara.gurrutxaga@extremecloud.com,093529,ES94209525837524276640,1768.53,2022-01-16T03:08:49,Donostia,expenses,clothing,-82.67,2353.25
buyer_5,Sara,Gurrutxaga,1994-03-12,40616649Y,sara.gurrutxaga@extremecloud.com,093529,ES94209525837524276640,1768.53,2022-01-19T10:10:04,Donostia,expenses,food,-88.57,2264.68
buyer_5,Sara,Gurrutxaga,1994-03-12,40616649Y,sara.gurrutxaga@extremecloud.com,093529,ES94209525837524276640,1768.53,2022-01-19T11:17:24,Donostia,expenses,leisure,-39.18,2225.5
buyer_5,Sara,Gurrutxaga,1994-03-12,40616649Y,sara.gurrutxaga@extremecloud.com,093529,ES94209525837524276640,1768.53,2022-01-20T11:38:29,Donostia,expenses,clothing,-63.09,2162.41
buyer_5,Sara,Gurrutxaga,1994-03-12,40616649Y,sara.gurrutxaga@extremecloud.com,093529,ES94209525837524276640,1768.53,2022-01-21T16:35:22,Donostia,expenses,cash,-100.0,2062.41
buyer_5,Sara,Gurrutxaga,1994-03-12,40616649Y,sara.gurrutxaga@extremecloud.com,093529,ES94209525837524276640,1768.53,2022-01-23T17:09:01,Donostia,expenses,leisure,-41.63,2020.78
buyer_5,Sara,Gurrutxaga,1994-03-12,40616649Y,sara.gurrutxaga@extremecloud.com,093529,ES94209525837524276640,1768.53,2022-01-25T12:17:12,Donostia,expenses,transport,-60.84,1959.94
buyer_5,Sara,Gurrutxaga,1994-03-12,40616649Y,sara.gurrutxaga@extremecloud.com,093529,ES94209525837524276640,1768.53,2022-01-30T09:35:05,Donostia,expenses,food,-65.15,1894.79
buyer_5,Sara,Gurrutxaga,1994-03-12,40616649Y,sara.gurrutxaga@extremecloud.com,093529,ES94209525837524276640,1768.53,2022-01-31T12:22:36,Donostia,expenses,education,-76.49,1818.3
buyer_5,Sara,Gurrutxaga,1994-03-12,40616649Y,sara.gurrutxaga@extremecloud.com,093529,ES94209525837524276640,1768.53,2022-01-31T17:10:26,Donostia,expenses,cash,-100.0,1718.3
buyer_5,Sara,Gurrutxaga,1994-03-12,40616649Y,sara.gurrutxaga@extremecloud.com,093529,ES94209525837524276640,1768.53,2022-02-01T15:10:02,Donostia,incomes,salary,2531.24,4249.54
buyer_5,Sara,Gurrutxaga,1994-03-12,40616649Y,sara.gurrutxaga@extremecloud.com,093529,ES94209525837524276640,1768.53,2022-02-01T15:10:02,Donostia,incomes,salary_partner,2972.21,7221.75
buyer_5,Sara,Gurrutxaga,1994-03-12,40616649Y,sara.gurrutxaga@extremecloud.com,093529,ES94209525837524276640,1768.53,2022-02-01T09:50:53,Donostia,expenses,appliances,-202.92,7018.83
buyer_5,Sara,Gurrutxaga,1994-03-12,40616649Y,sara.gurrutxaga@extremecloud.com,093529,ES94209525837524276640,1768.53,2022-02-02T10:17:59,Donostia,expenses,food,-67.91,6950.92
buyer_5,Sara,Gurrutxaga,1994-03-12,40616649Y,sara.gurrutxaga@extremecloud.com,093529,ES94209525837524276640,1768.53,2022-02-02T17:49:12,Donostia,expenses,healthcare,-142.2,6808.72
buyer_5,Sara,Gurrutxaga,1994-03-12,40616649Y,sara.gurrutxaga@extremecloud.com,093529,ES94209525837524276640,1768.53,2022-02-04T15:06:43,Donostia,expenses,mortgage,-2381.78,4426.94
buyer_5,Sara,Gurrutxaga,1994-03-12,40616649Y,sara.gurrutxaga@extremecloud.com,093529,ES94209525837524276640,1768.53,2022-02-05T20:52:38,Donostia,expenses,gas,-127.82,4299.12
buyer_5,Sara,Gurrutxaga,1994-03-12,40616649Y,sara.gurrutxaga@extremecloud.com,093529,ES94209525837524276640,1768.53,2022-02-05T14:41:19,Donostia,expenses,clothing,-45.19,4253.93
buyer_5,Sara,Gurrutxaga,1994-03-12,40616649Y,sara.gurrutxaga@extremecloud.com,093529,ES94209525837524276640,1768.53,2022-02-06T14:14:32,Donostia,expenses,water,-68.64,4185.29
buyer_5,Sara,Gurrutxaga,1994-03-12,40616649Y,sara.gurrutxaga@extremecloud.com,093529,ES94209525837524276640,1768.53,2022-02-06T08:35:20,Donostia,expenses,internet,-115.57,4069.72
buyer_5,Sara,Gurrutxaga,1994-03-12,40616649Y,sara.gurrutxaga@extremecloud.com,093529,ES94209525837524276640,1768.53,2022-02-07T12:53:34,Donostia,expenses,phone,-85.99,3983.73
buyer_5,Sara,Gurrutxaga,1994-03-12,40616649Y,sara.gurrutxaga@extremecloud.com,093529,ES94209525837524276640,1768.53,2022-02-07T14:07:33,Donostia,expenses,transport,-54.83,3928.9
buyer_5,Sara,Gurrutxaga,1994-03-12,40616649Y,sara.gurrutxaga@extremecloud.com,093529,ES94209525837524276640,1768.53,2022-02-07T11:24:22,Donostia,expenses,repairs,-110.4,3818.5
buyer_5,Sara,Gurrutxaga,1994-03-12,40616649Y,sara.gurrutxaga@extremecloud.com,093529,ES94209525837524276640,1768.53,2022-02-08T20:36:00,Donostia,expenses,water,-98.88,3719.62
buyer_5,Sara,Gurrutxaga,1994-03-12,40616649Y,sara.gurrutxaga@extremecloud.com,093529,ES94209525837524276640,1768.53,2022-02-08T15:00:58,Donostia,expenses,cash,-100.0,3619.62
buyer_5,Sara,Gurrutxaga,1994-03-12,40616649Y,sara.gurrutxaga@extremecloud.com,093529,ES94209525837524276640,1768.53,2022-02-09T18:02:20,Donostia,expenses,food,-77.36,3542.26
buyer_5,Sara,Gurrutxaga,1994-03-12,40616649Y,sara.gurrutxaga@extremecloud.com,093529,ES94209525837524276640,1768.53,2022-02-09T09:52:23,Donostia,expenses,healthcare,-112.73,3429.53
buyer_5,Sara,Gurrutxaga,1994-03-12,40616649Y,sara.gurrutxaga@extremecloud.com,093529,ES94209525837524276640,1768.53,2022-02-09T16:41:48,Donostia,expenses,education,-70.79,3358.74
buyer_5,Sara,Gurrutxaga,1994-03-12,40616649Y,sara.gurrutxaga@extremecloud.com,093529,ES94209525837524276640,1768.53,2022-02-10T16:07:11,Donostia,expenses,food,-92.03,3266.71
buyer_5,Sara,Gurrutxaga,1994-03-12,40616649Y,sara.gurrutxaga@extremecloud.com,093529,ES94209525837524276640,1768.53,2022-02-10T11:29:01,Donostia,expenses,cash,-100.0,3166.71
buyer_5,Sara,Gurrutxaga,1994-03-12,40616649Y,sara.gurrutxaga@extremecloud.com,093529,ES94209525837524276640,1768.53,2022-02-11T20:34:02,Donostia,expenses,food,-82.6,3084.11
buyer_5,Sara,Gurrutxaga,1994-03-12,40616649Y,sara.gurrutxaga@extremecloud.com,093529,ES94209525837524276640,1768.53,2022-02-12T16:26:49,Donostia,expenses,cash,-100.0,2984.11
buyer_5,Sara,Gurrutxaga,1994-03-12,40616649Y,sara.gurrutxaga@extremecloud.com,093529,ES94209525837524276640,1768.53,2022-02-15T11:30:59,Donostia,expenses,cash,-100.0,2884.11
buyer_5,Sara,Gurrutxaga,1994-03-12,40616649Y,sara.gurrutxaga@extremecloud.com,093529,ES94209525837524276640,1768.53,2022-02-15T09:37:06,Donostia,expenses,repairs,-91.53,2792.58
buyer_5,Sara,Gurrutxaga,1994-03-12,40616649Y,sara.gurrutxaga@extremecloud.com,093529,ES94209525837524276640,1768.53,2022-02-16T08:18:34,Donostia,expenses,leisure,-79.67,2712.91
buyer_5,Sara,Gurrutxaga,1994-03-12,40616649Y,sara.gurrutxaga@extremecloud.com,093529,ES94209525837524276640,1768.53,2022-02-20T13:33:40,Donostia,expenses,education,-59.7,2653.21
buyer_5,Sara,Gurrutxaga,1994-03-12,40616649Y,sara.gurrutxaga@extremecloud.com,093529,ES94209525837524276640,1768.53,2022-02-20T15:03:53,Donostia,expenses,repairs,-145.54,2507.67
buyer_5,Sara,Gurrutxaga,1994-03-12,40616649Y,sara.gurrutxaga@extremecloud.com,093529,ES94209525837524276640,1768.53,2022-02-20T18:12:05,Donostia,expenses,gifts,-791.62,1716.05
buyer_5,Sara,Gurrutxaga,1994-03-12,40616649Y,sara.gurrutxaga@extremecloud.com,093529,ES94209525837524276640,1768.53,2022-02-21T15:11:14,Donostia,expenses,food,-117.0,1599.05
buyer_5,Sara,Gurrutxaga,1994-03-12,40616649Y,sara.gurrutxaga@extremecloud.com,093529,ES94209525837524276640,1768.53,2022-02-21T10:54:57,Donostia,expenses,transport,-75.5,1523.55
buyer_5,Sara,Gurrutxaga,1994-03-12,40616649Y,sara.gurrutxaga@extremecloud.com,093529,ES94209525837524276640,1768.53,2022-02-21T18:47:39,Donostia,expenses,repairs,-159.56,1363.99
buyer_5,Sara,Gurrutxaga,1994-03-12,40616649Y,sara.gurrutxaga@extremecloud.com,093529,ES94209525837524276640,1768.53,2022-02-22T17:05:35,Donostia,expenses,leisure,-25.39,1338.6
buyer_5,Sara,Gurrutxaga,1994-03-12,40616649Y,sara.gurrutxaga@extremecloud.com,093529,ES94209525837524276640,1768.53,2022-02-22T13:11:24,Donostia,expenses,appliances,-260.81,1077.79
buyer_5,Sara,Gurrutxaga,1994-03-12,40616649Y,sara.gurrutxaga@extremecloud.com,093529,ES94209525837524276640,1768.53,2022-02-23T10:24:44,Donostia,expenses,cash,-100.0,977.79
buyer_5,Sara,Gurrutxaga,1994-03-12,40616649Y,sara.gurrutxaga@extremecloud.com,093529,ES94209525837524276640,1768.53,2022-02-23T16:56:42,Donostia,expenses,travel,-419.55,558.24
buyer_5,Sara,Gurrutxaga,1994-03-12,40616649Y,sara.gurrutxaga@extremecloud.com,093529,ES94209525837524276640,1768.53,2022-02-24T16:59:40,Donostia,expenses,healthcare,-124.26,433.98
buyer_5,Sara,Gurrutxaga,1994-03-12,40616649Y,sara.gurrutxaga@extremecloud.com,093529,ES94209525837524276640,1768.53,2022-02-25T18:53:54,Donostia,expenses,food,-97.74,336.24
buyer_5,Sara,Gurrutxaga,1994-03-12,40616649Y,sara.gurrutxaga@extremecloud.com,093529,ES94209525837524276640,1768.53,2022-02-25T20:10:08,Donostia,expenses,leisure,-30.3,305.94
buyer_5,Sara,Gurrutxaga,1994-03-12,40616649Y,sara.gurrutxaga@extremecloud.com,093529,ES94209525837524276640,1768.53,2022-02-26T12:10:25,Donostia,expenses,cash,-100.0,205.94
buyer_5,Sara,Gurrutxaga,1994-03-12,40616649Y,sara.gurrutxaga@extremecloud.com,093529,ES94209525837524276640,1768.53,2022-03-01T13:55:01,Donostia,incomes,salary,2531.24,2737.18
buyer_5,Sara,Gurrutxaga,1994-03-12,40616649Y,sara.gurrutxaga@extremecloud.com,093529,ES94209525837524276640,1768.53,2022-03-01T13:55:01,Donostia,incomes,salary_partner,2972.21,5709.39
buyer_5,Sara,Gurrutxaga,1994-03-12,40616649Y,sara.gurrutxaga@extremecloud.com,093529,ES94209525837524276640,1768.53,2022-03-01T08:07:17,Donostia,expenses,repairs,-130.27,5579.12
buyer_5,Sara,Gurrutxaga,1994-03-12,40616649Y,sara.gurrutxaga@extremecloud.com,093529,ES94209525837524276640,1768.53,2022-03-03T19:37:37,Donostia,expenses,transport,-42.18,5536.94
buyer_5,Sara,Gurrutxaga,1994-03-12,40616649Y,sara.gurrutxaga@extremecloud.com,093529,ES94209525837524276640,1768.53,2022-03-03T23:11:20,Donostia,expenses,leisure,-31.45,5505.49
buyer_5,Sara,Gurrutxaga,1994-03-12,40616649Y,sara.gurrutxaga@extremecloud.com,093529,ES94209525837524276640,1768.53,2022-03-03T14:24:21,Donostia,expenses,appliances,-384.56,5120.93
buyer_5,Sara,Gurrutxaga,1994-03-12,40616649Y,sara.gurrutxaga@extremecloud.com,093529,ES94209525837524276640,1768.53,2022-03-04T12:30:21,Donostia,expenses,mortgage,-2381.78,2739.15
buyer_5,Sara,Gurrutxaga,1994-03-12,40616649Y,sara.gurrutxaga@extremecloud.com,093529,ES94209525837524276640,1768.53,2022-03-04T13:03:29,Donostia,expenses,transport,-68.66,2670.49
buyer_5,Sara,Gurrutxaga,1994-03-12,40616649Y,sara.gurrutxaga@extremecloud.com,093529,ES94209525837524276640,1768.53,2022-03-04T16:24:09,Donostia,expenses,cash,-100.0,2570.49
buyer_5,Sara,Gurrutxaga,1994-03-12,40616649Y,sara.gurrutxaga@extremecloud.com,093529,ES94209525837524276640,1768.53,2022-03-04T08:29:48,Donostia,expenses,gifts,-581.48,1989.01
buyer_5,Sara,Gurrutxaga,1994-03-12,40616649Y,sara.gurrutxaga@extremecloud.com,093529,ES94209525837524276640,1768.53,2022-03-05T13:19:52,Donostia,expenses,internet,-115.57,1873.44
buyer_5,Sara,Gurrutxaga,1994-03-12,40616649Y,sara.gurrutxaga@extremecloud.com,093529,ES94209525837524276640,1768.53,2022-03-05T13:25:35,Donostia,expenses,repairs,-253.34,1620.1
buyer_5,Sara,Gurrutxaga,1994-03-12,40616649Y,sara.gurrutxaga@extremecloud.com,093529,ES94209525837524276640,1768.53,2022-03-06T14:40:34,Donostia,expenses,water,-98.44,1521.66
buyer_5,Sara,Gurrutxaga,1994-03-12,40616649Y,sara.gurrutxaga@extremecloud.com,093529,ES94209525837524276640,1768.53,2022-03-06T07:14:14,Donostia,expenses,food,-96.77,1424.89
buyer_5,Sara,Gurrutxaga,1994-03-12,40616649Y,sara.gurrutxaga@extremecloud.com,093529,ES94209525837524276640,1768.53,2022-03-06T09:38:11,Donostia,expenses,clothing,-150.77,1274.12
buyer_5,Sara,Gurrutxaga,1994-03-12,40616649Y,sara.gurrutxaga@extremecloud.com,093529,ES94209525837524276640,1768.53,2022-03-06T01:56:15,Donostia,expenses,gifts,-154.88,1119.24
buyer_5,Sara,Gurrutxaga,1994-03-12,40616649Y,sara.gurrutxaga@extremecloud.com,093529,ES94209525837524276640,1768.53,2022-03-07T10:48:37,Donostia,expenses,phone,-115.67,1003.57
buyer_5,Sara,Gurrutxaga,1994-03-12,40616649Y,sara.gurrutxaga@extremecloud.com,093529,ES94209525837524276640,1768.53,2022-03-08T21:26:48,Donostia,expenses,food,-91.16,912.41
buyer_5,Sara,Gurrutxaga,1994-03-12,40616649Y,sara.gurrutxaga@extremecloud.com,093529,ES94209525837524276640,1768.53,2022-03-10T13:10:27,Donostia,expenses,transport,-43.58,868.83
buyer_5,Sara,Gurrutxaga,1994-03-12,40616649Y,sara.gurrutxaga@extremecloud.com,093529,ES94209525837524276640,1768.53,2022-03-16T20:20:23,Donostia,expenses,repairs,-37.91,830.92
buyer_5,Sara,Gurrutxaga,1994-03-12,40616649Y,sara.gurrutxaga@extremecloud.com,093529,ES94209525837524276640,1768.53,2022-03-17T12:24:19,Donostia,expenses,food,-99.15,731.77
buyer_5,Sara,Gurrutxaga,1994-03-12,40616649Y,sara.gurrutxaga@extremecloud.com,093529,ES94209525837524276640,1768.53,2022-03-17T09:16:54,Donostia,expenses,gifts,-420.48,311.29
buyer_5,Sara,Gurrutxaga,1994-03-12,40616649Y,sara.gurrutxaga@extremecloud.com,093529,ES94209525837524276640,1768.53,2022-03-19T17:31:40,Donostia,expenses,food,-108.11,203.18
buyer_5,Sara,Gurrutxaga,1994-03-12,40616649Y,sara.gurrutxaga@extremecloud.com,093529,ES94209525837524276640,1768.53,2022-03-20T11:31:28,Donostia,expenses,leisure,-30.97,172.21
buyer_5,Sara,Gurrutxaga,1994-03-12,40616649Y,sara.gurrutxaga@extremecloud.com,093529,ES94209525837524276640,1768.53,2022-03-20T13:24:18,Donostia,expenses,cash,-100.0,72.21
buyer_5,Sara,Gurrutxaga,1994-03-12,40616649Y,sara.gurrutxaga@extremecloud.com,093529,ES94209525837524276640,1768.53,2022-03-21T08:24:22,Donostia,expenses,food,-63.78,8.43
buyer_5,Sara,Gurrutxaga,1994-03-12,40616649Y,sara.gurrutxaga@extremecloud.com,093529,ES94209525837524276640,1768.53,2022-03-26T13:55:05,Donostia,expenses,cash,-100.0,-91.57
buyer_5,Sara,Gurrutxaga,1994-03-12,40616649Y,sara.gurrutxaga@extremecloud.com,093529,ES94209525837524276640,1768.53,2022-03-27T17:45:08,Donostia,expenses,clothing,-83.34,-174.91
buyer_5,Sara,Gurrutxaga,1994-03-12,40616649Y,sara.gurrutxaga@extremecloud.com,093529,ES94209525837524276640,1768.53,2022-03-28T14:07:09,Donostia,expenses,transport,-42.18,-217.09
buyer_5,Sara,Gurrutxaga,1994-03-12,40616649Y,sara.gurrutxaga@extremecloud.com,093529,ES94209525837524276640,1768.53,2022-03-28T17:01:01,Donostia,expenses,leisure,-64.16,-281.25
buyer_5,Sara,Gurrutxaga,1994-03-12,40616649Y,sara.gurrutxaga@extremecloud.com,093529,ES94209525837524276640,1768.53,2022-03-28T11:47:56,Donostia,expenses,cash,-100.0,-381.25
buyer_5,Sara,Gurrutxaga,1994-03-12,40616649Y,sara.gurrutxaga@extremecloud.com,093529,ES94209525837524276640,1768.53,2022-03-29T16:59:21,Donostia,expenses,gifts,-476.61,-857.86
buyer_5,Sara,Gurrutxaga,1994-03-12,40616649Y,sara.gurrutxaga@extremecloud.com,093529,ES94209525837524276640,1768.53,2022-03-30T11:35:18,Donostia,expenses,clothing,-92.13,-949.99
buyer_5,Sara,Gurrutxaga,1994-03-12,40616649Y,sara.gurrutxaga@extremecloud.com,093529,ES94209525837524276640,1768.53,2022-04-01T15:33:56,Donostia,incomes,salary,2531.24,1581.25
buyer_5,Sara,Gurrutxaga,1994-03-12,40616649Y,sara.gurrutxaga@extremecloud.com,093529,ES94209525837524276640,1768.53,2022-04-01T15:33:56,Donostia,incomes,salary_partner,2972.21,4553.46
buyer_5,Sara,Gurrutxaga,1994-03-12,40616649Y,sara.gurrutxaga@extremecloud.com,093529,ES94209525837524276640,1768.53,2022-04-01T15:33:56,Donostia,incomes,extra_income,354.73,4908.19
buyer_5,Sara,Gurrutxaga,1994-03-12,40616649Y,sara.gurrutxaga@extremecloud.com,093529,ES94209525837524276640,1768.53,2022-04-01T13:01:39,Donostia,expenses,repairs,-210.26,4697.93
buyer_5,Sara,Gurrutxaga,1994-03-12,40616649Y,sara.gurrutxaga@extremecloud.com,093529,ES94209525837524276640,1768.53,2022-04-02T22:12:23,Donostia,expenses,leisure,-81.62,4616.31
buyer_5,Sara,Gurrutxaga,1994-03-12,40616649Y,sara.gurrutxaga@extremecloud.com,093529,ES94209525837524276640,1768.53,2022-04-02T15:11:21,Donostia,expenses,clothing,-124.66,4491.65
buyer_5,Sara,Gurrutxaga,1994-03-12,40616649Y,sara.gurrutxaga@extremecloud.com,093529,ES94209525837524276640,1768.53,2022-04-02T14:40:25,Donostia,expenses,education,-74.09,4417.56
buyer_5,Sara,Gurrutxaga,1994-03-12,40616649Y,sara.gurrutxaga@extremecloud.com,093529,ES94209525837524276640,1768.53,2022-04-04T19:52:55,Donostia,expenses,mortgage,-2381.78,2035.78
buyer_5,Sara,Gurrutxaga,1994-03-12,40616649Y,sara.gurrutxaga@extremecloud.com,093529,ES94209525837524276640,1768.53,2022-04-04T16:49:06,Donostia,expenses,leisure,-24.99,2010.79
buyer_5,Sara,Gurrutxaga,1994-03-12,40616649Y,sara.gurrutxaga@extremecloud.com,093529,ES94209525837524276640,1768.53,2022-04-05T21:57:44,Donostia,expenses,gas,-190.56,1820.23
buyer_5,Sara,Gurrutxaga,1994-03-12,40616649Y,sara.gurrutxaga@extremecloud.com,093529,ES94209525837524276640,1768.53,2022-04-05T10:02:13,Donostia,expenses,phone,-105.62,1714.61
buyer_5,Sara,Gurrutxaga,1994-03-12,40616649Y,sara.gurrutxaga@extremecloud.com,093529,ES94209525837524276640,1768.53,2022-04-06T20:34:42,Donostia,expenses,phone,-114.85,1599.76
buyer_5,Sara,Gurrutxaga,1994-03-12,40616649Y,sara.gurrutxaga@extremecloud.com,093529,ES94209525837524276640,1768.53,2022-04-07T16:19:15,Donostia,expenses,water,-113.19,1486.57
buyer_5,Sara,Gurrutxaga,1994-03-12,40616649Y,sara.gurrutxaga@extremecloud.com,093529,ES94209525837524276640,1768.53,2022-04-07T15:09:32,Donostia,expenses,food,-91.27,1395.3
buyer_5,Sara,Gurrutxaga,1994-03-12,40616649Y,sara.gurrutxaga@extremecloud.com,093529,ES94209525837524276640,1768.53,2022-04-08T01:48:29,Donostia,expenses,water,-104.05,1291.25
buyer_5,Sara,Gurrutxaga,1994-03-12,40616649Y,sara.gurrutxaga@extremecloud.com,093529,ES94209525837524276640,1768.53,2022-04-09T16:16:39,Donostia,expenses,food,-111.18,1180.07
buyer_5,Sara,Gurrutxaga,1994-03-12,40616649Y,sara.gurrutxaga@extremecloud.com,093529,ES94209525837524276640,1768.53,2022-04-09T11:09:02,Donostia,expenses,appliances,-220.52,959.55
buyer_5,Sara,Gurrutxaga,1994-03-12,40616649Y,sara.gurrutxaga@extremecloud.com,093529,ES94209525837524276640,1768.53,2022-04-11T11:25:34,Donostia,expenses,gifts,-439.59,519.96
buyer_5,Sara,Gurrutxaga,1994-03-12,40616649Y,sara.gurrutxaga@extremecloud.com,093529,ES94209525837524276640,1768.53,2022-04-13T18:53:43,Donostia,expenses,transport,-44.53,475.43
buyer_5,Sara,Gurrutxaga,1994-03-12,40616649Y,sara.gurrutxaga@extremecloud.com,093529,ES94209525837524276640,1768.53,2022-04-15T09:03:42,Donostia,expenses,cash,-100.0,375.43
buyer_5,Sara,Gurrutxaga,1994-03-12,40616649Y,sara.gurrutxaga@extremecloud.com,093529,ES94209525837524276640,1768.53,2022-04-16T21:00:51,Donostia,expenses,leisure,-57.35,318.08
buyer_5,Sara,Gurrutxaga,1994-03-12,40616649Y,sara.gurrutxaga@extremecloud.com,093529,ES94209525837524276640,1768.53,2022-04-16T18:48:31,Donostia,expenses,cash,-100.0,218.08
buyer_5,Sara,Gurrutxaga,1994-03-12,40616649Y,sara.gurrutxaga@extremecloud.com,093529,ES94209525837524276640,1768.53,2022-04-16T16:13:09,Donostia,expenses,appliances,-267.61,-49.53
buyer_5,Sara,Gurrutxaga,1994-03-12,40616649Y,sara.gurrutxaga@extremecloud.com,093529,ES94209525837524276640,1768.53,2022-04-19T08:15:25,Donostia,expenses,transport,-52.53,-102.06
buyer_5,Sara,Gurrutxaga,1994-03-12,40616649Y,sara.gurrutxaga@extremecloud.com,093529,ES94209525837524276640,1768.53,2022-04-19T10:14:56,Donostia,expenses,leisure,-82.22,-184.28
buyer_5,Sara,Gurrutxaga,1994-03-12,40616649Y,sara.gurrutxaga@extremecloud.com,093529,ES94209525837524276640,1768.53,2022-04-20T16:02:55,Donostia,expenses,transport,-58.51,-242.79
buyer_5,Sara,Gurrutxaga,1994-03-12,40616649Y,sara.gurrutxaga@extremecloud.com,093529,ES94209525837524276640,1768.53,2022-04-21T15:27:42,Donostia,expenses,clothing,-86.55,-329.34
buyer_5,Sara,Gurrutxaga,1994-03-12,40616649Y,sara.gurrutxaga@extremecloud.com,093529,ES94209525837524276640,1768.53,2022-04-21T12:57:27,Donostia,expenses,repairs,-238.7,-568.04
buyer_5,Sara,Gurrutxaga,1994-03-12,40616649Y,sara.gurrutxaga@extremecloud.com,093529,ES94209525837524276640,1768.53,2022-04-21T17:09:53,Donostia,expenses,gifts,-265.7,-833.74
buyer_5,Sara,Gurrutxaga,1994-03-12,40616649Y,sara.gurrutxaga@extremecloud.com,093529,ES94209525837524276640,1768.53,2022-04-22T08:49:07,Donostia,expenses,leisure,-28.46,-862.2
buyer_5,Sara,Gurrutxaga,1994-03-12,40616649Y,sara.gurrutxaga@extremecloud.com,093529,ES94209525837524276640,1768.53,2022-04-23T10:06:23,Donostia,expenses,transport,-47.09,-909.29
buyer_5,Sara,Gurrutxaga,1994-03-12,40616649Y,sara.gurrutxaga@extremecloud.com,093529,ES94209525837524276640,1768.53,2022-04-25T17:14:01,Donostia,expenses,appliances,-372.23,-1281.52
buyer_5,Sara,Gurrutxaga,1994-03-12,40616649Y,sara.gurrutxaga@extremecloud.com,093529,ES94209525837524276640,1768.53,2022-04-27T16:34:20,Donostia,expenses,transport,-40.69,-1322.21
buyer_5,Sara,Gurrutxaga,1994-03-12,40616649Y,sara.gurrutxaga@extremecloud.com,093529,ES94209525837524276640,1768.53,2022-04-27T08:09:43,Donostia,expenses,cash,-100.0,-1422.21
buyer_5,Sara,Gurrutxaga,1994-03-12,40616649Y,sara.gurrutxaga@extremecloud.com,093529,ES94209525837524276640,1768.53,2022-05-01T14:15:13,Donostia,incomes,salary,2531.24,1109.03
buyer_5,Sara,Gurrutxaga,1994-03-12,40616649Y,sara.gurrutxaga@extremecloud.com,093529,ES94209525837524276640,1768.53,2022-05-01T14:15:13,Donostia,incomes,salary_partner,2972.21,4081.24
buyer_5,Sara,Gurrutxaga,1994-03-12,40616649Y,sara.gurrutxaga@extremecloud.com,093529,ES94209525837524276640,1768.53,2022-05-01T13:30:12,Donostia,expenses,food,-64.03,4017.21
buyer_5,Sara,Gurrutxaga,1994-03-12,40616649Y,sara.gurrutxaga@extremecloud.com,093529,ES94209525837524276640,1768.53,2022-05-02T11:56:17,Donostia,expenses,food,-95.87,3921.34
buyer_5,Sara,Gurrutxaga,1994-03-12,40616649Y,sara.gurrutxaga@extremecloud.com,093529,ES94209525837524276640,1768.53,2022-05-02T15:45:22,Donostia,expenses,leisure,-62.04,3859.3
buyer_5,Sara,Gurrutxaga,1994-03-12,40616649Y,sara.gurrutxaga@extremecloud.com,093529,ES94209525837524276640,1768.53,2022-05-04T00:02:48,Donostia,expenses,mortgage,-2381.78,1477.52
buyer_5,Sara,Gurrutxaga,1994-03-12,40616649Y,sara.gurrutxaga@extremecloud.com,093529,ES94209525837524276640,1768.53,2022-05-05T17:02:40,Donostia,expenses,transport,-45.76,1431.76
buyer_5,Sara,Gurrutxaga,1994-03-12,40616649Y,sara.gurrutxaga@extremecloud.com,093529,ES94209525837524276640,1768.53,2022-05-05T13:22:57,Donostia,expenses,cash,-100.0,1331.76
buyer_5,Sara,Gurrutxaga,1994-03-12,40616649Y,sara.gurrutxaga@extremecloud.com,093529,ES94209525837524276640,1768.53,2022-05-05T13:10:24,Donostia,expenses,gifts,-159.09,1172.67
buyer_5,Sara,Gurrutxaga,1994-03-12,40616649Y,sara.gurrutxaga@extremecloud.com,093529,ES94209525837524276640,1768.53,2022-05-06T14:09:25,Donostia,expenses,electricity,-156.56,1016.11
buyer_5,Sara,Gurrutxaga,1994-03-12,40616649Y,sara.gurrutxaga@extremecloud.com,093529,ES94209525837524276640,1768.53,2022-05-06T16:27:35,Donostia,expenses,gas,-260.98,755.13
buyer_5,Sara,Gurrutxaga,1994-03-12,40616649Y,sara.gurrutxaga@extremecloud.com,093529,ES94209525837524276640,1768.53,2022-05-07T23:38:45,Donostia,expenses,water,-87.02,668.11
buyer_5,Sara,Gurrutxaga,1994-03-12,40616649Y,sara.gurrutxaga@extremecloud.com,093529,ES94209525837524276640,1768.53,2022-05-07T14:57:33,Donostia,expenses,clothing,-144.55,523.56
buyer_5,Sara,Gurrutxaga,1994-03-12,40616649Y,sara.gurrutxaga@extremecloud.com,093529,ES94209525837524276640,1768.53,2022-05-08T11:44:14,Donostia,expenses,food,-84.4,439.16
buyer_5,Sara,Gurrutxaga,1994-03-12,40616649Y,sara.gurrutxaga@extremecloud.com,093529,ES94209525837524276640,1768.53,2022-05-08T11:16:07,Donostia,expenses,cash,-100.0,339.16
buyer_5,Sara,Gurrutxaga,1994-03-12,40616649Y,sara.gurrutxaga@extremecloud.com,093529,ES94209525837524276640,1768.53,2022-05-09T19:31:07,Donostia,expenses,transport,-68.93,270.23
buyer_5,Sara,Gurrutxaga,1994-03-12,40616649Y,sara.gurrutxaga@extremecloud.com,093529,ES94209525837524276640,1768.53,2022-05-11T02:14:21,Donostia,expenses,cash,-100.0,170.23
buyer_5,Sara,Gurrutxaga,1994-03-12,40616649Y,sara.gurrutxaga@extremecloud.com,093529,ES94209525837524276640,1768.53,2022-05-11T11:32:10,Donostia,expenses,gifts,-304.62,-134.39
buyer_5,Sara,Gurrutxaga,1994-03-12,40616649Y,sara.gurrutxaga@extremecloud.com,093529,ES94209525837524276640,1768.53,2022-05-12T16:24:13,Donostia,expenses,leisure,-69.36,-203.75
buyer_5,Sara,Gurrutxaga,1994-03-12,40616649Y,sara.gurrutxaga@extremecloud.com,093529,ES94209525837524276640,1768.53,2022-05-13T08:32:43,Donostia,expenses,food,-70.83,-274.58
buyer_5,Sara,Gurrutxaga,1994-03-12,40616649Y,sara.gurrutxaga@extremecloud.com,093529,ES94209525837524276640,1768.53,2022-05-16T22:32:35,Donostia,expenses,food,-75.14,-349.72
buyer_5,Sara,Gurrutxaga,1994-03-12,40616649Y,sara.gurrutxaga@extremecloud.com,093529,ES94209525837524276640,1768.53,2022-05-16T01:07:43,Donostia,expenses,repairs,-73.08,-422.8
buyer_5,Sara,Gurrutxaga,1994-03-12,40616649Y,sara.gurrutxaga@extremecloud.com,093529,ES94209525837524276640,1768.53,2022-05-16T23:15:53,Donostia,expenses,gifts,-706.18,-1128.98
buyer_5,Sara,Gurrutxaga,1994-03-12,40616649Y,sara.gurrutxaga@extremecloud.com,093529,ES94209525837524276640,1768.53,2022-05-17T17:04:00,Donostia,expenses,education,-56.92,-1185.9
buyer_5,Sara,Gurrutxaga,1994-03-12,40616649Y,sara.gurrutxaga@extremecloud.com,093529,ES94209525837524276640,1768.53,2022-05-18T19:50:40,Donostia,expenses,healthcare,-92.92,-1278.82
buyer_5,Sara,Gurrutxaga,1994-03-12,40616649Y,sara.gurrutxaga@extremecloud.com,093529,ES94209525837524276640,1768.53,2022-05-21T18:05:51,Donostia,expenses,food,-97.29,-1376.11
buyer_5,Sara,Gurrutxaga,1994-03-12,40616649Y,sara.gurrutxaga@extremecloud.com,093529,ES94209525837524276640,1768.53,2022-05-21T07:51:24,Donostia,expenses,healthcare,-40.67,-1416.78
buyer_5,Sara,Gurrutxaga,1994-03-12,40616649Y,sara.gurrutxaga@extremecloud.com,093529,ES94209525837524276640,1768.53,2022-05-21T22:30:30,Donostia,expenses,gifts,-599.44,-2016.22
buyer_5,Sara,Gurrutxaga,1994-03-12,40616649Y,sara.gurrutxaga@extremecloud.com,093529,ES94209525837524276640,1768.53,2022-05-22T08:46:19,Donostia,expenses,gifts,-354.01,-2370.23
buyer_5,Sara,Gurrutxaga,1994-03-12,40616649Y,sara.gurrutxaga@extremecloud.com,093529,ES94209525837524276640,1768.53,2022-05-23T10:10:26,Donostia,expenses,food,-114.34,-2484.57
buyer_5,Sara,Gurrutxaga,1994-03-12,40616649Y,sara.gurrutxaga@extremecloud.com,093529,ES94209525837524276640,1768.53,2022-05-23T20:44:59,Donostia,expenses,leisure,-63.62,-2548.19
buyer_5,Sara,Gurrutxaga,1994-03-12,40616649Y,sara.gurrutxaga@extremecloud.com,093529,ES94209525837524276640,1768.53,2022-05-23T09:52:37,Donostia,expenses,cash,-100.0,-2648.19
buyer_5,Sara,Gurrutxaga,1994-03-12,40616649Y,sara.gurrutxaga@extremecloud.com,093529,ES94209525837524276640,1768.53,2022-05-25T14:41:40,Donostia,expenses,food,-73.05,-2721.24
buyer_5,Sara,Gurrutxaga,1994-03-12,40616649Y,sara.gurrutxaga@extremecloud.com,093529,ES94209525837524276640,1768.53,2022-05-25T17:32:52,Donostia,expenses,cash,-100.0,-2821.24
buyer_5,Sara,Gurrutxaga,1994-03-12,40616649Y,sara.gurrutxaga@extremecloud.com,093529,ES94209525837524276640,1768.53,2022-05-26T19:35:23,Donostia,expenses,leisure,-55.59,-2876.83
buyer_5,Sara,Gurrutxaga,1994-03-12,40616649Y,sara.gurrutxaga@extremecloud.com,093529,ES94209525837524276640,1768.53,2022-05-26T03:42:40,Donostia,expenses,cash,-100.0,-2976.83
buyer_5,Sara,Gurrutxaga,1994-03-12,40616649Y,sara.gurrutxaga@extremecloud.com,093529,ES94209525837524276640,1768.53,2022-05-27T20:01:26,Donostia,expenses,clothing,-147.63,-3124.46
buyer_5,Sara,Gurrutxaga,1994-03-12,40616649Y,sara.gurrutxaga@extremecloud.com,093529,ES94209525837524276640,1768.53,2022-05-30T17:08:12,Donostia,expenses,leisure,-46.92,-3171.38
buyer_5,Sara,Gurrutxaga,1994-03-12,40616649Y,sara.gurrutxaga@extremecloud.com,093529,ES94209525837524276640,1768.53,2022-05-31T16:58:46,Donostia,expenses,food,-79.27,-3250.65
buyer_5,Sara,Gurrutxaga,1994-03-12,40616649Y,sara.gurrutxaga@extremecloud.com,093529,ES94209525837524276640,1768.53,2022-06-01T22:56:04,Donostia,incomes,salary,2531.24,-719.41
buyer_5,Sara,Gurrutxaga,1994-03-12,40616649Y,sara.gurrutxaga@extremecloud.com,093529,ES94209525837524276640,1768.53,2022-06-01T22:56:04,Donostia,incomes,salary_partner,2972.21,2252.8
buyer_5,Sara,Gurrutxaga,1994-03-12,40616649Y,sara.gurrutxaga@extremecloud.com,093529,ES94209525837524276640,1768.53,2022-06-01T22:56:04,Donostia,incomes,salary_bonus,1826.98,4079.78
buyer_5,Sara,Gurrutxaga,1994-03-12,40616649Y,sara.gurrutxaga@extremecloud.com,093529,ES94209525837524276640,1768.53,2022-06-01T22:56:04,Donostia,incomes,salary_partner_bonus,2210.91,6290.69
buyer_5,Sara,Gurrutxaga,1994-03-12,40616649Y,sara.gurrutxaga@extremecloud.com,093529,ES94209525837524276640,1768.53,2022-06-01T12:28:17,Donostia,expenses,taxes,-4037.71,2252.98
buyer_5,Sara,Gurrutxaga,1994-03-12,40616649Y,sara.gurrutxaga@extremecloud.com,093529,ES94209525837524276640,1768.53,2022-06-01T18:57:19,Donostia,expenses,insurance,-1238.25,1014.73
buyer_5,Sara,Gurrutxaga,1994-03-12,40616649Y,sara.gurrutxaga@extremecloud.com,093529,ES94209525837524276640,1768.53,2022-06-01T22:46:56,Donostia,expenses,education,-70.64,944.09
buyer_5,Sara,Gurrutxaga,1994-03-12,40616649Y,sara.gurrutxaga@extremecloud.com,093529,ES94209525837524276640,1768.53,2022-06-01T21:00:49,Donostia,expenses,cash,-100.0,844.09
buyer_5,Sara,Gurrutxaga,1994-03-12,40616649Y,sara.gurrutxaga@extremecloud.com,093529,ES94209525837524276640,1768.53,2022-06-03T10:28:52,Donostia,expenses,transport,-58.78,785.31
buyer_5,Sara,Gurrutxaga,1994-03-12,40616649Y,sara.gurrutxaga@extremecloud.com,093529,ES94209525837524276640,1768.53,2022-06-04T13:46:33,Donostia,expenses,mortgage,-2381.78,-1596.47
buyer_5,Sara,Gurrutxaga,1994-03-12,40616649Y,sara.gurrutxaga@extremecloud.com,093529,ES94209525837524276640,1768.53,2022-06-04T19:23:38,Donostia,expenses,food,-105.99,-1702.46
buyer_5,Sara,Gurrutxaga,1994-03-12,40616649Y,sara.gurrutxaga@extremecloud.com,093529,ES94209525837524276640,1768.53,2022-06-04T08:28:52,Donostia,expenses,healthcare,-80.12,-1782.58
buyer_5,Sara,Gurrutxaga,1994-03-12,40616649Y,sara.gurrutxaga@extremecloud.com,093529,ES94209525837524276640,1768.53,2022-06-05T09:14:43,Donostia,expenses,water,-119.97,-1902.55
buyer_5,Sara,Gurrutxaga,1994-03-12,40616649Y,sara.gurrutxaga@extremecloud.com,093529,ES94209525837524276640,1768.53,2022-06-05T05:40:59,Donostia,expenses,internet,-115.57,-2018.12
buyer_5,Sara,Gurrutxaga,1994-03-12,40616649Y,sara.gurrutxaga@extremecloud.com,093529,ES94209525837524276640,1768.53,2022-06-06T17:48:21,Donostia,expenses,electricity,-77.43,-2095.55
buyer_5,Sara,Gurrutxaga,1994-03-12,40616649Y,sara.gurrutxaga@extremecloud.com,093529,ES94209525837524276640,1768.53,2022-06-06T17:40:03,Donostia,expenses,internet,-115.57,-2211.12
buyer_5,Sara,Gurrutxaga,1994-03-12,40616649Y,sara.gurrutxaga@extremecloud.com,093529,ES94209525837524276640,1768.53,2022-06-06T11:21:13,Donostia,expenses,appliances,-280.32,-2491.44
buyer_5,Sara,Gurrutxaga,1994-03-12,40616649Y,sara.gurrutxaga@extremecloud.com,093529,ES94209525837524276640,1768.53,2022-06-07T08:56:24,Donostia,expenses,water,-72.8,-2564.24
buyer_5,Sara,Gurrutxaga,1994-03-12,40616649Y,sara.gurrutxaga@extremecloud.com,093529,ES94209525837524276640,1768.53,2022-06-07T08:10:53,Donostia,expenses,internet,-115.57,-2679.81
buyer_5,Sara,Gurrutxaga,1994-03-12,40616649Y,sara.gurrutxaga@extremecloud.com,093529,ES94209525837524276640,1768.53,2022-06-07T10:34:58,Donostia,expenses,clothing,-122.63,-2802.44
buyer_5,Sara,Gurrutxaga,1994-03-12,40616649Y,sara.gurrutxaga@extremecloud.com,093529,ES94209525837524276640,1768.53,2022-06-08T10:10:33,Donostia,expenses,water,-106.15,-2908.59
buyer_5,Sara,Gurrutxaga,1994-03-12,40616649Y,sara.gurrutxaga@extremecloud.com,093529,ES94209525837524276640,1768.53,2022-06-08T20:21:48,Donostia,expenses,gas,-283.62,-3192.21
buyer_5,Sara,Gurrutxaga,1994-03-12,40616649Y,sara.gurrutxaga@extremecloud.com,093529,ES94209525837524276640,1768.53,2022-06-08T18:56:45,Donostia,expenses,internet,-115.57,-3307.78
buyer_5,Sara,Gurrutxaga,1994-03-12,40616649Y,sara.gurrutxaga@extremecloud.com,093529,ES94209525837524276640,1768.53,2022-06-08T18:13:42,Donostia,expenses,phone,-85.95,-3393.73
buyer_5,Sara,Gurrutxaga,1994-03-12,40616649Y,sara.gurrutxaga@extremecloud.com,093529,ES94209525837524276640,1768.53,2022-06-08T20:35:49,Donostia,expenses,food,-72.19,-3465.92
buyer_5,Sara,Gurrutxaga,1994-03-12,40616649Y,sara.gurrutxaga@extremecloud.com,093529,ES94209525837524276640,1768.53,2022-06-09T08:00:24,Donostia,expenses,food,-122.11,-3588.03
buyer_5,Sara,Gurrutxaga,1994-03-12,40616649Y,sara.gurrutxaga@extremecloud.com,093529,ES94209525837524276640,1768.53,2022-06-11T19:28:12,Donostia,expenses,leisure,-27.97,-3616.0
buyer_5,Sara,Gurrutxaga,1994-03-12,40616649Y,sara.gurrutxaga@extremecloud.com,093529,ES94209525837524276640,1768.53,2022-06-13T10:08:35,Donostia,expenses,transport,-40.71,-3656.71
buyer_5,Sara,Gurrutxaga,1994-03-12,40616649Y,sara.gurrutxaga@extremecloud.com,093529,ES94209525837524276640,1768.53,2022-06-14T16:26:10,Donostia,expenses,appliances,-372.48,-4029.19
buyer_5,Sara,Gurrutxaga,1994-03-12,40616649Y,sara.gurrutxaga@extremecloud.com,093529,ES94209525837524276640,1768.53,2022-06-15T14:41:34,Donostia,expenses,clothing,-130.39,-4159.58
buyer_5,Sara,Gurrutxaga,1994-03-12,40616649Y,sara.gurrutxaga@extremecloud.com,093529,ES94209525837524276640,1768.53,2022-06-16T19:31:55,Donostia,expenses,cash,-100.0,-4259.58
buyer_5,Sara,Gurrutxaga,1994-03-12,40616649Y,sara.gurrutxaga@extremecloud.com,093529,ES94209525837524276640,1768.53,2022-06-16T20:05:48,Donostia,expenses,gifts,-260.07,-4519.65
buyer_5,Sara,Gurrutxaga,1994-03-12,40616649Y,sara.gurrutxaga@extremecloud.com,093529,ES94209525837524276640,1768.53,2022-06-20T09:43:18,Donostia,expenses,food,-96.26,-4615.91
buyer_5,Sara,Gurrutxaga,1994-03-12,40616649Y,sara.gurrutxaga@extremecloud.com,093529,ES94209525837524276640,1768.53,2022-06-20T19:59:18,Donostia,expenses,leisure,-84.19,-4700.1
buyer_5,Sara,Gurrutxaga,1994-03-12,40616649Y,sara.gurrutxaga@extremecloud.com,093529,ES94209525837524276640,1768.53,2022-06-20T14:55:26,Donostia,expenses,gifts,-402.64,-5102.74
buyer_5,Sara,Gurrutxaga,1994-03-12,40616649Y,sara.gurrutxaga@extremecloud.com,093529,ES94209525837524276640,1768.53,2022-06-21T06:33:55,Donostia,expenses,leisure,-51.2,-5153.94
buyer_5,Sara,Gurrutxaga,1994-03-12,40616649Y,sara.gurrutxaga@extremecloud.com,093529,ES94209525837524276640,1768.53,2022-06-26T05:09:08,Donostia,expenses,education,-59.73,-5213.67
buyer_5,Sara,Gurrutxaga,1994-03-12,40616649Y,sara.gurrutxaga@extremecloud.com,093529,ES94209525837524276640,1768.53,2022-06-28T21:18:27,Donostia,expenses,clothing,-88.18,-5301.85
buyer_5,Sara,Gurrutxaga,1994-03-12,40616649Y,sara.gurrutxaga@extremecloud.com,093529,ES94209525837524276640,1768.53,2022-06-29T04:52:08,Donostia,expenses,cash,-100.0,-5401.85
buyer_5,Sara,Gurrutxaga,1994-03-12,40616649Y,sara.gurrutxaga@extremecloud.com,093529,ES94209525837524276640,1768.53,2022-07-01T20:02:47,Donostia,incomes,salary,2531.24,-2870.61
buyer_5,Sara,Gurrutxaga,1994-03-12,40616649Y,sara.gurrutxaga@extremecloud.com,093529,ES94209525837524276640,1768.53,2022-07-01T20:02:47,Donostia,incomes,salary_partner,2972.21,101.6
buyer_5,Sara,Gurrutxaga,1994-03-12,40616649Y,sara.gurrutxaga@extremecloud.com,093529,ES94209525837524276640,1768.53,2022-07-01T20:02:47,Donostia,incomes,extra_income,354.73,456.33
buyer_5,Sara,Gurrutxaga,1994-03-12,40616649Y,sara.gurrutxaga@extremecloud.com,093529,ES94209525837524276640,1768.53,2022-07-01T23:04:06,Donostia,expenses,cash,-100.0,356.33
buyer_5,Sara,Gurrutxaga,1994-03-12,40616649Y,sara.gurrutxaga@extremecloud.com,093529,ES94209525837524276640,1768.53,2022-07-02T14:52:27,Donostia,expenses,leisure,-48.75,307.58
buyer_5,Sara,Gurrutxaga,1994-03-12,40616649Y,sara.gurrutxaga@extremecloud.com,093529,ES94209525837524276640,1768.53,2022-07-03T10:35:27,Donostia,expenses,leisure,-62.08,245.5
buyer_5,Sara,Gurrutxaga,1994-03-12,40616649Y,sara.gurrutxaga@extremecloud.com,093529,ES94209525837524276640,1768.53,2022-07-03T13:20:40,Donostia,expenses,repairs,-27.88,217.62
buyer_5,Sara,Gurrutxaga,1994-03-12,40616649Y,sara.gurrutxaga@extremecloud.com,093529,ES94209525837524276640,1768.53,2022-07-04T09:12:20,Donostia,expenses,mortgage,-2381.78,-2164.16
buyer_5,Sara,Gurrutxaga,1994-03-12,40616649Y,sara.gurrutxaga@extremecloud.com,093529,ES94209525837524276640,1768.53,2022-07-05T18:05:25,Donostia,expenses,gifts,-460.37,-2624.53
buyer_5,Sara,Gurrutxaga,1994-03-12,40616649Y,sara.gurrutxaga@extremecloud.com,093529,ES94209525837524276640,1768.53,2022-07-06T17:58:42,Donostia,expenses,food,-85.01,-2709.54
buyer_5,Sara,Gurrutxaga,1994-03-12,40616649Y,sara.gurrutxaga@extremecloud.com,093529,ES94209525837524276640,1768.53,2022-07-06T21:04:32,Donostia,expenses,cash,-100.0,-2809.54
buyer_5,Sara,Gurrutxaga,1994-03-12,40616649Y,sara.gurrutxaga@extremecloud.com,093529,ES94209525837524276640,1768.53,2022-07-07T20:29:04,Donostia,expenses,phone,-108.66,-2918.2
buyer_5,Sara,Gurrutxaga,1994-03-12,40616649Y,sara.gurrutxaga@extremecloud.com,093529,ES94209525837524276640,1768.53,2022-07-07T08:22:25,Donostia,expenses,food,-110.42,-3028.62
buyer_5,Sara,Gurrutxaga,1994-03-12,40616649Y,sara.gurrutxaga@extremecloud.com,093529,ES94209525837524276640,1768.53,2022-07-07T23:10:33,Donostia,expenses,transport,-67.6,-3096.22
buyer_5,Sara,Gurrutxaga,1994-03-12,40616649Y,sara.gurrutxaga@extremecloud.com,093529,ES94209525837524276640,1768.53,2022-07-07T15:47:06,Donostia,expenses,cash,-100.0,-3196.22
buyer_5,Sara,Gurrutxaga,1994-03-12,40616649Y,sara.gurrutxaga@extremecloud.com,093529,ES94209525837524276640,1768.53,2022-07-08T16:08:27,Donostia,expenses,internet,-115.57,-3311.79
buyer_5,Sara,Gurrutxaga,1994-03-12,40616649Y,sara.gurrutxaga@extremecloud.com,093529,ES94209525837524276640,1768.53,2022-07-08T08:36:51,Donostia,expenses,leisure,-68.61,-3380.4
buyer_5,Sara,Gurrutxaga,1994-03-12,40616649Y,sara.gurrutxaga@extremecloud.com,093529,ES94209525837524276640,1768.53,2022-07-09T11:49:50,Donostia,expenses,leisure,-30.95,-3411.35
buyer_5,Sara,Gurrutxaga,1994-03-12,40616649Y,sara.gurrutxaga@extremecloud.com,093529,ES94209525837524276640,1768.53,2022-07-10T12:30:43,Donostia,expenses,repairs,-162.43,-3573.78
buyer_5,Sara,Gurrutxaga,1994-03-12,40616649Y,sara.gurrutxaga@extremecloud.com,093529,ES94209525837524276640,1768.53,2022-07-11T13:34:04,Donostia,expenses,leisure,-25.34,-3599.12
buyer_5,Sara,Gurrutxaga,1994-03-12,40616649Y,sara.gurrutxaga@extremecloud.com,093529,ES94209525837524276640,1768.53,2022-07-11T22:35:19,Donostia,expenses,healthcare,-156.21,-3755.33
buyer_5,Sara,Gurrutxaga,1994-03-12,40616649Y,sara.gurrutxaga@extremecloud.com,093529,ES94209525837524276640,1768.53,2022-07-12T17:37:02,Donostia,expenses,leisure,-67.65,-3822.98
buyer_5,Sara,Gurrutxaga,1994-03-12,40616649Y,sara.gurrutxaga@extremecloud.com,093529,ES94209525837524276640,1768.53,2022-07-12T05:36:10,Donostia,expenses,healthcare,-40.28,-3863.26
buyer_5,Sara,Gurrutxaga,1994-03-12,40616649Y,sara.gurrutxaga@extremecloud.com,093529,ES94209525837524276640,1768.53,2022-07-12T08:24:44,Donostia,expenses,cash,-100.0,-3963.26
buyer_5,Sara,Gurrutxaga,1994-03-12,40616649Y,sara.gurrutxaga@extremecloud.com,093529,ES94209525837524276640,1768.53,2022-07-13T04:13:16,Donostia,expenses,clothing,-71.23,-4034.49
buyer_5,Sara,Gurrutxaga,1994-03-12,40616649Y,sara.gurrutxaga@extremecloud.com,093529,ES94209525837524276640,1768.53,2022-07-13T02:24:24,Donostia,expenses,cash,-100.0,-4134.49
buyer_5,Sara,Gurrutxaga,1994-03-12,40616649Y,sara.gurrutxaga@extremecloud.com,093529,ES94209525837524276640,1768.53,2022-07-15T16:57:27,Donostia,expenses,leisure,-29.17,-4163.66
buyer_5,Sara,Gurrutxaga,1994-03-12,40616649Y,sara.gurrutxaga@extremecloud.com,093529,ES94209525837524276640,1768.53,2022-07-16T02:25:26,Donostia,expenses,clothing,-86.33,-4249.99
buyer_5,Sara,Gurrutxaga,1994-03-12,40616649Y,sara.gurrutxaga@extremecloud.com,093529,ES94209525837524276640,1768.53,2022-07-16T16:47:21,Donostia,expenses,cash,-100.0,-4349.99
buyer_5,Sara,Gurrutxaga,1994-03-12,40616649Y,sara.gurrutxaga@extremecloud.com,093529,ES94209525837524276640,1768.53,2022-07-17T09:29:34,Donostia,expenses,food,-78.05,-4428.04
buyer_5,Sara,Gurrutxaga,1994-03-12,40616649Y,sara.gurrutxaga@extremecloud.com,093529,ES94209525837524276640,1768.53,2022-07-18T12:11:43,Donostia,expenses,food,-97.98,-4526.02
buyer_5,Sara,Gurrutxaga,1994-03-12,40616649Y,sara.gurrutxaga@extremecloud.com,093529,ES94209525837524276640,1768.53,2022-07-20T14:12:37,Donostia,expenses,healthcare,-158.25,-4684.27
buyer_5,Sara,Gurrutxaga,1994-03-12,40616649Y,sara.gurrutxaga@extremecloud.com,093529,ES94209525837524276640,1768.53,2022-07-22T15:21:59,Donostia,expenses,cash,-100.0,-4784.27
buyer_5,Sara,Gurrutxaga,1994-03-12,40616649Y,sara.gurrutxaga@extremecloud.com,093529,ES94209525837524276640,1768.53,2022-07-23T08:44:42,Donostia,expenses,repairs,-128.32,-4912.59
buyer_5,Sara,Gurrutxaga,1994-03-12,40616649Y,sara.gurrutxaga@extremecloud.com,093529,ES94209525837524276640,1768.53,2022-07-23T12:27:18,Donostia,expenses,gifts,-244.36,-5156.95
buyer_5,Sara,Gurrutxaga,1994-03-12,40616649Y,sara.gurrutxaga@extremecloud.com,093529,ES94209525837524276640,1768.53,2022-07-25T09:09:40,Donostia,expenses,food,-81.5,-5238.45
buyer_5,Sara,Gurrutxaga,1994-03-12,40616649Y,sara.gurrutxaga@extremecloud.com,093529,ES94209525837524276640,1768.53,2022-07-25T08:18:40,Donostia,expenses,repairs,-80.19,-5318.64
buyer_5,Sara,Gurrutxaga,1994-03-12,40616649Y,sara.gurrutxaga@extremecloud.com,093529,ES94209525837524276640,1768.53,2022-07-26T10:14:01,Donostia,expenses,transport,-59.3,-5377.94
buyer_5,Sara,Gurrutxaga,1994-03-12,40616649Y,sara.gurrutxaga@extremecloud.com,093529,ES94209525837524276640,1768.53,2022-07-27T19:47:28,Donostia,expenses,cash,-100.0,-5477.94
buyer_5,Sara,Gurrutxaga,1994-03-12,40616649Y,sara.gurrutxaga@extremecloud.com,093529,ES94209525837524276640,1768.53,2022-07-28T11:17:13,Donostia,expenses,repairs,-60.2,-5538.14
buyer_5,Sara,Gurrutxaga,1994-03-12,40616649Y,sara.gurrutxaga@extremecloud.com,093529,ES94209525837524276640,1768.53,2022-07-29T12:39:53,Donostia,expenses,transport,-79.62,-5617.76
buyer_5,Sara,Gurrutxaga,1994-03-12,40616649Y,sara.gurrutxaga@extremecloud.com,093529,ES94209525837524276640,1768.53,2022-07-29T01:34:43,Donostia,expenses,cash,-100.0,-5717.76
buyer_5,Sara,Gurrutxaga,1994-03-12,40616649Y,sara.gurrutxaga@extremecloud.com,093529,ES94209525837524276640,1768.53,2022-07-30T10:50:07,Donostia,expenses,repairs,-94.73,-5812.49
buyer_5,Sara,Gurrutxaga,1994-03-12,40616649Y,sara.gurrutxaga@extremecloud.com,093529,ES94209525837524276640,1768.53,2022-07-30T15:29:16,Donostia,expenses,gifts,-830.11,-6642.6
buyer_5,Sara,Gurrutxaga,1994-03-12,40616649Y,sara.gurrutxaga@extremecloud.com,093529,ES94209525837524276640,1768.53,2022-07-31T21:15:01,Donostia,expenses,transport,-73.03,-6715.63
buyer_5,Sara,Gurrutxaga,1994-03-12,40616649Y,sara.gurrutxaga@extremecloud.com,093529,ES94209525837524276640,1768.53,2022-07-31T10:22:47,Donostia,expenses,leisure,-49.96,-6765.59
buyer_5,Sara,Gurrutxaga,1994-03-12,40616649Y,sara.gurrutxaga@extremecloud.com,093529,ES94209525837524276640,1768.53,2022-07-31T15:46:33,Donostia,expenses,gifts,-505.63,-7271.22
buyer_5,Sara,Gurrutxaga,1994-03-12,40616649Y,sara.gurrutxaga@extremecloud.com,093529,ES94209525837524276640,1768.53,2022-08-01T20:42:07,Donostia,incomes,salary,2531.24,-4739.98
buyer_5,Sara,Gurrutxaga,1994-03-12,40616649Y,sara.gurrutxaga@extremecloud.com,093529,ES94209525837524276640,1768.53,2022-08-01T20:42:07,Donostia,incomes,salary_partner,2972.21,-1767.77
buyer_5,Sara,Gurrutxaga,1994-03-12,40616649Y,sara.gurrutxaga@extremecloud.com,093529,ES94209525837524276640,1768.53,2022-08-02T18:00:07,Donostia,expenses,cash,-100.0,-1867.77
buyer_5,Sara,Gurrutxaga,1994-03-12,40616649Y,sara.gurrutxaga@extremecloud.com,093529,ES94209525837524276640,1768.53,2022-08-03T03:23:23,Donostia,expenses,appliances,-76.84,-1944.61
buyer_5,Sara,Gurrutxaga,1994-03-12,40616649Y,sara.gurrutxaga@extremecloud.com,093529,ES94209525837524276640,1768.53,2022-08-04T15:35:13,Donostia,expenses,mortgage,-2381.78,-4326.39
buyer_5,Sara,Gurrutxaga,1994-03-12,40616649Y,sara.gurrutxaga@extremecloud.com,093529,ES94209525837524276640,1768.53,2022-08-04T01:10:50,Donostia,expenses,food,-116.6,-4442.99
buyer_5,Sara,Gurrutxaga,1994-03-12,40616649Y,sara.gurrutxaga@extremecloud.com,093529,ES94209525837524276640,1768.53,2022-08-04T10:40:20,Donostia,expenses,cash,-100.0,-4542.99
buyer_5,Sara,Gurrutxaga,1994-03-12,40616649Y,sara.gurrutxaga@extremecloud.com,093529,ES94209525837524276640,1768.53,2022-08-05T02:21:44,Donostia,expenses,phone,-117.49,-4660.48
buyer_5,Sara,Gurrutxaga,1994-03-12,40616649Y,sara.gurrutxaga@extremecloud.com,093529,ES94209525837524276640,1768.53,2022-08-06T20:35:43,Donostia,expenses,cash,-100.0,-4760.48
buyer_5,Sara,Gurrutxaga,1994-03-12,40616649Y,sara.gurrutxaga@extremecloud.com,093529,ES94209525837524276640,1768.53,2022-08-07T18:14:11,Donostia,expenses,phone,-89.89,-4850.37
buyer_5,Sara,Gurrutxaga,1994-03-12,40616649Y,sara.gurrutxaga@extremecloud.com,093529,ES94209525837524276640,1768.53,2022-08-08T21:21:51,Donostia,expenses,water,-118.87,-4969.24
buyer_5,Sara,Gurrutxaga,1994-03-12,40616649Y,sara.gurrutxaga@extremecloud.com,093529,ES94209525837524276640,1768.53,2022-08-08T20:51:29,Donostia,expenses,gas,-190.79,-5160.03
buyer_5,Sara,Gurrutxaga,1994-03-12,40616649Y,sara.gurrutxaga@extremecloud.com,093529,ES94209525837524276640,1768.53,2022-08-08T11:44:07,Donostia,expenses,internet,-115.57,-5275.6
buyer_5,Sara,Gurrutxaga,1994-03-12,40616649Y,sara.gurrutxaga@extremecloud.com,093529,ES94209525837524276640,1768.53,2022-08-08T17:30:15,Donostia,expenses,repairs,-93.54,-5369.14
buyer_5,Sara,Gurrutxaga,1994-03-12,40616649Y,sara.gurrutxaga@extremecloud.com,093529,ES94209525837524276640,1768.53,2022-08-10T23:11:05,Donostia,expenses,gifts,-697.56,-6066.7
buyer_5,Sara,Gurrutxaga,1994-03-12,40616649Y,sara.gurrutxaga@extremecloud.com,093529,ES94209525837524276640,1768.53,2022-08-12T21:09:36,Donostia,expenses,repairs,-303.39,-6370.09
buyer_5,Sara,Gurrutxaga,1994-03-12,40616649Y,sara.gurrutxaga@extremecloud.com,093529,ES94209525837524276640,1768.53,2022-08-14T16:44:45,Donostia,expenses,education,-68.84,-6438.93
buyer_5,Sara,Gurrutxaga,1994-03-12,40616649Y,sara.gurrutxaga@extremecloud.com,093529,ES94209525837524276640,1768.53,2022-08-14T13:10:24,Donostia,expenses,appliances,-366.84,-6805.77
buyer_5,Sara,Gurrutxaga,1994-03-12,40616649Y,sara.gurrutxaga@extremecloud.com,093529,ES94209525837524276640,1768.53,2022-08-16T16:04:41,Donostia,expenses,leisure,-79.77,-6885.54
buyer_5,Sara,Gurrutxaga,1994-03-12,40616649Y,sara.gurrutxaga@extremecloud.com,093529,ES94209525837524276640,1768.53,2022-08-16T16:19:10,Donostia,expenses,healthcare,-160.88,-7046.42
buyer_5,Sara,Gurrutxaga,1994-03-12,40616649Y,sara.gurrutxaga@extremecloud.com,093529,ES94209525837524276640,1768.53,2022-08-18T12:01:07,Donostia,expenses,transport,-82.82,-7129.24
buyer_5,Sara,Gurrutxaga,1994-03-12,40616649Y,sara.gurrutxaga@extremecloud.com,093529,ES94209525837524276640,1768.53,2022-08-18T09:31:33,Donostia,expenses,cash,-100.0,-7229.24
buyer_5,Sara,Gurrutxaga,1994-03-12,40616649Y,sara.gurrutxaga@extremecloud.com,093529,ES94209525837524276640,1768.53,2022-08-19T13:00:18,Donostia,expenses,food,-105.4,-7334.64
buyer_5,Sara,Gurrutxaga,1994-03-12,40616649Y,sara.gurrutxaga@extremecloud.com,093529,ES94209525837524276640,1768.53,2022-08-20T15:56:33,Donostia,expenses,leisure,-56.26,-7390.9
buyer_5,Sara,Gurrutxaga,1994-03-12,40616649Y,sara.gurrutxaga@extremecloud.com,093529,ES94209525837524276640,1768.53,2022-08-21T18:08:36,Donostia,expenses,transport,-57.9,-7448.8
buyer_5,Sara,Gurrutxaga,1994-03-12,40616649Y,sara.gurrutxaga@extremecloud.com,093529,ES94209525837524276640,1768.53,2022-08-24T11:20:42,Donostia,expenses,transport,-50.43,-7499.23
buyer_5,Sara,Gurrutxaga,1994-03-12,40616649Y,sara.gurrutxaga@extremecloud.com,093529,ES94209525837524276640,1768.53,2022-08-24T18:26:34,Donostia,expenses,cash,-100.0,-7599.23
buyer_5,Sara,Gurrutxaga,1994-03-12,40616649Y,sara.gurrutxaga@extremecloud.com,093529,ES94209525837524276640,1768.53,2022-08-25T20:19:46,Donostia,expenses,cash,-100.0,-7699.23
buyer_5,Sara,Gurrutxaga,1994-03-12,40616649Y,sara.gurrutxaga@extremecloud.com,093529,ES94209525837524276640,1768.53,2022-08-26T01:08:44,Donostia,expenses,healthcare,-74.49,-7773.72
buyer_5,Sara,Gurrutxaga,1994-03-12,40616649Y,sara.gurrutxaga@extremecloud.com,093529,ES94209525837524276640,1768.53,2022-08-26T15:34:30,Donostia,expenses,repairs,-142.17,-7915.89
buyer_5,Sara,Gurrutxaga,1994-03-12,40616649Y,sara.gurrutxaga@extremecloud.com,093529,ES94209525837524276640,1768.53,2022-08-27T18:33:08,Donostia,expenses,leisure,-56.17,-7972.06
buyer_5,Sara,Gurrutxaga,1994-03-12,40616649Y,sara.gurrutxaga@extremecloud.com,093529,ES94209525837524276640,1768.53,2022-08-28T12:07:27,Donostia,expenses,food,-116.76,-8088.82
buyer_5,Sara,Gurrutxaga,1994-03-12,40616649Y,sara.gurrutxaga@extremecloud.com,093529,ES94209525837524276640,1768.53,2022-08-28T11:42:41,Donostia,expenses,leisure,-81.4,-8170.22
buyer_5,Sara,Gurrutxaga,1994-03-12,40616649Y,sara.gurrutxaga@extremecloud.com,093529,ES94209525837524276640,1768.53,2022-08-28T11:27:25,Donostia,expenses,cash,-100.0,-8270.22
buyer_5,Sara,Gurrutxaga,1994-03-12,40616649Y,sara.gurrutxaga@extremecloud.com,093529,ES94209525837524276640,1768.53,2022-08-30T19:24:42,Donostia,expenses,education,-69.37,-8339.59
buyer_5,Sara,Gurrutxaga,1994-03-12,40616649Y,sara.gurrutxaga@extremecloud.com,093529,ES94209525837524276640,1768.53,2022-08-30T10:43:10,Donostia,expenses,repairs,-239.1,-8578.69
buyer_5,Sara,Gurrutxaga,1994-03-12,40616649Y,sara.gurrutxaga@extremecloud.com,093529,ES94209525837524276640,1768.53,2022-08-31T23:03:43,Donostia,expenses,education,-54.1,-8632.79
buyer_5,Sara,Gurrutxaga,1994-03-12,40616649Y,sara.gurrutxaga@extremecloud.com,093529,ES94209525837524276640,1768.53,2022-08-31T16:41:41,Donostia,expenses,cash,-100.0,-8732.79
buyer_5,Sara,Gurrutxaga,1994-03-12,40616649Y,sara.gurrutxaga@extremecloud.com,093529,ES94209525837524276640,1768.53,2022-09-01T19:54:44,Donostia,incomes,salary,2531.24,-6201.55
buyer_5,Sara,Gurrutxaga,1994-03-12,40616649Y,sara.gurrutxaga@extremecloud.com,093529,ES94209525837524276640,1768.53,2022-09-01T19:54:44,Donostia,incomes,salary_partner,2972.21,-3229.34
buyer_5,Sara,Gurrutxaga,1994-03-12,40616649Y,sara.gurrutxaga@extremecloud.com,093529,ES94209525837524276640,1768.53,2022-09-01T10:41:34,Donostia,expenses,travel,-404.49,-3633.83
buyer_5,Sara,Gurrutxaga,1994-03-12,40616649Y,sara.gurrutxaga@extremecloud.com,093529,ES94209525837524276640,1768.53,2022-09-03T09:49:13,Donostia,expenses,food,-76.0,-3709.83
buyer_5,Sara,Gurrutxaga,1994-03-12,40616649Y,sara.gurrutxaga@extremecloud.com,093529,ES94209525837524276640,1768.53,2022-09-03T11:54:07,Donostia,expenses,cash,-100.0,-3809.83
buyer_5,Sara,Gurrutxaga,1994-03-12,40616649Y,sara.gurrutxaga@extremecloud.com,093529,ES94209525837524276640,1768.53,2022-09-04T11:38:40,Donostia,expenses,mortgage,-2381.78,-6191.61
buyer_5,Sara,Gurrutxaga,1994-03-12,40616649Y,sara.gurrutxaga@extremecloud.com,093529,ES94209525837524276640,1768.53,2022-09-04T15:17:57,Donostia,expenses,repairs,-109.28,-6300.89
buyer_5,Sara,Gurrutxaga,1994-03-12,40616649Y,sara.gurrutxaga@extremecloud.com,093529,ES94209525837524276640,1768.53,2022-09-05T11:36:45,Donostia,expenses,food,-104.18,-6405.07
buyer_5,Sara,Gurrutxaga,1994-03-12,40616649Y,sara.gurrutxaga@extremecloud.com,093529,ES94209525837524276640,1768.53,2022-09-05T14:18:50,Donostia,expenses,cash,-100.0,-6505.07
buyer_5,Sara,Gurrutxaga,1994-03-12,40616649Y,sara.gurrutxaga@extremecloud.com,093529,ES94209525837524276640,1768.53,2022-09-06T09:20:00,Donostia,expenses,electricity,-148.17,-6653.24
buyer_5,Sara,Gurrutxaga,1994-03-12,40616649Y,sara.gurrutxaga@extremecloud.com,093529,ES94209525837524276640,1768.53,2022-09-06T20:12:32,Donostia,expenses,gas,-169.14,-6822.38
buyer_5,Sara,Gurrutxaga,1994-03-12,40616649Y,sara.gurrutxaga@extremecloud.com,093529,ES94209525837524276640,1768.53,2022-09-06T16:38:31,Donostia,expenses,phone,-121.75,-6944.13
buyer_5,Sara,Gurrutxaga,1994-03-12,40616649Y,sara.gurrutxaga@extremecloud.com,093529,ES94209525837524276640,1768.53,2022-09-06T15:52:17,Donostia,expenses,cash,-100.0,-7044.13
buyer_5,Sara,Gurrutxaga,1994-03-12,40616649Y,sara.gurrutxaga@extremecloud.com,093529,ES94209525837524276640,1768.53,2022-09-07T13:19:08,Donostia,expenses,water,-66.47,-7110.6
buyer_5,Sara,Gurrutxaga,1994-03-12,40616649Y,sara.gurrutxaga@extremecloud.com,093529,ES94209525837524276640,1768.53,2022-09-07T19:24:18,Donostia,expenses,electricity,-112.54,-7223.14
buyer_5,Sara,Gurrutxaga,1994-03-12,40616649Y,sara.gurrutxaga@extremecloud.com,093529,ES94209525837524276640,1768.53,2022-09-08T18:23:37,Donostia,expenses,gas,-94.41,-7317.55
buyer_5,Sara,Gurrutxaga,1994-03-12,40616649Y,sara.gurrutxaga@extremecloud.com,093529,ES94209525837524276640,1768.53,2022-09-10T13:31:55,Donostia,expenses,food,-60.76,-7378.31
buyer_5,Sara,Gurrutxaga,1994-03-12,40616649Y,sara.gurrutxaga@extremecloud.com,093529,ES94209525837524276640,1768.53,2022-09-12T08:50:57,Donostia,expenses,food,-117.21,-7495.52
buyer_5,Sara,Gurrutxaga,1994-03-12,40616649Y,sara.gurrutxaga@extremecloud.com,093529,ES94209525837524276640,1768.53,2022-09-12T23:01:58,Donostia,expenses,leisure,-39.55,-7535.07
buyer_5,Sara,Gurrutxaga,1994-03-12,40616649Y,sara.gurrutxaga@extremecloud.com,093529,ES94209525837524276640,1768.53,2022-09-12T14:22:00,Donostia,expenses,appliances,-368.78,-7903.85
buyer_5,Sara,Gurrutxaga,1994-03-12,40616649Y,sara.gurrutxaga@extremecloud.com,093529,ES94209525837524276640,1768.53,2022-09-15T09:44:57,Donostia,expenses,food,-64.7,-7968.55
buyer_5,Sara,Gurrutxaga,1994-03-12,40616649Y,sara.gurrutxaga@extremecloud.com,093529,ES94209525837524276640,1768.53,2022-09-15T09:14:57,Donostia,expenses,cash,-100.0,-8068.55
buyer_5,Sara,Gurrutxaga,1994-03-12,40616649Y,sara.gurrutxaga@extremecloud.com,093529,ES94209525837524276640,1768.53,2022-09-15T19:36:15,Donostia,expenses,repairs,-131.75,-8200.3
buyer_5,Sara,Gurrutxaga,1994-03-12,40616649Y,sara.gurrutxaga@extremecloud.com,093529,ES94209525837524276640,1768.53,2022-09-17T08:08:55,Donostia,expenses,clothing,-46.32,-8246.62
buyer_5,Sara,Gurrutxaga,1994-03-12,40616649Y,sara.gurrutxaga@extremecloud.com,093529,ES94209525837524276640,1768.53,2022-09-17T09:11:26,Donostia,expenses,gifts,-543.71,-8790.33
buyer_5,Sara,Gurrutxaga,1994-03-12,40616649Y,sara.gurrutxaga@extremecloud.com,093529,ES94209525837524276640,1768.53,2022-09-18T11:19:17,Donostia,expenses,appliances,-376.4,-9166.73
buyer_5,Sara,Gurrutxaga,1994-03-12,40616649Y,sara.gurrutxaga@extremecloud.com,093529,ES94209525837524276640,1768.53,2022-09-22T12:57:26,Donostia,expenses,leisure,-73.56,-9240.29
buyer_5,Sara,Gurrutxaga,1994-03-12,40616649Y,sara.gurrutxaga@extremecloud.com,093529,ES94209525837524276640,1768.53,2022-09-22T11:29:22,Donostia,expenses,cash,-100.0,-9340.29
buyer_5,Sara,Gurrutxaga,1994-03-12,40616649Y,sara.gurrutxaga@extremecloud.com,093529,ES94209525837524276640,1768.53,2022-09-24T08:17:32,Donostia,expenses,clothing,-54.95,-9395.24
buyer_5,Sara,Gurrutxaga,1994-03-12,40616649Y,sara.gurrutxaga@extremecloud.com,093529,ES94209525837524276640,1768.53,2022-09-25T14:14:43,Donostia,expenses,gifts,-299.24,-9694.48
buyer_5,Sara,Gurrutxaga,1994-03-12,40616649Y,sara.gurrutxaga@extremecloud.com,093529,ES94209525837524276640,1768.53,2022-09-26T09:43:53,Donostia,expenses,cash,-100.0,-9794.48
buyer_5,Sara,Gurrutxaga,1994-03-12,40616649Y,sara.gurrutxaga@extremecloud.com,093529,ES94209525837524276640,1768.53,2022-09-27T20:10:47,Donostia,expenses,food,-67.83,-9862.31
buyer_5,Sara,Gurrutxaga,1994-03-12,40616649Y,sara.gurrutxaga@extremecloud.com,093529,ES94209525837524276640,1768.53,2022-09-29T10:34:57,Donostia,expenses,repairs,-177.24,-10039.55
buyer_5,Sara,Gurrutxaga,1994-03-12,40616649Y,sara.gurrutxaga@extremecloud.com,093529,ES94209525837524276640,1768.53,2022-09-30T19:38:03,Donostia,expenses,transport,-56.75,-10096.3
buyer_5,Sara,Gurrutxaga,1994-03-12,40616649Y,sara.gurrutxaga@extremecloud.com,093529,ES94209525837524276640,1768.53,2022-10-01T13:36:31,Donostia,incomes,salary,2531.24,-7565.06
buyer_5,Sara,Gurrutxaga,1994-03-12,40616649Y,sara.gurrutxaga@extremecloud.com,093529,ES94209525837524276640,1768.53,2022-10-01T13:36:31,Donostia,incomes,salary_partner,2972.21,-4592.85
buyer_5,Sara,Gurrutxaga,1994-03-12,40616649Y,sara.gurrutxaga@extremecloud.com,093529,ES94209525837524276640,1768.53,2022-10-01T13:36:31,Donostia,incomes,extra_income,354.73,-4238.12
buyer_5,Sara,Gurrutxaga,1994-03-12,40616649Y,sara.gurrutxaga@extremecloud.com,093529,ES94209525837524276640,1768.53,2022-10-01T15:20:19,Donostia,expenses,leisure,-68.51,-4306.63
buyer_5,Sara,Gurrutxaga,1994-03-12,40616649Y,sara.gurrutxaga@extremecloud.com,093529,ES94209525837524276640,1768.53,2022-10-01T18:36:07,Donostia,expenses,cash,-100.0,-4406.63
buyer_5,Sara,Gurrutxaga,1994-03-12,40616649Y,sara.gurrutxaga@extremecloud.com,093529,ES94209525837524276640,1768.53,2022-10-04T15:59:40,Donostia,expenses,mortgage,-2381.78,-6788.41
buyer_5,Sara,Gurrutxaga,1994-03-12,40616649Y,sara.gurrutxaga@extremecloud.com,093529,ES94209525837524276640,1768.53,2022-10-05T12:01:44,Donostia,expenses,electricity,-66.41,-6854.82
buyer_5,Sara,Gurrutxaga,1994-03-12,40616649Y,sara.gurrutxaga@extremecloud.com,093529,ES94209525837524276640,1768.53,2022-10-05T15:59:12,Donostia,expenses,gas,-147.11,-7001.93
buyer_5,Sara,Gurrutxaga,1994-03-12,40616649Y,sara.gurrutxaga@extremecloud.com,093529,ES94209525837524276640,1768.53,2022-10-05T07:57:58,Donostia,expenses,internet,-115.57,-7117.5
buyer_5,Sara,Gurrutxaga,1994-03-12,40616649Y,sara.gurrutxaga@extremecloud.com,093529,ES94209525837524276640,1768.53,2022-10-06T13:49:40,Donostia,expenses,electricity,-68.33,-7185.83
buyer_5,Sara,Gurrutxaga,1994-03-12,40616649Y,sara.gurrutxaga@extremecloud.com,093529,ES94209525837524276640,1768.53,2022-10-06T16:34:14,Donostia,expenses,internet,-115.57,-7301.4
buyer_5,Sara,Gurrutxaga,1994-03-12,40616649Y,sara.gurrutxaga@extremecloud.com,093529,ES94209525837524276640,1768.53,2022-10-07T18:39:05,Donostia,expenses,water,-101.86,-7403.26
buyer_5,Sara,Gurrutxaga,1994-03-12,40616649Y,sara.gurrutxaga@extremecloud.com,093529,ES94209525837524276640,1768.53,2022-10-07T18:29:44,Donostia,expenses,electricity,-121.64,-7524.9
buyer_5,Sara,Gurrutxaga,1994-03-12,40616649Y,sara.gurrutxaga@extremecloud.com,093529,ES94209525837524276640,1768.53,2022-10-07T19:19:32,Donostia,expenses,gas,-315.84,-7840.74
buyer_5,Sara,Gurrutxaga,1994-03-12,40616649Y,sara.gurrutxaga@extremecloud.com,093529,ES94209525837524276640,1768.53,2022-10-07T23:13:19,Donostia,expenses,food,-83.48,-7924.22
buyer_5,Sara,Gurrutxaga,1994-03-12,40616649Y,sara.gurrutxaga@extremecloud.com,093529,ES94209525837524276640,1768.53,2022-10-07T10:36:08,Donostia,expenses,transport,-54.38,-7978.6
buyer_5,Sara,Gurrutxaga,1994-03-12,40616649Y,sara.gurrutxaga@extremecloud.com,093529,ES94209525837524276640,1768.53,2022-10-07T09:48:38,Donostia,expenses,appliances,-182.48,-8161.08
buyer_5,Sara,Gurrutxaga,1994-03-12,40616649Y,sara.gurrutxaga@extremecloud.com,093529,ES94209525837524276640,1768.53,2022-10-08T13:57:53,Donostia,expenses,gas,-225.02,-8386.1
buyer_5,Sara,Gurrutxaga,1994-03-12,40616649Y,sara.gurrutxaga@extremecloud.com,093529,ES94209525837524276640,1768.53,2022-10-11T15:28:45,Donostia,expenses,cash,-100.0,-8486.1
buyer_5,Sara,Gurrutxaga,1994-03-12,40616649Y,sara.gurrutxaga@extremecloud.com,093529,ES94209525837524276640,1768.53,2022-10-12T07:17:18,Donostia,expenses,leisure,-38.57,-8524.67
buyer_5,Sara,Gurrutxaga,1994-03-12,40616649Y,sara.gurrutxaga@extremecloud.com,093529,ES94209525837524276640,1768.53,2022-10-14T15:28:28,Donostia,expenses,leisure,-78.32,-8602.99
buyer_5,Sara,Gurrutxaga,1994-03-12,40616649Y,sara.gurrutxaga@extremecloud.com,093529,ES94209525837524276640,1768.53,2022-10-16T20:22:14,Donostia,expenses,food,-78.37,-8681.36
buyer_5,Sara,Gurrutxaga,1994-03-12,40616649Y,sara.gurrutxaga@extremecloud.com,093529,ES94209525837524276640,1768.53,2022-10-16T11:26:19,Donostia,expenses,transport,-41.65,-8723.01
buyer_5,Sara,Gurrutxaga,1994-03-12,40616649Y,sara.gurrutxaga@extremecloud.com,093529,ES94209525837524276640,1768.53,2022-10-16T11:40:03,Donostia,expenses,leisure,-52.95,-8775.96
buyer_5,Sara,Gurrutxaga,1994-03-12,40616649Y,sara.gurrutxaga@extremecloud.com,093529,ES94209525837524276640,1768.53,2022-10-17T13:41:37,Donostia,expenses,cash,-100.0,-8875.96
buyer_5,Sara,Gurrutxaga,1994-03-12,40616649Y,sara.gurrutxaga@extremecloud.com,093529,ES94209525837524276640,1768.53,2022-10-17T14:28:52,Donostia,expenses,repairs,-301.8,-9177.76
buyer_5,Sara,Gurrutxaga,1994-03-12,40616649Y,sara.gurrutxaga@extremecloud.com,093529,ES94209525837524276640,1768.53,2022-10-19T12:53:15,Donostia,expenses,clothing,-91.0,-9268.76
buyer_5,Sara,Gurrutxaga,1994-03-12,40616649Y,sara.gurrutxaga@extremecloud.com,093529,ES94209525837524276640,1768.53,2022-10-20T10:49:45,Donostia,expenses,education,-58.2,-9326.96
buyer_5,Sara,Gurrutxaga,1994-03-12,40616649Y,sara.gurrutxaga@extremecloud.com,093529,ES94209525837524276640,1768.53,2022-10-20T20:55:23,Donostia,expenses,cash,-100.0,-9426.96
buyer_5,Sara,Gurrutxaga,1994-03-12,40616649Y,sara.gurrutxaga@extremecloud.com,093529,ES94209525837524276640,1768.53,2022-10-20T21:19:15,Donostia,expenses,repairs,-118.65,-9545.61
buyer_5,Sara,Gurrutxaga,1994-03-12,40616649Y,sara.gurrutxaga@extremecloud.com,093529,ES94209525837524276640,1768.53,2022-10-21T12:51:26,Donostia,expenses,transport,-48.95,-9594.56
buyer_5,Sara,Gurrutxaga,1994-03-12,40616649Y,sara.gurrutxaga@extremecloud.com,093529,ES94209525837524276640,1768.53,2022-10-22T15:12:06,Donostia,expenses,food,-62.15,-9656.71
buyer_5,Sara,Gurrutxaga,1994-03-12,40616649Y,sara.gurrutxaga@extremecloud.com,093529,ES94209525837524276640,1768.53,2022-10-22T19:55:56,Donostia,expenses,leisure,-75.07,-9731.78
buyer_5,Sara,Gurrutxaga,1994-03-12,40616649Y,sara.gurrutxaga@extremecloud.com,093529,ES94209525837524276640,1768.53,2022-10-22T09:03:37,Donostia,expenses,cash,-100.0,-9831.78
buyer_5,Sara,Gurrutxaga,1994-03-12,40616649Y,sara.gurrutxaga@extremecloud.com,093529,ES94209525837524276640,1768.53,2022-10-24T17:22:21,Donostia,expenses,food,-68.99,-9900.77
buyer_5,Sara,Gurrutxaga,1994-03-12,40616649Y,sara.gurrutxaga@extremecloud.com,093529,ES94209525837524276640,1768.53,2022-10-25T11:57:37,Donostia,expenses,gifts,-789.19,-10689.96
buyer_5,Sara,Gurrutxaga,1994-03-12,40616649Y,sara.gurrutxaga@extremecloud.com,093529,ES94209525837524276640,1768.53,2022-10-27T19:42:51,Donostia,expenses,cash,-100.0,-10789.96
buyer_5,Sara,Gurrutxaga,1994-03-12,40616649Y,sara.gurrutxaga@extremecloud.com,093529,ES94209525837524276640,1768.53,2022-10-28T18:13:32,Donostia,expenses,cash,-100.0,-10889.96
buyer_5,Sara,Gurrutxaga,1994-03-12,40616649Y,sara.gurrutxaga@extremecloud.com,093529,ES94209525837524276640,1768.53,2022-10-31T20:22:18,Donostia,expenses,food,-70.24,-10960.2
buyer_5,Sara,Gurrutxaga,1994-03-12,40616649Y,sara.gurrutxaga@extremecloud.com,093529,ES94209525837524276640,1768.53,2022-10-31T08:07:28,Donostia,expenses,leisure,-19.57,-10979.77
buyer_5,Sara,Gurrutxaga,1994-03-12,40616649Y,sara.gurrutxaga@extremecloud.com,093529,ES94209525837524276640,1768.53,2022-11-01T10:20:25,Donostia,incomes,salary,2531.24,-8448.53
buyer_5,Sara,Gurrutxaga,1994-03-12,40616649Y,sara.gurrutxaga@extremecloud.com,093529,ES94209525837524276640,1768.53,2022-11-01T10:20:25,Donostia,incomes,salary_partner,2972.21,-5476.32
buyer_5,Sara,Gurrutxaga,1994-03-12,40616649Y,sara.gurrutxaga@extremecloud.com,093529,ES94209525837524276640,1768.53,2022-11-01T19:44:04,Donostia,expenses,repairs,-87.69,-5564.01
buyer_5,Sara,Gurrutxaga,1994-03-12,40616649Y,sara.gurrutxaga@extremecloud.com,093529,ES94209525837524276640,1768.53,2022-11-02T12:30:02,Donostia,expenses,appliances,-355.45,-5919.46
buyer_5,Sara,Gurrutxaga,1994-03-12,40616649Y,sara.gurrutxaga@extremecloud.com,093529,ES94209525837524276640,1768.53,2022-11-04T15:10:44,Donostia,expenses,mortgage,-2381.78,-8301.24
buyer_5,Sara,Gurrutxaga,1994-03-12,40616649Y,sara.gurrutxaga@extremecloud.com,093529,ES94209525837524276640,1768.53,2022-11-05T16:37:21,Donostia,expenses,water,-80.65,-8381.89
buyer_5,Sara,Gurrutxaga,1994-03-12,40616649Y,sara.gurrutxaga@extremecloud.com,093529,ES94209525837524276640,1768.53,2022-11-05T14:13:50,Donostia,expenses,gas,-180.91,-8562.8
buyer_5,Sara,Gurrutxaga,1994-03-12,40616649Y,sara.gurrutxaga@extremecloud.com,093529,ES94209525837524276640,1768.53,2022-11-05T11:01:08,Donostia,expenses,food,-100.92,-8663.72
buyer_5,Sara,Gurrutxaga,1994-03-12,40616649Y,sara.gurrutxaga@extremecloud.com,093529,ES94209525837524276640,1768.53,2022-11-06T13:55:20,Donostia,expenses,internet,-115.57,-8779.29
buyer_5,Sara,Gurrutxaga,1994-03-12,40616649Y,sara.gurrutxaga@extremecloud.com,093529,ES94209525837524276640,1768.53,2022-11-06T13:35:58,Donostia,expenses,transport,-83.98,-8863.27
buyer_5,Sara,Gurrutxaga,1994-03-12,40616649Y,sara.gurrutxaga@extremecloud.com,093529,ES94209525837524276640,1768.53,2022-11-07T11:26:49,Donostia,expenses,water,-98.59,-8961.86
buyer_5,Sara,Gurrutxaga,1994-03-12,40616649Y,sara.gurrutxaga@extremecloud.com,093529,ES94209525837524276640,1768.53,2022-11-07T15:01:29,Donostia,expenses,electricity,-196.75,-9158.61
buyer_5,Sara,Gurrutxaga,1994-03-12,40616649Y,sara.gurrutxaga@extremecloud.com,093529,ES94209525837524276640,1768.53,2022-11-07T07:09:34,Donostia,expenses,leisure,-37.76,-9196.37
buyer_5,Sara,Gurrutxaga,1994-03-12,40616649Y,sara.gurrutxaga@extremecloud.com,093529,ES94209525837524276640,1768.53,2022-11-08T17:36:03,Donostia,expenses,phone,-91.4,-9287.77
buyer_5,Sara,Gurrutxaga,1994-03-12,40616649Y,sara.gurrutxaga@extremecloud.com,093529,ES94209525837524276640,1768.53,2022-11-09T18:28:32,Donostia,expenses,food,-87.45,-9375.22
buyer_5,Sara,Gurrutxaga,1994-03-12,40616649Y,sara.gurrutxaga@extremecloud.com,093529,ES94209525837524276640,1768.53,2022-11-09T15:53:19,Donostia,expenses,education,-69.06,-9444.28
buyer_5,Sara,Gurrutxaga,1994-03-12,40616649Y,sara.gurrutxaga@extremecloud.com,093529,ES94209525837524276640,1768.53,2022-11-10T14:16:00,Donostia,expenses,leisure,-53.54,-9497.82
buyer_5,Sara,Gurrutxaga,1994-03-12,40616649Y,sara.gurrutxaga@extremecloud.com,093529,ES94209525837524276640,1768.53,2022-11-12T22:09:46,Donostia,expenses,food,-95.79,-9593.61
buyer_5,Sara,Gurrutxaga,1994-03-12,40616649Y,sara.gurrutxaga@extremecloud.com,093529,ES94209525837524276640,1768.53,2022-11-14T13:59:35,Donostia,expenses,clothing,-113.26,-9706.87
buyer_5,Sara,Gurrutxaga,1994-03-12,40616649Y,sara.gurrutxaga@extremecloud.com,093529,ES94209525837524276640,1768.53,2022-11-14T11:25:36,Donostia,expenses,repairs,-246.98,-9953.85
buyer_5,Sara,Gurrutxaga,1994-03-12,40616649Y,sara.gurrutxaga@extremecloud.com,093529,ES94209525837524276640,1768.53,2022-11-17T12:17:26,Donostia,expenses,leisure,-51.14,-10004.99
buyer_5,Sara,Gurrutxaga,1994-03-12,40616649Y,sara.gurrutxaga@extremecloud.com,093529,ES94209525837524276640,1768.53,2022-11-18T11:18:52,Donostia,expenses,leisure,-56.59,-10061.58
buyer_5,Sara,Gurrutxaga,1994-03-12,40616649Y,sara.gurrutxaga@extremecloud.com,093529,ES94209525837524276640,1768.53,2022-11-20T13:37:22,Donostia,expenses,cash,-100.0,-10161.58
buyer_5,Sara,Gurrutxaga,1994-03-12,40616649Y,sara.gurrutxaga@extremecloud.com,093529,ES94209525837524276640,1768.53,2022-11-21T17:18:58,Donostia,expenses,appliances,-182.5,-10344.08
buyer_5,Sara,Gurrutxaga,1994-03-12,40616649Y,sara.gurrutxaga@extremecloud.com,093529,ES94209525837524276640,1768.53,2022-11-23T20:14:07,Donostia,expenses,cash,-100.0,-10444.08
buyer_5,Sara,Gurrutxaga,1994-03-12,40616649Y,sara.gurrutxaga@extremecloud.com,093529,ES94209525837524276640,1768.53,2022-11-26T09:34:17,Donostia,expenses,food,-110.73,-10554.81
buyer_5,Sara,Gurrutxaga,1994-03-12,40616649Y,sara.gurrutxaga@extremecloud.com,093529,ES94209525837524276640,1768.53,2022-11-28T17:13:36,Donostia,expenses,food,-109.87,-10664.68
buyer_5,Sara,Gurrutxaga,1994-03-12,40616649Y,sara.gurrutxaga@extremecloud.com,093529,ES94209525837524276640,1768.53,2022-11-28T15:52:16,Donostia,expenses,education,-74.01,-10738.69
buyer_5,Sara,Gurrutxaga,1994-03-12,40616649Y,sara.gurrutxaga@extremecloud.com,093529,ES94209525837524276640,1768.53,2022-12-01T20:42:35,Donostia,incomes,salary,2531.24,-8207.45
buyer_5,Sara,Gurrutxaga,1994-03-12,40616649Y,sara.gurrutxaga@extremecloud.com,093529,ES94209525837524276640,1768.53,2022-12-01T20:42:35,Donostia,incomes,salary_partner,2972.21,-5235.24
buyer_5,Sara,Gurrutxaga,1994-03-12,40616649Y,sara.gurrutxaga@extremecloud.com,093529,ES94209525837524276640,1768.53,2022-12-01T20:42:35,Donostia,incomes,salary_bonus,2019.64,-3215.6
buyer_5,Sara,Gurrutxaga,1994-03-12,40616649Y,sara.gurrutxaga@extremecloud.com,093529,ES94209525837524276640,1768.53,2022-12-01T20:42:35,Donostia,incomes,salary_partner_bonus,2168.59,-1047.01
buyer_5,Sara,Gurrutxaga,1994-03-12,40616649Y,sara.gurrutxaga@extremecloud.com,093529,ES94209525837524276640,1768.53,2022-12-03T16:39:22,Donostia,expenses,clothing,-100.44,-1147.45
buyer_5,Sara,Gurrutxaga,1994-03-12,40616649Y,sara.gurrutxaga@extremecloud.com,093529,ES94209525837524276640,1768.53,2022-12-03T11:39:03,Donostia,expenses,cash,-100.0,-1247.45
buyer_5,Sara,Gurrutxaga,1994-03-12,40616649Y,sara.gurrutxaga@extremecloud.com,093529,ES94209525837524276640,1768.53,2022-12-04T18:51:23,Donostia,expenses,mortgage,-2381.78,-3629.23
buyer_5,Sara,Gurrutxaga,1994-03-12,40616649Y,sara.gurrutxaga@extremecloud.com,093529,ES94209525837524276640,1768.53,2022-12-04T15:59:58,Donostia,expenses,food,-69.21,-3698.44
buyer_5,Sara,Gurrutxaga,1994-03-12,40616649Y,sara.gurrutxaga@extremecloud.com,093529,ES94209525837524276640,1768.53,2022-12-05T18:12:27,Donostia,expenses,food,-123.43,-3821.87
buyer_5,Sara,Gurrutxaga,1994-03-12,40616649Y,sara.gurrutxaga@extremecloud.com,093529,ES94209525837524276640,1768.53,2022-12-05T07:17:24,Donostia,expenses,cash,-100.0,-3921.87
buyer_5,Sara,Gurrutxaga,1994-03-12,40616649Y,sara.gurrutxaga@extremecloud.com,093529,ES94209525837524276640,1768.53,2022-12-06T09:45:51,Donostia,expenses,internet,-115.57,-4037.44
buyer_5,Sara,Gurrutxaga,1994-03-12,40616649Y,sara.gurrutxaga@extremecloud.com,093529,ES94209525837524276640,1768.53,2022-12-06T09:04:39,Donostia,expenses,food,-109.29,-4146.73
buyer_5,Sara,Gurrutxaga,1994-03-12,40616649Y,sara.gurrutxaga@extremecloud.com,093529,ES94209525837524276640,1768.53,2022-12-06T12:28:05,Donostia,expenses,travel,-437.15,-4583.88
buyer_5,Sara,Gurrutxaga,1994-03-12,40616649Y,sara.gurrutxaga@extremecloud.com,093529,ES94209525837524276640,1768.53,2022-12-07T09:59:44,Donostia,expenses,electricity,-184.76,-4768.64
buyer_5,Sara,Gurrutxaga,1994-03-12,40616649Y,sara.gurrutxaga@extremecloud.com,093529,ES94209525837524276640,1768.53,2022-12-08T09:28:06,Donostia,expenses,phone,-113.93,-4882.57
buyer_5,Sara,Gurrutxaga,1994-03-12,40616649Y,sara.gurrutxaga@extremecloud.com,093529,ES94209525837524276640,1768.53,2022-12-10T03:02:36,Donostia,expenses,leisure,-63.64,-4946.21
buyer_5,Sara,Gurrutxaga,1994-03-12,40616649Y,sara.gurrutxaga@extremecloud.com,093529,ES94209525837524276640,1768.53,2022-12-12T17:33:34,Donostia,expenses,leisure,-44.38,-4990.59
buyer_5,Sara,Gurrutxaga,1994-03-12,40616649Y,sara.gurrutxaga@extremecloud.com,093529,ES94209525837524276640,1768.53,2022-12-14T18:23:02,Donostia,expenses,repairs,-281.71,-5272.3
buyer_5,Sara,Gurrutxaga,1994-03-12,40616649Y,sara.gurrutxaga@extremecloud.com,093529,ES94209525837524276640,1768.53,2022-12-18T05:34:37,Donostia,expenses,food,-72.33,-5344.63
buyer_5,Sara,Gurrutxaga,1994-03-12,40616649Y,sara.gurrutxaga@extremecloud.com,093529,ES94209525837524276640,1768.53,2022-12-19T16:42:11,Donostia,expenses,cash,-100.0,-5444.63
buyer_5,Sara,Gurrutxaga,1994-03-12,40616649Y,sara.gurrutxaga@extremecloud.com,093529,ES94209525837524276640,1768.53,2022-12-21T11:59:21,Donostia,expenses,clothing,-64.51,-5509.14
buyer_5,Sara,Gurrutxaga,1994-03-12,40616649Y,sara.gurrutxaga@extremecloud.com,093529,ES94209525837524276640,1768.53,2022-12-23T15:04:09,Donostia,expenses,food,-85.44,-5594.58
buyer_5,Sara,Gurrutxaga,1994-03-12,40616649Y,sara.gurrutxaga@extremecloud.com,093529,ES94209525837524276640,1768.53,2022-12-24T18:44:38,Donostia,expenses,cash,-100.0,-5694.58
buyer_5,Sara,Gurrutxaga,1994-03-12,40616649Y,sara.gurrutxaga@extremecloud.com,093529,ES94209525837524276640,1768.53,2022-12-25T08:26:41,Donostia,expenses,gifts,-689.56,-6384.14
buyer_5,Sara,Gurrutxaga,1994-03-12,40616649Y,sara.gurrutxaga@extremecloud.com,093529,ES94209525837524276640,1768.53,2022-12-26T13:08:47,Donostia,expenses,leisure,-33.31,-6417.45
buyer_5,Sara,Gurrutxaga,1994-03-12,40616649Y,sara.gurrutxaga@extremecloud.com,093529,ES94209525837524276640,1768.53,2022-12-26T17:03:52,Donostia,expenses,clothing,-56.02,-6473.47
buyer_5,Sara,Gurrutxaga,1994-03-12,40616649Y,sara.gurrutxaga@extremecloud.com,093529,ES94209525837524276640,1768.53,2022-12-26T09:56:06,Donostia,expenses,cash,-100.0,-6573.47
buyer_5,Sara,Gurrutxaga,1994-03-12,40616649Y,sara.gurrutxaga@extremecloud.com,093529,ES94209525837524276640,1768.53,2022-12-27T14:42:58,Donostia,expenses,cash,-100.0,-6673.47
buyer_5,Sara,Gurrutxaga,1994-03-12,40616649Y,sara.gurrutxaga@extremecloud.com,093529,ES94209525837524276640,1768.53,2022-12-27T18:49:58,Donostia,expenses,travel,-482.12,-7155.59
buyer_5,Sara,Gurrutxaga,1994-03-12,40616649Y,sara.gurrutxaga@extremecloud.com,093529,ES94209525837524276640,1768.53,2022-12-27T15:32:22,Donostia,expenses,repairs,-284.36,-7439.95
buyer_5,Sara,Gurrutxaga,1994-03-12,40616649Y,sara.gurrutxaga@extremecloud.com,093529,ES94209525837524276640,1768.53,2022-12-31T18:25:31,Donostia,expenses,gifts,-603.49,-8043.44
buyer_5,Sara,Gurrutxaga,1994-03-12,40616649Y,sara.gurrutxaga@extremecloud.com,093529,ES94209525837524276640,1768.53,2023-01-01T17:56:14,Donostia,incomes,salary,2623.42,-5420.02
buyer_5,Sara,Gurrutxaga,1994-03-12,40616649Y,sara.gurrutxaga@extremecloud.com,093529,ES94209525837524276640,1768.53,2023-01-01T17:56:14,Donostia,incomes,salary_partner,3080.45,-2339.57
buyer_5,Sara,Gurrutxaga,1994-03-12,40616649Y,sara.gurrutxaga@extremecloud.com,093529,ES94209525837524276640,1768.53,2023-01-01T17:56:14,Donostia,incomes,extra_income,354.73,-1984.84
buyer_5,Sara,Gurrutxaga,1994-03-12,40616649Y,sara.gurrutxaga@extremecloud.com,093529,ES94209525837524276640,1768.53,2023-01-02T17:47:40,Donostia,expenses,clothing,-99.02,-2083.86
buyer_5,Sara,Gurrutxaga,1994-03-12,40616649Y,sara.gurrutxaga@extremecloud.com,093529,ES94209525837524276640,1768.53,2023-01-03T11:53:06,Donostia,expenses,transport,-59.35,-2143.21
buyer_5,Sara,Gurrutxaga,1994-03-12,40616649Y,sara.gurrutxaga@extremecloud.com,093529,ES94209525837524276640,1768.53,2023-01-04T04:55:50,Donostia,expenses,mortgage,-2279.14,-4422.35
buyer_5,Sara,Gurrutxaga,1994-03-12,40616649Y,sara.gurrutxaga@extremecloud.com,093529,ES94209525837524276640,1768.53,2023-01-05T18:11:53,Donostia,expenses,gas,-264.66,-4687.01
buyer_5,Sara,Gurrutxaga,1994-03-12,40616649Y,sara.gurrutxaga@extremecloud.com,093529,ES94209525837524276640,1768.53,2023-01-05T13:31:42,Donostia,expenses,internet,-119.78,-4806.79
buyer_5,Sara,Gurrutxaga,1994-03-12,40616649Y,sara.gurrutxaga@extremecloud.com,093529,ES94209525837524276640,1768.53,2023-01-05T09:20:47,Donostia,expenses,healthcare,-144.93,-4951.72
buyer_5,Sara,Gurrutxaga,1994-03-12,40616649Y,sara.gurrutxaga@extremecloud.com,093529,ES94209525837524276640,1768.53,2023-01-06T19:58:47,Donostia,expenses,electricity,-77.9,-5029.62
buyer_5,Sara,Gurrutxaga,1994-03-12,40616649Y,sara.gurrutxaga@extremecloud.com,093529,ES94209525837524276640,1768.53,2023-01-07T12:13:27,Donostia,expenses,water,-124.92,-5154.54
buyer_5,Sara,Gurrutxaga,1994-03-12,40616649Y,sara.gurrutxaga@extremecloud.com,093529,ES94209525837524276640,1768.53,2023-01-07T18:29:04,Donostia,expenses,electricity,-200.41,-5354.95
buyer_5,Sara,Gurrutxaga,1994-03-12,40616649Y,sara.gurrutxaga@extremecloud.com,093529,ES94209525837524276640,1768.53,2023-01-07T18:17:11,Donostia,expenses,leisure,-71.37,-5426.32
buyer_5,Sara,Gurrutxaga,1994-03-12,40616649Y,sara.gurrutxaga@extremecloud.com,093529,ES94209525837524276640,1768.53,2023-01-08T23:17:04,Donostia,expenses,phone,-122.64,-5548.96
buyer_5,Sara,Gurrutxaga,1994-03-12,40616649Y,sara.gurrutxaga@extremecloud.com,093529,ES94209525837524276640,1768.53,2023-01-08T09:02:59,Donostia,expenses,leisure,-32.51,-5581.47
buyer_5,Sara,Gurrutxaga,1994-03-12,40616649Y,sara.gurrutxaga@extremecloud.com,093529,ES94209525837524276640,1768.53,2023-01-08T12:48:00,Donostia,expenses,healthcare,-187.25,-5768.72
buyer_5,Sara,Gurrutxaga,1994-03-12,40616649Y,sara.gurrutxaga@extremecloud.com,093529,ES94209525837524276640,1768.53,2023-01-09T18:16:47,Donostia,expenses,transport,-80.56,-5849.28
buyer_5,Sara,Gurrutxaga,1994-03-12,40616649Y,sara.gurrutxaga@extremecloud.com,093529,ES94209525837524276640,1768.53,2023-01-09T11:24:21,Donostia,expenses,clothing,-136.99,-5986.27
buyer_5,Sara,Gurrutxaga,1994-03-12,40616649Y,sara.gurrutxaga@extremecloud.com,093529,ES94209525837524276640,1768.53,2023-01-12T19:01:46,Donostia,expenses,appliances,-266.34,-6252.61
buyer_5,Sara,Gurrutxaga,1994-03-12,40616649Y,sara.gurrutxaga@extremecloud.com,093529,ES94209525837524276640,1768.53,2023-01-13T13:23:44,Donostia,expenses,food,-64.18,-6316.79
buyer_5,Sara,Gurrutxaga,1994-03-12,40616649Y,sara.gurrutxaga@extremecloud.com,093529,ES94209525837524276640,1768.53,2023-01-14T21:17:45,Donostia,expenses,travel,-1043.92,-7360.71
buyer_5,Sara,Gurrutxaga,1994-03-12,40616649Y,sara.gurrutxaga@extremecloud.com,093529,ES94209525837524276640,1768.53,2023-01-16T20:18:30,Donostia,expenses,clothing,-97.08,-7457.79
buyer_5,Sara,Gurrutxaga,1994-03-12,40616649Y,sara.gurrutxaga@extremecloud.com,093529,ES94209525837524276640,1768.53,2023-01-17T13:05:54,Donostia,expenses,food,-65.72,-7523.51
buyer_5,Sara,Gurrutxaga,1994-03-12,40616649Y,sara.gurrutxaga@extremecloud.com,093529,ES94209525837524276640,1768.53,2023-01-17T19:22:42,Donostia,expenses,cash,-100.0,-7623.51
buyer_5,Sara,Gurrutxaga,1994-03-12,40616649Y,sara.gurrutxaga@extremecloud.com,093529,ES94209525837524276640,1768.53,2023-01-18T17:47:06,Donostia,expenses,food,-115.23,-7738.74
buyer_5,Sara,Gurrutxaga,1994-03-12,40616649Y,sara.gurrutxaga@extremecloud.com,093529,ES94209525837524276640,1768.53,2023-01-18T18:33:52,Donostia,expenses,leisure,-81.35,-7820.09
buyer_5,Sara,Gurrutxaga,1994-03-12,40616649Y,sara.gurrutxaga@extremecloud.com,093529,ES94209525837524276640,1768.53,2023-01-19T22:26:56,Donostia,expenses,food,-118.35,-7938.44
buyer_5,Sara,Gurrutxaga,1994-03-12,40616649Y,sara.gurrutxaga@extremecloud.com,093529,ES94209525837524276640,1768.53,2023-01-19T11:37:37,Donostia,expenses,clothing,-150.57,-8089.01
buyer_5,Sara,Gurrutxaga,1994-03-12,40616649Y,sara.gurrutxaga@extremecloud.com,093529,ES94209525837524276640,1768.53,2023-01-22T16:06:38,Donostia,expenses,cash,-100.0,-8189.01
buyer_5,Sara,Gurrutxaga,1994-03-12,40616649Y,sara.gurrutxaga@extremecloud.com,093529,ES94209525837524276640,1768.53,2023-01-23T15:29:11,Donostia,expenses,education,-72.73,-8261.74
buyer_5,Sara,Gurrutxaga,1994-03-12,40616649Y,sara.gurrutxaga@extremecloud.com,093529,ES94209525837524276640,1768.53,2023-01-24T17:17:12,Donostia,expenses,cash,-100.0,-8361.74
buyer_5,Sara,Gurrutxaga,1994-03-12,40616649Y,sara.gurrutxaga@extremecloud.com,093529,ES94209525837524276640,1768.53,2023-01-26T14:44:00,Donostia,expenses,gifts,-525.54,-8887.28
buyer_5,Sara,Gurrutxaga,1994-03-12,40616649Y,sara.gurrutxaga@extremecloud.com,093529,ES94209525837524276640,1768.53,2023-01-27T14:50:43,Donostia,expenses,food,-83.14,-8970.42
buyer_5,Sara,Gurrutxaga,1994-03-12,40616649Y,sara.gurrutxaga@extremecloud.com,093529,ES94209525837524276640,1768.53,2023-01-27T09:02:38,Donostia,expenses,cash,-100.0,-9070.42
buyer_5,Sara,Gurrutxaga,1994-03-12,40616649Y,sara.gurrutxaga@extremecloud.com,093529,ES94209525837524276640,1768.53,2023-01-28T17:36:35,Donostia,expenses,transport,-58.26,-9128.68
buyer_5,Sara,Gurrutxaga,1994-03-12,40616649Y,sara.gurrutxaga@extremecloud.com,093529,ES94209525837524276640,1768.53,2023-01-28T19:44:15,Donostia,expenses,healthcare,-53.75,-9182.43
buyer_5,Sara,Gurrutxaga,1994-03-12,40616649Y,sara.gurrutxaga@extremecloud.com,093529,ES94209525837524276640,1768.53,2023-01-28T11:50:33,Donostia,expenses,cash,-100.0,-9282.43
buyer_5,Sara,Gurrutxaga,1994-03-12,40616649Y,sara.gurrutxaga@extremecloud.com,093529,ES94209525837524276640,1768.53,2023-01-29T16:53:42,Donostia,expenses,transport,-80.85,-9363.28
buyer_5,Sara,Gurrutxaga,1994-03-12,40616649Y,sara.gurrutxaga@extremecloud.com,093529,ES94209525837524276640,1768.53,2023-02-01T18:55:44,Donostia,incomes,salary,2623.42,-6739.86
buyer_5,Sara,Gurrutxaga,1994-03-12,40616649Y,sara.gurrutxaga@extremecloud.com,093529,ES94209525837524276640,1768.53,2023-02-01T18:55:44,Donostia,incomes,salary_partner,3080.45,-3659.41
buyer_5,Sara,Gurrutxaga,1994-03-12,40616649Y,sara.gurrutxaga@extremecloud.com,093529,ES94209525837524276640,1768.53,2023-02-01T11:58:01,Donostia,expenses,leisure,-20.43,-3679.84
buyer_5,Sara,Gurrutxaga,1994-03-12,40616649Y,sara.gurrutxaga@extremecloud.com,093529,ES94209525837524276640,1768.53,2023-02-01T18:16:48,Donostia,expenses,appliances,-239.07,-3918.91
buyer_5,Sara,Gurrutxaga,1994-03-12,40616649Y,sara.gurrutxaga@extremecloud.com,093529,ES94209525837524276640,1768.53,2023-02-04T12:50:46,Donostia,expenses,mortgage,-2279.14,-6198.05
buyer_5,Sara,Gurrutxaga,1994-03-12,40616649Y,sara.gurrutxaga@extremecloud.com,093529,ES94209525837524276640,1768.53,2023-02-04T09:10:40,Donostia,expenses,food,-101.74,-6299.79
buyer_5,Sara,Gurrutxaga,1994-03-12,40616649Y,sara.gurrutxaga@extremecloud.com,093529,ES94209525837524276640,1768.53,2023-02-05T15:52:24,Donostia,expenses,food,-92.97,-6392.76
buyer_5,Sara,Gurrutxaga,1994-03-12,40616649Y,sara.gurrutxaga@extremecloud.com,093529,ES94209525837524276640,1768.53,2023-02-06T08:29:33,Donostia,expenses,water,-125.43,-6518.19
buyer_5,Sara,Gurrutxaga,1994-03-12,40616649Y,sara.gurrutxaga@extremecloud.com,093529,ES94209525837524276640,1768.53,2023-02-06T08:05:25,Donostia,expenses,gas,-242.27,-6760.46
buyer_5,Sara,Gurrutxaga,1994-03-12,40616649Y,sara.gurrutxaga@extremecloud.com,093529,ES94209525837524276640,1768.53,2023-02-06T08:47:33,Donostia,expenses,phone,-120.61,-6881.07
buyer_5,Sara,Gurrutxaga,1994-03-12,40616649Y,sara.gurrutxaga@extremecloud.com,093529,ES94209525837524276640,1768.53,2023-02-06T10:53:07,Donostia,expenses,repairs,-215.81,-7096.88
buyer_5,Sara,Gurrutxaga,1994-03-12,40616649Y,sara.gurrutxaga@extremecloud.com,093529,ES94209525837524276640,1768.53,2023-02-07T16:27:04,Donostia,expenses,gas,-116.75,-7213.63
buyer_5,Sara,Gurrutxaga,1994-03-12,40616649Y,sara.gurrutxaga@extremecloud.com,093529,ES94209525837524276640,1768.53,2023-02-07T07:03:23,Donostia,expenses,internet,-119.78,-7333.41
buyer_5,Sara,Gurrutxaga,1994-03-12,40616649Y,sara.gurrutxaga@extremecloud.com,093529,ES94209525837524276640,1768.53,2023-02-07T15:32:33,Donostia,expenses,food,-106.12,-7439.53
buyer_5,Sara,Gurrutxaga,1994-03-12,40616649Y,sara.gurrutxaga@extremecloud.com,093529,ES94209525837524276640,1768.53,2023-02-07T12:47:52,Donostia,expenses,transport,-44.63,-7484.16
buyer_5,Sara,Gurrutxaga,1994-03-12,40616649Y,sara.gurrutxaga@extremecloud.com,093529,ES94209525837524276640,1768.53,2023-02-07T22:25:35,Donostia,expenses,clothing,-121.28,-7605.44
buyer_5,Sara,Gurrutxaga,1994-03-12,40616649Y,sara.gurrutxaga@extremecloud.com,093529,ES94209525837524276640,1768.53,2023-02-08T19:05:22,Donostia,expenses,water,-90.5,-7695.94
buyer_5,Sara,Gurrutxaga,1994-03-12,40616649Y,sara.gurrutxaga@extremecloud.com,093529,ES94209525837524276640,1768.53,2023-02-08T22:15:25,Donostia,expenses,cash,-100.0,-7795.94
buyer_5,Sara,Gurrutxaga,1994-03-12,40616649Y,sara.gurrutxaga@extremecloud.com,093529,ES94209525837524276640,1768.53,2023-02-09T18:51:53,Donostia,expenses,clothing,-149.38,-7945.32
buyer_5,Sara,Gurrutxaga,1994-03-12,40616649Y,sara.gurrutxaga@extremecloud.com,093529,ES94209525837524276640,1768.53,2023-02-09T16:53:21,Donostia,expenses,gifts,-29.13,-7974.45
buyer_5,Sara,Gurrutxaga,1994-03-12,40616649Y,sara.gurrutxaga@extremecloud.com,093529,ES94209525837524276640,1768.53,2023-02-10T01:36:18,Donostia,expenses,leisure,-51.0,-8025.45
buyer_5,Sara,Gurrutxaga,1994-03-12,40616649Y,sara.gurrutxaga@extremecloud.com,093529,ES94209525837524276640,1768.53,2023-02-10T08:52:47,Donostia,expenses,cash,-100.0,-8125.45
buyer_5,Sara,Gurrutxaga,1994-03-12,40616649Y,sara.gurrutxaga@extremecloud.com,093529,ES94209525837524276640,1768.53,2023-02-12T08:03:50,Donostia,expenses,appliances,-281.13,-8406.58
buyer_5,Sara,Gurrutxaga,1994-03-12,40616649Y,sara.gurrutxaga@extremecloud.com,093529,ES94209525837524276640,1768.53,2023-02-13T19:25:14,Donostia,expenses,food,-122.46,-8529.04
buyer_5,Sara,Gurrutxaga,1994-03-12,40616649Y,sara.gurrutxaga@extremecloud.com,093529,ES94209525837524276640,1768.53,2023-02-13T17:02:29,Donostia,expenses,cash,-100.0,-8629.04
buyer_5,Sara,Gurrutxaga,1994-03-12,40616649Y,sara.gurrutxaga@extremecloud.com,093529,ES94209525837524276640,1768.53,2023-02-14T02:15:32,Donostia,expenses,appliances,-154.26,-8783.3
buyer_5,Sara,Gurrutxaga,1994-03-12,40616649Y,sara.gurrutxaga@extremecloud.com,093529,ES94209525837524276640,1768.53,2023-02-15T12:35:40,Donostia,expenses,healthcare,-92.52,-8875.82
buyer_5,Sara,Gurrutxaga,1994-03-12,40616649Y,sara.gurrutxaga@extremecloud.com,093529,ES94209525837524276640,1768.53,2023-02-16T11:59:50,Donostia,expenses,leisure,-82.13,-8957.95
buyer_5,Sara,Gurrutxaga,1994-03-12,40616649Y,sara.gurrutxaga@extremecloud.com,093529,ES94209525837524276640,1768.53,2023-02-17T08:51:31,Donostia,expenses,clothing,-87.29,-9045.24
buyer_5,Sara,Gurrutxaga,1994-03-12,40616649Y,sara.gurrutxaga@extremecloud.com,093529,ES94209525837524276640,1768.53,2023-02-17T21:13:04,Donostia,expenses,healthcare,-127.95,-9173.19
buyer_5,Sara,Gurrutxaga,1994-03-12,40616649Y,sara.gurrutxaga@extremecloud.com,093529,ES94209525837524276640,1768.53,2023-02-17T11:00:30,Donostia,expenses,appliances,-292.68,-9465.87
buyer_5,Sara,Gurrutxaga,1994-03-12,40616649Y,sara.gurrutxaga@extremecloud.com,093529,ES94209525837524276640,1768.53,2023-02-18T14:46:58,Donostia,expenses,repairs,-65.29,-9531.16
buyer_5,Sara,Gurrutxaga,1994-03-12,40616649Y,sara.gurrutxaga@extremecloud.com,093529,ES94209525837524276640,1768.53,2023-02-19T08:45:20,Donostia,expenses,leisure,-49.5,-9580.66
buyer_5,Sara,Gurrutxaga,1994-03-12,40616649Y,sara.gurrutxaga@extremecloud.com,093529,ES94209525837524276640,1768.53,2023-02-22T17:12:55,Donostia,expenses,cash,-100.0,-9680.66
buyer_5,Sara,Gurrutxaga,1994-03-12,40616649Y,sara.gurrutxaga@extremecloud.com,093529,ES94209525837524276640,1768.53,2023-02-25T16:36:20,Donostia,expenses,transport,-46.39,-9727.05
buyer_5,Sara,Gurrutxaga,1994-03-12,40616649Y,sara.gurrutxaga@extremecloud.com,093529,ES94209525837524276640,1768.53,2023-02-25T19:28:05,Donostia,expenses,appliances,-98.48,-9825.53
buyer_5,Sara,Gurrutxaga,1994-03-12,40616649Y,sara.gurrutxaga@extremecloud.com,093529,ES94209525837524276640,1768.53,2023-02-26T08:03:31,Donostia,expenses,food,-115.87,-9941.4
buyer_5,Sara,Gurrutxaga,1994-03-12,40616649Y,sara.gurrutxaga@extremecloud.com,093529,ES94209525837524276640,1768.53,2023-02-26T17:53:22,Donostia,expenses,healthcare,-85.48,-10026.88
buyer_5,Sara,Gurrutxaga,1994-03-12,40616649Y,sara.gurrutxaga@extremecloud.com,093529,ES94209525837524276640,1768.53,2023-02-27T21:51:42,Donostia,expenses,cash,-100.0,-10126.88
buyer_5,Sara,Gurrutxaga,1994-03-12,40616649Y,sara.gurrutxaga@extremecloud.com,093529,ES94209525837524276640,1768.53,2023-03-01T01:52:15,Donostia,incomes,salary,2623.42,-7503.46
buyer_5,Sara,Gurrutxaga,1994-03-12,40616649Y,sara.gurrutxaga@extremecloud.com,093529,ES94209525837524276640,1768.53,2023-03-01T01:52:15,Donostia,incomes,salary_partner,3080.45,-4423.01
buyer_5,Sara,Gurrutxaga,1994-03-12,40616649Y,sara.gurrutxaga@extremecloud.com,093529,ES94209525837524276640,1768.53,2023-03-01T03:50:37,Donostia,expenses,food,-117.78,-4540.79
buyer_5,Sara,Gurrutxaga,1994-03-12,40616649Y,sara.gurrutxaga@extremecloud.com,093529,ES94209525837524276640,1768.53,2023-03-01T07:10:25,Donostia,expenses,appliances,-243.34,-4784.13
buyer_5,Sara,Gurrutxaga,1994-03-12,40616649Y,sara.gurrutxaga@extremecloud.com,093529,ES94209525837524276640,1768.53,2023-03-04T23:01:17,Donostia,expenses,mortgage,-2279.14,-7063.27
buyer_5,Sara,Gurrutxaga,1994-03-12,40616649Y,sara.gurrutxaga@extremecloud.com,093529,ES94209525837524276640,1768.53,2023-03-04T18:20:39,Donostia,expenses,gifts,-627.15,-7690.42
buyer_5,Sara,Gurrutxaga,1994-03-12,40616649Y,sara.gurrutxaga@extremecloud.com,093529,ES94209525837524276640,1768.53,2023-03-05T17:35:02,Donostia,expenses,water,-86.54,-7776.96
buyer_5,Sara,Gurrutxaga,1994-03-12,40616649Y,sara.gurrutxaga@extremecloud.com,093529,ES94209525837524276640,1768.53,2023-03-06T06:46:43,Donostia,expenses,electricity,-96.19,-7873.15
buyer_5,Sara,Gurrutxaga,1994-03-12,40616649Y,sara.gurrutxaga@extremecloud.com,093529,ES94209525837524276640,1768.53,2023-03-08T11:28:36,Donostia,expenses,electricity,-102.02,-7975.17
buyer_5,Sara,Gurrutxaga,1994-03-12,40616649Y,sara.gurrutxaga@extremecloud.com,093529,ES94209525837524276640,1768.53,2023-03-08T15:04:09,Donostia,expenses,gas,-253.27,-8228.44
buyer_5,Sara,Gurrutxaga,1994-03-12,40616649Y,sara.gurrutxaga@extremecloud.com,093529,ES94209525837524276640,1768.53,2023-03-08T09:41:59,Donostia,expenses,cash,-100.0,-8328.44
buyer_5,Sara,Gurrutxaga,1994-03-12,40616649Y,sara.gurrutxaga@extremecloud.com,093529,ES94209525837524276640,1768.53,2023-03-08T22:58:13,Donostia,expenses,repairs,-253.6,-8582.04
buyer_5,Sara,Gurrutxaga,1994-03-12,40616649Y,sara.gurrutxaga@extremecloud.com,093529,ES94209525837524276640,1768.53,2023-03-09T12:08:17,Donostia,expenses,cash,-100.0,-8682.04
buyer_5,Sara,Gurrutxaga,1994-03-12,40616649Y,sara.gurrutxaga@extremecloud.com,093529,ES94209525837524276640,1768.53,2023-03-10T20:56:29,Donostia,expenses,cash,-100.0,-8782.04
buyer_5,Sara,Gurrutxaga,1994-03-12,40616649Y,sara.gurrutxaga@extremecloud.com,093529,ES94209525837524276640,1768.53,2023-03-12T16:21:25,Donostia,expenses,transport,-48.0,-8830.04
buyer_5,Sara,Gurrutxaga,1994-03-12,40616649Y,sara.gurrutxaga@extremecloud.com,093529,ES94209525837524276640,1768.53,2023-03-12T08:33:00,Donostia,expenses,healthcare,-134.77,-8964.81
buyer_5,Sara,Gurrutxaga,1994-03-12,40616649Y,sara.gurrutxaga@extremecloud.com,093529,ES94209525837524276640,1768.53,2023-03-13T08:43:35,Donostia,expenses,healthcare,-173.4,-9138.21
buyer_5,Sara,Gurrutxaga,1994-03-12,40616649Y,sara.gurrutxaga@extremecloud.com,093529,ES94209525837524276640,1768.53,2023-03-14T15:42:06,Donostia,expenses,gifts,-55.61,-9193.82
buyer_5,Sara,Gurrutxaga,1994-03-12,40616649Y,sara.gurrutxaga@extremecloud.com,093529,ES94209525837524276640,1768.53,2023-03-15T14:36:04,Donostia,expenses,cash,-100.0,-9293.82
buyer_5,Sara,Gurrutxaga,1994-03-12,40616649Y,sara.gurrutxaga@extremecloud.com,093529,ES94209525837524276640,1768.53,2023-03-17T10:49:34,Donostia,expenses,food,-93.57,-9387.39
buyer_5,Sara,Gurrutxaga,1994-03-12,40616649Y,sara.gurrutxaga@extremecloud.com,093529,ES94209525837524276640,1768.53,2023-03-17T10:53:11,Donostia,expenses,cash,-100.0,-9487.39
buyer_5,Sara,Gurrutxaga,1994-03-12,40616649Y,sara.gurrutxaga@extremecloud.com,093529,ES94209525837524276640,1768.53,2023-03-18T07:01:53,Donostia,expenses,cash,-100.0,-9587.39
buyer_5,Sara,Gurrutxaga,1994-03-12,40616649Y,sara.gurrutxaga@extremecloud.com,093529,ES94209525837524276640,1768.53,2023-03-20T18:48:00,Donostia,expenses,gifts,-753.3,-10340.69
buyer_5,Sara,Gurrutxaga,1994-03-12,40616649Y,sara.gurrutxaga@extremecloud.com,093529,ES94209525837524276640,1768.53,2023-03-21T15:47:43,Donostia,expenses,transport,-62.68,-10403.37
buyer_5,Sara,Gurrutxaga,1994-03-12,40616649Y,sara.gurrutxaga@extremecloud.com,093529,ES94209525837524276640,1768.53,2023-03-22T09:18:25,Donostia,expenses,food,-109.86,-10513.23
buyer_5,Sara,Gurrutxaga,1994-03-12,40616649Y,sara.gurrutxaga@extremecloud.com,093529,ES94209525837524276640,1768.53,2023-03-28T02:28:53,Donostia,expenses,education,-66.04,-10579.27
buyer_5,Sara,Gurrutxaga,1994-03-12,40616649Y,sara.gurrutxaga@extremecloud.com,093529,ES94209525837524276640,1768.53,2023-03-29T07:13:31,Donostia,expenses,repairs,-329.45,-10908.72
buyer_5,Sara,Gurrutxaga,1994-03-12,40616649Y,sara.gurrutxaga@extremecloud.com,093529,ES94209525837524276640,1768.53,2023-03-31T15:57:39,Donostia,expenses,food,-114.47,-11023.19
buyer_5,Sara,Gurrutxaga,1994-03-12,40616649Y,sara.gurrutxaga@extremecloud.com,093529,ES94209525837524276640,1768.53,2023-04-01T20:59:52,Donostia,incomes,salary,2623.42,-8399.77
buyer_5,Sara,Gurrutxaga,1994-03-12,40616649Y,sara.gurrutxaga@extremecloud.com,093529,ES94209525837524276640,1768.53,2023-04-01T20:59:52,Donostia,incomes,salary_partner,3080.45,-5319.32
buyer_5,Sara,Gurrutxaga,1994-03-12,40616649Y,sara.gurrutxaga@extremecloud.com,093529,ES94209525837524276640,1768.53,2023-04-01T20:59:52,Donostia,incomes,extra_income,354.73,-4964.59
buyer_5,Sara,Gurrutxaga,1994-03-12,40616649Y,sara.gurrutxaga@extremecloud.com,093529,ES94209525837524276640,1768.53,2023-04-01T09:10:44,Donostia,expenses,cash,-100.0,-5064.59
buyer_5,Sara,Gurrutxaga,1994-03-12,40616649Y,sara.gurrutxaga@extremecloud.com,093529,ES94209525837524276640,1768.53,2023-04-02T10:04:57,Donostia,expenses,repairs,-74.88,-5139.47
buyer_5,Sara,Gurrutxaga,1994-03-12,40616649Y,sara.gurrutxaga@extremecloud.com,093529,ES94209525837524276640,1768.53,2023-04-03T18:23:24,Donostia,expenses,food,-82.23,-5221.7
buyer_5,Sara,Gurrutxaga,1994-03-12,40616649Y,sara.gurrutxaga@extremecloud.com,093529,ES94209525837524276640,1768.53,2023-04-03T20:55:29,Donostia,expenses,leisure,-56.66,-5278.36
buyer_5,Sara,Gurrutxaga,1994-03-12,40616649Y,sara.gurrutxaga@extremecloud.com,093529,ES94209525837524276640,1768.53,2023-04-04T16:33:05,Donostia,expenses,mortgage,-2279.14,-7557.5
buyer_5,Sara,Gurrutxaga,1994-03-12,40616649Y,sara.gurrutxaga@extremecloud.com,093529,ES94209525837524276640,1768.53,2023-04-04T12:01:46,Donostia,expenses,transport,-51.81,-7609.31
buyer_5,Sara,Gurrutxaga,1994-03-12,40616649Y,sara.gurrutxaga@extremecloud.com,093529,ES94209525837524276640,1768.53,2023-04-06T06:41:50,Donostia,expenses,internet,-119.78,-7729.09
buyer_5,Sara,Gurrutxaga,1994-03-12,40616649Y,sara.gurrutxaga@extremecloud.com,093529,ES94209525837524276640,1768.53,2023-04-06T08:03:43,Donostia,expenses,transport,-68.84,-7797.93
buyer_5,Sara,Gurrutxaga,1994-03-12,40616649Y,sara.gurrutxaga@extremecloud.com,093529,ES94209525837524276640,1768.53,2023-04-08T13:21:12,Donostia,expenses,electricity,-210.2,-8008.13
buyer_5,Sara,Gurrutxaga,1994-03-12,40616649Y,sara.gurrutxaga@extremecloud.com,093529,ES94209525837524276640,1768.53,2023-04-08T20:45:50,Donostia,expenses,gas,-284.81,-8292.94
buyer_5,Sara,Gurrutxaga,1994-03-12,40616649Y,sara.gurrutxaga@extremecloud.com,093529,ES94209525837524276640,1768.53,2023-04-08T19:18:42,Donostia,expenses,internet,-119.78,-8412.72
buyer_5,Sara,Gurrutxaga,1994-03-12,40616649Y,sara.gurrutxaga@extremecloud.com,093529,ES94209525837524276640,1768.53,2023-04-08T10:17:41,Donostia,expenses,phone,-96.68,-8509.4
buyer_5,Sara,Gurrutxaga,1994-03-12,40616649Y,sara.gurrutxaga@extremecloud.com,093529,ES94209525837524276640,1768.53,2023-04-09T14:24:12,Donostia,expenses,travel,-578.46,-9087.86
buyer_5,Sara,Gurrutxaga,1994-03-12,40616649Y,sara.gurrutxaga@extremecloud.com,093529,ES94209525837524276640,1768.53,2023-04-11T18:58:49,Donostia,expenses,education,-49.61,-9137.47
buyer_5,Sara,Gurrutxaga,1994-03-12,40616649Y,sara.gurrutxaga@extremecloud.com,093529,ES94209525837524276640,1768.53,2023-04-14T15:06:26,Donostia,expenses,food,-101.82,-9239.29
buyer_5,Sara,Gurrutxaga,1994-03-12,40616649Y,sara.gurrutxaga@extremecloud.com,093529,ES94209525837524276640,1768.53,2023-04-15T06:47:25,Donostia,expenses,transport,-72.2,-9311.49
buyer_5,Sara,Gurrutxaga,1994-03-12,40616649Y,sara.gurrutxaga@extremecloud.com,093529,ES94209525837524276640,1768.53,2023-04-16T08:15:26,Donostia,expenses,clothing,-64.11,-9375.6
buyer_5,Sara,Gurrutxaga,1994-03-12,40616649Y,sara.gurrutxaga@extremecloud.com,093529,ES94209525837524276640,1768.53,2023-04-18T13:12:24,Donostia,expenses,cash,-100.0,-9475.6
buyer_5,Sara,Gurrutxaga,1994-03-12,40616649Y,sara.gurrutxaga@extremecloud.com,093529,ES94209525837524276640,1768.53,2023-04-20T18:33:34,Donostia,expenses,leisure,-48.72,-9524.32
buyer_5,Sara,Gurrutxaga,1994-03-12,40616649Y,sara.gurrutxaga@extremecloud.com,093529,ES94209525837524276640,1768.53,2023-04-21T18:55:37,Donostia,expenses,healthcare,-45.41,-9569.73
buyer_5,Sara,Gurrutxaga,1994-03-12,40616649Y,sara.gurrutxaga@extremecloud.com,093529,ES94209525837524276640,1768.53,2023-04-23T11:48:53,Donostia,expenses,repairs,-276.23,-9845.96
buyer_5,Sara,Gurrutxaga,1994-03-12,40616649Y,sara.gurrutxaga@extremecloud.com,093529,ES94209525837524276640,1768.53,2023-04-25T17:45:50,Donostia,expenses,leisure,-78.03,-9923.99
buyer_5,Sara,Gurrutxaga,1994-03-12,40616649Y,sara.gurrutxaga@extremecloud.com,093529,ES94209525837524276640,1768.53,2023-04-28T20:17:54,Donostia,expenses,education,-62.65,-9986.64
buyer_5,Sara,Gurrutxaga,1994-03-12,40616649Y,sara.gurrutxaga@extremecloud.com,093529,ES94209525837524276640,1768.53,2023-04-28T08:10:25,Donostia,expenses,repairs,-264.69,-10251.33
buyer_5,Sara,Gurrutxaga,1994-03-12,40616649Y,sara.gurrutxaga@extremecloud.com,093529,ES94209525837524276640,1768.53,2023-05-01T14:02:23,Donostia,incomes,salary,2623.42,-7627.91
buyer_5,Sara,Gurrutxaga,1994-03-12,40616649Y,sara.gurrutxaga@extremecloud.com,093529,ES94209525837524276640,1768.53,2023-05-01T14:02:23,Donostia,incomes,salary_partner,3080.45,-4547.46
buyer_5,Sara,Gurrutxaga,1994-03-12,40616649Y,sara.gurrutxaga@extremecloud.com,093529,ES94209525837524276640,1768.53,2023-05-02T21:55:01,Donostia,expenses,appliances,-418.49,-4965.95
buyer_5,Sara,Gurrutxaga,1994-03-12,40616649Y,sara.gurrutxaga@extremecloud.com,093529,ES94209525837524276640,1768.53,2023-05-04T11:37:56,Donostia,expenses,mortgage,-2279.14,-7245.09
buyer_5,Sara,Gurrutxaga,1994-03-12,40616649Y,sara.gurrutxaga@extremecloud.com,093529,ES94209525837524276640,1768.53,2023-05-04T20:36:27,Donostia,expenses,leisure,-72.99,-7318.08
buyer_5,Sara,Gurrutxaga,1994-03-12,40616649Y,sara.gurrutxaga@extremecloud.com,093529,ES94209525837524276640,1768.53,2023-05-04T21:31:19,Donostia,expenses,appliances,-418.99,-7737.07
buyer_5,Sara,Gurrutxaga,1994-03-12,40616649Y,sara.gurrutxaga@extremecloud.com,093529,ES94209525837524276640,1768.53,2023-05-05T15:09:47,Donostia,expenses,phone,-87.21,-7824.28
buyer_5,Sara,Gurrutxaga,1994-03-12,40616649Y,sara.gurrutxaga@extremecloud.com,093529,ES94209525837524276640,1768.53,2023-05-05T10:35:52,Donostia,expenses,transport,-69.41,-7893.69
buyer_5,Sara,Gurrutxaga,1994-03-12,40616649Y,sara.gurrutxaga@extremecloud.com,093529,ES94209525837524276640,1768.53,2023-05-06T13:52:45,Donostia,expenses,electricity,-136.48,-8030.17
buyer_5,Sara,Gurrutxaga,1994-03-12,40616649Y,sara.gurrutxaga@extremecloud.com,093529,ES94209525837524276640,1768.53,2023-05-06T15:51:16,Donostia,expenses,internet,-119.78,-8149.95
buyer_5,Sara,Gurrutxaga,1994-03-12,40616649Y,sara.gurrutxaga@extremecloud.com,093529,ES94209525837524276640,1768.53,2023-05-07T08:20:30,Donostia,expenses,internet,-119.78,-8269.73
buyer_5,Sara,Gurrutxaga,1994-03-12,40616649Y,sara.gurrutxaga@extremecloud.com,093529,ES94209525837524276640,1768.53,2023-05-08T19:02:46,Donostia,expenses,cash,-100.0,-8369.73
buyer_5,Sara,Gurrutxaga,1994-03-12,40616649Y,sara.gurrutxaga@extremecloud.com,093529,ES94209525837524276640,1768.53,2023-05-09T20:51:24,Donostia,expenses,healthcare,-111.58,-8481.31
buyer_5,Sara,Gurrutxaga,1994-03-12,40616649Y,sara.gurrutxaga@extremecloud.com,093529,ES94209525837524276640,1768.53,2023-05-10T08:12:37,Donostia,expenses,transport,-80.81,-8562.12
buyer_5,Sara,Gurrutxaga,1994-03-12,40616649Y,sara.gurrutxaga@extremecloud.com,093529,ES94209525837524276640,1768.53,2023-05-11T17:46:37,Donostia,expenses,food,-123.99,-8686.11
buyer_5,Sara,Gurrutxaga,1994-03-12,40616649Y,sara.gurrutxaga@extremecloud.com,093529,ES94209525837524276640,1768.53,2023-05-11T20:36:25,Donostia,expenses,cash,-100.0,-8786.11
buyer_5,Sara,Gurrutxaga,1994-03-12,40616649Y,sara.gurrutxaga@extremecloud.com,093529,ES94209525837524276640,1768.53,2023-05-11T06:32:26,Donostia,expenses,gifts,-281.86,-9067.97
buyer_5,Sara,Gurrutxaga,1994-03-12,40616649Y,sara.gurrutxaga@extremecloud.com,093529,ES94209525837524276640,1768.53,2023-05-13T19:55:23,Donostia,expenses,repairs,-249.78,-9317.75
buyer_5,Sara,Gurrutxaga,1994-03-12,40616649Y,sara.gurrutxaga@extremecloud.com,093529,ES94209525837524276640,1768.53,2023-05-14T08:56:15,Donostia,expenses,cash,-100.0,-9417.75
buyer_5,Sara,Gurrutxaga,1994-03-12,40616649Y,sara.gurrutxaga@extremecloud.com,093529,ES94209525837524276640,1768.53,2023-05-15T14:10:16,Donostia,expenses,food,-79.42,-9497.17
buyer_5,Sara,Gurrutxaga,1994-03-12,40616649Y,sara.gurrutxaga@extremecloud.com,093529,ES94209525837524276640,1768.53,2023-05-16T16:38:18,Donostia,expenses,leisure,-43.65,-9540.82
buyer_5,Sara,Gurrutxaga,1994-03-12,40616649Y,sara.gurrutxaga@extremecloud.com,093529,ES94209525837524276640,1768.53,2023-05-19T17:40:52,Donostia,expenses,transport,-87.65,-9628.47
buyer_5,Sara,Gurrutxaga,1994-03-12,40616649Y,sara.gurrutxaga@extremecloud.com,093529,ES94209525837524276640,1768.53,2023-05-19T14:17:02,Donostia,expenses,leisure,-60.2,-9688.67
buyer_5,Sara,Gurrutxaga,1994-03-12,40616649Y,sara.gurrutxaga@extremecloud.com,093529,ES94209525837524276640,1768.53,2023-05-19T02:51:21,Donostia,expenses,healthcare,-51.97,-9740.64
buyer_5,Sara,Gurrutxaga,1994-03-12,40616649Y,sara.gurrutxaga@extremecloud.com,093529,ES94209525837524276640,1768.53,2023-05-20T12:58:18,Donostia,expenses,repairs,-140.48,-9881.12
buyer_5,Sara,Gurrutxaga,1994-03-12,40616649Y,sara.gurrutxaga@extremecloud.com,093529,ES94209525837524276640,1768.53,2023-05-21T13:04:36,Donostia,expenses,food,-70.54,-9951.66
buyer_5,Sara,Gurrutxaga,1994-03-12,40616649Y,sara.gurrutxaga@extremecloud.com,093529,ES94209525837524276640,1768.53,2023-05-21T13:13:39,Donostia,expenses,cash,-100.0,-10051.66
buyer_5,Sara,Gurrutxaga,1994-03-12,40616649Y,sara.gurrutxaga@extremecloud.com,093529,ES94209525837524276640,1768.53,2023-05-24T15:09:13,Donostia,expenses,transport,-65.44,-10117.1
buyer_5,Sara,Gurrutxaga,1994-03-12,40616649Y,sara.gurrutxaga@extremecloud.com,093529,ES94209525837524276640,1768.53,2023-05-25T20:10:25,Donostia,expenses,gifts,-240.86,-10357.96
buyer_5,Sara,Gurrutxaga,1994-03-12,40616649Y,sara.gurrutxaga@extremecloud.com,093529,ES94209525837524276640,1768.53,2023-05-28T17:19:30,Donostia,expenses,leisure,-51.4,-10409.36
buyer_5,Sara,Gurrutxaga,1994-03-12,40616649Y,sara.gurrutxaga@extremecloud.com,093529,ES94209525837524276640,1768.53,2023-05-29T08:45:04,Donostia,expenses,clothing,-120.14,-10529.5
buyer_5,Sara,Gurrutxaga,1994-03-12,40616649Y,sara.gurrutxaga@extremecloud.com,093529,ES94209525837524276640,1768.53,2023-06-01T14:21:16,Donostia,incomes,salary,2623.42,-7906.08
buyer_5,Sara,Gurrutxaga,1994-03-12,40616649Y,sara.gurrutxaga@extremecloud.com,093529,ES94209525837524276640,1768.53,2023-06-01T14:21:16,Donostia,incomes,salary_partner,3080.45,-4825.63
buyer_5,Sara,Gurrutxaga,1994-03-12,40616649Y,sara.gurrutxaga@extremecloud.com,093529,ES94209525837524276640,1768.53,2023-06-01T14:21:16,Donostia,incomes,salary_bonus,2059.61,-2766.02
buyer_5,Sara,Gurrutxaga,1994-03-12,40616649Y,sara.gurrutxaga@extremecloud.com,093529,ES94209525837524276640,1768.53,2023-06-01T14:21:16,Donostia,incomes,salary_partner_bonus,2187.08,-578.94
buyer_5,Sara,Gurrutxaga,1994-03-12,40616649Y,sara.gurrutxaga@extremecloud.com,093529,ES94209525837524276640,1768.53,2023-06-02T13:43:38,Donostia,expenses,taxes,-4955.97,-5534.91
buyer_5,Sara,Gurrutxaga,1994-03-12,40616649Y,sara.gurrutxaga@extremecloud.com,093529,ES94209525837524276640,1768.53,2023-06-02T06:54:23,Donostia,expenses,insurance,-1462.69,-6997.6
buyer_5,Sara,Gurrutxaga,1994-03-12,40616649Y,sara.gurrutxaga@extremecloud.com,093529,ES94209525837524276640,1768.53,2023-06-04T11:16:49,Donostia,expenses,mortgage,-2279.14,-9276.74
buyer_5,Sara,Gurrutxaga,1994-03-12,40616649Y,sara.gurrutxaga@extremecloud.com,093529,ES94209525837524276640,1768.53,2023-06-04T17:01:07,Donostia,expenses,food,-90.25,-9366.99
buyer_5,Sara,Gurrutxaga,1994-03-12,40616649Y,sara.gurrutxaga@extremecloud.com,093529,ES94209525837524276640,1768.53,2023-06-05T13:39:46,Donostia,expenses,water,-104.61,-9471.6
buyer_5,Sara,Gurrutxaga,1994-03-12,40616649Y,sara.gurrutxaga@extremecloud.com,093529,ES94209525837524276640,1768.53,2023-06-05T16:11:42,Donostia,expenses,leisure,-18.73,-9490.33
buyer_5,Sara,Gurrutxaga,1994-03-12,40616649Y,sara.gurrutxaga@extremecloud.com,093529,ES94209525837524276640,1768.53,2023-06-07T16:31:27,Donostia,expenses,gas,-126.29,-9616.62
buyer_5,Sara,Gurrutxaga,1994-03-12,40616649Y,sara.gurrutxaga@extremecloud.com,093529,ES94209525837524276640,1768.53,2023-06-07T08:57:42,Donostia,expenses,healthcare,-135.67,-9752.29
buyer_5,Sara,Gurrutxaga,1994-03-12,40616649Y,sara.gurrutxaga@extremecloud.com,093529,ES94209525837524276640,1768.53,2023-06-08T16:58:58,Donostia,expenses,water,-97.62,-9849.91
buyer_5,Sara,Gurrutxaga,1994-03-12,40616649Y,sara.gurrutxaga@extremecloud.com,093529,ES94209525837524276640,1768.53,2023-06-08T10:04:37,Donostia,expenses,internet,-119.78,-9969.69
buyer_5,Sara,Gurrutxaga,1994-03-12,40616649Y,sara.gurrutxaga@extremecloud.com,093529,ES94209525837524276640,1768.53,2023-06-08T08:05:51,Donostia,expenses,cash,-100.0,-10069.69
buyer_5,Sara,Gurrutxaga,1994-03-12,40616649Y,sara.gurrutxaga@extremecloud.com,093529,ES94209525837524276640,1768.53,2023-06-09T16:16:30,Donostia,expenses,food,-106.06,-10175.75
buyer_5,Sara,Gurrutxaga,1994-03-12,40616649Y,sara.gurrutxaga@extremecloud.com,093529,ES94209525837524276640,1768.53,2023-06-09T16:40:50,Donostia,expenses,cash,-100.0,-10275.75
buyer_5,Sara,Gurrutxaga,1994-03-12,40616649Y,sara.gurrutxaga@extremecloud.com,093529,ES94209525837524276640,1768.53,2023-06-09T16:45:50,Donostia,expenses,appliances,-306.59,-10582.34
buyer_5,Sara,Gurrutxaga,1994-03-12,40616649Y,sara.gurrutxaga@extremecloud.com,093529,ES94209525837524276640,1768.53,2023-06-12T15:42:07,Donostia,expenses,gifts,-67.03,-10649.37
buyer_5,Sara,Gurrutxaga,1994-03-12,40616649Y,sara.gurrutxaga@extremecloud.com,093529,ES94209525837524276640,1768.53,2023-06-13T08:41:11,Donostia,expenses,food,-63.37,-10712.74
buyer_5,Sara,Gurrutxaga,1994-03-12,40616649Y,sara.gurrutxaga@extremecloud.com,093529,ES94209525837524276640,1768.53,2023-06-14T19:47:16,Donostia,expenses,transport,-56.61,-10769.35
buyer_5,Sara,Gurrutxaga,1994-03-12,40616649Y,sara.gurrutxaga@extremecloud.com,093529,ES94209525837524276640,1768.53,2023-06-14T05:53:14,Donostia,expenses,cash,-100.0,-10869.35
buyer_5,Sara,Gurrutxaga,1994-03-12,40616649Y,sara.gurrutxaga@extremecloud.com,093529,ES94209525837524276640,1768.53,2023-06-15T00:04:07,Donostia,expenses,food,-60.25,-10929.6
buyer_5,Sara,Gurrutxaga,1994-03-12,40616649Y,sara.gurrutxaga@extremecloud.com,093529,ES94209525837524276640,1768.53,2023-06-18T15:45:46,Donostia,expenses,cash,-100.0,-11029.6
buyer_5,Sara,Gurrutxaga,1994-03-12,40616649Y,sara.gurrutxaga@extremecloud.com,093529,ES94209525837524276640,1768.53,2023-06-19T20:48:32,Donostia,expenses,clothing,-157.59,-11187.19
buyer_5,Sara,Gurrutxaga,1994-03-12,40616649Y,sara.gurrutxaga@extremecloud.com,093529,ES94209525837524276640,1768.53,2023-06-19T07:40:02,Donostia,expenses,repairs,-178.77,-11365.96
buyer_5,Sara,Gurrutxaga,1994-03-12,40616649Y,sara.gurrutxaga@extremecloud.com,093529,ES94209525837524276640,1768.53,2023-06-20T22:17:58,Donostia,expenses,food,-67.78,-11433.74
buyer_5,Sara,Gurrutxaga,1994-03-12,40616649Y,sara.gurrutxaga@extremecloud.com,093529,ES94209525837524276640,1768.53,2023-06-20T11:01:40,Donostia,expenses,cash,-100.0,-11533.74
buyer_5,Sara,Gurrutxaga,1994-03-12,40616649Y,sara.gurrutxaga@extremecloud.com,093529,ES94209525837524276640,1768.53,2023-06-22T08:23:22,Donostia,expenses,food,-120.25,-11653.99
buyer_5,Sara,Gurrutxaga,1994-03-12,40616649Y,sara.gurrutxaga@extremecloud.com,093529,ES94209525837524276640,1768.53,2023-06-25T17:47:15,Donostia,expenses,leisure,-28.62,-11682.61
buyer_5,Sara,Gurrutxaga,1994-03-12,40616649Y,sara.gurrutxaga@extremecloud.com,093529,ES94209525837524276640,1768.53,2023-06-25T19:57:25,Donostia,expenses,cash,-100.0,-11782.61
buyer_5,Sara,Gurrutxaga,1994-03-12,40616649Y,sara.gurrutxaga@extremecloud.com,093529,ES94209525837524276640,1768.53,2023-06-26T19:18:30,Donostia,expenses,leisure,-48.89,-11831.5
buyer_5,Sara,Gurrutxaga,1994-03-12,40616649Y,sara.gurrutxaga@extremecloud.com,093529,ES94209525837524276640,1768.53,2023-06-27T15:38:51,Donostia,expenses,food,-91.66,-11923.16
buyer_5,Sara,Gurrutxaga,1994-03-12,40616649Y,sara.gurrutxaga@extremecloud.com,093529,ES94209525837524276640,1768.53,2023-06-27T08:17:28,Donostia,expenses,leisure,-47.37,-11970.53
buyer_5,Sara,Gurrutxaga,1994-03-12,40616649Y,sara.gurrutxaga@extremecloud.com,093529,ES94209525837524276640,1768.53,2023-06-29T01:54:33,Donostia,expenses,food,-94.54,-12065.07
buyer_5,Sara,Gurrutxaga,1994-03-12,40616649Y,sara.gurrutxaga@extremecloud.com,093529,ES94209525837524276640,1768.53,2023-06-30T08:17:38,Donostia,expenses,food,-118.9,-12183.97
buyer_5,Sara,Gurrutxaga,1994-03-12,40616649Y,sara.gurrutxaga@extremecloud.com,093529,ES94209525837524276640,1768.53,2023-07-01T04:26:15,Donostia,incomes,salary,2623.42,-9560.55
buyer_5,Sara,Gurrutxaga,1994-03-12,40616649Y,sara.gurrutxaga@extremecloud.com,093529,ES94209525837524276640,1768.53,2023-07-01T04:26:15,Donostia,incomes,salary_partner,3080.45,-6480.1
buyer_5,Sara,Gurrutxaga,1994-03-12,40616649Y,sara.gurrutxaga@extremecloud.com,093529,ES94209525837524276640,1768.53,2023-07-01T04:26:15,Donostia,incomes,extra_income,354.73,-6125.37
buyer_5,Sara,Gurrutxaga,1994-03-12,40616649Y,sara.gurrutxaga@extremecloud.com,093529,ES94209525837524276640,1768.53,2023-07-01T10:18:24,Donostia,expenses,education,-70.67,-6196.04
buyer_5,Sara,Gurrutxaga,1994-03-12,40616649Y,sara.gurrutxaga@extremecloud.com,093529,ES94209525837524276640,1768.53,2023-07-02T19:03:09,Donostia,expenses,food,-71.53,-6267.57
buyer_5,Sara,Gurrutxaga,1994-03-12,40616649Y,sara.gurrutxaga@extremecloud.com,093529,ES94209525837524276640,1768.53,2023-07-02T12:09:10,Donostia,expenses,appliances,-329.54,-6597.11
buyer_5,Sara,Gurrutxaga,1994-03-12,40616649Y,sara.gurrutxaga@extremecloud.com,093529,ES94209525837524276640,1768.53,2023-07-04T12:54:17,Donostia,expenses,mortgage,-2279.14,-8876.25
buyer_5,Sara,Gurrutxaga,1994-03-12,40616649Y,sara.gurrutxaga@extremecloud.com,093529,ES94209525837524276640,1768.53,2023-07-05T13:16:23,Donostia,expenses,transport,-79.84,-8956.09
buyer_5,Sara,Gurrutxaga,1994-03-12,40616649Y,sara.gurrutxaga@extremecloud.com,093529,ES94209525837524276640,1768.53,2023-07-05T08:39:45,Donostia,expenses,healthcare,-139.21,-9095.3
buyer_5,Sara,Gurrutxaga,1994-03-12,40616649Y,sara.gurrutxaga@extremecloud.com,093529,ES94209525837524276640,1768.53,2023-07-07T12:52:33,Donostia,expenses,transport,-58.13,-9153.43
buyer_5,Sara,Gurrutxaga,1994-03-12,40616649Y,sara.gurrutxaga@extremecloud.com,093529,ES94209525837524276640,1768.53,2023-07-07T22:57:36,Donostia,expenses,leisure,-23.76,-9177.19
buyer_5,Sara,Gurrutxaga,1994-03-12,40616649Y,sara.gurrutxaga@extremecloud.com,093529,ES94209525837524276640,1768.53,2023-07-08T12:57:25,Donostia,expenses,leisure,-29.7,-9206.89
buyer_5,Sara,Gurrutxaga,1994-03-12,40616649Y,sara.gurrutxaga@extremecloud.com,093529,ES94209525837524276640,1768.53,2023-07-11T15:24:53,Donostia,expenses,food,-111.16,-9318.05
buyer_5,Sara,Gurrutxaga,1994-03-12,40616649Y,sara.gurrutxaga@extremecloud.com,093529,ES94209525837524276640,1768.53,2023-07-11T08:11:33,Donostia,expenses,leisure,-51.53,-9369.58
buyer_5,Sara,Gurrutxaga,1994-03-12,40616649Y,sara.gurrutxaga@extremecloud.com,093529,ES94209525837524276640,1768.53,2023-07-11T09:56:33,Donostia,expenses,appliances,-138.07,-9507.65
buyer_5,Sara,Gurrutxaga,1994-03-12,40616649Y,sara.gurrutxaga@extremecloud.com,093529,ES94209525837524276640,1768.53,2023-07-13T18:29:57,Donostia,expenses,transport,-58.36,-9566.01
buyer_5,Sara,Gurrutxaga,1994-03-12,40616649Y,sara.gurrutxaga@extremecloud.com,093529,ES94209525837524276640,1768.53,2023-07-14T14:37:27,Donostia,expenses,leisure,-38.2,-9604.21
buyer_5,Sara,Gurrutxaga,1994-03-12,40616649Y,sara.gurrutxaga@extremecloud.com,093529,ES94209525837524276640,1768.53,2023-07-16T10:29:25,Donostia,expenses,food,-124.33,-9728.54
buyer_5,Sara,Gurrutxaga,1994-03-12,40616649Y,sara.gurrutxaga@extremecloud.com,093529,ES94209525837524276640,1768.53,2023-07-17T10:16:00,Donostia,expenses,education,-68.11,-9796.65
buyer_5,Sara,Gurrutxaga,1994-03-12,40616649Y,sara.gurrutxaga@extremecloud.com,093529,ES94209525837524276640,1768.53,2023-07-19T13:53:45,Donostia,expenses,clothing,-146.72,-9943.37
buyer_5,Sara,Gurrutxaga,1994-03-12,40616649Y,sara.gurrutxaga@extremecloud.com,093529,ES94209525837524276640,1768.53,2023-07-19T19:52:37,Donostia,expenses,healthcare,-181.54,-10124.91
buyer_5,Sara,Gurrutxaga,1994-03-12,40616649Y,sara.gurrutxaga@extremecloud.com,093529,ES94209525837524276640,1768.53,2023-07-19T09:27:50,Donostia,expenses,cash,-100.0,-10224.91
buyer_5,Sara,Gurrutxaga,1994-03-12,40616649Y,sara.gurrutxaga@extremecloud.com,093529,ES94209525837524276640,1768.53,2023-07-20T02:30:22,Donostia,expenses,cash,-100.0,-10324.91
buyer_5,Sara,Gurrutxaga,1994-03-12,40616649Y,sara.gurrutxaga@extremecloud.com,093529,ES94209525837524276640,1768.53,2023-07-21T15:00:59,Donostia,expenses,leisure,-64.23,-10389.14
buyer_5,Sara,Gurrutxaga,1994-03-12,40616649Y,sara.gurrutxaga@extremecloud.com,093529,ES94209525837524276640,1768.53,2023-07-23T08:35:17,Donostia,expenses,gifts,-130.06,-10519.2
buyer_5,Sara,Gurrutxaga,1994-03-12,40616649Y,sara.gurrutxaga@extremecloud.com,093529,ES94209525837524276640,1768.53,2023-07-26T20:10:37,Donostia,expenses,food,-90.7,-10609.9
buyer_5,Sara,Gurrutxaga,1994-03-12,40616649Y,sara.gurrutxaga@extremecloud.com,093529,ES94209525837524276640,1768.53,2023-07-26T11:58:43,Donostia,expenses,repairs,-57.47,-10667.37
buyer_5,Sara,Gurrutxaga,1994-03-12,40616649Y,sara.gurrutxaga@extremecloud.com,093529,ES94209525837524276640,1768.53,2023-07-27T09:19:14,Donostia,expenses,cash,-100.0,-10767.37
buyer_5,Sara,Gurrutxaga,1994-03-12,40616649Y,sara.gurrutxaga@extremecloud.com,093529,ES94209525837524276640,1768.53,2023-07-28T13:30:27,Donostia,expenses,cash,-100.0,-10867.37
buyer_5,Sara,Gurrutxaga,1994-03-12,40616649Y,sara.gurrutxaga@extremecloud.com,093529,ES94209525837524276640,1768.53,2023-07-30T08:07:58,Donostia,expenses,food,-114.75,-10982.12
buyer_5,Sara,Gurrutxaga,1994-03-12,40616649Y,sara.gurrutxaga@extremecloud.com,093529,ES94209525837524276640,1768.53,2023-07-31T13:32:24,Donostia,expenses,repairs,-261.9,-11244.02
buyer_5,Sara,Gurrutxaga,1994-03-12,40616649Y,sara.gurrutxaga@extremecloud.com,093529,ES94209525837524276640,1768.53,2023-08-01T17:52:31,Donostia,incomes,salary,2623.42,-8620.6
buyer_5,Sara,Gurrutxaga,1994-03-12,40616649Y,sara.gurrutxaga@extremecloud.com,093529,ES94209525837524276640,1768.53,2023-08-01T17:52:31,Donostia,incomes,salary_partner,3080.45,-5540.15
buyer_5,Sara,Gurrutxaga,1994-03-12,40616649Y,sara.gurrutxaga@extremecloud.com,093529,ES94209525837524276640,1768.53,2023-08-01T16:44:53,Donostia,expenses,transport,-65.78,-5605.93
buyer_5,Sara,Gurrutxaga,1994-03-12,40616649Y,sara.gurrutxaga@extremecloud.com,093529,ES94209525837524276640,1768.53,2023-08-01T12:40:05,Donostia,expenses,leisure,-55.26,-5661.19
buyer_5,Sara,Gurrutxaga,1994-03-12,40616649Y,sara.gurrutxaga@extremecloud.com,093529,ES94209525837524276640,1768.53,2023-08-02T20:33:28,Donostia,expenses,leisure,-41.23,-5702.42
buyer_5,Sara,Gurrutxaga,1994-03-12,40616649Y,sara.gurrutxaga@extremecloud.com,093529,ES94209525837524276640,1768.53,2023-08-04T14:27:23,Donostia,expenses,mortgage,-2279.14,-7981.56
buyer_5,Sara,Gurrutxaga,1994-03-12,40616649Y,sara.gurrutxaga@extremecloud.com,093529,ES94209525837524276640,1768.53,2023-08-04T01:55:13,Donostia,expenses,clothing,-150.69,-8132.25
buyer_5,Sara,Gurrutxaga,1994-03-12,40616649Y,sara.gurrutxaga@extremecloud.com,093529,ES94209525837524276640,1768.53,2023-08-05T11:31:26,Donostia,expenses,water,-100.78,-8233.03
buyer_5,Sara,Gurrutxaga,1994-03-12,40616649Y,sara.gurrutxaga@extremecloud.com,093529,ES94209525837524276640,1768.53,2023-08-06T03:54:05,Donostia,expenses,cash,-100.0,-8333.03
buyer_5,Sara,Gurrutxaga,1994-03-12,40616649Y,sara.gurrutxaga@extremecloud.com,093529,ES94209525837524276640,1768.53,2023-08-07T20:23:34,Donostia,expenses,electricity,-215.87,-8548.9
buyer_5,Sara,Gurrutxaga,1994-03-12,40616649Y,sara.gurrutxaga@extremecloud.com,093529,ES94209525837524276640,1768.53,2023-08-07T08:00:21,Donostia,expenses,gas,-232.65,-8781.55
buyer_5,Sara,Gurrutxaga,1994-03-12,40616649Y,sara.gurrutxaga@extremecloud.com,093529,ES94209525837524276640,1768.53,2023-08-07T18:37:54,Donostia,expenses,internet,-119.78,-8901.33
buyer_5,Sara,Gurrutxaga,1994-03-12,40616649Y,sara.gurrutxaga@extremecloud.com,093529,ES94209525837524276640,1768.53,2023-08-07T17:51:43,Donostia,expenses,repairs,-223.36,-9124.69
buyer_5,Sara,Gurrutxaga,1994-03-12,40616649Y,sara.gurrutxaga@extremecloud.com,093529,ES94209525837524276640,1768.53,2023-08-08T16:07:10,Donostia,expenses,electricity,-222.76,-9347.45
buyer_5,Sara,Gurrutxaga,1994-03-12,40616649Y,sara.gurrutxaga@extremecloud.com,093529,ES94209525837524276640,1768.53,2023-08-08T13:08:22,Donostia,expenses,repairs,-230.86,-9578.31
buyer_5,Sara,Gurrutxaga,1994-03-12,40616649Y,sara.gurrutxaga@extremecloud.com,093529,ES94209525837524276640,1768.53,2023-08-09T08:27:38,Donostia,expenses,transport,-46.19,-9624.5
buyer_5,Sara,Gurrutxaga,1994-03-12,40616649Y,sara.gurrutxaga@extremecloud.com,093529,ES94209525837524276640,1768.53,2023-08-09T12:17:49,Donostia,expenses,cash,-100.0,-9724.5
buyer_5,Sara,Gurrutxaga,1994-03-12,40616649Y,sara.gurrutxaga@extremecloud.com,093529,ES94209525837524276640,1768.53,2023-08-10T21:27:13,Donostia,expenses,education,-73.27,-9797.77
buyer_5,Sara,Gurrutxaga,1994-03-12,40616649Y,sara.gurrutxaga@extremecloud.com,093529,ES94209525837524276640,1768.53,2023-08-12T23:45:07,Donostia,expenses,transport,-77.93,-9875.7
buyer_5,Sara,Gurrutxaga,1994-03-12,40616649Y,sara.gurrutxaga@extremecloud.com,093529,ES94209525837524276640,1768.53,2023-08-14T03:40:08,Donostia,expenses,repairs,-243.71,-10119.41
buyer_5,Sara,Gurrutxaga,1994-03-12,40616649Y,sara.gurrutxaga@extremecloud.com,093529,ES94209525837524276640,1768.53,2023-08-17T17:16:03,Donostia,expenses,repairs,-292.48,-10411.89
buyer_5,Sara,Gurrutxaga,1994-03-12,40616649Y,sara.gurrutxaga@extremecloud.com,093529,ES94209525837524276640,1768.53,2023-08-17T21:44:38,Donostia,expenses,gifts,-391.99,-10803.88
buyer_5,Sara,Gurrutxaga,1994-03-12,40616649Y,sara.gurrutxaga@extremecloud.com,093529,ES94209525837524276640,1768.53,2023-08-18T14:52:47,Donostia,expenses,cash,-100.0,-10903.88
buyer_5,Sara,Gurrutxaga,1994-03-12,40616649Y,sara.gurrutxaga@extremecloud.com,093529,ES94209525837524276640,1768.53,2023-08-22T18:15:03,Donostia,expenses,cash,-100.0,-11003.88
buyer_5,Sara,Gurrutxaga,1994-03-12,40616649Y,sara.gurrutxaga@extremecloud.com,093529,ES94209525837524276640,1768.53,2023-08-23T20:03:03,Donostia,expenses,clothing,-93.54,-11097.42
buyer_5,Sara,Gurrutxaga,1994-03-12,40616649Y,sara.gurrutxaga@extremecloud.com,093529,ES94209525837524276640,1768.53,2023-08-23T12:27:00,Donostia,expenses,cash,-100.0,-11197.42
buyer_5,Sara,Gurrutxaga,1994-03-12,40616649Y,sara.gurrutxaga@extremecloud.com,093529,ES94209525837524276640,1768.53,2023-08-24T08:33:20,Donostia,expenses,cash,-100.0,-11297.42
buyer_5,Sara,Gurrutxaga,1994-03-12,40616649Y,sara.gurrutxaga@extremecloud.com,093529,ES94209525837524276640,1768.53,2023-08-25T23:42:20,Donostia,expenses,leisure,-54.32,-11351.74
buyer_5,Sara,Gurrutxaga,1994-03-12,40616649Y,sara.gurrutxaga@extremecloud.com,093529,ES94209525837524276640,1768.53,2023-08-25T11:15:00,Donostia,expenses,cash,-100.0,-11451.74
buyer_5,Sara,Gurrutxaga,1994-03-12,40616649Y,sara.gurrutxaga@extremecloud.com,093529,ES94209525837524276640,1768.53,2023-08-25T13:39:45,Donostia,expenses,appliances,-354.22,-11805.96
buyer_5,Sara,Gurrutxaga,1994-03-12,40616649Y,sara.gurrutxaga@extremecloud.com,093529,ES94209525837524276640,1768.53,2023-08-26T15:50:04,Donostia,expenses,cash,-100.0,-11905.96
buyer_5,Sara,Gurrutxaga,1994-03-12,40616649Y,sara.gurrutxaga@extremecloud.com,093529,ES94209525837524276640,1768.53,2023-08-28T17:50:46,Donostia,expenses,travel,-716.79,-12622.75
buyer_5,Sara,Gurrutxaga,1994-03-12,40616649Y,sara.gurrutxaga@extremecloud.com,093529,ES94209525837524276640,1768.53,2023-08-30T08:43:13,Donostia,expenses,repairs,-152.95,-12775.7
buyer_5,Sara,Gurrutxaga,1994-03-12,40616649Y,sara.gurrutxaga@extremecloud.com,093529,ES94209525837524276640,1768.53,2023-08-31T16:57:55,Donostia,expenses,leisure,-46.01,-12821.71
buyer_5,Sara,Gurrutxaga,1994-03-12,40616649Y,sara.gurrutxaga@extremecloud.com,093529,ES94209525837524276640,1768.53,2023-08-31T15:30:11,Donostia,expenses,education,-73.46,-12895.17
buyer_5,Sara,Gurrutxaga,1994-03-12,40616649Y,sara.gurrutxaga@extremecloud.com,093529,ES94209525837524276640,1768.53,2023-08-31T17:26:30,Donostia,expenses,cash,-100.0,-12995.17
buyer_5,Sara,Gurrutxaga,1994-03-12,40616649Y,sara.gurrutxaga@extremecloud.com,093529,ES94209525837524276640,1768.53,2023-09-01T00:56:00,Donostia,incomes,salary,2623.42,-10371.75
buyer_5,Sara,Gurrutxaga,1994-03-12,40616649Y,sara.gurrutxaga@extremecloud.com,093529,ES94209525837524276640,1768.53,2023-09-01T00:56:00,Donostia,incomes,salary_partner,3080.45,-7291.3
buyer_5,Sara,Gurrutxaga,1994-03-12,40616649Y,sara.gurrutxaga@extremecloud.com,093529,ES94209525837524276640,1768.53,2023-09-03T10:38:20,Donostia,expenses,healthcare,-71.0,-7362.3
buyer_5,Sara,Gurrutxaga,1994-03-12,40616649Y,sara.gurrutxaga@extremecloud.com,093529,ES94209525837524276640,1768.53,2023-09-03T11:08:59,Donostia,expenses,cash,-100.0,-7462.3
buyer_5,Sara,Gurrutxaga,1994-03-12,40616649Y,sara.gurrutxaga@extremecloud.com,093529,ES94209525837524276640,1768.53,2023-09-04T08:02:08,Donostia,expenses,mortgage,-2279.14,-9741.44
buyer_5,Sara,Gurrutxaga,1994-03-12,40616649Y,sara.gurrutxaga@extremecloud.com,093529,ES94209525837524276640,1768.53,2023-09-05T11:17:37,Donostia,expenses,gas,-284.64,-10026.08
buyer_5,Sara,Gurrutxaga,1994-03-12,40616649Y,sara.gurrutxaga@extremecloud.com,093529,ES94209525837524276640,1768.53,2023-09-05T09:20:59,Donostia,expenses,internet,-119.78,-10145.86
buyer_5,Sara,Gurrutxaga,1994-03-12,40616649Y,sara.gurrutxaga@extremecloud.com,093529,ES94209525837524276640,1768.53,2023-09-05T14:18:45,Donostia,expenses,food,-61.68,-10207.54
buyer_5,Sara,Gurrutxaga,1994-03-12,40616649Y,sara.gurrutxaga@extremecloud.com,093529,ES94209525837524276640,1768.53,2023-09-06T17:44:22,Donostia,expenses,gas,-291.16,-10498.7
buyer_5,Sara,Gurrutxaga,1994-03-12,40616649Y,sara.gurrutxaga@extremecloud.com,093529,ES94209525837524276640,1768.53,2023-09-07T16:02:44,Donostia,expenses,water,-109.3,-10608.0
buyer_5,Sara,Gurrutxaga,1994-03-12,40616649Y,sara.gurrutxaga@extremecloud.com,093529,ES94209525837524276640,1768.53,2023-09-07T12:42:34,Donostia,expenses,gifts,-293.05,-10901.05
buyer_5,Sara,Gurrutxaga,1994-03-12,40616649Y,sara.gurrutxaga@extremecloud.com,093529,ES94209525837524276640,1768.53,2023-09-08T13:22:21,Donostia,expenses,electricity,-190.89,-11091.94
buyer_5,Sara,Gurrutxaga,1994-03-12,40616649Y,sara.gurrutxaga@extremecloud.com,093529,ES94209525837524276640,1768.53,2023-09-08T18:33:33,Donostia,expenses,transport,-60.09,-11152.03
buyer_5,Sara,Gurrutxaga,1994-03-12,40616649Y,sara.gurrutxaga@extremecloud.com,093529,ES94209525837524276640,1768.53,2023-09-09T06:02:54,Donostia,expenses,food,-115.26,-11267.29
buyer_5,Sara,Gurrutxaga,1994-03-12,40616649Y,sara.gurrutxaga@extremecloud.com,093529,ES94209525837524276640,1768.53,2023-09-09T20:40:58,Donostia,expenses,leisure,-47.82,-11315.11
buyer_5,Sara,Gurrutxaga,1994-03-12,40616649Y,sara.gurrutxaga@extremecloud.com,093529,ES94209525837524276640,1768.53,2023-09-11T01:58:31,Donostia,expenses,cash,-100.0,-11415.11
buyer_5,Sara,Gurrutxaga,1994-03-12,40616649Y,sara.gurrutxaga@extremecloud.com,093529,ES94209525837524276640,1768.53,2023-09-12T03:12:39,Donostia,expenses,healthcare,-84.28,-11499.39
buyer_5,Sara,Gurrutxaga,1994-03-12,40616649Y,sara.gurrutxaga@extremecloud.com,093529,ES94209525837524276640,1768.53,2023-09-12T19:45:39,Donostia,expenses,education,-73.0,-11572.39
buyer_5,Sara,Gurrutxaga,1994-03-12,40616649Y,sara.gurrutxaga@extremecloud.com,093529,ES94209525837524276640,1768.53,2023-09-12T10:45:26,Donostia,expenses,gifts,-547.91,-12120.3
buyer_5,Sara,Gurrutxaga,1994-03-12,40616649Y,sara.gurrutxaga@extremecloud.com,093529,ES94209525837524276640,1768.53,2023-09-13T11:45:30,Donostia,expenses,transport,-81.88,-12202.18
buyer_5,Sara,Gurrutxaga,1994-03-12,40616649Y,sara.gurrutxaga@extremecloud.com,093529,ES94209525837524276640,1768.53,2023-09-13T21:10:13,Donostia,expenses,healthcare,-105.17,-12307.35
buyer_5,Sara,Gurrutxaga,1994-03-12,40616649Y,sara.gurrutxaga@extremecloud.com,093529,ES94209525837524276640,1768.53,2023-09-13T04:21:11,Donostia,expenses,cash,-100.0,-12407.35
buyer_5,Sara,Gurrutxaga,1994-03-12,40616649Y,sara.gurrutxaga@extremecloud.com,093529,ES94209525837524276640,1768.53,2023-09-14T12:01:44,Donostia,expenses,transport,-64.83,-12472.18
buyer_5,Sara,Gurrutxaga,1994-03-12,40616649Y,sara.gurrutxaga@extremecloud.com,093529,ES94209525837524276640,1768.53,2023-09-17T19:23:07,Donostia,expenses,cash,-100.0,-12572.18
buyer_5,Sara,Gurrutxaga,1994-03-12,40616649Y,sara.gurrutxaga@extremecloud.com,093529,ES94209525837524276640,1768.53,2023-09-19T14:56:02,Donostia,expenses,cash,-100.0,-12672.18
buyer_5,Sara,Gurrutxaga,1994-03-12,40616649Y,sara.gurrutxaga@extremecloud.com,093529,ES94209525837524276640,1768.53,2023-09-20T11:13:18,Donostia,expenses,leisure,-20.89,-12693.07
buyer_5,Sara,Gurrutxaga,1994-03-12,40616649Y,sara.gurrutxaga@extremecloud.com,093529,ES94209525837524276640,1768.53,2023-09-21T09:44:52,Donostia,expenses,leisure,-22.0,-12715.07
buyer_5,Sara,Gurrutxaga,1994-03-12,40616649Y,sara.gurrutxaga@extremecloud.com,093529,ES94209525837524276640,1768.53,2023-09-22T03:46:54,Donostia,expenses,cash,-100.0,-12815.07
buyer_5,Sara,Gurrutxaga,1994-03-12,40616649Y,sara.gurrutxaga@extremecloud.com,093529,ES94209525837524276640,1768.53,2023-09-23T13:06:01,Donostia,expenses,transport,-65.47,-12880.54
buyer_5,Sara,Gurrutxaga,1994-03-12,40616649Y,sara.gurrutxaga@extremecloud.com,093529,ES94209525837524276640,1768.53,2023-09-23T20:32:48,Donostia,expenses,leisure,-82.87,-12963.41
buyer_5,Sara,Gurrutxaga,1994-03-12,40616649Y,sara.gurrutxaga@extremecloud.com,093529,ES94209525837524276640,1768.53,2023-09-24T03:55:33,Donostia,expenses,travel,-376.72,-13340.13
buyer_5,Sara,Gurrutxaga,1994-03-12,40616649Y,sara.gurrutxaga@extremecloud.com,093529,ES94209525837524276640,1768.53,2023-09-24T09:49:07,Donostia,expenses,repairs,-111.06,-13451.19
buyer_5,Sara,Gurrutxaga,1994-03-12,40616649Y,sara.gurrutxaga@extremecloud.com,093529,ES94209525837524276640,1768.53,2023-09-27T19:58:47,Donostia,expenses,clothing,-114.1,-13565.29
buyer_5,Sara,Gurrutxaga,1994-03-12,40616649Y,sara.gurrutxaga@extremecloud.com,093529,ES94209525837524276640,1768.53,2023-09-28T20:50:20,Donostia,expenses,food,-86.25,-13651.54
buyer_5,Sara,Gurrutxaga,1994-03-12,40616649Y,sara.gurrutxaga@extremecloud.com,093529,ES94209525837524276640,1768.53,2023-09-29T16:09:32,Donostia,expenses,food,-85.32,-13736.86
buyer_5,Sara,Gurrutxaga,1994-03-12,40616649Y,sara.gurrutxaga@extremecloud.com,093529,ES94209525837524276640,1768.53,2023-09-29T19:16:08,Donostia,expenses,transport,-71.28,-13808.14
buyer_5,Sara,Gurrutxaga,1994-03-12,40616649Y,sara.gurrutxaga@extremecloud.com,093529,ES94209525837524276640,1768.53,2023-09-30T11:41:32,Donostia,expenses,repairs,-108.23,-13916.37
buyer_5,Sara,Gurrutxaga,1994-03-12,40616649Y,sara.gurrutxaga@extremecloud.com,093529,ES94209525837524276640,1768.53,2023-10-01T13:54:37,Donostia,incomes,salary,2623.42,-11292.95
buyer_5,Sara,Gurrutxaga,1994-03-12,40616649Y,sara.gurrutxaga@extremecloud.com,093529,ES94209525837524276640,1768.53,2023-10-01T13:54:37,Donostia,incomes,salary_partner,3080.45,-8212.5
buyer_5,Sara,Gurrutxaga,1994-03-12,40616649Y,sara.gurrutxaga@extremecloud.com,093529,ES94209525837524276640,1768.53,2023-10-01T00:25:57,Donostia,expenses,leisure,-33.67,-8246.17
buyer_5,Sara,Gurrutxaga,1994-03-12,40616649Y,sara.gurrutxaga@extremecloud.com,093529,ES94209525837524276640,1768.53,2023-10-01T11:43:04,Donostia,expenses,cash,-100.0,-8346.17
buyer_5,Sara,Gurrutxaga,1994-03-12,40616649Y,sara.gurrutxaga@extremecloud.com,093529,ES94209525837524276640,1768.53,2023-10-03T16:37:31,Donostia,expenses,cash,-100.0,-8446.17
buyer_5,Sara,Gurrutxaga,1994-03-12,40616649Y,sara.gurrutxaga@extremecloud.com,093529,ES94209525837524276640,1768.53,2023-10-04T03:03:45,Donostia,expenses,mortgage,-2279.14,-10725.31
buyer_5,Sara,Gurrutxaga,1994-03-12,40616649Y,sara.gurrutxaga@extremecloud.com,093529,ES94209525837524276640,1768.53,2023-10-04T10:31:02,Donostia,expenses,leisure,-53.09,-10778.4
buyer_5,Sara,Gurrutxaga,1994-03-12,40616649Y,sara.gurrutxaga@extremecloud.com,093529,ES94209525837524276640,1768.53,2023-10-05T20:04:10,Donostia,expenses,internet,-119.78,-10898.18
buyer_5,Sara,Gurrutxaga,1994-03-12,40616649Y,sara.gurrutxaga@extremecloud.com,093529,ES94209525837524276640,1768.53,2023-10-06T20:05:56,Donostia,expenses,water,-121.68,-11019.86
buyer_5,Sara,Gurrutxaga,1994-03-12,40616649Y,sara.gurrutxaga@extremecloud.com,093529,ES94209525837524276640,1768.53,2023-10-07T13:38:19,Donostia,expenses,electricity,-81.73,-11101.59
buyer_5,Sara,Gurrutxaga,1994-03-12,40616649Y,sara.gurrutxaga@extremecloud.com,093529,ES94209525837524276640,1768.53,2023-10-07T22:39:23,Donostia,expenses,gas,-301.8,-11403.39
buyer_5,Sara,Gurrutxaga,1994-03-12,40616649Y,sara.gurrutxaga@extremecloud.com,093529,ES94209525837524276640,1768.53,2023-10-07T19:11:39,Donostia,expenses,food,-74.59,-11477.98
buyer_5,Sara,Gurrutxaga,1994-03-12,40616649Y,sara.gurrutxaga@extremecloud.com,093529,ES94209525837524276640,1768.53,2023-10-07T11:05:01,Donostia,expenses,transport,-84.96,-11562.94
buyer_5,Sara,Gurrutxaga,1994-03-12,40616649Y,sara.gurrutxaga@extremecloud.com,093529,ES94209525837524276640,1768.53,2023-10-07T09:34:09,Donostia,expenses,appliances,-161.99,-11724.93
buyer_5,Sara,Gurrutxaga,1994-03-12,40616649Y,sara.gurrutxaga@extremecloud.com,093529,ES94209525837524276640,1768.53,2023-10-08T09:40:08,Donostia,expenses,water,-118.01,-11842.94
buyer_5,Sara,Gurrutxaga,1994-03-12,40616649Y,sara.gurrutxaga@extremecloud.com,093529,ES94209525837524276640,1768.53,2023-10-08T12:38:54,Donostia,expenses,phone,-123.08,-11966.02
buyer_5,Sara,Gurrutxaga,1994-03-12,40616649Y,sara.gurrutxaga@extremecloud.com,093529,ES94209525837524276640,1768.53,2023-10-08T18:37:50,Donostia,expenses,food,-89.36,-12055.38
buyer_5,Sara,Gurrutxaga,1994-03-12,40616649Y,sara.gurrutxaga@extremecloud.com,093529,ES94209525837524276640,1768.53,2023-10-08T15:36:01,Donostia,expenses,transport,-59.79,-12115.17
buyer_5,Sara,Gurrutxaga,1994-03-12,40616649Y,sara.gurrutxaga@extremecloud.com,093529,ES94209525837524276640,1768.53,2023-10-10T09:32:28,Donostia,expenses,leisure,-54.1,-12169.27
buyer_5,Sara,Gurrutxaga,1994-03-12,40616649Y,sara.gurrutxaga@extremecloud.com,093529,ES94209525837524276640,1768.53,2023-10-10T15:54:02,Donostia,expenses,repairs,-295.22,-12464.49
buyer_5,Sara,Gurrutxaga,1994-03-12,40616649Y,sara.gurrutxaga@extremecloud.com,093529,ES94209525837524276640,1768.53,2023-10-10T20:18:23,Donostia,expenses,gifts,-666.33,-13130.82
buyer_5,Sara,Gurrutxaga,1994-03-12,40616649Y,sara.gurrutxaga@extremecloud.com,093529,ES94209525837524276640,1768.53,2023-10-11T13:25:53,Donostia,expenses,education,-65.3,-13196.12
buyer_5,Sara,Gurrutxaga,1994-03-12,40616649Y,sara.gurrutxaga@extremecloud.com,093529,ES94209525837524276640,1768.53,2023-10-12T09:04:55,Donostia,expenses,transport,-52.12,-13248.24
buyer_5,Sara,Gurrutxaga,1994-03-12,40616649Y,sara.gurrutxaga@extremecloud.com,093529,ES94209525837524276640,1768.53,2023-10-13T13:30:00,Donostia,expenses,healthcare,-140.12,-13388.36
buyer_5,Sara,Gurrutxaga,1994-03-12,40616649Y,sara.gurrutxaga@extremecloud.com,093529,ES94209525837524276640,1768.53,2023-10-13T20:55:13,Donostia,expenses,cash,-100.0,-13488.36
buyer_5,Sara,Gurrutxaga,1994-03-12,40616649Y,sara.gurrutxaga@extremecloud.com,093529,ES94209525837524276640,1768.53,2023-10-14T12:59:06,Donostia,expenses,food,-99.71,-13588.07
buyer_5,Sara,Gurrutxaga,1994-03-12,40616649Y,sara.gurrutxaga@extremecloud.com,093529,ES94209525837524276640,1768.53,2023-10-19T15:37:05,Donostia,expenses,transport,-87.99,-13676.06
buyer_5,Sara,Gurrutxaga,1994-03-12,40616649Y,sara.gurrutxaga@extremecloud.com,093529,ES94209525837524276640,1768.53,2023-10-20T11:49:42,Donostia,expenses,cash,-100.0,-13776.06
buyer_5,Sara,Gurrutxaga,1994-03-12,40616649Y,sara.gurrutxaga@extremecloud.com,093529,ES94209525837524276640,1768.53,2023-10-20T13:38:28,Donostia,expenses,repairs,-271.02,-14047.08
buyer_5,Sara,Gurrutxaga,1994-03-12,40616649Y,sara.gurrutxaga@extremecloud.com,093529,ES94209525837524276640,1768.53,2023-10-21T18:04:27,Donostia,expenses,education,-61.09,-14108.17
buyer_5,Sara,Gurrutxaga,1994-03-12,40616649Y,sara.gurrutxaga@extremecloud.com,093529,ES94209525837524276640,1768.53,2023-10-23T11:39:29,Donostia,expenses,food,-60.85,-14169.02
buyer_5,Sara,Gurrutxaga,1994-03-12,40616649Y,sara.gurrutxaga@extremecloud.com,093529,ES94209525837524276640,1768.53,2023-10-24T19:30:52,Donostia,expenses,leisure,-50.04,-14219.06
buyer_5,Sara,Gurrutxaga,1994-03-12,40616649Y,sara.gurrutxaga@extremecloud.com,093529,ES94209525837524276640,1768.53,2023-10-25T14:45:04,Donostia,expenses,cash,-100.0,-14319.06
buyer_5,Sara,Gurrutxaga,1994-03-12,40616649Y,sara.gurrutxaga@extremecloud.com,093529,ES94209525837524276640,1768.53,2023-10-26T20:44:07,Donostia,expenses,food,-117.65,-14436.71
buyer_5,Sara,Gurrutxaga,1994-03-12,40616649Y,sara.gurrutxaga@extremecloud.com,093529,ES94209525837524276640,1768.53,2023-10-27T14:20:39,Donostia,expenses,travel,-596.32,-15033.03
buyer_5,Sara,Gurrutxaga,1994-03-12,40616649Y,sara.gurrutxaga@extremecloud.com,093529,ES94209525837524276640,1768.53,2023-10-29T09:05:34,Donostia,expenses,clothing,-82.99,-15116.02
buyer_5,Sara,Gurrutxaga,1994-03-12,40616649Y,sara.gurrutxaga@extremecloud.com,093529,ES94209525837524276640,1768.53,2023-10-30T01:21:48,Donostia,expenses,healthcare,-44.98,-15161.0
buyer_5,Sara,Gurrutxaga,1994-03-12,40616649Y,sara.gurrutxaga@extremecloud.com,093529,ES94209525837524276640,1768.53,2023-10-30T18:58:30,Donostia,expenses,repairs,-294.69,-15455.69
buyer_5,Sara,Gurrutxaga,1994-03-12,40616649Y,sara.gurrutxaga@extremecloud.com,093529,ES94209525837524276640,1768.53,2023-11-01T18:26:32,Donostia,incomes,salary,2623.42,-12832.27
buyer_5,Sara,Gurrutxaga,1994-03-12,40616649Y,sara.gurrutxaga@extremecloud.com,093529,ES94209525837524276640,1768.53,2023-11-01T18:26:32,Donostia,incomes,salary_partner,3080.45,-9751.82
buyer_5,Sara,Gurrutxaga,1994-03-12,40616649Y,sara.gurrutxaga@extremecloud.com,093529,ES94209525837524276640,1768.53,2023-11-01T18:26:32,Donostia,incomes,extra_income,354.73,-9397.09
buyer_5,Sara,Gurrutxaga,1994-03-12,40616649Y,sara.gurrutxaga@extremecloud.com,093529,ES94209525837524276640,1768.53,2023-11-04T21:09:11,Donostia,expenses,mortgage,-2279.14,-11676.23
buyer_5,Sara,Gurrutxaga,1994-03-12,40616649Y,sara.gurrutxaga@extremecloud.com,093529,ES94209525837524276640,1768.53,2023-11-04T14:33:20,Donostia,expenses,transport,-40.3,-11716.53
buyer_5,Sara,Gurrutxaga,1994-03-12,40616649Y,sara.gurrutxaga@extremecloud.com,093529,ES94209525837524276640,1768.53,2023-11-04T19:18:49,Donostia,expenses,healthcare,-92.77,-11809.3
buyer_5,Sara,Gurrutxaga,1994-03-12,40616649Y,sara.gurrutxaga@extremecloud.com,093529,ES94209525837524276640,1768.53,2023-11-05T10:34:09,Donostia,expenses,transport,-63.75,-11873.05
buyer_5,Sara,Gurrutxaga,1994-03-12,40616649Y,sara.gurrutxaga@extremecloud.com,093529,ES94209525837524276640,1768.53,2023-11-06T13:29:38,Donostia,expenses,water,-77.45,-11950.5
buyer_5,Sara,Gurrutxaga,1994-03-12,40616649Y,sara.gurrutxaga@extremecloud.com,093529,ES94209525837524276640,1768.53,2023-11-08T09:05:40,Donostia,expenses,gas,-179.05,-12129.55
buyer_5,Sara,Gurrutxaga,1994-03-12,40616649Y,sara.gurrutxaga@extremecloud.com,093529,ES94209525837524276640,1768.53,2023-11-08T16:13:21,Donostia,expenses,internet,-119.78,-12249.33
buyer_5,Sara,Gurrutxaga,1994-03-12,40616649Y,sara.gurrutxaga@extremecloud.com,093529,ES94209525837524276640,1768.53,2023-11-08T16:31:05,Donostia,expenses,leisure,-30.63,-12279.96
buyer_5,Sara,Gurrutxaga,1994-03-12,40616649Y,sara.gurrutxaga@extremecloud.com,093529,ES94209525837524276640,1768.53,2023-11-10T10:44:34,Donostia,expenses,food,-99.19,-12379.15
buyer_5,Sara,Gurrutxaga,1994-03-12,40616649Y,sara.gurrutxaga@extremecloud.com,093529,ES94209525837524276640,1768.53,2023-11-10T13:30:51,Donostia,expenses,appliances,-283.44,-12662.59
buyer_5,Sara,Gurrutxaga,1994-03-12,40616649Y,sara.gurrutxaga@extremecloud.com,093529,ES94209525837524276640,1768.53,2023-11-11T04:11:23,Donostia,expenses,repairs,-170.12,-12832.71
buyer_5,Sara,Gurrutxaga,1994-03-12,40616649Y,sara.gurrutxaga@extremecloud.com,093529,ES94209525837524276640,1768.53,2023-11-12T20:10:16,Donostia,expenses,leisure,-67.42,-12900.13
buyer_5,Sara,Gurrutxaga,1994-03-12,40616649Y,sara.gurrutxaga@extremecloud.com,093529,ES94209525837524276640,1768.53,2023-11-13T17:15:09,Donostia,expenses,cash,-100.0,-13000.13
buyer_5,Sara,Gurrutxaga,1994-03-12,40616649Y,sara.gurrutxaga@extremecloud.com,093529,ES94209525837524276640,1768.53,2023-11-14T10:18:35,Donostia,expenses,cash,-100.0,-13100.13
buyer_5,Sara,Gurrutxaga,1994-03-12,40616649Y,sara.gurrutxaga@extremecloud.com,093529,ES94209525837524276640,1768.53,2023-11-15T14:18:17,Donostia,expenses,transport,-48.6,-13148.73
buyer_5,Sara,Gurrutxaga,1994-03-12,40616649Y,sara.gurrutxaga@extremecloud.com,093529,ES94209525837524276640,1768.53,2023-11-15T14:23:38,Donostia,expenses,leisure,-81.85,-13230.58
buyer_5,Sara,Gurrutxaga,1994-03-12,40616649Y,sara.gurrutxaga@extremecloud.com,093529,ES94209525837524276640,1768.53,2023-11-17T19:15:00,Donostia,expenses,food,-90.75,-13321.33
buyer_5,Sara,Gurrutxaga,1994-03-12,40616649Y,sara.gurrutxaga@extremecloud.com,093529,ES94209525837524276640,1768.53,2023-11-17T09:25:22,Donostia,expenses,cash,-100.0,-13421.33
buyer_5,Sara,Gurrutxaga,1994-03-12,40616649Y,sara.gurrutxaga@extremecloud.com,093529,ES94209525837524276640,1768.53,2023-11-19T10:50:29,Donostia,expenses,food,-79.03,-13500.36
buyer_5,Sara,Gurrutxaga,1994-03-12,40616649Y,sara.gurrutxaga@extremecloud.com,093529,ES94209525837524276640,1768.53,2023-11-19T14:51:00,Donostia,expenses,education,-44.87,-13545.23
buyer_5,Sara,Gurrutxaga,1994-03-12,40616649Y,sara.gurrutxaga@extremecloud.com,093529,ES94209525837524276640,1768.53,2023-11-19T19:36:02,Donostia,expenses,cash,-100.0,-13645.23
buyer_5,Sara,Gurrutxaga,1994-03-12,40616649Y,sara.gurrutxaga@extremecloud.com,093529,ES94209525837524276640,1768.53,2023-11-20T06:28:06,Donostia,expenses,food,-90.04,-13735.27
buyer_5,Sara,Gurrutxaga,1994-03-12,40616649Y,sara.gurrutxaga@extremecloud.com,093529,ES94209525837524276640,1768.53,2023-11-24T09:07:13,Donostia,expenses,food,-98.25,-13833.52
buyer_5,Sara,Gurrutxaga,1994-03-12,40616649Y,sara.gurrutxaga@extremecloud.com,093529,ES94209525837524276640,1768.53,2023-11-24T13:45:01,Donostia,expenses,clothing,-158.15,-13991.67
buyer_5,Sara,Gurrutxaga,1994-03-12,40616649Y,sara.gurrutxaga@extremecloud.com,093529,ES94209525837524276640,1768.53,2023-11-25T13:01:17,Donostia,expenses,leisure,-25.48,-14017.15
buyer_5,Sara,Gurrutxaga,1994-03-12,40616649Y,sara.gurrutxaga@extremecloud.com,093529,ES94209525837524276640,1768.53,2023-11-25T13:48:52,Donostia,expenses,cash,-100.0,-14117.15
buyer_5,Sara,Gurrutxaga,1994-03-12,40616649Y,sara.gurrutxaga@extremecloud.com,093529,ES94209525837524276640,1768.53,2023-11-25T16:08:41,Donostia,expenses,gifts,-830.52,-14947.67
buyer_5,Sara,Gurrutxaga,1994-03-12,40616649Y,sara.gurrutxaga@extremecloud.com,093529,ES94209525837524276640,1768.53,2023-11-27T14:25:23,Donostia,expenses,cash,-100.0,-15047.67
buyer_5,Sara,Gurrutxaga,1994-03-12,40616649Y,sara.gurrutxaga@extremecloud.com,093529,ES94209525837524276640,1768.53,2023-11-28T11:14:45,Donostia,expenses,appliances,-233.12,-15280.79
buyer_5,Sara,Gurrutxaga,1994-03-12,40616649Y,sara.gurrutxaga@extremecloud.com,093529,ES94209525837524276640,1768.53,2023-11-29T20:13:07,Donostia,expenses,leisure,-52.84,-15333.63
buyer_5,Sara,Gurrutxaga,1994-03-12,40616649Y,sara.gurrutxaga@extremecloud.com,093529,ES94209525837524276640,1768.53,2023-12-01T13:36:19,Donostia,incomes,salary,2623.42,-12710.21
buyer_5,Sara,Gurrutxaga,1994-03-12,40616649Y,sara.gurrutxaga@extremecloud.com,093529,ES94209525837524276640,1768.53,2023-12-01T13:36:19,Donostia,incomes,salary_partner,3080.45,-9629.76
buyer_5,Sara,Gurrutxaga,1994-03-12,40616649Y,sara.gurrutxaga@extremecloud.com,093529,ES94209525837524276640,1768.53,2023-12-01T13:36:19,Donostia,incomes,salary_bonus,2058.36,-7571.4
buyer_5,Sara,Gurrutxaga,1994-03-12,40616649Y,sara.gurrutxaga@extremecloud.com,093529,ES94209525837524276640,1768.53,2023-12-01T13:36:19,Donostia,incomes,salary_partner_bonus,2298.04,-5273.36
buyer_5,Sara,Gurrutxaga,1994-03-12,40616649Y,sara.gurrutxaga@extremecloud.com,093529,ES94209525837524276640,1768.53,2023-12-03T14:08:45,Donostia,expenses,food,-94.22,-5367.58
buyer_5,Sara,Gurrutxaga,1994-03-12,40616649Y,sara.gurrutxaga@extremecloud.com,093529,ES94209525837524276640,1768.53,2023-12-04T10:01:41,Donostia,expenses,mortgage,-2279.14,-7646.72
buyer_5,Sara,Gurrutxaga,1994-03-12,40616649Y,sara.gurrutxaga@extremecloud.com,093529,ES94209525837524276640,1768.53,2023-12-04T17:38:53,Donostia,expenses,leisure,-77.34,-7724.06
buyer_5,Sara,Gurrutxaga,1994-03-12,40616649Y,sara.gurrutxaga@extremecloud.com,093529,ES94209525837524276640,1768.53,2023-12-04T16:25:45,Donostia,expenses,gifts,-688.43,-8412.49
buyer_5,Sara,Gurrutxaga,1994-03-12,40616649Y,sara.gurrutxaga@extremecloud.com,093529,ES94209525837524276640,1768.53,2023-12-05T16:37:30,Donostia,expenses,electricity,-142.26,-8554.75
buyer_5,Sara,Gurrutxaga,1994-03-12,40616649Y,sara.gurrutxaga@extremecloud.com,093529,ES94209525837524276640,1768.53,2023-12-05T16:43:32,Donostia,expenses,internet,-119.78,-8674.53
buyer_5,Sara,Gurrutxaga,1994-03-12,40616649Y,sara.gurrutxaga@extremecloud.com,093529,ES94209525837524276640,1768.53,2023-12-06T18:35:26,Donostia,expenses,electricity,-156.85,-8831.38
buyer_5,Sara,Gurrutxaga,1994-03-12,40616649Y,sara.gurrutxaga@extremecloud.com,093529,ES94209525837524276640,1768.53,2023-12-07T11:37:21,Donostia,expenses,cash,-100.0,-8931.38
buyer_5,Sara,Gurrutxaga,1994-03-12,40616649Y,sara.gurrutxaga@extremecloud.com,093529,ES94209525837524276640,1768.53,2023-12-08T15:06:17,Donostia,expenses,gas,-295.03,-9226.41
buyer_5,Sara,Gurrutxaga,1994-03-12,40616649Y,sara.gurrutxaga@extremecloud.com,093529,ES94209525837524276640,1768.53,2023-12-08T14:40:54,Donostia,expenses,internet,-119.78,-9346.19
buyer_5,Sara,Gurrutxaga,1994-03-12,40616649Y,sara.gurrutxaga@extremecloud.com,093529,ES94209525837524276640,1768.53,2023-12-08T11:14:01,Donostia,expenses,phone,-120.65,-9466.84
buyer_5,Sara,Gurrutxaga,1994-03-12,40616649Y,sara.gurrutxaga@extremecloud.com,093529,ES94209525837524276640,1768.53,2023-12-08T13:07:26,Donostia,expenses,food,-71.18,-9538.02
buyer_5,Sara,Gurrutxaga,1994-03-12,40616649Y,sara.gurrutxaga@extremecloud.com,093529,ES94209525837524276640,1768.53,2023-12-08T13:13:36,Donostia,expenses,clothing,-61.5,-9599.52
buyer_5,Sara,Gurrutxaga,1994-03-12,40616649Y,sara.gurrutxaga@extremecloud.com,093529,ES94209525837524276640,1768.53,2023-12-09T15:27:05,Donostia,expenses,leisure,-63.04,-9662.56
buyer_5,Sara,Gurrutxaga,1994-03-12,40616649Y,sara.gurrutxaga@extremecloud.com,093529,ES94209525837524276640,1768.53,2023-12-10T15:34:44,Donostia,expenses,appliances,-369.19,-10031.75
buyer_5,Sara,Gurrutxaga,1994-03-12,40616649Y,sara.gurrutxaga@extremecloud.com,093529,ES94209525837524276640,1768.53,2023-12-12T19:09:40,Donostia,expenses,cash,-100.0,-10131.75
buyer_5,Sara,Gurrutxaga,1994-03-12,40616649Y,sara.gurrutxaga@extremecloud.com,093529,ES94209525837524276640,1768.53,2023-12-13T10:26:25,Donostia,expenses,transport,-81.69,-10213.44
buyer_5,Sara,Gurrutxaga,1994-03-12,40616649Y,sara.gurrutxaga@extremecloud.com,093529,ES94209525837524276640,1768.53,2023-12-14T19:50:51,Donostia,expenses,cash,-100.0,-10313.44
buyer_5,Sara,Gurrutxaga,1994-03-12,40616649Y,sara.gurrutxaga@extremecloud.com,093529,ES94209525837524276640,1768.53,2023-12-15T13:44:10,Donostia,expenses,leisure,-70.3,-10383.74
buyer_5,Sara,Gurrutxaga,1994-03-12,40616649Y,sara.gurrutxaga@extremecloud.com,093529,ES94209525837524276640,1768.53,2023-12-17T11:05:16,Donostia,expenses,food,-70.1,-10453.84
buyer_5,Sara,Gurrutxaga,1994-03-12,40616649Y,sara.gurrutxaga@extremecloud.com,093529,ES94209525837524276640,1768.53,2023-12-21T11:39:53,Donostia,expenses,food,-108.62,-10562.46
buyer_5,Sara,Gurrutxaga,1994-03-12,40616649Y,sara.gurrutxaga@extremecloud.com,093529,ES94209525837524276640,1768.53,2023-12-21T19:27:28,Donostia,expenses,cash,-100.0,-10662.46
buyer_5,Sara,Gurrutxaga,1994-03-12,40616649Y,sara.gurrutxaga@extremecloud.com,093529,ES94209525837524276640,1768.53,2023-12-23T15:51:41,Donostia,expenses,food,-94.92,-10757.38
buyer_5,Sara,Gurrutxaga,1994-03-12,40616649Y,sara.gurrutxaga@extremecloud.com,093529,ES94209525837524276640,1768.53,2023-12-23T14:12:02,Donostia,expenses,transport,-82.48,-10839.86
buyer_5,Sara,Gurrutxaga,1994-03-12,40616649Y,sara.gurrutxaga@extremecloud.com,093529,ES94209525837524276640,1768.53,2023-12-23T16:16:11,Donostia,expenses,leisure,-54.52,-10894.38
buyer_5,Sara,Gurrutxaga,1994-03-12,40616649Y,sara.gurrutxaga@extremecloud.com,093529,ES94209525837524276640,1768.53,2023-12-23T12:06:22,Donostia,expenses,cash,-100.0,-10994.38
buyer_5,Sara,Gurrutxaga,1994-03-12,40616649Y,sara.gurrutxaga@extremecloud.com,093529,ES94209525837524276640,1768.53,2023-12-23T08:16:35,Donostia,expenses,gifts,-352.53,-11346.91
buyer_5,Sara,Gurrutxaga,1994-03-12,40616649Y,sara.gurrutxaga@extremecloud.com,093529,ES94209525837524276640,1768.53,2023-12-26T14:06:30,Donostia,expenses,leisure,-39.57,-11386.48
buyer_5,Sara,Gurrutxaga,1994-03-12,40616649Y,sara.gurrutxaga@extremecloud.com,093529,ES94209525837524276640,1768.53,2023-12-30T14:43:35,Donostia,expenses,leisure,-39.43,-11425.91
buyer_5,Sara,Gurrutxaga,1994-03-12,40616649Y,sara.gurrutxaga@extremecloud.com,093529,ES94209525837524276640,1768.53,2023-12-31T19:45:02,Donostia,expenses,repairs,-68.93,-11494.84
buyer_5,Sara,Gurrutxaga,1994-03-12,40616649Y,sara.gurrutxaga@extremecloud.com,093529,ES94209525837524276640,1768.53,2024-01-01T13:40:19,Donostia,incomes,salary,2682.24,-8812.6
buyer_5,Sara,Gurrutxaga,1994-03-12,40616649Y,sara.gurrutxaga@extremecloud.com,093529,ES94209525837524276640,1768.53,2024-01-01T13:40:19,Donostia,incomes,salary_partner,3149.51,-5663.09
buyer_5,Sara,Gurrutxaga,1994-03-12,40616649Y,sara.gurrutxaga@extremecloud.com,093529,ES94209525837524276640,1768.53,2024-01-01T12:03:00,Donostia,expenses,healthcare,-129.44,-5792.53
buyer_5,Sara,Gurrutxaga,1994-03-12,40616649Y,sara.gurrutxaga@extremecloud.com,093529,ES94209525837524276640,1768.53,2024-01-02T19:45:51,Donostia,expenses,healthcare,-183.05,-5975.58
buyer_5,Sara,Gurrutxaga,1994-03-12,40616649Y,sara.gurrutxaga@extremecloud.com,093529,ES94209525837524276640,1768.53,2024-01-04T16:38:04,Donostia,expenses,mortgage,-3055.94,-9031.52
buyer_5,Sara,Gurrutxaga,1994-03-12,40616649Y,sara.gurrutxaga@extremecloud.com,093529,ES94209525837524276640,1768.53,2024-01-05T18:27:14,Donostia,expenses,water,-76.3,-9107.82
buyer_5,Sara,Gurrutxaga,1994-03-12,40616649Y,sara.gurrutxaga@extremecloud.com,093529,ES94209525837524276640,1768.53,2024-01-05T06:04:45,Donostia,expenses,phone,-122.36,-9230.18
buyer_5,Sara,Gurrutxaga,1994-03-12,40616649Y,sara.gurrutxaga@extremecloud.com,093529,ES94209525837524276640,1768.53,2024-01-06T12:12:25,Donostia,expenses,gas,-274.96,-9505.14
buyer_5,Sara,Gurrutxaga,1994-03-12,40616649Y,sara.gurrutxaga@extremecloud.com,093529,ES94209525837524276640,1768.53,2024-01-06T19:49:33,Donostia,expenses,cash,-100.0,-9605.14
buyer_5,Sara,Gurrutxaga,1994-03-12,40616649Y,sara.gurrutxaga@extremecloud.com,093529,ES94209525837524276640,1768.53,2024-01-07T10:55:49,Donostia,expenses,gas,-188.65,-9793.79
buyer_5,Sara,Gurrutxaga,1994-03-12,40616649Y,sara.gurrutxaga@extremecloud.com,093529,ES94209525837524276640,1768.53,2024-01-07T06:34:53,Donostia,expenses,phone,-108.9,-9902.69
buyer_5,Sara,Gurrutxaga,1994-03-12,40616649Y,sara.gurrutxaga@extremecloud.com,093529,ES94209525837524276640,1768.53,2024-01-07T12:03:11,Donostia,expenses,cash,-100.0,-10002.69
buyer_5,Sara,Gurrutxaga,1994-03-12,40616649Y,sara.gurrutxaga@extremecloud.com,093529,ES94209525837524276640,1768.53,2024-01-08T15:07:42,Donostia,expenses,internet,-122.47,-10125.16
buyer_5,Sara,Gurrutxaga,1994-03-12,40616649Y,sara.gurrutxaga@extremecloud.com,093529,ES94209525837524276640,1768.53,2024-01-09T08:56:20,Donostia,expenses,food,-81.16,-10206.32
buyer_5,Sara,Gurrutxaga,1994-03-12,40616649Y,sara.gurrutxaga@extremecloud.com,093529,ES94209525837524276640,1768.53,2024-01-10T10:22:20,Donostia,expenses,transport,-64.17,-10270.49
buyer_5,Sara,Gurrutxaga,1994-03-12,40616649Y,sara.gurrutxaga@extremecloud.com,093529,ES94209525837524276640,1768.53,2024-01-10T21:14:00,Donostia,expenses,repairs,-179.75,-10450.24
buyer_5,Sara,Gurrutxaga,1994-03-12,40616649Y,sara.gurrutxaga@extremecloud.com,093529,ES94209525837524276640,1768.53,2024-01-11T22:35:26,Donostia,expenses,cash,-100.0,-10550.24
buyer_5,Sara,Gurrutxaga,1994-03-12,40616649Y,sara.gurrutxaga@extremecloud.com,093529,ES94209525837524276640,1768.53,2024-01-13T11:27:15,Donostia,expenses,food,-114.81,-10665.05
buyer_5,Sara,Gurrutxaga,1994-03-12,40616649Y,sara.gurrutxaga@extremecloud.com,093529,ES94209525837524276640,1768.53,2024-01-14T18:29:04,Donostia,expenses,food,-87.01,-10752.06
buyer_5,Sara,Gurrutxaga,1994-03-12,40616649Y,sara.gurrutxaga@extremecloud.com,093529,ES94209525837524276640,1768.53,2024-01-15T08:33:33,Donostia,expenses,clothing,-104.37,-10856.43
buyer_5,Sara,Gurrutxaga,1994-03-12,40616649Y,sara.gurrutxaga@extremecloud.com,093529,ES94209525837524276640,1768.53,2024-01-15T01:53:32,Donostia,expenses,repairs,-280.06,-11136.49
buyer_5,Sara,Gurrutxaga,1994-03-12,40616649Y,sara.gurrutxaga@extremecloud.com,093529,ES94209525837524276640,1768.53,2024-01-16T23:18:23,Donostia,expenses,healthcare,-111.37,-11247.86
buyer_5,Sara,Gurrutxaga,1994-03-12,40616649Y,sara.gurrutxaga@extremecloud.com,093529,ES94209525837524276640,1768.53,2024-01-16T12:21:03,Donostia,expenses,gifts,-238.93,-11486.79
buyer_5,Sara,Gurrutxaga,1994-03-12,40616649Y,sara.gurrutxaga@extremecloud.com,093529,ES94209525837524276640,1768.53,2024-01-18T14:00:49,Donostia,expenses,cash,-100.0,-11586.79
buyer_5,Sara,Gurrutxaga,1994-03-12,40616649Y,sara.gurrutxaga@extremecloud.com,093529,ES94209525837524276640,1768.53,2024-01-20T13:37:51,Donostia,expenses,transport,-69.44,-11656.23
buyer_5,Sara,Gurrutxaga,1994-03-12,40616649Y,sara.gurrutxaga@extremecloud.com,093529,ES94209525837524276640,1768.53,2024-01-21T19:47:33,Donostia,expenses,food,-104.99,-11761.22
buyer_5,Sara,Gurrutxaga,1994-03-12,40616649Y,sara.gurrutxaga@extremecloud.com,093529,ES94209525837524276640,1768.53,2024-01-22T18:11:47,Donostia,expenses,repairs,-71.25,-11832.47
buyer_5,Sara,Gurrutxaga,1994-03-12,40616649Y,sara.gurrutxaga@extremecloud.com,093529,ES94209525837524276640,1768.53,2024-01-23T18:49:54,Donostia,expenses,food,-116.2,-11948.67
buyer_5,Sara,Gurrutxaga,1994-03-12,40616649Y,sara.gurrutxaga@extremecloud.com,093529,ES94209525837524276640,1768.53,2024-01-23T08:53:42,Donostia,expenses,leisure,-30.14,-11978.81
buyer_5,Sara,Gurrutxaga,1994-03-12,40616649Y,sara.gurrutxaga@extremecloud.com,093529,ES94209525837524276640,1768.53,2024-01-23T10:21:12,Donostia,expenses,clothing,-95.6,-12074.41
buyer_5,Sara,Gurrutxaga,1994-03-12,40616649Y,sara.gurrutxaga@extremecloud.com,093529,ES94209525837524276640,1768.53,2024-01-25T14:55:01,Donostia,expenses,food,-108.88,-12183.29
buyer_5,Sara,Gurrutxaga,1994-03-12,40616649Y,sara.gurrutxaga@extremecloud.com,093529,ES94209525837524276640,1768.53,2024-01-25T09:31:25,Donostia,expenses,cash,-100.0,-12283.29
buyer_5,Sara,Gurrutxaga,1994-03-12,40616649Y,sara.gurrutxaga@extremecloud.com,093529,ES94209525837524276640,1768.53,2024-01-26T16:20:02,Donostia,expenses,travel,-750.53,-13033.82
buyer_5,Sara,Gurrutxaga,1994-03-12,40616649Y,sara.gurrutxaga@extremecloud.com,093529,ES94209525837524276640,1768.53,2024-01-28T19:32:11,Donostia,expenses,food,-90.96,-13124.78
buyer_5,Sara,Gurrutxaga,1994-03-12,40616649Y,sara.gurrutxaga@extremecloud.com,093529,ES94209525837524276640,1768.53,2024-01-28T17:54:09,Donostia,expenses,leisure,-20.22,-13145.0
buyer_5,Sara,Gurrutxaga,1994-03-12,40616649Y,sara.gurrutxaga@extremecloud.com,093529,ES94209525837524276640,1768.53,2024-01-29T10:58:35,Donostia,expenses,leisure,-74.41,-13219.41
buyer_5,Sara,Gurrutxaga,1994-03-12,40616649Y,sara.gurrutxaga@extremecloud.com,093529,ES94209525837524276640,1768.53,2024-01-29T21:28:42,Donostia,expenses,gifts,-458.81,-13678.22
buyer_5,Sara,Gurrutxaga,1994-03-12,40616649Y,sara.gurrutxaga@extremecloud.com,093529,ES94209525837524276640,1768.53,2024-01-30T16:19:20,Donostia,expenses,clothing,-142.66,-13820.88
buyer_5,Sara,Gurrutxaga,1994-03-12,40616649Y,sara.gurrutxaga@extremecloud.com,093529,ES94209525837524276640,1768.53,2024-01-31T20:52:06,Donostia,expenses,cash,-100.0,-13920.88
buyer_5,Sara,Gurrutxaga,1994-03-12,40616649Y,sara.gurrutxaga@extremecloud.com,093529,ES94209525837524276640,1768.53,2024-02-01T18:18:46,Donostia,incomes,salary,2682.24,-11238.64
buyer_5,Sara,Gurrutxaga,1994-03-12,40616649Y,sara.gurrutxaga@extremecloud.com,093529,ES94209525837524276640,1768.53,2024-02-01T18:18:46,Donostia,incomes,salary_partner,3149.51,-8089.13
buyer_5,Sara,Gurrutxaga,1994-03-12,40616649Y,sara.gurrutxaga@extremecloud.com,093529,ES94209525837524276640,1768.53,2024-02-01T18:18:46,Donostia,incomes,extra_income,354.73,-7734.4
buyer_5,Sara,Gurrutxaga,1994-03-12,40616649Y,sara.gurrutxaga@extremecloud.com,093529,ES94209525837524276640,1768.53,2024-02-01T19:47:31,Donostia,expenses,travel,-504.24,-8238.64
buyer_5,Sara,Gurrutxaga,1994-03-12,40616649Y,sara.gurrutxaga@extremecloud.com,093529,ES94209525837524276640,1768.53,2024-02-03T12:42:28,Donostia,expenses,food,-85.5,-8324.14
buyer_5,Sara,Gurrutxaga,1994-03-12,40616649Y,sara.gurrutxaga@extremecloud.com,093529,ES94209525837524276640,1768.53,2024-02-04T18:59:21,Donostia,expenses,mortgage,-3055.94,-11380.08
buyer_5,Sara,Gurrutxaga,1994-03-12,40616649Y,sara.gurrutxaga@extremecloud.com,093529,ES94209525837524276640,1768.53,2024-02-05T13:28:15,Donostia,expenses,electricity,-246.56,-11626.64
buyer_5,Sara,Gurrutxaga,1994-03-12,40616649Y,sara.gurrutxaga@extremecloud.com,093529,ES94209525837524276640,1768.53,2024-02-05T03:06:39,Donostia,expenses,internet,-122.47,-11749.11
buyer_5,Sara,Gurrutxaga,1994-03-12,40616649Y,sara.gurrutxaga@extremecloud.com,093529,ES94209525837524276640,1768.53,2024-02-06T23:48:19,Donostia,expenses,electricity,-71.84,-11820.95
buyer_5,Sara,Gurrutxaga,1994-03-12,40616649Y,sara.gurrutxaga@extremecloud.com,093529,ES94209525837524276640,1768.53,2024-02-06T17:08:47,Donostia,expenses,clothing,-88.23,-11909.18
buyer_5,Sara,Gurrutxaga,1994-03-12,40616649Y,sara.gurrutxaga@extremecloud.com,093529,ES94209525837524276640,1768.53,2024-02-07T09:12:59,Donostia,expenses,electricity,-261.6,-12170.78
buyer_5,Sara,Gurrutxaga,1994-03-12,40616649Y,sara.gurrutxaga@extremecloud.com,093529,ES94209525837524276640,1768.53,2024-02-07T17:25:16,Donostia,expenses,leisure,-35.9,-12206.68
buyer_5,Sara,Gurrutxaga,1994-03-12,40616649Y,sara.gurrutxaga@extremecloud.com,093529,ES94209525837524276640,1768.53,2024-02-07T19:31:03,Donostia,expenses,cash,-100.0,-12306.68
buyer_5,Sara,Gurrutxaga,1994-03-12,40616649Y,sara.gurrutxaga@extremecloud.com,093529,ES94209525837524276640,1768.53,2024-02-07T22:08:05,Donostia,expenses,gifts,-619.99,-12926.67
buyer_5,Sara,Gurrutxaga,1994-03-12,40616649Y,sara.gurrutxaga@extremecloud.com,093529,ES94209525837524276640,1768.53,2024-02-08T13:45:49,Donostia,expenses,gas,-147.43,-13074.1
buyer_5,Sara,Gurrutxaga,1994-03-12,40616649Y,sara.gurrutxaga@extremecloud.com,093529,ES94209525837524276640,1768.53,2024-02-08T10:35:36,Donostia,expenses,transport,-77.12,-13151.22
buyer_5,Sara,Gurrutxaga,1994-03-12,40616649Y,sara.gurrutxaga@extremecloud.com,093529,ES94209525837524276640,1768.53,2024-02-10T16:22:25,Donostia,expenses,food,-93.18,-13244.4
buyer_5,Sara,Gurrutxaga,1994-03-12,40616649Y,sara.gurrutxaga@extremecloud.com,093529,ES94209525837524276640,1768.53,2024-02-10T19:44:55,Donostia,expenses,cash,-100.0,-13344.4
buyer_5,Sara,Gurrutxaga,1994-03-12,40616649Y,sara.gurrutxaga@extremecloud.com,093529,ES94209525837524276640,1768.53,2024-02-14T16:19:00,Donostia,expenses,gifts,-46.88,-13391.28
buyer_5,Sara,Gurrutxaga,1994-03-12,40616649Y,sara.gurrutxaga@extremecloud.com,093529,ES94209525837524276640,1768.53,2024-02-16T18:11:20,Donostia,expenses,repairs,-231.64,-13622.92
buyer_5,Sara,Gurrutxaga,1994-03-12,40616649Y,sara.gurrutxaga@extremecloud.com,093529,ES94209525837524276640,1768.53,2024-02-16T08:06:06,Donostia,expenses,gifts,-312.56,-13935.48
buyer_5,Sara,Gurrutxaga,1994-03-12,40616649Y,sara.gurrutxaga@extremecloud.com,093529,ES94209525837524276640,1768.53,2024-02-18T08:45:55,Donostia,expenses,cash,-100.0,-14035.48
buyer_5,Sara,Gurrutxaga,1994-03-12,40616649Y,sara.gurrutxaga@extremecloud.com,093529,ES94209525837524276640,1768.53,2024-02-19T09:56:45,Donostia,expenses,transport,-45.9,-14081.38
buyer_5,Sara,Gurrutxaga,1994-03-12,40616649Y,sara.gurrutxaga@extremecloud.com,093529,ES94209525837524276640,1768.53,2024-02-20T05:07:52,Donostia,expenses,healthcare,-65.33,-14146.71
buyer_5,Sara,Gurrutxaga,1994-03-12,40616649Y,sara.gurrutxaga@extremecloud.com,093529,ES94209525837524276640,1768.53,2024-02-22T17:38:50,Donostia,expenses,food,-60.99,-14207.7
buyer_5,Sara,Gurrutxaga,1994-03-12,40616649Y,sara.gurrutxaga@extremecloud.com,093529,ES94209525837524276640,1768.53,2024-02-22T08:22:32,Donostia,expenses,cash,-100.0,-14307.7
buyer_5,Sara,Gurrutxaga,1994-03-12,40616649Y,sara.gurrutxaga@extremecloud.com,093529,ES94209525837524276640,1768.53,2024-02-25T16:29:27,Donostia,expenses,transport,-48.69,-14356.39
buyer_5,Sara,Gurrutxaga,1994-03-12,40616649Y,sara.gurrutxaga@extremecloud.com,093529,ES94209525837524276640,1768.53,2024-02-25T18:23:12,Donostia,expenses,cash,-100.0,-14456.39
buyer_5,Sara,Gurrutxaga,1994-03-12,40616649Y,sara.gurrutxaga@extremecloud.com,093529,ES94209525837524276640,1768.53,2024-02-27T16:45:56,Donostia,expenses,food,-80.3,-14536.69
buyer_5,Sara,Gurrutxaga,1994-03-12,40616649Y,sara.gurrutxaga@extremecloud.com,093529,ES94209525837524276640,1768.53,2024-02-28T08:50:05,Donostia,expenses,food,-87.92,-14624.61
buyer_5,Sara,Gurrutxaga,1994-03-12,40616649Y,sara.gurrutxaga@extremecloud.com,093529,ES94209525837524276640,1768.53,2024-02-28T15:12:27,Donostia,expenses,clothing,-112.53,-14737.14
buyer_5,Sara,Gurrutxaga,1994-03-12,40616649Y,sara.gurrutxaga@extremecloud.com,093529,ES94209525837524276640,1768.53,2024-03-01T12:25:19,Donostia,incomes,salary,2682.24,-12054.9
buyer_5,Sara,Gurrutxaga,1994-03-12,40616649Y,sara.gurrutxaga@extremecloud.com,093529,ES94209525837524276640,1768.53,2024-03-01T12:25:19,Donostia,incomes,salary_partner,3149.51,-8905.39
buyer_5,Sara,Gurrutxaga,1994-03-12,40616649Y,sara.gurrutxaga@extremecloud.com,093529,ES94209525837524276640,1768.53,2024-03-04T10:09:44,Donostia,expenses,mortgage,-3055.94,-11961.33
buyer_5,Sara,Gurrutxaga,1994-03-12,40616649Y,sara.gurrutxaga@extremecloud.com,093529,ES94209525837524276640,1768.53,2024-03-04T19:29:42,Donostia,expenses,food,-86.87,-12048.2
buyer_5,Sara,Gurrutxaga,1994-03-12,40616649Y,sara.gurrutxaga@extremecloud.com,093529,ES94209525837524276640,1768.53,2024-03-04T13:49:07,Donostia,expenses,transport,-50.48,-12098.68
buyer_5,Sara,Gurrutxaga,1994-03-12,40616649Y,sara.gurrutxaga@extremecloud.com,093529,ES94209525837524276640,1768.53,2024-03-04T02:49:36,Donostia,expenses,education,-62.53,-12161.21
buyer_5,Sara,Gurrutxaga,1994-03-12,40616649Y,sara.gurrutxaga@extremecloud.com,093529,ES94209525837524276640,1768.53,2024-03-04T19:22:15,Donostia,expenses,appliances,-234.71,-12395.92
buyer_5,Sara,Gurrutxaga,1994-03-12,40616649Y,sara.gurrutxaga@extremecloud.com,093529,ES94209525837524276640,1768.53,2024-03-05T13:04:32,Donostia,expenses,internet,-122.47,-12518.39
buyer_5,Sara,Gurrutxaga,1994-03-12,40616649Y,sara.gurrutxaga@extremecloud.com,093529,ES94209525837524276640,1768.53,2024-03-06T17:24:49,Donostia,expenses,water,-96.37,-12614.76
buyer_5,Sara,Gurrutxaga,1994-03-12,40616649Y,sara.gurrutxaga@extremecloud.com,093529,ES94209525837524276640,1768.53,2024-03-06T13:41:12,Donostia,expenses,leisure,-45.31,-12660.07
buyer_5,Sara,Gurrutxaga,1994-03-12,40616649Y,sara.gurrutxaga@extremecloud.com,093529,ES94209525837524276640,1768.53,2024-03-06T04:34:53,Donostia,expenses,cash,-100.0,-12760.07
buyer_5,Sara,Gurrutxaga,1994-03-12,40616649Y,sara.gurrutxaga@extremecloud.com,093529,ES94209525837524276640,1768.53,2024-03-06T16:32:36,Donostia,expenses,repairs,-142.43,-12902.5
buyer_5,Sara,Gurrutxaga,1994-03-12,40616649Y,sara.gurrutxaga@extremecloud.com,093529,ES94209525837524276640,1768.53,2024-03-08T10:33:06,Donostia,expenses,water,-94.19,-12996.69
buyer_5,Sara,Gurrutxaga,1994-03-12,40616649Y,sara.gurrutxaga@extremecloud.com,093529,ES94209525837524276640,1768.53,2024-03-08T13:17:06,Donostia,expenses,internet,-122.47,-13119.16
buyer_5,Sara,Gurrutxaga,1994-03-12,40616649Y,sara.gurrutxaga@extremecloud.com,093529,ES94209525837524276640,1768.53,2024-03-10T20:39:04,Donostia,expenses,food,-119.37,-13238.53
buyer_5,Sara,Gurrutxaga,1994-03-12,40616649Y,sara.gurrutxaga@extremecloud.com,093529,ES94209525837524276640,1768.53,2024-03-10T19:19:40,Donostia,expenses,leisure,-27.14,-13265.67
buyer_5,Sara,Gurrutxaga,1994-03-12,40616649Y,sara.gurrutxaga@extremecloud.com,093529,ES94209525837524276640,1768.53,2024-03-13T18:11:43,Donostia,expenses,food,-93.77,-13359.44
buyer_5,Sara,Gurrutxaga,1994-03-12,40616649Y,sara.gurrutxaga@extremecloud.com,093529,ES94209525837524276640,1768.53,2024-03-13T14:50:42,Donostia,expenses,cash,-100.0,-13459.44
buyer_5,Sara,Gurrutxaga,1994-03-12,40616649Y,sara.gurrutxaga@extremecloud.com,093529,ES94209525837524276640,1768.53,2024-03-13T13:06:29,Donostia,expenses,travel,-280.88,-13740.32
buyer_5,Sara,Gurrutxaga,1994-03-12,40616649Y,sara.gurrutxaga@extremecloud.com,093529,ES94209525837524276640,1768.53,2024-03-15T08:54:19,Donostia,expenses,food,-96.1,-13836.42
buyer_5,Sara,Gurrutxaga,1994-03-12,40616649Y,sara.gurrutxaga@extremecloud.com,093529,ES94209525837524276640,1768.53,2024-03-15T19:17:45,Donostia,expenses,transport,-63.83,-13900.25
buyer_5,Sara,Gurrutxaga,1994-03-12,40616649Y,sara.gurrutxaga@extremecloud.com,093529,ES94209525837524276640,1768.53,2024-03-15T16:41:21,Donostia,expenses,cash,-100.0,-14000.25
buyer_5,Sara,Gurrutxaga,1994-03-12,40616649Y,sara.gurrutxaga@extremecloud.com,093529,ES94209525837524276640,1768.53,2024-03-16T16:25:13,Donostia,expenses,cash,-100.0,-14100.25
buyer_5,Sara,Gurrutxaga,1994-03-12,40616649Y,sara.gurrutxaga@extremecloud.com,093529,ES94209525837524276640,1768.53,2024-03-18T11:28:28,Donostia,expenses,gifts,-608.9,-14709.15
buyer_5,Sara,Gurrutxaga,1994-03-12,40616649Y,sara.gurrutxaga@extremecloud.com,093529,ES94209525837524276640,1768.53,2024-03-19T10:32:17,Donostia,expenses,leisure,-24.97,-14734.12
buyer_5,Sara,Gurrutxaga,1994-03-12,40616649Y,sara.gurrutxaga@extremecloud.com,093529,ES94209525837524276640,1768.53,2024-03-19T06:14:57,Donostia,expenses,cash,-100.0,-14834.12
buyer_5,Sara,Gurrutxaga,1994-03-12,40616649Y,sara.gurrutxaga@extremecloud.com,093529,ES94209525837524276640,1768.53,2024-03-20T17:14:25,Donostia,expenses,cash,-100.0,-14934.12
buyer_5,Sara,Gurrutxaga,1994-03-12,40616649Y,sara.gurrutxaga@extremecloud.com,093529,ES94209525837524276640,1768.53,2024-03-22T16:23:15,Donostia,expenses,transport,-58.23,-14992.35
buyer_5,Sara,Gurrutxaga,1994-03-12,40616649Y,sara.gurrutxaga@extremecloud.com,093529,ES94209525837524276640,1768.53,2024-03-24T11:10:23,Donostia,expenses,gifts,-358.02,-15350.37
buyer_5,Sara,Gurrutxaga,1994-03-12,40616649Y,sara.gurrutxaga@extremecloud.com,093529,ES94209525837524276640,1768.53,2024-03-25T22:21:06,Donostia,expenses,food,-104.38,-15454.75
buyer_5,Sara,Gurrutxaga,1994-03-12,40616649Y,sara.gurrutxaga@extremecloud.com,093529,ES94209525837524276640,1768.53,2024-03-28T18:30:25,Donostia,expenses,food,-64.01,-15518.76
buyer_5,Sara,Gurrutxaga,1994-03-12,40616649Y,sara.gurrutxaga@extremecloud.com,093529,ES94209525837524276640,1768.53,2024-03-28T16:02:30,Donostia,expenses,cash,-100.0,-15618.76
buyer_5,Sara,Gurrutxaga,1994-03-12,40616649Y,sara.gurrutxaga@extremecloud.com,093529,ES94209525837524276640,1768.53,2024-03-29T20:41:38,Donostia,expenses,leisure,-20.07,-15638.83
buyer_5,Sara,Gurrutxaga,1994-03-12,40616649Y,sara.gurrutxaga@extremecloud.com,093529,ES94209525837524276640,1768.53,2024-03-30T20:03:37,Donostia,expenses,cash,-100.0,-15738.83
buyer_5,Sara,Gurrutxaga,1994-03-12,40616649Y,sara.gurrutxaga@extremecloud.com,093529,ES94209525837524276640,1768.53,2024-03-31T10:44:20,Donostia,expenses,food,-75.85,-15814.68
buyer_5,Sara,Gurrutxaga,1994-03-12,40616649Y,sara.gurrutxaga@extremecloud.com,093529,ES94209525837524276640,1768.53,2024-03-31T01:41:53,Donostia,expenses,cash,-100.0,-15914.68
buyer_5,Sara,Gurrutxaga,1994-03-12,40616649Y,sara.gurrutxaga@extremecloud.com,093529,ES94209525837524276640,1768.53,2024-04-01T14:30:52,Donostia,incomes,salary,2682.24,-13232.44
buyer_5,Sara,Gurrutxaga,1994-03-12,40616649Y,sara.gurrutxaga@extremecloud.com,093529,ES94209525837524276640,1768.53,2024-04-01T14:30:52,Donostia,incomes,salary_partner,3149.51,-10082.93
buyer_5,Sara,Gurrutxaga,1994-03-12,40616649Y,sara.gurrutxaga@extremecloud.com,093529,ES94209525837524276640,1768.53,2024-04-01T07:16:02,Donostia,expenses,food,-91.35,-10174.28
buyer_5,Sara,Gurrutxaga,1994-03-12,40616649Y,sara.gurrutxaga@extremecloud.com,093529,ES94209525837524276640,1768.53,2024-04-04T08:47:37,Donostia,expenses,mortgage,-3055.94,-13230.22
buyer_5,Sara,Gurrutxaga,1994-03-12,40616649Y,sara.gurrutxaga@extremecloud.com,093529,ES94209525837524276640,1768.53,2024-04-05T11:37:24,Donostia,expenses,electricity,-111.84,-13342.06
buyer_5,Sara,Gurrutxaga,1994-03-12,40616649Y,sara.gurrutxaga@extremecloud.com,093529,ES94209525837524276640,1768.53,2024-04-06T17:56:39,Donostia,expenses,food,-61.53,-13403.59
buyer_5,Sara,Gurrutxaga,1994-03-12,40616649Y,sara.gurrutxaga@extremecloud.com,093529,ES94209525837524276640,1768.53,2024-04-06T10:29:06,Donostia,expenses,cash,-100.0,-13503.59
buyer_5,Sara,Gurrutxaga,1994-03-12,40616649Y,sara.gurrutxaga@extremecloud.com,093529,ES94209525837524276640,1768.53,2024-04-08T04:19:14,Donostia,expenses,water,-118.6,-13622.19
buyer_5,Sara,Gurrutxaga,1994-03-12,40616649Y,sara.gurrutxaga@extremecloud.com,093529,ES94209525837524276640,1768.53,2024-04-10T17:48:14,Donostia,expenses,transport,-72.95,-13695.14
buyer_5,Sara,Gurrutxaga,1994-03-12,40616649Y,sara.gurrutxaga@extremecloud.com,093529,ES94209525837524276640,1768.53,2024-04-12T20:27:26,Donostia,expenses,transport,-50.81,-13745.95
buyer_5,Sara,Gurrutxaga,1994-03-12,40616649Y,sara.gurrutxaga@extremecloud.com,093529,ES94209525837524276640,1768.53,2024-04-12T06:17:26,Donostia,expenses,cash,-100.0,-13845.95
buyer_5,Sara,Gurrutxaga,1994-03-12,40616649Y,sara.gurrutxaga@extremecloud.com,093529,ES94209525837524276640,1768.53,2024-04-13T21:29:05,Donostia,expenses,clothing,-145.76,-13991.71
buyer_5,Sara,Gurrutxaga,1994-03-12,40616649Y,sara.gurrutxaga@extremecloud.com,093529,ES94209525837524276640,1768.53,2024-04-13T13:11:04,Donostia,expenses,cash,-100.0,-14091.71
buyer_5,Sara,Gurrutxaga,1994-03-12,40616649Y,sara.gurrutxaga@extremecloud.com,093529,ES94209525837524276640,1768.53,2024-04-16T12:46:28,Donostia,expenses,clothing,-107.03,-14198.74
buyer_5,Sara,Gurrutxaga,1994-03-12,40616649Y,sara.gurrutxaga@extremecloud.com,093529,ES94209525837524276640,1768.53,2024-04-16T23:57:13,Donostia,expenses,appliances,-362.16,-14560.9
buyer_5,Sara,Gurrutxaga,1994-03-12,40616649Y,sara.gurrutxaga@extremecloud.com,093529,ES94209525837524276640,1768.53,2024-04-17T00:28:33,Donostia,expenses,clothing,-106.81,-14667.71
buyer_5,Sara,Gurrutxaga,1994-03-12,40616649Y,sara.gurrutxaga@extremecloud.com,093529,ES94209525837524276640,1768.53,2024-04-17T10:56:09,Donostia,expenses,repairs,-233.22,-14900.93
buyer_5,Sara,Gurrutxaga,1994-03-12,40616649Y,sara.gurrutxaga@extremecloud.com,093529,ES94209525837524276640,1768.53,2024-04-19T16:23:56,Donostia,expenses,food,-88.27,-14989.2
buyer_5,Sara,Gurrutxaga,1994-03-12,40616649Y,sara.gurrutxaga@extremecloud.com,093529,ES94209525837524276640,1768.53,2024-04-19T21:59:47,Donostia,expenses,education,-69.48,-15058.68
buyer_5,Sara,Gurrutxaga,1994-03-12,40616649Y,sara.gurrutxaga@extremecloud.com,093529,ES94209525837524276640,1768.53,2024-04-20T11:42:19,Donostia,expenses,transport,-59.6,-15118.28
buyer_5,Sara,Gurrutxaga,1994-03-12,40616649Y,sara.gurrutxaga@extremecloud.com,093529,ES94209525837524276640,1768.53,2024-04-20T19:28:20,Donostia,expenses,cash,-100.0,-15218.28
buyer_5,Sara,Gurrutxaga,1994-03-12,40616649Y,sara.gurrutxaga@extremecloud.com,093529,ES94209525837524276640,1768.53,2024-04-21T16:54:10,Donostia,expenses,food,-70.77,-15289.05
buyer_5,Sara,Gurrutxaga,1994-03-12,40616649Y,sara.gurrutxaga@extremecloud.com,093529,ES94209525837524276640,1768.53,2024-04-22T09:32:37,Donostia,expenses,healthcare,-100.08,-15389.13
buyer_5,Sara,Gurrutxaga,1994-03-12,40616649Y,sara.gurrutxaga@extremecloud.com,093529,ES94209525837524276640,1768.53,2024-04-23T08:20:23,Donostia,expenses,cash,-100.0,-15489.13
buyer_5,Sara,Gurrutxaga,1994-03-12,40616649Y,sara.gurrutxaga@extremecloud.com,093529,ES94209525837524276640,1768.53,2024-04-24T03:20:02,Donostia,expenses,transport,-89.81,-15578.94
buyer_5,Sara,Gurrutxaga,1994-03-12,40616649Y,sara.gurrutxaga@extremecloud.com,093529,ES94209525837524276640,1768.53,2024-04-24T09:21:34,Donostia,expenses,education,-78.37,-15657.31
buyer_5,Sara,Gurrutxaga,1994-03-12,40616649Y,sara.gurrutxaga@extremecloud.com,093529,ES94209525837524276640,1768.53,2024-04-24T09:55:33,Donostia,expenses,cash,-100.0,-15757.31
buyer_5,Sara,Gurrutxaga,1994-03-12,40616649Y,sara.gurrutxaga@extremecloud.com,093529,ES94209525837524276640,1768.53,2024-04-25T15:54:39,Donostia,expenses,education,-64.29,-15821.6
buyer_5,Sara,Gurrutxaga,1994-03-12,40616649Y,sara.gurrutxaga@extremecloud.com,093529,ES94209525837524276640,1768.53,2024-04-26T17:24:21,Donostia,expenses,healthcare,-126.81,-15948.41
buyer_5,Sara,Gurrutxaga,1994-03-12,40616649Y,sara.gurrutxaga@extremecloud.com,093529,ES94209525837524276640,1768.53,2024-05-01T14:00:10,Donostia,incomes,salary,2682.24,-13266.17
buyer_5,Sara,Gurrutxaga,1994-03-12,40616649Y,sara.gurrutxaga@extremecloud.com,093529,ES94209525837524276640,1768.53,2024-05-01T14:00:10,Donostia,incomes,salary_partner,3149.51,-10116.66
buyer_5,Sara,Gurrutxaga,1994-03-12,40616649Y,sara.gurrutxaga@extremecloud.com,093529,ES94209525837524276640,1768.53,2024-05-02T18:06:54,Donostia,expenses,healthcare,-133.51,-10250.17
buyer_5,Sara,Gurrutxaga,1994-03-12,40616649Y,sara.gurrutxaga@extremecloud.com,093529,ES94209525837524276640,1768.53,2024-05-03T10:12:49,Donostia,expenses,leisure,-57.92,-10308.09
buyer_5,Sara,Gurrutxaga,1994-03-12,40616649Y,sara.gurrutxaga@extremecloud.com,093529,ES94209525837524276640,1768.53,2024-05-04T12:02:52,Donostia,expenses,mortgage,-3055.94,-13364.03
buyer_5,Sara,Gurrutxaga,1994-03-12,40616649Y,sara.gurrutxaga@extremecloud.com,093529,ES94209525837524276640,1768.53,2024-05-04T23:46:19,Donostia,expenses,leisure,-66.79,-13430.82
buyer_5,Sara,Gurrutxaga,1994-03-12,40616649Y,sara.gurrutxaga@extremecloud.com,093529,ES94209525837524276640,1768.53,2024-05-04T14:30:51,Donostia,expenses,repairs,-256.56,-13687.38
buyer_5,Sara,Gurrutxaga,1994-03-12,40616649Y,sara.gurrutxaga@extremecloud.com,093529,ES94209525837524276640,1768.53,2024-05-05T09:44:30,Donostia,expenses,water,-73.93,-13761.31
buyer_5,Sara,Gurrutxaga,1994-03-12,40616649Y,sara.gurrutxaga@extremecloud.com,093529,ES94209525837524276640,1768.53,2024-05-05T08:20:43,Donostia,expenses,food,-77.87,-13839.18
buyer_5,Sara,Gurrutxaga,1994-03-12,40616649Y,sara.gurrutxaga@extremecloud.com,093529,ES94209525837524276640,1768.53,2024-05-06T12:57:54,Donostia,expenses,water,-119.58,-13958.76
buyer_5,Sara,Gurrutxaga,1994-03-12,40616649Y,sara.gurrutxaga@extremecloud.com,093529,ES94209525837524276640,1768.53,2024-05-06T13:06:27,Donostia,expenses,gas,-212.53,-14171.29
buyer_5,Sara,Gurrutxaga,1994-03-12,40616649Y,sara.gurrutxaga@extremecloud.com,093529,ES94209525837524276640,1768.53,2024-05-06T17:34:40,Donostia,expenses,internet,-122.47,-14293.76
buyer_5,Sara,Gurrutxaga,1994-03-12,40616649Y,sara.gurrutxaga@extremecloud.com,093529,ES94209525837524276640,1768.53,2024-05-06T20:36:34,Donostia,expenses,transport,-54.66,-14348.42
buyer_5,Sara,Gurrutxaga,1994-03-12,40616649Y,sara.gurrutxaga@extremecloud.com,093529,ES94209525837524276640,1768.53,2024-05-06T20:19:10,Donostia,expenses,repairs,-136.98,-14485.4
buyer_5,Sara,Gurrutxaga,1994-03-12,40616649Y,sara.gurrutxaga@extremecloud.com,093529,ES94209525837524276640,1768.53,2024-05-07T10:07:16,Donostia,expenses,electricity,-157.25,-14642.65
buyer_5,Sara,Gurrutxaga,1994-03-12,40616649Y,sara.gurrutxaga@extremecloud.com,093529,ES94209525837524276640,1768.53,2024-05-07T15:21:39,Donostia,expenses,cash,-100.0,-14742.65
buyer_5,Sara,Gurrutxaga,1994-03-12,40616649Y,sara.gurrutxaga@extremecloud.com,093529,ES94209525837524276640,1768.53,2024-05-08T23:34:24,Donostia,expenses,gas,-204.34,-14946.99
buyer_5,Sara,Gurrutxaga,1994-03-12,40616649Y,sara.gurrutxaga@extremecloud.com,093529,ES94209525837524276640,1768.53,2024-05-08T21:34:46,Donostia,expenses,internet,-122.47,-15069.46
buyer_5,Sara,Gurrutxaga,1994-03-12,40616649Y,sara.gurrutxaga@extremecloud.com,093529,ES94209525837524276640,1768.53,2024-05-10T17:23:14,Donostia,expenses,transport,-68.94,-15138.4
buyer_5,Sara,Gurrutxaga,1994-03-12,40616649Y,sara.gurrutxaga@extremecloud.com,093529,ES94209525837524276640,1768.53,2024-05-13T19:15:52,Donostia,expenses,food,-86.3,-15224.7
buyer_5,Sara,Gurrutxaga,1994-03-12,40616649Y,sara.gurrutxaga@extremecloud.com,093529,ES94209525837524276640,1768.53,2024-05-14T18:02:18,Donostia,expenses,transport,-73.4,-15298.1
buyer_5,Sara,Gurrutxaga,1994-03-12,40616649Y,sara.gurrutxaga@extremecloud.com,093529,ES94209525837524276640,1768.53,2024-05-15T22:00:20,Donostia,expenses,transport,-74.11,-15372.21
buyer_5,Sara,Gurrutxaga,1994-03-12,40616649Y,sara.gurrutxaga@extremecloud.com,093529,ES94209525837524276640,1768.53,2024-05-15T10:49:41,Donostia,expenses,cash,-100.0,-15472.21
buyer_5,Sara,Gurrutxaga,1994-03-12,40616649Y,sara.gurrutxaga@extremecloud.com,093529,ES94209525837524276640,1768.53,2024-05-15T10:49:05,Donostia,expenses,gifts,-456.07,-15928.28
buyer_5,Sara,Gurrutxaga,1994-03-12,40616649Y,sara.gurrutxaga@extremecloud.com,093529,ES94209525837524276640,1768.53,2024-05-17T13:47:07,Donostia,expenses,cash,-100.0,-16028.28
buyer_5,Sara,Gurrutxaga,1994-03-12,40616649Y,sara.gurrutxaga@extremecloud.com,093529,ES94209525837524276640,1768.53,2024-05-23T14:13:44,Donostia,expenses,leisure,-62.43,-16090.71
buyer_5,Sara,Gurrutxaga,1994-03-12,40616649Y,sara.gurrutxaga@extremecloud.com,093529,ES94209525837524276640,1768.53,2024-05-26T08:41:18,Donostia,expenses,appliances,-293.73,-16384.44
buyer_5,Sara,Gurrutxaga,1994-03-12,40616649Y,sara.gurrutxaga@extremecloud.com,093529,ES94209525837524276640,1768.53,2024-05-28T12:20:12,Donostia,expenses,transport,-43.04,-16427.48
buyer_5,Sara,Gurrutxaga,1994-03-12,40616649Y,sara.gurrutxaga@extremecloud.com,093529,ES94209525837524276640,1768.53,2024-05-28T23:41:14,Donostia,expenses,clothing,-149.81,-16577.29
buyer_5,Sara,Gurrutxaga,1994-03-12,40616649Y,sara.gurrutxaga@extremecloud.com,093529,ES94209525837524276640,1768.53,2024-05-30T14:26:03,Donostia,expenses,food,-94.02,-16671.31
buyer_5,Sara,Gurrutxaga,1994-03-12,40616649Y,sara.gurrutxaga@extremecloud.com,093529,ES94209525837524276640,1768.53,2024-05-31T14:55:41,Donostia,expenses,cash,-100.0,-16771.31
buyer_5,Sara,Gurrutxaga,1994-03-12,40616649Y,sara.gurrutxaga@extremecloud.com,093529,ES94209525837524276640,1768.53,2024-06-01T19:25:47,Donostia,incomes,salary,2682.24,-14089.07
buyer_5,Sara,Gurrutxaga,1994-03-12,40616649Y,sara.gurrutxaga@extremecloud.com,093529,ES94209525837524276640,1768.53,2024-06-01T19:25:47,Donostia,incomes,salary_partner,3149.51,-10939.56
buyer_5,Sara,Gurrutxaga,1994-03-12,40616649Y,sara.gurrutxaga@extremecloud.com,093529,ES94209525837524276640,1768.53,2024-06-01T19:25:47,Donostia,incomes,extra_income,354.73,-10584.83
buyer_5,Sara,Gurrutxaga,1994-03-12,40616649Y,sara.gurrutxaga@extremecloud.com,093529,ES94209525837524276640,1768.53,2024-06-01T19:25:47,Donostia,incomes,salary_bonus,2124.8,-8460.03
buyer_5,Sara,Gurrutxaga,1994-03-12,40616649Y,sara.gurrutxaga@extremecloud.com,093529,ES94209525837524276640,1768.53,2024-06-01T19:25:47,Donostia,incomes,salary_partner_bonus,2456.67,-6003.36
buyer_5,Sara,Gurrutxaga,1994-03-12,40616649Y,sara.gurrutxaga@extremecloud.com,093529,ES94209525837524276640,1768.53,2024-06-01T19:58:05,Donostia,expenses,clothing,-55.01,-6058.37
buyer_5,Sara,Gurrutxaga,1994-03-12,40616649Y,sara.gurrutxaga@extremecloud.com,093529,ES94209525837524276640,1768.53,2024-06-02T23:51:16,Donostia,expenses,repairs,-180.67,-6239.04
buyer_5,Sara,Gurrutxaga,1994-03-12,40616649Y,sara.gurrutxaga@extremecloud.com,093529,ES94209525837524276640,1768.53,2024-06-03T10:12:57,Donostia,expenses,taxes,-4673.85,-10912.89
buyer_5,Sara,Gurrutxaga,1994-03-12,40616649Y,sara.gurrutxaga@extremecloud.com,093529,ES94209525837524276640,1768.53,2024-06-03T13:28:40,Donostia,expenses,insurance,-1036.48,-11949.37
buyer_5,Sara,Gurrutxaga,1994-03-12,40616649Y,sara.gurrutxaga@extremecloud.com,093529,ES94209525837524276640,1768.53,2024-06-04T12:21:09,Donostia,expenses,mortgage,-3055.94,-15005.31
buyer_5,Sara,Gurrutxaga,1994-03-12,40616649Y,sara.gurrutxaga@extremecloud.com,093529,ES94209525837524276640,1768.53,2024-06-04T18:43:14,Donostia,expenses,food,-84.11,-15089.42
buyer_5,Sara,Gurrutxaga,1994-03-12,40616649Y,sara.gurrutxaga@extremecloud.com,093529,ES94209525837524276640,1768.53,2024-06-04T15:44:56,Donostia,expenses,cash,-100.0,-15189.42
buyer_5,Sara,Gurrutxaga,1994-03-12,40616649Y,sara.gurrutxaga@extremecloud.com,093529,ES94209525837524276640,1768.53,2024-06-05T10:17:04,Donostia,expenses,gas,-107.29,-15296.71
buyer_5,Sara,Gurrutxaga,1994-03-12,40616649Y,sara.gurrutxaga@extremecloud.com,093529,ES94209525837524276640,1768.53,2024-06-06T19:32:33,Donostia,expenses,transport,-64.12,-15360.83
buyer_5,Sara,Gurrutxaga,1994-03-12,40616649Y,sara.gurrutxaga@extremecloud.com,093529,ES94209525837524276640,1768.53,2024-06-07T13:34:13,Donostia,expenses,phone,-95.36,-15456.19
buyer_5,Sara,Gurrutxaga,1994-03-12,40616649Y,sara.gurrutxaga@extremecloud.com,093529,ES94209525837524276640,1768.53,2024-06-07T12:35:47,Donostia,expenses,cash,-100.0,-15556.19
buyer_5,Sara,Gurrutxaga,1994-03-12,40616649Y,sara.gurrutxaga@extremecloud.com,093529,ES94209525837524276640,1768.53,2024-06-08T08:19:23,Donostia,expenses,cash,-100.0,-15656.19
buyer_5,Sara,Gurrutxaga,1994-03-12,40616649Y,sara.gurrutxaga@extremecloud.com,093529,ES94209525837524276640,1768.53,2024-06-10T13:06:55,Donostia,expenses,repairs,-308.34,-15964.53
buyer_5,Sara,Gurrutxaga,1994-03-12,40616649Y,sara.gurrutxaga@extremecloud.com,093529,ES94209525837524276640,1768.53,2024-06-11T19:38:47,Donostia,expenses,transport,-70.75,-16035.28
buyer_5,Sara,Gurrutxaga,1994-03-12,40616649Y,sara.gurrutxaga@extremecloud.com,093529,ES94209525837524276640,1768.53,2024-06-11T19:25:45,Donostia,expenses,clothing,-98.74,-16134.02
buyer_5,Sara,Gurrutxaga,1994-03-12,40616649Y,sara.gurrutxaga@extremecloud.com,093529,ES94209525837524276640,1768.53,2024-06-11T17:34:33,Donostia,expenses,repairs,-101.53,-16235.55
buyer_5,Sara,Gurrutxaga,1994-03-12,40616649Y,sara.gurrutxaga@extremecloud.com,093529,ES94209525837524276640,1768.53,2024-06-15T16:14:09,Donostia,expenses,cash,-100.0,-16335.55
buyer_5,Sara,Gurrutxaga,1994-03-12,40616649Y,sara.gurrutxaga@extremecloud.com,093529,ES94209525837524276640,1768.53,2024-06-16T18:13:09,Donostia,expenses,cash,-100.0,-16435.55
buyer_5,Sara,Gurrutxaga,1994-03-12,40616649Y,sara.gurrutxaga@extremecloud.com,093529,ES94209525837524276640,1768.53,2024-06-19T20:18:43,Donostia,expenses,appliances,-125.21,-16560.76
buyer_5,Sara,Gurrutxaga,1994-03-12,40616649Y,sara.gurrutxaga@extremecloud.com,093529,ES94209525837524276640,1768.53,2024-06-20T06:31:26,Donostia,expenses,education,-70.13,-16630.89
buyer_5,Sara,Gurrutxaga,1994-03-12,40616649Y,sara.gurrutxaga@extremecloud.com,093529,ES94209525837524276640,1768.53,2024-06-21T13:12:22,Donostia,expenses,leisure,-22.54,-16653.43
buyer_5,Sara,Gurrutxaga,1994-03-12,40616649Y,sara.gurrutxaga@extremecloud.com,093529,ES94209525837524276640,1768.53,2024-06-21T23:17:22,Donostia,expenses,cash,-100.0,-16753.43
buyer_5,Sara,Gurrutxaga,1994-03-12,40616649Y,sara.gurrutxaga@extremecloud.com,093529,ES94209525837524276640,1768.53,2024-06-22T12:11:28,Donostia,expenses,clothing,-73.44,-16826.87
buyer_5,Sara,Gurrutxaga,1994-03-12,40616649Y,sara.gurrutxaga@extremecloud.com,093529,ES94209525837524276640,1768.53,2024-06-23T09:17:43,Donostia,expenses,cash,-100.0,-16926.87
buyer_5,Sara,Gurrutxaga,1994-03-12,40616649Y,sara.gurrutxaga@extremecloud.com,093529,ES94209525837524276640,1768.53,2024-06-24T09:48:12,Donostia,expenses,appliances,-343.71,-17270.58
buyer_5,Sara,Gurrutxaga,1994-03-12,40616649Y,sara.gurrutxaga@extremecloud.com,093529,ES94209525837524276640,1768.53,2024-06-25T12:57:08,Donostia,expenses,appliances,-82.52,-17353.1
buyer_5,Sara,Gurrutxaga,1994-03-12,40616649Y,sara.gurrutxaga@extremecloud.com,093529,ES94209525837524276640,1768.53,2024-06-27T19:34:27,Donostia,expenses,repairs,-277.21,-17630.31
buyer_5,Sara,Gurrutxaga,1994-03-12,40616649Y,sara.gurrutxaga@extremecloud.com,093529,ES94209525837524276640,1768.53,2024-06-29T22:52:04,Donostia,expenses,transport,-53.87,-17684.18
buyer_5,Sara,Gurrutxaga,1994-03-12,40616649Y,sara.gurrutxaga@extremecloud.com,093529,ES94209525837524276640,1768.53,2024-06-29T17:34:03,Donostia,expenses,cash,-100.0,-17784.18
buyer_5,Sara,Gurrutxaga,1994-03-12,40616649Y,sara.gurrutxaga@extremecloud.com,093529,ES94209525837524276640,1768.53,2024-07-01T12:36:55,Donostia,incomes,salary,2682.24,-15101.94
buyer_5,Sara,Gurrutxaga,1994-03-12,40616649Y,sara.gurrutxaga@extremecloud.com,093529,ES94209525837524276640,1768.53,2024-07-01T12:36:55,Donostia,incomes,salary_partner,3149.51,-11952.43
buyer_5,Sara,Gurrutxaga,1994-03-12,40616649Y,sara.gurrutxaga@extremecloud.com,093529,ES94209525837524276640,1768.53,2024-07-01T07:42:29,Donostia,expenses,transport,-53.86,-12006.29
buyer_5,Sara,Gurrutxaga,1994-03-12,40616649Y,sara.gurrutxaga@extremecloud.com,093529,ES94209525837524276640,1768.53,2024-07-01T15:48:04,Donostia,expenses,leisure,-19.76,-12026.05
buyer_5,Sara,Gurrutxaga,1994-03-12,40616649Y,sara.gurrutxaga@extremecloud.com,093529,ES94209525837524276640,1768.53,2024-07-01T22:43:11,Donostia,expenses,education,-50.51,-12076.56
buyer_5,Sara,Gurrutxaga,1994-03-12,40616649Y,sara.gurrutxaga@extremecloud.com,093529,ES94209525837524276640,1768.53,2024-07-02T14:11:28,Donostia,expenses,transport,-62.37,-12138.93
buyer_5,Sara,Gurrutxaga,1994-03-12,40616649Y,sara.gurrutxaga@extremecloud.com,093529,ES94209525837524276640,1768.53,2024-07-02T14:24:43,Donostia,expenses,cash,-100.0,-12238.93
buyer_5,Sara,Gurrutxaga,1994-03-12,40616649Y,sara.gurrutxaga@extremecloud.com,093529,ES94209525837524276640,1768.53,2024-07-03T15:22:34,Donostia,expenses,food,-63.51,-12302.44
buyer_5,Sara,Gurrutxaga,1994-03-12,40616649Y,sara.gurrutxaga@extremecloud.com,093529,ES94209525837524276640,1768.53,2024-07-04T15:14:40,Donostia,expenses,mortgage,-3055.94,-15358.38
buyer_5,Sara,Gurrutxaga,1994-03-12,40616649Y,sara.gurrutxaga@extremecloud.com,093529,ES94209525837524276640,1768.53,2024-07-06T08:55:59,Donostia,expenses,food,-71.58,-15429.96
buyer_5,Sara,Gurrutxaga,1994-03-12,40616649Y,sara.gurrutxaga@extremecloud.com,093529,ES94209525837524276640,1768.53,2024-07-07T22:10:37,Donostia,expenses,electricity,-137.88,-15567.84
buyer_5,Sara,Gurrutxaga,1994-03-12,40616649Y,sara.gurrutxaga@extremecloud.com,093529,ES94209525837524276640,1768.53,2024-07-09T14:32:27,Donostia,expenses,transport,-53.95,-15621.79
buyer_5,Sara,Gurrutxaga,1994-03-12,40616649Y,sara.gurrutxaga@extremecloud.com,093529,ES94209525837524276640,1768.53,2024-07-09T14:29:34,Donostia,expenses,cash,-100.0,-15721.79
buyer_5,Sara,Gurrutxaga,1994-03-12,40616649Y,sara.gurrutxaga@extremecloud.com,093529,ES94209525837524276640,1768.53,2024-07-10T16:27:19,Donostia,expenses,food,-66.8,-15788.59
buyer_5,Sara,Gurrutxaga,1994-03-12,40616649Y,sara.gurrutxaga@extremecloud.com,093529,ES94209525837524276640,1768.53,2024-07-10T18:03:10,Donostia,expenses,leisure,-24.44,-15813.03
buyer_5,Sara,Gurrutxaga,1994-03-12,40616649Y,sara.gurrutxaga@extremecloud.com,093529,ES94209525837524276640,1768.53,2024-07-10T13:20:53,Donostia,expenses,cash,-100.0,-15913.03
buyer_5,Sara,Gurrutxaga,1994-03-12,40616649Y,sara.gurrutxaga@extremecloud.com,093529,ES94209525837524276640,1768.53,2024-07-11T20:03:43,Donostia,expenses,food,-76.26,-15989.29
buyer_5,Sara,Gurrutxaga,1994-03-12,40616649Y,sara.gurrutxaga@extremecloud.com,093529,ES94209525837524276640,1768.53,2024-07-14T10:49:56,Donostia,expenses,cash,-100.0,-16089.29
buyer_5,Sara,Gurrutxaga,1994-03-12,40616649Y,sara.gurrutxaga@extremecloud.com,093529,ES94209525837524276640,1768.53,2024-07-15T10:34:42,Donostia,expenses,food,-121.62,-16210.91
buyer_5,Sara,Gurrutxaga,1994-03-12,40616649Y,sara.gurrutxaga@extremecloud.com,093529,ES94209525837524276640,1768.53,2024-07-15T06:07:36,Donostia,expenses,leisure,-31.87,-16242.78
buyer_5,Sara,Gurrutxaga,1994-03-12,40616649Y,sara.gurrutxaga@extremecloud.com,093529,ES94209525837524276640,1768.53,2024-07-15T12:38:23,Donostia,expenses,gifts,-30.62,-16273.4
buyer_5,Sara,Gurrutxaga,1994-03-12,40616649Y,sara.gurrutxaga@extremecloud.com,093529,ES94209525837524276640,1768.53,2024-07-21T08:14:13,Donostia,expenses,appliances,-84.52,-16357.92
buyer_5,Sara,Gurrutxaga,1994-03-12,40616649Y,sara.gurrutxaga@extremecloud.com,093529,ES94209525837524276640,1768.53,2024-07-21T11:48:40,Donostia,expenses,repairs,-319.31,-16677.23
buyer_5,Sara,Gurrutxaga,1994-03-12,40616649Y,sara.gurrutxaga@extremecloud.com,093529,ES94209525837524276640,1768.53,2024-07-22T14:53:36,Donostia,expenses,food,-62.1,-16739.33
buyer_5,Sara,Gurrutxaga,1994-03-12,40616649Y,sara.gurrutxaga@extremecloud.com,093529,ES94209525837524276640,1768.53,2024-07-23T09:34:30,Donostia,expenses,cash,-100.0,-16839.33
buyer_5,Sara,Gurrutxaga,1994-03-12,40616649Y,sara.gurrutxaga@extremecloud.com,093529,ES94209525837524276640,1768.53,2024-07-24T17:09:57,Donostia,expenses,transport,-59.13,-16898.46
buyer_5,Sara,Gurrutxaga,1994-03-12,40616649Y,sara.gurrutxaga@extremecloud.com,093529,ES94209525837524276640,1768.53,2024-07-25T06:18:19,Donostia,expenses,transport,-41.64,-16940.1
buyer_5,Sara,Gurrutxaga,1994-03-12,40616649Y,sara.gurrutxaga@extremecloud.com,093529,ES94209525837524276640,1768.53,2024-07-25T15:47:46,Donostia,expenses,cash,-100.0,-17040.1
buyer_5,Sara,Gurrutxaga,1994-03-12,40616649Y,sara.gurrutxaga@extremecloud.com,093529,ES94209525837524276640,1768.53,2024-07-26T18:16:57,Donostia,expenses,food,-84.74,-17124.84
buyer_5,Sara,Gurrutxaga,1994-03-12,40616649Y,sara.gurrutxaga@extremecloud.com,093529,ES94209525837524276640,1768.53,2024-07-26T05:34:24,Donostia,expenses,cash,-100.0,-17224.84
buyer_5,Sara,Gurrutxaga,1994-03-12,40616649Y,sara.gurrutxaga@extremecloud.com,093529,ES94209525837524276640,1768.53,2024-07-26T19:58:58,Donostia,expenses,repairs,-264.26,-17489.1
buyer_5,Sara,Gurrutxaga,1994-03-12,40616649Y,sara.gurrutxaga@extremecloud.com,093529,ES94209525837524276640,1768.53,2024-07-27T12:26:43,Donostia,expenses,leisure,-81.23,-17570.33
buyer_5,Sara,Gurrutxaga,1994-03-12,40616649Y,sara.gurrutxaga@extremecloud.com,093529,ES94209525837524276640,1768.53,2024-07-29T12:56:40,Donostia,expenses,food,-111.07,-17681.4
buyer_5,Sara,Gurrutxaga,1994-03-12,40616649Y,sara.gurrutxaga@extremecloud.com,093529,ES94209525837524276640,1768.53,2024-07-31T20:43:52,Donostia,expenses,repairs,-198.6,-17880.0
buyer_5,Sara,Gurrutxaga,1994-03-12,40616649Y,sara.gurrutxaga@extremecloud.com,093529,ES94209525837524276640,1768.53,2024-08-01T11:18:58,Donostia,incomes,salary,2682.24,-15197.76
buyer_5,Sara,Gurrutxaga,1994-03-12,40616649Y,sara.gurrutxaga@extremecloud.com,093529,ES94209525837524276640,1768.53,2024-08-01T11:18:58,Donostia,incomes,salary_partner,3149.51,-12048.25
buyer_5,Sara,Gurrutxaga,1994-03-12,40616649Y,sara.gurrutxaga@extremecloud.com,093529,ES94209525837524276640,1768.53,2024-08-02T08:29:06,Donostia,expenses,clothing,-151.42,-12199.67
buyer_5,Sara,Gurrutxaga,1994-03-12,40616649Y,sara.gurrutxaga@extremecloud.com,093529,ES94209525837524276640,1768.53,2024-08-03T21:58:47,Donostia,expenses,cash,-100.0,-12299.67
buyer_5,Sara,Gurrutxaga,1994-03-12,40616649Y,sara.gurrutxaga@extremecloud.com,093529,ES94209525837524276640,1768.53,2024-08-04T13:16:16,Donostia,expenses,mortgage,-3055.94,-15355.61
buyer_5,Sara,Gurrutxaga,1994-03-12,40616649Y,sara.gurrutxaga@extremecloud.com,093529,ES94209525837524276640,1768.53,2024-08-05T17:56:37,Donostia,expenses,water,-85.7,-15441.31
buyer_5,Sara,Gurrutxaga,1994-03-12,40616649Y,sara.gurrutxaga@extremecloud.com,093529,ES94209525837524276640,1768.53,2024-08-05T15:07:46,Donostia,expenses,phone,-102.7,-15544.01
buyer_5,Sara,Gurrutxaga,1994-03-12,40616649Y,sara.gurrutxaga@extremecloud.com,093529,ES94209525837524276640,1768.53,2024-08-05T10:58:45,Donostia,expenses,cash,-100.0,-15644.01
buyer_5,Sara,Gurrutxaga,1994-03-12,40616649Y,sara.gurrutxaga@extremecloud.com,093529,ES94209525837524276640,1768.53,2024-08-06T18:18:15,Donostia,expenses,internet,-122.47,-15766.48
buyer_5,Sara,Gurrutxaga,1994-03-12,40616649Y,sara.gurrutxaga@extremecloud.com,093529,ES94209525837524276640,1768.53,2024-08-07T19:41:27,Donostia,expenses,gas,-224.24,-15990.72
buyer_5,Sara,Gurrutxaga,1994-03-12,40616649Y,sara.gurrutxaga@extremecloud.com,093529,ES94209525837524276640,1768.53,2024-08-07T15:07:47,Donostia,expenses,phone,-106.91,-16097.63
buyer_5,Sara,Gurrutxaga,1994-03-12,40616649Y,sara.gurrutxaga@extremecloud.com,093529,ES94209525837524276640,1768.53,2024-08-07T12:08:29,Donostia,expenses,education,-62.99,-16160.62
buyer_5,Sara,Gurrutxaga,1994-03-12,40616649Y,sara.gurrutxaga@extremecloud.com,093529,ES94209525837524276640,1768.53,2024-08-08T16:08:28,Donostia,expenses,cash,-100.0,-16260.62
buyer_5,Sara,Gurrutxaga,1994-03-12,40616649Y,sara.gurrutxaga@extremecloud.com,093529,ES94209525837524276640,1768.53,2024-08-08T10:42:48,Donostia,expenses,repairs,-253.04,-16513.66
buyer_5,Sara,Gurrutxaga,1994-03-12,40616649Y,sara.gurrutxaga@extremecloud.com,093529,ES94209525837524276640,1768.53,2024-08-09T17:53:20,Donostia,expenses,cash,-100.0,-16613.66
buyer_5,Sara,Gurrutxaga,1994-03-12,40616649Y,sara.gurrutxaga@extremecloud.com,093529,ES94209525837524276640,1768.53,2024-08-10T15:18:19,Donostia,expenses,gifts,-209.35,-16823.01
buyer_5,Sara,Gurrutxaga,1994-03-12,40616649Y,sara.gurrutxaga@extremecloud.com,093529,ES94209525837524276640,1768.53,2024-08-13T09:53:32,Donostia,expenses,clothing,-76.6,-16899.61
buyer_5,Sara,Gurrutxaga,1994-03-12,40616649Y,sara.gurrutxaga@extremecloud.com,093529,ES94209525837524276640,1768.53,2024-08-14T22:32:05,Donostia,expenses,food,-111.42,-17011.03
buyer_5,Sara,Gurrutxaga,1994-03-12,40616649Y,sara.gurrutxaga@extremecloud.com,093529,ES94209525837524276640,1768.53,2024-08-15T14:25:43,Donostia,expenses,transport,-88.69,-17099.72
buyer_5,Sara,Gurrutxaga,1994-03-12,40616649Y,sara.gurrutxaga@extremecloud.com,093529,ES94209525837524276640,1768.53,2024-08-16T12:09:04,Donostia,expenses,food,-110.14,-17209.86
buyer_5,Sara,Gurrutxaga,1994-03-12,40616649Y,sara.gurrutxaga@extremecloud.com,093529,ES94209525837524276640,1768.53,2024-08-19T12:49:57,Donostia,expenses,clothing,-119.35,-17329.21
buyer_5,Sara,Gurrutxaga,1994-03-12,40616649Y,sara.gurrutxaga@extremecloud.com,093529,ES94209525837524276640,1768.53,2024-08-20T11:33:17,Donostia,expenses,gifts,-113.78,-17442.99
buyer_5,Sara,Gurrutxaga,1994-03-12,40616649Y,sara.gurrutxaga@extremecloud.com,093529,ES94209525837524276640,1768.53,2024-08-22T10:40:44,Donostia,expenses,food,-100.72,-17543.71
buyer_5,Sara,Gurrutxaga,1994-03-12,40616649Y,sara.gurrutxaga@extremecloud.com,093529,ES94209525837524276640,1768.53,2024-08-23T18:09:06,Donostia,expenses,cash,-100.0,-17643.71
buyer_5,Sara,Gurrutxaga,1994-03-12,40616649Y,sara.gurrutxaga@extremecloud.com,093529,ES94209525837524276640,1768.53,2024-08-25T21:44:46,Donostia,expenses,leisure,-31.99,-17675.7
buyer_5,Sara,Gurrutxaga,1994-03-12,40616649Y,sara.gurrutxaga@extremecloud.com,093529,ES94209525837524276640,1768.53,2024-08-26T23:09:50,Donostia,expenses,repairs,-53.32,-17729.02
buyer_5,Sara,Gurrutxaga,1994-03-12,40616649Y,sara.gurrutxaga@extremecloud.com,093529,ES94209525837524276640,1768.53,2024-08-27T17:10:44,Donostia,expenses,food,-106.15,-17835.17
buyer_5,Sara,Gurrutxaga,1994-03-12,40616649Y,sara.gurrutxaga@extremecloud.com,093529,ES94209525837524276640,1768.53,2024-08-27T19:11:39,Donostia,expenses,repairs,-122.97,-17958.14
buyer_5,Sara,Gurrutxaga,1994-03-12,40616649Y,sara.gurrutxaga@extremecloud.com,093529,ES94209525837524276640,1768.53,2024-08-28T14:21:58,Donostia,expenses,leisure,-72.82,-18030.96
buyer_5,Sara,Gurrutxaga,1994-03-12,40616649Y,sara.gurrutxaga@extremecloud.com,093529,ES94209525837524276640,1768.53,2024-08-29T23:38:38,Donostia,expenses,transport,-86.27,-18117.23
buyer_5,Sara,Gurrutxaga,1994-03-12,40616649Y,sara.gurrutxaga@extremecloud.com,093529,ES94209525837524276640,1768.53,2024-08-29T16:29:55,Donostia,expenses,leisure,-71.56,-18188.79
buyer_5,Sara,Gurrutxaga,1994-03-12,40616649Y,sara.gurrutxaga@extremecloud.com,093529,ES94209525837524276640,1768.53,2024-08-30T16:51:46,Donostia,expenses,cash,-100.0,-18288.79
buyer_5,Sara,Gurrutxaga,1994-03-12,40616649Y,sara.gurrutxaga@extremecloud.com,093529,ES94209525837524276640,1768.53,2024-08-31T08:37:00,Donostia,expenses,gifts,-592.82,-18881.61
buyer_5,Sara,Gurrutxaga,1994-03-12,40616649Y,sara.gurrutxaga@extremecloud.com,093529,ES94209525837524276640,1768.53,2024-09-01T10:06:43,Donostia,incomes,salary,2682.24,-16199.37
buyer_5,Sara,Gurrutxaga,1994-03-12,40616649Y,sara.gurrutxaga@extremecloud.com,093529,ES94209525837524276640,1768.53,2024-09-01T10:06:43,Donostia,incomes,salary_partner,3149.51,-13049.86
buyer_5,Sara,Gurrutxaga,1994-03-12,40616649Y,sara.gurrutxaga@extremecloud.com,093529,ES94209525837524276640,1768.53,2024-09-01T22:21:55,Donostia,expenses,cash,-100.0,-13149.86
buyer_5,Sara,Gurrutxaga,1994-03-12,40616649Y,sara.gurrutxaga@extremecloud.com,093529,ES94209525837524276640,1768.53,2024-09-02T22:37:06,Donostia,expenses,food,-102.88,-13252.74
buyer_5,Sara,Gurrutxaga,1994-03-12,40616649Y,sara.gurrutxaga@extremecloud.com,093529,ES94209525837524276640,1768.53,2024-09-02T19:55:10,Donostia,expenses,leisure,-83.12,-13335.86
buyer_5,Sara,Gurrutxaga,1994-03-12,40616649Y,sara.gurrutxaga@extremecloud.com,093529,ES94209525837524276640,1768.53,2024-09-02T17:43:06,Donostia,expenses,repairs,-254.1,-13589.96
buyer_5,Sara,Gurrutxaga,1994-03-12,40616649Y,sara.gurrutxaga@extremecloud.com,093529,ES94209525837524276640,1768.53,2024-09-04T12:45:04,Donostia,expenses,mortgage,-3055.94,-16645.9
buyer_5,Sara,Gurrutxaga,1994-03-12,40616649Y,sara.gurrutxaga@extremecloud.com,093529,ES94209525837524276640,1768.53,2024-09-04T17:22:36,Donostia,expenses,transport,-78.69,-16724.59
buyer_5,Sara,Gurrutxaga,1994-03-12,40616649Y,sara.gurrutxaga@extremecloud.com,093529,ES94209525837524276640,1768.53,2024-09-04T13:49:55,Donostia,expenses,leisure,-75.97,-16800.56
buyer_5,Sara,Gurrutxaga,1994-03-12,40616649Y,sara.gurrutxaga@extremecloud.com,093529,ES94209525837524276640,1768.53,2024-09-05T10:47:37,Donostia,expenses,internet,-122.47,-16923.03
buyer_5,Sara,Gurrutxaga,1994-03-12,40616649Y,sara.gurrutxaga@extremecloud.com,093529,ES94209525837524276640,1768.53,2024-09-05T19:30:04,Donostia,expenses,transport,-57.01,-16980.04
buyer_5,Sara,Gurrutxaga,1994-03-12,40616649Y,sara.gurrutxaga@extremecloud.com,093529,ES94209525837524276640,1768.53,2024-09-06T14:12:58,Donostia,expenses,phone,-129.84,-17109.88
buyer_5,Sara,Gurrutxaga,1994-03-12,40616649Y,sara.gurrutxaga@extremecloud.com,093529,ES94209525837524276640,1768.53,2024-09-06T16:57:40,Donostia,expenses,cash,-100.0,-17209.88
buyer_5,Sara,Gurrutxaga,1994-03-12,40616649Y,sara.gurrutxaga@extremecloud.com,093529,ES94209525837524276640,1768.53,2024-09-06T20:46:30,Donostia,expenses,appliances,-133.65,-17343.53
buyer_5,Sara,Gurrutxaga,1994-03-12,40616649Y,sara.gurrutxaga@extremecloud.com,093529,ES94209525837524276640,1768.53,2024-09-07T09:21:20,Donostia,expenses,gas,-286.99,-17630.52
buyer_5,Sara,Gurrutxaga,1994-03-12,40616649Y,sara.gurrutxaga@extremecloud.com,093529,ES94209525837524276640,1768.53,2024-09-07T17:31:33,Donostia,expenses,leisure,-65.86,-17696.38
buyer_5,Sara,Gurrutxaga,1994-03-12,40616649Y,sara.gurrutxaga@extremecloud.com,093529,ES94209525837524276640,1768.53,2024-09-08T17:01:08,Donostia,expenses,electricity,-205.05,-17901.43
buyer_5,Sara,Gurrutxaga,1994-03-12,40616649Y,sara.gurrutxaga@extremecloud.com,093529,ES94209525837524276640,1768.53,2024-09-09T12:23:05,Donostia,expenses,food,-100.35,-18001.78
buyer_5,Sara,Gurrutxaga,1994-03-12,40616649Y,sara.gurrutxaga@extremecloud.com,093529,ES94209525837524276640,1768.53,2024-09-10T12:09:37,Donostia,expenses,transport,-75.19,-18076.97
buyer_5,Sara,Gurrutxaga,1994-03-12,40616649Y,sara.gurrutxaga@extremecloud.com,093529,ES94209525837524276640,1768.53,2024-09-10T08:04:45,Donostia,expenses,leisure,-44.0,-18120.97
buyer_5,Sara,Gurrutxaga,1994-03-12,40616649Y,sara.gurrutxaga@extremecloud.com,093529,ES94209525837524276640,1768.53,2024-09-11T09:27:00,Donostia,expenses,cash,-100.0,-18220.97
buyer_5,Sara,Gurrutxaga,1994-03-12,40616649Y,sara.gurrutxaga@extremecloud.com,093529,ES94209525837524276640,1768.53,2024-09-12T09:14:57,Donostia,expenses,gifts,-513.23,-18734.2
buyer_5,Sara,Gurrutxaga,1994-03-12,40616649Y,sara.gurrutxaga@extremecloud.com,093529,ES94209525837524276640,1768.53,2024-09-13T09:02:43,Donostia,expenses,leisure,-19.63,-18753.83
buyer_5,Sara,Gurrutxaga,1994-03-12,40616649Y,sara.gurrutxaga@extremecloud.com,093529,ES94209525837524276640,1768.53,2024-09-13T09:36:10,Donostia,expenses,cash,-100.0,-18853.83
buyer_5,Sara,Gurrutxaga,1994-03-12,40616649Y,sara.gurrutxaga@extremecloud.com,093529,ES94209525837524276640,1768.53,2024-09-13T08:50:55,Donostia,expenses,repairs,-246.31,-19100.14
buyer_5,Sara,Gurrutxaga,1994-03-12,40616649Y,sara.gurrutxaga@extremecloud.com,093529,ES94209525837524276640,1768.53,2024-09-16T00:21:56,Donostia,expenses,healthcare,-154.29,-19254.43
buyer_5,Sara,Gurrutxaga,1994-03-12,40616649Y,sara.gurrutxaga@extremecloud.com,093529,ES94209525837524276640,1768.53,2024-09-16T16:42:38,Donostia,expenses,appliances,-269.57,-19524.0
buyer_5,Sara,Gurrutxaga,1994-03-12,40616649Y,sara.gurrutxaga@extremecloud.com,093529,ES94209525837524276640,1768.53,2024-09-17T22:13:04,Donostia,expenses,cash,-100.0,-19624.0
buyer_5,Sara,Gurrutxaga,1994-03-12,40616649Y,sara.gurrutxaga@extremecloud.com,093529,ES94209525837524276640,1768.53,2024-09-19T10:07:27,Donostia,expenses,cash,-100.0,-19724.0
buyer_5,Sara,Gurrutxaga,1994-03-12,40616649Y,sara.gurrutxaga@extremecloud.com,093529,ES94209525837524276640,1768.53,2024-09-20T17:08:40,Donostia,expenses,travel,-744.27,-20468.27
buyer_5,Sara,Gurrutxaga,1994-03-12,40616649Y,sara.gurrutxaga@extremecloud.com,093529,ES94209525837524276640,1768.53,2024-09-20T09:12:47,Donostia,expenses,repairs,-61.56,-20529.83
buyer_5,Sara,Gurrutxaga,1994-03-12,40616649Y,sara.gurrutxaga@extremecloud.com,093529,ES94209525837524276640,1768.53,2024-09-21T16:13:00,Donostia,expenses,cash,-100.0,-20629.83
buyer_5,Sara,Gurrutxaga,1994-03-12,40616649Y,sara.gurrutxaga@extremecloud.com,093529,ES94209525837524276640,1768.53,2024-09-24T08:40:41,Donostia,expenses,cash,-100.0,-20729.83
buyer_5,Sara,Gurrutxaga,1994-03-12,40616649Y,sara.gurrutxaga@extremecloud.com,093529,ES94209525837524276640,1768.53,2024-09-25T21:57:36,Donostia,expenses,transport,-59.42,-20789.25
buyer_5,Sara,Gurrutxaga,1994-03-12,40616649Y,sara.gurrutxaga@extremecloud.com,093529,ES94209525837524276640,1768.53,2024-10-01T15:18:54,Donostia,incomes,salary,2682.24,-18107.01
buyer_5,Sara,Gurrutxaga,1994-03-12,40616649Y,sara.gurrutxaga@extremecloud.com,093529,ES94209525837524276640,1768.53,2024-10-01T15:18:54,Donostia,incomes,salary_partner,3149.51,-14957.5
buyer_5,Sara,Gurrutxaga,1994-03-12,40616649Y,sara.gurrutxaga@extremecloud.com,093529,ES94209525837524276640,1768.53,2024-10-01T15:18:54,Donostia,incomes,extra_income,354.73,-14602.77
buyer_5,Sara,Gurrutxaga,1994-03-12,40616649Y,sara.gurrutxaga@extremecloud.com,093529,ES94209525837524276640,1768.53,2024-10-01T22:51:24,Donostia,expenses,transport,-44.24,-14647.01
buyer_5,Sara,Gurrutxaga,1994-03-12,40616649Y,sara.gurrutxaga@extremecloud.com,093529,ES94209525837524276640,1768.53,2024-10-01T06:15:32,Donostia,expenses,leisure,-50.61,-14697.62
buyer_5,Sara,Gurrutxaga,1994-03-12,40616649Y,sara.gurrutxaga@extremecloud.com,093529,ES94209525837524276640,1768.53,2024-10-02T09:42:45,Donostia,expenses,food,-65.88,-14763.5
buyer_5,Sara,Gurrutxaga,1994-03-12,40616649Y,sara.gurrutxaga@extremecloud.com,093529,ES94209525837524276640,1768.53,2024-10-02T11:09:50,Donostia,expenses,cash,-100.0,-14863.5
buyer_5,Sara,Gurrutxaga,1994-03-12,40616649Y,sara.gurrutxaga@extremecloud.com,093529,ES94209525837524276640,1768.53,2024-10-02T18:26:51,Donostia,expenses,repairs,-160.91,-15024.41
buyer_5,Sara,Gurrutxaga,1994-03-12,40616649Y,sara.gurrutxaga@extremecloud.com,093529,ES94209525837524276640,1768.53,2024-10-03T16:06:09,Donostia,expenses,transport,-49.24,-15073.65
buyer_5,Sara,Gurrutxaga,1994-03-12,40616649Y,sara.gurrutxaga@extremecloud.com,093529,ES94209525837524276640,1768.53,2024-10-04T10:04:51,Donostia,expenses,mortgage,-3055.94,-18129.59
buyer_5,Sara,Gurrutxaga,1994-03-12,40616649Y,sara.gurrutxaga@extremecloud.com,093529,ES94209525837524276640,1768.53,2024-10-04T13:32:16,Donostia,expenses,cash,-100.0,-18229.59
buyer_5,Sara,Gurrutxaga,1994-03-12,40616649Y,sara.gurrutxaga@extremecloud.com,093529,ES94209525837524276640,1768.53,2024-10-05T03:21:00,Donostia,expenses,internet,-122.47,-18352.06
buyer_5,Sara,Gurrutxaga,1994-03-12,40616649Y,sara.gurrutxaga@extremecloud.com,093529,ES94209525837524276640,1768.53,2024-10-05T08:29:32,Donostia,expenses,leisure,-22.03,-18374.09
buyer_5,Sara,Gurrutxaga,1994-03-12,40616649Y,sara.gurrutxaga@extremecloud.com,093529,ES94209525837524276640,1768.53,2024-10-05T17:04:26,Donostia,expenses,clothing,-106.96,-18481.05
buyer_5,Sara,Gurrutxaga,1994-03-12,40616649Y,sara.gurrutxaga@extremecloud.com,093529,ES94209525837524276640,1768.53,2024-10-06T10:29:00,Donostia,expenses,electricity,-182.51,-18663.56
buyer_5,Sara,Gurrutxaga,1994-03-12,40616649Y,sara.gurrutxaga@extremecloud.com,093529,ES94209525837524276640,1768.53,2024-10-07T11:45:57,Donostia,expenses,transport,-71.27,-18734.83
buyer_5,Sara,Gurrutxaga,1994-03-12,40616649Y,sara.gurrutxaga@extremecloud.com,093529,ES94209525837524276640,1768.53,2024-10-08T13:13:55,Donostia,expenses,water,-84.11,-18818.94
buyer_5,Sara,Gurrutxaga,1994-03-12,40616649Y,sara.gurrutxaga@extremecloud.com,093529,ES94209525837524276640,1768.53,2024-10-09T14:42:57,Donostia,expenses,cash,-100.0,-18918.94
buyer_5,Sara,Gurrutxaga,1994-03-12,40616649Y,sara.gurrutxaga@extremecloud.com,093529,ES94209525837524276640,1768.53,2024-10-10T18:56:09,Donostia,expenses,transport,-48.51,-18967.45
buyer_6,Manuel,Rodríguez,1979-02-14,27528818A,manuel.rodríguez@awesomenet.com,755124,ES73209503138719377420,1500.62,2022-01-01T01:19:27,Vitoria-Gasteiz,incomes,salary,1505.49,3006.11
buyer_6,Manuel,Rodríguez,1979-02-14,27528818A,manuel.rodríguez@awesomenet.com,755124,ES73209503138719377420,1500.62,2022-01-01T15:09:37,Vitoria-Gasteiz,expenses,food,-92.46,2913.65
buyer_6,Manuel,Rodríguez,1979-02-14,27528818A,manuel.rodríguez@awesomenet.com,755124,ES73209503138719377420,1500.62,2022-01-01T16:38:54,Vitoria-Gasteiz,expenses,repairs,-133.54,2780.11
buyer_6,Manuel,Rodríguez,1979-02-14,27528818A,manuel.rodríguez@awesomenet.com,755124,ES73209503138719377420,1500.62,2022-01-03T19:58:04,Vitoria-Gasteiz,expenses,cash,-100.0,2680.11
buyer_6,Manuel,Rodríguez,1979-02-14,27528818A,manuel.rodríguez@awesomenet.com,755124,ES73209503138719377420,1500.62,2022-01-04T07:59:22,Vitoria-Gasteiz,expenses,mortgage,-782.29,1897.82
buyer_6,Manuel,Rodríguez,1979-02-14,27528818A,manuel.rodríguez@awesomenet.com,755124,ES73209503138719377420,1500.62,2022-01-04T08:57:10,Vitoria-Gasteiz,expenses,leisure,-22.49,1875.33
buyer_6,Manuel,Rodríguez,1979-02-14,27528818A,manuel.rodríguez@awesomenet.com,755124,ES73209503138719377420,1500.62,2022-01-05T10:16:21,Vitoria-Gasteiz,expenses,leisure,-70.76,1804.57
buyer_6,Manuel,Rodríguez,1979-02-14,27528818A,manuel.rodríguez@awesomenet.com,755124,ES73209503138719377420,1500.62,2022-01-05T05:55:46,Vitoria-Gasteiz,expenses,cash,-100.0,1704.57
buyer_6,Manuel,Rodríguez,1979-02-14,27528818A,manuel.rodríguez@awesomenet.com,755124,ES73209503138719377420,1500.62,2022-01-07T13:08:26,Vitoria-Gasteiz,expenses,internet,-31.62,1672.95
buyer_6,Manuel,Rodríguez,1979-02-14,27528818A,manuel.rodríguez@awesomenet.com,755124,ES73209503138719377420,1500.62,2022-01-07T12:55:10,Vitoria-Gasteiz,expenses,cash,-100.0,1572.95
buyer_6,Manuel,Rodríguez,1979-02-14,27528818A,manuel.rodríguez@awesomenet.com,755124,ES73209503138719377420,1500.62,2022-01-09T07:50:08,Vitoria-Gasteiz,expenses,cash,-100.0,1472.95
buyer_6,Manuel,Rodríguez,1979-02-14,27528818A,manuel.rodríguez@awesomenet.com,755124,ES73209503138719377420,1500.62,2022-01-11T20:36:34,Vitoria-Gasteiz,expenses,repairs,-205.56,1267.39
buyer_6,Manuel,Rodríguez,1979-02-14,27528818A,manuel.rodríguez@awesomenet.com,755124,ES73209503138719377420,1500.62,2022-01-12T20:23:39,Vitoria-Gasteiz,expenses,leisure,-65.57,1201.82
buyer_6,Manuel,Rodríguez,1979-02-14,27528818A,manuel.rodríguez@awesomenet.com,755124,ES73209503138719377420,1500.62,2022-01-12T13:37:53,Vitoria-Gasteiz,expenses,cash,-100.0,1101.82
buyer_6,Manuel,Rodríguez,1979-02-14,27528818A,manuel.rodríguez@awesomenet.com,755124,ES73209503138719377420,1500.62,2022-01-14T23:56:40,Vitoria-Gasteiz,expenses,repairs,-131.32,970.5
buyer_6,Manuel,Rodríguez,1979-02-14,27528818A,manuel.rodríguez@awesomenet.com,755124,ES73209503138719377420,1500.62,2022-01-15T10:26:05,Vitoria-Gasteiz,expenses,leisure,-23.35,947.15
buyer_6,Manuel,Rodríguez,1979-02-14,27528818A,manuel.rodríguez@awesomenet.com,755124,ES73209503138719377420,1500.62,2022-01-15T08:23:24,Vitoria-Gasteiz,expenses,clothing,-129.26,817.89
buyer_6,Manuel,Rodríguez,1979-02-14,27528818A,manuel.rodríguez@awesomenet.com,755124,ES73209503138719377420,1500.62,2022-01-15T02:45:16,Vitoria-Gasteiz,expenses,gifts,-278.31,539.58
buyer_6,Manuel,Rodríguez,1979-02-14,27528818A,manuel.rodríguez@awesomenet.com,755124,ES73209503138719377420,1500.62,2022-01-17T16:25:48,Vitoria-Gasteiz,expenses,healthcare,-131.65,407.93
buyer_6,Manuel,Rodríguez,1979-02-14,27528818A,manuel.rodríguez@awesomenet.com,755124,ES73209503138719377420,1500.62,2022-01-17T09:21:22,Vitoria-Gasteiz,expenses,cash,-100.0,307.93
buyer_6,Manuel,Rodríguez,1979-02-14,27528818A,manuel.rodríguez@awesomenet.com,755124,ES73209503138719377420,1500.62,2022-01-18T19:02:16,Vitoria-Gasteiz,expenses,travel,-394.56,-86.63
buyer_6,Manuel,Rodríguez,1979-02-14,27528818A,manuel.rodríguez@awesomenet.com,755124,ES73209503138719377420,1500.62,2022-01-20T18:40:30,Vitoria-Gasteiz,expenses,leisure,-29.01,-115.64
buyer_6,Manuel,Rodríguez,1979-02-14,27528818A,manuel.rodríguez@awesomenet.com,755124,ES73209503138719377420,1500.62,2022-01-22T16:34:35,Vitoria-Gasteiz,expenses,cash,-100.0,-215.64
buyer_6,Manuel,Rodríguez,1979-02-14,27528818A,manuel.rodríguez@awesomenet.com,755124,ES73209503138719377420,1500.62,2022-01-23T09:05:58,Vitoria-Gasteiz,expenses,transport,-85.35,-300.99
buyer_6,Manuel,Rodríguez,1979-02-14,27528818A,manuel.rodríguez@awesomenet.com,755124,ES73209503138719377420,1500.62,2022-01-23T12:16:39,Vitoria-Gasteiz,expenses,repairs,-65.89,-366.88
buyer_6,Manuel,Rodríguez,1979-02-14,27528818A,manuel.rodríguez@awesomenet.com,755124,ES73209503138719377420,1500.62,2022-01-24T17:01:11,Vitoria-Gasteiz,expenses,food,-115.38,-482.26
buyer_6,Manuel,Rodríguez,1979-02-14,27528818A,manuel.rodríguez@awesomenet.com,755124,ES73209503138719377420,1500.62,2022-01-24T18:39:50,Vitoria-Gasteiz,expenses,leisure,-32.36,-514.62
buyer_6,Manuel,Rodríguez,1979-02-14,27528818A,manuel.rodríguez@awesomenet.com,755124,ES73209503138719377420,1500.62,2022-01-25T04:57:04,Vitoria-Gasteiz,expenses,food,-74.73,-589.35
buyer_6,Manuel,Rodríguez,1979-02-14,27528818A,manuel.rodríguez@awesomenet.com,755124,ES73209503138719377420,1500.62,2022-01-25T09:33:53,Vitoria-Gasteiz,expenses,clothing,-129.98,-719.33
buyer_6,Manuel,Rodríguez,1979-02-14,27528818A,manuel.rodríguez@awesomenet.com,755124,ES73209503138719377420,1500.62,2022-01-27T17:58:29,Vitoria-Gasteiz,expenses,repairs,-28.25,-747.58
buyer_6,Manuel,Rodríguez,1979-02-14,27528818A,manuel.rodríguez@awesomenet.com,755124,ES73209503138719377420,1500.62,2022-01-29T09:37:29,Vitoria-Gasteiz,expenses,leisure,-32.72,-780.3
buyer_6,Manuel,Rodríguez,1979-02-14,27528818A,manuel.rodríguez@awesomenet.com,755124,ES73209503138719377420,1500.62,2022-02-01T15:48:50,Vitoria-Gasteiz,incomes,salary,1505.49,725.19
buyer_6,Manuel,Rodríguez,1979-02-14,27528818A,manuel.rodríguez@awesomenet.com,755124,ES73209503138719377420,1500.62,2022-02-01T10:32:28,Vitoria-Gasteiz,expenses,food,-77.56,647.63
buyer_6,Manuel,Rodríguez,1979-02-14,27528818A,manuel.rodríguez@awesomenet.com,755124,ES73209503138719377420,1500.62,2022-02-02T17:43:12,Vitoria-Gasteiz,expenses,appliances,-145.95,501.68
buyer_6,Manuel,Rodríguez,1979-02-14,27528818A,manuel.rodríguez@awesomenet.com,755124,ES73209503138719377420,1500.62,2022-02-03T15:58:29,Vitoria-Gasteiz,expenses,leisure,-64.2,437.48
buyer_6,Manuel,Rodríguez,1979-02-14,27528818A,manuel.rodríguez@awesomenet.com,755124,ES73209503138719377420,1500.62,2022-02-04T21:14:30,Vitoria-Gasteiz,expenses,mortgage,-782.29,-344.81
buyer_6,Manuel,Rodríguez,1979-02-14,27528818A,manuel.rodríguez@awesomenet.com,755124,ES73209503138719377420,1500.62,2022-02-04T14:50:54,Vitoria-Gasteiz,expenses,transport,-49.12,-393.93
buyer_6,Manuel,Rodríguez,1979-02-14,27528818A,manuel.rodríguez@awesomenet.com,755124,ES73209503138719377420,1500.62,2022-02-04T17:31:10,Vitoria-Gasteiz,expenses,cash,-100.0,-493.93
buyer_6,Manuel,Rodríguez,1979-02-14,27528818A,manuel.rodríguez@awesomenet.com,755124,ES73209503138719377420,1500.62,2022-02-05T23:49:28,Vitoria-Gasteiz,expenses,internet,-31.62,-525.55
buyer_6,Manuel,Rodríguez,1979-02-14,27528818A,manuel.rodríguez@awesomenet.com,755124,ES73209503138719377420,1500.62,2022-02-06T09:08:01,Vitoria-Gasteiz,expenses,food,-69.93,-595.48
buyer_6,Manuel,Rodríguez,1979-02-14,27528818A,manuel.rodríguez@awesomenet.com,755124,ES73209503138719377420,1500.62,2022-02-06T16:35:35,Vitoria-Gasteiz,expenses,cash,-100.0,-695.48
buyer_6,Manuel,Rodríguez,1979-02-14,27528818A,manuel.rodríguez@awesomenet.com,755124,ES73209503138719377420,1500.62,2022-02-07T22:48:07,Vitoria-Gasteiz,expenses,gas,-78.75,-774.23
buyer_6,Manuel,Rodríguez,1979-02-14,27528818A,manuel.rodríguez@awesomenet.com,755124,ES73209503138719377420,1500.62,2022-02-07T10:46:53,Vitoria-Gasteiz,expenses,transport,-63.86,-838.09
buyer_6,Manuel,Rodríguez,1979-02-14,27528818A,manuel.rodríguez@awesomenet.com,755124,ES73209503138719377420,1500.62,2022-02-07T23:44:55,Vitoria-Gasteiz,expenses,healthcare,-171.9,-1009.99
buyer_6,Manuel,Rodríguez,1979-02-14,27528818A,manuel.rodríguez@awesomenet.com,755124,ES73209503138719377420,1500.62,2022-02-08T20:42:14,Vitoria-Gasteiz,expenses,water,-29.03,-1039.02
buyer_6,Manuel,Rodríguez,1979-02-14,27528818A,manuel.rodríguez@awesomenet.com,755124,ES73209503138719377420,1500.62,2022-02-08T13:05:24,Vitoria-Gasteiz,expenses,internet,-31.62,-1070.64
buyer_6,Manuel,Rodríguez,1979-02-14,27528818A,manuel.rodríguez@awesomenet.com,755124,ES73209503138719377420,1500.62,2022-02-08T09:49:34,Vitoria-Gasteiz,expenses,leisure,-34.29,-1104.93
buyer_6,Manuel,Rodríguez,1979-02-14,27528818A,manuel.rodríguez@awesomenet.com,755124,ES73209503138719377420,1500.62,2022-02-09T13:48:02,Vitoria-Gasteiz,expenses,cash,-100.0,-1204.93
buyer_6,Manuel,Rodríguez,1979-02-14,27528818A,manuel.rodríguez@awesomenet.com,755124,ES73209503138719377420,1500.62,2022-02-10T18:18:56,Vitoria-Gasteiz,expenses,healthcare,-89.8,-1294.73
buyer_6,Manuel,Rodríguez,1979-02-14,27528818A,manuel.rodríguez@awesomenet.com,755124,ES73209503138719377420,1500.62,2022-02-11T20:14:19,Vitoria-Gasteiz,expenses,leisure,-50.89,-1345.62
buyer_6,Manuel,Rodríguez,1979-02-14,27528818A,manuel.rodríguez@awesomenet.com,755124,ES73209503138719377420,1500.62,2022-02-13T20:29:04,Vitoria-Gasteiz,expenses,repairs,-322.03,-1667.65
buyer_6,Manuel,Rodríguez,1979-02-14,27528818A,manuel.rodríguez@awesomenet.com,755124,ES73209503138719377420,1500.62,2022-02-16T21:42:18,Vitoria-Gasteiz,expenses,cash,-100.0,-1767.65
buyer_6,Manuel,Rodríguez,1979-02-14,27528818A,manuel.rodríguez@awesomenet.com,755124,ES73209503138719377420,1500.62,2022-02-16T19:55:23,Vitoria-Gasteiz,expenses,repairs,-50.22,-1817.87
buyer_6,Manuel,Rodríguez,1979-02-14,27528818A,manuel.rodríguez@awesomenet.com,755124,ES73209503138719377420,1500.62,2022-02-18T20:01:44,Vitoria-Gasteiz,expenses,cash,-100.0,-1917.87
buyer_6,Manuel,Rodríguez,1979-02-14,27528818A,manuel.rodríguez@awesomenet.com,755124,ES73209503138719377420,1500.62,2022-02-22T13:04:03,Vitoria-Gasteiz,expenses,transport,-42.08,-1959.95
buyer_6,Manuel,Rodríguez,1979-02-14,27528818A,manuel.rodríguez@awesomenet.com,755124,ES73209503138719377420,1500.62,2022-02-23T17:52:01,Vitoria-Gasteiz,expenses,cash,-100.0,-2059.95
buyer_6,Manuel,Rodríguez,1979-02-14,27528818A,manuel.rodríguez@awesomenet.com,755124,ES73209503138719377420,1500.62,2022-02-24T21:28:28,Vitoria-Gasteiz,expenses,repairs,-214.77,-2274.72
buyer_6,Manuel,Rodríguez,1979-02-14,27528818A,manuel.rodríguez@awesomenet.com,755124,ES73209503138719377420,1500.62,2022-02-25T08:06:35,Vitoria-Gasteiz,expenses,transport,-50.69,-2325.41
buyer_6,Manuel,Rodríguez,1979-02-14,27528818A,manuel.rodríguez@awesomenet.com,755124,ES73209503138719377420,1500.62,2022-02-26T01:11:03,Vitoria-Gasteiz,expenses,transport,-40.93,-2366.34
buyer_6,Manuel,Rodríguez,1979-02-14,27528818A,manuel.rodríguez@awesomenet.com,755124,ES73209503138719377420,1500.62,2022-03-01T18:40:42,Vitoria-Gasteiz,incomes,salary,1505.49,-860.85
buyer_6,Manuel,Rodríguez,1979-02-14,27528818A,manuel.rodríguez@awesomenet.com,755124,ES73209503138719377420,1500.62,2022-03-04T12:24:25,Vitoria-Gasteiz,expenses,mortgage,-782.29,-1643.14
buyer_6,Manuel,Rodríguez,1979-02-14,27528818A,manuel.rodríguez@awesomenet.com,755124,ES73209503138719377420,1500.62,2022-03-05T18:10:49,Vitoria-Gasteiz,expenses,water,-27.37,-1670.51
buyer_6,Manuel,Rodríguez,1979-02-14,27528818A,manuel.rodríguez@awesomenet.com,755124,ES73209503138719377420,1500.62,2022-03-05T09:38:21,Vitoria-Gasteiz,expenses,electricity,-36.81,-1707.32
buyer_6,Manuel,Rodríguez,1979-02-14,27528818A,manuel.rodríguez@awesomenet.com,755124,ES73209503138719377420,1500.62,2022-03-05T07:24:13,Vitoria-Gasteiz,expenses,cash,-100.0,-1807.32
buyer_6,Manuel,Rodríguez,1979-02-14,27528818A,manuel.rodríguez@awesomenet.com,755124,ES73209503138719377420,1500.62,2022-03-06T10:43:13,Vitoria-Gasteiz,expenses,food,-69.88,-1877.2
buyer_6,Manuel,Rodríguez,1979-02-14,27528818A,manuel.rodríguez@awesomenet.com,755124,ES73209503138719377420,1500.62,2022-03-08T12:39:00,Vitoria-Gasteiz,expenses,gas,-78.17,-1955.37
buyer_6,Manuel,Rodríguez,1979-02-14,27528818A,manuel.rodríguez@awesomenet.com,755124,ES73209503138719377420,1500.62,2022-03-09T23:35:03,Vitoria-Gasteiz,expenses,leisure,-48.08,-2003.45
buyer_6,Manuel,Rodríguez,1979-02-14,27528818A,manuel.rodríguez@awesomenet.com,755124,ES73209503138719377420,1500.62,2022-03-09T19:40:14,Vitoria-Gasteiz,expenses,cash,-100.0,-2103.45
buyer_6,Manuel,Rodríguez,1979-02-14,27528818A,manuel.rodríguez@awesomenet.com,755124,ES73209503138719377420,1500.62,2022-03-09T15:23:06,Vitoria-Gasteiz,expenses,travel,-386.11,-2489.56
buyer_6,Manuel,Rodríguez,1979-02-14,27528818A,manuel.rodríguez@awesomenet.com,755124,ES73209503138719377420,1500.62,2022-03-12T14:51:39,Vitoria-Gasteiz,expenses,cash,-100.0,-2589.56
buyer_6,Manuel,Rodríguez,1979-02-14,27528818A,manuel.rodríguez@awesomenet.com,755124,ES73209503138719377420,1500.62,2022-03-13T10:38:08,Vitoria-Gasteiz,expenses,clothing,-91.94,-2681.5
buyer_6,Manuel,Rodríguez,1979-02-14,27528818A,manuel.rodríguez@awesomenet.com,755124,ES73209503138719377420,1500.62,2022-03-13T20:19:02,Vitoria-Gasteiz,expenses,cash,-100.0,-2781.5
buyer_6,Manuel,Rodríguez,1979-02-14,27528818A,manuel.rodríguez@awesomenet.com,755124,ES73209503138719377420,1500.62,2022-03-16T00:12:32,Vitoria-Gasteiz,expenses,leisure,-54.05,-2835.55
buyer_6,Manuel,Rodríguez,1979-02-14,27528818A,manuel.rodríguez@awesomenet.com,755124,ES73209503138719377420,1500.62,2022-03-17T13:05:34,Vitoria-Gasteiz,expenses,cash,-100.0,-2935.55
buyer_6,Manuel,Rodríguez,1979-02-14,27528818A,manuel.rodríguez@awesomenet.com,755124,ES73209503138719377420,1500.62,2022-03-18T11:15:07,Vitoria-Gasteiz,expenses,leisure,-27.12,-2962.67
buyer_6,Manuel,Rodríguez,1979-02-14,27528818A,manuel.rodríguez@awesomenet.com,755124,ES73209503138719377420,1500.62,2022-03-18T11:28:04,Vitoria-Gasteiz,expenses,healthcare,-64.03,-3026.7
buyer_6,Manuel,Rodríguez,1979-02-14,27528818A,manuel.rodríguez@awesomenet.com,755124,ES73209503138719377420,1500.62,2022-03-19T16:07:36,Vitoria-Gasteiz,expenses,education,-44.38,-3071.08
buyer_6,Manuel,Rodríguez,1979-02-14,27528818A,manuel.rodríguez@awesomenet.com,755124,ES73209503138719377420,1500.62,2022-03-20T11:52:53,Vitoria-Gasteiz,expenses,cash,-100.0,-3171.08
buyer_6,Manuel,Rodríguez,1979-02-14,27528818A,manuel.rodríguez@awesomenet.com,755124,ES73209503138719377420,1500.62,2022-03-20T23:24:49,Vitoria-Gasteiz,expenses,gifts,-309.61,-3480.69
buyer_6,Manuel,Rodríguez,1979-02-14,27528818A,manuel.rodríguez@awesomenet.com,755124,ES73209503138719377420,1500.62,2022-03-22T09:32:56,Vitoria-Gasteiz,expenses,gifts,-425.84,-3906.53
buyer_6,Manuel,Rodríguez,1979-02-14,27528818A,manuel.rodríguez@awesomenet.com,755124,ES73209503138719377420,1500.62,2022-03-23T18:29:56,Vitoria-Gasteiz,expenses,transport,-63.05,-3969.58
buyer_6,Manuel,Rodríguez,1979-02-14,27528818A,manuel.rodríguez@awesomenet.com,755124,ES73209503138719377420,1500.62,2022-03-24T15:34:59,Vitoria-Gasteiz,expenses,cash,-100.0,-4069.58
buyer_6,Manuel,Rodríguez,1979-02-14,27528818A,manuel.rodríguez@awesomenet.com,755124,ES73209503138719377420,1500.62,2022-03-25T18:33:53,Vitoria-Gasteiz,expenses,food,-120.95,-4190.53
buyer_6,Manuel,Rodríguez,1979-02-14,27528818A,manuel.rodríguez@awesomenet.com,755124,ES73209503138719377420,1500.62,2022-03-25T00:26:18,Vitoria-Gasteiz,expenses,clothing,-118.16,-4308.69
buyer_6,Manuel,Rodríguez,1979-02-14,27528818A,manuel.rodríguez@awesomenet.com,755124,ES73209503138719377420,1500.62,2022-03-29T21:52:05,Vitoria-Gasteiz,expenses,gifts,-497.51,-4806.2
buyer_6,Manuel,Rodríguez,1979-02-14,27528818A,manuel.rodríguez@awesomenet.com,755124,ES73209503138719377420,1500.62,2022-04-01T19:56:03,Vitoria-Gasteiz,incomes,salary,1505.49,-3300.71
buyer_6,Manuel,Rodríguez,1979-02-14,27528818A,manuel.rodríguez@awesomenet.com,755124,ES73209503138719377420,1500.62,2022-04-01T19:56:03,Vitoria-Gasteiz,incomes,extra_income,161.05,-3139.66
buyer_6,Manuel,Rodríguez,1979-02-14,27528818A,manuel.rodríguez@awesomenet.com,755124,ES73209503138719377420,1500.62,2022-04-01T14:11:57,Vitoria-Gasteiz,expenses,food,-70.24,-3209.9
buyer_6,Manuel,Rodríguez,1979-02-14,27528818A,manuel.rodríguez@awesomenet.com,755124,ES73209503138719377420,1500.62,2022-04-02T13:58:47,Vitoria-Gasteiz,expenses,education,-70.67,-3280.57
buyer_6,Manuel,Rodríguez,1979-02-14,27528818A,manuel.rodríguez@awesomenet.com,755124,ES73209503138719377420,1500.62,2022-04-02T14:24:00,Vitoria-Gasteiz,expenses,gifts,-294.51,-3575.08
buyer_6,Manuel,Rodríguez,1979-02-14,27528818A,manuel.rodríguez@awesomenet.com,755124,ES73209503138719377420,1500.62,2022-04-04T12:18:40,Vitoria-Gasteiz,expenses,mortgage,-782.29,-4357.37
buyer_6,Manuel,Rodríguez,1979-02-14,27528818A,manuel.rodríguez@awesomenet.com,755124,ES73209503138719377420,1500.62,2022-04-04T11:15:45,Vitoria-Gasteiz,expenses,food,-90.78,-4448.15
buyer_6,Manuel,Rodríguez,1979-02-14,27528818A,manuel.rodríguez@awesomenet.com,755124,ES73209503138719377420,1500.62,2022-04-04T08:29:04,Vitoria-Gasteiz,expenses,education,-58.25,-4506.4
buyer_6,Manuel,Rodríguez,1979-02-14,27528818A,manuel.rodríguez@awesomenet.com,755124,ES73209503138719377420,1500.62,2022-04-05T12:11:40,Vitoria-Gasteiz,expenses,water,-30.1,-4536.5
buyer_6,Manuel,Rodríguez,1979-02-14,27528818A,manuel.rodríguez@awesomenet.com,755124,ES73209503138719377420,1500.62,2022-04-05T14:11:16,Vitoria-Gasteiz,expenses,internet,-31.62,-4568.12
buyer_6,Manuel,Rodríguez,1979-02-14,27528818A,manuel.rodríguez@awesomenet.com,755124,ES73209503138719377420,1500.62,2022-04-05T11:06:21,Vitoria-Gasteiz,expenses,transport,-69.44,-4637.56
buyer_6,Manuel,Rodríguez,1979-02-14,27528818A,manuel.rodríguez@awesomenet.com,755124,ES73209503138719377420,1500.62,2022-04-05T20:28:33,Vitoria-Gasteiz,expenses,clothing,-157.14,-4794.7
buyer_6,Manuel,Rodríguez,1979-02-14,27528818A,manuel.rodríguez@awesomenet.com,755124,ES73209503138719377420,1500.62,2022-04-06T16:49:03,Vitoria-Gasteiz,expenses,electricity,-45.65,-4840.35
buyer_6,Manuel,Rodríguez,1979-02-14,27528818A,manuel.rodríguez@awesomenet.com,755124,ES73209503138719377420,1500.62,2022-04-06T20:05:28,Vitoria-Gasteiz,expenses,gas,-30.39,-4870.74
buyer_6,Manuel,Rodríguez,1979-02-14,27528818A,manuel.rodríguez@awesomenet.com,755124,ES73209503138719377420,1500.62,2022-04-06T15:08:22,Vitoria-Gasteiz,expenses,internet,-31.62,-4902.36
buyer_6,Manuel,Rodríguez,1979-02-14,27528818A,manuel.rodríguez@awesomenet.com,755124,ES73209503138719377420,1500.62,2022-04-06T09:51:09,Vitoria-Gasteiz,expenses,phone,-23.1,-4925.46
buyer_6,Manuel,Rodríguez,1979-02-14,27528818A,manuel.rodríguez@awesomenet.com,755124,ES73209503138719377420,1500.62,2022-04-07T08:04:17,Vitoria-Gasteiz,expenses,electricity,-67.19,-4992.65
buyer_6,Manuel,Rodríguez,1979-02-14,27528818A,manuel.rodríguez@awesomenet.com,755124,ES73209503138719377420,1500.62,2022-04-08T11:28:57,Vitoria-Gasteiz,expenses,phone,-31.32,-5023.97
buyer_6,Manuel,Rodríguez,1979-02-14,27528818A,manuel.rodríguez@awesomenet.com,755124,ES73209503138719377420,1500.62,2022-04-11T10:50:28,Vitoria-Gasteiz,expenses,leisure,-77.99,-5101.96
buyer_6,Manuel,Rodríguez,1979-02-14,27528818A,manuel.rodríguez@awesomenet.com,755124,ES73209503138719377420,1500.62,2022-04-11T14:49:30,Vitoria-Gasteiz,expenses,healthcare,-144.06,-5246.02
buyer_6,Manuel,Rodríguez,1979-02-14,27528818A,manuel.rodríguez@awesomenet.com,755124,ES73209503138719377420,1500.62,2022-04-12T11:45:07,Vitoria-Gasteiz,expenses,leisure,-42.56,-5288.58
buyer_6,Manuel,Rodríguez,1979-02-14,27528818A,manuel.rodríguez@awesomenet.com,755124,ES73209503138719377420,1500.62,2022-04-12T10:20:50,Vitoria-Gasteiz,expenses,appliances,-96.59,-5385.17
buyer_6,Manuel,Rodríguez,1979-02-14,27528818A,manuel.rodríguez@awesomenet.com,755124,ES73209503138719377420,1500.62,2022-04-15T10:34:58,Vitoria-Gasteiz,expenses,transport,-58.0,-5443.17
buyer_6,Manuel,Rodríguez,1979-02-14,27528818A,manuel.rodríguez@awesomenet.com,755124,ES73209503138719377420,1500.62,2022-04-17T10:00:26,Vitoria-Gasteiz,expenses,repairs,-120.64,-5563.81
buyer_6,Manuel,Rodríguez,1979-02-14,27528818A,manuel.rodríguez@awesomenet.com,755124,ES73209503138719377420,1500.62,2022-04-22T15:14:18,Vitoria-Gasteiz,expenses,cash,-100.0,-5663.81
buyer_6,Manuel,Rodríguez,1979-02-14,27528818A,manuel.rodríguez@awesomenet.com,755124,ES73209503138719377420,1500.62,2022-04-22T18:45:37,Vitoria-Gasteiz,expenses,repairs,-27.72,-5691.53
buyer_6,Manuel,Rodríguez,1979-02-14,27528818A,manuel.rodríguez@awesomenet.com,755124,ES73209503138719377420,1500.62,2022-04-24T16:38:45,Vitoria-Gasteiz,expenses,cash,-100.0,-5791.53
buyer_6,Manuel,Rodríguez,1979-02-14,27528818A,manuel.rodríguez@awesomenet.com,755124,ES73209503138719377420,1500.62,2022-04-26T14:54:01,Vitoria-Gasteiz,expenses,clothing,-114.66,-5906.19
buyer_6,Manuel,Rodríguez,1979-02-14,27528818A,manuel.rodríguez@awesomenet.com,755124,ES73209503138719377420,1500.62,2022-04-26T12:24:58,Vitoria-Gasteiz,expenses,repairs,-138.57,-6044.76
buyer_6,Manuel,Rodríguez,1979-02-14,27528818A,manuel.rodríguez@awesomenet.com,755124,ES73209503138719377420,1500.62,2022-04-26T12:43:50,Vitoria-Gasteiz,expenses,gifts,-235.4,-6280.16
buyer_6,Manuel,Rodríguez,1979-02-14,27528818A,manuel.rodríguez@awesomenet.com,755124,ES73209503138719377420,1500.62,2022-04-27T15:25:23,Vitoria-Gasteiz,expenses,cash,-100.0,-6380.16
buyer_6,Manuel,Rodríguez,1979-02-14,27528818A,manuel.rodríguez@awesomenet.com,755124,ES73209503138719377420,1500.62,2022-04-29T08:05:08,Vitoria-Gasteiz,expenses,food,-73.32,-6453.48
buyer_6,Manuel,Rodríguez,1979-02-14,27528818A,manuel.rodríguez@awesomenet.com,755124,ES73209503138719377420,1500.62,2022-05-01T14:50:45,Vitoria-Gasteiz,incomes,salary,1505.49,-4947.99
buyer_6,Manuel,Rodríguez,1979-02-14,27528818A,manuel.rodríguez@awesomenet.com,755124,ES73209503138719377420,1500.62,2022-05-01T17:08:41,Vitoria-Gasteiz,expenses,healthcare,-73.76,-5021.75
buyer_6,Manuel,Rodríguez,1979-02-14,27528818A,manuel.rodríguez@awesomenet.com,755124,ES73209503138719377420,1500.62,2022-05-02T20:28:01,Vitoria-Gasteiz,expenses,leisure,-35.04,-5056.79
buyer_6,Manuel,Rodríguez,1979-02-14,27528818A,manuel.rodríguez@awesomenet.com,755124,ES73209503138719377420,1500.62,2022-05-03T08:40:34,Vitoria-Gasteiz,expenses,healthcare,-62.83,-5119.62
buyer_6,Manuel,Rodríguez,1979-02-14,27528818A,manuel.rodríguez@awesomenet.com,755124,ES73209503138719377420,1500.62,2022-05-04T14:57:59,Vitoria-Gasteiz,expenses,mortgage,-782.29,-5901.91
buyer_6,Manuel,Rodríguez,1979-02-14,27528818A,manuel.rodríguez@awesomenet.com,755124,ES73209503138719377420,1500.62,2022-05-04T12:16:55,Vitoria-Gasteiz,expenses,transport,-63.52,-5965.43
buyer_6,Manuel,Rodríguez,1979-02-14,27528818A,manuel.rodríguez@awesomenet.com,755124,ES73209503138719377420,1500.62,2022-05-04T17:28:25,Vitoria-Gasteiz,expenses,leisure,-22.62,-5988.05
buyer_6,Manuel,Rodríguez,1979-02-14,27528818A,manuel.rodríguez@awesomenet.com,755124,ES73209503138719377420,1500.62,2022-05-05T09:32:44,Vitoria-Gasteiz,expenses,water,-23.58,-6011.63
buyer_6,Manuel,Rodríguez,1979-02-14,27528818A,manuel.rodríguez@awesomenet.com,755124,ES73209503138719377420,1500.62,2022-05-05T17:24:27,Vitoria-Gasteiz,expenses,gas,-77.61,-6089.24
buyer_6,Manuel,Rodríguez,1979-02-14,27528818A,manuel.rodríguez@awesomenet.com,755124,ES73209503138719377420,1500.62,2022-05-06T09:26:43,Vitoria-Gasteiz,expenses,electricity,-39.68,-6128.92
buyer_6,Manuel,Rodríguez,1979-02-14,27528818A,manuel.rodríguez@awesomenet.com,755124,ES73209503138719377420,1500.62,2022-05-06T19:33:41,Vitoria-Gasteiz,expenses,phone,-26.94,-6155.86
buyer_6,Manuel,Rodríguez,1979-02-14,27528818A,manuel.rodríguez@awesomenet.com,755124,ES73209503138719377420,1500.62,2022-05-07T19:43:36,Vitoria-Gasteiz,expenses,water,-20.08,-6175.94
buyer_6,Manuel,Rodríguez,1979-02-14,27528818A,manuel.rodríguez@awesomenet.com,755124,ES73209503138719377420,1500.62,2022-05-07T11:41:16,Vitoria-Gasteiz,expenses,internet,-31.62,-6207.56
buyer_6,Manuel,Rodríguez,1979-02-14,27528818A,manuel.rodríguez@awesomenet.com,755124,ES73209503138719377420,1500.62,2022-05-08T01:53:38,Vitoria-Gasteiz,expenses,water,-19.13,-6226.69
buyer_6,Manuel,Rodríguez,1979-02-14,27528818A,manuel.rodríguez@awesomenet.com,755124,ES73209503138719377420,1500.62,2022-05-08T16:15:37,Vitoria-Gasteiz,expenses,internet,-31.62,-6258.31
buyer_6,Manuel,Rodríguez,1979-02-14,27528818A,manuel.rodríguez@awesomenet.com,755124,ES73209503138719377420,1500.62,2022-05-09T19:36:29,Vitoria-Gasteiz,expenses,repairs,-217.0,-6475.31
buyer_6,Manuel,Rodríguez,1979-02-14,27528818A,manuel.rodríguez@awesomenet.com,755124,ES73209503138719377420,1500.62,2022-05-11T07:31:46,Vitoria-Gasteiz,expenses,cash,-100.0,-6575.31
buyer_6,Manuel,Rodríguez,1979-02-14,27528818A,manuel.rodríguez@awesomenet.com,755124,ES73209503138719377420,1500.62,2022-05-12T17:46:44,Vitoria-Gasteiz,expenses,cash,-100.0,-6675.31
buyer_6,Manuel,Rodríguez,1979-02-14,27528818A,manuel.rodríguez@awesomenet.com,755124,ES73209503138719377420,1500.62,2022-05-13T14:47:00,Vitoria-Gasteiz,expenses,clothing,-134.08,-6809.39
buyer_6,Manuel,Rodríguez,1979-02-14,27528818A,manuel.rodríguez@awesomenet.com,755124,ES73209503138719377420,1500.62,2022-05-15T21:55:33,Vitoria-Gasteiz,expenses,transport,-47.31,-6856.7
buyer_6,Manuel,Rodríguez,1979-02-14,27528818A,manuel.rodríguez@awesomenet.com,755124,ES73209503138719377420,1500.62,2022-05-16T09:24:33,Vitoria-Gasteiz,expenses,cash,-100.0,-6956.7
buyer_6,Manuel,Rodríguez,1979-02-14,27528818A,manuel.rodríguez@awesomenet.com,755124,ES73209503138719377420,1500.62,2022-05-16T17:05:22,Vitoria-Gasteiz,expenses,repairs,-276.52,-7233.22
buyer_6,Manuel,Rodríguez,1979-02-14,27528818A,manuel.rodríguez@awesomenet.com,755124,ES73209503138719377420,1500.62,2022-05-17T11:43:29,Vitoria-Gasteiz,expenses,leisure,-67.2,-7300.42
buyer_6,Manuel,Rodríguez,1979-02-14,27528818A,manuel.rodríguez@awesomenet.com,755124,ES73209503138719377420,1500.62,2022-05-18T23:01:18,Vitoria-Gasteiz,expenses,leisure,-21.7,-7322.12
buyer_6,Manuel,Rodríguez,1979-02-14,27528818A,manuel.rodríguez@awesomenet.com,755124,ES73209503138719377420,1500.62,2022-05-21T08:34:47,Vitoria-Gasteiz,expenses,repairs,-274.37,-7596.49
buyer_6,Manuel,Rodríguez,1979-02-14,27528818A,manuel.rodríguez@awesomenet.com,755124,ES73209503138719377420,1500.62,2022-05-21T17:44:59,Vitoria-Gasteiz,expenses,gifts,-187.15,-7783.64
buyer_6,Manuel,Rodríguez,1979-02-14,27528818A,manuel.rodríguez@awesomenet.com,755124,ES73209503138719377420,1500.62,2022-05-22T14:25:37,Vitoria-Gasteiz,expenses,food,-76.83,-7860.47
buyer_6,Manuel,Rodríguez,1979-02-14,27528818A,manuel.rodríguez@awesomenet.com,755124,ES73209503138719377420,1500.62,2022-05-22T18:27:22,Vitoria-Gasteiz,expenses,repairs,-246.31,-8106.78
buyer_6,Manuel,Rodríguez,1979-02-14,27528818A,manuel.rodríguez@awesomenet.com,755124,ES73209503138719377420,1500.62,2022-05-24T16:09:18,Vitoria-Gasteiz,expenses,food,-68.85,-8175.63
buyer_6,Manuel,Rodríguez,1979-02-14,27528818A,manuel.rodríguez@awesomenet.com,755124,ES73209503138719377420,1500.62,2022-05-24T22:03:53,Vitoria-Gasteiz,expenses,cash,-100.0,-8275.63
buyer_6,Manuel,Rodríguez,1979-02-14,27528818A,manuel.rodríguez@awesomenet.com,755124,ES73209503138719377420,1500.62,2022-05-26T22:52:22,Vitoria-Gasteiz,expenses,food,-92.16,-8367.79
buyer_6,Manuel,Rodríguez,1979-02-14,27528818A,manuel.rodríguez@awesomenet.com,755124,ES73209503138719377420,1500.62,2022-05-27T21:55:01,Vitoria-Gasteiz,expenses,cash,-100.0,-8467.79
buyer_6,Manuel,Rodríguez,1979-02-14,27528818A,manuel.rodríguez@awesomenet.com,755124,ES73209503138719377420,1500.62,2022-06-01T12:08:25,Vitoria-Gasteiz,incomes,salary,1505.49,-6962.3
buyer_6,Manuel,Rodríguez,1979-02-14,27528818A,manuel.rodríguez@awesomenet.com,755124,ES73209503138719377420,1500.62,2022-06-01T12:08:25,Vitoria-Gasteiz,incomes,salary_bonus,1170.59,-5791.71
buyer_6,Manuel,Rodríguez,1979-02-14,27528818A,manuel.rodríguez@awesomenet.com,755124,ES73209503138719377420,1500.62,2022-06-03T10:39:16,Vitoria-Gasteiz,expenses,taxes,-1095.1,-6886.81
buyer_6,Manuel,Rodríguez,1979-02-14,27528818A,manuel.rodríguez@awesomenet.com,755124,ES73209503138719377420,1500.62,2022-06-03T10:50:38,Vitoria-Gasteiz,expenses,insurance,-356.22,-7243.03
buyer_6,Manuel,Rodríguez,1979-02-14,27528818A,manuel.rodríguez@awesomenet.com,755124,ES73209503138719377420,1500.62,2022-06-03T16:33:02,Vitoria-Gasteiz,expenses,transport,-58.54,-7301.57
buyer_6,Manuel,Rodríguez,1979-02-14,27528818A,manuel.rodríguez@awesomenet.com,755124,ES73209503138719377420,1500.62,2022-06-04T13:26:57,Vitoria-Gasteiz,expenses,mortgage,-782.29,-8083.86
buyer_6,Manuel,Rodríguez,1979-02-14,27528818A,manuel.rodríguez@awesomenet.com,755124,ES73209503138719377420,1500.62,2022-06-04T22:00:15,Vitoria-Gasteiz,expenses,transport,-57.6,-8141.46
buyer_6,Manuel,Rodríguez,1979-02-14,27528818A,manuel.rodríguez@awesomenet.com,755124,ES73209503138719377420,1500.62,2022-06-04T13:12:05,Vitoria-Gasteiz,expenses,cash,-100.0,-8241.46
buyer_6,Manuel,Rodríguez,1979-02-14,27528818A,manuel.rodríguez@awesomenet.com,755124,ES73209503138719377420,1500.62,2022-06-05T07:52:39,Vitoria-Gasteiz,expenses,gas,-32.98,-8274.44
buyer_6,Manuel,Rodríguez,1979-02-14,27528818A,manuel.rodríguez@awesomenet.com,755124,ES73209503138719377420,1500.62,2022-06-05T21:59:58,Vitoria-Gasteiz,expenses,internet,-31.62,-8306.06
buyer_6,Manuel,Rodríguez,1979-02-14,27528818A,manuel.rodríguez@awesomenet.com,755124,ES73209503138719377420,1500.62,2022-06-05T14:02:06,Vitoria-Gasteiz,expenses,food,-90.15,-8396.21
buyer_6,Manuel,Rodríguez,1979-02-14,27528818A,manuel.rodríguez@awesomenet.com,755124,ES73209503138719377420,1500.62,2022-06-06T09:01:46,Vitoria-Gasteiz,expenses,transport,-82.09,-8478.3
buyer_6,Manuel,Rodríguez,1979-02-14,27528818A,manuel.rodríguez@awesomenet.com,755124,ES73209503138719377420,1500.62,2022-06-07T10:53:13,Vitoria-Gasteiz,expenses,gas,-81.36,-8559.66
buyer_6,Manuel,Rodríguez,1979-02-14,27528818A,manuel.rodríguez@awesomenet.com,755124,ES73209503138719377420,1500.62,2022-06-08T16:41:38,Vitoria-Gasteiz,expenses,internet,-31.62,-8591.28
buyer_6,Manuel,Rodríguez,1979-02-14,27528818A,manuel.rodríguez@awesomenet.com,755124,ES73209503138719377420,1500.62,2022-06-13T12:26:58,Vitoria-Gasteiz,expenses,cash,-100.0,-8691.28
buyer_6,Manuel,Rodríguez,1979-02-14,27528818A,manuel.rodríguez@awesomenet.com,755124,ES73209503138719377420,1500.62,2022-06-14T19:26:15,Vitoria-Gasteiz,expenses,appliances,-119.31,-8810.59
buyer_6,Manuel,Rodríguez,1979-02-14,27528818A,manuel.rodríguez@awesomenet.com,755124,ES73209503138719377420,1500.62,2022-06-16T12:28:45,Vitoria-Gasteiz,expenses,food,-97.52,-8908.11
buyer_6,Manuel,Rodríguez,1979-02-14,27528818A,manuel.rodríguez@awesomenet.com,755124,ES73209503138719377420,1500.62,2022-06-16T18:54:20,Vitoria-Gasteiz,expenses,cash,-100.0,-9008.11
buyer_6,Manuel,Rodríguez,1979-02-14,27528818A,manuel.rodríguez@awesomenet.com,755124,ES73209503138719377420,1500.62,2022-06-19T16:09:08,Vitoria-Gasteiz,expenses,food,-123.49,-9131.6
buyer_6,Manuel,Rodríguez,1979-02-14,27528818A,manuel.rodríguez@awesomenet.com,755124,ES73209503138719377420,1500.62,2022-06-19T12:19:29,Vitoria-Gasteiz,expenses,appliances,-80.47,-9212.07
buyer_6,Manuel,Rodríguez,1979-02-14,27528818A,manuel.rodríguez@awesomenet.com,755124,ES73209503138719377420,1500.62,2022-06-20T08:11:00,Vitoria-Gasteiz,expenses,leisure,-67.85,-9279.92
buyer_6,Manuel,Rodríguez,1979-02-14,27528818A,manuel.rodríguez@awesomenet.com,755124,ES73209503138719377420,1500.62,2022-06-21T16:33:45,Vitoria-Gasteiz,expenses,food,-105.9,-9385.82
buyer_6,Manuel,Rodríguez,1979-02-14,27528818A,manuel.rodríguez@awesomenet.com,755124,ES73209503138719377420,1500.62,2022-06-21T19:05:06,Vitoria-Gasteiz,expenses,leisure,-80.37,-9466.19
buyer_6,Manuel,Rodríguez,1979-02-14,27528818A,manuel.rodríguez@awesomenet.com,755124,ES73209503138719377420,1500.62,2022-06-24T18:26:13,Vitoria-Gasteiz,expenses,cash,-100.0,-9566.19
buyer_6,Manuel,Rodríguez,1979-02-14,27528818A,manuel.rodríguez@awesomenet.com,755124,ES73209503138719377420,1500.62,2022-06-25T19:34:10,Vitoria-Gasteiz,expenses,food,-111.72,-9677.91
buyer_6,Manuel,Rodríguez,1979-02-14,27528818A,manuel.rodríguez@awesomenet.com,755124,ES73209503138719377420,1500.62,2022-06-25T16:19:11,Vitoria-Gasteiz,expenses,transport,-72.65,-9750.56
buyer_6,Manuel,Rodríguez,1979-02-14,27528818A,manuel.rodríguez@awesomenet.com,755124,ES73209503138719377420,1500.62,2022-06-27T04:31:02,Vitoria-Gasteiz,expenses,leisure,-49.87,-9800.43
buyer_6,Manuel,Rodríguez,1979-02-14,27528818A,manuel.rodríguez@awesomenet.com,755124,ES73209503138719377420,1500.62,2022-06-27T22:56:47,Vitoria-Gasteiz,expenses,gifts,-205.56,-10005.99
buyer_6,Manuel,Rodríguez,1979-02-14,27528818A,manuel.rodríguez@awesomenet.com,755124,ES73209503138719377420,1500.62,2022-06-28T15:57:29,Vitoria-Gasteiz,expenses,transport,-58.25,-10064.24
buyer_6,Manuel,Rodríguez,1979-02-14,27528818A,manuel.rodríguez@awesomenet.com,755124,ES73209503138719377420,1500.62,2022-06-28T14:03:04,Vitoria-Gasteiz,expenses,repairs,-137.65,-10201.89
buyer_6,Manuel,Rodríguez,1979-02-14,27528818A,manuel.rodríguez@awesomenet.com,755124,ES73209503138719377420,1500.62,2022-06-29T14:56:05,Vitoria-Gasteiz,expenses,food,-96.09,-10297.98
buyer_6,Manuel,Rodríguez,1979-02-14,27528818A,manuel.rodríguez@awesomenet.com,755124,ES73209503138719377420,1500.62,2022-06-30T10:39:13,Vitoria-Gasteiz,expenses,cash,-100.0,-10397.98
buyer_6,Manuel,Rodríguez,1979-02-14,27528818A,manuel.rodríguez@awesomenet.com,755124,ES73209503138719377420,1500.62,2022-06-30T08:21:38,Vitoria-Gasteiz,expenses,gifts,-346.07,-10744.05
buyer_6,Manuel,Rodríguez,1979-02-14,27528818A,manuel.rodríguez@awesomenet.com,755124,ES73209503138719377420,1500.62,2022-07-01T20:22:55,Vitoria-Gasteiz,incomes,salary,1505.49,-9238.56
buyer_6,Manuel,Rodríguez,1979-02-14,27528818A,manuel.rodríguez@awesomenet.com,755124,ES73209503138719377420,1500.62,2022-07-01T08:30:00,Vitoria-Gasteiz,expenses,transport,-54.5,-9293.06
buyer_6,Manuel,Rodríguez,1979-02-14,27528818A,manuel.rodríguez@awesomenet.com,755124,ES73209503138719377420,1500.62,2022-07-03T11:50:17,Vitoria-Gasteiz,expenses,education,-56.82,-9349.88
buyer_6,Manuel,Rodríguez,1979-02-14,27528818A,manuel.rodríguez@awesomenet.com,755124,ES73209503138719377420,1500.62,2022-07-03T16:18:57,Vitoria-Gasteiz,expenses,cash,-100.0,-9449.88
buyer_6,Manuel,Rodríguez,1979-02-14,27528818A,manuel.rodríguez@awesomenet.com,755124,ES73209503138719377420,1500.62,2022-07-04T12:12:03,Vitoria-Gasteiz,expenses,mortgage,-782.29,-10232.17
buyer_6,Manuel,Rodríguez,1979-02-14,27528818A,manuel.rodríguez@awesomenet.com,755124,ES73209503138719377420,1500.62,2022-07-04T13:01:59,Vitoria-Gasteiz,expenses,cash,-100.0,-10332.17
buyer_6,Manuel,Rodríguez,1979-02-14,27528818A,manuel.rodríguez@awesomenet.com,755124,ES73209503138719377420,1500.62,2022-07-05T10:50:48,Vitoria-Gasteiz,expenses,gas,-69.72,-10401.89
buyer_6,Manuel,Rodríguez,1979-02-14,27528818A,manuel.rodríguez@awesomenet.com,755124,ES73209503138719377420,1500.62,2022-07-05T09:32:23,Vitoria-Gasteiz,expenses,clothing,-136.97,-10538.86
buyer_6,Manuel,Rodríguez,1979-02-14,27528818A,manuel.rodríguez@awesomenet.com,755124,ES73209503138719377420,1500.62,2022-07-06T13:43:26,Vitoria-Gasteiz,expenses,electricity,-22.38,-10561.24
buyer_6,Manuel,Rodríguez,1979-02-14,27528818A,manuel.rodríguez@awesomenet.com,755124,ES73209503138719377420,1500.62,2022-07-06T17:21:48,Vitoria-Gasteiz,expenses,phone,-28.7,-10589.94
buyer_6,Manuel,Rodríguez,1979-02-14,27528818A,manuel.rodríguez@awesomenet.com,755124,ES73209503138719377420,1500.62,2022-07-07T17:14:13,Vitoria-Gasteiz,expenses,water,-23.64,-10613.58
buyer_6,Manuel,Rodríguez,1979-02-14,27528818A,manuel.rodríguez@awesomenet.com,755124,ES73209503138719377420,1500.62,2022-07-07T20:28:13,Vitoria-Gasteiz,expenses,internet,-31.62,-10645.2
buyer_6,Manuel,Rodríguez,1979-02-14,27528818A,manuel.rodríguez@awesomenet.com,755124,ES73209503138719377420,1500.62,2022-07-07T17:16:14,Vitoria-Gasteiz,expenses,phone,-26.03,-10671.23
buyer_6,Manuel,Rodríguez,1979-02-14,27528818A,manuel.rodríguez@awesomenet.com,755124,ES73209503138719377420,1500.62,2022-07-08T12:25:42,Vitoria-Gasteiz,expenses,water,-29.23,-10700.46
buyer_6,Manuel,Rodríguez,1979-02-14,27528818A,manuel.rodríguez@awesomenet.com,755124,ES73209503138719377420,1500.62,2022-07-08T10:29:02,Vitoria-Gasteiz,expenses,phone,-32.02,-10732.48
buyer_6,Manuel,Rodríguez,1979-02-14,27528818A,manuel.rodríguez@awesomenet.com,755124,ES73209503138719377420,1500.62,2022-07-08T20:27:45,Vitoria-Gasteiz,expenses,leisure,-45.81,-10778.29
buyer_6,Manuel,Rodríguez,1979-02-14,27528818A,manuel.rodríguez@awesomenet.com,755124,ES73209503138719377420,1500.62,2022-07-08T19:21:59,Vitoria-Gasteiz,expenses,cash,-100.0,-10878.29
buyer_6,Manuel,Rodríguez,1979-02-14,27528818A,manuel.rodríguez@awesomenet.com,755124,ES73209503138719377420,1500.62,2022-07-09T09:00:57,Vitoria-Gasteiz,expenses,cash,-100.0,-10978.29
buyer_6,Manuel,Rodríguez,1979-02-14,27528818A,manuel.rodríguez@awesomenet.com,755124,ES73209503138719377420,1500.62,2022-07-10T07:44:04,Vitoria-Gasteiz,expenses,leisure,-77.1,-11055.39
buyer_6,Manuel,Rodríguez,1979-02-14,27528818A,manuel.rodríguez@awesomenet.com,755124,ES73209503138719377420,1500.62,2022-07-10T11:53:29,Vitoria-Gasteiz,expenses,appliances,-273.71,-11329.1
buyer_6,Manuel,Rodríguez,1979-02-14,27528818A,manuel.rodríguez@awesomenet.com,755124,ES73209503138719377420,1500.62,2022-07-11T12:20:28,Vitoria-Gasteiz,expenses,gifts,-154.42,-11483.52
buyer_6,Manuel,Rodríguez,1979-02-14,27528818A,manuel.rodríguez@awesomenet.com,755124,ES73209503138719377420,1500.62,2022-07-12T22:17:01,Vitoria-Gasteiz,expenses,transport,-69.66,-11553.18
buyer_6,Manuel,Rodríguez,1979-02-14,27528818A,manuel.rodríguez@awesomenet.com,755124,ES73209503138719377420,1500.62,2022-07-13T09:06:24,Vitoria-Gasteiz,expenses,leisure,-71.52,-11624.7
buyer_6,Manuel,Rodríguez,1979-02-14,27528818A,manuel.rodríguez@awesomenet.com,755124,ES73209503138719377420,1500.62,2022-07-15T14:21:20,Vitoria-Gasteiz,expenses,food,-90.66,-11715.36
buyer_6,Manuel,Rodríguez,1979-02-14,27528818A,manuel.rodríguez@awesomenet.com,755124,ES73209503138719377420,1500.62,2022-07-16T10:19:55,Vitoria-Gasteiz,expenses,gifts,-437.44,-12152.8
buyer_6,Manuel,Rodríguez,1979-02-14,27528818A,manuel.rodríguez@awesomenet.com,755124,ES73209503138719377420,1500.62,2022-07-18T15:52:41,Vitoria-Gasteiz,expenses,food,-121.06,-12273.86
buyer_6,Manuel,Rodríguez,1979-02-14,27528818A,manuel.rodríguez@awesomenet.com,755124,ES73209503138719377420,1500.62,2022-07-25T16:59:12,Vitoria-Gasteiz,expenses,food,-97.85,-12371.71
buyer_6,Manuel,Rodríguez,1979-02-14,27528818A,manuel.rodríguez@awesomenet.com,755124,ES73209503138719377420,1500.62,2022-07-27T18:52:27,Vitoria-Gasteiz,expenses,food,-104.7,-12476.41
buyer_6,Manuel,Rodríguez,1979-02-14,27528818A,manuel.rodríguez@awesomenet.com,755124,ES73209503138719377420,1500.62,2022-07-27T13:51:00,Vitoria-Gasteiz,expenses,leisure,-22.87,-12499.28
buyer_6,Manuel,Rodríguez,1979-02-14,27528818A,manuel.rodríguez@awesomenet.com,755124,ES73209503138719377420,1500.62,2022-07-27T15:48:42,Vitoria-Gasteiz,expenses,cash,-100.0,-12599.28
buyer_6,Manuel,Rodríguez,1979-02-14,27528818A,manuel.rodríguez@awesomenet.com,755124,ES73209503138719377420,1500.62,2022-07-28T13:26:08,Vitoria-Gasteiz,expenses,leisure,-28.28,-12627.56
buyer_6,Manuel,Rodríguez,1979-02-14,27528818A,manuel.rodríguez@awesomenet.com,755124,ES73209503138719377420,1500.62,2022-07-29T17:49:14,Vitoria-Gasteiz,expenses,leisure,-68.8,-12696.36
buyer_6,Manuel,Rodríguez,1979-02-14,27528818A,manuel.rodríguez@awesomenet.com,755124,ES73209503138719377420,1500.62,2022-07-30T22:58:38,Vitoria-Gasteiz,expenses,cash,-100.0,-12796.36
buyer_6,Manuel,Rodríguez,1979-02-14,27528818A,manuel.rodríguez@awesomenet.com,755124,ES73209503138719377420,1500.62,2022-07-31T19:12:17,Vitoria-Gasteiz,expenses,leisure,-46.7,-12843.06
buyer_6,Manuel,Rodríguez,1979-02-14,27528818A,manuel.rodríguez@awesomenet.com,755124,ES73209503138719377420,1500.62,2022-08-01T15:04:00,Vitoria-Gasteiz,incomes,salary,1505.49,-11337.57
buyer_6,Manuel,Rodríguez,1979-02-14,27528818A,manuel.rodríguez@awesomenet.com,755124,ES73209503138719377420,1500.62,2022-08-01T15:04:00,Vitoria-Gasteiz,incomes,extra_income,161.05,-11176.52
buyer_6,Manuel,Rodríguez,1979-02-14,27528818A,manuel.rodríguez@awesomenet.com,755124,ES73209503138719377420,1500.62,2022-08-01T10:48:48,Vitoria-Gasteiz,expenses,leisure,-28.03,-11204.55
buyer_6,Manuel,Rodríguez,1979-02-14,27528818A,manuel.rodríguez@awesomenet.com,755124,ES73209503138719377420,1500.62,2022-08-01T20:33:21,Vitoria-Gasteiz,expenses,clothing,-78.18,-11282.73
buyer_6,Manuel,Rodríguez,1979-02-14,27528818A,manuel.rodríguez@awesomenet.com,755124,ES73209503138719377420,1500.62,2022-08-02T22:54:12,Vitoria-Gasteiz,expenses,food,-73.88,-11356.61
buyer_6,Manuel,Rodríguez,1979-02-14,27528818A,manuel.rodríguez@awesomenet.com,755124,ES73209503138719377420,1500.62,2022-08-02T14:23:49,Vitoria-Gasteiz,expenses,transport,-45.88,-11402.49
buyer_6,Manuel,Rodríguez,1979-02-14,27528818A,manuel.rodríguez@awesomenet.com,755124,ES73209503138719377420,1500.62,2022-08-04T23:42:52,Vitoria-Gasteiz,expenses,mortgage,-782.29,-12184.78
buyer_6,Manuel,Rodríguez,1979-02-14,27528818A,manuel.rodríguez@awesomenet.com,755124,ES73209503138719377420,1500.62,2022-08-04T08:32:15,Vitoria-Gasteiz,expenses,cash,-100.0,-12284.78
buyer_6,Manuel,Rodríguez,1979-02-14,27528818A,manuel.rodríguez@awesomenet.com,755124,ES73209503138719377420,1500.62,2022-08-05T20:28:37,Vitoria-Gasteiz,expenses,gas,-51.93,-12336.71
buyer_6,Manuel,Rodríguez,1979-02-14,27528818A,manuel.rodríguez@awesomenet.com,755124,ES73209503138719377420,1500.62,2022-08-05T23:33:47,Vitoria-Gasteiz,expenses,internet,-31.62,-12368.33
buyer_6,Manuel,Rodríguez,1979-02-14,27528818A,manuel.rodríguez@awesomenet.com,755124,ES73209503138719377420,1500.62,2022-08-05T16:57:38,Vitoria-Gasteiz,expenses,healthcare,-181.1,-12549.43
buyer_6,Manuel,Rodríguez,1979-02-14,27528818A,manuel.rodríguez@awesomenet.com,755124,ES73209503138719377420,1500.62,2022-08-06T08:55:56,Vitoria-Gasteiz,expenses,internet,-31.62,-12581.05
buyer_6,Manuel,Rodríguez,1979-02-14,27528818A,manuel.rodríguez@awesomenet.com,755124,ES73209503138719377420,1500.62,2022-08-07T23:42:10,Vitoria-Gasteiz,expenses,education,-44.76,-12625.81
buyer_6,Manuel,Rodríguez,1979-02-14,27528818A,manuel.rodríguez@awesomenet.com,755124,ES73209503138719377420,1500.62,2022-08-08T09:29:25,Vitoria-Gasteiz,expenses,phone,-23.95,-12649.76
buyer_6,Manuel,Rodríguez,1979-02-14,27528818A,manuel.rodríguez@awesomenet.com,755124,ES73209503138719377420,1500.62,2022-08-12T10:17:12,Vitoria-Gasteiz,expenses,gifts,-552.8,-13202.56
buyer_6,Manuel,Rodríguez,1979-02-14,27528818A,manuel.rodríguez@awesomenet.com,755124,ES73209503138719377420,1500.62,2022-08-13T15:40:47,Vitoria-Gasteiz,expenses,leisure,-66.22,-13268.78
buyer_6,Manuel,Rodríguez,1979-02-14,27528818A,manuel.rodríguez@awesomenet.com,755124,ES73209503138719377420,1500.62,2022-08-13T16:53:05,Vitoria-Gasteiz,expenses,education,-50.62,-13319.4
buyer_6,Manuel,Rodríguez,1979-02-14,27528818A,manuel.rodríguez@awesomenet.com,755124,ES73209503138719377420,1500.62,2022-08-16T09:52:36,Vitoria-Gasteiz,expenses,transport,-79.77,-13399.17
buyer_6,Manuel,Rodríguez,1979-02-14,27528818A,manuel.rodríguez@awesomenet.com,755124,ES73209503138719377420,1500.62,2022-08-16T08:11:54,Vitoria-Gasteiz,expenses,cash,-100.0,-13499.17
buyer_6,Manuel,Rodríguez,1979-02-14,27528818A,manuel.rodríguez@awesomenet.com,755124,ES73209503138719377420,1500.62,2022-08-16T13:06:37,Vitoria-Gasteiz,expenses,repairs,-27.15,-13526.32
buyer_6,Manuel,Rodríguez,1979-02-14,27528818A,manuel.rodríguez@awesomenet.com,755124,ES73209503138719377420,1500.62,2022-08-17T15:21:56,Vitoria-Gasteiz,expenses,transport,-78.58,-13604.9
buyer_6,Manuel,Rodríguez,1979-02-14,27528818A,manuel.rodríguez@awesomenet.com,755124,ES73209503138719377420,1500.62,2022-08-19T15:35:09,Vitoria-Gasteiz,expenses,gifts,-553.63,-14158.53
buyer_6,Manuel,Rodríguez,1979-02-14,27528818A,manuel.rodríguez@awesomenet.com,755124,ES73209503138719377420,1500.62,2022-08-21T12:23:12,Vitoria-Gasteiz,expenses,clothing,-140.78,-14299.31
buyer_6,Manuel,Rodríguez,1979-02-14,27528818A,manuel.rodríguez@awesomenet.com,755124,ES73209503138719377420,1500.62,2022-08-21T18:10:35,Vitoria-Gasteiz,expenses,repairs,-45.47,-14344.78
buyer_6,Manuel,Rodríguez,1979-02-14,27528818A,manuel.rodríguez@awesomenet.com,755124,ES73209503138719377420,1500.62,2022-08-23T19:26:17,Vitoria-Gasteiz,expenses,cash,-100.0,-14444.78
buyer_6,Manuel,Rodríguez,1979-02-14,27528818A,manuel.rodríguez@awesomenet.com,755124,ES73209503138719377420,1500.62,2022-08-24T10:53:17,Vitoria-Gasteiz,expenses,leisure,-21.43,-14466.21
buyer_6,Manuel,Rodríguez,1979-02-14,27528818A,manuel.rodríguez@awesomenet.com,755124,ES73209503138719377420,1500.62,2022-08-25T16:54:53,Vitoria-Gasteiz,expenses,education,-54.38,-14520.59
buyer_6,Manuel,Rodríguez,1979-02-14,27528818A,manuel.rodríguez@awesomenet.com,755124,ES73209503138719377420,1500.62,2022-08-25T17:05:24,Vitoria-Gasteiz,expenses,gifts,-54.69,-14575.28
buyer_6,Manuel,Rodríguez,1979-02-14,27528818A,manuel.rodríguez@awesomenet.com,755124,ES73209503138719377420,1500.62,2022-08-28T19:49:29,Vitoria-Gasteiz,expenses,gifts,-556.29,-15131.57
buyer_6,Manuel,Rodríguez,1979-02-14,27528818A,manuel.rodríguez@awesomenet.com,755124,ES73209503138719377420,1500.62,2022-08-29T18:13:49,Vitoria-Gasteiz,expenses,leisure,-18.06,-15149.63
buyer_6,Manuel,Rodríguez,1979-02-14,27528818A,manuel.rodríguez@awesomenet.com,755124,ES73209503138719377420,1500.62,2022-08-30T14:01:46,Vitoria-Gasteiz,expenses,leisure,-66.42,-15216.05
buyer_6,Manuel,Rodríguez,1979-02-14,27528818A,manuel.rodríguez@awesomenet.com,755124,ES73209503138719377420,1500.62,2022-08-30T19:34:18,Vitoria-Gasteiz,expenses,repairs,-241.3,-15457.35
buyer_6,Manuel,Rodríguez,1979-02-14,27528818A,manuel.rodríguez@awesomenet.com,755124,ES73209503138719377420,1500.62,2022-08-31T05:39:03,Vitoria-Gasteiz,expenses,repairs,-97.03,-15554.38
buyer_6,Manuel,Rodríguez,1979-02-14,27528818A,manuel.rodríguez@awesomenet.com,755124,ES73209503138719377420,1500.62,2022-08-31T09:11:25,Vitoria-Gasteiz,expenses,gifts,-25.4,-15579.78
buyer_6,Manuel,Rodríguez,1979-02-14,27528818A,manuel.rodríguez@awesomenet.com,755124,ES73209503138719377420,1500.62,2022-09-01T12:37:25,Vitoria-Gasteiz,incomes,salary,1505.49,-14074.29
buyer_6,Manuel,Rodríguez,1979-02-14,27528818A,manuel.rodríguez@awesomenet.com,755124,ES73209503138719377420,1500.62,2022-09-01T12:43:05,Vitoria-Gasteiz,expenses,transport,-46.66,-14120.95
buyer_6,Manuel,Rodríguez,1979-02-14,27528818A,manuel.rodríguez@awesomenet.com,755124,ES73209503138719377420,1500.62,2022-09-03T20:58:59,Vitoria-Gasteiz,expenses,leisure,-19.07,-14140.02
buyer_6,Manuel,Rodríguez,1979-02-14,27528818A,manuel.rodríguez@awesomenet.com,755124,ES73209503138719377420,1500.62,2022-09-03T18:55:13,Vitoria-Gasteiz,expenses,cash,-100.0,-14240.02
buyer_6,Manuel,Rodríguez,1979-02-14,27528818A,manuel.rodríguez@awesomenet.com,755124,ES73209503138719377420,1500.62,2022-09-04T10:52:40,Vitoria-Gasteiz,expenses,mortgage,-782.29,-15022.31
buyer_6,Manuel,Rodríguez,1979-02-14,27528818A,manuel.rodríguez@awesomenet.com,755124,ES73209503138719377420,1500.62,2022-09-04T09:48:57,Vitoria-Gasteiz,expenses,food,-108.8,-15131.11
buyer_6,Manuel,Rodríguez,1979-02-14,27528818A,manuel.rodríguez@awesomenet.com,755124,ES73209503138719377420,1500.62,2022-09-06T20:52:10,Vitoria-Gasteiz,expenses,water,-17.47,-15148.58
buyer_6,Manuel,Rodríguez,1979-02-14,27528818A,manuel.rodríguez@awesomenet.com,755124,ES73209503138719377420,1500.62,2022-09-06T08:13:16,Vitoria-Gasteiz,expenses,internet,-31.62,-15180.2
buyer_6,Manuel,Rodríguez,1979-02-14,27528818A,manuel.rodríguez@awesomenet.com,755124,ES73209503138719377420,1500.62,2022-09-06T23:58:10,Vitoria-Gasteiz,expenses,transport,-87.43,-15267.63
buyer_6,Manuel,Rodríguez,1979-02-14,27528818A,manuel.rodríguez@awesomenet.com,755124,ES73209503138719377420,1500.62,2022-09-07T15:38:53,Vitoria-Gasteiz,expenses,phone,-28.33,-15295.96
buyer_6,Manuel,Rodríguez,1979-02-14,27528818A,manuel.rodríguez@awesomenet.com,755124,ES73209503138719377420,1500.62,2022-09-07T23:27:02,Vitoria-Gasteiz,expenses,leisure,-62.34,-15358.3
buyer_6,Manuel,Rodríguez,1979-02-14,27528818A,manuel.rodríguez@awesomenet.com,755124,ES73209503138719377420,1500.62,2022-09-07T17:53:31,Vitoria-Gasteiz,expenses,cash,-100.0,-15458.3
buyer_6,Manuel,Rodríguez,1979-02-14,27528818A,manuel.rodríguez@awesomenet.com,755124,ES73209503138719377420,1500.62,2022-09-08T14:20:11,Vitoria-Gasteiz,expenses,cash,-100.0,-15558.3
buyer_6,Manuel,Rodríguez,1979-02-14,27528818A,manuel.rodríguez@awesomenet.com,755124,ES73209503138719377420,1500.62,2022-09-11T23:45:55,Vitoria-Gasteiz,expenses,food,-69.2,-15627.5
buyer_6,Manuel,Rodríguez,1979-02-14,27528818A,manuel.rodríguez@awesomenet.com,755124,ES73209503138719377420,1500.62,2022-09-11T21:38:41,Vitoria-Gasteiz,expenses,clothing,-119.4,-15746.9
buyer_6,Manuel,Rodríguez,1979-02-14,27528818A,manuel.rodríguez@awesomenet.com,755124,ES73209503138719377420,1500.62,2022-09-11T15:06:29,Vitoria-Gasteiz,expenses,education,-42.42,-15789.32
buyer_6,Manuel,Rodríguez,1979-02-14,27528818A,manuel.rodríguez@awesomenet.com,755124,ES73209503138719377420,1500.62,2022-09-11T17:05:26,Vitoria-Gasteiz,expenses,appliances,-82.09,-15871.41
buyer_6,Manuel,Rodríguez,1979-02-14,27528818A,manuel.rodríguez@awesomenet.com,755124,ES73209503138719377420,1500.62,2022-09-12T12:16:48,Vitoria-Gasteiz,expenses,food,-116.98,-15988.39
buyer_6,Manuel,Rodríguez,1979-02-14,27528818A,manuel.rodríguez@awesomenet.com,755124,ES73209503138719377420,1500.62,2022-09-14T09:37:31,Vitoria-Gasteiz,expenses,food,-115.52,-16103.91
buyer_6,Manuel,Rodríguez,1979-02-14,27528818A,manuel.rodríguez@awesomenet.com,755124,ES73209503138719377420,1500.62,2022-09-15T09:00:56,Vitoria-Gasteiz,expenses,cash,-100.0,-16203.91
buyer_6,Manuel,Rodríguez,1979-02-14,27528818A,manuel.rodríguez@awesomenet.com,755124,ES73209503138719377420,1500.62,2022-09-17T12:27:19,Vitoria-Gasteiz,expenses,transport,-79.68,-16283.59
buyer_6,Manuel,Rodríguez,1979-02-14,27528818A,manuel.rodríguez@awesomenet.com,755124,ES73209503138719377420,1500.62,2022-09-18T10:16:38,Vitoria-Gasteiz,expenses,healthcare,-157.08,-16440.67
buyer_6,Manuel,Rodríguez,1979-02-14,27528818A,manuel.rodríguez@awesomenet.com,755124,ES73209503138719377420,1500.62,2022-09-18T02:41:36,Vitoria-Gasteiz,expenses,cash,-100.0,-16540.67
buyer_6,Manuel,Rodríguez,1979-02-14,27528818A,manuel.rodríguez@awesomenet.com,755124,ES73209503138719377420,1500.62,2022-09-18T19:12:09,Vitoria-Gasteiz,expenses,gifts,-261.38,-16802.05
buyer_6,Manuel,Rodríguez,1979-02-14,27528818A,manuel.rodríguez@awesomenet.com,755124,ES73209503138719377420,1500.62,2022-09-19T09:01:20,Vitoria-Gasteiz,expenses,healthcare,-178.84,-16980.89
buyer_6,Manuel,Rodríguez,1979-02-14,27528818A,manuel.rodríguez@awesomenet.com,755124,ES73209503138719377420,1500.62,2022-09-23T18:16:08,Vitoria-Gasteiz,expenses,transport,-49.75,-17030.64
buyer_6,Manuel,Rodríguez,1979-02-14,27528818A,manuel.rodríguez@awesomenet.com,755124,ES73209503138719377420,1500.62,2022-09-24T15:59:25,Vitoria-Gasteiz,expenses,food,-104.81,-17135.45
buyer_6,Manuel,Rodríguez,1979-02-14,27528818A,manuel.rodríguez@awesomenet.com,755124,ES73209503138719377420,1500.62,2022-09-24T19:07:48,Vitoria-Gasteiz,expenses,leisure,-75.48,-17210.93
buyer_6,Manuel,Rodríguez,1979-02-14,27528818A,manuel.rodríguez@awesomenet.com,755124,ES73209503138719377420,1500.62,2022-09-24T12:11:05,Vitoria-Gasteiz,expenses,gifts,-55.39,-17266.32
buyer_6,Manuel,Rodríguez,1979-02-14,27528818A,manuel.rodríguez@awesomenet.com,755124,ES73209503138719377420,1500.62,2022-09-25T11:58:55,Vitoria-Gasteiz,expenses,transport,-43.77,-17310.09
buyer_6,Manuel,Rodríguez,1979-02-14,27528818A,manuel.rodríguez@awesomenet.com,755124,ES73209503138719377420,1500.62,2022-09-30T15:06:58,Vitoria-Gasteiz,expenses,leisure,-21.6,-17331.69
buyer_6,Manuel,Rodríguez,1979-02-14,27528818A,manuel.rodríguez@awesomenet.com,755124,ES73209503138719377420,1500.62,2022-10-01T23:34:19,Vitoria-Gasteiz,incomes,salary,1505.49,-15826.2
buyer_6,Manuel,Rodríguez,1979-02-14,27528818A,manuel.rodríguez@awesomenet.com,755124,ES73209503138719377420,1500.62,2022-10-01T20:41:06,Vitoria-Gasteiz,expenses,leisure,-57.25,-15883.45
buyer_6,Manuel,Rodríguez,1979-02-14,27528818A,manuel.rodríguez@awesomenet.com,755124,ES73209503138719377420,1500.62,2022-10-04T14:59:54,Vitoria-Gasteiz,expenses,mortgage,-782.29,-16665.74
buyer_6,Manuel,Rodríguez,1979-02-14,27528818A,manuel.rodríguez@awesomenet.com,755124,ES73209503138719377420,1500.62,2022-10-06T15:57:50,Vitoria-Gasteiz,expenses,internet,-31.62,-16697.36
buyer_6,Manuel,Rodríguez,1979-02-14,27528818A,manuel.rodríguez@awesomenet.com,755124,ES73209503138719377420,1500.62,2022-10-06T04:16:44,Vitoria-Gasteiz,expenses,phone,-22.61,-16719.97
buyer_6,Manuel,Rodríguez,1979-02-14,27528818A,manuel.rodríguez@awesomenet.com,755124,ES73209503138719377420,1500.62,2022-10-06T16:02:27,Vitoria-Gasteiz,expenses,healthcare,-64.83,-16784.8
buyer_6,Manuel,Rodríguez,1979-02-14,27528818A,manuel.rodríguez@awesomenet.com,755124,ES73209503138719377420,1500.62,2022-10-06T15:44:26,Vitoria-Gasteiz,expenses,cash,-100.0,-16884.8
buyer_6,Manuel,Rodríguez,1979-02-14,27528818A,manuel.rodríguez@awesomenet.com,755124,ES73209503138719377420,1500.62,2022-10-07T08:15:42,Vitoria-Gasteiz,expenses,phone,-30.45,-16915.25
buyer_6,Manuel,Rodríguez,1979-02-14,27528818A,manuel.rodríguez@awesomenet.com,755124,ES73209503138719377420,1500.62,2022-10-08T18:58:01,Vitoria-Gasteiz,expenses,electricity,-26.36,-16941.61
buyer_6,Manuel,Rodríguez,1979-02-14,27528818A,manuel.rodríguez@awesomenet.com,755124,ES73209503138719377420,1500.62,2022-10-08T13:05:28,Vitoria-Gasteiz,expenses,internet,-31.62,-16973.23
buyer_6,Manuel,Rodríguez,1979-02-14,27528818A,manuel.rodríguez@awesomenet.com,755124,ES73209503138719377420,1500.62,2022-10-08T00:08:09,Vitoria-Gasteiz,expenses,leisure,-47.54,-17020.77
buyer_6,Manuel,Rodríguez,1979-02-14,27528818A,manuel.rodríguez@awesomenet.com,755124,ES73209503138719377420,1500.62,2022-10-09T18:25:16,Vitoria-Gasteiz,expenses,food,-96.41,-17117.18
buyer_6,Manuel,Rodríguez,1979-02-14,27528818A,manuel.rodríguez@awesomenet.com,755124,ES73209503138719377420,1500.62,2022-10-10T02:42:55,Vitoria-Gasteiz,expenses,travel,-403.59,-17520.77
buyer_6,Manuel,Rodríguez,1979-02-14,27528818A,manuel.rodríguez@awesomenet.com,755124,ES73209503138719377420,1500.62,2022-10-11T10:58:46,Vitoria-Gasteiz,expenses,transport,-44.39,-17565.16
buyer_6,Manuel,Rodríguez,1979-02-14,27528818A,manuel.rodríguez@awesomenet.com,755124,ES73209503138719377420,1500.62,2022-10-11T08:57:24,Vitoria-Gasteiz,expenses,leisure,-71.5,-17636.66
buyer_6,Manuel,Rodríguez,1979-02-14,27528818A,manuel.rodríguez@awesomenet.com,755124,ES73209503138719377420,1500.62,2022-10-11T16:41:05,Vitoria-Gasteiz,expenses,cash,-100.0,-17736.66
buyer_6,Manuel,Rodríguez,1979-02-14,27528818A,manuel.rodríguez@awesomenet.com,755124,ES73209503138719377420,1500.62,2022-10-13T21:47:57,Vitoria-Gasteiz,expenses,gifts,-484.28,-18220.94
buyer_6,Manuel,Rodríguez,1979-02-14,27528818A,manuel.rodríguez@awesomenet.com,755124,ES73209503138719377420,1500.62,2022-10-14T13:17:37,Vitoria-Gasteiz,expenses,transport,-65.8,-18286.74
buyer_6,Manuel,Rodríguez,1979-02-14,27528818A,manuel.rodríguez@awesomenet.com,755124,ES73209503138719377420,1500.62,2022-10-14T20:07:57,Vitoria-Gasteiz,expenses,clothing,-94.94,-18381.68
buyer_6,Manuel,Rodríguez,1979-02-14,27528818A,manuel.rodríguez@awesomenet.com,755124,ES73209503138719377420,1500.62,2022-10-14T14:54:08,Vitoria-Gasteiz,expenses,cash,-100.0,-18481.68
buyer_6,Manuel,Rodríguez,1979-02-14,27528818A,manuel.rodríguez@awesomenet.com,755124,ES73209503138719377420,1500.62,2022-10-15T09:14:13,Vitoria-Gasteiz,expenses,transport,-55.13,-18536.81
buyer_6,Manuel,Rodríguez,1979-02-14,27528818A,manuel.rodríguez@awesomenet.com,755124,ES73209503138719377420,1500.62,2022-10-15T16:33:00,Vitoria-Gasteiz,expenses,gifts,-268.9,-18805.71
buyer_6,Manuel,Rodríguez,1979-02-14,27528818A,manuel.rodríguez@awesomenet.com,755124,ES73209503138719377420,1500.62,2022-10-17T19:59:56,Vitoria-Gasteiz,expenses,cash,-100.0,-18905.71
buyer_6,Manuel,Rodríguez,1979-02-14,27528818A,manuel.rodríguez@awesomenet.com,755124,ES73209503138719377420,1500.62,2022-10-19T08:16:10,Vitoria-Gasteiz,expenses,food,-72.15,-18977.86
buyer_6,Manuel,Rodríguez,1979-02-14,27528818A,manuel.rodríguez@awesomenet.com,755124,ES73209503138719377420,1500.62,2022-10-20T10:44:37,Vitoria-Gasteiz,expenses,food,-66.55,-19044.41
buyer_6,Manuel,Rodríguez,1979-02-14,27528818A,manuel.rodríguez@awesomenet.com,755124,ES73209503138719377420,1500.62,2022-10-20T13:51:54,Vitoria-Gasteiz,expenses,cash,-100.0,-19144.41
buyer_6,Manuel,Rodríguez,1979-02-14,27528818A,manuel.rodríguez@awesomenet.com,755124,ES73209503138719377420,1500.62,2022-10-21T08:31:15,Vitoria-Gasteiz,expenses,transport,-81.02,-19225.43
buyer_6,Manuel,Rodríguez,1979-02-14,27528818A,manuel.rodríguez@awesomenet.com,755124,ES73209503138719377420,1500.62,2022-10-21T00:24:47,Vitoria-Gasteiz,expenses,cash,-100.0,-19325.43
buyer_6,Manuel,Rodríguez,1979-02-14,27528818A,manuel.rodríguez@awesomenet.com,755124,ES73209503138719377420,1500.62,2022-10-22T18:51:04,Vitoria-Gasteiz,expenses,leisure,-77.12,-19402.55
buyer_6,Manuel,Rodríguez,1979-02-14,27528818A,manuel.rodríguez@awesomenet.com,755124,ES73209503138719377420,1500.62,2022-10-22T16:52:07,Vitoria-Gasteiz,expenses,healthcare,-168.91,-19571.46
buyer_6,Manuel,Rodríguez,1979-02-14,27528818A,manuel.rodríguez@awesomenet.com,755124,ES73209503138719377420,1500.62,2022-10-24T02:54:57,Vitoria-Gasteiz,expenses,cash,-100.0,-19671.46
buyer_6,Manuel,Rodríguez,1979-02-14,27528818A,manuel.rodríguez@awesomenet.com,755124,ES73209503138719377420,1500.62,2022-10-26T13:28:58,Vitoria-Gasteiz,expenses,cash,-100.0,-19771.46
buyer_6,Manuel,Rodríguez,1979-02-14,27528818A,manuel.rodríguez@awesomenet.com,755124,ES73209503138719377420,1500.62,2022-10-27T15:17:14,Vitoria-Gasteiz,expenses,clothing,-65.87,-19837.33
buyer_6,Manuel,Rodríguez,1979-02-14,27528818A,manuel.rodríguez@awesomenet.com,755124,ES73209503138719377420,1500.62,2022-10-28T09:32:55,Vitoria-Gasteiz,expenses,cash,-100.0,-19937.33
buyer_6,Manuel,Rodríguez,1979-02-14,27528818A,manuel.rodríguez@awesomenet.com,755124,ES73209503138719377420,1500.62,2022-10-30T14:39:12,Vitoria-Gasteiz,expenses,food,-79.6,-20016.93
buyer_6,Manuel,Rodríguez,1979-02-14,27528818A,manuel.rodríguez@awesomenet.com,755124,ES73209503138719377420,1500.62,2022-10-30T20:50:11,Vitoria-Gasteiz,expenses,healthcare,-38.75,-20055.68
buyer_6,Manuel,Rodríguez,1979-02-14,27528818A,manuel.rodríguez@awesomenet.com,755124,ES73209503138719377420,1500.62,2022-10-31T16:18:53,Vitoria-Gasteiz,expenses,food,-91.56,-20147.24
buyer_6,Manuel,Rodríguez,1979-02-14,27528818A,manuel.rodríguez@awesomenet.com,755124,ES73209503138719377420,1500.62,2022-11-01T08:08:23,Vitoria-Gasteiz,incomes,salary,1505.49,-18641.75
buyer_6,Manuel,Rodríguez,1979-02-14,27528818A,manuel.rodríguez@awesomenet.com,755124,ES73209503138719377420,1500.62,2022-11-01T08:08:23,Vitoria-Gasteiz,incomes,extra_income,161.05,-18480.7
buyer_6,Manuel,Rodríguez,1979-02-14,27528818A,manuel.rodríguez@awesomenet.com,755124,ES73209503138719377420,1500.62,2022-11-03T10:20:25,Vitoria-Gasteiz,expenses,cash,-100.0,-18580.7
buyer_6,Manuel,Rodríguez,1979-02-14,27528818A,manuel.rodríguez@awesomenet.com,755124,ES73209503138719377420,1500.62,2022-11-04T21:01:30,Vitoria-Gasteiz,expenses,mortgage,-782.29,-19362.99
buyer_6,Manuel,Rodríguez,1979-02-14,27528818A,manuel.rodríguez@awesomenet.com,755124,ES73209503138719377420,1500.62,2022-11-04T16:39:15,Vitoria-Gasteiz,expenses,healthcare,-65.35,-19428.34
buyer_6,Manuel,Rodríguez,1979-02-14,27528818A,manuel.rodríguez@awesomenet.com,755124,ES73209503138719377420,1500.62,2022-11-05T16:27:20,Vitoria-Gasteiz,expenses,food,-92.28,-19520.62
buyer_6,Manuel,Rodríguez,1979-02-14,27528818A,manuel.rodríguez@awesomenet.com,755124,ES73209503138719377420,1500.62,2022-11-06T20:23:27,Vitoria-Gasteiz,expenses,electricity,-42.13,-19562.75
buyer_6,Manuel,Rodríguez,1979-02-14,27528818A,manuel.rodríguez@awesomenet.com,755124,ES73209503138719377420,1500.62,2022-11-06T09:07:18,Vitoria-Gasteiz,expenses,internet,-31.62,-19594.37
buyer_6,Manuel,Rodríguez,1979-02-14,27528818A,manuel.rodríguez@awesomenet.com,755124,ES73209503138719377420,1500.62,2022-11-06T11:17:47,Vitoria-Gasteiz,expenses,phone,-31.3,-19625.67
buyer_6,Manuel,Rodríguez,1979-02-14,27528818A,manuel.rodríguez@awesomenet.com,755124,ES73209503138719377420,1500.62,2022-11-06T11:52:14,Vitoria-Gasteiz,expenses,clothing,-94.83,-19720.5
buyer_6,Manuel,Rodríguez,1979-02-14,27528818A,manuel.rodríguez@awesomenet.com,755124,ES73209503138719377420,1500.62,2022-11-07T13:29:26,Vitoria-Gasteiz,expenses,transport,-63.15,-19783.65
buyer_6,Manuel,Rodríguez,1979-02-14,27528818A,manuel.rodríguez@awesomenet.com,755124,ES73209503138719377420,1500.62,2022-11-07T18:13:30,Vitoria-Gasteiz,expenses,cash,-100.0,-19883.65
buyer_6,Manuel,Rodríguez,1979-02-14,27528818A,manuel.rodríguez@awesomenet.com,755124,ES73209503138719377420,1500.62,2022-11-08T11:26:33,Vitoria-Gasteiz,expenses,water,-17.53,-19901.18
buyer_6,Manuel,Rodríguez,1979-02-14,27528818A,manuel.rodríguez@awesomenet.com,755124,ES73209503138719377420,1500.62,2022-11-08T08:36:25,Vitoria-Gasteiz,expenses,cash,-100.0,-20001.18
buyer_6,Manuel,Rodríguez,1979-02-14,27528818A,manuel.rodríguez@awesomenet.com,755124,ES73209503138719377420,1500.62,2022-11-11T15:01:12,Vitoria-Gasteiz,expenses,healthcare,-162.82,-20164.0
buyer_6,Manuel,Rodríguez,1979-02-14,27528818A,manuel.rodríguez@awesomenet.com,755124,ES73209503138719377420,1500.62,2022-11-13T12:11:30,Vitoria-Gasteiz,expenses,clothing,-77.73,-20241.73
buyer_6,Manuel,Rodríguez,1979-02-14,27528818A,manuel.rodríguez@awesomenet.com,755124,ES73209503138719377420,1500.62,2022-11-14T18:29:38,Vitoria-Gasteiz,expenses,food,-83.6,-20325.33
buyer_6,Manuel,Rodríguez,1979-02-14,27528818A,manuel.rodríguez@awesomenet.com,755124,ES73209503138719377420,1500.62,2022-11-14T22:24:38,Vitoria-Gasteiz,expenses,clothing,-131.46,-20456.79
buyer_6,Manuel,Rodríguez,1979-02-14,27528818A,manuel.rodríguez@awesomenet.com,755124,ES73209503138719377420,1500.62,2022-11-15T08:27:00,Vitoria-Gasteiz,expenses,education,-67.32,-20524.11
buyer_6,Manuel,Rodríguez,1979-02-14,27528818A,manuel.rodríguez@awesomenet.com,755124,ES73209503138719377420,1500.62,2022-11-16T17:08:24,Vitoria-Gasteiz,expenses,food,-60.34,-20584.45
buyer_6,Manuel,Rodríguez,1979-02-14,27528818A,manuel.rodríguez@awesomenet.com,755124,ES73209503138719377420,1500.62,2022-11-16T01:03:32,Vitoria-Gasteiz,expenses,leisure,-68.63,-20653.08
buyer_6,Manuel,Rodríguez,1979-02-14,27528818A,manuel.rodríguez@awesomenet.com,755124,ES73209503138719377420,1500.62,2022-11-17T13:32:30,Vitoria-Gasteiz,expenses,transport,-78.73,-20731.81
buyer_6,Manuel,Rodríguez,1979-02-14,27528818A,manuel.rodríguez@awesomenet.com,755124,ES73209503138719377420,1500.62,2022-11-19T18:53:57,Vitoria-Gasteiz,expenses,leisure,-70.73,-20802.54
buyer_6,Manuel,Rodríguez,1979-02-14,27528818A,manuel.rodríguez@awesomenet.com,755124,ES73209503138719377420,1500.62,2022-11-21T14:42:00,Vitoria-Gasteiz,expenses,leisure,-44.11,-20846.65
buyer_6,Manuel,Rodríguez,1979-02-14,27528818A,manuel.rodríguez@awesomenet.com,755124,ES73209503138719377420,1500.62,2022-11-22T10:36:29,Vitoria-Gasteiz,expenses,food,-119.4,-20966.05
buyer_6,Manuel,Rodríguez,1979-02-14,27528818A,manuel.rodríguez@awesomenet.com,755124,ES73209503138719377420,1500.62,2022-11-23T13:06:39,Vitoria-Gasteiz,expenses,cash,-100.0,-21066.05
buyer_6,Manuel,Rodríguez,1979-02-14,27528818A,manuel.rodríguez@awesomenet.com,755124,ES73209503138719377420,1500.62,2022-11-27T18:59:45,Vitoria-Gasteiz,expenses,transport,-63.86,-21129.91
buyer_6,Manuel,Rodríguez,1979-02-14,27528818A,manuel.rodríguez@awesomenet.com,755124,ES73209503138719377420,1500.62,2022-11-29T10:34:27,Vitoria-Gasteiz,expenses,transport,-61.99,-21191.9
buyer_6,Manuel,Rodríguez,1979-02-14,27528818A,manuel.rodríguez@awesomenet.com,755124,ES73209503138719377420,1500.62,2022-12-01T12:52:34,Vitoria-Gasteiz,incomes,salary,1505.49,-19686.41
buyer_6,Manuel,Rodríguez,1979-02-14,27528818A,manuel.rodríguez@awesomenet.com,755124,ES73209503138719377420,1500.62,2022-12-01T12:52:34,Vitoria-Gasteiz,incomes,salary_bonus,1127.15,-18559.26
buyer_6,Manuel,Rodríguez,1979-02-14,27528818A,manuel.rodríguez@awesomenet.com,755124,ES73209503138719377420,1500.62,2022-12-03T15:55:22,Vitoria-Gasteiz,expenses,food,-70.59,-18629.85
buyer_6,Manuel,Rodríguez,1979-02-14,27528818A,manuel.rodríguez@awesomenet.com,755124,ES73209503138719377420,1500.62,2022-12-03T19:36:15,Vitoria-Gasteiz,expenses,cash,-100.0,-18729.85
buyer_6,Manuel,Rodríguez,1979-02-14,27528818A,manuel.rodríguez@awesomenet.com,755124,ES73209503138719377420,1500.62,2022-12-04T07:17:16,Vitoria-Gasteiz,expenses,mortgage,-782.29,-19512.14
buyer_6,Manuel,Rodríguez,1979-02-14,27528818A,manuel.rodríguez@awesomenet.com,755124,ES73209503138719377420,1500.62,2022-12-04T09:12:56,Vitoria-Gasteiz,expenses,transport,-44.64,-19556.78
buyer_6,Manuel,Rodríguez,1979-02-14,27528818A,manuel.rodríguez@awesomenet.com,755124,ES73209503138719377420,1500.62,2022-12-05T09:37:53,Vitoria-Gasteiz,expenses,internet,-31.62,-19588.4
buyer_6,Manuel,Rodríguez,1979-02-14,27528818A,manuel.rodríguez@awesomenet.com,755124,ES73209503138719377420,1500.62,2022-12-05T18:22:23,Vitoria-Gasteiz,expenses,cash,-100.0,-19688.4
buyer_6,Manuel,Rodríguez,1979-02-14,27528818A,manuel.rodríguez@awesomenet.com,755124,ES73209503138719377420,1500.62,2022-12-06T14:22:51,Vitoria-Gasteiz,expenses,gas,-23.52,-19711.92
buyer_6,Manuel,Rodríguez,1979-02-14,27528818A,manuel.rodríguez@awesomenet.com,755124,ES73209503138719377420,1500.62,2022-12-06T13:44:50,Vitoria-Gasteiz,expenses,phone,-30.02,-19741.94
buyer_6,Manuel,Rodríguez,1979-02-14,27528818A,manuel.rodríguez@awesomenet.com,755124,ES73209503138719377420,1500.62,2022-12-06T08:40:28,Vitoria-Gasteiz,expenses,transport,-57.97,-19799.91
buyer_6,Manuel,Rodríguez,1979-02-14,27528818A,manuel.rodríguez@awesomenet.com,755124,ES73209503138719377420,1500.62,2022-12-06T09:24:12,Vitoria-Gasteiz,expenses,healthcare,-44.65,-19844.56
buyer_6,Manuel,Rodríguez,1979-02-14,27528818A,manuel.rodríguez@awesomenet.com,755124,ES73209503138719377420,1500.62,2022-12-07T23:26:15,Vitoria-Gasteiz,expenses,phone,-32.75,-19877.31
buyer_6,Manuel,Rodríguez,1979-02-14,27528818A,manuel.rodríguez@awesomenet.com,755124,ES73209503138719377420,1500.62,2022-12-07T17:19:28,Vitoria-Gasteiz,expenses,food,-101.85,-19979.16
buyer_6,Manuel,Rodríguez,1979-02-14,27528818A,manuel.rodríguez@awesomenet.com,755124,ES73209503138719377420,1500.62,2022-12-09T16:07:22,Vitoria-Gasteiz,expenses,food,-110.12,-20089.28
buyer_6,Manuel,Rodríguez,1979-02-14,27528818A,manuel.rodríguez@awesomenet.com,755124,ES73209503138719377420,1500.62,2022-12-11T14:23:45,Vitoria-Gasteiz,expenses,clothing,-140.57,-20229.85
buyer_6,Manuel,Rodríguez,1979-02-14,27528818A,manuel.rodríguez@awesomenet.com,755124,ES73209503138719377420,1500.62,2022-12-11T12:23:47,Vitoria-Gasteiz,expenses,repairs,-298.19,-20528.04
buyer_6,Manuel,Rodríguez,1979-02-14,27528818A,manuel.rodríguez@awesomenet.com,755124,ES73209503138719377420,1500.62,2022-12-13T21:18:39,Vitoria-Gasteiz,expenses,clothing,-125.72,-20653.76
buyer_6,Manuel,Rodríguez,1979-02-14,27528818A,manuel.rodríguez@awesomenet.com,755124,ES73209503138719377420,1500.62,2022-12-13T17:07:17,Vitoria-Gasteiz,expenses,cash,-100.0,-20753.76
buyer_6,Manuel,Rodríguez,1979-02-14,27528818A,manuel.rodríguez@awesomenet.com,755124,ES73209503138719377420,1500.62,2022-12-15T14:00:25,Vitoria-Gasteiz,expenses,education,-42.4,-20796.16
buyer_6,Manuel,Rodríguez,1979-02-14,27528818A,manuel.rodríguez@awesomenet.com,755124,ES73209503138719377420,1500.62,2022-12-19T11:57:41,Vitoria-Gasteiz,expenses,transport,-43.85,-20840.01
buyer_6,Manuel,Rodríguez,1979-02-14,27528818A,manuel.rodríguez@awesomenet.com,755124,ES73209503138719377420,1500.62,2022-12-19T11:01:13,Vitoria-Gasteiz,expenses,cash,-100.0,-20940.01
buyer_6,Manuel,Rodríguez,1979-02-14,27528818A,manuel.rodríguez@awesomenet.com,755124,ES73209503138719377420,1500.62,2022-12-20T22:14:14,Vitoria-Gasteiz,expenses,leisure,-19.18,-20959.19
buyer_6,Manuel,Rodríguez,1979-02-14,27528818A,manuel.rodríguez@awesomenet.com,755124,ES73209503138719377420,1500.62,2022-12-22T11:07:42,Vitoria-Gasteiz,expenses,education,-58.89,-21018.08
buyer_6,Manuel,Rodríguez,1979-02-14,27528818A,manuel.rodríguez@awesomenet.com,755124,ES73209503138719377420,1500.62,2022-12-25T09:39:57,Vitoria-Gasteiz,expenses,transport,-46.57,-21064.65
buyer_6,Manuel,Rodríguez,1979-02-14,27528818A,manuel.rodríguez@awesomenet.com,755124,ES73209503138719377420,1500.62,2022-12-26T19:32:37,Vitoria-Gasteiz,expenses,education,-57.59,-21122.24
buyer_6,Manuel,Rodríguez,1979-02-14,27528818A,manuel.rodríguez@awesomenet.com,755124,ES73209503138719377420,1500.62,2022-12-27T20:18:10,Vitoria-Gasteiz,expenses,leisure,-22.9,-21145.14
buyer_6,Manuel,Rodríguez,1979-02-14,27528818A,manuel.rodríguez@awesomenet.com,755124,ES73209503138719377420,1500.62,2022-12-28T10:18:26,Vitoria-Gasteiz,expenses,leisure,-63.79,-21208.93
buyer_6,Manuel,Rodríguez,1979-02-14,27528818A,manuel.rodríguez@awesomenet.com,755124,ES73209503138719377420,1500.62,2022-12-29T19:31:33,Vitoria-Gasteiz,expenses,cash,-100.0,-21308.93
buyer_6,Manuel,Rodríguez,1979-02-14,27528818A,manuel.rodríguez@awesomenet.com,755124,ES73209503138719377420,1500.62,2022-12-30T17:10:27,Vitoria-Gasteiz,expenses,healthcare,-51.46,-21360.39
buyer_6,Manuel,Rodríguez,1979-02-14,27528818A,manuel.rodríguez@awesomenet.com,755124,ES73209503138719377420,1500.62,2023-01-01T17:48:41,Vitoria-Gasteiz,incomes,salary,1536.94,-19823.45
buyer_6,Manuel,Rodríguez,1979-02-14,27528818A,manuel.rodríguez@awesomenet.com,755124,ES73209503138719377420,1500.62,2023-01-01T11:14:40,Vitoria-Gasteiz,expenses,clothing,-49.17,-19872.62
buyer_6,Manuel,Rodríguez,1979-02-14,27528818A,manuel.rodríguez@awesomenet.com,755124,ES73209503138719377420,1500.62,2023-01-02T19:01:00,Vitoria-Gasteiz,expenses,cash,-100.0,-19972.62
buyer_6,Manuel,Rodríguez,1979-02-14,27528818A,manuel.rodríguez@awesomenet.com,755124,ES73209503138719377420,1500.62,2023-01-03T11:06:31,Vitoria-Gasteiz,expenses,food,-89.4,-20062.02
buyer_6,Manuel,Rodríguez,1979-02-14,27528818A,manuel.rodríguez@awesomenet.com,755124,ES73209503138719377420,1500.62,2023-01-03T04:11:14,Vitoria-Gasteiz,expenses,appliances,-312.97,-20374.99
buyer_6,Manuel,Rodríguez,1979-02-14,27528818A,manuel.rodríguez@awesomenet.com,755124,ES73209503138719377420,1500.62,2023-01-04T13:31:45,Vitoria-Gasteiz,expenses,mortgage,-675.14,-21050.13
buyer_6,Manuel,Rodríguez,1979-02-14,27528818A,manuel.rodríguez@awesomenet.com,755124,ES73209503138719377420,1500.62,2023-01-05T16:08:57,Vitoria-Gasteiz,expenses,phone,-25.8,-21075.93
buyer_6,Manuel,Rodríguez,1979-02-14,27528818A,manuel.rodríguez@awesomenet.com,755124,ES73209503138719377420,1500.62,2023-01-05T17:36:44,Vitoria-Gasteiz,expenses,cash,-100.0,-21175.93
buyer_6,Manuel,Rodríguez,1979-02-14,27528818A,manuel.rodríguez@awesomenet.com,755124,ES73209503138719377420,1500.62,2023-01-07T11:48:00,Vitoria-Gasteiz,expenses,phone,-32.63,-21208.56
buyer_6,Manuel,Rodríguez,1979-02-14,27528818A,manuel.rodríguez@awesomenet.com,755124,ES73209503138719377420,1500.62,2023-01-08T04:48:39,Vitoria-Gasteiz,expenses,gas,-26.44,-21235.0
buyer_6,Manuel,Rodríguez,1979-02-14,27528818A,manuel.rodríguez@awesomenet.com,755124,ES73209503138719377420,1500.62,2023-01-08T18:22:12,Vitoria-Gasteiz,expenses,appliances,-337.49,-21572.49
buyer_6,Manuel,Rodríguez,1979-02-14,27528818A,manuel.rodríguez@awesomenet.com,755124,ES73209503138719377420,1500.62,2023-01-09T10:27:51,Vitoria-Gasteiz,expenses,appliances,-120.79,-21693.28
buyer_6,Manuel,Rodríguez,1979-02-14,27528818A,manuel.rodríguez@awesomenet.com,755124,ES73209503138719377420,1500.62,2023-01-10T18:47:58,Vitoria-Gasteiz,expenses,clothing,-119.02,-21812.3
buyer_6,Manuel,Rodríguez,1979-02-14,27528818A,manuel.rodríguez@awesomenet.com,755124,ES73209503138719377420,1500.62,2023-01-11T10:52:46,Vitoria-Gasteiz,expenses,leisure,-76.58,-21888.88
buyer_6,Manuel,Rodríguez,1979-02-14,27528818A,manuel.rodríguez@awesomenet.com,755124,ES73209503138719377420,1500.62,2023-01-12T22:06:10,Vitoria-Gasteiz,expenses,repairs,-290.45,-22179.33
buyer_6,Manuel,Rodríguez,1979-02-14,27528818A,manuel.rodríguez@awesomenet.com,755124,ES73209503138719377420,1500.62,2023-01-15T08:47:58,Vitoria-Gasteiz,expenses,repairs,-167.28,-22346.61
buyer_6,Manuel,Rodríguez,1979-02-14,27528818A,manuel.rodríguez@awesomenet.com,755124,ES73209503138719377420,1500.62,2023-01-16T13:14:49,Vitoria-Gasteiz,expenses,cash,-100.0,-22446.61
buyer_6,Manuel,Rodríguez,1979-02-14,27528818A,manuel.rodríguez@awesomenet.com,755124,ES73209503138719377420,1500.62,2023-01-17T18:16:09,Vitoria-Gasteiz,expenses,transport,-60.86,-22507.47
buyer_6,Manuel,Rodríguez,1979-02-14,27528818A,manuel.rodríguez@awesomenet.com,755124,ES73209503138719377420,1500.62,2023-01-17T11:46:55,Vitoria-Gasteiz,expenses,leisure,-68.79,-22576.26
buyer_6,Manuel,Rodríguez,1979-02-14,27528818A,manuel.rodríguez@awesomenet.com,755124,ES73209503138719377420,1500.62,2023-01-19T16:28:06,Vitoria-Gasteiz,expenses,leisure,-46.52,-22622.78
buyer_6,Manuel,Rodríguez,1979-02-14,27528818A,manuel.rodríguez@awesomenet.com,755124,ES73209503138719377420,1500.62,2023-01-24T17:12:17,Vitoria-Gasteiz,expenses,leisure,-34.34,-22657.12
buyer_6,Manuel,Rodríguez,1979-02-14,27528818A,manuel.rodríguez@awesomenet.com,755124,ES73209503138719377420,1500.62,2023-01-25T13:17:09,Vitoria-Gasteiz,expenses,food,-119.93,-22777.05
buyer_6,Manuel,Rodríguez,1979-02-14,27528818A,manuel.rodríguez@awesomenet.com,755124,ES73209503138719377420,1500.62,2023-01-25T13:54:39,Vitoria-Gasteiz,expenses,leisure,-26.5,-22803.55
buyer_6,Manuel,Rodríguez,1979-02-14,27528818A,manuel.rodríguez@awesomenet.com,755124,ES73209503138719377420,1500.62,2023-01-25T14:15:04,Vitoria-Gasteiz,expenses,clothing,-98.28,-22901.83
buyer_6,Manuel,Rodríguez,1979-02-14,27528818A,manuel.rodríguez@awesomenet.com,755124,ES73209503138719377420,1500.62,2023-01-27T10:45:04,Vitoria-Gasteiz,expenses,transport,-45.01,-22946.84
buyer_6,Manuel,Rodríguez,1979-02-14,27528818A,manuel.rodríguez@awesomenet.com,755124,ES73209503138719377420,1500.62,2023-01-29T08:18:19,Vitoria-Gasteiz,expenses,leisure,-70.89,-23017.73
buyer_6,Manuel,Rodríguez,1979-02-14,27528818A,manuel.rodríguez@awesomenet.com,755124,ES73209503138719377420,1500.62,2023-01-29T00:46:16,Vitoria-Gasteiz,expenses,cash,-100.0,-23117.73
buyer_6,Manuel,Rodríguez,1979-02-14,27528818A,manuel.rodríguez@awesomenet.com,755124,ES73209503138719377420,1500.62,2023-01-31T18:13:38,Vitoria-Gasteiz,expenses,appliances,-166.88,-23284.61
buyer_6,Manuel,Rodríguez,1979-02-14,27528818A,manuel.rodríguez@awesomenet.com,755124,ES73209503138719377420,1500.62,2023-02-01T16:08:21,Vitoria-Gasteiz,incomes,salary,1536.94,-21747.67
buyer_6,Manuel,Rodríguez,1979-02-14,27528818A,manuel.rodríguez@awesomenet.com,755124,ES73209503138719377420,1500.62,2023-02-01T16:08:21,Vitoria-Gasteiz,incomes,extra_income,161.05,-21586.62
buyer_6,Manuel,Rodríguez,1979-02-14,27528818A,manuel.rodríguez@awesomenet.com,755124,ES73209503138719377420,1500.62,2023-02-02T11:56:56,Vitoria-Gasteiz,expenses,clothing,-156.01,-21742.63
buyer_6,Manuel,Rodríguez,1979-02-14,27528818A,manuel.rodríguez@awesomenet.com,755124,ES73209503138719377420,1500.62,2023-02-03T19:39:27,Vitoria-Gasteiz,expenses,food,-66.25,-21808.88
buyer_6,Manuel,Rodríguez,1979-02-14,27528818A,manuel.rodríguez@awesomenet.com,755124,ES73209503138719377420,1500.62,2023-02-04T11:17:42,Vitoria-Gasteiz,expenses,mortgage,-675.14,-22484.02
buyer_6,Manuel,Rodríguez,1979-02-14,27528818A,manuel.rodríguez@awesomenet.com,755124,ES73209503138719377420,1500.62,2023-02-04T18:12:17,Vitoria-Gasteiz,expenses,cash,-100.0,-22584.02
buyer_6,Manuel,Rodríguez,1979-02-14,27528818A,manuel.rodríguez@awesomenet.com,755124,ES73209503138719377420,1500.62,2023-02-05T19:04:26,Vitoria-Gasteiz,expenses,water,-25.75,-22609.77
buyer_6,Manuel,Rodríguez,1979-02-14,27528818A,manuel.rodríguez@awesomenet.com,755124,ES73209503138719377420,1500.62,2023-02-05T19:44:09,Vitoria-Gasteiz,expenses,gas,-77.71,-22687.48
buyer_6,Manuel,Rodríguez,1979-02-14,27528818A,manuel.rodríguez@awesomenet.com,755124,ES73209503138719377420,1500.62,2023-02-05T09:46:45,Vitoria-Gasteiz,expenses,travel,-747.45,-23434.93
buyer_6,Manuel,Rodríguez,1979-02-14,27528818A,manuel.rodríguez@awesomenet.com,755124,ES73209503138719377420,1500.62,2023-02-07T15:35:14,Vitoria-Gasteiz,expenses,gas,-69.16,-23504.09
buyer_6,Manuel,Rodríguez,1979-02-14,27528818A,manuel.rodríguez@awesomenet.com,755124,ES73209503138719377420,1500.62,2023-02-07T10:25:55,Vitoria-Gasteiz,expenses,internet,-32.28,-23536.37
buyer_6,Manuel,Rodríguez,1979-02-14,27528818A,manuel.rodríguez@awesomenet.com,755124,ES73209503138719377420,1500.62,2023-02-07T17:15:39,Vitoria-Gasteiz,expenses,phone,-23.36,-23559.73
buyer_6,Manuel,Rodríguez,1979-02-14,27528818A,manuel.rodríguez@awesomenet.com,755124,ES73209503138719377420,1500.62,2023-02-07T18:24:47,Vitoria-Gasteiz,expenses,food,-63.96,-23623.69
buyer_6,Manuel,Rodríguez,1979-02-14,27528818A,manuel.rodríguez@awesomenet.com,755124,ES73209503138719377420,1500.62,2023-02-09T20:39:17,Vitoria-Gasteiz,expenses,cash,-100.0,-23723.69
buyer_6,Manuel,Rodríguez,1979-02-14,27528818A,manuel.rodríguez@awesomenet.com,755124,ES73209503138719377420,1500.62,2023-02-15T16:33:09,Vitoria-Gasteiz,expenses,healthcare,-173.08,-23896.77
buyer_6,Manuel,Rodríguez,1979-02-14,27528818A,manuel.rodríguez@awesomenet.com,755124,ES73209503138719377420,1500.62,2023-02-17T21:47:35,Vitoria-Gasteiz,expenses,transport,-47.51,-23944.28
buyer_6,Manuel,Rodríguez,1979-02-14,27528818A,manuel.rodríguez@awesomenet.com,755124,ES73209503138719377420,1500.62,2023-02-18T14:48:38,Vitoria-Gasteiz,expenses,leisure,-37.54,-23981.82
buyer_6,Manuel,Rodríguez,1979-02-14,27528818A,manuel.rodríguez@awesomenet.com,755124,ES73209503138719377420,1500.62,2023-02-18T13:50:42,Vitoria-Gasteiz,expenses,clothing,-84.38,-24066.2
buyer_6,Manuel,Rodríguez,1979-02-14,27528818A,manuel.rodríguez@awesomenet.com,755124,ES73209503138719377420,1500.62,2023-02-18T17:03:33,Vitoria-Gasteiz,expenses,healthcare,-88.3,-24154.5
buyer_6,Manuel,Rodríguez,1979-02-14,27528818A,manuel.rodríguez@awesomenet.com,755124,ES73209503138719377420,1500.62,2023-02-18T21:08:00,Vitoria-Gasteiz,expenses,cash,-100.0,-24254.5
buyer_6,Manuel,Rodríguez,1979-02-14,27528818A,manuel.rodríguez@awesomenet.com,755124,ES73209503138719377420,1500.62,2023-02-18T11:37:24,Vitoria-Gasteiz,expenses,gifts,-169.47,-24423.97
buyer_6,Manuel,Rodríguez,1979-02-14,27528818A,manuel.rodríguez@awesomenet.com,755124,ES73209503138719377420,1500.62,2023-02-19T08:25:54,Vitoria-Gasteiz,expenses,food,-122.0,-24545.97
buyer_6,Manuel,Rodríguez,1979-02-14,27528818A,manuel.rodríguez@awesomenet.com,755124,ES73209503138719377420,1500.62,2023-02-19T20:00:45,Vitoria-Gasteiz,expenses,cash,-100.0,-24645.97
buyer_6,Manuel,Rodríguez,1979-02-14,27528818A,manuel.rodríguez@awesomenet.com,755124,ES73209503138719377420,1500.62,2023-02-19T12:51:03,Vitoria-Gasteiz,expenses,repairs,-117.5,-24763.47
buyer_6,Manuel,Rodríguez,1979-02-14,27528818A,manuel.rodríguez@awesomenet.com,755124,ES73209503138719377420,1500.62,2023-02-20T12:37:40,Vitoria-Gasteiz,expenses,food,-105.02,-24868.49
buyer_6,Manuel,Rodríguez,1979-02-14,27528818A,manuel.rodríguez@awesomenet.com,755124,ES73209503138719377420,1500.62,2023-02-20T09:13:16,Vitoria-Gasteiz,expenses,leisure,-20.95,-24889.44
buyer_6,Manuel,Rodríguez,1979-02-14,27528818A,manuel.rodríguez@awesomenet.com,755124,ES73209503138719377420,1500.62,2023-02-24T08:47:48,Vitoria-Gasteiz,expenses,cash,-100.0,-24989.44
buyer_6,Manuel,Rodríguez,1979-02-14,27528818A,manuel.rodríguez@awesomenet.com,755124,ES73209503138719377420,1500.62,2023-02-25T19:49:21,Vitoria-Gasteiz,expenses,cash,-100.0,-25089.44
buyer_6,Manuel,Rodríguez,1979-02-14,27528818A,manuel.rodríguez@awesomenet.com,755124,ES73209503138719377420,1500.62,2023-03-01T05:13:36,Vitoria-Gasteiz,incomes,salary,1536.94,-23552.5
buyer_6,Manuel,Rodríguez,1979-02-14,27528818A,manuel.rodríguez@awesomenet.com,755124,ES73209503138719377420,1500.62,2023-03-04T09:34:29,Vitoria-Gasteiz,expenses,mortgage,-675.14,-24227.64
buyer_6,Manuel,Rodríguez,1979-02-14,27528818A,manuel.rodríguez@awesomenet.com,755124,ES73209503138719377420,1500.62,2023-03-05T11:13:26,Vitoria-Gasteiz,expenses,internet,-32.28,-24259.92
buyer_6,Manuel,Rodríguez,1979-02-14,27528818A,manuel.rodríguez@awesomenet.com,755124,ES73209503138719377420,1500.62,2023-03-05T09:45:45,Vitoria-Gasteiz,expenses,food,-106.94,-24366.86
buyer_6,Manuel,Rodríguez,1979-02-14,27528818A,manuel.rodríguez@awesomenet.com,755124,ES73209503138719377420,1500.62,2023-03-06T11:08:25,Vitoria-Gasteiz,expenses,electricity,-62.97,-24429.83
buyer_6,Manuel,Rodríguez,1979-02-14,27528818A,manuel.rodríguez@awesomenet.com,755124,ES73209503138719377420,1500.62,2023-03-07T20:12:59,Vitoria-Gasteiz,expenses,water,-29.9,-24459.73
buyer_6,Manuel,Rodríguez,1979-02-14,27528818A,manuel.rodríguez@awesomenet.com,755124,ES73209503138719377420,1500.62,2023-03-08T12:39:18,Vitoria-Gasteiz,expenses,healthcare,-98.46,-24558.19
buyer_6,Manuel,Rodríguez,1979-02-14,27528818A,manuel.rodríguez@awesomenet.com,755124,ES73209503138719377420,1500.62,2023-03-08T18:00:53,Vitoria-Gasteiz,expenses,appliances,-414.47,-24972.66
buyer_6,Manuel,Rodríguez,1979-02-14,27528818A,manuel.rodríguez@awesomenet.com,755124,ES73209503138719377420,1500.62,2023-03-08T18:20:43,Vitoria-Gasteiz,expenses,repairs,-205.36,-25178.02
buyer_6,Manuel,Rodríguez,1979-02-14,27528818A,manuel.rodríguez@awesomenet.com,755124,ES73209503138719377420,1500.62,2023-03-08T15:09:50,Vitoria-Gasteiz,expenses,gifts,-56.07,-25234.09
buyer_6,Manuel,Rodríguez,1979-02-14,27528818A,manuel.rodríguez@awesomenet.com,755124,ES73209503138719377420,1500.62,2023-03-09T20:27:08,Vitoria-Gasteiz,expenses,food,-110.32,-25344.41
buyer_6,Manuel,Rodríguez,1979-02-14,27528818A,manuel.rodríguez@awesomenet.com,755124,ES73209503138719377420,1500.62,2023-03-09T10:30:21,Vitoria-Gasteiz,expenses,gifts,-556.63,-25901.04
buyer_6,Manuel,Rodríguez,1979-02-14,27528818A,manuel.rodríguez@awesomenet.com,755124,ES73209503138719377420,1500.62,2023-03-10T08:21:45,Vitoria-Gasteiz,expenses,leisure,-28.72,-25929.76
buyer_6,Manuel,Rodríguez,1979-02-14,27528818A,manuel.rodríguez@awesomenet.com,755124,ES73209503138719377420,1500.62,2023-03-12T19:25:56,Vitoria-Gasteiz,expenses,appliances,-201.48,-26131.24
buyer_6,Manuel,Rodríguez,1979-02-14,27528818A,manuel.rodríguez@awesomenet.com,755124,ES73209503138719377420,1500.62,2023-03-13T20:49:35,Vitoria-Gasteiz,expenses,transport,-62.04,-26193.28
buyer_6,Manuel,Rodríguez,1979-02-14,27528818A,manuel.rodríguez@awesomenet.com,755124,ES73209503138719377420,1500.62,2023-03-13T06:15:35,Vitoria-Gasteiz,expenses,cash,-100.0,-26293.28
buyer_6,Manuel,Rodríguez,1979-02-14,27528818A,manuel.rodríguez@awesomenet.com,755124,ES73209503138719377420,1500.62,2023-03-16T16:12:01,Vitoria-Gasteiz,expenses,repairs,-109.26,-26402.54
buyer_6,Manuel,Rodríguez,1979-02-14,27528818A,manuel.rodríguez@awesomenet.com,755124,ES73209503138719377420,1500.62,2023-03-17T16:28:01,Vitoria-Gasteiz,expenses,food,-76.48,-26479.02
buyer_6,Manuel,Rodríguez,1979-02-14,27528818A,manuel.rodríguez@awesomenet.com,755124,ES73209503138719377420,1500.62,2023-03-20T15:02:06,Vitoria-Gasteiz,expenses,cash,-100.0,-26579.02
buyer_6,Manuel,Rodríguez,1979-02-14,27528818A,manuel.rodríguez@awesomenet.com,755124,ES73209503138719377420,1500.62,2023-03-24T19:56:11,Vitoria-Gasteiz,expenses,cash,-100.0,-26679.02
buyer_6,Manuel,Rodríguez,1979-02-14,27528818A,manuel.rodríguez@awesomenet.com,755124,ES73209503138719377420,1500.62,2023-03-25T13:46:56,Vitoria-Gasteiz,expenses,food,-104.97,-26783.99
buyer_6,Manuel,Rodríguez,1979-02-14,27528818A,manuel.rodríguez@awesomenet.com,755124,ES73209503138719377420,1500.62,2023-03-26T08:48:42,Vitoria-Gasteiz,expenses,leisure,-30.73,-26814.72
buyer_6,Manuel,Rodríguez,1979-02-14,27528818A,manuel.rodríguez@awesomenet.com,755124,ES73209503138719377420,1500.62,2023-03-27T10:05:40,Vitoria-Gasteiz,expenses,cash,-100.0,-26914.72
buyer_6,Manuel,Rodríguez,1979-02-14,27528818A,manuel.rodríguez@awesomenet.com,755124,ES73209503138719377420,1500.62,2023-03-27T21:16:49,Vitoria-Gasteiz,expenses,repairs,-87.1,-27001.82
buyer_6,Manuel,Rodríguez,1979-02-14,27528818A,manuel.rodríguez@awesomenet.com,755124,ES73209503138719377420,1500.62,2023-03-29T18:22:56,Vitoria-Gasteiz,expenses,cash,-100.0,-27101.82
buyer_6,Manuel,Rodríguez,1979-02-14,27528818A,manuel.rodríguez@awesomenet.com,755124,ES73209503138719377420,1500.62,2023-03-29T20:12:36,Vitoria-Gasteiz,expenses,gifts,-493.14,-27594.96
buyer_6,Manuel,Rodríguez,1979-02-14,27528818A,manuel.rodríguez@awesomenet.com,755124,ES73209503138719377420,1500.62,2023-03-30T14:19:50,Vitoria-Gasteiz,expenses,cash,-100.0,-27694.96
buyer_6,Manuel,Rodríguez,1979-02-14,27528818A,manuel.rodríguez@awesomenet.com,755124,ES73209503138719377420,1500.62,2023-03-31T19:59:53,Vitoria-Gasteiz,expenses,transport,-88.85,-27783.81
buyer_6,Manuel,Rodríguez,1979-02-14,27528818A,manuel.rodríguez@awesomenet.com,755124,ES73209503138719377420,1500.62,2023-03-31T14:02:53,Vitoria-Gasteiz,expenses,repairs,-42.31,-27826.12
buyer_6,Manuel,Rodríguez,1979-02-14,27528818A,manuel.rodríguez@awesomenet.com,755124,ES73209503138719377420,1500.62,2023-04-01T15:00:55,Vitoria-Gasteiz,incomes,salary,1536.94,-26289.18
buyer_6,Manuel,Rodríguez,1979-02-14,27528818A,manuel.rodríguez@awesomenet.com,755124,ES73209503138719377420,1500.62,2023-04-01T08:23:50,Vitoria-Gasteiz,expenses,leisure,-18.26,-26307.44
buyer_6,Manuel,Rodríguez,1979-02-14,27528818A,manuel.rodríguez@awesomenet.com,755124,ES73209503138719377420,1500.62,2023-04-02T11:04:19,Vitoria-Gasteiz,expenses,education,-52.55,-26359.99
buyer_6,Manuel,Rodríguez,1979-02-14,27528818A,manuel.rodríguez@awesomenet.com,755124,ES73209503138719377420,1500.62,2023-04-03T18:05:26,Vitoria-Gasteiz,expenses,food,-124.19,-26484.18
buyer_6,Manuel,Rodríguez,1979-02-14,27528818A,manuel.rodríguez@awesomenet.com,755124,ES73209503138719377420,1500.62,2023-04-04T14:18:58,Vitoria-Gasteiz,expenses,mortgage,-675.14,-27159.32
buyer_6,Manuel,Rodríguez,1979-02-14,27528818A,manuel.rodríguez@awesomenet.com,755124,ES73209503138719377420,1500.62,2023-04-05T20:27:49,Vitoria-Gasteiz,expenses,cash,-100.0,-27259.32
buyer_6,Manuel,Rodríguez,1979-02-14,27528818A,manuel.rodríguez@awesomenet.com,755124,ES73209503138719377420,1500.62,2023-04-05T14:00:37,Vitoria-Gasteiz,expenses,gifts,-173.33,-27432.65
buyer_6,Manuel,Rodríguez,1979-02-14,27528818A,manuel.rodríguez@awesomenet.com,755124,ES73209503138719377420,1500.62,2023-04-06T19:18:45,Vitoria-Gasteiz,expenses,water,-25.92,-27458.57
buyer_6,Manuel,Rodríguez,1979-02-14,27528818A,manuel.rodríguez@awesomenet.com,755124,ES73209503138719377420,1500.62,2023-04-07T19:59:38,Vitoria-Gasteiz,expenses,water,-34.25,-27492.82
buyer_6,Manuel,Rodríguez,1979-02-14,27528818A,manuel.rodríguez@awesomenet.com,755124,ES73209503138719377420,1500.62,2023-04-07T10:02:58,Vitoria-Gasteiz,expenses,internet,-32.28,-27525.1
buyer_6,Manuel,Rodríguez,1979-02-14,27528818A,manuel.rodríguez@awesomenet.com,755124,ES73209503138719377420,1500.62,2023-04-08T17:11:37,Vitoria-Gasteiz,expenses,gas,-23.34,-27548.44
buyer_6,Manuel,Rodríguez,1979-02-14,27528818A,manuel.rodríguez@awesomenet.com,755124,ES73209503138719377420,1500.62,2023-04-08T09:08:58,Vitoria-Gasteiz,expenses,internet,-32.28,-27580.72
buyer_6,Manuel,Rodríguez,1979-02-14,27528818A,manuel.rodríguez@awesomenet.com,755124,ES73209503138719377420,1500.62,2023-04-08T19:25:36,Vitoria-Gasteiz,expenses,gifts,-622.26,-28202.98
buyer_6,Manuel,Rodríguez,1979-02-14,27528818A,manuel.rodríguez@awesomenet.com,755124,ES73209503138719377420,1500.62,2023-04-11T15:41:07,Vitoria-Gasteiz,expenses,leisure,-49.63,-28252.61
buyer_6,Manuel,Rodríguez,1979-02-14,27528818A,manuel.rodríguez@awesomenet.com,755124,ES73209503138719377420,1500.62,2023-04-15T20:57:24,Vitoria-Gasteiz,expenses,transport,-70.18,-28322.79
buyer_6,Manuel,Rodríguez,1979-02-14,27528818A,manuel.rodríguez@awesomenet.com,755124,ES73209503138719377420,1500.62,2023-04-15T16:44:56,Vitoria-Gasteiz,expenses,leisure,-67.9,-28390.69
buyer_6,Manuel,Rodríguez,1979-02-14,27528818A,manuel.rodríguez@awesomenet.com,755124,ES73209503138719377420,1500.62,2023-04-16T13:08:25,Vitoria-Gasteiz,expenses,food,-110.78,-28501.47
buyer_6,Manuel,Rodríguez,1979-02-14,27528818A,manuel.rodríguez@awesomenet.com,755124,ES73209503138719377420,1500.62,2023-04-16T11:12:35,Vitoria-Gasteiz,expenses,transport,-74.4,-28575.87
buyer_6,Manuel,Rodríguez,1979-02-14,27528818A,manuel.rodríguez@awesomenet.com,755124,ES73209503138719377420,1500.62,2023-04-17T13:46:46,Vitoria-Gasteiz,expenses,leisure,-79.14,-28655.01
buyer_6,Manuel,Rodríguez,1979-02-14,27528818A,manuel.rodríguez@awesomenet.com,755124,ES73209503138719377420,1500.62,2023-04-19T09:47:10,Vitoria-Gasteiz,expenses,repairs,-62.0,-28717.01
buyer_6,Manuel,Rodríguez,1979-02-14,27528818A,manuel.rodríguez@awesomenet.com,755124,ES73209503138719377420,1500.62,2023-04-21T09:03:45,Vitoria-Gasteiz,expenses,food,-101.11,-28818.12
buyer_6,Manuel,Rodríguez,1979-02-14,27528818A,manuel.rodríguez@awesomenet.com,755124,ES73209503138719377420,1500.62,2023-04-25T20:58:50,Vitoria-Gasteiz,expenses,leisure,-55.45,-28873.57
buyer_6,Manuel,Rodríguez,1979-02-14,27528818A,manuel.rodríguez@awesomenet.com,755124,ES73209503138719377420,1500.62,2023-04-26T20:20:06,Vitoria-Gasteiz,expenses,gifts,-690.89,-29564.46
buyer_6,Manuel,Rodríguez,1979-02-14,27528818A,manuel.rodríguez@awesomenet.com,755124,ES73209503138719377420,1500.62,2023-04-27T20:03:08,Vitoria-Gasteiz,expenses,leisure,-33.3,-29597.76
buyer_6,Manuel,Rodríguez,1979-02-14,27528818A,manuel.rodríguez@awesomenet.com,755124,ES73209503138719377420,1500.62,2023-04-29T13:55:31,Vitoria-Gasteiz,expenses,leisure,-29.39,-29627.15
buyer_6,Manuel,Rodríguez,1979-02-14,27528818A,manuel.rodríguez@awesomenet.com,755124,ES73209503138719377420,1500.62,2023-05-01T01:22:42,Vitoria-Gasteiz,incomes,salary,1536.94,-28090.21
buyer_6,Manuel,Rodríguez,1979-02-14,27528818A,manuel.rodríguez@awesomenet.com,755124,ES73209503138719377420,1500.62,2023-05-01T01:22:42,Vitoria-Gasteiz,incomes,extra_income,161.05,-27929.16
buyer_6,Manuel,Rodríguez,1979-02-14,27528818A,manuel.rodríguez@awesomenet.com,755124,ES73209503138719377420,1500.62,2023-05-01T23:00:00,Vitoria-Gasteiz,expenses,transport,-65.64,-27994.8
buyer_6,Manuel,Rodríguez,1979-02-14,27528818A,manuel.rodríguez@awesomenet.com,755124,ES73209503138719377420,1500.62,2023-05-02T23:21:21,Vitoria-Gasteiz,expenses,leisure,-24.41,-28019.21
buyer_6,Manuel,Rodríguez,1979-02-14,27528818A,manuel.rodríguez@awesomenet.com,755124,ES73209503138719377420,1500.62,2023-05-02T01:12:12,Vitoria-Gasteiz,expenses,cash,-100.0,-28119.21
buyer_6,Manuel,Rodríguez,1979-02-14,27528818A,manuel.rodríguez@awesomenet.com,755124,ES73209503138719377420,1500.62,2023-05-03T14:39:29,Vitoria-Gasteiz,expenses,transport,-49.22,-28168.43
buyer_6,Manuel,Rodríguez,1979-02-14,27528818A,manuel.rodríguez@awesomenet.com,755124,ES73209503138719377420,1500.62,2023-05-03T09:43:05,Vitoria-Gasteiz,expenses,leisure,-74.31,-28242.74
buyer_6,Manuel,Rodríguez,1979-02-14,27528818A,manuel.rodríguez@awesomenet.com,755124,ES73209503138719377420,1500.62,2023-05-03T12:01:31,Vitoria-Gasteiz,expenses,gifts,-380.02,-28622.76
buyer_6,Manuel,Rodríguez,1979-02-14,27528818A,manuel.rodríguez@awesomenet.com,755124,ES73209503138719377420,1500.62,2023-05-04T15:13:43,Vitoria-Gasteiz,expenses,mortgage,-675.14,-29297.9
buyer_6,Manuel,Rodríguez,1979-02-14,27528818A,manuel.rodríguez@awesomenet.com,755124,ES73209503138719377420,1500.62,2023-05-05T20:03:48,Vitoria-Gasteiz,expenses,gas,-79.59,-29377.49
buyer_6,Manuel,Rodríguez,1979-02-14,27528818A,manuel.rodríguez@awesomenet.com,755124,ES73209503138719377420,1500.62,2023-05-05T15:51:32,Vitoria-Gasteiz,expenses,internet,-32.28,-29409.77
buyer_6,Manuel,Rodríguez,1979-02-14,27528818A,manuel.rodríguez@awesomenet.com,755124,ES73209503138719377420,1500.62,2023-05-05T18:42:25,Vitoria-Gasteiz,expenses,healthcare,-188.84,-29598.61
buyer_6,Manuel,Rodríguez,1979-02-14,27528818A,manuel.rodríguez@awesomenet.com,755124,ES73209503138719377420,1500.62,2023-05-06T10:51:13,Vitoria-Gasteiz,expenses,water,-24.97,-29623.58
buyer_6,Manuel,Rodríguez,1979-02-14,27528818A,manuel.rodríguez@awesomenet.com,755124,ES73209503138719377420,1500.62,2023-05-06T11:55:14,Vitoria-Gasteiz,expenses,phone,-32.95,-29656.53
buyer_6,Manuel,Rodríguez,1979-02-14,27528818A,manuel.rodríguez@awesomenet.com,755124,ES73209503138719377420,1500.62,2023-05-06T14:27:00,Vitoria-Gasteiz,expenses,leisure,-55.07,-29711.6
buyer_6,Manuel,Rodríguez,1979-02-14,27528818A,manuel.rodríguez@awesomenet.com,755124,ES73209503138719377420,1500.62,2023-05-07T06:08:57,Vitoria-Gasteiz,expenses,electricity,-48.12,-29759.72
buyer_6,Manuel,Rodríguez,1979-02-14,27528818A,manuel.rodríguez@awesomenet.com,755124,ES73209503138719377420,1500.62,2023-05-07T10:57:09,Vitoria-Gasteiz,expenses,gas,-30.51,-29790.23
buyer_6,Manuel,Rodríguez,1979-02-14,27528818A,manuel.rodríguez@awesomenet.com,755124,ES73209503138719377420,1500.62,2023-05-07T22:40:50,Vitoria-Gasteiz,expenses,gifts,-268.46,-30058.69
buyer_6,Manuel,Rodríguez,1979-02-14,27528818A,manuel.rodríguez@awesomenet.com,755124,ES73209503138719377420,1500.62,2023-05-08T17:28:01,Vitoria-Gasteiz,expenses,gas,-34.99,-30093.68
buyer_6,Manuel,Rodríguez,1979-02-14,27528818A,manuel.rodríguez@awesomenet.com,755124,ES73209503138719377420,1500.62,2023-05-09T13:41:57,Vitoria-Gasteiz,expenses,food,-85.41,-30179.09
buyer_6,Manuel,Rodríguez,1979-02-14,27528818A,manuel.rodríguez@awesomenet.com,755124,ES73209503138719377420,1500.62,2023-05-09T12:01:58,Vitoria-Gasteiz,expenses,education,-45.65,-30224.74
buyer_6,Manuel,Rodríguez,1979-02-14,27528818A,manuel.rodríguez@awesomenet.com,755124,ES73209503138719377420,1500.62,2023-05-11T19:21:09,Vitoria-Gasteiz,expenses,education,-62.81,-30287.55
buyer_6,Manuel,Rodríguez,1979-02-14,27528818A,manuel.rodríguez@awesomenet.com,755124,ES73209503138719377420,1500.62,2023-05-12T19:23:55,Vitoria-Gasteiz,expenses,food,-86.23,-30373.78
buyer_6,Manuel,Rodríguez,1979-02-14,27528818A,manuel.rodríguez@awesomenet.com,755124,ES73209503138719377420,1500.62,2023-05-14T14:42:53,Vitoria-Gasteiz,expenses,leisure,-64.69,-30438.47
buyer_6,Manuel,Rodríguez,1979-02-14,27528818A,manuel.rodríguez@awesomenet.com,755124,ES73209503138719377420,1500.62,2023-05-15T19:45:55,Vitoria-Gasteiz,expenses,healthcare,-65.17,-30503.64
buyer_6,Manuel,Rodríguez,1979-02-14,27528818A,manuel.rodríguez@awesomenet.com,755124,ES73209503138719377420,1500.62,2023-05-16T13:42:03,Vitoria-Gasteiz,expenses,leisure,-65.1,-30568.74
buyer_6,Manuel,Rodríguez,1979-02-14,27528818A,manuel.rodríguez@awesomenet.com,755124,ES73209503138719377420,1500.62,2023-05-16T08:24:12,Vitoria-Gasteiz,expenses,clothing,-139.04,-30707.78
buyer_6,Manuel,Rodríguez,1979-02-14,27528818A,manuel.rodríguez@awesomenet.com,755124,ES73209503138719377420,1500.62,2023-05-16T13:25:38,Vitoria-Gasteiz,expenses,cash,-100.0,-30807.78
buyer_6,Manuel,Rodríguez,1979-02-14,27528818A,manuel.rodríguez@awesomenet.com,755124,ES73209503138719377420,1500.62,2023-05-17T13:34:46,Vitoria-Gasteiz,expenses,food,-111.43,-30919.21
buyer_6,Manuel,Rodríguez,1979-02-14,27528818A,manuel.rodríguez@awesomenet.com,755124,ES73209503138719377420,1500.62,2023-05-18T15:27:46,Vitoria-Gasteiz,expenses,gifts,-746.1,-31665.31
buyer_6,Manuel,Rodríguez,1979-02-14,27528818A,manuel.rodríguez@awesomenet.com,755124,ES73209503138719377420,1500.62,2023-05-19T12:53:53,Vitoria-Gasteiz,expenses,leisure,-38.88,-31704.19
buyer_6,Manuel,Rodríguez,1979-02-14,27528818A,manuel.rodríguez@awesomenet.com,755124,ES73209503138719377420,1500.62,2023-05-19T08:11:02,Vitoria-Gasteiz,expenses,appliances,-261.33,-31965.52
buyer_6,Manuel,Rodríguez,1979-02-14,27528818A,manuel.rodríguez@awesomenet.com,755124,ES73209503138719377420,1500.62,2023-05-21T15:50:02,Vitoria-Gasteiz,expenses,leisure,-47.64,-32013.16
buyer_6,Manuel,Rodríguez,1979-02-14,27528818A,manuel.rodríguez@awesomenet.com,755124,ES73209503138719377420,1500.62,2023-05-22T09:46:29,Vitoria-Gasteiz,expenses,clothing,-115.93,-32129.09
buyer_6,Manuel,Rodríguez,1979-02-14,27528818A,manuel.rodríguez@awesomenet.com,755124,ES73209503138719377420,1500.62,2023-05-24T18:17:47,Vitoria-Gasteiz,expenses,healthcare,-127.75,-32256.84
buyer_6,Manuel,Rodríguez,1979-02-14,27528818A,manuel.rodríguez@awesomenet.com,755124,ES73209503138719377420,1500.62,2023-05-25T08:38:11,Vitoria-Gasteiz,expenses,leisure,-34.33,-32291.17
buyer_6,Manuel,Rodríguez,1979-02-14,27528818A,manuel.rodríguez@awesomenet.com,755124,ES73209503138719377420,1500.62,2023-05-26T04:14:42,Vitoria-Gasteiz,expenses,transport,-50.24,-32341.41
buyer_6,Manuel,Rodríguez,1979-02-14,27528818A,manuel.rodríguez@awesomenet.com,755124,ES73209503138719377420,1500.62,2023-05-26T14:30:38,Vitoria-Gasteiz,expenses,leisure,-19.72,-32361.13
buyer_6,Manuel,Rodríguez,1979-02-14,27528818A,manuel.rodríguez@awesomenet.com,755124,ES73209503138719377420,1500.62,2023-05-29T17:47:08,Vitoria-Gasteiz,expenses,food,-83.77,-32444.9
buyer_6,Manuel,Rodríguez,1979-02-14,27528818A,manuel.rodríguez@awesomenet.com,755124,ES73209503138719377420,1500.62,2023-05-30T16:51:44,Vitoria-Gasteiz,expenses,cash,-100.0,-32544.9
buyer_6,Manuel,Rodríguez,1979-02-14,27528818A,manuel.rodríguez@awesomenet.com,755124,ES73209503138719377420,1500.62,2023-05-30T03:57:47,Vitoria-Gasteiz,expenses,appliances,-80.88,-32625.78
buyer_6,Manuel,Rodríguez,1979-02-14,27528818A,manuel.rodríguez@awesomenet.com,755124,ES73209503138719377420,1500.62,2023-05-30T20:20:06,Vitoria-Gasteiz,expenses,repairs,-94.35,-32720.13
buyer_6,Manuel,Rodríguez,1979-02-14,27528818A,manuel.rodríguez@awesomenet.com,755124,ES73209503138719377420,1500.62,2023-05-30T16:20:45,Vitoria-Gasteiz,expenses,gifts,-404.15,-33124.28
buyer_6,Manuel,Rodríguez,1979-02-14,27528818A,manuel.rodríguez@awesomenet.com,755124,ES73209503138719377420,1500.62,2023-05-31T20:46:38,Vitoria-Gasteiz,expenses,healthcare,-43.67,-33167.95
buyer_6,Manuel,Rodríguez,1979-02-14,27528818A,manuel.rodríguez@awesomenet.com,755124,ES73209503138719377420,1500.62,2023-06-01T16:55:41,Vitoria-Gasteiz,incomes,salary,1536.94,-31631.01
buyer_6,Manuel,Rodríguez,1979-02-14,27528818A,manuel.rodríguez@awesomenet.com,755124,ES73209503138719377420,1500.62,2023-06-01T16:55:41,Vitoria-Gasteiz,incomes,salary_bonus,1159.29,-30471.72
buyer_6,Manuel,Rodríguez,1979-02-14,27528818A,manuel.rodríguez@awesomenet.com,755124,ES73209503138719377420,1500.62,2023-06-01T19:15:18,Vitoria-Gasteiz,expenses,cash,-100.0,-30571.72
buyer_6,Manuel,Rodríguez,1979-02-14,27528818A,manuel.rodríguez@awesomenet.com,755124,ES73209503138719377420,1500.62,2023-06-02T14:18:16,Vitoria-Gasteiz,expenses,leisure,-84.15,-30655.87
buyer_6,Manuel,Rodríguez,1979-02-14,27528818A,manuel.rodríguez@awesomenet.com,755124,ES73209503138719377420,1500.62,2023-06-03T08:32:59,Vitoria-Gasteiz,expenses,food,-109.66,-30765.53
buyer_6,Manuel,Rodríguez,1979-02-14,27528818A,manuel.rodríguez@awesomenet.com,755124,ES73209503138719377420,1500.62,2023-06-03T08:32:38,Vitoria-Gasteiz,expenses,cash,-100.0,-30865.53
buyer_6,Manuel,Rodríguez,1979-02-14,27528818A,manuel.rodríguez@awesomenet.com,755124,ES73209503138719377420,1500.62,2023-06-04T14:40:51,Vitoria-Gasteiz,expenses,mortgage,-675.14,-31540.67
buyer_6,Manuel,Rodríguez,1979-02-14,27528818A,manuel.rodríguez@awesomenet.com,755124,ES73209503138719377420,1500.62,2023-06-04T17:26:03,Vitoria-Gasteiz,expenses,taxes,-1149.72,-32690.39
buyer_6,Manuel,Rodríguez,1979-02-14,27528818A,manuel.rodríguez@awesomenet.com,755124,ES73209503138719377420,1500.62,2023-06-04T20:49:25,Vitoria-Gasteiz,expenses,insurance,-460.26,-33150.65
buyer_6,Manuel,Rodríguez,1979-02-14,27528818A,manuel.rodríguez@awesomenet.com,755124,ES73209503138719377420,1500.62,2023-06-06T20:19:22,Vitoria-Gasteiz,expenses,food,-88.26,-33238.91
buyer_6,Manuel,Rodríguez,1979-02-14,27528818A,manuel.rodríguez@awesomenet.com,755124,ES73209503138719377420,1500.62,2023-06-06T21:12:32,Vitoria-Gasteiz,expenses,gifts,-415.63,-33654.54
buyer_6,Manuel,Rodríguez,1979-02-14,27528818A,manuel.rodríguez@awesomenet.com,755124,ES73209503138719377420,1500.62,2023-06-07T23:52:19,Vitoria-Gasteiz,expenses,water,-33.56,-33688.1
buyer_6,Manuel,Rodríguez,1979-02-14,27528818A,manuel.rodríguez@awesomenet.com,755124,ES73209503138719377420,1500.62,2023-06-08T19:39:20,Vitoria-Gasteiz,expenses,gas,-70.29,-33758.39
buyer_6,Manuel,Rodríguez,1979-02-14,27528818A,manuel.rodríguez@awesomenet.com,755124,ES73209503138719377420,1500.62,2023-06-08T08:28:00,Vitoria-Gasteiz,expenses,internet,-32.28,-33790.67
buyer_6,Manuel,Rodríguez,1979-02-14,27528818A,manuel.rodríguez@awesomenet.com,755124,ES73209503138719377420,1500.62,2023-06-08T08:16:21,Vitoria-Gasteiz,expenses,phone,-30.07,-33820.74
buyer_6,Manuel,Rodríguez,1979-02-14,27528818A,manuel.rodríguez@awesomenet.com,755124,ES73209503138719377420,1500.62,2023-06-08T19:32:49,Vitoria-Gasteiz,expenses,food,-62.27,-33883.01
buyer_6,Manuel,Rodríguez,1979-02-14,27528818A,manuel.rodríguez@awesomenet.com,755124,ES73209503138719377420,1500.62,2023-06-08T12:56:30,Vitoria-Gasteiz,expenses,transport,-47.5,-33930.51
buyer_6,Manuel,Rodríguez,1979-02-14,27528818A,manuel.rodríguez@awesomenet.com,755124,ES73209503138719377420,1500.62,2023-06-09T10:24:53,Vitoria-Gasteiz,expenses,transport,-87.45,-34017.96
buyer_6,Manuel,Rodríguez,1979-02-14,27528818A,manuel.rodríguez@awesomenet.com,755124,ES73209503138719377420,1500.62,2023-06-10T11:14:01,Vitoria-Gasteiz,expenses,transport,-69.91,-34087.87
buyer_6,Manuel,Rodríguez,1979-02-14,27528818A,manuel.rodríguez@awesomenet.com,755124,ES73209503138719377420,1500.62,2023-06-11T18:02:01,Vitoria-Gasteiz,expenses,food,-93.12,-34180.99
buyer_6,Manuel,Rodríguez,1979-02-14,27528818A,manuel.rodríguez@awesomenet.com,755124,ES73209503138719377420,1500.62,2023-06-17T10:56:27,Vitoria-Gasteiz,expenses,cash,-100.0,-34280.99
buyer_6,Manuel,Rodríguez,1979-02-14,27528818A,manuel.rodríguez@awesomenet.com,755124,ES73209503138719377420,1500.62,2023-06-19T15:30:20,Vitoria-Gasteiz,expenses,food,-87.83,-34368.82
buyer_6,Manuel,Rodríguez,1979-02-14,27528818A,manuel.rodríguez@awesomenet.com,755124,ES73209503138719377420,1500.62,2023-06-21T09:41:24,Vitoria-Gasteiz,expenses,food,-101.26,-34470.08
buyer_6,Manuel,Rodríguez,1979-02-14,27528818A,manuel.rodríguez@awesomenet.com,755124,ES73209503138719377420,1500.62,2023-06-21T09:58:58,Vitoria-Gasteiz,expenses,transport,-87.35,-34557.43
buyer_6,Manuel,Rodríguez,1979-02-14,27528818A,manuel.rodríguez@awesomenet.com,755124,ES73209503138719377420,1500.62,2023-06-21T16:49:48,Vitoria-Gasteiz,expenses,cash,-100.0,-34657.43
buyer_6,Manuel,Rodríguez,1979-02-14,27528818A,manuel.rodríguez@awesomenet.com,755124,ES73209503138719377420,1500.62,2023-06-22T15:22:05,Vitoria-Gasteiz,expenses,food,-90.91,-34748.34
buyer_6,Manuel,Rodríguez,1979-02-14,27528818A,manuel.rodríguez@awesomenet.com,755124,ES73209503138719377420,1500.62,2023-06-22T22:59:11,Vitoria-Gasteiz,expenses,transport,-69.82,-34818.16
buyer_6,Manuel,Rodríguez,1979-02-14,27528818A,manuel.rodríguez@awesomenet.com,755124,ES73209503138719377420,1500.62,2023-06-23T14:27:10,Vitoria-Gasteiz,expenses,food,-108.12,-34926.28
buyer_6,Manuel,Rodríguez,1979-02-14,27528818A,manuel.rodríguez@awesomenet.com,755124,ES73209503138719377420,1500.62,2023-06-23T15:17:05,Vitoria-Gasteiz,expenses,leisure,-83.66,-35009.94
buyer_6,Manuel,Rodríguez,1979-02-14,27528818A,manuel.rodríguez@awesomenet.com,755124,ES73209503138719377420,1500.62,2023-06-25T09:56:52,Vitoria-Gasteiz,expenses,leisure,-50.11,-35060.05
buyer_6,Manuel,Rodríguez,1979-02-14,27528818A,manuel.rodríguez@awesomenet.com,755124,ES73209503138719377420,1500.62,2023-06-25T21:00:40,Vitoria-Gasteiz,expenses,clothing,-95.35,-35155.4
buyer_6,Manuel,Rodríguez,1979-02-14,27528818A,manuel.rodríguez@awesomenet.com,755124,ES73209503138719377420,1500.62,2023-06-30T09:25:41,Vitoria-Gasteiz,expenses,food,-60.82,-35216.22
buyer_6,Manuel,Rodríguez,1979-02-14,27528818A,manuel.rodríguez@awesomenet.com,755124,ES73209503138719377420,1500.62,2023-06-30T22:00:31,Vitoria-Gasteiz,expenses,cash,-100.0,-35316.22
buyer_6,Manuel,Rodríguez,1979-02-14,27528818A,manuel.rodríguez@awesomenet.com,755124,ES73209503138719377420,1500.62,2023-07-01T08:24:15,Vitoria-Gasteiz,incomes,salary,1536.94,-33779.28
buyer_6,Manuel,Rodríguez,1979-02-14,27528818A,manuel.rodríguez@awesomenet.com,755124,ES73209503138719377420,1500.62,2023-07-01T08:07:29,Vitoria-Gasteiz,expenses,appliances,-204.83,-33984.11
buyer_6,Manuel,Rodríguez,1979-02-14,27528818A,manuel.rodríguez@awesomenet.com,755124,ES73209503138719377420,1500.62,2023-07-02T13:15:40,Vitoria-Gasteiz,expenses,transport,-48.03,-34032.14
buyer_6,Manuel,Rodríguez,1979-02-14,27528818A,manuel.rodríguez@awesomenet.com,755124,ES73209503138719377420,1500.62,2023-07-02T20:42:00,Vitoria-Gasteiz,expenses,cash,-100.0,-34132.14
buyer_6,Manuel,Rodríguez,1979-02-14,27528818A,manuel.rodríguez@awesomenet.com,755124,ES73209503138719377420,1500.62,2023-07-02T14:29:01,Vitoria-Gasteiz,expenses,repairs,-224.3,-34356.44
buyer_6,Manuel,Rodríguez,1979-02-14,27528818A,manuel.rodríguez@awesomenet.com,755124,ES73209503138719377420,1500.62,2023-07-03T20:20:56,Vitoria-Gasteiz,expenses,food,-65.69,-34422.13
buyer_6,Manuel,Rodríguez,1979-02-14,27528818A,manuel.rodríguez@awesomenet.com,755124,ES73209503138719377420,1500.62,2023-07-03T20:59:00,Vitoria-Gasteiz,expenses,cash,-100.0,-34522.13
buyer_6,Manuel,Rodríguez,1979-02-14,27528818A,manuel.rodríguez@awesomenet.com,755124,ES73209503138719377420,1500.62,2023-07-04T18:15:28,Vitoria-Gasteiz,expenses,mortgage,-675.14,-35197.27
buyer_6,Manuel,Rodríguez,1979-02-14,27528818A,manuel.rodríguez@awesomenet.com,755124,ES73209503138719377420,1500.62,2023-07-04T09:48:11,Vitoria-Gasteiz,expenses,cash,-100.0,-35297.27
buyer_6,Manuel,Rodríguez,1979-02-14,27528818A,manuel.rodríguez@awesomenet.com,755124,ES73209503138719377420,1500.62,2023-07-05T12:11:47,Vitoria-Gasteiz,expenses,food,-79.62,-35376.89
buyer_6,Manuel,Rodríguez,1979-02-14,27528818A,manuel.rodríguez@awesomenet.com,755124,ES73209503138719377420,1500.62,2023-07-06T22:18:08,Vitoria-Gasteiz,expenses,electricity,-62.12,-35439.01
buyer_6,Manuel,Rodríguez,1979-02-14,27528818A,manuel.rodríguez@awesomenet.com,755124,ES73209503138719377420,1500.62,2023-07-06T08:39:42,Vitoria-Gasteiz,expenses,cash,-100.0,-35539.01
buyer_6,Manuel,Rodríguez,1979-02-14,27528818A,manuel.rodríguez@awesomenet.com,755124,ES73209503138719377420,1500.62,2023-07-07T18:52:45,Vitoria-Gasteiz,expenses,gas,-24.62,-35563.63
buyer_6,Manuel,Rodríguez,1979-02-14,27528818A,manuel.rodríguez@awesomenet.com,755124,ES73209503138719377420,1500.62,2023-07-07T14:55:12,Vitoria-Gasteiz,expenses,leisure,-44.81,-35608.44
buyer_6,Manuel,Rodríguez,1979-02-14,27528818A,manuel.rodríguez@awesomenet.com,755124,ES73209503138719377420,1500.62,2023-07-07T11:25:12,Vitoria-Gasteiz,expenses,cash,-100.0,-35708.44
buyer_6,Manuel,Rodríguez,1979-02-14,27528818A,manuel.rodríguez@awesomenet.com,755124,ES73209503138719377420,1500.62,2023-07-08T23:56:33,Vitoria-Gasteiz,expenses,education,-72.56,-35781.0
buyer_6,Manuel,Rodríguez,1979-02-14,27528818A,manuel.rodríguez@awesomenet.com,755124,ES73209503138719377420,1500.62,2023-07-09T14:06:14,Vitoria-Gasteiz,expenses,transport,-52.95,-35833.95
buyer_6,Manuel,Rodríguez,1979-02-14,27528818A,manuel.rodríguez@awesomenet.com,755124,ES73209503138719377420,1500.62,2023-07-10T10:36:53,Vitoria-Gasteiz,expenses,cash,-100.0,-35933.95
buyer_6,Manuel,Rodríguez,1979-02-14,27528818A,manuel.rodríguez@awesomenet.com,755124,ES73209503138719377420,1500.62,2023-07-10T07:56:36,Vitoria-Gasteiz,expenses,repairs,-34.15,-35968.1
buyer_6,Manuel,Rodríguez,1979-02-14,27528818A,manuel.rodríguez@awesomenet.com,755124,ES73209503138719377420,1500.62,2023-07-12T16:35:28,Vitoria-Gasteiz,expenses,leisure,-56.19,-36024.29
buyer_6,Manuel,Rodríguez,1979-02-14,27528818A,manuel.rodríguez@awesomenet.com,755124,ES73209503138719377420,1500.62,2023-07-12T13:01:39,Vitoria-Gasteiz,expenses,healthcare,-183.74,-36208.03
buyer_6,Manuel,Rodríguez,1979-02-14,27528818A,manuel.rodríguez@awesomenet.com,755124,ES73209503138719377420,1500.62,2023-07-12T22:06:49,Vitoria-Gasteiz,expenses,travel,-506.53,-36714.56
buyer_6,Manuel,Rodríguez,1979-02-14,27528818A,manuel.rodríguez@awesomenet.com,755124,ES73209503138719377420,1500.62,2023-07-13T17:42:02,Vitoria-Gasteiz,expenses,cash,-100.0,-36814.56
buyer_6,Manuel,Rodríguez,1979-02-14,27528818A,manuel.rodríguez@awesomenet.com,755124,ES73209503138719377420,1500.62,2023-07-14T15:46:46,Vitoria-Gasteiz,expenses,clothing,-95.21,-36909.77
buyer_6,Manuel,Rodríguez,1979-02-14,27528818A,manuel.rodríguez@awesomenet.com,755124,ES73209503138719377420,1500.62,2023-07-15T16:58:04,Vitoria-Gasteiz,expenses,food,-122.15,-37031.92
buyer_6,Manuel,Rodríguez,1979-02-14,27528818A,manuel.rodríguez@awesomenet.com,755124,ES73209503138719377420,1500.62,2023-07-18T16:04:29,Vitoria-Gasteiz,expenses,food,-61.63,-37093.55
buyer_6,Manuel,Rodríguez,1979-02-14,27528818A,manuel.rodríguez@awesomenet.com,755124,ES73209503138719377420,1500.62,2023-07-18T11:55:37,Vitoria-Gasteiz,expenses,transport,-49.54,-37143.09
buyer_6,Manuel,Rodríguez,1979-02-14,27528818A,manuel.rodríguez@awesomenet.com,755124,ES73209503138719377420,1500.62,2023-07-19T23:01:20,Vitoria-Gasteiz,expenses,education,-57.99,-37201.08
buyer_6,Manuel,Rodríguez,1979-02-14,27528818A,manuel.rodríguez@awesomenet.com,755124,ES73209503138719377420,1500.62,2023-07-21T04:43:45,Vitoria-Gasteiz,expenses,leisure,-19.62,-37220.7
buyer_6,Manuel,Rodríguez,1979-02-14,27528818A,manuel.rodríguez@awesomenet.com,755124,ES73209503138719377420,1500.62,2023-07-22T13:57:42,Vitoria-Gasteiz,expenses,food,-122.28,-37342.98
buyer_6,Manuel,Rodríguez,1979-02-14,27528818A,manuel.rodríguez@awesomenet.com,755124,ES73209503138719377420,1500.62,2023-07-22T10:19:09,Vitoria-Gasteiz,expenses,leisure,-49.88,-37392.86
buyer_6,Manuel,Rodríguez,1979-02-14,27528818A,manuel.rodríguez@awesomenet.com,755124,ES73209503138719377420,1500.62,2023-07-22T15:27:59,Vitoria-Gasteiz,expenses,travel,-501.96,-37894.82
buyer_6,Manuel,Rodríguez,1979-02-14,27528818A,manuel.rodríguez@awesomenet.com,755124,ES73209503138719377420,1500.62,2023-07-23T20:53:59,Vitoria-Gasteiz,expenses,appliances,-149.03,-38043.85
buyer_6,Manuel,Rodríguez,1979-02-14,27528818A,manuel.rodríguez@awesomenet.com,755124,ES73209503138719377420,1500.62,2023-07-24T15:18:12,Vitoria-Gasteiz,expenses,gifts,-759.51,-38803.36
buyer_6,Manuel,Rodríguez,1979-02-14,27528818A,manuel.rodríguez@awesomenet.com,755124,ES73209503138719377420,1500.62,2023-07-26T20:57:39,Vitoria-Gasteiz,expenses,food,-88.4,-38891.76
buyer_6,Manuel,Rodríguez,1979-02-14,27528818A,manuel.rodríguez@awesomenet.com,755124,ES73209503138719377420,1500.62,2023-07-26T16:38:34,Vitoria-Gasteiz,expenses,cash,-100.0,-38991.76
buyer_6,Manuel,Rodríguez,1979-02-14,27528818A,manuel.rodríguez@awesomenet.com,755124,ES73209503138719377420,1500.62,2023-07-29T09:44:08,Vitoria-Gasteiz,expenses,cash,-100.0,-39091.76
buyer_6,Manuel,Rodríguez,1979-02-14,27528818A,manuel.rodríguez@awesomenet.com,755124,ES73209503138719377420,1500.62,2023-07-30T08:24:16,Vitoria-Gasteiz,expenses,cash,-100.0,-39191.76
buyer_6,Manuel,Rodríguez,1979-02-14,27528818A,manuel.rodríguez@awesomenet.com,755124,ES73209503138719377420,1500.62,2023-07-31T19:27:20,Vitoria-Gasteiz,expenses,food,-107.45,-39299.21
buyer_6,Manuel,Rodríguez,1979-02-14,27528818A,manuel.rodríguez@awesomenet.com,755124,ES73209503138719377420,1500.62,2023-07-31T14:45:35,Vitoria-Gasteiz,expenses,leisure,-34.83,-39334.04
buyer_6,Manuel,Rodríguez,1979-02-14,27528818A,manuel.rodríguez@awesomenet.com,755124,ES73209503138719377420,1500.62,2023-08-01T15:57:02,Vitoria-Gasteiz,incomes,salary,1536.94,-37797.1
buyer_6,Manuel,Rodríguez,1979-02-14,27528818A,manuel.rodríguez@awesomenet.com,755124,ES73209503138719377420,1500.62,2023-08-01T16:13:08,Vitoria-Gasteiz,expenses,food,-93.36,-37890.46
buyer_6,Manuel,Rodríguez,1979-02-14,27528818A,manuel.rodríguez@awesomenet.com,755124,ES73209503138719377420,1500.62,2023-08-01T15:59:23,Vitoria-Gasteiz,expenses,appliances,-151.75,-38042.21
buyer_6,Manuel,Rodríguez,1979-02-14,27528818A,manuel.rodríguez@awesomenet.com,755124,ES73209503138719377420,1500.62,2023-08-02T10:56:59,Vitoria-Gasteiz,expenses,leisure,-64.32,-38106.53
buyer_6,Manuel,Rodríguez,1979-02-14,27528818A,manuel.rodríguez@awesomenet.com,755124,ES73209503138719377420,1500.62,2023-08-02T13:51:41,Vitoria-Gasteiz,expenses,education,-48.65,-38155.18
buyer_6,Manuel,Rodríguez,1979-02-14,27528818A,manuel.rodríguez@awesomenet.com,755124,ES73209503138719377420,1500.62,2023-08-02T21:18:53,Vitoria-Gasteiz,expenses,appliances,-408.79,-38563.97
buyer_6,Manuel,Rodríguez,1979-02-14,27528818A,manuel.rodríguez@awesomenet.com,755124,ES73209503138719377420,1500.62,2023-08-04T11:24:25,Vitoria-Gasteiz,expenses,mortgage,-675.14,-39239.11
buyer_6,Manuel,Rodríguez,1979-02-14,27528818A,manuel.rodríguez@awesomenet.com,755124,ES73209503138719377420,1500.62,2023-08-04T16:15:40,Vitoria-Gasteiz,expenses,leisure,-37.32,-39276.43
buyer_6,Manuel,Rodríguez,1979-02-14,27528818A,manuel.rodríguez@awesomenet.com,755124,ES73209503138719377420,1500.62,2023-08-04T18:18:29,Vitoria-Gasteiz,expenses,healthcare,-101.76,-39378.19
buyer_6,Manuel,Rodríguez,1979-02-14,27528818A,manuel.rodríguez@awesomenet.com,755124,ES73209503138719377420,1500.62,2023-08-05T08:12:46,Vitoria-Gasteiz,expenses,phone,-30.83,-39409.02
buyer_6,Manuel,Rodríguez,1979-02-14,27528818A,manuel.rodríguez@awesomenet.com,755124,ES73209503138719377420,1500.62,2023-08-05T23:31:14,Vitoria-Gasteiz,expenses,transport,-88.85,-39497.87
buyer_6,Manuel,Rodríguez,1979-02-14,27528818A,manuel.rodríguez@awesomenet.com,755124,ES73209503138719377420,1500.62,2023-08-05T19:12:29,Vitoria-Gasteiz,expenses,leisure,-25.44,-39523.31
buyer_6,Manuel,Rodríguez,1979-02-14,27528818A,manuel.rodríguez@awesomenet.com,755124,ES73209503138719377420,1500.62,2023-08-06T19:44:37,Vitoria-Gasteiz,expenses,phone,-28.48,-39551.79
buyer_6,Manuel,Rodríguez,1979-02-14,27528818A,manuel.rodríguez@awesomenet.com,755124,ES73209503138719377420,1500.62,2023-08-07T18:02:12,Vitoria-Gasteiz,expenses,electricity,-41.73,-39593.52
buyer_6,Manuel,Rodríguez,1979-02-14,27528818A,manuel.rodríguez@awesomenet.com,755124,ES73209503138719377420,1500.62,2023-08-07T18:43:28,Vitoria-Gasteiz,expenses,phone,-33.55,-39627.07
buyer_6,Manuel,Rodríguez,1979-02-14,27528818A,manuel.rodríguez@awesomenet.com,755124,ES73209503138719377420,1500.62,2023-08-08T19:15:30,Vitoria-Gasteiz,expenses,transport,-54.7,-39681.77
buyer_6,Manuel,Rodríguez,1979-02-14,27528818A,manuel.rodríguez@awesomenet.com,755124,ES73209503138719377420,1500.62,2023-08-10T09:12:37,Vitoria-Gasteiz,expenses,food,-66.82,-39748.59
buyer_6,Manuel,Rodríguez,1979-02-14,27528818A,manuel.rodríguez@awesomenet.com,755124,ES73209503138719377420,1500.62,2023-08-13T10:28:58,Vitoria-Gasteiz,expenses,cash,-100.0,-39848.59
buyer_6,Manuel,Rodríguez,1979-02-14,27528818A,manuel.rodríguez@awesomenet.com,755124,ES73209503138719377420,1500.62,2023-08-14T19:42:33,Vitoria-Gasteiz,expenses,leisure,-76.8,-39925.39
buyer_6,Manuel,Rodríguez,1979-02-14,27528818A,manuel.rodríguez@awesomenet.com,755124,ES73209503138719377420,1500.62,2023-08-15T12:32:59,Vitoria-Gasteiz,expenses,leisure,-65.89,-39991.28
buyer_6,Manuel,Rodríguez,1979-02-14,27528818A,manuel.rodríguez@awesomenet.com,755124,ES73209503138719377420,1500.62,2023-08-18T20:21:03,Vitoria-Gasteiz,expenses,food,-119.25,-40110.53
buyer_6,Manuel,Rodríguez,1979-02-14,27528818A,manuel.rodríguez@awesomenet.com,755124,ES73209503138719377420,1500.62,2023-08-18T09:15:01,Vitoria-Gasteiz,expenses,travel,-385.18,-40495.71
buyer_6,Manuel,Rodríguez,1979-02-14,27528818A,manuel.rodríguez@awesomenet.com,755124,ES73209503138719377420,1500.62,2023-08-20T22:50:29,Vitoria-Gasteiz,expenses,food,-85.69,-40581.4
buyer_6,Manuel,Rodríguez,1979-02-14,27528818A,manuel.rodríguez@awesomenet.com,755124,ES73209503138719377420,1500.62,2023-08-20T08:59:11,Vitoria-Gasteiz,expenses,transport,-42.95,-40624.35
buyer_6,Manuel,Rodríguez,1979-02-14,27528818A,manuel.rodríguez@awesomenet.com,755124,ES73209503138719377420,1500.62,2023-08-21T15:57:53,Vitoria-Gasteiz,expenses,transport,-62.29,-40686.64
buyer_6,Manuel,Rodríguez,1979-02-14,27528818A,manuel.rodríguez@awesomenet.com,755124,ES73209503138719377420,1500.62,2023-08-23T12:09:59,Vitoria-Gasteiz,expenses,food,-113.61,-40800.25
buyer_6,Manuel,Rodríguez,1979-02-14,27528818A,manuel.rodríguez@awesomenet.com,755124,ES73209503138719377420,1500.62,2023-08-23T17:20:27,Vitoria-Gasteiz,expenses,appliances,-276.19,-41076.44
buyer_6,Manuel,Rodríguez,1979-02-14,27528818A,manuel.rodríguez@awesomenet.com,755124,ES73209503138719377420,1500.62,2023-08-24T20:18:24,Vitoria-Gasteiz,expenses,cash,-100.0,-41176.44
buyer_6,Manuel,Rodríguez,1979-02-14,27528818A,manuel.rodríguez@awesomenet.com,755124,ES73209503138719377420,1500.62,2023-08-25T15:39:53,Vitoria-Gasteiz,expenses,repairs,-102.57,-41279.01
buyer_6,Manuel,Rodríguez,1979-02-14,27528818A,manuel.rodríguez@awesomenet.com,755124,ES73209503138719377420,1500.62,2023-08-26T18:33:23,Vitoria-Gasteiz,expenses,healthcare,-123.5,-41402.51
buyer_6,Manuel,Rodríguez,1979-02-14,27528818A,manuel.rodríguez@awesomenet.com,755124,ES73209503138719377420,1500.62,2023-08-26T21:00:37,Vitoria-Gasteiz,expenses,education,-65.74,-41468.25
buyer_6,Manuel,Rodríguez,1979-02-14,27528818A,manuel.rodríguez@awesomenet.com,755124,ES73209503138719377420,1500.62,2023-08-27T11:35:37,Vitoria-Gasteiz,expenses,food,-68.03,-41536.28
buyer_6,Manuel,Rodríguez,1979-02-14,27528818A,manuel.rodríguez@awesomenet.com,755124,ES73209503138719377420,1500.62,2023-08-28T08:53:56,Vitoria-Gasteiz,expenses,leisure,-21.26,-41557.54
buyer_6,Manuel,Rodríguez,1979-02-14,27528818A,manuel.rodríguez@awesomenet.com,755124,ES73209503138719377420,1500.62,2023-09-01T22:08:31,Vitoria-Gasteiz,incomes,salary,1536.94,-40020.6
buyer_6,Manuel,Rodríguez,1979-02-14,27528818A,manuel.rodríguez@awesomenet.com,755124,ES73209503138719377420,1500.62,2023-09-01T22:08:31,Vitoria-Gasteiz,incomes,extra_income,161.05,-39859.55
buyer_6,Manuel,Rodríguez,1979-02-14,27528818A,manuel.rodríguez@awesomenet.com,755124,ES73209503138719377420,1500.62,2023-09-01T17:40:42,Vitoria-Gasteiz,expenses,transport,-87.92,-39947.47
buyer_6,Manuel,Rodríguez,1979-02-14,27528818A,manuel.rodríguez@awesomenet.com,755124,ES73209503138719377420,1500.62,2023-09-01T11:09:03,Vitoria-Gasteiz,expenses,leisure,-62.07,-40009.54
buyer_6,Manuel,Rodríguez,1979-02-14,27528818A,manuel.rodríguez@awesomenet.com,755124,ES73209503138719377420,1500.62,2023-09-02T08:19:19,Vitoria-Gasteiz,expenses,food,-60.2,-40069.74
buyer_6,Manuel,Rodríguez,1979-02-14,27528818A,manuel.rodríguez@awesomenet.com,755124,ES73209503138719377420,1500.62,2023-09-02T13:33:51,Vitoria-Gasteiz,expenses,transport,-68.71,-40138.45
buyer_6,Manuel,Rodríguez,1979-02-14,27528818A,manuel.rodríguez@awesomenet.com,755124,ES73209503138719377420,1500.62,2023-09-04T11:47:43,Vitoria-Gasteiz,expenses,mortgage,-675.14,-40813.59
buyer_6,Manuel,Rodríguez,1979-02-14,27528818A,manuel.rodríguez@awesomenet.com,755124,ES73209503138719377420,1500.62,2023-09-05T06:38:23,Vitoria-Gasteiz,expenses,electricity,-37.68,-40851.27
buyer_6,Manuel,Rodríguez,1979-02-14,27528818A,manuel.rodríguez@awesomenet.com,755124,ES73209503138719377420,1500.62,2023-09-05T03:10:19,Vitoria-Gasteiz,expenses,gas,-48.9,-40900.17
buyer_6,Manuel,Rodríguez,1979-02-14,27528818A,manuel.rodríguez@awesomenet.com,755124,ES73209503138719377420,1500.62,2023-09-05T01:07:53,Vitoria-Gasteiz,expenses,food,-94.61,-40994.78
buyer_6,Manuel,Rodríguez,1979-02-14,27528818A,manuel.rodríguez@awesomenet.com,755124,ES73209503138719377420,1500.62,2023-09-05T11:04:39,Vitoria-Gasteiz,expenses,healthcare,-174.68,-41169.46
buyer_6,Manuel,Rodríguez,1979-02-14,27528818A,manuel.rodríguez@awesomenet.com,755124,ES73209503138719377420,1500.62,2023-09-05T15:31:23,Vitoria-Gasteiz,expenses,cash,-100.0,-41269.46
buyer_6,Manuel,Rodríguez,1979-02-14,27528818A,manuel.rodríguez@awesomenet.com,755124,ES73209503138719377420,1500.62,2023-09-06T15:29:20,Vitoria-Gasteiz,expenses,water,-28.4,-41297.86
buyer_6,Manuel,Rodríguez,1979-02-14,27528818A,manuel.rodríguez@awesomenet.com,755124,ES73209503138719377420,1500.62,2023-09-06T10:27:03,Vitoria-Gasteiz,expenses,internet,-32.28,-41330.14
buyer_6,Manuel,Rodríguez,1979-02-14,27528818A,manuel.rodríguez@awesomenet.com,755124,ES73209503138719377420,1500.62,2023-09-07T14:44:26,Vitoria-Gasteiz,expenses,electricity,-26.47,-41356.61
buyer_6,Manuel,Rodríguez,1979-02-14,27528818A,manuel.rodríguez@awesomenet.com,755124,ES73209503138719377420,1500.62,2023-09-08T20:57:53,Vitoria-Gasteiz,expenses,phone,-24.68,-41381.29
buyer_6,Manuel,Rodríguez,1979-02-14,27528818A,manuel.rodríguez@awesomenet.com,755124,ES73209503138719377420,1500.62,2023-09-08T09:33:42,Vitoria-Gasteiz,expenses,education,-62.66,-41443.95
buyer_6,Manuel,Rodríguez,1979-02-14,27528818A,manuel.rodríguez@awesomenet.com,755124,ES73209503138719377420,1500.62,2023-09-09T12:50:13,Vitoria-Gasteiz,expenses,food,-91.25,-41535.2
buyer_6,Manuel,Rodríguez,1979-02-14,27528818A,manuel.rodríguez@awesomenet.com,755124,ES73209503138719377420,1500.62,2023-09-11T19:28:45,Vitoria-Gasteiz,expenses,food,-114.43,-41649.63
buyer_6,Manuel,Rodríguez,1979-02-14,27528818A,manuel.rodríguez@awesomenet.com,755124,ES73209503138719377420,1500.62,2023-09-11T10:08:30,Vitoria-Gasteiz,expenses,leisure,-28.51,-41678.14
buyer_6,Manuel,Rodríguez,1979-02-14,27528818A,manuel.rodríguez@awesomenet.com,755124,ES73209503138719377420,1500.62,2023-09-12T15:25:19,Vitoria-Gasteiz,expenses,leisure,-66.63,-41744.77
buyer_6,Manuel,Rodríguez,1979-02-14,27528818A,manuel.rodríguez@awesomenet.com,755124,ES73209503138719377420,1500.62,2023-09-12T08:59:04,Vitoria-Gasteiz,expenses,gifts,-324.38,-42069.15
buyer_6,Manuel,Rodríguez,1979-02-14,27528818A,manuel.rodríguez@awesomenet.com,755124,ES73209503138719377420,1500.62,2023-09-13T18:56:17,Vitoria-Gasteiz,expenses,repairs,-237.11,-42306.26
buyer_6,Manuel,Rodríguez,1979-02-14,27528818A,manuel.rodríguez@awesomenet.com,755124,ES73209503138719377420,1500.62,2023-09-14T18:09:53,Vitoria-Gasteiz,expenses,clothing,-133.92,-42440.18
buyer_6,Manuel,Rodríguez,1979-02-14,27528818A,manuel.rodríguez@awesomenet.com,755124,ES73209503138719377420,1500.62,2023-09-16T16:07:43,Vitoria-Gasteiz,expenses,leisure,-23.74,-42463.92
buyer_6,Manuel,Rodríguez,1979-02-14,27528818A,manuel.rodríguez@awesomenet.com,755124,ES73209503138719377420,1500.62,2023-09-16T18:15:39,Vitoria-Gasteiz,expenses,appliances,-133.61,-42597.53
buyer_6,Manuel,Rodríguez,1979-02-14,27528818A,manuel.rodríguez@awesomenet.com,755124,ES73209503138719377420,1500.62,2023-09-21T08:03:31,Vitoria-Gasteiz,expenses,healthcare,-44.61,-42642.14
buyer_6,Manuel,Rodríguez,1979-02-14,27528818A,manuel.rodríguez@awesomenet.com,755124,ES73209503138719377420,1500.62,2023-09-22T13:24:14,Vitoria-Gasteiz,expenses,transport,-64.2,-42706.34
buyer_6,Manuel,Rodríguez,1979-02-14,27528818A,manuel.rodríguez@awesomenet.com,755124,ES73209503138719377420,1500.62,2023-09-22T09:46:30,Vitoria-Gasteiz,expenses,cash,-100.0,-42806.34
buyer_6,Manuel,Rodríguez,1979-02-14,27528818A,manuel.rodríguez@awesomenet.com,755124,ES73209503138719377420,1500.62,2023-09-23T17:34:46,Vitoria-Gasteiz,expenses,transport,-47.8,-42854.14
buyer_6,Manuel,Rodríguez,1979-02-14,27528818A,manuel.rodríguez@awesomenet.com,755124,ES73209503138719377420,1500.62,2023-09-24T22:33:10,Vitoria-Gasteiz,expenses,cash,-100.0,-42954.14
buyer_6,Manuel,Rodríguez,1979-02-14,27528818A,manuel.rodríguez@awesomenet.com,755124,ES73209503138719377420,1500.62,2023-09-25T17:47:23,Vitoria-Gasteiz,expenses,food,-108.28,-43062.42
buyer_6,Manuel,Rodríguez,1979-02-14,27528818A,manuel.rodríguez@awesomenet.com,755124,ES73209503138719377420,1500.62,2023-09-27T12:21:51,Vitoria-Gasteiz,expenses,leisure,-32.15,-43094.57
buyer_6,Manuel,Rodríguez,1979-02-14,27528818A,manuel.rodríguez@awesomenet.com,755124,ES73209503138719377420,1500.62,2023-09-28T15:16:54,Vitoria-Gasteiz,expenses,food,-105.75,-43200.32
buyer_6,Manuel,Rodríguez,1979-02-14,27528818A,manuel.rodríguez@awesomenet.com,755124,ES73209503138719377420,1500.62,2023-09-28T12:23:38,Vitoria-Gasteiz,expenses,cash,-100.0,-43300.32
buyer_6,Manuel,Rodríguez,1979-02-14,27528818A,manuel.rodríguez@awesomenet.com,755124,ES73209503138719377420,1500.62,2023-09-28T08:47:28,Vitoria-Gasteiz,expenses,gifts,-496.67,-43796.99
buyer_6,Manuel,Rodríguez,1979-02-14,27528818A,manuel.rodríguez@awesomenet.com,755124,ES73209503138719377420,1500.62,2023-09-29T13:18:48,Vitoria-Gasteiz,expenses,food,-67.45,-43864.44
buyer_6,Manuel,Rodríguez,1979-02-14,27528818A,manuel.rodríguez@awesomenet.com,755124,ES73209503138719377420,1500.62,2023-09-29T13:54:18,Vitoria-Gasteiz,expenses,education,-51.5,-43915.94
buyer_6,Manuel,Rodríguez,1979-02-14,27528818A,manuel.rodríguez@awesomenet.com,755124,ES73209503138719377420,1500.62,2023-09-30T19:03:10,Vitoria-Gasteiz,expenses,food,-108.47,-44024.41
buyer_6,Manuel,Rodríguez,1979-02-14,27528818A,manuel.rodríguez@awesomenet.com,755124,ES73209503138719377420,1500.62,2023-09-30T20:37:25,Vitoria-Gasteiz,expenses,cash,-100.0,-44124.41
buyer_6,Manuel,Rodríguez,1979-02-14,27528818A,manuel.rodríguez@awesomenet.com,755124,ES73209503138719377420,1500.62,2023-10-01T00:01:17,Vitoria-Gasteiz,incomes,salary,1536.94,-42587.47
buyer_6,Manuel,Rodríguez,1979-02-14,27528818A,manuel.rodríguez@awesomenet.com,755124,ES73209503138719377420,1500.62,2023-10-01T13:31:04,Vitoria-Gasteiz,expenses,food,-61.72,-42649.19
buyer_6,Manuel,Rodríguez,1979-02-14,27528818A,manuel.rodríguez@awesomenet.com,755124,ES73209503138719377420,1500.62,2023-10-03T14:16:08,Vitoria-Gasteiz,expenses,leisure,-29.1,-42678.29
buyer_6,Manuel,Rodríguez,1979-02-14,27528818A,manuel.rodríguez@awesomenet.com,755124,ES73209503138719377420,1500.62,2023-10-04T18:08:24,Vitoria-Gasteiz,expenses,mortgage,-675.14,-43353.43
buyer_6,Manuel,Rodríguez,1979-02-14,27528818A,manuel.rodríguez@awesomenet.com,755124,ES73209503138719377420,1500.62,2023-10-04T16:18:35,Vitoria-Gasteiz,expenses,healthcare,-47.38,-43400.81
buyer_6,Manuel,Rodríguez,1979-02-14,27528818A,manuel.rodríguez@awesomenet.com,755124,ES73209503138719377420,1500.62,2023-10-05T11:07:02,Vitoria-Gasteiz,expenses,electricity,-67.78,-43468.59
buyer_6,Manuel,Rodríguez,1979-02-14,27528818A,manuel.rodríguez@awesomenet.com,755124,ES73209503138719377420,1500.62,2023-10-05T16:11:31,Vitoria-Gasteiz,expenses,transport,-57.24,-43525.83
buyer_6,Manuel,Rodríguez,1979-02-14,27528818A,manuel.rodríguez@awesomenet.com,755124,ES73209503138719377420,1500.62,2023-10-05T11:41:50,Vitoria-Gasteiz,expenses,gifts,-360.53,-43886.36
buyer_6,Manuel,Rodríguez,1979-02-14,27528818A,manuel.rodríguez@awesomenet.com,755124,ES73209503138719377420,1500.62,2023-10-06T03:06:33,Vitoria-Gasteiz,expenses,electricity,-67.77,-43954.13
buyer_6,Manuel,Rodríguez,1979-02-14,27528818A,manuel.rodríguez@awesomenet.com,755124,ES73209503138719377420,1500.62,2023-10-07T19:17:56,Vitoria-Gasteiz,expenses,water,-20.39,-43974.52
buyer_6,Manuel,Rodríguez,1979-02-14,27528818A,manuel.rodríguez@awesomenet.com,755124,ES73209503138719377420,1500.62,2023-10-07T14:51:36,Vitoria-Gasteiz,expenses,gas,-69.81,-44044.33
buyer_6,Manuel,Rodríguez,1979-02-14,27528818A,manuel.rodríguez@awesomenet.com,755124,ES73209503138719377420,1500.62,2023-10-07T13:49:43,Vitoria-Gasteiz,expenses,cash,-100.0,-44144.33
buyer_6,Manuel,Rodríguez,1979-02-14,27528818A,manuel.rodríguez@awesomenet.com,755124,ES73209503138719377420,1500.62,2023-10-08T08:35:56,Vitoria-Gasteiz,expenses,transport,-66.56,-44210.89
buyer_6,Manuel,Rodríguez,1979-02-14,27528818A,manuel.rodríguez@awesomenet.com,755124,ES73209503138719377420,1500.62,2023-10-09T08:34:29,Vitoria-Gasteiz,expenses,food,-89.93,-44300.82
buyer_6,Manuel,Rodríguez,1979-02-14,27528818A,manuel.rodríguez@awesomenet.com,755124,ES73209503138719377420,1500.62,2023-10-10T05:16:34,Vitoria-Gasteiz,expenses,food,-119.09,-44419.91
buyer_6,Manuel,Rodríguez,1979-02-14,27528818A,manuel.rodríguez@awesomenet.com,755124,ES73209503138719377420,1500.62,2023-10-11T20:11:45,Vitoria-Gasteiz,expenses,cash,-100.0,-44519.91
buyer_6,Manuel,Rodríguez,1979-02-14,27528818A,manuel.rodríguez@awesomenet.com,755124,ES73209503138719377420,1500.62,2023-10-12T09:16:31,Vitoria-Gasteiz,expenses,food,-113.65,-44633.56
buyer_6,Manuel,Rodríguez,1979-02-14,27528818A,manuel.rodríguez@awesomenet.com,755124,ES73209503138719377420,1500.62,2023-10-12T05:16:29,Vitoria-Gasteiz,expenses,transport,-64.5,-44698.06
buyer_6,Manuel,Rodríguez,1979-02-14,27528818A,manuel.rodríguez@awesomenet.com,755124,ES73209503138719377420,1500.62,2023-10-12T22:44:39,Vitoria-Gasteiz,expenses,leisure,-72.52,-44770.58
buyer_6,Manuel,Rodríguez,1979-02-14,27528818A,manuel.rodríguez@awesomenet.com,755124,ES73209503138719377420,1500.62,2023-10-14T13:26:11,Vitoria-Gasteiz,expenses,cash,-100.0,-44870.58
buyer_6,Manuel,Rodríguez,1979-02-14,27528818A,manuel.rodríguez@awesomenet.com,755124,ES73209503138719377420,1500.62,2023-10-16T01:49:48,Vitoria-Gasteiz,expenses,food,-65.12,-44935.7
buyer_6,Manuel,Rodríguez,1979-02-14,27528818A,manuel.rodríguez@awesomenet.com,755124,ES73209503138719377420,1500.62,2023-10-16T19:01:42,Vitoria-Gasteiz,expenses,transport,-42.09,-44977.79
buyer_6,Manuel,Rodríguez,1979-02-14,27528818A,manuel.rodríguez@awesomenet.com,755124,ES73209503138719377420,1500.62,2023-10-17T10:27:12,Vitoria-Gasteiz,expenses,food,-60.79,-45038.58
buyer_6,Manuel,Rodríguez,1979-02-14,27528818A,manuel.rodríguez@awesomenet.com,755124,ES73209503138719377420,1500.62,2023-10-22T14:35:33,Vitoria-Gasteiz,expenses,food,-72.56,-45111.14
buyer_6,Manuel,Rodríguez,1979-02-14,27528818A,manuel.rodríguez@awesomenet.com,755124,ES73209503138719377420,1500.62,2023-10-23T17:54:52,Vitoria-Gasteiz,expenses,cash,-100.0,-45211.14
buyer_6,Manuel,Rodríguez,1979-02-14,27528818A,manuel.rodríguez@awesomenet.com,755124,ES73209503138719377420,1500.62,2023-10-26T14:50:17,Vitoria-Gasteiz,expenses,leisure,-28.04,-45239.18
buyer_6,Manuel,Rodríguez,1979-02-14,27528818A,manuel.rodríguez@awesomenet.com,755124,ES73209503138719377420,1500.62,2023-10-26T19:54:26,Vitoria-Gasteiz,expenses,cash,-100.0,-45339.18
buyer_6,Manuel,Rodríguez,1979-02-14,27528818A,manuel.rodríguez@awesomenet.com,755124,ES73209503138719377420,1500.62,2023-10-29T11:48:38,Vitoria-Gasteiz,expenses,leisure,-55.98,-45395.16
buyer_6,Manuel,Rodríguez,1979-02-14,27528818A,manuel.rodríguez@awesomenet.com,755124,ES73209503138719377420,1500.62,2023-10-30T11:41:26,Vitoria-Gasteiz,expenses,leisure,-82.07,-45477.23
buyer_6,Manuel,Rodríguez,1979-02-14,27528818A,manuel.rodríguez@awesomenet.com,755124,ES73209503138719377420,1500.62,2023-11-01T23:24:23,Vitoria-Gasteiz,incomes,salary,1536.94,-43940.29
buyer_6,Manuel,Rodríguez,1979-02-14,27528818A,manuel.rodríguez@awesomenet.com,755124,ES73209503138719377420,1500.62,2023-11-01T10:26:05,Vitoria-Gasteiz,expenses,cash,-100.0,-44040.29
buyer_6,Manuel,Rodríguez,1979-02-14,27528818A,manuel.rodríguez@awesomenet.com,755124,ES73209503138719377420,1500.62,2023-11-04T19:21:00,Vitoria-Gasteiz,expenses,mortgage,-675.14,-44715.43
buyer_6,Manuel,Rodríguez,1979-02-14,27528818A,manuel.rodríguez@awesomenet.com,755124,ES73209503138719377420,1500.62,2023-11-04T05:05:05,Vitoria-Gasteiz,expenses,gifts,-92.32,-44807.75
buyer_6,Manuel,Rodríguez,1979-02-14,27528818A,manuel.rodríguez@awesomenet.com,755124,ES73209503138719377420,1500.62,2023-11-05T12:18:31,Vitoria-Gasteiz,expenses,water,-30.43,-44838.18
buyer_6,Manuel,Rodríguez,1979-02-14,27528818A,manuel.rodríguez@awesomenet.com,755124,ES73209503138719377420,1500.62,2023-11-05T20:16:27,Vitoria-Gasteiz,expenses,phone,-33.57,-44871.75
buyer_6,Manuel,Rodríguez,1979-02-14,27528818A,manuel.rodríguez@awesomenet.com,755124,ES73209503138719377420,1500.62,2023-11-07T10:37:17,Vitoria-Gasteiz,expenses,water,-25.23,-44896.98
buyer_6,Manuel,Rodríguez,1979-02-14,27528818A,manuel.rodríguez@awesomenet.com,755124,ES73209503138719377420,1500.62,2023-11-07T12:00:50,Vitoria-Gasteiz,expenses,internet,-32.28,-44929.26
buyer_6,Manuel,Rodríguez,1979-02-14,27528818A,manuel.rodríguez@awesomenet.com,755124,ES73209503138719377420,1500.62,2023-11-07T08:46:53,Vitoria-Gasteiz,expenses,gifts,-762.23,-45691.49
buyer_6,Manuel,Rodríguez,1979-02-14,27528818A,manuel.rodríguez@awesomenet.com,755124,ES73209503138719377420,1500.62,2023-11-08T18:44:00,Vitoria-Gasteiz,expenses,water,-22.29,-45713.78
buyer_6,Manuel,Rodríguez,1979-02-14,27528818A,manuel.rodríguez@awesomenet.com,755124,ES73209503138719377420,1500.62,2023-11-08T16:02:27,Vitoria-Gasteiz,expenses,phone,-23.74,-45737.52
buyer_6,Manuel,Rodríguez,1979-02-14,27528818A,manuel.rodríguez@awesomenet.com,755124,ES73209503138719377420,1500.62,2023-11-09T19:32:10,Vitoria-Gasteiz,expenses,cash,-100.0,-45837.52
buyer_6,Manuel,Rodríguez,1979-02-14,27528818A,manuel.rodríguez@awesomenet.com,755124,ES73209503138719377420,1500.62,2023-11-10T17:45:16,Vitoria-Gasteiz,expenses,food,-95.35,-45932.87
buyer_6,Manuel,Rodríguez,1979-02-14,27528818A,manuel.rodríguez@awesomenet.com,755124,ES73209503138719377420,1500.62,2023-11-10T12:40:44,Vitoria-Gasteiz,expenses,leisure,-64.33,-45997.2
buyer_6,Manuel,Rodríguez,1979-02-14,27528818A,manuel.rodríguez@awesomenet.com,755124,ES73209503138719377420,1500.62,2023-11-11T20:27:44,Vitoria-Gasteiz,expenses,clothing,-89.55,-46086.75
buyer_6,Manuel,Rodríguez,1979-02-14,27528818A,manuel.rodríguez@awesomenet.com,755124,ES73209503138719377420,1500.62,2023-11-12T13:10:24,Vitoria-Gasteiz,expenses,leisure,-68.55,-46155.3
buyer_6,Manuel,Rodríguez,1979-02-14,27528818A,manuel.rodríguez@awesomenet.com,755124,ES73209503138719377420,1500.62,2023-11-12T23:05:48,Vitoria-Gasteiz,expenses,repairs,-75.35,-46230.65
buyer_6,Manuel,Rodríguez,1979-02-14,27528818A,manuel.rodríguez@awesomenet.com,755124,ES73209503138719377420,1500.62,2023-11-13T12:23:35,Vitoria-Gasteiz,expenses,leisure,-69.61,-46300.26
buyer_6,Manuel,Rodríguez,1979-02-14,27528818A,manuel.rodríguez@awesomenet.com,755124,ES73209503138719377420,1500.62,2023-11-13T13:41:27,Vitoria-Gasteiz,expenses,gifts,-258.12,-46558.38
buyer_6,Manuel,Rodríguez,1979-02-14,27528818A,manuel.rodríguez@awesomenet.com,755124,ES73209503138719377420,1500.62,2023-11-14T04:30:22,Vitoria-Gasteiz,expenses,appliances,-236.03,-46794.41
buyer_6,Manuel,Rodríguez,1979-02-14,27528818A,manuel.rodríguez@awesomenet.com,755124,ES73209503138719377420,1500.62,2023-11-15T11:53:53,Vitoria-Gasteiz,expenses,cash,-100.0,-46894.41
buyer_6,Manuel,Rodríguez,1979-02-14,27528818A,manuel.rodríguez@awesomenet.com,755124,ES73209503138719377420,1500.62,2023-11-17T08:11:17,Vitoria-Gasteiz,expenses,transport,-64.65,-46959.06
buyer_6,Manuel,Rodríguez,1979-02-14,27528818A,manuel.rodríguez@awesomenet.com,755124,ES73209503138719377420,1500.62,2023-11-17T19:04:57,Vitoria-Gasteiz,expenses,clothing,-158.89,-47117.95
buyer_6,Manuel,Rodríguez,1979-02-14,27528818A,manuel.rodríguez@awesomenet.com,755124,ES73209503138719377420,1500.62,2023-11-18T14:51:46,Vitoria-Gasteiz,expenses,repairs,-311.46,-47429.41
buyer_6,Manuel,Rodríguez,1979-02-14,27528818A,manuel.rodríguez@awesomenet.com,755124,ES73209503138719377420,1500.62,2023-11-19T08:05:32,Vitoria-Gasteiz,expenses,leisure,-78.31,-47507.72
buyer_6,Manuel,Rodríguez,1979-02-14,27528818A,manuel.rodríguez@awesomenet.com,755124,ES73209503138719377420,1500.62,2023-11-21T20:42:01,Vitoria-Gasteiz,expenses,food,-65.29,-47573.01
buyer_6,Manuel,Rodríguez,1979-02-14,27528818A,manuel.rodríguez@awesomenet.com,755124,ES73209503138719377420,1500.62,2023-11-22T01:10:59,Vitoria-Gasteiz,expenses,leisure,-80.26,-47653.27
buyer_6,Manuel,Rodríguez,1979-02-14,27528818A,manuel.rodríguez@awesomenet.com,755124,ES73209503138719377420,1500.62,2023-11-22T11:45:37,Vitoria-Gasteiz,expenses,clothing,-86.7,-47739.97
buyer_6,Manuel,Rodríguez,1979-02-14,27528818A,manuel.rodríguez@awesomenet.com,755124,ES73209503138719377420,1500.62,2023-11-23T20:38:34,Vitoria-Gasteiz,expenses,cash,-100.0,-47839.97
buyer_6,Manuel,Rodríguez,1979-02-14,27528818A,manuel.rodríguez@awesomenet.com,755124,ES73209503138719377420,1500.62,2023-11-23T16:22:51,Vitoria-Gasteiz,expenses,appliances,-400.23,-48240.2
buyer_6,Manuel,Rodríguez,1979-02-14,27528818A,manuel.rodríguez@awesomenet.com,755124,ES73209503138719377420,1500.62,2023-11-23T21:50:30,Vitoria-Gasteiz,expenses,repairs,-280.74,-48520.94
buyer_6,Manuel,Rodríguez,1979-02-14,27528818A,manuel.rodríguez@awesomenet.com,755124,ES73209503138719377420,1500.62,2023-11-26T23:11:35,Vitoria-Gasteiz,expenses,healthcare,-41.56,-48562.5
buyer_6,Manuel,Rodríguez,1979-02-14,27528818A,manuel.rodríguez@awesomenet.com,755124,ES73209503138719377420,1500.62,2023-11-27T09:23:13,Vitoria-Gasteiz,expenses,cash,-100.0,-48662.5
buyer_6,Manuel,Rodríguez,1979-02-14,27528818A,manuel.rodríguez@awesomenet.com,755124,ES73209503138719377420,1500.62,2023-11-27T13:41:28,Vitoria-Gasteiz,expenses,gifts,-75.03,-48737.53
buyer_6,Manuel,Rodríguez,1979-02-14,27528818A,manuel.rodríguez@awesomenet.com,755124,ES73209503138719377420,1500.62,2023-11-29T12:48:15,Vitoria-Gasteiz,expenses,cash,-100.0,-48837.53
buyer_6,Manuel,Rodríguez,1979-02-14,27528818A,manuel.rodríguez@awesomenet.com,755124,ES73209503138719377420,1500.62,2023-12-01T08:09:15,Vitoria-Gasteiz,incomes,salary,1536.94,-47300.59
buyer_6,Manuel,Rodríguez,1979-02-14,27528818A,manuel.rodríguez@awesomenet.com,755124,ES73209503138719377420,1500.62,2023-12-01T08:09:15,Vitoria-Gasteiz,incomes,extra_income,161.05,-47139.54
buyer_6,Manuel,Rodríguez,1979-02-14,27528818A,manuel.rodríguez@awesomenet.com,755124,ES73209503138719377420,1500.62,2023-12-01T08:09:15,Vitoria-Gasteiz,incomes,salary_bonus,1181.24,-45958.3
buyer_6,Manuel,Rodríguez,1979-02-14,27528818A,manuel.rodríguez@awesomenet.com,755124,ES73209503138719377420,1500.62,2023-12-01T14:57:45,Vitoria-Gasteiz,expenses,gifts,-356.05,-46314.35
buyer_6,Manuel,Rodríguez,1979-02-14,27528818A,manuel.rodríguez@awesomenet.com,755124,ES73209503138719377420,1500.62,2023-12-02T12:44:28,Vitoria-Gasteiz,expenses,transport,-73.54,-46387.89
buyer_6,Manuel,Rodríguez,1979-02-14,27528818A,manuel.rodríguez@awesomenet.com,755124,ES73209503138719377420,1500.62,2023-12-02T19:28:15,Vitoria-Gasteiz,expenses,cash,-100.0,-46487.89
buyer_6,Manuel,Rodríguez,1979-02-14,27528818A,manuel.rodríguez@awesomenet.com,755124,ES73209503138719377420,1500.62,2023-12-03T10:02:15,Vitoria-Gasteiz,expenses,cash,-100.0,-46587.89
buyer_6,Manuel,Rodríguez,1979-02-14,27528818A,manuel.rodríguez@awesomenet.com,755124,ES73209503138719377420,1500.62,2023-12-03T13:36:46,Vitoria-Gasteiz,expenses,gifts,-135.98,-46723.87
buyer_6,Manuel,Rodríguez,1979-02-14,27528818A,manuel.rodríguez@awesomenet.com,755124,ES73209503138719377420,1500.62,2023-12-04T18:12:55,Vitoria-Gasteiz,expenses,mortgage,-675.14,-47399.01
buyer_6,Manuel,Rodríguez,1979-02-14,27528818A,manuel.rodríguez@awesomenet.com,755124,ES73209503138719377420,1500.62,2023-12-04T17:28:17,Vitoria-Gasteiz,expenses,clothing,-155.64,-47554.65
buyer_6,Manuel,Rodríguez,1979-02-14,27528818A,manuel.rodríguez@awesomenet.com,755124,ES73209503138719377420,1500.62,2023-12-04T10:31:41,Vitoria-Gasteiz,expenses,education,-45.31,-47599.96
buyer_6,Manuel,Rodríguez,1979-02-14,27528818A,manuel.rodríguez@awesomenet.com,755124,ES73209503138719377420,1500.62,2023-12-05T20:19:15,Vitoria-Gasteiz,expenses,water,-16.12,-47616.08
buyer_6,Manuel,Rodríguez,1979-02-14,27528818A,manuel.rodríguez@awesomenet.com,755124,ES73209503138719377420,1500.62,2023-12-05T12:35:47,Vitoria-Gasteiz,expenses,leisure,-49.57,-47665.65
buyer_6,Manuel,Rodríguez,1979-02-14,27528818A,manuel.rodríguez@awesomenet.com,755124,ES73209503138719377420,1500.62,2023-12-06T18:46:11,Vitoria-Gasteiz,expenses,gas,-47.2,-47712.85
buyer_6,Manuel,Rodríguez,1979-02-14,27528818A,manuel.rodríguez@awesomenet.com,755124,ES73209503138719377420,1500.62,2023-12-06T19:58:31,Vitoria-Gasteiz,expenses,phone,-29.39,-47742.24
buyer_6,Manuel,Rodríguez,1979-02-14,27528818A,manuel.rodríguez@awesomenet.com,755124,ES73209503138719377420,1500.62,2023-12-06T14:15:17,Vitoria-Gasteiz,expenses,food,-108.38,-47850.62
buyer_6,Manuel,Rodríguez,1979-02-14,27528818A,manuel.rodríguez@awesomenet.com,755124,ES73209503138719377420,1500.62,2023-12-07T17:41:09,Vitoria-Gasteiz,expenses,internet,-32.28,-47882.9
buyer_6,Manuel,Rodríguez,1979-02-14,27528818A,manuel.rodríguez@awesomenet.com,755124,ES73209503138719377420,1500.62,2023-12-07T15:23:18,Vitoria-Gasteiz,expenses,cash,-100.0,-47982.9
buyer_6,Manuel,Rodríguez,1979-02-14,27528818A,manuel.rodríguez@awesomenet.com,755124,ES73209503138719377420,1500.62,2023-12-10T12:39:50,Vitoria-Gasteiz,expenses,cash,-100.0,-48082.9
buyer_6,Manuel,Rodríguez,1979-02-14,27528818A,manuel.rodríguez@awesomenet.com,755124,ES73209503138719377420,1500.62,2023-12-11T20:08:55,Vitoria-Gasteiz,expenses,cash,-100.0,-48182.9
buyer_6,Manuel,Rodríguez,1979-02-14,27528818A,manuel.rodríguez@awesomenet.com,755124,ES73209503138719377420,1500.62,2023-12-12T12:51:00,Vitoria-Gasteiz,expenses,transport,-65.74,-48248.64
buyer_6,Manuel,Rodríguez,1979-02-14,27528818A,manuel.rodríguez@awesomenet.com,755124,ES73209503138719377420,1500.62,2023-12-14T12:25:02,Vitoria-Gasteiz,expenses,leisure,-39.62,-48288.26
buyer_6,Manuel,Rodríguez,1979-02-14,27528818A,manuel.rodríguez@awesomenet.com,755124,ES73209503138719377420,1500.62,2023-12-14T09:05:51,Vitoria-Gasteiz,expenses,gifts,-247.48,-48535.74
buyer_6,Manuel,Rodríguez,1979-02-14,27528818A,manuel.rodríguez@awesomenet.com,755124,ES73209503138719377420,1500.62,2023-12-16T08:14:40,Vitoria-Gasteiz,expenses,food,-77.13,-48612.87
buyer_6,Manuel,Rodríguez,1979-02-14,27528818A,manuel.rodríguez@awesomenet.com,755124,ES73209503138719377420,1500.62,2023-12-18T10:59:14,Vitoria-Gasteiz,expenses,cash,-100.0,-48712.87
buyer_6,Manuel,Rodríguez,1979-02-14,27528818A,manuel.rodríguez@awesomenet.com,755124,ES73209503138719377420,1500.62,2023-12-19T19:49:54,Vitoria-Gasteiz,expenses,gifts,-348.08,-49060.95
buyer_6,Manuel,Rodríguez,1979-02-14,27528818A,manuel.rodríguez@awesomenet.com,755124,ES73209503138719377420,1500.62,2023-12-23T13:21:14,Vitoria-Gasteiz,expenses,transport,-73.63,-49134.58
buyer_6,Manuel,Rodríguez,1979-02-14,27528818A,manuel.rodríguez@awesomenet.com,755124,ES73209503138719377420,1500.62,2023-12-29T16:53:35,Vitoria-Gasteiz,expenses,healthcare,-146.65,-49281.23
buyer_6,Manuel,Rodríguez,1979-02-14,27528818A,manuel.rodríguez@awesomenet.com,755124,ES73209503138719377420,1500.62,2023-12-30T20:10:24,Vitoria-Gasteiz,expenses,leisure,-80.8,-49362.03
buyer_6,Manuel,Rodríguez,1979-02-14,27528818A,manuel.rodríguez@awesomenet.com,755124,ES73209503138719377420,1500.62,2024-01-01T13:42:24,Vitoria-Gasteiz,incomes,salary,1569.47,-47792.56
buyer_6,Manuel,Rodríguez,1979-02-14,27528818A,manuel.rodríguez@awesomenet.com,755124,ES73209503138719377420,1500.62,2024-01-01T12:43:21,Vitoria-Gasteiz,expenses,education,-50.16,-47842.72
buyer_6,Manuel,Rodríguez,1979-02-14,27528818A,manuel.rodríguez@awesomenet.com,755124,ES73209503138719377420,1500.62,2024-01-01T14:34:49,Vitoria-Gasteiz,expenses,cash,-100.0,-47942.72
buyer_6,Manuel,Rodríguez,1979-02-14,27528818A,manuel.rodríguez@awesomenet.com,755124,ES73209503138719377420,1500.62,2024-01-01T16:02:57,Vitoria-Gasteiz,expenses,repairs,-80.01,-48022.73
buyer_6,Manuel,Rodríguez,1979-02-14,27528818A,manuel.rodríguez@awesomenet.com,755124,ES73209503138719377420,1500.62,2024-01-02T10:18:28,Vitoria-Gasteiz,expenses,food,-119.49,-48142.22
buyer_6,Manuel,Rodríguez,1979-02-14,27528818A,manuel.rodríguez@awesomenet.com,755124,ES73209503138719377420,1500.62,2024-01-04T10:35:08,Vitoria-Gasteiz,expenses,mortgage,-818.36,-48960.58
buyer_6,Manuel,Rodríguez,1979-02-14,27528818A,manuel.rodríguez@awesomenet.com,755124,ES73209503138719377420,1500.62,2024-01-05T08:21:27,Vitoria-Gasteiz,expenses,water,-23.45,-48984.03
buyer_6,Manuel,Rodríguez,1979-02-14,27528818A,manuel.rodríguez@awesomenet.com,755124,ES73209503138719377420,1500.62,2024-01-05T12:58:41,Vitoria-Gasteiz,expenses,internet,-32.96,-49016.99
buyer_6,Manuel,Rodríguez,1979-02-14,27528818A,manuel.rodríguez@awesomenet.com,755124,ES73209503138719377420,1500.62,2024-01-06T23:32:23,Vitoria-Gasteiz,expenses,phone,-30.5,-49047.49
buyer_6,Manuel,Rodríguez,1979-02-14,27528818A,manuel.rodríguez@awesomenet.com,755124,ES73209503138719377420,1500.62,2024-01-08T16:36:11,Vitoria-Gasteiz,expenses,internet,-32.96,-49080.45
buyer_6,Manuel,Rodríguez,1979-02-14,27528818A,manuel.rodríguez@awesomenet.com,755124,ES73209503138719377420,1500.62,2024-01-08T17:21:09,Vitoria-Gasteiz,expenses,cash,-100.0,-49180.45
buyer_6,Manuel,Rodríguez,1979-02-14,27528818A,manuel.rodríguez@awesomenet.com,755124,ES73209503138719377420,1500.62,2024-01-08T14:39:34,Vitoria-Gasteiz,expenses,travel,-348.7,-49529.15
buyer_6,Manuel,Rodríguez,1979-02-14,27528818A,manuel.rodríguez@awesomenet.com,755124,ES73209503138719377420,1500.62,2024-01-09T10:32:07,Vitoria-Gasteiz,expenses,clothing,-124.83,-49653.98
buyer_6,Manuel,Rodríguez,1979-02-14,27528818A,manuel.rodríguez@awesomenet.com,755124,ES73209503138719377420,1500.62,2024-01-09T14:21:51,Vitoria-Gasteiz,expenses,cash,-100.0,-49753.98
buyer_6,Manuel,Rodríguez,1979-02-14,27528818A,manuel.rodríguez@awesomenet.com,755124,ES73209503138719377420,1500.62,2024-01-09T10:02:49,Vitoria-Gasteiz,expenses,gifts,-260.71,-50014.69
buyer_6,Manuel,Rodríguez,1979-02-14,27528818A,manuel.rodríguez@awesomenet.com,755124,ES73209503138719377420,1500.62,2024-01-10T18:21:29,Vitoria-Gasteiz,expenses,repairs,-150.79,-50165.48
buyer_6,Manuel,Rodríguez,1979-02-14,27528818A,manuel.rodríguez@awesomenet.com,755124,ES73209503138719377420,1500.62,2024-01-11T16:32:34,Vitoria-Gasteiz,expenses,cash,-100.0,-50265.48
buyer_6,Manuel,Rodríguez,1979-02-14,27528818A,manuel.rodríguez@awesomenet.com,755124,ES73209503138719377420,1500.62,2024-01-11T09:33:29,Vitoria-Gasteiz,expenses,gifts,-25.28,-50290.76
buyer_6,Manuel,Rodríguez,1979-02-14,27528818A,manuel.rodríguez@awesomenet.com,755124,ES73209503138719377420,1500.62,2024-01-13T09:55:16,Vitoria-Gasteiz,expenses,repairs,-38.07,-50328.83
buyer_6,Manuel,Rodríguez,1979-02-14,27528818A,manuel.rodríguez@awesomenet.com,755124,ES73209503138719377420,1500.62,2024-01-15T06:57:08,Vitoria-Gasteiz,expenses,food,-119.6,-50448.43
buyer_6,Manuel,Rodríguez,1979-02-14,27528818A,manuel.rodríguez@awesomenet.com,755124,ES73209503138719377420,1500.62,2024-01-15T14:34:03,Vitoria-Gasteiz,expenses,education,-42.85,-50491.28
buyer_6,Manuel,Rodríguez,1979-02-14,27528818A,manuel.rodríguez@awesomenet.com,755124,ES73209503138719377420,1500.62,2024-01-15T09:44:05,Vitoria-Gasteiz,expenses,cash,-100.0,-50591.28
buyer_6,Manuel,Rodríguez,1979-02-14,27528818A,manuel.rodríguez@awesomenet.com,755124,ES73209503138719377420,1500.62,2024-01-20T11:23:53,Vitoria-Gasteiz,expenses,food,-69.43,-50660.71
buyer_6,Manuel,Rodríguez,1979-02-14,27528818A,manuel.rodríguez@awesomenet.com,755124,ES73209503138719377420,1500.62,2024-01-21T10:37:08,Vitoria-Gasteiz,expenses,leisure,-39.35,-50700.06
buyer_6,Manuel,Rodríguez,1979-02-14,27528818A,manuel.rodríguez@awesomenet.com,755124,ES73209503138719377420,1500.62,2024-01-21T11:06:47,Vitoria-Gasteiz,expenses,repairs,-103.75,-50803.81
buyer_6,Manuel,Rodríguez,1979-02-14,27528818A,manuel.rodríguez@awesomenet.com,755124,ES73209503138719377420,1500.62,2024-01-21T18:28:53,Vitoria-Gasteiz,expenses,gifts,-113.58,-50917.39
buyer_6,Manuel,Rodríguez,1979-02-14,27528818A,manuel.rodríguez@awesomenet.com,755124,ES73209503138719377420,1500.62,2024-01-22T23:43:28,Vitoria-Gasteiz,expenses,food,-78.47,-50995.86
buyer_6,Manuel,Rodríguez,1979-02-14,27528818A,manuel.rodríguez@awesomenet.com,755124,ES73209503138719377420,1500.62,2024-01-23T14:50:49,Vitoria-Gasteiz,expenses,food,-118.84,-51114.7
buyer_6,Manuel,Rodríguez,1979-02-14,27528818A,manuel.rodríguez@awesomenet.com,755124,ES73209503138719377420,1500.62,2024-01-24T22:31:08,Vitoria-Gasteiz,expenses,education,-72.73,-51187.43
buyer_6,Manuel,Rodríguez,1979-02-14,27528818A,manuel.rodríguez@awesomenet.com,755124,ES73209503138719377420,1500.62,2024-01-24T03:12:32,Vitoria-Gasteiz,expenses,appliances,-335.76,-51523.19
buyer_6,Manuel,Rodríguez,1979-02-14,27528818A,manuel.rodríguez@awesomenet.com,755124,ES73209503138719377420,1500.62,2024-01-27T07:44:07,Vitoria-Gasteiz,expenses,healthcare,-50.62,-51573.81
buyer_6,Manuel,Rodríguez,1979-02-14,27528818A,manuel.rodríguez@awesomenet.com,755124,ES73209503138719377420,1500.62,2024-01-27T20:35:55,Vitoria-Gasteiz,expenses,gifts,-174.36,-51748.17
buyer_6,Manuel,Rodríguez,1979-02-14,27528818A,manuel.rodríguez@awesomenet.com,755124,ES73209503138719377420,1500.62,2024-01-29T06:53:57,Vitoria-Gasteiz,expenses,leisure,-31.77,-51779.94
buyer_6,Manuel,Rodríguez,1979-02-14,27528818A,manuel.rodríguez@awesomenet.com,755124,ES73209503138719377420,1500.62,2024-01-30T11:29:10,Vitoria-Gasteiz,expenses,cash,-100.0,-51879.94
buyer_6,Manuel,Rodríguez,1979-02-14,27528818A,manuel.rodríguez@awesomenet.com,755124,ES73209503138719377420,1500.62,2024-01-31T12:10:57,Vitoria-Gasteiz,expenses,food,-115.79,-51995.73
buyer_6,Manuel,Rodríguez,1979-02-14,27528818A,manuel.rodríguez@awesomenet.com,755124,ES73209503138719377420,1500.62,2024-02-01T09:10:21,Vitoria-Gasteiz,incomes,salary,1569.47,-50426.26
buyer_6,Manuel,Rodríguez,1979-02-14,27528818A,manuel.rodríguez@awesomenet.com,755124,ES73209503138719377420,1500.62,2024-02-01T18:00:28,Vitoria-Gasteiz,expenses,gifts,-682.3,-51108.56
buyer_6,Manuel,Rodríguez,1979-02-14,27528818A,manuel.rodríguez@awesomenet.com,755124,ES73209503138719377420,1500.62,2024-02-02T04:46:35,Vitoria-Gasteiz,expenses,healthcare,-175.19,-51283.75
buyer_6,Manuel,Rodríguez,1979-02-14,27528818A,manuel.rodríguez@awesomenet.com,755124,ES73209503138719377420,1500.62,2024-02-02T19:04:51,Vitoria-Gasteiz,expenses,cash,-100.0,-51383.75
buyer_6,Manuel,Rodríguez,1979-02-14,27528818A,manuel.rodríguez@awesomenet.com,755124,ES73209503138719377420,1500.62,2024-02-04T05:45:34,Vitoria-Gasteiz,expenses,mortgage,-818.36,-52202.11
buyer_6,Manuel,Rodríguez,1979-02-14,27528818A,manuel.rodríguez@awesomenet.com,755124,ES73209503138719377420,1500.62,2024-02-04T10:03:47,Vitoria-Gasteiz,expenses,food,-112.3,-52314.41
buyer_6,Manuel,Rodríguez,1979-02-14,27528818A,manuel.rodríguez@awesomenet.com,755124,ES73209503138719377420,1500.62,2024-02-04T20:48:19,Vitoria-Gasteiz,expenses,clothing,-128.81,-52443.22
buyer_6,Manuel,Rodríguez,1979-02-14,27528818A,manuel.rodríguez@awesomenet.com,755124,ES73209503138719377420,1500.62,2024-02-06T12:15:55,Vitoria-Gasteiz,expenses,electricity,-23.5,-52466.72
buyer_6,Manuel,Rodríguez,1979-02-14,27528818A,manuel.rodríguez@awesomenet.com,755124,ES73209503138719377420,1500.62,2024-02-08T17:35:42,Vitoria-Gasteiz,expenses,electricity,-66.2,-52532.92
buyer_6,Manuel,Rodríguez,1979-02-14,27528818A,manuel.rodríguez@awesomenet.com,755124,ES73209503138719377420,1500.62,2024-02-08T22:10:47,Vitoria-Gasteiz,expenses,gas,-38.14,-52571.06
buyer_6,Manuel,Rodríguez,1979-02-14,27528818A,manuel.rodríguez@awesomenet.com,755124,ES73209503138719377420,1500.62,2024-02-08T11:16:04,Vitoria-Gasteiz,expenses,transport,-55.35,-52626.41
buyer_6,Manuel,Rodríguez,1979-02-14,27528818A,manuel.rodríguez@awesomenet.com,755124,ES73209503138719377420,1500.62,2024-02-09T13:09:14,Vitoria-Gasteiz,expenses,travel,-487.09,-53113.5
buyer_6,Manuel,Rodríguez,1979-02-14,27528818A,manuel.rodríguez@awesomenet.com,755124,ES73209503138719377420,1500.62,2024-02-10T23:45:10,Vitoria-Gasteiz,expenses,food,-100.42,-53213.92
buyer_6,Manuel,Rodríguez,1979-02-14,27528818A,manuel.rodríguez@awesomenet.com,755124,ES73209503138719377420,1500.62,2024-02-10T12:38:24,Vitoria-Gasteiz,expenses,education,-48.06,-53261.98
buyer_6,Manuel,Rodríguez,1979-02-14,27528818A,manuel.rodríguez@awesomenet.com,755124,ES73209503138719377420,1500.62,2024-02-10T20:04:15,Vitoria-Gasteiz,expenses,repairs,-27.44,-53289.42
buyer_6,Manuel,Rodríguez,1979-02-14,27528818A,manuel.rodríguez@awesomenet.com,755124,ES73209503138719377420,1500.62,2024-02-11T19:54:39,Vitoria-Gasteiz,expenses,gifts,-482.72,-53772.14
buyer_6,Manuel,Rodríguez,1979-02-14,27528818A,manuel.rodríguez@awesomenet.com,755124,ES73209503138719377420,1500.62,2024-02-12T12:02:33,Vitoria-Gasteiz,expenses,cash,-100.0,-53872.14
buyer_6,Manuel,Rodríguez,1979-02-14,27528818A,manuel.rodríguez@awesomenet.com,755124,ES73209503138719377420,1500.62,2024-02-12T19:31:51,Vitoria-Gasteiz,expenses,gifts,-79.08,-53951.22
buyer_6,Manuel,Rodríguez,1979-02-14,27528818A,manuel.rodríguez@awesomenet.com,755124,ES73209503138719377420,1500.62,2024-02-13T19:38:35,Vitoria-Gasteiz,expenses,healthcare,-161.99,-54113.21
buyer_6,Manuel,Rodríguez,1979-02-14,27528818A,manuel.rodríguez@awesomenet.com,755124,ES73209503138719377420,1500.62,2024-02-14T08:27:17,Vitoria-Gasteiz,expenses,gifts,-223.47,-54336.68
buyer_6,Manuel,Rodríguez,1979-02-14,27528818A,manuel.rodríguez@awesomenet.com,755124,ES73209503138719377420,1500.62,2024-02-16T08:28:09,Vitoria-Gasteiz,expenses,transport,-48.02,-54384.7
buyer_6,Manuel,Rodríguez,1979-02-14,27528818A,manuel.rodríguez@awesomenet.com,755124,ES73209503138719377420,1500.62,2024-02-16T14:27:28,Vitoria-Gasteiz,expenses,education,-75.96,-54460.66
buyer_6,Manuel,Rodríguez,1979-02-14,27528818A,manuel.rodríguez@awesomenet.com,755124,ES73209503138719377420,1500.62,2024-02-17T13:24:01,Vitoria-Gasteiz,expenses,cash,-100.0,-54560.66
buyer_6,Manuel,Rodríguez,1979-02-14,27528818A,manuel.rodríguez@awesomenet.com,755124,ES73209503138719377420,1500.62,2024-02-18T22:37:36,Vitoria-Gasteiz,expenses,food,-102.35,-54663.01
buyer_6,Manuel,Rodríguez,1979-02-14,27528818A,manuel.rodríguez@awesomenet.com,755124,ES73209503138719377420,1500.62,2024-02-19T13:47:47,Vitoria-Gasteiz,expenses,food,-62.68,-54725.69
buyer_6,Manuel,Rodríguez,1979-02-14,27528818A,manuel.rodríguez@awesomenet.com,755124,ES73209503138719377420,1500.62,2024-02-24T13:09:26,Vitoria-Gasteiz,expenses,healthcare,-125.4,-54851.09
buyer_6,Manuel,Rodríguez,1979-02-14,27528818A,manuel.rodríguez@awesomenet.com,755124,ES73209503138719377420,1500.62,2024-02-26T10:54:27,Vitoria-Gasteiz,expenses,clothing,-157.72,-55008.81
buyer_6,Manuel,Rodríguez,1979-02-14,27528818A,manuel.rodríguez@awesomenet.com,755124,ES73209503138719377420,1500.62,2024-02-27T09:04:41,Vitoria-Gasteiz,expenses,healthcare,-96.92,-55105.73
buyer_6,Manuel,Rodríguez,1979-02-14,27528818A,manuel.rodríguez@awesomenet.com,755124,ES73209503138719377420,1500.62,2024-02-28T12:58:11,Vitoria-Gasteiz,expenses,food,-73.84,-55179.57
buyer_6,Manuel,Rodríguez,1979-02-14,27528818A,manuel.rodríguez@awesomenet.com,755124,ES73209503138719377420,1500.62,2024-02-28T22:07:15,Vitoria-Gasteiz,expenses,travel,-565.16,-55744.73
buyer_6,Manuel,Rodríguez,1979-02-14,27528818A,manuel.rodríguez@awesomenet.com,755124,ES73209503138719377420,1500.62,2024-02-29T20:58:46,Vitoria-Gasteiz,expenses,travel,-469.16,-56213.89
buyer_6,Manuel,Rodríguez,1979-02-14,27528818A,manuel.rodríguez@awesomenet.com,755124,ES73209503138719377420,1500.62,2024-03-01T11:02:27,Vitoria-Gasteiz,incomes,salary,1569.47,-54644.42
buyer_6,Manuel,Rodríguez,1979-02-14,27528818A,manuel.rodríguez@awesomenet.com,755124,ES73209503138719377420,1500.62,2024-03-01T10:37:09,Vitoria-Gasteiz,expenses,repairs,-280.03,-54924.45
buyer_6,Manuel,Rodríguez,1979-02-14,27528818A,manuel.rodríguez@awesomenet.com,755124,ES73209503138719377420,1500.62,2024-03-04T18:02:25,Vitoria-Gasteiz,expenses,mortgage,-818.36,-55742.81
buyer_6,Manuel,Rodríguez,1979-02-14,27528818A,manuel.rodríguez@awesomenet.com,755124,ES73209503138719377420,1500.62,2024-03-04T14:47:37,Vitoria-Gasteiz,expenses,cash,-100.0,-55842.81
buyer_6,Manuel,Rodríguez,1979-02-14,27528818A,manuel.rodríguez@awesomenet.com,755124,ES73209503138719377420,1500.62,2024-03-05T12:47:07,Vitoria-Gasteiz,expenses,electricity,-57.31,-55900.12
buyer_6,Manuel,Rodríguez,1979-02-14,27528818A,manuel.rodríguez@awesomenet.com,755124,ES73209503138719377420,1500.62,2024-03-05T17:49:50,Vitoria-Gasteiz,expenses,phone,-26.48,-55926.6
buyer_6,Manuel,Rodríguez,1979-02-14,27528818A,manuel.rodríguez@awesomenet.com,755124,ES73209503138719377420,1500.62,2024-03-05T20:37:14,Vitoria-Gasteiz,expenses,transport,-84.79,-56011.39
buyer_6,Manuel,Rodríguez,1979-02-14,27528818A,manuel.rodríguez@awesomenet.com,755124,ES73209503138719377420,1500.62,2024-03-05T19:54:00,Vitoria-Gasteiz,expenses,education,-50.92,-56062.31
buyer_6,Manuel,Rodríguez,1979-02-14,27528818A,manuel.rodríguez@awesomenet.com,755124,ES73209503138719377420,1500.62,2024-03-06T09:52:53,Vitoria-Gasteiz,expenses,gas,-36.9,-56099.21
buyer_6,Manuel,Rodríguez,1979-02-14,27528818A,manuel.rodríguez@awesomenet.com,755124,ES73209503138719377420,1500.62,2024-03-06T09:55:09,Vitoria-Gasteiz,expenses,internet,-32.96,-56132.17
buyer_6,Manuel,Rodríguez,1979-02-14,27528818A,manuel.rodríguez@awesomenet.com,755124,ES73209503138719377420,1500.62,2024-03-07T14:16:52,Vitoria-Gasteiz,expenses,electricity,-64.43,-56196.6
buyer_6,Manuel,Rodríguez,1979-02-14,27528818A,manuel.rodríguez@awesomenet.com,755124,ES73209503138719377420,1500.62,2024-03-07T09:37:07,Vitoria-Gasteiz,expenses,food,-124.12,-56320.72
buyer_6,Manuel,Rodríguez,1979-02-14,27528818A,manuel.rodríguez@awesomenet.com,755124,ES73209503138719377420,1500.62,2024-03-07T17:05:58,Vitoria-Gasteiz,expenses,healthcare,-61.37,-56382.09
buyer_6,Manuel,Rodríguez,1979-02-14,27528818A,manuel.rodríguez@awesomenet.com,755124,ES73209503138719377420,1500.62,2024-03-07T22:04:55,Vitoria-Gasteiz,expenses,cash,-100.0,-56482.09
buyer_6,Manuel,Rodríguez,1979-02-14,27528818A,manuel.rodríguez@awesomenet.com,755124,ES73209503138719377420,1500.62,2024-03-08T21:19:41,Vitoria-Gasteiz,expenses,water,-16.95,-56499.04
buyer_6,Manuel,Rodríguez,1979-02-14,27528818A,manuel.rodríguez@awesomenet.com,755124,ES73209503138719377420,1500.62,2024-03-08T13:55:31,Vitoria-Gasteiz,expenses,transport,-41.29,-56540.33
buyer_6,Manuel,Rodríguez,1979-02-14,27528818A,manuel.rodríguez@awesomenet.com,755124,ES73209503138719377420,1500.62,2024-03-08T10:39:04,Vitoria-Gasteiz,expenses,leisure,-24.97,-56565.3
buyer_6,Manuel,Rodríguez,1979-02-14,27528818A,manuel.rodríguez@awesomenet.com,755124,ES73209503138719377420,1500.62,2024-03-09T02:39:33,Vitoria-Gasteiz,expenses,clothing,-68.37,-56633.67
buyer_6,Manuel,Rodríguez,1979-02-14,27528818A,manuel.rodríguez@awesomenet.com,755124,ES73209503138719377420,1500.62,2024-03-10T13:11:15,Vitoria-Gasteiz,expenses,transport,-81.41,-56715.08
buyer_6,Manuel,Rodríguez,1979-02-14,27528818A,manuel.rodríguez@awesomenet.com,755124,ES73209503138719377420,1500.62,2024-03-11T12:13:22,Vitoria-Gasteiz,expenses,transport,-74.05,-56789.13
buyer_6,Manuel,Rodríguez,1979-02-14,27528818A,manuel.rodríguez@awesomenet.com,755124,ES73209503138719377420,1500.62,2024-03-11T13:20:45,Vitoria-Gasteiz,expenses,gifts,-213.12,-57002.25
buyer_6,Manuel,Rodríguez,1979-02-14,27528818A,manuel.rodríguez@awesomenet.com,755124,ES73209503138719377420,1500.62,2024-03-14T20:22:06,Vitoria-Gasteiz,expenses,gifts,-131.81,-57134.06
buyer_6,Manuel,Rodríguez,1979-02-14,27528818A,manuel.rodríguez@awesomenet.com,755124,ES73209503138719377420,1500.62,2024-03-15T12:44:20,Vitoria-Gasteiz,expenses,food,-77.38,-57211.44
buyer_6,Manuel,Rodríguez,1979-02-14,27528818A,manuel.rodríguez@awesomenet.com,755124,ES73209503138719377420,1500.62,2024-03-16T19:40:15,Vitoria-Gasteiz,expenses,food,-71.82,-57283.26
buyer_6,Manuel,Rodríguez,1979-02-14,27528818A,manuel.rodríguez@awesomenet.com,755124,ES73209503138719377420,1500.62,2024-03-16T14:19:54,Vitoria-Gasteiz,expenses,transport,-57.35,-57340.61
buyer_6,Manuel,Rodríguez,1979-02-14,27528818A,manuel.rodríguez@awesomenet.com,755124,ES73209503138719377420,1500.62,2024-03-17T13:54:28,Vitoria-Gasteiz,expenses,transport,-65.22,-57405.83
buyer_6,Manuel,Rodríguez,1979-02-14,27528818A,manuel.rodríguez@awesomenet.com,755124,ES73209503138719377420,1500.62,2024-03-17T21:57:47,Vitoria-Gasteiz,expenses,repairs,-250.29,-57656.12
buyer_6,Manuel,Rodríguez,1979-02-14,27528818A,manuel.rodríguez@awesomenet.com,755124,ES73209503138719377420,1500.62,2024-03-18T12:07:50,Vitoria-Gasteiz,expenses,cash,-100.0,-57756.12
buyer_6,Manuel,Rodríguez,1979-02-14,27528818A,manuel.rodríguez@awesomenet.com,755124,ES73209503138719377420,1500.62,2024-03-19T18:28:35,Vitoria-Gasteiz,expenses,repairs,-60.16,-57816.28
buyer_6,Manuel,Rodríguez,1979-02-14,27528818A,manuel.rodríguez@awesomenet.com,755124,ES73209503138719377420,1500.62,2024-03-20T01:38:32,Vitoria-Gasteiz,expenses,clothing,-135.32,-57951.6
buyer_6,Manuel,Rodríguez,1979-02-14,27528818A,manuel.rodríguez@awesomenet.com,755124,ES73209503138719377420,1500.62,2024-03-21T18:19:19,Vitoria-Gasteiz,expenses,cash,-100.0,-58051.6
buyer_6,Manuel,Rodríguez,1979-02-14,27528818A,manuel.rodríguez@awesomenet.com,755124,ES73209503138719377420,1500.62,2024-03-25T08:31:40,Vitoria-Gasteiz,expenses,leisure,-41.81,-58093.41
buyer_6,Manuel,Rodríguez,1979-02-14,27528818A,manuel.rodríguez@awesomenet.com,755124,ES73209503138719377420,1500.62,2024-03-26T15:10:48,Vitoria-Gasteiz,expenses,education,-75.29,-58168.7
buyer_6,Manuel,Rodríguez,1979-02-14,27528818A,manuel.rodríguez@awesomenet.com,755124,ES73209503138719377420,1500.62,2024-03-27T16:55:32,Vitoria-Gasteiz,expenses,clothing,-84.12,-58252.82
buyer_6,Manuel,Rodríguez,1979-02-14,27528818A,manuel.rodríguez@awesomenet.com,755124,ES73209503138719377420,1500.62,2024-03-27T20:12:30,Vitoria-Gasteiz,expenses,cash,-100.0,-58352.82
buyer_6,Manuel,Rodríguez,1979-02-14,27528818A,manuel.rodríguez@awesomenet.com,755124,ES73209503138719377420,1500.62,2024-03-27T20:07:26,Vitoria-Gasteiz,expenses,repairs,-316.89,-58669.71
buyer_6,Manuel,Rodríguez,1979-02-14,27528818A,manuel.rodríguez@awesomenet.com,755124,ES73209503138719377420,1500.62,2024-03-30T07:35:13,Vitoria-Gasteiz,expenses,cash,-100.0,-58769.71
buyer_6,Manuel,Rodríguez,1979-02-14,27528818A,manuel.rodríguez@awesomenet.com,755124,ES73209503138719377420,1500.62,2024-03-31T09:27:04,Vitoria-Gasteiz,expenses,clothing,-99.31,-58869.02
buyer_6,Manuel,Rodríguez,1979-02-14,27528818A,manuel.rodríguez@awesomenet.com,755124,ES73209503138719377420,1500.62,2024-03-31T17:35:55,Vitoria-Gasteiz,expenses,travel,-357.56,-59226.58
buyer_6,Manuel,Rodríguez,1979-02-14,27528818A,manuel.rodríguez@awesomenet.com,755124,ES73209503138719377420,1500.62,2024-04-01T19:39:56,Vitoria-Gasteiz,incomes,salary,1569.47,-57657.11
buyer_6,Manuel,Rodríguez,1979-02-14,27528818A,manuel.rodríguez@awesomenet.com,755124,ES73209503138719377420,1500.62,2024-04-01T19:39:56,Vitoria-Gasteiz,incomes,extra_income,161.05,-57496.06
buyer_6,Manuel,Rodríguez,1979-02-14,27528818A,manuel.rodríguez@awesomenet.com,755124,ES73209503138719377420,1500.62,2024-04-01T17:10:54,Vitoria-Gasteiz,expenses,leisure,-65.11,-57561.17
buyer_6,Manuel,Rodríguez,1979-02-14,27528818A,manuel.rodríguez@awesomenet.com,755124,ES73209503138719377420,1500.62,2024-04-01T20:06:27,Vitoria-Gasteiz,expenses,repairs,-156.12,-57717.29
buyer_6,Manuel,Rodríguez,1979-02-14,27528818A,manuel.rodríguez@awesomenet.com,755124,ES73209503138719377420,1500.62,2024-04-01T08:21:38,Vitoria-Gasteiz,expenses,gifts,-252.3,-57969.59
buyer_6,Manuel,Rodríguez,1979-02-14,27528818A,manuel.rodríguez@awesomenet.com,755124,ES73209503138719377420,1500.62,2024-04-02T08:37:23,Vitoria-Gasteiz,expenses,transport,-45.99,-58015.58
buyer_6,Manuel,Rodríguez,1979-02-14,27528818A,manuel.rodríguez@awesomenet.com,755124,ES73209503138719377420,1500.62,2024-04-02T18:31:17,Vitoria-Gasteiz,expenses,leisure,-41.73,-58057.31
buyer_6,Manuel,Rodríguez,1979-02-14,27528818A,manuel.rodríguez@awesomenet.com,755124,ES73209503138719377420,1500.62,2024-04-03T13:06:16,Vitoria-Gasteiz,expenses,cash,-100.0,-58157.31
buyer_6,Manuel,Rodríguez,1979-02-14,27528818A,manuel.rodríguez@awesomenet.com,755124,ES73209503138719377420,1500.62,2024-04-03T17:38:29,Vitoria-Gasteiz,expenses,repairs,-291.07,-58448.38
buyer_6,Manuel,Rodríguez,1979-02-14,27528818A,manuel.rodríguez@awesomenet.com,755124,ES73209503138719377420,1500.62,2024-04-04T09:59:22,Vitoria-Gasteiz,expenses,mortgage,-818.36,-59266.74
buyer_6,Manuel,Rodríguez,1979-02-14,27528818A,manuel.rodríguez@awesomenet.com,755124,ES73209503138719377420,1500.62,2024-04-06T15:08:33,Vitoria-Gasteiz,expenses,gas,-79.3,-59346.04
buyer_6,Manuel,Rodríguez,1979-02-14,27528818A,manuel.rodríguez@awesomenet.com,755124,ES73209503138719377420,1500.62,2024-04-06T09:50:13,Vitoria-Gasteiz,expenses,internet,-32.96,-59379.0
buyer_6,Manuel,Rodríguez,1979-02-14,27528818A,manuel.rodríguez@awesomenet.com,755124,ES73209503138719377420,1500.62,2024-04-06T13:31:11,Vitoria-Gasteiz,expenses,phone,-33.8,-59412.8
buyer_6,Manuel,Rodríguez,1979-02-14,27528818A,manuel.rodríguez@awesomenet.com,755124,ES73209503138719377420,1500.62,2024-04-06T10:53:39,Vitoria-Gasteiz,expenses,transport,-77.5,-59490.3
buyer_6,Manuel,Rodríguez,1979-02-14,27528818A,manuel.rodríguez@awesomenet.com,755124,ES73209503138719377420,1500.62,2024-04-07T14:31:13,Vitoria-Gasteiz,expenses,water,-25.75,-59516.05
buyer_6,Manuel,Rodríguez,1979-02-14,27528818A,manuel.rodríguez@awesomenet.com,755124,ES73209503138719377420,1500.62,2024-04-07T18:45:47,Vitoria-Gasteiz,expenses,electricity,-20.92,-59536.97
buyer_6,Manuel,Rodríguez,1979-02-14,27528818A,manuel.rodríguez@awesomenet.com,755124,ES73209503138719377420,1500.62,2024-04-08T17:56:20,Vitoria-Gasteiz,expenses,gas,-86.08,-59623.05
buyer_6,Manuel,Rodríguez,1979-02-14,27528818A,manuel.rodríguez@awesomenet.com,755124,ES73209503138719377420,1500.62,2024-04-10T14:54:22,Vitoria-Gasteiz,expenses,cash,-100.0,-59723.05
buyer_6,Manuel,Rodríguez,1979-02-14,27528818A,manuel.rodríguez@awesomenet.com,755124,ES73209503138719377420,1500.62,2024-04-10T09:36:45,Vitoria-Gasteiz,expenses,gifts,-152.1,-59875.15
buyer_6,Manuel,Rodríguez,1979-02-14,27528818A,manuel.rodríguez@awesomenet.com,755124,ES73209503138719377420,1500.62,2024-04-11T16:43:46,Vitoria-Gasteiz,expenses,transport,-67.51,-59942.66
buyer_6,Manuel,Rodríguez,1979-02-14,27528818A,manuel.rodríguez@awesomenet.com,755124,ES73209503138719377420,1500.62,2024-04-12T19:37:31,Vitoria-Gasteiz,expenses,education,-42.36,-59985.02
buyer_6,Manuel,Rodríguez,1979-02-14,27528818A,manuel.rodríguez@awesomenet.com,755124,ES73209503138719377420,1500.62,2024-04-12T14:47:40,Vitoria-Gasteiz,expenses,cash,-100.0,-60085.02
buyer_6,Manuel,Rodríguez,1979-02-14,27528818A,manuel.rodríguez@awesomenet.com,755124,ES73209503138719377420,1500.62,2024-04-14T20:04:36,Vitoria-Gasteiz,expenses,cash,-100.0,-60185.02
buyer_6,Manuel,Rodríguez,1979-02-14,27528818A,manuel.rodríguez@awesomenet.com,755124,ES73209503138719377420,1500.62,2024-04-15T19:34:57,Vitoria-Gasteiz,expenses,cash,-100.0,-60285.02
buyer_6,Manuel,Rodríguez,1979-02-14,27528818A,manuel.rodríguez@awesomenet.com,755124,ES73209503138719377420,1500.62,2024-04-17T20:18:43,Vitoria-Gasteiz,expenses,leisure,-56.69,-60341.71
buyer_6,Manuel,Rodríguez,1979-02-14,27528818A,manuel.rodríguez@awesomenet.com,755124,ES73209503138719377420,1500.62,2024-04-17T08:14:33,Vitoria-Gasteiz,expenses,cash,-100.0,-60441.71
buyer_6,Manuel,Rodríguez,1979-02-14,27528818A,manuel.rodríguez@awesomenet.com,755124,ES73209503138719377420,1500.62,2024-04-18T15:01:38,Vitoria-Gasteiz,expenses,leisure,-34.9,-60476.61
buyer_6,Manuel,Rodríguez,1979-02-14,27528818A,manuel.rodríguez@awesomenet.com,755124,ES73209503138719377420,1500.62,2024-04-19T13:29:11,Vitoria-Gasteiz,expenses,food,-95.07,-60571.68
buyer_6,Manuel,Rodríguez,1979-02-14,27528818A,manuel.rodríguez@awesomenet.com,755124,ES73209503138719377420,1500.62,2024-04-19T14:44:47,Vitoria-Gasteiz,expenses,cash,-100.0,-60671.68
buyer_6,Manuel,Rodríguez,1979-02-14,27528818A,manuel.rodríguez@awesomenet.com,755124,ES73209503138719377420,1500.62,2024-04-19T09:37:52,Vitoria-Gasteiz,expenses,repairs,-180.36,-60852.04
buyer_6,Manuel,Rodríguez,1979-02-14,27528818A,manuel.rodríguez@awesomenet.com,755124,ES73209503138719377420,1500.62,2024-04-20T11:45:10,Vitoria-Gasteiz,expenses,food,-91.97,-60944.01
buyer_6,Manuel,Rodríguez,1979-02-14,27528818A,manuel.rodríguez@awesomenet.com,755124,ES73209503138719377420,1500.62,2024-04-20T10:44:11,Vitoria-Gasteiz,expenses,clothing,-121.21,-61065.22
buyer_6,Manuel,Rodríguez,1979-02-14,27528818A,manuel.rodríguez@awesomenet.com,755124,ES73209503138719377420,1500.62,2024-04-22T17:06:45,Vitoria-Gasteiz,expenses,food,-63.04,-61128.26
buyer_6,Manuel,Rodríguez,1979-02-14,27528818A,manuel.rodríguez@awesomenet.com,755124,ES73209503138719377420,1500.62,2024-04-24T08:00:02,Vitoria-Gasteiz,expenses,transport,-65.78,-61194.04
buyer_6,Manuel,Rodríguez,1979-02-14,27528818A,manuel.rodríguez@awesomenet.com,755124,ES73209503138719377420,1500.62,2024-04-25T09:13:20,Vitoria-Gasteiz,expenses,clothing,-120.05,-61314.09
buyer_6,Manuel,Rodríguez,1979-02-14,27528818A,manuel.rodríguez@awesomenet.com,755124,ES73209503138719377420,1500.62,2024-04-27T16:04:39,Vitoria-Gasteiz,expenses,healthcare,-53.88,-61367.97
buyer_6,Manuel,Rodríguez,1979-02-14,27528818A,manuel.rodríguez@awesomenet.com,755124,ES73209503138719377420,1500.62,2024-05-01T09:46:14,Vitoria-Gasteiz,incomes,salary,1569.47,-59798.5
buyer_6,Manuel,Rodríguez,1979-02-14,27528818A,manuel.rodríguez@awesomenet.com,755124,ES73209503138719377420,1500.62,2024-05-01T11:58:45,Vitoria-Gasteiz,expenses,food,-117.66,-59916.16
buyer_6,Manuel,Rodríguez,1979-02-14,27528818A,manuel.rodríguez@awesomenet.com,755124,ES73209503138719377420,1500.62,2024-05-01T19:41:28,Vitoria-Gasteiz,expenses,leisure,-82.45,-59998.61
buyer_6,Manuel,Rodríguez,1979-02-14,27528818A,manuel.rodríguez@awesomenet.com,755124,ES73209503138719377420,1500.62,2024-05-01T12:39:57,Vitoria-Gasteiz,expenses,clothing,-79.88,-60078.49
buyer_6,Manuel,Rodríguez,1979-02-14,27528818A,manuel.rodríguez@awesomenet.com,755124,ES73209503138719377420,1500.62,2024-05-01T20:59:24,Vitoria-Gasteiz,expenses,gifts,-65.47,-60143.96
buyer_6,Manuel,Rodríguez,1979-02-14,27528818A,manuel.rodríguez@awesomenet.com,755124,ES73209503138719377420,1500.62,2024-05-02T11:14:19,Vitoria-Gasteiz,expenses,leisure,-35.03,-60178.99
buyer_6,Manuel,Rodríguez,1979-02-14,27528818A,manuel.rodríguez@awesomenet.com,755124,ES73209503138719377420,1500.62,2024-05-04T22:57:32,Vitoria-Gasteiz,expenses,mortgage,-818.36,-60997.35
buyer_6,Manuel,Rodríguez,1979-02-14,27528818A,manuel.rodríguez@awesomenet.com,755124,ES73209503138719377420,1500.62,2024-05-06T11:05:29,Vitoria-Gasteiz,expenses,water,-22.52,-61019.87
buyer_6,Manuel,Rodríguez,1979-02-14,27528818A,manuel.rodríguez@awesomenet.com,755124,ES73209503138719377420,1500.62,2024-05-06T16:55:31,Vitoria-Gasteiz,expenses,internet,-32.96,-61052.83
buyer_6,Manuel,Rodríguez,1979-02-14,27528818A,manuel.rodríguez@awesomenet.com,755124,ES73209503138719377420,1500.62,2024-05-06T11:19:50,Vitoria-Gasteiz,expenses,food,-110.66,-61163.49
buyer_6,Manuel,Rodríguez,1979-02-14,27528818A,manuel.rodríguez@awesomenet.com,755124,ES73209503138719377420,1500.62,2024-05-06T18:04:39,Vitoria-Gasteiz,expenses,cash,-100.0,-61263.49
buyer_6,Manuel,Rodríguez,1979-02-14,27528818A,manuel.rodríguez@awesomenet.com,755124,ES73209503138719377420,1500.62,2024-05-08T16:46:54,Vitoria-Gasteiz,expenses,gas,-43.71,-61307.2
buyer_6,Manuel,Rodríguez,1979-02-14,27528818A,manuel.rodríguez@awesomenet.com,755124,ES73209503138719377420,1500.62,2024-05-08T08:17:46,Vitoria-Gasteiz,expenses,phone,-31.74,-61338.94
buyer_6,Manuel,Rodríguez,1979-02-14,27528818A,manuel.rodríguez@awesomenet.com,755124,ES73209503138719377420,1500.62,2024-05-09T16:20:56,Vitoria-Gasteiz,expenses,repairs,-217.63,-61556.57
buyer_6,Manuel,Rodríguez,1979-02-14,27528818A,manuel.rodríguez@awesomenet.com,755124,ES73209503138719377420,1500.62,2024-05-10T23:17:12,Vitoria-Gasteiz,expenses,food,-120.58,-61677.15
buyer_6,Manuel,Rodríguez,1979-02-14,27528818A,manuel.rodríguez@awesomenet.com,755124,ES73209503138719377420,1500.62,2024-05-12T19:41:37,Vitoria-Gasteiz,expenses,repairs,-330.83,-62007.98
buyer_6,Manuel,Rodríguez,1979-02-14,27528818A,manuel.rodríguez@awesomenet.com,755124,ES73209503138719377420,1500.62,2024-05-13T09:52:27,Vitoria-Gasteiz,expenses,clothing,-115.97,-62123.95
buyer_6,Manuel,Rodríguez,1979-02-14,27528818A,manuel.rodríguez@awesomenet.com,755124,ES73209503138719377420,1500.62,2024-05-13T13:37:50,Vitoria-Gasteiz,expenses,repairs,-48.16,-62172.11
buyer_6,Manuel,Rodríguez,1979-02-14,27528818A,manuel.rodríguez@awesomenet.com,755124,ES73209503138719377420,1500.62,2024-05-14T07:18:12,Vitoria-Gasteiz,expenses,cash,-100.0,-62272.11
buyer_6,Manuel,Rodríguez,1979-02-14,27528818A,manuel.rodríguez@awesomenet.com,755124,ES73209503138719377420,1500.62,2024-05-14T18:43:39,Vitoria-Gasteiz,expenses,repairs,-76.15,-62348.26
buyer_6,Manuel,Rodríguez,1979-02-14,27528818A,manuel.rodríguez@awesomenet.com,755124,ES73209503138719377420,1500.62,2024-05-15T08:33:23,Vitoria-Gasteiz,expenses,food,-86.94,-62435.2
buyer_6,Manuel,Rodríguez,1979-02-14,27528818A,manuel.rodríguez@awesomenet.com,755124,ES73209503138719377420,1500.62,2024-05-16T12:00:45,Vitoria-Gasteiz,expenses,appliances,-224.22,-62659.42
buyer_6,Manuel,Rodríguez,1979-02-14,27528818A,manuel.rodríguez@awesomenet.com,755124,ES73209503138719377420,1500.62,2024-05-17T10:15:50,Vitoria-Gasteiz,expenses,repairs,-27.84,-62687.26
buyer_6,Manuel,Rodríguez,1979-02-14,27528818A,manuel.rodríguez@awesomenet.com,755124,ES73209503138719377420,1500.62,2024-05-20T14:19:13,Vitoria-Gasteiz,expenses,food,-79.52,-62766.78
buyer_6,Manuel,Rodríguez,1979-02-14,27528818A,manuel.rodríguez@awesomenet.com,755124,ES73209503138719377420,1500.62,2024-05-21T06:31:34,Vitoria-Gasteiz,expenses,food,-113.47,-62880.25
buyer_6,Manuel,Rodríguez,1979-02-14,27528818A,manuel.rodríguez@awesomenet.com,755124,ES73209503138719377420,1500.62,2024-05-23T10:06:10,Vitoria-Gasteiz,expenses,leisure,-39.82,-62920.07
buyer_6,Manuel,Rodríguez,1979-02-14,27528818A,manuel.rodríguez@awesomenet.com,755124,ES73209503138719377420,1500.62,2024-05-24T22:09:56,Vitoria-Gasteiz,expenses,food,-86.7,-63006.77
buyer_6,Manuel,Rodríguez,1979-02-14,27528818A,manuel.rodríguez@awesomenet.com,755124,ES73209503138719377420,1500.62,2024-05-27T15:34:45,Vitoria-Gasteiz,expenses,transport,-44.88,-63051.65
buyer_6,Manuel,Rodríguez,1979-02-14,27528818A,manuel.rodríguez@awesomenet.com,755124,ES73209503138719377420,1500.62,2024-05-28T09:24:26,Vitoria-Gasteiz,expenses,repairs,-126.49,-63178.14
buyer_6,Manuel,Rodríguez,1979-02-14,27528818A,manuel.rodríguez@awesomenet.com,755124,ES73209503138719377420,1500.62,2024-05-30T11:28:55,Vitoria-Gasteiz,expenses,food,-71.81,-63249.95
buyer_6,Manuel,Rodríguez,1979-02-14,27528818A,manuel.rodríguez@awesomenet.com,755124,ES73209503138719377420,1500.62,2024-05-31T10:57:26,Vitoria-Gasteiz,expenses,food,-83.85,-63333.8
buyer_6,Manuel,Rodríguez,1979-02-14,27528818A,manuel.rodríguez@awesomenet.com,755124,ES73209503138719377420,1500.62,2024-06-01T08:32:36,Vitoria-Gasteiz,incomes,salary,1569.47,-61764.33
buyer_6,Manuel,Rodríguez,1979-02-14,27528818A,manuel.rodríguez@awesomenet.com,755124,ES73209503138719377420,1500.62,2024-06-01T08:32:36,Vitoria-Gasteiz,incomes,salary_bonus,1176.46,-60587.87
buyer_6,Manuel,Rodríguez,1979-02-14,27528818A,manuel.rodríguez@awesomenet.com,755124,ES73209503138719377420,1500.62,2024-06-01T17:39:31,Vitoria-Gasteiz,expenses,cash,-100.0,-60687.87
buyer_6,Manuel,Rodríguez,1979-02-14,27528818A,manuel.rodríguez@awesomenet.com,755124,ES73209503138719377420,1500.62,2024-06-02T22:22:30,Vitoria-Gasteiz,expenses,taxes,-1342.51,-62030.38
buyer_6,Manuel,Rodríguez,1979-02-14,27528818A,manuel.rodríguez@awesomenet.com,755124,ES73209503138719377420,1500.62,2024-06-02T02:21:12,Vitoria-Gasteiz,expenses,insurance,-420.28,-62450.66
buyer_6,Manuel,Rodríguez,1979-02-14,27528818A,manuel.rodríguez@awesomenet.com,755124,ES73209503138719377420,1500.62,2024-06-04T21:41:24,Vitoria-Gasteiz,expenses,mortgage,-818.36,-63269.02
buyer_6,Manuel,Rodríguez,1979-02-14,27528818A,manuel.rodríguez@awesomenet.com,755124,ES73209503138719377420,1500.62,2024-06-04T13:52:17,Vitoria-Gasteiz,expenses,cash,-100.0,-63369.02
buyer_6,Manuel,Rodríguez,1979-02-14,27528818A,manuel.rodríguez@awesomenet.com,755124,ES73209503138719377420,1500.62,2024-06-04T13:38:10,Vitoria-Gasteiz,expenses,repairs,-299.11,-63668.13
buyer_6,Manuel,Rodríguez,1979-02-14,27528818A,manuel.rodríguez@awesomenet.com,755124,ES73209503138719377420,1500.62,2024-06-05T20:41:19,Vitoria-Gasteiz,expenses,electricity,-53.35,-63721.48
buyer_6,Manuel,Rodríguez,1979-02-14,27528818A,manuel.rodríguez@awesomenet.com,755124,ES73209503138719377420,1500.62,2024-06-05T19:25:02,Vitoria-Gasteiz,expenses,internet,-32.96,-63754.44
buyer_6,Manuel,Rodríguez,1979-02-14,27528818A,manuel.rodríguez@awesomenet.com,755124,ES73209503138719377420,1500.62,2024-06-06T16:15:22,Vitoria-Gasteiz,expenses,gas,-85.11,-63839.55
buyer_6,Manuel,Rodríguez,1979-02-14,27528818A,manuel.rodríguez@awesomenet.com,755124,ES73209503138719377420,1500.62,2024-06-06T21:01:08,Vitoria-Gasteiz,expenses,phone,-32.12,-63871.67
buyer_6,Manuel,Rodríguez,1979-02-14,27528818A,manuel.rodríguez@awesomenet.com,755124,ES73209503138719377420,1500.62,2024-06-06T15:09:58,Vitoria-Gasteiz,expenses,appliances,-90.07,-63961.74
buyer_6,Manuel,Rodríguez,1979-02-14,27528818A,manuel.rodríguez@awesomenet.com,755124,ES73209503138719377420,1500.62,2024-06-07T12:37:48,Vitoria-Gasteiz,expenses,gas,-84.07,-64045.81
buyer_6,Manuel,Rodríguez,1979-02-14,27528818A,manuel.rodríguez@awesomenet.com,755124,ES73209503138719377420,1500.62,2024-06-07T07:56:44,Vitoria-Gasteiz,expenses,internet,-32.96,-64078.77
buyer_6,Manuel,Rodríguez,1979-02-14,27528818A,manuel.rodríguez@awesomenet.com,755124,ES73209503138719377420,1500.62,2024-06-07T15:30:24,Vitoria-Gasteiz,expenses,appliances,-149.81,-64228.58
buyer_6,Manuel,Rodríguez,1979-02-14,27528818A,manuel.rodríguez@awesomenet.com,755124,ES73209503138719377420,1500.62,2024-06-07T12:17:01,Vitoria-Gasteiz,expenses,repairs,-237.82,-64466.4
buyer_6,Manuel,Rodríguez,1979-02-14,27528818A,manuel.rodríguez@awesomenet.com,755124,ES73209503138719377420,1500.62,2024-06-08T17:20:38,Vitoria-Gasteiz,expenses,water,-33.8,-64500.2
buyer_6,Manuel,Rodríguez,1979-02-14,27528818A,manuel.rodríguez@awesomenet.com,755124,ES73209503138719377420,1500.62,2024-06-08T13:30:46,Vitoria-Gasteiz,expenses,gas,-66.67,-64566.87
buyer_6,Manuel,Rodríguez,1979-02-14,27528818A,manuel.rodríguez@awesomenet.com,755124,ES73209503138719377420,1500.62,2024-06-08T07:05:00,Vitoria-Gasteiz,expenses,internet,-32.96,-64599.83
buyer_6,Manuel,Rodríguez,1979-02-14,27528818A,manuel.rodríguez@awesomenet.com,755124,ES73209503138719377420,1500.62,2024-06-09T20:54:13,Vitoria-Gasteiz,expenses,repairs,-281.68,-64881.51
buyer_6,Manuel,Rodríguez,1979-02-14,27528818A,manuel.rodríguez@awesomenet.com,755124,ES73209503138719377420,1500.62,2024-06-11T14:37:34,Vitoria-Gasteiz,expenses,gifts,-179.16,-65060.67
buyer_6,Manuel,Rodríguez,1979-02-14,27528818A,manuel.rodríguez@awesomenet.com,755124,ES73209503138719377420,1500.62,2024-06-12T02:06:25,Vitoria-Gasteiz,expenses,food,-77.24,-65137.91
buyer_6,Manuel,Rodríguez,1979-02-14,27528818A,manuel.rodríguez@awesomenet.com,755124,ES73209503138719377420,1500.62,2024-06-14T19:18:37,Vitoria-Gasteiz,expenses,healthcare,-85.33,-65223.24
buyer_6,Manuel,Rodríguez,1979-02-14,27528818A,manuel.rodríguez@awesomenet.com,755124,ES73209503138719377420,1500.62,2024-06-15T10:55:39,Vitoria-Gasteiz,expenses,cash,-100.0,-65323.24
buyer_6,Manuel,Rodríguez,1979-02-14,27528818A,manuel.rodríguez@awesomenet.com,755124,ES73209503138719377420,1500.62,2024-06-16T22:39:15,Vitoria-Gasteiz,expenses,transport,-45.06,-65368.3
buyer_6,Manuel,Rodríguez,1979-02-14,27528818A,manuel.rodríguez@awesomenet.com,755124,ES73209503138719377420,1500.62,2024-06-17T18:51:56,Vitoria-Gasteiz,expenses,transport,-70.99,-65439.29
buyer_6,Manuel,Rodríguez,1979-02-14,27528818A,manuel.rodríguez@awesomenet.com,755124,ES73209503138719377420,1500.62,2024-06-18T11:01:48,Vitoria-Gasteiz,expenses,food,-90.65,-65529.94
buyer_6,Manuel,Rodríguez,1979-02-14,27528818A,manuel.rodríguez@awesomenet.com,755124,ES73209503138719377420,1500.62,2024-06-19T00:05:31,Vitoria-Gasteiz,expenses,leisure,-38.99,-65568.93
buyer_6,Manuel,Rodríguez,1979-02-14,27528818A,manuel.rodríguez@awesomenet.com,755124,ES73209503138719377420,1500.62,2024-06-21T12:55:41,Vitoria-Gasteiz,expenses,cash,-100.0,-65668.93
buyer_6,Manuel,Rodríguez,1979-02-14,27528818A,manuel.rodríguez@awesomenet.com,755124,ES73209503138719377420,1500.62,2024-06-23T18:50:31,Vitoria-Gasteiz,expenses,food,-123.79,-65792.72
buyer_6,Manuel,Rodríguez,1979-02-14,27528818A,manuel.rodríguez@awesomenet.com,755124,ES73209503138719377420,1500.62,2024-06-23T23:10:35,Vitoria-Gasteiz,expenses,transport,-51.3,-65844.02
buyer_6,Manuel,Rodríguez,1979-02-14,27528818A,manuel.rodríguez@awesomenet.com,755124,ES73209503138719377420,1500.62,2024-06-24T17:28:43,Vitoria-Gasteiz,expenses,transport,-75.04,-65919.06
buyer_6,Manuel,Rodríguez,1979-02-14,27528818A,manuel.rodríguez@awesomenet.com,755124,ES73209503138719377420,1500.62,2024-06-24T12:26:02,Vitoria-Gasteiz,expenses,healthcare,-136.27,-66055.33
buyer_6,Manuel,Rodríguez,1979-02-14,27528818A,manuel.rodríguez@awesomenet.com,755124,ES73209503138719377420,1500.62,2024-06-24T23:27:37,Vitoria-Gasteiz,expenses,travel,-383.53,-66438.86
buyer_6,Manuel,Rodríguez,1979-02-14,27528818A,manuel.rodríguez@awesomenet.com,755124,ES73209503138719377420,1500.62,2024-06-25T13:33:02,Vitoria-Gasteiz,expenses,gifts,-290.32,-66729.18
buyer_6,Manuel,Rodríguez,1979-02-14,27528818A,manuel.rodríguez@awesomenet.com,755124,ES73209503138719377420,1500.62,2024-06-27T08:32:33,Vitoria-Gasteiz,expenses,cash,-100.0,-66829.18
buyer_6,Manuel,Rodríguez,1979-02-14,27528818A,manuel.rodríguez@awesomenet.com,755124,ES73209503138719377420,1500.62,2024-06-28T08:00:18,Vitoria-Gasteiz,expenses,repairs,-220.19,-67049.37
buyer_6,Manuel,Rodríguez,1979-02-14,27528818A,manuel.rodríguez@awesomenet.com,755124,ES73209503138719377420,1500.62,2024-06-29T10:52:27,Vitoria-Gasteiz,expenses,clothing,-96.46,-67145.83
buyer_6,Manuel,Rodríguez,1979-02-14,27528818A,manuel.rodríguez@awesomenet.com,755124,ES73209503138719377420,1500.62,2024-06-30T09:14:56,Vitoria-Gasteiz,expenses,food,-90.9,-67236.73
buyer_6,Manuel,Rodríguez,1979-02-14,27528818A,manuel.rodríguez@awesomenet.com,755124,ES73209503138719377420,1500.62,2024-07-01T16:09:22,Vitoria-Gasteiz,incomes,salary,1569.47,-65667.26
buyer_6,Manuel,Rodríguez,1979-02-14,27528818A,manuel.rodríguez@awesomenet.com,755124,ES73209503138719377420,1500.62,2024-07-04T20:08:45,Vitoria-Gasteiz,expenses,mortgage,-818.36,-66485.62
buyer_6,Manuel,Rodríguez,1979-02-14,27528818A,manuel.rodríguez@awesomenet.com,755124,ES73209503138719377420,1500.62,2024-07-05T12:44:24,Vitoria-Gasteiz,expenses,internet,-32.96,-66518.58
buyer_6,Manuel,Rodríguez,1979-02-14,27528818A,manuel.rodríguez@awesomenet.com,755124,ES73209503138719377420,1500.62,2024-07-05T10:29:56,Vitoria-Gasteiz,expenses,transport,-49.02,-66567.6
buyer_6,Manuel,Rodríguez,1979-02-14,27528818A,manuel.rodríguez@awesomenet.com,755124,ES73209503138719377420,1500.62,2024-07-06T18:19:54,Vitoria-Gasteiz,expenses,water,-17.56,-66585.16
buyer_6,Manuel,Rodríguez,1979-02-14,27528818A,manuel.rodríguez@awesomenet.com,755124,ES73209503138719377420,1500.62,2024-07-07T17:22:24,Vitoria-Gasteiz,expenses,phone,-31.15,-66616.31
buyer_6,Manuel,Rodríguez,1979-02-14,27528818A,manuel.rodríguez@awesomenet.com,755124,ES73209503138719377420,1500.62,2024-07-08T19:25:05,Vitoria-Gasteiz,expenses,internet,-32.96,-66649.27
buyer_6,Manuel,Rodríguez,1979-02-14,27528818A,manuel.rodríguez@awesomenet.com,755124,ES73209503138719377420,1500.62,2024-07-08T13:56:49,Vitoria-Gasteiz,expenses,phone,-34.54,-66683.81
buyer_6,Manuel,Rodríguez,1979-02-14,27528818A,manuel.rodríguez@awesomenet.com,755124,ES73209503138719377420,1500.62,2024-07-08T11:45:54,Vitoria-Gasteiz,expenses,leisure,-43.97,-66727.78
buyer_6,Manuel,Rodríguez,1979-02-14,27528818A,manuel.rodríguez@awesomenet.com,755124,ES73209503138719377420,1500.62,2024-07-09T12:46:03,Vitoria-Gasteiz,expenses,cash,-100.0,-66827.78
buyer_6,Manuel,Rodríguez,1979-02-14,27528818A,manuel.rodríguez@awesomenet.com,755124,ES73209503138719377420,1500.62,2024-07-12T12:25:50,Vitoria-Gasteiz,expenses,healthcare,-82.35,-66910.13
buyer_6,Manuel,Rodríguez,1979-02-14,27528818A,manuel.rodríguez@awesomenet.com,755124,ES73209503138719377420,1500.62,2024-07-13T09:29:15,Vitoria-Gasteiz,expenses,cash,-100.0,-67010.13
buyer_6,Manuel,Rodríguez,1979-02-14,27528818A,manuel.rodríguez@awesomenet.com,755124,ES73209503138719377420,1500.62,2024-07-13T21:06:52,Vitoria-Gasteiz,expenses,repairs,-197.92,-67208.05
buyer_6,Manuel,Rodríguez,1979-02-14,27528818A,manuel.rodríguez@awesomenet.com,755124,ES73209503138719377420,1500.62,2024-07-14T17:29:05,Vitoria-Gasteiz,expenses,transport,-45.53,-67253.58
buyer_6,Manuel,Rodríguez,1979-02-14,27528818A,manuel.rodríguez@awesomenet.com,755124,ES73209503138719377420,1500.62,2024-07-14T18:49:49,Vitoria-Gasteiz,expenses,healthcare,-137.93,-67391.51
buyer_6,Manuel,Rodríguez,1979-02-14,27528818A,manuel.rodríguez@awesomenet.com,755124,ES73209503138719377420,1500.62,2024-07-14T06:28:35,Vitoria-Gasteiz,expenses,cash,-100.0,-67491.51
buyer_6,Manuel,Rodríguez,1979-02-14,27528818A,manuel.rodríguez@awesomenet.com,755124,ES73209503138719377420,1500.62,2024-07-18T17:59:57,Vitoria-Gasteiz,expenses,food,-105.27,-67596.78
buyer_6,Manuel,Rodríguez,1979-02-14,27528818A,manuel.rodríguez@awesomenet.com,755124,ES73209503138719377420,1500.62,2024-07-18T10:07:26,Vitoria-Gasteiz,expenses,cash,-100.0,-67696.78
buyer_6,Manuel,Rodríguez,1979-02-14,27528818A,manuel.rodríguez@awesomenet.com,755124,ES73209503138719377420,1500.62,2024-07-19T10:41:21,Vitoria-Gasteiz,expenses,clothing,-121.75,-67818.53
buyer_6,Manuel,Rodríguez,1979-02-14,27528818A,manuel.rodríguez@awesomenet.com,755124,ES73209503138719377420,1500.62,2024-07-20T19:35:38,Vitoria-Gasteiz,expenses,food,-104.94,-67923.47
buyer_6,Manuel,Rodríguez,1979-02-14,27528818A,manuel.rodríguez@awesomenet.com,755124,ES73209503138719377420,1500.62,2024-07-21T07:53:35,Vitoria-Gasteiz,expenses,transport,-58.98,-67982.45
buyer_6,Manuel,Rodríguez,1979-02-14,27528818A,manuel.rodríguez@awesomenet.com,755124,ES73209503138719377420,1500.62,2024-07-21T09:41:01,Vitoria-Gasteiz,expenses,repairs,-54.44,-68036.89
buyer_6,Manuel,Rodríguez,1979-02-14,27528818A,manuel.rodríguez@awesomenet.com,755124,ES73209503138719377420,1500.62,2024-07-25T23:29:48,Vitoria-Gasteiz,expenses,appliances,-252.51,-68289.4
buyer_6,Manuel,Rodríguez,1979-02-14,27528818A,manuel.rodríguez@awesomenet.com,755124,ES73209503138719377420,1500.62,2024-07-26T14:04:41,Vitoria-Gasteiz,expenses,cash,-100.0,-68389.4
buyer_6,Manuel,Rodríguez,1979-02-14,27528818A,manuel.rodríguez@awesomenet.com,755124,ES73209503138719377420,1500.62,2024-07-31T22:39:46,Vitoria-Gasteiz,expenses,cash,-100.0,-68489.4
buyer_6,Manuel,Rodríguez,1979-02-14,27528818A,manuel.rodríguez@awesomenet.com,755124,ES73209503138719377420,1500.62,2024-08-01T18:26:09,Vitoria-Gasteiz,incomes,salary,1569.47,-66919.93
buyer_6,Manuel,Rodríguez,1979-02-14,27528818A,manuel.rodríguez@awesomenet.com,755124,ES73209503138719377420,1500.62,2024-08-01T18:26:09,Vitoria-Gasteiz,incomes,extra_income,161.05,-66758.88
buyer_6,Manuel,Rodríguez,1979-02-14,27528818A,manuel.rodríguez@awesomenet.com,755124,ES73209503138719377420,1500.62,2024-08-02T11:27:09,Vitoria-Gasteiz,expenses,food,-91.89,-66850.77
buyer_6,Manuel,Rodríguez,1979-02-14,27528818A,manuel.rodríguez@awesomenet.com,755124,ES73209503138719377420,1500.62,2024-08-03T16:37:24,Vitoria-Gasteiz,expenses,leisure,-84.49,-66935.26
buyer_6,Manuel,Rodríguez,1979-02-14,27528818A,manuel.rodríguez@awesomenet.com,755124,ES73209503138719377420,1500.62,2024-08-03T23:31:18,Vitoria-Gasteiz,expenses,clothing,-152.94,-67088.2
buyer_6,Manuel,Rodríguez,1979-02-14,27528818A,manuel.rodríguez@awesomenet.com,755124,ES73209503138719377420,1500.62,2024-08-04T17:21:20,Vitoria-Gasteiz,expenses,mortgage,-818.36,-67906.56
buyer_6,Manuel,Rodríguez,1979-02-14,27528818A,manuel.rodríguez@awesomenet.com,755124,ES73209503138719377420,1500.62,2024-08-04T07:11:37,Vitoria-Gasteiz,expenses,travel,-406.99,-68313.55
buyer_6,Manuel,Rodríguez,1979-02-14,27528818A,manuel.rodríguez@awesomenet.com,755124,ES73209503138719377420,1500.62,2024-08-04T09:12:49,Vitoria-Gasteiz,expenses,appliances,-217.67,-68531.22
buyer_6,Manuel,Rodríguez,1979-02-14,27528818A,manuel.rodríguez@awesomenet.com,755124,ES73209503138719377420,1500.62,2024-08-04T15:25:40,Vitoria-Gasteiz,expenses,repairs,-38.89,-68570.11
buyer_6,Manuel,Rodríguez,1979-02-14,27528818A,manuel.rodríguez@awesomenet.com,755124,ES73209503138719377420,1500.62,2024-08-05T23:33:42,Vitoria-Gasteiz,expenses,internet,-32.96,-68603.07
buyer_6,Manuel,Rodríguez,1979-02-14,27528818A,manuel.rodríguez@awesomenet.com,755124,ES73209503138719377420,1500.62,2024-08-06T03:46:29,Vitoria-Gasteiz,expenses,water,-22.44,-68625.51
buyer_6,Manuel,Rodríguez,1979-02-14,27528818A,manuel.rodríguez@awesomenet.com,755124,ES73209503138719377420,1500.62,2024-08-06T07:45:43,Vitoria-Gasteiz,expenses,food,-76.36,-68701.87
buyer_6,Manuel,Rodríguez,1979-02-14,27528818A,manuel.rodríguez@awesomenet.com,755124,ES73209503138719377420,1500.62,2024-08-06T06:04:41,Vitoria-Gasteiz,expenses,cash,-100.0,-68801.87
buyer_6,Manuel,Rodríguez,1979-02-14,27528818A,manuel.rodríguez@awesomenet.com,755124,ES73209503138719377420,1500.62,2024-08-07T15:19:11,Vitoria-Gasteiz,expenses,leisure,-52.45,-68854.32
buyer_6,Manuel,Rodríguez,1979-02-14,27528818A,manuel.rodríguez@awesomenet.com,755124,ES73209503138719377420,1500.62,2024-08-07T09:52:35,Vitoria-Gasteiz,expenses,healthcare,-155.25,-69009.57
buyer_6,Manuel,Rodríguez,1979-02-14,27528818A,manuel.rodríguez@awesomenet.com,755124,ES73209503138719377420,1500.62,2024-08-08T20:09:52,Vitoria-Gasteiz,expenses,electricity,-45.56,-69055.13
buyer_6,Manuel,Rodríguez,1979-02-14,27528818A,manuel.rodríguez@awesomenet.com,755124,ES73209503138719377420,1500.62,2024-08-08T12:16:12,Vitoria-Gasteiz,expenses,cash,-100.0,-69155.13
buyer_6,Manuel,Rodríguez,1979-02-14,27528818A,manuel.rodríguez@awesomenet.com,755124,ES73209503138719377420,1500.62,2024-08-09T09:41:16,Vitoria-Gasteiz,expenses,clothing,-98.6,-69253.73
buyer_6,Manuel,Rodríguez,1979-02-14,27528818A,manuel.rodríguez@awesomenet.com,755124,ES73209503138719377420,1500.62,2024-08-09T09:36:58,Vitoria-Gasteiz,expenses,cash,-100.0,-69353.73
buyer_6,Manuel,Rodríguez,1979-02-14,27528818A,manuel.rodríguez@awesomenet.com,755124,ES73209503138719377420,1500.62,2024-08-14T08:42:26,Vitoria-Gasteiz,expenses,gifts,-59.11,-69412.84
buyer_6,Manuel,Rodríguez,1979-02-14,27528818A,manuel.rodríguez@awesomenet.com,755124,ES73209503138719377420,1500.62,2024-08-15T15:54:56,Vitoria-Gasteiz,expenses,repairs,-113.19,-69526.03
buyer_6,Manuel,Rodríguez,1979-02-14,27528818A,manuel.rodríguez@awesomenet.com,755124,ES73209503138719377420,1500.62,2024-08-17T23:08:24,Vitoria-Gasteiz,expenses,leisure,-18.16,-69544.19
buyer_6,Manuel,Rodríguez,1979-02-14,27528818A,manuel.rodríguez@awesomenet.com,755124,ES73209503138719377420,1500.62,2024-08-18T15:41:20,Vitoria-Gasteiz,expenses,cash,-100.0,-69644.19
buyer_6,Manuel,Rodríguez,1979-02-14,27528818A,manuel.rodríguez@awesomenet.com,755124,ES73209503138719377420,1500.62,2024-08-18T22:03:44,Vitoria-Gasteiz,expenses,gifts,-228.55,-69872.74
buyer_6,Manuel,Rodríguez,1979-02-14,27528818A,manuel.rodríguez@awesomenet.com,755124,ES73209503138719377420,1500.62,2024-08-21T08:05:19,Vitoria-Gasteiz,expenses,transport,-57.89,-69930.63
buyer_6,Manuel,Rodríguez,1979-02-14,27528818A,manuel.rodríguez@awesomenet.com,755124,ES73209503138719377420,1500.62,2024-08-22T16:02:24,Vitoria-Gasteiz,expenses,food,-111.67,-70042.3
buyer_6,Manuel,Rodríguez,1979-02-14,27528818A,manuel.rodríguez@awesomenet.com,755124,ES73209503138719377420,1500.62,2024-08-23T17:51:24,Vitoria-Gasteiz,expenses,cash,-100.0,-70142.3
buyer_6,Manuel,Rodríguez,1979-02-14,27528818A,manuel.rodríguez@awesomenet.com,755124,ES73209503138719377420,1500.62,2024-08-24T08:09:28,Vitoria-Gasteiz,expenses,gifts,-662.09,-70804.39
buyer_6,Manuel,Rodríguez,1979-02-14,27528818A,manuel.rodríguez@awesomenet.com,755124,ES73209503138719377420,1500.62,2024-08-28T20:00:36,Vitoria-Gasteiz,expenses,transport,-64.28,-70868.67
buyer_6,Manuel,Rodríguez,1979-02-14,27528818A,manuel.rodríguez@awesomenet.com,755124,ES73209503138719377420,1500.62,2024-08-29T17:35:40,Vitoria-Gasteiz,expenses,transport,-70.9,-70939.57
buyer_6,Manuel,Rodríguez,1979-02-14,27528818A,manuel.rodríguez@awesomenet.com,755124,ES73209503138719377420,1500.62,2024-08-30T17:50:32,Vitoria-Gasteiz,expenses,cash,-100.0,-71039.57
buyer_6,Manuel,Rodríguez,1979-02-14,27528818A,manuel.rodríguez@awesomenet.com,755124,ES73209503138719377420,1500.62,2024-09-01T22:51:54,Vitoria-Gasteiz,incomes,salary,1569.47,-69470.1
buyer_6,Manuel,Rodríguez,1979-02-14,27528818A,manuel.rodríguez@awesomenet.com,755124,ES73209503138719377420,1500.62,2024-09-02T14:03:39,Vitoria-Gasteiz,expenses,food,-73.14,-69543.24
buyer_6,Manuel,Rodríguez,1979-02-14,27528818A,manuel.rodríguez@awesomenet.com,755124,ES73209503138719377420,1500.62,2024-09-02T12:42:48,Vitoria-Gasteiz,expenses,gifts,-314.29,-69857.53
buyer_6,Manuel,Rodríguez,1979-02-14,27528818A,manuel.rodríguez@awesomenet.com,755124,ES73209503138719377420,1500.62,2024-09-03T19:08:44,Vitoria-Gasteiz,expenses,clothing,-124.54,-69982.07
buyer_6,Manuel,Rodríguez,1979-02-14,27528818A,manuel.rodríguez@awesomenet.com,755124,ES73209503138719377420,1500.62,2024-09-04T12:29:14,Vitoria-Gasteiz,expenses,mortgage,-818.36,-70800.43
buyer_6,Manuel,Rodríguez,1979-02-14,27528818A,manuel.rodríguez@awesomenet.com,755124,ES73209503138719377420,1500.62,2024-09-04T09:25:01,Vitoria-Gasteiz,expenses,transport,-56.11,-70856.54
buyer_6,Manuel,Rodríguez,1979-02-14,27528818A,manuel.rodríguez@awesomenet.com,755124,ES73209503138719377420,1500.62,2024-09-05T16:47:10,Vitoria-Gasteiz,expenses,internet,-32.96,-70889.5
buyer_6,Manuel,Rodríguez,1979-02-14,27528818A,manuel.rodríguez@awesomenet.com,755124,ES73209503138719377420,1500.62,2024-09-06T10:50:26,Vitoria-Gasteiz,expenses,gas,-47.27,-70936.77
buyer_6,Manuel,Rodríguez,1979-02-14,27528818A,manuel.rodríguez@awesomenet.com,755124,ES73209503138719377420,1500.62,2024-09-06T12:21:16,Vitoria-Gasteiz,expenses,repairs,-295.01,-71231.78
buyer_6,Manuel,Rodríguez,1979-02-14,27528818A,manuel.rodríguez@awesomenet.com,755124,ES73209503138719377420,1500.62,2024-09-08T20:31:10,Vitoria-Gasteiz,expenses,internet,-32.96,-71264.74
buyer_6,Manuel,Rodríguez,1979-02-14,27528818A,manuel.rodríguez@awesomenet.com,755124,ES73209503138719377420,1500.62,2024-09-09T00:46:43,Vitoria-Gasteiz,expenses,food,-101.83,-71366.57
buyer_6,Manuel,Rodríguez,1979-02-14,27528818A,manuel.rodríguez@awesomenet.com,755124,ES73209503138719377420,1500.62,2024-09-09T13:26:16,Vitoria-Gasteiz,expenses,cash,-100.0,-71466.57
buyer_6,Manuel,Rodríguez,1979-02-14,27528818A,manuel.rodríguez@awesomenet.com,755124,ES73209503138719377420,1500.62,2024-09-16T15:29:00,Vitoria-Gasteiz,expenses,appliances,-355.88,-71822.45
buyer_6,Manuel,Rodríguez,1979-02-14,27528818A,manuel.rodríguez@awesomenet.com,755124,ES73209503138719377420,1500.62,2024-09-18T14:39:45,Vitoria-Gasteiz,expenses,food,-71.55,-71894.0
buyer_6,Manuel,Rodríguez,1979-02-14,27528818A,manuel.rodríguez@awesomenet.com,755124,ES73209503138719377420,1500.62,2024-09-18T20:08:57,Vitoria-Gasteiz,expenses,transport,-40.45,-71934.45
buyer_6,Manuel,Rodríguez,1979-02-14,27528818A,manuel.rodríguez@awesomenet.com,755124,ES73209503138719377420,1500.62,2024-09-18T15:53:03,Vitoria-Gasteiz,expenses,travel,-569.58,-72504.03
buyer_6,Manuel,Rodríguez,1979-02-14,27528818A,manuel.rodríguez@awesomenet.com,755124,ES73209503138719377420,1500.62,2024-09-19T17:00:31,Vitoria-Gasteiz,expenses,travel,-534.62,-73038.65
buyer_6,Manuel,Rodríguez,1979-02-14,27528818A,manuel.rodríguez@awesomenet.com,755124,ES73209503138719377420,1500.62,2024-09-22T01:52:10,Vitoria-Gasteiz,expenses,food,-113.92,-73152.57
buyer_6,Manuel,Rodríguez,1979-02-14,27528818A,manuel.rodríguez@awesomenet.com,755124,ES73209503138719377420,1500.62,2024-09-26T12:17:49,Vitoria-Gasteiz,expenses,transport,-63.59,-73216.16
buyer_6,Manuel,Rodríguez,1979-02-14,27528818A,manuel.rodríguez@awesomenet.com,755124,ES73209503138719377420,1500.62,2024-09-27T11:21:18,Vitoria-Gasteiz,expenses,cash,-100.0,-73316.16
buyer_6,Manuel,Rodríguez,1979-02-14,27528818A,manuel.rodríguez@awesomenet.com,755124,ES73209503138719377420,1500.62,2024-09-27T15:28:44,Vitoria-Gasteiz,expenses,repairs,-162.8,-73478.96
buyer_6,Manuel,Rodríguez,1979-02-14,27528818A,manuel.rodríguez@awesomenet.com,755124,ES73209503138719377420,1500.62,2024-09-27T18:32:07,Vitoria-Gasteiz,expenses,gifts,-119.13,-73598.09
buyer_6,Manuel,Rodríguez,1979-02-14,27528818A,manuel.rodríguez@awesomenet.com,755124,ES73209503138719377420,1500.62,2024-09-30T12:17:02,Vitoria-Gasteiz,expenses,food,-92.6,-73690.69
buyer_6,Manuel,Rodríguez,1979-02-14,27528818A,manuel.rodríguez@awesomenet.com,755124,ES73209503138719377420,1500.62,2024-09-30T16:42:12,Vitoria-Gasteiz,expenses,healthcare,-149.37,-73840.06
buyer_6,Manuel,Rodríguez,1979-02-14,27528818A,manuel.rodríguez@awesomenet.com,755124,ES73209503138719377420,1500.62,2024-09-30T19:59:21,Vitoria-Gasteiz,expenses,cash,-100.0,-73940.06
buyer_6,Manuel,Rodríguez,1979-02-14,27528818A,manuel.rodríguez@awesomenet.com,755124,ES73209503138719377420,1500.62,2024-10-01T17:49:36,Vitoria-Gasteiz,incomes,salary,1569.47,-72370.59
buyer_6,Manuel,Rodríguez,1979-02-14,27528818A,manuel.rodríguez@awesomenet.com,755124,ES73209503138719377420,1500.62,2024-10-01T17:27:32,Vitoria-Gasteiz,expenses,clothing,-127.41,-72498.0
buyer_6,Manuel,Rodríguez,1979-02-14,27528818A,manuel.rodríguez@awesomenet.com,755124,ES73209503138719377420,1500.62,2024-10-02T12:02:40,Vitoria-Gasteiz,expenses,leisure,-46.31,-72544.31
buyer_6,Manuel,Rodríguez,1979-02-14,27528818A,manuel.rodríguez@awesomenet.com,755124,ES73209503138719377420,1500.62,2024-10-04T14:58:35,Vitoria-Gasteiz,expenses,mortgage,-818.36,-73362.67
buyer_6,Manuel,Rodríguez,1979-02-14,27528818A,manuel.rodríguez@awesomenet.com,755124,ES73209503138719377420,1500.62,2024-10-05T07:18:56,Vitoria-Gasteiz,expenses,education,-58.12,-73420.79
buyer_6,Manuel,Rodríguez,1979-02-14,27528818A,manuel.rodríguez@awesomenet.com,755124,ES73209503138719377420,1500.62,2024-10-06T12:08:52,Vitoria-Gasteiz,expenses,water,-21.11,-73441.9
buyer_6,Manuel,Rodríguez,1979-02-14,27528818A,manuel.rodríguez@awesomenet.com,755124,ES73209503138719377420,1500.62,2024-10-06T10:23:57,Vitoria-Gasteiz,expenses,phone,-23.95,-73465.85
buyer_6,Manuel,Rodríguez,1979-02-14,27528818A,manuel.rodríguez@awesomenet.com,755124,ES73209503138719377420,1500.62,2024-10-07T17:51:09,Vitoria-Gasteiz,expenses,food,-77.59,-73543.44
buyer_6,Manuel,Rodríguez,1979-02-14,27528818A,manuel.rodríguez@awesomenet.com,755124,ES73209503138719377420,1500.62,2024-10-08T18:15:28,Vitoria-Gasteiz,expenses,internet,-32.96,-73576.4
buyer_6,Manuel,Rodríguez,1979-02-14,27528818A,manuel.rodríguez@awesomenet.com,755124,ES73209503138719377420,1500.62,2024-10-08T11:06:27,Vitoria-Gasteiz,expenses,transport,-59.35,-73635.75
buyer_7,María,Valdec,1968-12-31,54502279F,maría.valdec@awesomecloud.com,031005,ES72209544951851809297,6307.96,2022-01-01T08:53:26,Portugalete,incomes,salary,1502.17,7810.13
buyer_7,María,Valdec,1968-12-31,54502279F,maría.valdec@awesomecloud.com,031005,ES72209544951851809297,6307.96,2022-01-04T15:52:17,Portugalete,expenses,mortgage,-748.36,7061.77
buyer_7,María,Valdec,1968-12-31,54502279F,maría.valdec@awesomecloud.com,031005,ES72209544951851809297,6307.96,2022-01-05T13:52:09,Portugalete,expenses,phone,-33.09,7028.68
buyer_7,María,Valdec,1968-12-31,54502279F,maría.valdec@awesomecloud.com,031005,ES72209544951851809297,6307.96,2022-01-05T19:22:40,Portugalete,expenses,leisure,-51.18,6977.5
buyer_7,María,Valdec,1968-12-31,54502279F,maría.valdec@awesomecloud.com,031005,ES72209544951851809297,6307.96,2022-01-06T10:56:52,Portugalete,expenses,internet,-31.55,6945.95
buyer_7,María,Valdec,1968-12-31,54502279F,maría.valdec@awesomecloud.com,031005,ES72209544951851809297,6307.96,2022-01-06T17:35:45,Portugalete,expenses,clothing,-50.6,6895.35
buyer_7,María,Valdec,1968-12-31,54502279F,maría.valdec@awesomecloud.com,031005,ES72209544951851809297,6307.96,2022-01-07T16:01:37,Portugalete,expenses,electricity,-51.28,6844.07
buyer_7,María,Valdec,1968-12-31,54502279F,maría.valdec@awesomecloud.com,031005,ES72209544951851809297,6307.96,2022-01-08T20:35:28,Portugalete,expenses,electricity,-40.09,6803.98
buyer_7,María,Valdec,1968-12-31,54502279F,maría.valdec@awesomecloud.com,031005,ES72209544951851809297,6307.96,2022-01-08T05:39:21,Portugalete,expenses,gas,-50.87,6753.11
buyer_7,María,Valdec,1968-12-31,54502279F,maría.valdec@awesomecloud.com,031005,ES72209544951851809297,6307.96,2022-01-08T13:12:03,Portugalete,expenses,internet,-31.55,6721.56
buyer_7,María,Valdec,1968-12-31,54502279F,maría.valdec@awesomecloud.com,031005,ES72209544951851809297,6307.96,2022-01-08T11:19:26,Portugalete,expenses,phone,-24.08,6697.48
buyer_7,María,Valdec,1968-12-31,54502279F,maría.valdec@awesomecloud.com,031005,ES72209544951851809297,6307.96,2022-01-08T11:36:35,Portugalete,expenses,transport,-60.05,6637.43
buyer_7,María,Valdec,1968-12-31,54502279F,maría.valdec@awesomecloud.com,031005,ES72209544951851809297,6307.96,2022-01-08T12:24:40,Portugalete,expenses,gifts,-45.11,6592.32
buyer_7,María,Valdec,1968-12-31,54502279F,maría.valdec@awesomecloud.com,031005,ES72209544951851809297,6307.96,2022-01-09T19:10:51,Portugalete,expenses,food,-81.95,6510.37
buyer_7,María,Valdec,1968-12-31,54502279F,maría.valdec@awesomecloud.com,031005,ES72209544951851809297,6307.96,2022-01-09T15:54:01,Portugalete,expenses,cash,-100.0,6410.37
buyer_7,María,Valdec,1968-12-31,54502279F,maría.valdec@awesomecloud.com,031005,ES72209544951851809297,6307.96,2022-01-10T08:42:52,Portugalete,expenses,food,-63.31,6347.06
buyer_7,María,Valdec,1968-12-31,54502279F,maría.valdec@awesomecloud.com,031005,ES72209544951851809297,6307.96,2022-01-11T20:57:23,Portugalete,expenses,gifts,-291.23,6055.83
buyer_7,María,Valdec,1968-12-31,54502279F,maría.valdec@awesomecloud.com,031005,ES72209544951851809297,6307.96,2022-01-12T16:14:04,Portugalete,expenses,food,-120.45,5935.38
buyer_7,María,Valdec,1968-12-31,54502279F,maría.valdec@awesomecloud.com,031005,ES72209544951851809297,6307.96,2022-01-12T08:05:29,Portugalete,expenses,clothing,-155.0,5780.38
buyer_7,María,Valdec,1968-12-31,54502279F,maría.valdec@awesomecloud.com,031005,ES72209544951851809297,6307.96,2022-01-12T01:24:09,Portugalete,expenses,healthcare,-30.89,5749.49
buyer_7,María,Valdec,1968-12-31,54502279F,maría.valdec@awesomecloud.com,031005,ES72209544951851809297,6307.96,2022-01-13T14:26:18,Portugalete,expenses,transport,-71.34,5678.15
buyer_7,María,Valdec,1968-12-31,54502279F,maría.valdec@awesomecloud.com,031005,ES72209544951851809297,6307.96,2022-01-14T20:48:00,Portugalete,expenses,clothing,-150.3,5527.85
buyer_7,María,Valdec,1968-12-31,54502279F,maría.valdec@awesomecloud.com,031005,ES72209544951851809297,6307.96,2022-01-14T09:04:44,Portugalete,expenses,gifts,-31.58,5496.27
buyer_7,María,Valdec,1968-12-31,54502279F,maría.valdec@awesomecloud.com,031005,ES72209544951851809297,6307.96,2022-01-16T21:56:21,Portugalete,expenses,transport,-88.84,5407.43
buyer_7,María,Valdec,1968-12-31,54502279F,maría.valdec@awesomecloud.com,031005,ES72209544951851809297,6307.96,2022-01-17T11:57:48,Portugalete,expenses,food,-75.07,5332.36
buyer_7,María,Valdec,1968-12-31,54502279F,maría.valdec@awesomecloud.com,031005,ES72209544951851809297,6307.96,2022-01-17T15:26:01,Portugalete,expenses,leisure,-38.81,5293.55
buyer_7,María,Valdec,1968-12-31,54502279F,maría.valdec@awesomecloud.com,031005,ES72209544951851809297,6307.96,2022-01-20T20:25:18,Portugalete,expenses,leisure,-45.16,5248.39
buyer_7,María,Valdec,1968-12-31,54502279F,maría.valdec@awesomecloud.com,031005,ES72209544951851809297,6307.96,2022-01-21T09:29:29,Portugalete,expenses,food,-86.04,5162.35
buyer_7,María,Valdec,1968-12-31,54502279F,maría.valdec@awesomecloud.com,031005,ES72209544951851809297,6307.96,2022-01-21T15:58:59,Portugalete,expenses,leisure,-32.3,5130.05
buyer_7,María,Valdec,1968-12-31,54502279F,maría.valdec@awesomecloud.com,031005,ES72209544951851809297,6307.96,2022-01-21T09:22:06,Portugalete,expenses,cash,-100.0,5030.05
buyer_7,María,Valdec,1968-12-31,54502279F,maría.valdec@awesomecloud.com,031005,ES72209544951851809297,6307.96,2022-01-22T16:15:12,Portugalete,expenses,repairs,-298.72,4731.33
buyer_7,María,Valdec,1968-12-31,54502279F,maría.valdec@awesomecloud.com,031005,ES72209544951851809297,6307.96,2022-01-24T12:02:55,Portugalete,expenses,food,-88.11,4643.22
buyer_7,María,Valdec,1968-12-31,54502279F,maría.valdec@awesomecloud.com,031005,ES72209544951851809297,6307.96,2022-01-24T09:11:27,Portugalete,expenses,leisure,-69.28,4573.94
buyer_7,María,Valdec,1968-12-31,54502279F,maría.valdec@awesomecloud.com,031005,ES72209544951851809297,6307.96,2022-01-28T18:15:01,Portugalete,expenses,clothing,-159.21,4414.73
buyer_7,María,Valdec,1968-12-31,54502279F,maría.valdec@awesomecloud.com,031005,ES72209544951851809297,6307.96,2022-01-29T13:39:34,Portugalete,expenses,cash,-100.0,4314.73
buyer_7,María,Valdec,1968-12-31,54502279F,maría.valdec@awesomecloud.com,031005,ES72209544951851809297,6307.96,2022-02-01T17:45:24,Portugalete,incomes,salary,1502.17,5816.9
buyer_7,María,Valdec,1968-12-31,54502279F,maría.valdec@awesomecloud.com,031005,ES72209544951851809297,6307.96,2022-02-01T20:57:21,Portugalete,expenses,travel,-302.31,5514.59
buyer_7,María,Valdec,1968-12-31,54502279F,maría.valdec@awesomecloud.com,031005,ES72209544951851809297,6307.96,2022-02-04T17:41:18,Portugalete,expenses,mortgage,-748.36,4766.23
buyer_7,María,Valdec,1968-12-31,54502279F,maría.valdec@awesomecloud.com,031005,ES72209544951851809297,6307.96,2022-02-04T01:11:19,Portugalete,expenses,leisure,-38.28,4727.95
buyer_7,María,Valdec,1968-12-31,54502279F,maría.valdec@awesomecloud.com,031005,ES72209544951851809297,6307.96,2022-02-05T11:31:33,Portugalete,expenses,electricity,-57.81,4670.14
buyer_7,María,Valdec,1968-12-31,54502279F,maría.valdec@awesomecloud.com,031005,ES72209544951851809297,6307.96,2022-02-05T18:36:38,Portugalete,expenses,phone,-27.93,4642.21
buyer_7,María,Valdec,1968-12-31,54502279F,maría.valdec@awesomecloud.com,031005,ES72209544951851809297,6307.96,2022-02-06T05:51:54,Portugalete,expenses,internet,-31.55,4610.66
buyer_7,María,Valdec,1968-12-31,54502279F,maría.valdec@awesomecloud.com,031005,ES72209544951851809297,6307.96,2022-02-06T08:22:43,Portugalete,expenses,leisure,-76.57,4534.09
buyer_7,María,Valdec,1968-12-31,54502279F,maría.valdec@awesomecloud.com,031005,ES72209544951851809297,6307.96,2022-02-06T20:14:57,Portugalete,expenses,repairs,-194.01,4340.08
buyer_7,María,Valdec,1968-12-31,54502279F,maría.valdec@awesomecloud.com,031005,ES72209544951851809297,6307.96,2022-02-07T17:36:47,Portugalete,expenses,repairs,-112.84,4227.24
buyer_7,María,Valdec,1968-12-31,54502279F,maría.valdec@awesomecloud.com,031005,ES72209544951851809297,6307.96,2022-02-08T18:29:50,Portugalete,expenses,internet,-31.55,4195.69
buyer_7,María,Valdec,1968-12-31,54502279F,maría.valdec@awesomecloud.com,031005,ES72209544951851809297,6307.96,2022-02-08T15:56:34,Portugalete,expenses,food,-122.26,4073.43
buyer_7,María,Valdec,1968-12-31,54502279F,maría.valdec@awesomecloud.com,031005,ES72209544951851809297,6307.96,2022-02-08T10:29:23,Portugalete,expenses,cash,-100.0,3973.43
buyer_7,María,Valdec,1968-12-31,54502279F,maría.valdec@awesomecloud.com,031005,ES72209544951851809297,6307.96,2022-02-08T09:47:43,Portugalete,expenses,repairs,-63.79,3909.64
buyer_7,María,Valdec,1968-12-31,54502279F,maría.valdec@awesomecloud.com,031005,ES72209544951851809297,6307.96,2022-02-10T20:34:04,Portugalete,expenses,food,-70.6,3839.04
buyer_7,María,Valdec,1968-12-31,54502279F,maría.valdec@awesomecloud.com,031005,ES72209544951851809297,6307.96,2022-02-10T21:20:53,Portugalete,expenses,education,-78.44,3760.6
buyer_7,María,Valdec,1968-12-31,54502279F,maría.valdec@awesomecloud.com,031005,ES72209544951851809297,6307.96,2022-02-12T13:00:00,Portugalete,expenses,education,-69.39,3691.21
buyer_7,María,Valdec,1968-12-31,54502279F,maría.valdec@awesomecloud.com,031005,ES72209544951851809297,6307.96,2022-02-13T20:27:06,Portugalete,expenses,food,-110.18,3581.03
buyer_7,María,Valdec,1968-12-31,54502279F,maría.valdec@awesomecloud.com,031005,ES72209544951851809297,6307.96,2022-02-14T10:26:36,Portugalete,expenses,food,-61.11,3519.92
buyer_7,María,Valdec,1968-12-31,54502279F,maría.valdec@awesomecloud.com,031005,ES72209544951851809297,6307.96,2022-02-15T19:03:55,Portugalete,expenses,leisure,-55.85,3464.07
buyer_7,María,Valdec,1968-12-31,54502279F,maría.valdec@awesomecloud.com,031005,ES72209544951851809297,6307.96,2022-02-17T08:17:57,Portugalete,expenses,leisure,-81.96,3382.11
buyer_7,María,Valdec,1968-12-31,54502279F,maría.valdec@awesomecloud.com,031005,ES72209544951851809297,6307.96,2022-02-20T12:15:10,Portugalete,expenses,repairs,-150.91,3231.2
buyer_7,María,Valdec,1968-12-31,54502279F,maría.valdec@awesomecloud.com,031005,ES72209544951851809297,6307.96,2022-02-21T15:05:26,Portugalete,expenses,children,-246.79,2984.41
buyer_7,María,Valdec,1968-12-31,54502279F,maría.valdec@awesomecloud.com,031005,ES72209544951851809297,6307.96,2022-02-22T08:36:44,Portugalete,expenses,education,-65.35,2919.06
buyer_7,María,Valdec,1968-12-31,54502279F,maría.valdec@awesomecloud.com,031005,ES72209544951851809297,6307.96,2022-02-23T03:31:38,Portugalete,expenses,education,-52.12,2866.94
buyer_7,María,Valdec,1968-12-31,54502279F,maría.valdec@awesomecloud.com,031005,ES72209544951851809297,6307.96,2022-02-23T11:49:53,Portugalete,expenses,cash,-100.0,2766.94
buyer_7,María,Valdec,1968-12-31,54502279F,maría.valdec@awesomecloud.com,031005,ES72209544951851809297,6307.96,2022-02-23T19:52:36,Portugalete,expenses,repairs,-69.2,2697.74
buyer_7,María,Valdec,1968-12-31,54502279F,maría.valdec@awesomecloud.com,031005,ES72209544951851809297,6307.96,2022-02-25T20:30:27,Portugalete,expenses,leisure,-60.42,2637.32
buyer_7,María,Valdec,1968-12-31,54502279F,maría.valdec@awesomecloud.com,031005,ES72209544951851809297,6307.96,2022-02-26T13:06:56,Portugalete,expenses,appliances,-174.47,2462.85
buyer_7,María,Valdec,1968-12-31,54502279F,maría.valdec@awesomecloud.com,031005,ES72209544951851809297,6307.96,2022-03-01T19:41:31,Portugalete,incomes,salary,1502.17,3965.02
buyer_7,María,Valdec,1968-12-31,54502279F,maría.valdec@awesomecloud.com,031005,ES72209544951851809297,6307.96,2022-03-02T22:32:00,Portugalete,expenses,food,-124.62,3840.4
buyer_7,María,Valdec,1968-12-31,54502279F,maría.valdec@awesomecloud.com,031005,ES72209544951851809297,6307.96,2022-03-03T20:13:25,Portugalete,expenses,food,-74.65,3765.75
buyer_7,María,Valdec,1968-12-31,54502279F,maría.valdec@awesomecloud.com,031005,ES72209544951851809297,6307.96,2022-03-03T11:04:47,Portugalete,expenses,transport,-64.88,3700.87
buyer_7,María,Valdec,1968-12-31,54502279F,maría.valdec@awesomecloud.com,031005,ES72209544951851809297,6307.96,2022-03-04T14:58:16,Portugalete,expenses,mortgage,-748.36,2952.51
buyer_7,María,Valdec,1968-12-31,54502279F,maría.valdec@awesomecloud.com,031005,ES72209544951851809297,6307.96,2022-03-05T08:01:57,Portugalete,expenses,education,-74.19,2878.32
buyer_7,María,Valdec,1968-12-31,54502279F,maría.valdec@awesomecloud.com,031005,ES72209544951851809297,6307.96,2022-03-05T10:56:00,Portugalete,expenses,cash,-100.0,2778.32
buyer_7,María,Valdec,1968-12-31,54502279F,maría.valdec@awesomecloud.com,031005,ES72209544951851809297,6307.96,2022-03-07T17:18:31,Portugalete,expenses,water,-29.25,2749.07
buyer_7,María,Valdec,1968-12-31,54502279F,maría.valdec@awesomecloud.com,031005,ES72209544951851809297,6307.96,2022-03-07T16:02:44,Portugalete,expenses,electricity,-41.15,2707.92
buyer_7,María,Valdec,1968-12-31,54502279F,maría.valdec@awesomecloud.com,031005,ES72209544951851809297,6307.96,2022-03-07T12:05:16,Portugalete,expenses,food,-65.71,2642.21
buyer_7,María,Valdec,1968-12-31,54502279F,maría.valdec@awesomecloud.com,031005,ES72209544951851809297,6307.96,2022-03-07T12:05:05,Portugalete,expenses,leisure,-67.96,2574.25
buyer_7,María,Valdec,1968-12-31,54502279F,maría.valdec@awesomecloud.com,031005,ES72209544951851809297,6307.96,2022-03-08T15:17:43,Portugalete,expenses,gas,-83.77,2490.48
buyer_7,María,Valdec,1968-12-31,54502279F,maría.valdec@awesomecloud.com,031005,ES72209544951851809297,6307.96,2022-03-08T17:26:36,Portugalete,expenses,phone,-30.39,2460.09
buyer_7,María,Valdec,1968-12-31,54502279F,maría.valdec@awesomecloud.com,031005,ES72209544951851809297,6307.96,2022-03-08T13:31:46,Portugalete,expenses,transport,-67.21,2392.88
buyer_7,María,Valdec,1968-12-31,54502279F,maría.valdec@awesomecloud.com,031005,ES72209544951851809297,6307.96,2022-03-08T15:20:17,Portugalete,expenses,travel,-266.57,2126.31
buyer_7,María,Valdec,1968-12-31,54502279F,maría.valdec@awesomecloud.com,031005,ES72209544951851809297,6307.96,2022-03-09T15:48:29,Portugalete,expenses,leisure,-80.77,2045.54
buyer_7,María,Valdec,1968-12-31,54502279F,maría.valdec@awesomecloud.com,031005,ES72209544951851809297,6307.96,2022-03-10T15:26:47,Portugalete,expenses,cash,-100.0,1945.54
buyer_7,María,Valdec,1968-12-31,54502279F,maría.valdec@awesomecloud.com,031005,ES72209544951851809297,6307.96,2022-03-12T13:36:15,Portugalete,expenses,appliances,-180.51,1765.03
buyer_7,María,Valdec,1968-12-31,54502279F,maría.valdec@awesomecloud.com,031005,ES72209544951851809297,6307.96,2022-03-14T20:49:07,Portugalete,expenses,leisure,-74.49,1690.54
buyer_7,María,Valdec,1968-12-31,54502279F,maría.valdec@awesomecloud.com,031005,ES72209544951851809297,6307.96,2022-03-14T14:20:30,Portugalete,expenses,cash,-100.0,1590.54
buyer_7,María,Valdec,1968-12-31,54502279F,maría.valdec@awesomecloud.com,031005,ES72209544951851809297,6307.96,2022-03-14T08:06:18,Portugalete,expenses,repairs,-39.28,1551.26
buyer_7,María,Valdec,1968-12-31,54502279F,maría.valdec@awesomecloud.com,031005,ES72209544951851809297,6307.96,2022-03-15T19:24:40,Portugalete,expenses,leisure,-35.99,1515.27
buyer_7,María,Valdec,1968-12-31,54502279F,maría.valdec@awesomecloud.com,031005,ES72209544951851809297,6307.96,2022-03-16T01:17:41,Portugalete,expenses,transport,-70.79,1444.48
buyer_7,María,Valdec,1968-12-31,54502279F,maría.valdec@awesomecloud.com,031005,ES72209544951851809297,6307.96,2022-03-19T22:03:07,Portugalete,expenses,transport,-83.87,1360.61
buyer_7,María,Valdec,1968-12-31,54502279F,maría.valdec@awesomecloud.com,031005,ES72209544951851809297,6307.96,2022-03-19T18:08:42,Portugalete,expenses,cash,-100.0,1260.61
buyer_7,María,Valdec,1968-12-31,54502279F,maría.valdec@awesomecloud.com,031005,ES72209544951851809297,6307.96,2022-03-20T12:31:48,Portugalete,expenses,cash,-100.0,1160.61
buyer_7,María,Valdec,1968-12-31,54502279F,maría.valdec@awesomecloud.com,031005,ES72209544951851809297,6307.96,2022-03-20T12:29:06,Portugalete,expenses,repairs,-198.89,961.72
buyer_7,María,Valdec,1968-12-31,54502279F,maría.valdec@awesomecloud.com,031005,ES72209544951851809297,6307.96,2022-03-21T17:58:10,Portugalete,expenses,gifts,-137.75,823.97
buyer_7,María,Valdec,1968-12-31,54502279F,maría.valdec@awesomecloud.com,031005,ES72209544951851809297,6307.96,2022-03-22T20:10:40,Portugalete,expenses,cash,-100.0,723.97
buyer_7,María,Valdec,1968-12-31,54502279F,maría.valdec@awesomecloud.com,031005,ES72209544951851809297,6307.96,2022-03-23T09:19:22,Portugalete,expenses,children,-169.75,554.22
buyer_7,María,Valdec,1968-12-31,54502279F,maría.valdec@awesomecloud.com,031005,ES72209544951851809297,6307.96,2022-03-24T12:32:04,Portugalete,expenses,transport,-69.19,485.03
buyer_7,María,Valdec,1968-12-31,54502279F,maría.valdec@awesomecloud.com,031005,ES72209544951851809297,6307.96,2022-03-24T14:26:12,Portugalete,expenses,clothing,-108.33,376.7
buyer_7,María,Valdec,1968-12-31,54502279F,maría.valdec@awesomecloud.com,031005,ES72209544951851809297,6307.96,2022-03-24T14:05:59,Portugalete,expenses,cash,-100.0,276.7
buyer_7,María,Valdec,1968-12-31,54502279F,maría.valdec@awesomecloud.com,031005,ES72209544951851809297,6307.96,2022-03-25T09:34:58,Portugalete,expenses,gifts,-121.32,155.38
buyer_7,María,Valdec,1968-12-31,54502279F,maría.valdec@awesomecloud.com,031005,ES72209544951851809297,6307.96,2022-03-27T23:19:03,Portugalete,expenses,clothing,-91.63,63.75
buyer_7,María,Valdec,1968-12-31,54502279F,maría.valdec@awesomecloud.com,031005,ES72209544951851809297,6307.96,2022-03-28T18:46:19,Portugalete,expenses,transport,-48.19,15.56
buyer_7,María,Valdec,1968-12-31,54502279F,maría.valdec@awesomecloud.com,031005,ES72209544951851809297,6307.96,2022-03-29T02:09:49,Portugalete,expenses,children,-114.76,-99.2
buyer_7,María,Valdec,1968-12-31,54502279F,maría.valdec@awesomecloud.com,031005,ES72209544951851809297,6307.96,2022-03-30T20:48:39,Portugalete,expenses,transport,-56.13,-155.33
buyer_7,María,Valdec,1968-12-31,54502279F,maría.valdec@awesomecloud.com,031005,ES72209544951851809297,6307.96,2022-03-31T18:02:15,Portugalete,expenses,repairs,-230.89,-386.22
buyer_7,María,Valdec,1968-12-31,54502279F,maría.valdec@awesomecloud.com,031005,ES72209544951851809297,6307.96,2022-04-01T05:54:07,Portugalete,incomes,salary,1502.17,1115.95
buyer_7,María,Valdec,1968-12-31,54502279F,maría.valdec@awesomecloud.com,031005,ES72209544951851809297,6307.96,2022-04-01T05:54:07,Portugalete,incomes,extra_income,219.04,1334.99
buyer_7,María,Valdec,1968-12-31,54502279F,maría.valdec@awesomecloud.com,031005,ES72209544951851809297,6307.96,2022-04-02T19:54:05,Portugalete,expenses,food,-83.37,1251.62
buyer_7,María,Valdec,1968-12-31,54502279F,maría.valdec@awesomecloud.com,031005,ES72209544951851809297,6307.96,2022-04-02T16:21:26,Portugalete,expenses,transport,-74.28,1177.34
buyer_7,María,Valdec,1968-12-31,54502279F,maría.valdec@awesomecloud.com,031005,ES72209544951851809297,6307.96,2022-04-02T10:37:06,Portugalete,expenses,appliances,-91.41,1085.93
buyer_7,María,Valdec,1968-12-31,54502279F,maría.valdec@awesomecloud.com,031005,ES72209544951851809297,6307.96,2022-04-03T13:55:48,Portugalete,expenses,leisure,-24.65,1061.28
buyer_7,María,Valdec,1968-12-31,54502279F,maría.valdec@awesomecloud.com,031005,ES72209544951851809297,6307.96,2022-04-03T17:42:59,Portugalete,expenses,clothing,-58.13,1003.15
buyer_7,María,Valdec,1968-12-31,54502279F,maría.valdec@awesomecloud.com,031005,ES72209544951851809297,6307.96,2022-04-04T08:17:33,Portugalete,expenses,mortgage,-748.36,254.79
buyer_7,María,Valdec,1968-12-31,54502279F,maría.valdec@awesomecloud.com,031005,ES72209544951851809297,6307.96,2022-04-05T09:53:26,Portugalete,expenses,electricity,-63.18,191.61
buyer_7,María,Valdec,1968-12-31,54502279F,maría.valdec@awesomecloud.com,031005,ES72209544951851809297,6307.96,2022-04-05T14:04:51,Portugalete,expenses,gas,-84.03,107.58
buyer_7,María,Valdec,1968-12-31,54502279F,maría.valdec@awesomecloud.com,031005,ES72209544951851809297,6307.96,2022-04-06T12:18:36,Portugalete,expenses,electricity,-64.43,43.15
buyer_7,María,Valdec,1968-12-31,54502279F,maría.valdec@awesomecloud.com,031005,ES72209544951851809297,6307.96,2022-04-06T11:24:12,Portugalete,expenses,clothing,-46.99,-3.84
buyer_7,María,Valdec,1968-12-31,54502279F,maría.valdec@awesomecloud.com,031005,ES72209544951851809297,6307.96,2022-04-07T08:45:01,Portugalete,expenses,phone,-33.04,-36.88
buyer_7,María,Valdec,1968-12-31,54502279F,maría.valdec@awesomecloud.com,031005,ES72209544951851809297,6307.96,2022-04-09T05:41:15,Portugalete,expenses,gifts,-276.14,-313.02
buyer_7,María,Valdec,1968-12-31,54502279F,maría.valdec@awesomecloud.com,031005,ES72209544951851809297,6307.96,2022-04-12T20:48:16,Portugalete,expenses,food,-63.38,-376.4
buyer_7,María,Valdec,1968-12-31,54502279F,maría.valdec@awesomecloud.com,031005,ES72209544951851809297,6307.96,2022-04-14T09:50:49,Portugalete,expenses,cash,-100.0,-476.4
buyer_7,María,Valdec,1968-12-31,54502279F,maría.valdec@awesomecloud.com,031005,ES72209544951851809297,6307.96,2022-04-15T08:02:13,Portugalete,expenses,transport,-41.57,-517.97
buyer_7,María,Valdec,1968-12-31,54502279F,maría.valdec@awesomecloud.com,031005,ES72209544951851809297,6307.96,2022-04-16T18:50:03,Portugalete,expenses,cash,-100.0,-617.97
buyer_7,María,Valdec,1968-12-31,54502279F,maría.valdec@awesomecloud.com,031005,ES72209544951851809297,6307.96,2022-04-17T21:14:05,Portugalete,expenses,leisure,-44.02,-661.99
buyer_7,María,Valdec,1968-12-31,54502279F,maría.valdec@awesomecloud.com,031005,ES72209544951851809297,6307.96,2022-04-18T13:11:10,Portugalete,expenses,transport,-58.74,-720.73
buyer_7,María,Valdec,1968-12-31,54502279F,maría.valdec@awesomecloud.com,031005,ES72209544951851809297,6307.96,2022-04-21T10:53:18,Portugalete,expenses,leisure,-31.88,-752.61
buyer_7,María,Valdec,1968-12-31,54502279F,maría.valdec@awesomecloud.com,031005,ES72209544951851809297,6307.96,2022-04-22T15:20:46,Portugalete,expenses,clothing,-147.56,-900.17
buyer_7,María,Valdec,1968-12-31,54502279F,maría.valdec@awesomecloud.com,031005,ES72209544951851809297,6307.96,2022-04-23T11:16:22,Portugalete,expenses,transport,-68.07,-968.24
buyer_7,María,Valdec,1968-12-31,54502279F,maría.valdec@awesomecloud.com,031005,ES72209544951851809297,6307.96,2022-04-23T14:27:35,Portugalete,expenses,clothing,-127.85,-1096.09
buyer_7,María,Valdec,1968-12-31,54502279F,maría.valdec@awesomecloud.com,031005,ES72209544951851809297,6307.96,2022-04-23T09:03:19,Portugalete,expenses,cash,-100.0,-1196.09
buyer_7,María,Valdec,1968-12-31,54502279F,maría.valdec@awesomecloud.com,031005,ES72209544951851809297,6307.96,2022-04-23T12:15:23,Portugalete,expenses,repairs,-15.9,-1211.99
buyer_7,María,Valdec,1968-12-31,54502279F,maría.valdec@awesomecloud.com,031005,ES72209544951851809297,6307.96,2022-04-26T13:45:55,Portugalete,expenses,repairs,-118.32,-1330.31
buyer_7,María,Valdec,1968-12-31,54502279F,maría.valdec@awesomecloud.com,031005,ES72209544951851809297,6307.96,2022-04-27T17:37:26,Portugalete,expenses,food,-124.5,-1454.81
buyer_7,María,Valdec,1968-12-31,54502279F,maría.valdec@awesomecloud.com,031005,ES72209544951851809297,6307.96,2022-04-28T02:56:40,Portugalete,expenses,transport,-74.36,-1529.17
buyer_7,María,Valdec,1968-12-31,54502279F,maría.valdec@awesomecloud.com,031005,ES72209544951851809297,6307.96,2022-04-28T16:39:54,Portugalete,expenses,cash,-100.0,-1629.17
buyer_7,María,Valdec,1968-12-31,54502279F,maría.valdec@awesomecloud.com,031005,ES72209544951851809297,6307.96,2022-04-30T01:27:24,Portugalete,expenses,appliances,-143.36,-1772.53
buyer_7,María,Valdec,1968-12-31,54502279F,maría.valdec@awesomecloud.com,031005,ES72209544951851809297,6307.96,2022-05-01T09:51:15,Portugalete,incomes,salary,1502.17,-270.36
buyer_7,María,Valdec,1968-12-31,54502279F,maría.valdec@awesomecloud.com,031005,ES72209544951851809297,6307.96,2022-05-02T14:12:55,Portugalete,expenses,transport,-77.46,-347.82
buyer_7,María,Valdec,1968-12-31,54502279F,maría.valdec@awesomecloud.com,031005,ES72209544951851809297,6307.96,2022-05-02T15:00:35,Portugalete,expenses,healthcare,-142.44,-490.26
buyer_7,María,Valdec,1968-12-31,54502279F,maría.valdec@awesomecloud.com,031005,ES72209544951851809297,6307.96,2022-05-02T10:16:19,Portugalete,expenses,gifts,-26.28,-516.54
buyer_7,María,Valdec,1968-12-31,54502279F,maría.valdec@awesomecloud.com,031005,ES72209544951851809297,6307.96,2022-05-03T11:01:38,Portugalete,expenses,food,-65.12,-581.66
buyer_7,María,Valdec,1968-12-31,54502279F,maría.valdec@awesomecloud.com,031005,ES72209544951851809297,6307.96,2022-05-04T23:41:55,Portugalete,expenses,mortgage,-748.36,-1330.02
buyer_7,María,Valdec,1968-12-31,54502279F,maría.valdec@awesomecloud.com,031005,ES72209544951851809297,6307.96,2022-05-06T08:52:39,Portugalete,expenses,electricity,-31.7,-1361.72
buyer_7,María,Valdec,1968-12-31,54502279F,maría.valdec@awesomecloud.com,031005,ES72209544951851809297,6307.96,2022-05-07T14:47:18,Portugalete,expenses,internet,-31.55,-1393.27
buyer_7,María,Valdec,1968-12-31,54502279F,maría.valdec@awesomecloud.com,031005,ES72209544951851809297,6307.96,2022-05-07T15:28:09,Portugalete,expenses,education,-52.7,-1445.97
buyer_7,María,Valdec,1968-12-31,54502279F,maría.valdec@awesomecloud.com,031005,ES72209544951851809297,6307.96,2022-05-10T01:12:28,Portugalete,expenses,transport,-63.46,-1509.43
buyer_7,María,Valdec,1968-12-31,54502279F,maría.valdec@awesomecloud.com,031005,ES72209544951851809297,6307.96,2022-05-10T21:27:28,Portugalete,expenses,leisure,-54.27,-1563.7
buyer_7,María,Valdec,1968-12-31,54502279F,maría.valdec@awesomecloud.com,031005,ES72209544951851809297,6307.96,2022-05-11T21:00:15,Portugalete,expenses,healthcare,-118.24,-1681.94
buyer_7,María,Valdec,1968-12-31,54502279F,maría.valdec@awesomecloud.com,031005,ES72209544951851809297,6307.96,2022-05-11T13:44:59,Portugalete,expenses,cash,-100.0,-1781.94
buyer_7,María,Valdec,1968-12-31,54502279F,maría.valdec@awesomecloud.com,031005,ES72209544951851809297,6307.96,2022-05-12T16:38:51,Portugalete,expenses,clothing,-45.84,-1827.78
buyer_7,María,Valdec,1968-12-31,54502279F,maría.valdec@awesomecloud.com,031005,ES72209544951851809297,6307.96,2022-05-13T15:56:27,Portugalete,expenses,leisure,-32.76,-1860.54
buyer_7,María,Valdec,1968-12-31,54502279F,maría.valdec@awesomecloud.com,031005,ES72209544951851809297,6307.96,2022-05-14T19:12:45,Portugalete,expenses,food,-108.12,-1968.66
buyer_7,María,Valdec,1968-12-31,54502279F,maría.valdec@awesomecloud.com,031005,ES72209544951851809297,6307.96,2022-05-14T18:44:45,Portugalete,expenses,cash,-100.0,-2068.66
buyer_7,María,Valdec,1968-12-31,54502279F,maría.valdec@awesomecloud.com,031005,ES72209544951851809297,6307.96,2022-05-16T21:19:14,Portugalete,expenses,leisure,-74.95,-2143.61
buyer_7,María,Valdec,1968-12-31,54502279F,maría.valdec@awesomecloud.com,031005,ES72209544951851809297,6307.96,2022-05-16T16:16:10,Portugalete,expenses,appliances,-200.75,-2344.36
buyer_7,María,Valdec,1968-12-31,54502279F,maría.valdec@awesomecloud.com,031005,ES72209544951851809297,6307.96,2022-05-17T14:57:49,Portugalete,expenses,food,-106.97,-2451.33
buyer_7,María,Valdec,1968-12-31,54502279F,maría.valdec@awesomecloud.com,031005,ES72209544951851809297,6307.96,2022-05-18T08:24:48,Portugalete,expenses,leisure,-57.53,-2508.86
buyer_7,María,Valdec,1968-12-31,54502279F,maría.valdec@awesomecloud.com,031005,ES72209544951851809297,6307.96,2022-05-18T13:19:49,Portugalete,expenses,clothing,-149.71,-2658.57
buyer_7,María,Valdec,1968-12-31,54502279F,maría.valdec@awesomecloud.com,031005,ES72209544951851809297,6307.96,2022-05-20T12:01:19,Portugalete,expenses,food,-102.12,-2760.69
buyer_7,María,Valdec,1968-12-31,54502279F,maría.valdec@awesomecloud.com,031005,ES72209544951851809297,6307.96,2022-05-21T00:45:20,Portugalete,expenses,cash,-100.0,-2860.69
buyer_7,María,Valdec,1968-12-31,54502279F,maría.valdec@awesomecloud.com,031005,ES72209544951851809297,6307.96,2022-05-23T10:03:27,Portugalete,expenses,clothing,-118.97,-2979.66
buyer_7,María,Valdec,1968-12-31,54502279F,maría.valdec@awesomecloud.com,031005,ES72209544951851809297,6307.96,2022-05-23T20:58:32,Portugalete,expenses,cash,-100.0,-3079.66
buyer_7,María,Valdec,1968-12-31,54502279F,maría.valdec@awesomecloud.com,031005,ES72209544951851809297,6307.96,2022-05-25T18:11:48,Portugalete,expenses,food,-67.02,-3146.68
buyer_7,María,Valdec,1968-12-31,54502279F,maría.valdec@awesomecloud.com,031005,ES72209544951851809297,6307.96,2022-05-25T03:44:26,Portugalete,expenses,travel,-270.05,-3416.73
buyer_7,María,Valdec,1968-12-31,54502279F,maría.valdec@awesomecloud.com,031005,ES72209544951851809297,6307.96,2022-05-26T16:16:29,Portugalete,expenses,healthcare,-126.05,-3542.78
buyer_7,María,Valdec,1968-12-31,54502279F,maría.valdec@awesomecloud.com,031005,ES72209544951851809297,6307.96,2022-05-27T16:05:20,Portugalete,expenses,cash,-100.0,-3642.78
buyer_7,María,Valdec,1968-12-31,54502279F,maría.valdec@awesomecloud.com,031005,ES72209544951851809297,6307.96,2022-05-28T12:12:53,Portugalete,expenses,repairs,-80.75,-3723.53
buyer_7,María,Valdec,1968-12-31,54502279F,maría.valdec@awesomecloud.com,031005,ES72209544951851809297,6307.96,2022-05-29T08:59:55,Portugalete,expenses,transport,-59.85,-3783.38
buyer_7,María,Valdec,1968-12-31,54502279F,maría.valdec@awesomecloud.com,031005,ES72209544951851809297,6307.96,2022-06-01T02:11:56,Portugalete,incomes,salary,1502.17,-2281.21
buyer_7,María,Valdec,1968-12-31,54502279F,maría.valdec@awesomecloud.com,031005,ES72209544951851809297,6307.96,2022-06-01T02:11:56,Portugalete,incomes,salary_bonus,1054.5,-1226.71
buyer_7,María,Valdec,1968-12-31,54502279F,maría.valdec@awesomecloud.com,031005,ES72209544951851809297,6307.96,2022-06-01T16:09:54,Portugalete,expenses,repairs,-141.14,-1367.85
buyer_7,María,Valdec,1968-12-31,54502279F,maría.valdec@awesomecloud.com,031005,ES72209544951851809297,6307.96,2022-06-01T12:55:15,Portugalete,expenses,gifts,-152.86,-1520.71
buyer_7,María,Valdec,1968-12-31,54502279F,maría.valdec@awesomecloud.com,031005,ES72209544951851809297,6307.96,2022-06-02T12:29:57,Portugalete,expenses,taxes,-1351.33,-2872.04
buyer_7,María,Valdec,1968-12-31,54502279F,maría.valdec@awesomecloud.com,031005,ES72209544951851809297,6307.96,2022-06-02T15:57:37,Portugalete,expenses,insurance,-368.39,-3240.43
buyer_7,María,Valdec,1968-12-31,54502279F,maría.valdec@awesomecloud.com,031005,ES72209544951851809297,6307.96,2022-06-02T18:19:56,Portugalete,expenses,transport,-86.4,-3326.83
buyer_7,María,Valdec,1968-12-31,54502279F,maría.valdec@awesomecloud.com,031005,ES72209544951851809297,6307.96,2022-06-03T23:22:29,Portugalete,expenses,cash,-100.0,-3426.83
buyer_7,María,Valdec,1968-12-31,54502279F,maría.valdec@awesomecloud.com,031005,ES72209544951851809297,6307.96,2022-06-04T09:53:56,Portugalete,expenses,mortgage,-748.36,-4175.19
buyer_7,María,Valdec,1968-12-31,54502279F,maría.valdec@awesomecloud.com,031005,ES72209544951851809297,6307.96,2022-06-05T18:36:58,Portugalete,expenses,electricity,-28.48,-4203.67
buyer_7,María,Valdec,1968-12-31,54502279F,maría.valdec@awesomecloud.com,031005,ES72209544951851809297,6307.96,2022-06-05T09:36:12,Portugalete,expenses,phone,-33.25,-4236.92
buyer_7,María,Valdec,1968-12-31,54502279F,maría.valdec@awesomecloud.com,031005,ES72209544951851809297,6307.96,2022-06-05T14:33:44,Portugalete,expenses,children,-304.0648333333333,-4540.98
buyer_7,María,Valdec,1968-12-31,54502279F,maría.valdec@awesomecloud.com,031005,ES72209544951851809297,6307.96,2022-06-06T08:34:28,Portugalete,expenses,repairs,-197.57,-4738.55
buyer_7,María,Valdec,1968-12-31,54502279F,maría.valdec@awesomecloud.com,031005,ES72209544951851809297,6307.96,2022-06-07T14:59:15,Portugalete,expenses,electricity,-61.4,-4799.95
buyer_7,María,Valdec,1968-12-31,54502279F,maría.valdec@awesomecloud.com,031005,ES72209544951851809297,6307.96,2022-06-07T22:18:22,Portugalete,expenses,internet,-31.55,-4831.5
buyer_7,María,Valdec,1968-12-31,54502279F,maría.valdec@awesomecloud.com,031005,ES72209544951851809297,6307.96,2022-06-07T17:13:38,Portugalete,expenses,food,-75.09,-4906.59
buyer_7,María,Valdec,1968-12-31,54502279F,maría.valdec@awesomecloud.com,031005,ES72209544951851809297,6307.96,2022-06-08T13:23:23,Portugalete,expenses,gas,-26.41,-4933.0
buyer_7,María,Valdec,1968-12-31,54502279F,maría.valdec@awesomecloud.com,031005,ES72209544951851809297,6307.96,2022-06-09T19:50:35,Portugalete,expenses,cash,-100.0,-5033.0
buyer_7,María,Valdec,1968-12-31,54502279F,maría.valdec@awesomecloud.com,031005,ES72209544951851809297,6307.96,2022-06-11T10:28:34,Portugalete,expenses,cash,-100.0,-5133.0
buyer_7,María,Valdec,1968-12-31,54502279F,maría.valdec@awesomecloud.com,031005,ES72209544951851809297,6307.96,2022-06-12T18:43:50,Portugalete,expenses,cash,-100.0,-5233.0
buyer_7,María,Valdec,1968-12-31,54502279F,maría.valdec@awesomecloud.com,031005,ES72209544951851809297,6307.96,2022-06-12T18:25:07,Portugalete,expenses,gifts,-86.47,-5319.47
buyer_7,María,Valdec,1968-12-31,54502279F,maría.valdec@awesomecloud.com,031005,ES72209544951851809297,6307.96,2022-06-13T16:36:33,Portugalete,expenses,travel,-282.69,-5602.16
buyer_7,María,Valdec,1968-12-31,54502279F,maría.valdec@awesomecloud.com,031005,ES72209544951851809297,6307.96,2022-06-15T18:43:40,Portugalete,expenses,food,-66.43,-5668.59
buyer_7,María,Valdec,1968-12-31,54502279F,maría.valdec@awesomecloud.com,031005,ES72209544951851809297,6307.96,2022-06-18T09:24:49,Portugalete,expenses,cash,-100.0,-5768.59
buyer_7,María,Valdec,1968-12-31,54502279F,maría.valdec@awesomecloud.com,031005,ES72209544951851809297,6307.96,2022-06-20T18:23:23,Portugalete,expenses,food,-116.24,-5884.83
buyer_7,María,Valdec,1968-12-31,54502279F,maría.valdec@awesomecloud.com,031005,ES72209544951851809297,6307.96,2022-06-20T15:41:34,Portugalete,expenses,repairs,-101.0,-5985.83
buyer_7,María,Valdec,1968-12-31,54502279F,maría.valdec@awesomecloud.com,031005,ES72209544951851809297,6307.96,2022-06-22T13:34:31,Portugalete,expenses,food,-111.85,-6097.68
buyer_7,María,Valdec,1968-12-31,54502279F,maría.valdec@awesomecloud.com,031005,ES72209544951851809297,6307.96,2022-06-25T19:12:07,Portugalete,expenses,cash,-100.0,-6197.68
buyer_7,María,Valdec,1968-12-31,54502279F,maría.valdec@awesomecloud.com,031005,ES72209544951851809297,6307.96,2022-06-28T08:24:11,Portugalete,expenses,food,-70.29,-6267.97
buyer_7,María,Valdec,1968-12-31,54502279F,maría.valdec@awesomecloud.com,031005,ES72209544951851809297,6307.96,2022-06-29T12:55:17,Portugalete,expenses,food,-111.03,-6379.0
buyer_7,María,Valdec,1968-12-31,54502279F,maría.valdec@awesomecloud.com,031005,ES72209544951851809297,6307.96,2022-06-29T19:12:15,Portugalete,expenses,transport,-68.33,-6447.33
buyer_7,María,Valdec,1968-12-31,54502279F,maría.valdec@awesomecloud.com,031005,ES72209544951851809297,6307.96,2022-07-01T13:04:16,Portugalete,incomes,salary,1502.17,-4945.16
buyer_7,María,Valdec,1968-12-31,54502279F,maría.valdec@awesomecloud.com,031005,ES72209544951851809297,6307.96,2022-07-01T13:04:16,Portugalete,incomes,extra_income,219.04,-4726.12
buyer_7,María,Valdec,1968-12-31,54502279F,maría.valdec@awesomecloud.com,031005,ES72209544951851809297,6307.96,2022-07-01T14:33:04,Portugalete,expenses,leisure,-44.65,-4770.77
buyer_7,María,Valdec,1968-12-31,54502279F,maría.valdec@awesomecloud.com,031005,ES72209544951851809297,6307.96,2022-07-01T15:59:37,Portugalete,expenses,repairs,-41.75,-4812.52
buyer_7,María,Valdec,1968-12-31,54502279F,maría.valdec@awesomecloud.com,031005,ES72209544951851809297,6307.96,2022-07-04T15:24:58,Portugalete,expenses,mortgage,-748.36,-5560.88
buyer_7,María,Valdec,1968-12-31,54502279F,maría.valdec@awesomecloud.com,031005,ES72209544951851809297,6307.96,2022-07-04T19:05:19,Portugalete,expenses,healthcare,-119.54,-5680.42
buyer_7,María,Valdec,1968-12-31,54502279F,maría.valdec@awesomecloud.com,031005,ES72209544951851809297,6307.96,2022-07-04T12:02:44,Portugalete,expenses,gifts,-51.69,-5732.11
buyer_7,María,Valdec,1968-12-31,54502279F,maría.valdec@awesomecloud.com,031005,ES72209544951851809297,6307.96,2022-07-06T10:25:42,Portugalete,expenses,gas,-61.26,-5793.37
buyer_7,María,Valdec,1968-12-31,54502279F,maría.valdec@awesomecloud.com,031005,ES72209544951851809297,6307.96,2022-07-06T18:57:38,Portugalete,expenses,phone,-25.05,-5818.42
buyer_7,María,Valdec,1968-12-31,54502279F,maría.valdec@awesomecloud.com,031005,ES72209544951851809297,6307.96,2022-07-06T12:29:53,Portugalete,expenses,food,-103.8,-5922.22
buyer_7,María,Valdec,1968-12-31,54502279F,maría.valdec@awesomecloud.com,031005,ES72209544951851809297,6307.96,2022-07-07T13:46:41,Portugalete,expenses,internet,-31.55,-5953.77
buyer_7,María,Valdec,1968-12-31,54502279F,maría.valdec@awesomecloud.com,031005,ES72209544951851809297,6307.96,2022-07-08T12:45:58,Portugalete,expenses,gas,-46.65,-6000.42
buyer_7,María,Valdec,1968-12-31,54502279F,maría.valdec@awesomecloud.com,031005,ES72209544951851809297,6307.96,2022-07-08T08:18:44,Portugalete,expenses,food,-117.13,-6117.55
buyer_7,María,Valdec,1968-12-31,54502279F,maría.valdec@awesomecloud.com,031005,ES72209544951851809297,6307.96,2022-07-08T07:20:52,Portugalete,expenses,gifts,-78.25,-6195.8
buyer_7,María,Valdec,1968-12-31,54502279F,maría.valdec@awesomecloud.com,031005,ES72209544951851809297,6307.96,2022-07-09T13:28:31,Portugalete,expenses,healthcare,-158.17,-6353.97
buyer_7,María,Valdec,1968-12-31,54502279F,maría.valdec@awesomecloud.com,031005,ES72209544951851809297,6307.96,2022-07-09T09:42:58,Portugalete,expenses,cash,-100.0,-6453.97
buyer_7,María,Valdec,1968-12-31,54502279F,maría.valdec@awesomecloud.com,031005,ES72209544951851809297,6307.96,2022-07-11T11:07:14,Portugalete,expenses,transport,-73.97,-6527.94
buyer_7,María,Valdec,1968-12-31,54502279F,maría.valdec@awesomecloud.com,031005,ES72209544951851809297,6307.96,2022-07-11T11:27:10,Portugalete,expenses,cash,-100.0,-6627.94
buyer_7,María,Valdec,1968-12-31,54502279F,maría.valdec@awesomecloud.com,031005,ES72209544951851809297,6307.96,2022-07-12T17:23:04,Portugalete,expenses,education,-57.51,-6685.45
buyer_7,María,Valdec,1968-12-31,54502279F,maría.valdec@awesomecloud.com,031005,ES72209544951851809297,6307.96,2022-07-13T22:09:50,Portugalete,expenses,cash,-100.0,-6785.45
buyer_7,María,Valdec,1968-12-31,54502279F,maría.valdec@awesomecloud.com,031005,ES72209544951851809297,6307.96,2022-07-14T09:52:19,Portugalete,expenses,education,-77.97,-6863.42
buyer_7,María,Valdec,1968-12-31,54502279F,maría.valdec@awesomecloud.com,031005,ES72209544951851809297,6307.96,2022-07-16T13:19:12,Portugalete,expenses,food,-108.81,-6972.23
buyer_7,María,Valdec,1968-12-31,54502279F,maría.valdec@awesomecloud.com,031005,ES72209544951851809297,6307.96,2022-07-17T14:00:31,Portugalete,expenses,repairs,-290.01,-7262.24
buyer_7,María,Valdec,1968-12-31,54502279F,maría.valdec@awesomecloud.com,031005,ES72209544951851809297,6307.96,2022-07-19T10:46:09,Portugalete,expenses,food,-66.72,-7328.96
buyer_7,María,Valdec,1968-12-31,54502279F,maría.valdec@awesomecloud.com,031005,ES72209544951851809297,6307.96,2022-07-19T23:09:54,Portugalete,expenses,cash,-100.0,-7428.96
buyer_7,María,Valdec,1968-12-31,54502279F,maría.valdec@awesomecloud.com,031005,ES72209544951851809297,6307.96,2022-07-20T09:06:18,Portugalete,expenses,gifts,-170.95,-7599.91
buyer_7,María,Valdec,1968-12-31,54502279F,maría.valdec@awesomecloud.com,031005,ES72209544951851809297,6307.96,2022-07-21T03:28:20,Portugalete,expenses,transport,-59.33,-7659.24
buyer_7,María,Valdec,1968-12-31,54502279F,maría.valdec@awesomecloud.com,031005,ES72209544951851809297,6307.96,2022-07-23T09:10:54,Portugalete,expenses,cash,-100.0,-7759.24
buyer_7,María,Valdec,1968-12-31,54502279F,maría.valdec@awesomecloud.com,031005,ES72209544951851809297,6307.96,2022-07-23T14:17:32,Portugalete,expenses,travel,-216.94,-7976.18
buyer_7,María,Valdec,1968-12-31,54502279F,maría.valdec@awesomecloud.com,031005,ES72209544951851809297,6307.96,2022-07-26T08:55:48,Portugalete,expenses,transport,-83.47,-8059.65
buyer_7,María,Valdec,1968-12-31,54502279F,maría.valdec@awesomecloud.com,031005,ES72209544951851809297,6307.96,2022-07-28T10:57:26,Portugalete,expenses,food,-71.23,-8130.88
buyer_7,María,Valdec,1968-12-31,54502279F,maría.valdec@awesomecloud.com,031005,ES72209544951851809297,6307.96,2022-07-28T10:40:33,Portugalete,expenses,healthcare,-76.65,-8207.53
buyer_7,María,Valdec,1968-12-31,54502279F,maría.valdec@awesomecloud.com,031005,ES72209544951851809297,6307.96,2022-07-30T13:44:23,Portugalete,expenses,children,-111.49,-8319.02
buyer_7,María,Valdec,1968-12-31,54502279F,maría.valdec@awesomecloud.com,031005,ES72209544951851809297,6307.96,2022-08-01T09:29:38,Portugalete,incomes,salary,1502.17,-6816.85
buyer_7,María,Valdec,1968-12-31,54502279F,maría.valdec@awesomecloud.com,031005,ES72209544951851809297,6307.96,2022-08-01T22:39:22,Portugalete,expenses,leisure,-84.82,-6901.67
buyer_7,María,Valdec,1968-12-31,54502279F,maría.valdec@awesomecloud.com,031005,ES72209544951851809297,6307.96,2022-08-02T13:33:23,Portugalete,expenses,leisure,-36.91,-6938.58
buyer_7,María,Valdec,1968-12-31,54502279F,maría.valdec@awesomecloud.com,031005,ES72209544951851809297,6307.96,2022-08-02T18:23:12,Portugalete,expenses,cash,-100.0,-7038.58
buyer_7,María,Valdec,1968-12-31,54502279F,maría.valdec@awesomecloud.com,031005,ES72209544951851809297,6307.96,2022-08-04T19:16:52,Portugalete,expenses,mortgage,-748.36,-7786.94
buyer_7,María,Valdec,1968-12-31,54502279F,maría.valdec@awesomecloud.com,031005,ES72209544951851809297,6307.96,2022-08-04T15:56:59,Portugalete,expenses,repairs,-35.85,-7822.79
buyer_7,María,Valdec,1968-12-31,54502279F,maría.valdec@awesomecloud.com,031005,ES72209544951851809297,6307.96,2022-08-05T09:17:52,Portugalete,expenses,cash,-100.0,-7922.79
buyer_7,María,Valdec,1968-12-31,54502279F,maría.valdec@awesomecloud.com,031005,ES72209544951851809297,6307.96,2022-08-06T13:41:14,Portugalete,expenses,water,-23.2,-7945.99
buyer_7,María,Valdec,1968-12-31,54502279F,maría.valdec@awesomecloud.com,031005,ES72209544951851809297,6307.96,2022-08-07T03:57:27,Portugalete,expenses,electricity,-53.72,-7999.71
buyer_7,María,Valdec,1968-12-31,54502279F,maría.valdec@awesomecloud.com,031005,ES72209544951851809297,6307.96,2022-08-07T10:44:22,Portugalete,expenses,transport,-52.34,-8052.05
buyer_7,María,Valdec,1968-12-31,54502279F,maría.valdec@awesomecloud.com,031005,ES72209544951851809297,6307.96,2022-08-10T16:07:58,Portugalete,expenses,children,-304.0648333333333,-8356.11
buyer_7,María,Valdec,1968-12-31,54502279F,maría.valdec@awesomecloud.com,031005,ES72209544951851809297,6307.96,2022-08-12T18:19:38,Portugalete,expenses,food,-110.18,-8466.29
buyer_7,María,Valdec,1968-12-31,54502279F,maría.valdec@awesomecloud.com,031005,ES72209544951851809297,6307.96,2022-08-12T08:20:41,Portugalete,expenses,repairs,-84.92,-8551.21
buyer_7,María,Valdec,1968-12-31,54502279F,maría.valdec@awesomecloud.com,031005,ES72209544951851809297,6307.96,2022-08-15T09:26:29,Portugalete,expenses,food,-78.84,-8630.05
buyer_7,María,Valdec,1968-12-31,54502279F,maría.valdec@awesomecloud.com,031005,ES72209544951851809297,6307.96,2022-08-16T13:07:09,Portugalete,expenses,food,-114.2,-8744.25
buyer_7,María,Valdec,1968-12-31,54502279F,maría.valdec@awesomecloud.com,031005,ES72209544951851809297,6307.96,2022-08-17T17:25:27,Portugalete,expenses,clothing,-101.67,-8845.92
buyer_7,María,Valdec,1968-12-31,54502279F,maría.valdec@awesomecloud.com,031005,ES72209544951851809297,6307.96,2022-08-19T15:48:47,Portugalete,expenses,cash,-100.0,-8945.92
buyer_7,María,Valdec,1968-12-31,54502279F,maría.valdec@awesomecloud.com,031005,ES72209544951851809297,6307.96,2022-08-23T16:47:45,Portugalete,expenses,repairs,-300.11,-9246.03
buyer_7,María,Valdec,1968-12-31,54502279F,maría.valdec@awesomecloud.com,031005,ES72209544951851809297,6307.96,2022-08-26T09:09:22,Portugalete,expenses,gifts,-105.29,-9351.32
buyer_7,María,Valdec,1968-12-31,54502279F,maría.valdec@awesomecloud.com,031005,ES72209544951851809297,6307.96,2022-08-27T19:12:44,Portugalete,expenses,cash,-100.0,-9451.32
buyer_7,María,Valdec,1968-12-31,54502279F,maría.valdec@awesomecloud.com,031005,ES72209544951851809297,6307.96,2022-08-28T12:59:41,Portugalete,expenses,food,-75.85,-9527.17
buyer_7,María,Valdec,1968-12-31,54502279F,maría.valdec@awesomecloud.com,031005,ES72209544951851809297,6307.96,2022-08-28T12:49:46,Portugalete,expenses,transport,-66.34,-9593.51
buyer_7,María,Valdec,1968-12-31,54502279F,maría.valdec@awesomecloud.com,031005,ES72209544951851809297,6307.96,2022-08-28T09:09:34,Portugalete,expenses,gifts,-58.01,-9651.52
buyer_7,María,Valdec,1968-12-31,54502279F,maría.valdec@awesomecloud.com,031005,ES72209544951851809297,6307.96,2022-08-28T12:58:34,Portugalete,expenses,children,-103.86483333333331,-9755.38
buyer_7,María,Valdec,1968-12-31,54502279F,maría.valdec@awesomecloud.com,031005,ES72209544951851809297,6307.96,2022-08-29T21:52:11,Portugalete,expenses,food,-106.4,-9861.78
buyer_7,María,Valdec,1968-12-31,54502279F,maría.valdec@awesomecloud.com,031005,ES72209544951851809297,6307.96,2022-08-29T08:29:01,Portugalete,expenses,gifts,-30.99,-9892.77
buyer_7,María,Valdec,1968-12-31,54502279F,maría.valdec@awesomecloud.com,031005,ES72209544951851809297,6307.96,2022-08-31T19:05:11,Portugalete,expenses,education,-77.23,-9970.0
buyer_7,María,Valdec,1968-12-31,54502279F,maría.valdec@awesomecloud.com,031005,ES72209544951851809297,6307.96,2022-09-01T15:15:44,Portugalete,incomes,salary,1502.17,-8467.83
buyer_7,María,Valdec,1968-12-31,54502279F,maría.valdec@awesomecloud.com,031005,ES72209544951851809297,6307.96,2022-09-02T16:23:15,Portugalete,expenses,repairs,-135.46,-8603.29
buyer_7,María,Valdec,1968-12-31,54502279F,maría.valdec@awesomecloud.com,031005,ES72209544951851809297,6307.96,2022-09-04T08:20:46,Portugalete,expenses,mortgage,-748.36,-9351.65
buyer_7,María,Valdec,1968-12-31,54502279F,maría.valdec@awesomecloud.com,031005,ES72209544951851809297,6307.96,2022-09-04T13:22:40,Portugalete,expenses,food,-101.9,-9453.55
buyer_7,María,Valdec,1968-12-31,54502279F,maría.valdec@awesomecloud.com,031005,ES72209544951851809297,6307.96,2022-09-05T18:59:55,Portugalete,expenses,internet,-31.55,-9485.1
buyer_7,María,Valdec,1968-12-31,54502279F,maría.valdec@awesomecloud.com,031005,ES72209544951851809297,6307.96,2022-09-05T18:34:36,Portugalete,expenses,phone,-27.92,-9513.02
buyer_7,María,Valdec,1968-12-31,54502279F,maría.valdec@awesomecloud.com,031005,ES72209544951851809297,6307.96,2022-09-06T10:53:14,Portugalete,expenses,water,-27.92,-9540.94
buyer_7,María,Valdec,1968-12-31,54502279F,maría.valdec@awesomecloud.com,031005,ES72209544951851809297,6307.96,2022-09-06T13:18:12,Portugalete,expenses,electricity,-33.95,-9574.89
buyer_7,María,Valdec,1968-12-31,54502279F,maría.valdec@awesomecloud.com,031005,ES72209544951851809297,6307.96,2022-09-07T10:27:41,Portugalete,expenses,electricity,-29.37,-9604.26
buyer_7,María,Valdec,1968-12-31,54502279F,maría.valdec@awesomecloud.com,031005,ES72209544951851809297,6307.96,2022-09-07T08:40:05,Portugalete,expenses,clothing,-58.53,-9662.79
buyer_7,María,Valdec,1968-12-31,54502279F,maría.valdec@awesomecloud.com,031005,ES72209544951851809297,6307.96,2022-09-07T17:13:11,Portugalete,expenses,healthcare,-177.76,-9840.55
buyer_7,María,Valdec,1968-12-31,54502279F,maría.valdec@awesomecloud.com,031005,ES72209544951851809297,6307.96,2022-09-07T08:49:39,Portugalete,expenses,repairs,-48.83,-9889.38
buyer_7,María,Valdec,1968-12-31,54502279F,maría.valdec@awesomecloud.com,031005,ES72209544951851809297,6307.96,2022-09-08T04:11:51,Portugalete,expenses,clothing,-92.9,-9982.28
buyer_7,María,Valdec,1968-12-31,54502279F,maría.valdec@awesomecloud.com,031005,ES72209544951851809297,6307.96,2022-09-09T11:31:33,Portugalete,expenses,cash,-100.0,-10082.28
buyer_7,María,Valdec,1968-12-31,54502279F,maría.valdec@awesomecloud.com,031005,ES72209544951851809297,6307.96,2022-09-10T00:50:11,Portugalete,expenses,food,-111.63,-10193.91
buyer_7,María,Valdec,1968-12-31,54502279F,maría.valdec@awesomecloud.com,031005,ES72209544951851809297,6307.96,2022-09-10T08:21:11,Portugalete,expenses,repairs,-75.63,-10269.54
buyer_7,María,Valdec,1968-12-31,54502279F,maría.valdec@awesomecloud.com,031005,ES72209544951851809297,6307.96,2022-09-11T14:15:47,Portugalete,expenses,cash,-100.0,-10369.54
buyer_7,María,Valdec,1968-12-31,54502279F,maría.valdec@awesomecloud.com,031005,ES72209544951851809297,6307.96,2022-09-12T16:27:07,Portugalete,expenses,food,-64.59,-10434.13
buyer_7,María,Valdec,1968-12-31,54502279F,maría.valdec@awesomecloud.com,031005,ES72209544951851809297,6307.96,2022-09-12T20:55:00,Portugalete,expenses,cash,-100.0,-10534.13
buyer_7,María,Valdec,1968-12-31,54502279F,maría.valdec@awesomecloud.com,031005,ES72209544951851809297,6307.96,2022-09-14T17:38:14,Portugalete,expenses,leisure,-48.63,-10582.76
buyer_7,María,Valdec,1968-12-31,54502279F,maría.valdec@awesomecloud.com,031005,ES72209544951851809297,6307.96,2022-09-14T11:59:20,Portugalete,expenses,cash,-100.0,-10682.76
buyer_7,María,Valdec,1968-12-31,54502279F,maría.valdec@awesomecloud.com,031005,ES72209544951851809297,6307.96,2022-09-14T13:04:11,Portugalete,expenses,appliances,-145.4,-10828.16
buyer_7,María,Valdec,1968-12-31,54502279F,maría.valdec@awesomecloud.com,031005,ES72209544951851809297,6307.96,2022-09-17T15:49:54,Portugalete,expenses,transport,-82.1,-10910.26
buyer_7,María,Valdec,1968-12-31,54502279F,maría.valdec@awesomecloud.com,031005,ES72209544951851809297,6307.96,2022-09-18T15:32:49,Portugalete,expenses,clothing,-69.67,-10979.93
buyer_7,María,Valdec,1968-12-31,54502279F,maría.valdec@awesomecloud.com,031005,ES72209544951851809297,6307.96,2022-09-20T14:13:30,Portugalete,expenses,food,-60.11,-11040.04
buyer_7,María,Valdec,1968-12-31,54502279F,maría.valdec@awesomecloud.com,031005,ES72209544951851809297,6307.96,2022-09-22T23:11:54,Portugalete,expenses,transport,-51.91,-11091.95
buyer_7,María,Valdec,1968-12-31,54502279F,maría.valdec@awesomecloud.com,031005,ES72209544951851809297,6307.96,2022-09-22T20:50:17,Portugalete,expenses,leisure,-76.15,-11168.1
buyer_7,María,Valdec,1968-12-31,54502279F,maría.valdec@awesomecloud.com,031005,ES72209544951851809297,6307.96,2022-09-23T20:07:44,Portugalete,expenses,gifts,-253.78,-11421.88
buyer_7,María,Valdec,1968-12-31,54502279F,maría.valdec@awesomecloud.com,031005,ES72209544951851809297,6307.96,2022-09-23T22:15:34,Portugalete,expenses,children,-50.284833333333296,-11472.16
buyer_7,María,Valdec,1968-12-31,54502279F,maría.valdec@awesomecloud.com,031005,ES72209544951851809297,6307.96,2022-09-24T11:04:36,Portugalete,expenses,food,-75.82,-11547.98
buyer_7,María,Valdec,1968-12-31,54502279F,maría.valdec@awesomecloud.com,031005,ES72209544951851809297,6307.96,2022-09-25T17:15:44,Portugalete,expenses,healthcare,-157.88,-11705.86
buyer_7,María,Valdec,1968-12-31,54502279F,maría.valdec@awesomecloud.com,031005,ES72209544951851809297,6307.96,2022-09-26T13:59:18,Portugalete,expenses,food,-61.15,-11767.01
buyer_7,María,Valdec,1968-12-31,54502279F,maría.valdec@awesomecloud.com,031005,ES72209544951851809297,6307.96,2022-09-27T18:59:05,Portugalete,expenses,food,-76.3,-11843.31
buyer_7,María,Valdec,1968-12-31,54502279F,maría.valdec@awesomecloud.com,031005,ES72209544951851809297,6307.96,2022-09-27T08:48:51,Portugalete,expenses,transport,-44.11,-11887.42
buyer_7,María,Valdec,1968-12-31,54502279F,maría.valdec@awesomecloud.com,031005,ES72209544951851809297,6307.96,2022-09-30T13:22:49,Portugalete,expenses,clothing,-156.99,-12044.41
buyer_7,María,Valdec,1968-12-31,54502279F,maría.valdec@awesomecloud.com,031005,ES72209544951851809297,6307.96,2022-09-30T13:11:12,Portugalete,expenses,appliances,-82.18,-12126.59
buyer_7,María,Valdec,1968-12-31,54502279F,maría.valdec@awesomecloud.com,031005,ES72209544951851809297,6307.96,2022-10-01T11:05:26,Portugalete,incomes,salary,1502.17,-10624.42
buyer_7,María,Valdec,1968-12-31,54502279F,maría.valdec@awesomecloud.com,031005,ES72209544951851809297,6307.96,2022-10-02T08:14:53,Portugalete,expenses,clothing,-118.3,-10742.72
buyer_7,María,Valdec,1968-12-31,54502279F,maría.valdec@awesomecloud.com,031005,ES72209544951851809297,6307.96,2022-10-02T12:06:33,Portugalete,expenses,travel,-232.49,-10975.21
buyer_7,María,Valdec,1968-12-31,54502279F,maría.valdec@awesomecloud.com,031005,ES72209544951851809297,6307.96,2022-10-03T17:56:52,Portugalete,expenses,transport,-50.64,-11025.85
buyer_7,María,Valdec,1968-12-31,54502279F,maría.valdec@awesomecloud.com,031005,ES72209544951851809297,6307.96,2022-10-04T18:19:33,Portugalete,expenses,mortgage,-748.36,-11774.21
buyer_7,María,Valdec,1968-12-31,54502279F,maría.valdec@awesomecloud.com,031005,ES72209544951851809297,6307.96,2022-10-04T04:42:01,Portugalete,expenses,leisure,-40.88,-11815.09
buyer_7,María,Valdec,1968-12-31,54502279F,maría.valdec@awesomecloud.com,031005,ES72209544951851809297,6307.96,2022-10-04T22:29:12,Portugalete,expenses,healthcare,-69.67,-11884.76
buyer_7,María,Valdec,1968-12-31,54502279F,maría.valdec@awesomecloud.com,031005,ES72209544951851809297,6307.96,2022-10-05T11:24:44,Portugalete,expenses,water,-29.22,-11913.98
buyer_7,María,Valdec,1968-12-31,54502279F,maría.valdec@awesomecloud.com,031005,ES72209544951851809297,6307.96,2022-10-05T14:46:41,Portugalete,expenses,electricity,-34.71,-11948.69
buyer_7,María,Valdec,1968-12-31,54502279F,maría.valdec@awesomecloud.com,031005,ES72209544951851809297,6307.96,2022-10-05T07:28:15,Portugalete,expenses,gas,-48.15,-11996.84
buyer_7,María,Valdec,1968-12-31,54502279F,maría.valdec@awesomecloud.com,031005,ES72209544951851809297,6307.96,2022-10-06T18:19:27,Portugalete,expenses,internet,-31.55,-12028.39
buyer_7,María,Valdec,1968-12-31,54502279F,maría.valdec@awesomecloud.com,031005,ES72209544951851809297,6307.96,2022-10-06T18:07:44,Portugalete,expenses,phone,-29.94,-12058.33
buyer_7,María,Valdec,1968-12-31,54502279F,maría.valdec@awesomecloud.com,031005,ES72209544951851809297,6307.96,2022-10-06T08:07:42,Portugalete,expenses,repairs,-189.95,-12248.28
buyer_7,María,Valdec,1968-12-31,54502279F,maría.valdec@awesomecloud.com,031005,ES72209544951851809297,6307.96,2022-10-07T10:38:01,Portugalete,expenses,transport,-71.05,-12319.33
buyer_7,María,Valdec,1968-12-31,54502279F,maría.valdec@awesomecloud.com,031005,ES72209544951851809297,6307.96,2022-10-08T20:11:56,Portugalete,expenses,repairs,-211.45,-12530.78
buyer_7,María,Valdec,1968-12-31,54502279F,maría.valdec@awesomecloud.com,031005,ES72209544951851809297,6307.96,2022-10-09T09:01:21,Portugalete,expenses,food,-103.22,-12634.0
buyer_7,María,Valdec,1968-12-31,54502279F,maría.valdec@awesomecloud.com,031005,ES72209544951851809297,6307.96,2022-10-13T09:32:21,Portugalete,expenses,cash,-100.0,-12734.0
buyer_7,María,Valdec,1968-12-31,54502279F,maría.valdec@awesomecloud.com,031005,ES72209544951851809297,6307.96,2022-10-14T23:50:58,Portugalete,expenses,transport,-50.33,-12784.33
buyer_7,María,Valdec,1968-12-31,54502279F,maría.valdec@awesomecloud.com,031005,ES72209544951851809297,6307.96,2022-10-17T13:18:19,Portugalete,expenses,food,-72.33,-12856.66
buyer_7,María,Valdec,1968-12-31,54502279F,maría.valdec@awesomecloud.com,031005,ES72209544951851809297,6307.96,2022-10-17T15:55:47,Portugalete,expenses,clothing,-76.37,-12933.03
buyer_7,María,Valdec,1968-12-31,54502279F,maría.valdec@awesomecloud.com,031005,ES72209544951851809297,6307.96,2022-10-18T12:31:39,Portugalete,expenses,leisure,-78.96,-13011.99
buyer_7,María,Valdec,1968-12-31,54502279F,maría.valdec@awesomecloud.com,031005,ES72209544951851809297,6307.96,2022-10-20T18:16:11,Portugalete,expenses,food,-78.13,-13090.12
buyer_7,María,Valdec,1968-12-31,54502279F,maría.valdec@awesomecloud.com,031005,ES72209544951851809297,6307.96,2022-10-24T09:58:07,Portugalete,expenses,leisure,-32.22,-13122.34
buyer_7,María,Valdec,1968-12-31,54502279F,maría.valdec@awesomecloud.com,031005,ES72209544951851809297,6307.96,2022-10-24T00:27:14,Portugalete,expenses,cash,-100.0,-13222.34
buyer_7,María,Valdec,1968-12-31,54502279F,maría.valdec@awesomecloud.com,031005,ES72209544951851809297,6307.96,2022-10-25T04:21:30,Portugalete,expenses,cash,-100.0,-13322.34
buyer_7,María,Valdec,1968-12-31,54502279F,maría.valdec@awesomecloud.com,031005,ES72209544951851809297,6307.96,2022-10-29T11:18:34,Portugalete,expenses,children,-73.58,-13395.92
buyer_7,María,Valdec,1968-12-31,54502279F,maría.valdec@awesomecloud.com,031005,ES72209544951851809297,6307.96,2022-10-30T20:37:08,Portugalete,expenses,healthcare,-107.64,-13503.56
buyer_7,María,Valdec,1968-12-31,54502279F,maría.valdec@awesomecloud.com,031005,ES72209544951851809297,6307.96,2022-10-31T11:15:45,Portugalete,expenses,transport,-76.7,-13580.26
buyer_7,María,Valdec,1968-12-31,54502279F,maría.valdec@awesomecloud.com,031005,ES72209544951851809297,6307.96,2022-11-01T09:26:55,Portugalete,incomes,salary,1502.17,-12078.09
buyer_7,María,Valdec,1968-12-31,54502279F,maría.valdec@awesomecloud.com,031005,ES72209544951851809297,6307.96,2022-11-01T09:26:55,Portugalete,incomes,extra_income,219.04,-11859.05
buyer_7,María,Valdec,1968-12-31,54502279F,maría.valdec@awesomecloud.com,031005,ES72209544951851809297,6307.96,2022-11-01T08:37:48,Portugalete,expenses,transport,-41.53,-11900.58
buyer_7,María,Valdec,1968-12-31,54502279F,maría.valdec@awesomecloud.com,031005,ES72209544951851809297,6307.96,2022-11-02T09:46:56,Portugalete,expenses,food,-122.1,-12022.68
buyer_7,María,Valdec,1968-12-31,54502279F,maría.valdec@awesomecloud.com,031005,ES72209544951851809297,6307.96,2022-11-03T20:54:59,Portugalete,expenses,food,-92.01,-12114.69
buyer_7,María,Valdec,1968-12-31,54502279F,maría.valdec@awesomecloud.com,031005,ES72209544951851809297,6307.96,2022-11-03T11:27:08,Portugalete,expenses,leisure,-35.28,-12149.97
buyer_7,María,Valdec,1968-12-31,54502279F,maría.valdec@awesomecloud.com,031005,ES72209544951851809297,6307.96,2022-11-03T14:06:53,Portugalete,expenses,cash,-100.0,-12249.97
buyer_7,María,Valdec,1968-12-31,54502279F,maría.valdec@awesomecloud.com,031005,ES72209544951851809297,6307.96,2022-11-03T15:12:04,Portugalete,expenses,gifts,-74.59,-12324.56
buyer_7,María,Valdec,1968-12-31,54502279F,maría.valdec@awesomecloud.com,031005,ES72209544951851809297,6307.96,2022-11-04T09:21:59,Portugalete,expenses,mortgage,-748.36,-13072.92
buyer_7,María,Valdec,1968-12-31,54502279F,maría.valdec@awesomecloud.com,031005,ES72209544951851809297,6307.96,2022-11-05T19:52:51,Portugalete,expenses,gas,-70.04,-13142.96
buyer_7,María,Valdec,1968-12-31,54502279F,maría.valdec@awesomecloud.com,031005,ES72209544951851809297,6307.96,2022-11-05T14:43:07,Portugalete,expenses,repairs,-207.06,-13350.02
buyer_7,María,Valdec,1968-12-31,54502279F,maría.valdec@awesomecloud.com,031005,ES72209544951851809297,6307.96,2022-11-05T10:57:38,Portugalete,expenses,gifts,-27.54,-13377.56
buyer_7,María,Valdec,1968-12-31,54502279F,maría.valdec@awesomecloud.com,031005,ES72209544951851809297,6307.96,2022-11-06T18:08:29,Portugalete,expenses,gas,-74.86,-13452.42
buyer_7,María,Valdec,1968-12-31,54502279F,maría.valdec@awesomecloud.com,031005,ES72209544951851809297,6307.96,2022-11-07T16:29:52,Portugalete,expenses,internet,-31.55,-13483.97
buyer_7,María,Valdec,1968-12-31,54502279F,maría.valdec@awesomecloud.com,031005,ES72209544951851809297,6307.96,2022-11-07T11:28:26,Portugalete,expenses,food,-66.24,-13550.21
buyer_7,María,Valdec,1968-12-31,54502279F,maría.valdec@awesomecloud.com,031005,ES72209544951851809297,6307.96,2022-11-07T16:04:44,Portugalete,expenses,clothing,-46.13,-13596.34
buyer_7,María,Valdec,1968-12-31,54502279F,maría.valdec@awesomecloud.com,031005,ES72209544951851809297,6307.96,2022-11-08T16:54:04,Portugalete,expenses,water,-17.38,-13613.72
buyer_7,María,Valdec,1968-12-31,54502279F,maría.valdec@awesomecloud.com,031005,ES72209544951851809297,6307.96,2022-11-08T09:51:09,Portugalete,expenses,electricity,-16.77,-13630.49
buyer_7,María,Valdec,1968-12-31,54502279F,maría.valdec@awesomecloud.com,031005,ES72209544951851809297,6307.96,2022-11-09T20:07:22,Portugalete,expenses,gifts,-205.15,-13835.64
buyer_7,María,Valdec,1968-12-31,54502279F,maría.valdec@awesomecloud.com,031005,ES72209544951851809297,6307.96,2022-11-10T18:10:54,Portugalete,expenses,children,-304.0648333333333,-14139.7
buyer_7,María,Valdec,1968-12-31,54502279F,maría.valdec@awesomecloud.com,031005,ES72209544951851809297,6307.96,2022-11-13T17:20:53,Portugalete,expenses,transport,-69.85,-14209.55
buyer_7,María,Valdec,1968-12-31,54502279F,maría.valdec@awesomecloud.com,031005,ES72209544951851809297,6307.96,2022-11-13T16:45:57,Portugalete,expenses,repairs,-146.25,-14355.8
buyer_7,María,Valdec,1968-12-31,54502279F,maría.valdec@awesomecloud.com,031005,ES72209544951851809297,6307.96,2022-11-14T20:19:09,Portugalete,expenses,food,-77.4,-14433.2
buyer_7,María,Valdec,1968-12-31,54502279F,maría.valdec@awesomecloud.com,031005,ES72209544951851809297,6307.96,2022-11-14T11:59:34,Portugalete,expenses,transport,-82.53,-14515.73
buyer_7,María,Valdec,1968-12-31,54502279F,maría.valdec@awesomecloud.com,031005,ES72209544951851809297,6307.96,2022-11-14T22:28:53,Portugalete,expenses,clothing,-70.78,-14586.51
buyer_7,María,Valdec,1968-12-31,54502279F,maría.valdec@awesomecloud.com,031005,ES72209544951851809297,6307.96,2022-11-14T16:39:28,Portugalete,expenses,children,-73.35483333333329,-14659.86
buyer_7,María,Valdec,1968-12-31,54502279F,maría.valdec@awesomecloud.com,031005,ES72209544951851809297,6307.96,2022-11-16T08:05:58,Portugalete,expenses,food,-116.04,-14775.9
buyer_7,María,Valdec,1968-12-31,54502279F,maría.valdec@awesomecloud.com,031005,ES72209544951851809297,6307.96,2022-11-18T13:23:44,Portugalete,expenses,transport,-67.07,-14842.97
buyer_7,María,Valdec,1968-12-31,54502279F,maría.valdec@awesomecloud.com,031005,ES72209544951851809297,6307.96,2022-11-20T23:46:19,Portugalete,expenses,transport,-42.57,-14885.54
buyer_7,María,Valdec,1968-12-31,54502279F,maría.valdec@awesomecloud.com,031005,ES72209544951851809297,6307.96,2022-11-21T20:39:45,Portugalete,expenses,gifts,-151.88,-15037.42
buyer_7,María,Valdec,1968-12-31,54502279F,maría.valdec@awesomecloud.com,031005,ES72209544951851809297,6307.96,2022-11-22T18:39:26,Portugalete,expenses,food,-67.53,-15104.95
buyer_7,María,Valdec,1968-12-31,54502279F,maría.valdec@awesomecloud.com,031005,ES72209544951851809297,6307.96,2022-11-22T14:18:31,Portugalete,expenses,clothing,-135.42,-15240.37
buyer_7,María,Valdec,1968-12-31,54502279F,maría.valdec@awesomecloud.com,031005,ES72209544951851809297,6307.96,2022-11-23T11:20:18,Portugalete,expenses,leisure,-46.57,-15286.94
buyer_7,María,Valdec,1968-12-31,54502279F,maría.valdec@awesomecloud.com,031005,ES72209544951851809297,6307.96,2022-11-23T14:17:00,Portugalete,expenses,cash,-100.0,-15386.94
buyer_7,María,Valdec,1968-12-31,54502279F,maría.valdec@awesomecloud.com,031005,ES72209544951851809297,6307.96,2022-11-24T11:03:45,Portugalete,expenses,appliances,-265.38,-15652.32
buyer_7,María,Valdec,1968-12-31,54502279F,maría.valdec@awesomecloud.com,031005,ES72209544951851809297,6307.96,2022-11-25T10:24:18,Portugalete,expenses,transport,-61.42,-15713.74
buyer_7,María,Valdec,1968-12-31,54502279F,maría.valdec@awesomecloud.com,031005,ES72209544951851809297,6307.96,2022-11-25T13:13:07,Portugalete,expenses,cash,-100.0,-15813.74
buyer_7,María,Valdec,1968-12-31,54502279F,maría.valdec@awesomecloud.com,031005,ES72209544951851809297,6307.96,2022-11-26T23:06:30,Portugalete,expenses,gifts,-50.8,-15864.54
buyer_7,María,Valdec,1968-12-31,54502279F,maría.valdec@awesomecloud.com,031005,ES72209544951851809297,6307.96,2022-11-27T21:22:04,Portugalete,expenses,leisure,-44.36,-15908.9
buyer_7,María,Valdec,1968-12-31,54502279F,maría.valdec@awesomecloud.com,031005,ES72209544951851809297,6307.96,2022-11-28T15:05:54,Portugalete,expenses,cash,-100.0,-16008.9
buyer_7,María,Valdec,1968-12-31,54502279F,maría.valdec@awesomecloud.com,031005,ES72209544951851809297,6307.96,2022-11-29T13:04:17,Portugalete,expenses,leisure,-75.59,-16084.49
buyer_7,María,Valdec,1968-12-31,54502279F,maría.valdec@awesomecloud.com,031005,ES72209544951851809297,6307.96,2022-11-29T13:34:05,Portugalete,expenses,cash,-100.0,-16184.49
buyer_7,María,Valdec,1968-12-31,54502279F,maría.valdec@awesomecloud.com,031005,ES72209544951851809297,6307.96,2022-12-01T17:55:10,Portugalete,incomes,salary,1502.17,-14682.32
buyer_7,María,Valdec,1968-12-31,54502279F,maría.valdec@awesomecloud.com,031005,ES72209544951851809297,6307.96,2022-12-01T17:55:10,Portugalete,incomes,salary_bonus,1192.39,-13489.93
buyer_7,María,Valdec,1968-12-31,54502279F,maría.valdec@awesomecloud.com,031005,ES72209544951851809297,6307.96,2022-12-01T09:53:14,Portugalete,expenses,leisure,-79.32,-13569.25
buyer_7,María,Valdec,1968-12-31,54502279F,maría.valdec@awesomecloud.com,031005,ES72209544951851809297,6307.96,2022-12-02T19:25:20,Portugalete,expenses,children,-79.72,-13648.97
buyer_7,María,Valdec,1968-12-31,54502279F,maría.valdec@awesomecloud.com,031005,ES72209544951851809297,6307.96,2022-12-03T12:21:33,Portugalete,expenses,clothing,-98.1,-13747.07
buyer_7,María,Valdec,1968-12-31,54502279F,maría.valdec@awesomecloud.com,031005,ES72209544951851809297,6307.96,2022-12-03T10:40:19,Portugalete,expenses,cash,-100.0,-13847.07
buyer_7,María,Valdec,1968-12-31,54502279F,maría.valdec@awesomecloud.com,031005,ES72209544951851809297,6307.96,2022-12-04T08:27:10,Portugalete,expenses,mortgage,-748.36,-14595.43
buyer_7,María,Valdec,1968-12-31,54502279F,maría.valdec@awesomecloud.com,031005,ES72209544951851809297,6307.96,2022-12-05T21:16:21,Portugalete,expenses,electricity,-22.15,-14617.58
buyer_7,María,Valdec,1968-12-31,54502279F,maría.valdec@awesomecloud.com,031005,ES72209544951851809297,6307.96,2022-12-06T08:28:31,Portugalete,expenses,water,-24.11,-14641.69
buyer_7,María,Valdec,1968-12-31,54502279F,maría.valdec@awesomecloud.com,031005,ES72209544951851809297,6307.96,2022-12-06T17:34:11,Portugalete,expenses,gas,-45.43,-14687.12
buyer_7,María,Valdec,1968-12-31,54502279F,maría.valdec@awesomecloud.com,031005,ES72209544951851809297,6307.96,2022-12-07T19:42:34,Portugalete,expenses,education,-44.93,-14732.05
buyer_7,María,Valdec,1968-12-31,54502279F,maría.valdec@awesomecloud.com,031005,ES72209544951851809297,6307.96,2022-12-07T11:03:11,Portugalete,expenses,cash,-100.0,-14832.05
buyer_7,María,Valdec,1968-12-31,54502279F,maría.valdec@awesomecloud.com,031005,ES72209544951851809297,6307.96,2022-12-08T08:56:53,Portugalete,expenses,gas,-51.32,-14883.37
buyer_7,María,Valdec,1968-12-31,54502279F,maría.valdec@awesomecloud.com,031005,ES72209544951851809297,6307.96,2022-12-08T22:28:22,Portugalete,expenses,gifts,-163.33,-15046.7
buyer_7,María,Valdec,1968-12-31,54502279F,maría.valdec@awesomecloud.com,031005,ES72209544951851809297,6307.96,2022-12-09T15:17:15,Portugalete,expenses,food,-122.91,-15169.61
buyer_7,María,Valdec,1968-12-31,54502279F,maría.valdec@awesomecloud.com,031005,ES72209544951851809297,6307.96,2022-12-10T02:04:25,Portugalete,expenses,transport,-62.25,-15231.86
buyer_7,María,Valdec,1968-12-31,54502279F,maría.valdec@awesomecloud.com,031005,ES72209544951851809297,6307.96,2022-12-11T19:35:34,Portugalete,expenses,children,-304.0648333333333,-15535.92
buyer_7,María,Valdec,1968-12-31,54502279F,maría.valdec@awesomecloud.com,031005,ES72209544951851809297,6307.96,2022-12-12T00:16:45,Portugalete,expenses,transport,-66.09,-15602.01
buyer_7,María,Valdec,1968-12-31,54502279F,maría.valdec@awesomecloud.com,031005,ES72209544951851809297,6307.96,2022-12-15T14:40:48,Portugalete,expenses,transport,-55.92,-15657.93
buyer_7,María,Valdec,1968-12-31,54502279F,maría.valdec@awesomecloud.com,031005,ES72209544951851809297,6307.96,2022-12-18T17:17:02,Portugalete,expenses,transport,-47.61,-15705.54
buyer_7,María,Valdec,1968-12-31,54502279F,maría.valdec@awesomecloud.com,031005,ES72209544951851809297,6307.96,2022-12-18T11:10:26,Portugalete,expenses,education,-61.11,-15766.65
buyer_7,María,Valdec,1968-12-31,54502279F,maría.valdec@awesomecloud.com,031005,ES72209544951851809297,6307.96,2022-12-20T16:09:28,Portugalete,expenses,food,-110.8,-15877.45
buyer_7,María,Valdec,1968-12-31,54502279F,maría.valdec@awesomecloud.com,031005,ES72209544951851809297,6307.96,2022-12-24T12:19:31,Portugalete,expenses,cash,-100.0,-15977.45
buyer_7,María,Valdec,1968-12-31,54502279F,maría.valdec@awesomecloud.com,031005,ES72209544951851809297,6307.96,2022-12-26T09:15:28,Portugalete,expenses,transport,-47.96,-16025.41
buyer_7,María,Valdec,1968-12-31,54502279F,maría.valdec@awesomecloud.com,031005,ES72209544951851809297,6307.96,2022-12-26T22:13:31,Portugalete,expenses,leisure,-78.53,-16103.94
buyer_7,María,Valdec,1968-12-31,54502279F,maría.valdec@awesomecloud.com,031005,ES72209544951851809297,6307.96,2022-12-27T12:37:45,Portugalete,expenses,leisure,-18.65,-16122.59
buyer_7,María,Valdec,1968-12-31,54502279F,maría.valdec@awesomecloud.com,031005,ES72209544951851809297,6307.96,2022-12-28T13:57:04,Portugalete,expenses,cash,-100.0,-16222.59
buyer_7,María,Valdec,1968-12-31,54502279F,maría.valdec@awesomecloud.com,031005,ES72209544951851809297,6307.96,2022-12-30T13:50:46,Portugalete,expenses,gifts,-57.54,-16280.13
buyer_7,María,Valdec,1968-12-31,54502279F,maría.valdec@awesomecloud.com,031005,ES72209544951851809297,6307.96,2022-12-31T14:46:36,Portugalete,expenses,food,-117.62,-16397.75
buyer_7,María,Valdec,1968-12-31,54502279F,maría.valdec@awesomecloud.com,031005,ES72209544951851809297,6307.96,2022-12-31T10:26:13,Portugalete,expenses,transport,-80.23,-16477.98
buyer_7,María,Valdec,1968-12-31,54502279F,maría.valdec@awesomecloud.com,031005,ES72209544951851809297,6307.96,2022-12-31T16:21:07,Portugalete,expenses,cash,-100.0,-16577.98
buyer_7,María,Valdec,1968-12-31,54502279F,maría.valdec@awesomecloud.com,031005,ES72209544951851809297,6307.96,2023-01-01T08:48:45,Portugalete,incomes,salary,1561.25,-15016.73
buyer_7,María,Valdec,1968-12-31,54502279F,maría.valdec@awesomecloud.com,031005,ES72209544951851809297,6307.96,2023-01-01T19:19:48,Portugalete,expenses,food,-63.06,-15079.79
buyer_7,María,Valdec,1968-12-31,54502279F,maría.valdec@awesomecloud.com,031005,ES72209544951851809297,6307.96,2023-01-02T08:48:11,Portugalete,expenses,food,-79.68,-15159.47
buyer_7,María,Valdec,1968-12-31,54502279F,maría.valdec@awesomecloud.com,031005,ES72209544951851809297,6307.96,2023-01-03T15:56:28,Portugalete,expenses,children,-278.54,-15438.01
buyer_7,María,Valdec,1968-12-31,54502279F,maría.valdec@awesomecloud.com,031005,ES72209544951851809297,6307.96,2023-01-04T14:57:46,Portugalete,expenses,mortgage,-835.54,-16273.55
buyer_7,María,Valdec,1968-12-31,54502279F,maría.valdec@awesomecloud.com,031005,ES72209544951851809297,6307.96,2023-01-04T04:13:08,Portugalete,expenses,leisure,-76.11,-16349.66
buyer_7,María,Valdec,1968-12-31,54502279F,maría.valdec@awesomecloud.com,031005,ES72209544951851809297,6307.96,2023-01-04T19:59:42,Portugalete,expenses,travel,-268.97,-16618.63
buyer_7,María,Valdec,1968-12-31,54502279F,maría.valdec@awesomecloud.com,031005,ES72209544951851809297,6307.96,2023-01-06T20:22:37,Portugalete,expenses,gas,-79.7,-16698.33
buyer_7,María,Valdec,1968-12-31,54502279F,maría.valdec@awesomecloud.com,031005,ES72209544951851809297,6307.96,2023-01-06T15:42:42,Portugalete,expenses,cash,-100.0,-16798.33
buyer_7,María,Valdec,1968-12-31,54502279F,maría.valdec@awesomecloud.com,031005,ES72209544951851809297,6307.96,2023-01-07T14:03:27,Portugalete,expenses,gas,-56.95,-16855.28
buyer_7,María,Valdec,1968-12-31,54502279F,maría.valdec@awesomecloud.com,031005,ES72209544951851809297,6307.96,2023-01-07T22:45:11,Portugalete,expenses,food,-112.1,-16967.38
buyer_7,María,Valdec,1968-12-31,54502279F,maría.valdec@awesomecloud.com,031005,ES72209544951851809297,6307.96,2023-01-07T15:57:33,Portugalete,expenses,repairs,-55.03,-17022.41
buyer_7,María,Valdec,1968-12-31,54502279F,maría.valdec@awesomecloud.com,031005,ES72209544951851809297,6307.96,2023-01-07T08:31:11,Portugalete,expenses,gifts,-88.39,-17110.8
buyer_7,María,Valdec,1968-12-31,54502279F,maría.valdec@awesomecloud.com,031005,ES72209544951851809297,6307.96,2023-01-08T12:16:46,Portugalete,expenses,leisure,-32.04,-17142.84
buyer_7,María,Valdec,1968-12-31,54502279F,maría.valdec@awesomecloud.com,031005,ES72209544951851809297,6307.96,2023-01-09T21:33:10,Portugalete,expenses,food,-77.89,-17220.73
buyer_7,María,Valdec,1968-12-31,54502279F,maría.valdec@awesomecloud.com,031005,ES72209544951851809297,6307.96,2023-01-10T23:33:14,Portugalete,expenses,food,-115.04,-17335.77
buyer_7,María,Valdec,1968-12-31,54502279F,maría.valdec@awesomecloud.com,031005,ES72209544951851809297,6307.96,2023-01-12T19:01:28,Portugalete,expenses,cash,-100.0,-17435.77
buyer_7,María,Valdec,1968-12-31,54502279F,maría.valdec@awesomecloud.com,031005,ES72209544951851809297,6307.96,2023-01-14T15:20:21,Portugalete,expenses,food,-110.5,-17546.27
buyer_7,María,Valdec,1968-12-31,54502279F,maría.valdec@awesomecloud.com,031005,ES72209544951851809297,6307.96,2023-01-14T21:09:04,Portugalete,expenses,cash,-100.0,-17646.27
buyer_7,María,Valdec,1968-12-31,54502279F,maría.valdec@awesomecloud.com,031005,ES72209544951851809297,6307.96,2023-01-15T14:17:51,Portugalete,expenses,gifts,-129.2,-17775.47
buyer_7,María,Valdec,1968-12-31,54502279F,maría.valdec@awesomecloud.com,031005,ES72209544951851809297,6307.96,2023-01-17T17:02:07,Portugalete,expenses,cash,-100.0,-17875.47
buyer_7,María,Valdec,1968-12-31,54502279F,maría.valdec@awesomecloud.com,031005,ES72209544951851809297,6307.96,2023-01-18T17:18:48,Portugalete,expenses,food,-108.18,-17983.65
buyer_7,María,Valdec,1968-12-31,54502279F,maría.valdec@awesomecloud.com,031005,ES72209544951851809297,6307.96,2023-01-19T07:45:03,Portugalete,expenses,leisure,-46.8,-18030.45
buyer_7,María,Valdec,1968-12-31,54502279F,maría.valdec@awesomecloud.com,031005,ES72209544951851809297,6307.96,2023-01-20T14:32:22,Portugalete,expenses,leisure,-55.2,-18085.65
buyer_7,María,Valdec,1968-12-31,54502279F,maría.valdec@awesomecloud.com,031005,ES72209544951851809297,6307.96,2023-01-20T17:26:22,Portugalete,expenses,education,-53.01,-18138.66
buyer_7,María,Valdec,1968-12-31,54502279F,maría.valdec@awesomecloud.com,031005,ES72209544951851809297,6307.96,2023-01-21T22:06:38,Portugalete,expenses,leisure,-78.19,-18216.85
buyer_7,María,Valdec,1968-12-31,54502279F,maría.valdec@awesomecloud.com,031005,ES72209544951851809297,6307.96,2023-01-23T08:00:45,Portugalete,expenses,healthcare,-169.55,-18386.4
buyer_7,María,Valdec,1968-12-31,54502279F,maría.valdec@awesomecloud.com,031005,ES72209544951851809297,6307.96,2023-01-24T09:51:22,Portugalete,expenses,cash,-100.0,-18486.4
buyer_7,María,Valdec,1968-12-31,54502279F,maría.valdec@awesomecloud.com,031005,ES72209544951851809297,6307.96,2023-01-26T13:41:12,Portugalete,expenses,clothing,-97.8,-18584.2
buyer_7,María,Valdec,1968-12-31,54502279F,maría.valdec@awesomecloud.com,031005,ES72209544951851809297,6307.96,2023-01-27T20:21:40,Portugalete,expenses,gifts,-247.49,-18831.69
buyer_7,María,Valdec,1968-12-31,54502279F,maría.valdec@awesomecloud.com,031005,ES72209544951851809297,6307.96,2023-01-28T19:20:03,Portugalete,expenses,transport,-80.33,-18912.02
buyer_7,María,Valdec,1968-12-31,54502279F,maría.valdec@awesomecloud.com,031005,ES72209544951851809297,6307.96,2023-01-28T16:27:23,Portugalete,expenses,repairs,-40.16,-18952.18
buyer_7,María,Valdec,1968-12-31,54502279F,maría.valdec@awesomecloud.com,031005,ES72209544951851809297,6307.96,2023-01-28T20:58:16,Portugalete,expenses,children,-189.49,-19141.67
buyer_7,María,Valdec,1968-12-31,54502279F,maría.valdec@awesomecloud.com,031005,ES72209544951851809297,6307.96,2023-01-29T16:21:25,Portugalete,expenses,transport,-61.93,-19203.6
buyer_7,María,Valdec,1968-12-31,54502279F,maría.valdec@awesomecloud.com,031005,ES72209544951851809297,6307.96,2023-01-29T22:43:35,Portugalete,expenses,cash,-100.0,-19303.6
buyer_7,María,Valdec,1968-12-31,54502279F,maría.valdec@awesomecloud.com,031005,ES72209544951851809297,6307.96,2023-01-30T23:10:41,Portugalete,expenses,appliances,-239.84,-19543.44
buyer_7,María,Valdec,1968-12-31,54502279F,maría.valdec@awesomecloud.com,031005,ES72209544951851809297,6307.96,2023-01-30T18:49:37,Portugalete,expenses,gifts,-31.09,-19574.53
buyer_7,María,Valdec,1968-12-31,54502279F,maría.valdec@awesomecloud.com,031005,ES72209544951851809297,6307.96,2023-02-01T23:24:13,Portugalete,incomes,salary,1561.25,-18013.28
buyer_7,María,Valdec,1968-12-31,54502279F,maría.valdec@awesomecloud.com,031005,ES72209544951851809297,6307.96,2023-02-01T03:24:53,Portugalete,expenses,cash,-100.0,-18113.28
buyer_7,María,Valdec,1968-12-31,54502279F,maría.valdec@awesomecloud.com,031005,ES72209544951851809297,6307.96,2023-02-02T19:29:06,Portugalete,expenses,cash,-100.0,-18213.28
buyer_7,María,Valdec,1968-12-31,54502279F,maría.valdec@awesomecloud.com,031005,ES72209544951851809297,6307.96,2023-02-02T13:58:34,Portugalete,expenses,repairs,-196.06,-18409.34
buyer_7,María,Valdec,1968-12-31,54502279F,maría.valdec@awesomecloud.com,031005,ES72209544951851809297,6307.96,2023-02-03T12:34:53,Portugalete,expenses,transport,-65.63,-18474.97
buyer_7,María,Valdec,1968-12-31,54502279F,maría.valdec@awesomecloud.com,031005,ES72209544951851809297,6307.96,2023-02-03T08:04:42,Portugalete,expenses,clothing,-107.41,-18582.38
buyer_7,María,Valdec,1968-12-31,54502279F,maría.valdec@awesomecloud.com,031005,ES72209544951851809297,6307.96,2023-02-04T04:37:07,Portugalete,expenses,mortgage,-835.54,-19417.92
buyer_7,María,Valdec,1968-12-31,54502279F,maría.valdec@awesomecloud.com,031005,ES72209544951851809297,6307.96,2023-02-04T08:33:06,Portugalete,expenses,food,-89.63,-19507.55
buyer_7,María,Valdec,1968-12-31,54502279F,maría.valdec@awesomecloud.com,031005,ES72209544951851809297,6307.96,2023-02-04T20:07:04,Portugalete,expenses,clothing,-122.29,-19629.84
buyer_7,María,Valdec,1968-12-31,54502279F,maría.valdec@awesomecloud.com,031005,ES72209544951851809297,6307.96,2023-02-05T09:39:19,Portugalete,expenses,electricity,-46.86,-19676.7
buyer_7,María,Valdec,1968-12-31,54502279F,maría.valdec@awesomecloud.com,031005,ES72209544951851809297,6307.96,2023-02-05T00:20:18,Portugalete,expenses,phone,-34.08,-19710.78
buyer_7,María,Valdec,1968-12-31,54502279F,maría.valdec@awesomecloud.com,031005,ES72209544951851809297,6307.96,2023-02-05T19:32:06,Portugalete,expenses,repairs,-67.78,-19778.56
buyer_7,María,Valdec,1968-12-31,54502279F,maría.valdec@awesomecloud.com,031005,ES72209544951851809297,6307.96,2023-02-06T09:26:05,Portugalete,expenses,cash,-100.0,-19878.56
buyer_7,María,Valdec,1968-12-31,54502279F,maría.valdec@awesomecloud.com,031005,ES72209544951851809297,6307.96,2023-02-07T12:14:53,Portugalete,expenses,transport,-50.54,-19929.1
buyer_7,María,Valdec,1968-12-31,54502279F,maría.valdec@awesomecloud.com,031005,ES72209544951851809297,6307.96,2023-02-08T20:37:14,Portugalete,expenses,electricity,-18.39,-19947.49
buyer_7,María,Valdec,1968-12-31,54502279F,maría.valdec@awesomecloud.com,031005,ES72209544951851809297,6307.96,2023-02-08T12:26:18,Portugalete,expenses,phone,-31.7,-19979.19
buyer_7,María,Valdec,1968-12-31,54502279F,maría.valdec@awesomecloud.com,031005,ES72209544951851809297,6307.96,2023-02-08T17:14:52,Portugalete,expenses,cash,-100.0,-20079.19
buyer_7,María,Valdec,1968-12-31,54502279F,maría.valdec@awesomecloud.com,031005,ES72209544951851809297,6307.96,2023-02-08T17:21:48,Portugalete,expenses,children,-215.07,-20294.26
buyer_7,María,Valdec,1968-12-31,54502279F,maría.valdec@awesomecloud.com,031005,ES72209544951851809297,6307.96,2023-02-10T19:41:34,Portugalete,expenses,repairs,-267.21,-20561.47
buyer_7,María,Valdec,1968-12-31,54502279F,maría.valdec@awesomecloud.com,031005,ES72209544951851809297,6307.96,2023-02-11T17:38:03,Portugalete,expenses,appliances,-151.42,-20712.89
buyer_7,María,Valdec,1968-12-31,54502279F,maría.valdec@awesomecloud.com,031005,ES72209544951851809297,6307.96,2023-02-12T15:33:00,Portugalete,expenses,cash,-100.0,-20812.89
buyer_7,María,Valdec,1968-12-31,54502279F,maría.valdec@awesomecloud.com,031005,ES72209544951851809297,6307.96,2023-02-12T09:43:17,Portugalete,expenses,repairs,-203.86,-21016.75
buyer_7,María,Valdec,1968-12-31,54502279F,maría.valdec@awesomecloud.com,031005,ES72209544951851809297,6307.96,2023-02-12T16:21:41,Portugalete,expenses,gifts,-21.65,-21038.4
buyer_7,María,Valdec,1968-12-31,54502279F,maría.valdec@awesomecloud.com,031005,ES72209544951851809297,6307.96,2023-02-13T09:21:40,Portugalete,expenses,repairs,-311.06,-21349.46
buyer_7,María,Valdec,1968-12-31,54502279F,maría.valdec@awesomecloud.com,031005,ES72209544951851809297,6307.96,2023-02-14T11:05:27,Portugalete,expenses,leisure,-50.7,-21400.16
buyer_7,María,Valdec,1968-12-31,54502279F,maría.valdec@awesomecloud.com,031005,ES72209544951851809297,6307.96,2023-02-14T04:33:52,Portugalete,expenses,cash,-100.0,-21500.16
buyer_7,María,Valdec,1968-12-31,54502279F,maría.valdec@awesomecloud.com,031005,ES72209544951851809297,6307.96,2023-02-15T12:21:47,Portugalete,expenses,food,-123.59,-21623.75
buyer_7,María,Valdec,1968-12-31,54502279F,maría.valdec@awesomecloud.com,031005,ES72209544951851809297,6307.96,2023-02-15T20:22:31,Portugalete,expenses,leisure,-57.0,-21680.75
buyer_7,María,Valdec,1968-12-31,54502279F,maría.valdec@awesomecloud.com,031005,ES72209544951851809297,6307.96,2023-02-18T21:34:40,Portugalete,expenses,transport,-42.59,-21723.34
buyer_7,María,Valdec,1968-12-31,54502279F,maría.valdec@awesomecloud.com,031005,ES72209544951851809297,6307.96,2023-02-19T12:41:46,Portugalete,expenses,healthcare,-49.49,-21772.83
buyer_7,María,Valdec,1968-12-31,54502279F,maría.valdec@awesomecloud.com,031005,ES72209544951851809297,6307.96,2023-02-19T15:53:46,Portugalete,expenses,appliances,-169.72,-21942.55
buyer_7,María,Valdec,1968-12-31,54502279F,maría.valdec@awesomecloud.com,031005,ES72209544951851809297,6307.96,2023-02-21T08:28:16,Portugalete,expenses,repairs,-308.85,-22251.4
buyer_7,María,Valdec,1968-12-31,54502279F,maría.valdec@awesomecloud.com,031005,ES72209544951851809297,6307.96,2023-02-23T23:51:54,Portugalete,expenses,transport,-41.09,-22292.49
buyer_7,María,Valdec,1968-12-31,54502279F,maría.valdec@awesomecloud.com,031005,ES72209544951851809297,6307.96,2023-02-26T15:26:01,Portugalete,expenses,leisure,-20.11,-22312.6
buyer_7,María,Valdec,1968-12-31,54502279F,maría.valdec@awesomecloud.com,031005,ES72209544951851809297,6307.96,2023-03-01T22:10:36,Portugalete,incomes,salary,1561.25,-20751.35
buyer_7,María,Valdec,1968-12-31,54502279F,maría.valdec@awesomecloud.com,031005,ES72209544951851809297,6307.96,2023-03-01T22:10:36,Portugalete,incomes,extra_income,219.04,-20532.31
buyer_7,María,Valdec,1968-12-31,54502279F,maría.valdec@awesomecloud.com,031005,ES72209544951851809297,6307.96,2023-03-01T14:40:12,Portugalete,expenses,food,-81.13,-20613.44
buyer_7,María,Valdec,1968-12-31,54502279F,maría.valdec@awesomecloud.com,031005,ES72209544951851809297,6307.96,2023-03-02T19:34:47,Portugalete,expenses,appliances,-251.13,-20864.57
buyer_7,María,Valdec,1968-12-31,54502279F,maría.valdec@awesomecloud.com,031005,ES72209544951851809297,6307.96,2023-03-03T00:57:28,Portugalete,expenses,clothing,-126.56,-20991.13
buyer_7,María,Valdec,1968-12-31,54502279F,maría.valdec@awesomecloud.com,031005,ES72209544951851809297,6307.96,2023-03-04T13:45:14,Portugalete,expenses,mortgage,-835.54,-21826.67
buyer_7,María,Valdec,1968-12-31,54502279F,maría.valdec@awesomecloud.com,031005,ES72209544951851809297,6307.96,2023-03-04T09:44:21,Portugalete,expenses,transport,-74.08,-21900.75
buyer_7,María,Valdec,1968-12-31,54502279F,maría.valdec@awesomecloud.com,031005,ES72209544951851809297,6307.96,2023-03-04T18:36:33,Portugalete,expenses,clothing,-90.91,-21991.66
buyer_7,María,Valdec,1968-12-31,54502279F,maría.valdec@awesomecloud.com,031005,ES72209544951851809297,6307.96,2023-03-04T16:53:45,Portugalete,expenses,cash,-100.0,-22091.66
buyer_7,María,Valdec,1968-12-31,54502279F,maría.valdec@awesomecloud.com,031005,ES72209544951851809297,6307.96,2023-03-05T13:37:51,Portugalete,expenses,water,-15.74,-22107.4
buyer_7,María,Valdec,1968-12-31,54502279F,maría.valdec@awesomecloud.com,031005,ES72209544951851809297,6307.96,2023-03-05T05:10:20,Portugalete,expenses,clothing,-118.24,-22225.64
buyer_7,María,Valdec,1968-12-31,54502279F,maría.valdec@awesomecloud.com,031005,ES72209544951851809297,6307.96,2023-03-06T15:06:32,Portugalete,expenses,phone,-33.6,-22259.24
buyer_7,María,Valdec,1968-12-31,54502279F,maría.valdec@awesomecloud.com,031005,ES72209544951851809297,6307.96,2023-03-07T14:56:42,Portugalete,expenses,internet,-32.79,-22292.03
buyer_7,María,Valdec,1968-12-31,54502279F,maría.valdec@awesomecloud.com,031005,ES72209544951851809297,6307.96,2023-03-07T12:36:10,Portugalete,expenses,food,-94.97,-22387.0
buyer_7,María,Valdec,1968-12-31,54502279F,maría.valdec@awesomecloud.com,031005,ES72209544951851809297,6307.96,2023-03-08T14:17:02,Portugalete,expenses,phone,-32.34,-22419.34
buyer_7,María,Valdec,1968-12-31,54502279F,maría.valdec@awesomecloud.com,031005,ES72209544951851809297,6307.96,2023-03-08T10:54:06,Portugalete,expenses,clothing,-76.11,-22495.45
buyer_7,María,Valdec,1968-12-31,54502279F,maría.valdec@awesomecloud.com,031005,ES72209544951851809297,6307.96,2023-03-08T10:39:50,Portugalete,expenses,education,-49.49,-22544.94
buyer_7,María,Valdec,1968-12-31,54502279F,maría.valdec@awesomecloud.com,031005,ES72209544951851809297,6307.96,2023-03-11T10:33:49,Portugalete,expenses,education,-77.96,-22622.9
buyer_7,María,Valdec,1968-12-31,54502279F,maría.valdec@awesomecloud.com,031005,ES72209544951851809297,6307.96,2023-03-12T10:30:50,Portugalete,expenses,food,-123.89,-22746.79
buyer_7,María,Valdec,1968-12-31,54502279F,maría.valdec@awesomecloud.com,031005,ES72209544951851809297,6307.96,2023-03-13T11:18:03,Portugalete,expenses,cash,-100.0,-22846.79
buyer_7,María,Valdec,1968-12-31,54502279F,maría.valdec@awesomecloud.com,031005,ES72209544951851809297,6307.96,2023-03-13T13:38:28,Portugalete,expenses,children,-166.43,-23013.22
buyer_7,María,Valdec,1968-12-31,54502279F,maría.valdec@awesomecloud.com,031005,ES72209544951851809297,6307.96,2023-03-16T20:21:51,Portugalete,expenses,children,-248.59,-23261.81
buyer_7,María,Valdec,1968-12-31,54502279F,maría.valdec@awesomecloud.com,031005,ES72209544951851809297,6307.96,2023-03-18T08:49:54,Portugalete,expenses,transport,-84.12,-23345.93
buyer_7,María,Valdec,1968-12-31,54502279F,maría.valdec@awesomecloud.com,031005,ES72209544951851809297,6307.96,2023-03-18T22:32:08,Portugalete,expenses,education,-57.02,-23402.95
buyer_7,María,Valdec,1968-12-31,54502279F,maría.valdec@awesomecloud.com,031005,ES72209544951851809297,6307.96,2023-03-22T16:41:02,Portugalete,expenses,leisure,-30.49,-23433.44
buyer_7,María,Valdec,1968-12-31,54502279F,maría.valdec@awesomecloud.com,031005,ES72209544951851809297,6307.96,2023-03-23T14:10:58,Portugalete,expenses,food,-93.6,-23527.04
buyer_7,María,Valdec,1968-12-31,54502279F,maría.valdec@awesomecloud.com,031005,ES72209544951851809297,6307.96,2023-03-23T10:27:00,Portugalete,expenses,clothing,-66.83,-23593.87
buyer_7,María,Valdec,1968-12-31,54502279F,maría.valdec@awesomecloud.com,031005,ES72209544951851809297,6307.96,2023-03-25T16:16:03,Portugalete,expenses,cash,-100.0,-23693.87
buyer_7,María,Valdec,1968-12-31,54502279F,maría.valdec@awesomecloud.com,031005,ES72209544951851809297,6307.96,2023-03-26T20:39:34,Portugalete,expenses,cash,-100.0,-23793.87
buyer_7,María,Valdec,1968-12-31,54502279F,maría.valdec@awesomecloud.com,031005,ES72209544951851809297,6307.96,2023-03-27T02:26:40,Portugalete,expenses,food,-74.46,-23868.33
buyer_7,María,Valdec,1968-12-31,54502279F,maría.valdec@awesomecloud.com,031005,ES72209544951851809297,6307.96,2023-03-28T21:25:36,Portugalete,expenses,food,-121.73,-23990.06
buyer_7,María,Valdec,1968-12-31,54502279F,maría.valdec@awesomecloud.com,031005,ES72209544951851809297,6307.96,2023-03-28T15:51:08,Portugalete,expenses,leisure,-25.5,-24015.56
buyer_7,María,Valdec,1968-12-31,54502279F,maría.valdec@awesomecloud.com,031005,ES72209544951851809297,6307.96,2023-03-28T18:36:51,Portugalete,expenses,cash,-100.0,-24115.56
buyer_7,María,Valdec,1968-12-31,54502279F,maría.valdec@awesomecloud.com,031005,ES72209544951851809297,6307.96,2023-03-29T00:17:59,Portugalete,expenses,cash,-100.0,-24215.56
buyer_7,María,Valdec,1968-12-31,54502279F,maría.valdec@awesomecloud.com,031005,ES72209544951851809297,6307.96,2023-03-30T19:29:33,Portugalete,expenses,transport,-88.91,-24304.47
buyer_7,María,Valdec,1968-12-31,54502279F,maría.valdec@awesomecloud.com,031005,ES72209544951851809297,6307.96,2023-03-31T16:23:12,Portugalete,expenses,food,-76.73,-24381.2
buyer_7,María,Valdec,1968-12-31,54502279F,maría.valdec@awesomecloud.com,031005,ES72209544951851809297,6307.96,2023-03-31T08:20:11,Portugalete,expenses,cash,-100.0,-24481.2
buyer_7,María,Valdec,1968-12-31,54502279F,maría.valdec@awesomecloud.com,031005,ES72209544951851809297,6307.96,2023-04-01T20:12:51,Portugalete,incomes,salary,1561.25,-22919.95
buyer_7,María,Valdec,1968-12-31,54502279F,maría.valdec@awesomecloud.com,031005,ES72209544951851809297,6307.96,2023-04-02T09:23:36,Portugalete,expenses,gifts,-159.11,-23079.06
buyer_7,María,Valdec,1968-12-31,54502279F,maría.valdec@awesomecloud.com,031005,ES72209544951851809297,6307.96,2023-04-04T17:33:57,Portugalete,expenses,mortgage,-835.54,-23914.6
buyer_7,María,Valdec,1968-12-31,54502279F,maría.valdec@awesomecloud.com,031005,ES72209544951851809297,6307.96,2023-04-04T20:56:59,Portugalete,expenses,clothing,-51.47,-23966.07
buyer_7,María,Valdec,1968-12-31,54502279F,maría.valdec@awesomecloud.com,031005,ES72209544951851809297,6307.96,2023-04-05T08:48:10,Portugalete,expenses,electricity,-70.06,-24036.13
buyer_7,María,Valdec,1968-12-31,54502279F,maría.valdec@awesomecloud.com,031005,ES72209544951851809297,6307.96,2023-04-06T12:31:41,Portugalete,expenses,water,-27.98,-24064.11
buyer_7,María,Valdec,1968-12-31,54502279F,maría.valdec@awesomecloud.com,031005,ES72209544951851809297,6307.96,2023-04-06T19:56:49,Portugalete,expenses,phone,-31.51,-24095.62
buyer_7,María,Valdec,1968-12-31,54502279F,maría.valdec@awesomecloud.com,031005,ES72209544951851809297,6307.96,2023-04-06T13:41:18,Portugalete,expenses,cash,-100.0,-24195.62
buyer_7,María,Valdec,1968-12-31,54502279F,maría.valdec@awesomecloud.com,031005,ES72209544951851809297,6307.96,2023-04-07T10:37:53,Portugalete,expenses,gas,-71.36,-24266.98
buyer_7,María,Valdec,1968-12-31,54502279F,maría.valdec@awesomecloud.com,031005,ES72209544951851809297,6307.96,2023-04-08T15:05:01,Portugalete,expenses,electricity,-45.28,-24312.26
buyer_7,María,Valdec,1968-12-31,54502279F,maría.valdec@awesomecloud.com,031005,ES72209544951851809297,6307.96,2023-04-08T20:54:41,Portugalete,expenses,gas,-64.66,-24376.92
buyer_7,María,Valdec,1968-12-31,54502279F,maría.valdec@awesomecloud.com,031005,ES72209544951851809297,6307.96,2023-04-08T09:39:15,Portugalete,expenses,phone,-33.67,-24410.59
buyer_7,María,Valdec,1968-12-31,54502279F,maría.valdec@awesomecloud.com,031005,ES72209544951851809297,6307.96,2023-04-08T21:17:22,Portugalete,expenses,food,-108.54,-24519.13
buyer_7,María,Valdec,1968-12-31,54502279F,maría.valdec@awesomecloud.com,031005,ES72209544951851809297,6307.96,2023-04-08T13:40:04,Portugalete,expenses,clothing,-97.99,-24617.12
buyer_7,María,Valdec,1968-12-31,54502279F,maría.valdec@awesomecloud.com,031005,ES72209544951851809297,6307.96,2023-04-10T17:28:16,Portugalete,expenses,cash,-100.0,-24717.12
buyer_7,María,Valdec,1968-12-31,54502279F,maría.valdec@awesomecloud.com,031005,ES72209544951851809297,6307.96,2023-04-15T16:27:37,Portugalete,expenses,cash,-100.0,-24817.12
buyer_7,María,Valdec,1968-12-31,54502279F,maría.valdec@awesomecloud.com,031005,ES72209544951851809297,6307.96,2023-04-15T14:18:38,Portugalete,expenses,children,-220.87241666666677,-25037.99
buyer_7,María,Valdec,1968-12-31,54502279F,maría.valdec@awesomecloud.com,031005,ES72209544951851809297,6307.96,2023-04-16T20:05:30,Portugalete,expenses,food,-80.71,-25118.7
buyer_7,María,Valdec,1968-12-31,54502279F,maría.valdec@awesomecloud.com,031005,ES72209544951851809297,6307.96,2023-04-16T15:39:51,Portugalete,expenses,clothing,-133.61,-25252.31
buyer_7,María,Valdec,1968-12-31,54502279F,maría.valdec@awesomecloud.com,031005,ES72209544951851809297,6307.96,2023-04-17T04:52:03,Portugalete,expenses,transport,-47.21,-25299.52
buyer_7,María,Valdec,1968-12-31,54502279F,maría.valdec@awesomecloud.com,031005,ES72209544951851809297,6307.96,2023-04-17T12:23:57,Portugalete,expenses,leisure,-26.49,-25326.01
buyer_7,María,Valdec,1968-12-31,54502279F,maría.valdec@awesomecloud.com,031005,ES72209544951851809297,6307.96,2023-04-18T17:17:00,Portugalete,expenses,education,-69.2,-25395.21
buyer_7,María,Valdec,1968-12-31,54502279F,maría.valdec@awesomecloud.com,031005,ES72209544951851809297,6307.96,2023-04-19T18:56:15,Portugalete,expenses,leisure,-83.99,-25479.2
buyer_7,María,Valdec,1968-12-31,54502279F,maría.valdec@awesomecloud.com,031005,ES72209544951851809297,6307.96,2023-04-19T13:24:13,Portugalete,expenses,education,-56.73,-25535.93
buyer_7,María,Valdec,1968-12-31,54502279F,maría.valdec@awesomecloud.com,031005,ES72209544951851809297,6307.96,2023-04-21T09:33:18,Portugalete,expenses,leisure,-65.47,-25601.4
buyer_7,María,Valdec,1968-12-31,54502279F,maría.valdec@awesomecloud.com,031005,ES72209544951851809297,6307.96,2023-04-22T04:05:28,Portugalete,expenses,gifts,-212.63,-25814.03
buyer_7,María,Valdec,1968-12-31,54502279F,maría.valdec@awesomecloud.com,031005,ES72209544951851809297,6307.96,2023-04-23T09:06:50,Portugalete,expenses,education,-50.61,-25864.64
buyer_7,María,Valdec,1968-12-31,54502279F,maría.valdec@awesomecloud.com,031005,ES72209544951851809297,6307.96,2023-04-24T23:16:24,Portugalete,expenses,transport,-79.16,-25943.8
buyer_7,María,Valdec,1968-12-31,54502279F,maría.valdec@awesomecloud.com,031005,ES72209544951851809297,6307.96,2023-04-24T10:26:59,Portugalete,expenses,clothing,-84.29,-26028.09
buyer_7,María,Valdec,1968-12-31,54502279F,maría.valdec@awesomecloud.com,031005,ES72209544951851809297,6307.96,2023-04-24T08:24:08,Portugalete,expenses,cash,-100.0,-26128.09
buyer_7,María,Valdec,1968-12-31,54502279F,maría.valdec@awesomecloud.com,031005,ES72209544951851809297,6307.96,2023-04-25T19:00:39,Portugalete,expenses,food,-96.86,-26224.95
buyer_7,María,Valdec,1968-12-31,54502279F,maría.valdec@awesomecloud.com,031005,ES72209544951851809297,6307.96,2023-04-27T16:39:48,Portugalete,expenses,food,-95.77,-26320.72
buyer_7,María,Valdec,1968-12-31,54502279F,maría.valdec@awesomecloud.com,031005,ES72209544951851809297,6307.96,2023-04-27T19:26:31,Portugalete,expenses,leisure,-18.01,-26338.73
buyer_7,María,Valdec,1968-12-31,54502279F,maría.valdec@awesomecloud.com,031005,ES72209544951851809297,6307.96,2023-04-28T18:18:53,Portugalete,expenses,transport,-73.51,-26412.24
buyer_7,María,Valdec,1968-12-31,54502279F,maría.valdec@awesomecloud.com,031005,ES72209544951851809297,6307.96,2023-04-29T09:32:47,Portugalete,expenses,clothing,-115.23,-26527.47
buyer_7,María,Valdec,1968-12-31,54502279F,maría.valdec@awesomecloud.com,031005,ES72209544951851809297,6307.96,2023-04-29T15:37:23,Portugalete,expenses,cash,-100.0,-26627.47
buyer_7,María,Valdec,1968-12-31,54502279F,maría.valdec@awesomecloud.com,031005,ES72209544951851809297,6307.96,2023-04-29T14:15:17,Portugalete,expenses,gifts,-97.47,-26724.94
buyer_7,María,Valdec,1968-12-31,54502279F,maría.valdec@awesomecloud.com,031005,ES72209544951851809297,6307.96,2023-05-01T16:25:26,Portugalete,incomes,salary,1561.25,-25163.69
buyer_7,María,Valdec,1968-12-31,54502279F,maría.valdec@awesomecloud.com,031005,ES72209544951851809297,6307.96,2023-05-01T13:24:56,Portugalete,expenses,food,-95.86,-25259.55
buyer_7,María,Valdec,1968-12-31,54502279F,maría.valdec@awesomecloud.com,031005,ES72209544951851809297,6307.96,2023-05-01T10:35:48,Portugalete,expenses,cash,-100.0,-25359.55
buyer_7,María,Valdec,1968-12-31,54502279F,maría.valdec@awesomecloud.com,031005,ES72209544951851809297,6307.96,2023-05-02T17:50:33,Portugalete,expenses,education,-53.83,-25413.38
buyer_7,María,Valdec,1968-12-31,54502279F,maría.valdec@awesomecloud.com,031005,ES72209544951851809297,6307.96,2023-05-03T11:29:16,Portugalete,expenses,cash,-100.0,-25513.38
buyer_7,María,Valdec,1968-12-31,54502279F,maría.valdec@awesomecloud.com,031005,ES72209544951851809297,6307.96,2023-05-04T09:21:11,Portugalete,expenses,mortgage,-835.54,-26348.92
buyer_7,María,Valdec,1968-12-31,54502279F,maría.valdec@awesomecloud.com,031005,ES72209544951851809297,6307.96,2023-05-04T09:47:18,Portugalete,expenses,cash,-100.0,-26448.92
buyer_7,María,Valdec,1968-12-31,54502279F,maría.valdec@awesomecloud.com,031005,ES72209544951851809297,6307.96,2023-05-05T16:21:13,Portugalete,expenses,electricity,-30.98,-26479.9
buyer_7,María,Valdec,1968-12-31,54502279F,maría.valdec@awesomecloud.com,031005,ES72209544951851809297,6307.96,2023-05-06T10:54:24,Portugalete,expenses,gas,-87.82,-26567.72
buyer_7,María,Valdec,1968-12-31,54502279F,maría.valdec@awesomecloud.com,031005,ES72209544951851809297,6307.96,2023-05-06T11:07:02,Portugalete,expenses,internet,-32.79,-26600.51
buyer_7,María,Valdec,1968-12-31,54502279F,maría.valdec@awesomecloud.com,031005,ES72209544951851809297,6307.96,2023-05-06T11:32:33,Portugalete,expenses,phone,-33.49,-26634.0
buyer_7,María,Valdec,1968-12-31,54502279F,maría.valdec@awesomecloud.com,031005,ES72209544951851809297,6307.96,2023-05-07T22:37:40,Portugalete,expenses,gas,-52.97,-26686.97
buyer_7,María,Valdec,1968-12-31,54502279F,maría.valdec@awesomecloud.com,031005,ES72209544951851809297,6307.96,2023-05-08T15:10:54,Portugalete,expenses,water,-32.69,-26719.66
buyer_7,María,Valdec,1968-12-31,54502279F,maría.valdec@awesomecloud.com,031005,ES72209544951851809297,6307.96,2023-05-09T08:05:01,Portugalete,expenses,education,-78.84,-26798.5
buyer_7,María,Valdec,1968-12-31,54502279F,maría.valdec@awesomecloud.com,031005,ES72209544951851809297,6307.96,2023-05-10T18:48:56,Portugalete,expenses,children,-320.87241666666677,-27119.37
buyer_7,María,Valdec,1968-12-31,54502279F,maría.valdec@awesomecloud.com,031005,ES72209544951851809297,6307.96,2023-05-11T23:52:24,Portugalete,expenses,cash,-100.0,-27219.37
buyer_7,María,Valdec,1968-12-31,54502279F,maría.valdec@awesomecloud.com,031005,ES72209544951851809297,6307.96,2023-05-12T22:12:27,Portugalete,expenses,leisure,-50.68,-27270.05
buyer_7,María,Valdec,1968-12-31,54502279F,maría.valdec@awesomecloud.com,031005,ES72209544951851809297,6307.96,2023-05-12T10:17:00,Portugalete,expenses,repairs,-215.4,-27485.45
buyer_7,María,Valdec,1968-12-31,54502279F,maría.valdec@awesomecloud.com,031005,ES72209544951851809297,6307.96,2023-05-16T09:38:44,Portugalete,expenses,leisure,-30.31,-27515.76
buyer_7,María,Valdec,1968-12-31,54502279F,maría.valdec@awesomecloud.com,031005,ES72209544951851809297,6307.96,2023-05-17T19:07:38,Portugalete,expenses,healthcare,-56.88,-27572.64
buyer_7,María,Valdec,1968-12-31,54502279F,maría.valdec@awesomecloud.com,031005,ES72209544951851809297,6307.96,2023-05-18T22:52:10,Portugalete,expenses,transport,-57.64,-27630.28
buyer_7,María,Valdec,1968-12-31,54502279F,maría.valdec@awesomecloud.com,031005,ES72209544951851809297,6307.96,2023-05-18T09:51:03,Portugalete,expenses,cash,-100.0,-27730.28
buyer_7,María,Valdec,1968-12-31,54502279F,maría.valdec@awesomecloud.com,031005,ES72209544951851809297,6307.96,2023-05-20T12:56:53,Portugalete,expenses,leisure,-69.52,-27799.8
buyer_7,María,Valdec,1968-12-31,54502279F,maría.valdec@awesomecloud.com,031005,ES72209544951851809297,6307.96,2023-05-21T08:42:38,Portugalete,expenses,education,-50.25,-27850.05
buyer_7,María,Valdec,1968-12-31,54502279F,maría.valdec@awesomecloud.com,031005,ES72209544951851809297,6307.96,2023-05-22T22:41:10,Portugalete,expenses,clothing,-131.36,-27981.41
buyer_7,María,Valdec,1968-12-31,54502279F,maría.valdec@awesomecloud.com,031005,ES72209544951851809297,6307.96,2023-05-22T18:09:29,Portugalete,expenses,healthcare,-126.0,-28107.41
buyer_7,María,Valdec,1968-12-31,54502279F,maría.valdec@awesomecloud.com,031005,ES72209544951851809297,6307.96,2023-05-23T22:57:15,Portugalete,expenses,transport,-41.94,-28149.35
buyer_7,María,Valdec,1968-12-31,54502279F,maría.valdec@awesomecloud.com,031005,ES72209544951851809297,6307.96,2023-05-23T11:53:25,Portugalete,expenses,cash,-100.0,-28249.35
buyer_7,María,Valdec,1968-12-31,54502279F,maría.valdec@awesomecloud.com,031005,ES72209544951851809297,6307.96,2023-05-25T14:16:12,Portugalete,expenses,leisure,-74.59,-28323.94
buyer_7,María,Valdec,1968-12-31,54502279F,maría.valdec@awesomecloud.com,031005,ES72209544951851809297,6307.96,2023-05-26T23:41:04,Portugalete,expenses,cash,-100.0,-28423.94
buyer_7,María,Valdec,1968-12-31,54502279F,maría.valdec@awesomecloud.com,031005,ES72209544951851809297,6307.96,2023-05-27T10:23:19,Portugalete,expenses,clothing,-104.24,-28528.18
buyer_7,María,Valdec,1968-12-31,54502279F,maría.valdec@awesomecloud.com,031005,ES72209544951851809297,6307.96,2023-05-29T15:44:03,Portugalete,expenses,food,-63.08,-28591.26
buyer_7,María,Valdec,1968-12-31,54502279F,maría.valdec@awesomecloud.com,031005,ES72209544951851809297,6307.96,2023-05-31T08:46:28,Portugalete,expenses,food,-68.66,-28659.92
buyer_7,María,Valdec,1968-12-31,54502279F,maría.valdec@awesomecloud.com,031005,ES72209544951851809297,6307.96,2023-05-31T15:36:07,Portugalete,expenses,leisure,-30.42,-28690.34
buyer_7,María,Valdec,1968-12-31,54502279F,maría.valdec@awesomecloud.com,031005,ES72209544951851809297,6307.96,2023-05-31T21:27:05,Portugalete,expenses,cash,-100.0,-28790.34
buyer_7,María,Valdec,1968-12-31,54502279F,maría.valdec@awesomecloud.com,031005,ES72209544951851809297,6307.96,2023-06-01T18:05:04,Portugalete,incomes,salary,1561.25,-27229.09
buyer_7,María,Valdec,1968-12-31,54502279F,maría.valdec@awesomecloud.com,031005,ES72209544951851809297,6307.96,2023-06-01T18:05:04,Portugalete,incomes,extra_income,219.04,-27010.05
buyer_7,María,Valdec,1968-12-31,54502279F,maría.valdec@awesomecloud.com,031005,ES72209544951851809297,6307.96,2023-06-01T18:05:04,Portugalete,incomes,salary_bonus,1146.11,-25863.94
buyer_7,María,Valdec,1968-12-31,54502279F,maría.valdec@awesomecloud.com,031005,ES72209544951851809297,6307.96,2023-06-01T20:39:04,Portugalete,expenses,taxes,-1168.21,-27032.15
buyer_7,María,Valdec,1968-12-31,54502279F,maría.valdec@awesomecloud.com,031005,ES72209544951851809297,6307.96,2023-06-01T16:43:18,Portugalete,expenses,insurance,-303.16,-27335.31
buyer_7,María,Valdec,1968-12-31,54502279F,maría.valdec@awesomecloud.com,031005,ES72209544951851809297,6307.96,2023-06-01T19:30:58,Portugalete,expenses,cash,-100.0,-27435.31
buyer_7,María,Valdec,1968-12-31,54502279F,maría.valdec@awesomecloud.com,031005,ES72209544951851809297,6307.96,2023-06-02T12:08:20,Portugalete,expenses,transport,-42.84,-27478.15
buyer_7,María,Valdec,1968-12-31,54502279F,maría.valdec@awesomecloud.com,031005,ES72209544951851809297,6307.96,2023-06-03T10:36:34,Portugalete,expenses,transport,-63.18,-27541.33
buyer_7,María,Valdec,1968-12-31,54502279F,maría.valdec@awesomecloud.com,031005,ES72209544951851809297,6307.96,2023-06-04T20:50:16,Portugalete,expenses,mortgage,-835.54,-28376.87
buyer_7,María,Valdec,1968-12-31,54502279F,maría.valdec@awesomecloud.com,031005,ES72209544951851809297,6307.96,2023-06-06T14:24:16,Portugalete,expenses,water,-17.58,-28394.45
buyer_7,María,Valdec,1968-12-31,54502279F,maría.valdec@awesomecloud.com,031005,ES72209544951851809297,6307.96,2023-06-06T10:13:38,Portugalete,expenses,gas,-57.7,-28452.15
buyer_7,María,Valdec,1968-12-31,54502279F,maría.valdec@awesomecloud.com,031005,ES72209544951851809297,6307.96,2023-06-06T22:52:54,Portugalete,expenses,food,-109.81,-28561.96
buyer_7,María,Valdec,1968-12-31,54502279F,maría.valdec@awesomecloud.com,031005,ES72209544951851809297,6307.96,2023-06-06T05:27:45,Portugalete,expenses,clothing,-117.52,-28679.48
buyer_7,María,Valdec,1968-12-31,54502279F,maría.valdec@awesomecloud.com,031005,ES72209544951851809297,6307.96,2023-06-07T19:08:35,Portugalete,expenses,water,-19.65,-28699.13
buyer_7,María,Valdec,1968-12-31,54502279F,maría.valdec@awesomecloud.com,031005,ES72209544951851809297,6307.96,2023-06-07T12:48:02,Portugalete,expenses,electricity,-57.64,-28756.77
buyer_7,María,Valdec,1968-12-31,54502279F,maría.valdec@awesomecloud.com,031005,ES72209544951851809297,6307.96,2023-06-07T19:58:06,Portugalete,expenses,gas,-88.1,-28844.87
buyer_7,María,Valdec,1968-12-31,54502279F,maría.valdec@awesomecloud.com,031005,ES72209544951851809297,6307.96,2023-06-09T21:20:53,Portugalete,expenses,healthcare,-46.96,-28891.83
buyer_7,María,Valdec,1968-12-31,54502279F,maría.valdec@awesomecloud.com,031005,ES72209544951851809297,6307.96,2023-06-09T20:40:04,Portugalete,expenses,cash,-100.0,-28991.83
buyer_7,María,Valdec,1968-12-31,54502279F,maría.valdec@awesomecloud.com,031005,ES72209544951851809297,6307.96,2023-06-16T12:03:23,Portugalete,expenses,food,-101.09,-29092.92
buyer_7,María,Valdec,1968-12-31,54502279F,maría.valdec@awesomecloud.com,031005,ES72209544951851809297,6307.96,2023-06-16T10:42:54,Portugalete,expenses,leisure,-41.27,-29134.19
buyer_7,María,Valdec,1968-12-31,54502279F,maría.valdec@awesomecloud.com,031005,ES72209544951851809297,6307.96,2023-06-19T17:39:54,Portugalete,expenses,transport,-64.95,-29199.14
buyer_7,María,Valdec,1968-12-31,54502279F,maría.valdec@awesomecloud.com,031005,ES72209544951851809297,6307.96,2023-06-20T20:53:04,Portugalete,expenses,leisure,-56.11,-29255.25
buyer_7,María,Valdec,1968-12-31,54502279F,maría.valdec@awesomecloud.com,031005,ES72209544951851809297,6307.96,2023-06-20T18:12:16,Portugalete,expenses,cash,-100.0,-29355.25
buyer_7,María,Valdec,1968-12-31,54502279F,maría.valdec@awesomecloud.com,031005,ES72209544951851809297,6307.96,2023-06-23T18:26:46,Portugalete,expenses,leisure,-58.9,-29414.15
buyer_7,María,Valdec,1968-12-31,54502279F,maría.valdec@awesomecloud.com,031005,ES72209544951851809297,6307.96,2023-06-23T18:00:54,Portugalete,expenses,clothing,-142.55,-29556.7
buyer_7,María,Valdec,1968-12-31,54502279F,maría.valdec@awesomecloud.com,031005,ES72209544951851809297,6307.96,2023-06-23T16:19:00,Portugalete,expenses,education,-42.49,-29599.19
buyer_7,María,Valdec,1968-12-31,54502279F,maría.valdec@awesomecloud.com,031005,ES72209544951851809297,6307.96,2023-06-24T21:08:57,Portugalete,expenses,education,-67.39,-29666.58
buyer_7,María,Valdec,1968-12-31,54502279F,maría.valdec@awesomecloud.com,031005,ES72209544951851809297,6307.96,2023-06-24T13:53:04,Portugalete,expenses,repairs,-195.55,-29862.13
buyer_7,María,Valdec,1968-12-31,54502279F,maría.valdec@awesomecloud.com,031005,ES72209544951851809297,6307.96,2023-06-25T20:14:34,Portugalete,expenses,cash,-100.0,-29962.13
buyer_7,María,Valdec,1968-12-31,54502279F,maría.valdec@awesomecloud.com,031005,ES72209544951851809297,6307.96,2023-06-26T17:33:16,Portugalete,expenses,food,-123.38,-30085.51
buyer_7,María,Valdec,1968-12-31,54502279F,maría.valdec@awesomecloud.com,031005,ES72209544951851809297,6307.96,2023-06-27T12:06:56,Portugalete,expenses,travel,-320.18,-30405.69
buyer_7,María,Valdec,1968-12-31,54502279F,maría.valdec@awesomecloud.com,031005,ES72209544951851809297,6307.96,2023-06-29T11:53:54,Portugalete,expenses,food,-122.57,-30528.26
buyer_7,María,Valdec,1968-12-31,54502279F,maría.valdec@awesomecloud.com,031005,ES72209544951851809297,6307.96,2023-06-29T21:44:54,Portugalete,expenses,gifts,-177.66,-30705.92
buyer_7,María,Valdec,1968-12-31,54502279F,maría.valdec@awesomecloud.com,031005,ES72209544951851809297,6307.96,2023-06-30T10:01:59,Portugalete,expenses,transport,-55.36,-30761.28
buyer_7,María,Valdec,1968-12-31,54502279F,maría.valdec@awesomecloud.com,031005,ES72209544951851809297,6307.96,2023-06-30T10:13:02,Portugalete,expenses,cash,-100.0,-30861.28
buyer_7,María,Valdec,1968-12-31,54502279F,maría.valdec@awesomecloud.com,031005,ES72209544951851809297,6307.96,2023-07-01T20:37:44,Portugalete,incomes,salary,1561.25,-29300.03
buyer_7,María,Valdec,1968-12-31,54502279F,maría.valdec@awesomecloud.com,031005,ES72209544951851809297,6307.96,2023-07-03T00:23:31,Portugalete,expenses,food,-83.44,-29383.47
buyer_7,María,Valdec,1968-12-31,54502279F,maría.valdec@awesomecloud.com,031005,ES72209544951851809297,6307.96,2023-07-03T10:37:22,Portugalete,expenses,repairs,-158.64,-29542.11
buyer_7,María,Valdec,1968-12-31,54502279F,maría.valdec@awesomecloud.com,031005,ES72209544951851809297,6307.96,2023-07-04T08:58:12,Portugalete,expenses,mortgage,-835.54,-30377.65
buyer_7,María,Valdec,1968-12-31,54502279F,maría.valdec@awesomecloud.com,031005,ES72209544951851809297,6307.96,2023-07-04T13:15:28,Portugalete,expenses,gifts,-257.68,-30635.33
buyer_7,María,Valdec,1968-12-31,54502279F,maría.valdec@awesomecloud.com,031005,ES72209544951851809297,6307.96,2023-07-04T09:53:14,Portugalete,expenses,children,-63.19241666666676,-30698.52
buyer_7,María,Valdec,1968-12-31,54502279F,maría.valdec@awesomecloud.com,031005,ES72209544951851809297,6307.96,2023-07-05T20:40:49,Portugalete,expenses,water,-26.58,-30725.1
buyer_7,María,Valdec,1968-12-31,54502279F,maría.valdec@awesomecloud.com,031005,ES72209544951851809297,6307.96,2023-07-05T13:44:18,Portugalete,expenses,electricity,-23.22,-30748.32
buyer_7,María,Valdec,1968-12-31,54502279F,maría.valdec@awesomecloud.com,031005,ES72209544951851809297,6307.96,2023-07-05T18:06:37,Portugalete,expenses,cash,-100.0,-30848.32
buyer_7,María,Valdec,1968-12-31,54502279F,maría.valdec@awesomecloud.com,031005,ES72209544951851809297,6307.96,2023-07-06T10:10:07,Portugalete,expenses,appliances,-261.12,-31109.44
buyer_7,María,Valdec,1968-12-31,54502279F,maría.valdec@awesomecloud.com,031005,ES72209544951851809297,6307.96,2023-07-07T08:32:00,Portugalete,expenses,gas,-65.11,-31174.55
buyer_7,María,Valdec,1968-12-31,54502279F,maría.valdec@awesomecloud.com,031005,ES72209544951851809297,6307.96,2023-07-07T09:20:04,Portugalete,expenses,transport,-86.45,-31261.0
buyer_7,María,Valdec,1968-12-31,54502279F,maría.valdec@awesomecloud.com,031005,ES72209544951851809297,6307.96,2023-07-08T18:23:03,Portugalete,expenses,gas,-39.32,-31300.32
buyer_7,María,Valdec,1968-12-31,54502279F,maría.valdec@awesomecloud.com,031005,ES72209544951851809297,6307.96,2023-07-08T15:56:52,Portugalete,expenses,leisure,-34.16,-31334.48
buyer_7,María,Valdec,1968-12-31,54502279F,maría.valdec@awesomecloud.com,031005,ES72209544951851809297,6307.96,2023-07-08T20:08:25,Portugalete,expenses,repairs,-169.03,-31503.51
buyer_7,María,Valdec,1968-12-31,54502279F,maría.valdec@awesomecloud.com,031005,ES72209544951851809297,6307.96,2023-07-09T08:53:44,Portugalete,expenses,appliances,-291.65,-31795.16
buyer_7,María,Valdec,1968-12-31,54502279F,maría.valdec@awesomecloud.com,031005,ES72209544951851809297,6307.96,2023-07-12T23:12:48,Portugalete,expenses,cash,-100.0,-31895.16
buyer_7,María,Valdec,1968-12-31,54502279F,maría.valdec@awesomecloud.com,031005,ES72209544951851809297,6307.96,2023-07-13T10:08:10,Portugalete,expenses,leisure,-24.67,-31919.83
buyer_7,María,Valdec,1968-12-31,54502279F,maría.valdec@awesomecloud.com,031005,ES72209544951851809297,6307.96,2023-07-15T21:59:59,Portugalete,expenses,transport,-84.02,-32003.85
buyer_7,María,Valdec,1968-12-31,54502279F,maría.valdec@awesomecloud.com,031005,ES72209544951851809297,6307.96,2023-07-16T17:14:24,Portugalete,expenses,education,-69.11,-32072.96
buyer_7,María,Valdec,1968-12-31,54502279F,maría.valdec@awesomecloud.com,031005,ES72209544951851809297,6307.96,2023-07-17T17:58:41,Portugalete,expenses,repairs,-284.98,-32357.94
buyer_7,María,Valdec,1968-12-31,54502279F,maría.valdec@awesomecloud.com,031005,ES72209544951851809297,6307.96,2023-07-17T02:43:33,Portugalete,expenses,gifts,-35.42,-32393.36
buyer_7,María,Valdec,1968-12-31,54502279F,maría.valdec@awesomecloud.com,031005,ES72209544951851809297,6307.96,2023-07-18T19:38:24,Portugalete,expenses,food,-124.57,-32517.93
buyer_7,María,Valdec,1968-12-31,54502279F,maría.valdec@awesomecloud.com,031005,ES72209544951851809297,6307.96,2023-07-19T18:40:00,Portugalete,expenses,leisure,-46.64,-32564.57
buyer_7,María,Valdec,1968-12-31,54502279F,maría.valdec@awesomecloud.com,031005,ES72209544951851809297,6307.96,2023-07-19T14:58:03,Portugalete,expenses,repairs,-264.12,-32828.69
buyer_7,María,Valdec,1968-12-31,54502279F,maría.valdec@awesomecloud.com,031005,ES72209544951851809297,6307.96,2023-07-20T16:50:37,Portugalete,expenses,transport,-62.62,-32891.31
buyer_7,María,Valdec,1968-12-31,54502279F,maría.valdec@awesomecloud.com,031005,ES72209544951851809297,6307.96,2023-07-21T08:02:05,Portugalete,expenses,transport,-85.84,-32977.15
buyer_7,María,Valdec,1968-12-31,54502279F,maría.valdec@awesomecloud.com,031005,ES72209544951851809297,6307.96,2023-07-21T10:44:37,Portugalete,expenses,leisure,-51.51,-33028.66
buyer_7,María,Valdec,1968-12-31,54502279F,maría.valdec@awesomecloud.com,031005,ES72209544951851809297,6307.96,2023-07-21T06:39:47,Portugalete,expenses,cash,-100.0,-33128.66
buyer_7,María,Valdec,1968-12-31,54502279F,maría.valdec@awesomecloud.com,031005,ES72209544951851809297,6307.96,2023-07-23T14:54:59,Portugalete,expenses,repairs,-45.45,-33174.11
buyer_7,María,Valdec,1968-12-31,54502279F,maría.valdec@awesomecloud.com,031005,ES72209544951851809297,6307.96,2023-07-24T09:17:29,Portugalete,expenses,gifts,-301.36,-33475.47
buyer_7,María,Valdec,1968-12-31,54502279F,maría.valdec@awesomecloud.com,031005,ES72209544951851809297,6307.96,2023-07-25T23:20:17,Portugalete,expenses,clothing,-123.91,-33599.38
buyer_7,María,Valdec,1968-12-31,54502279F,maría.valdec@awesomecloud.com,031005,ES72209544951851809297,6307.96,2023-07-28T06:50:32,Portugalete,expenses,education,-63.9,-33663.28
buyer_7,María,Valdec,1968-12-31,54502279F,maría.valdec@awesomecloud.com,031005,ES72209544951851809297,6307.96,2023-07-30T17:01:20,Portugalete,expenses,transport,-71.84,-33735.12
buyer_7,María,Valdec,1968-12-31,54502279F,maría.valdec@awesomecloud.com,031005,ES72209544951851809297,6307.96,2023-08-01T20:09:57,Portugalete,incomes,salary,1561.25,-32173.87
buyer_7,María,Valdec,1968-12-31,54502279F,maría.valdec@awesomecloud.com,031005,ES72209544951851809297,6307.96,2023-08-01T15:18:51,Portugalete,expenses,leisure,-27.45,-32201.32
buyer_7,María,Valdec,1968-12-31,54502279F,maría.valdec@awesomecloud.com,031005,ES72209544951851809297,6307.96,2023-08-03T15:52:32,Portugalete,expenses,clothing,-113.8,-32315.12
buyer_7,María,Valdec,1968-12-31,54502279F,maría.valdec@awesomecloud.com,031005,ES72209544951851809297,6307.96,2023-08-04T10:56:16,Portugalete,expenses,mortgage,-835.54,-33150.66
buyer_7,María,Valdec,1968-12-31,54502279F,maría.valdec@awesomecloud.com,031005,ES72209544951851809297,6307.96,2023-08-04T15:15:54,Portugalete,expenses,food,-81.06,-33231.72
buyer_7,María,Valdec,1968-12-31,54502279F,maría.valdec@awesomecloud.com,031005,ES72209544951851809297,6307.96,2023-08-04T16:25:52,Portugalete,expenses,leisure,-41.1,-33272.82
buyer_7,María,Valdec,1968-12-31,54502279F,maría.valdec@awesomecloud.com,031005,ES72209544951851809297,6307.96,2023-08-04T22:53:17,Portugalete,expenses,cash,-100.0,-33372.82
buyer_7,María,Valdec,1968-12-31,54502279F,maría.valdec@awesomecloud.com,031005,ES72209544951851809297,6307.96,2023-08-05T21:14:55,Portugalete,expenses,electricity,-58.69,-33431.51
buyer_7,María,Valdec,1968-12-31,54502279F,maría.valdec@awesomecloud.com,031005,ES72209544951851809297,6307.96,2023-08-05T09:39:46,Portugalete,expenses,transport,-40.54,-33472.05
buyer_7,María,Valdec,1968-12-31,54502279F,maría.valdec@awesomecloud.com,031005,ES72209544951851809297,6307.96,2023-08-05T14:29:10,Portugalete,expenses,cash,-100.0,-33572.05
buyer_7,María,Valdec,1968-12-31,54502279F,maría.valdec@awesomecloud.com,031005,ES72209544951851809297,6307.96,2023-08-06T10:08:02,Portugalete,expenses,water,-21.89,-33593.94
buyer_7,María,Valdec,1968-12-31,54502279F,maría.valdec@awesomecloud.com,031005,ES72209544951851809297,6307.96,2023-08-06T14:18:21,Portugalete,expenses,gas,-35.63,-33629.57
buyer_7,María,Valdec,1968-12-31,54502279F,maría.valdec@awesomecloud.com,031005,ES72209544951851809297,6307.96,2023-08-06T10:38:44,Portugalete,expenses,transport,-50.02,-33679.59
buyer_7,María,Valdec,1968-12-31,54502279F,maría.valdec@awesomecloud.com,031005,ES72209544951851809297,6307.96,2023-08-06T09:44:11,Portugalete,expenses,repairs,-162.8,-33842.39
buyer_7,María,Valdec,1968-12-31,54502279F,maría.valdec@awesomecloud.com,031005,ES72209544951851809297,6307.96,2023-08-07T13:13:39,Portugalete,expenses,electricity,-43.02,-33885.41
buyer_7,María,Valdec,1968-12-31,54502279F,maría.valdec@awesomecloud.com,031005,ES72209544951851809297,6307.96,2023-08-07T00:44:46,Portugalete,expenses,internet,-32.79,-33918.2
buyer_7,María,Valdec,1968-12-31,54502279F,maría.valdec@awesomecloud.com,031005,ES72209544951851809297,6307.96,2023-08-07T14:24:09,Portugalete,expenses,food,-81.76,-33999.96
buyer_7,María,Valdec,1968-12-31,54502279F,maría.valdec@awesomecloud.com,031005,ES72209544951851809297,6307.96,2023-08-07T23:48:32,Portugalete,expenses,transport,-74.43,-34074.39
buyer_7,María,Valdec,1968-12-31,54502279F,maría.valdec@awesomecloud.com,031005,ES72209544951851809297,6307.96,2023-08-08T10:53:09,Portugalete,expenses,phone,-24.86,-34099.25
buyer_7,María,Valdec,1968-12-31,54502279F,maría.valdec@awesomecloud.com,031005,ES72209544951851809297,6307.96,2023-08-08T18:39:05,Portugalete,expenses,food,-102.71,-34201.96
buyer_7,María,Valdec,1968-12-31,54502279F,maría.valdec@awesomecloud.com,031005,ES72209544951851809297,6307.96,2023-08-09T22:30:01,Portugalete,expenses,food,-80.34,-34282.3
buyer_7,María,Valdec,1968-12-31,54502279F,maría.valdec@awesomecloud.com,031005,ES72209544951851809297,6307.96,2023-08-09T19:22:31,Portugalete,expenses,repairs,-62.16,-34344.46
buyer_7,María,Valdec,1968-12-31,54502279F,maría.valdec@awesomecloud.com,031005,ES72209544951851809297,6307.96,2023-08-11T09:06:38,Portugalete,expenses,cash,-100.0,-34444.46
buyer_7,María,Valdec,1968-12-31,54502279F,maría.valdec@awesomecloud.com,031005,ES72209544951851809297,6307.96,2023-08-15T10:43:24,Portugalete,expenses,transport,-62.59,-34507.05
buyer_7,María,Valdec,1968-12-31,54502279F,maría.valdec@awesomecloud.com,031005,ES72209544951851809297,6307.96,2023-08-18T08:04:22,Portugalete,expenses,cash,-100.0,-34607.05
buyer_7,María,Valdec,1968-12-31,54502279F,maría.valdec@awesomecloud.com,031005,ES72209544951851809297,6307.96,2023-08-20T17:21:40,Portugalete,expenses,education,-63.44,-34670.49
buyer_7,María,Valdec,1968-12-31,54502279F,maría.valdec@awesomecloud.com,031005,ES72209544951851809297,6307.96,2023-08-21T20:19:36,Portugalete,expenses,leisure,-48.64,-34719.13
buyer_7,María,Valdec,1968-12-31,54502279F,maría.valdec@awesomecloud.com,031005,ES72209544951851809297,6307.96,2023-08-23T18:15:54,Portugalete,expenses,cash,-100.0,-34819.13
buyer_7,María,Valdec,1968-12-31,54502279F,maría.valdec@awesomecloud.com,031005,ES72209544951851809297,6307.96,2023-08-24T16:19:07,Portugalete,expenses,cash,-100.0,-34919.13
buyer_7,María,Valdec,1968-12-31,54502279F,maría.valdec@awesomecloud.com,031005,ES72209544951851809297,6307.96,2023-08-24T15:05:15,Portugalete,expenses,gifts,-192.77,-35111.9
buyer_7,María,Valdec,1968-12-31,54502279F,maría.valdec@awesomecloud.com,031005,ES72209544951851809297,6307.96,2023-08-25T11:51:21,Portugalete,expenses,clothing,-115.1,-35227.0
buyer_7,María,Valdec,1968-12-31,54502279F,maría.valdec@awesomecloud.com,031005,ES72209544951851809297,6307.96,2023-08-26T10:40:43,Portugalete,expenses,appliances,-299.51,-35526.51
buyer_7,María,Valdec,1968-12-31,54502279F,maría.valdec@awesomecloud.com,031005,ES72209544951851809297,6307.96,2023-08-27T00:42:22,Portugalete,expenses,food,-103.86,-35630.37
buyer_7,María,Valdec,1968-12-31,54502279F,maría.valdec@awesomecloud.com,031005,ES72209544951851809297,6307.96,2023-08-27T10:34:32,Portugalete,expenses,clothing,-107.47,-35737.84
buyer_7,María,Valdec,1968-12-31,54502279F,maría.valdec@awesomecloud.com,031005,ES72209544951851809297,6307.96,2023-08-29T17:11:06,Portugalete,expenses,cash,-100.0,-35837.84
buyer_7,María,Valdec,1968-12-31,54502279F,maría.valdec@awesomecloud.com,031005,ES72209544951851809297,6307.96,2023-08-29T03:38:09,Portugalete,expenses,repairs,-165.26,-36003.1
buyer_7,María,Valdec,1968-12-31,54502279F,maría.valdec@awesomecloud.com,031005,ES72209544951851809297,6307.96,2023-09-01T18:17:20,Portugalete,incomes,salary,1561.25,-34441.85
buyer_7,María,Valdec,1968-12-31,54502279F,maría.valdec@awesomecloud.com,031005,ES72209544951851809297,6307.96,2023-09-01T09:18:10,Portugalete,expenses,transport,-58.45,-34500.3
buyer_7,María,Valdec,1968-12-31,54502279F,maría.valdec@awesomecloud.com,031005,ES72209544951851809297,6307.96,2023-09-02T20:50:56,Portugalete,expenses,gifts,-42.79,-34543.09
buyer_7,María,Valdec,1968-12-31,54502279F,maría.valdec@awesomecloud.com,031005,ES72209544951851809297,6307.96,2023-09-04T19:57:52,Portugalete,expenses,mortgage,-835.54,-35378.63
buyer_7,María,Valdec,1968-12-31,54502279F,maría.valdec@awesomecloud.com,031005,ES72209544951851809297,6307.96,2023-09-04T06:35:58,Portugalete,expenses,food,-105.19,-35483.82
buyer_7,María,Valdec,1968-12-31,54502279F,maría.valdec@awesomecloud.com,031005,ES72209544951851809297,6307.96,2023-09-04T18:55:11,Portugalete,expenses,leisure,-44.76,-35528.58
buyer_7,María,Valdec,1968-12-31,54502279F,maría.valdec@awesomecloud.com,031005,ES72209544951851809297,6307.96,2023-09-04T09:57:36,Portugalete,expenses,repairs,-88.3,-35616.88
buyer_7,María,Valdec,1968-12-31,54502279F,maría.valdec@awesomecloud.com,031005,ES72209544951851809297,6307.96,2023-09-05T09:07:19,Portugalete,expenses,water,-18.5,-35635.38
buyer_7,María,Valdec,1968-12-31,54502279F,maría.valdec@awesomecloud.com,031005,ES72209544951851809297,6307.96,2023-09-05T22:12:23,Portugalete,expenses,electricity,-44.61,-35679.99
buyer_7,María,Valdec,1968-12-31,54502279F,maría.valdec@awesomecloud.com,031005,ES72209544951851809297,6307.96,2023-09-05T15:21:04,Portugalete,expenses,gas,-78.3,-35758.29
buyer_7,María,Valdec,1968-12-31,54502279F,maría.valdec@awesomecloud.com,031005,ES72209544951851809297,6307.96,2023-09-05T11:39:27,Portugalete,expenses,transport,-86.58,-35844.87
buyer_7,María,Valdec,1968-12-31,54502279F,maría.valdec@awesomecloud.com,031005,ES72209544951851809297,6307.96,2023-09-05T16:39:09,Portugalete,expenses,leisure,-54.85,-35899.72
buyer_7,María,Valdec,1968-12-31,54502279F,maría.valdec@awesomecloud.com,031005,ES72209544951851809297,6307.96,2023-09-06T10:34:39,Portugalete,expenses,healthcare,-105.11,-36004.83
buyer_7,María,Valdec,1968-12-31,54502279F,maría.valdec@awesomecloud.com,031005,ES72209544951851809297,6307.96,2023-09-07T00:18:10,Portugalete,expenses,phone,-33.06,-36037.89
buyer_7,María,Valdec,1968-12-31,54502279F,maría.valdec@awesomecloud.com,031005,ES72209544951851809297,6307.96,2023-09-07T12:07:16,Portugalete,expenses,cash,-100.0,-36137.89
buyer_7,María,Valdec,1968-12-31,54502279F,maría.valdec@awesomecloud.com,031005,ES72209544951851809297,6307.96,2023-09-08T13:39:43,Portugalete,expenses,gas,-66.6,-36204.49
buyer_7,María,Valdec,1968-12-31,54502279F,maría.valdec@awesomecloud.com,031005,ES72209544951851809297,6307.96,2023-09-08T11:27:06,Portugalete,expenses,internet,-32.79,-36237.28
buyer_7,María,Valdec,1968-12-31,54502279F,maría.valdec@awesomecloud.com,031005,ES72209544951851809297,6307.96,2023-09-08T11:01:40,Portugalete,expenses,phone,-31.96,-36269.24
buyer_7,María,Valdec,1968-12-31,54502279F,maría.valdec@awesomecloud.com,031005,ES72209544951851809297,6307.96,2023-09-09T00:53:10,Portugalete,expenses,leisure,-82.68,-36351.92
buyer_7,María,Valdec,1968-12-31,54502279F,maría.valdec@awesomecloud.com,031005,ES72209544951851809297,6307.96,2023-09-12T08:23:14,Portugalete,expenses,leisure,-42.5,-36394.42
buyer_7,María,Valdec,1968-12-31,54502279F,maría.valdec@awesomecloud.com,031005,ES72209544951851809297,6307.96,2023-09-13T19:56:52,Portugalete,expenses,healthcare,-44.69,-36439.11
buyer_7,María,Valdec,1968-12-31,54502279F,maría.valdec@awesomecloud.com,031005,ES72209544951851809297,6307.96,2023-09-13T17:48:27,Portugalete,expenses,repairs,-157.8,-36596.91
buyer_7,María,Valdec,1968-12-31,54502279F,maría.valdec@awesomecloud.com,031005,ES72209544951851809297,6307.96,2023-09-16T16:47:27,Portugalete,expenses,transport,-67.11,-36664.02
buyer_7,María,Valdec,1968-12-31,54502279F,maría.valdec@awesomecloud.com,031005,ES72209544951851809297,6307.96,2023-09-16T12:41:25,Portugalete,expenses,travel,-273.64,-36937.66
buyer_7,María,Valdec,1968-12-31,54502279F,maría.valdec@awesomecloud.com,031005,ES72209544951851809297,6307.96,2023-09-18T11:23:31,Portugalete,expenses,transport,-41.85,-36979.51
buyer_7,María,Valdec,1968-12-31,54502279F,maría.valdec@awesomecloud.com,031005,ES72209544951851809297,6307.96,2023-09-18T10:34:49,Portugalete,expenses,repairs,-124.14,-37103.65
buyer_7,María,Valdec,1968-12-31,54502279F,maría.valdec@awesomecloud.com,031005,ES72209544951851809297,6307.96,2023-09-19T17:58:15,Portugalete,expenses,healthcare,-53.23,-37156.88
buyer_7,María,Valdec,1968-12-31,54502279F,maría.valdec@awesomecloud.com,031005,ES72209544951851809297,6307.96,2023-09-19T20:20:58,Portugalete,expenses,appliances,-118.01,-37274.89
buyer_7,María,Valdec,1968-12-31,54502279F,maría.valdec@awesomecloud.com,031005,ES72209544951851809297,6307.96,2023-09-20T12:01:48,Portugalete,expenses,food,-74.81,-37349.7
buyer_7,María,Valdec,1968-12-31,54502279F,maría.valdec@awesomecloud.com,031005,ES72209544951851809297,6307.96,2023-09-20T19:03:28,Portugalete,expenses,appliances,-99.86,-37449.56
buyer_7,María,Valdec,1968-12-31,54502279F,maría.valdec@awesomecloud.com,031005,ES72209544951851809297,6307.96,2023-09-22T11:25:37,Portugalete,expenses,leisure,-19.21,-37468.77
buyer_7,María,Valdec,1968-12-31,54502279F,maría.valdec@awesomecloud.com,031005,ES72209544951851809297,6307.96,2023-09-23T23:08:43,Portugalete,expenses,leisure,-26.63,-37495.4
buyer_7,María,Valdec,1968-12-31,54502279F,maría.valdec@awesomecloud.com,031005,ES72209544951851809297,6307.96,2023-09-25T20:29:23,Portugalete,expenses,transport,-89.14,-37584.54
buyer_7,María,Valdec,1968-12-31,54502279F,maría.valdec@awesomecloud.com,031005,ES72209544951851809297,6307.96,2023-09-25T07:53:39,Portugalete,expenses,repairs,-182.16,-37766.7
buyer_7,María,Valdec,1968-12-31,54502279F,maría.valdec@awesomecloud.com,031005,ES72209544951851809297,6307.96,2023-09-26T11:00:15,Portugalete,expenses,leisure,-75.19,-37841.89
buyer_7,María,Valdec,1968-12-31,54502279F,maría.valdec@awesomecloud.com,031005,ES72209544951851809297,6307.96,2023-09-27T11:49:20,Portugalete,expenses,repairs,-108.03,-37949.92
buyer_7,María,Valdec,1968-12-31,54502279F,maría.valdec@awesomecloud.com,031005,ES72209544951851809297,6307.96,2023-09-28T20:24:19,Portugalete,expenses,transport,-86.62,-38036.54
buyer_7,María,Valdec,1968-12-31,54502279F,maría.valdec@awesomecloud.com,031005,ES72209544951851809297,6307.96,2023-09-29T09:42:18,Portugalete,expenses,transport,-52.46,-38089.0
buyer_7,María,Valdec,1968-12-31,54502279F,maría.valdec@awesomecloud.com,031005,ES72209544951851809297,6307.96,2023-09-29T16:46:38,Portugalete,expenses,leisure,-52.25,-38141.25
buyer_7,María,Valdec,1968-12-31,54502279F,maría.valdec@awesomecloud.com,031005,ES72209544951851809297,6307.96,2023-10-01T19:22:01,Portugalete,incomes,salary,1561.25,-36580.0
buyer_7,María,Valdec,1968-12-31,54502279F,maría.valdec@awesomecloud.com,031005,ES72209544951851809297,6307.96,2023-10-01T19:22:01,Portugalete,incomes,extra_income,219.04,-36360.96
buyer_7,María,Valdec,1968-12-31,54502279F,maría.valdec@awesomecloud.com,031005,ES72209544951851809297,6307.96,2023-10-01T08:31:42,Portugalete,expenses,gifts,-213.15,-36574.11
buyer_7,María,Valdec,1968-12-31,54502279F,maría.valdec@awesomecloud.com,031005,ES72209544951851809297,6307.96,2023-10-02T13:49:24,Portugalete,expenses,food,-111.86,-36685.97
buyer_7,María,Valdec,1968-12-31,54502279F,maría.valdec@awesomecloud.com,031005,ES72209544951851809297,6307.96,2023-10-04T18:46:51,Portugalete,expenses,mortgage,-835.54,-37521.51
buyer_7,María,Valdec,1968-12-31,54502279F,maría.valdec@awesomecloud.com,031005,ES72209544951851809297,6307.96,2023-10-04T14:41:36,Portugalete,expenses,healthcare,-157.55,-37679.06
buyer_7,María,Valdec,1968-12-31,54502279F,maría.valdec@awesomecloud.com,031005,ES72209544951851809297,6307.96,2023-10-06T12:13:56,Portugalete,expenses,leisure,-63.24,-37742.3
buyer_7,María,Valdec,1968-12-31,54502279F,maría.valdec@awesomecloud.com,031005,ES72209544951851809297,6307.96,2023-10-06T13:10:55,Portugalete,expenses,travel,-260.53,-38002.83
buyer_7,María,Valdec,1968-12-31,54502279F,maría.valdec@awesomecloud.com,031005,ES72209544951851809297,6307.96,2023-10-08T15:17:47,Portugalete,expenses,gas,-42.92,-38045.75
buyer_7,María,Valdec,1968-12-31,54502279F,maría.valdec@awesomecloud.com,031005,ES72209544951851809297,6307.96,2023-10-08T20:44:49,Portugalete,expenses,internet,-32.79,-38078.54
buyer_7,María,Valdec,1968-12-31,54502279F,maría.valdec@awesomecloud.com,031005,ES72209544951851809297,6307.96,2023-10-08T16:32:57,Portugalete,expenses,healthcare,-110.4,-38188.94
buyer_7,María,Valdec,1968-12-31,54502279F,maría.valdec@awesomecloud.com,031005,ES72209544951851809297,6307.96,2023-10-10T14:01:53,Portugalete,expenses,food,-66.87,-38255.81
buyer_7,María,Valdec,1968-12-31,54502279F,maría.valdec@awesomecloud.com,031005,ES72209544951851809297,6307.96,2023-10-11T18:18:43,Portugalete,expenses,transport,-76.16,-38331.97
buyer_7,María,Valdec,1968-12-31,54502279F,maría.valdec@awesomecloud.com,031005,ES72209544951851809297,6307.96,2023-10-11T14:13:54,Portugalete,expenses,gifts,-171.54,-38503.51
buyer_7,María,Valdec,1968-12-31,54502279F,maría.valdec@awesomecloud.com,031005,ES72209544951851809297,6307.96,2023-10-14T02:49:30,Portugalete,expenses,gifts,-146.4,-38649.91
buyer_7,María,Valdec,1968-12-31,54502279F,maría.valdec@awesomecloud.com,031005,ES72209544951851809297,6307.96,2023-10-15T20:07:31,Portugalete,expenses,food,-123.87,-38773.78
buyer_7,María,Valdec,1968-12-31,54502279F,maría.valdec@awesomecloud.com,031005,ES72209544951851809297,6307.96,2023-10-15T12:33:08,Portugalete,expenses,cash,-100.0,-38873.78
buyer_7,María,Valdec,1968-12-31,54502279F,maría.valdec@awesomecloud.com,031005,ES72209544951851809297,6307.96,2023-10-18T05:25:19,Portugalete,expenses,repairs,-305.62,-39179.4
buyer_7,María,Valdec,1968-12-31,54502279F,maría.valdec@awesomecloud.com,031005,ES72209544951851809297,6307.96,2023-10-19T00:02:07,Portugalete,expenses,food,-69.57,-39248.97
buyer_7,María,Valdec,1968-12-31,54502279F,maría.valdec@awesomecloud.com,031005,ES72209544951851809297,6307.96,2023-10-20T15:47:21,Portugalete,expenses,travel,-283.26,-39532.23
buyer_7,María,Valdec,1968-12-31,54502279F,maría.valdec@awesomecloud.com,031005,ES72209544951851809297,6307.96,2023-10-21T21:27:53,Portugalete,expenses,food,-86.1,-39618.33
buyer_7,María,Valdec,1968-12-31,54502279F,maría.valdec@awesomecloud.com,031005,ES72209544951851809297,6307.96,2023-10-22T17:40:20,Portugalete,expenses,cash,-100.0,-39718.33
buyer_7,María,Valdec,1968-12-31,54502279F,maría.valdec@awesomecloud.com,031005,ES72209544951851809297,6307.96,2023-10-22T18:55:55,Portugalete,expenses,gifts,-196.3,-39914.63
buyer_7,María,Valdec,1968-12-31,54502279F,maría.valdec@awesomecloud.com,031005,ES72209544951851809297,6307.96,2023-10-23T12:30:23,Portugalete,expenses,cash,-100.0,-40014.63
buyer_7,María,Valdec,1968-12-31,54502279F,maría.valdec@awesomecloud.com,031005,ES72209544951851809297,6307.96,2023-10-23T12:15:23,Portugalete,expenses,repairs,-162.06,-40176.69
buyer_7,María,Valdec,1968-12-31,54502279F,maría.valdec@awesomecloud.com,031005,ES72209544951851809297,6307.96,2023-10-25T20:13:22,Portugalete,expenses,cash,-100.0,-40276.69
buyer_7,María,Valdec,1968-12-31,54502279F,maría.valdec@awesomecloud.com,031005,ES72209544951851809297,6307.96,2023-10-28T14:12:31,Portugalete,expenses,leisure,-44.56,-40321.25
buyer_7,María,Valdec,1968-12-31,54502279F,maría.valdec@awesomecloud.com,031005,ES72209544951851809297,6307.96,2023-10-30T02:02:52,Portugalete,expenses,leisure,-41.12,-40362.37
buyer_7,María,Valdec,1968-12-31,54502279F,maría.valdec@awesomecloud.com,031005,ES72209544951851809297,6307.96,2023-10-31T09:49:14,Portugalete,expenses,food,-113.49,-40475.86
buyer_7,María,Valdec,1968-12-31,54502279F,maría.valdec@awesomecloud.com,031005,ES72209544951851809297,6307.96,2023-10-31T08:26:24,Portugalete,expenses,education,-60.84,-40536.7
buyer_7,María,Valdec,1968-12-31,54502279F,maría.valdec@awesomecloud.com,031005,ES72209544951851809297,6307.96,2023-11-01T20:18:26,Portugalete,incomes,salary,1561.25,-38975.45
buyer_7,María,Valdec,1968-12-31,54502279F,maría.valdec@awesomecloud.com,031005,ES72209544951851809297,6307.96,2023-11-02T12:23:09,Portugalete,expenses,repairs,-318.35,-39293.8
buyer_7,María,Valdec,1968-12-31,54502279F,maría.valdec@awesomecloud.com,031005,ES72209544951851809297,6307.96,2023-11-04T11:47:39,Portugalete,expenses,mortgage,-835.54,-40129.34
buyer_7,María,Valdec,1968-12-31,54502279F,maría.valdec@awesomecloud.com,031005,ES72209544951851809297,6307.96,2023-11-05T21:41:16,Portugalete,expenses,internet,-32.79,-40162.13
buyer_7,María,Valdec,1968-12-31,54502279F,maría.valdec@awesomecloud.com,031005,ES72209544951851809297,6307.96,2023-11-06T16:51:07,Portugalete,expenses,water,-24.82,-40186.95
buyer_7,María,Valdec,1968-12-31,54502279F,maría.valdec@awesomecloud.com,031005,ES72209544951851809297,6307.96,2023-11-06T17:07:01,Portugalete,expenses,electricity,-17.51,-40204.46
buyer_7,María,Valdec,1968-12-31,54502279F,maría.valdec@awesomecloud.com,031005,ES72209544951851809297,6307.96,2023-11-06T14:18:15,Portugalete,expenses,children,-197.78,-40402.24
buyer_7,María,Valdec,1968-12-31,54502279F,maría.valdec@awesomecloud.com,031005,ES72209544951851809297,6307.96,2023-11-07T17:29:59,Portugalete,expenses,water,-34.06,-40436.3
buyer_7,María,Valdec,1968-12-31,54502279F,maría.valdec@awesomecloud.com,031005,ES72209544951851809297,6307.96,2023-11-07T15:35:03,Portugalete,expenses,gifts,-259.17,-40695.47
buyer_7,María,Valdec,1968-12-31,54502279F,maría.valdec@awesomecloud.com,031005,ES72209544951851809297,6307.96,2023-11-08T15:33:27,Portugalete,expenses,water,-19.33,-40714.8
buyer_7,María,Valdec,1968-12-31,54502279F,maría.valdec@awesomecloud.com,031005,ES72209544951851809297,6307.96,2023-11-08T13:26:14,Portugalete,expenses,internet,-32.79,-40747.59
buyer_7,María,Valdec,1968-12-31,54502279F,maría.valdec@awesomecloud.com,031005,ES72209544951851809297,6307.96,2023-11-08T08:22:36,Portugalete,expenses,phone,-31.39,-40778.98
buyer_7,María,Valdec,1968-12-31,54502279F,maría.valdec@awesomecloud.com,031005,ES72209544951851809297,6307.96,2023-11-08T14:32:45,Portugalete,expenses,cash,-100.0,-40878.98
buyer_7,María,Valdec,1968-12-31,54502279F,maría.valdec@awesomecloud.com,031005,ES72209544951851809297,6307.96,2023-11-09T11:07:51,Portugalete,expenses,education,-67.98,-40946.96
buyer_7,María,Valdec,1968-12-31,54502279F,maría.valdec@awesomecloud.com,031005,ES72209544951851809297,6307.96,2023-11-09T08:13:08,Portugalete,expenses,cash,-100.0,-41046.96
buyer_7,María,Valdec,1968-12-31,54502279F,maría.valdec@awesomecloud.com,031005,ES72209544951851809297,6307.96,2023-11-09T13:39:44,Portugalete,expenses,children,-101.4,-41148.36
buyer_7,María,Valdec,1968-12-31,54502279F,maría.valdec@awesomecloud.com,031005,ES72209544951851809297,6307.96,2023-11-11T15:08:12,Portugalete,expenses,healthcare,-90.59,-41238.95
buyer_7,María,Valdec,1968-12-31,54502279F,maría.valdec@awesomecloud.com,031005,ES72209544951851809297,6307.96,2023-11-11T18:38:21,Portugalete,expenses,cash,-100.0,-41338.95
buyer_7,María,Valdec,1968-12-31,54502279F,maría.valdec@awesomecloud.com,031005,ES72209544951851809297,6307.96,2023-11-14T09:00:51,Portugalete,expenses,clothing,-94.84,-41433.79
buyer_7,María,Valdec,1968-12-31,54502279F,maría.valdec@awesomecloud.com,031005,ES72209544951851809297,6307.96,2023-11-15T13:11:51,Portugalete,expenses,transport,-57.48,-41491.27
buyer_7,María,Valdec,1968-12-31,54502279F,maría.valdec@awesomecloud.com,031005,ES72209544951851809297,6307.96,2023-11-15T10:29:15,Portugalete,expenses,children,-246.53,-41737.8
buyer_7,María,Valdec,1968-12-31,54502279F,maría.valdec@awesomecloud.com,031005,ES72209544951851809297,6307.96,2023-11-16T18:50:32,Portugalete,expenses,food,-93.59,-41831.39
buyer_7,María,Valdec,1968-12-31,54502279F,maría.valdec@awesomecloud.com,031005,ES72209544951851809297,6307.96,2023-11-20T08:01:34,Portugalete,expenses,cash,-100.0,-41931.39
buyer_7,María,Valdec,1968-12-31,54502279F,maría.valdec@awesomecloud.com,031005,ES72209544951851809297,6307.96,2023-11-23T18:38:57,Portugalete,expenses,food,-97.48,-42028.87
buyer_7,María,Valdec,1968-12-31,54502279F,maría.valdec@awesomecloud.com,031005,ES72209544951851809297,6307.96,2023-11-23T23:56:50,Portugalete,expenses,cash,-100.0,-42128.87
buyer_7,María,Valdec,1968-12-31,54502279F,maría.valdec@awesomecloud.com,031005,ES72209544951851809297,6307.96,2023-11-24T09:49:05,Portugalete,expenses,transport,-85.67,-42214.54
buyer_7,María,Valdec,1968-12-31,54502279F,maría.valdec@awesomecloud.com,031005,ES72209544951851809297,6307.96,2023-11-27T19:38:10,Portugalete,expenses,cash,-100.0,-42314.54
buyer_7,María,Valdec,1968-12-31,54502279F,maría.valdec@awesomecloud.com,031005,ES72209544951851809297,6307.96,2023-11-28T03:35:37,Portugalete,expenses,cash,-100.0,-42414.54
buyer_7,María,Valdec,1968-12-31,54502279F,maría.valdec@awesomecloud.com,031005,ES72209544951851809297,6307.96,2023-11-29T18:18:04,Portugalete,expenses,food,-84.14,-42498.68
buyer_7,María,Valdec,1968-12-31,54502279F,maría.valdec@awesomecloud.com,031005,ES72209544951851809297,6307.96,2023-12-01T10:21:52,Portugalete,incomes,salary,1561.25,-40937.43
buyer_7,María,Valdec,1968-12-31,54502279F,maría.valdec@awesomecloud.com,031005,ES72209544951851809297,6307.96,2023-12-01T10:21:52,Portugalete,incomes,salary_bonus,1208.87,-39728.56
buyer_7,María,Valdec,1968-12-31,54502279F,maría.valdec@awesomecloud.com,031005,ES72209544951851809297,6307.96,2023-12-01T21:15:47,Portugalete,expenses,food,-61.3,-39789.86
buyer_7,María,Valdec,1968-12-31,54502279F,maría.valdec@awesomecloud.com,031005,ES72209544951851809297,6307.96,2023-12-01T20:50:11,Portugalete,expenses,children,-259.57241666666675,-40049.43
buyer_7,María,Valdec,1968-12-31,54502279F,maría.valdec@awesomecloud.com,031005,ES72209544951851809297,6307.96,2023-12-02T13:11:05,Portugalete,expenses,repairs,-290.13,-40339.56
buyer_7,María,Valdec,1968-12-31,54502279F,maría.valdec@awesomecloud.com,031005,ES72209544951851809297,6307.96,2023-12-04T09:35:07,Portugalete,expenses,mortgage,-835.54,-41175.1
buyer_7,María,Valdec,1968-12-31,54502279F,maría.valdec@awesomecloud.com,031005,ES72209544951851809297,6307.96,2023-12-05T14:20:09,Portugalete,expenses,transport,-87.21,-41262.31
buyer_7,María,Valdec,1968-12-31,54502279F,maría.valdec@awesomecloud.com,031005,ES72209544951851809297,6307.96,2023-12-06T14:09:43,Portugalete,expenses,gas,-79.45,-41341.76
buyer_7,María,Valdec,1968-12-31,54502279F,maría.valdec@awesomecloud.com,031005,ES72209544951851809297,6307.96,2023-12-06T15:11:47,Portugalete,expenses,leisure,-79.01,-41420.77
buyer_7,María,Valdec,1968-12-31,54502279F,maría.valdec@awesomecloud.com,031005,ES72209544951851809297,6307.96,2023-12-07T15:30:18,Portugalete,expenses,phone,-34.57,-41455.34
buyer_7,María,Valdec,1968-12-31,54502279F,maría.valdec@awesomecloud.com,031005,ES72209544951851809297,6307.96,2023-12-08T15:26:29,Portugalete,expenses,food,-89.91,-41545.25
buyer_7,María,Valdec,1968-12-31,54502279F,maría.valdec@awesomecloud.com,031005,ES72209544951851809297,6307.96,2023-12-08T14:20:07,Portugalete,expenses,leisure,-68.98,-41614.23
buyer_7,María,Valdec,1968-12-31,54502279F,maría.valdec@awesomecloud.com,031005,ES72209544951851809297,6307.96,2023-12-10T08:42:37,Portugalete,expenses,transport,-77.45,-41691.68
buyer_7,María,Valdec,1968-12-31,54502279F,maría.valdec@awesomecloud.com,031005,ES72209544951851809297,6307.96,2023-12-11T19:42:09,Portugalete,expenses,cash,-100.0,-41791.68
buyer_7,María,Valdec,1968-12-31,54502279F,maría.valdec@awesomecloud.com,031005,ES72209544951851809297,6307.96,2023-12-12T12:20:30,Portugalete,expenses,food,-84.3,-41875.98
buyer_7,María,Valdec,1968-12-31,54502279F,maría.valdec@awesomecloud.com,031005,ES72209544951851809297,6307.96,2023-12-13T20:13:56,Portugalete,expenses,clothing,-117.99,-41993.97
buyer_7,María,Valdec,1968-12-31,54502279F,maría.valdec@awesomecloud.com,031005,ES72209544951851809297,6307.96,2023-12-16T03:07:46,Portugalete,expenses,transport,-80.27,-42074.24
buyer_7,María,Valdec,1968-12-31,54502279F,maría.valdec@awesomecloud.com,031005,ES72209544951851809297,6307.96,2023-12-16T15:06:05,Portugalete,expenses,clothing,-98.79,-42173.03
buyer_7,María,Valdec,1968-12-31,54502279F,maría.valdec@awesomecloud.com,031005,ES72209544951851809297,6307.96,2023-12-18T09:39:12,Portugalete,expenses,leisure,-31.27,-42204.3
buyer_7,María,Valdec,1968-12-31,54502279F,maría.valdec@awesomecloud.com,031005,ES72209544951851809297,6307.96,2023-12-18T04:34:19,Portugalete,expenses,education,-58.38,-42262.68
buyer_7,María,Valdec,1968-12-31,54502279F,maría.valdec@awesomecloud.com,031005,ES72209544951851809297,6307.96,2023-12-19T12:55:35,Portugalete,expenses,leisure,-33.67,-42296.35
buyer_7,María,Valdec,1968-12-31,54502279F,maría.valdec@awesomecloud.com,031005,ES72209544951851809297,6307.96,2023-12-20T23:50:14,Portugalete,expenses,children,-127.53,-42423.88
buyer_7,María,Valdec,1968-12-31,54502279F,maría.valdec@awesomecloud.com,031005,ES72209544951851809297,6307.96,2023-12-23T14:18:26,Portugalete,expenses,leisure,-82.51,-42506.39
buyer_7,María,Valdec,1968-12-31,54502279F,maría.valdec@awesomecloud.com,031005,ES72209544951851809297,6307.96,2023-12-23T09:36:09,Portugalete,expenses,clothing,-77.58,-42583.97
buyer_7,María,Valdec,1968-12-31,54502279F,maría.valdec@awesomecloud.com,031005,ES72209544951851809297,6307.96,2023-12-24T21:12:26,Portugalete,expenses,cash,-100.0,-42683.97
buyer_7,María,Valdec,1968-12-31,54502279F,maría.valdec@awesomecloud.com,031005,ES72209544951851809297,6307.96,2023-12-25T09:25:10,Portugalete,expenses,food,-90.81,-42774.78
buyer_7,María,Valdec,1968-12-31,54502279F,maría.valdec@awesomecloud.com,031005,ES72209544951851809297,6307.96,2023-12-26T14:27:14,Portugalete,expenses,cash,-100.0,-42874.78
buyer_7,María,Valdec,1968-12-31,54502279F,maría.valdec@awesomecloud.com,031005,ES72209544951851809297,6307.96,2023-12-27T19:52:45,Portugalete,expenses,cash,-100.0,-42974.78
buyer_7,María,Valdec,1968-12-31,54502279F,maría.valdec@awesomecloud.com,031005,ES72209544951851809297,6307.96,2023-12-29T18:32:28,Portugalete,expenses,food,-104.46,-43079.24
buyer_7,María,Valdec,1968-12-31,54502279F,maría.valdec@awesomecloud.com,031005,ES72209544951851809297,6307.96,2023-12-29T10:55:00,Portugalete,expenses,leisure,-53.58,-43132.82
buyer_7,María,Valdec,1968-12-31,54502279F,maría.valdec@awesomecloud.com,031005,ES72209544951851809297,6307.96,2023-12-31T10:17:32,Portugalete,expenses,food,-103.19,-43236.01
buyer_7,María,Valdec,1968-12-31,54502279F,maría.valdec@awesomecloud.com,031005,ES72209544951851809297,6307.96,2024-01-01T10:28:06,Portugalete,incomes,salary,1622.81,-41613.2
buyer_7,María,Valdec,1968-12-31,54502279F,maría.valdec@awesomecloud.com,031005,ES72209544951851809297,6307.96,2024-01-01T10:28:06,Portugalete,incomes,extra_income,219.04,-41394.16
buyer_7,María,Valdec,1968-12-31,54502279F,maría.valdec@awesomecloud.com,031005,ES72209544951851809297,6307.96,2024-01-02T16:23:42,Portugalete,expenses,food,-83.94,-41478.1
buyer_7,María,Valdec,1968-12-31,54502279F,maría.valdec@awesomecloud.com,031005,ES72209544951851809297,6307.96,2024-01-03T10:53:33,Portugalete,expenses,cash,-100.0,-41578.1
buyer_7,María,Valdec,1968-12-31,54502279F,maría.valdec@awesomecloud.com,031005,ES72209544951851809297,6307.96,2024-01-04T02:04:47,Portugalete,expenses,mortgage,-630.41,-42208.51
buyer_7,María,Valdec,1968-12-31,54502279F,maría.valdec@awesomecloud.com,031005,ES72209544951851809297,6307.96,2024-01-04T21:39:08,Portugalete,expenses,cash,-100.0,-42308.51
buyer_7,María,Valdec,1968-12-31,54502279F,maría.valdec@awesomecloud.com,031005,ES72209544951851809297,6307.96,2024-01-05T16:04:16,Portugalete,expenses,food,-63.74,-42372.25
buyer_7,María,Valdec,1968-12-31,54502279F,maría.valdec@awesomecloud.com,031005,ES72209544951851809297,6307.96,2024-01-05T08:31:47,Portugalete,expenses,children,-354.69,-42726.94
buyer_7,María,Valdec,1968-12-31,54502279F,maría.valdec@awesomecloud.com,031005,ES72209544951851809297,6307.96,2024-01-06T13:12:56,Portugalete,expenses,water,-29.8,-42756.74
buyer_7,María,Valdec,1968-12-31,54502279F,maría.valdec@awesomecloud.com,031005,ES72209544951851809297,6307.96,2024-01-06T11:35:48,Portugalete,expenses,internet,-34.08,-42790.82
buyer_7,María,Valdec,1968-12-31,54502279F,maría.valdec@awesomecloud.com,031005,ES72209544951851809297,6307.96,2024-01-06T13:11:30,Portugalete,expenses,cash,-100.0,-42890.82
buyer_7,María,Valdec,1968-12-31,54502279F,maría.valdec@awesomecloud.com,031005,ES72209544951851809297,6307.96,2024-01-07T00:03:03,Portugalete,expenses,water,-18.72,-42909.54
buyer_7,María,Valdec,1968-12-31,54502279F,maría.valdec@awesomecloud.com,031005,ES72209544951851809297,6307.96,2024-01-07T10:38:28,Portugalete,expenses,internet,-34.08,-42943.62
buyer_7,María,Valdec,1968-12-31,54502279F,maría.valdec@awesomecloud.com,031005,ES72209544951851809297,6307.96,2024-01-08T12:27:55,Portugalete,expenses,phone,-30.16,-42973.78
buyer_7,María,Valdec,1968-12-31,54502279F,maría.valdec@awesomecloud.com,031005,ES72209544951851809297,6307.96,2024-01-08T11:07:26,Portugalete,expenses,cash,-100.0,-43073.78
buyer_7,María,Valdec,1968-12-31,54502279F,maría.valdec@awesomecloud.com,031005,ES72209544951851809297,6307.96,2024-01-09T14:10:21,Portugalete,expenses,food,-60.16,-43133.94
buyer_7,María,Valdec,1968-12-31,54502279F,maría.valdec@awesomecloud.com,031005,ES72209544951851809297,6307.96,2024-01-09T00:24:35,Portugalete,expenses,cash,-100.0,-43233.94
buyer_7,María,Valdec,1968-12-31,54502279F,maría.valdec@awesomecloud.com,031005,ES72209544951851809297,6307.96,2024-01-09T20:49:35,Portugalete,expenses,repairs,-157.59,-43391.53
buyer_7,María,Valdec,1968-12-31,54502279F,maría.valdec@awesomecloud.com,031005,ES72209544951851809297,6307.96,2024-01-09T16:32:38,Portugalete,expenses,children,-135.73741666666643,-43527.27
buyer_7,María,Valdec,1968-12-31,54502279F,maría.valdec@awesomecloud.com,031005,ES72209544951851809297,6307.96,2024-01-10T13:56:55,Portugalete,expenses,food,-65.6,-43592.87
buyer_7,María,Valdec,1968-12-31,54502279F,maría.valdec@awesomecloud.com,031005,ES72209544951851809297,6307.96,2024-01-10T13:21:32,Portugalete,expenses,transport,-72.72,-43665.59
buyer_7,María,Valdec,1968-12-31,54502279F,maría.valdec@awesomecloud.com,031005,ES72209544951851809297,6307.96,2024-01-10T15:09:43,Portugalete,expenses,clothing,-49.12,-43714.71
buyer_7,María,Valdec,1968-12-31,54502279F,maría.valdec@awesomecloud.com,031005,ES72209544951851809297,6307.96,2024-01-12T01:51:02,Portugalete,expenses,leisure,-42.82,-43757.53
buyer_7,María,Valdec,1968-12-31,54502279F,maría.valdec@awesomecloud.com,031005,ES72209544951851809297,6307.96,2024-01-12T11:18:53,Portugalete,expenses,children,-396.21,-44153.74
buyer_7,María,Valdec,1968-12-31,54502279F,maría.valdec@awesomecloud.com,031005,ES72209544951851809297,6307.96,2024-01-14T15:15:06,Portugalete,expenses,clothing,-147.9,-44301.64
buyer_7,María,Valdec,1968-12-31,54502279F,maría.valdec@awesomecloud.com,031005,ES72209544951851809297,6307.96,2024-01-14T18:26:42,Portugalete,expenses,cash,-100.0,-44401.64
buyer_7,María,Valdec,1968-12-31,54502279F,maría.valdec@awesomecloud.com,031005,ES72209544951851809297,6307.96,2024-01-15T10:54:41,Portugalete,expenses,leisure,-50.8,-44452.44
buyer_7,María,Valdec,1968-12-31,54502279F,maría.valdec@awesomecloud.com,031005,ES72209544951851809297,6307.96,2024-01-16T22:11:55,Portugalete,expenses,car,-148.4,-44600.84
buyer_7,María,Valdec,1968-12-31,54502279F,maría.valdec@awesomecloud.com,031005,ES72209544951851809297,6307.96,2024-01-17T07:54:42,Portugalete,expenses,gifts,-75.63,-44676.47
buyer_7,María,Valdec,1968-12-31,54502279F,maría.valdec@awesomecloud.com,031005,ES72209544951851809297,6307.96,2024-01-19T20:29:07,Portugalete,expenses,healthcare,-121.45,-44797.92
buyer_7,María,Valdec,1968-12-31,54502279F,maría.valdec@awesomecloud.com,031005,ES72209544951851809297,6307.96,2024-01-21T17:47:35,Portugalete,expenses,appliances,-127.03,-44924.95
buyer_7,María,Valdec,1968-12-31,54502279F,maría.valdec@awesomecloud.com,031005,ES72209544951851809297,6307.96,2024-01-22T15:41:36,Portugalete,expenses,transport,-82.48,-45007.43
buyer_7,María,Valdec,1968-12-31,54502279F,maría.valdec@awesomecloud.com,031005,ES72209544951851809297,6307.96,2024-01-24T13:14:30,Portugalete,expenses,repairs,-250.33,-45257.76
buyer_7,María,Valdec,1968-12-31,54502279F,maría.valdec@awesomecloud.com,031005,ES72209544951851809297,6307.96,2024-01-25T13:56:59,Portugalete,expenses,clothing,-118.44,-45376.2
buyer_7,María,Valdec,1968-12-31,54502279F,maría.valdec@awesomecloud.com,031005,ES72209544951851809297,6307.96,2024-01-26T14:05:25,Portugalete,expenses,leisure,-41.3,-45417.5
buyer_7,María,Valdec,1968-12-31,54502279F,maría.valdec@awesomecloud.com,031005,ES72209544951851809297,6307.96,2024-01-26T16:21:54,Portugalete,expenses,children,-282.98,-45700.48
buyer_7,María,Valdec,1968-12-31,54502279F,maría.valdec@awesomecloud.com,031005,ES72209544951851809297,6307.96,2024-01-27T15:51:11,Portugalete,expenses,cash,-100.0,-45800.48
buyer_7,María,Valdec,1968-12-31,54502279F,maría.valdec@awesomecloud.com,031005,ES72209544951851809297,6307.96,2024-01-28T10:19:02,Portugalete,expenses,repairs,-104.46,-45904.94
buyer_7,María,Valdec,1968-12-31,54502279F,maría.valdec@awesomecloud.com,031005,ES72209544951851809297,6307.96,2024-01-30T13:34:39,Portugalete,expenses,cash,-100.0,-46004.94
buyer_7,María,Valdec,1968-12-31,54502279F,maría.valdec@awesomecloud.com,031005,ES72209544951851809297,6307.96,2024-01-31T15:28:30,Portugalete,expenses,food,-109.96,-46114.9
buyer_7,María,Valdec,1968-12-31,54502279F,maría.valdec@awesomecloud.com,031005,ES72209544951851809297,6307.96,2024-02-01T18:33:51,Portugalete,incomes,salary,1622.81,-44492.09
buyer_7,María,Valdec,1968-12-31,54502279F,maría.valdec@awesomecloud.com,031005,ES72209544951851809297,6307.96,2024-02-01T04:54:49,Portugalete,expenses,transport,-75.73,-44567.82
buyer_7,María,Valdec,1968-12-31,54502279F,maría.valdec@awesomecloud.com,031005,ES72209544951851809297,6307.96,2024-02-01T12:21:13,Portugalete,expenses,gifts,-205.88,-44773.7
buyer_7,María,Valdec,1968-12-31,54502279F,maría.valdec@awesomecloud.com,031005,ES72209544951851809297,6307.96,2024-02-02T14:47:26,Portugalete,expenses,cash,-100.0,-44873.7
buyer_7,María,Valdec,1968-12-31,54502279F,maría.valdec@awesomecloud.com,031005,ES72209544951851809297,6307.96,2024-02-02T20:43:13,Portugalete,expenses,children,-83.04,-44956.74
buyer_7,María,Valdec,1968-12-31,54502279F,maría.valdec@awesomecloud.com,031005,ES72209544951851809297,6307.96,2024-02-03T20:12:29,Portugalete,expenses,food,-77.35,-45034.09
buyer_7,María,Valdec,1968-12-31,54502279F,maría.valdec@awesomecloud.com,031005,ES72209544951851809297,6307.96,2024-02-03T18:08:52,Portugalete,expenses,travel,-352.55,-45386.64
buyer_7,María,Valdec,1968-12-31,54502279F,maría.valdec@awesomecloud.com,031005,ES72209544951851809297,6307.96,2024-02-04T11:26:27,Portugalete,expenses,mortgage,-630.41,-46017.05
buyer_7,María,Valdec,1968-12-31,54502279F,maría.valdec@awesomecloud.com,031005,ES72209544951851809297,6307.96,2024-02-05T09:03:59,Portugalete,expenses,education,-70.58,-46087.63
buyer_7,María,Valdec,1968-12-31,54502279F,maría.valdec@awesomecloud.com,031005,ES72209544951851809297,6307.96,2024-02-05T19:00:32,Portugalete,expenses,repairs,-220.12,-46307.75
buyer_7,María,Valdec,1968-12-31,54502279F,maría.valdec@awesomecloud.com,031005,ES72209544951851809297,6307.96,2024-02-06T17:20:53,Portugalete,expenses,electricity,-27.83,-46335.58
buyer_7,María,Valdec,1968-12-31,54502279F,maría.valdec@awesomecloud.com,031005,ES72209544951851809297,6307.96,2024-02-07T07:00:40,Portugalete,expenses,water,-27.42,-46363.0
buyer_7,María,Valdec,1968-12-31,54502279F,maría.valdec@awesomecloud.com,031005,ES72209544951851809297,6307.96,2024-02-08T11:32:24,Portugalete,expenses,internet,-34.08,-46397.08
buyer_7,María,Valdec,1968-12-31,54502279F,maría.valdec@awesomecloud.com,031005,ES72209544951851809297,6307.96,2024-02-08T11:02:53,Portugalete,expenses,transport,-45.07,-46442.15
buyer_7,María,Valdec,1968-12-31,54502279F,maría.valdec@awesomecloud.com,031005,ES72209544951851809297,6307.96,2024-02-09T15:11:21,Portugalete,expenses,cash,-100.0,-46542.15
buyer_7,María,Valdec,1968-12-31,54502279F,maría.valdec@awesomecloud.com,031005,ES72209544951851809297,6307.96,2024-02-10T20:53:28,Portugalete,expenses,food,-119.37,-46661.52
buyer_7,María,Valdec,1968-12-31,54502279F,maría.valdec@awesomecloud.com,031005,ES72209544951851809297,6307.96,2024-02-12T14:26:25,Portugalete,expenses,leisure,-49.71,-46711.23
buyer_7,María,Valdec,1968-12-31,54502279F,maría.valdec@awesomecloud.com,031005,ES72209544951851809297,6307.96,2024-02-12T16:19:44,Portugalete,expenses,clothing,-153.28,-46864.51
buyer_7,María,Valdec,1968-12-31,54502279F,maría.valdec@awesomecloud.com,031005,ES72209544951851809297,6307.96,2024-02-12T14:45:10,Portugalete,expenses,appliances,-197.97,-47062.48
buyer_7,María,Valdec,1968-12-31,54502279F,maría.valdec@awesomecloud.com,031005,ES72209544951851809297,6307.96,2024-02-13T18:13:14,Portugalete,expenses,gifts,-208.98,-47271.46
buyer_7,María,Valdec,1968-12-31,54502279F,maría.valdec@awesomecloud.com,031005,ES72209544951851809297,6307.96,2024-02-15T13:10:40,Portugalete,expenses,children,-323.83,-47595.29
buyer_7,María,Valdec,1968-12-31,54502279F,maría.valdec@awesomecloud.com,031005,ES72209544951851809297,6307.96,2024-02-16T18:24:23,Portugalete,expenses,food,-87.35,-47682.64
buyer_7,María,Valdec,1968-12-31,54502279F,maría.valdec@awesomecloud.com,031005,ES72209544951851809297,6307.96,2024-02-17T23:11:31,Portugalete,expenses,transport,-66.91,-47749.55
buyer_7,María,Valdec,1968-12-31,54502279F,maría.valdec@awesomecloud.com,031005,ES72209544951851809297,6307.96,2024-02-17T03:32:03,Portugalete,expenses,leisure,-74.24,-47823.79
buyer_7,María,Valdec,1968-12-31,54502279F,maría.valdec@awesomecloud.com,031005,ES72209544951851809297,6307.96,2024-02-19T16:57:36,Portugalete,expenses,clothing,-95.61,-47919.4
buyer_7,María,Valdec,1968-12-31,54502279F,maría.valdec@awesomecloud.com,031005,ES72209544951851809297,6307.96,2024-02-20T17:35:42,Portugalete,expenses,healthcare,-84.54,-48003.94
buyer_7,María,Valdec,1968-12-31,54502279F,maría.valdec@awesomecloud.com,031005,ES72209544951851809297,6307.96,2024-02-21T21:10:17,Portugalete,expenses,cash,-100.0,-48103.94
buyer_7,María,Valdec,1968-12-31,54502279F,maría.valdec@awesomecloud.com,031005,ES72209544951851809297,6307.96,2024-02-22T02:13:11,Portugalete,expenses,food,-101.0,-48204.94
buyer_7,María,Valdec,1968-12-31,54502279F,maría.valdec@awesomecloud.com,031005,ES72209544951851809297,6307.96,2024-02-22T03:22:09,Portugalete,expenses,appliances,-83.48,-48288.42
buyer_7,María,Valdec,1968-12-31,54502279F,maría.valdec@awesomecloud.com,031005,ES72209544951851809297,6307.96,2024-02-24T18:21:25,Portugalete,expenses,transport,-57.73,-48346.15
buyer_7,María,Valdec,1968-12-31,54502279F,maría.valdec@awesomecloud.com,031005,ES72209544951851809297,6307.96,2024-02-24T15:07:25,Portugalete,expenses,leisure,-38.27,-48384.42
buyer_7,María,Valdec,1968-12-31,54502279F,maría.valdec@awesomecloud.com,031005,ES72209544951851809297,6307.96,2024-03-01T15:39:11,Portugalete,incomes,salary,1622.81,-46761.61
buyer_7,María,Valdec,1968-12-31,54502279F,maría.valdec@awesomecloud.com,031005,ES72209544951851809297,6307.96,2024-03-03T18:39:05,Portugalete,expenses,transport,-82.76,-46844.37
buyer_7,María,Valdec,1968-12-31,54502279F,maría.valdec@awesomecloud.com,031005,ES72209544951851809297,6307.96,2024-03-04T13:23:32,Portugalete,expenses,mortgage,-630.41,-47474.78
buyer_7,María,Valdec,1968-12-31,54502279F,maría.valdec@awesomecloud.com,031005,ES72209544951851809297,6307.96,2024-03-05T19:13:21,Portugalete,expenses,electricity,-49.39,-47524.17
buyer_7,María,Valdec,1968-12-31,54502279F,maría.valdec@awesomecloud.com,031005,ES72209544951851809297,6307.96,2024-03-05T11:33:50,Portugalete,expenses,phone,-30.33,-47554.5
buyer_7,María,Valdec,1968-12-31,54502279F,maría.valdec@awesomecloud.com,031005,ES72209544951851809297,6307.96,2024-03-05T12:42:40,Portugalete,expenses,transport,-89.36,-47643.86
buyer_7,María,Valdec,1968-12-31,54502279F,maría.valdec@awesomecloud.com,031005,ES72209544951851809297,6307.96,2024-03-06T14:46:11,Portugalete,expenses,water,-20.07,-47663.93
buyer_7,María,Valdec,1968-12-31,54502279F,maría.valdec@awesomecloud.com,031005,ES72209544951851809297,6307.96,2024-03-06T17:50:15,Portugalete,expenses,electricity,-45.94,-47709.87
buyer_7,María,Valdec,1968-12-31,54502279F,maría.valdec@awesomecloud.com,031005,ES72209544951851809297,6307.96,2024-03-06T14:43:45,Portugalete,expenses,phone,-35.99,-47745.86
buyer_7,María,Valdec,1968-12-31,54502279F,maría.valdec@awesomecloud.com,031005,ES72209544951851809297,6307.96,2024-03-07T19:07:20,Portugalete,expenses,cash,-100.0,-47845.86
buyer_7,María,Valdec,1968-12-31,54502279F,maría.valdec@awesomecloud.com,031005,ES72209544951851809297,6307.96,2024-03-08T07:54:24,Portugalete,expenses,gas,-39.95,-47885.81
buyer_7,María,Valdec,1968-12-31,54502279F,maría.valdec@awesomecloud.com,031005,ES72209544951851809297,6307.96,2024-03-08T19:47:57,Portugalete,expenses,cash,-100.0,-47985.81
buyer_7,María,Valdec,1968-12-31,54502279F,maría.valdec@awesomecloud.com,031005,ES72209544951851809297,6307.96,2024-03-09T12:53:28,Portugalete,expenses,food,-123.15,-48108.96
buyer_7,María,Valdec,1968-12-31,54502279F,maría.valdec@awesomecloud.com,031005,ES72209544951851809297,6307.96,2024-03-09T20:23:31,Portugalete,expenses,clothing,-90.99,-48199.95
buyer_7,María,Valdec,1968-12-31,54502279F,maría.valdec@awesomecloud.com,031005,ES72209544951851809297,6307.96,2024-03-09T21:00:18,Portugalete,expenses,education,-47.01,-48246.96
buyer_7,María,Valdec,1968-12-31,54502279F,maría.valdec@awesomecloud.com,031005,ES72209544951851809297,6307.96,2024-03-10T10:48:20,Portugalete,expenses,cash,-100.0,-48346.96
buyer_7,María,Valdec,1968-12-31,54502279F,maría.valdec@awesomecloud.com,031005,ES72209544951851809297,6307.96,2024-03-10T18:55:48,Portugalete,expenses,gifts,-128.44,-48475.4
buyer_7,María,Valdec,1968-12-31,54502279F,maría.valdec@awesomecloud.com,031005,ES72209544951851809297,6307.96,2024-03-11T19:58:09,Portugalete,expenses,cash,-100.0,-48575.4
buyer_7,María,Valdec,1968-12-31,54502279F,maría.valdec@awesomecloud.com,031005,ES72209544951851809297,6307.96,2024-03-13T20:55:35,Portugalete,expenses,transport,-78.31,-48653.71
buyer_7,María,Valdec,1968-12-31,54502279F,maría.valdec@awesomecloud.com,031005,ES72209544951851809297,6307.96,2024-03-16T15:27:16,Portugalete,expenses,leisure,-46.97,-48700.68
buyer_7,María,Valdec,1968-12-31,54502279F,maría.valdec@awesomecloud.com,031005,ES72209544951851809297,6307.96,2024-03-17T23:03:02,Portugalete,expenses,food,-99.29,-48799.97
buyer_7,María,Valdec,1968-12-31,54502279F,maría.valdec@awesomecloud.com,031005,ES72209544951851809297,6307.96,2024-03-17T16:37:24,Portugalete,expenses,leisure,-39.39,-48839.36
buyer_7,María,Valdec,1968-12-31,54502279F,maría.valdec@awesomecloud.com,031005,ES72209544951851809297,6307.96,2024-03-17T19:05:46,Portugalete,expenses,clothing,-151.55,-48990.91
buyer_7,María,Valdec,1968-12-31,54502279F,maría.valdec@awesomecloud.com,031005,ES72209544951851809297,6307.96,2024-03-18T21:16:09,Portugalete,expenses,transport,-66.67,-49057.58
buyer_7,María,Valdec,1968-12-31,54502279F,maría.valdec@awesomecloud.com,031005,ES72209544951851809297,6307.96,2024-03-18T18:29:59,Portugalete,expenses,gifts,-348.91,-49406.49
buyer_7,María,Valdec,1968-12-31,54502279F,maría.valdec@awesomecloud.com,031005,ES72209544951851809297,6307.96,2024-03-19T00:23:55,Portugalete,expenses,cash,-100.0,-49506.49
buyer_7,María,Valdec,1968-12-31,54502279F,maría.valdec@awesomecloud.com,031005,ES72209544951851809297,6307.96,2024-03-20T20:15:23,Portugalete,expenses,repairs,-152.97,-49659.46
buyer_7,María,Valdec,1968-12-31,54502279F,maría.valdec@awesomecloud.com,031005,ES72209544951851809297,6307.96,2024-03-21T16:33:33,Portugalete,expenses,appliances,-319.24,-49978.7
buyer_7,María,Valdec,1968-12-31,54502279F,maría.valdec@awesomecloud.com,031005,ES72209544951851809297,6307.96,2024-03-21T09:35:58,Portugalete,expenses,children,-134.24741666666642,-50112.95
buyer_7,María,Valdec,1968-12-31,54502279F,maría.valdec@awesomecloud.com,031005,ES72209544951851809297,6307.96,2024-03-24T19:20:49,Portugalete,expenses,leisure,-58.81,-50171.76
buyer_7,María,Valdec,1968-12-31,54502279F,maría.valdec@awesomecloud.com,031005,ES72209544951851809297,6307.96,2024-03-24T16:04:53,Portugalete,expenses,repairs,-275.91,-50447.67
buyer_7,María,Valdec,1968-12-31,54502279F,maría.valdec@awesomecloud.com,031005,ES72209544951851809297,6307.96,2024-03-25T17:11:38,Portugalete,expenses,food,-84.05,-50531.72
buyer_7,María,Valdec,1968-12-31,54502279F,maría.valdec@awesomecloud.com,031005,ES72209544951851809297,6307.96,2024-03-25T10:19:01,Portugalete,expenses,leisure,-21.71,-50553.43
buyer_7,María,Valdec,1968-12-31,54502279F,maría.valdec@awesomecloud.com,031005,ES72209544951851809297,6307.96,2024-03-26T10:02:23,Portugalete,expenses,cash,-100.0,-50653.43
buyer_7,María,Valdec,1968-12-31,54502279F,maría.valdec@awesomecloud.com,031005,ES72209544951851809297,6307.96,2024-03-26T20:39:36,Portugalete,expenses,children,-119.31,-50772.74
buyer_7,María,Valdec,1968-12-31,54502279F,maría.valdec@awesomecloud.com,031005,ES72209544951851809297,6307.96,2024-03-27T12:53:08,Portugalete,expenses,food,-99.88,-50872.62
buyer_7,María,Valdec,1968-12-31,54502279F,maría.valdec@awesomecloud.com,031005,ES72209544951851809297,6307.96,2024-03-27T09:09:32,Portugalete,expenses,cash,-100.0,-50972.62
buyer_7,María,Valdec,1968-12-31,54502279F,maría.valdec@awesomecloud.com,031005,ES72209544951851809297,6307.96,2024-03-28T13:26:02,Portugalete,expenses,food,-64.05,-51036.67
buyer_7,María,Valdec,1968-12-31,54502279F,maría.valdec@awesomecloud.com,031005,ES72209544951851809297,6307.96,2024-03-29T14:38:34,Portugalete,expenses,food,-102.65,-51139.32
buyer_7,María,Valdec,1968-12-31,54502279F,maría.valdec@awesomecloud.com,031005,ES72209544951851809297,6307.96,2024-03-29T14:38:52,Portugalete,expenses,education,-58.12,-51197.44
buyer_7,María,Valdec,1968-12-31,54502279F,maría.valdec@awesomecloud.com,031005,ES72209544951851809297,6307.96,2024-03-30T13:03:10,Portugalete,expenses,transport,-86.68,-51284.12
buyer_7,María,Valdec,1968-12-31,54502279F,maría.valdec@awesomecloud.com,031005,ES72209544951851809297,6307.96,2024-03-30T15:19:06,Portugalete,expenses,travel,-317.93,-51602.05
buyer_7,María,Valdec,1968-12-31,54502279F,maría.valdec@awesomecloud.com,031005,ES72209544951851809297,6307.96,2024-03-30T13:59:40,Portugalete,expenses,children,-48.87741666666642,-51650.93
buyer_7,María,Valdec,1968-12-31,54502279F,maría.valdec@awesomecloud.com,031005,ES72209544951851809297,6307.96,2024-03-31T19:33:06,Portugalete,expenses,food,-118.27,-51769.2
buyer_7,María,Valdec,1968-12-31,54502279F,maría.valdec@awesomecloud.com,031005,ES72209544951851809297,6307.96,2024-04-01T09:25:42,Portugalete,incomes,salary,1622.81,-50146.39
buyer_7,María,Valdec,1968-12-31,54502279F,maría.valdec@awesomecloud.com,031005,ES72209544951851809297,6307.96,2024-04-01T16:12:10,Portugalete,expenses,food,-67.58,-50213.97
buyer_7,María,Valdec,1968-12-31,54502279F,maría.valdec@awesomecloud.com,031005,ES72209544951851809297,6307.96,2024-04-02T18:34:24,Portugalete,expenses,cash,-100.0,-50313.97
buyer_7,María,Valdec,1968-12-31,54502279F,maría.valdec@awesomecloud.com,031005,ES72209544951851809297,6307.96,2024-04-04T16:47:56,Portugalete,expenses,mortgage,-630.41,-50944.38
buyer_7,María,Valdec,1968-12-31,54502279F,maría.valdec@awesomecloud.com,031005,ES72209544951851809297,6307.96,2024-04-05T11:16:20,Portugalete,expenses,water,-17.68,-50962.06
buyer_7,María,Valdec,1968-12-31,54502279F,maría.valdec@awesomecloud.com,031005,ES72209544951851809297,6307.96,2024-04-07T15:10:40,Portugalete,expenses,electricity,-65.64,-51027.7
buyer_7,María,Valdec,1968-12-31,54502279F,maría.valdec@awesomecloud.com,031005,ES72209544951851809297,6307.96,2024-04-07T10:37:59,Portugalete,expenses,gas,-50.23,-51077.93
buyer_7,María,Valdec,1968-12-31,54502279F,maría.valdec@awesomecloud.com,031005,ES72209544951851809297,6307.96,2024-04-07T08:02:17,Portugalete,expenses,internet,-34.08,-51112.01
buyer_7,María,Valdec,1968-12-31,54502279F,maría.valdec@awesomecloud.com,031005,ES72209544951851809297,6307.96,2024-04-08T08:06:20,Portugalete,expenses,water,-21.38,-51133.39
buyer_7,María,Valdec,1968-12-31,54502279F,maría.valdec@awesomecloud.com,031005,ES72209544951851809297,6307.96,2024-04-08T18:14:11,Portugalete,expenses,phone,-33.62,-51167.01
buyer_7,María,Valdec,1968-12-31,54502279F,maría.valdec@awesomecloud.com,031005,ES72209544951851809297,6307.96,2024-04-08T18:20:38,Portugalete,expenses,transport,-44.64,-51211.65
buyer_7,María,Valdec,1968-12-31,54502279F,maría.valdec@awesomecloud.com,031005,ES72209544951851809297,6307.96,2024-04-09T10:23:20,Portugalete,expenses,leisure,-32.12,-51243.77
buyer_7,María,Valdec,1968-12-31,54502279F,maría.valdec@awesomecloud.com,031005,ES72209544951851809297,6307.96,2024-04-09T10:45:29,Portugalete,expenses,education,-61.9,-51305.67
buyer_7,María,Valdec,1968-12-31,54502279F,maría.valdec@awesomecloud.com,031005,ES72209544951851809297,6307.96,2024-04-09T17:59:24,Portugalete,expenses,cash,-100.0,-51405.67
buyer_7,María,Valdec,1968-12-31,54502279F,maría.valdec@awesomecloud.com,031005,ES72209544951851809297,6307.96,2024-04-13T18:40:55,Portugalete,expenses,education,-75.36,-51481.03
buyer_7,María,Valdec,1968-12-31,54502279F,maría.valdec@awesomecloud.com,031005,ES72209544951851809297,6307.96,2024-04-15T15:25:28,Portugalete,expenses,healthcare,-114.39,-51595.42
buyer_7,María,Valdec,1968-12-31,54502279F,maría.valdec@awesomecloud.com,031005,ES72209544951851809297,6307.96,2024-04-15T12:36:30,Portugalete,expenses,cash,-100.0,-51695.42
buyer_7,María,Valdec,1968-12-31,54502279F,maría.valdec@awesomecloud.com,031005,ES72209544951851809297,6307.96,2024-04-16T15:04:40,Portugalete,expenses,leisure,-64.36,-51759.78
buyer_7,María,Valdec,1968-12-31,54502279F,maría.valdec@awesomecloud.com,031005,ES72209544951851809297,6307.96,2024-04-16T08:53:10,Portugalete,expenses,cash,-100.0,-51859.78
buyer_7,María,Valdec,1968-12-31,54502279F,maría.valdec@awesomecloud.com,031005,ES72209544951851809297,6307.96,2024-04-16T17:47:47,Portugalete,expenses,appliances,-268.44,-52128.22
buyer_7,María,Valdec,1968-12-31,54502279F,maría.valdec@awesomecloud.com,031005,ES72209544951851809297,6307.96,2024-04-17T20:25:19,Portugalete,expenses,repairs,-178.43,-52306.65
buyer_7,María,Valdec,1968-12-31,54502279F,maría.valdec@awesomecloud.com,031005,ES72209544951851809297,6307.96,2024-04-18T18:47:17,Portugalete,expenses,cash,-100.0,-52406.65
buyer_7,María,Valdec,1968-12-31,54502279F,maría.valdec@awesomecloud.com,031005,ES72209544951851809297,6307.96,2024-04-19T09:19:51,Portugalete,expenses,education,-53.44,-52460.09
buyer_7,María,Valdec,1968-12-31,54502279F,maría.valdec@awesomecloud.com,031005,ES72209544951851809297,6307.96,2024-04-19T10:36:58,Portugalete,expenses,repairs,-35.21,-52495.3
buyer_7,María,Valdec,1968-12-31,54502279F,maría.valdec@awesomecloud.com,031005,ES72209544951851809297,6307.96,2024-04-21T16:09:38,Portugalete,expenses,food,-78.2,-52573.5
buyer_7,María,Valdec,1968-12-31,54502279F,maría.valdec@awesomecloud.com,031005,ES72209544951851809297,6307.96,2024-04-21T18:11:34,Portugalete,expenses,cash,-100.0,-52673.5
buyer_7,María,Valdec,1968-12-31,54502279F,maría.valdec@awesomecloud.com,031005,ES72209544951851809297,6307.96,2024-04-22T17:39:55,Portugalete,expenses,leisure,-31.5,-52705.0
buyer_7,María,Valdec,1968-12-31,54502279F,maría.valdec@awesomecloud.com,031005,ES72209544951851809297,6307.96,2024-04-22T11:49:28,Portugalete,expenses,clothing,-77.44,-52782.44
buyer_7,María,Valdec,1968-12-31,54502279F,maría.valdec@awesomecloud.com,031005,ES72209544951851809297,6307.96,2024-04-23T16:13:27,Portugalete,expenses,transport,-54.73,-52837.17
buyer_7,María,Valdec,1968-12-31,54502279F,maría.valdec@awesomecloud.com,031005,ES72209544951851809297,6307.96,2024-04-26T13:37:46,Portugalete,expenses,clothing,-151.48,-52988.65
buyer_7,María,Valdec,1968-12-31,54502279F,maría.valdec@awesomecloud.com,031005,ES72209544951851809297,6307.96,2024-04-27T17:16:44,Portugalete,expenses,leisure,-41.15,-53029.8
buyer_7,María,Valdec,1968-12-31,54502279F,maría.valdec@awesomecloud.com,031005,ES72209544951851809297,6307.96,2024-05-01T10:37:41,Portugalete,incomes,salary,1622.81,-51406.99
buyer_7,María,Valdec,1968-12-31,54502279F,maría.valdec@awesomecloud.com,031005,ES72209544951851809297,6307.96,2024-05-01T10:37:41,Portugalete,incomes,extra_income,219.04,-51187.95
buyer_7,María,Valdec,1968-12-31,54502279F,maría.valdec@awesomecloud.com,031005,ES72209544951851809297,6307.96,2024-05-02T12:07:46,Portugalete,expenses,cash,-100.0,-51287.95
buyer_7,María,Valdec,1968-12-31,54502279F,maría.valdec@awesomecloud.com,031005,ES72209544951851809297,6307.96,2024-05-02T10:20:02,Portugalete,expenses,children,-201.73,-51489.68
buyer_7,María,Valdec,1968-12-31,54502279F,maría.valdec@awesomecloud.com,031005,ES72209544951851809297,6307.96,2024-05-04T13:07:14,Portugalete,expenses,mortgage,-630.41,-52120.09
buyer_7,María,Valdec,1968-12-31,54502279F,maría.valdec@awesomecloud.com,031005,ES72209544951851809297,6307.96,2024-05-04T01:48:19,Portugalete,expenses,transport,-78.71,-52198.8
buyer_7,María,Valdec,1968-12-31,54502279F,maría.valdec@awesomecloud.com,031005,ES72209544951851809297,6307.96,2024-05-05T12:39:05,Portugalete,expenses,gas,-48.61,-52247.41
buyer_7,María,Valdec,1968-12-31,54502279F,maría.valdec@awesomecloud.com,031005,ES72209544951851809297,6307.96,2024-05-06T14:49:56,Portugalete,expenses,water,-24.85,-52272.26
buyer_7,María,Valdec,1968-12-31,54502279F,maría.valdec@awesomecloud.com,031005,ES72209544951851809297,6307.96,2024-05-06T08:39:42,Portugalete,expenses,internet,-34.08,-52306.34
buyer_7,María,Valdec,1968-12-31,54502279F,maría.valdec@awesomecloud.com,031005,ES72209544951851809297,6307.96,2024-05-06T20:00:14,Portugalete,expenses,transport,-82.86,-52389.2
buyer_7,María,Valdec,1968-12-31,54502279F,maría.valdec@awesomecloud.com,031005,ES72209544951851809297,6307.96,2024-05-06T12:19:06,Portugalete,expenses,repairs,-80.37,-52469.57
buyer_7,María,Valdec,1968-12-31,54502279F,maría.valdec@awesomecloud.com,031005,ES72209544951851809297,6307.96,2024-05-07T22:28:25,Portugalete,expenses,water,-19.79,-52489.36
buyer_7,María,Valdec,1968-12-31,54502279F,maría.valdec@awesomecloud.com,031005,ES72209544951851809297,6307.96,2024-05-07T08:37:44,Portugalete,expenses,electricity,-67.15,-52556.51
buyer_7,María,Valdec,1968-12-31,54502279F,maría.valdec@awesomecloud.com,031005,ES72209544951851809297,6307.96,2024-05-08T14:12:19,Portugalete,expenses,gas,-74.19,-52630.7
buyer_7,María,Valdec,1968-12-31,54502279F,maría.valdec@awesomecloud.com,031005,ES72209544951851809297,6307.96,2024-05-08T06:58:58,Portugalete,expenses,internet,-34.08,-52664.78
buyer_7,María,Valdec,1968-12-31,54502279F,maría.valdec@awesomecloud.com,031005,ES72209544951851809297,6307.96,2024-05-08T08:52:33,Portugalete,expenses,phone,-28.15,-52692.93
buyer_7,María,Valdec,1968-12-31,54502279F,maría.valdec@awesomecloud.com,031005,ES72209544951851809297,6307.96,2024-05-08T22:08:46,Portugalete,expenses,gifts,-351.54,-53044.47
buyer_7,María,Valdec,1968-12-31,54502279F,maría.valdec@awesomecloud.com,031005,ES72209544951851809297,6307.96,2024-05-10T13:54:04,Portugalete,expenses,cash,-100.0,-53144.47
buyer_7,María,Valdec,1968-12-31,54502279F,maría.valdec@awesomecloud.com,031005,ES72209544951851809297,6307.96,2024-05-12T09:39:00,Portugalete,expenses,cash,-100.0,-53244.47
buyer_7,María,Valdec,1968-12-31,54502279F,maría.valdec@awesomecloud.com,031005,ES72209544951851809297,6307.96,2024-05-13T18:19:42,Portugalete,expenses,transport,-49.34,-53293.81
buyer_7,María,Valdec,1968-12-31,54502279F,maría.valdec@awesomecloud.com,031005,ES72209544951851809297,6307.96,2024-05-13T17:17:17,Portugalete,expenses,gifts,-340.61,-53634.42
buyer_7,María,Valdec,1968-12-31,54502279F,maría.valdec@awesomecloud.com,031005,ES72209544951851809297,6307.96,2024-05-16T08:09:22,Portugalete,expenses,transport,-51.7,-53686.12
buyer_7,María,Valdec,1968-12-31,54502279F,maría.valdec@awesomecloud.com,031005,ES72209544951851809297,6307.96,2024-05-17T09:05:59,Portugalete,expenses,cash,-100.0,-53786.12
buyer_7,María,Valdec,1968-12-31,54502279F,maría.valdec@awesomecloud.com,031005,ES72209544951851809297,6307.96,2024-05-17T12:24:21,Portugalete,expenses,gifts,-334.31,-54120.43
buyer_7,María,Valdec,1968-12-31,54502279F,maría.valdec@awesomecloud.com,031005,ES72209544951851809297,6307.96,2024-05-18T17:10:32,Portugalete,expenses,appliances,-182.8,-54303.23
buyer_7,María,Valdec,1968-12-31,54502279F,maría.valdec@awesomecloud.com,031005,ES72209544951851809297,6307.96,2024-05-19T15:37:39,Portugalete,expenses,leisure,-32.2,-54335.43
buyer_7,María,Valdec,1968-12-31,54502279F,maría.valdec@awesomecloud.com,031005,ES72209544951851809297,6307.96,2024-05-20T15:27:35,Portugalete,expenses,gifts,-91.98,-54427.41
buyer_7,María,Valdec,1968-12-31,54502279F,maría.valdec@awesomecloud.com,031005,ES72209544951851809297,6307.96,2024-05-21T10:25:32,Portugalete,expenses,food,-89.15,-54516.56
buyer_7,María,Valdec,1968-12-31,54502279F,maría.valdec@awesomecloud.com,031005,ES72209544951851809297,6307.96,2024-05-22T14:09:14,Portugalete,expenses,leisure,-56.37,-54572.93
buyer_7,María,Valdec,1968-12-31,54502279F,maría.valdec@awesomecloud.com,031005,ES72209544951851809297,6307.96,2024-05-22T01:34:39,Portugalete,expenses,cash,-100.0,-54672.93
buyer_7,María,Valdec,1968-12-31,54502279F,maría.valdec@awesomecloud.com,031005,ES72209544951851809297,6307.96,2024-05-22T18:22:05,Portugalete,expenses,gifts,-83.94,-54756.87
buyer_7,María,Valdec,1968-12-31,54502279F,maría.valdec@awesomecloud.com,031005,ES72209544951851809297,6307.96,2024-05-23T10:33:02,Portugalete,expenses,food,-72.01,-54828.88
buyer_7,María,Valdec,1968-12-31,54502279F,maría.valdec@awesomecloud.com,031005,ES72209544951851809297,6307.96,2024-05-25T22:46:11,Portugalete,expenses,food,-109.95,-54938.83
buyer_7,María,Valdec,1968-12-31,54502279F,maría.valdec@awesomecloud.com,031005,ES72209544951851809297,6307.96,2024-05-25T20:46:21,Portugalete,expenses,gifts,-70.42,-55009.25
buyer_7,María,Valdec,1968-12-31,54502279F,maría.valdec@awesomecloud.com,031005,ES72209544951851809297,6307.96,2024-05-26T18:21:28,Portugalete,expenses,food,-84.36,-55093.61
buyer_7,María,Valdec,1968-12-31,54502279F,maría.valdec@awesomecloud.com,031005,ES72209544951851809297,6307.96,2024-05-29T14:24:18,Portugalete,expenses,leisure,-31.96,-55125.57
buyer_7,María,Valdec,1968-12-31,54502279F,maría.valdec@awesomecloud.com,031005,ES72209544951851809297,6307.96,2024-05-31T13:25:39,Portugalete,expenses,food,-87.02,-55212.59
buyer_7,María,Valdec,1968-12-31,54502279F,maría.valdec@awesomecloud.com,031005,ES72209544951851809297,6307.96,2024-05-31T19:39:51,Portugalete,expenses,clothing,-49.96,-55262.55
buyer_7,María,Valdec,1968-12-31,54502279F,maría.valdec@awesomecloud.com,031005,ES72209544951851809297,6307.96,2024-06-01T11:08:51,Portugalete,incomes,salary,1622.81,-53639.74
buyer_7,María,Valdec,1968-12-31,54502279F,maría.valdec@awesomecloud.com,031005,ES72209544951851809297,6307.96,2024-06-01T11:08:51,Portugalete,incomes,salary_bonus,1220.16,-52419.58
buyer_7,María,Valdec,1968-12-31,54502279F,maría.valdec@awesomecloud.com,031005,ES72209544951851809297,6307.96,2024-06-01T08:51:53,Portugalete,expenses,food,-80.93,-52500.51
buyer_7,María,Valdec,1968-12-31,54502279F,maría.valdec@awesomecloud.com,031005,ES72209544951851809297,6307.96,2024-06-01T10:52:13,Portugalete,expenses,repairs,-28.74,-52529.25
buyer_7,María,Valdec,1968-12-31,54502279F,maría.valdec@awesomecloud.com,031005,ES72209544951851809297,6307.96,2024-06-02T16:16:42,Portugalete,expenses,taxes,-1228.93,-53758.18
buyer_7,María,Valdec,1968-12-31,54502279F,maría.valdec@awesomecloud.com,031005,ES72209544951851809297,6307.96,2024-06-02T13:14:02,Portugalete,expenses,insurance,-254.98,-54013.16
buyer_7,María,Valdec,1968-12-31,54502279F,maría.valdec@awesomecloud.com,031005,ES72209544951851809297,6307.96,2024-06-03T17:09:01,Portugalete,expenses,gifts,-255.56,-54268.72
buyer_7,María,Valdec,1968-12-31,54502279F,maría.valdec@awesomecloud.com,031005,ES72209544951851809297,6307.96,2024-06-04T10:13:00,Portugalete,expenses,mortgage,-630.41,-54899.13
buyer_7,María,Valdec,1968-12-31,54502279F,maría.valdec@awesomecloud.com,031005,ES72209544951851809297,6307.96,2024-06-04T19:59:26,Portugalete,expenses,clothing,-103.52,-55002.65
buyer_7,María,Valdec,1968-12-31,54502279F,maría.valdec@awesomecloud.com,031005,ES72209544951851809297,6307.96,2024-06-05T17:35:35,Portugalete,expenses,water,-21.17,-55023.82
buyer_7,María,Valdec,1968-12-31,54502279F,maría.valdec@awesomecloud.com,031005,ES72209544951851809297,6307.96,2024-06-05T15:39:20,Portugalete,expenses,electricity,-38.38,-55062.2
buyer_7,María,Valdec,1968-12-31,54502279F,maría.valdec@awesomecloud.com,031005,ES72209544951851809297,6307.96,2024-06-05T09:37:20,Portugalete,expenses,gas,-82.57,-55144.77
buyer_7,María,Valdec,1968-12-31,54502279F,maría.valdec@awesomecloud.com,031005,ES72209544951851809297,6307.96,2024-06-06T14:52:45,Portugalete,expenses,water,-17.81,-55162.58
buyer_7,María,Valdec,1968-12-31,54502279F,maría.valdec@awesomecloud.com,031005,ES72209544951851809297,6307.96,2024-06-06T10:50:42,Portugalete,expenses,internet,-34.08,-55196.66
buyer_7,María,Valdec,1968-12-31,54502279F,maría.valdec@awesomecloud.com,031005,ES72209544951851809297,6307.96,2024-06-06T16:48:49,Portugalete,expenses,leisure,-21.04,-55217.7
buyer_7,María,Valdec,1968-12-31,54502279F,maría.valdec@awesomecloud.com,031005,ES72209544951851809297,6307.96,2024-06-07T12:37:59,Portugalete,expenses,gas,-73.13,-55290.83
buyer_7,María,Valdec,1968-12-31,54502279F,maría.valdec@awesomecloud.com,031005,ES72209544951851809297,6307.96,2024-06-08T20:31:11,Portugalete,expenses,gas,-82.49,-55373.32
buyer_7,María,Valdec,1968-12-31,54502279F,maría.valdec@awesomecloud.com,031005,ES72209544951851809297,6307.96,2024-06-08T18:04:44,Portugalete,expenses,food,-123.25,-55496.57
buyer_7,María,Valdec,1968-12-31,54502279F,maría.valdec@awesomecloud.com,031005,ES72209544951851809297,6307.96,2024-06-09T16:05:14,Portugalete,expenses,transport,-89.47,-55586.04
buyer_7,María,Valdec,1968-12-31,54502279F,maría.valdec@awesomecloud.com,031005,ES72209544951851809297,6307.96,2024-06-09T20:34:33,Portugalete,expenses,leisure,-20.37,-55606.41
buyer_7,María,Valdec,1968-12-31,54502279F,maría.valdec@awesomecloud.com,031005,ES72209544951851809297,6307.96,2024-06-10T11:40:42,Portugalete,expenses,leisure,-60.56,-55666.97
buyer_7,María,Valdec,1968-12-31,54502279F,maría.valdec@awesomecloud.com,031005,ES72209544951851809297,6307.96,2024-06-11T11:08:32,Portugalete,expenses,repairs,-42.04,-55709.01
buyer_7,María,Valdec,1968-12-31,54502279F,maría.valdec@awesomecloud.com,031005,ES72209544951851809297,6307.96,2024-06-11T16:39:16,Portugalete,expenses,gifts,-71.68,-55780.69
buyer_7,María,Valdec,1968-12-31,54502279F,maría.valdec@awesomecloud.com,031005,ES72209544951851809297,6307.96,2024-06-12T15:37:32,Portugalete,expenses,cash,-100.0,-55880.69
buyer_7,María,Valdec,1968-12-31,54502279F,maría.valdec@awesomecloud.com,031005,ES72209544951851809297,6307.96,2024-06-13T19:27:40,Portugalete,expenses,transport,-41.26,-55921.95
buyer_7,María,Valdec,1968-12-31,54502279F,maría.valdec@awesomecloud.com,031005,ES72209544951851809297,6307.96,2024-06-13T05:23:10,Portugalete,expenses,cash,-100.0,-56021.95
buyer_7,María,Valdec,1968-12-31,54502279F,maría.valdec@awesomecloud.com,031005,ES72209544951851809297,6307.96,2024-06-15T13:59:29,Portugalete,expenses,cash,-100.0,-56121.95
buyer_7,María,Valdec,1968-12-31,54502279F,maría.valdec@awesomecloud.com,031005,ES72209544951851809297,6307.96,2024-06-16T19:57:53,Portugalete,expenses,transport,-80.34,-56202.29
buyer_7,María,Valdec,1968-12-31,54502279F,maría.valdec@awesomecloud.com,031005,ES72209544951851809297,6307.96,2024-06-17T09:53:36,Portugalete,expenses,children,-110.92,-56313.21
buyer_7,María,Valdec,1968-12-31,54502279F,maría.valdec@awesomecloud.com,031005,ES72209544951851809297,6307.96,2024-06-18T05:18:51,Portugalete,expenses,transport,-53.87,-56367.08
buyer_7,María,Valdec,1968-12-31,54502279F,maría.valdec@awesomecloud.com,031005,ES72209544951851809297,6307.96,2024-06-18T12:20:12,Portugalete,expenses,cash,-100.0,-56467.08
buyer_7,María,Valdec,1968-12-31,54502279F,maría.valdec@awesomecloud.com,031005,ES72209544951851809297,6307.96,2024-06-19T12:03:10,Portugalete,expenses,repairs,-266.02,-56733.1
buyer_7,María,Valdec,1968-12-31,54502279F,maría.valdec@awesomecloud.com,031005,ES72209544951851809297,6307.96,2024-06-20T10:45:34,Portugalete,expenses,travel,-384.96,-57118.06
buyer_7,María,Valdec,1968-12-31,54502279F,maría.valdec@awesomecloud.com,031005,ES72209544951851809297,6307.96,2024-06-22T15:33:22,Portugalete,expenses,leisure,-29.96,-57148.02
buyer_7,María,Valdec,1968-12-31,54502279F,maría.valdec@awesomecloud.com,031005,ES72209544951851809297,6307.96,2024-06-22T18:19:18,Portugalete,expenses,cash,-100.0,-57248.02
buyer_7,María,Valdec,1968-12-31,54502279F,maría.valdec@awesomecloud.com,031005,ES72209544951851809297,6307.96,2024-06-24T11:46:24,Portugalete,expenses,cash,-100.0,-57348.02
buyer_7,María,Valdec,1968-12-31,54502279F,maría.valdec@awesomecloud.com,031005,ES72209544951851809297,6307.96,2024-06-25T16:53:22,Portugalete,expenses,food,-108.89,-57456.91
buyer_7,María,Valdec,1968-12-31,54502279F,maría.valdec@awesomecloud.com,031005,ES72209544951851809297,6307.96,2024-06-25T12:17:24,Portugalete,expenses,transport,-60.53,-57517.44
buyer_7,María,Valdec,1968-12-31,54502279F,maría.valdec@awesomecloud.com,031005,ES72209544951851809297,6307.96,2024-06-25T21:21:59,Portugalete,expenses,cash,-100.0,-57617.44
buyer_7,María,Valdec,1968-12-31,54502279F,maría.valdec@awesomecloud.com,031005,ES72209544951851809297,6307.96,2024-06-26T22:41:39,Portugalete,expenses,transport,-70.52,-57687.96
buyer_7,María,Valdec,1968-12-31,54502279F,maría.valdec@awesomecloud.com,031005,ES72209544951851809297,6307.96,2024-06-26T08:38:34,Portugalete,expenses,repairs,-307.6,-57995.56
buyer_7,María,Valdec,1968-12-31,54502279F,maría.valdec@awesomecloud.com,031005,ES72209544951851809297,6307.96,2024-06-27T21:46:11,Portugalete,expenses,transport,-47.2,-58042.76
buyer_7,María,Valdec,1968-12-31,54502279F,maría.valdec@awesomecloud.com,031005,ES72209544951851809297,6307.96,2024-06-27T12:58:36,Portugalete,expenses,cash,-100.0,-58142.76
buyer_7,María,Valdec,1968-12-31,54502279F,maría.valdec@awesomecloud.com,031005,ES72209544951851809297,6307.96,2024-06-27T11:03:12,Portugalete,expenses,repairs,-207.03,-58349.79
buyer_7,María,Valdec,1968-12-31,54502279F,maría.valdec@awesomecloud.com,031005,ES72209544951851809297,6307.96,2024-06-28T20:33:50,Portugalete,expenses,cash,-100.0,-58449.79
buyer_7,María,Valdec,1968-12-31,54502279F,maría.valdec@awesomecloud.com,031005,ES72209544951851809297,6307.96,2024-07-01T20:31:59,Portugalete,incomes,salary,1622.81,-56826.98
buyer_7,María,Valdec,1968-12-31,54502279F,maría.valdec@awesomecloud.com,031005,ES72209544951851809297,6307.96,2024-07-02T12:43:27,Portugalete,expenses,transport,-86.05,-56913.03
buyer_7,María,Valdec,1968-12-31,54502279F,maría.valdec@awesomecloud.com,031005,ES72209544951851809297,6307.96,2024-07-03T15:16:57,Portugalete,expenses,appliances,-270.35,-57183.38
buyer_7,María,Valdec,1968-12-31,54502279F,maría.valdec@awesomecloud.com,031005,ES72209544951851809297,6307.96,2024-07-04T17:11:43,Portugalete,expenses,mortgage,-630.41,-57813.79
buyer_7,María,Valdec,1968-12-31,54502279F,maría.valdec@awesomecloud.com,031005,ES72209544951851809297,6307.96,2024-07-04T04:26:31,Portugalete,expenses,travel,-383.91,-58197.7
buyer_7,María,Valdec,1968-12-31,54502279F,maría.valdec@awesomecloud.com,031005,ES72209544951851809297,6307.96,2024-07-05T09:29:27,Portugalete,expenses,electricity,-35.35,-58233.05
buyer_7,María,Valdec,1968-12-31,54502279F,maría.valdec@awesomecloud.com,031005,ES72209544951851809297,6307.96,2024-07-05T22:03:49,Portugalete,expenses,phone,-34.36,-58267.41
buyer_7,María,Valdec,1968-12-31,54502279F,maría.valdec@awesomecloud.com,031005,ES72209544951851809297,6307.96,2024-07-06T20:46:36,Portugalete,expenses,phone,-26.1,-58293.51
buyer_7,María,Valdec,1968-12-31,54502279F,maría.valdec@awesomecloud.com,031005,ES72209544951851809297,6307.96,2024-07-07T09:33:09,Portugalete,expenses,internet,-34.08,-58327.59
buyer_7,María,Valdec,1968-12-31,54502279F,maría.valdec@awesomecloud.com,031005,ES72209544951851809297,6307.96,2024-07-07T13:04:49,Portugalete,expenses,phone,-35.78,-58363.37
buyer_7,María,Valdec,1968-12-31,54502279F,maría.valdec@awesomecloud.com,031005,ES72209544951851809297,6307.96,2024-07-08T09:58:12,Portugalete,expenses,repairs,-167.21,-58530.58
buyer_7,María,Valdec,1968-12-31,54502279F,maría.valdec@awesomecloud.com,031005,ES72209544951851809297,6307.96,2024-07-10T11:15:51,Portugalete,expenses,clothing,-149.81,-58680.39
buyer_7,María,Valdec,1968-12-31,54502279F,maría.valdec@awesomecloud.com,031005,ES72209544951851809297,6307.96,2024-07-10T22:50:22,Portugalete,expenses,cash,-100.0,-58780.39
buyer_7,María,Valdec,1968-12-31,54502279F,maría.valdec@awesomecloud.com,031005,ES72209544951851809297,6307.96,2024-07-12T12:15:28,Portugalete,expenses,children,-387.19,-59167.58
buyer_7,María,Valdec,1968-12-31,54502279F,maría.valdec@awesomecloud.com,031005,ES72209544951851809297,6307.96,2024-07-14T18:02:46,Portugalete,expenses,leisure,-70.61,-59238.19
buyer_7,María,Valdec,1968-12-31,54502279F,maría.valdec@awesomecloud.com,031005,ES72209544951851809297,6307.96,2024-07-14T17:35:40,Portugalete,expenses,cash,-100.0,-59338.19
buyer_7,María,Valdec,1968-12-31,54502279F,maría.valdec@awesomecloud.com,031005,ES72209544951851809297,6307.96,2024-07-16T20:06:58,Portugalete,expenses,cash,-100.0,-59438.19
buyer_7,María,Valdec,1968-12-31,54502279F,maría.valdec@awesomecloud.com,031005,ES72209544951851809297,6307.96,2024-07-19T08:47:03,Portugalete,expenses,food,-90.23,-59528.42
buyer_7,María,Valdec,1968-12-31,54502279F,maría.valdec@awesomecloud.com,031005,ES72209544951851809297,6307.96,2024-07-19T17:56:06,Portugalete,expenses,transport,-79.31,-59607.73
buyer_7,María,Valdec,1968-12-31,54502279F,maría.valdec@awesomecloud.com,031005,ES72209544951851809297,6307.96,2024-07-19T09:42:11,Portugalete,expenses,cash,-100.0,-59707.73
buyer_7,María,Valdec,1968-12-31,54502279F,maría.valdec@awesomecloud.com,031005,ES72209544951851809297,6307.96,2024-07-22T20:48:49,Portugalete,expenses,food,-60.34,-59768.07
buyer_7,María,Valdec,1968-12-31,54502279F,maría.valdec@awesomecloud.com,031005,ES72209544951851809297,6307.96,2024-07-22T13:12:00,Portugalete,expenses,healthcare,-78.72,-59846.79
buyer_7,María,Valdec,1968-12-31,54502279F,maría.valdec@awesomecloud.com,031005,ES72209544951851809297,6307.96,2024-07-28T19:43:17,Portugalete,expenses,cash,-100.0,-59946.79
buyer_7,María,Valdec,1968-12-31,54502279F,maría.valdec@awesomecloud.com,031005,ES72209544951851809297,6307.96,2024-07-29T15:56:37,Portugalete,expenses,cash,-100.0,-60046.79
buyer_7,María,Valdec,1968-12-31,54502279F,maría.valdec@awesomecloud.com,031005,ES72209544951851809297,6307.96,2024-07-29T08:55:48,Portugalete,expenses,repairs,-85.98,-60132.77
buyer_7,María,Valdec,1968-12-31,54502279F,maría.valdec@awesomecloud.com,031005,ES72209544951851809297,6307.96,2024-07-30T17:48:54,Portugalete,expenses,clothing,-126.01,-60258.78
buyer_7,María,Valdec,1968-12-31,54502279F,maría.valdec@awesomecloud.com,031005,ES72209544951851809297,6307.96,2024-07-31T13:27:55,Portugalete,expenses,leisure,-44.83,-60303.61
buyer_7,María,Valdec,1968-12-31,54502279F,maría.valdec@awesomecloud.com,031005,ES72209544951851809297,6307.96,2024-08-01T15:13:10,Portugalete,incomes,salary,1622.81,-58680.8
buyer_7,María,Valdec,1968-12-31,54502279F,maría.valdec@awesomecloud.com,031005,ES72209544951851809297,6307.96,2024-08-01T15:13:10,Portugalete,incomes,extra_income,219.04,-58461.76
buyer_7,María,Valdec,1968-12-31,54502279F,maría.valdec@awesomecloud.com,031005,ES72209544951851809297,6307.96,2024-08-01T13:07:20,Portugalete,expenses,food,-103.43,-58565.19
buyer_7,María,Valdec,1968-12-31,54502279F,maría.valdec@awesomecloud.com,031005,ES72209544951851809297,6307.96,2024-08-02T19:09:26,Portugalete,expenses,food,-123.17,-58688.36
buyer_7,María,Valdec,1968-12-31,54502279F,maría.valdec@awesomecloud.com,031005,ES72209544951851809297,6307.96,2024-08-04T17:06:04,Portugalete,expenses,mortgage,-630.41,-59318.77
buyer_7,María,Valdec,1968-12-31,54502279F,maría.valdec@awesomecloud.com,031005,ES72209544951851809297,6307.96,2024-08-04T15:02:33,Portugalete,expenses,transport,-58.64,-59377.41
buyer_7,María,Valdec,1968-12-31,54502279F,maría.valdec@awesomecloud.com,031005,ES72209544951851809297,6307.96,2024-08-05T12:27:26,Portugalete,expenses,internet,-34.08,-59411.49
buyer_7,María,Valdec,1968-12-31,54502279F,maría.valdec@awesomecloud.com,031005,ES72209544951851809297,6307.96,2024-08-06T09:14:21,Portugalete,expenses,electricity,-38.71,-59450.2
buyer_7,María,Valdec,1968-12-31,54502279F,maría.valdec@awesomecloud.com,031005,ES72209544951851809297,6307.96,2024-08-06T22:02:38,Portugalete,expenses,phone,-31.15,-59481.35
buyer_7,María,Valdec,1968-12-31,54502279F,maría.valdec@awesomecloud.com,031005,ES72209544951851809297,6307.96,2024-08-07T19:24:24,Portugalete,expenses,food,-105.15,-59586.5
buyer_7,María,Valdec,1968-12-31,54502279F,maría.valdec@awesomecloud.com,031005,ES72209544951851809297,6307.96,2024-08-07T09:47:59,Portugalete,expenses,gifts,-77.65,-59664.15
buyer_7,María,Valdec,1968-12-31,54502279F,maría.valdec@awesomecloud.com,031005,ES72209544951851809297,6307.96,2024-08-08T15:35:24,Portugalete,expenses,internet,-34.08,-59698.23
buyer_7,María,Valdec,1968-12-31,54502279F,maría.valdec@awesomecloud.com,031005,ES72209544951851809297,6307.96,2024-08-08T13:28:19,Portugalete,expenses,phone,-33.0,-59731.23
buyer_7,María,Valdec,1968-12-31,54502279F,maría.valdec@awesomecloud.com,031005,ES72209544951851809297,6307.96,2024-08-08T11:27:28,Portugalete,expenses,leisure,-63.37,-59794.6
buyer_7,María,Valdec,1968-12-31,54502279F,maría.valdec@awesomecloud.com,031005,ES72209544951851809297,6307.96,2024-08-10T15:04:59,Portugalete,expenses,leisure,-57.98,-59852.58
buyer_7,María,Valdec,1968-12-31,54502279F,maría.valdec@awesomecloud.com,031005,ES72209544951851809297,6307.96,2024-08-10T12:14:38,Portugalete,expenses,cash,-100.0,-59952.58
buyer_7,María,Valdec,1968-12-31,54502279F,maría.valdec@awesomecloud.com,031005,ES72209544951851809297,6307.96,2024-08-11T19:01:54,Portugalete,expenses,food,-118.73,-60071.31
buyer_7,María,Valdec,1968-12-31,54502279F,maría.valdec@awesomecloud.com,031005,ES72209544951851809297,6307.96,2024-08-11T16:52:39,Portugalete,expenses,transport,-86.35,-60157.66
buyer_7,María,Valdec,1968-12-31,54502279F,maría.valdec@awesomecloud.com,031005,ES72209544951851809297,6307.96,2024-08-12T20:01:48,Portugalete,expenses,education,-48.93,-60206.59
buyer_7,María,Valdec,1968-12-31,54502279F,maría.valdec@awesomecloud.com,031005,ES72209544951851809297,6307.96,2024-08-12T14:58:04,Portugalete,expenses,cash,-100.0,-60306.59
buyer_7,María,Valdec,1968-12-31,54502279F,maría.valdec@awesomecloud.com,031005,ES72209544951851809297,6307.96,2024-08-14T14:59:12,Portugalete,expenses,gifts,-410.58,-60717.17
buyer_7,María,Valdec,1968-12-31,54502279F,maría.valdec@awesomecloud.com,031005,ES72209544951851809297,6307.96,2024-08-15T12:56:44,Portugalete,expenses,cash,-100.0,-60817.17
buyer_7,María,Valdec,1968-12-31,54502279F,maría.valdec@awesomecloud.com,031005,ES72209544951851809297,6307.96,2024-08-15T17:15:31,Portugalete,expenses,gifts,-181.75,-60998.92
buyer_7,María,Valdec,1968-12-31,54502279F,maría.valdec@awesomecloud.com,031005,ES72209544951851809297,6307.96,2024-08-16T20:44:48,Portugalete,expenses,transport,-40.49,-61039.41
buyer_7,María,Valdec,1968-12-31,54502279F,maría.valdec@awesomecloud.com,031005,ES72209544951851809297,6307.96,2024-08-16T08:03:14,Portugalete,expenses,children,-400.71,-61440.12
buyer_7,María,Valdec,1968-12-31,54502279F,maría.valdec@awesomecloud.com,031005,ES72209544951851809297,6307.96,2024-08-17T14:03:35,Portugalete,expenses,food,-110.65,-61550.77
buyer_7,María,Valdec,1968-12-31,54502279F,maría.valdec@awesomecloud.com,031005,ES72209544951851809297,6307.96,2024-08-17T18:29:15,Portugalete,expenses,cash,-100.0,-61650.77
buyer_7,María,Valdec,1968-12-31,54502279F,maría.valdec@awesomecloud.com,031005,ES72209544951851809297,6307.96,2024-08-17T23:57:45,Portugalete,expenses,appliances,-161.46,-61812.23
buyer_7,María,Valdec,1968-12-31,54502279F,maría.valdec@awesomecloud.com,031005,ES72209544951851809297,6307.96,2024-08-18T09:34:08,Portugalete,expenses,children,-406.64,-62218.87
buyer_7,María,Valdec,1968-12-31,54502279F,maría.valdec@awesomecloud.com,031005,ES72209544951851809297,6307.96,2024-08-19T20:34:56,Portugalete,expenses,transport,-48.78,-62267.65
buyer_7,María,Valdec,1968-12-31,54502279F,maría.valdec@awesomecloud.com,031005,ES72209544951851809297,6307.96,2024-08-22T11:48:06,Portugalete,expenses,cash,-100.0,-62367.65
buyer_7,María,Valdec,1968-12-31,54502279F,maría.valdec@awesomecloud.com,031005,ES72209544951851809297,6307.96,2024-08-23T17:23:08,Portugalete,expenses,leisure,-81.44,-62449.09
buyer_7,María,Valdec,1968-12-31,54502279F,maría.valdec@awesomecloud.com,031005,ES72209544951851809297,6307.96,2024-08-24T17:05:04,Portugalete,expenses,transport,-63.41,-62512.5
buyer_7,María,Valdec,1968-12-31,54502279F,maría.valdec@awesomecloud.com,031005,ES72209544951851809297,6307.96,2024-08-24T09:42:12,Portugalete,expenses,children,-207.04,-62719.54
buyer_7,María,Valdec,1968-12-31,54502279F,maría.valdec@awesomecloud.com,031005,ES72209544951851809297,6307.96,2024-08-25T09:27:49,Portugalete,expenses,food,-77.22,-62796.76
buyer_7,María,Valdec,1968-12-31,54502279F,maría.valdec@awesomecloud.com,031005,ES72209544951851809297,6307.96,2024-08-27T20:46:16,Portugalete,expenses,healthcare,-177.92,-62974.68
buyer_7,María,Valdec,1968-12-31,54502279F,maría.valdec@awesomecloud.com,031005,ES72209544951851809297,6307.96,2024-08-28T14:13:06,Portugalete,expenses,appliances,-129.12,-63103.8
buyer_7,María,Valdec,1968-12-31,54502279F,maría.valdec@awesomecloud.com,031005,ES72209544951851809297,6307.96,2024-08-29T18:43:51,Portugalete,expenses,food,-115.22,-63219.02
buyer_7,María,Valdec,1968-12-31,54502279F,maría.valdec@awesomecloud.com,031005,ES72209544951851809297,6307.96,2024-08-29T17:19:08,Portugalete,expenses,gifts,-82.27,-63301.29
buyer_7,María,Valdec,1968-12-31,54502279F,maría.valdec@awesomecloud.com,031005,ES72209544951851809297,6307.96,2024-08-30T08:12:44,Portugalete,expenses,cash,-100.0,-63401.29
buyer_7,María,Valdec,1968-12-31,54502279F,maría.valdec@awesomecloud.com,031005,ES72209544951851809297,6307.96,2024-09-01T20:29:40,Portugalete,incomes,salary,1622.81,-61778.48
buyer_7,María,Valdec,1968-12-31,54502279F,maría.valdec@awesomecloud.com,031005,ES72209544951851809297,6307.96,2024-09-01T10:02:59,Portugalete,expenses,cash,-100.0,-61878.48
buyer_7,María,Valdec,1968-12-31,54502279F,maría.valdec@awesomecloud.com,031005,ES72209544951851809297,6307.96,2024-09-02T17:25:02,Portugalete,expenses,children,-313.61,-62192.09
buyer_7,María,Valdec,1968-12-31,54502279F,maría.valdec@awesomecloud.com,031005,ES72209544951851809297,6307.96,2024-09-03T16:37:24,Portugalete,expenses,transport,-68.1,-62260.19
buyer_7,María,Valdec,1968-12-31,54502279F,maría.valdec@awesomecloud.com,031005,ES72209544951851809297,6307.96,2024-09-04T13:13:46,Portugalete,expenses,mortgage,-630.41,-62890.6
buyer_7,María,Valdec,1968-12-31,54502279F,maría.valdec@awesomecloud.com,031005,ES72209544951851809297,6307.96,2024-09-04T09:58:00,Portugalete,expenses,transport,-44.9,-62935.5
buyer_7,María,Valdec,1968-12-31,54502279F,maría.valdec@awesomecloud.com,031005,ES72209544951851809297,6307.96,2024-09-05T10:01:41,Portugalete,expenses,transport,-77.21,-63012.71
buyer_7,María,Valdec,1968-12-31,54502279F,maría.valdec@awesomecloud.com,031005,ES72209544951851809297,6307.96,2024-09-06T15:45:13,Portugalete,expenses,gas,-65.26,-63077.97
buyer_7,María,Valdec,1968-12-31,54502279F,maría.valdec@awesomecloud.com,031005,ES72209544951851809297,6307.96,2024-09-06T09:45:12,Portugalete,expenses,cash,-100.0,-63177.97
buyer_7,María,Valdec,1968-12-31,54502279F,maría.valdec@awesomecloud.com,031005,ES72209544951851809297,6307.96,2024-09-07T14:14:07,Portugalete,expenses,water,-26.09,-63204.06
buyer_7,María,Valdec,1968-12-31,54502279F,maría.valdec@awesomecloud.com,031005,ES72209544951851809297,6307.96,2024-09-07T19:17:51,Portugalete,expenses,internet,-34.08,-63238.14
buyer_7,María,Valdec,1968-12-31,54502279F,maría.valdec@awesomecloud.com,031005,ES72209544951851809297,6307.96,2024-09-08T09:28:38,Portugalete,expenses,electricity,-29.64,-63267.78
buyer_7,María,Valdec,1968-12-31,54502279F,maría.valdec@awesomecloud.com,031005,ES72209544951851809297,6307.96,2024-09-08T01:32:44,Portugalete,expenses,phone,-26.93,-63294.71
buyer_7,María,Valdec,1968-12-31,54502279F,maría.valdec@awesomecloud.com,031005,ES72209544951851809297,6307.96,2024-09-08T17:04:40,Portugalete,expenses,cash,-100.0,-63394.71
buyer_7,María,Valdec,1968-12-31,54502279F,maría.valdec@awesomecloud.com,031005,ES72209544951851809297,6307.96,2024-09-10T11:18:14,Portugalete,expenses,food,-60.03,-63454.74
buyer_7,María,Valdec,1968-12-31,54502279F,maría.valdec@awesomecloud.com,031005,ES72209544951851809297,6307.96,2024-09-10T18:56:44,Portugalete,expenses,leisure,-78.1,-63532.84
buyer_7,María,Valdec,1968-12-31,54502279F,maría.valdec@awesomecloud.com,031005,ES72209544951851809297,6307.96,2024-09-11T15:28:50,Portugalete,expenses,transport,-79.01,-63611.85
buyer_7,María,Valdec,1968-12-31,54502279F,maría.valdec@awesomecloud.com,031005,ES72209544951851809297,6307.96,2024-09-11T17:15:01,Portugalete,expenses,clothing,-125.98,-63737.83
buyer_7,María,Valdec,1968-12-31,54502279F,maría.valdec@awesomecloud.com,031005,ES72209544951851809297,6307.96,2024-09-12T11:37:37,Portugalete,expenses,healthcare,-148.43,-63886.26
buyer_7,María,Valdec,1968-12-31,54502279F,maría.valdec@awesomecloud.com,031005,ES72209544951851809297,6307.96,2024-09-12T17:12:18,Portugalete,expenses,children,-305.0574166666664,-64191.32
buyer_7,María,Valdec,1968-12-31,54502279F,maría.valdec@awesomecloud.com,031005,ES72209544951851809297,6307.96,2024-09-14T20:10:22,Portugalete,expenses,education,-63.47,-64254.79
buyer_7,María,Valdec,1968-12-31,54502279F,maría.valdec@awesomecloud.com,031005,ES72209544951851809297,6307.96,2024-09-14T14:41:38,Portugalete,expenses,repairs,-134.31,-64389.1
buyer_7,María,Valdec,1968-12-31,54502279F,maría.valdec@awesomecloud.com,031005,ES72209544951851809297,6307.96,2024-09-15T03:15:00,Portugalete,expenses,transport,-82.68,-64471.78
buyer_7,María,Valdec,1968-12-31,54502279F,maría.valdec@awesomecloud.com,031005,ES72209544951851809297,6307.96,2024-09-16T18:57:40,Portugalete,expenses,healthcare,-113.92,-64585.7
buyer_7,María,Valdec,1968-12-31,54502279F,maría.valdec@awesomecloud.com,031005,ES72209544951851809297,6307.96,2024-09-16T08:46:41,Portugalete,expenses,repairs,-247.51,-64833.21
buyer_7,María,Valdec,1968-12-31,54502279F,maría.valdec@awesomecloud.com,031005,ES72209544951851809297,6307.96,2024-09-17T20:53:29,Portugalete,expenses,cash,-100.0,-64933.21
buyer_7,María,Valdec,1968-12-31,54502279F,maría.valdec@awesomecloud.com,031005,ES72209544951851809297,6307.96,2024-09-18T13:15:58,Portugalete,expenses,children,-154.21,-65087.42
buyer_7,María,Valdec,1968-12-31,54502279F,maría.valdec@awesomecloud.com,031005,ES72209544951851809297,6307.96,2024-09-20T20:37:45,Portugalete,expenses,leisure,-61.81,-65149.23
buyer_7,María,Valdec,1968-12-31,54502279F,maría.valdec@awesomecloud.com,031005,ES72209544951851809297,6307.96,2024-09-21T18:39:58,Portugalete,expenses,children,-162.16,-65311.39
buyer_7,María,Valdec,1968-12-31,54502279F,maría.valdec@awesomecloud.com,031005,ES72209544951851809297,6307.96,2024-09-22T16:45:57,Portugalete,expenses,transport,-66.79,-65378.18
buyer_7,María,Valdec,1968-12-31,54502279F,maría.valdec@awesomecloud.com,031005,ES72209544951851809297,6307.96,2024-09-22T12:05:35,Portugalete,expenses,clothing,-112.67,-65490.85
buyer_7,María,Valdec,1968-12-31,54502279F,maría.valdec@awesomecloud.com,031005,ES72209544951851809297,6307.96,2024-09-22T12:12:13,Portugalete,expenses,repairs,-91.56,-65582.41
buyer_7,María,Valdec,1968-12-31,54502279F,maría.valdec@awesomecloud.com,031005,ES72209544951851809297,6307.96,2024-09-23T18:35:13,Portugalete,expenses,transport,-42.65,-65625.06
buyer_7,María,Valdec,1968-12-31,54502279F,maría.valdec@awesomecloud.com,031005,ES72209544951851809297,6307.96,2024-09-24T22:15:58,Portugalete,expenses,food,-73.44,-65698.5
buyer_7,María,Valdec,1968-12-31,54502279F,maría.valdec@awesomecloud.com,031005,ES72209544951851809297,6307.96,2024-09-24T19:08:17,Portugalete,expenses,transport,-72.2,-65770.7
buyer_7,María,Valdec,1968-12-31,54502279F,maría.valdec@awesomecloud.com,031005,ES72209544951851809297,6307.96,2024-09-24T20:36:26,Portugalete,expenses,clothing,-51.31,-65822.01
buyer_7,María,Valdec,1968-12-31,54502279F,maría.valdec@awesomecloud.com,031005,ES72209544951851809297,6307.96,2024-09-25T10:28:22,Portugalete,expenses,children,-368.68,-66190.69
buyer_7,María,Valdec,1968-12-31,54502279F,maría.valdec@awesomecloud.com,031005,ES72209544951851809297,6307.96,2024-09-26T16:52:49,Portugalete,expenses,food,-68.77,-66259.46
buyer_7,María,Valdec,1968-12-31,54502279F,maría.valdec@awesomecloud.com,031005,ES72209544951851809297,6307.96,2024-09-26T06:01:57,Portugalete,expenses,clothing,-111.58,-66371.04
buyer_7,María,Valdec,1968-12-31,54502279F,maría.valdec@awesomecloud.com,031005,ES72209544951851809297,6307.96,2024-09-27T13:31:04,Portugalete,expenses,cash,-100.0,-66471.04
buyer_7,María,Valdec,1968-12-31,54502279F,maría.valdec@awesomecloud.com,031005,ES72209544951851809297,6307.96,2024-09-29T13:50:51,Portugalete,expenses,clothing,-152.02,-66623.06
buyer_7,María,Valdec,1968-12-31,54502279F,maría.valdec@awesomecloud.com,031005,ES72209544951851809297,6307.96,2024-09-30T18:13:55,Portugalete,expenses,food,-70.89,-66693.95
buyer_7,María,Valdec,1968-12-31,54502279F,maría.valdec@awesomecloud.com,031005,ES72209544951851809297,6307.96,2024-09-30T11:41:09,Portugalete,expenses,gifts,-349.86,-67043.81
buyer_7,María,Valdec,1968-12-31,54502279F,maría.valdec@awesomecloud.com,031005,ES72209544951851809297,6307.96,2024-10-01T21:11:00,Portugalete,incomes,salary,1622.81,-65421.0
buyer_7,María,Valdec,1968-12-31,54502279F,maría.valdec@awesomecloud.com,031005,ES72209544951851809297,6307.96,2024-10-02T20:03:43,Portugalete,expenses,transport,-74.12,-65495.12
buyer_7,María,Valdec,1968-12-31,54502279F,maría.valdec@awesomecloud.com,031005,ES72209544951851809297,6307.96,2024-10-02T08:41:40,Portugalete,expenses,children,-318.55,-65813.67
buyer_7,María,Valdec,1968-12-31,54502279F,maría.valdec@awesomecloud.com,031005,ES72209544951851809297,6307.96,2024-10-03T21:55:37,Portugalete,expenses,transport,-51.15,-65864.82
buyer_7,María,Valdec,1968-12-31,54502279F,maría.valdec@awesomecloud.com,031005,ES72209544951851809297,6307.96,2024-10-03T17:54:33,Portugalete,expenses,travel,-398.89,-66263.71
buyer_7,María,Valdec,1968-12-31,54502279F,maría.valdec@awesomecloud.com,031005,ES72209544951851809297,6307.96,2024-10-04T14:05:59,Portugalete,expenses,mortgage,-630.41,-66894.12
buyer_7,María,Valdec,1968-12-31,54502279F,maría.valdec@awesomecloud.com,031005,ES72209544951851809297,6307.96,2024-10-05T12:06:58,Portugalete,expenses,internet,-34.08,-66928.2
buyer_7,María,Valdec,1968-12-31,54502279F,maría.valdec@awesomecloud.com,031005,ES72209544951851809297,6307.96,2024-10-05T08:40:02,Portugalete,expenses,cash,-100.0,-67028.2
buyer_7,María,Valdec,1968-12-31,54502279F,maría.valdec@awesomecloud.com,031005,ES72209544951851809297,6307.96,2024-10-06T15:56:45,Portugalete,expenses,gas,-60.87,-67089.07
buyer_7,María,Valdec,1968-12-31,54502279F,maría.valdec@awesomecloud.com,031005,ES72209544951851809297,6307.96,2024-10-06T12:04:11,Portugalete,expenses,internet,-34.08,-67123.15
buyer_7,María,Valdec,1968-12-31,54502279F,maría.valdec@awesomecloud.com,031005,ES72209544951851809297,6307.96,2024-10-06T22:02:54,Portugalete,expenses,food,-65.47,-67188.62
buyer_7,María,Valdec,1968-12-31,54502279F,maría.valdec@awesomecloud.com,031005,ES72209544951851809297,6307.96,2024-10-06T13:05:56,Portugalete,expenses,healthcare,-176.76,-67365.38
buyer_7,María,Valdec,1968-12-31,54502279F,maría.valdec@awesomecloud.com,031005,ES72209544951851809297,6307.96,2024-10-08T11:07:23,Portugalete,expenses,food,-62.59,-67427.97
buyer_8,Antonio,Miranda,1979-04-04,90579541K,antonio.miranda@smartweb.digital,551483,ES06209535008739372467,1493.81,2022-01-01T14:12:35,Labastida,incomes,salary,3939.08,5432.89
buyer_8,Antonio,Miranda,1979-04-04,90579541K,antonio.miranda@smartweb.digital,551483,ES06209535008739372467,1493.81,2022-01-01T08:51:13,Labastida,expenses,transport,-54.11,5378.78
buyer_8,Antonio,Miranda,1979-04-04,90579541K,antonio.miranda@smartweb.digital,551483,ES06209535008739372467,1493.81,2022-01-03T16:07:27,Labastida,expenses,cash,-100.0,5278.78
buyer_8,Antonio,Miranda,1979-04-04,90579541K,antonio.miranda@smartweb.digital,551483,ES06209535008739372467,1493.81,2022-01-04T17:00:26,Labastida,expenses,mortgage,-2302.06,2976.72
buyer_8,Antonio,Miranda,1979-04-04,90579541K,antonio.miranda@smartweb.digital,551483,ES06209535008739372467,1493.81,2022-01-05T17:18:52,Labastida,expenses,clothing,-86.05,2890.67
buyer_8,Antonio,Miranda,1979-04-04,90579541K,antonio.miranda@smartweb.digital,551483,ES06209535008739372467,1493.81,2022-01-05T18:35:00,Labastida,expenses,cash,-100.0,2790.67
buyer_8,Antonio,Miranda,1979-04-04,90579541K,antonio.miranda@smartweb.digital,551483,ES06209535008739372467,1493.81,2022-01-05T14:10:38,Labastida,expenses,gifts,-821.38,1969.29
buyer_8,Antonio,Miranda,1979-04-04,90579541K,antonio.miranda@smartweb.digital,551483,ES06209535008739372467,1493.81,2022-01-06T14:35:45,Labastida,expenses,electricity,-118.83,1850.46
buyer_8,Antonio,Miranda,1979-04-04,90579541K,antonio.miranda@smartweb.digital,551483,ES06209535008739372467,1493.81,2022-01-06T14:36:49,Labastida,expenses,phone,-70.48,1779.98
buyer_8,Antonio,Miranda,1979-04-04,90579541K,antonio.miranda@smartweb.digital,551483,ES06209535008739372467,1493.81,2022-01-06T17:39:05,Labastida,expenses,cash,-100.0,1679.98
buyer_8,Antonio,Miranda,1979-04-04,90579541K,antonio.miranda@smartweb.digital,551483,ES06209535008739372467,1493.81,2022-01-07T13:44:50,Labastida,expenses,electricity,-189.31,1490.67
buyer_8,Antonio,Miranda,1979-04-04,90579541K,antonio.miranda@smartweb.digital,551483,ES06209535008739372467,1493.81,2022-01-07T08:38:44,Labastida,expenses,phone,-66.55,1424.12
buyer_8,Antonio,Miranda,1979-04-04,90579541K,antonio.miranda@smartweb.digital,551483,ES06209535008739372467,1493.81,2022-01-08T21:43:12,Labastida,expenses,electricity,-80.73,1343.39
buyer_8,Antonio,Miranda,1979-04-04,90579541K,antonio.miranda@smartweb.digital,551483,ES06209535008739372467,1493.81,2022-01-10T09:00:15,Labastida,expenses,leisure,-59.52,1283.87
buyer_8,Antonio,Miranda,1979-04-04,90579541K,antonio.miranda@smartweb.digital,551483,ES06209535008739372467,1493.81,2022-01-11T10:04:18,Labastida,expenses,repairs,-95.06,1188.81
buyer_8,Antonio,Miranda,1979-04-04,90579541K,antonio.miranda@smartweb.digital,551483,ES06209535008739372467,1493.81,2022-01-12T17:55:50,Labastida,expenses,food,-109.78,1079.03
buyer_8,Antonio,Miranda,1979-04-04,90579541K,antonio.miranda@smartweb.digital,551483,ES06209535008739372467,1493.81,2022-01-15T21:31:07,Labastida,expenses,education,-69.9,1009.13
buyer_8,Antonio,Miranda,1979-04-04,90579541K,antonio.miranda@smartweb.digital,551483,ES06209535008739372467,1493.81,2022-01-15T08:36:52,Labastida,expenses,travel,-756.31,252.82
buyer_8,Antonio,Miranda,1979-04-04,90579541K,antonio.miranda@smartweb.digital,551483,ES06209535008739372467,1493.81,2022-01-17T17:08:09,Labastida,expenses,clothing,-108.65,144.17
buyer_8,Antonio,Miranda,1979-04-04,90579541K,antonio.miranda@smartweb.digital,551483,ES06209535008739372467,1493.81,2022-01-20T19:47:05,Labastida,expenses,transport,-80.49,63.68
buyer_8,Antonio,Miranda,1979-04-04,90579541K,antonio.miranda@smartweb.digital,551483,ES06209535008739372467,1493.81,2022-01-20T19:33:00,Labastida,expenses,cash,-100.0,-36.32
buyer_8,Antonio,Miranda,1979-04-04,90579541K,antonio.miranda@smartweb.digital,551483,ES06209535008739372467,1493.81,2022-01-21T15:02:47,Labastida,expenses,travel,-725.83,-762.15
buyer_8,Antonio,Miranda,1979-04-04,90579541K,antonio.miranda@smartweb.digital,551483,ES06209535008739372467,1493.81,2022-01-23T08:22:21,Labastida,expenses,clothing,-77.15,-839.3
buyer_8,Antonio,Miranda,1979-04-04,90579541K,antonio.miranda@smartweb.digital,551483,ES06209535008739372467,1493.81,2022-01-23T16:02:05,Labastida,expenses,gifts,-621.26,-1460.56
buyer_8,Antonio,Miranda,1979-04-04,90579541K,antonio.miranda@smartweb.digital,551483,ES06209535008739372467,1493.81,2022-01-24T17:07:26,Labastida,expenses,transport,-73.13,-1533.69
buyer_8,Antonio,Miranda,1979-04-04,90579541K,antonio.miranda@smartweb.digital,551483,ES06209535008739372467,1493.81,2022-01-25T13:32:19,Labastida,expenses,repairs,-192.85,-1726.54
buyer_8,Antonio,Miranda,1979-04-04,90579541K,antonio.miranda@smartweb.digital,551483,ES06209535008739372467,1493.81,2022-01-26T13:14:11,Labastida,expenses,food,-122.65,-1849.19
buyer_8,Antonio,Miranda,1979-04-04,90579541K,antonio.miranda@smartweb.digital,551483,ES06209535008739372467,1493.81,2022-01-27T13:46:40,Labastida,expenses,education,-50.69,-1899.88
buyer_8,Antonio,Miranda,1979-04-04,90579541K,antonio.miranda@smartweb.digital,551483,ES06209535008739372467,1493.81,2022-01-27T17:31:00,Labastida,expenses,gifts,-325.81,-2225.69
buyer_8,Antonio,Miranda,1979-04-04,90579541K,antonio.miranda@smartweb.digital,551483,ES06209535008739372467,1493.81,2022-01-28T19:51:23,Labastida,expenses,leisure,-40.48,-2266.17
buyer_8,Antonio,Miranda,1979-04-04,90579541K,antonio.miranda@smartweb.digital,551483,ES06209535008739372467,1493.81,2022-01-28T09:30:42,Labastida,expenses,repairs,-183.98,-2450.15
buyer_8,Antonio,Miranda,1979-04-04,90579541K,antonio.miranda@smartweb.digital,551483,ES06209535008739372467,1493.81,2022-01-29T12:19:02,Labastida,expenses,leisure,-53.62,-2503.77
buyer_8,Antonio,Miranda,1979-04-04,90579541K,antonio.miranda@smartweb.digital,551483,ES06209535008739372467,1493.81,2022-01-31T23:53:19,Labastida,expenses,repairs,-78.84,-2582.61
buyer_8,Antonio,Miranda,1979-04-04,90579541K,antonio.miranda@smartweb.digital,551483,ES06209535008739372467,1493.81,2022-02-01T13:53:31,Labastida,incomes,salary,3939.08,1356.47
buyer_8,Antonio,Miranda,1979-04-04,90579541K,antonio.miranda@smartweb.digital,551483,ES06209535008739372467,1493.81,2022-02-01T13:12:35,Labastida,expenses,cash,-100.0,1256.47
buyer_8,Antonio,Miranda,1979-04-04,90579541K,antonio.miranda@smartweb.digital,551483,ES06209535008739372467,1493.81,2022-02-02T18:36:47,Labastida,expenses,leisure,-46.24,1210.23
buyer_8,Antonio,Miranda,1979-04-04,90579541K,antonio.miranda@smartweb.digital,551483,ES06209535008739372467,1493.81,2022-02-04T20:04:39,Labastida,expenses,mortgage,-2302.06,-1091.83
buyer_8,Antonio,Miranda,1979-04-04,90579541K,antonio.miranda@smartweb.digital,551483,ES06209535008739372467,1493.81,2022-02-04T12:39:33,Labastida,expenses,clothing,-159.12,-1250.95
buyer_8,Antonio,Miranda,1979-04-04,90579541K,antonio.miranda@smartweb.digital,551483,ES06209535008739372467,1493.81,2022-02-05T09:05:49,Labastida,expenses,electricity,-93.56,-1344.51
buyer_8,Antonio,Miranda,1979-04-04,90579541K,antonio.miranda@smartweb.digital,551483,ES06209535008739372467,1493.81,2022-02-06T14:43:32,Labastida,expenses,cash,-100.0,-1444.51
buyer_8,Antonio,Miranda,1979-04-04,90579541K,antonio.miranda@smartweb.digital,551483,ES06209535008739372467,1493.81,2022-02-07T20:22:07,Labastida,expenses,water,-59.67,-1504.18
buyer_8,Antonio,Miranda,1979-04-04,90579541K,antonio.miranda@smartweb.digital,551483,ES06209535008739372467,1493.81,2022-02-08T20:20:14,Labastida,expenses,water,-77.67,-1581.85
buyer_8,Antonio,Miranda,1979-04-04,90579541K,antonio.miranda@smartweb.digital,551483,ES06209535008739372467,1493.81,2022-02-08T15:52:09,Labastida,expenses,internet,-90.99,-1672.84
buyer_8,Antonio,Miranda,1979-04-04,90579541K,antonio.miranda@smartweb.digital,551483,ES06209535008739372467,1493.81,2022-02-08T17:49:21,Labastida,expenses,transport,-40.35,-1713.19
buyer_8,Antonio,Miranda,1979-04-04,90579541K,antonio.miranda@smartweb.digital,551483,ES06209535008739372467,1493.81,2022-02-09T16:20:41,Labastida,expenses,car,-707.43,-2420.62
buyer_8,Antonio,Miranda,1979-04-04,90579541K,antonio.miranda@smartweb.digital,551483,ES06209535008739372467,1493.81,2022-02-11T20:17:14,Labastida,expenses,leisure,-73.95,-2494.57
buyer_8,Antonio,Miranda,1979-04-04,90579541K,antonio.miranda@smartweb.digital,551483,ES06209535008739372467,1493.81,2022-02-12T10:27:42,Labastida,expenses,repairs,-218.45,-2713.02
buyer_8,Antonio,Miranda,1979-04-04,90579541K,antonio.miranda@smartweb.digital,551483,ES06209535008739372467,1493.81,2022-02-13T21:05:14,Labastida,expenses,appliances,-389.37,-3102.39
buyer_8,Antonio,Miranda,1979-04-04,90579541K,antonio.miranda@smartweb.digital,551483,ES06209535008739372467,1493.81,2022-02-16T18:59:53,Labastida,expenses,education,-73.88,-3176.27
buyer_8,Antonio,Miranda,1979-04-04,90579541K,antonio.miranda@smartweb.digital,551483,ES06209535008739372467,1493.81,2022-02-17T15:19:42,Labastida,expenses,leisure,-61.62,-3237.89
buyer_8,Antonio,Miranda,1979-04-04,90579541K,antonio.miranda@smartweb.digital,551483,ES06209535008739372467,1493.81,2022-02-19T17:07:38,Labastida,expenses,food,-78.21,-3316.1
buyer_8,Antonio,Miranda,1979-04-04,90579541K,antonio.miranda@smartweb.digital,551483,ES06209535008739372467,1493.81,2022-02-19T08:36:25,Labastida,expenses,appliances,-416.34,-3732.44
buyer_8,Antonio,Miranda,1979-04-04,90579541K,antonio.miranda@smartweb.digital,551483,ES06209535008739372467,1493.81,2022-02-20T19:55:07,Labastida,expenses,food,-109.49,-3841.93
buyer_8,Antonio,Miranda,1979-04-04,90579541K,antonio.miranda@smartweb.digital,551483,ES06209535008739372467,1493.81,2022-02-20T20:55:34,Labastida,expenses,repairs,-138.46,-3980.39
buyer_8,Antonio,Miranda,1979-04-04,90579541K,antonio.miranda@smartweb.digital,551483,ES06209535008739372467,1493.81,2022-02-21T08:51:16,Labastida,expenses,repairs,-318.52,-4298.91
buyer_8,Antonio,Miranda,1979-04-04,90579541K,antonio.miranda@smartweb.digital,551483,ES06209535008739372467,1493.81,2022-02-23T19:13:11,Labastida,expenses,food,-79.04,-4377.95
buyer_8,Antonio,Miranda,1979-04-04,90579541K,antonio.miranda@smartweb.digital,551483,ES06209535008739372467,1493.81,2022-02-23T03:52:42,Labastida,expenses,gifts,-271.5,-4649.45
buyer_8,Antonio,Miranda,1979-04-04,90579541K,antonio.miranda@smartweb.digital,551483,ES06209535008739372467,1493.81,2022-02-24T17:35:49,Labastida,expenses,transport,-88.1,-4737.55
buyer_8,Antonio,Miranda,1979-04-04,90579541K,antonio.miranda@smartweb.digital,551483,ES06209535008739372467,1493.81,2022-02-24T19:09:09,Labastida,expenses,healthcare,-145.32,-4882.87
buyer_8,Antonio,Miranda,1979-04-04,90579541K,antonio.miranda@smartweb.digital,551483,ES06209535008739372467,1493.81,2022-02-25T04:02:19,Labastida,expenses,clothing,-56.17,-4939.04
buyer_8,Antonio,Miranda,1979-04-04,90579541K,antonio.miranda@smartweb.digital,551483,ES06209535008739372467,1493.81,2022-02-25T17:22:57,Labastida,expenses,education,-74.84,-5013.88
buyer_8,Antonio,Miranda,1979-04-04,90579541K,antonio.miranda@smartweb.digital,551483,ES06209535008739372467,1493.81,2022-02-25T15:39:53,Labastida,expenses,gifts,-849.42,-5863.3
buyer_8,Antonio,Miranda,1979-04-04,90579541K,antonio.miranda@smartweb.digital,551483,ES06209535008739372467,1493.81,2022-02-26T11:33:28,Labastida,expenses,food,-100.04,-5963.34
buyer_8,Antonio,Miranda,1979-04-04,90579541K,antonio.miranda@smartweb.digital,551483,ES06209535008739372467,1493.81,2022-02-27T20:09:46,Labastida,expenses,cash,-100.0,-6063.34
buyer_8,Antonio,Miranda,1979-04-04,90579541K,antonio.miranda@smartweb.digital,551483,ES06209535008739372467,1493.81,2022-02-28T12:35:08,Labastida,expenses,cash,-100.0,-6163.34
buyer_8,Antonio,Miranda,1979-04-04,90579541K,antonio.miranda@smartweb.digital,551483,ES06209535008739372467,1493.81,2022-03-01T18:04:55,Labastida,incomes,salary,3939.08,-2224.26
buyer_8,Antonio,Miranda,1979-04-04,90579541K,antonio.miranda@smartweb.digital,551483,ES06209535008739372467,1493.81,2022-03-01T18:04:55,Labastida,incomes,extra_income,531.65,-1692.61
buyer_8,Antonio,Miranda,1979-04-04,90579541K,antonio.miranda@smartweb.digital,551483,ES06209535008739372467,1493.81,2022-03-01T11:48:22,Labastida,expenses,food,-80.78,-1773.39
buyer_8,Antonio,Miranda,1979-04-04,90579541K,antonio.miranda@smartweb.digital,551483,ES06209535008739372467,1493.81,2022-03-02T14:19:01,Labastida,expenses,leisure,-20.68,-1794.07
buyer_8,Antonio,Miranda,1979-04-04,90579541K,antonio.miranda@smartweb.digital,551483,ES06209535008739372467,1493.81,2022-03-03T18:42:34,Labastida,expenses,food,-76.28,-1870.35
buyer_8,Antonio,Miranda,1979-04-04,90579541K,antonio.miranda@smartweb.digital,551483,ES06209535008739372467,1493.81,2022-03-03T11:09:32,Labastida,expenses,transport,-71.95,-1942.3
buyer_8,Antonio,Miranda,1979-04-04,90579541K,antonio.miranda@smartweb.digital,551483,ES06209535008739372467,1493.81,2022-03-03T13:01:14,Labastida,expenses,leisure,-84.76,-2027.06
buyer_8,Antonio,Miranda,1979-04-04,90579541K,antonio.miranda@smartweb.digital,551483,ES06209535008739372467,1493.81,2022-03-04T15:44:42,Labastida,expenses,mortgage,-2302.06,-4329.12
buyer_8,Antonio,Miranda,1979-04-04,90579541K,antonio.miranda@smartweb.digital,551483,ES06209535008739372467,1493.81,2022-03-04T20:00:00,Labastida,expenses,cash,-100.0,-4429.12
buyer_8,Antonio,Miranda,1979-04-04,90579541K,antonio.miranda@smartweb.digital,551483,ES06209535008739372467,1493.81,2022-03-05T05:57:55,Labastida,expenses,water,-77.4,-4506.52
buyer_8,Antonio,Miranda,1979-04-04,90579541K,antonio.miranda@smartweb.digital,551483,ES06209535008739372467,1493.81,2022-03-05T08:39:43,Labastida,expenses,phone,-72.33,-4578.85
buyer_8,Antonio,Miranda,1979-04-04,90579541K,antonio.miranda@smartweb.digital,551483,ES06209535008739372467,1493.81,2022-03-05T01:28:40,Labastida,expenses,transport,-85.04,-4663.89
buyer_8,Antonio,Miranda,1979-04-04,90579541K,antonio.miranda@smartweb.digital,551483,ES06209535008739372467,1493.81,2022-03-06T09:28:11,Labastida,expenses,gas,-76.32,-4740.21
buyer_8,Antonio,Miranda,1979-04-04,90579541K,antonio.miranda@smartweb.digital,551483,ES06209535008739372467,1493.81,2022-03-06T20:26:59,Labastida,expenses,internet,-90.99,-4831.2
buyer_8,Antonio,Miranda,1979-04-04,90579541K,antonio.miranda@smartweb.digital,551483,ES06209535008739372467,1493.81,2022-03-06T02:27:23,Labastida,expenses,phone,-94.79,-4925.99
buyer_8,Antonio,Miranda,1979-04-04,90579541K,antonio.miranda@smartweb.digital,551483,ES06209535008739372467,1493.81,2022-03-07T14:26:49,Labastida,expenses,water,-67.21,-4993.2
buyer_8,Antonio,Miranda,1979-04-04,90579541K,antonio.miranda@smartweb.digital,551483,ES06209535008739372467,1493.81,2022-03-07T14:41:39,Labastida,expenses,gas,-66.92,-5060.12
buyer_8,Antonio,Miranda,1979-04-04,90579541K,antonio.miranda@smartweb.digital,551483,ES06209535008739372467,1493.81,2022-03-07T07:34:56,Labastida,expenses,internet,-90.99,-5151.11
buyer_8,Antonio,Miranda,1979-04-04,90579541K,antonio.miranda@smartweb.digital,551483,ES06209535008739372467,1493.81,2022-03-07T13:59:06,Labastida,expenses,phone,-75.13,-5226.24
buyer_8,Antonio,Miranda,1979-04-04,90579541K,antonio.miranda@smartweb.digital,551483,ES06209535008739372467,1493.81,2022-03-07T13:47:14,Labastida,expenses,cash,-100.0,-5326.24
buyer_8,Antonio,Miranda,1979-04-04,90579541K,antonio.miranda@smartweb.digital,551483,ES06209535008739372467,1493.81,2022-03-08T09:59:18,Labastida,expenses,phone,-65.03,-5391.27
buyer_8,Antonio,Miranda,1979-04-04,90579541K,antonio.miranda@smartweb.digital,551483,ES06209535008739372467,1493.81,2022-03-08T18:45:00,Labastida,expenses,gifts,-402.35,-5793.62
buyer_8,Antonio,Miranda,1979-04-04,90579541K,antonio.miranda@smartweb.digital,551483,ES06209535008739372467,1493.81,2022-03-11T18:58:55,Labastida,expenses,food,-89.73,-5883.35
buyer_8,Antonio,Miranda,1979-04-04,90579541K,antonio.miranda@smartweb.digital,551483,ES06209535008739372467,1493.81,2022-03-11T08:43:07,Labastida,expenses,gifts,-638.65,-6522.0
buyer_8,Antonio,Miranda,1979-04-04,90579541K,antonio.miranda@smartweb.digital,551483,ES06209535008739372467,1493.81,2022-03-12T08:12:08,Labastida,expenses,education,-60.9,-6582.9
buyer_8,Antonio,Miranda,1979-04-04,90579541K,antonio.miranda@smartweb.digital,551483,ES06209535008739372467,1493.81,2022-03-13T04:42:08,Labastida,expenses,cash,-100.0,-6682.9
buyer_8,Antonio,Miranda,1979-04-04,90579541K,antonio.miranda@smartweb.digital,551483,ES06209535008739372467,1493.81,2022-03-15T18:52:26,Labastida,expenses,food,-79.19,-6762.09
buyer_8,Antonio,Miranda,1979-04-04,90579541K,antonio.miranda@smartweb.digital,551483,ES06209535008739372467,1493.81,2022-03-15T12:02:32,Labastida,expenses,clothing,-86.57,-6848.66
buyer_8,Antonio,Miranda,1979-04-04,90579541K,antonio.miranda@smartweb.digital,551483,ES06209535008739372467,1493.81,2022-03-15T19:15:39,Labastida,expenses,healthcare,-107.33,-6955.99
buyer_8,Antonio,Miranda,1979-04-04,90579541K,antonio.miranda@smartweb.digital,551483,ES06209535008739372467,1493.81,2022-03-16T22:20:14,Labastida,expenses,food,-90.19,-7046.18
buyer_8,Antonio,Miranda,1979-04-04,90579541K,antonio.miranda@smartweb.digital,551483,ES06209535008739372467,1493.81,2022-03-16T00:41:54,Labastida,expenses,transport,-88.41,-7134.59
buyer_8,Antonio,Miranda,1979-04-04,90579541K,antonio.miranda@smartweb.digital,551483,ES06209535008739372467,1493.81,2022-03-16T09:24:46,Labastida,expenses,leisure,-69.13,-7203.72
buyer_8,Antonio,Miranda,1979-04-04,90579541K,antonio.miranda@smartweb.digital,551483,ES06209535008739372467,1493.81,2022-03-18T10:25:24,Labastida,expenses,cash,-100.0,-7303.72
buyer_8,Antonio,Miranda,1979-04-04,90579541K,antonio.miranda@smartweb.digital,551483,ES06209535008739372467,1493.81,2022-03-18T17:41:20,Labastida,expenses,appliances,-298.36,-7602.08
buyer_8,Antonio,Miranda,1979-04-04,90579541K,antonio.miranda@smartweb.digital,551483,ES06209535008739372467,1493.81,2022-03-22T11:55:01,Labastida,expenses,food,-89.58,-7691.66
buyer_8,Antonio,Miranda,1979-04-04,90579541K,antonio.miranda@smartweb.digital,551483,ES06209535008739372467,1493.81,2022-03-24T16:29:08,Labastida,expenses,appliances,-172.48,-7864.14
buyer_8,Antonio,Miranda,1979-04-04,90579541K,antonio.miranda@smartweb.digital,551483,ES06209535008739372467,1493.81,2022-03-25T18:54:26,Labastida,expenses,transport,-54.19,-7918.33
buyer_8,Antonio,Miranda,1979-04-04,90579541K,antonio.miranda@smartweb.digital,551483,ES06209535008739372467,1493.81,2022-03-25T13:29:26,Labastida,expenses,travel,-666.62,-8584.95
buyer_8,Antonio,Miranda,1979-04-04,90579541K,antonio.miranda@smartweb.digital,551483,ES06209535008739372467,1493.81,2022-03-26T17:29:44,Labastida,expenses,gifts,-297.46,-8882.41
buyer_8,Antonio,Miranda,1979-04-04,90579541K,antonio.miranda@smartweb.digital,551483,ES06209535008739372467,1493.81,2022-03-27T11:29:07,Labastida,expenses,food,-105.44,-8987.85
buyer_8,Antonio,Miranda,1979-04-04,90579541K,antonio.miranda@smartweb.digital,551483,ES06209535008739372467,1493.81,2022-03-27T19:53:18,Labastida,expenses,appliances,-391.55,-9379.4
buyer_8,Antonio,Miranda,1979-04-04,90579541K,antonio.miranda@smartweb.digital,551483,ES06209535008739372467,1493.81,2022-03-27T12:19:07,Labastida,expenses,repairs,-73.62,-9453.02
buyer_8,Antonio,Miranda,1979-04-04,90579541K,antonio.miranda@smartweb.digital,551483,ES06209535008739372467,1493.81,2022-03-28T16:15:08,Labastida,expenses,gifts,-378.18,-9831.2
buyer_8,Antonio,Miranda,1979-04-04,90579541K,antonio.miranda@smartweb.digital,551483,ES06209535008739372467,1493.81,2022-03-29T19:29:33,Labastida,expenses,cash,-100.0,-9931.2
buyer_8,Antonio,Miranda,1979-04-04,90579541K,antonio.miranda@smartweb.digital,551483,ES06209535008739372467,1493.81,2022-03-29T12:58:53,Labastida,expenses,appliances,-246.89,-10178.09
buyer_8,Antonio,Miranda,1979-04-04,90579541K,antonio.miranda@smartweb.digital,551483,ES06209535008739372467,1493.81,2022-04-01T17:24:10,Labastida,incomes,salary,3939.08,-6239.01
buyer_8,Antonio,Miranda,1979-04-04,90579541K,antonio.miranda@smartweb.digital,551483,ES06209535008739372467,1493.81,2022-04-01T23:35:00,Labastida,expenses,gifts,-817.23,-7056.24
buyer_8,Antonio,Miranda,1979-04-04,90579541K,antonio.miranda@smartweb.digital,551483,ES06209535008739372467,1493.81,2022-04-02T15:04:52,Labastida,expenses,food,-97.41,-7153.65
buyer_8,Antonio,Miranda,1979-04-04,90579541K,antonio.miranda@smartweb.digital,551483,ES06209535008739372467,1493.81,2022-04-02T08:58:30,Labastida,expenses,travel,-919.04,-8072.69
buyer_8,Antonio,Miranda,1979-04-04,90579541K,antonio.miranda@smartweb.digital,551483,ES06209535008739372467,1493.81,2022-04-03T18:39:51,Labastida,expenses,healthcare,-101.8,-8174.49
buyer_8,Antonio,Miranda,1979-04-04,90579541K,antonio.miranda@smartweb.digital,551483,ES06209535008739372467,1493.81,2022-04-03T17:40:15,Labastida,expenses,cash,-100.0,-8274.49
buyer_8,Antonio,Miranda,1979-04-04,90579541K,antonio.miranda@smartweb.digital,551483,ES06209535008739372467,1493.81,2022-04-04T15:55:54,Labastida,expenses,mortgage,-2302.06,-10576.55
buyer_8,Antonio,Miranda,1979-04-04,90579541K,antonio.miranda@smartweb.digital,551483,ES06209535008739372467,1493.81,2022-04-04T11:20:26,Labastida,expenses,cash,-100.0,-10676.55
buyer_8,Antonio,Miranda,1979-04-04,90579541K,antonio.miranda@smartweb.digital,551483,ES06209535008739372467,1493.81,2022-04-05T09:26:54,Labastida,expenses,gas,-160.96,-10837.51
buyer_8,Antonio,Miranda,1979-04-04,90579541K,antonio.miranda@smartweb.digital,551483,ES06209535008739372467,1493.81,2022-04-05T14:11:24,Labastida,expenses,internet,-90.99,-10928.5
buyer_8,Antonio,Miranda,1979-04-04,90579541K,antonio.miranda@smartweb.digital,551483,ES06209535008739372467,1493.81,2022-04-05T21:49:04,Labastida,expenses,food,-122.56,-11051.06
buyer_8,Antonio,Miranda,1979-04-04,90579541K,antonio.miranda@smartweb.digital,551483,ES06209535008739372467,1493.81,2022-04-06T13:00:13,Labastida,expenses,water,-94.33,-11145.39
buyer_8,Antonio,Miranda,1979-04-04,90579541K,antonio.miranda@smartweb.digital,551483,ES06209535008739372467,1493.81,2022-04-06T10:30:46,Labastida,expenses,electricity,-67.73,-11213.12
buyer_8,Antonio,Miranda,1979-04-04,90579541K,antonio.miranda@smartweb.digital,551483,ES06209535008739372467,1493.81,2022-04-06T11:16:40,Labastida,expenses,internet,-90.99,-11304.11
buyer_8,Antonio,Miranda,1979-04-04,90579541K,antonio.miranda@smartweb.digital,551483,ES06209535008739372467,1493.81,2022-04-06T14:08:37,Labastida,expenses,phone,-67.85,-11371.96
buyer_8,Antonio,Miranda,1979-04-04,90579541K,antonio.miranda@smartweb.digital,551483,ES06209535008739372467,1493.81,2022-04-07T10:38:00,Labastida,expenses,appliances,-411.99,-11783.95
buyer_8,Antonio,Miranda,1979-04-04,90579541K,antonio.miranda@smartweb.digital,551483,ES06209535008739372467,1493.81,2022-04-07T22:24:59,Labastida,expenses,repairs,-304.46,-12088.41
buyer_8,Antonio,Miranda,1979-04-04,90579541K,antonio.miranda@smartweb.digital,551483,ES06209535008739372467,1493.81,2022-04-08T13:06:31,Labastida,expenses,transport,-66.1,-12154.51
buyer_8,Antonio,Miranda,1979-04-04,90579541K,antonio.miranda@smartweb.digital,551483,ES06209535008739372467,1493.81,2022-04-08T12:00:41,Labastida,expenses,cash,-100.0,-12254.51
buyer_8,Antonio,Miranda,1979-04-04,90579541K,antonio.miranda@smartweb.digital,551483,ES06209535008739372467,1493.81,2022-04-09T19:21:03,Labastida,expenses,healthcare,-72.39,-12326.9
buyer_8,Antonio,Miranda,1979-04-04,90579541K,antonio.miranda@smartweb.digital,551483,ES06209535008739372467,1493.81,2022-04-13T20:43:46,Labastida,expenses,transport,-40.02,-12366.92
buyer_8,Antonio,Miranda,1979-04-04,90579541K,antonio.miranda@smartweb.digital,551483,ES06209535008739372467,1493.81,2022-04-14T10:58:58,Labastida,expenses,food,-61.22,-12428.14
buyer_8,Antonio,Miranda,1979-04-04,90579541K,antonio.miranda@smartweb.digital,551483,ES06209535008739372467,1493.81,2022-04-14T14:17:35,Labastida,expenses,transport,-44.85,-12472.99
buyer_8,Antonio,Miranda,1979-04-04,90579541K,antonio.miranda@smartweb.digital,551483,ES06209535008739372467,1493.81,2022-04-14T03:59:01,Labastida,expenses,gifts,-168.79,-12641.78
buyer_8,Antonio,Miranda,1979-04-04,90579541K,antonio.miranda@smartweb.digital,551483,ES06209535008739372467,1493.81,2022-04-15T02:08:03,Labastida,expenses,food,-120.57,-12762.35
buyer_8,Antonio,Miranda,1979-04-04,90579541K,antonio.miranda@smartweb.digital,551483,ES06209535008739372467,1493.81,2022-04-15T01:15:20,Labastida,expenses,clothing,-137.35,-12899.7
buyer_8,Antonio,Miranda,1979-04-04,90579541K,antonio.miranda@smartweb.digital,551483,ES06209535008739372467,1493.81,2022-04-18T09:21:09,Labastida,expenses,leisure,-74.73,-12974.43
buyer_8,Antonio,Miranda,1979-04-04,90579541K,antonio.miranda@smartweb.digital,551483,ES06209535008739372467,1493.81,2022-04-20T19:45:25,Labastida,expenses,education,-62.34,-13036.77
buyer_8,Antonio,Miranda,1979-04-04,90579541K,antonio.miranda@smartweb.digital,551483,ES06209535008739372467,1493.81,2022-04-21T18:29:19,Labastida,expenses,transport,-79.48,-13116.25
buyer_8,Antonio,Miranda,1979-04-04,90579541K,antonio.miranda@smartweb.digital,551483,ES06209535008739372467,1493.81,2022-04-21T18:39:01,Labastida,expenses,leisure,-56.35,-13172.6
buyer_8,Antonio,Miranda,1979-04-04,90579541K,antonio.miranda@smartweb.digital,551483,ES06209535008739372467,1493.81,2022-04-21T16:20:13,Labastida,expenses,cash,-100.0,-13272.6
buyer_8,Antonio,Miranda,1979-04-04,90579541K,antonio.miranda@smartweb.digital,551483,ES06209535008739372467,1493.81,2022-04-24T10:13:22,Labastida,expenses,leisure,-45.75,-13318.35
buyer_8,Antonio,Miranda,1979-04-04,90579541K,antonio.miranda@smartweb.digital,551483,ES06209535008739372467,1493.81,2022-04-26T11:39:56,Labastida,expenses,transport,-56.87,-13375.22
buyer_8,Antonio,Miranda,1979-04-04,90579541K,antonio.miranda@smartweb.digital,551483,ES06209535008739372467,1493.81,2022-04-28T16:26:29,Labastida,expenses,education,-52.67,-13427.89
buyer_8,Antonio,Miranda,1979-04-04,90579541K,antonio.miranda@smartweb.digital,551483,ES06209535008739372467,1493.81,2022-05-01T09:05:34,Labastida,incomes,salary,3939.08,-9488.81
buyer_8,Antonio,Miranda,1979-04-04,90579541K,antonio.miranda@smartweb.digital,551483,ES06209535008739372467,1493.81,2022-05-01T15:57:31,Labastida,expenses,transport,-56.84,-9545.65
buyer_8,Antonio,Miranda,1979-04-04,90579541K,antonio.miranda@smartweb.digital,551483,ES06209535008739372467,1493.81,2022-05-02T14:36:42,Labastida,expenses,education,-77.49,-9623.14
buyer_8,Antonio,Miranda,1979-04-04,90579541K,antonio.miranda@smartweb.digital,551483,ES06209535008739372467,1493.81,2022-05-03T12:18:53,Labastida,expenses,healthcare,-184.33,-9807.47
buyer_8,Antonio,Miranda,1979-04-04,90579541K,antonio.miranda@smartweb.digital,551483,ES06209535008739372467,1493.81,2022-05-03T18:02:48,Labastida,expenses,cash,-100.0,-9907.47
buyer_8,Antonio,Miranda,1979-04-04,90579541K,antonio.miranda@smartweb.digital,551483,ES06209535008739372467,1493.81,2022-05-04T20:26:43,Labastida,expenses,mortgage,-2302.06,-12209.53
buyer_8,Antonio,Miranda,1979-04-04,90579541K,antonio.miranda@smartweb.digital,551483,ES06209535008739372467,1493.81,2022-05-06T12:19:03,Labastida,expenses,electricity,-114.2,-12323.73
buyer_8,Antonio,Miranda,1979-04-04,90579541K,antonio.miranda@smartweb.digital,551483,ES06209535008739372467,1493.81,2022-05-06T09:39:13,Labastida,expenses,gas,-81.42,-12405.15
buyer_8,Antonio,Miranda,1979-04-04,90579541K,antonio.miranda@smartweb.digital,551483,ES06209535008739372467,1493.81,2022-05-06T11:05:05,Labastida,expenses,food,-99.63,-12504.78
buyer_8,Antonio,Miranda,1979-04-04,90579541K,antonio.miranda@smartweb.digital,551483,ES06209535008739372467,1493.81,2022-05-06T08:32:28,Labastida,expenses,repairs,-151.41,-12656.19
buyer_8,Antonio,Miranda,1979-04-04,90579541K,antonio.miranda@smartweb.digital,551483,ES06209535008739372467,1493.81,2022-05-08T15:41:56,Labastida,expenses,water,-83.63,-12739.82
buyer_8,Antonio,Miranda,1979-04-04,90579541K,antonio.miranda@smartweb.digital,551483,ES06209535008739372467,1493.81,2022-05-08T09:35:03,Labastida,expenses,leisure,-21.4,-12761.22
buyer_8,Antonio,Miranda,1979-04-04,90579541K,antonio.miranda@smartweb.digital,551483,ES06209535008739372467,1493.81,2022-05-12T19:25:15,Labastida,expenses,food,-114.48,-12875.7
buyer_8,Antonio,Miranda,1979-04-04,90579541K,antonio.miranda@smartweb.digital,551483,ES06209535008739372467,1493.81,2022-05-12T19:28:14,Labastida,expenses,education,-43.21,-12918.91
buyer_8,Antonio,Miranda,1979-04-04,90579541K,antonio.miranda@smartweb.digital,551483,ES06209535008739372467,1493.81,2022-05-13T21:45:30,Labastida,expenses,food,-103.35,-13022.26
buyer_8,Antonio,Miranda,1979-04-04,90579541K,antonio.miranda@smartweb.digital,551483,ES06209535008739372467,1493.81,2022-05-13T10:46:07,Labastida,expenses,cash,-100.0,-13122.26
buyer_8,Antonio,Miranda,1979-04-04,90579541K,antonio.miranda@smartweb.digital,551483,ES06209535008739372467,1493.81,2022-05-14T21:55:59,Labastida,expenses,food,-78.17,-13200.43
buyer_8,Antonio,Miranda,1979-04-04,90579541K,antonio.miranda@smartweb.digital,551483,ES06209535008739372467,1493.81,2022-05-14T19:43:45,Labastida,expenses,gifts,-582.0,-13782.43
buyer_8,Antonio,Miranda,1979-04-04,90579541K,antonio.miranda@smartweb.digital,551483,ES06209535008739372467,1493.81,2022-05-17T20:33:15,Labastida,expenses,food,-81.1,-13863.53
buyer_8,Antonio,Miranda,1979-04-04,90579541K,antonio.miranda@smartweb.digital,551483,ES06209535008739372467,1493.81,2022-05-18T10:13:10,Labastida,expenses,leisure,-30.58,-13894.11
buyer_8,Antonio,Miranda,1979-04-04,90579541K,antonio.miranda@smartweb.digital,551483,ES06209535008739372467,1493.81,2022-05-21T19:00:49,Labastida,expenses,repairs,-174.72,-14068.83
buyer_8,Antonio,Miranda,1979-04-04,90579541K,antonio.miranda@smartweb.digital,551483,ES06209535008739372467,1493.81,2022-05-22T17:45:29,Labastida,expenses,cash,-100.0,-14168.83
buyer_8,Antonio,Miranda,1979-04-04,90579541K,antonio.miranda@smartweb.digital,551483,ES06209535008739372467,1493.81,2022-05-22T13:14:54,Labastida,expenses,repairs,-86.24,-14255.07
buyer_8,Antonio,Miranda,1979-04-04,90579541K,antonio.miranda@smartweb.digital,551483,ES06209535008739372467,1493.81,2022-05-23T09:19:08,Labastida,expenses,cash,-100.0,-14355.07
buyer_8,Antonio,Miranda,1979-04-04,90579541K,antonio.miranda@smartweb.digital,551483,ES06209535008739372467,1493.81,2022-05-24T11:08:21,Labastida,expenses,education,-77.07,-14432.14
buyer_8,Antonio,Miranda,1979-04-04,90579541K,antonio.miranda@smartweb.digital,551483,ES06209535008739372467,1493.81,2022-05-25T09:16:08,Labastida,expenses,food,-95.44,-14527.58
buyer_8,Antonio,Miranda,1979-04-04,90579541K,antonio.miranda@smartweb.digital,551483,ES06209535008739372467,1493.81,2022-05-26T17:52:23,Labastida,expenses,food,-61.14,-14588.72
buyer_8,Antonio,Miranda,1979-04-04,90579541K,antonio.miranda@smartweb.digital,551483,ES06209535008739372467,1493.81,2022-05-27T09:54:17,Labastida,expenses,cash,-100.0,-14688.72
buyer_8,Antonio,Miranda,1979-04-04,90579541K,antonio.miranda@smartweb.digital,551483,ES06209535008739372467,1493.81,2022-05-30T18:40:27,Labastida,expenses,transport,-44.22,-14732.94
buyer_8,Antonio,Miranda,1979-04-04,90579541K,antonio.miranda@smartweb.digital,551483,ES06209535008739372467,1493.81,2022-05-30T17:55:42,Labastida,expenses,leisure,-81.18,-14814.12
buyer_8,Antonio,Miranda,1979-04-04,90579541K,antonio.miranda@smartweb.digital,551483,ES06209535008739372467,1493.81,2022-05-30T14:25:30,Labastida,expenses,repairs,-94.04,-14908.16
buyer_8,Antonio,Miranda,1979-04-04,90579541K,antonio.miranda@smartweb.digital,551483,ES06209535008739372467,1493.81,2022-05-31T15:20:55,Labastida,expenses,food,-110.81,-15018.97
buyer_8,Antonio,Miranda,1979-04-04,90579541K,antonio.miranda@smartweb.digital,551483,ES06209535008739372467,1493.81,2022-05-31T08:43:28,Labastida,expenses,cash,-100.0,-15118.97
buyer_8,Antonio,Miranda,1979-04-04,90579541K,antonio.miranda@smartweb.digital,551483,ES06209535008739372467,1493.81,2022-06-01T09:27:19,Labastida,incomes,salary,3939.08,-11179.89
buyer_8,Antonio,Miranda,1979-04-04,90579541K,antonio.miranda@smartweb.digital,551483,ES06209535008739372467,1493.81,2022-06-01T09:27:19,Labastida,incomes,salary_bonus,2812.06,-8367.83
buyer_8,Antonio,Miranda,1979-04-04,90579541K,antonio.miranda@smartweb.digital,551483,ES06209535008739372467,1493.81,2022-06-02T10:55:18,Labastida,expenses,taxes,-3100.95,-11468.78
buyer_8,Antonio,Miranda,1979-04-04,90579541K,antonio.miranda@smartweb.digital,551483,ES06209535008739372467,1493.81,2022-06-02T10:37:17,Labastida,expenses,insurance,-1021.63,-12490.41
buyer_8,Antonio,Miranda,1979-04-04,90579541K,antonio.miranda@smartweb.digital,551483,ES06209535008739372467,1493.81,2022-06-03T12:23:36,Labastida,expenses,food,-102.85,-12593.26
buyer_8,Antonio,Miranda,1979-04-04,90579541K,antonio.miranda@smartweb.digital,551483,ES06209535008739372467,1493.81,2022-06-03T21:00:08,Labastida,expenses,gifts,-254.06,-12847.32
buyer_8,Antonio,Miranda,1979-04-04,90579541K,antonio.miranda@smartweb.digital,551483,ES06209535008739372467,1493.81,2022-06-04T14:56:38,Labastida,expenses,mortgage,-2302.06,-15149.38
buyer_8,Antonio,Miranda,1979-04-04,90579541K,antonio.miranda@smartweb.digital,551483,ES06209535008739372467,1493.81,2022-06-04T11:47:08,Labastida,expenses,cash,-100.0,-15249.38
buyer_8,Antonio,Miranda,1979-04-04,90579541K,antonio.miranda@smartweb.digital,551483,ES06209535008739372467,1493.81,2022-06-05T14:42:30,Labastida,expenses,electricity,-127.59,-15376.97
buyer_8,Antonio,Miranda,1979-04-04,90579541K,antonio.miranda@smartweb.digital,551483,ES06209535008739372467,1493.81,2022-06-05T18:15:02,Labastida,expenses,leisure,-52.78,-15429.75
buyer_8,Antonio,Miranda,1979-04-04,90579541K,antonio.miranda@smartweb.digital,551483,ES06209535008739372467,1493.81,2022-06-06T09:47:41,Labastida,expenses,water,-89.28,-15519.03
buyer_8,Antonio,Miranda,1979-04-04,90579541K,antonio.miranda@smartweb.digital,551483,ES06209535008739372467,1493.81,2022-06-06T18:03:37,Labastida,expenses,food,-78.47,-15597.5
buyer_8,Antonio,Miranda,1979-04-04,90579541K,antonio.miranda@smartweb.digital,551483,ES06209535008739372467,1493.81,2022-06-06T03:36:24,Labastida,expenses,cash,-100.0,-15697.5
buyer_8,Antonio,Miranda,1979-04-04,90579541K,antonio.miranda@smartweb.digital,551483,ES06209535008739372467,1493.81,2022-06-07T20:32:31,Labastida,expenses,internet,-90.99,-15788.49
buyer_8,Antonio,Miranda,1979-04-04,90579541K,antonio.miranda@smartweb.digital,551483,ES06209535008739372467,1493.81,2022-06-07T16:30:48,Labastida,expenses,food,-90.38,-15878.87
buyer_8,Antonio,Miranda,1979-04-04,90579541K,antonio.miranda@smartweb.digital,551483,ES06209535008739372467,1493.81,2022-06-08T01:36:54,Labastida,expenses,electricity,-162.62,-16041.49
buyer_8,Antonio,Miranda,1979-04-04,90579541K,antonio.miranda@smartweb.digital,551483,ES06209535008739372467,1493.81,2022-06-08T18:51:48,Labastida,expenses,internet,-90.99,-16132.48
buyer_8,Antonio,Miranda,1979-04-04,90579541K,antonio.miranda@smartweb.digital,551483,ES06209535008739372467,1493.81,2022-06-08T19:52:28,Labastida,expenses,phone,-75.32,-16207.8
buyer_8,Antonio,Miranda,1979-04-04,90579541K,antonio.miranda@smartweb.digital,551483,ES06209535008739372467,1493.81,2022-06-08T18:48:33,Labastida,expenses,gifts,-218.78,-16426.58
buyer_8,Antonio,Miranda,1979-04-04,90579541K,antonio.miranda@smartweb.digital,551483,ES06209535008739372467,1493.81,2022-06-09T08:39:25,Labastida,expenses,repairs,-289.5,-16716.08
buyer_8,Antonio,Miranda,1979-04-04,90579541K,antonio.miranda@smartweb.digital,551483,ES06209535008739372467,1493.81,2022-06-10T12:06:07,Labastida,expenses,food,-75.37,-16791.45
buyer_8,Antonio,Miranda,1979-04-04,90579541K,antonio.miranda@smartweb.digital,551483,ES06209535008739372467,1493.81,2022-06-13T12:15:29,Labastida,expenses,healthcare,-180.34,-16971.79
buyer_8,Antonio,Miranda,1979-04-04,90579541K,antonio.miranda@smartweb.digital,551483,ES06209535008739372467,1493.81,2022-06-13T14:31:09,Labastida,expenses,cash,-100.0,-17071.79
buyer_8,Antonio,Miranda,1979-04-04,90579541K,antonio.miranda@smartweb.digital,551483,ES06209535008739372467,1493.81,2022-06-14T15:45:34,Labastida,expenses,repairs,-208.69,-17280.48
buyer_8,Antonio,Miranda,1979-04-04,90579541K,antonio.miranda@smartweb.digital,551483,ES06209535008739372467,1493.81,2022-06-15T19:45:18,Labastida,expenses,transport,-74.84,-17355.32
buyer_8,Antonio,Miranda,1979-04-04,90579541K,antonio.miranda@smartweb.digital,551483,ES06209535008739372467,1493.81,2022-06-18T08:54:28,Labastida,expenses,food,-75.25,-17430.57
buyer_8,Antonio,Miranda,1979-04-04,90579541K,antonio.miranda@smartweb.digital,551483,ES06209535008739372467,1493.81,2022-06-19T18:51:09,Labastida,expenses,food,-68.66,-17499.23
buyer_8,Antonio,Miranda,1979-04-04,90579541K,antonio.miranda@smartweb.digital,551483,ES06209535008739372467,1493.81,2022-06-19T16:14:15,Labastida,expenses,leisure,-20.09,-17519.32
buyer_8,Antonio,Miranda,1979-04-04,90579541K,antonio.miranda@smartweb.digital,551483,ES06209535008739372467,1493.81,2022-06-19T09:41:26,Labastida,expenses,education,-51.45,-17570.77
buyer_8,Antonio,Miranda,1979-04-04,90579541K,antonio.miranda@smartweb.digital,551483,ES06209535008739372467,1493.81,2022-06-21T16:00:13,Labastida,expenses,cash,-100.0,-17670.77
buyer_8,Antonio,Miranda,1979-04-04,90579541K,antonio.miranda@smartweb.digital,551483,ES06209535008739372467,1493.81,2022-06-22T18:30:05,Labastida,expenses,transport,-53.23,-17724.0
buyer_8,Antonio,Miranda,1979-04-04,90579541K,antonio.miranda@smartweb.digital,551483,ES06209535008739372467,1493.81,2022-06-24T10:40:34,Labastida,expenses,transport,-65.52,-17789.52
buyer_8,Antonio,Miranda,1979-04-04,90579541K,antonio.miranda@smartweb.digital,551483,ES06209535008739372467,1493.81,2022-06-24T15:46:32,Labastida,expenses,leisure,-25.85,-17815.37
buyer_8,Antonio,Miranda,1979-04-04,90579541K,antonio.miranda@smartweb.digital,551483,ES06209535008739372467,1493.81,2022-06-24T16:44:27,Labastida,expenses,travel,-674.14,-18489.51
buyer_8,Antonio,Miranda,1979-04-04,90579541K,antonio.miranda@smartweb.digital,551483,ES06209535008739372467,1493.81,2022-06-25T10:41:15,Labastida,expenses,leisure,-84.09,-18573.6
buyer_8,Antonio,Miranda,1979-04-04,90579541K,antonio.miranda@smartweb.digital,551483,ES06209535008739372467,1493.81,2022-06-26T16:22:36,Labastida,expenses,cash,-100.0,-18673.6
buyer_8,Antonio,Miranda,1979-04-04,90579541K,antonio.miranda@smartweb.digital,551483,ES06209535008739372467,1493.81,2022-06-27T09:29:39,Labastida,expenses,cash,-100.0,-18773.6
buyer_8,Antonio,Miranda,1979-04-04,90579541K,antonio.miranda@smartweb.digital,551483,ES06209535008739372467,1493.81,2022-07-01T03:29:20,Labastida,incomes,salary,3939.08,-14834.52
buyer_8,Antonio,Miranda,1979-04-04,90579541K,antonio.miranda@smartweb.digital,551483,ES06209535008739372467,1493.81,2022-07-01T03:29:20,Labastida,incomes,extra_income,531.65,-14302.87
buyer_8,Antonio,Miranda,1979-04-04,90579541K,antonio.miranda@smartweb.digital,551483,ES06209535008739372467,1493.81,2022-07-04T23:57:54,Labastida,expenses,mortgage,-2302.06,-16604.93
buyer_8,Antonio,Miranda,1979-04-04,90579541K,antonio.miranda@smartweb.digital,551483,ES06209535008739372467,1493.81,2022-07-04T13:22:43,Labastida,expenses,food,-117.85,-16722.78
buyer_8,Antonio,Miranda,1979-04-04,90579541K,antonio.miranda@smartweb.digital,551483,ES06209535008739372467,1493.81,2022-07-04T14:09:37,Labastida,expenses,transport,-63.19,-16785.97
buyer_8,Antonio,Miranda,1979-04-04,90579541K,antonio.miranda@smartweb.digital,551483,ES06209535008739372467,1493.81,2022-07-04T12:14:45,Labastida,expenses,leisure,-42.91,-16828.88
buyer_8,Antonio,Miranda,1979-04-04,90579541K,antonio.miranda@smartweb.digital,551483,ES06209535008739372467,1493.81,2022-07-05T17:35:02,Labastida,expenses,electricity,-56.81,-16885.69
buyer_8,Antonio,Miranda,1979-04-04,90579541K,antonio.miranda@smartweb.digital,551483,ES06209535008739372467,1493.81,2022-07-05T19:54:52,Labastida,expenses,phone,-77.07,-16962.76
buyer_8,Antonio,Miranda,1979-04-04,90579541K,antonio.miranda@smartweb.digital,551483,ES06209535008739372467,1493.81,2022-07-05T12:08:37,Labastida,expenses,cash,-100.0,-17062.76
buyer_8,Antonio,Miranda,1979-04-04,90579541K,antonio.miranda@smartweb.digital,551483,ES06209535008739372467,1493.81,2022-07-06T18:24:50,Labastida,expenses,electricity,-102.31,-17165.07
buyer_8,Antonio,Miranda,1979-04-04,90579541K,antonio.miranda@smartweb.digital,551483,ES06209535008739372467,1493.81,2022-07-07T16:15:12,Labastida,expenses,food,-119.9,-17284.97
buyer_8,Antonio,Miranda,1979-04-04,90579541K,antonio.miranda@smartweb.digital,551483,ES06209535008739372467,1493.81,2022-07-07T13:03:23,Labastida,expenses,cash,-100.0,-17384.97
buyer_8,Antonio,Miranda,1979-04-04,90579541K,antonio.miranda@smartweb.digital,551483,ES06209535008739372467,1493.81,2022-07-07T15:54:57,Labastida,expenses,gifts,-239.42,-17624.39
buyer_8,Antonio,Miranda,1979-04-04,90579541K,antonio.miranda@smartweb.digital,551483,ES06209535008739372467,1493.81,2022-07-08T17:09:38,Labastida,expenses,electricity,-102.49,-17726.88
buyer_8,Antonio,Miranda,1979-04-04,90579541K,antonio.miranda@smartweb.digital,551483,ES06209535008739372467,1493.81,2022-07-08T13:02:17,Labastida,expenses,internet,-90.99,-17817.87
buyer_8,Antonio,Miranda,1979-04-04,90579541K,antonio.miranda@smartweb.digital,551483,ES06209535008739372467,1493.81,2022-07-08T09:54:56,Labastida,expenses,phone,-78.17,-17896.04
buyer_8,Antonio,Miranda,1979-04-04,90579541K,antonio.miranda@smartweb.digital,551483,ES06209535008739372467,1493.81,2022-07-08T16:58:35,Labastida,expenses,leisure,-31.24,-17927.28
buyer_8,Antonio,Miranda,1979-04-04,90579541K,antonio.miranda@smartweb.digital,551483,ES06209535008739372467,1493.81,2022-07-10T03:48:58,Labastida,expenses,food,-73.96,-18001.24
buyer_8,Antonio,Miranda,1979-04-04,90579541K,antonio.miranda@smartweb.digital,551483,ES06209535008739372467,1493.81,2022-07-11T14:41:14,Labastida,expenses,cash,-100.0,-18101.24
buyer_8,Antonio,Miranda,1979-04-04,90579541K,antonio.miranda@smartweb.digital,551483,ES06209535008739372467,1493.81,2022-07-14T08:49:32,Labastida,expenses,gifts,-215.23,-18316.47
buyer_8,Antonio,Miranda,1979-04-04,90579541K,antonio.miranda@smartweb.digital,551483,ES06209535008739372467,1493.81,2022-07-16T20:59:05,Labastida,expenses,transport,-52.71,-18369.18
buyer_8,Antonio,Miranda,1979-04-04,90579541K,antonio.miranda@smartweb.digital,551483,ES06209535008739372467,1493.81,2022-07-16T08:59:15,Labastida,expenses,gifts,-745.42,-19114.6
buyer_8,Antonio,Miranda,1979-04-04,90579541K,antonio.miranda@smartweb.digital,551483,ES06209535008739372467,1493.81,2022-07-17T15:32:42,Labastida,expenses,cash,-100.0,-19214.6
buyer_8,Antonio,Miranda,1979-04-04,90579541K,antonio.miranda@smartweb.digital,551483,ES06209535008739372467,1493.81,2022-07-20T21:37:27,Labastida,expenses,leisure,-27.65,-19242.25
buyer_8,Antonio,Miranda,1979-04-04,90579541K,antonio.miranda@smartweb.digital,551483,ES06209535008739372467,1493.81,2022-07-21T20:54:02,Labastida,expenses,food,-107.85,-19350.1
buyer_8,Antonio,Miranda,1979-04-04,90579541K,antonio.miranda@smartweb.digital,551483,ES06209535008739372467,1493.81,2022-07-21T09:07:23,Labastida,expenses,leisure,-41.32,-19391.42
buyer_8,Antonio,Miranda,1979-04-04,90579541K,antonio.miranda@smartweb.digital,551483,ES06209535008739372467,1493.81,2022-07-24T14:28:38,Labastida,expenses,gifts,-327.45,-19718.87
buyer_8,Antonio,Miranda,1979-04-04,90579541K,antonio.miranda@smartweb.digital,551483,ES06209535008739372467,1493.81,2022-07-25T17:05:30,Labastida,expenses,gifts,-801.2,-20520.07
buyer_8,Antonio,Miranda,1979-04-04,90579541K,antonio.miranda@smartweb.digital,551483,ES06209535008739372467,1493.81,2022-07-26T17:52:06,Labastida,expenses,cash,-100.0,-20620.07
buyer_8,Antonio,Miranda,1979-04-04,90579541K,antonio.miranda@smartweb.digital,551483,ES06209535008739372467,1493.81,2022-07-26T11:02:00,Labastida,expenses,repairs,-145.62,-20765.69
buyer_8,Antonio,Miranda,1979-04-04,90579541K,antonio.miranda@smartweb.digital,551483,ES06209535008739372467,1493.81,2022-07-27T14:52:28,Labastida,expenses,leisure,-76.6,-20842.29
buyer_8,Antonio,Miranda,1979-04-04,90579541K,antonio.miranda@smartweb.digital,551483,ES06209535008739372467,1493.81,2022-07-28T12:55:54,Labastida,expenses,cash,-100.0,-20942.29
buyer_8,Antonio,Miranda,1979-04-04,90579541K,antonio.miranda@smartweb.digital,551483,ES06209535008739372467,1493.81,2022-07-29T20:33:55,Labastida,expenses,food,-64.75,-21007.04
buyer_8,Antonio,Miranda,1979-04-04,90579541K,antonio.miranda@smartweb.digital,551483,ES06209535008739372467,1493.81,2022-08-01T00:27:12,Labastida,incomes,salary,3939.08,-17067.96
buyer_8,Antonio,Miranda,1979-04-04,90579541K,antonio.miranda@smartweb.digital,551483,ES06209535008739372467,1493.81,2022-08-01T08:44:48,Labastida,expenses,healthcare,-151.09,-17219.05
buyer_8,Antonio,Miranda,1979-04-04,90579541K,antonio.miranda@smartweb.digital,551483,ES06209535008739372467,1493.81,2022-08-01T14:14:58,Labastida,expenses,appliances,-332.66,-17551.71
buyer_8,Antonio,Miranda,1979-04-04,90579541K,antonio.miranda@smartweb.digital,551483,ES06209535008739372467,1493.81,2022-08-02T22:03:28,Labastida,expenses,cash,-100.0,-17651.71
buyer_8,Antonio,Miranda,1979-04-04,90579541K,antonio.miranda@smartweb.digital,551483,ES06209535008739372467,1493.81,2022-08-03T00:37:59,Labastida,expenses,food,-66.09,-17717.8
buyer_8,Antonio,Miranda,1979-04-04,90579541K,antonio.miranda@smartweb.digital,551483,ES06209535008739372467,1493.81,2022-08-03T05:35:30,Labastida,expenses,transport,-89.38,-17807.18
buyer_8,Antonio,Miranda,1979-04-04,90579541K,antonio.miranda@smartweb.digital,551483,ES06209535008739372467,1493.81,2022-08-04T23:35:23,Labastida,expenses,mortgage,-2302.06,-20109.24
buyer_8,Antonio,Miranda,1979-04-04,90579541K,antonio.miranda@smartweb.digital,551483,ES06209535008739372467,1493.81,2022-08-04T08:50:56,Labastida,expenses,food,-84.94,-20194.18
buyer_8,Antonio,Miranda,1979-04-04,90579541K,antonio.miranda@smartweb.digital,551483,ES06209535008739372467,1493.81,2022-08-05T15:24:01,Labastida,expenses,cash,-100.0,-20294.18
buyer_8,Antonio,Miranda,1979-04-04,90579541K,antonio.miranda@smartweb.digital,551483,ES06209535008739372467,1493.81,2022-08-05T15:49:11,Labastida,expenses,repairs,-225.04,-20519.22
buyer_8,Antonio,Miranda,1979-04-04,90579541K,antonio.miranda@smartweb.digital,551483,ES06209535008739372467,1493.81,2022-08-06T18:24:21,Labastida,expenses,gas,-68.82,-20588.04
buyer_8,Antonio,Miranda,1979-04-04,90579541K,antonio.miranda@smartweb.digital,551483,ES06209535008739372467,1493.81,2022-08-06T19:42:58,Labastida,expenses,cash,-100.0,-20688.04
buyer_8,Antonio,Miranda,1979-04-04,90579541K,antonio.miranda@smartweb.digital,551483,ES06209535008739372467,1493.81,2022-08-08T12:32:00,Labastida,expenses,water,-69.15,-20757.19
buyer_8,Antonio,Miranda,1979-04-04,90579541K,antonio.miranda@smartweb.digital,551483,ES06209535008739372467,1493.81,2022-08-08T06:45:33,Labastida,expenses,internet,-90.99,-20848.18
buyer_8,Antonio,Miranda,1979-04-04,90579541K,antonio.miranda@smartweb.digital,551483,ES06209535008739372467,1493.81,2022-08-08T18:37:33,Labastida,expenses,gifts,-246.69,-21094.87
buyer_8,Antonio,Miranda,1979-04-04,90579541K,antonio.miranda@smartweb.digital,551483,ES06209535008739372467,1493.81,2022-08-09T11:07:28,Labastida,expenses,food,-67.16,-21162.03
buyer_8,Antonio,Miranda,1979-04-04,90579541K,antonio.miranda@smartweb.digital,551483,ES06209535008739372467,1493.81,2022-08-10T20:00:48,Labastida,expenses,cash,-100.0,-21262.03
buyer_8,Antonio,Miranda,1979-04-04,90579541K,antonio.miranda@smartweb.digital,551483,ES06209535008739372467,1493.81,2022-08-12T18:05:02,Labastida,expenses,car,-573.54,-21835.57
buyer_8,Antonio,Miranda,1979-04-04,90579541K,antonio.miranda@smartweb.digital,551483,ES06209535008739372467,1493.81,2022-08-14T22:47:23,Labastida,expenses,food,-80.49,-21916.06
buyer_8,Antonio,Miranda,1979-04-04,90579541K,antonio.miranda@smartweb.digital,551483,ES06209535008739372467,1493.81,2022-08-18T17:35:15,Labastida,expenses,food,-65.43,-21981.49
buyer_8,Antonio,Miranda,1979-04-04,90579541K,antonio.miranda@smartweb.digital,551483,ES06209535008739372467,1493.81,2022-08-22T16:02:57,Labastida,expenses,repairs,-90.15,-22071.64
buyer_8,Antonio,Miranda,1979-04-04,90579541K,antonio.miranda@smartweb.digital,551483,ES06209535008739372467,1493.81,2022-08-23T18:51:33,Labastida,expenses,clothing,-122.87,-22194.51
buyer_8,Antonio,Miranda,1979-04-04,90579541K,antonio.miranda@smartweb.digital,551483,ES06209535008739372467,1493.81,2022-08-24T20:34:30,Labastida,expenses,gifts,-131.86,-22326.37
buyer_8,Antonio,Miranda,1979-04-04,90579541K,antonio.miranda@smartweb.digital,551483,ES06209535008739372467,1493.81,2022-08-26T14:55:33,Labastida,expenses,food,-102.9,-22429.27
buyer_8,Antonio,Miranda,1979-04-04,90579541K,antonio.miranda@smartweb.digital,551483,ES06209535008739372467,1493.81,2022-08-27T01:16:34,Labastida,expenses,gifts,-503.86,-22933.13
buyer_8,Antonio,Miranda,1979-04-04,90579541K,antonio.miranda@smartweb.digital,551483,ES06209535008739372467,1493.81,2022-08-28T10:04:36,Labastida,expenses,gifts,-598.72,-23531.85
buyer_8,Antonio,Miranda,1979-04-04,90579541K,antonio.miranda@smartweb.digital,551483,ES06209535008739372467,1493.81,2022-08-29T13:40:00,Labastida,expenses,clothing,-76.56,-23608.41
buyer_8,Antonio,Miranda,1979-04-04,90579541K,antonio.miranda@smartweb.digital,551483,ES06209535008739372467,1493.81,2022-09-01T15:37:19,Labastida,incomes,salary,3939.08,-19669.33
buyer_8,Antonio,Miranda,1979-04-04,90579541K,antonio.miranda@smartweb.digital,551483,ES06209535008739372467,1493.81,2022-09-01T14:30:00,Labastida,expenses,cash,-100.0,-19769.33
buyer_8,Antonio,Miranda,1979-04-04,90579541K,antonio.miranda@smartweb.digital,551483,ES06209535008739372467,1493.81,2022-09-02T10:48:22,Labastida,expenses,leisure,-76.05,-19845.38
buyer_8,Antonio,Miranda,1979-04-04,90579541K,antonio.miranda@smartweb.digital,551483,ES06209535008739372467,1493.81,2022-09-02T08:26:02,Labastida,expenses,clothing,-116.6,-19961.98
buyer_8,Antonio,Miranda,1979-04-04,90579541K,antonio.miranda@smartweb.digital,551483,ES06209535008739372467,1493.81,2022-09-03T20:49:12,Labastida,expenses,food,-70.43,-20032.41
buyer_8,Antonio,Miranda,1979-04-04,90579541K,antonio.miranda@smartweb.digital,551483,ES06209535008739372467,1493.81,2022-09-03T22:39:38,Labastida,expenses,transport,-82.13,-20114.54
buyer_8,Antonio,Miranda,1979-04-04,90579541K,antonio.miranda@smartweb.digital,551483,ES06209535008739372467,1493.81,2022-09-04T09:22:41,Labastida,expenses,mortgage,-2302.06,-22416.6
buyer_8,Antonio,Miranda,1979-04-04,90579541K,antonio.miranda@smartweb.digital,551483,ES06209535008739372467,1493.81,2022-09-05T20:16:47,Labastida,expenses,internet,-90.99,-22507.59
buyer_8,Antonio,Miranda,1979-04-04,90579541K,antonio.miranda@smartweb.digital,551483,ES06209535008739372467,1493.81,2022-09-05T16:44:44,Labastida,expenses,cash,-100.0,-22607.59
buyer_8,Antonio,Miranda,1979-04-04,90579541K,antonio.miranda@smartweb.digital,551483,ES06209535008739372467,1493.81,2022-09-05T11:10:41,Labastida,expenses,repairs,-285.3,-22892.89
buyer_8,Antonio,Miranda,1979-04-04,90579541K,antonio.miranda@smartweb.digital,551483,ES06209535008739372467,1493.81,2022-09-06T15:16:54,Labastida,expenses,electricity,-148.24,-23041.13
buyer_8,Antonio,Miranda,1979-04-04,90579541K,antonio.miranda@smartweb.digital,551483,ES06209535008739372467,1493.81,2022-09-06T11:23:48,Labastida,expenses,food,-87.45,-23128.58
buyer_8,Antonio,Miranda,1979-04-04,90579541K,antonio.miranda@smartweb.digital,551483,ES06209535008739372467,1493.81,2022-09-08T09:45:58,Labastida,expenses,cash,-100.0,-23228.58
buyer_8,Antonio,Miranda,1979-04-04,90579541K,antonio.miranda@smartweb.digital,551483,ES06209535008739372467,1493.81,2022-09-11T12:53:18,Labastida,expenses,healthcare,-182.74,-23411.32
buyer_8,Antonio,Miranda,1979-04-04,90579541K,antonio.miranda@smartweb.digital,551483,ES06209535008739372467,1493.81,2022-09-11T11:41:00,Labastida,expenses,cash,-100.0,-23511.32
buyer_8,Antonio,Miranda,1979-04-04,90579541K,antonio.miranda@smartweb.digital,551483,ES06209535008739372467,1493.81,2022-09-13T23:49:56,Labastida,expenses,clothing,-66.33,-23577.65
buyer_8,Antonio,Miranda,1979-04-04,90579541K,antonio.miranda@smartweb.digital,551483,ES06209535008739372467,1493.81,2022-09-13T15:16:20,Labastida,expenses,healthcare,-106.29,-23683.94
buyer_8,Antonio,Miranda,1979-04-04,90579541K,antonio.miranda@smartweb.digital,551483,ES06209535008739372467,1493.81,2022-09-13T08:13:46,Labastida,expenses,cash,-100.0,-23783.94
buyer_8,Antonio,Miranda,1979-04-04,90579541K,antonio.miranda@smartweb.digital,551483,ES06209535008739372467,1493.81,2022-09-15T13:28:34,Labastida,expenses,leisure,-18.87,-23802.81
buyer_8,Antonio,Miranda,1979-04-04,90579541K,antonio.miranda@smartweb.digital,551483,ES06209535008739372467,1493.81,2022-09-17T02:43:42,Labastida,expenses,gifts,-695.3,-24498.11
buyer_8,Antonio,Miranda,1979-04-04,90579541K,antonio.miranda@smartweb.digital,551483,ES06209535008739372467,1493.81,2022-09-18T14:49:35,Labastida,expenses,food,-64.21,-24562.32
buyer_8,Antonio,Miranda,1979-04-04,90579541K,antonio.miranda@smartweb.digital,551483,ES06209535008739372467,1493.81,2022-09-18T00:32:54,Labastida,expenses,transport,-60.27,-24622.59
buyer_8,Antonio,Miranda,1979-04-04,90579541K,antonio.miranda@smartweb.digital,551483,ES06209535008739372467,1493.81,2022-09-18T09:33:13,Labastida,expenses,clothing,-153.72,-24776.31
buyer_8,Antonio,Miranda,1979-04-04,90579541K,antonio.miranda@smartweb.digital,551483,ES06209535008739372467,1493.81,2022-09-21T17:28:56,Labastida,expenses,leisure,-63.48,-24839.79
buyer_8,Antonio,Miranda,1979-04-04,90579541K,antonio.miranda@smartweb.digital,551483,ES06209535008739372467,1493.81,2022-09-21T15:30:13,Labastida,expenses,clothing,-119.76,-24959.55
buyer_8,Antonio,Miranda,1979-04-04,90579541K,antonio.miranda@smartweb.digital,551483,ES06209535008739372467,1493.81,2022-09-24T11:58:23,Labastida,expenses,food,-100.56,-25060.11
buyer_8,Antonio,Miranda,1979-04-04,90579541K,antonio.miranda@smartweb.digital,551483,ES06209535008739372467,1493.81,2022-09-24T17:11:03,Labastida,expenses,cash,-100.0,-25160.11
buyer_8,Antonio,Miranda,1979-04-04,90579541K,antonio.miranda@smartweb.digital,551483,ES06209535008739372467,1493.81,2022-09-24T22:46:39,Labastida,expenses,repairs,-178.39,-25338.5
buyer_8,Antonio,Miranda,1979-04-04,90579541K,antonio.miranda@smartweb.digital,551483,ES06209535008739372467,1493.81,2022-09-27T11:42:08,Labastida,expenses,healthcare,-153.92,-25492.42
buyer_8,Antonio,Miranda,1979-04-04,90579541K,antonio.miranda@smartweb.digital,551483,ES06209535008739372467,1493.81,2022-09-28T14:12:35,Labastida,expenses,food,-124.54,-25616.96
buyer_8,Antonio,Miranda,1979-04-04,90579541K,antonio.miranda@smartweb.digital,551483,ES06209535008739372467,1493.81,2022-09-28T15:38:07,Labastida,expenses,cash,-100.0,-25716.96
buyer_8,Antonio,Miranda,1979-04-04,90579541K,antonio.miranda@smartweb.digital,551483,ES06209535008739372467,1493.81,2022-09-29T11:42:43,Labastida,expenses,repairs,-36.42,-25753.38
buyer_8,Antonio,Miranda,1979-04-04,90579541K,antonio.miranda@smartweb.digital,551483,ES06209535008739372467,1493.81,2022-09-30T18:59:58,Labastida,expenses,leisure,-43.35,-25796.73
buyer_8,Antonio,Miranda,1979-04-04,90579541K,antonio.miranda@smartweb.digital,551483,ES06209535008739372467,1493.81,2022-09-30T15:08:04,Labastida,expenses,cash,-100.0,-25896.73
buyer_8,Antonio,Miranda,1979-04-04,90579541K,antonio.miranda@smartweb.digital,551483,ES06209535008739372467,1493.81,2022-10-01T15:25:43,Labastida,incomes,salary,3939.08,-21957.65
buyer_8,Antonio,Miranda,1979-04-04,90579541K,antonio.miranda@smartweb.digital,551483,ES06209535008739372467,1493.81,2022-10-01T16:30:43,Labastida,expenses,leisure,-82.27,-22039.92
buyer_8,Antonio,Miranda,1979-04-04,90579541K,antonio.miranda@smartweb.digital,551483,ES06209535008739372467,1493.81,2022-10-04T16:25:12,Labastida,expenses,mortgage,-2302.06,-24341.98
buyer_8,Antonio,Miranda,1979-04-04,90579541K,antonio.miranda@smartweb.digital,551483,ES06209535008739372467,1493.81,2022-10-05T08:31:33,Labastida,expenses,phone,-97.43,-24439.41
buyer_8,Antonio,Miranda,1979-04-04,90579541K,antonio.miranda@smartweb.digital,551483,ES06209535008739372467,1493.81,2022-10-05T21:35:56,Labastida,expenses,cash,-100.0,-24539.41
buyer_8,Antonio,Miranda,1979-04-04,90579541K,antonio.miranda@smartweb.digital,551483,ES06209535008739372467,1493.81,2022-10-06T17:23:54,Labastida,expenses,phone,-81.39,-24620.8
buyer_8,Antonio,Miranda,1979-04-04,90579541K,antonio.miranda@smartweb.digital,551483,ES06209535008739372467,1493.81,2022-10-06T13:30:58,Labastida,expenses,transport,-61.84,-24682.64
buyer_8,Antonio,Miranda,1979-04-04,90579541K,antonio.miranda@smartweb.digital,551483,ES06209535008739372467,1493.81,2022-10-06T12:49:46,Labastida,expenses,repairs,-302.43,-24985.07
buyer_8,Antonio,Miranda,1979-04-04,90579541K,antonio.miranda@smartweb.digital,551483,ES06209535008739372467,1493.81,2022-10-07T08:37:00,Labastida,expenses,phone,-87.39,-25072.46
buyer_8,Antonio,Miranda,1979-04-04,90579541K,antonio.miranda@smartweb.digital,551483,ES06209535008739372467,1493.81,2022-10-07T13:07:28,Labastida,expenses,food,-64.69,-25137.15
buyer_8,Antonio,Miranda,1979-04-04,90579541K,antonio.miranda@smartweb.digital,551483,ES06209535008739372467,1493.81,2022-10-09T23:19:10,Labastida,expenses,appliances,-315.06,-25452.21
buyer_8,Antonio,Miranda,1979-04-04,90579541K,antonio.miranda@smartweb.digital,551483,ES06209535008739372467,1493.81,2022-10-10T17:49:54,Labastida,expenses,food,-112.13,-25564.34
buyer_8,Antonio,Miranda,1979-04-04,90579541K,antonio.miranda@smartweb.digital,551483,ES06209535008739372467,1493.81,2022-10-10T20:19:20,Labastida,expenses,repairs,-175.74,-25740.08
buyer_8,Antonio,Miranda,1979-04-04,90579541K,antonio.miranda@smartweb.digital,551483,ES06209535008739372467,1493.81,2022-10-13T13:35:27,Labastida,expenses,cash,-100.0,-25840.08
buyer_8,Antonio,Miranda,1979-04-04,90579541K,antonio.miranda@smartweb.digital,551483,ES06209535008739372467,1493.81,2022-10-14T08:10:47,Labastida,expenses,cash,-100.0,-25940.08
buyer_8,Antonio,Miranda,1979-04-04,90579541K,antonio.miranda@smartweb.digital,551483,ES06209535008739372467,1493.81,2022-10-15T11:04:01,Labastida,expenses,repairs,-132.0,-26072.08
buyer_8,Antonio,Miranda,1979-04-04,90579541K,antonio.miranda@smartweb.digital,551483,ES06209535008739372467,1493.81,2022-10-17T09:53:34,Labastida,expenses,repairs,-85.98,-26158.06
buyer_8,Antonio,Miranda,1979-04-04,90579541K,antonio.miranda@smartweb.digital,551483,ES06209535008739372467,1493.81,2022-10-18T17:12:11,Labastida,expenses,clothing,-115.72,-26273.78
buyer_8,Antonio,Miranda,1979-04-04,90579541K,antonio.miranda@smartweb.digital,551483,ES06209535008739372467,1493.81,2022-10-21T07:04:11,Labastida,expenses,clothing,-116.84,-26390.62
buyer_8,Antonio,Miranda,1979-04-04,90579541K,antonio.miranda@smartweb.digital,551483,ES06209535008739372467,1493.81,2022-10-21T06:31:46,Labastida,expenses,travel,-822.17,-27212.79
buyer_8,Antonio,Miranda,1979-04-04,90579541K,antonio.miranda@smartweb.digital,551483,ES06209535008739372467,1493.81,2022-10-23T13:59:04,Labastida,expenses,leisure,-29.69,-27242.48
buyer_8,Antonio,Miranda,1979-04-04,90579541K,antonio.miranda@smartweb.digital,551483,ES06209535008739372467,1493.81,2022-10-23T18:12:08,Labastida,expenses,travel,-655.28,-27897.76
buyer_8,Antonio,Miranda,1979-04-04,90579541K,antonio.miranda@smartweb.digital,551483,ES06209535008739372467,1493.81,2022-10-23T17:03:59,Labastida,expenses,repairs,-188.04,-28085.8
buyer_8,Antonio,Miranda,1979-04-04,90579541K,antonio.miranda@smartweb.digital,551483,ES06209535008739372467,1493.81,2022-10-25T18:48:03,Labastida,expenses,travel,-503.68,-28589.48
buyer_8,Antonio,Miranda,1979-04-04,90579541K,antonio.miranda@smartweb.digital,551483,ES06209535008739372467,1493.81,2022-10-29T22:05:07,Labastida,expenses,transport,-80.07,-28669.55
buyer_8,Antonio,Miranda,1979-04-04,90579541K,antonio.miranda@smartweb.digital,551483,ES06209535008739372467,1493.81,2022-10-30T09:28:19,Labastida,expenses,leisure,-46.32,-28715.87
buyer_8,Antonio,Miranda,1979-04-04,90579541K,antonio.miranda@smartweb.digital,551483,ES06209535008739372467,1493.81,2022-11-01T13:28:21,Labastida,incomes,salary,3939.08,-24776.79
buyer_8,Antonio,Miranda,1979-04-04,90579541K,antonio.miranda@smartweb.digital,551483,ES06209535008739372467,1493.81,2022-11-01T13:28:21,Labastida,incomes,extra_income,531.65,-24245.14
buyer_8,Antonio,Miranda,1979-04-04,90579541K,antonio.miranda@smartweb.digital,551483,ES06209535008739372467,1493.81,2022-11-01T19:56:57,Labastida,expenses,food,-123.47,-24368.61
buyer_8,Antonio,Miranda,1979-04-04,90579541K,antonio.miranda@smartweb.digital,551483,ES06209535008739372467,1493.81,2022-11-03T20:52:45,Labastida,expenses,food,-80.99,-24449.6
buyer_8,Antonio,Miranda,1979-04-04,90579541K,antonio.miranda@smartweb.digital,551483,ES06209535008739372467,1493.81,2022-11-03T17:18:36,Labastida,expenses,cash,-100.0,-24549.6
buyer_8,Antonio,Miranda,1979-04-04,90579541K,antonio.miranda@smartweb.digital,551483,ES06209535008739372467,1493.81,2022-11-04T13:21:22,Labastida,expenses,mortgage,-2302.06,-26851.66
buyer_8,Antonio,Miranda,1979-04-04,90579541K,antonio.miranda@smartweb.digital,551483,ES06209535008739372467,1493.81,2022-11-04T15:19:34,Labastida,expenses,cash,-100.0,-26951.66
buyer_8,Antonio,Miranda,1979-04-04,90579541K,antonio.miranda@smartweb.digital,551483,ES06209535008739372467,1493.81,2022-11-05T16:32:52,Labastida,expenses,gifts,-745.19,-27696.85
buyer_8,Antonio,Miranda,1979-04-04,90579541K,antonio.miranda@smartweb.digital,551483,ES06209535008739372467,1493.81,2022-11-06T19:54:20,Labastida,expenses,transport,-74.42,-27771.27
buyer_8,Antonio,Miranda,1979-04-04,90579541K,antonio.miranda@smartweb.digital,551483,ES06209535008739372467,1493.81,2022-11-07T20:59:05,Labastida,expenses,water,-66.43,-27837.7
buyer_8,Antonio,Miranda,1979-04-04,90579541K,antonio.miranda@smartweb.digital,551483,ES06209535008739372467,1493.81,2022-11-07T13:12:08,Labastida,expenses,internet,-90.99,-27928.69
buyer_8,Antonio,Miranda,1979-04-04,90579541K,antonio.miranda@smartweb.digital,551483,ES06209535008739372467,1493.81,2022-11-08T15:42:00,Labastida,expenses,electricity,-171.17,-28099.86
buyer_8,Antonio,Miranda,1979-04-04,90579541K,antonio.miranda@smartweb.digital,551483,ES06209535008739372467,1493.81,2022-11-10T12:05:17,Labastida,expenses,transport,-69.41,-28169.27
buyer_8,Antonio,Miranda,1979-04-04,90579541K,antonio.miranda@smartweb.digital,551483,ES06209535008739372467,1493.81,2022-11-10T12:54:38,Labastida,expenses,leisure,-56.78,-28226.05
buyer_8,Antonio,Miranda,1979-04-04,90579541K,antonio.miranda@smartweb.digital,551483,ES06209535008739372467,1493.81,2022-11-10T23:58:48,Labastida,expenses,cash,-100.0,-28326.05
buyer_8,Antonio,Miranda,1979-04-04,90579541K,antonio.miranda@smartweb.digital,551483,ES06209535008739372467,1493.81,2022-11-11T14:08:04,Labastida,expenses,clothing,-59.23,-28385.28
buyer_8,Antonio,Miranda,1979-04-04,90579541K,antonio.miranda@smartweb.digital,551483,ES06209535008739372467,1493.81,2022-11-11T13:05:41,Labastida,expenses,gifts,-802.71,-29187.99
buyer_8,Antonio,Miranda,1979-04-04,90579541K,antonio.miranda@smartweb.digital,551483,ES06209535008739372467,1493.81,2022-11-17T10:31:55,Labastida,expenses,leisure,-34.42,-29222.41
buyer_8,Antonio,Miranda,1979-04-04,90579541K,antonio.miranda@smartweb.digital,551483,ES06209535008739372467,1493.81,2022-11-18T20:34:07,Labastida,expenses,food,-68.81,-29291.22
buyer_8,Antonio,Miranda,1979-04-04,90579541K,antonio.miranda@smartweb.digital,551483,ES06209535008739372467,1493.81,2022-11-19T09:45:25,Labastida,expenses,food,-67.85,-29359.07
buyer_8,Antonio,Miranda,1979-04-04,90579541K,antonio.miranda@smartweb.digital,551483,ES06209535008739372467,1493.81,2022-11-19T19:41:15,Labastida,expenses,cash,-100.0,-29459.07
buyer_8,Antonio,Miranda,1979-04-04,90579541K,antonio.miranda@smartweb.digital,551483,ES06209535008739372467,1493.81,2022-11-20T18:52:46,Labastida,expenses,appliances,-111.16,-29570.23
buyer_8,Antonio,Miranda,1979-04-04,90579541K,antonio.miranda@smartweb.digital,551483,ES06209535008739372467,1493.81,2022-11-21T20:24:50,Labastida,expenses,transport,-62.18,-29632.41
buyer_8,Antonio,Miranda,1979-04-04,90579541K,antonio.miranda@smartweb.digital,551483,ES06209535008739372467,1493.81,2022-11-24T20:24:58,Labastida,expenses,food,-94.99,-29727.4
buyer_8,Antonio,Miranda,1979-04-04,90579541K,antonio.miranda@smartweb.digital,551483,ES06209535008739372467,1493.81,2022-11-24T13:46:46,Labastida,expenses,healthcare,-147.46,-29874.86
buyer_8,Antonio,Miranda,1979-04-04,90579541K,antonio.miranda@smartweb.digital,551483,ES06209535008739372467,1493.81,2022-11-25T11:08:29,Labastida,expenses,food,-117.56,-29992.42
buyer_8,Antonio,Miranda,1979-04-04,90579541K,antonio.miranda@smartweb.digital,551483,ES06209535008739372467,1493.81,2022-11-27T19:56:41,Labastida,expenses,cash,-100.0,-30092.42
buyer_8,Antonio,Miranda,1979-04-04,90579541K,antonio.miranda@smartweb.digital,551483,ES06209535008739372467,1493.81,2022-11-29T12:35:54,Labastida,expenses,transport,-41.98,-30134.4
buyer_8,Antonio,Miranda,1979-04-04,90579541K,antonio.miranda@smartweb.digital,551483,ES06209535008739372467,1493.81,2022-11-30T14:27:40,Labastida,expenses,education,-63.84,-30198.24
buyer_8,Antonio,Miranda,1979-04-04,90579541K,antonio.miranda@smartweb.digital,551483,ES06209535008739372467,1493.81,2022-12-01T15:49:38,Labastida,incomes,salary,3939.08,-26259.16
buyer_8,Antonio,Miranda,1979-04-04,90579541K,antonio.miranda@smartweb.digital,551483,ES06209535008739372467,1493.81,2022-12-01T15:49:38,Labastida,incomes,salary_bonus,2892.8,-23366.36
buyer_8,Antonio,Miranda,1979-04-04,90579541K,antonio.miranda@smartweb.digital,551483,ES06209535008739372467,1493.81,2022-12-01T15:01:48,Labastida,expenses,cash,-100.0,-23466.36
buyer_8,Antonio,Miranda,1979-04-04,90579541K,antonio.miranda@smartweb.digital,551483,ES06209535008739372467,1493.81,2022-12-02T16:29:32,Labastida,expenses,clothing,-95.64,-23562.0
buyer_8,Antonio,Miranda,1979-04-04,90579541K,antonio.miranda@smartweb.digital,551483,ES06209535008739372467,1493.81,2022-12-03T08:13:47,Labastida,expenses,clothing,-111.36,-23673.36
buyer_8,Antonio,Miranda,1979-04-04,90579541K,antonio.miranda@smartweb.digital,551483,ES06209535008739372467,1493.81,2022-12-03T18:54:47,Labastida,expenses,cash,-100.0,-23773.36
buyer_8,Antonio,Miranda,1979-04-04,90579541K,antonio.miranda@smartweb.digital,551483,ES06209535008739372467,1493.81,2022-12-03T17:09:25,Labastida,expenses,appliances,-390.36,-24163.72
buyer_8,Antonio,Miranda,1979-04-04,90579541K,antonio.miranda@smartweb.digital,551483,ES06209535008739372467,1493.81,2022-12-04T08:45:11,Labastida,expenses,mortgage,-2302.06,-26465.78
buyer_8,Antonio,Miranda,1979-04-04,90579541K,antonio.miranda@smartweb.digital,551483,ES06209535008739372467,1493.81,2022-12-04T14:28:21,Labastida,expenses,leisure,-58.11,-26523.89
buyer_8,Antonio,Miranda,1979-04-04,90579541K,antonio.miranda@smartweb.digital,551483,ES06209535008739372467,1493.81,2022-12-05T08:10:03,Labastida,expenses,electricity,-189.59,-26713.48
buyer_8,Antonio,Miranda,1979-04-04,90579541K,antonio.miranda@smartweb.digital,551483,ES06209535008739372467,1493.81,2022-12-05T22:15:45,Labastida,expenses,transport,-52.82,-26766.3
buyer_8,Antonio,Miranda,1979-04-04,90579541K,antonio.miranda@smartweb.digital,551483,ES06209535008739372467,1493.81,2022-12-05T14:53:53,Labastida,expenses,gifts,-580.06,-27346.36
buyer_8,Antonio,Miranda,1979-04-04,90579541K,antonio.miranda@smartweb.digital,551483,ES06209535008739372467,1493.81,2022-12-06T11:05:22,Labastida,expenses,phone,-78.23,-27424.59
buyer_8,Antonio,Miranda,1979-04-04,90579541K,antonio.miranda@smartweb.digital,551483,ES06209535008739372467,1493.81,2022-12-06T22:58:12,Labastida,expenses,transport,-85.41,-27510.0
buyer_8,Antonio,Miranda,1979-04-04,90579541K,antonio.miranda@smartweb.digital,551483,ES06209535008739372467,1493.81,2022-12-06T21:39:31,Labastida,expenses,education,-47.97,-27557.97
buyer_8,Antonio,Miranda,1979-04-04,90579541K,antonio.miranda@smartweb.digital,551483,ES06209535008739372467,1493.81,2022-12-07T20:18:42,Labastida,expenses,transport,-74.37,-27632.34
buyer_8,Antonio,Miranda,1979-04-04,90579541K,antonio.miranda@smartweb.digital,551483,ES06209535008739372467,1493.81,2022-12-07T09:38:17,Labastida,expenses,leisure,-78.28,-27710.62
buyer_8,Antonio,Miranda,1979-04-04,90579541K,antonio.miranda@smartweb.digital,551483,ES06209535008739372467,1493.81,2022-12-08T11:21:06,Labastida,expenses,water,-66.54,-27777.16
buyer_8,Antonio,Miranda,1979-04-04,90579541K,antonio.miranda@smartweb.digital,551483,ES06209535008739372467,1493.81,2022-12-08T14:11:22,Labastida,expenses,cash,-100.0,-27877.16
buyer_8,Antonio,Miranda,1979-04-04,90579541K,antonio.miranda@smartweb.digital,551483,ES06209535008739372467,1493.81,2022-12-09T20:31:02,Labastida,expenses,cash,-100.0,-27977.16
buyer_8,Antonio,Miranda,1979-04-04,90579541K,antonio.miranda@smartweb.digital,551483,ES06209535008739372467,1493.81,2022-12-09T12:31:30,Labastida,expenses,appliances,-315.36,-28292.52
buyer_8,Antonio,Miranda,1979-04-04,90579541K,antonio.miranda@smartweb.digital,551483,ES06209535008739372467,1493.81,2022-12-10T08:44:08,Labastida,expenses,food,-79.91,-28372.43
buyer_8,Antonio,Miranda,1979-04-04,90579541K,antonio.miranda@smartweb.digital,551483,ES06209535008739372467,1493.81,2022-12-11T21:30:49,Labastida,expenses,food,-123.11,-28495.54
buyer_8,Antonio,Miranda,1979-04-04,90579541K,antonio.miranda@smartweb.digital,551483,ES06209535008739372467,1493.81,2022-12-11T17:54:47,Labastida,expenses,leisure,-50.43,-28545.97
buyer_8,Antonio,Miranda,1979-04-04,90579541K,antonio.miranda@smartweb.digital,551483,ES06209535008739372467,1493.81,2022-12-11T16:55:30,Labastida,expenses,cash,-100.0,-28645.97
buyer_8,Antonio,Miranda,1979-04-04,90579541K,antonio.miranda@smartweb.digital,551483,ES06209535008739372467,1493.81,2022-12-12T20:27:04,Labastida,expenses,transport,-64.7,-28710.67
buyer_8,Antonio,Miranda,1979-04-04,90579541K,antonio.miranda@smartweb.digital,551483,ES06209535008739372467,1493.81,2022-12-12T03:42:56,Labastida,expenses,cash,-100.0,-28810.67
buyer_8,Antonio,Miranda,1979-04-04,90579541K,antonio.miranda@smartweb.digital,551483,ES06209535008739372467,1493.81,2022-12-12T14:35:41,Labastida,expenses,repairs,-170.77,-28981.44
buyer_8,Antonio,Miranda,1979-04-04,90579541K,antonio.miranda@smartweb.digital,551483,ES06209535008739372467,1493.81,2022-12-14T22:59:48,Labastida,expenses,leisure,-30.91,-29012.35
buyer_8,Antonio,Miranda,1979-04-04,90579541K,antonio.miranda@smartweb.digital,551483,ES06209535008739372467,1493.81,2022-12-15T09:14:09,Labastida,expenses,repairs,-101.59,-29113.94
buyer_8,Antonio,Miranda,1979-04-04,90579541K,antonio.miranda@smartweb.digital,551483,ES06209535008739372467,1493.81,2022-12-17T12:47:13,Labastida,expenses,transport,-67.99,-29181.93
buyer_8,Antonio,Miranda,1979-04-04,90579541K,antonio.miranda@smartweb.digital,551483,ES06209535008739372467,1493.81,2022-12-20T16:34:26,Labastida,expenses,transport,-76.48,-29258.41
buyer_8,Antonio,Miranda,1979-04-04,90579541K,antonio.miranda@smartweb.digital,551483,ES06209535008739372467,1493.81,2022-12-22T19:19:30,Labastida,expenses,gifts,-535.6,-29794.01
buyer_8,Antonio,Miranda,1979-04-04,90579541K,antonio.miranda@smartweb.digital,551483,ES06209535008739372467,1493.81,2022-12-23T19:47:05,Labastida,expenses,appliances,-156.97,-29950.98
buyer_8,Antonio,Miranda,1979-04-04,90579541K,antonio.miranda@smartweb.digital,551483,ES06209535008739372467,1493.81,2022-12-23T08:51:40,Labastida,expenses,repairs,-300.37,-30251.35
buyer_8,Antonio,Miranda,1979-04-04,90579541K,antonio.miranda@smartweb.digital,551483,ES06209535008739372467,1493.81,2022-12-24T11:59:26,Labastida,expenses,cash,-100.0,-30351.35
buyer_8,Antonio,Miranda,1979-04-04,90579541K,antonio.miranda@smartweb.digital,551483,ES06209535008739372467,1493.81,2022-12-26T18:58:16,Labastida,expenses,food,-101.92,-30453.27
buyer_8,Antonio,Miranda,1979-04-04,90579541K,antonio.miranda@smartweb.digital,551483,ES06209535008739372467,1493.81,2022-12-28T08:09:21,Labastida,expenses,gifts,-177.64,-30630.91
buyer_8,Antonio,Miranda,1979-04-04,90579541K,antonio.miranda@smartweb.digital,551483,ES06209535008739372467,1493.81,2022-12-30T10:50:07,Labastida,expenses,gifts,-514.65,-31145.56
buyer_8,Antonio,Miranda,1979-04-04,90579541K,antonio.miranda@smartweb.digital,551483,ES06209535008739372467,1493.81,2022-12-31T14:20:47,Labastida,expenses,food,-66.76,-31212.32
buyer_8,Antonio,Miranda,1979-04-04,90579541K,antonio.miranda@smartweb.digital,551483,ES06209535008739372467,1493.81,2022-12-31T01:15:13,Labastida,expenses,clothing,-57.88,-31270.2
buyer_8,Antonio,Miranda,1979-04-04,90579541K,antonio.miranda@smartweb.digital,551483,ES06209535008739372467,1493.81,2023-01-01T16:14:38,Labastida,incomes,salary,4069.3,-27200.9
buyer_8,Antonio,Miranda,1979-04-04,90579541K,antonio.miranda@smartweb.digital,551483,ES06209535008739372467,1493.81,2023-01-01T12:43:49,Labastida,expenses,food,-110.44,-27311.34
buyer_8,Antonio,Miranda,1979-04-04,90579541K,antonio.miranda@smartweb.digital,551483,ES06209535008739372467,1493.81,2023-01-01T11:37:16,Labastida,expenses,leisure,-22.56,-27333.9
buyer_8,Antonio,Miranda,1979-04-04,90579541K,antonio.miranda@smartweb.digital,551483,ES06209535008739372467,1493.81,2023-01-02T15:25:21,Labastida,expenses,cash,-100.0,-27433.9
buyer_8,Antonio,Miranda,1979-04-04,90579541K,antonio.miranda@smartweb.digital,551483,ES06209535008739372467,1493.81,2023-01-03T12:05:06,Labastida,expenses,cash,-100.0,-27533.9
buyer_8,Antonio,Miranda,1979-04-04,90579541K,antonio.miranda@smartweb.digital,551483,ES06209535008739372467,1493.81,2023-01-04T09:09:25,Labastida,expenses,mortgage,-2056.66,-29590.56
buyer_8,Antonio,Miranda,1979-04-04,90579541K,antonio.miranda@smartweb.digital,551483,ES06209535008739372467,1493.81,2023-01-04T12:37:51,Labastida,expenses,cash,-100.0,-29690.56
buyer_8,Antonio,Miranda,1979-04-04,90579541K,antonio.miranda@smartweb.digital,551483,ES06209535008739372467,1493.81,2023-01-05T22:46:18,Labastida,expenses,gas,-239.64,-29930.2
buyer_8,Antonio,Miranda,1979-04-04,90579541K,antonio.miranda@smartweb.digital,551483,ES06209535008739372467,1493.81,2023-01-06T20:01:58,Labastida,expenses,food,-110.98,-30041.18
buyer_8,Antonio,Miranda,1979-04-04,90579541K,antonio.miranda@smartweb.digital,551483,ES06209535008739372467,1493.81,2023-01-07T13:33:24,Labastida,expenses,electricity,-55.77,-30096.95
buyer_8,Antonio,Miranda,1979-04-04,90579541K,antonio.miranda@smartweb.digital,551483,ES06209535008739372467,1493.81,2023-01-07T06:54:05,Labastida,expenses,transport,-73.05,-30170.0
buyer_8,Antonio,Miranda,1979-04-04,90579541K,antonio.miranda@smartweb.digital,551483,ES06209535008739372467,1493.81,2023-01-08T19:51:05,Labastida,expenses,food,-112.25,-30282.25
buyer_8,Antonio,Miranda,1979-04-04,90579541K,antonio.miranda@smartweb.digital,551483,ES06209535008739372467,1493.81,2023-01-09T10:08:14,Labastida,expenses,appliances,-213.21,-30495.46
buyer_8,Antonio,Miranda,1979-04-04,90579541K,antonio.miranda@smartweb.digital,551483,ES06209535008739372467,1493.81,2023-01-10T21:21:42,Labastida,expenses,gifts,-260.6,-30756.06
buyer_8,Antonio,Miranda,1979-04-04,90579541K,antonio.miranda@smartweb.digital,551483,ES06209535008739372467,1493.81,2023-01-11T19:52:43,Labastida,expenses,food,-111.56,-30867.62
buyer_8,Antonio,Miranda,1979-04-04,90579541K,antonio.miranda@smartweb.digital,551483,ES06209535008739372467,1493.81,2023-01-11T11:26:09,Labastida,expenses,healthcare,-136.52,-31004.14
buyer_8,Antonio,Miranda,1979-04-04,90579541K,antonio.miranda@smartweb.digital,551483,ES06209535008739372467,1493.81,2023-01-11T11:54:30,Labastida,expenses,education,-66.98,-31071.12
buyer_8,Antonio,Miranda,1979-04-04,90579541K,antonio.miranda@smartweb.digital,551483,ES06209535008739372467,1493.81,2023-01-12T09:01:47,Labastida,expenses,transport,-69.75,-31140.87
buyer_8,Antonio,Miranda,1979-04-04,90579541K,antonio.miranda@smartweb.digital,551483,ES06209535008739372467,1493.81,2023-01-13T11:20:15,Labastida,expenses,travel,-1088.38,-32229.25
buyer_8,Antonio,Miranda,1979-04-04,90579541K,antonio.miranda@smartweb.digital,551483,ES06209535008739372467,1493.81,2023-01-14T19:03:24,Labastida,expenses,leisure,-41.84,-32271.09
buyer_8,Antonio,Miranda,1979-04-04,90579541K,antonio.miranda@smartweb.digital,551483,ES06209535008739372467,1493.81,2023-01-14T18:04:22,Labastida,expenses,cash,-100.0,-32371.09
buyer_8,Antonio,Miranda,1979-04-04,90579541K,antonio.miranda@smartweb.digital,551483,ES06209535008739372467,1493.81,2023-01-14T17:43:53,Labastida,expenses,repairs,-311.89,-32682.98
buyer_8,Antonio,Miranda,1979-04-04,90579541K,antonio.miranda@smartweb.digital,551483,ES06209535008739372467,1493.81,2023-01-15T19:47:17,Labastida,expenses,repairs,-159.95,-32842.93
buyer_8,Antonio,Miranda,1979-04-04,90579541K,antonio.miranda@smartweb.digital,551483,ES06209535008739372467,1493.81,2023-01-19T19:00:02,Labastida,expenses,food,-113.91,-32956.84
buyer_8,Antonio,Miranda,1979-04-04,90579541K,antonio.miranda@smartweb.digital,551483,ES06209535008739372467,1493.81,2023-01-21T15:24:16,Labastida,expenses,cash,-100.0,-33056.84
buyer_8,Antonio,Miranda,1979-04-04,90579541K,antonio.miranda@smartweb.digital,551483,ES06209535008739372467,1493.81,2023-01-22T17:05:31,Labastida,expenses,leisure,-40.52,-33097.36
buyer_8,Antonio,Miranda,1979-04-04,90579541K,antonio.miranda@smartweb.digital,551483,ES06209535008739372467,1493.81,2023-01-23T13:43:44,Labastida,expenses,food,-60.12,-33157.48
buyer_8,Antonio,Miranda,1979-04-04,90579541K,antonio.miranda@smartweb.digital,551483,ES06209535008739372467,1493.81,2023-01-27T12:23:50,Labastida,expenses,clothing,-54.2,-33211.68
buyer_8,Antonio,Miranda,1979-04-04,90579541K,antonio.miranda@smartweb.digital,551483,ES06209535008739372467,1493.81,2023-01-28T08:45:38,Labastida,expenses,appliances,-347.7,-33559.38
buyer_8,Antonio,Miranda,1979-04-04,90579541K,antonio.miranda@smartweb.digital,551483,ES06209535008739372467,1493.81,2023-01-28T19:24:33,Labastida,expenses,repairs,-152.46,-33711.84
buyer_8,Antonio,Miranda,1979-04-04,90579541K,antonio.miranda@smartweb.digital,551483,ES06209535008739372467,1493.81,2023-01-31T13:07:57,Labastida,expenses,food,-124.57,-33836.41
buyer_8,Antonio,Miranda,1979-04-04,90579541K,antonio.miranda@smartweb.digital,551483,ES06209535008739372467,1493.81,2023-02-01T19:20:59,Labastida,incomes,salary,4069.3,-29767.11
buyer_8,Antonio,Miranda,1979-04-04,90579541K,antonio.miranda@smartweb.digital,551483,ES06209535008739372467,1493.81,2023-02-01T19:20:59,Labastida,incomes,extra_income,531.65,-29235.46
buyer_8,Antonio,Miranda,1979-04-04,90579541K,antonio.miranda@smartweb.digital,551483,ES06209535008739372467,1493.81,2023-02-03T14:22:54,Labastida,expenses,food,-64.4,-29299.86
buyer_8,Antonio,Miranda,1979-04-04,90579541K,antonio.miranda@smartweb.digital,551483,ES06209535008739372467,1493.81,2023-02-03T16:22:15,Labastida,expenses,leisure,-71.98,-29371.84
buyer_8,Antonio,Miranda,1979-04-04,90579541K,antonio.miranda@smartweb.digital,551483,ES06209535008739372467,1493.81,2023-02-04T15:50:25,Labastida,expenses,mortgage,-2056.66,-31428.5
buyer_8,Antonio,Miranda,1979-04-04,90579541K,antonio.miranda@smartweb.digital,551483,ES06209535008739372467,1493.81,2023-02-04T02:44:57,Labastida,expenses,transport,-56.11,-31484.61
buyer_8,Antonio,Miranda,1979-04-04,90579541K,antonio.miranda@smartweb.digital,551483,ES06209535008739372467,1493.81,2023-02-05T14:46:56,Labastida,expenses,food,-62.93,-31547.54
buyer_8,Antonio,Miranda,1979-04-04,90579541K,antonio.miranda@smartweb.digital,551483,ES06209535008739372467,1493.81,2023-02-05T22:51:11,Labastida,expenses,cash,-100.0,-31647.54
buyer_8,Antonio,Miranda,1979-04-04,90579541K,antonio.miranda@smartweb.digital,551483,ES06209535008739372467,1493.81,2023-02-07T08:45:44,Labastida,expenses,water,-78.48,-31726.02
buyer_8,Antonio,Miranda,1979-04-04,90579541K,antonio.miranda@smartweb.digital,551483,ES06209535008739372467,1493.81,2023-02-07T09:01:41,Labastida,expenses,food,-111.43,-31837.45
buyer_8,Antonio,Miranda,1979-04-04,90579541K,antonio.miranda@smartweb.digital,551483,ES06209535008739372467,1493.81,2023-02-07T08:18:24,Labastida,expenses,cash,-100.0,-31937.45
buyer_8,Antonio,Miranda,1979-04-04,90579541K,antonio.miranda@smartweb.digital,551483,ES06209535008739372467,1493.81,2023-02-08T13:26:43,Labastida,expenses,food,-100.73,-32038.18
buyer_8,Antonio,Miranda,1979-04-04,90579541K,antonio.miranda@smartweb.digital,551483,ES06209535008739372467,1493.81,2023-02-08T09:36:51,Labastida,expenses,transport,-65.93,-32104.11
buyer_8,Antonio,Miranda,1979-04-04,90579541K,antonio.miranda@smartweb.digital,551483,ES06209535008739372467,1493.81,2023-02-09T09:35:13,Labastida,expenses,cash,-100.0,-32204.11
buyer_8,Antonio,Miranda,1979-04-04,90579541K,antonio.miranda@smartweb.digital,551483,ES06209535008739372467,1493.81,2023-02-10T16:50:49,Labastida,expenses,appliances,-151.28,-32355.39
buyer_8,Antonio,Miranda,1979-04-04,90579541K,antonio.miranda@smartweb.digital,551483,ES06209535008739372467,1493.81,2023-02-11T08:45:51,Labastida,expenses,transport,-47.69,-32403.08
buyer_8,Antonio,Miranda,1979-04-04,90579541K,antonio.miranda@smartweb.digital,551483,ES06209535008739372467,1493.81,2023-02-12T11:17:57,Labastida,expenses,gifts,-780.21,-33183.29
buyer_8,Antonio,Miranda,1979-04-04,90579541K,antonio.miranda@smartweb.digital,551483,ES06209535008739372467,1493.81,2023-02-13T10:28:27,Labastida,expenses,food,-119.8,-33303.09
buyer_8,Antonio,Miranda,1979-04-04,90579541K,antonio.miranda@smartweb.digital,551483,ES06209535008739372467,1493.81,2023-02-14T18:30:24,Labastida,expenses,appliances,-151.16,-33454.25
buyer_8,Antonio,Miranda,1979-04-04,90579541K,antonio.miranda@smartweb.digital,551483,ES06209535008739372467,1493.81,2023-02-16T18:22:48,Labastida,expenses,repairs,-328.28,-33782.53
buyer_8,Antonio,Miranda,1979-04-04,90579541K,antonio.miranda@smartweb.digital,551483,ES06209535008739372467,1493.81,2023-02-17T13:14:57,Labastida,expenses,food,-62.31,-33844.84
buyer_8,Antonio,Miranda,1979-04-04,90579541K,antonio.miranda@smartweb.digital,551483,ES06209535008739372467,1493.81,2023-02-17T20:58:25,Labastida,expenses,leisure,-81.88,-33926.72
buyer_8,Antonio,Miranda,1979-04-04,90579541K,antonio.miranda@smartweb.digital,551483,ES06209535008739372467,1493.81,2023-02-18T16:44:19,Labastida,expenses,transport,-54.12,-33980.84
buyer_8,Antonio,Miranda,1979-04-04,90579541K,antonio.miranda@smartweb.digital,551483,ES06209535008739372467,1493.81,2023-02-20T11:19:35,Labastida,expenses,leisure,-57.94,-34038.78
buyer_8,Antonio,Miranda,1979-04-04,90579541K,antonio.miranda@smartweb.digital,551483,ES06209535008739372467,1493.81,2023-02-21T19:37:14,Labastida,expenses,education,-69.36,-34108.14
buyer_8,Antonio,Miranda,1979-04-04,90579541K,antonio.miranda@smartweb.digital,551483,ES06209535008739372467,1493.81,2023-02-22T13:15:04,Labastida,expenses,travel,-990.49,-35098.63
buyer_8,Antonio,Miranda,1979-04-04,90579541K,antonio.miranda@smartweb.digital,551483,ES06209535008739372467,1493.81,2023-02-27T11:06:52,Labastida,expenses,healthcare,-119.21,-35217.84
buyer_8,Antonio,Miranda,1979-04-04,90579541K,antonio.miranda@smartweb.digital,551483,ES06209535008739372467,1493.81,2023-02-28T15:49:54,Labastida,expenses,gifts,-211.59,-35429.43
buyer_8,Antonio,Miranda,1979-04-04,90579541K,antonio.miranda@smartweb.digital,551483,ES06209535008739372467,1493.81,2023-03-01T14:13:56,Labastida,incomes,salary,4069.3,-31360.13
buyer_8,Antonio,Miranda,1979-04-04,90579541K,antonio.miranda@smartweb.digital,551483,ES06209535008739372467,1493.81,2023-03-02T20:41:40,Labastida,expenses,cash,-100.0,-31460.13
buyer_8,Antonio,Miranda,1979-04-04,90579541K,antonio.miranda@smartweb.digital,551483,ES06209535008739372467,1493.81,2023-03-04T13:55:03,Labastida,expenses,mortgage,-2056.66,-33516.79
buyer_8,Antonio,Miranda,1979-04-04,90579541K,antonio.miranda@smartweb.digital,551483,ES06209535008739372467,1493.81,2023-03-05T13:54:39,Labastida,expenses,phone,-91.39,-33608.18
buyer_8,Antonio,Miranda,1979-04-04,90579541K,antonio.miranda@smartweb.digital,551483,ES06209535008739372467,1493.81,2023-03-05T14:36:38,Labastida,expenses,leisure,-59.96,-33668.14
buyer_8,Antonio,Miranda,1979-04-04,90579541K,antonio.miranda@smartweb.digital,551483,ES06209535008739372467,1493.81,2023-03-05T04:01:37,Labastida,expenses,cash,-100.0,-33768.14
buyer_8,Antonio,Miranda,1979-04-04,90579541K,antonio.miranda@smartweb.digital,551483,ES06209535008739372467,1493.81,2023-03-06T20:30:47,Labastida,expenses,water,-62.03,-33830.17
buyer_8,Antonio,Miranda,1979-04-04,90579541K,antonio.miranda@smartweb.digital,551483,ES06209535008739372467,1493.81,2023-03-06T15:39:23,Labastida,expenses,internet,-94.0,-33924.17
buyer_8,Antonio,Miranda,1979-04-04,90579541K,antonio.miranda@smartweb.digital,551483,ES06209535008739372467,1493.81,2023-03-07T09:49:06,Labastida,expenses,internet,-94.0,-34018.17
buyer_8,Antonio,Miranda,1979-04-04,90579541K,antonio.miranda@smartweb.digital,551483,ES06209535008739372467,1493.81,2023-03-08T06:40:20,Labastida,expenses,internet,-94.0,-34112.17
buyer_8,Antonio,Miranda,1979-04-04,90579541K,antonio.miranda@smartweb.digital,551483,ES06209535008739372467,1493.81,2023-03-09T11:54:38,Labastida,expenses,travel,-475.7,-34587.87
buyer_8,Antonio,Miranda,1979-04-04,90579541K,antonio.miranda@smartweb.digital,551483,ES06209535008739372467,1493.81,2023-03-10T14:07:49,Labastida,expenses,repairs,-66.83,-34654.7
buyer_8,Antonio,Miranda,1979-04-04,90579541K,antonio.miranda@smartweb.digital,551483,ES06209535008739372467,1493.81,2023-03-11T17:02:14,Labastida,expenses,leisure,-48.26,-34702.96
buyer_8,Antonio,Miranda,1979-04-04,90579541K,antonio.miranda@smartweb.digital,551483,ES06209535008739372467,1493.81,2023-03-11T11:58:37,Labastida,expenses,education,-68.05,-34771.01
buyer_8,Antonio,Miranda,1979-04-04,90579541K,antonio.miranda@smartweb.digital,551483,ES06209535008739372467,1493.81,2023-03-13T16:51:29,Labastida,expenses,cash,-100.0,-34871.01
buyer_8,Antonio,Miranda,1979-04-04,90579541K,antonio.miranda@smartweb.digital,551483,ES06209535008739372467,1493.81,2023-03-14T17:00:37,Labastida,expenses,leisure,-49.42,-34920.43
buyer_8,Antonio,Miranda,1979-04-04,90579541K,antonio.miranda@smartweb.digital,551483,ES06209535008739372467,1493.81,2023-03-15T18:20:09,Labastida,expenses,leisure,-18.49,-34938.92
buyer_8,Antonio,Miranda,1979-04-04,90579541K,antonio.miranda@smartweb.digital,551483,ES06209535008739372467,1493.81,2023-03-16T17:48:05,Labastida,expenses,cash,-100.0,-35038.92
buyer_8,Antonio,Miranda,1979-04-04,90579541K,antonio.miranda@smartweb.digital,551483,ES06209535008739372467,1493.81,2023-03-17T10:22:20,Labastida,expenses,education,-44.93,-35083.85
buyer_8,Antonio,Miranda,1979-04-04,90579541K,antonio.miranda@smartweb.digital,551483,ES06209535008739372467,1493.81,2023-03-17T11:39:42,Labastida,expenses,repairs,-136.98,-35220.83
buyer_8,Antonio,Miranda,1979-04-04,90579541K,antonio.miranda@smartweb.digital,551483,ES06209535008739372467,1493.81,2023-03-19T14:25:42,Labastida,expenses,cash,-100.0,-35320.83
buyer_8,Antonio,Miranda,1979-04-04,90579541K,antonio.miranda@smartweb.digital,551483,ES06209535008739372467,1493.81,2023-03-20T12:56:19,Labastida,expenses,gifts,-772.38,-36093.21
buyer_8,Antonio,Miranda,1979-04-04,90579541K,antonio.miranda@smartweb.digital,551483,ES06209535008739372467,1493.81,2023-03-21T14:30:16,Labastida,expenses,cash,-100.0,-36193.21
buyer_8,Antonio,Miranda,1979-04-04,90579541K,antonio.miranda@smartweb.digital,551483,ES06209535008739372467,1493.81,2023-03-21T08:48:05,Labastida,expenses,repairs,-218.31,-36411.52
buyer_8,Antonio,Miranda,1979-04-04,90579541K,antonio.miranda@smartweb.digital,551483,ES06209535008739372467,1493.81,2023-03-27T17:01:42,Labastida,expenses,transport,-47.74,-36459.26
buyer_8,Antonio,Miranda,1979-04-04,90579541K,antonio.miranda@smartweb.digital,551483,ES06209535008739372467,1493.81,2023-03-29T23:14:34,Labastida,expenses,cash,-100.0,-36559.26
buyer_8,Antonio,Miranda,1979-04-04,90579541K,antonio.miranda@smartweb.digital,551483,ES06209535008739372467,1493.81,2023-03-31T12:10:23,Labastida,expenses,food,-82.45,-36641.71
buyer_8,Antonio,Miranda,1979-04-04,90579541K,antonio.miranda@smartweb.digital,551483,ES06209535008739372467,1493.81,2023-04-01T14:19:55,Labastida,incomes,salary,4069.3,-32572.41
buyer_8,Antonio,Miranda,1979-04-04,90579541K,antonio.miranda@smartweb.digital,551483,ES06209535008739372467,1493.81,2023-04-01T10:14:40,Labastida,expenses,clothing,-102.03,-32674.44
buyer_8,Antonio,Miranda,1979-04-04,90579541K,antonio.miranda@smartweb.digital,551483,ES06209535008739372467,1493.81,2023-04-02T11:02:37,Labastida,expenses,repairs,-88.3,-32762.74
buyer_8,Antonio,Miranda,1979-04-04,90579541K,antonio.miranda@smartweb.digital,551483,ES06209535008739372467,1493.81,2023-04-03T17:43:29,Labastida,expenses,transport,-46.6,-32809.34
buyer_8,Antonio,Miranda,1979-04-04,90579541K,antonio.miranda@smartweb.digital,551483,ES06209535008739372467,1493.81,2023-04-03T15:09:48,Labastida,expenses,cash,-100.0,-32909.34
buyer_8,Antonio,Miranda,1979-04-04,90579541K,antonio.miranda@smartweb.digital,551483,ES06209535008739372467,1493.81,2023-04-04T12:46:40,Labastida,expenses,mortgage,-2056.66,-34966.0
buyer_8,Antonio,Miranda,1979-04-04,90579541K,antonio.miranda@smartweb.digital,551483,ES06209535008739372467,1493.81,2023-04-04T10:59:36,Labastida,expenses,food,-121.01,-35087.01
buyer_8,Antonio,Miranda,1979-04-04,90579541K,antonio.miranda@smartweb.digital,551483,ES06209535008739372467,1493.81,2023-04-06T19:03:33,Labastida,expenses,electricity,-134.02,-35221.03
buyer_8,Antonio,Miranda,1979-04-04,90579541K,antonio.miranda@smartweb.digital,551483,ES06209535008739372467,1493.81,2023-04-07T20:26:26,Labastida,expenses,gas,-230.24,-35451.27
buyer_8,Antonio,Miranda,1979-04-04,90579541K,antonio.miranda@smartweb.digital,551483,ES06209535008739372467,1493.81,2023-04-07T21:27:17,Labastida,expenses,repairs,-332.96,-35784.23
buyer_8,Antonio,Miranda,1979-04-04,90579541K,antonio.miranda@smartweb.digital,551483,ES06209535008739372467,1493.81,2023-04-08T21:29:04,Labastida,expenses,transport,-55.88,-35840.11
buyer_8,Antonio,Miranda,1979-04-04,90579541K,antonio.miranda@smartweb.digital,551483,ES06209535008739372467,1493.81,2023-04-09T18:17:13,Labastida,expenses,transport,-84.27,-35924.38
buyer_8,Antonio,Miranda,1979-04-04,90579541K,antonio.miranda@smartweb.digital,551483,ES06209535008739372467,1493.81,2023-04-10T15:54:15,Labastida,expenses,cash,-100.0,-36024.38
buyer_8,Antonio,Miranda,1979-04-04,90579541K,antonio.miranda@smartweb.digital,551483,ES06209535008739372467,1493.81,2023-04-11T13:21:01,Labastida,expenses,food,-105.86,-36130.24
buyer_8,Antonio,Miranda,1979-04-04,90579541K,antonio.miranda@smartweb.digital,551483,ES06209535008739372467,1493.81,2023-04-11T15:49:46,Labastida,expenses,repairs,-171.29,-36301.53
buyer_8,Antonio,Miranda,1979-04-04,90579541K,antonio.miranda@smartweb.digital,551483,ES06209535008739372467,1493.81,2023-04-12T18:00:11,Labastida,expenses,transport,-60.24,-36361.77
buyer_8,Antonio,Miranda,1979-04-04,90579541K,antonio.miranda@smartweb.digital,551483,ES06209535008739372467,1493.81,2023-04-13T13:29:49,Labastida,expenses,food,-66.9,-36428.67
buyer_8,Antonio,Miranda,1979-04-04,90579541K,antonio.miranda@smartweb.digital,551483,ES06209535008739372467,1493.81,2023-04-15T14:42:48,Labastida,expenses,cash,-100.0,-36528.67
buyer_8,Antonio,Miranda,1979-04-04,90579541K,antonio.miranda@smartweb.digital,551483,ES06209535008739372467,1493.81,2023-04-16T23:00:01,Labastida,expenses,appliances,-336.16,-36864.83
buyer_8,Antonio,Miranda,1979-04-04,90579541K,antonio.miranda@smartweb.digital,551483,ES06209535008739372467,1493.81,2023-04-16T22:27:40,Labastida,expenses,gifts,-314.82,-37179.65
buyer_8,Antonio,Miranda,1979-04-04,90579541K,antonio.miranda@smartweb.digital,551483,ES06209535008739372467,1493.81,2023-04-18T11:42:54,Labastida,expenses,leisure,-52.11,-37231.76
buyer_8,Antonio,Miranda,1979-04-04,90579541K,antonio.miranda@smartweb.digital,551483,ES06209535008739372467,1493.81,2023-04-19T08:42:36,Labastida,expenses,leisure,-22.56,-37254.32
buyer_8,Antonio,Miranda,1979-04-04,90579541K,antonio.miranda@smartweb.digital,551483,ES06209535008739372467,1493.81,2023-04-20T10:15:04,Labastida,expenses,food,-123.87,-37378.19
buyer_8,Antonio,Miranda,1979-04-04,90579541K,antonio.miranda@smartweb.digital,551483,ES06209535008739372467,1493.81,2023-04-21T20:32:17,Labastida,expenses,cash,-100.0,-37478.19
buyer_8,Antonio,Miranda,1979-04-04,90579541K,antonio.miranda@smartweb.digital,551483,ES06209535008739372467,1493.81,2023-04-21T22:32:14,Labastida,expenses,repairs,-59.28,-37537.47
buyer_8,Antonio,Miranda,1979-04-04,90579541K,antonio.miranda@smartweb.digital,551483,ES06209535008739372467,1493.81,2023-04-22T15:07:43,Labastida,expenses,leisure,-33.25,-37570.72
buyer_8,Antonio,Miranda,1979-04-04,90579541K,antonio.miranda@smartweb.digital,551483,ES06209535008739372467,1493.81,2023-04-22T16:15:48,Labastida,expenses,appliances,-196.02,-37766.74
buyer_8,Antonio,Miranda,1979-04-04,90579541K,antonio.miranda@smartweb.digital,551483,ES06209535008739372467,1493.81,2023-04-23T06:48:01,Labastida,expenses,food,-66.88,-37833.62
buyer_8,Antonio,Miranda,1979-04-04,90579541K,antonio.miranda@smartweb.digital,551483,ES06209535008739372467,1493.81,2023-04-23T15:06:31,Labastida,expenses,repairs,-77.71,-37911.33
buyer_8,Antonio,Miranda,1979-04-04,90579541K,antonio.miranda@smartweb.digital,551483,ES06209535008739372467,1493.81,2023-04-25T19:42:19,Labastida,expenses,gifts,-369.41,-38280.74
buyer_8,Antonio,Miranda,1979-04-04,90579541K,antonio.miranda@smartweb.digital,551483,ES06209535008739372467,1493.81,2023-04-26T13:14:33,Labastida,expenses,cash,-100.0,-38380.74
buyer_8,Antonio,Miranda,1979-04-04,90579541K,antonio.miranda@smartweb.digital,551483,ES06209535008739372467,1493.81,2023-04-27T22:38:11,Labastida,expenses,healthcare,-126.4,-38507.14
buyer_8,Antonio,Miranda,1979-04-04,90579541K,antonio.miranda@smartweb.digital,551483,ES06209535008739372467,1493.81,2023-04-28T09:54:04,Labastida,expenses,cash,-100.0,-38607.14
buyer_8,Antonio,Miranda,1979-04-04,90579541K,antonio.miranda@smartweb.digital,551483,ES06209535008739372467,1493.81,2023-04-30T11:58:04,Labastida,expenses,transport,-72.5,-38679.64
buyer_8,Antonio,Miranda,1979-04-04,90579541K,antonio.miranda@smartweb.digital,551483,ES06209535008739372467,1493.81,2023-05-01T16:31:25,Labastida,incomes,salary,4069.3,-34610.34
buyer_8,Antonio,Miranda,1979-04-04,90579541K,antonio.miranda@smartweb.digital,551483,ES06209535008739372467,1493.81,2023-05-01T16:31:25,Labastida,incomes,extra_income,531.65,-34078.69
buyer_8,Antonio,Miranda,1979-04-04,90579541K,antonio.miranda@smartweb.digital,551483,ES06209535008739372467,1493.81,2023-05-03T18:16:28,Labastida,expenses,appliances,-89.48,-34168.17
buyer_8,Antonio,Miranda,1979-04-04,90579541K,antonio.miranda@smartweb.digital,551483,ES06209535008739372467,1493.81,2023-05-04T11:04:53,Labastida,expenses,mortgage,-2056.66,-36224.83
buyer_8,Antonio,Miranda,1979-04-04,90579541K,antonio.miranda@smartweb.digital,551483,ES06209535008739372467,1493.81,2023-05-04T13:31:44,Labastida,expenses,transport,-87.25,-36312.08
buyer_8,Antonio,Miranda,1979-04-04,90579541K,antonio.miranda@smartweb.digital,551483,ES06209535008739372467,1493.81,2023-05-05T11:25:58,Labastida,expenses,water,-68.36,-36380.44
buyer_8,Antonio,Miranda,1979-04-04,90579541K,antonio.miranda@smartweb.digital,551483,ES06209535008739372467,1493.81,2023-05-05T12:08:16,Labastida,expenses,electricity,-59.66,-36440.1
buyer_8,Antonio,Miranda,1979-04-04,90579541K,antonio.miranda@smartweb.digital,551483,ES06209535008739372467,1493.81,2023-05-05T17:34:19,Labastida,expenses,transport,-43.02,-36483.12
buyer_8,Antonio,Miranda,1979-04-04,90579541K,antonio.miranda@smartweb.digital,551483,ES06209535008739372467,1493.81,2023-05-05T16:55:52,Labastida,expenses,leisure,-75.53,-36558.65
buyer_8,Antonio,Miranda,1979-04-04,90579541K,antonio.miranda@smartweb.digital,551483,ES06209535008739372467,1493.81,2023-05-05T19:17:01,Labastida,expenses,repairs,-81.38,-36640.03
buyer_8,Antonio,Miranda,1979-04-04,90579541K,antonio.miranda@smartweb.digital,551483,ES06209535008739372467,1493.81,2023-05-07T10:54:01,Labastida,expenses,electricity,-170.63,-36810.66
buyer_8,Antonio,Miranda,1979-04-04,90579541K,antonio.miranda@smartweb.digital,551483,ES06209535008739372467,1493.81,2023-05-07T11:12:49,Labastida,expenses,gas,-156.96,-36967.62
buyer_8,Antonio,Miranda,1979-04-04,90579541K,antonio.miranda@smartweb.digital,551483,ES06209535008739372467,1493.81,2023-05-07T16:21:56,Labastida,expenses,cash,-100.0,-37067.62
buyer_8,Antonio,Miranda,1979-04-04,90579541K,antonio.miranda@smartweb.digital,551483,ES06209535008739372467,1493.81,2023-05-08T14:56:28,Labastida,expenses,phone,-80.85,-37148.47
buyer_8,Antonio,Miranda,1979-04-04,90579541K,antonio.miranda@smartweb.digital,551483,ES06209535008739372467,1493.81,2023-05-09T18:21:40,Labastida,expenses,clothing,-69.46,-37217.93
buyer_8,Antonio,Miranda,1979-04-04,90579541K,antonio.miranda@smartweb.digital,551483,ES06209535008739372467,1493.81,2023-05-10T18:08:33,Labastida,expenses,cash,-100.0,-37317.93
buyer_8,Antonio,Miranda,1979-04-04,90579541K,antonio.miranda@smartweb.digital,551483,ES06209535008739372467,1493.81,2023-05-11T11:19:19,Labastida,expenses,leisure,-37.25,-37355.18
buyer_8,Antonio,Miranda,1979-04-04,90579541K,antonio.miranda@smartweb.digital,551483,ES06209535008739372467,1493.81,2023-05-11T14:24:14,Labastida,expenses,cash,-100.0,-37455.18
buyer_8,Antonio,Miranda,1979-04-04,90579541K,antonio.miranda@smartweb.digital,551483,ES06209535008739372467,1493.81,2023-05-12T18:34:29,Labastida,expenses,cash,-100.0,-37555.18
buyer_8,Antonio,Miranda,1979-04-04,90579541K,antonio.miranda@smartweb.digital,551483,ES06209535008739372467,1493.81,2023-05-13T07:52:13,Labastida,expenses,food,-87.35,-37642.53
buyer_8,Antonio,Miranda,1979-04-04,90579541K,antonio.miranda@smartweb.digital,551483,ES06209535008739372467,1493.81,2023-05-13T04:27:28,Labastida,expenses,cash,-100.0,-37742.53
buyer_8,Antonio,Miranda,1979-04-04,90579541K,antonio.miranda@smartweb.digital,551483,ES06209535008739372467,1493.81,2023-05-14T20:23:16,Labastida,expenses,food,-63.5,-37806.03
buyer_8,Antonio,Miranda,1979-04-04,90579541K,antonio.miranda@smartweb.digital,551483,ES06209535008739372467,1493.81,2023-05-14T18:53:01,Labastida,expenses,transport,-55.6,-37861.63
buyer_8,Antonio,Miranda,1979-04-04,90579541K,antonio.miranda@smartweb.digital,551483,ES06209535008739372467,1493.81,2023-05-16T13:15:27,Labastida,expenses,gifts,-195.28,-38056.91
buyer_8,Antonio,Miranda,1979-04-04,90579541K,antonio.miranda@smartweb.digital,551483,ES06209535008739372467,1493.81,2023-05-17T10:15:47,Labastida,expenses,cash,-100.0,-38156.91
buyer_8,Antonio,Miranda,1979-04-04,90579541K,antonio.miranda@smartweb.digital,551483,ES06209535008739372467,1493.81,2023-05-18T20:10:40,Labastida,expenses,leisure,-84.43,-38241.34
buyer_8,Antonio,Miranda,1979-04-04,90579541K,antonio.miranda@smartweb.digital,551483,ES06209535008739372467,1493.81,2023-05-18T13:58:51,Labastida,expenses,gifts,-313.51,-38554.85
buyer_8,Antonio,Miranda,1979-04-04,90579541K,antonio.miranda@smartweb.digital,551483,ES06209535008739372467,1493.81,2023-05-19T10:18:10,Labastida,expenses,food,-114.41,-38669.26
buyer_8,Antonio,Miranda,1979-04-04,90579541K,antonio.miranda@smartweb.digital,551483,ES06209535008739372467,1493.81,2023-05-20T08:10:23,Labastida,expenses,food,-67.22,-38736.48
buyer_8,Antonio,Miranda,1979-04-04,90579541K,antonio.miranda@smartweb.digital,551483,ES06209535008739372467,1493.81,2023-05-20T19:54:02,Labastida,expenses,leisure,-44.01,-38780.49
buyer_8,Antonio,Miranda,1979-04-04,90579541K,antonio.miranda@smartweb.digital,551483,ES06209535008739372467,1493.81,2023-05-20T22:59:02,Labastida,expenses,healthcare,-67.82,-38848.31
buyer_8,Antonio,Miranda,1979-04-04,90579541K,antonio.miranda@smartweb.digital,551483,ES06209535008739372467,1493.81,2023-05-20T14:00:20,Labastida,expenses,cash,-100.0,-38948.31
buyer_8,Antonio,Miranda,1979-04-04,90579541K,antonio.miranda@smartweb.digital,551483,ES06209535008739372467,1493.81,2023-05-22T14:44:08,Labastida,expenses,food,-68.01,-39016.32
buyer_8,Antonio,Miranda,1979-04-04,90579541K,antonio.miranda@smartweb.digital,551483,ES06209535008739372467,1493.81,2023-05-22T11:19:16,Labastida,expenses,education,-77.8,-39094.12
buyer_8,Antonio,Miranda,1979-04-04,90579541K,antonio.miranda@smartweb.digital,551483,ES06209535008739372467,1493.81,2023-05-26T16:44:09,Labastida,expenses,education,-50.28,-39144.4
buyer_8,Antonio,Miranda,1979-04-04,90579541K,antonio.miranda@smartweb.digital,551483,ES06209535008739372467,1493.81,2023-05-28T14:16:41,Labastida,expenses,food,-111.11,-39255.51
buyer_8,Antonio,Miranda,1979-04-04,90579541K,antonio.miranda@smartweb.digital,551483,ES06209535008739372467,1493.81,2023-05-28T23:21:22,Labastida,expenses,leisure,-47.64,-39303.15
buyer_8,Antonio,Miranda,1979-04-04,90579541K,antonio.miranda@smartweb.digital,551483,ES06209535008739372467,1493.81,2023-06-01T17:19:23,Labastida,incomes,salary,4069.3,-35233.85
buyer_8,Antonio,Miranda,1979-04-04,90579541K,antonio.miranda@smartweb.digital,551483,ES06209535008739372467,1493.81,2023-06-01T17:19:23,Labastida,incomes,salary_bonus,2974.95,-32258.9
buyer_8,Antonio,Miranda,1979-04-04,90579541K,antonio.miranda@smartweb.digital,551483,ES06209535008739372467,1493.81,2023-06-02T00:27:27,Labastida,expenses,cash,-100.0,-32358.9
buyer_8,Antonio,Miranda,1979-04-04,90579541K,antonio.miranda@smartweb.digital,551483,ES06209535008739372467,1493.81,2023-06-03T13:59:38,Labastida,expenses,taxes,-3983.69,-36342.59
buyer_8,Antonio,Miranda,1979-04-04,90579541K,antonio.miranda@smartweb.digital,551483,ES06209535008739372467,1493.81,2023-06-03T16:03:27,Labastida,expenses,insurance,-1172.85,-37515.44
buyer_8,Antonio,Miranda,1979-04-04,90579541K,antonio.miranda@smartweb.digital,551483,ES06209535008739372467,1493.81,2023-06-03T17:11:07,Labastida,expenses,cash,-100.0,-37615.44
buyer_8,Antonio,Miranda,1979-04-04,90579541K,antonio.miranda@smartweb.digital,551483,ES06209535008739372467,1493.81,2023-06-03T09:39:16,Labastida,expenses,gifts,-798.27,-38413.71
buyer_8,Antonio,Miranda,1979-04-04,90579541K,antonio.miranda@smartweb.digital,551483,ES06209535008739372467,1493.81,2023-06-04T16:49:23,Labastida,expenses,mortgage,-2056.66,-40470.37
buyer_8,Antonio,Miranda,1979-04-04,90579541K,antonio.miranda@smartweb.digital,551483,ES06209535008739372467,1493.81,2023-06-06T19:09:41,Labastida,expenses,internet,-94.0,-40564.37
buyer_8,Antonio,Miranda,1979-04-04,90579541K,antonio.miranda@smartweb.digital,551483,ES06209535008739372467,1493.81,2023-06-06T10:16:28,Labastida,expenses,phone,-77.01,-40641.38
buyer_8,Antonio,Miranda,1979-04-04,90579541K,antonio.miranda@smartweb.digital,551483,ES06209535008739372467,1493.81,2023-06-06T11:47:30,Labastida,expenses,cash,-100.0,-40741.38
buyer_8,Antonio,Miranda,1979-04-04,90579541K,antonio.miranda@smartweb.digital,551483,ES06209535008739372467,1493.81,2023-06-07T20:09:44,Labastida,expenses,water,-60.15,-40801.53
buyer_8,Antonio,Miranda,1979-04-04,90579541K,antonio.miranda@smartweb.digital,551483,ES06209535008739372467,1493.81,2023-06-07T14:38:38,Labastida,expenses,cash,-100.0,-40901.53
buyer_8,Antonio,Miranda,1979-04-04,90579541K,antonio.miranda@smartweb.digital,551483,ES06209535008739372467,1493.81,2023-06-07T10:14:30,Labastida,expenses,repairs,-48.06,-40949.59
buyer_8,Antonio,Miranda,1979-04-04,90579541K,antonio.miranda@smartweb.digital,551483,ES06209535008739372467,1493.81,2023-06-08T15:25:29,Labastida,expenses,transport,-41.49,-40991.08
buyer_8,Antonio,Miranda,1979-04-04,90579541K,antonio.miranda@smartweb.digital,551483,ES06209535008739372467,1493.81,2023-06-09T15:43:07,Labastida,expenses,cash,-100.0,-41091.08
buyer_8,Antonio,Miranda,1979-04-04,90579541K,antonio.miranda@smartweb.digital,551483,ES06209535008739372467,1493.81,2023-06-09T17:42:39,Labastida,expenses,appliances,-327.34,-41418.42
buyer_8,Antonio,Miranda,1979-04-04,90579541K,antonio.miranda@smartweb.digital,551483,ES06209535008739372467,1493.81,2023-06-12T09:36:33,Labastida,expenses,clothing,-118.02,-41536.44
buyer_8,Antonio,Miranda,1979-04-04,90579541K,antonio.miranda@smartweb.digital,551483,ES06209535008739372467,1493.81,2023-06-13T12:27:50,Labastida,expenses,cash,-100.0,-41636.44
buyer_8,Antonio,Miranda,1979-04-04,90579541K,antonio.miranda@smartweb.digital,551483,ES06209535008739372467,1493.81,2023-06-15T01:07:38,Labastida,expenses,food,-72.79,-41709.23
buyer_8,Antonio,Miranda,1979-04-04,90579541K,antonio.miranda@smartweb.digital,551483,ES06209535008739372467,1493.81,2023-06-15T08:45:59,Labastida,expenses,leisure,-21.21,-41730.44
buyer_8,Antonio,Miranda,1979-04-04,90579541K,antonio.miranda@smartweb.digital,551483,ES06209535008739372467,1493.81,2023-06-15T01:29:29,Labastida,expenses,gifts,-342.09,-42072.53
buyer_8,Antonio,Miranda,1979-04-04,90579541K,antonio.miranda@smartweb.digital,551483,ES06209535008739372467,1493.81,2023-06-16T17:44:11,Labastida,expenses,clothing,-60.59,-42133.12
buyer_8,Antonio,Miranda,1979-04-04,90579541K,antonio.miranda@smartweb.digital,551483,ES06209535008739372467,1493.81,2023-06-16T12:31:57,Labastida,expenses,appliances,-214.19,-42347.31
buyer_8,Antonio,Miranda,1979-04-04,90579541K,antonio.miranda@smartweb.digital,551483,ES06209535008739372467,1493.81,2023-06-19T19:20:14,Labastida,expenses,appliances,-191.16,-42538.47
buyer_8,Antonio,Miranda,1979-04-04,90579541K,antonio.miranda@smartweb.digital,551483,ES06209535008739372467,1493.81,2023-06-20T18:14:57,Labastida,expenses,transport,-63.34,-42601.81
buyer_8,Antonio,Miranda,1979-04-04,90579541K,antonio.miranda@smartweb.digital,551483,ES06209535008739372467,1493.81,2023-06-20T13:57:21,Labastida,expenses,appliances,-318.0,-42919.81
buyer_8,Antonio,Miranda,1979-04-04,90579541K,antonio.miranda@smartweb.digital,551483,ES06209535008739372467,1493.81,2023-06-21T12:13:18,Labastida,expenses,clothing,-136.1,-43055.91
buyer_8,Antonio,Miranda,1979-04-04,90579541K,antonio.miranda@smartweb.digital,551483,ES06209535008739372467,1493.81,2023-06-21T14:04:17,Labastida,expenses,healthcare,-67.17,-43123.08
buyer_8,Antonio,Miranda,1979-04-04,90579541K,antonio.miranda@smartweb.digital,551483,ES06209535008739372467,1493.81,2023-06-23T09:30:08,Labastida,expenses,leisure,-80.47,-43203.55
buyer_8,Antonio,Miranda,1979-04-04,90579541K,antonio.miranda@smartweb.digital,551483,ES06209535008739372467,1493.81,2023-06-24T18:43:17,Labastida,expenses,leisure,-36.41,-43239.96
buyer_8,Antonio,Miranda,1979-04-04,90579541K,antonio.miranda@smartweb.digital,551483,ES06209535008739372467,1493.81,2023-06-25T22:53:48,Labastida,expenses,cash,-100.0,-43339.96
buyer_8,Antonio,Miranda,1979-04-04,90579541K,antonio.miranda@smartweb.digital,551483,ES06209535008739372467,1493.81,2023-06-28T00:19:06,Labastida,expenses,leisure,-40.81,-43380.77
buyer_8,Antonio,Miranda,1979-04-04,90579541K,antonio.miranda@smartweb.digital,551483,ES06209535008739372467,1493.81,2023-06-28T23:45:42,Labastida,expenses,cash,-100.0,-43480.77
buyer_8,Antonio,Miranda,1979-04-04,90579541K,antonio.miranda@smartweb.digital,551483,ES06209535008739372467,1493.81,2023-06-29T13:24:20,Labastida,expenses,cash,-100.0,-43580.77
buyer_8,Antonio,Miranda,1979-04-04,90579541K,antonio.miranda@smartweb.digital,551483,ES06209535008739372467,1493.81,2023-06-29T09:15:31,Labastida,expenses,gifts,-381.39,-43962.16
buyer_8,Antonio,Miranda,1979-04-04,90579541K,antonio.miranda@smartweb.digital,551483,ES06209535008739372467,1493.81,2023-07-01T15:38:02,Labastida,incomes,salary,4069.3,-39892.86
buyer_8,Antonio,Miranda,1979-04-04,90579541K,antonio.miranda@smartweb.digital,551483,ES06209535008739372467,1493.81,2023-07-01T12:58:38,Labastida,expenses,cash,-100.0,-39992.86
buyer_8,Antonio,Miranda,1979-04-04,90579541K,antonio.miranda@smartweb.digital,551483,ES06209535008739372467,1493.81,2023-07-03T18:52:34,Labastida,expenses,cash,-100.0,-40092.86
buyer_8,Antonio,Miranda,1979-04-04,90579541K,antonio.miranda@smartweb.digital,551483,ES06209535008739372467,1493.81,2023-07-04T18:16:33,Labastida,expenses,mortgage,-2056.66,-42149.52
buyer_8,Antonio,Miranda,1979-04-04,90579541K,antonio.miranda@smartweb.digital,551483,ES06209535008739372467,1493.81,2023-07-05T18:08:10,Labastida,expenses,internet,-94.0,-42243.52
buyer_8,Antonio,Miranda,1979-04-04,90579541K,antonio.miranda@smartweb.digital,551483,ES06209535008739372467,1493.81,2023-07-05T22:38:45,Labastida,expenses,food,-76.77,-42320.29
buyer_8,Antonio,Miranda,1979-04-04,90579541K,antonio.miranda@smartweb.digital,551483,ES06209535008739372467,1493.81,2023-07-06T17:17:03,Labastida,expenses,gas,-79.85,-42400.14
buyer_8,Antonio,Miranda,1979-04-04,90579541K,antonio.miranda@smartweb.digital,551483,ES06209535008739372467,1493.81,2023-07-06T18:48:59,Labastida,expenses,internet,-94.0,-42494.14
buyer_8,Antonio,Miranda,1979-04-04,90579541K,antonio.miranda@smartweb.digital,551483,ES06209535008739372467,1493.81,2023-07-07T02:01:34,Labastida,expenses,water,-85.31,-42579.45
buyer_8,Antonio,Miranda,1979-04-04,90579541K,antonio.miranda@smartweb.digital,551483,ES06209535008739372467,1493.81,2023-07-07T10:42:21,Labastida,expenses,food,-60.19,-42639.64
buyer_8,Antonio,Miranda,1979-04-04,90579541K,antonio.miranda@smartweb.digital,551483,ES06209535008739372467,1493.81,2023-07-08T12:55:54,Labastida,expenses,electricity,-66.5,-42706.14
buyer_8,Antonio,Miranda,1979-04-04,90579541K,antonio.miranda@smartweb.digital,551483,ES06209535008739372467,1493.81,2023-07-10T14:06:31,Labastida,expenses,food,-108.62,-42814.76
buyer_8,Antonio,Miranda,1979-04-04,90579541K,antonio.miranda@smartweb.digital,551483,ES06209535008739372467,1493.81,2023-07-12T08:20:42,Labastida,expenses,food,-109.63,-42924.39
buyer_8,Antonio,Miranda,1979-04-04,90579541K,antonio.miranda@smartweb.digital,551483,ES06209535008739372467,1493.81,2023-07-12T06:15:51,Labastida,expenses,cash,-100.0,-43024.39
buyer_8,Antonio,Miranda,1979-04-04,90579541K,antonio.miranda@smartweb.digital,551483,ES06209535008739372467,1493.81,2023-07-12T23:15:38,Labastida,expenses,gifts,-811.43,-43835.82
buyer_8,Antonio,Miranda,1979-04-04,90579541K,antonio.miranda@smartweb.digital,551483,ES06209535008739372467,1493.81,2023-07-15T18:02:28,Labastida,expenses,healthcare,-133.1,-43968.92
buyer_8,Antonio,Miranda,1979-04-04,90579541K,antonio.miranda@smartweb.digital,551483,ES06209535008739372467,1493.81,2023-07-17T19:26:58,Labastida,expenses,food,-78.11,-44047.03
buyer_8,Antonio,Miranda,1979-04-04,90579541K,antonio.miranda@smartweb.digital,551483,ES06209535008739372467,1493.81,2023-07-17T23:12:16,Labastida,expenses,cash,-100.0,-44147.03
buyer_8,Antonio,Miranda,1979-04-04,90579541K,antonio.miranda@smartweb.digital,551483,ES06209535008739372467,1493.81,2023-07-20T16:13:43,Labastida,expenses,clothing,-106.32,-44253.35
buyer_8,Antonio,Miranda,1979-04-04,90579541K,antonio.miranda@smartweb.digital,551483,ES06209535008739372467,1493.81,2023-07-23T18:42:36,Labastida,expenses,cash,-100.0,-44353.35
buyer_8,Antonio,Miranda,1979-04-04,90579541K,antonio.miranda@smartweb.digital,551483,ES06209535008739372467,1493.81,2023-07-25T12:56:56,Labastida,expenses,food,-109.97,-44463.32
buyer_8,Antonio,Miranda,1979-04-04,90579541K,antonio.miranda@smartweb.digital,551483,ES06209535008739372467,1493.81,2023-07-27T10:17:31,Labastida,expenses,food,-67.47,-44530.79
buyer_8,Antonio,Miranda,1979-04-04,90579541K,antonio.miranda@smartweb.digital,551483,ES06209535008739372467,1493.81,2023-07-29T03:04:43,Labastida,expenses,leisure,-69.06,-44599.85
buyer_8,Antonio,Miranda,1979-04-04,90579541K,antonio.miranda@smartweb.digital,551483,ES06209535008739372467,1493.81,2023-07-30T17:28:15,Labastida,expenses,transport,-78.79,-44678.64
buyer_8,Antonio,Miranda,1979-04-04,90579541K,antonio.miranda@smartweb.digital,551483,ES06209535008739372467,1493.81,2023-07-31T15:17:50,Labastida,expenses,transport,-84.6,-44763.24
buyer_8,Antonio,Miranda,1979-04-04,90579541K,antonio.miranda@smartweb.digital,551483,ES06209535008739372467,1493.81,2023-08-01T15:18:10,Labastida,incomes,salary,4069.3,-40693.94
buyer_8,Antonio,Miranda,1979-04-04,90579541K,antonio.miranda@smartweb.digital,551483,ES06209535008739372467,1493.81,2023-08-01T15:18:10,Labastida,incomes,extra_income,531.65,-40162.29
buyer_8,Antonio,Miranda,1979-04-04,90579541K,antonio.miranda@smartweb.digital,551483,ES06209535008739372467,1493.81,2023-08-02T12:11:23,Labastida,expenses,transport,-74.52,-40236.81
buyer_8,Antonio,Miranda,1979-04-04,90579541K,antonio.miranda@smartweb.digital,551483,ES06209535008739372467,1493.81,2023-08-02T15:15:10,Labastida,expenses,clothing,-93.66,-40330.47
buyer_8,Antonio,Miranda,1979-04-04,90579541K,antonio.miranda@smartweb.digital,551483,ES06209535008739372467,1493.81,2023-08-02T12:43:45,Labastida,expenses,repairs,-142.83,-40473.3
buyer_8,Antonio,Miranda,1979-04-04,90579541K,antonio.miranda@smartweb.digital,551483,ES06209535008739372467,1493.81,2023-08-04T18:42:20,Labastida,expenses,mortgage,-2056.66,-42529.96
buyer_8,Antonio,Miranda,1979-04-04,90579541K,antonio.miranda@smartweb.digital,551483,ES06209535008739372467,1493.81,2023-08-04T17:19:09,Labastida,expenses,cash,-100.0,-42629.96
buyer_8,Antonio,Miranda,1979-04-04,90579541K,antonio.miranda@smartweb.digital,551483,ES06209535008739372467,1493.81,2023-08-05T15:14:47,Labastida,expenses,internet,-94.0,-42723.96
buyer_8,Antonio,Miranda,1979-04-04,90579541K,antonio.miranda@smartweb.digital,551483,ES06209535008739372467,1493.81,2023-08-05T10:15:39,Labastida,expenses,phone,-85.18,-42809.14
buyer_8,Antonio,Miranda,1979-04-04,90579541K,antonio.miranda@smartweb.digital,551483,ES06209535008739372467,1493.81,2023-08-06T14:32:25,Labastida,expenses,electricity,-155.22,-42964.36
buyer_8,Antonio,Miranda,1979-04-04,90579541K,antonio.miranda@smartweb.digital,551483,ES06209535008739372467,1493.81,2023-08-06T12:25:21,Labastida,expenses,gas,-235.48,-43199.84
buyer_8,Antonio,Miranda,1979-04-04,90579541K,antonio.miranda@smartweb.digital,551483,ES06209535008739372467,1493.81,2023-08-06T16:54:54,Labastida,expenses,phone,-79.21,-43279.05
buyer_8,Antonio,Miranda,1979-04-04,90579541K,antonio.miranda@smartweb.digital,551483,ES06209535008739372467,1493.81,2023-08-06T01:23:41,Labastida,expenses,cash,-100.0,-43379.05
buyer_8,Antonio,Miranda,1979-04-04,90579541K,antonio.miranda@smartweb.digital,551483,ES06209535008739372467,1493.81,2023-08-08T16:00:32,Labastida,expenses,water,-87.27,-43466.32
buyer_8,Antonio,Miranda,1979-04-04,90579541K,antonio.miranda@smartweb.digital,551483,ES06209535008739372467,1493.81,2023-08-09T02:39:14,Labastida,expenses,cash,-100.0,-43566.32
buyer_8,Antonio,Miranda,1979-04-04,90579541K,antonio.miranda@smartweb.digital,551483,ES06209535008739372467,1493.81,2023-08-09T12:54:44,Labastida,expenses,repairs,-312.2,-43878.52
buyer_8,Antonio,Miranda,1979-04-04,90579541K,antonio.miranda@smartweb.digital,551483,ES06209535008739372467,1493.81,2023-08-10T20:50:22,Labastida,expenses,leisure,-69.52,-43948.04
buyer_8,Antonio,Miranda,1979-04-04,90579541K,antonio.miranda@smartweb.digital,551483,ES06209535008739372467,1493.81,2023-08-11T22:58:30,Labastida,expenses,education,-63.72,-44011.76
buyer_8,Antonio,Miranda,1979-04-04,90579541K,antonio.miranda@smartweb.digital,551483,ES06209535008739372467,1493.81,2023-08-11T08:45:54,Labastida,expenses,cash,-100.0,-44111.76
buyer_8,Antonio,Miranda,1979-04-04,90579541K,antonio.miranda@smartweb.digital,551483,ES06209535008739372467,1493.81,2023-08-12T15:10:57,Labastida,expenses,food,-103.04,-44214.8
buyer_8,Antonio,Miranda,1979-04-04,90579541K,antonio.miranda@smartweb.digital,551483,ES06209535008739372467,1493.81,2023-08-12T21:11:07,Labastida,expenses,clothing,-148.38,-44363.18
buyer_8,Antonio,Miranda,1979-04-04,90579541K,antonio.miranda@smartweb.digital,551483,ES06209535008739372467,1493.81,2023-08-13T12:22:02,Labastida,expenses,transport,-66.64,-44429.82
buyer_8,Antonio,Miranda,1979-04-04,90579541K,antonio.miranda@smartweb.digital,551483,ES06209535008739372467,1493.81,2023-08-13T20:34:07,Labastida,expenses,gifts,-155.19,-44585.01
buyer_8,Antonio,Miranda,1979-04-04,90579541K,antonio.miranda@smartweb.digital,551483,ES06209535008739372467,1493.81,2023-08-16T15:24:32,Labastida,expenses,transport,-46.34,-44631.35
buyer_8,Antonio,Miranda,1979-04-04,90579541K,antonio.miranda@smartweb.digital,551483,ES06209535008739372467,1493.81,2023-08-16T10:59:18,Labastida,expenses,travel,-1279.63,-45910.98
buyer_8,Antonio,Miranda,1979-04-04,90579541K,antonio.miranda@smartweb.digital,551483,ES06209535008739372467,1493.81,2023-08-17T14:10:55,Labastida,expenses,food,-123.16,-46034.14
buyer_8,Antonio,Miranda,1979-04-04,90579541K,antonio.miranda@smartweb.digital,551483,ES06209535008739372467,1493.81,2023-08-17T09:40:56,Labastida,expenses,cash,-100.0,-46134.14
buyer_8,Antonio,Miranda,1979-04-04,90579541K,antonio.miranda@smartweb.digital,551483,ES06209535008739372467,1493.81,2023-08-18T20:34:58,Labastida,expenses,clothing,-111.63,-46245.77
buyer_8,Antonio,Miranda,1979-04-04,90579541K,antonio.miranda@smartweb.digital,551483,ES06209535008739372467,1493.81,2023-08-19T16:25:27,Labastida,expenses,cash,-100.0,-46345.77
buyer_8,Antonio,Miranda,1979-04-04,90579541K,antonio.miranda@smartweb.digital,551483,ES06209535008739372467,1493.81,2023-08-22T08:14:14,Labastida,expenses,food,-70.77,-46416.54
buyer_8,Antonio,Miranda,1979-04-04,90579541K,antonio.miranda@smartweb.digital,551483,ES06209535008739372467,1493.81,2023-08-24T20:42:00,Labastida,expenses,cash,-100.0,-46516.54
buyer_8,Antonio,Miranda,1979-04-04,90579541K,antonio.miranda@smartweb.digital,551483,ES06209535008739372467,1493.81,2023-08-26T15:58:52,Labastida,expenses,food,-91.53,-46608.07
buyer_8,Antonio,Miranda,1979-04-04,90579541K,antonio.miranda@smartweb.digital,551483,ES06209535008739372467,1493.81,2023-08-26T18:43:19,Labastida,expenses,healthcare,-69.12,-46677.19
buyer_8,Antonio,Miranda,1979-04-04,90579541K,antonio.miranda@smartweb.digital,551483,ES06209535008739372467,1493.81,2023-08-27T10:40:45,Labastida,expenses,food,-119.6,-46796.79
buyer_8,Antonio,Miranda,1979-04-04,90579541K,antonio.miranda@smartweb.digital,551483,ES06209535008739372467,1493.81,2023-08-27T01:40:01,Labastida,expenses,healthcare,-117.58,-46914.37
buyer_8,Antonio,Miranda,1979-04-04,90579541K,antonio.miranda@smartweb.digital,551483,ES06209535008739372467,1493.81,2023-08-27T09:19:21,Labastida,expenses,repairs,-294.41,-47208.78
buyer_8,Antonio,Miranda,1979-04-04,90579541K,antonio.miranda@smartweb.digital,551483,ES06209535008739372467,1493.81,2023-08-28T20:13:15,Labastida,expenses,food,-67.36,-47276.14
buyer_8,Antonio,Miranda,1979-04-04,90579541K,antonio.miranda@smartweb.digital,551483,ES06209535008739372467,1493.81,2023-08-28T19:55:01,Labastida,expenses,leisure,-45.93,-47322.07
buyer_8,Antonio,Miranda,1979-04-04,90579541K,antonio.miranda@smartweb.digital,551483,ES06209535008739372467,1493.81,2023-08-29T17:11:38,Labastida,expenses,transport,-72.81,-47394.88
buyer_8,Antonio,Miranda,1979-04-04,90579541K,antonio.miranda@smartweb.digital,551483,ES06209535008739372467,1493.81,2023-09-01T17:18:00,Labastida,incomes,salary,4069.3,-43325.58
buyer_8,Antonio,Miranda,1979-04-04,90579541K,antonio.miranda@smartweb.digital,551483,ES06209535008739372467,1493.81,2023-09-02T20:45:37,Labastida,expenses,transport,-80.93,-43406.51
buyer_8,Antonio,Miranda,1979-04-04,90579541K,antonio.miranda@smartweb.digital,551483,ES06209535008739372467,1493.81,2023-09-04T19:45:17,Labastida,expenses,mortgage,-2056.66,-45463.17
buyer_8,Antonio,Miranda,1979-04-04,90579541K,antonio.miranda@smartweb.digital,551483,ES06209535008739372467,1493.81,2023-09-04T09:04:44,Labastida,expenses,healthcare,-99.02,-45562.19
buyer_8,Antonio,Miranda,1979-04-04,90579541K,antonio.miranda@smartweb.digital,551483,ES06209535008739372467,1493.81,2023-09-04T11:23:14,Labastida,expenses,cash,-100.0,-45662.19
buyer_8,Antonio,Miranda,1979-04-04,90579541K,antonio.miranda@smartweb.digital,551483,ES06209535008739372467,1493.81,2023-09-05T17:34:12,Labastida,expenses,water,-92.06,-45754.25
buyer_8,Antonio,Miranda,1979-04-04,90579541K,antonio.miranda@smartweb.digital,551483,ES06209535008739372467,1493.81,2023-09-05T13:43:36,Labastida,expenses,electricity,-137.31,-45891.56
buyer_8,Antonio,Miranda,1979-04-04,90579541K,antonio.miranda@smartweb.digital,551483,ES06209535008739372467,1493.81,2023-09-05T12:47:37,Labastida,expenses,phone,-86.4,-45977.96
buyer_8,Antonio,Miranda,1979-04-04,90579541K,antonio.miranda@smartweb.digital,551483,ES06209535008739372467,1493.81,2023-09-06T19:00:26,Labastida,expenses,water,-63.47,-46041.43
buyer_8,Antonio,Miranda,1979-04-04,90579541K,antonio.miranda@smartweb.digital,551483,ES06209535008739372467,1493.81,2023-09-06T16:44:52,Labastida,expenses,phone,-87.53,-46128.96
buyer_8,Antonio,Miranda,1979-04-04,90579541K,antonio.miranda@smartweb.digital,551483,ES06209535008739372467,1493.81,2023-09-06T12:47:32,Labastida,expenses,food,-108.55,-46237.51
buyer_8,Antonio,Miranda,1979-04-04,90579541K,antonio.miranda@smartweb.digital,551483,ES06209535008739372467,1493.81,2023-09-07T15:37:34,Labastida,expenses,phone,-100.26,-46337.77
buyer_8,Antonio,Miranda,1979-04-04,90579541K,antonio.miranda@smartweb.digital,551483,ES06209535008739372467,1493.81,2023-09-07T12:49:30,Labastida,expenses,education,-53.43,-46391.2
buyer_8,Antonio,Miranda,1979-04-04,90579541K,antonio.miranda@smartweb.digital,551483,ES06209535008739372467,1493.81,2023-09-08T17:35:14,Labastida,expenses,water,-62.1,-46453.3
buyer_8,Antonio,Miranda,1979-04-04,90579541K,antonio.miranda@smartweb.digital,551483,ES06209535008739372467,1493.81,2023-09-12T17:01:13,Labastida,expenses,clothing,-108.21,-46561.51
buyer_8,Antonio,Miranda,1979-04-04,90579541K,antonio.miranda@smartweb.digital,551483,ES06209535008739372467,1493.81,2023-09-15T10:51:55,Labastida,expenses,transport,-82.03,-46643.54
buyer_8,Antonio,Miranda,1979-04-04,90579541K,antonio.miranda@smartweb.digital,551483,ES06209535008739372467,1493.81,2023-09-17T00:06:35,Labastida,expenses,food,-96.27,-46739.81
buyer_8,Antonio,Miranda,1979-04-04,90579541K,antonio.miranda@smartweb.digital,551483,ES06209535008739372467,1493.81,2023-09-17T17:01:35,Labastida,expenses,repairs,-258.4,-46998.21
buyer_8,Antonio,Miranda,1979-04-04,90579541K,antonio.miranda@smartweb.digital,551483,ES06209535008739372467,1493.81,2023-09-21T15:56:57,Labastida,expenses,cash,-100.0,-47098.21
buyer_8,Antonio,Miranda,1979-04-04,90579541K,antonio.miranda@smartweb.digital,551483,ES06209535008739372467,1493.81,2023-09-22T09:33:31,Labastida,expenses,cash,-100.0,-47198.21
buyer_8,Antonio,Miranda,1979-04-04,90579541K,antonio.miranda@smartweb.digital,551483,ES06209535008739372467,1493.81,2023-09-23T09:12:58,Labastida,expenses,leisure,-61.09,-47259.3
buyer_8,Antonio,Miranda,1979-04-04,90579541K,antonio.miranda@smartweb.digital,551483,ES06209535008739372467,1493.81,2023-09-23T12:33:40,Labastida,expenses,cash,-100.0,-47359.3
buyer_8,Antonio,Miranda,1979-04-04,90579541K,antonio.miranda@smartweb.digital,551483,ES06209535008739372467,1493.81,2023-09-24T15:46:36,Labastida,expenses,leisure,-59.95,-47419.25
buyer_8,Antonio,Miranda,1979-04-04,90579541K,antonio.miranda@smartweb.digital,551483,ES06209535008739372467,1493.81,2023-09-28T15:30:14,Labastida,expenses,food,-93.11,-47512.36
buyer_8,Antonio,Miranda,1979-04-04,90579541K,antonio.miranda@smartweb.digital,551483,ES06209535008739372467,1493.81,2023-09-28T19:09:59,Labastida,expenses,healthcare,-63.78,-47576.14
buyer_8,Antonio,Miranda,1979-04-04,90579541K,antonio.miranda@smartweb.digital,551483,ES06209535008739372467,1493.81,2023-09-29T21:12:21,Labastida,expenses,transport,-61.8,-47637.94
buyer_8,Antonio,Miranda,1979-04-04,90579541K,antonio.miranda@smartweb.digital,551483,ES06209535008739372467,1493.81,2023-09-30T12:03:30,Labastida,expenses,food,-115.63,-47753.57
buyer_8,Antonio,Miranda,1979-04-04,90579541K,antonio.miranda@smartweb.digital,551483,ES06209535008739372467,1493.81,2023-10-01T19:23:21,Labastida,incomes,salary,4069.3,-43684.27
buyer_8,Antonio,Miranda,1979-04-04,90579541K,antonio.miranda@smartweb.digital,551483,ES06209535008739372467,1493.81,2023-10-01T14:28:59,Labastida,expenses,food,-91.87,-43776.14
buyer_8,Antonio,Miranda,1979-04-04,90579541K,antonio.miranda@smartweb.digital,551483,ES06209535008739372467,1493.81,2023-10-02T14:15:42,Labastida,expenses,food,-105.71,-43881.85
buyer_8,Antonio,Miranda,1979-04-04,90579541K,antonio.miranda@smartweb.digital,551483,ES06209535008739372467,1493.81,2023-10-02T12:34:44,Labastida,expenses,leisure,-67.06,-43948.91
buyer_8,Antonio,Miranda,1979-04-04,90579541K,antonio.miranda@smartweb.digital,551483,ES06209535008739372467,1493.81,2023-10-03T10:04:09,Labastida,expenses,cash,-100.0,-44048.91
buyer_8,Antonio,Miranda,1979-04-04,90579541K,antonio.miranda@smartweb.digital,551483,ES06209535008739372467,1493.81,2023-10-03T17:50:36,Labastida,expenses,repairs,-251.15,-44300.06
buyer_8,Antonio,Miranda,1979-04-04,90579541K,antonio.miranda@smartweb.digital,551483,ES06209535008739372467,1493.81,2023-10-04T18:51:18,Labastida,expenses,mortgage,-2056.66,-46356.72
buyer_8,Antonio,Miranda,1979-04-04,90579541K,antonio.miranda@smartweb.digital,551483,ES06209535008739372467,1493.81,2023-10-04T18:55:53,Labastida,expenses,food,-83.31,-46440.03
buyer_8,Antonio,Miranda,1979-04-04,90579541K,antonio.miranda@smartweb.digital,551483,ES06209535008739372467,1493.81,2023-10-05T08:42:57,Labastida,expenses,phone,-71.65,-46511.68
buyer_8,Antonio,Miranda,1979-04-04,90579541K,antonio.miranda@smartweb.digital,551483,ES06209535008739372467,1493.81,2023-10-06T18:06:35,Labastida,expenses,gas,-72.64,-46584.32
buyer_8,Antonio,Miranda,1979-04-04,90579541K,antonio.miranda@smartweb.digital,551483,ES06209535008739372467,1493.81,2023-10-06T22:31:31,Labastida,expenses,internet,-94.0,-46678.32
buyer_8,Antonio,Miranda,1979-04-04,90579541K,antonio.miranda@smartweb.digital,551483,ES06209535008739372467,1493.81,2023-10-06T09:32:47,Labastida,expenses,cash,-100.0,-46778.32
buyer_8,Antonio,Miranda,1979-04-04,90579541K,antonio.miranda@smartweb.digital,551483,ES06209535008739372467,1493.81,2023-10-07T19:53:09,Labastida,expenses,leisure,-82.71,-46861.03
buyer_8,Antonio,Miranda,1979-04-04,90579541K,antonio.miranda@smartweb.digital,551483,ES06209535008739372467,1493.81,2023-10-08T23:34:48,Labastida,expenses,appliances,-81.71,-46942.74
buyer_8,Antonio,Miranda,1979-04-04,90579541K,antonio.miranda@smartweb.digital,551483,ES06209535008739372467,1493.81,2023-10-09T07:12:55,Labastida,expenses,food,-68.37,-47011.11
buyer_8,Antonio,Miranda,1979-04-04,90579541K,antonio.miranda@smartweb.digital,551483,ES06209535008739372467,1493.81,2023-10-10T10:08:17,Labastida,expenses,food,-121.42,-47132.53
buyer_8,Antonio,Miranda,1979-04-04,90579541K,antonio.miranda@smartweb.digital,551483,ES06209535008739372467,1493.81,2023-10-10T06:28:13,Labastida,expenses,cash,-100.0,-47232.53
buyer_8,Antonio,Miranda,1979-04-04,90579541K,antonio.miranda@smartweb.digital,551483,ES06209535008739372467,1493.81,2023-10-11T04:57:51,Labastida,expenses,food,-92.82,-47325.35
buyer_8,Antonio,Miranda,1979-04-04,90579541K,antonio.miranda@smartweb.digital,551483,ES06209535008739372467,1493.81,2023-10-11T23:02:49,Labastida,expenses,leisure,-21.41,-47346.76
buyer_8,Antonio,Miranda,1979-04-04,90579541K,antonio.miranda@smartweb.digital,551483,ES06209535008739372467,1493.81,2023-10-11T23:47:24,Labastida,expenses,cash,-100.0,-47446.76
buyer_8,Antonio,Miranda,1979-04-04,90579541K,antonio.miranda@smartweb.digital,551483,ES06209535008739372467,1493.81,2023-10-12T13:12:54,Labastida,expenses,clothing,-77.34,-47524.1
buyer_8,Antonio,Miranda,1979-04-04,90579541K,antonio.miranda@smartweb.digital,551483,ES06209535008739372467,1493.81,2023-10-14T09:41:31,Labastida,expenses,gifts,-98.35,-47622.45
buyer_8,Antonio,Miranda,1979-04-04,90579541K,antonio.miranda@smartweb.digital,551483,ES06209535008739372467,1493.81,2023-10-15T13:45:39,Labastida,expenses,education,-72.72,-47695.17
buyer_8,Antonio,Miranda,1979-04-04,90579541K,antonio.miranda@smartweb.digital,551483,ES06209535008739372467,1493.81,2023-10-17T05:04:23,Labastida,expenses,healthcare,-151.79,-47846.96
buyer_8,Antonio,Miranda,1979-04-04,90579541K,antonio.miranda@smartweb.digital,551483,ES06209535008739372467,1493.81,2023-10-17T21:31:34,Labastida,expenses,cash,-100.0,-47946.96
buyer_8,Antonio,Miranda,1979-04-04,90579541K,antonio.miranda@smartweb.digital,551483,ES06209535008739372467,1493.81,2023-10-18T19:52:34,Labastida,expenses,food,-72.32,-48019.28
buyer_8,Antonio,Miranda,1979-04-04,90579541K,antonio.miranda@smartweb.digital,551483,ES06209535008739372467,1493.81,2023-10-22T16:20:43,Labastida,expenses,food,-110.13,-48129.41
buyer_8,Antonio,Miranda,1979-04-04,90579541K,antonio.miranda@smartweb.digital,551483,ES06209535008739372467,1493.81,2023-10-22T11:23:07,Labastida,expenses,gifts,-690.84,-48820.25
buyer_8,Antonio,Miranda,1979-04-04,90579541K,antonio.miranda@smartweb.digital,551483,ES06209535008739372467,1493.81,2023-10-23T13:50:20,Labastida,expenses,cash,-100.0,-48920.25
buyer_8,Antonio,Miranda,1979-04-04,90579541K,antonio.miranda@smartweb.digital,551483,ES06209535008739372467,1493.81,2023-10-23T18:46:08,Labastida,expenses,repairs,-253.87,-49174.12
buyer_8,Antonio,Miranda,1979-04-04,90579541K,antonio.miranda@smartweb.digital,551483,ES06209535008739372467,1493.81,2023-10-24T14:01:29,Labastida,expenses,food,-88.81,-49262.93
buyer_8,Antonio,Miranda,1979-04-04,90579541K,antonio.miranda@smartweb.digital,551483,ES06209535008739372467,1493.81,2023-10-24T19:21:03,Labastida,expenses,transport,-66.2,-49329.13
buyer_8,Antonio,Miranda,1979-04-04,90579541K,antonio.miranda@smartweb.digital,551483,ES06209535008739372467,1493.81,2023-10-25T13:16:14,Labastida,expenses,food,-102.36,-49431.49
buyer_8,Antonio,Miranda,1979-04-04,90579541K,antonio.miranda@smartweb.digital,551483,ES06209535008739372467,1493.81,2023-10-25T15:59:43,Labastida,expenses,travel,-864.34,-50295.83
buyer_8,Antonio,Miranda,1979-04-04,90579541K,antonio.miranda@smartweb.digital,551483,ES06209535008739372467,1493.81,2023-10-25T12:06:35,Labastida,expenses,repairs,-214.86,-50510.69
buyer_8,Antonio,Miranda,1979-04-04,90579541K,antonio.miranda@smartweb.digital,551483,ES06209535008739372467,1493.81,2023-10-28T14:26:07,Labastida,expenses,leisure,-75.08,-50585.77
buyer_8,Antonio,Miranda,1979-04-04,90579541K,antonio.miranda@smartweb.digital,551483,ES06209535008739372467,1493.81,2023-10-29T16:29:55,Labastida,expenses,transport,-42.05,-50627.82
buyer_8,Antonio,Miranda,1979-04-04,90579541K,antonio.miranda@smartweb.digital,551483,ES06209535008739372467,1493.81,2023-10-29T19:59:49,Labastida,expenses,leisure,-39.76,-50667.58
buyer_8,Antonio,Miranda,1979-04-04,90579541K,antonio.miranda@smartweb.digital,551483,ES06209535008739372467,1493.81,2023-10-29T16:58:55,Labastida,expenses,healthcare,-158.3,-50825.88
buyer_8,Antonio,Miranda,1979-04-04,90579541K,antonio.miranda@smartweb.digital,551483,ES06209535008739372467,1493.81,2023-10-29T11:04:36,Labastida,expenses,cash,-100.0,-50925.88
buyer_8,Antonio,Miranda,1979-04-04,90579541K,antonio.miranda@smartweb.digital,551483,ES06209535008739372467,1493.81,2023-10-31T11:15:40,Labastida,expenses,clothing,-144.88,-51070.76
buyer_8,Antonio,Miranda,1979-04-04,90579541K,antonio.miranda@smartweb.digital,551483,ES06209535008739372467,1493.81,2023-11-01T10:42:02,Labastida,incomes,salary,4069.3,-47001.46
buyer_8,Antonio,Miranda,1979-04-04,90579541K,antonio.miranda@smartweb.digital,551483,ES06209535008739372467,1493.81,2023-11-03T04:48:48,Labastida,expenses,repairs,-137.05,-47138.51
buyer_8,Antonio,Miranda,1979-04-04,90579541K,antonio.miranda@smartweb.digital,551483,ES06209535008739372467,1493.81,2023-11-04T11:19:43,Labastida,expenses,mortgage,-2056.66,-49195.17
buyer_8,Antonio,Miranda,1979-04-04,90579541K,antonio.miranda@smartweb.digital,551483,ES06209535008739372467,1493.81,2023-11-05T18:00:35,Labastida,expenses,cash,-100.0,-49295.17
buyer_8,Antonio,Miranda,1979-04-04,90579541K,antonio.miranda@smartweb.digital,551483,ES06209535008739372467,1493.81,2023-11-05T16:28:32,Labastida,expenses,gifts,-590.75,-49885.92
buyer_8,Antonio,Miranda,1979-04-04,90579541K,antonio.miranda@smartweb.digital,551483,ES06209535008739372467,1493.81,2023-11-06T17:22:57,Labastida,expenses,internet,-94.0,-49979.92
buyer_8,Antonio,Miranda,1979-04-04,90579541K,antonio.miranda@smartweb.digital,551483,ES06209535008739372467,1493.81,2023-11-06T09:00:57,Labastida,expenses,phone,-97.52,-50077.44
buyer_8,Antonio,Miranda,1979-04-04,90579541K,antonio.miranda@smartweb.digital,551483,ES06209535008739372467,1493.81,2023-11-07T22:19:35,Labastida,expenses,electricity,-165.7,-50243.14
buyer_8,Antonio,Miranda,1979-04-04,90579541K,antonio.miranda@smartweb.digital,551483,ES06209535008739372467,1493.81,2023-11-08T14:38:25,Labastida,expenses,electricity,-197.96,-50441.1
buyer_8,Antonio,Miranda,1979-04-04,90579541K,antonio.miranda@smartweb.digital,551483,ES06209535008739372467,1493.81,2023-11-08T04:10:09,Labastida,expenses,food,-113.67,-50554.77
buyer_8,Antonio,Miranda,1979-04-04,90579541K,antonio.miranda@smartweb.digital,551483,ES06209535008739372467,1493.81,2023-11-13T18:31:57,Labastida,expenses,leisure,-82.95,-50637.72
buyer_8,Antonio,Miranda,1979-04-04,90579541K,antonio.miranda@smartweb.digital,551483,ES06209535008739372467,1493.81,2023-11-13T17:27:25,Labastida,expenses,gifts,-776.61,-51414.33
buyer_8,Antonio,Miranda,1979-04-04,90579541K,antonio.miranda@smartweb.digital,551483,ES06209535008739372467,1493.81,2023-11-14T15:20:02,Labastida,expenses,food,-67.87,-51482.2
buyer_8,Antonio,Miranda,1979-04-04,90579541K,antonio.miranda@smartweb.digital,551483,ES06209535008739372467,1493.81,2023-11-14T12:06:53,Labastida,expenses,cash,-100.0,-51582.2
buyer_8,Antonio,Miranda,1979-04-04,90579541K,antonio.miranda@smartweb.digital,551483,ES06209535008739372467,1493.81,2023-11-15T19:00:03,Labastida,expenses,transport,-43.22,-51625.42
buyer_8,Antonio,Miranda,1979-04-04,90579541K,antonio.miranda@smartweb.digital,551483,ES06209535008739372467,1493.81,2023-11-17T12:32:58,Labastida,expenses,cash,-100.0,-51725.42
buyer_8,Antonio,Miranda,1979-04-04,90579541K,antonio.miranda@smartweb.digital,551483,ES06209535008739372467,1493.81,2023-11-17T11:44:23,Labastida,expenses,gifts,-83.66,-51809.08
buyer_8,Antonio,Miranda,1979-04-04,90579541K,antonio.miranda@smartweb.digital,551483,ES06209535008739372467,1493.81,2023-11-19T15:28:55,Labastida,expenses,food,-89.2,-51898.28
buyer_8,Antonio,Miranda,1979-04-04,90579541K,antonio.miranda@smartweb.digital,551483,ES06209535008739372467,1493.81,2023-11-19T16:52:01,Labastida,expenses,leisure,-24.75,-51923.03
buyer_8,Antonio,Miranda,1979-04-04,90579541K,antonio.miranda@smartweb.digital,551483,ES06209535008739372467,1493.81,2023-11-19T12:31:17,Labastida,expenses,clothing,-151.45,-52074.48
buyer_8,Antonio,Miranda,1979-04-04,90579541K,antonio.miranda@smartweb.digital,551483,ES06209535008739372467,1493.81,2023-11-19T20:11:17,Labastida,expenses,appliances,-187.76,-52262.24
buyer_8,Antonio,Miranda,1979-04-04,90579541K,antonio.miranda@smartweb.digital,551483,ES06209535008739372467,1493.81,2023-11-20T14:29:36,Labastida,expenses,food,-60.43,-52322.67
buyer_8,Antonio,Miranda,1979-04-04,90579541K,antonio.miranda@smartweb.digital,551483,ES06209535008739372467,1493.81,2023-11-20T12:28:27,Labastida,expenses,repairs,-123.84,-52446.51
buyer_8,Antonio,Miranda,1979-04-04,90579541K,antonio.miranda@smartweb.digital,551483,ES06209535008739372467,1493.81,2023-11-22T19:01:39,Labastida,expenses,clothing,-95.22,-52541.73
buyer_8,Antonio,Miranda,1979-04-04,90579541K,antonio.miranda@smartweb.digital,551483,ES06209535008739372467,1493.81,2023-11-24T12:54:05,Labastida,expenses,cash,-100.0,-52641.73
buyer_8,Antonio,Miranda,1979-04-04,90579541K,antonio.miranda@smartweb.digital,551483,ES06209535008739372467,1493.81,2023-11-24T10:01:39,Labastida,expenses,repairs,-166.67,-52808.4
buyer_8,Antonio,Miranda,1979-04-04,90579541K,antonio.miranda@smartweb.digital,551483,ES06209535008739372467,1493.81,2023-11-25T20:32:16,Labastida,expenses,food,-98.64,-52907.04
buyer_8,Antonio,Miranda,1979-04-04,90579541K,antonio.miranda@smartweb.digital,551483,ES06209535008739372467,1493.81,2023-11-25T13:29:25,Labastida,expenses,leisure,-26.26,-52933.3
buyer_8,Antonio,Miranda,1979-04-04,90579541K,antonio.miranda@smartweb.digital,551483,ES06209535008739372467,1493.81,2023-11-25T11:45:52,Labastida,expenses,healthcare,-165.27,-53098.57
buyer_8,Antonio,Miranda,1979-04-04,90579541K,antonio.miranda@smartweb.digital,551483,ES06209535008739372467,1493.81,2023-11-26T07:29:40,Labastida,expenses,leisure,-71.4,-53169.97
buyer_8,Antonio,Miranda,1979-04-04,90579541K,antonio.miranda@smartweb.digital,551483,ES06209535008739372467,1493.81,2023-11-26T07:31:03,Labastida,expenses,education,-61.63,-53231.6
buyer_8,Antonio,Miranda,1979-04-04,90579541K,antonio.miranda@smartweb.digital,551483,ES06209535008739372467,1493.81,2023-11-27T11:44:37,Labastida,expenses,food,-62.07,-53293.67
buyer_8,Antonio,Miranda,1979-04-04,90579541K,antonio.miranda@smartweb.digital,551483,ES06209535008739372467,1493.81,2023-11-28T01:37:07,Labastida,expenses,leisure,-54.31,-53347.98
buyer_8,Antonio,Miranda,1979-04-04,90579541K,antonio.miranda@smartweb.digital,551483,ES06209535008739372467,1493.81,2023-11-29T07:49:47,Labastida,expenses,leisure,-64.37,-53412.35
buyer_8,Antonio,Miranda,1979-04-04,90579541K,antonio.miranda@smartweb.digital,551483,ES06209535008739372467,1493.81,2023-11-29T13:02:03,Labastida,expenses,cash,-100.0,-53512.35
buyer_8,Antonio,Miranda,1979-04-04,90579541K,antonio.miranda@smartweb.digital,551483,ES06209535008739372467,1493.81,2023-11-30T08:59:41,Labastida,expenses,transport,-43.24,-53555.59
buyer_8,Antonio,Miranda,1979-04-04,90579541K,antonio.miranda@smartweb.digital,551483,ES06209535008739372467,1493.81,2023-11-30T13:43:45,Labastida,expenses,leisure,-52.05,-53607.64
buyer_8,Antonio,Miranda,1979-04-04,90579541K,antonio.miranda@smartweb.digital,551483,ES06209535008739372467,1493.81,2023-12-01T16:29:56,Labastida,incomes,salary,4069.3,-49538.34
buyer_8,Antonio,Miranda,1979-04-04,90579541K,antonio.miranda@smartweb.digital,551483,ES06209535008739372467,1493.81,2023-12-01T16:29:56,Labastida,incomes,extra_income,531.65,-49006.69
buyer_8,Antonio,Miranda,1979-04-04,90579541K,antonio.miranda@smartweb.digital,551483,ES06209535008739372467,1493.81,2023-12-01T16:29:56,Labastida,incomes,salary_bonus,3178.1,-45828.59
buyer_8,Antonio,Miranda,1979-04-04,90579541K,antonio.miranda@smartweb.digital,551483,ES06209535008739372467,1493.81,2023-12-02T12:46:04,Labastida,expenses,food,-121.17,-45949.76
buyer_8,Antonio,Miranda,1979-04-04,90579541K,antonio.miranda@smartweb.digital,551483,ES06209535008739372467,1493.81,2023-12-02T09:43:50,Labastida,expenses,leisure,-78.31,-46028.07
buyer_8,Antonio,Miranda,1979-04-04,90579541K,antonio.miranda@smartweb.digital,551483,ES06209535008739372467,1493.81,2023-12-04T13:50:39,Labastida,expenses,mortgage,-2056.66,-48084.73
buyer_8,Antonio,Miranda,1979-04-04,90579541K,antonio.miranda@smartweb.digital,551483,ES06209535008739372467,1493.81,2023-12-05T17:23:52,Labastida,expenses,internet,-94.0,-48178.73
buyer_8,Antonio,Miranda,1979-04-04,90579541K,antonio.miranda@smartweb.digital,551483,ES06209535008739372467,1493.81,2023-12-05T11:12:47,Labastida,expenses,leisure,-25.95,-48204.68
buyer_8,Antonio,Miranda,1979-04-04,90579541K,antonio.miranda@smartweb.digital,551483,ES06209535008739372467,1493.81,2023-12-06T15:50:15,Labastida,expenses,phone,-93.59,-48298.27
buyer_8,Antonio,Miranda,1979-04-04,90579541K,antonio.miranda@smartweb.digital,551483,ES06209535008739372467,1493.81,2023-12-06T15:53:02,Labastida,expenses,transport,-76.2,-48374.47
buyer_8,Antonio,Miranda,1979-04-04,90579541K,antonio.miranda@smartweb.digital,551483,ES06209535008739372467,1493.81,2023-12-06T19:17:16,Labastida,expenses,gifts,-719.3,-49093.77
buyer_8,Antonio,Miranda,1979-04-04,90579541K,antonio.miranda@smartweb.digital,551483,ES06209535008739372467,1493.81,2023-12-07T14:43:00,Labastida,expenses,clothing,-50.49,-49144.26
buyer_8,Antonio,Miranda,1979-04-04,90579541K,antonio.miranda@smartweb.digital,551483,ES06209535008739372467,1493.81,2023-12-08T10:09:59,Labastida,expenses,water,-80.47,-49224.73
buyer_8,Antonio,Miranda,1979-04-04,90579541K,antonio.miranda@smartweb.digital,551483,ES06209535008739372467,1493.81,2023-12-08T16:31:37,Labastida,expenses,electricity,-142.37,-49367.1
buyer_8,Antonio,Miranda,1979-04-04,90579541K,antonio.miranda@smartweb.digital,551483,ES06209535008739372467,1493.81,2023-12-08T10:32:21,Labastida,expenses,internet,-94.0,-49461.1
buyer_8,Antonio,Miranda,1979-04-04,90579541K,antonio.miranda@smartweb.digital,551483,ES06209535008739372467,1493.81,2023-12-08T21:09:08,Labastida,expenses,phone,-75.67,-49536.77
buyer_8,Antonio,Miranda,1979-04-04,90579541K,antonio.miranda@smartweb.digital,551483,ES06209535008739372467,1493.81,2023-12-09T10:14:17,Labastida,expenses,cash,-100.0,-49636.77
buyer_8,Antonio,Miranda,1979-04-04,90579541K,antonio.miranda@smartweb.digital,551483,ES06209535008739372467,1493.81,2023-12-10T04:32:58,Labastida,expenses,transport,-75.02,-49711.79
buyer_8,Antonio,Miranda,1979-04-04,90579541K,antonio.miranda@smartweb.digital,551483,ES06209535008739372467,1493.81,2023-12-10T13:01:16,Labastida,expenses,education,-70.43,-49782.22
buyer_8,Antonio,Miranda,1979-04-04,90579541K,antonio.miranda@smartweb.digital,551483,ES06209535008739372467,1493.81,2023-12-12T14:49:59,Labastida,expenses,leisure,-24.69,-49806.91
buyer_8,Antonio,Miranda,1979-04-04,90579541K,antonio.miranda@smartweb.digital,551483,ES06209535008739372467,1493.81,2023-12-13T12:37:41,Labastida,expenses,healthcare,-44.66,-49851.57
buyer_8,Antonio,Miranda,1979-04-04,90579541K,antonio.miranda@smartweb.digital,551483,ES06209535008739372467,1493.81,2023-12-14T12:24:12,Labastida,expenses,leisure,-22.23,-49873.8
buyer_8,Antonio,Miranda,1979-04-04,90579541K,antonio.miranda@smartweb.digital,551483,ES06209535008739372467,1493.81,2023-12-14T22:52:29,Labastida,expenses,cash,-100.0,-49973.8
buyer_8,Antonio,Miranda,1979-04-04,90579541K,antonio.miranda@smartweb.digital,551483,ES06209535008739372467,1493.81,2023-12-15T14:35:32,Labastida,expenses,food,-64.7,-50038.5
buyer_8,Antonio,Miranda,1979-04-04,90579541K,antonio.miranda@smartweb.digital,551483,ES06209535008739372467,1493.81,2023-12-18T11:39:46,Labastida,expenses,gifts,-824.29,-50862.79
buyer_8,Antonio,Miranda,1979-04-04,90579541K,antonio.miranda@smartweb.digital,551483,ES06209535008739372467,1493.81,2023-12-20T19:43:24,Labastida,expenses,healthcare,-145.44,-51008.23
buyer_8,Antonio,Miranda,1979-04-04,90579541K,antonio.miranda@smartweb.digital,551483,ES06209535008739372467,1493.81,2023-12-21T16:33:39,Labastida,expenses,food,-67.89,-51076.12
buyer_8,Antonio,Miranda,1979-04-04,90579541K,antonio.miranda@smartweb.digital,551483,ES06209535008739372467,1493.81,2023-12-22T21:21:55,Labastida,expenses,transport,-84.37,-51160.49
buyer_8,Antonio,Miranda,1979-04-04,90579541K,antonio.miranda@smartweb.digital,551483,ES06209535008739372467,1493.81,2023-12-24T09:51:31,Labastida,expenses,cash,-100.0,-51260.49
buyer_8,Antonio,Miranda,1979-04-04,90579541K,antonio.miranda@smartweb.digital,551483,ES06209535008739372467,1493.81,2023-12-25T08:17:15,Labastida,expenses,food,-121.0,-51381.49
buyer_8,Antonio,Miranda,1979-04-04,90579541K,antonio.miranda@smartweb.digital,551483,ES06209535008739372467,1493.81,2023-12-25T18:08:33,Labastida,expenses,clothing,-107.6,-51489.09
buyer_8,Antonio,Miranda,1979-04-04,90579541K,antonio.miranda@smartweb.digital,551483,ES06209535008739372467,1493.81,2023-12-26T16:20:19,Labastida,expenses,cash,-100.0,-51589.09
buyer_8,Antonio,Miranda,1979-04-04,90579541K,antonio.miranda@smartweb.digital,551483,ES06209535008739372467,1493.81,2023-12-27T12:54:57,Labastida,expenses,food,-67.31,-51656.4
buyer_8,Antonio,Miranda,1979-04-04,90579541K,antonio.miranda@smartweb.digital,551483,ES06209535008739372467,1493.81,2023-12-28T15:46:25,Labastida,expenses,food,-104.52,-51760.92
buyer_8,Antonio,Miranda,1979-04-04,90579541K,antonio.miranda@smartweb.digital,551483,ES06209535008739372467,1493.81,2023-12-28T12:42:23,Labastida,expenses,leisure,-41.94,-51802.86
buyer_8,Antonio,Miranda,1979-04-04,90579541K,antonio.miranda@smartweb.digital,551483,ES06209535008739372467,1493.81,2023-12-29T18:35:03,Labastida,expenses,repairs,-114.18,-51917.04
buyer_8,Antonio,Miranda,1979-04-04,90579541K,antonio.miranda@smartweb.digital,551483,ES06209535008739372467,1493.81,2023-12-31T17:01:53,Labastida,expenses,leisure,-55.52,-51972.56
buyer_8,Antonio,Miranda,1979-04-04,90579541K,antonio.miranda@smartweb.digital,551483,ES06209535008739372467,1493.81,2024-01-01T16:28:46,Labastida,incomes,salary,4159.64,-47812.92
buyer_8,Antonio,Miranda,1979-04-04,90579541K,antonio.miranda@smartweb.digital,551483,ES06209535008739372467,1493.81,2024-01-02T17:17:37,Labastida,expenses,appliances,-245.36,-48058.28
buyer_8,Antonio,Miranda,1979-04-04,90579541K,antonio.miranda@smartweb.digital,551483,ES06209535008739372467,1493.81,2024-01-02T10:56:52,Labastida,expenses,gifts,-203.7,-48261.98
buyer_8,Antonio,Miranda,1979-04-04,90579541K,antonio.miranda@smartweb.digital,551483,ES06209535008739372467,1493.81,2024-01-03T08:03:31,Labastida,expenses,food,-100.5,-48362.48
buyer_8,Antonio,Miranda,1979-04-04,90579541K,antonio.miranda@smartweb.digital,551483,ES06209535008739372467,1493.81,2024-01-04T08:16:59,Labastida,expenses,mortgage,-1724.68,-50087.16
buyer_8,Antonio,Miranda,1979-04-04,90579541K,antonio.miranda@smartweb.digital,551483,ES06209535008739372467,1493.81,2024-01-05T20:13:17,Labastida,expenses,internet,-96.09,-50183.25
buyer_8,Antonio,Miranda,1979-04-04,90579541K,antonio.miranda@smartweb.digital,551483,ES06209535008739372467,1493.81,2024-01-05T03:46:20,Labastida,expenses,transport,-42.51,-50225.76
buyer_8,Antonio,Miranda,1979-04-04,90579541K,antonio.miranda@smartweb.digital,551483,ES06209535008739372467,1493.81,2024-01-05T13:10:08,Labastida,expenses,cash,-100.0,-50325.76
buyer_8,Antonio,Miranda,1979-04-04,90579541K,antonio.miranda@smartweb.digital,551483,ES06209535008739372467,1493.81,2024-01-06T11:15:51,Labastida,expenses,repairs,-36.86,-50362.62
buyer_8,Antonio,Miranda,1979-04-04,90579541K,antonio.miranda@smartweb.digital,551483,ES06209535008739372467,1493.81,2024-01-07T12:00:46,Labastida,expenses,internet,-96.09,-50458.71
buyer_8,Antonio,Miranda,1979-04-04,90579541K,antonio.miranda@smartweb.digital,551483,ES06209535008739372467,1493.81,2024-01-08T02:37:55,Labastida,expenses,water,-50.62,-50509.33
buyer_8,Antonio,Miranda,1979-04-04,90579541K,antonio.miranda@smartweb.digital,551483,ES06209535008739372467,1493.81,2024-01-08T18:47:01,Labastida,expenses,electricity,-93.43,-50602.76
buyer_8,Antonio,Miranda,1979-04-04,90579541K,antonio.miranda@smartweb.digital,551483,ES06209535008739372467,1493.81,2024-01-08T18:46:52,Labastida,expenses,phone,-88.04,-50690.8
buyer_8,Antonio,Miranda,1979-04-04,90579541K,antonio.miranda@smartweb.digital,551483,ES06209535008739372467,1493.81,2024-01-09T14:08:43,Labastida,expenses,travel,-989.64,-51680.44
buyer_8,Antonio,Miranda,1979-04-04,90579541K,antonio.miranda@smartweb.digital,551483,ES06209535008739372467,1493.81,2024-01-09T19:27:11,Labastida,expenses,appliances,-266.96,-51947.4
buyer_8,Antonio,Miranda,1979-04-04,90579541K,antonio.miranda@smartweb.digital,551483,ES06209535008739372467,1493.81,2024-01-11T02:45:39,Labastida,expenses,food,-93.29,-52040.69
buyer_8,Antonio,Miranda,1979-04-04,90579541K,antonio.miranda@smartweb.digital,551483,ES06209535008739372467,1493.81,2024-01-11T18:11:20,Labastida,expenses,healthcare,-88.12,-52128.81
buyer_8,Antonio,Miranda,1979-04-04,90579541K,antonio.miranda@smartweb.digital,551483,ES06209535008739372467,1493.81,2024-01-13T09:07:53,Labastida,expenses,leisure,-56.81,-52185.62
buyer_8,Antonio,Miranda,1979-04-04,90579541K,antonio.miranda@smartweb.digital,551483,ES06209535008739372467,1493.81,2024-01-13T15:05:52,Labastida,expenses,gifts,-263.37,-52448.99
buyer_8,Antonio,Miranda,1979-04-04,90579541K,antonio.miranda@smartweb.digital,551483,ES06209535008739372467,1493.81,2024-01-15T13:34:28,Labastida,expenses,cash,-100.0,-52548.99
buyer_8,Antonio,Miranda,1979-04-04,90579541K,antonio.miranda@smartweb.digital,551483,ES06209535008739372467,1493.81,2024-01-17T19:33:17,Labastida,expenses,healthcare,-150.0,-52698.99
buyer_8,Antonio,Miranda,1979-04-04,90579541K,antonio.miranda@smartweb.digital,551483,ES06209535008739372467,1493.81,2024-01-17T17:09:54,Labastida,expenses,cash,-100.0,-52798.99
buyer_8,Antonio,Miranda,1979-04-04,90579541K,antonio.miranda@smartweb.digital,551483,ES06209535008739372467,1493.81,2024-01-17T12:41:38,Labastida,expenses,repairs,-140.35,-52939.34
buyer_8,Antonio,Miranda,1979-04-04,90579541K,antonio.miranda@smartweb.digital,551483,ES06209535008739372467,1493.81,2024-01-21T02:16:24,Labastida,expenses,food,-120.84,-53060.18
buyer_8,Antonio,Miranda,1979-04-04,90579541K,antonio.miranda@smartweb.digital,551483,ES06209535008739372467,1493.81,2024-01-21T16:11:55,Labastida,expenses,gifts,-257.97,-53318.15
buyer_8,Antonio,Miranda,1979-04-04,90579541K,antonio.miranda@smartweb.digital,551483,ES06209535008739372467,1493.81,2024-01-22T13:37:25,Labastida,expenses,cash,-100.0,-53418.15
buyer_8,Antonio,Miranda,1979-04-04,90579541K,antonio.miranda@smartweb.digital,551483,ES06209535008739372467,1493.81,2024-01-23T19:35:14,Labastida,expenses,education,-74.54,-53492.69
buyer_8,Antonio,Miranda,1979-04-04,90579541K,antonio.miranda@smartweb.digital,551483,ES06209535008739372467,1493.81,2024-01-23T19:11:16,Labastida,expenses,cash,-100.0,-53592.69
buyer_8,Antonio,Miranda,1979-04-04,90579541K,antonio.miranda@smartweb.digital,551483,ES06209535008739372467,1493.81,2024-01-25T14:24:38,Labastida,expenses,repairs,-190.2,-53782.89
buyer_8,Antonio,Miranda,1979-04-04,90579541K,antonio.miranda@smartweb.digital,551483,ES06209535008739372467,1493.81,2024-01-26T16:22:32,Labastida,expenses,gifts,-484.6,-54267.49
buyer_8,Antonio,Miranda,1979-04-04,90579541K,antonio.miranda@smartweb.digital,551483,ES06209535008739372467,1493.81,2024-01-29T16:26:04,Labastida,expenses,cash,-100.0,-54367.49
buyer_8,Antonio,Miranda,1979-04-04,90579541K,antonio.miranda@smartweb.digital,551483,ES06209535008739372467,1493.81,2024-01-30T21:29:26,Labastida,expenses,education,-48.09,-54415.58
buyer_8,Antonio,Miranda,1979-04-04,90579541K,antonio.miranda@smartweb.digital,551483,ES06209535008739372467,1493.81,2024-01-30T18:31:48,Labastida,expenses,cash,-100.0,-54515.58
buyer_8,Antonio,Miranda,1979-04-04,90579541K,antonio.miranda@smartweb.digital,551483,ES06209535008739372467,1493.81,2024-01-30T17:19:40,Labastida,expenses,gifts,-195.22,-54710.8
buyer_8,Antonio,Miranda,1979-04-04,90579541K,antonio.miranda@smartweb.digital,551483,ES06209535008739372467,1493.81,2024-01-31T12:59:09,Labastida,expenses,leisure,-68.17,-54778.97
buyer_8,Antonio,Miranda,1979-04-04,90579541K,antonio.miranda@smartweb.digital,551483,ES06209535008739372467,1493.81,2024-02-01T08:58:36,Labastida,incomes,salary,4159.64,-50619.33
buyer_8,Antonio,Miranda,1979-04-04,90579541K,antonio.miranda@smartweb.digital,551483,ES06209535008739372467,1493.81,2024-02-02T19:22:33,Labastida,expenses,transport,-88.76,-50708.09
buyer_8,Antonio,Miranda,1979-04-04,90579541K,antonio.miranda@smartweb.digital,551483,ES06209535008739372467,1493.81,2024-02-02T16:11:39,Labastida,expenses,cash,-100.0,-50808.09
buyer_8,Antonio,Miranda,1979-04-04,90579541K,antonio.miranda@smartweb.digital,551483,ES06209535008739372467,1493.81,2024-02-04T21:01:38,Labastida,expenses,mortgage,-1724.68,-52532.77
buyer_8,Antonio,Miranda,1979-04-04,90579541K,antonio.miranda@smartweb.digital,551483,ES06209535008739372467,1493.81,2024-02-04T11:14:40,Labastida,expenses,leisure,-36.5,-52569.27
buyer_8,Antonio,Miranda,1979-04-04,90579541K,antonio.miranda@smartweb.digital,551483,ES06209535008739372467,1493.81,2024-02-05T11:36:21,Labastida,expenses,electricity,-104.06,-52673.33
buyer_8,Antonio,Miranda,1979-04-04,90579541K,antonio.miranda@smartweb.digital,551483,ES06209535008739372467,1493.81,2024-02-06T21:12:05,Labastida,expenses,electricity,-172.26,-52845.59
buyer_8,Antonio,Miranda,1979-04-04,90579541K,antonio.miranda@smartweb.digital,551483,ES06209535008739372467,1493.81,2024-02-06T20:13:03,Labastida,expenses,internet,-96.09,-52941.68
buyer_8,Antonio,Miranda,1979-04-04,90579541K,antonio.miranda@smartweb.digital,551483,ES06209535008739372467,1493.81,2024-02-06T16:36:06,Labastida,expenses,food,-99.13,-53040.81
buyer_8,Antonio,Miranda,1979-04-04,90579541K,antonio.miranda@smartweb.digital,551483,ES06209535008739372467,1493.81,2024-02-06T19:45:05,Labastida,expenses,cash,-100.0,-53140.81
buyer_8,Antonio,Miranda,1979-04-04,90579541K,antonio.miranda@smartweb.digital,551483,ES06209535008739372467,1493.81,2024-02-06T09:01:08,Labastida,expenses,gifts,-774.42,-53915.23
buyer_8,Antonio,Miranda,1979-04-04,90579541K,antonio.miranda@smartweb.digital,551483,ES06209535008739372467,1493.81,2024-02-07T09:08:28,Labastida,expenses,internet,-96.09,-54011.32
buyer_8,Antonio,Miranda,1979-04-04,90579541K,antonio.miranda@smartweb.digital,551483,ES06209535008739372467,1493.81,2024-02-07T13:01:58,Labastida,expenses,clothing,-73.81,-54085.13
buyer_8,Antonio,Miranda,1979-04-04,90579541K,antonio.miranda@smartweb.digital,551483,ES06209535008739372467,1493.81,2024-02-07T14:16:51,Labastida,expenses,gifts,-187.28,-54272.41
buyer_8,Antonio,Miranda,1979-04-04,90579541K,antonio.miranda@smartweb.digital,551483,ES06209535008739372467,1493.81,2024-02-08T16:56:28,Labastida,expenses,internet,-96.09,-54368.5
buyer_8,Antonio,Miranda,1979-04-04,90579541K,antonio.miranda@smartweb.digital,551483,ES06209535008739372467,1493.81,2024-02-08T18:36:09,Labastida,expenses,clothing,-135.3,-54503.8
buyer_8,Antonio,Miranda,1979-04-04,90579541K,antonio.miranda@smartweb.digital,551483,ES06209535008739372467,1493.81,2024-02-08T13:29:10,Labastida,expenses,cash,-100.0,-54603.8
buyer_8,Antonio,Miranda,1979-04-04,90579541K,antonio.miranda@smartweb.digital,551483,ES06209535008739372467,1493.81,2024-02-11T23:18:56,Labastida,expenses,repairs,-279.0,-54882.8
buyer_8,Antonio,Miranda,1979-04-04,90579541K,antonio.miranda@smartweb.digital,551483,ES06209535008739372467,1493.81,2024-02-12T15:50:47,Labastida,expenses,transport,-49.2,-54932.0
buyer_8,Antonio,Miranda,1979-04-04,90579541K,antonio.miranda@smartweb.digital,551483,ES06209535008739372467,1493.81,2024-02-14T18:40:46,Labastida,expenses,cash,-100.0,-55032.0
buyer_8,Antonio,Miranda,1979-04-04,90579541K,antonio.miranda@smartweb.digital,551483,ES06209535008739372467,1493.81,2024-02-16T09:34:36,Labastida,expenses,leisure,-69.4,-55101.4
buyer_8,Antonio,Miranda,1979-04-04,90579541K,antonio.miranda@smartweb.digital,551483,ES06209535008739372467,1493.81,2024-02-16T12:22:43,Labastida,expenses,education,-78.89,-55180.29
buyer_8,Antonio,Miranda,1979-04-04,90579541K,antonio.miranda@smartweb.digital,551483,ES06209535008739372467,1493.81,2024-02-17T18:51:38,Labastida,expenses,healthcare,-67.84,-55248.13
buyer_8,Antonio,Miranda,1979-04-04,90579541K,antonio.miranda@smartweb.digital,551483,ES06209535008739372467,1493.81,2024-02-18T14:02:33,Labastida,expenses,clothing,-51.7,-55299.83
buyer_8,Antonio,Miranda,1979-04-04,90579541K,antonio.miranda@smartweb.digital,551483,ES06209535008739372467,1493.81,2024-02-19T21:37:07,Labastida,expenses,transport,-89.36,-55389.19
buyer_8,Antonio,Miranda,1979-04-04,90579541K,antonio.miranda@smartweb.digital,551483,ES06209535008739372467,1493.81,2024-02-24T19:08:52,Labastida,expenses,cash,-100.0,-55489.19
buyer_8,Antonio,Miranda,1979-04-04,90579541K,antonio.miranda@smartweb.digital,551483,ES06209535008739372467,1493.81,2024-02-27T08:25:49,Labastida,expenses,food,-63.89,-55553.08
buyer_8,Antonio,Miranda,1979-04-04,90579541K,antonio.miranda@smartweb.digital,551483,ES06209535008739372467,1493.81,2024-02-29T20:38:30,Labastida,expenses,gifts,-82.12,-55635.2
buyer_8,Antonio,Miranda,1979-04-04,90579541K,antonio.miranda@smartweb.digital,551483,ES06209535008739372467,1493.81,2024-03-01T19:22:54,Labastida,incomes,salary,4159.64,-51475.56
buyer_8,Antonio,Miranda,1979-04-04,90579541K,antonio.miranda@smartweb.digital,551483,ES06209535008739372467,1493.81,2024-03-01T21:47:50,Labastida,expenses,repairs,-227.71,-51703.27
buyer_8,Antonio,Miranda,1979-04-04,90579541K,antonio.miranda@smartweb.digital,551483,ES06209535008739372467,1493.81,2024-03-01T02:15:39,Labastida,expenses,gifts,-747.9,-52451.17
buyer_8,Antonio,Miranda,1979-04-04,90579541K,antonio.miranda@smartweb.digital,551483,ES06209535008739372467,1493.81,2024-03-02T14:18:26,Labastida,expenses,leisure,-19.57,-52470.74
buyer_8,Antonio,Miranda,1979-04-04,90579541K,antonio.miranda@smartweb.digital,551483,ES06209535008739372467,1493.81,2024-03-04T15:58:24,Labastida,expenses,mortgage,-1724.68,-54195.42
buyer_8,Antonio,Miranda,1979-04-04,90579541K,antonio.miranda@smartweb.digital,551483,ES06209535008739372467,1493.81,2024-03-05T14:31:41,Labastida,expenses,electricity,-184.92,-54380.34
buyer_8,Antonio,Miranda,1979-04-04,90579541K,antonio.miranda@smartweb.digital,551483,ES06209535008739372467,1493.81,2024-03-05T13:51:04,Labastida,expenses,transport,-62.28,-54442.62
buyer_8,Antonio,Miranda,1979-04-04,90579541K,antonio.miranda@smartweb.digital,551483,ES06209535008739372467,1493.81,2024-03-05T13:03:31,Labastida,expenses,cash,-100.0,-54542.62
buyer_8,Antonio,Miranda,1979-04-04,90579541K,antonio.miranda@smartweb.digital,551483,ES06209535008739372467,1493.81,2024-03-06T22:23:12,Labastida,expenses,water,-102.85,-54645.47
buyer_8,Antonio,Miranda,1979-04-04,90579541K,antonio.miranda@smartweb.digital,551483,ES06209535008739372467,1493.81,2024-03-06T09:25:39,Labastida,expenses,phone,-92.14,-54737.61
buyer_8,Antonio,Miranda,1979-04-04,90579541K,antonio.miranda@smartweb.digital,551483,ES06209535008739372467,1493.81,2024-03-07T08:09:28,Labastida,expenses,water,-91.37,-54828.98
buyer_8,Antonio,Miranda,1979-04-04,90579541K,antonio.miranda@smartweb.digital,551483,ES06209535008739372467,1493.81,2024-03-08T14:14:04,Labastida,expenses,car,-360.32,-55189.3
buyer_8,Antonio,Miranda,1979-04-04,90579541K,antonio.miranda@smartweb.digital,551483,ES06209535008739372467,1493.81,2024-03-09T15:09:19,Labastida,expenses,cash,-100.0,-55289.3
buyer_8,Antonio,Miranda,1979-04-04,90579541K,antonio.miranda@smartweb.digital,551483,ES06209535008739372467,1493.81,2024-03-10T10:40:54,Labastida,expenses,gifts,-720.17,-56009.47
buyer_8,Antonio,Miranda,1979-04-04,90579541K,antonio.miranda@smartweb.digital,551483,ES06209535008739372467,1493.81,2024-03-11T13:05:12,Labastida,expenses,education,-76.97,-56086.44
buyer_8,Antonio,Miranda,1979-04-04,90579541K,antonio.miranda@smartweb.digital,551483,ES06209535008739372467,1493.81,2024-03-11T08:00:39,Labastida,expenses,cash,-100.0,-56186.44
buyer_8,Antonio,Miranda,1979-04-04,90579541K,antonio.miranda@smartweb.digital,551483,ES06209535008739372467,1493.81,2024-03-11T14:19:30,Labastida,expenses,repairs,-208.8,-56395.24
buyer_8,Antonio,Miranda,1979-04-04,90579541K,antonio.miranda@smartweb.digital,551483,ES06209535008739372467,1493.81,2024-03-12T20:31:01,Labastida,expenses,healthcare,-127.83,-56523.07
buyer_8,Antonio,Miranda,1979-04-04,90579541K,antonio.miranda@smartweb.digital,551483,ES06209535008739372467,1493.81,2024-03-13T11:54:22,Labastida,expenses,travel,-422.17,-56945.24
buyer_8,Antonio,Miranda,1979-04-04,90579541K,antonio.miranda@smartweb.digital,551483,ES06209535008739372467,1493.81,2024-03-14T15:17:20,Labastida,expenses,education,-52.33,-56997.57
buyer_8,Antonio,Miranda,1979-04-04,90579541K,antonio.miranda@smartweb.digital,551483,ES06209535008739372467,1493.81,2024-03-14T21:58:45,Labastida,expenses,gifts,-251.59,-57249.16
buyer_8,Antonio,Miranda,1979-04-04,90579541K,antonio.miranda@smartweb.digital,551483,ES06209535008739372467,1493.81,2024-03-17T22:30:50,Labastida,expenses,leisure,-65.99,-57315.15
buyer_8,Antonio,Miranda,1979-04-04,90579541K,antonio.miranda@smartweb.digital,551483,ES06209535008739372467,1493.81,2024-03-17T14:25:37,Labastida,expenses,cash,-100.0,-57415.15
buyer_8,Antonio,Miranda,1979-04-04,90579541K,antonio.miranda@smartweb.digital,551483,ES06209535008739372467,1493.81,2024-03-18T11:47:21,Labastida,expenses,cash,-100.0,-57515.15
buyer_8,Antonio,Miranda,1979-04-04,90579541K,antonio.miranda@smartweb.digital,551483,ES06209535008739372467,1493.81,2024-03-18T05:45:08,Labastida,expenses,repairs,-169.58,-57684.73
buyer_8,Antonio,Miranda,1979-04-04,90579541K,antonio.miranda@smartweb.digital,551483,ES06209535008739372467,1493.81,2024-03-19T14:15:46,Labastida,expenses,appliances,-248.16,-57932.89
buyer_8,Antonio,Miranda,1979-04-04,90579541K,antonio.miranda@smartweb.digital,551483,ES06209535008739372467,1493.81,2024-03-20T18:53:17,Labastida,expenses,transport,-45.4,-57978.29
buyer_8,Antonio,Miranda,1979-04-04,90579541K,antonio.miranda@smartweb.digital,551483,ES06209535008739372467,1493.81,2024-03-20T19:04:21,Labastida,expenses,cash,-100.0,-58078.29
buyer_8,Antonio,Miranda,1979-04-04,90579541K,antonio.miranda@smartweb.digital,551483,ES06209535008739372467,1493.81,2024-03-22T13:02:52,Labastida,expenses,repairs,-142.68,-58220.97
buyer_8,Antonio,Miranda,1979-04-04,90579541K,antonio.miranda@smartweb.digital,551483,ES06209535008739372467,1493.81,2024-03-24T09:04:19,Labastida,expenses,transport,-43.7,-58264.67
buyer_8,Antonio,Miranda,1979-04-04,90579541K,antonio.miranda@smartweb.digital,551483,ES06209535008739372467,1493.81,2024-03-25T16:01:41,Labastida,expenses,food,-79.73,-58344.4
buyer_8,Antonio,Miranda,1979-04-04,90579541K,antonio.miranda@smartweb.digital,551483,ES06209535008739372467,1493.81,2024-03-26T08:48:53,Labastida,expenses,cash,-100.0,-58444.4
buyer_8,Antonio,Miranda,1979-04-04,90579541K,antonio.miranda@smartweb.digital,551483,ES06209535008739372467,1493.81,2024-03-27T20:11:14,Labastida,expenses,leisure,-28.44,-58472.84
buyer_8,Antonio,Miranda,1979-04-04,90579541K,antonio.miranda@smartweb.digital,551483,ES06209535008739372467,1493.81,2024-03-27T18:22:53,Labastida,expenses,cash,-100.0,-58572.84
buyer_8,Antonio,Miranda,1979-04-04,90579541K,antonio.miranda@smartweb.digital,551483,ES06209535008739372467,1493.81,2024-03-29T09:59:10,Labastida,expenses,leisure,-69.46,-58642.3
buyer_8,Antonio,Miranda,1979-04-04,90579541K,antonio.miranda@smartweb.digital,551483,ES06209535008739372467,1493.81,2024-03-29T18:09:19,Labastida,expenses,education,-44.95,-58687.25
buyer_8,Antonio,Miranda,1979-04-04,90579541K,antonio.miranda@smartweb.digital,551483,ES06209535008739372467,1493.81,2024-03-31T12:19:13,Labastida,expenses,leisure,-61.85,-58749.1
buyer_8,Antonio,Miranda,1979-04-04,90579541K,antonio.miranda@smartweb.digital,551483,ES06209535008739372467,1493.81,2024-04-01T07:25:50,Labastida,incomes,salary,4159.64,-54589.46
buyer_8,Antonio,Miranda,1979-04-04,90579541K,antonio.miranda@smartweb.digital,551483,ES06209535008739372467,1493.81,2024-04-01T07:25:50,Labastida,incomes,extra_income,531.65,-54057.81
buyer_8,Antonio,Miranda,1979-04-04,90579541K,antonio.miranda@smartweb.digital,551483,ES06209535008739372467,1493.81,2024-04-01T19:45:06,Labastida,expenses,food,-105.99,-54163.8
buyer_8,Antonio,Miranda,1979-04-04,90579541K,antonio.miranda@smartweb.digital,551483,ES06209535008739372467,1493.81,2024-04-01T16:19:18,Labastida,expenses,cash,-100.0,-54263.8
buyer_8,Antonio,Miranda,1979-04-04,90579541K,antonio.miranda@smartweb.digital,551483,ES06209535008739372467,1493.81,2024-04-02T22:00:01,Labastida,expenses,transport,-79.06,-54342.86
buyer_8,Antonio,Miranda,1979-04-04,90579541K,antonio.miranda@smartweb.digital,551483,ES06209535008739372467,1493.81,2024-04-04T16:19:02,Labastida,expenses,mortgage,-1724.68,-56067.54
buyer_8,Antonio,Miranda,1979-04-04,90579541K,antonio.miranda@smartweb.digital,551483,ES06209535008739372467,1493.81,2024-04-05T15:21:27,Labastida,expenses,internet,-96.09,-56163.63
buyer_8,Antonio,Miranda,1979-04-04,90579541K,antonio.miranda@smartweb.digital,551483,ES06209535008739372467,1493.81,2024-04-05T10:03:43,Labastida,expenses,transport,-80.12,-56243.75
buyer_8,Antonio,Miranda,1979-04-04,90579541K,antonio.miranda@smartweb.digital,551483,ES06209535008739372467,1493.81,2024-04-05T06:28:27,Labastida,expenses,repairs,-45.65,-56289.4
buyer_8,Antonio,Miranda,1979-04-04,90579541K,antonio.miranda@smartweb.digital,551483,ES06209535008739372467,1493.81,2024-04-06T14:08:07,Labastida,expenses,electricity,-89.66,-56379.06
buyer_8,Antonio,Miranda,1979-04-04,90579541K,antonio.miranda@smartweb.digital,551483,ES06209535008739372467,1493.81,2024-04-06T16:14:48,Labastida,expenses,gas,-74.47,-56453.53
buyer_8,Antonio,Miranda,1979-04-04,90579541K,antonio.miranda@smartweb.digital,551483,ES06209535008739372467,1493.81,2024-04-07T14:23:42,Labastida,expenses,gas,-149.13,-56602.66
buyer_8,Antonio,Miranda,1979-04-04,90579541K,antonio.miranda@smartweb.digital,551483,ES06209535008739372467,1493.81,2024-04-07T16:26:31,Labastida,expenses,cash,-100.0,-56702.66
buyer_8,Antonio,Miranda,1979-04-04,90579541K,antonio.miranda@smartweb.digital,551483,ES06209535008739372467,1493.81,2024-04-09T15:36:07,Labastida,expenses,transport,-51.44,-56754.1
buyer_8,Antonio,Miranda,1979-04-04,90579541K,antonio.miranda@smartweb.digital,551483,ES06209535008739372467,1493.81,2024-04-10T08:43:28,Labastida,expenses,repairs,-311.39,-57065.49
buyer_8,Antonio,Miranda,1979-04-04,90579541K,antonio.miranda@smartweb.digital,551483,ES06209535008739372467,1493.81,2024-04-13T15:13:02,Labastida,expenses,clothing,-58.18,-57123.67
buyer_8,Antonio,Miranda,1979-04-04,90579541K,antonio.miranda@smartweb.digital,551483,ES06209535008739372467,1493.81,2024-04-14T18:31:19,Labastida,expenses,food,-80.37,-57204.04
buyer_8,Antonio,Miranda,1979-04-04,90579541K,antonio.miranda@smartweb.digital,551483,ES06209535008739372467,1493.81,2024-04-15T12:49:12,Labastida,expenses,clothing,-45.47,-57249.51
buyer_8,Antonio,Miranda,1979-04-04,90579541K,antonio.miranda@smartweb.digital,551483,ES06209535008739372467,1493.81,2024-04-18T13:55:17,Labastida,expenses,travel,-1132.63,-58382.14
buyer_8,Antonio,Miranda,1979-04-04,90579541K,antonio.miranda@smartweb.digital,551483,ES06209535008739372467,1493.81,2024-04-19T19:18:18,Labastida,expenses,leisure,-27.29,-58409.43
buyer_8,Antonio,Miranda,1979-04-04,90579541K,antonio.miranda@smartweb.digital,551483,ES06209535008739372467,1493.81,2024-04-19T10:39:10,Labastida,expenses,cash,-100.0,-58509.43
buyer_8,Antonio,Miranda,1979-04-04,90579541K,antonio.miranda@smartweb.digital,551483,ES06209535008739372467,1493.81,2024-04-21T08:06:50,Labastida,expenses,gifts,-565.91,-59075.34
buyer_8,Antonio,Miranda,1979-04-04,90579541K,antonio.miranda@smartweb.digital,551483,ES06209535008739372467,1493.81,2024-04-23T20:35:27,Labastida,expenses,leisure,-58.72,-59134.06
buyer_8,Antonio,Miranda,1979-04-04,90579541K,antonio.miranda@smartweb.digital,551483,ES06209535008739372467,1493.81,2024-04-24T05:21:52,Labastida,expenses,food,-62.48,-59196.54
buyer_8,Antonio,Miranda,1979-04-04,90579541K,antonio.miranda@smartweb.digital,551483,ES06209535008739372467,1493.81,2024-04-26T13:24:20,Labastida,expenses,food,-72.48,-59269.02
buyer_8,Antonio,Miranda,1979-04-04,90579541K,antonio.miranda@smartweb.digital,551483,ES06209535008739372467,1493.81,2024-04-27T16:32:41,Labastida,expenses,education,-77.83,-59346.85
buyer_8,Antonio,Miranda,1979-04-04,90579541K,antonio.miranda@smartweb.digital,551483,ES06209535008739372467,1493.81,2024-04-28T10:40:22,Labastida,expenses,repairs,-319.15,-59666.0
buyer_8,Antonio,Miranda,1979-04-04,90579541K,antonio.miranda@smartweb.digital,551483,ES06209535008739372467,1493.81,2024-04-29T08:11:29,Labastida,expenses,leisure,-79.11,-59745.11
buyer_8,Antonio,Miranda,1979-04-04,90579541K,antonio.miranda@smartweb.digital,551483,ES06209535008739372467,1493.81,2024-04-30T14:01:12,Labastida,expenses,transport,-53.84,-59798.95
buyer_8,Antonio,Miranda,1979-04-04,90579541K,antonio.miranda@smartweb.digital,551483,ES06209535008739372467,1493.81,2024-05-01T10:40:16,Labastida,incomes,salary,4159.64,-55639.31
buyer_8,Antonio,Miranda,1979-04-04,90579541K,antonio.miranda@smartweb.digital,551483,ES06209535008739372467,1493.81,2024-05-02T11:27:07,Labastida,expenses,leisure,-21.5,-55660.81
buyer_8,Antonio,Miranda,1979-04-04,90579541K,antonio.miranda@smartweb.digital,551483,ES06209535008739372467,1493.81,2024-05-03T11:55:25,Labastida,expenses,cash,-100.0,-55760.81
buyer_8,Antonio,Miranda,1979-04-04,90579541K,antonio.miranda@smartweb.digital,551483,ES06209535008739372467,1493.81,2024-05-04T12:49:17,Labastida,expenses,mortgage,-1724.68,-57485.49
buyer_8,Antonio,Miranda,1979-04-04,90579541K,antonio.miranda@smartweb.digital,551483,ES06209535008739372467,1493.81,2024-05-05T14:11:03,Labastida,expenses,water,-62.44,-57547.93
buyer_8,Antonio,Miranda,1979-04-04,90579541K,antonio.miranda@smartweb.digital,551483,ES06209535008739372467,1493.81,2024-05-05T12:38:02,Labastida,expenses,phone,-90.17,-57638.1
buyer_8,Antonio,Miranda,1979-04-04,90579541K,antonio.miranda@smartweb.digital,551483,ES06209535008739372467,1493.81,2024-05-06T15:47:05,Labastida,expenses,gas,-98.72,-57736.82
buyer_8,Antonio,Miranda,1979-04-04,90579541K,antonio.miranda@smartweb.digital,551483,ES06209535008739372467,1493.81,2024-05-07T15:09:46,Labastida,expenses,electricity,-184.61,-57921.43
buyer_8,Antonio,Miranda,1979-04-04,90579541K,antonio.miranda@smartweb.digital,551483,ES06209535008739372467,1493.81,2024-05-07T20:52:03,Labastida,expenses,gifts,-564.68,-58486.11
buyer_8,Antonio,Miranda,1979-04-04,90579541K,antonio.miranda@smartweb.digital,551483,ES06209535008739372467,1493.81,2024-05-08T22:42:26,Labastida,expenses,phone,-69.76,-58555.87
buyer_8,Antonio,Miranda,1979-04-04,90579541K,antonio.miranda@smartweb.digital,551483,ES06209535008739372467,1493.81,2024-05-08T02:22:53,Labastida,expenses,leisure,-60.85,-58616.72
buyer_8,Antonio,Miranda,1979-04-04,90579541K,antonio.miranda@smartweb.digital,551483,ES06209535008739372467,1493.81,2024-05-08T18:47:06,Labastida,expenses,cash,-100.0,-58716.72
buyer_8,Antonio,Miranda,1979-04-04,90579541K,antonio.miranda@smartweb.digital,551483,ES06209535008739372467,1493.81,2024-05-10T17:40:59,Labastida,expenses,healthcare,-65.08,-58781.8
buyer_8,Antonio,Miranda,1979-04-04,90579541K,antonio.miranda@smartweb.digital,551483,ES06209535008739372467,1493.81,2024-05-11T21:09:51,Labastida,expenses,cash,-100.0,-58881.8
buyer_8,Antonio,Miranda,1979-04-04,90579541K,antonio.miranda@smartweb.digital,551483,ES06209535008739372467,1493.81,2024-05-11T12:20:57,Labastida,expenses,travel,-1228.63,-60110.43
buyer_8,Antonio,Miranda,1979-04-04,90579541K,antonio.miranda@smartweb.digital,551483,ES06209535008739372467,1493.81,2024-05-13T14:27:07,Labastida,expenses,food,-102.53,-60212.96
buyer_8,Antonio,Miranda,1979-04-04,90579541K,antonio.miranda@smartweb.digital,551483,ES06209535008739372467,1493.81,2024-05-13T13:44:29,Labastida,expenses,education,-68.21,-60281.17
buyer_8,Antonio,Miranda,1979-04-04,90579541K,antonio.miranda@smartweb.digital,551483,ES06209535008739372467,1493.81,2024-05-13T18:38:01,Labastida,expenses,appliances,-396.18,-60677.35
buyer_8,Antonio,Miranda,1979-04-04,90579541K,antonio.miranda@smartweb.digital,551483,ES06209535008739372467,1493.81,2024-05-13T20:28:27,Labastida,expenses,gifts,-420.65,-61098.0
buyer_8,Antonio,Miranda,1979-04-04,90579541K,antonio.miranda@smartweb.digital,551483,ES06209535008739372467,1493.81,2024-05-14T20:23:53,Labastida,expenses,leisure,-51.4,-61149.4
buyer_8,Antonio,Miranda,1979-04-04,90579541K,antonio.miranda@smartweb.digital,551483,ES06209535008739372467,1493.81,2024-05-14T17:16:43,Labastida,expenses,cash,-100.0,-61249.4
buyer_8,Antonio,Miranda,1979-04-04,90579541K,antonio.miranda@smartweb.digital,551483,ES06209535008739372467,1493.81,2024-05-15T13:47:28,Labastida,expenses,clothing,-84.21,-61333.61
buyer_8,Antonio,Miranda,1979-04-04,90579541K,antonio.miranda@smartweb.digital,551483,ES06209535008739372467,1493.81,2024-05-16T17:52:26,Labastida,expenses,cash,-100.0,-61433.61
buyer_8,Antonio,Miranda,1979-04-04,90579541K,antonio.miranda@smartweb.digital,551483,ES06209535008739372467,1493.81,2024-05-17T17:02:30,Labastida,expenses,education,-54.14,-61487.75
buyer_8,Antonio,Miranda,1979-04-04,90579541K,antonio.miranda@smartweb.digital,551483,ES06209535008739372467,1493.81,2024-05-18T12:47:39,Labastida,expenses,food,-87.04,-61574.79
buyer_8,Antonio,Miranda,1979-04-04,90579541K,antonio.miranda@smartweb.digital,551483,ES06209535008739372467,1493.81,2024-05-19T09:40:33,Labastida,expenses,leisure,-84.87,-61659.66
buyer_8,Antonio,Miranda,1979-04-04,90579541K,antonio.miranda@smartweb.digital,551483,ES06209535008739372467,1493.81,2024-05-19T11:49:14,Labastida,expenses,repairs,-279.84,-61939.5
buyer_8,Antonio,Miranda,1979-04-04,90579541K,antonio.miranda@smartweb.digital,551483,ES06209535008739372467,1493.81,2024-05-19T17:36:21,Labastida,expenses,gifts,-795.73,-62735.23
buyer_8,Antonio,Miranda,1979-04-04,90579541K,antonio.miranda@smartweb.digital,551483,ES06209535008739372467,1493.81,2024-05-20T04:26:36,Labastida,expenses,gifts,-222.5,-62957.73
buyer_8,Antonio,Miranda,1979-04-04,90579541K,antonio.miranda@smartweb.digital,551483,ES06209535008739372467,1493.81,2024-05-21T13:13:02,Labastida,expenses,leisure,-76.61,-63034.34
buyer_8,Antonio,Miranda,1979-04-04,90579541K,antonio.miranda@smartweb.digital,551483,ES06209535008739372467,1493.81,2024-05-22T19:22:57,Labastida,expenses,transport,-69.31,-63103.65
buyer_8,Antonio,Miranda,1979-04-04,90579541K,antonio.miranda@smartweb.digital,551483,ES06209535008739372467,1493.81,2024-05-23T23:54:07,Labastida,expenses,leisure,-79.64,-63183.29
buyer_8,Antonio,Miranda,1979-04-04,90579541K,antonio.miranda@smartweb.digital,551483,ES06209535008739372467,1493.81,2024-05-24T11:41:31,Labastida,expenses,transport,-77.94,-63261.23
buyer_8,Antonio,Miranda,1979-04-04,90579541K,antonio.miranda@smartweb.digital,551483,ES06209535008739372467,1493.81,2024-05-25T16:00:42,Labastida,expenses,food,-122.13,-63383.36
buyer_8,Antonio,Miranda,1979-04-04,90579541K,antonio.miranda@smartweb.digital,551483,ES06209535008739372467,1493.81,2024-05-25T20:02:45,Labastida,expenses,education,-73.52,-63456.88
buyer_8,Antonio,Miranda,1979-04-04,90579541K,antonio.miranda@smartweb.digital,551483,ES06209535008739372467,1493.81,2024-05-26T08:42:59,Labastida,expenses,food,-116.43,-63573.31
buyer_8,Antonio,Miranda,1979-04-04,90579541K,antonio.miranda@smartweb.digital,551483,ES06209535008739372467,1493.81,2024-05-26T16:13:34,Labastida,expenses,leisure,-42.59,-63615.9
buyer_8,Antonio,Miranda,1979-04-04,90579541K,antonio.miranda@smartweb.digital,551483,ES06209535008739372467,1493.81,2024-05-26T14:08:20,Labastida,expenses,cash,-100.0,-63715.9
buyer_8,Antonio,Miranda,1979-04-04,90579541K,antonio.miranda@smartweb.digital,551483,ES06209535008739372467,1493.81,2024-05-27T08:59:52,Labastida,expenses,education,-48.83,-63764.73
buyer_8,Antonio,Miranda,1979-04-04,90579541K,antonio.miranda@smartweb.digital,551483,ES06209535008739372467,1493.81,2024-06-01T20:19:58,Labastida,incomes,salary,4159.64,-59605.09
buyer_8,Antonio,Miranda,1979-04-04,90579541K,antonio.miranda@smartweb.digital,551483,ES06209535008739372467,1493.81,2024-06-01T20:19:58,Labastida,incomes,salary_bonus,3070.66,-56534.43
buyer_8,Antonio,Miranda,1979-04-04,90579541K,antonio.miranda@smartweb.digital,551483,ES06209535008739372467,1493.81,2024-06-01T14:24:49,Labastida,expenses,taxes,-2756.9,-59291.33
buyer_8,Antonio,Miranda,1979-04-04,90579541K,antonio.miranda@smartweb.digital,551483,ES06209535008739372467,1493.81,2024-06-01T19:40:47,Labastida,expenses,insurance,-1161.86,-60453.19
buyer_8,Antonio,Miranda,1979-04-04,90579541K,antonio.miranda@smartweb.digital,551483,ES06209535008739372467,1493.81,2024-06-02T15:45:30,Labastida,expenses,education,-46.71,-60499.9
buyer_8,Antonio,Miranda,1979-04-04,90579541K,antonio.miranda@smartweb.digital,551483,ES06209535008739372467,1493.81,2024-06-04T01:50:24,Labastida,expenses,mortgage,-1724.68,-62224.58
buyer_8,Antonio,Miranda,1979-04-04,90579541K,antonio.miranda@smartweb.digital,551483,ES06209535008739372467,1493.81,2024-06-05T19:05:44,Labastida,expenses,water,-57.36,-62281.94
buyer_8,Antonio,Miranda,1979-04-04,90579541K,antonio.miranda@smartweb.digital,551483,ES06209535008739372467,1493.81,2024-06-05T18:42:25,Labastida,expenses,food,-112.52,-62394.46
buyer_8,Antonio,Miranda,1979-04-04,90579541K,antonio.miranda@smartweb.digital,551483,ES06209535008739372467,1493.81,2024-06-05T16:18:15,Labastida,expenses,leisure,-76.02,-62470.48
buyer_8,Antonio,Miranda,1979-04-04,90579541K,antonio.miranda@smartweb.digital,551483,ES06209535008739372467,1493.81,2024-06-07T09:08:39,Labastida,expenses,water,-89.09,-62559.57
buyer_8,Antonio,Miranda,1979-04-04,90579541K,antonio.miranda@smartweb.digital,551483,ES06209535008739372467,1493.81,2024-06-07T08:32:52,Labastida,expenses,electricity,-110.27,-62669.84
buyer_8,Antonio,Miranda,1979-04-04,90579541K,antonio.miranda@smartweb.digital,551483,ES06209535008739372467,1493.81,2024-06-08T19:31:12,Labastida,expenses,internet,-96.09,-62765.93
buyer_8,Antonio,Miranda,1979-04-04,90579541K,antonio.miranda@smartweb.digital,551483,ES06209535008739372467,1493.81,2024-06-08T18:36:32,Labastida,expenses,phone,-98.83,-62864.76
buyer_8,Antonio,Miranda,1979-04-04,90579541K,antonio.miranda@smartweb.digital,551483,ES06209535008739372467,1493.81,2024-06-08T13:02:43,Labastida,expenses,cash,-100.0,-62964.76
buyer_8,Antonio,Miranda,1979-04-04,90579541K,antonio.miranda@smartweb.digital,551483,ES06209535008739372467,1493.81,2024-06-09T14:03:55,Labastida,expenses,clothing,-98.71,-63063.47
buyer_8,Antonio,Miranda,1979-04-04,90579541K,antonio.miranda@smartweb.digital,551483,ES06209535008739372467,1493.81,2024-06-10T09:44:42,Labastida,expenses,clothing,-128.37,-63191.84
buyer_8,Antonio,Miranda,1979-04-04,90579541K,antonio.miranda@smartweb.digital,551483,ES06209535008739372467,1493.81,2024-06-11T08:21:01,Labastida,expenses,gifts,-103.56,-63295.4
buyer_8,Antonio,Miranda,1979-04-04,90579541K,antonio.miranda@smartweb.digital,551483,ES06209535008739372467,1493.81,2024-06-12T13:39:07,Labastida,expenses,cash,-100.0,-63395.4
buyer_8,Antonio,Miranda,1979-04-04,90579541K,antonio.miranda@smartweb.digital,551483,ES06209535008739372467,1493.81,2024-06-14T21:06:29,Labastida,expenses,transport,-81.94,-63477.34
buyer_8,Antonio,Miranda,1979-04-04,90579541K,antonio.miranda@smartweb.digital,551483,ES06209535008739372467,1493.81,2024-06-14T17:58:18,Labastida,expenses,cash,-100.0,-63577.34
buyer_8,Antonio,Miranda,1979-04-04,90579541K,antonio.miranda@smartweb.digital,551483,ES06209535008739372467,1493.81,2024-06-15T13:09:43,Labastida,expenses,food,-106.62,-63683.96
buyer_8,Antonio,Miranda,1979-04-04,90579541K,antonio.miranda@smartweb.digital,551483,ES06209535008739372467,1493.81,2024-06-15T22:59:22,Labastida,expenses,leisure,-47.28,-63731.24
buyer_8,Antonio,Miranda,1979-04-04,90579541K,antonio.miranda@smartweb.digital,551483,ES06209535008739372467,1493.81,2024-06-17T21:13:39,Labastida,expenses,leisure,-62.51,-63793.75
buyer_8,Antonio,Miranda,1979-04-04,90579541K,antonio.miranda@smartweb.digital,551483,ES06209535008739372467,1493.81,2024-06-17T11:45:48,Labastida,expenses,appliances,-307.61,-64101.36
buyer_8,Antonio,Miranda,1979-04-04,90579541K,antonio.miranda@smartweb.digital,551483,ES06209535008739372467,1493.81,2024-06-19T01:23:43,Labastida,expenses,transport,-84.61,-64185.97
buyer_8,Antonio,Miranda,1979-04-04,90579541K,antonio.miranda@smartweb.digital,551483,ES06209535008739372467,1493.81,2024-06-20T19:15:36,Labastida,expenses,food,-112.28,-64298.25
buyer_8,Antonio,Miranda,1979-04-04,90579541K,antonio.miranda@smartweb.digital,551483,ES06209535008739372467,1493.81,2024-06-20T14:02:48,Labastida,expenses,cash,-100.0,-64398.25
buyer_8,Antonio,Miranda,1979-04-04,90579541K,antonio.miranda@smartweb.digital,551483,ES06209535008739372467,1493.81,2024-06-20T01:31:12,Labastida,expenses,gifts,-841.37,-65239.62
buyer_8,Antonio,Miranda,1979-04-04,90579541K,antonio.miranda@smartweb.digital,551483,ES06209535008739372467,1493.81,2024-06-21T09:44:48,Labastida,expenses,repairs,-139.77,-65379.39
buyer_8,Antonio,Miranda,1979-04-04,90579541K,antonio.miranda@smartweb.digital,551483,ES06209535008739372467,1493.81,2024-06-22T18:27:13,Labastida,expenses,food,-72.72,-65452.11
buyer_8,Antonio,Miranda,1979-04-04,90579541K,antonio.miranda@smartweb.digital,551483,ES06209535008739372467,1493.81,2024-06-22T18:46:12,Labastida,expenses,repairs,-62.78,-65514.89
buyer_8,Antonio,Miranda,1979-04-04,90579541K,antonio.miranda@smartweb.digital,551483,ES06209535008739372467,1493.81,2024-06-23T12:28:15,Labastida,expenses,leisure,-19.4,-65534.29
buyer_8,Antonio,Miranda,1979-04-04,90579541K,antonio.miranda@smartweb.digital,551483,ES06209535008739372467,1493.81,2024-06-24T13:40:08,Labastida,expenses,clothing,-76.09,-65610.38
buyer_8,Antonio,Miranda,1979-04-04,90579541K,antonio.miranda@smartweb.digital,551483,ES06209535008739372467,1493.81,2024-06-26T11:57:44,Labastida,expenses,food,-72.93,-65683.31
buyer_8,Antonio,Miranda,1979-04-04,90579541K,antonio.miranda@smartweb.digital,551483,ES06209535008739372467,1493.81,2024-06-27T09:59:52,Labastida,expenses,repairs,-42.4,-65725.71
buyer_8,Antonio,Miranda,1979-04-04,90579541K,antonio.miranda@smartweb.digital,551483,ES06209535008739372467,1493.81,2024-07-01T15:03:28,Labastida,incomes,salary,4159.64,-61566.07
buyer_8,Antonio,Miranda,1979-04-04,90579541K,antonio.miranda@smartweb.digital,551483,ES06209535008739372467,1493.81,2024-07-01T09:28:32,Labastida,expenses,cash,-100.0,-61666.07
buyer_8,Antonio,Miranda,1979-04-04,90579541K,antonio.miranda@smartweb.digital,551483,ES06209535008739372467,1493.81,2024-07-02T19:49:01,Labastida,expenses,cash,-100.0,-61766.07
buyer_8,Antonio,Miranda,1979-04-04,90579541K,antonio.miranda@smartweb.digital,551483,ES06209535008739372467,1493.81,2024-07-03T16:49:23,Labastida,expenses,repairs,-27.88,-61793.95
buyer_8,Antonio,Miranda,1979-04-04,90579541K,antonio.miranda@smartweb.digital,551483,ES06209535008739372467,1493.81,2024-07-04T11:44:15,Labastida,expenses,mortgage,-1724.68,-63518.63
buyer_8,Antonio,Miranda,1979-04-04,90579541K,antonio.miranda@smartweb.digital,551483,ES06209535008739372467,1493.81,2024-07-04T08:40:55,Labastida,expenses,food,-70.43,-63589.06
buyer_8,Antonio,Miranda,1979-04-04,90579541K,antonio.miranda@smartweb.digital,551483,ES06209535008739372467,1493.81,2024-07-05T08:26:32,Labastida,expenses,phone,-70.9,-63659.96
buyer_8,Antonio,Miranda,1979-04-04,90579541K,antonio.miranda@smartweb.digital,551483,ES06209535008739372467,1493.81,2024-07-06T10:46:59,Labastida,expenses,gas,-131.63,-63791.59
buyer_8,Antonio,Miranda,1979-04-04,90579541K,antonio.miranda@smartweb.digital,551483,ES06209535008739372467,1493.81,2024-07-06T03:56:49,Labastida,expenses,leisure,-26.3,-63817.89
buyer_8,Antonio,Miranda,1979-04-04,90579541K,antonio.miranda@smartweb.digital,551483,ES06209535008739372467,1493.81,2024-07-06T15:33:52,Labastida,expenses,cash,-100.0,-63917.89
buyer_8,Antonio,Miranda,1979-04-04,90579541K,antonio.miranda@smartweb.digital,551483,ES06209535008739372467,1493.81,2024-07-06T12:46:08,Labastida,expenses,repairs,-241.58,-64159.47
buyer_8,Antonio,Miranda,1979-04-04,90579541K,antonio.miranda@smartweb.digital,551483,ES06209535008739372467,1493.81,2024-07-08T19:02:25,Labastida,expenses,internet,-96.09,-64255.56
buyer_8,Antonio,Miranda,1979-04-04,90579541K,antonio.miranda@smartweb.digital,551483,ES06209535008739372467,1493.81,2024-07-08T18:54:25,Labastida,expenses,cash,-100.0,-64355.56
buyer_8,Antonio,Miranda,1979-04-04,90579541K,antonio.miranda@smartweb.digital,551483,ES06209535008739372467,1493.81,2024-07-09T13:56:33,Labastida,expenses,transport,-51.2,-64406.76
buyer_8,Antonio,Miranda,1979-04-04,90579541K,antonio.miranda@smartweb.digital,551483,ES06209535008739372467,1493.81,2024-07-10T17:56:26,Labastida,expenses,clothing,-143.49,-64550.25
buyer_8,Antonio,Miranda,1979-04-04,90579541K,antonio.miranda@smartweb.digital,551483,ES06209535008739372467,1493.81,2024-07-10T15:15:34,Labastida,expenses,cash,-100.0,-64650.25
buyer_8,Antonio,Miranda,1979-04-04,90579541K,antonio.miranda@smartweb.digital,551483,ES06209535008739372467,1493.81,2024-07-13T20:32:59,Labastida,expenses,food,-63.48,-64713.73
buyer_8,Antonio,Miranda,1979-04-04,90579541K,antonio.miranda@smartweb.digital,551483,ES06209535008739372467,1493.81,2024-07-13T22:52:17,Labastida,expenses,healthcare,-160.96,-64874.69
buyer_8,Antonio,Miranda,1979-04-04,90579541K,antonio.miranda@smartweb.digital,551483,ES06209535008739372467,1493.81,2024-07-13T05:59:00,Labastida,expenses,cash,-100.0,-64974.69
buyer_8,Antonio,Miranda,1979-04-04,90579541K,antonio.miranda@smartweb.digital,551483,ES06209535008739372467,1493.81,2024-07-13T08:18:10,Labastida,expenses,repairs,-217.98,-65192.67
buyer_8,Antonio,Miranda,1979-04-04,90579541K,antonio.miranda@smartweb.digital,551483,ES06209535008739372467,1493.81,2024-07-14T09:36:18,Labastida,expenses,transport,-68.4,-65261.07
buyer_8,Antonio,Miranda,1979-04-04,90579541K,antonio.miranda@smartweb.digital,551483,ES06209535008739372467,1493.81,2024-07-16T10:03:11,Labastida,expenses,leisure,-75.19,-65336.26
buyer_8,Antonio,Miranda,1979-04-04,90579541K,antonio.miranda@smartweb.digital,551483,ES06209535008739372467,1493.81,2024-07-16T08:21:38,Labastida,expenses,cash,-100.0,-65436.26
buyer_8,Antonio,Miranda,1979-04-04,90579541K,antonio.miranda@smartweb.digital,551483,ES06209535008739372467,1493.81,2024-07-17T20:16:59,Labastida,expenses,transport,-55.48,-65491.74
buyer_8,Antonio,Miranda,1979-04-04,90579541K,antonio.miranda@smartweb.digital,551483,ES06209535008739372467,1493.81,2024-07-17T08:05:52,Labastida,expenses,gifts,-337.41,-65829.15
buyer_8,Antonio,Miranda,1979-04-04,90579541K,antonio.miranda@smartweb.digital,551483,ES06209535008739372467,1493.81,2024-07-18T02:45:38,Labastida,expenses,clothing,-148.37,-65977.52
buyer_8,Antonio,Miranda,1979-04-04,90579541K,antonio.miranda@smartweb.digital,551483,ES06209535008739372467,1493.81,2024-07-18T17:44:35,Labastida,expenses,cash,-100.0,-66077.52
buyer_8,Antonio,Miranda,1979-04-04,90579541K,antonio.miranda@smartweb.digital,551483,ES06209535008739372467,1493.81,2024-07-19T13:19:34,Labastida,expenses,transport,-44.68,-66122.2
buyer_8,Antonio,Miranda,1979-04-04,90579541K,antonio.miranda@smartweb.digital,551483,ES06209535008739372467,1493.81,2024-07-21T07:58:50,Labastida,expenses,food,-75.35,-66197.55
buyer_8,Antonio,Miranda,1979-04-04,90579541K,antonio.miranda@smartweb.digital,551483,ES06209535008739372467,1493.81,2024-07-22T10:36:23,Labastida,expenses,leisure,-27.8,-66225.35
buyer_8,Antonio,Miranda,1979-04-04,90579541K,antonio.miranda@smartweb.digital,551483,ES06209535008739372467,1493.81,2024-07-25T21:01:24,Labastida,expenses,transport,-63.58,-66288.93
buyer_8,Antonio,Miranda,1979-04-04,90579541K,antonio.miranda@smartweb.digital,551483,ES06209535008739372467,1493.81,2024-07-27T15:50:54,Labastida,expenses,leisure,-38.39,-66327.32
buyer_8,Antonio,Miranda,1979-04-04,90579541K,antonio.miranda@smartweb.digital,551483,ES06209535008739372467,1493.81,2024-07-28T11:17:48,Labastida,expenses,cash,-100.0,-66427.32
buyer_8,Antonio,Miranda,1979-04-04,90579541K,antonio.miranda@smartweb.digital,551483,ES06209535008739372467,1493.81,2024-07-29T14:50:51,Labastida,expenses,food,-117.77,-66545.09
buyer_8,Antonio,Miranda,1979-04-04,90579541K,antonio.miranda@smartweb.digital,551483,ES06209535008739372467,1493.81,2024-07-30T12:59:45,Labastida,expenses,cash,-100.0,-66645.09
buyer_8,Antonio,Miranda,1979-04-04,90579541K,antonio.miranda@smartweb.digital,551483,ES06209535008739372467,1493.81,2024-08-01T12:46:25,Labastida,incomes,salary,4159.64,-62485.45
buyer_8,Antonio,Miranda,1979-04-04,90579541K,antonio.miranda@smartweb.digital,551483,ES06209535008739372467,1493.81,2024-08-01T12:46:25,Labastida,incomes,extra_income,531.65,-61953.8
buyer_8,Antonio,Miranda,1979-04-04,90579541K,antonio.miranda@smartweb.digital,551483,ES06209535008739372467,1493.81,2024-08-03T11:12:58,Labastida,expenses,food,-119.63,-62073.43
buyer_8,Antonio,Miranda,1979-04-04,90579541K,antonio.miranda@smartweb.digital,551483,ES06209535008739372467,1493.81,2024-08-03T11:27:02,Labastida,expenses,repairs,-95.95,-62169.38
buyer_8,Antonio,Miranda,1979-04-04,90579541K,antonio.miranda@smartweb.digital,551483,ES06209535008739372467,1493.81,2024-08-04T16:50:40,Labastida,expenses,mortgage,-1724.68,-63894.06
buyer_8,Antonio,Miranda,1979-04-04,90579541K,antonio.miranda@smartweb.digital,551483,ES06209535008739372467,1493.81,2024-08-04T04:50:52,Labastida,expenses,cash,-100.0,-63994.06
buyer_8,Antonio,Miranda,1979-04-04,90579541K,antonio.miranda@smartweb.digital,551483,ES06209535008739372467,1493.81,2024-08-05T03:53:55,Labastida,expenses,water,-63.29,-64057.35
buyer_8,Antonio,Miranda,1979-04-04,90579541K,antonio.miranda@smartweb.digital,551483,ES06209535008739372467,1493.81,2024-08-05T15:47:11,Labastida,expenses,electricity,-76.97,-64134.32
buyer_8,Antonio,Miranda,1979-04-04,90579541K,antonio.miranda@smartweb.digital,551483,ES06209535008739372467,1493.81,2024-08-06T12:41:44,Labastida,expenses,gas,-163.81,-64298.13
buyer_8,Antonio,Miranda,1979-04-04,90579541K,antonio.miranda@smartweb.digital,551483,ES06209535008739372467,1493.81,2024-08-07T13:33:13,Labastida,expenses,gas,-139.48,-64437.61
buyer_8,Antonio,Miranda,1979-04-04,90579541K,antonio.miranda@smartweb.digital,551483,ES06209535008739372467,1493.81,2024-08-07T03:32:58,Labastida,expenses,phone,-97.25,-64534.86
buyer_8,Antonio,Miranda,1979-04-04,90579541K,antonio.miranda@smartweb.digital,551483,ES06209535008739372467,1493.81,2024-08-07T21:29:38,Labastida,expenses,food,-77.1,-64611.96
buyer_8,Antonio,Miranda,1979-04-04,90579541K,antonio.miranda@smartweb.digital,551483,ES06209535008739372467,1493.81,2024-08-08T21:41:42,Labastida,expenses,water,-85.99,-64697.95
buyer_8,Antonio,Miranda,1979-04-04,90579541K,antonio.miranda@smartweb.digital,551483,ES06209535008739372467,1493.81,2024-08-08T06:55:57,Labastida,expenses,internet,-96.09,-64794.04
buyer_8,Antonio,Miranda,1979-04-04,90579541K,antonio.miranda@smartweb.digital,551483,ES06209535008739372467,1493.81,2024-08-11T17:31:58,Labastida,expenses,transport,-53.86,-64847.9
buyer_8,Antonio,Miranda,1979-04-04,90579541K,antonio.miranda@smartweb.digital,551483,ES06209535008739372467,1493.81,2024-08-11T16:26:36,Labastida,expenses,education,-67.42,-64915.32
buyer_8,Antonio,Miranda,1979-04-04,90579541K,antonio.miranda@smartweb.digital,551483,ES06209535008739372467,1493.81,2024-08-14T13:29:53,Labastida,expenses,leisure,-33.68,-64949.0
buyer_8,Antonio,Miranda,1979-04-04,90579541K,antonio.miranda@smartweb.digital,551483,ES06209535008739372467,1493.81,2024-08-14T10:40:38,Labastida,expenses,cash,-100.0,-65049.0
buyer_8,Antonio,Miranda,1979-04-04,90579541K,antonio.miranda@smartweb.digital,551483,ES06209535008739372467,1493.81,2024-08-15T17:52:46,Labastida,expenses,transport,-74.42,-65123.42
buyer_8,Antonio,Miranda,1979-04-04,90579541K,antonio.miranda@smartweb.digital,551483,ES06209535008739372467,1493.81,2024-08-15T00:28:01,Labastida,expenses,cash,-100.0,-65223.42
buyer_8,Antonio,Miranda,1979-04-04,90579541K,antonio.miranda@smartweb.digital,551483,ES06209535008739372467,1493.81,2024-08-16T04:21:43,Labastida,expenses,clothing,-47.14,-65270.56
buyer_8,Antonio,Miranda,1979-04-04,90579541K,antonio.miranda@smartweb.digital,551483,ES06209535008739372467,1493.81,2024-08-16T13:06:13,Labastida,expenses,cash,-100.0,-65370.56
buyer_8,Antonio,Miranda,1979-04-04,90579541K,antonio.miranda@smartweb.digital,551483,ES06209535008739372467,1493.81,2024-08-17T05:48:00,Labastida,expenses,healthcare,-163.08,-65533.64
buyer_8,Antonio,Miranda,1979-04-04,90579541K,antonio.miranda@smartweb.digital,551483,ES06209535008739372467,1493.81,2024-08-18T15:11:53,Labastida,expenses,repairs,-250.23,-65783.87
buyer_8,Antonio,Miranda,1979-04-04,90579541K,antonio.miranda@smartweb.digital,551483,ES06209535008739372467,1493.81,2024-08-19T11:24:48,Labastida,expenses,transport,-83.64,-65867.51
buyer_8,Antonio,Miranda,1979-04-04,90579541K,antonio.miranda@smartweb.digital,551483,ES06209535008739372467,1493.81,2024-08-19T17:21:59,Labastida,expenses,cash,-100.0,-65967.51
buyer_8,Antonio,Miranda,1979-04-04,90579541K,antonio.miranda@smartweb.digital,551483,ES06209535008739372467,1493.81,2024-08-20T17:25:10,Labastida,expenses,food,-111.49,-66079.0
buyer_8,Antonio,Miranda,1979-04-04,90579541K,antonio.miranda@smartweb.digital,551483,ES06209535008739372467,1493.81,2024-08-20T08:18:13,Labastida,expenses,cash,-100.0,-66179.0
buyer_8,Antonio,Miranda,1979-04-04,90579541K,antonio.miranda@smartweb.digital,551483,ES06209535008739372467,1493.81,2024-08-21T16:29:17,Labastida,expenses,cash,-100.0,-66279.0
buyer_8,Antonio,Miranda,1979-04-04,90579541K,antonio.miranda@smartweb.digital,551483,ES06209535008739372467,1493.81,2024-08-22T08:12:30,Labastida,expenses,transport,-49.27,-66328.27
buyer_8,Antonio,Miranda,1979-04-04,90579541K,antonio.miranda@smartweb.digital,551483,ES06209535008739372467,1493.81,2024-08-22T23:49:38,Labastida,expenses,repairs,-289.39,-66617.66
buyer_8,Antonio,Miranda,1979-04-04,90579541K,antonio.miranda@smartweb.digital,551483,ES06209535008739372467,1493.81,2024-08-23T02:30:37,Labastida,expenses,leisure,-54.5,-66672.16
buyer_8,Antonio,Miranda,1979-04-04,90579541K,antonio.miranda@smartweb.digital,551483,ES06209535008739372467,1493.81,2024-08-25T08:18:48,Labastida,expenses,food,-79.98,-66752.14
buyer_8,Antonio,Miranda,1979-04-04,90579541K,antonio.miranda@smartweb.digital,551483,ES06209535008739372467,1493.81,2024-08-25T10:27:18,Labastida,expenses,leisure,-83.28,-66835.42
buyer_8,Antonio,Miranda,1979-04-04,90579541K,antonio.miranda@smartweb.digital,551483,ES06209535008739372467,1493.81,2024-08-25T16:06:05,Labastida,expenses,cash,-100.0,-66935.42
buyer_8,Antonio,Miranda,1979-04-04,90579541K,antonio.miranda@smartweb.digital,551483,ES06209535008739372467,1493.81,2024-08-26T20:44:53,Labastida,expenses,clothing,-133.46,-67068.88
buyer_8,Antonio,Miranda,1979-04-04,90579541K,antonio.miranda@smartweb.digital,551483,ES06209535008739372467,1493.81,2024-08-26T18:31:06,Labastida,expenses,cash,-100.0,-67168.88
buyer_8,Antonio,Miranda,1979-04-04,90579541K,antonio.miranda@smartweb.digital,551483,ES06209535008739372467,1493.81,2024-08-27T19:49:21,Labastida,expenses,repairs,-265.55,-67434.43
buyer_8,Antonio,Miranda,1979-04-04,90579541K,antonio.miranda@smartweb.digital,551483,ES06209535008739372467,1493.81,2024-08-29T12:28:09,Labastida,expenses,food,-86.03,-67520.46
buyer_8,Antonio,Miranda,1979-04-04,90579541K,antonio.miranda@smartweb.digital,551483,ES06209535008739372467,1493.81,2024-09-01T10:12:50,Labastida,incomes,salary,4159.64,-63360.82
buyer_8,Antonio,Miranda,1979-04-04,90579541K,antonio.miranda@smartweb.digital,551483,ES06209535008739372467,1493.81,2024-09-02T11:01:39,Labastida,expenses,food,-67.4,-63428.22
buyer_8,Antonio,Miranda,1979-04-04,90579541K,antonio.miranda@smartweb.digital,551483,ES06209535008739372467,1493.81,2024-09-02T20:28:42,Labastida,expenses,cash,-100.0,-63528.22
buyer_8,Antonio,Miranda,1979-04-04,90579541K,antonio.miranda@smartweb.digital,551483,ES06209535008739372467,1493.81,2024-09-04T10:17:40,Labastida,expenses,mortgage,-1724.68,-65252.9
buyer_8,Antonio,Miranda,1979-04-04,90579541K,antonio.miranda@smartweb.digital,551483,ES06209535008739372467,1493.81,2024-09-04T16:58:51,Labastida,expenses,food,-64.74,-65317.64
buyer_8,Antonio,Miranda,1979-04-04,90579541K,antonio.miranda@smartweb.digital,551483,ES06209535008739372467,1493.81,2024-09-04T09:07:14,Labastida,expenses,healthcare,-81.86,-65399.5
buyer_8,Antonio,Miranda,1979-04-04,90579541K,antonio.miranda@smartweb.digital,551483,ES06209535008739372467,1493.81,2024-09-04T19:09:35,Labastida,expenses,appliances,-228.1,-65627.6
buyer_8,Antonio,Miranda,1979-04-04,90579541K,antonio.miranda@smartweb.digital,551483,ES06209535008739372467,1493.81,2024-09-06T09:56:27,Labastida,expenses,water,-74.76,-65702.36
buyer_8,Antonio,Miranda,1979-04-04,90579541K,antonio.miranda@smartweb.digital,551483,ES06209535008739372467,1493.81,2024-09-06T13:31:22,Labastida,expenses,phone,-77.42,-65779.78
buyer_8,Antonio,Miranda,1979-04-04,90579541K,antonio.miranda@smartweb.digital,551483,ES06209535008739372467,1493.81,2024-09-07T19:07:12,Labastida,expenses,food,-98.59,-65878.37
buyer_8,Antonio,Miranda,1979-04-04,90579541K,antonio.miranda@smartweb.digital,551483,ES06209535008739372467,1493.81,2024-09-08T06:23:17,Labastida,expenses,transport,-76.2,-65954.57
buyer_8,Antonio,Miranda,1979-04-04,90579541K,antonio.miranda@smartweb.digital,551483,ES06209535008739372467,1493.81,2024-09-10T12:51:17,Labastida,expenses,leisure,-70.13,-66024.7
buyer_8,Antonio,Miranda,1979-04-04,90579541K,antonio.miranda@smartweb.digital,551483,ES06209535008739372467,1493.81,2024-09-11T14:44:34,Labastida,expenses,cash,-100.0,-66124.7
buyer_8,Antonio,Miranda,1979-04-04,90579541K,antonio.miranda@smartweb.digital,551483,ES06209535008739372467,1493.81,2024-09-13T14:52:21,Labastida,expenses,cash,-100.0,-66224.7
buyer_8,Antonio,Miranda,1979-04-04,90579541K,antonio.miranda@smartweb.digital,551483,ES06209535008739372467,1493.81,2024-09-14T15:22:18,Labastida,expenses,leisure,-34.66,-66259.36
buyer_8,Antonio,Miranda,1979-04-04,90579541K,antonio.miranda@smartweb.digital,551483,ES06209535008739372467,1493.81,2024-09-16T10:48:45,Labastida,expenses,transport,-74.76,-66334.12
buyer_8,Antonio,Miranda,1979-04-04,90579541K,antonio.miranda@smartweb.digital,551483,ES06209535008739372467,1493.81,2024-09-16T14:26:17,Labastida,expenses,cash,-100.0,-66434.12
buyer_8,Antonio,Miranda,1979-04-04,90579541K,antonio.miranda@smartweb.digital,551483,ES06209535008739372467,1493.81,2024-09-17T15:46:35,Labastida,expenses,cash,-100.0,-66534.12
buyer_8,Antonio,Miranda,1979-04-04,90579541K,antonio.miranda@smartweb.digital,551483,ES06209535008739372467,1493.81,2024-09-17T12:34:30,Labastida,expenses,gifts,-192.0,-66726.12
buyer_8,Antonio,Miranda,1979-04-04,90579541K,antonio.miranda@smartweb.digital,551483,ES06209535008739372467,1493.81,2024-09-18T16:05:46,Labastida,expenses,leisure,-18.67,-66744.79
buyer_8,Antonio,Miranda,1979-04-04,90579541K,antonio.miranda@smartweb.digital,551483,ES06209535008739372467,1493.81,2024-09-23T13:45:02,Labastida,expenses,food,-85.36,-66830.15
buyer_8,Antonio,Miranda,1979-04-04,90579541K,antonio.miranda@smartweb.digital,551483,ES06209535008739372467,1493.81,2024-09-24T02:46:22,Labastida,expenses,cash,-100.0,-66930.15
buyer_8,Antonio,Miranda,1979-04-04,90579541K,antonio.miranda@smartweb.digital,551483,ES06209535008739372467,1493.81,2024-09-27T15:07:21,Labastida,expenses,leisure,-24.92,-66955.07
buyer_8,Antonio,Miranda,1979-04-04,90579541K,antonio.miranda@smartweb.digital,551483,ES06209535008739372467,1493.81,2024-09-29T19:33:43,Labastida,expenses,food,-64.24,-67019.31
buyer_8,Antonio,Miranda,1979-04-04,90579541K,antonio.miranda@smartweb.digital,551483,ES06209535008739372467,1493.81,2024-09-30T13:58:56,Labastida,expenses,food,-65.06,-67084.37
buyer_8,Antonio,Miranda,1979-04-04,90579541K,antonio.miranda@smartweb.digital,551483,ES06209535008739372467,1493.81,2024-09-30T18:50:38,Labastida,expenses,gifts,-423.98,-67508.35
buyer_8,Antonio,Miranda,1979-04-04,90579541K,antonio.miranda@smartweb.digital,551483,ES06209535008739372467,1493.81,2024-10-01T14:05:00,Labastida,incomes,salary,4159.64,-63348.71
buyer_8,Antonio,Miranda,1979-04-04,90579541K,antonio.miranda@smartweb.digital,551483,ES06209535008739372467,1493.81,2024-10-01T11:04:49,Labastida,expenses,leisure,-40.52,-63389.23
buyer_8,Antonio,Miranda,1979-04-04,90579541K,antonio.miranda@smartweb.digital,551483,ES06209535008739372467,1493.81,2024-10-02T00:34:05,Labastida,expenses,food,-72.41,-63461.64
buyer_8,Antonio,Miranda,1979-04-04,90579541K,antonio.miranda@smartweb.digital,551483,ES06209535008739372467,1493.81,2024-10-03T09:36:45,Labastida,expenses,leisure,-42.76,-63504.4
buyer_8,Antonio,Miranda,1979-04-04,90579541K,antonio.miranda@smartweb.digital,551483,ES06209535008739372467,1493.81,2024-10-04T11:31:40,Labastida,expenses,mortgage,-1724.68,-65229.08
buyer_8,Antonio,Miranda,1979-04-04,90579541K,antonio.miranda@smartweb.digital,551483,ES06209535008739372467,1493.81,2024-10-05T15:24:18,Labastida,expenses,water,-51.78,-65280.86
buyer_8,Antonio,Miranda,1979-04-04,90579541K,antonio.miranda@smartweb.digital,551483,ES06209535008739372467,1493.81,2024-10-06T13:18:35,Labastida,expenses,water,-55.66,-65336.52
buyer_8,Antonio,Miranda,1979-04-04,90579541K,antonio.miranda@smartweb.digital,551483,ES06209535008739372467,1493.81,2024-10-06T15:52:31,Labastida,expenses,electricity,-109.11,-65445.63
buyer_8,Antonio,Miranda,1979-04-04,90579541K,antonio.miranda@smartweb.digital,551483,ES06209535008739372467,1493.81,2024-10-06T20:37:48,Labastida,expenses,transport,-42.25,-65487.88
buyer_8,Antonio,Miranda,1979-04-04,90579541K,antonio.miranda@smartweb.digital,551483,ES06209535008739372467,1493.81,2024-10-06T08:39:21,Labastida,expenses,repairs,-216.05,-65703.93
buyer_8,Antonio,Miranda,1979-04-04,90579541K,antonio.miranda@smartweb.digital,551483,ES06209535008739372467,1493.81,2024-10-06T19:49:40,Labastida,expenses,gifts,-728.25,-66432.18
buyer_8,Antonio,Miranda,1979-04-04,90579541K,antonio.miranda@smartweb.digital,551483,ES06209535008739372467,1493.81,2024-10-07T11:14:51,Labastida,expenses,internet,-96.09,-66528.27
buyer_8,Antonio,Miranda,1979-04-04,90579541K,antonio.miranda@smartweb.digital,551483,ES06209535008739372467,1493.81,2024-10-07T05:47:24,Labastida,expenses,cash,-100.0,-66628.27
buyer_8,Antonio,Miranda,1979-04-04,90579541K,antonio.miranda@smartweb.digital,551483,ES06209535008739372467,1493.81,2024-10-08T09:24:38,Labastida,expenses,water,-91.31,-66719.58
buyer_8,Antonio,Miranda,1979-04-04,90579541K,antonio.miranda@smartweb.digital,551483,ES06209535008739372467,1493.81,2024-10-08T19:54:53,Labastida,expenses,gas,-182.31,-66901.89
buyer_8,Antonio,Miranda,1979-04-04,90579541K,antonio.miranda@smartweb.digital,551483,ES06209535008739372467,1493.81,2024-10-08T21:24:53,Labastida,expenses,phone,-79.49,-66981.38
buyer_8,Antonio,Miranda,1979-04-04,90579541K,antonio.miranda@smartweb.digital,551483,ES06209535008739372467,1493.81,2024-10-09T09:37:29,Labastida,expenses,food,-116.04,-67097.42
buyer_8,Antonio,Miranda,1979-04-04,90579541K,antonio.miranda@smartweb.digital,551483,ES06209535008739372467,1493.81,2024-10-09T22:26:07,Labastida,expenses,repairs,-31.84,-67129.26
buyer_8,Antonio,Miranda,1979-04-04,90579541K,antonio.miranda@smartweb.digital,551483,ES06209535008739372467,1493.81,2024-10-10T09:15:36,Labastida,expenses,leisure,-35.31,-67164.57
buyer_8,Antonio,Miranda,1979-04-04,90579541K,antonio.miranda@smartweb.digital,551483,ES06209535008739372467,1493.81,2024-10-10T16:44:13,Labastida,expenses,cash,-100.0,-67264.57
buyer_8,Antonio,Miranda,1979-04-04,90579541K,antonio.miranda@smartweb.digital,551483,ES06209535008739372467,1493.81,2024-10-10T08:54:16,Labastida,expenses,repairs,-83.07,-67347.64
