profile,name,age,iban,trx_id,timestamp,city,transaction_type,transaction_category,amount_eur,balance
buyer_1,Luis,28,ES87209573564583313774,TRX_N-00001-323528789443,2020-01-01T20:56:26,Bilbao,transfer,Salary,1310.41,1716.54
buyer_1,Luis,28,ES87209573564583313774,TRX_N-00002-827159965329,2020-01-04T15:05:57,Bilbao,Expense,transport,-133.72,1582.82
buyer_1,Luis,28,ES87209573564583313774,TRX_N-00003-962853831000,2020-01-05T11:23:19,Bilbao,Housing,Rent,-935.95,646.87
buyer_1,Luis,28,ES87209573564583313774,TRX_N-00004-457083028796,2020-01-05T20:16:52,Bilbao,Basic services,water,-28.74,618.13
buyer_1,Luis,28,ES87209573564583313774,TRX_N-00005-747792267072,2020-01-06T21:57:03,Bilbao,Basic services,internet,-55.14,562.99
buyer_1,Luis,28,ES87209573564583313774,TRX_N-00006-676569155054,2020-01-06T10:23:59,Bilbao,Basic services,phone,-55.1,507.89
buyer_1,Luis,28,ES87209573564583313774,TRX_N-00007-452048855438,2020-01-14T02:17:37,Bilbao,Expense,healthcare,-181.54,326.35
buyer_1,Luis,28,ES87209573564583313774,TRX_N-00008-730647333782,2020-01-15T16:53:10,Bilbao,Expense,transport,-37.67,288.68
buyer_1,Luis,28,ES87209573564583313774,TRX_N-00009-552232576096,2020-01-26T19:28:59,Bilbao,Expense,education,-754.27,-465.59
buyer_1,Luis,28,ES87209573564583313774,TRX_N-00010-402084951439,2020-02-01T23:25:41,Bilbao,transfer,Salary,1310.41,844.82
buyer_1,Luis,28,ES87209573564583313774,TRX_N-00011-762684145831,2020-02-05T21:06:45,Bilbao,Housing,Rent,-935.95,-91.13
buyer_1,Luis,28,ES87209573564583313774,TRX_N-00012-684427741464,2020-02-06T15:53:13,Bilbao,Basic services,water,-57.87,-149.0
buyer_1,Luis,28,ES87209573564583313774,TRX_N-00013-311173228197,2020-02-06T14:48:40,Bilbao,Basic services,electricity,-133.59,-282.59
buyer_1,Luis,28,ES87209573564583313774,TRX_N-00014-556074241757,2020-02-06T12:45:28,Bilbao,Basic services,phone,-53.2,-335.79
buyer_1,Luis,28,ES87209573564583313774,TRX_N-00015-803124534174,2020-02-07T17:26:03,Bilbao,Basic services,gas,-69.0,-404.79
buyer_1,Luis,28,ES87209573564583313774,TRX_N-00016-283911708101,2020-03-01T13:37:48,Bilbao,transfer,Salary,1310.41,905.62
buyer_1,Luis,28,ES87209573564583313774,TRX_N-00017-988950176349,2020-03-01T13:37:48,Bilbao,transfer,Extra Income,131.04,1036.66
buyer_1,Luis,28,ES87209573564583313774,TRX_N-00018-120835666240,2020-03-05T11:24:25,Bilbao,Housing,Rent,-935.95,100.71
buyer_1,Luis,28,ES87209573564583313774,TRX_N-00019-505670007285,2020-03-05T13:30:55,Bilbao,Basic services,electricity,-49.33,51.38
buyer_1,Luis,28,ES87209573564583313774,TRX_N-00020-225218285254,2020-03-05T14:28:02,Bilbao,Basic services,gas,-52.73,-1.35
buyer_1,Luis,28,ES87209573564583313774,TRX_N-00021-794748771574,2020-03-05T13:15:42,Bilbao,Basic services,internet,-54.02,-55.37
buyer_1,Luis,28,ES87209573564583313774,TRX_N-00022-792278114047,2020-03-05T12:05:55,Bilbao,Basic services,phone,-87.11,-142.48
buyer_1,Luis,28,ES87209573564583313774,TRX_N-00023-904422450918,2020-03-06T19:38:27,Bilbao,Expense,gifts,-183.19,-325.67
buyer_1,Luis,28,ES87209573564583313774,TRX_N-00024-644850904927,2020-03-07T20:42:24,Bilbao,Basic services,phone,-47.97,-373.64
buyer_1,Luis,28,ES87209573564583313774,TRX_N-00025-161601257770,2020-03-08T08:15:41,Bilbao,Expense,food,-608.36,-982.0
buyer_1,Luis,28,ES87209573564583313774,TRX_N-00026-464051150902,2020-03-12T08:55:53,Bilbao,Expense,repairs,-626.5,-1608.5
buyer_1,Luis,28,ES87209573564583313774,TRX_N-00027-518523910667,2020-03-13T19:17:16,Bilbao,Expense,food,-742.24,-2350.74
buyer_1,Luis,28,ES87209573564583313774,TRX_N-00028-317715563790,2020-03-13T13:37:55,Bilbao,Expense,leisure,-50.44,-2401.18
buyer_1,Luis,28,ES87209573564583313774,TRX_N-00029-7590296,2020-03-22T18:20:52,Bilbao,Expense,leisure,-103.12,-2504.3
buyer_1,Luis,28,ES87209573564583313774,TRX_N-00030-24294922027,2020-03-27T18:29:34,Bilbao,Expense,food,-523.45,-3027.75
buyer_1,Luis,28,ES87209573564583313774,TRX_N-00031-671156382076,2020-04-01T19:36:27,Bilbao,transfer,Salary,1310.41,-1717.34
buyer_1,Luis,28,ES87209573564583313774,TRX_N-00032-297640481609,2020-04-05T22:25:36,Bilbao,Housing,Rent,-935.95,-2653.29
buyer_1,Luis,28,ES87209573564583313774,TRX_N-00033-436007603572,2020-04-06T19:24:58,Bilbao,Basic services,water,-42.86,-2696.15
buyer_1,Luis,28,ES87209573564583313774,TRX_N-00034-900898469500,2020-04-06T09:23:43,Bilbao,Basic services,electricity,-39.67,-2735.82
buyer_1,Luis,28,ES87209573564583313774,TRX_N-00035-133826666863,2020-04-06T17:31:51,Bilbao,Basic services,internet,-32.86,-2768.68
buyer_1,Luis,28,ES87209573564583313774,TRX_N-00036-383572129638,2020-04-07T20:55:47,Bilbao,Basic services,water,-76.99,-2845.67
buyer_1,Luis,28,ES87209573564583313774,TRX_N-00037-275966086676,2020-04-07T09:45:45,Bilbao,Basic services,internet,-76.78,-2922.45
buyer_1,Luis,28,ES87209573564583313774,TRX_N-00038-129150252369,2020-04-08T19:36:57,Bilbao,Expense,leisure,-36.07,-2958.52
buyer_1,Luis,28,ES87209573564583313774,TRX_N-00039-674262332477,2020-04-10T09:20:35,Bilbao,Expense,leisure,-179.44,-3137.96
buyer_1,Luis,28,ES87209573564583313774,TRX_N-00040-819464859967,2020-04-19T20:19:56,Zuia,Expense,food,-629.87,-3767.83
buyer_1,Luis,28,ES87209573564583313774,TRX_N-00041-450082190939,2020-04-23T15:02:30,Bilbao,Expense,healthcare,-155.42,-3923.25
buyer_1,Luis,28,ES87209573564583313774,TRX_N-00042-930406805843,2020-04-28T08:57:34,Llodio,Expense,appliances,-941.39,-4864.64
buyer_1,Luis,28,ES87209573564583313774,TRX_N-00043-958798777652,2020-05-01T18:01:50,Bilbao,transfer,Salary,1310.41,-3554.23
buyer_1,Luis,28,ES87209573564583313774,TRX_N-00044-487829611894,2020-05-01T18:01:50,Bilbao,transfer,Extra Income,131.04,-3423.19
buyer_1,Luis,28,ES87209573564583313774,TRX_N-00045-75780089696,2020-05-05T11:04:00,Bilbao,Housing,Rent,-935.95,-4359.14
buyer_1,Luis,28,ES87209573564583313774,TRX_N-00046-408835496654,2020-05-05T10:01:46,Bilbao,Basic services,electricity,-137.82,-4496.96
buyer_1,Luis,28,ES87209573564583313774,TRX_N-00047-805188406793,2020-05-05T09:51:06,Bilbao,Basic services,internet,-56.06,-4553.02
buyer_1,Luis,28,ES87209573564583313774,TRX_N-00048-794975736037,2020-05-06T19:04:40,Bilbao,Basic services,electricity,-118.73,-4671.75
buyer_1,Luis,28,ES87209573564583313774,TRX_N-00049-205903099842,2020-05-06T20:34:05,Bilbao,Basic services,internet,-38.41,-4710.16
buyer_1,Luis,28,ES87209573564583313774,TRX_N-00050-103016018460,2020-05-06T09:29:20,Bilbao,Basic services,phone,-58.96,-4769.12
buyer_1,Luis,28,ES87209573564583313774,TRX_N-00051-45351620175,2020-05-20T17:20:36,Bilbao,Expense,transport,-23.8,-4792.92
buyer_1,Luis,28,ES87209573564583313774,TRX_N-00052-364573716017,2020-05-29T09:25:21,Bilbao,Expense,transport,-83.65,-4876.57
buyer_1,Luis,28,ES87209573564583313774,TRX_N-00053-57072317784,2020-06-01T12:53:41,Bilbao,transfer,Salary,1310.41,-3566.16
buyer_1,Luis,28,ES87209573564583313774,TRX_N-00054-834302060260,2020-06-01T12:53:41,Bilbao,transfer,Bonus,1189.08,-2377.08
buyer_1,Luis,28,ES87209573564583313774,TRX_N-00055-660298536659,2020-06-05T14:04:06,Bilbao,Housing,Rent,-935.95,-3313.03
buyer_1,Luis,28,ES87209573564583313774,TRX_N-00056-17758200775,2020-06-05T16:47:14,Bilbao,Basic services,phone,-28.48,-3341.51
buyer_1,Luis,28,ES87209573564583313774,TRX_N-00057-25212115134,2020-06-06T15:02:17,Bilbao,Basic services,water,-70.39,-3411.9
buyer_1,Luis,28,ES87209573564583313774,TRX_N-00058-656531220646,2020-06-06T16:55:48,Bilbao,Basic services,gas,-95.77,-3507.67
buyer_1,Luis,28,ES87209573564583313774,TRX_N-00059-68183772493,2020-06-07T08:28:18,Bilbao,Basic services,gas,-52.11,-3559.78
buyer_1,Luis,28,ES87209573564583313774,TRX_N-00060-85518566195,2020-06-07T08:29:56,Bilbao,Basic services,internet,-43.77,-3603.55
buyer_1,Luis,28,ES87209573564583313774,TRX_N-00061-79226024675,2020-06-07T15:32:12,Bilbao,Expense,leisure,-233.55,-3837.1
buyer_1,Luis,28,ES87209573564583313774,TRX_N-00062-698488441146,2020-06-16T17:42:23,Bilbao,Expense,gifts,-45.39,-3882.49
buyer_1,Luis,28,ES87209573564583313774,TRX_N-00063-763000421724,2020-06-27T19:31:13,Zarautz,Expense,transport,-20.63,-3903.12
buyer_1,Luis,28,ES87209573564583313774,TRX_N-00064-930142416981,2020-07-01T11:43:24,Bilbao,transfer,Salary,1310.41,-2592.71
buyer_1,Luis,28,ES87209573564583313774,TRX_N-00065-168855427707,2020-07-05T22:20:38,Bilbao,Housing,Rent,-935.95,-3528.66
buyer_1,Luis,28,ES87209573564583313774,TRX_N-00066-719675021715,2020-07-06T15:29:32,Bilbao,Basic services,water,-54.51,-3583.17
buyer_1,Luis,28,ES87209573564583313774,TRX_N-00067-57041364563,2020-07-06T14:44:03,Bilbao,Basic services,gas,-75.06,-3658.23
buyer_1,Luis,28,ES87209573564583313774,TRX_N-00068-601204725353,2020-07-06T16:33:10,Bilbao,Basic services,phone,-73.7,-3731.93
buyer_1,Luis,28,ES87209573564583313774,TRX_N-00069-546873085194,2020-07-07T17:25:23,Bilbao,Basic services,internet,-30.51,-3762.44
buyer_1,Luis,28,ES87209573564583313774,TRX_N-00070-524281288788,2020-07-11T12:18:00,Leioa,Expense,healthcare,-252.09,-4014.53
buyer_1,Luis,28,ES87209573564583313774,TRX_N-00071-737164807492,2020-07-17T10:59:26,Bilbao,Expense,transport,-149.15,-4163.68
buyer_1,Luis,28,ES87209573564583313774,TRX_N-00072-74626083404,2020-07-19T04:21:39,Bilbao,Expense,food,-632.58,-4796.26
buyer_1,Luis,28,ES87209573564583313774,TRX_N-00073-130106702067,2020-07-23T22:04:32,Bilbao,Expense,food,-150.61,-4946.87
buyer_1,Luis,28,ES87209573564583313774,TRX_N-00074-353500525642,2020-07-24T17:03:29,Bilbao,Expense,food,-507.65,-5454.52
buyer_1,Luis,28,ES87209573564583313774,TRX_N-00075-749395006481,2020-07-28T10:46:26,Bilbao,Expense,transport,-75.31,-5529.83
buyer_1,Luis,28,ES87209573564583313774,TRX_N-00076-213297205359,2020-07-28T07:18:36,Basauri,Expense,clothing,-182.69,-5712.52
buyer_1,Luis,28,ES87209573564583313774,TRX_N-00077-247804221074,2020-08-01T17:58:20,Bilbao,transfer,Salary,1310.41,-4402.11
buyer_1,Luis,28,ES87209573564583313774,TRX_N-00078-433379832409,2020-08-01T17:58:20,Bilbao,transfer,Extra Income,131.04,-4271.07
buyer_1,Luis,28,ES87209573564583313774,TRX_N-00079-19629482610,2020-08-05T13:12:23,Bilbao,Housing,Rent,-935.95,-5207.02
buyer_1,Luis,28,ES87209573564583313774,TRX_N-00080-192384506470,2020-08-05T12:14:58,Bilbao,Basic services,water,-30.27,-5237.29
buyer_1,Luis,28,ES87209573564583313774,TRX_N-00081-977989884561,2020-08-05T09:05:21,Bilbao,Expense,transport,-117.76,-5355.05
buyer_1,Luis,28,ES87209573564583313774,TRX_N-00082-808623674345,2020-08-05T18:03:09,Bilbao,Expense,clothing,-56.68,-5411.73
buyer_1,Luis,28,ES87209573564583313774,TRX_N-00083-130381201363,2020-08-05T12:36:48,Bilbao,Expense,gifts,-197.18,-5608.91
buyer_1,Luis,28,ES87209573564583313774,TRX_N-00084-572709150786,2020-08-06T14:59:01,Bilbao,Basic services,water,-69.88,-5678.79
buyer_1,Luis,28,ES87209573564583313774,TRX_N-00085-307773868216,2020-08-06T13:53:29,Bilbao,Basic services,internet,-48.1,-5726.89
buyer_1,Luis,28,ES87209573564583313774,TRX_N-00086-768564540347,2020-08-07T09:30:41,Bilbao,Basic services,electricity,-56.51,-5783.4
buyer_1,Luis,28,ES87209573564583313774,TRX_N-00087-378886684453,2020-08-07T19:46:38,Bilbao,Basic services,gas,-46.93,-5830.33
buyer_1,Luis,28,ES87209573564583313774,TRX_N-00088-323811073311,2020-08-18T12:19:12,Bilbao,Expense,food,-698.92,-6529.25
buyer_1,Luis,28,ES87209573564583313774,TRX_N-00089-783504064400,2020-08-18T10:58:16,Bilbao,Expense,transport,-172.87,-6702.12
buyer_1,Luis,28,ES87209573564583313774,TRX_N-00090-883549540879,2020-08-23T20:32:34,Bilbao,Expense,healthcare,-235.58,-6937.7
buyer_1,Luis,28,ES87209573564583313774,TRX_N-00091-391055879812,2020-08-28T10:49:36,Bilbao,Expense,food,-688.56,-7626.26
buyer_1,Luis,28,ES87209573564583313774,TRX_N-00092-120375462807,2020-09-01T18:37:34,Bilbao,transfer,Salary,1310.41,-6315.85
buyer_1,Luis,28,ES87209573564583313774,TRX_N-00093-300625098802,2020-09-05T12:04:29,Bilbao,Housing,Rent,-935.95,-7251.8
buyer_1,Luis,28,ES87209573564583313774,TRX_N-00094-641729447278,2020-09-05T18:03:51,Bilbao,Basic services,water,-59.35,-7311.15
buyer_1,Luis,28,ES87209573564583313774,TRX_N-00095-935442358266,2020-09-05T15:07:14,Bilbao,Basic services,gas,-96.7,-7407.85
buyer_1,Luis,28,ES87209573564583313774,TRX_N-00096-339663516722,2020-09-06T16:24:39,Bilbao,Basic services,water,-58.91,-7466.76
buyer_1,Luis,28,ES87209573564583313774,TRX_N-00097-401187083584,2020-09-06T14:40:16,Bilbao,Basic services,electricity,-124.79,-7591.55
buyer_1,Luis,28,ES87209573564583313774,TRX_N-00098-665548369695,2020-09-07T13:18:10,Bilbao,Basic services,water,-71.4,-7662.95
buyer_1,Luis,28,ES87209573564583313774,TRX_N-00099-288603876649,2020-09-07T09:44:57,Bilbao,Basic services,electricity,-108.25,-7771.2
buyer_1,Luis,28,ES87209573564583313774,TRX_N-00100-324108899584,2020-09-08T10:29:21,Bilbao,Expense,food,-123.42,-7894.62
buyer_1,Luis,28,ES87209573564583313774,TRX_N-00101-372018764767,2020-09-08T15:02:51,Bilbao,Expense,healthcare,-225.07,-8119.69
buyer_1,Luis,28,ES87209573564583313774,TRX_N-00102-650731856265,2020-09-13T14:17:11,Bilbao,Expense,leisure,-14.24,-8133.93
buyer_1,Luis,28,ES87209573564583313774,TRX_N-00103-982145242130,2020-09-17T16:36:46,Bilbao,Expense,clothing,-399.38,-8533.31
buyer_1,Luis,28,ES87209573564583313774,TRX_N-00104-403923427495,2020-09-20T11:01:20,Elciego,Expense,food,-118.38,-8651.69
buyer_1,Luis,28,ES87209573564583313774,TRX_N-00105-122048097033,2020-09-26T04:03:02,Bilbao,Expense,food,-371.51,-9023.2
buyer_1,Luis,28,ES87209573564583313774,TRX_N-00106-391061133272,2020-09-30T01:11:34,Bilbao,Expense,gifts,-126.9,-9150.1
buyer_1,Luis,28,ES87209573564583313774,TRX_N-00107-299806073309,2020-10-01T15:52:06,Bilbao,transfer,Salary,1310.41,-7839.69
buyer_1,Luis,28,ES87209573564583313774,TRX_N-00108-600809927348,2020-10-01T15:52:06,Bilbao,transfer,Extra Income,131.04,-7708.65
buyer_1,Luis,28,ES87209573564583313774,TRX_N-00109-572600945452,2020-10-05T09:24:02,Bilbao,Housing,Rent,-935.95,-8644.6
buyer_1,Luis,28,ES87209573564583313774,TRX_N-00110-653754407381,2020-10-05T18:12:55,Bilbao,Basic services,phone,-83.17,-8727.77
buyer_1,Luis,28,ES87209573564583313774,TRX_N-00111-789568533534,2020-10-06T20:59:46,Bilbao,Basic services,water,-73.18,-8800.95
buyer_1,Luis,28,ES87209573564583313774,TRX_N-00112-155567253957,2020-10-07T15:46:06,Bilbao,Basic services,water,-26.71,-8827.66
buyer_1,Luis,28,ES87209573564583313774,TRX_N-00113-506857507389,2020-10-07T22:57:21,Bilbao,Basic services,electricity,-66.54,-8894.2
buyer_1,Luis,28,ES87209573564583313774,TRX_N-00114-15828585891,2020-10-07T18:55:59,Bilbao,Basic services,phone,-47.14,-8941.34
buyer_1,Luis,28,ES87209573564583313774,TRX_N-00115-764932638314,2020-10-16T20:47:02,Iruña de Oca,Expense,clothing,-69.95,-9011.29
buyer_1,Luis,28,ES87209573564583313774,TRX_N-00116-810754063905,2020-10-17T14:47:26,Bilbao,Expense,healthcare,-274.93,-9286.22
buyer_1,Luis,28,ES87209573564583313774,TRX_N-00117-362166964742,2020-11-01T15:46:57,Bilbao,transfer,Salary,1310.41,-7975.81
buyer_1,Luis,28,ES87209573564583313774,TRX_N-00118-695705474597,2020-11-02T17:08:07,Bilbao,Expense,food,-644.68,-8620.49
buyer_1,Luis,28,ES87209573564583313774,TRX_N-00119-347142374004,2020-11-05T15:40:31,Bilbao,Housing,Rent,-935.95,-9556.44
buyer_1,Luis,28,ES87209573564583313774,TRX_N-00120-700403994023,2020-11-05T00:19:10,Bilbao,Basic services,water,-45.4,-9601.84
buyer_1,Luis,28,ES87209573564583313774,TRX_N-00121-355873037388,2020-11-05T11:48:24,Bilbao,Basic services,phone,-36.2,-9638.04
buyer_1,Luis,28,ES87209573564583313774,TRX_N-00122-848020963842,2020-11-06T11:33:13,Bilbao,Basic services,gas,-62.94,-9700.98
buyer_1,Luis,28,ES87209573564583313774,TRX_N-00123-518529862330,2020-11-07T14:35:19,Bilbao,Basic services,water,-38.85,-9739.83
buyer_1,Luis,28,ES87209573564583313774,TRX_N-00124-772921508638,2020-11-07T15:48:28,Bilbao,Basic services,electricity,-37.21,-9777.04
buyer_1,Luis,28,ES87209573564583313774,TRX_N-00125-509059544230,2020-11-07T09:10:28,Bilbao,Basic services,internet,-49.19,-9826.23
buyer_1,Luis,28,ES87209573564583313774,TRX_N-00126-321759439927,2020-11-13T18:56:44,Bilbao,Expense,appliances,-563.62,-10389.85
buyer_1,Luis,28,ES87209573564583313774,TRX_N-00127-33177719075,2020-11-16T11:06:54,Bilbao,Expense,transport,-31.22,-10421.07
buyer_1,Luis,28,ES87209573564583313774,TRX_N-00128-932228023649,2020-11-21T14:15:45,Bilbao,Expense,food,-301.67,-10722.74
buyer_1,Luis,28,ES87209573564583313774,TRX_N-00129-680792106849,2020-11-28T14:53:23,Bilbao,Expense,food,-618.13,-11340.87
buyer_1,Luis,28,ES87209573564583313774,TRX_N-00130-881825782124,2020-12-01T01:41:57,Bilbao,transfer,Salary,1310.41,-10030.46
buyer_1,Luis,28,ES87209573564583313774,TRX_N-00131-507201128158,2020-12-01T01:41:57,Bilbao,transfer,Bonus,1408.83,-8621.63
buyer_1,Luis,28,ES87209573564583313774,TRX_N-00132-853327420733,2020-12-05T20:59:24,Bilbao,Housing,Rent,-935.95,-9557.58
buyer_1,Luis,28,ES87209573564583313774,TRX_N-00133-236222995049,2020-12-05T16:25:03,Bilbao,Basic services,water,-72.48,-9630.06
buyer_1,Luis,28,ES87209573564583313774,TRX_N-00134-815909704780,2020-12-05T08:32:28,Bilbao,Basic services,gas,-91.69,-9721.75
buyer_1,Luis,28,ES87209573564583313774,TRX_N-00135-28721205915,2020-12-05T14:41:43,Bilbao,Basic services,internet,-75.76,-9797.51
buyer_1,Luis,28,ES87209573564583313774,TRX_N-00136-41002301127,2020-12-05T17:37:00,Bilbao,Basic services,phone,-54.14,-9851.65
buyer_1,Luis,28,ES87209573564583313774,TRX_N-00137-430440378685,2020-12-06T09:03:02,Bilbao,Basic services,gas,-32.55,-9884.2
buyer_1,Luis,28,ES87209573564583313774,TRX_N-00138-777136546983,2020-12-06T15:57:15,Bilbao,Basic services,internet,-40.59,-9924.79
buyer_1,Luis,28,ES87209573564583313774,TRX_N-00139-682622617266,2020-12-07T17:28:55,Bilbao,Basic services,water,-13.06,-9937.85
buyer_1,Luis,28,ES87209573564583313774,TRX_N-00140-633527563354,2020-12-07T12:52:52,Bilbao,Basic services,gas,-97.45,-10035.3
buyer_1,Luis,28,ES87209573564583313774,TRX_N-00141-832340493398,2020-12-07T20:19:32,Bilbao,Basic services,phone,-87.15,-10122.45
buyer_1,Luis,28,ES87209573564583313774,TRX_N-00142-154772522703,2020-12-27T11:28:48,Bilbao,Expense,transport,-85.35,-10207.8
buyer_1,Luis,28,ES87209573564583313774,TRX_N-00143-327262693053,2021-01-01T22:41:39,Bilbao,transfer,Salary,1310.41,-8897.39
buyer_1,Luis,28,ES87209573564583313774,TRX_N-00144-409687294478,2021-01-01T22:41:39,Bilbao,transfer,Extra Income,131.04,-8766.35
buyer_1,Luis,28,ES87209573564583313774,TRX_N-00145-90791443137,2021-01-03T06:43:39,Bilbao,Expense,food,-465.76,-9232.11
buyer_1,Luis,28,ES87209573564583313774,TRX_N-00146-841673725277,2021-01-05T19:22:52,Bilbao,Housing,Rent,-935.95,-10168.06
buyer_1,Luis,28,ES87209573564583313774,TRX_N-00147-421642479853,2021-01-05T12:30:36,Bilbao,Basic services,electricity,-51.74,-10219.8
buyer_1,Luis,28,ES87209573564583313774,TRX_N-00148-277782176626,2021-01-06T16:30:39,Bilbao,Basic services,electricity,-89.68,-10309.48
buyer_1,Luis,28,ES87209573564583313774,TRX_N-00149-552591682528,2021-01-06T19:44:35,Bilbao,Basic services,phone,-53.6,-10363.08
buyer_1,Luis,28,ES87209573564583313774,TRX_N-00150-964896208944,2021-01-07T13:42:44,Bilbao,Basic services,phone,-58.16,-10421.24
buyer_1,Luis,28,ES87209573564583313774,TRX_N-00151-428026020479,2021-01-15T18:08:02,Bilbao,Expense,leisure,-200.98,-10622.22
buyer_1,Luis,28,ES87209573564583313774,TRX_N-00152-856162936668,2021-01-17T15:11:54,Bilbao,Expense,food,-399.38,-11021.6
buyer_1,Luis,28,ES87209573564583313774,TRX_N-00153-114340868900,2021-01-19T20:41:56,Bilbao,Expense,food,-562.8,-11584.4
buyer_1,Luis,28,ES87209573564583313774,TRX_N-00154-271235552516,2021-01-27T11:30:28,Bilbao,Expense,education,-76.78,-11661.18
buyer_1,Luis,28,ES87209573564583313774,TRX_N-00155-268473783195,2021-02-01T19:10:51,Bilbao,transfer,Salary,1310.41,-10350.77
buyer_1,Luis,28,ES87209573564583313774,TRX_N-00156-48247729657,2021-02-05T07:21:46,Bilbao,Housing,Rent,-935.95,-11286.72
buyer_1,Luis,28,ES87209573564583313774,TRX_N-00157-396880632313,2021-02-05T09:23:48,Bilbao,Basic services,water,-18.65,-11305.37
buyer_1,Luis,28,ES87209573564583313774,TRX_N-00158-417519332888,2021-02-05T20:41:07,Bilbao,Basic services,gas,-66.17,-11371.54
buyer_1,Luis,28,ES87209573564583313774,TRX_N-00159-917486595525,2021-02-05T12:37:37,Bilbao,Basic services,internet,-31.35,-11402.89
buyer_1,Luis,28,ES87209573564583313774,TRX_N-00160-23483683395,2021-02-06T12:25:58,Bilbao,Basic services,water,-41.52,-11444.41
buyer_1,Luis,28,ES87209573564583313774,TRX_N-00161-650679939684,2021-02-06T17:36:48,Bilbao,Expense,healthcare,-200.31,-11644.72
buyer_1,Luis,28,ES87209573564583313774,TRX_N-00162-974713577232,2021-02-07T16:44:04,Bilbao,Basic services,water,-54.58,-11699.3
buyer_1,Luis,28,ES87209573564583313774,TRX_N-00163-999773413840,2021-02-07T10:15:41,Bilbao,Basic services,phone,-68.63,-11767.93
buyer_1,Luis,28,ES87209573564583313774,TRX_N-00164-651485508085,2021-02-17T18:17:44,Bilbao,Expense,clothing,-373.63,-12141.56
buyer_1,Luis,28,ES87209573564583313774,TRX_N-00165-350212277834,2021-02-22T17:10:43,Bilbao,Expense,transport,-129.54,-12271.1
buyer_1,Luis,28,ES87209573564583313774,TRX_N-00166-850469644382,2021-03-01T21:40:26,Bilbao,transfer,Salary,1310.41,-10960.69
buyer_1,Luis,28,ES87209573564583313774,TRX_N-00167-92579679845,2021-03-03T10:55:12,Bilbao,Expense,leisure,-278.23,-11238.92
buyer_1,Luis,28,ES87209573564583313774,TRX_N-00168-434693684547,2021-03-05T15:04:57,Bilbao,Housing,Rent,-935.95,-12174.87
buyer_1,Luis,28,ES87209573564583313774,TRX_N-00169-5843908107,2021-03-06T20:58:02,Bilbao,Basic services,water,-31.21,-12206.08
buyer_1,Luis,28,ES87209573564583313774,TRX_N-00170-756001774867,2021-03-07T08:06:27,Bilbao,Basic services,water,-20.02,-12226.1
buyer_1,Luis,28,ES87209573564583313774,TRX_N-00171-10828405948,2021-03-07T19:04:35,Bilbao,Basic services,electricity,-75.6,-12301.7
buyer_1,Luis,28,ES87209573564583313774,TRX_N-00172-821443516474,2021-03-07T10:28:10,Bilbao,Basic services,internet,-44.23,-12345.93
buyer_1,Luis,28,ES87209573564583313774,TRX_N-00173-650882214489,2021-03-07T23:18:56,Bilbao,Expense,food,-685.19,-13031.12
buyer_1,Luis,28,ES87209573564583313774,TRX_N-00174-735522960383,2021-03-12T10:58:03,Llodio,Expense,clothing,-370.95,-13402.07
buyer_1,Luis,28,ES87209573564583313774,TRX_N-00175-579358314434,2021-03-13T16:57:45,Bilbao,Expense,transport,-64.27,-13466.34
buyer_1,Luis,28,ES87209573564583313774,TRX_N-00176-226152597037,2021-03-28T16:16:59,Llodio,Expense,leisure,-141.21,-13607.55
buyer_1,Luis,28,ES87209573564583313774,TRX_N-00177-566018700265,2021-03-31T17:04:58,Salvatierra/Agurain,Expense,gifts,-311.87,-13919.42
buyer_1,Luis,28,ES87209573564583313774,TRX_N-00178-793859585501,2021-04-01T18:12:43,Bilbao,transfer,Salary,1310.41,-12609.01
buyer_1,Luis,28,ES87209573564583313774,TRX_N-00179-606910527689,2021-04-01T18:12:43,Bilbao,transfer,Extra Income,131.04,-12477.97
buyer_1,Luis,28,ES87209573564583313774,TRX_N-00180-282261578198,2021-04-02T19:22:45,Bilbao,Expense,leisure,-276.13,-12754.1
buyer_1,Luis,28,ES87209573564583313774,TRX_N-00181-113203869057,2021-04-05T17:47:58,Bilbao,Housing,Rent,-935.95,-13690.05
buyer_1,Luis,28,ES87209573564583313774,TRX_N-00182-231325600739,2021-04-05T15:33:56,Bilbao,Basic services,water,-35.9,-13725.95
buyer_1,Luis,28,ES87209573564583313774,TRX_N-00183-541326958689,2021-04-06T14:41:43,Bilbao,Basic services,gas,-30.65,-13756.6
buyer_1,Luis,28,ES87209573564583313774,TRX_N-00184-347375410551,2021-04-06T16:10:15,Bilbao,Basic services,phone,-81.25,-13837.85
buyer_1,Luis,28,ES87209573564583313774,TRX_N-00185-193663667497,2021-04-07T14:19:01,Bilbao,Basic services,gas,-98.89,-13936.74
buyer_1,Luis,28,ES87209573564583313774,TRX_N-00186-81620922211,2021-04-12T19:50:30,Bilbao,Expense,transport,-94.52,-14031.26
buyer_1,Luis,28,ES87209573564583313774,TRX_N-00187-503275235753,2021-04-12T10:13:43,Bilbao,Expense,gifts,-393.42,-14424.68
buyer_1,Luis,28,ES87209573564583313774,TRX_N-00188-328308119283,2021-04-30T16:20:23,Bilbao,Expense,clothing,-318.41,-14743.09
buyer_1,Luis,28,ES87209573564583313774,TRX_N-00189-406440275722,2021-05-01T16:15:01,Bilbao,transfer,Salary,1310.41,-13432.68
buyer_1,Luis,28,ES87209573564583313774,TRX_N-00190-444669137935,2021-05-05T14:17:14,Bilbao,Housing,Rent,-935.95,-14368.63
buyer_1,Luis,28,ES87209573564583313774,TRX_N-00191-846507302410,2021-05-05T21:53:52,Bilbao,Basic services,internet,-54.82,-14423.45
buyer_1,Luis,28,ES87209573564583313774,TRX_N-00192-292885851045,2021-05-06T17:10:04,Bilbao,Basic services,phone,-48.5,-14471.95
buyer_1,Luis,28,ES87209573564583313774,TRX_N-00193-774453216766,2021-05-07T18:58:57,Bilbao,Basic services,electricity,-51.9,-14523.85
buyer_1,Luis,28,ES87209573564583313774,TRX_N-00194-889416726992,2021-05-11T09:04:13,Bilbao,Expense,leisure,-56.71,-14580.56
buyer_1,Luis,28,ES87209573564583313774,TRX_N-00195-67022218650,2021-05-24T19:38:25,Bilbao,Expense,clothing,-361.76,-14942.32
buyer_1,Luis,28,ES87209573564583313774,TRX_N-00196-41497041252,2021-06-01T20:43:46,Bilbao,transfer,Salary,1310.41,-13631.91
buyer_1,Luis,28,ES87209573564583313774,TRX_N-00197-18097505653,2021-06-01T20:43:46,Bilbao,transfer,Extra Income,131.04,-13500.87
buyer_1,Luis,28,ES87209573564583313774,TRX_N-00198-179118556589,2021-06-01T20:43:46,Bilbao,transfer,Bonus,1396.08,-12104.79
buyer_1,Luis,28,ES87209573564583313774,TRX_N-00199-80655074291,2021-06-05T08:57:53,Bilbao,Housing,Rent,-935.95,-13040.74
buyer_1,Luis,28,ES87209573564583313774,TRX_N-00200-251937035151,2021-06-05T11:03:43,Bilbao,Basic services,water,-47.96,-13088.7
buyer_1,Luis,28,ES87209573564583313774,TRX_N-00201-359755638355,2021-06-05T08:04:23,Bilbao,Basic services,electricity,-88.69,-13177.39
buyer_1,Luis,28,ES87209573564583313774,TRX_N-00202-963682141255,2021-06-05T09:40:06,Bilbao,Basic services,phone,-99.19,-13276.58
buyer_1,Luis,28,ES87209573564583313774,TRX_N-00203-389133052447,2021-06-06T00:46:33,Bilbao,Basic services,electricity,-109.05,-13385.63
buyer_1,Luis,28,ES87209573564583313774,TRX_N-00204-610770618516,2021-06-06T19:20:35,Bilbao,Basic services,gas,-89.57,-13475.2
buyer_1,Luis,28,ES87209573564583313774,TRX_N-00205-269229023372,2021-06-06T09:47:26,Bilbao,Basic services,internet,-57.44,-13532.64
buyer_1,Luis,28,ES87209573564583313774,TRX_N-00206-842414785430,2021-06-07T16:11:16,Bilbao,Basic services,electricity,-139.73,-13672.37
buyer_1,Luis,28,ES87209573564583313774,TRX_N-00207-881821365627,2021-06-07T16:36:58,Bilbao,Basic services,internet,-46.97,-13719.34
buyer_1,Luis,28,ES87209573564583313774,TRX_N-00208-586898702858,2021-07-01T18:26:01,Bilbao,transfer,Salary,1310.41,-12408.93
buyer_1,Luis,28,ES87209573564583313774,TRX_N-00209-873798917127,2021-07-05T09:36:35,Bilbao,Housing,Rent,-935.95,-13344.88
buyer_1,Luis,28,ES87209573564583313774,TRX_N-00210-210372342610,2021-07-05T15:10:44,Bilbao,Basic services,gas,-83.29,-13428.17
buyer_1,Luis,28,ES87209573564583313774,TRX_N-00211-536944679420,2021-07-05T20:24:19,Bilbao,Basic services,internet,-38.1,-13466.27
buyer_1,Luis,28,ES87209573564583313774,TRX_N-00212-230585083416,2021-07-06T17:56:54,Bilbao,Basic services,water,-13.88,-13480.15
buyer_1,Luis,28,ES87209573564583313774,TRX_N-00213-700372851899,2021-07-06T23:54:47,Bilbao,Basic services,phone,-69.43,-13549.58
buyer_1,Luis,28,ES87209573564583313774,TRX_N-00214-538259519121,2021-07-07T16:52:41,Bilbao,Basic services,electricity,-20.44,-13570.02
buyer_1,Luis,28,ES87209573564583313774,TRX_N-00215-552138315807,2021-07-07T08:17:53,Bilbao,Basic services,internet,-53.9,-13623.92
buyer_1,Luis,28,ES87209573564583313774,TRX_N-00216-323511299337,2021-07-07T15:30:59,Bilbao,Basic services,phone,-76.47,-13700.39
buyer_1,Luis,28,ES87209573564583313774,TRX_N-00217-976804978543,2021-07-25T17:49:58,Bilbao,Expense,leisure,-277.64,-13978.03
buyer_1,Luis,28,ES87209573564583313774,TRX_N-00218-464290393893,2021-07-26T15:24:53,Alegría-Dulantzi,Expense,clothing,-124.11,-14102.14
buyer_1,Luis,28,ES87209573564583313774,TRX_N-00219-974962058275,2021-07-28T14:29:46,Bilbao,Expense,transport,-59.86,-14162.0
buyer_1,Luis,28,ES87209573564583313774,TRX_N-00220-212474980183,2021-08-01T05:40:00,Bilbao,transfer,Salary,1310.41,-12851.59
buyer_1,Luis,28,ES87209573564583313774,TRX_N-00221-625451676877,2021-08-01T05:40:00,Bilbao,transfer,Extra Income,131.04,-12720.55
buyer_1,Luis,28,ES87209573564583313774,TRX_N-00222-268148516362,2021-08-05T17:15:59,Bilbao,Housing,Rent,-935.95,-13656.5
buyer_1,Luis,28,ES87209573564583313774,TRX_N-00223-674570024472,2021-08-05T07:04:09,Bilbao,Basic services,internet,-44.52,-13701.02
buyer_1,Luis,28,ES87209573564583313774,TRX_N-00224-414199144243,2021-08-06T08:52:26,Bilbao,Expense,food,-655.75,-14356.77
buyer_1,Luis,28,ES87209573564583313774,TRX_N-00225-470851973761,2021-08-07T12:50:15,Bilbao,Basic services,internet,-52.05,-14408.82
buyer_1,Luis,28,ES87209573564583313774,TRX_N-00226-129380036057,2021-08-07T13:34:31,Bilbao,Basic services,phone,-76.21,-14485.03
buyer_1,Luis,28,ES87209573564583313774,TRX_N-00227-627307322676,2021-08-07T19:41:18,Bilbao,Expense,transport,-55.84,-14540.87
buyer_1,Luis,28,ES87209573564583313774,TRX_N-00228-815571453395,2021-08-12T08:36:08,Bilbao,Expense,food,-258.17,-14799.04
buyer_1,Luis,28,ES87209573564583313774,TRX_N-00229-399430825255,2021-08-27T21:49:28,Zuia,Expense,repairs,-925.36,-15724.4
buyer_1,Luis,28,ES87209573564583313774,TRX_N-00230-920382704410,2021-09-01T13:20:36,Bilbao,transfer,Salary,1310.41,-14413.99
buyer_1,Luis,28,ES87209573564583313774,TRX_N-00231-579998828875,2021-09-05T16:23:31,Bilbao,Housing,Rent,-935.95,-15349.94
buyer_1,Luis,28,ES87209573564583313774,TRX_N-00232-716348494544,2021-09-05T20:31:36,Bilbao,Basic services,internet,-44.29,-15394.23
buyer_1,Luis,28,ES87209573564583313774,TRX_N-00233-866096125396,2021-09-06T10:18:20,Bilbao,Basic services,internet,-56.77,-15451.0
buyer_1,Luis,28,ES87209573564583313774,TRX_N-00234-874804281009,2021-09-06T17:21:02,Bilbao,Basic services,phone,-89.96,-15540.96
buyer_1,Luis,28,ES87209573564583313774,TRX_N-00235-740066538716,2021-09-06T10:31:28,Bilbao,Expense,leisure,-146.22,-15687.18
buyer_1,Luis,28,ES87209573564583313774,TRX_N-00236-815806159266,2021-09-07T16:58:21,Bilbao,Basic services,water,-79.82,-15767.0
buyer_1,Luis,28,ES87209573564583313774,TRX_N-00237-141295233229,2021-09-07T12:45:43,Bilbao,Basic services,gas,-60.49,-15827.49
buyer_1,Luis,28,ES87209573564583313774,TRX_N-00238-809380288071,2021-09-07T08:01:12,Bilbao,Basic services,phone,-53.68,-15881.17
buyer_1,Luis,28,ES87209573564583313774,TRX_N-00239-987854656338,2021-09-11T19:52:23,Bilbao,Expense,food,-426.84,-16308.01
buyer_1,Luis,28,ES87209573564583313774,TRX_N-00240-821613416986,2021-09-14T23:09:18,Bilbao,Expense,food,-596.57,-16904.58
buyer_1,Luis,28,ES87209573564583313774,TRX_N-00241-272124645211,2021-09-19T18:43:07,Arrasate/Mondragon,Expense,clothing,-430.57,-17335.15
buyer_1,Luis,28,ES87209573564583313774,TRX_N-00242-732698693501,2021-09-19T19:07:14,Hernani,Expense,repairs,-879.26,-18214.41
buyer_1,Luis,28,ES87209573564583313774,TRX_N-00243-303923538644,2021-09-30T16:27:45,Bilbao,Expense,repairs,-906.35,-19120.76
buyer_1,Luis,28,ES87209573564583313774,TRX_N-00244-221282192797,2021-10-01T13:23:15,Bilbao,transfer,Salary,1310.41,-17810.35
buyer_1,Luis,28,ES87209573564583313774,TRX_N-00245-331841849894,2021-10-01T13:23:15,Bilbao,transfer,Extra Income,131.04,-17679.31
buyer_1,Luis,28,ES87209573564583313774,TRX_N-00246-385623056579,2021-10-04T08:49:31,Bilbao,Expense,leisure,-271.75,-17951.06
buyer_1,Luis,28,ES87209573564583313774,TRX_N-00247-697147008513,2021-10-05T18:44:50,Bilbao,Housing,Rent,-935.95,-18887.01
buyer_1,Luis,28,ES87209573564583313774,TRX_N-00248-662431178308,2021-10-05T12:20:23,Bilbao,Basic services,water,-21.6,-18908.61
buyer_1,Luis,28,ES87209573564583313774,TRX_N-00249-995065109088,2021-10-06T19:23:13,Bilbao,Basic services,internet,-71.57,-18980.18
buyer_1,Luis,28,ES87209573564583313774,TRX_N-00250-354530087557,2021-10-06T19:16:23,Bilbao,Basic services,phone,-91.3,-19071.48
buyer_1,Luis,28,ES87209573564583313774,TRX_N-00251-185105013955,2021-11-01T08:49:43,Bilbao,transfer,Salary,1310.41,-17761.07
buyer_1,Luis,28,ES87209573564583313774,TRX_N-00252-702643542996,2021-11-05T17:42:20,Bilbao,Housing,Rent,-935.95,-18697.02
buyer_1,Luis,28,ES87209573564583313774,TRX_N-00253-540541114853,2021-11-05T11:17:25,Bilbao,Basic services,internet,-76.81,-18773.83
buyer_1,Luis,28,ES87209573564583313774,TRX_N-00254-765695314171,2021-11-06T21:00:17,Bilbao,Basic services,electricity,-33.09,-18806.92
buyer_1,Luis,28,ES87209573564583313774,TRX_N-00255-211094455012,2021-11-07T08:21:48,Bilbao,Basic services,electricity,-141.8,-18948.72
buyer_1,Luis,28,ES87209573564583313774,TRX_N-00256-343285343801,2021-11-07T01:26:37,Bilbao,Basic services,gas,-42.0,-18990.72
buyer_1,Luis,28,ES87209573564583313774,TRX_N-00257-170533418002,2021-11-07T18:31:57,Bilbao,Expense,food,-761.71,-19752.43
buyer_1,Luis,28,ES87209573564583313774,TRX_N-00258-983318786078,2021-11-12T05:59:33,Bilbao,Expense,healthcare,-41.78,-19794.21
buyer_1,Luis,28,ES87209573564583313774,TRX_N-00259-640433302798,2021-12-01T17:03:39,Bilbao,transfer,Salary,1310.41,-18483.8
buyer_1,Luis,28,ES87209573564583313774,TRX_N-00260-419118636370,2021-12-01T17:03:39,Bilbao,transfer,Extra Income,131.04,-18352.76
buyer_1,Luis,28,ES87209573564583313774,TRX_N-00261-328075564892,2021-12-01T17:03:39,Bilbao,transfer,Bonus,1320.47,-17032.29
buyer_1,Luis,28,ES87209573564583313774,TRX_N-00262-554879930617,2021-12-05T15:55:47,Bilbao,Housing,Rent,-935.95,-17968.24
buyer_1,Luis,28,ES87209573564583313774,TRX_N-00263-691697232289,2021-12-07T20:17:34,Bilbao,Basic services,electricity,-53.6,-18021.84
buyer_1,Luis,28,ES87209573564583313774,TRX_N-00264-436257093176,2021-12-07T12:33:28,Bilbao,Basic services,gas,-45.36,-18067.2
buyer_1,Luis,28,ES87209573564583313774,TRX_N-00265-534432640880,2021-12-22T06:42:08,Bilbao,Expense,transport,-140.0,-18207.2
buyer_1,Luis,28,ES87209573564583313774,TRX_N-00266-49092717801,2022-01-01T15:39:44,Bilbao,transfer,Salary,1310.41,-16896.79
buyer_1,Luis,28,ES87209573564583313774,TRX_N-00267-295114764813,2022-01-05T11:23:54,Bilbao,Housing,Rent,-935.95,-17832.74
buyer_1,Luis,28,ES87209573564583313774,TRX_N-00268-195013340170,2022-01-05T11:10:02,Bilbao,Basic services,water,-30.32,-17863.06
buyer_1,Luis,28,ES87209573564583313774,TRX_N-00269-521043062427,2022-01-05T00:38:55,Bilbao,Basic services,internet,-65.14,-17928.2
buyer_1,Luis,28,ES87209573564583313774,TRX_N-00270-626391774804,2022-01-06T11:02:56,Bilbao,Basic services,electricity,-72.24,-18000.44
buyer_1,Luis,28,ES87209573564583313774,TRX_N-00271-325677022470,2022-01-07T09:42:01,Bilbao,Basic services,electricity,-71.52,-18071.96
buyer_1,Luis,28,ES87209573564583313774,TRX_N-00272-874302849235,2022-01-07T13:16:39,Bilbao,Basic services,phone,-80.97,-18152.93
buyer_1,Luis,28,ES87209573564583313774,TRX_N-00273-602423419271,2022-01-09T15:22:32,Bilbao,Expense,healthcare,-176.18,-18329.11
buyer_1,Luis,28,ES87209573564583313774,TRX_N-00274-613656423923,2022-01-13T14:34:37,Bilbao,Expense,travel,-1553.34,-19882.45
buyer_1,Luis,28,ES87209573564583313774,TRX_N-00275-629310063023,2022-01-22T17:23:13,Andoain,Expense,food,-454.97,-20337.42
buyer_1,Luis,28,ES87209573564583313774,TRX_N-00276-788363575374,2022-01-28T15:48:21,Santurtzi,Expense,food,-142.59,-20480.01
buyer_1,Luis,28,ES87209573564583313774,TRX_N-00277-571243871910,2022-01-29T13:06:05,Bilbao,Expense,education,-606.13,-21086.14
buyer_1,Luis,28,ES87209573564583313774,TRX_N-00278-591195334519,2022-02-01T08:33:41,Bilbao,transfer,Salary,1310.41,-19775.73
buyer_1,Luis,28,ES87209573564583313774,TRX_N-00279-477019225661,2022-02-01T08:33:41,Bilbao,transfer,Extra Income,131.04,-19644.69
buyer_1,Luis,28,ES87209573564583313774,TRX_N-00280-261359022996,2022-02-05T12:34:02,Bilbao,Housing,Rent,-935.95,-20580.64
buyer_1,Luis,28,ES87209573564583313774,TRX_N-00281-540443850273,2022-02-05T10:28:54,Bilbao,Basic services,electricity,-80.01,-20660.65
buyer_1,Luis,28,ES87209573564583313774,TRX_N-00282-868738354156,2022-02-05T16:48:13,Bilbao,Expense,leisure,-276.85,-20937.5
buyer_1,Luis,28,ES87209573564583313774,TRX_N-00283-87478372112,2022-02-06T20:48:05,Bilbao,Basic services,electricity,-80.66,-21018.16
buyer_1,Luis,28,ES87209573564583313774,TRX_N-00284-869772904023,2022-02-06T08:55:45,Bilbao,Basic services,internet,-38.62,-21056.78
buyer_1,Luis,28,ES87209573564583313774,TRX_N-00285-200266485596,2022-02-07T14:35:23,Bilbao,Basic services,water,-16.68,-21073.46
buyer_1,Luis,28,ES87209573564583313774,TRX_N-00286-79632555210,2022-02-07T17:41:48,Bilbao,Basic services,electricity,-33.26,-21106.72
buyer_1,Luis,28,ES87209573564583313774,TRX_N-00287-918499238117,2022-02-07T17:44:21,Bilbao,Basic services,phone,-63.06,-21169.78
buyer_1,Luis,28,ES87209573564583313774,TRX_N-00288-816749317837,2022-02-09T03:16:05,Bilbao,Expense,education,-271.51,-21441.29
buyer_1,Luis,28,ES87209573564583313774,TRX_N-00289-944285343387,2022-02-11T15:12:49,Bilbao,Expense,food,-760.52,-22201.81
buyer_1,Luis,28,ES87209573564583313774,TRX_N-00290-999760421325,2022-02-17T19:40:28,Bilbao,Expense,leisure,-172.44,-22374.25
buyer_1,Luis,28,ES87209573564583313774,TRX_N-00291-863718209638,2022-02-28T14:38:50,Bilbao,Expense,food,-651.27,-23025.52
buyer_1,Luis,28,ES87209573564583313774,TRX_N-00292-880424443507,2022-03-01T10:30:05,Bilbao,transfer,Salary,1310.41,-21715.11
buyer_1,Luis,28,ES87209573564583313774,TRX_N-00293-317323129156,2022-03-05T19:26:31,Bilbao,Housing,Rent,-935.95,-22651.06
buyer_1,Luis,28,ES87209573564583313774,TRX_N-00294-167664475506,2022-03-05T13:14:33,Bilbao,Expense,food,-796.43,-23447.49
buyer_1,Luis,28,ES87209573564583313774,TRX_N-00295-353520680565,2022-03-06T14:15:40,Bilbao,Basic services,electricity,-94.5,-23541.99
buyer_1,Luis,28,ES87209573564583313774,TRX_N-00296-870460345810,2022-03-06T18:12:29,Bilbao,Basic services,internet,-68.73,-23610.72
buyer_1,Luis,28,ES87209573564583313774,TRX_N-00297-926641324305,2022-03-06T18:02:48,Bilbao,Expense,transport,-141.56,-23752.28
buyer_1,Luis,28,ES87209573564583313774,TRX_N-00298-653813210258,2022-03-07T16:50:10,Bilbao,Basic services,internet,-40.33,-23792.61
buyer_1,Luis,28,ES87209573564583313774,TRX_N-00299-442974352414,2022-03-16T09:38:53,Bilbao,Expense,food,-744.46,-24537.07
buyer_1,Luis,28,ES87209573564583313774,TRX_N-00300-978539948586,2022-03-20T16:29:31,Bilbao,Expense,gifts,-239.03,-24776.1
buyer_1,Luis,28,ES87209573564583313774,TRX_N-00301-689190619364,2022-03-22T18:09:45,Bilbao,Expense,food,-596.81,-25372.91
buyer_1,Luis,28,ES87209573564583313774,TRX_N-00302-946449099780,2022-03-26T08:24:29,Bilbao,Expense,leisure,-209.05,-25581.96
buyer_1,Luis,28,ES87209573564583313774,TRX_N-00303-725397940594,2022-04-01T16:03:36,Bilbao,transfer,Salary,1310.41,-24271.55
buyer_1,Luis,28,ES87209573564583313774,TRX_N-00304-951066618135,2022-04-03T10:43:13,Bilbao,Expense,healthcare,-327.23,-24598.78
buyer_1,Luis,28,ES87209573564583313774,TRX_N-00305-745822245835,2022-04-05T09:11:57,Bilbao,Housing,Rent,-935.95,-25534.73
buyer_1,Luis,28,ES87209573564583313774,TRX_N-00306-108011031268,2022-04-06T12:52:31,Bilbao,Basic services,gas,-42.27,-25577.0
buyer_1,Luis,28,ES87209573564583313774,TRX_N-00307-676844367391,2022-04-08T12:44:39,Bilbao,Expense,transport,-156.38,-25733.38
buyer_1,Luis,28,ES87209573564583313774,TRX_N-00308-503856554631,2022-05-01T08:47:43,Bilbao,transfer,Salary,1310.41,-24422.97
buyer_1,Luis,28,ES87209573564583313774,TRX_N-00309-654726830515,2022-05-01T08:47:43,Bilbao,transfer,Extra Income,131.04,-24291.93
buyer_1,Luis,28,ES87209573564583313774,TRX_N-00310-933038622701,2022-05-05T14:59:09,Bilbao,Housing,Rent,-935.95,-25227.88
buyer_1,Luis,28,ES87209573564583313774,TRX_N-00311-354940766749,2022-05-05T08:07:58,Bilbao,Basic services,water,-18.78,-25246.66
buyer_1,Luis,28,ES87209573564583313774,TRX_N-00312-63226363281,2022-05-05T09:27:09,Bilbao,Basic services,electricity,-135.23,-25381.89
buyer_1,Luis,28,ES87209573564583313774,TRX_N-00313-712474772179,2022-05-05T18:24:44,Bilbao,Basic services,gas,-45.29,-25427.18
buyer_1,Luis,28,ES87209573564583313774,TRX_N-00314-897441785282,2022-05-05T17:07:49,Bilbao,Basic services,phone,-32.58,-25459.76
buyer_1,Luis,28,ES87209573564583313774,TRX_N-00315-336338180933,2022-05-06T17:28:54,Bilbao,Basic services,water,-50.85,-25510.61
buyer_1,Luis,28,ES87209573564583313774,TRX_N-00316-536701656813,2022-05-07T16:17:06,Bilbao,Basic services,water,-17.69,-25528.3
buyer_1,Luis,28,ES87209573564583313774,TRX_N-00317-228400926138,2022-05-07T09:47:58,Bilbao,Basic services,electricity,-118.06,-25646.36
buyer_1,Luis,28,ES87209573564583313774,TRX_N-00318-414299597318,2022-05-11T09:52:25,Bilbao,Expense,clothing,-175.08,-25821.44
buyer_1,Luis,28,ES87209573564583313774,TRX_N-00319-578681627242,2022-05-27T08:13:45,Bilbao,Expense,food,-171.87,-25993.31
buyer_1,Luis,28,ES87209573564583313774,TRX_N-00320-223964734978,2022-05-28T08:58:04,Bilbao,Expense,transport,-49.03,-26042.34
buyer_1,Luis,28,ES87209573564583313774,TRX_N-00321-111908024717,2022-05-30T22:28:22,Bilbao,Expense,food,-218.96,-26261.3
buyer_1,Luis,28,ES87209573564583313774,TRX_N-00322-915430301943,2022-06-01T14:38:40,Bilbao,transfer,Salary,1310.41,-24950.89
buyer_1,Luis,28,ES87209573564583313774,TRX_N-00323-624819409000,2022-06-01T14:38:40,Bilbao,transfer,Bonus,1290.47,-23660.42
buyer_1,Luis,28,ES87209573564583313774,TRX_N-00324-135934958706,2022-06-05T13:48:37,Bilbao,Housing,Rent,-935.95,-24596.37
buyer_1,Luis,28,ES87209573564583313774,TRX_N-00325-28019292053,2022-06-05T08:57:16,Bilbao,Basic services,electricity,-95.11,-24691.48
buyer_1,Luis,28,ES87209573564583313774,TRX_N-00326-159361096178,2022-06-05T03:49:28,Bilbao,Basic services,internet,-47.6,-24739.08
buyer_1,Luis,28,ES87209573564583313774,TRX_N-00327-794216508720,2022-06-06T21:04:45,Bilbao,Basic services,water,-50.25,-24789.33
buyer_1,Luis,28,ES87209573564583313774,TRX_N-00328-371968870690,2022-06-06T11:51:22,Bilbao,Basic services,internet,-61.35,-24850.68
buyer_1,Luis,28,ES87209573564583313774,TRX_N-00329-701901602369,2022-06-14T21:44:16,Bilbao,Expense,transport,-186.61,-25037.29
buyer_1,Luis,28,ES87209573564583313774,TRX_N-00330-699508335478,2022-06-21T14:31:47,Arrasate/Mondragon,Expense,appliances,-1269.49,-26306.78
buyer_1,Luis,28,ES87209573564583313774,TRX_N-00331-363779155277,2022-07-01T12:08:47,Bilbao,transfer,Salary,1310.41,-24996.37
buyer_1,Luis,28,ES87209573564583313774,TRX_N-00332-205423126166,2022-07-05T10:05:07,Bilbao,Housing,Rent,-935.95,-25932.32
buyer_1,Luis,28,ES87209573564583313774,TRX_N-00333-907410637908,2022-07-05T14:18:17,Salvatierra/Agurain,Expense,leisure,-29.45,-25961.77
buyer_1,Luis,28,ES87209573564583313774,TRX_N-00334-213156578760,2022-07-06T15:14:49,Bilbao,Basic services,water,-66.28,-26028.05
buyer_1,Luis,28,ES87209573564583313774,TRX_N-00335-979347600325,2022-07-06T21:54:02,Bilbao,Basic services,electricity,-145.65,-26173.7
buyer_1,Luis,28,ES87209573564583313774,TRX_N-00336-77811555011,2022-07-06T14:36:27,Bilbao,Basic services,internet,-79.49,-26253.19
buyer_1,Luis,28,ES87209573564583313774,TRX_N-00337-213519396420,2022-07-06T11:24:45,Bilbao,Basic services,phone,-46.56,-26299.75
buyer_1,Luis,28,ES87209573564583313774,TRX_N-00338-977467403878,2022-07-07T09:38:53,Bilbao,Basic services,internet,-60.44,-26360.19
buyer_1,Luis,28,ES87209573564583313774,TRX_N-00339-897892488301,2022-07-30T08:14:46,Bilbao,Expense,leisure,-277.71,-26637.9
buyer_1,Luis,28,ES87209573564583313774,TRX_N-00340-149949322755,2022-08-01T11:24:08,Bilbao,transfer,Salary,1310.41,-25327.49
buyer_1,Luis,28,ES87209573564583313774,TRX_N-00341-595148103790,2022-08-01T11:24:08,Bilbao,transfer,Extra Income,131.04,-25196.45
buyer_1,Luis,28,ES87209573564583313774,TRX_N-00342-847677757097,2022-08-05T12:05:51,Bilbao,Housing,Rent,-935.95,-26132.4
buyer_1,Luis,28,ES87209573564583313774,TRX_N-00343-938265706454,2022-08-05T10:47:56,Bilbao,Basic services,electricity,-34.14,-26166.54
buyer_1,Luis,28,ES87209573564583313774,TRX_N-00344-233928051808,2022-08-06T17:10:42,Bilbao,Basic services,water,-16.26,-26182.8
buyer_1,Luis,28,ES87209573564583313774,TRX_N-00345-781127445034,2022-08-06T09:50:10,Bilbao,Basic services,electricity,-147.28,-26330.08
buyer_1,Luis,28,ES87209573564583313774,TRX_N-00346-426165694975,2022-08-06T20:49:40,Bilbao,Basic services,internet,-46.33,-26376.41
buyer_1,Luis,28,ES87209573564583313774,TRX_N-00347-333061031264,2022-08-11T17:03:23,Bilbao,Expense,education,-642.07,-27018.48
buyer_1,Luis,28,ES87209573564583313774,TRX_N-00348-765877603848,2022-08-20T09:48:23,Bilbao,Expense,clothing,-268.38,-27286.86
buyer_1,Luis,28,ES87209573564583313774,TRX_N-00349-257502991601,2022-08-23T19:28:16,Bilbao,Expense,food,-664.35,-27951.21
buyer_1,Luis,28,ES87209573564583313774,TRX_N-00350-692965205103,2022-09-01T11:33:09,Bilbao,transfer,Salary,1310.41,-26640.8
buyer_1,Luis,28,ES87209573564583313774,TRX_N-00351-183427806191,2022-09-05T17:22:43,Bilbao,Housing,Rent,-935.95,-27576.75
buyer_1,Luis,28,ES87209573564583313774,TRX_N-00352-250410681406,2022-09-05T12:28:36,Bilbao,Basic services,phone,-48.75,-27625.5
buyer_1,Luis,28,ES87209573564583313774,TRX_N-00353-362868091253,2022-09-06T15:59:33,Bilbao,Basic services,water,-72.71,-27698.21
buyer_1,Luis,28,ES87209573564583313774,TRX_N-00354-864660606053,2022-09-06T11:50:42,Bilbao,Basic services,electricity,-89.47,-27787.68
buyer_1,Luis,28,ES87209573564583313774,TRX_N-00355-778643371404,2022-09-06T10:43:41,Bilbao,Basic services,phone,-47.49,-27835.17
buyer_1,Luis,28,ES87209573564583313774,TRX_N-00356-473618416988,2022-09-07T08:01:21,Bilbao,Basic services,electricity,-103.34,-27938.51
buyer_1,Luis,28,ES87209573564583313774,TRX_N-00357-424190816904,2022-09-07T18:05:24,Bilbao,Basic services,gas,-19.07,-27957.58
buyer_1,Luis,28,ES87209573564583313774,TRX_N-00358-665463982983,2022-09-12T09:33:49,Oyón-Oion,Expense,leisure,-212.46,-28170.04
buyer_1,Luis,28,ES87209573564583313774,TRX_N-00359-672990533295,2022-10-01T09:49:01,Bilbao,transfer,Salary,1310.41,-26859.63
buyer_1,Luis,28,ES87209573564583313774,TRX_N-00360-797643970127,2022-10-01T20:28:20,Bilbao,Expense,healthcare,-385.03,-27244.66
buyer_1,Luis,28,ES87209573564583313774,TRX_N-00361-516798216952,2022-10-04T14:39:18,Bilbao,Expense,leisure,-97.43,-27342.09
buyer_1,Luis,28,ES87209573564583313774,TRX_N-00362-592284051093,2022-10-05T08:54:14,Bilbao,Housing,Rent,-935.95,-28278.04
buyer_1,Luis,28,ES87209573564583313774,TRX_N-00363-1757782500,2022-10-05T17:35:38,Bilbao,Basic services,water,-75.09,-28353.13
buyer_1,Luis,28,ES87209573564583313774,TRX_N-00364-557796515921,2022-10-05T17:16:14,Bilbao,Basic services,electricity,-131.14,-28484.27
buyer_1,Luis,28,ES87209573564583313774,TRX_N-00365-734526969397,2022-10-05T20:26:57,Bilbao,Basic services,phone,-40.88,-28525.15
buyer_1,Luis,28,ES87209573564583313774,TRX_N-00366-14382230404,2022-10-06T11:55:37,Bilbao,Basic services,water,-62.29,-28587.44
buyer_1,Luis,28,ES87209573564583313774,TRX_N-00367-684081287068,2022-10-06T15:35:55,Bilbao,Basic services,internet,-41.27,-28628.71
buyer_1,Luis,28,ES87209573564583313774,TRX_N-00368-228037509596,2022-10-07T10:53:53,Bilbao,Basic services,water,-69.46,-28698.17
buyer_1,Luis,28,ES87209573564583313774,TRX_N-00369-113128234270,2022-10-07T20:22:13,Bilbao,Basic services,gas,-93.22,-28791.39
buyer_1,Luis,28,ES87209573564583313774,TRX_N-00370-232825190330,2022-10-07T08:20:59,Bilbao,Basic services,internet,-39.6,-28830.99
buyer_1,Luis,28,ES87209573564583313774,TRX_N-00371-193339668431,2022-10-09T12:12:41,Bilbao,Expense,leisure,-97.98,-28928.97
buyer_1,Luis,28,ES87209573564583313774,TRX_N-00372-76218356978,2022-10-20T03:24:26,Bilbao,Expense,healthcare,-279.03,-29208.0
buyer_1,Luis,28,ES87209573564583313774,TRX_N-00373-435515502326,2022-10-26T22:39:22,Bilbao,Expense,food,-619.4,-29827.4
buyer_1,Luis,28,ES87209573564583313774,TRX_N-00374-32319489322,2022-11-01T16:02:52,Bilbao,transfer,Salary,1310.41,-28516.99
buyer_1,Luis,28,ES87209573564583313774,TRX_N-00375-101159464340,2022-11-01T16:02:52,Bilbao,transfer,Extra Income,131.04,-28385.95
buyer_1,Luis,28,ES87209573564583313774,TRX_N-00376-962538039607,2022-11-05T09:03:13,Bilbao,Housing,Rent,-935.95,-29321.9
buyer_1,Luis,28,ES87209573564583313774,TRX_N-00377-185311632912,2022-11-05T16:40:32,Bilbao,Basic services,phone,-86.77,-29408.67
buyer_1,Luis,28,ES87209573564583313774,TRX_N-00378-900170104977,2022-11-06T13:12:02,Bilbao,Basic services,water,-48.22,-29456.89
buyer_1,Luis,28,ES87209573564583313774,TRX_N-00379-834202876320,2022-11-06T14:58:33,Bilbao,Basic services,internet,-71.43,-29528.32
buyer_1,Luis,28,ES87209573564583313774,TRX_N-00380-36381892740,2022-11-07T20:25:07,Bilbao,Basic services,phone,-89.25,-29617.57
buyer_1,Luis,28,ES87209573564583313774,TRX_N-00381-975656321996,2022-11-16T18:19:41,Bilbao,Expense,transport,-186.37,-29803.94
buyer_1,Luis,28,ES87209573564583313774,TRX_N-00382-13568264842,2022-12-01T11:11:55,Bilbao,transfer,Salary,1310.41,-28493.53
buyer_1,Luis,28,ES87209573564583313774,TRX_N-00383-16994977061,2022-12-01T11:11:55,Bilbao,transfer,Bonus,1300.18,-27193.35
buyer_1,Luis,28,ES87209573564583313774,TRX_N-00384-430413828982,2022-12-05T18:11:25,Bilbao,Housing,Rent,-935.95,-28129.3
buyer_1,Luis,28,ES87209573564583313774,TRX_N-00385-890135614980,2022-12-05T14:04:56,Bilbao,Basic services,water,-42.78,-28172.08
buyer_1,Luis,28,ES87209573564583313774,TRX_N-00386-513894350104,2022-12-05T17:27:12,Bilbao,Basic services,internet,-34.08,-28206.16
buyer_1,Luis,28,ES87209573564583313774,TRX_N-00387-611919075803,2022-12-06T11:58:02,Bilbao,Basic services,gas,-35.96,-28242.12
buyer_1,Luis,28,ES87209573564583313774,TRX_N-00388-376702147897,2022-12-06T12:16:56,Bilbao,Basic services,phone,-57.68,-28299.8
buyer_1,Luis,28,ES87209573564583313774,TRX_N-00389-459473378620,2022-12-07T14:05:59,Bilbao,Basic services,gas,-90.35,-28390.15
buyer_1,Luis,28,ES87209573564583313774,TRX_N-00390-709416117018,2022-12-11T11:05:31,Bilbao,Expense,transport,-185.27,-28575.42
buyer_1,Luis,28,ES87209573564583313774,TRX_N-00391-983717878879,2022-12-20T15:02:05,Bilbao,Expense,food,-201.16,-28776.58
buyer_1,Luis,28,ES87209573564583313774,TRX_N-00392-751486065434,2022-12-23T19:49:44,Bilbao,Expense,leisure,-189.11,-28965.69
buyer_1,Luis,28,ES87209573564583313774,TRX_N-00393-379373053358,2023-01-01T08:02:41,Bilbao,transfer,Salary,1310.41,-27655.28
buyer_1,Luis,28,ES87209573564583313774,TRX_N-00394-239170762567,2023-01-01T08:02:41,Bilbao,transfer,Extra Income,131.04,-27524.24
buyer_1,Luis,28,ES87209573564583313774,TRX_N-00395-931161409058,2023-01-05T09:26:32,Bilbao,Housing,Rent,-935.95,-28460.19
buyer_1,Luis,28,ES87209573564583313774,TRX_N-00396-370351030650,2023-01-05T19:02:56,Bilbao,Basic services,gas,-24.03,-28484.22
buyer_1,Luis,28,ES87209573564583313774,TRX_N-00397-724005067348,2023-01-05T23:48:41,Bilbao,Basic services,internet,-46.79,-28531.01
buyer_1,Luis,28,ES87209573564583313774,TRX_N-00398-880515789705,2023-01-06T21:13:09,Bilbao,Basic services,electricity,-98.91,-28629.92
buyer_1,Luis,28,ES87209573564583313774,TRX_N-00399-42359772294,2023-01-06T14:27:13,Bilbao,Basic services,internet,-44.81,-28674.73
buyer_1,Luis,28,ES87209573564583313774,TRX_N-00400-204737006570,2023-01-06T09:30:05,Bilbao,Basic services,phone,-61.02,-28735.75
buyer_1,Luis,28,ES87209573564583313774,TRX_N-00401-586351499607,2023-01-07T11:50:55,Bilbao,Basic services,electricity,-133.88,-28869.63
buyer_1,Luis,28,ES87209573564583313774,TRX_N-00402-665984179129,2023-01-07T10:19:17,Bilbao,Basic services,phone,-28.68,-28898.31
buyer_1,Luis,28,ES87209573564583313774,TRX_N-00403-450236834614,2023-01-13T16:28:24,Bilbao,Expense,leisure,-214.85,-29113.16
buyer_1,Luis,28,ES87209573564583313774,TRX_N-00404-43888563559,2023-02-01T18:06:57,Bilbao,transfer,Salary,1310.41,-27802.75
buyer_1,Luis,28,ES87209573564583313774,TRX_N-00405-956324933639,2023-02-05T03:04:42,Bilbao,Housing,Rent,-935.95,-28738.7
buyer_1,Luis,28,ES87209573564583313774,TRX_N-00406-483793101626,2023-02-06T15:56:46,Bilbao,Basic services,gas,-42.93,-28781.63
buyer_1,Luis,28,ES87209573564583313774,TRX_N-00407-747954931739,2023-02-07T08:58:37,Bilbao,Basic services,water,-24.05,-28805.68
buyer_1,Luis,28,ES87209573564583313774,TRX_N-00408-285027992135,2023-02-07T15:32:38,Bilbao,Basic services,electricity,-76.18,-28881.86
buyer_1,Luis,28,ES87209573564583313774,TRX_N-00409-229971603566,2023-02-07T11:05:34,Bilbao,Basic services,gas,-41.79,-28923.65
buyer_1,Luis,28,ES87209573564583313774,TRX_N-00410-919618002938,2023-02-07T08:54:28,Bilbao,Basic services,internet,-49.46,-28973.11
buyer_1,Luis,28,ES87209573564583313774,TRX_N-00411-243672417180,2023-02-07T09:04:50,Bilbao,Basic services,phone,-31.36,-29004.47
buyer_1,Luis,28,ES87209573564583313774,TRX_N-00412-560822278109,2023-02-08T10:24:50,Bilbao,Expense,gifts,-197.22,-29201.69
buyer_1,Luis,28,ES87209573564583313774,TRX_N-00413-203805927043,2023-02-14T13:13:45,Bilbao,Expense,food,-123.25,-29324.94
buyer_1,Luis,28,ES87209573564583313774,TRX_N-00414-824283548968,2023-02-22T16:15:29,Bilbao,Expense,healthcare,-380.36,-29705.3
buyer_1,Luis,28,ES87209573564583313774,TRX_N-00415-440938240393,2023-03-01T22:12:54,Bilbao,transfer,Salary,1310.41,-28394.89
buyer_1,Luis,28,ES87209573564583313774,TRX_N-00416-232540605082,2023-03-05T12:07:43,Bilbao,Housing,Rent,-935.95,-29330.84
buyer_1,Luis,28,ES87209573564583313774,TRX_N-00417-952246707352,2023-03-05T10:43:24,Bilbao,Basic services,electricity,-124.46,-29455.3
buyer_1,Luis,28,ES87209573564583313774,TRX_N-00418-451269937477,2023-03-06T09:52:09,Bilbao,Basic services,internet,-77.32,-29532.62
buyer_1,Luis,28,ES87209573564583313774,TRX_N-00419-756059215331,2023-03-06T09:35:42,Bilbao,Basic services,phone,-80.0,-29612.62
buyer_1,Luis,28,ES87209573564583313774,TRX_N-00420-845387169602,2023-03-07T22:45:25,Bilbao,Basic services,water,-68.86,-29681.48
buyer_1,Luis,28,ES87209573564583313774,TRX_N-00421-688437444027,2023-03-07T17:24:34,Bilbao,Basic services,electricity,-123.23,-29804.71
buyer_1,Luis,28,ES87209573564583313774,TRX_N-00422-883085942147,2023-03-07T11:11:25,Bilbao,Basic services,phone,-76.01,-29880.72
buyer_1,Luis,28,ES87209573564583313774,TRX_N-00423-154498257072,2023-03-18T10:37:20,Bilbao,Expense,food,-795.3,-30676.02
buyer_1,Luis,28,ES87209573564583313774,TRX_N-00424-696288004658,2023-03-25T17:18:41,Portugalete,Expense,gifts,-276.75,-30952.77
buyer_1,Luis,28,ES87209573564583313774,TRX_N-00425-136183274444,2023-04-01T00:52:36,Bilbao,transfer,Salary,1310.41,-29642.36
buyer_1,Luis,28,ES87209573564583313774,TRX_N-00426-191644479557,2023-04-01T00:52:36,Bilbao,transfer,Extra Income,131.04,-29511.32
buyer_1,Luis,28,ES87209573564583313774,TRX_N-00427-337930511879,2023-04-01T20:09:24,Bilbao,Expense,healthcare,-363.91,-29875.23
buyer_1,Luis,28,ES87209573564583313774,TRX_N-00428-110436858154,2023-04-05T14:13:43,Bilbao,Housing,Rent,-935.95,-30811.18
buyer_1,Luis,28,ES87209573564583313774,TRX_N-00429-718514820268,2023-04-05T15:26:59,Bilbao,Basic services,electricity,-57.27,-30868.45
buyer_1,Luis,28,ES87209573564583313774,TRX_N-00430-805091365811,2023-04-05T20:46:15,Bilbao,Basic services,internet,-56.22,-30924.67
buyer_1,Luis,28,ES87209573564583313774,TRX_N-00431-820483165433,2023-04-06T16:32:45,Bilbao,Basic services,water,-70.82,-30995.49
buyer_1,Luis,28,ES87209573564583313774,TRX_N-00432-168376640520,2023-04-06T11:25:30,Bilbao,Basic services,electricity,-33.45,-31028.94
buyer_1,Luis,28,ES87209573564583313774,TRX_N-00433-568996245154,2023-04-06T09:46:06,Bilbao,Basic services,gas,-29.52,-31058.46
buyer_1,Luis,28,ES87209573564583313774,TRX_N-00434-451162234737,2023-04-06T09:33:24,Bilbao,Expense,healthcare,-202.44,-31260.9
buyer_1,Luis,28,ES87209573564583313774,TRX_N-00435-332945467934,2023-04-07T17:55:15,Bilbao,Basic services,electricity,-67.59,-31328.49
buyer_1,Luis,28,ES87209573564583313774,TRX_N-00436-365664174679,2023-04-16T16:43:38,Bilbao,Expense,food,-277.44,-31605.93
buyer_1,Luis,28,ES87209573564583313774,TRX_N-00437-341885391223,2023-05-01T16:53:49,Bilbao,transfer,Salary,1310.41,-30295.52
buyer_1,Luis,28,ES87209573564583313774,TRX_N-00438-660335045564,2023-05-05T18:56:07,Bilbao,Housing,Rent,-935.95,-31231.47
buyer_1,Luis,28,ES87209573564583313774,TRX_N-00439-523610102459,2023-05-05T10:19:48,Bilbao,Basic services,water,-56.17,-31287.64
buyer_1,Luis,28,ES87209573564583313774,TRX_N-00440-472869784953,2023-05-05T16:20:43,Bilbao,Basic services,electricity,-36.81,-31324.45
buyer_1,Luis,28,ES87209573564583313774,TRX_N-00441-259935735314,2023-05-05T14:46:31,Bilbao,Basic services,gas,-84.85,-31409.3
buyer_1,Luis,28,ES87209573564583313774,TRX_N-00442-832649322299,2023-05-05T23:14:54,Bilbao,Basic services,internet,-45.19,-31454.49
buyer_1,Luis,28,ES87209573564583313774,TRX_N-00443-904847243140,2023-05-05T09:31:46,Bilbao,Basic services,phone,-70.54,-31525.03
buyer_1,Luis,28,ES87209573564583313774,TRX_N-00444-893014131753,2023-05-06T13:26:37,Bilbao,Basic services,water,-22.97,-31548.0
buyer_1,Luis,28,ES87209573564583313774,TRX_N-00445-734010308327,2023-05-06T08:26:50,Bilbao,Basic services,gas,-68.31,-31616.31
buyer_1,Luis,28,ES87209573564583313774,TRX_N-00446-482036560615,2023-05-07T15:16:27,Bilbao,Expense,leisure,-264.3,-31880.61
buyer_1,Luis,28,ES87209573564583313774,TRX_N-00447-68998403571,2023-05-08T16:53:55,Mungia,Expense,food,-264.43,-32145.04
buyer_1,Luis,28,ES87209573564583313774,TRX_N-00448-623198494685,2023-05-12T15:51:14,Bilbao,Expense,leisure,-96.24,-32241.28
buyer_1,Luis,28,ES87209573564583313774,TRX_N-00449-389203286296,2023-05-15T19:32:33,Bilbao,Expense,leisure,-85.42,-32326.7
buyer_1,Luis,28,ES87209573564583313774,TRX_N-00450-515755145600,2023-05-20T15:40:12,Errenteria,Expense,leisure,-202.23,-32528.93
buyer_1,Luis,28,ES87209573564583313774,TRX_N-00451-419738458123,2023-05-21T08:46:43,Bilbao,Expense,travel,-325.21,-32854.14
buyer_1,Luis,28,ES87209573564583313774,TRX_N-00452-405395193269,2023-05-29T13:48:57,Mungia,Expense,healthcare,-384.23,-33238.37
buyer_1,Luis,28,ES87209573564583313774,TRX_N-00453-183671657051,2023-05-31T18:13:50,Bilbao,Expense,transport,-198.24,-33436.61
buyer_1,Luis,28,ES87209573564583313774,TRX_N-00454-72321777012,2023-06-01T12:33:35,Bilbao,transfer,Salary,1310.41,-32126.2
buyer_1,Luis,28,ES87209573564583313774,TRX_N-00455-966636313325,2023-06-01T12:33:35,Bilbao,transfer,Extra Income,131.04,-31995.16
buyer_1,Luis,28,ES87209573564583313774,TRX_N-00456-360821157749,2023-06-01T12:33:35,Bilbao,transfer,Bonus,1201.23,-30793.93
buyer_1,Luis,28,ES87209573564583313774,TRX_N-00457-109353184718,2023-06-02T22:42:19,Bilbao,Expense,food,-113.63,-30907.56
buyer_1,Luis,28,ES87209573564583313774,TRX_N-00458-962460570578,2023-06-03T20:22:52,Bilbao,Expense,transport,-77.06,-30984.62
buyer_1,Luis,28,ES87209573564583313774,TRX_N-00459-131254937665,2023-06-03T16:38:29,Bilbao,Expense,leisure,-103.72,-31088.34
buyer_1,Luis,28,ES87209573564583313774,TRX_N-00460-69347089298,2023-06-05T10:29:29,Bilbao,Housing,Rent,-935.95,-32024.29
buyer_1,Luis,28,ES87209573564583313774,TRX_N-00461-267251759917,2023-06-05T20:16:09,Bilbao,Basic services,electricity,-26.23,-32050.52
buyer_1,Luis,28,ES87209573564583313774,TRX_N-00462-5766471753,2023-06-07T20:22:53,Bilbao,Basic services,internet,-46.88,-32097.4
buyer_1,Luis,28,ES87209573564583313774,TRX_N-00463-126834414904,2023-06-11T14:38:43,Bilbao,Expense,education,-230.6,-32328.0
buyer_1,Luis,28,ES87209573564583313774,TRX_N-00464-892818515650,2023-06-13T20:38:31,Bilbao,Expense,transport,-185.5,-32513.5
buyer_1,Luis,28,ES87209573564583313774,TRX_N-00465-909418537244,2023-06-17T01:41:49,Bilbao,Expense,clothing,-92.04,-32605.54
buyer_1,Luis,28,ES87209573564583313774,TRX_N-00466-207541658693,2023-06-27T07:55:02,Bilbao,Expense,transport,-149.46,-32755.0
buyer_1,Luis,28,ES87209573564583313774,TRX_N-00467-435029617475,2023-07-01T18:22:32,Bilbao,transfer,Salary,1310.41,-31444.59
buyer_1,Luis,28,ES87209573564583313774,TRX_N-00468-58975317348,2023-07-05T06:05:40,Bilbao,Housing,Rent,-935.95,-32380.54
buyer_1,Luis,28,ES87209573564583313774,TRX_N-00469-403818850506,2023-07-05T16:20:39,Bilbao,Basic services,water,-36.35,-32416.89
buyer_1,Luis,28,ES87209573564583313774,TRX_N-00470-315521834805,2023-07-05T14:46:58,Bilbao,Basic services,gas,-56.05,-32472.94
buyer_1,Luis,28,ES87209573564583313774,TRX_N-00471-935275055685,2023-07-05T07:01:29,Bilbao,Basic services,phone,-20.21,-32493.15
buyer_1,Luis,28,ES87209573564583313774,TRX_N-00472-997250652028,2023-07-05T13:47:18,Bilbao,Expense,leisure,-12.95,-32506.1
buyer_1,Luis,28,ES87209573564583313774,TRX_N-00473-851138318301,2023-07-06T11:53:30,Bilbao,Basic services,electricity,-92.55,-32598.65
buyer_1,Luis,28,ES87209573564583313774,TRX_N-00474-570575355026,2023-07-06T13:29:40,Bilbao,Basic services,gas,-82.05,-32680.7
buyer_1,Luis,28,ES87209573564583313774,TRX_N-00475-572432711458,2023-07-06T14:51:45,Bilbao,Basic services,phone,-82.49,-32763.19
buyer_1,Luis,28,ES87209573564583313774,TRX_N-00476-624891527946,2023-07-07T19:20:01,Bilbao,Basic services,electricity,-27.72,-32790.91
buyer_1,Luis,28,ES87209573564583313774,TRX_N-00477-781005078242,2023-07-11T18:26:24,Bilbao,Expense,food,-599.75,-33390.66
buyer_1,Luis,28,ES87209573564583313774,TRX_N-00478-562519226594,2023-07-11T13:46:32,Bilbao,Expense,leisure,-299.9,-33690.56
buyer_1,Luis,28,ES87209573564583313774,TRX_N-00479-507451955009,2023-07-18T17:08:28,Bilbao,Expense,food,-340.62,-34031.18
buyer_1,Luis,28,ES87209573564583313774,TRX_N-00480-415006854776,2023-07-23T15:36:31,Santurtzi,Expense,healthcare,-302.74,-34333.92
buyer_1,Luis,28,ES87209573564583313774,TRX_N-00481-334541424219,2023-07-29T17:21:56,Bilbao,Expense,healthcare,-349.44,-34683.36
buyer_1,Luis,28,ES87209573564583313774,TRX_N-00482-265526264552,2023-08-01T01:27:53,Bilbao,transfer,Salary,1310.41,-33372.95
buyer_1,Luis,28,ES87209573564583313774,TRX_N-00483-124960983902,2023-08-05T08:47:00,Bilbao,Housing,Rent,-935.95,-34308.9
buyer_1,Luis,28,ES87209573564583313774,TRX_N-00484-884152250787,2023-08-05T19:05:24,Bilbao,Basic services,water,-70.06,-34378.96
buyer_1,Luis,28,ES87209573564583313774,TRX_N-00485-735641437848,2023-08-05T18:55:53,Bilbao,Basic services,gas,-64.25,-34443.21
buyer_1,Luis,28,ES87209573564583313774,TRX_N-00486-224781461215,2023-08-05T12:16:34,Bilbao,Basic services,phone,-24.26,-34467.47
buyer_1,Luis,28,ES87209573564583313774,TRX_N-00487-443858317294,2023-08-05T19:46:13,Bilbao,Expense,transport,-44.85,-34512.32
buyer_1,Luis,28,ES87209573564583313774,TRX_N-00488-892604242335,2023-08-06T17:50:38,Bilbao,Basic services,water,-41.01,-34553.33
buyer_1,Luis,28,ES87209573564583313774,TRX_N-00489-6919784505,2023-08-07T21:35:02,Bilbao,Basic services,water,-75.03,-34628.36
buyer_1,Luis,28,ES87209573564583313774,TRX_N-00490-584029588473,2023-08-07T09:18:44,Bilbao,Basic services,gas,-74.84,-34703.2
buyer_1,Luis,28,ES87209573564583313774,TRX_N-00491-776558003684,2023-08-07T17:23:19,Bilbao,Basic services,phone,-28.32,-34731.52
buyer_1,Luis,28,ES87209573564583313774,TRX_N-00492-346080206475,2023-08-12T15:35:35,Mungia,Expense,healthcare,-78.2,-34809.72
buyer_1,Luis,28,ES87209573564583313774,TRX_N-00493-245822486930,2023-08-13T14:09:54,Zarautz,Expense,transport,-62.78,-34872.5
buyer_1,Luis,28,ES87209573564583313774,TRX_N-00494-223486105814,2023-08-20T14:34:14,Bilbao,Expense,transport,-40.87,-34913.37
buyer_1,Luis,28,ES87209573564583313774,TRX_N-00495-322165338621,2023-08-27T12:43:13,Bilbao,Expense,clothing,-421.75,-35335.12
buyer_1,Luis,28,ES87209573564583313774,TRX_N-00496-278855630740,2023-08-28T10:28:15,Mungia,Expense,transport,-90.18,-35425.3
buyer_1,Luis,28,ES87209573564583313774,TRX_N-00497-557365997231,2023-09-01T16:31:42,Bilbao,transfer,Salary,1310.41,-34114.89
buyer_1,Luis,28,ES87209573564583313774,TRX_N-00498-907080749207,2023-09-01T16:31:42,Bilbao,transfer,Extra Income,131.04,-33983.85
buyer_1,Luis,28,ES87209573564583313774,TRX_N-00499-703476572726,2023-09-02T08:45:30,Bilbao,Expense,leisure,-264.59,-34248.44
buyer_1,Luis,28,ES87209573564583313774,TRX_N-00500-119330654015,2023-09-04T15:16:00,Bilbao,Expense,healthcare,-96.16,-34344.6
buyer_1,Luis,28,ES87209573564583313774,TRX_N-00501-98755776913,2023-09-05T15:42:59,Bilbao,Housing,Rent,-935.95,-35280.55
buyer_1,Luis,28,ES87209573564583313774,TRX_N-00502-670956712124,2023-09-05T16:27:16,Bilbao,Basic services,electricity,-107.48,-35388.03
buyer_1,Luis,28,ES87209573564583313774,TRX_N-00503-195044531896,2023-09-05T20:33:15,Bilbao,Basic services,internet,-76.92,-35464.95
buyer_1,Luis,28,ES87209573564583313774,TRX_N-00504-219964332964,2023-09-05T15:31:47,Bilbao,Basic services,phone,-52.66,-35517.61
buyer_1,Luis,28,ES87209573564583313774,TRX_N-00505-590319223672,2023-09-06T16:15:46,Bilbao,Basic services,electricity,-139.84,-35657.45
buyer_1,Luis,28,ES87209573564583313774,TRX_N-00506-998349778486,2023-09-06T19:14:55,Bilbao,Basic services,gas,-81.71,-35739.16
buyer_1,Luis,28,ES87209573564583313774,TRX_N-00507-565638678703,2023-09-06T16:40:48,Bilbao,Basic services,internet,-53.98,-35793.14
buyer_1,Luis,28,ES87209573564583313774,TRX_N-00508-215441134675,2023-09-07T22:55:51,Bilbao,Basic services,electricity,-65.04,-35858.18
buyer_1,Luis,28,ES87209573564583313774,TRX_N-00509-960508500042,2023-09-07T19:41:40,Bilbao,Basic services,phone,-70.05,-35928.23
buyer_1,Luis,28,ES87209573564583313774,TRX_N-00510-66485107587,2023-10-01T11:36:14,Bilbao,transfer,Salary,1310.41,-34617.82
buyer_1,Luis,28,ES87209573564583313774,TRX_N-00511-302852031467,2023-10-01T12:34:41,Bilbao,Expense,healthcare,-384.12,-35001.94
buyer_1,Luis,28,ES87209573564583313774,TRX_N-00512-507723047945,2023-10-05T08:27:13,Bilbao,Housing,Rent,-935.95,-35937.89
buyer_1,Luis,28,ES87209573564583313774,TRX_N-00513-806140016195,2023-10-05T22:55:13,Bilbao,Basic services,water,-72.47,-36010.36
buyer_1,Luis,28,ES87209573564583313774,TRX_N-00514-39934830405,2023-10-05T17:24:56,Bilbao,Basic services,gas,-21.12,-36031.48
buyer_1,Luis,28,ES87209573564583313774,TRX_N-00515-468290875946,2023-10-06T22:55:53,Bilbao,Basic services,water,-45.1,-36076.58
buyer_1,Luis,28,ES87209573564583313774,TRX_N-00516-612812969984,2023-10-07T16:12:05,Bilbao,Basic services,water,-64.44,-36141.02
buyer_1,Luis,28,ES87209573564583313774,TRX_N-00517-550866333242,2023-10-07T10:18:59,Bilbao,Basic services,gas,-96.67,-36237.69
buyer_1,Luis,28,ES87209573564583313774,TRX_N-00518-69425351198,2023-10-10T18:06:07,Bilbao,Expense,repairs,-471.54,-36709.23
buyer_1,Luis,28,ES87209573564583313774,TRX_N-00519-51331149055,2023-10-17T09:33:52,Bilbao,Expense,transport,-116.46,-36825.69
buyer_1,Luis,28,ES87209573564583313774,TRX_N-00520-467895840208,2023-11-01T17:59:49,Bilbao,transfer,Salary,1310.41,-35515.28
buyer_1,Luis,28,ES87209573564583313774,TRX_N-00521-100608687959,2023-11-03T07:39:59,Bilbao,Expense,transport,-165.13,-35680.41
buyer_1,Luis,28,ES87209573564583313774,TRX_N-00522-329393126227,2023-11-05T13:43:54,Bilbao,Housing,Rent,-935.95,-36616.36
buyer_1,Luis,28,ES87209573564583313774,TRX_N-00523-702564280686,2023-11-05T12:28:26,Bilbao,Basic services,gas,-47.23,-36663.59
buyer_1,Luis,28,ES87209573564583313774,TRX_N-00524-403666710820,2023-11-06T23:17:17,Bilbao,Basic services,phone,-53.46,-36717.05
buyer_1,Luis,28,ES87209573564583313774,TRX_N-00525-947607529318,2023-11-07T17:22:52,Bilbao,Basic services,water,-16.98,-36734.03
buyer_1,Luis,28,ES87209573564583313774,TRX_N-00526-569460909524,2023-11-07T09:11:35,Bilbao,Basic services,electricity,-39.26,-36773.29
buyer_1,Luis,28,ES87209573564583313774,TRX_N-00527-862196941254,2023-11-08T22:58:36,Arrasate/Mondragon,Expense,gifts,-249.2,-37022.49
buyer_1,Luis,28,ES87209573564583313774,TRX_N-00528-434394354137,2023-11-29T20:26:11,Bilbao,Expense,leisure,-27.6,-37050.09
buyer_1,Luis,28,ES87209573564583313774,TRX_N-00529-456273061136,2023-12-01T20:52:02,Bilbao,transfer,Salary,1310.41,-35739.68
buyer_1,Luis,28,ES87209573564583313774,TRX_N-00530-833004132148,2023-12-01T20:52:02,Bilbao,transfer,Extra Income,131.04,-35608.64
buyer_1,Luis,28,ES87209573564583313774,TRX_N-00531-828903899272,2023-12-01T20:52:02,Bilbao,transfer,Bonus,1256.7,-34351.94
buyer_1,Luis,28,ES87209573564583313774,TRX_N-00532-982869504656,2023-12-03T12:42:48,Getxo,Expense,transport,-193.28,-34545.22
buyer_1,Luis,28,ES87209573564583313774,TRX_N-00533-695532944561,2023-12-05T22:12:38,Bilbao,Housing,Rent,-935.95,-35481.17
buyer_1,Luis,28,ES87209573564583313774,TRX_N-00534-799928081105,2023-12-05T20:43:38,Bilbao,Basic services,internet,-53.04,-35534.21
buyer_1,Luis,28,ES87209573564583313774,TRX_N-00535-811615741898,2023-12-07T17:47:00,Bilbao,Basic services,internet,-39.84,-35574.05
buyer_1,Luis,28,ES87209573564583313774,TRX_N-00536-982841308536,2023-12-16T14:42:58,Bilbao,Expense,leisure,-185.52,-35759.57
buyer_1,Luis,28,ES87209573564583313774,TRX_N-00537-543136306389,2023-12-19T09:48:22,Bilbao,Expense,leisure,-254.88,-36014.45
buyer_1,Luis,28,ES87209573564583313774,TRX_N-00538-921741697374,2023-12-20T18:44:37,Bilbao,Expense,food,-254.61,-36269.06
buyer_1,Luis,28,ES87209573564583313774,TRX_N-00539-160790829447,2024-01-01T21:15:56,Bilbao,transfer,Salary,1310.41,-34958.65
buyer_1,Luis,28,ES87209573564583313774,TRX_N-00540-709804124417,2024-01-01T09:36:02,Bilbao,Expense,leisure,-297.23,-35255.88
buyer_1,Luis,28,ES87209573564583313774,TRX_N-00541-998944739276,2024-01-05T22:24:37,Bilbao,Housing,Rent,-935.95,-36191.83
buyer_1,Luis,28,ES87209573564583313774,TRX_N-00542-758933953661,2024-01-05T21:18:47,Bilbao,Expense,healthcare,-195.1,-36386.93
buyer_1,Luis,28,ES87209573564583313774,TRX_N-00543-117289635443,2024-01-06T08:55:24,Bilbao,Basic services,electricity,-53.89,-36440.82
buyer_1,Luis,28,ES87209573564583313774,TRX_N-00544-851761443726,2024-01-06T17:17:09,Bilbao,Basic services,gas,-98.51,-36539.33
buyer_1,Luis,28,ES87209573564583313774,TRX_N-00545-616188070260,2024-01-07T12:47:37,Bilbao,Basic services,electricity,-34.29,-36573.62
buyer_1,Luis,28,ES87209573564583313774,TRX_N-00546-408617782594,2024-01-07T11:11:30,Bilbao,Basic services,internet,-48.7,-36622.32
buyer_1,Luis,28,ES87209573564583313774,TRX_N-00547-637992963384,2024-01-07T11:50:52,Bilbao,Basic services,phone,-90.92,-36713.24
buyer_1,Luis,28,ES87209573564583313774,TRX_N-00548-29192683216,2024-01-22T20:58:04,Bilbao,Expense,transport,-165.31,-36878.55
buyer_1,Luis,28,ES87209573564583313774,TRX_N-00549-624680157851,2024-02-01T01:58:54,Bilbao,transfer,Salary,1310.41,-35568.14
buyer_1,Luis,28,ES87209573564583313774,TRX_N-00550-156854122387,2024-02-01T01:58:54,Bilbao,transfer,Extra Income,131.04,-35437.1
buyer_1,Luis,28,ES87209573564583313774,TRX_N-00551-580934676776,2024-02-03T10:30:05,Bilbao,Expense,transport,-164.09,-35601.19
buyer_1,Luis,28,ES87209573564583313774,TRX_N-00552-742437881141,2024-02-05T16:05:43,Bilbao,Housing,Rent,-935.95,-36537.14
buyer_1,Luis,28,ES87209573564583313774,TRX_N-00553-920544581558,2024-02-06T16:08:42,Bilbao,Basic services,gas,-37.83,-36574.97
buyer_1,Luis,28,ES87209573564583313774,TRX_N-00554-822400192914,2024-02-07T12:23:39,Bilbao,Basic services,electricity,-57.12,-36632.09
buyer_1,Luis,28,ES87209573564583313774,TRX_N-00555-837121325293,2024-02-07T14:38:37,Bilbao,Basic services,gas,-87.96,-36720.05
buyer_1,Luis,28,ES87209573564583313774,TRX_N-00556-517950531001,2024-02-10T13:20:26,Bilbao,Expense,leisure,-94.91,-36814.96
buyer_1,Luis,28,ES87209573564583313774,TRX_N-00557-749995433410,2024-02-16T09:28:23,Bilbao,Expense,gifts,-275.33,-37090.29
buyer_1,Luis,28,ES87209573564583313774,TRX_N-00558-232705196929,2024-02-29T22:38:02,Bilbao,Expense,transport,-165.39,-37255.68
buyer_1,Luis,28,ES87209573564583313774,TRX_N-00559-31585746543,2024-03-01T09:31:27,Bilbao,transfer,Salary,1310.41,-35945.27
buyer_1,Luis,28,ES87209573564583313774,TRX_N-00560-744430866960,2024-03-05T08:35:20,Bilbao,Housing,Rent,-935.95,-36881.22
buyer_1,Luis,28,ES87209573564583313774,TRX_N-00561-236623507145,2024-03-06T11:59:39,Bilbao,Basic services,gas,-73.04,-36954.26
buyer_1,Luis,28,ES87209573564583313774,TRX_N-00562-633584965284,2024-03-06T17:00:55,Bilbao,Expense,transport,-154.61,-37108.87
buyer_1,Luis,28,ES87209573564583313774,TRX_N-00563-740103616330,2024-03-07T20:15:07,Bilbao,Basic services,water,-73.35,-37182.22
buyer_1,Luis,28,ES87209573564583313774,TRX_N-00564-171743981914,2024-03-07T16:01:35,Bilbao,Basic services,gas,-52.53,-37234.75
buyer_1,Luis,28,ES87209573564583313774,TRX_N-00565-660000240788,2024-03-11T16:45:13,Bilbao,Expense,food,-196.29,-37431.04
buyer_1,Luis,28,ES87209573564583313774,TRX_N-00566-741340115292,2024-03-12T11:40:32,Bilbao,Expense,leisure,-24.65,-37455.69
buyer_1,Luis,28,ES87209573564583313774,TRX_N-00567-498298397296,2024-03-27T13:03:04,Bilbao,Expense,transport,-123.13,-37578.82
buyer_1,Luis,28,ES87209573564583313774,TRX_N-00568-530361977632,2024-03-31T11:34:47,Bilbao,Expense,transport,-49.13,-37627.95
buyer_1,Luis,28,ES87209573564583313774,TRX_N-00569-718209291901,2024-04-01T16:08:40,Bilbao,transfer,Salary,1310.41,-36317.54
buyer_1,Luis,28,ES87209573564583313774,TRX_N-00570-707822778040,2024-04-01T16:08:40,Bilbao,transfer,Extra Income,131.04,-36186.5
buyer_1,Luis,28,ES87209573564583313774,TRX_N-00571-137652429450,2024-04-03T11:39:42,Bilbao,Expense,leisure,-183.41,-36369.91
buyer_1,Luis,28,ES87209573564583313774,TRX_N-00572-922696223567,2024-04-05T15:02:14,Bilbao,Housing,Rent,-935.95,-37305.86
buyer_1,Luis,28,ES87209573564583313774,TRX_N-00573-363880989380,2024-04-06T12:06:45,Bilbao,Basic services,electricity,-88.59,-37394.45
buyer_1,Luis,28,ES87209573564583313774,TRX_N-00574-257056147474,2024-04-06T15:29:47,Bilbao,Expense,clothing,-121.16,-37515.61
buyer_1,Luis,28,ES87209573564583313774,TRX_N-00575-79004251241,2024-04-07T19:01:32,Bilbao,Basic services,phone,-81.7,-37597.31
buyer_1,Luis,28,ES87209573564583313774,TRX_N-00576-712584837128,2024-04-10T09:15:25,Pasaia,Expense,transport,-114.93,-37712.24
buyer_1,Luis,28,ES87209573564583313774,TRX_N-00577-904240839918,2024-04-25T12:25:55,Bilbao,Expense,gifts,-46.47,-37758.71
buyer_1,Luis,28,ES87209573564583313774,TRX_N-00578-740551556647,2024-04-26T19:25:04,Bilbao,Expense,food,-140.85,-37899.56
buyer_1,Luis,28,ES87209573564583313774,TRX_N-00579-379717479194,2024-04-26T19:55:02,Bilbao,Expense,clothing,-180.32,-38079.88
buyer_1,Luis,28,ES87209573564583313774,TRX_N-00580-159977284583,2024-04-30T08:34:51,Bilbao,Expense,transport,-73.22,-38153.1
buyer_1,Luis,28,ES87209573564583313774,TRX_N-00581-43928657096,2024-05-01T14:15:27,Bilbao,transfer,Salary,1310.41,-36842.69
buyer_1,Luis,28,ES87209573564583313774,TRX_N-00582-515929216095,2024-05-05T16:30:38,Bilbao,Housing,Rent,-935.95,-37778.64
buyer_1,Luis,28,ES87209573564583313774,TRX_N-00583-915287530430,2024-05-05T16:38:10,Bilbao,Basic services,water,-69.86,-37848.5
buyer_1,Luis,28,ES87209573564583313774,TRX_N-00584-243677202172,2024-05-06T12:50:56,Bilbao,Basic services,electricity,-45.21,-37893.71
buyer_1,Luis,28,ES87209573564583313774,TRX_N-00585-908525453448,2024-05-06T17:50:54,Bilbao,Basic services,internet,-44.62,-37938.33
buyer_1,Luis,28,ES87209573564583313774,TRX_N-00586-875277992702,2024-05-06T19:42:09,Bilbao,Basic services,phone,-42.63,-37980.96
buyer_1,Luis,28,ES87209573564583313774,TRX_N-00587-902128262377,2024-05-07T12:37:22,Bilbao,Expense,transport,-140.93,-38121.89
buyer_1,Luis,28,ES87209573564583313774,TRX_N-00588-602958516405,2024-05-11T09:44:46,Basauri,Expense,healthcare,-100.15,-38222.04
buyer_1,Luis,28,ES87209573564583313774,TRX_N-00589-770735422849,2024-05-12T22:57:08,Bilbao,Expense,transport,-28.75,-38250.79
buyer_1,Luis,28,ES87209573564583313774,TRX_N-00590-98342685305,2024-05-13T09:18:01,Bilbao,Expense,healthcare,-61.86,-38312.65
buyer_1,Luis,28,ES87209573564583313774,TRX_N-00591-693271635042,2024-05-23T12:17:29,Bilbao,Expense,healthcare,-156.81,-38469.46
buyer_1,Luis,28,ES87209573564583313774,TRX_N-00592-454077149438,2024-05-31T15:18:46,Bilbao,Expense,leisure,-273.91,-38743.37
buyer_1,Luis,28,ES87209573564583313774,TRX_N-00593-485808169699,2024-06-01T11:58:14,Bilbao,transfer,Salary,1310.41,-37432.96
buyer_1,Luis,28,ES87209573564583313774,TRX_N-00594-877605558087,2024-06-01T11:58:14,Bilbao,transfer,Extra Income,131.04,-37301.92
buyer_1,Luis,28,ES87209573564583313774,TRX_N-00595-628997789912,2024-06-01T11:58:14,Bilbao,transfer,Bonus,1237.85,-36064.07
buyer_1,Luis,28,ES87209573564583313774,TRX_N-00596-127729274149,2024-06-05T03:49:34,Bilbao,Housing,Rent,-935.95,-37000.02
buyer_1,Luis,28,ES87209573564583313774,TRX_N-00597-211752701090,2024-06-05T18:03:13,Bilbao,Basic services,electricity,-92.23,-37092.25
buyer_1,Luis,28,ES87209573564583313774,TRX_N-00598-681905421510,2024-06-06T21:55:40,Bilbao,Basic services,electricity,-138.95,-37231.2
buyer_1,Luis,28,ES87209573564583313774,TRX_N-00599-505808980040,2024-06-07T17:33:57,Bilbao,Basic services,internet,-57.14,-37288.34
buyer_1,Luis,28,ES87209573564583313774,TRX_N-00600-338822294507,2024-06-07T10:39:12,Bilbao,Basic services,phone,-22.09,-37310.43
buyer_1,Luis,28,ES87209573564583313774,TRX_N-00601-665873461595,2024-06-10T10:04:16,Bilbao,Expense,gifts,-138.62,-37449.05
buyer_1,Luis,28,ES87209573564583313774,TRX_N-00602-880940298002,2024-07-01T08:05:27,Bilbao,transfer,Salary,1310.41,-36138.64
buyer_1,Luis,28,ES87209573564583313774,TRX_N-00603-855972136236,2024-07-05T03:36:24,Bilbao,Housing,Rent,-935.95,-37074.59
buyer_1,Luis,28,ES87209573564583313774,TRX_N-00604-902915536155,2024-07-05T16:22:52,Bilbao,Basic services,electricity,-111.37,-37185.96
buyer_1,Luis,28,ES87209573564583313774,TRX_N-00605-429818914071,2024-07-05T20:46:33,Bilbao,Expense,leisure,-227.04,-37413.0
buyer_1,Luis,28,ES87209573564583313774,TRX_N-00606-432653613325,2024-07-07T09:59:16,Bilbao,Basic services,internet,-77.58,-37490.58
buyer_1,Luis,28,ES87209573564583313774,TRX_N-00607-60709697250,2024-07-20T19:14:57,Bilbao,Expense,leisure,-171.73,-37662.31
buyer_1,Luis,28,ES87209573564583313774,TRX_N-00608-532009484018,2024-07-22T17:29:12,Bilbao,Expense,transport,-160.6,-37822.91
buyer_1,Luis,28,ES87209573564583313774,TRX_N-00609-662159640991,2024-08-01T09:16:41,Bilbao,transfer,Salary,1310.41,-36512.5
buyer_1,Luis,28,ES87209573564583313774,TRX_N-00610-37028752397,2024-08-01T09:16:41,Bilbao,transfer,Extra Income,131.04,-36381.46
buyer_1,Luis,28,ES87209573564583313774,TRX_N-00611-322104756450,2024-08-02T14:49:57,Bilbao,Expense,repairs,-209.92,-36591.38
buyer_1,Luis,28,ES87209573564583313774,TRX_N-00612-732911005290,2024-08-02T16:43:10,Bilbao,Expense,gifts,-259.53,-36850.91
buyer_1,Luis,28,ES87209573564583313774,TRX_N-00613-530755097078,2024-08-05T09:27:52,Bilbao,Housing,Rent,-935.95,-37786.86
buyer_1,Luis,28,ES87209573564583313774,TRX_N-00614-990551211510,2024-08-05T09:27:34,Bilbao,Basic services,water,-51.67,-37838.53
buyer_1,Luis,28,ES87209573564583313774,TRX_N-00615-734003239914,2024-08-05T12:21:43,Bilbao,Basic services,internet,-46.66,-37885.19
buyer_1,Luis,28,ES87209573564583313774,TRX_N-00616-495510659548,2024-08-06T17:00:18,Bilbao,Basic services,water,-17.73,-37902.92
buyer_1,Luis,28,ES87209573564583313774,TRX_N-00617-710583964095,2024-08-06T12:41:41,Bilbao,Basic services,electricity,-129.91,-38032.83
buyer_1,Luis,28,ES87209573564583313774,TRX_N-00618-23871184867,2024-08-06T12:23:00,Bilbao,Basic services,gas,-72.21,-38105.04
buyer_1,Luis,28,ES87209573564583313774,TRX_N-00619-951954235900,2024-08-06T19:21:08,Bilbao,Basic services,internet,-53.16,-38158.2
buyer_1,Luis,28,ES87209573564583313774,TRX_N-00620-711313890597,2024-08-07T09:09:01,Bilbao,Basic services,water,-30.06,-38188.26
buyer_1,Luis,28,ES87209573564583313774,TRX_N-00621-899143327859,2024-08-21T16:17:45,Bilbao,Expense,transport,-69.54,-38257.8
buyer_1,Luis,28,ES87209573564583313774,TRX_N-00622-400155757103,2024-08-25T17:42:33,Bilbao,Expense,repairs,-685.11,-38942.91
buyer_1,Luis,28,ES87209573564583313774,TRX_N-00623-500985488755,2024-08-26T19:30:15,Erandio,Expense,healthcare,-229.41,-39172.32
buyer_1,Luis,28,ES87209573564583313774,TRX_N-00624-602802292357,2024-09-01T08:55:23,Bilbao,transfer,Salary,1310.41,-37861.91
buyer_1,Luis,28,ES87209573564583313774,TRX_N-00625-151084287719,2024-09-05T20:46:25,Bilbao,Housing,Rent,-935.95,-38797.86
buyer_1,Luis,28,ES87209573564583313774,TRX_N-00626-98809873252,2024-09-05T10:08:45,Bilbao,Basic services,water,-59.83,-38857.69
buyer_1,Luis,28,ES87209573564583313774,TRX_N-00627-574995137731,2024-09-05T19:58:32,Bilbao,Basic services,electricity,-107.73,-38965.42
buyer_1,Luis,28,ES87209573564583313774,TRX_N-00628-739447541981,2024-09-05T11:42:43,Bilbao,Expense,clothing,-376.5,-39341.92
buyer_1,Luis,28,ES87209573564583313774,TRX_N-00629-849447222808,2024-09-06T19:54:48,Bilbao,Basic services,internet,-62.89,-39404.81
buyer_1,Luis,28,ES87209573564583313774,TRX_N-00630-236965521970,2024-09-07T08:30:17,Bilbao,Basic services,water,-34.29,-39439.1
buyer_1,Luis,28,ES87209573564583313774,TRX_N-00631-708327206613,2024-09-07T16:06:57,Bilbao,Basic services,electricity,-105.62,-39544.72
buyer_1,Luis,28,ES87209573564583313774,TRX_N-00632-225992325750,2024-09-07T20:19:50,Bilbao,Basic services,phone,-26.34,-39571.06
buyer_1,Luis,28,ES87209573564583313774,TRX_N-00633-433486727342,2024-09-17T09:28:21,Bilbao,Expense,transport,-143.55,-39714.61
buyer_1,Luis,28,ES87209573564583313774,TRX_N-00634-285673158358,2024-09-19T08:41:21,Bilbao,Expense,leisure,-193.42,-39908.03
buyer_1,Luis,28,ES87209573564583313774,TRX_N-00635-910027926331,2024-09-22T11:20:33,Pasaia,Expense,transport,-191.66,-40099.69
buyer_1,Luis,28,ES87209573564583313774,TRX_N-00636-107400257155,2024-09-24T13:45:59,Bilbao,Expense,food,-273.99,-40373.68
buyer_1,Luis,28,ES87209573564583313774,TRX_N-00637-473328359677,2024-09-24T22:23:07,Bilbao,Expense,gifts,-390.99,-40764.67
buyer_1,Luis,28,ES87209573564583313774,TRX_N-00638-304195628904,2024-09-26T13:38:37,Bilbao,Expense,leisure,-246.47,-41011.14
buyer_1,Luis,28,ES87209573564583313774,TRX_N-00639-760696415044,2024-10-01T10:28:07,Bilbao,transfer,Salary,1310.41,-39700.73
buyer_1,Luis,28,ES87209573564583313774,TRX_N-00640-550478966317,2024-10-05T23:48:49,Bilbao,Housing,Rent,-935.95,-40636.68
buyer_1,Luis,28,ES87209573564583313774,TRX_N-00641-840838793949,2024-10-05T09:29:12,Bilbao,Basic services,electricity,-138.5,-40775.18
buyer_1,Luis,28,ES87209573564583313774,TRX_N-00642-82874167988,2024-10-05T20:45:05,Bilbao,Basic services,phone,-33.64,-40808.82
buyer_1,Luis,28,ES87209573564583313774,TRX_N-00643-541078099021,2024-10-05T15:10:59,Bilbao,Expense,transport,-73.61,-40882.43
buyer_1,Luis,28,ES87209573564583313774,TRX_N-00644-776673944376,2024-10-06T11:50:51,Bilbao,Basic services,phone,-53.81,-40936.24
buyer_1,Luis,28,ES87209573564583313774,TRX_N-00645-247838155203,2024-10-07T17:30:16,Bilbao,Basic services,internet,-48.87,-40985.11
buyer_2,Carmen,40,ES56209544069065867779,TRX_N-00001-492677901293,2020-01-01T15:01:20,Zarautz,transfer,Salary,1556.63,2388.14
buyer_2,Carmen,40,ES56209544069065867779,TRX_N-00002-558733875435,2020-01-05T13:44:00,Zarautz,Housing,Rent,-651.68,1736.46
buyer_2,Carmen,40,ES56209544069065867779,TRX_N-00003-558816970608,2020-01-05T10:31:56,Zarautz,Basic services,gas,-44.47,1691.99
buyer_2,Carmen,40,ES56209544069065867779,TRX_N-00004-265262600420,2020-01-05T09:10:08,Zarautz,Expense,leisure,-204.64,1487.35
buyer_2,Carmen,40,ES56209544069065867779,TRX_N-00005-976940568576,2020-01-06T16:12:12,Zarautz,Basic services,gas,-56.13,1431.22
buyer_2,Carmen,40,ES56209544069065867779,TRX_N-00006-19642043958,2020-01-06T12:32:49,Zarautz,Basic services,internet,-63.0,1368.22
buyer_2,Carmen,40,ES56209544069065867779,TRX_N-00007-682082637578,2020-01-07T15:32:33,Zarautz,Basic services,internet,-69.89,1298.33
buyer_2,Carmen,40,ES56209544069065867779,TRX_N-00008-273689054817,2020-01-07T16:04:22,Zarautz,Basic services,phone,-87.57,1210.76
buyer_2,Carmen,40,ES56209544069065867779,TRX_N-00009-517197679364,2020-01-16T20:40:44,Zarautz,Expense,food,-214.8,995.96
buyer_2,Carmen,40,ES56209544069065867779,TRX_N-00010-680429266055,2020-01-21T07:07:30,Zarautz,Expense,transport,-77.41,918.55
buyer_2,Carmen,40,ES56209544069065867779,TRX_N-00011-272048387068,2020-01-21T12:58:52,Zarautz,Expense,healthcare,-121.5,797.05
buyer_2,Carmen,40,ES56209544069065867779,TRX_N-00012-904775222359,2020-02-01T21:19:48,Zarautz,transfer,Salary,1556.63,2353.68
buyer_2,Carmen,40,ES56209544069065867779,TRX_N-00013-203397556516,2020-02-03T00:03:59,Mungia,Expense,education,-242.1,2111.58
buyer_2,Carmen,40,ES56209544069065867779,TRX_N-00014-536290923709,2020-02-05T07:41:45,Zarautz,Housing,Rent,-651.68,1459.9
buyer_2,Carmen,40,ES56209544069065867779,TRX_N-00015-838315620173,2020-02-05T21:42:01,Zarautz,Basic services,electricity,-114.22,1345.68
buyer_2,Carmen,40,ES56209544069065867779,TRX_N-00016-243189323874,2020-02-05T12:37:07,Zarautz,Basic services,internet,-34.38,1311.3
buyer_2,Carmen,40,ES56209544069065867779,TRX_N-00017-637656750276,2020-02-06T20:25:08,Zarautz,Basic services,water,-37.3,1274.0
buyer_2,Carmen,40,ES56209544069065867779,TRX_N-00018-9658338570,2020-02-06T16:45:49,Zarautz,Basic services,gas,-33.15,1240.85
buyer_2,Carmen,40,ES56209544069065867779,TRX_N-00019-209454604178,2020-02-07T03:03:53,Zarautz,Basic services,water,-41.45,1199.4
buyer_2,Carmen,40,ES56209544069065867779,TRX_N-00020-777147142660,2020-02-07T22:51:36,Zarautz,Basic services,internet,-58.37,1141.03
buyer_2,Carmen,40,ES56209544069065867779,TRX_N-00021-790192099827,2020-02-20T08:13:40,Zarautz,Expense,transport,-172.02,969.01
buyer_2,Carmen,40,ES56209544069065867779,TRX_N-00022-665098984084,2020-03-01T01:06:22,Zarautz,transfer,Salary,1556.63,2525.64
buyer_2,Carmen,40,ES56209544069065867779,TRX_N-00023-883948603737,2020-03-01T01:06:22,Zarautz,transfer,Extra Income,155.66,2681.3
buyer_2,Carmen,40,ES56209544069065867779,TRX_N-00024-79851461564,2020-03-05T15:31:09,Zarautz,Housing,Rent,-651.68,2029.62
buyer_2,Carmen,40,ES56209544069065867779,TRX_N-00025-985011588943,2020-03-05T12:43:49,Zarautz,Basic services,electricity,-87.31,1942.31
buyer_2,Carmen,40,ES56209544069065867779,TRX_N-00026-205249923520,2020-03-05T22:45:40,Zarautz,Basic services,phone,-55.35,1886.96
buyer_2,Carmen,40,ES56209544069065867779,TRX_N-00027-7036127400,2020-03-06T17:49:40,Zarautz,Basic services,water,-44.6,1842.36
buyer_2,Carmen,40,ES56209544069065867779,TRX_N-00028-259382436479,2020-03-06T18:50:13,Zarautz,Basic services,internet,-47.55,1794.81
buyer_2,Carmen,40,ES56209544069065867779,TRX_N-00029-500749170492,2020-03-07T14:28:43,Zarautz,Basic services,internet,-30.67,1764.14
buyer_2,Carmen,40,ES56209544069065867779,TRX_N-00030-255401870774,2020-03-10T20:26:12,Zarautz,Expense,clothing,-334.09,1430.05
buyer_2,Carmen,40,ES56209544069065867779,TRX_N-00031-461057398384,2020-03-15T19:26:44,Zarautz,Expense,leisure,-45.98,1384.07
buyer_2,Carmen,40,ES56209544069065867779,TRX_N-00032-380711166085,2020-03-18T20:40:45,Zarautz,Expense,food,-780.42,603.65
buyer_2,Carmen,40,ES56209544069065867779,TRX_N-00033-232114030237,2020-03-19T05:03:28,Zarautz,Expense,leisure,-58.19,545.46
buyer_2,Carmen,40,ES56209544069065867779,TRX_N-00034-987305424095,2020-03-28T10:11:17,Portugalete,Expense,transport,-85.59,459.87
buyer_2,Carmen,40,ES56209544069065867779,TRX_N-00035-150976046291,2020-04-01T15:51:14,Zarautz,transfer,Salary,1556.63,2016.5
buyer_2,Carmen,40,ES56209544069065867779,TRX_N-00036-472954678031,2020-04-05T10:10:25,Zarautz,Housing,Rent,-651.68,1364.82
buyer_2,Carmen,40,ES56209544069065867779,TRX_N-00037-86191381933,2020-04-05T15:17:05,Zarautz,Basic services,electricity,-47.85,1316.97
buyer_2,Carmen,40,ES56209544069065867779,TRX_N-00038-592868419743,2020-04-05T18:14:43,Zarautz,Basic services,internet,-63.15,1253.82
buyer_2,Carmen,40,ES56209544069065867779,TRX_N-00039-985434987580,2020-04-05T10:15:29,Zarautz,Basic services,phone,-81.45,1172.37
buyer_2,Carmen,40,ES56209544069065867779,TRX_N-00040-223349075660,2020-04-05T20:01:53,Zarautz,Expense,food,-233.43,938.94
buyer_2,Carmen,40,ES56209544069065867779,TRX_N-00041-101872483322,2020-04-06T23:57:46,Zarautz,Basic services,electricity,-36.72,902.22
buyer_2,Carmen,40,ES56209544069065867779,TRX_N-00042-147799671737,2020-04-06T14:50:58,Zarautz,Basic services,phone,-75.19,827.03
buyer_2,Carmen,40,ES56209544069065867779,TRX_N-00043-651508838737,2020-04-06T13:46:30,Zarautz,Expense,appliances,-768.49,58.54
buyer_2,Carmen,40,ES56209544069065867779,TRX_N-00044-943670064244,2020-04-07T15:44:40,Zarautz,Basic services,internet,-44.51,14.03
buyer_2,Carmen,40,ES56209544069065867779,TRX_N-00045-535780843769,2020-04-21T16:19:18,Zarautz,Expense,healthcare,-27.28,-13.25
buyer_2,Carmen,40,ES56209544069065867779,TRX_N-00046-668936798279,2020-05-01T14:56:54,Zarautz,transfer,Salary,1556.63,1543.38
buyer_2,Carmen,40,ES56209544069065867779,TRX_N-00047-402349290921,2020-05-05T19:27:46,Zarautz,Housing,Rent,-651.68,891.7
buyer_2,Carmen,40,ES56209544069065867779,TRX_N-00048-104058503472,2020-05-05T18:59:15,Zarautz,Basic services,gas,-47.68,844.02
buyer_2,Carmen,40,ES56209544069065867779,TRX_N-00049-960465429848,2020-05-05T09:01:20,Zarautz,Basic services,internet,-42.07,801.95
buyer_2,Carmen,40,ES56209544069065867779,TRX_N-00050-557585968458,2020-05-05T17:40:37,Zarautz,Basic services,phone,-73.19,728.76
buyer_2,Carmen,40,ES56209544069065867779,TRX_N-00051-760432380725,2020-05-07T15:52:51,Zarautz,Basic services,water,-32.14,696.62
buyer_2,Carmen,40,ES56209544069065867779,TRX_N-00052-145932895596,2020-05-12T00:31:27,Zarautz,Expense,transport,-31.21,665.41
buyer_2,Carmen,40,ES56209544069065867779,TRX_N-00053-941404221145,2020-05-17T03:31:30,Zarautz,Expense,repairs,-696.37,-30.96
buyer_2,Carmen,40,ES56209544069065867779,TRX_N-00054-205773224735,2020-06-01T15:51:47,Zarautz,transfer,Salary,1556.63,1525.67
buyer_2,Carmen,40,ES56209544069065867779,TRX_N-00055-238111587548,2020-06-01T15:51:47,Zarautz,transfer,Extra Income,155.66,1681.33
buyer_2,Carmen,40,ES56209544069065867779,TRX_N-00056-952610690,2020-06-01T15:51:47,Zarautz,transfer,Bonus,1409.83,3091.16
buyer_2,Carmen,40,ES56209544069065867779,TRX_N-00057-414898001104,2020-06-02T16:42:32,Zarautz,Expense,transport,-171.65,2919.51
buyer_2,Carmen,40,ES56209544069065867779,TRX_N-00058-970732382778,2020-06-05T12:28:15,Zarautz,Housing,Rent,-651.68,2267.83
buyer_2,Carmen,40,ES56209544069065867779,TRX_N-00059-90604567465,2020-06-05T04:53:19,Zarautz,Basic services,water,-60.31,2207.52
buyer_2,Carmen,40,ES56209544069065867779,TRX_N-00060-621076516978,2020-06-05T23:52:43,Zarautz,Basic services,electricity,-77.55,2129.97
buyer_2,Carmen,40,ES56209544069065867779,TRX_N-00061-717811705788,2020-06-05T19:33:05,Zarautz,Basic services,gas,-58.75,2071.22
buyer_2,Carmen,40,ES56209544069065867779,TRX_N-00062-602802516350,2020-06-05T14:45:17,Zarautz,Basic services,internet,-40.01,2031.21
buyer_2,Carmen,40,ES56209544069065867779,TRX_N-00063-897716097125,2020-06-06T08:04:45,Zarautz,Basic services,internet,-34.26,1996.95
buyer_2,Carmen,40,ES56209544069065867779,TRX_N-00064-944814586137,2020-06-06T14:14:54,Zarautz,Basic services,phone,-94.07,1902.88
buyer_2,Carmen,40,ES56209544069065867779,TRX_N-00065-989759032236,2020-06-07T19:01:56,Zarautz,Basic services,gas,-19.77,1883.11
buyer_2,Carmen,40,ES56209544069065867779,TRX_N-00066-34939858096,2020-06-07T12:58:40,Zarautz,Basic services,internet,-74.25,1808.86
buyer_2,Carmen,40,ES56209544069065867779,TRX_N-00067-471900199315,2020-06-07T12:53:08,Zarautz,Basic services,phone,-48.68,1760.18
buyer_2,Carmen,40,ES56209544069065867779,TRX_N-00068-197050975082,2020-06-08T08:33:37,Zarautz,Expense,food,-670.53,1089.65
buyer_2,Carmen,40,ES56209544069065867779,TRX_N-00069-139731724760,2020-06-12T11:09:21,Zarautz,Expense,travel,-2760.58,-1670.93
buyer_2,Carmen,40,ES56209544069065867779,TRX_N-00070-643267558842,2020-06-17T11:41:15,Zarautz,Expense,leisure,-181.42,-1852.35
buyer_2,Carmen,40,ES56209544069065867779,TRX_N-00071-61955798091,2020-06-19T17:31:15,Zarautz,Expense,healthcare,-212.05,-2064.4
buyer_2,Carmen,40,ES56209544069065867779,TRX_N-00072-412508614191,2020-07-01T16:07:22,Zarautz,transfer,Salary,1556.63,-507.77
buyer_2,Carmen,40,ES56209544069065867779,TRX_N-00073-924891970231,2020-07-05T12:49:38,Zarautz,Housing,Rent,-651.68,-1159.45
buyer_2,Carmen,40,ES56209544069065867779,TRX_N-00074-851038275005,2020-07-05T17:38:39,Zarautz,Basic services,water,-78.16,-1237.61
buyer_2,Carmen,40,ES56209544069065867779,TRX_N-00075-834404535937,2020-07-05T20:48:55,Zarautz,Basic services,electricity,-27.96,-1265.57
buyer_2,Carmen,40,ES56209544069065867779,TRX_N-00076-154826911931,2020-07-05T16:08:11,Zarautz,Basic services,phone,-75.06,-1340.63
buyer_2,Carmen,40,ES56209544069065867779,TRX_N-00077-542598608113,2020-07-06T13:42:23,Zarautz,Basic services,water,-56.66,-1397.29
buyer_2,Carmen,40,ES56209544069065867779,TRX_N-00078-734916424554,2020-07-06T16:09:22,Zarautz,Basic services,electricity,-134.7,-1531.99
buyer_2,Carmen,40,ES56209544069065867779,TRX_N-00079-869593332782,2020-07-13T18:55:48,Zarautz,Expense,healthcare,-37.37,-1569.36
buyer_2,Carmen,40,ES56209544069065867779,TRX_N-00080-140569459431,2020-07-14T09:27:19,Zarautz,Expense,food,-436.02,-2005.38
buyer_2,Carmen,40,ES56209544069065867779,TRX_N-00081-575951122643,2020-08-01T20:18:41,Zarautz,transfer,Salary,1556.63,-448.75
buyer_2,Carmen,40,ES56209544069065867779,TRX_N-00082-208959054400,2020-08-05T13:41:03,Zarautz,Housing,Rent,-651.68,-1100.43
buyer_2,Carmen,40,ES56209544069065867779,TRX_N-00083-517042024934,2020-08-05T19:26:05,Zarautz,Basic services,electricity,-133.95,-1234.38
buyer_2,Carmen,40,ES56209544069065867779,TRX_N-00084-401696251052,2020-08-06T11:08:53,Zarautz,Basic services,water,-26.93,-1261.31
buyer_2,Carmen,40,ES56209544069065867779,TRX_N-00085-676699491515,2020-08-06T17:31:03,Zarautz,Basic services,internet,-68.22,-1329.53
buyer_2,Carmen,40,ES56209544069065867779,TRX_N-00086-594174583516,2020-08-06T11:56:45,Zarautz,Basic services,phone,-99.98,-1429.51
buyer_2,Carmen,40,ES56209544069065867779,TRX_N-00087-920381025421,2020-08-07T19:54:53,Zarautz,Basic services,water,-43.31,-1472.82
buyer_2,Carmen,40,ES56209544069065867779,TRX_N-00088-886858883680,2020-08-08T17:16:07,Zarautz,Expense,education,-349.79,-1822.61
buyer_2,Carmen,40,ES56209544069065867779,TRX_N-00089-949557695412,2020-08-15T09:36:44,Zarautz,Expense,transport,-160.83,-1983.44
buyer_2,Carmen,40,ES56209544069065867779,TRX_N-00090-889569279736,2020-08-24T05:42:17,Zarautz,Expense,transport,-190.21,-2173.65
buyer_2,Carmen,40,ES56209544069065867779,TRX_N-00091-116813021244,2020-08-25T12:53:14,Lasarte-Oria,Expense,food,-128.53,-2302.18
buyer_2,Carmen,40,ES56209544069065867779,TRX_N-00092-746173071402,2020-09-01T17:26:17,Zarautz,transfer,Salary,1556.63,-745.55
buyer_2,Carmen,40,ES56209544069065867779,TRX_N-00093-566198342948,2020-09-01T17:26:17,Zarautz,transfer,Extra Income,155.66,-589.89
buyer_2,Carmen,40,ES56209544069065867779,TRX_N-00094-773137698558,2020-09-05T05:14:44,Zarautz,Housing,Rent,-651.68,-1241.57
buyer_2,Carmen,40,ES56209544069065867779,TRX_N-00095-721056312718,2020-09-05T12:57:56,Zarautz,Basic services,electricity,-26.88,-1268.45
buyer_2,Carmen,40,ES56209544069065867779,TRX_N-00096-250894788614,2020-09-05T20:22:39,Zarautz,Basic services,gas,-36.74,-1305.19
buyer_2,Carmen,40,ES56209544069065867779,TRX_N-00097-534905394688,2020-09-06T18:02:58,Zarautz,Basic services,electricity,-86.09,-1391.28
buyer_2,Carmen,40,ES56209544069065867779,TRX_N-00098-435518387310,2020-09-06T22:47:37,Zarautz,Basic services,internet,-62.94,-1454.22
buyer_2,Carmen,40,ES56209544069065867779,TRX_N-00099-600257070149,2020-09-07T16:23:28,Zarautz,Basic services,electricity,-51.04,-1505.26
buyer_2,Carmen,40,ES56209544069065867779,TRX_N-00100-389900319589,2020-09-07T09:23:22,Zarautz,Basic services,internet,-71.6,-1576.86
buyer_2,Carmen,40,ES56209544069065867779,TRX_N-00101-766562004789,2020-09-07T20:00:33,Zarautz,Basic services,phone,-47.02,-1623.88
buyer_2,Carmen,40,ES56209544069065867779,TRX_N-00102-644495817457,2020-09-19T10:06:36,Zarautz,Expense,gifts,-61.76,-1685.64
buyer_2,Carmen,40,ES56209544069065867779,TRX_N-00103-588453791708,2020-09-20T18:18:37,Zarautz,Expense,transport,-113.14,-1798.78
buyer_2,Carmen,40,ES56209544069065867779,TRX_N-00104-66990180480,2020-09-28T15:46:43,Zarautz,Expense,transport,-169.28,-1968.06
buyer_2,Carmen,40,ES56209544069065867779,TRX_N-00105-89736496075,2020-10-01T14:45:10,Zarautz,transfer,Salary,1556.63,-411.43
buyer_2,Carmen,40,ES56209544069065867779,TRX_N-00106-895458714757,2020-10-05T19:14:11,Zarautz,Housing,Rent,-651.68,-1063.11
buyer_2,Carmen,40,ES56209544069065867779,TRX_N-00107-221047251697,2020-10-05T17:57:19,Zarautz,Basic services,water,-29.97,-1093.08
buyer_2,Carmen,40,ES56209544069065867779,TRX_N-00108-64869270705,2020-10-06T20:14:12,Zarautz,Basic services,electricity,-32.08,-1125.16
buyer_2,Carmen,40,ES56209544069065867779,TRX_N-00109-547179465039,2020-10-07T15:27:16,Zarautz,Basic services,water,-37.33,-1162.49
buyer_2,Carmen,40,ES56209544069065867779,TRX_N-00110-953692947631,2020-10-07T20:10:05,Zarautz,Expense,leisure,-136.57,-1299.06
buyer_2,Carmen,40,ES56209544069065867779,TRX_N-00111-145039522936,2020-10-07T11:42:19,Hernani,Expense,travel,-2997.25,-4296.31
buyer_2,Carmen,40,ES56209544069065867779,TRX_N-00112-32622668372,2020-10-07T13:06:35,Zarautz,Expense,gifts,-123.24,-4419.55
buyer_2,Carmen,40,ES56209544069065867779,TRX_N-00113-423058426942,2020-10-11T16:22:47,Zarautz,Expense,leisure,-173.62,-4593.17
buyer_2,Carmen,40,ES56209544069065867779,TRX_N-00114-134081084450,2020-10-13T17:16:55,Zarautz,Expense,travel,-2969.34,-7562.51
buyer_2,Carmen,40,ES56209544069065867779,TRX_N-00115-590504990324,2020-10-26T17:21:49,Zarautz,Expense,transport,-89.25,-7651.76
buyer_2,Carmen,40,ES56209544069065867779,TRX_N-00116-435785726135,2020-11-01T00:41:05,Zarautz,transfer,Salary,1556.63,-6095.13
buyer_2,Carmen,40,ES56209544069065867779,TRX_N-00117-330711394737,2020-11-01T00:41:05,Zarautz,transfer,Extra Income,155.66,-5939.47
buyer_2,Carmen,40,ES56209544069065867779,TRX_N-00118-742366811817,2020-11-01T12:18:50,Erandio,Expense,education,-878.94,-6818.41
buyer_2,Carmen,40,ES56209544069065867779,TRX_N-00119-580528644181,2020-11-03T15:25:30,Zarautz,Expense,food,-208.45,-7026.86
buyer_2,Carmen,40,ES56209544069065867779,TRX_N-00120-950059647332,2020-11-05T15:49:56,Zarautz,Housing,Rent,-651.68,-7678.54
buyer_2,Carmen,40,ES56209544069065867779,TRX_N-00121-158421075558,2020-11-05T10:15:28,Zarautz,Basic services,internet,-42.11,-7720.65
buyer_2,Carmen,40,ES56209544069065867779,TRX_N-00122-745526052783,2020-11-05T10:32:55,Zarautz,Basic services,phone,-29.44,-7750.09
buyer_2,Carmen,40,ES56209544069065867779,TRX_N-00123-571883844482,2020-11-07T08:22:57,Zarautz,Basic services,water,-72.15,-7822.24
buyer_2,Carmen,40,ES56209544069065867779,TRX_N-00124-901841953006,2020-11-07T16:16:05,Zarautz,Basic services,gas,-28.78,-7851.02
buyer_2,Carmen,40,ES56209544069065867779,TRX_N-00125-41200119938,2020-11-08T19:10:31,Errenteria,Expense,transport,-118.22,-7969.24
buyer_2,Carmen,40,ES56209544069065867779,TRX_N-00126-943137369167,2020-11-08T18:16:59,Errenteria,Expense,gifts,-264.25,-8233.49
buyer_2,Carmen,40,ES56209544069065867779,TRX_N-00127-694554821726,2020-11-14T13:16:25,Zarautz,Expense,travel,-1508.48,-9741.97
buyer_2,Carmen,40,ES56209544069065867779,TRX_N-00128-324317704408,2020-11-15T19:38:29,Zarautz,Expense,leisure,-298.88,-10040.85
buyer_2,Carmen,40,ES56209544069065867779,TRX_N-00129-145958127166,2020-12-01T00:03:25,Zarautz,transfer,Salary,1556.63,-8484.22
buyer_2,Carmen,40,ES56209544069065867779,TRX_N-00130-330445711838,2020-12-01T00:03:25,Zarautz,transfer,Bonus,1595.71,-6888.51
buyer_2,Carmen,40,ES56209544069065867779,TRX_N-00131-647251444500,2020-12-05T08:23:03,Zarautz,Housing,Rent,-651.68,-7540.19
buyer_2,Carmen,40,ES56209544069065867779,TRX_N-00132-187712677302,2020-12-05T15:11:28,Zarautz,Basic services,water,-73.54,-7613.73
buyer_2,Carmen,40,ES56209544069065867779,TRX_N-00133-602181961376,2020-12-05T09:34:57,Zarautz,Basic services,electricity,-22.83,-7636.56
buyer_2,Carmen,40,ES56209544069065867779,TRX_N-00134-222741455720,2020-12-06T16:16:56,Zarautz,Basic services,water,-34.4,-7670.96
buyer_2,Carmen,40,ES56209544069065867779,TRX_N-00135-268998453614,2020-12-06T15:44:13,Zarautz,Basic services,phone,-96.81,-7767.77
buyer_2,Carmen,40,ES56209544069065867779,TRX_N-00136-597771728189,2020-12-07T12:17:07,Zarautz,Basic services,internet,-58.43,-7826.2
buyer_2,Carmen,40,ES56209544069065867779,TRX_N-00137-873586115894,2020-12-07T19:32:26,Zarautz,Basic services,phone,-98.95,-7925.15
buyer_2,Carmen,40,ES56209544069065867779,TRX_N-00138-351559676184,2020-12-07T20:10:14,Arrasate/Mondragon,Expense,food,-705.32,-8630.47
buyer_2,Carmen,40,ES56209544069065867779,TRX_N-00139-742546739611,2020-12-17T18:09:40,Hernani,Expense,gifts,-298.59,-8929.06
buyer_2,Carmen,40,ES56209544069065867779,TRX_N-00140-67161346832,2020-12-18T10:25:37,Zarautz,Expense,food,-621.48,-9550.54
buyer_2,Carmen,40,ES56209544069065867779,TRX_N-00141-112572430979,2021-01-01T14:04:01,Zarautz,transfer,Salary,1556.63,-7993.91
buyer_2,Carmen,40,ES56209544069065867779,TRX_N-00142-843872076270,2021-01-01T14:04:01,Zarautz,transfer,Extra Income,155.66,-7838.25
buyer_2,Carmen,40,ES56209544069065867779,TRX_N-00143-629658709207,2021-01-05T13:54:36,Zarautz,Housing,Rent,-651.68,-8489.93
buyer_2,Carmen,40,ES56209544069065867779,TRX_N-00144-344615703882,2021-01-06T19:58:54,Zarautz,Basic services,internet,-74.75,-8564.68
buyer_2,Carmen,40,ES56209544069065867779,TRX_N-00145-66048978683,2021-01-07T09:25:23,Zarautz,Basic services,internet,-45.24,-8609.92
buyer_2,Carmen,40,ES56209544069065867779,TRX_N-00146-934345586415,2021-01-07T18:52:18,Zarautz,Expense,transport,-97.03,-8706.95
buyer_2,Carmen,40,ES56209544069065867779,TRX_N-00147-600177270727,2021-01-08T08:19:16,Zarautz,Expense,clothing,-108.97,-8815.92
buyer_2,Carmen,40,ES56209544069065867779,TRX_N-00148-176933276199,2021-01-11T10:00:58,Zarautz,Expense,food,-504.37,-9320.29
buyer_2,Carmen,40,ES56209544069065867779,TRX_N-00149-155255401972,2021-01-29T19:44:19,Zarautz,Expense,transport,-146.72,-9467.01
buyer_2,Carmen,40,ES56209544069065867779,TRX_N-00150-692324580655,2021-02-01T15:42:22,Zarautz,transfer,Salary,1556.63,-7910.38
buyer_2,Carmen,40,ES56209544069065867779,TRX_N-00151-878174657856,2021-02-05T22:32:55,Zarautz,Housing,Rent,-651.68,-8562.06
buyer_2,Carmen,40,ES56209544069065867779,TRX_N-00152-80874983513,2021-02-06T17:58:05,Zarautz,Basic services,water,-34.6,-8596.66
buyer_2,Carmen,40,ES56209544069065867779,TRX_N-00153-916964043643,2021-02-06T21:18:50,Zarautz,Basic services,electricity,-90.9,-8687.56
buyer_2,Carmen,40,ES56209544069065867779,TRX_N-00154-883715366573,2021-02-06T08:37:26,Zarautz,Basic services,phone,-68.05,-8755.61
buyer_2,Carmen,40,ES56209544069065867779,TRX_N-00155-907612000672,2021-02-07T13:26:56,Zarautz,Basic services,water,-63.94,-8819.55
buyer_2,Carmen,40,ES56209544069065867779,TRX_N-00156-137850288642,2021-02-07T12:43:44,Zarautz,Basic services,electricity,-44.35,-8863.9
buyer_2,Carmen,40,ES56209544069065867779,TRX_N-00157-874354953392,2021-02-07T01:38:30,Zarautz,Basic services,internet,-47.84,-8911.74
buyer_2,Carmen,40,ES56209544069065867779,TRX_N-00158-165531228515,2021-02-08T19:28:42,Zarautz,Expense,transport,-189.16,-9100.9
buyer_2,Carmen,40,ES56209544069065867779,TRX_N-00159-725243692783,2021-02-09T11:14:59,Zarautz,Expense,food,-455.02,-9555.92
buyer_2,Carmen,40,ES56209544069065867779,TRX_N-00160-187522011931,2021-02-17T06:33:06,Alegría-Dulantzi,Expense,leisure,-116.77,-9672.69
buyer_2,Carmen,40,ES56209544069065867779,TRX_N-00161-834028886110,2021-02-21T18:10:13,Zarautz,Expense,food,-237.22,-9909.91
buyer_2,Carmen,40,ES56209544069065867779,TRX_N-00162-210660661928,2021-03-01T12:14:56,Zarautz,transfer,Salary,1556.63,-8353.28
buyer_2,Carmen,40,ES56209544069065867779,TRX_N-00163-854297693607,2021-03-05T00:32:18,Zarautz,Housing,Rent,-651.68,-9004.96
buyer_2,Carmen,40,ES56209544069065867779,TRX_N-00164-929232338565,2021-03-05T17:12:13,Zarautz,Basic services,water,-46.14,-9051.1
buyer_2,Carmen,40,ES56209544069065867779,TRX_N-00165-755113019870,2021-03-05T12:26:24,Zarautz,Basic services,gas,-49.88,-9100.98
buyer_2,Carmen,40,ES56209544069065867779,TRX_N-00166-771546361103,2021-03-05T18:02:20,Zarautz,Basic services,phone,-91.51,-9192.49
buyer_2,Carmen,40,ES56209544069065867779,TRX_N-00167-162737736048,2021-03-06T10:48:00,Zarautz,Basic services,water,-30.39,-9222.88
buyer_2,Carmen,40,ES56209544069065867779,TRX_N-00168-172050785051,2021-03-06T09:57:39,Zarautz,Basic services,internet,-32.49,-9255.37
buyer_2,Carmen,40,ES56209544069065867779,TRX_N-00169-763886536129,2021-03-06T15:41:53,Zarautz,Basic services,phone,-85.21,-9340.58
buyer_2,Carmen,40,ES56209544069065867779,TRX_N-00170-711518229500,2021-03-06T13:58:39,Zarautz,Expense,food,-733.91,-10074.49
buyer_2,Carmen,40,ES56209544069065867779,TRX_N-00171-246235663523,2021-03-07T14:26:18,Zarautz,Basic services,internet,-49.02,-10123.51
buyer_2,Carmen,40,ES56209544069065867779,TRX_N-00172-101002303360,2021-03-12T15:10:39,Galdakao,Expense,food,-484.26,-10607.77
buyer_2,Carmen,40,ES56209544069065867779,TRX_N-00173-315113280696,2021-03-15T08:09:55,Zarautz,Expense,transport,-158.28,-10766.05
buyer_2,Carmen,40,ES56209544069065867779,TRX_N-00174-858321451607,2021-03-15T19:28:49,Zarautz,Expense,education,-111.8,-10877.85
buyer_2,Carmen,40,ES56209544069065867779,TRX_N-00175-846068634053,2021-03-18T18:15:35,Vitoria-Gasteiz,Expense,clothing,-125.78,-11003.63
buyer_2,Carmen,40,ES56209544069065867779,TRX_N-00176-160386797696,2021-03-25T09:37:05,Zarautz,Expense,education,-653.68,-11657.31
buyer_2,Carmen,40,ES56209544069065867779,TRX_N-00177-919737166494,2021-03-30T10:07:50,Zarautz,Expense,transport,-75.8,-11733.11
buyer_2,Carmen,40,ES56209544069065867779,TRX_N-00178-771684210541,2021-04-01T19:06:14,Zarautz,transfer,Salary,1556.63,-10176.48
buyer_2,Carmen,40,ES56209544069065867779,TRX_N-00179-551363765171,2021-04-01T19:06:14,Zarautz,transfer,Extra Income,155.66,-10020.82
buyer_2,Carmen,40,ES56209544069065867779,TRX_N-00180-579483291216,2021-04-05T13:44:59,Zarautz,Housing,Rent,-651.68,-10672.5
buyer_2,Carmen,40,ES56209544069065867779,TRX_N-00181-735963730319,2021-04-05T20:42:20,Zarautz,Basic services,internet,-68.06,-10740.56
buyer_2,Carmen,40,ES56209544069065867779,TRX_N-00182-438917568751,2021-04-06T19:35:44,Zarautz,Basic services,internet,-41.57,-10782.13
buyer_2,Carmen,40,ES56209544069065867779,TRX_N-00183-65165581154,2021-04-07T21:23:16,Zarautz,Basic services,internet,-61.14,-10843.27
buyer_2,Carmen,40,ES56209544069065867779,TRX_N-00184-539743713983,2021-04-25T15:11:07,Zarautz,Expense,appliances,-578.22,-11421.49
buyer_2,Carmen,40,ES56209544069065867779,TRX_N-00185-487765934901,2021-05-01T20:29:25,Zarautz,transfer,Salary,1556.63,-9864.86
buyer_2,Carmen,40,ES56209544069065867779,TRX_N-00186-233561672735,2021-05-05T14:47:34,Zarautz,Housing,Rent,-651.68,-10516.54
buyer_2,Carmen,40,ES56209544069065867779,TRX_N-00187-947147033363,2021-05-05T10:18:29,Zarautz,Basic services,gas,-92.7,-10609.24
buyer_2,Carmen,40,ES56209544069065867779,TRX_N-00188-29576316410,2021-05-06T20:20:52,Zarautz,Basic services,electricity,-90.06,-10699.3
buyer_2,Carmen,40,ES56209544069065867779,TRX_N-00189-330707533176,2021-05-06T11:21:15,Zarautz,Basic services,gas,-54.53,-10753.83
buyer_2,Carmen,40,ES56209544069065867779,TRX_N-00190-505140495130,2021-05-06T05:27:51,Zarautz,Basic services,phone,-47.2,-10801.03
buyer_2,Carmen,40,ES56209544069065867779,TRX_N-00191-92079233207,2021-05-07T11:29:58,Zarautz,Basic services,electricity,-75.18,-10876.21
buyer_2,Carmen,40,ES56209544069065867779,TRX_N-00192-338132666752,2021-05-07T10:07:39,Zarautz,Basic services,gas,-72.64,-10948.85
buyer_2,Carmen,40,ES56209544069065867779,TRX_N-00193-40186207484,2021-05-07T18:15:21,Zarautz,Basic services,phone,-90.32,-11039.17
buyer_2,Carmen,40,ES56209544069065867779,TRX_N-00194-633209361700,2021-05-10T18:00:15,Bermeo,Expense,food,-102.01,-11141.18
buyer_2,Carmen,40,ES56209544069065867779,TRX_N-00195-550893067457,2021-05-13T12:56:19,Zarautz,Expense,transport,-71.97,-11213.15
buyer_2,Carmen,40,ES56209544069065867779,TRX_N-00196-409428552605,2021-05-15T16:35:50,Vitoria-Gasteiz,Expense,food,-163.01,-11376.16
buyer_2,Carmen,40,ES56209544069065867779,TRX_N-00197-624897324257,2021-05-17T15:09:30,Zarautz,Expense,transport,-82.08,-11458.24
buyer_2,Carmen,40,ES56209544069065867779,TRX_N-00198-778393452959,2021-05-21T09:56:36,Zarautz,Expense,food,-728.39,-12186.63
buyer_2,Carmen,40,ES56209544069065867779,TRX_N-00199-160640204630,2021-05-29T23:52:31,Vitoria-Gasteiz,Expense,education,-248.89,-12435.52
buyer_2,Carmen,40,ES56209544069065867779,TRX_N-00200-336479770708,2021-06-01T09:13:21,Zarautz,transfer,Salary,1556.63,-10878.89
buyer_2,Carmen,40,ES56209544069065867779,TRX_N-00201-435735686561,2021-06-01T09:13:21,Zarautz,transfer,Extra Income,155.66,-10723.23
buyer_2,Carmen,40,ES56209544069065867779,TRX_N-00202-28384401343,2021-06-01T09:13:21,Zarautz,transfer,Bonus,1664.39,-9058.84
buyer_2,Carmen,40,ES56209544069065867779,TRX_N-00203-322070464018,2021-06-05T18:06:09,Zarautz,Housing,Rent,-651.68,-9710.52
buyer_2,Carmen,40,ES56209544069065867779,TRX_N-00204-63702390663,2021-06-05T10:15:52,Zarautz,Basic services,water,-61.61,-9772.13
buyer_2,Carmen,40,ES56209544069065867779,TRX_N-00205-954354749386,2021-06-05T22:10:13,Zarautz,Basic services,electricity,-65.56,-9837.69
buyer_2,Carmen,40,ES56209544069065867779,TRX_N-00206-174699078484,2021-06-05T18:14:32,Zarautz,Basic services,gas,-15.35,-9853.04
buyer_2,Carmen,40,ES56209544069065867779,TRX_N-00207-997671822090,2021-06-05T12:59:12,Zarautz,Basic services,internet,-78.52,-9931.56
buyer_2,Carmen,40,ES56209544069065867779,TRX_N-00208-646245268372,2021-06-06T11:57:01,Zarautz,Basic services,electricity,-141.87,-10073.43
buyer_2,Carmen,40,ES56209544069065867779,TRX_N-00209-316712651594,2021-06-06T19:40:54,Zarautz,Basic services,internet,-59.68,-10133.11
buyer_2,Carmen,40,ES56209544069065867779,TRX_N-00210-850067923485,2021-06-07T18:39:54,Zarautz,Basic services,internet,-76.62,-10209.73
buyer_2,Carmen,40,ES56209544069065867779,TRX_N-00211-185182889652,2021-06-07T20:43:41,Zarautz,Expense,food,-373.75,-10583.48
buyer_2,Carmen,40,ES56209544069065867779,TRX_N-00212-662341212429,2021-06-09T19:31:08,Zarautz,Expense,food,-138.75,-10722.23
buyer_2,Carmen,40,ES56209544069065867779,TRX_N-00213-985769325796,2021-06-10T19:27:08,Zarautz,Expense,clothing,-124.04,-10846.27
buyer_2,Carmen,40,ES56209544069065867779,TRX_N-00214-591931814841,2021-06-11T14:17:41,Andoain,Expense,leisure,-268.66,-11114.93
buyer_2,Carmen,40,ES56209544069065867779,TRX_N-00215-525261368396,2021-06-13T09:39:53,Zarautz,Expense,transport,-35.29,-11150.22
buyer_2,Carmen,40,ES56209544069065867779,TRX_N-00216-401357366374,2021-07-01T08:58:42,Zarautz,transfer,Salary,1556.63,-9593.59
buyer_2,Carmen,40,ES56209544069065867779,TRX_N-00217-889922851571,2021-07-05T21:24:00,Zarautz,Housing,Rent,-651.68,-10245.27
buyer_2,Carmen,40,ES56209544069065867779,TRX_N-00218-388877421304,2021-07-05T19:44:36,Zarautz,Basic services,water,-29.4,-10274.67
buyer_2,Carmen,40,ES56209544069065867779,TRX_N-00219-116440547211,2021-07-05T10:55:07,Zarautz,Basic services,gas,-58.21,-10332.88
buyer_2,Carmen,40,ES56209544069065867779,TRX_N-00220-681543878071,2021-07-05T16:51:54,Zarautz,Basic services,internet,-39.02,-10371.9
buyer_2,Carmen,40,ES56209544069065867779,TRX_N-00221-236317496044,2021-07-06T13:48:28,Zarautz,Basic services,electricity,-39.42,-10411.32
buyer_2,Carmen,40,ES56209544069065867779,TRX_N-00222-820573358998,2021-07-06T13:37:49,Zarautz,Basic services,gas,-46.81,-10458.13
buyer_2,Carmen,40,ES56209544069065867779,TRX_N-00223-506165128691,2021-07-06T10:15:59,Zarautz,Basic services,phone,-98.77,-10556.9
buyer_2,Carmen,40,ES56209544069065867779,TRX_N-00224-612776611544,2021-07-07T10:16:13,Zarautz,Basic services,internet,-32.07,-10588.97
buyer_2,Carmen,40,ES56209544069065867779,TRX_N-00225-937422601290,2021-07-07T08:09:55,Zarautz,Basic services,phone,-77.59,-10666.56
buyer_2,Carmen,40,ES56209544069065867779,TRX_N-00226-529204911791,2021-07-18T19:20:43,Zarautz,Expense,healthcare,-166.52,-10833.08
buyer_2,Carmen,40,ES56209544069065867779,TRX_N-00227-301698781729,2021-07-28T14:11:56,Zarautz,Expense,transport,-160.83,-10993.91
buyer_2,Carmen,40,ES56209544069065867779,TRX_N-00228-860563223224,2021-07-29T18:41:29,Zarautz,Expense,food,-424.71,-11418.62
buyer_2,Carmen,40,ES56209544069065867779,TRX_N-00229-567800000489,2021-07-29T12:06:29,Santurtzi,Expense,clothing,-78.68,-11497.3
buyer_2,Carmen,40,ES56209544069065867779,TRX_N-00230-512345813521,2021-08-01T12:50:15,Zarautz,transfer,Salary,1556.63,-9940.67
buyer_2,Carmen,40,ES56209544069065867779,TRX_N-00231-165693336982,2021-08-01T12:50:15,Zarautz,transfer,Extra Income,155.66,-9785.01
buyer_2,Carmen,40,ES56209544069065867779,TRX_N-00232-710613004542,2021-08-05T11:03:10,Zarautz,Housing,Rent,-651.68,-10436.69
buyer_2,Carmen,40,ES56209544069065867779,TRX_N-00233-627899731464,2021-08-05T20:07:51,Zarautz,Basic services,internet,-46.17,-10482.86
buyer_2,Carmen,40,ES56209544069065867779,TRX_N-00234-242332498333,2021-08-07T19:25:32,Zarautz,Basic services,water,-31.46,-10514.32
buyer_2,Carmen,40,ES56209544069065867779,TRX_N-00235-290794872643,2021-08-07T11:35:25,Zarautz,Basic services,gas,-33.96,-10548.28
buyer_2,Carmen,40,ES56209544069065867779,TRX_N-00236-840386041693,2021-08-21T10:40:01,Zarautz,Expense,gifts,-172.46,-10720.74
buyer_2,Carmen,40,ES56209544069065867779,TRX_N-00237-521051492557,2021-08-29T20:50:08,Zarautz,Expense,healthcare,-273.11,-10993.85
buyer_2,Carmen,40,ES56209544069065867779,TRX_N-00238-199815837297,2021-09-01T11:58:46,Zarautz,transfer,Salary,1556.63,-9437.22
buyer_2,Carmen,40,ES56209544069065867779,TRX_N-00239-553294038930,2021-09-05T20:09:25,Zarautz,Housing,Rent,-651.68,-10088.9
buyer_2,Carmen,40,ES56209544069065867779,TRX_N-00240-403599953947,2021-09-05T16:06:38,Zarautz,Basic services,water,-65.51,-10154.41
buyer_2,Carmen,40,ES56209544069065867779,TRX_N-00241-174995557497,2021-09-05T04:58:41,Zarautz,Basic services,electricity,-139.67,-10294.08
buyer_2,Carmen,40,ES56209544069065867779,TRX_N-00242-954493296820,2021-09-05T15:16:59,Zarautz,Basic services,gas,-58.74,-10352.82
buyer_2,Carmen,40,ES56209544069065867779,TRX_N-00243-913197217272,2021-09-05T18:51:05,Zarautz,Basic services,internet,-61.43,-10414.25
buyer_2,Carmen,40,ES56209544069065867779,TRX_N-00244-6528207966,2021-09-05T18:48:35,Zarautz,Basic services,phone,-64.94,-10479.19
buyer_2,Carmen,40,ES56209544069065867779,TRX_N-00245-973056040755,2021-09-06T20:50:15,Zarautz,Basic services,internet,-60.94,-10540.13
buyer_2,Carmen,40,ES56209544069065867779,TRX_N-00246-909672147709,2021-09-15T19:57:22,Zarautz,Expense,food,-202.2,-10742.33
buyer_2,Carmen,40,ES56209544069065867779,TRX_N-00247-688377240542,2021-09-16T12:24:36,Zarautz,Expense,transport,-122.07,-10864.4
buyer_2,Carmen,40,ES56209544069065867779,TRX_N-00248-446437044401,2021-10-01T09:01:42,Zarautz,transfer,Salary,1556.63,-9307.77
buyer_2,Carmen,40,ES56209544069065867779,TRX_N-00249-586955994829,2021-10-05T15:52:30,Zarautz,Housing,Rent,-651.68,-9959.45
buyer_2,Carmen,40,ES56209544069065867779,TRX_N-00250-870573549939,2021-10-05T14:38:04,Zarautz,Basic services,phone,-87.51,-10046.96
buyer_2,Carmen,40,ES56209544069065867779,TRX_N-00251-273965112091,2021-10-06T16:14:06,Zarautz,Basic services,water,-12.41,-10059.37
buyer_2,Carmen,40,ES56209544069065867779,TRX_N-00252-215513147836,2021-10-06T11:39:26,Zarautz,Basic services,phone,-60.56,-10119.93
buyer_2,Carmen,40,ES56209544069065867779,TRX_N-00253-444673788347,2021-10-07T14:16:37,Zarautz,Basic services,water,-75.98,-10195.91
buyer_2,Carmen,40,ES56209544069065867779,TRX_N-00254-439264206856,2021-10-15T17:02:40,Zarautz,Expense,transport,-110.63,-10306.54
buyer_2,Carmen,40,ES56209544069065867779,TRX_N-00255-13105578748,2021-10-27T17:14:17,Zarautz,Expense,food,-250.92,-10557.46
buyer_2,Carmen,40,ES56209544069065867779,TRX_N-00256-591057348218,2021-10-29T12:25:53,Zarautz,Expense,food,-427.36,-10984.82
buyer_2,Carmen,40,ES56209544069065867779,TRX_N-00257-918915342236,2021-10-30T19:01:41,Zarautz,Expense,gifts,-232.35,-11217.17
buyer_2,Carmen,40,ES56209544069065867779,TRX_N-00258-690111216237,2021-11-01T05:41:21,Zarautz,transfer,Salary,1556.63,-9660.54
buyer_2,Carmen,40,ES56209544069065867779,TRX_N-00259-26505790194,2021-11-01T05:41:21,Zarautz,transfer,Extra Income,155.66,-9504.88
buyer_2,Carmen,40,ES56209544069065867779,TRX_N-00260-40031143363,2021-11-04T22:27:48,Zarautz,Expense,leisure,-65.89,-9570.77
buyer_2,Carmen,40,ES56209544069065867779,TRX_N-00261-225262013998,2021-11-05T08:36:57,Zarautz,Housing,Rent,-651.68,-10222.45
buyer_2,Carmen,40,ES56209544069065867779,TRX_N-00262-739242416562,2021-11-05T20:20:24,Zarautz,Basic services,water,-16.6,-10239.05
buyer_2,Carmen,40,ES56209544069065867779,TRX_N-00263-289906900083,2021-11-05T18:56:00,Zarautz,Basic services,electricity,-53.2,-10292.25
buyer_2,Carmen,40,ES56209544069065867779,TRX_N-00264-589348479977,2021-11-05T19:57:26,Zarautz,Basic services,internet,-45.04,-10337.29
buyer_2,Carmen,40,ES56209544069065867779,TRX_N-00265-314072126210,2021-11-06T20:31:28,Zarautz,Basic services,electricity,-105.95,-10443.24
buyer_2,Carmen,40,ES56209544069065867779,TRX_N-00266-349317695979,2021-11-06T08:53:52,Zarautz,Basic services,internet,-44.26,-10487.5
buyer_2,Carmen,40,ES56209544069065867779,TRX_N-00267-107533019489,2021-11-07T22:46:03,Arrasate/Mondragon,Expense,transport,-50.62,-10538.12
buyer_2,Carmen,40,ES56209544069065867779,TRX_N-00268-682586312018,2021-11-29T15:41:02,Galdakao,Expense,education,-685.11,-11223.23
buyer_2,Carmen,40,ES56209544069065867779,TRX_N-00269-741661341375,2021-12-01T20:31:55,Zarautz,transfer,Salary,1556.63,-9666.6
buyer_2,Carmen,40,ES56209544069065867779,TRX_N-00270-94936606166,2021-12-01T20:31:55,Zarautz,transfer,Bonus,1437.95,-8228.65
buyer_2,Carmen,40,ES56209544069065867779,TRX_N-00271-560091860057,2021-12-05T08:51:49,Zarautz,Housing,Rent,-651.68,-8880.33
buyer_2,Carmen,40,ES56209544069065867779,TRX_N-00272-244523632808,2021-12-05T11:59:00,Zarautz,Basic services,water,-21.25,-8901.58
buyer_2,Carmen,40,ES56209544069065867779,TRX_N-00273-375425460815,2021-12-05T23:02:45,Zarautz,Basic services,electricity,-44.06,-8945.64
buyer_2,Carmen,40,ES56209544069065867779,TRX_N-00274-911482338613,2021-12-05T03:12:28,Zarautz,Expense,gifts,-317.99,-9263.63
buyer_2,Carmen,40,ES56209544069065867779,TRX_N-00275-879672701812,2021-12-06T20:38:02,Zarautz,Basic services,electricity,-112.27,-9375.9
buyer_2,Carmen,40,ES56209544069065867779,TRX_N-00276-253634325297,2021-12-06T13:58:03,Zarautz,Basic services,gas,-73.21,-9449.11
buyer_2,Carmen,40,ES56209544069065867779,TRX_N-00277-866502742409,2021-12-07T14:35:09,Zarautz,Basic services,water,-76.29,-9525.4
buyer_2,Carmen,40,ES56209544069065867779,TRX_N-00278-356514169160,2021-12-07T19:32:39,Zarautz,Basic services,electricity,-102.97,-9628.37
buyer_2,Carmen,40,ES56209544069065867779,TRX_N-00279-422287736828,2021-12-07T10:40:26,Zarautz,Basic services,phone,-95.8,-9724.17
buyer_2,Carmen,40,ES56209544069065867779,TRX_N-00280-239849687860,2021-12-08T20:43:52,Oyón-Oion,Expense,education,-755.71,-10479.88
buyer_2,Carmen,40,ES56209544069065867779,TRX_N-00281-559638480994,2021-12-15T16:12:57,Zarautz,Expense,food,-649.47,-11129.35
buyer_2,Carmen,40,ES56209544069065867779,TRX_N-00282-188727634398,2021-12-30T06:31:13,Zarautz,Expense,leisure,-208.29,-11337.64
buyer_2,Carmen,40,ES56209544069065867779,TRX_N-00283-890328450129,2022-01-01T14:53:55,Zarautz,transfer,Salary,1556.63,-9781.01
buyer_2,Carmen,40,ES56209544069065867779,TRX_N-00284-601204379516,2022-01-05T22:42:46,Zarautz,Housing,Rent,-651.68,-10432.69
buyer_2,Carmen,40,ES56209544069065867779,TRX_N-00285-92989667886,2022-01-05T12:10:28,Zarautz,Basic services,internet,-30.94,-10463.63
buyer_2,Carmen,40,ES56209544069065867779,TRX_N-00286-602292363511,2022-01-06T02:39:41,Zarautz,Basic services,electricity,-75.84,-10539.47
buyer_2,Carmen,40,ES56209544069065867779,TRX_N-00287-308942715136,2022-01-06T21:31:08,Zarautz,Basic services,gas,-92.45,-10631.92
buyer_2,Carmen,40,ES56209544069065867779,TRX_N-00288-878952169346,2022-01-07T08:18:20,Zarautz,Basic services,water,-39.21,-10671.13
buyer_2,Carmen,40,ES56209544069065867779,TRX_N-00289-961433150191,2022-01-07T16:12:23,Zarautz,Basic services,phone,-78.29,-10749.42
buyer_2,Carmen,40,ES56209544069065867779,TRX_N-00290-204998764676,2022-01-11T11:27:35,Zarautz,Expense,leisure,-297.04,-11046.46
buyer_2,Carmen,40,ES56209544069065867779,TRX_N-00291-216821778521,2022-01-19T20:17:08,Zarautz,Expense,transport,-65.92,-11112.38
buyer_2,Carmen,40,ES56209544069065867779,TRX_N-00292-645040072333,2022-02-01T17:17:04,Zarautz,transfer,Salary,1556.63,-9555.75
buyer_2,Carmen,40,ES56209544069065867779,TRX_N-00293-910120111800,2022-02-01T17:17:04,Zarautz,transfer,Extra Income,155.66,-9400.09
buyer_2,Carmen,40,ES56209544069065867779,TRX_N-00294-909217813898,2022-02-05T15:56:53,Zarautz,Housing,Rent,-651.68,-10051.77
buyer_2,Carmen,40,ES56209544069065867779,TRX_N-00295-151676799506,2022-02-05T22:24:29,Zarautz,Basic services,electricity,-130.97,-10182.74
buyer_2,Carmen,40,ES56209544069065867779,TRX_N-00296-959803357713,2022-02-06T17:35:47,Zarautz,Basic services,water,-27.42,-10210.16
buyer_2,Carmen,40,ES56209544069065867779,TRX_N-00297-838521349418,2022-02-07T16:38:06,Zarautz,Basic services,gas,-32.57,-10242.73
buyer_2,Carmen,40,ES56209544069065867779,TRX_N-00298-667040773772,2022-02-07T13:30:27,Zarautz,Basic services,internet,-56.84,-10299.57
buyer_2,Carmen,40,ES56209544069065867779,TRX_N-00299-482670600920,2022-03-01T18:13:48,Zarautz,transfer,Salary,1556.63,-8742.94
buyer_2,Carmen,40,ES56209544069065867779,TRX_N-00300-82826636336,2022-03-05T08:39:24,Zarautz,Housing,Rent,-651.68,-9394.62
buyer_2,Carmen,40,ES56209544069065867779,TRX_N-00301-253365534335,2022-03-05T17:09:01,Zarautz,Basic services,electricity,-94.26,-9488.88
buyer_2,Carmen,40,ES56209544069065867779,TRX_N-00302-591456357210,2022-03-06T22:09:56,Zarautz,Basic services,electricity,-37.91,-9526.79
buyer_2,Carmen,40,ES56209544069065867779,TRX_N-00303-214260350384,2022-03-12T17:01:53,Zarautz,Expense,transport,-121.54,-9648.33
buyer_2,Carmen,40,ES56209544069065867779,TRX_N-00304-501969216206,2022-03-22T22:01:25,Zarautz,Expense,transport,-138.41,-9786.74
buyer_2,Carmen,40,ES56209544069065867779,TRX_N-00305-80146550591,2022-03-25T20:08:44,Zarautz,Expense,transport,-129.85,-9916.59
buyer_2,Carmen,40,ES56209544069065867779,TRX_N-00306-522754312991,2022-03-26T13:48:40,Zarautz,Expense,transport,-179.78,-10096.37
buyer_2,Carmen,40,ES56209544069065867779,TRX_N-00307-619432264290,2022-03-31T08:01:07,Zarautz,Expense,healthcare,-199.93,-10296.3
buyer_2,Carmen,40,ES56209544069065867779,TRX_N-00308-840759357342,2022-04-01T00:42:47,Zarautz,transfer,Salary,1556.63,-8739.67
buyer_2,Carmen,40,ES56209544069065867779,TRX_N-00309-526527845599,2022-04-05T17:57:22,Zarautz,Housing,Rent,-651.68,-9391.35
buyer_2,Carmen,40,ES56209544069065867779,TRX_N-00310-361643856333,2022-04-05T15:31:46,Zarautz,Basic services,water,-48.34,-9439.69
buyer_2,Carmen,40,ES56209544069065867779,TRX_N-00311-96052271143,2022-04-05T09:31:57,Zarautz,Basic services,electricity,-53.74,-9493.43
buyer_2,Carmen,40,ES56209544069065867779,TRX_N-00312-246069418685,2022-04-05T12:22:50,Zarautz,Basic services,internet,-69.22,-9562.65
buyer_2,Carmen,40,ES56209544069065867779,TRX_N-00313-632566363256,2022-04-05T09:49:14,Zarautz,Basic services,phone,-29.29,-9591.94
buyer_2,Carmen,40,ES56209544069065867779,TRX_N-00314-743292162469,2022-04-05T11:32:59,Zarautz,Expense,food,-695.37,-10287.31
buyer_2,Carmen,40,ES56209544069065867779,TRX_N-00315-941031374890,2022-04-06T15:45:40,Zarautz,Basic services,water,-32.63,-10319.94
buyer_2,Carmen,40,ES56209544069065867779,TRX_N-00316-801875211675,2022-04-07T10:30:17,Zarautz,Basic services,water,-38.67,-10358.61
buyer_2,Carmen,40,ES56209544069065867779,TRX_N-00317-271190156709,2022-04-09T19:46:00,Zarautz,Expense,leisure,-94.38,-10452.99
buyer_2,Carmen,40,ES56209544069065867779,TRX_N-00318-303892122672,2022-04-18T16:00:45,Zarautz,Expense,healthcare,-27.8,-10480.79
buyer_2,Carmen,40,ES56209544069065867779,TRX_N-00319-356785880387,2022-05-01T12:20:35,Zarautz,transfer,Salary,1556.63,-8924.16
buyer_2,Carmen,40,ES56209544069065867779,TRX_N-00320-746175539045,2022-05-01T12:20:35,Zarautz,transfer,Extra Income,155.66,-8768.5
buyer_2,Carmen,40,ES56209544069065867779,TRX_N-00321-410068037419,2022-05-05T08:46:22,Zarautz,Housing,Rent,-651.68,-9420.18
buyer_2,Carmen,40,ES56209544069065867779,TRX_N-00322-338989889279,2022-05-05T15:44:30,Zarautz,Basic services,water,-17.3,-9437.48
buyer_2,Carmen,40,ES56209544069065867779,TRX_N-00323-624260692627,2022-05-05T13:16:28,Zarautz,Basic services,electricity,-54.88,-9492.36
buyer_2,Carmen,40,ES56209544069065867779,TRX_N-00324-767831859141,2022-05-05T09:59:13,Zarautz,Basic services,internet,-31.22,-9523.58
buyer_2,Carmen,40,ES56209544069065867779,TRX_N-00325-144401189895,2022-05-05T23:44:28,Zarautz,Basic services,phone,-60.89,-9584.47
buyer_2,Carmen,40,ES56209544069065867779,TRX_N-00326-640138776810,2022-05-06T16:04:16,Zarautz,Basic services,electricity,-84.32,-9668.79
buyer_2,Carmen,40,ES56209544069065867779,TRX_N-00327-409428375822,2022-05-06T14:29:41,Zarautz,Basic services,phone,-32.12,-9700.91
buyer_2,Carmen,40,ES56209544069065867779,TRX_N-00328-258194033867,2022-05-06T19:16:29,Zarautz,Expense,transport,-148.2,-9849.11
buyer_2,Carmen,40,ES56209544069065867779,TRX_N-00329-484953536226,2022-05-07T09:58:10,Zarautz,Basic services,internet,-63.56,-9912.67
buyer_2,Carmen,40,ES56209544069065867779,TRX_N-00330-656523686607,2022-05-07T20:41:00,Zarautz,Basic services,phone,-74.3,-9986.97
buyer_2,Carmen,40,ES56209544069065867779,TRX_N-00331-170400760393,2022-05-07T01:14:32,Zarautz,Expense,transport,-22.86,-10009.83
buyer_2,Carmen,40,ES56209544069065867779,TRX_N-00332-132516529276,2022-06-01T09:49:34,Zarautz,transfer,Salary,1556.63,-8453.2
buyer_2,Carmen,40,ES56209544069065867779,TRX_N-00333-403869128883,2022-06-01T09:49:34,Zarautz,transfer,Bonus,1488.58,-6964.62
buyer_2,Carmen,40,ES56209544069065867779,TRX_N-00334-76053425027,2022-06-05T18:44:05,Zarautz,Housing,Rent,-651.68,-7616.3
buyer_2,Carmen,40,ES56209544069065867779,TRX_N-00335-186384843552,2022-06-05T22:10:32,Zarautz,Basic services,water,-34.75,-7651.05
buyer_2,Carmen,40,ES56209544069065867779,TRX_N-00336-123347344694,2022-06-06T10:36:32,Zarautz,Basic services,water,-47.7,-7698.75
buyer_2,Carmen,40,ES56209544069065867779,TRX_N-00337-523978103481,2022-06-07T15:12:04,Zarautz,Basic services,electricity,-101.48,-7800.23
buyer_2,Carmen,40,ES56209544069065867779,TRX_N-00338-685914828998,2022-06-07T19:03:00,Zarautz,Basic services,gas,-22.1,-7822.33
buyer_2,Carmen,40,ES56209544069065867779,TRX_N-00339-430289516607,2022-06-12T11:11:16,Zarautz,Expense,transport,-41.01,-7863.34
buyer_2,Carmen,40,ES56209544069065867779,TRX_N-00340-943139248745,2022-06-14T20:48:40,Durango,Expense,transport,-23.24,-7886.58
buyer_2,Carmen,40,ES56209544069065867779,TRX_N-00341-131904204084,2022-06-18T10:09:13,Hondarribia,Expense,food,-123.3,-8009.88
buyer_2,Carmen,40,ES56209544069065867779,TRX_N-00342-504541232978,2022-07-01T09:58:14,Zarautz,transfer,Salary,1556.63,-6453.25
buyer_2,Carmen,40,ES56209544069065867779,TRX_N-00343-853530510367,2022-07-01T19:25:55,Zarautz,Expense,transport,-97.87,-6551.12
buyer_2,Carmen,40,ES56209544069065867779,TRX_N-00344-399768561813,2022-07-01T18:57:52,Arrasate/Mondragon,Expense,clothing,-125.75,-6676.87
buyer_2,Carmen,40,ES56209544069065867779,TRX_N-00345-222246434533,2022-07-05T23:19:34,Zarautz,Housing,Rent,-651.68,-7328.55
buyer_2,Carmen,40,ES56209544069065867779,TRX_N-00346-381591815312,2022-07-05T04:40:05,Zarautz,Basic services,internet,-40.15,-7368.7
buyer_2,Carmen,40,ES56209544069065867779,TRX_N-00347-352212208544,2022-07-06T11:32:40,Zarautz,Basic services,water,-67.33,-7436.03
buyer_2,Carmen,40,ES56209544069065867779,TRX_N-00348-424686091592,2022-07-06T08:11:43,Zarautz,Basic services,electricity,-80.46,-7516.49
buyer_2,Carmen,40,ES56209544069065867779,TRX_N-00349-134956861579,2022-07-07T08:25:10,Zarautz,Basic services,gas,-65.51,-7582.0
buyer_2,Carmen,40,ES56209544069065867779,TRX_N-00350-55368271268,2022-07-07T18:33:10,Zarautz,Basic services,phone,-95.03,-7677.03
buyer_2,Carmen,40,ES56209544069065867779,TRX_N-00351-773383680900,2022-07-11T09:45:49,Zarautz,Expense,food,-636.73,-8313.76
buyer_2,Carmen,40,ES56209544069065867779,TRX_N-00352-403053781310,2022-08-01T05:51:28,Zarautz,transfer,Salary,1556.63,-6757.13
buyer_2,Carmen,40,ES56209544069065867779,TRX_N-00353-797477526749,2022-08-01T05:51:28,Zarautz,transfer,Extra Income,155.66,-6601.47
buyer_2,Carmen,40,ES56209544069065867779,TRX_N-00354-880163508881,2022-08-05T17:18:14,Zarautz,Housing,Rent,-651.68,-7253.15
buyer_2,Carmen,40,ES56209544069065867779,TRX_N-00355-984968433257,2022-08-05T08:24:51,Zarautz,Basic services,gas,-36.2,-7289.35
buyer_2,Carmen,40,ES56209544069065867779,TRX_N-00356-993296868086,2022-08-06T18:27:17,Zarautz,Basic services,electricity,-82.99,-7372.34
buyer_2,Carmen,40,ES56209544069065867779,TRX_N-00357-727180658104,2022-08-06T08:35:57,Zarautz,Basic services,internet,-69.69,-7442.03
buyer_2,Carmen,40,ES56209544069065867779,TRX_N-00358-150904145574,2022-08-06T09:23:22,Zarautz,Expense,food,-172.9,-7614.93
buyer_2,Carmen,40,ES56209544069065867779,TRX_N-00359-849614643555,2022-08-06T08:40:47,Zarautz,Expense,repairs,-808.9,-8423.83
buyer_2,Carmen,40,ES56209544069065867779,TRX_N-00360-876640312837,2022-08-07T13:32:05,Zarautz,Basic services,gas,-71.57,-8495.4
buyer_2,Carmen,40,ES56209544069065867779,TRX_N-00361-372168823732,2022-08-07T09:17:15,Zarautz,Basic services,internet,-43.54,-8538.94
buyer_2,Carmen,40,ES56209544069065867779,TRX_N-00362-811979299066,2022-08-16T17:31:05,Amurrio,Expense,food,-629.68,-9168.62
buyer_2,Carmen,40,ES56209544069065867779,TRX_N-00363-234928503889,2022-08-20T08:13:17,Zarautz,Expense,clothing,-467.79,-9636.41
buyer_2,Carmen,40,ES56209544069065867779,TRX_N-00364-297993972044,2022-08-25T18:14:47,Lasarte-Oria,Expense,clothing,-494.26,-10130.67
buyer_2,Carmen,40,ES56209544069065867779,TRX_N-00365-661751767097,2022-09-01T15:16:14,Zarautz,transfer,Salary,1556.63,-8574.04
buyer_2,Carmen,40,ES56209544069065867779,TRX_N-00366-986040120897,2022-09-02T11:05:03,Zarautz,Expense,gifts,-124.47,-8698.51
buyer_2,Carmen,40,ES56209544069065867779,TRX_N-00367-436991193406,2022-09-05T10:11:06,Zarautz,Housing,Rent,-651.68,-9350.19
buyer_2,Carmen,40,ES56209544069065867779,TRX_N-00368-465901741805,2022-09-06T19:59:29,Zarautz,Expense,transport,-72.74,-9422.93
buyer_2,Carmen,40,ES56209544069065867779,TRX_N-00369-704136547962,2022-09-06T19:42:45,Zarautz,Expense,leisure,-159.04,-9581.97
buyer_2,Carmen,40,ES56209544069065867779,TRX_N-00370-296809389893,2022-09-15T16:25:46,Eibar,Expense,leisure,-15.99,-9597.96
buyer_2,Carmen,40,ES56209544069065867779,TRX_N-00371-129413348100,2022-09-21T10:03:30,Zarautz,Expense,transport,-22.0,-9619.96
buyer_2,Carmen,40,ES56209544069065867779,TRX_N-00372-524655093066,2022-10-01T22:13:29,Zarautz,transfer,Salary,1556.63,-8063.33
buyer_2,Carmen,40,ES56209544069065867779,TRX_N-00373-978646817256,2022-10-05T20:40:18,Zarautz,Housing,Rent,-651.68,-8715.01
buyer_2,Carmen,40,ES56209544069065867779,TRX_N-00374-939079720302,2022-10-05T10:02:00,Zarautz,Basic services,phone,-97.0,-8812.01
buyer_2,Carmen,40,ES56209544069065867779,TRX_N-00375-791410673103,2022-10-06T05:54:46,Zarautz,Basic services,water,-51.14,-8863.15
buyer_2,Carmen,40,ES56209544069065867779,TRX_N-00376-143347951915,2022-10-06T08:59:33,Zarautz,Basic services,phone,-94.94,-8958.09
buyer_2,Carmen,40,ES56209544069065867779,TRX_N-00377-214792382251,2022-10-07T17:55:06,Zarautz,Basic services,gas,-83.62,-9041.71
buyer_2,Carmen,40,ES56209544069065867779,TRX_N-00378-363208950361,2022-10-07T16:58:12,Zarautz,Basic services,internet,-43.39,-9085.1
buyer_2,Carmen,40,ES56209544069065867779,TRX_N-00379-252751850370,2022-10-07T15:43:52,Zarautz,Basic services,phone,-56.87,-9141.97
buyer_2,Carmen,40,ES56209544069065867779,TRX_N-00380-853068765049,2022-10-19T19:49:21,Zarautz,Expense,transport,-186.74,-9328.71
buyer_2,Carmen,40,ES56209544069065867779,TRX_N-00381-249842318402,2022-10-22T14:34:49,Elciego,Expense,transport,-155.65,-9484.36
buyer_2,Carmen,40,ES56209544069065867779,TRX_N-00382-587771039395,2022-10-31T13:52:02,Zarautz,Expense,food,-692.25,-10176.61
buyer_2,Carmen,40,ES56209544069065867779,TRX_N-00383-819707944271,2022-10-31T12:00:42,Labastida/Bastida,Expense,clothing,-78.07,-10254.68
buyer_2,Carmen,40,ES56209544069065867779,TRX_N-00384-77931873260,2022-11-01T13:47:45,Zarautz,transfer,Salary,1556.63,-8698.05
buyer_2,Carmen,40,ES56209544069065867779,TRX_N-00385-457515660499,2022-11-01T13:47:45,Zarautz,transfer,Extra Income,155.66,-8542.39
buyer_2,Carmen,40,ES56209544069065867779,TRX_N-00386-423859601477,2022-11-05T10:51:44,Zarautz,Housing,Rent,-651.68,-9194.07
buyer_2,Carmen,40,ES56209544069065867779,TRX_N-00387-527303491178,2022-11-06T11:15:07,Zarautz,Basic services,internet,-65.46,-9259.53
buyer_2,Carmen,40,ES56209544069065867779,TRX_N-00388-604496565122,2022-11-06T08:12:10,Zarautz,Basic services,phone,-73.92,-9333.45
buyer_2,Carmen,40,ES56209544069065867779,TRX_N-00389-523667235384,2022-11-07T08:52:16,Zarautz,Basic services,water,-57.64,-9391.09
buyer_2,Carmen,40,ES56209544069065867779,TRX_N-00390-622100040104,2022-11-07T11:45:53,Zarautz,Basic services,electricity,-88.22,-9479.31
buyer_2,Carmen,40,ES56209544069065867779,TRX_N-00391-768690735520,2022-11-07T19:17:38,Zarautz,Basic services,phone,-50.23,-9529.54
buyer_2,Carmen,40,ES56209544069065867779,TRX_N-00392-844467530032,2022-11-14T12:39:29,Eibar,Expense,food,-650.94,-10180.48
buyer_2,Carmen,40,ES56209544069065867779,TRX_N-00393-563863752853,2022-11-18T12:55:27,Zarautz,Expense,clothing,-401.4,-10581.88
buyer_2,Carmen,40,ES56209544069065867779,TRX_N-00394-363195550721,2022-11-21T08:37:58,Zarautz,Expense,food,-698.41,-11280.29
buyer_2,Carmen,40,ES56209544069065867779,TRX_N-00395-673868384427,2022-11-22T12:54:16,Erandio,Expense,food,-342.03,-11622.32
buyer_2,Carmen,40,ES56209544069065867779,TRX_N-00396-151682480968,2022-11-30T09:39:22,Zarautz,Expense,transport,-25.96,-11648.28
buyer_2,Carmen,40,ES56209544069065867779,TRX_N-00397-463972597561,2022-12-01T14:01:20,Zarautz,transfer,Salary,1556.63,-10091.65
buyer_2,Carmen,40,ES56209544069065867779,TRX_N-00398-844042837477,2022-12-01T14:01:20,Zarautz,transfer,Bonus,1655.09,-8436.56
buyer_2,Carmen,40,ES56209544069065867779,TRX_N-00399-211983433849,2022-12-05T01:37:00,Zarautz,Housing,Rent,-651.68,-9088.24
buyer_2,Carmen,40,ES56209544069065867779,TRX_N-00400-319645042809,2022-12-05T19:16:44,Zarautz,Basic services,internet,-73.16,-9161.4
buyer_2,Carmen,40,ES56209544069065867779,TRX_N-00401-588690111594,2022-12-05T09:07:13,Zarautz,Basic services,phone,-38.21,-9199.61
buyer_2,Carmen,40,ES56209544069065867779,TRX_N-00402-557363463368,2022-12-06T08:29:51,Zarautz,Basic services,phone,-47.6,-9247.21
buyer_2,Carmen,40,ES56209544069065867779,TRX_N-00403-211714593142,2022-12-07T23:05:57,Zarautz,Basic services,electricity,-123.16,-9370.37
buyer_2,Carmen,40,ES56209544069065867779,TRX_N-00404-868634954878,2022-12-07T19:07:04,Zarautz,Basic services,gas,-83.05,-9453.42
buyer_2,Carmen,40,ES56209544069065867779,TRX_N-00405-587988922256,2022-12-07T14:59:16,Zarautz,Basic services,internet,-36.12,-9489.54
buyer_2,Carmen,40,ES56209544069065867779,TRX_N-00406-874980651094,2022-12-08T11:46:14,Andoain,Expense,healthcare,-294.87,-9784.41
buyer_2,Carmen,40,ES56209544069065867779,TRX_N-00407-804641838073,2022-12-30T22:02:03,Eibar,Expense,transport,-84.28,-9868.69
buyer_2,Carmen,40,ES56209544069065867779,TRX_N-00408-372485242672,2023-01-01T18:37:39,Zarautz,transfer,Salary,1556.63,-8312.06
buyer_2,Carmen,40,ES56209544069065867779,TRX_N-00409-75656629345,2023-01-05T11:05:30,Zarautz,Housing,Rent,-651.68,-8963.74
buyer_2,Carmen,40,ES56209544069065867779,TRX_N-00410-776898260497,2023-01-05T11:15:42,Zarautz,Basic services,internet,-59.72,-9023.46
buyer_2,Carmen,40,ES56209544069065867779,TRX_N-00411-954218522194,2023-01-06T10:12:11,Zarautz,Basic services,electricity,-44.86,-9068.32
buyer_2,Carmen,40,ES56209544069065867779,TRX_N-00412-412611541211,2023-01-06T21:22:07,Zarautz,Basic services,gas,-95.88,-9164.2
buyer_2,Carmen,40,ES56209544069065867779,TRX_N-00413-149790345469,2023-01-06T11:49:06,Zarautz,Expense,food,-273.88,-9438.08
buyer_2,Carmen,40,ES56209544069065867779,TRX_N-00414-623477127777,2023-01-07T20:31:59,Zarautz,Basic services,water,-46.29,-9484.37
buyer_2,Carmen,40,ES56209544069065867779,TRX_N-00415-355726919754,2023-01-07T01:59:30,Zarautz,Basic services,internet,-77.91,-9562.28
buyer_2,Carmen,40,ES56209544069065867779,TRX_N-00416-571299480905,2023-01-10T12:15:46,Zarautz,Expense,transport,-123.97,-9686.25
buyer_2,Carmen,40,ES56209544069065867779,TRX_N-00417-163254744579,2023-01-26T08:25:25,Zarautz,Expense,transport,-193.56,-9879.81
buyer_2,Carmen,40,ES56209544069065867779,TRX_N-00418-267402794018,2023-01-30T16:05:36,Zarautz,Expense,healthcare,-311.2,-10191.01
buyer_2,Carmen,40,ES56209544069065867779,TRX_N-00419-274300406723,2023-02-01T09:01:03,Zarautz,transfer,Salary,1556.63,-8634.38
buyer_2,Carmen,40,ES56209544069065867779,TRX_N-00420-721919634573,2023-02-01T09:01:03,Zarautz,transfer,Extra Income,155.66,-8478.72
buyer_2,Carmen,40,ES56209544069065867779,TRX_N-00421-626440674469,2023-02-05T19:41:26,Zarautz,Housing,Rent,-651.68,-9130.4
buyer_2,Carmen,40,ES56209544069065867779,TRX_N-00422-869014268281,2023-02-05T14:52:03,Zarautz,Basic services,water,-79.41,-9209.81
buyer_2,Carmen,40,ES56209544069065867779,TRX_N-00423-666895819722,2023-02-06T18:02:26,Zarautz,Basic services,internet,-50.33,-9260.14
buyer_2,Carmen,40,ES56209544069065867779,TRX_N-00424-605243621850,2023-02-06T14:46:50,Zarautz,Basic services,phone,-81.48,-9341.62
buyer_2,Carmen,40,ES56209544069065867779,TRX_N-00425-814941918354,2023-02-07T09:05:34,Zarautz,Basic services,electricity,-87.97,-9429.59
buyer_2,Carmen,40,ES56209544069065867779,TRX_N-00426-61854447861,2023-02-07T14:58:16,Zarautz,Basic services,internet,-71.84,-9501.43
buyer_2,Carmen,40,ES56209544069065867779,TRX_N-00427-115340565984,2023-02-07T12:05:24,Zarautz,Basic services,phone,-47.2,-9548.63
buyer_2,Carmen,40,ES56209544069065867779,TRX_N-00428-277664156960,2023-02-18T09:07:45,Zarautz,Expense,transport,-96.45,-9645.08
buyer_2,Carmen,40,ES56209544069065867779,TRX_N-00429-208484167092,2023-02-21T01:57:27,Zarautz,Expense,transport,-156.16,-9801.24
buyer_2,Carmen,40,ES56209544069065867779,TRX_N-00430-152101779388,2023-02-27T14:27:17,Zarautz,Expense,food,-417.56,-10218.8
buyer_2,Carmen,40,ES56209544069065867779,TRX_N-00431-352798505706,2023-03-01T13:13:05,Zarautz,transfer,Salary,1556.63,-8662.17
buyer_2,Carmen,40,ES56209544069065867779,TRX_N-00432-542153387771,2023-03-02T17:18:29,Zarautz,Expense,transport,-22.4,-8684.57
buyer_2,Carmen,40,ES56209544069065867779,TRX_N-00433-838585572810,2023-03-05T17:11:46,Zarautz,Housing,Rent,-651.68,-9336.25
buyer_2,Carmen,40,ES56209544069065867779,TRX_N-00434-301252552645,2023-03-05T18:33:15,Zarautz,Basic services,water,-64.57,-9400.82
buyer_2,Carmen,40,ES56209544069065867779,TRX_N-00435-969022337646,2023-03-05T16:20:31,Zarautz,Basic services,electricity,-95.92,-9496.74
buyer_2,Carmen,40,ES56209544069065867779,TRX_N-00436-968774824192,2023-03-05T11:41:29,Zarautz,Basic services,gas,-33.95,-9530.69
buyer_2,Carmen,40,ES56209544069065867779,TRX_N-00437-367556858904,2023-03-05T07:59:47,Zarautz,Basic services,internet,-69.07,-9599.76
buyer_2,Carmen,40,ES56209544069065867779,TRX_N-00438-159423951264,2023-03-05T05:45:11,Zarautz,Basic services,phone,-55.72,-9655.48
buyer_2,Carmen,40,ES56209544069065867779,TRX_N-00439-115715033308,2023-03-07T20:00:44,Zarautz,Basic services,phone,-22.73,-9678.21
buyer_2,Carmen,40,ES56209544069065867779,TRX_N-00440-530882717286,2023-03-13T12:08:52,Eibar,Expense,education,-721.55,-10399.76
buyer_2,Carmen,40,ES56209544069065867779,TRX_N-00441-687752248869,2023-03-22T12:11:16,Zarautz,Expense,leisure,-23.99,-10423.75
buyer_2,Carmen,40,ES56209544069065867779,TRX_N-00442-719445544881,2023-03-31T09:58:11,Llodio,Expense,food,-208.72,-10632.47
buyer_2,Carmen,40,ES56209544069065867779,TRX_N-00443-614624789688,2023-04-01T13:11:01,Zarautz,transfer,Salary,1556.63,-9075.84
buyer_2,Carmen,40,ES56209544069065867779,TRX_N-00444-595555915835,2023-04-01T13:11:01,Zarautz,transfer,Extra Income,155.66,-8920.18
buyer_2,Carmen,40,ES56209544069065867779,TRX_N-00445-924396791100,2023-04-05T18:23:52,Zarautz,Housing,Rent,-651.68,-9571.86
buyer_2,Carmen,40,ES56209544069065867779,TRX_N-00446-702149500529,2023-04-05T12:24:21,Zarautz,Basic services,phone,-84.43,-9656.29
buyer_2,Carmen,40,ES56209544069065867779,TRX_N-00447-208639547243,2023-04-06T20:20:59,Zarautz,Basic services,gas,-96.74,-9753.03
buyer_2,Carmen,40,ES56209544069065867779,TRX_N-00448-310371570123,2023-04-06T17:30:15,Zarautz,Basic services,internet,-63.7,-9816.73
buyer_2,Carmen,40,ES56209544069065867779,TRX_N-00449-139979236131,2023-04-06T15:46:45,Zarautz,Basic services,phone,-40.79,-9857.52
buyer_2,Carmen,40,ES56209544069065867779,TRX_N-00450-21363673353,2023-04-07T11:58:10,Zarautz,Basic services,water,-61.5,-9919.02
buyer_2,Carmen,40,ES56209544069065867779,TRX_N-00451-432424325143,2023-04-07T13:32:33,Zarautz,Basic services,gas,-37.26,-9956.28
buyer_2,Carmen,40,ES56209544069065867779,TRX_N-00452-653036286500,2023-04-07T08:00:01,Zarautz,Basic services,phone,-35.73,-9992.01
buyer_2,Carmen,40,ES56209544069065867779,TRX_N-00453-349737117684,2023-04-16T20:02:26,Zarautz,Expense,food,-690.55,-10682.56
buyer_2,Carmen,40,ES56209544069065867779,TRX_N-00454-251618316210,2023-04-18T15:14:23,Irun,Expense,transport,-56.94,-10739.5
buyer_2,Carmen,40,ES56209544069065867779,TRX_N-00455-632566916878,2023-04-19T11:44:22,Zarautz,Expense,food,-205.69,-10945.19
buyer_2,Carmen,40,ES56209544069065867779,TRX_N-00456-555372040856,2023-04-29T18:54:35,Zarautz,Expense,transport,-175.48,-11120.67
buyer_2,Carmen,40,ES56209544069065867779,TRX_N-00457-86176288495,2023-05-01T17:37:43,Zarautz,transfer,Salary,1556.63,-9564.04
buyer_2,Carmen,40,ES56209544069065867779,TRX_N-00458-93679296889,2023-05-05T16:48:30,Zarautz,Housing,Rent,-651.68,-10215.72
buyer_2,Carmen,40,ES56209544069065867779,TRX_N-00459-432412394993,2023-05-05T09:51:29,Zarautz,Basic services,gas,-18.75,-10234.47
buyer_2,Carmen,40,ES56209544069065867779,TRX_N-00460-712909125382,2023-05-05T11:24:05,Zarautz,Basic services,internet,-57.76,-10292.23
buyer_2,Carmen,40,ES56209544069065867779,TRX_N-00461-414946927298,2023-05-05T13:59:12,Zarautz,Basic services,phone,-76.9,-10369.13
buyer_2,Carmen,40,ES56209544069065867779,TRX_N-00462-232563191924,2023-05-06T23:46:28,Zarautz,Basic services,gas,-80.44,-10449.57
buyer_2,Carmen,40,ES56209544069065867779,TRX_N-00463-369727516613,2023-05-06T17:33:42,Zarautz,Basic services,internet,-79.16,-10528.73
buyer_2,Carmen,40,ES56209544069065867779,TRX_N-00464-364754433066,2023-05-07T11:46:45,Zarautz,Basic services,gas,-42.12,-10570.85
buyer_2,Carmen,40,ES56209544069065867779,TRX_N-00465-778430170927,2023-05-07T22:05:11,Zarautz,Basic services,internet,-48.36,-10619.21
buyer_2,Carmen,40,ES56209544069065867779,TRX_N-00466-632222719219,2023-05-29T10:20:38,Zarautz,Expense,food,-230.64,-10849.85
buyer_2,Carmen,40,ES56209544069065867779,TRX_N-00467-106588584342,2023-06-01T10:00:06,Zarautz,transfer,Salary,1556.63,-9293.22
buyer_2,Carmen,40,ES56209544069065867779,TRX_N-00468-224270753479,2023-06-01T10:00:06,Zarautz,transfer,Extra Income,155.66,-9137.56
buyer_2,Carmen,40,ES56209544069065867779,TRX_N-00469-936735932892,2023-06-01T10:00:06,Zarautz,transfer,Bonus,1486.91,-7650.65
buyer_2,Carmen,40,ES56209544069065867779,TRX_N-00470-243323747972,2023-06-01T08:21:34,Hernani,Expense,transport,-99.94,-7750.59
buyer_2,Carmen,40,ES56209544069065867779,TRX_N-00471-365399428662,2023-06-03T08:34:06,Sopela,Expense,clothing,-224.82,-7975.41
buyer_2,Carmen,40,ES56209544069065867779,TRX_N-00472-678651107430,2023-06-05T18:16:28,Zarautz,Housing,Rent,-651.68,-8627.09
buyer_2,Carmen,40,ES56209544069065867779,TRX_N-00473-150781631314,2023-06-06T10:34:03,Zarautz,Basic services,water,-17.95,-8645.04
buyer_2,Carmen,40,ES56209544069065867779,TRX_N-00474-93810446529,2023-06-07T10:06:05,Zarautz,Basic services,phone,-31.29,-8676.33
buyer_2,Carmen,40,ES56209544069065867779,TRX_N-00475-257142258899,2023-06-07T19:02:24,Zuia,Expense,leisure,-276.15,-8952.48
buyer_2,Carmen,40,ES56209544069065867779,TRX_N-00476-371324065943,2023-06-11T08:11:30,Zarautz,Expense,transport,-110.2,-9062.68
buyer_2,Carmen,40,ES56209544069065867779,TRX_N-00477-553125716970,2023-06-12T17:33:20,Zarautz,Expense,clothing,-317.23,-9379.91
buyer_2,Carmen,40,ES56209544069065867779,TRX_N-00478-167945239422,2023-06-16T01:46:49,Zarautz,Expense,transport,-58.61,-9438.52
buyer_2,Carmen,40,ES56209544069065867779,TRX_N-00479-210986169873,2023-06-27T20:17:05,Zarautz,Expense,education,-568.15,-10006.67
buyer_2,Carmen,40,ES56209544069065867779,TRX_N-00480-141909721258,2023-06-28T13:18:29,Zarautz,Expense,healthcare,-176.07,-10182.74
buyer_2,Carmen,40,ES56209544069065867779,TRX_N-00481-262963759157,2023-07-01T14:59:04,Zarautz,transfer,Salary,1556.63,-8626.11
buyer_2,Carmen,40,ES56209544069065867779,TRX_N-00482-878658642582,2023-07-05T18:48:57,Zarautz,Housing,Rent,-651.68,-9277.79
buyer_2,Carmen,40,ES56209544069065867779,TRX_N-00483-141451850202,2023-07-06T13:40:01,Zarautz,Basic services,electricity,-147.78,-9425.57
buyer_2,Carmen,40,ES56209544069065867779,TRX_N-00484-998805696650,2023-07-06T08:26:55,Zarautz,Basic services,gas,-74.33,-9499.9
buyer_2,Carmen,40,ES56209544069065867779,TRX_N-00485-885671402361,2023-07-15T15:59:10,Zarautz,Expense,transport,-81.64,-9581.54
buyer_2,Carmen,40,ES56209544069065867779,TRX_N-00486-812603841980,2023-07-21T06:07:42,Zarautz,Expense,repairs,-715.4,-10296.94
buyer_2,Carmen,40,ES56209544069065867779,TRX_N-00487-24631024355,2023-08-01T15:11:01,Zarautz,transfer,Salary,1556.63,-8740.31
buyer_2,Carmen,40,ES56209544069065867779,TRX_N-00488-104921388632,2023-08-02T12:09:43,Basauri,Expense,transport,-25.47,-8765.78
buyer_2,Carmen,40,ES56209544069065867779,TRX_N-00489-806420607121,2023-08-05T15:59:00,Zarautz,Housing,Rent,-651.68,-9417.46
buyer_2,Carmen,40,ES56209544069065867779,TRX_N-00490-800552490939,2023-08-05T11:26:22,Zarautz,Basic services,water,-64.21,-9481.67
buyer_2,Carmen,40,ES56209544069065867779,TRX_N-00491-964189503913,2023-08-05T22:30:43,Zarautz,Basic services,phone,-44.08,-9525.75
buyer_2,Carmen,40,ES56209544069065867779,TRX_N-00492-188764623111,2023-08-06T23:40:43,Zarautz,Basic services,electricity,-67.0,-9592.75
buyer_2,Carmen,40,ES56209544069065867779,TRX_N-00493-577322884621,2023-08-06T21:52:30,Zarautz,Basic services,gas,-41.16,-9633.91
buyer_2,Carmen,40,ES56209544069065867779,TRX_N-00494-3809618474,2023-08-07T11:34:38,Zarautz,Basic services,water,-79.37,-9713.28
buyer_2,Carmen,40,ES56209544069065867779,TRX_N-00495-421461217171,2023-08-07T12:07:43,Zarautz,Basic services,gas,-30.52,-9743.8
buyer_2,Carmen,40,ES56209544069065867779,TRX_N-00496-742640390023,2023-08-07T18:55:43,Zarautz,Basic services,internet,-63.33,-9807.13
buyer_2,Carmen,40,ES56209544069065867779,TRX_N-00497-838420536836,2023-08-07T16:19:26,Zarautz,Expense,transport,-71.62,-9878.75
buyer_2,Carmen,40,ES56209544069065867779,TRX_N-00498-883874835463,2023-08-12T09:32:06,Zarautz,Expense,food,-526.3,-10405.05
buyer_2,Carmen,40,ES56209544069065867779,TRX_N-00499-589669296143,2023-08-19T02:38:30,Zarautz,Expense,food,-237.41,-10642.46
buyer_2,Carmen,40,ES56209544069065867779,TRX_N-00500-800067639943,2023-08-21T08:02:28,Zarautz,Expense,education,-600.49,-11242.95
buyer_2,Carmen,40,ES56209544069065867779,TRX_N-00501-27465547416,2023-08-27T08:46:28,Zarautz,Expense,education,-202.29,-11445.24
buyer_2,Carmen,40,ES56209544069065867779,TRX_N-00502-713104303811,2023-09-01T12:58:47,Zarautz,transfer,Salary,1556.63,-9888.61
buyer_2,Carmen,40,ES56209544069065867779,TRX_N-00503-83986758357,2023-09-01T12:58:47,Zarautz,transfer,Extra Income,155.66,-9732.95
buyer_2,Carmen,40,ES56209544069065867779,TRX_N-00504-904634683073,2023-09-05T08:51:20,Zarautz,Housing,Rent,-651.68,-10384.63
buyer_2,Carmen,40,ES56209544069065867779,TRX_N-00505-282665678319,2023-09-05T08:05:43,Zarautz,Basic services,electricity,-58.83,-10443.46
buyer_2,Carmen,40,ES56209544069065867779,TRX_N-00506-840341277197,2023-09-05T20:18:43,Zarautz,Basic services,gas,-85.32,-10528.78
buyer_2,Carmen,40,ES56209544069065867779,TRX_N-00507-531621858755,2023-09-05T11:55:21,Zarautz,Expense,leisure,-265.32,-10794.1
buyer_2,Carmen,40,ES56209544069065867779,TRX_N-00508-727183489829,2023-09-06T19:59:43,Zarautz,Basic services,electricity,-86.76,-10880.86
buyer_2,Carmen,40,ES56209544069065867779,TRX_N-00509-389080633635,2023-09-06T09:43:44,Zarautz,Basic services,internet,-44.0,-10924.86
buyer_2,Carmen,40,ES56209544069065867779,TRX_N-00510-271432487827,2023-09-06T10:56:17,Zarautz,Basic services,phone,-48.36,-10973.22
buyer_2,Carmen,40,ES56209544069065867779,TRX_N-00511-481785893473,2023-09-07T22:11:15,Zarautz,Basic services,electricity,-96.82,-11070.04
buyer_2,Carmen,40,ES56209544069065867779,TRX_N-00512-359911435801,2023-09-14T18:58:35,Zarautz,Expense,leisure,-177.74,-11247.78
buyer_2,Carmen,40,ES56209544069065867779,TRX_N-00513-213988754066,2023-10-01T11:33:29,Zarautz,transfer,Salary,1556.63,-9691.15
buyer_2,Carmen,40,ES56209544069065867779,TRX_N-00514-230388185248,2023-10-01T10:55:56,Zarautz,Expense,clothing,-137.47,-9828.62
buyer_2,Carmen,40,ES56209544069065867779,TRX_N-00515-7169563572,2023-10-05T19:53:40,Zarautz,Housing,Rent,-651.68,-10480.3
buyer_2,Carmen,40,ES56209544069065867779,TRX_N-00516-593654110903,2023-10-05T15:23:03,Andoain,Expense,clothing,-38.31,-10518.61
buyer_2,Carmen,40,ES56209544069065867779,TRX_N-00517-477213320160,2023-10-06T12:51:10,Zarautz,Basic services,water,-17.33,-10535.94
buyer_2,Carmen,40,ES56209544069065867779,TRX_N-00518-835705443752,2023-10-06T14:13:07,Zarautz,Basic services,gas,-48.92,-10584.86
buyer_2,Carmen,40,ES56209544069065867779,TRX_N-00519-966093592076,2023-10-06T17:08:33,Zarautz,Basic services,internet,-35.07,-10619.93
buyer_2,Carmen,40,ES56209544069065867779,TRX_N-00520-432511095160,2023-10-06T09:39:26,Zarautz,Basic services,phone,-28.94,-10648.87
buyer_2,Carmen,40,ES56209544069065867779,TRX_N-00521-811987120583,2023-10-07T10:50:58,Zarautz,Basic services,water,-57.79,-10706.66
buyer_2,Carmen,40,ES56209544069065867779,TRX_N-00522-228484626189,2023-10-07T13:47:13,Zarautz,Basic services,electricity,-124.13,-10830.79
buyer_2,Carmen,40,ES56209544069065867779,TRX_N-00523-171577706236,2023-10-10T19:05:05,Lasarte-Oria,Expense,food,-612.89,-11443.68
buyer_2,Carmen,40,ES56209544069065867779,TRX_N-00524-979529666273,2023-10-18T21:04:13,Zarautz,Expense,transport,-127.59,-11571.27
buyer_2,Carmen,40,ES56209544069065867779,TRX_N-00525-895666182080,2023-10-28T09:41:36,Zarautz,Expense,leisure,-144.45,-11715.72
buyer_2,Carmen,40,ES56209544069065867779,TRX_N-00526-189363032955,2023-10-31T21:41:17,Zarautz,Expense,healthcare,-370.33,-12086.05
buyer_2,Carmen,40,ES56209544069065867779,TRX_N-00527-553555781985,2023-11-01T17:07:30,Zarautz,transfer,Salary,1556.63,-10529.42
buyer_2,Carmen,40,ES56209544069065867779,TRX_N-00528-807690224996,2023-11-01T17:07:30,Zarautz,transfer,Extra Income,155.66,-10373.76
buyer_2,Carmen,40,ES56209544069065867779,TRX_N-00529-88776210175,2023-11-05T20:33:18,Zarautz,Housing,Rent,-651.68,-11025.44
buyer_2,Carmen,40,ES56209544069065867779,TRX_N-00530-508183773418,2023-11-06T19:54:37,Zarautz,Expense,clothing,-218.95,-11244.39
buyer_2,Carmen,40,ES56209544069065867779,TRX_N-00531-30328458305,2023-11-07T13:21:54,Zarautz,Basic services,internet,-61.95,-11306.34
buyer_2,Carmen,40,ES56209544069065867779,TRX_N-00532-92235513334,2023-11-20T14:40:01,Zarautz,Expense,transport,-60.89,-11367.23
buyer_2,Carmen,40,ES56209544069065867779,TRX_N-00533-550727503085,2023-11-30T20:12:52,Zarautz,Expense,transport,-197.84,-11565.07
buyer_2,Carmen,40,ES56209544069065867779,TRX_N-00534-517187335174,2023-12-01T00:05:20,Zarautz,transfer,Salary,1556.63,-10008.44
buyer_2,Carmen,40,ES56209544069065867779,TRX_N-00535-90215354864,2023-12-01T00:05:20,Zarautz,transfer,Bonus,1708.83,-8299.61
buyer_2,Carmen,40,ES56209544069065867779,TRX_N-00536-853499516262,2023-12-05T08:03:58,Zarautz,Housing,Rent,-651.68,-8951.29
buyer_2,Carmen,40,ES56209544069065867779,TRX_N-00537-784928876401,2023-12-05T15:02:20,Zarautz,Basic services,water,-43.92,-8995.21
buyer_2,Carmen,40,ES56209544069065867779,TRX_N-00538-769361016302,2023-12-06T17:29:28,Zarautz,Basic services,electricity,-63.15,-9058.36
buyer_2,Carmen,40,ES56209544069065867779,TRX_N-00539-866194380545,2023-12-06T19:45:48,Zarautz,Basic services,gas,-93.82,-9152.18
buyer_2,Carmen,40,ES56209544069065867779,TRX_N-00540-104180070866,2023-12-06T14:43:24,Zarautz,Basic services,internet,-45.67,-9197.85
buyer_2,Carmen,40,ES56209544069065867779,TRX_N-00541-637666292951,2023-12-07T14:17:32,Zarautz,Basic services,electricity,-66.6,-9264.45
buyer_2,Carmen,40,ES56209544069065867779,TRX_N-00542-139819754201,2023-12-07T10:37:27,Zarautz,Basic services,gas,-33.29,-9297.74
buyer_2,Carmen,40,ES56209544069065867779,TRX_N-00543-701841988614,2023-12-07T13:38:59,Zarautz,Basic services,phone,-99.33,-9397.07
buyer_2,Carmen,40,ES56209544069065867779,TRX_N-00544-558107684973,2023-12-21T16:09:24,Zarautz,Expense,food,-311.7,-9708.77
buyer_2,Carmen,40,ES56209544069065867779,TRX_N-00545-64452855161,2023-12-29T15:31:29,Zarautz,Expense,clothing,-452.43,-10161.2
buyer_2,Carmen,40,ES56209544069065867779,TRX_N-00546-1958413105,2023-12-30T23:09:33,Zarautz,Expense,clothing,-34.95,-10196.15
buyer_2,Carmen,40,ES56209544069065867779,TRX_N-00547-102658070985,2024-01-01T09:23:57,Zarautz,transfer,Salary,1556.63,-8639.52
buyer_2,Carmen,40,ES56209544069065867779,TRX_N-00548-38088920210,2024-01-05T11:24:00,Zarautz,Housing,Rent,-651.68,-9291.2
buyer_2,Carmen,40,ES56209544069065867779,TRX_N-00549-451086857272,2024-01-05T08:11:41,Zarautz,Expense,education,-150.66,-9441.86
buyer_2,Carmen,40,ES56209544069065867779,TRX_N-00550-590022437874,2024-01-06T14:27:31,Zarautz,Basic services,internet,-77.44,-9519.3
buyer_2,Carmen,40,ES56209544069065867779,TRX_N-00551-400929095182,2024-01-19T18:29:47,Oyón-Oion,Expense,transport,-170.97,-9690.27
buyer_2,Carmen,40,ES56209544069065867779,TRX_N-00552-264178481893,2024-01-25T10:51:53,Oyón-Oion,Expense,leisure,-16.74,-9707.01
buyer_2,Carmen,40,ES56209544069065867779,TRX_N-00553-559900772493,2024-02-01T11:34:52,Zarautz,transfer,Salary,1556.63,-8150.38
buyer_2,Carmen,40,ES56209544069065867779,TRX_N-00554-692252375937,2024-02-01T11:34:52,Zarautz,transfer,Extra Income,155.66,-7994.72
buyer_2,Carmen,40,ES56209544069065867779,TRX_N-00555-322647584412,2024-02-05T21:49:12,Zarautz,Housing,Rent,-651.68,-8646.4
buyer_2,Carmen,40,ES56209544069065867779,TRX_N-00556-525757388730,2024-02-06T12:31:11,Zarautz,Basic services,water,-30.98,-8677.38
buyer_2,Carmen,40,ES56209544069065867779,TRX_N-00557-298778885571,2024-02-06T19:43:10,Zarautz,Basic services,gas,-38.24,-8715.62
buyer_2,Carmen,40,ES56209544069065867779,TRX_N-00558-888716819515,2024-02-14T11:16:39,Zarautz,Expense,food,-558.01,-9273.63
buyer_2,Carmen,40,ES56209544069065867779,TRX_N-00559-569708807295,2024-02-21T14:31:38,Zarautz,Expense,leisure,-160.08,-9433.71
buyer_2,Carmen,40,ES56209544069065867779,TRX_N-00560-330120206138,2024-02-24T14:24:10,Zarautz,Expense,food,-664.44,-10098.15
buyer_2,Carmen,40,ES56209544069065867779,TRX_N-00561-347860778017,2024-03-01T10:40:18,Zarautz,transfer,Salary,1556.63,-8541.52
buyer_2,Carmen,40,ES56209544069065867779,TRX_N-00562-621547057409,2024-03-05T21:27:15,Zarautz,Housing,Rent,-651.68,-9193.2
buyer_2,Carmen,40,ES56209544069065867779,TRX_N-00563-549380205272,2024-03-05T02:12:32,Zarautz,Basic services,water,-67.93,-9261.13
buyer_2,Carmen,40,ES56209544069065867779,TRX_N-00564-469957156152,2024-03-07T13:24:25,Zarautz,Basic services,water,-78.96,-9340.09
buyer_2,Carmen,40,ES56209544069065867779,TRX_N-00565-430954385829,2024-03-07T10:56:56,Zarautz,Basic services,gas,-83.21,-9423.3
buyer_2,Carmen,40,ES56209544069065867779,TRX_N-00566-378497574921,2024-03-07T10:26:04,Zarautz,Basic services,internet,-62.59,-9485.89
buyer_2,Carmen,40,ES56209544069065867779,TRX_N-00567-239952282206,2024-03-07T13:43:32,Zarautz,Basic services,phone,-26.8,-9512.69
buyer_2,Carmen,40,ES56209544069065867779,TRX_N-00568-243031017707,2024-03-14T03:51:03,Mungia,Expense,transport,-184.95,-9697.64
buyer_2,Carmen,40,ES56209544069065867779,TRX_N-00569-622706838461,2024-03-15T23:13:59,Zarautz,Expense,food,-424.87,-10122.51
buyer_2,Carmen,40,ES56209544069065867779,TRX_N-00570-427156108672,2024-03-16T09:10:09,Zarautz,Expense,transport,-152.34,-10274.85
buyer_2,Carmen,40,ES56209544069065867779,TRX_N-00571-524598334476,2024-03-18T07:29:32,Zarautz,Expense,education,-312.72,-10587.57
buyer_2,Carmen,40,ES56209544069065867779,TRX_N-00572-152745756900,2024-03-26T08:27:28,Zarautz,Expense,education,-77.66,-10665.23
buyer_2,Carmen,40,ES56209544069065867779,TRX_N-00573-222754161583,2024-03-30T17:39:34,Zarautz,Expense,food,-737.46,-11402.69
buyer_2,Carmen,40,ES56209544069065867779,TRX_N-00574-962477647893,2024-04-01T09:40:04,Zarautz,transfer,Salary,1556.63,-9846.06
buyer_2,Carmen,40,ES56209544069065867779,TRX_N-00575-819365688632,2024-04-05T08:09:40,Zarautz,Housing,Rent,-651.68,-10497.74
buyer_2,Carmen,40,ES56209544069065867779,TRX_N-00576-275748775467,2024-04-05T13:27:06,Zarautz,Basic services,water,-50.14,-10547.88
buyer_2,Carmen,40,ES56209544069065867779,TRX_N-00577-129568870084,2024-04-05T14:23:48,Zarautz,Basic services,electricity,-108.96,-10656.84
buyer_2,Carmen,40,ES56209544069065867779,TRX_N-00578-577769764442,2024-04-05T13:21:31,Zarautz,Basic services,gas,-15.89,-10672.73
buyer_2,Carmen,40,ES56209544069065867779,TRX_N-00579-471944871315,2024-04-05T18:36:39,Zarautz,Expense,healthcare,-294.54,-10967.27
buyer_2,Carmen,40,ES56209544069065867779,TRX_N-00580-697523684373,2024-04-06T17:49:20,Zarautz,Basic services,electricity,-76.21,-11043.48
buyer_2,Carmen,40,ES56209544069065867779,TRX_N-00581-328431048318,2024-04-06T09:14:03,Zarautz,Basic services,gas,-80.98,-11124.46
buyer_2,Carmen,40,ES56209544069065867779,TRX_N-00582-355077571822,2024-04-07T13:05:36,Zarautz,Basic services,electricity,-80.12,-11204.58
buyer_2,Carmen,40,ES56209544069065867779,TRX_N-00583-496943880154,2024-04-12T05:08:15,Zarautz,Expense,food,-223.52,-11428.1
buyer_2,Carmen,40,ES56209544069065867779,TRX_N-00584-886354223432,2024-04-14T08:23:14,Zarautz,Expense,gifts,-129.2,-11557.3
buyer_2,Carmen,40,ES56209544069065867779,TRX_N-00585-113927024391,2024-05-01T17:30:14,Zarautz,transfer,Salary,1556.63,-10000.67
buyer_2,Carmen,40,ES56209544069065867779,TRX_N-00586-551871011300,2024-05-01T17:30:14,Zarautz,transfer,Extra Income,155.66,-9845.01
buyer_2,Carmen,40,ES56209544069065867779,TRX_N-00587-88412554231,2024-05-05T16:11:08,Zarautz,Housing,Rent,-651.68,-10496.69
buyer_2,Carmen,40,ES56209544069065867779,TRX_N-00588-72123552192,2024-05-05T18:22:01,Zarautz,Basic services,electricity,-58.61,-10555.3
buyer_2,Carmen,40,ES56209544069065867779,TRX_N-00589-945162879495,2024-05-05T17:42:28,Zarautz,Basic services,phone,-51.51,-10606.81
buyer_2,Carmen,40,ES56209544069065867779,TRX_N-00590-230127802686,2024-05-06T09:16:13,Zarautz,Basic services,water,-31.33,-10638.14
buyer_2,Carmen,40,ES56209544069065867779,TRX_N-00591-986575080802,2024-05-06T16:40:55,Zarautz,Basic services,electricity,-55.49,-10693.63
buyer_2,Carmen,40,ES56209544069065867779,TRX_N-00592-279253729613,2024-05-06T15:43:20,Zarautz,Basic services,internet,-74.16,-10767.79
buyer_2,Carmen,40,ES56209544069065867779,TRX_N-00593-163882954282,2024-05-06T19:29:27,Zarautz,Basic services,phone,-84.33,-10852.12
buyer_2,Carmen,40,ES56209544069065867779,TRX_N-00594-858352148901,2024-05-07T12:10:30,Zarautz,Basic services,electricity,-70.13,-10922.25
buyer_2,Carmen,40,ES56209544069065867779,TRX_N-00595-601521375459,2024-05-07T12:06:08,Zarautz,Basic services,internet,-59.81,-10982.06
buyer_2,Carmen,40,ES56209544069065867779,TRX_N-00596-711318006840,2024-05-08T12:07:59,Zarautz,Expense,leisure,-245.4,-11227.46
buyer_2,Carmen,40,ES56209544069065867779,TRX_N-00597-474528918120,2024-06-01T18:17:40,Zarautz,transfer,Salary,1556.63,-9670.83
buyer_2,Carmen,40,ES56209544069065867779,TRX_N-00598-852759195122,2024-06-01T18:17:40,Zarautz,transfer,Bonus,1617.13,-8053.7
buyer_2,Carmen,40,ES56209544069065867779,TRX_N-00599-666635470721,2024-06-05T17:01:31,Zarautz,Housing,Rent,-651.68,-8705.38
buyer_2,Carmen,40,ES56209544069065867779,TRX_N-00600-627271163098,2024-06-07T09:14:52,Zarautz,Basic services,water,-72.67,-8778.05
buyer_2,Carmen,40,ES56209544069065867779,TRX_N-00601-787354329991,2024-06-12T08:48:36,Lasarte-Oria,Expense,food,-712.56,-9490.61
buyer_2,Carmen,40,ES56209544069065867779,TRX_N-00602-381863219076,2024-06-14T15:13:25,Zarautz,Expense,travel,-2811.75,-12302.36
buyer_2,Carmen,40,ES56209544069065867779,TRX_N-00603-716579045501,2024-06-19T17:06:02,Zarautz,Expense,healthcare,-162.95,-12465.31
buyer_2,Carmen,40,ES56209544069065867779,TRX_N-00604-952632050329,2024-07-01T08:28:18,Zarautz,transfer,Salary,1556.63,-10908.68
buyer_2,Carmen,40,ES56209544069065867779,TRX_N-00605-642807809238,2024-07-01T08:28:18,Zarautz,transfer,Extra Income,155.66,-10753.02
buyer_2,Carmen,40,ES56209544069065867779,TRX_N-00606-788020781593,2024-07-04T12:11:30,Zarautz,Expense,transport,-33.8,-10786.82
buyer_2,Carmen,40,ES56209544069065867779,TRX_N-00607-281548919355,2024-07-05T18:56:47,Zarautz,Housing,Rent,-651.68,-11438.5
buyer_2,Carmen,40,ES56209544069065867779,TRX_N-00608-870749339396,2024-07-05T11:02:33,Zarautz,Basic services,electricity,-41.49,-11479.99
buyer_2,Carmen,40,ES56209544069065867779,TRX_N-00609-289028286043,2024-07-05T22:33:54,Zarautz,Expense,transport,-65.27,-11545.26
buyer_2,Carmen,40,ES56209544069065867779,TRX_N-00610-725699899837,2024-07-06T02:00:03,Zarautz,Basic services,water,-32.64,-11577.9
buyer_2,Carmen,40,ES56209544069065867779,TRX_N-00611-275648426962,2024-07-06T16:02:45,Zarautz,Basic services,internet,-45.99,-11623.89
buyer_2,Carmen,40,ES56209544069065867779,TRX_N-00612-10108807147,2024-07-07T10:29:50,Zarautz,Basic services,water,-46.73,-11670.62
buyer_2,Carmen,40,ES56209544069065867779,TRX_N-00613-281977562450,2024-07-10T19:24:39,Zarautz,Expense,food,-205.06,-11875.68
buyer_2,Carmen,40,ES56209544069065867779,TRX_N-00614-960553780257,2024-07-25T13:49:24,Durango,Expense,healthcare,-208.38,-12084.06
buyer_2,Carmen,40,ES56209544069065867779,TRX_N-00615-199758590181,2024-08-01T22:52:26,Zarautz,transfer,Salary,1556.63,-10527.43
buyer_2,Carmen,40,ES56209544069065867779,TRX_N-00616-375076840669,2024-08-05T02:24:45,Zarautz,Housing,Rent,-651.68,-11179.11
buyer_2,Carmen,40,ES56209544069065867779,TRX_N-00617-66782461290,2024-08-05T17:31:03,Zarautz,Basic services,electricity,-90.33,-11269.44
buyer_2,Carmen,40,ES56209544069065867779,TRX_N-00618-32108817390,2024-08-07T10:35:53,Zarautz,Basic services,water,-27.64,-11297.08
buyer_2,Carmen,40,ES56209544069065867779,TRX_N-00619-89151517285,2024-08-07T00:31:07,Zarautz,Basic services,electricity,-75.18,-11372.26
buyer_2,Carmen,40,ES56209544069065867779,TRX_N-00620-844638301362,2024-08-07T00:18:32,Zarautz,Basic services,phone,-43.24,-11415.5
buyer_2,Carmen,40,ES56209544069065867779,TRX_N-00621-845615928474,2024-08-16T11:32:19,Zarautz,Expense,healthcare,-144.52,-11560.02
buyer_2,Carmen,40,ES56209544069065867779,TRX_N-00622-999285505715,2024-08-18T09:06:58,Zarautz,Expense,gifts,-115.51,-11675.53
buyer_2,Carmen,40,ES56209544069065867779,TRX_N-00623-542520428231,2024-08-21T08:44:52,Zarautz,Expense,healthcare,-155.73,-11831.26
buyer_2,Carmen,40,ES56209544069065867779,TRX_N-00624-962265501568,2024-09-01T21:53:31,Zarautz,transfer,Salary,1556.63,-10274.63
buyer_2,Carmen,40,ES56209544069065867779,TRX_N-00625-36978243710,2024-09-01T21:53:31,Zarautz,transfer,Extra Income,155.66,-10118.97
buyer_2,Carmen,40,ES56209544069065867779,TRX_N-00626-297439187948,2024-09-04T17:41:46,Zarautz,Expense,repairs,-245.64,-10364.61
buyer_2,Carmen,40,ES56209544069065867779,TRX_N-00627-722859127104,2024-09-05T11:08:54,Zarautz,Housing,Rent,-651.68,-11016.29
buyer_2,Carmen,40,ES56209544069065867779,TRX_N-00628-688365706808,2024-09-06T16:14:50,Zarautz,Basic services,electricity,-26.76,-11043.05
buyer_2,Carmen,40,ES56209544069065867779,TRX_N-00629-601554008872,2024-09-18T09:40:42,Zarautz,Expense,transport,-113.54,-11156.59
buyer_2,Carmen,40,ES56209544069065867779,TRX_N-00630-665179228063,2024-09-21T15:16:12,Zarautz,Expense,gifts,-185.02,-11341.61
buyer_2,Carmen,40,ES56209544069065867779,TRX_N-00631-688300733496,2024-09-27T09:41:25,Zarautz,Expense,leisure,-233.41,-11575.02
buyer_2,Carmen,40,ES56209544069065867779,TRX_N-00632-128249855818,2024-10-01T09:57:26,Zarautz,transfer,Salary,1556.63,-10018.39
buyer_2,Carmen,40,ES56209544069065867779,TRX_N-00633-520866170412,2024-10-05T08:52:13,Zarautz,Housing,Rent,-651.68,-10670.07
buyer_2,Carmen,40,ES56209544069065867779,TRX_N-00634-980880049191,2024-10-05T22:42:13,Zarautz,Basic services,water,-78.61,-10748.68
buyer_2,Carmen,40,ES56209544069065867779,TRX_N-00635-565213081366,2024-10-05T22:55:17,Zarautz,Basic services,gas,-38.99,-10787.67
buyer_2,Carmen,40,ES56209544069065867779,TRX_N-00636-452483194322,2024-10-05T17:44:29,Zarautz,Basic services,phone,-48.04,-10835.71
buyer_2,Carmen,40,ES56209544069065867779,TRX_N-00637-421591795853,2024-10-06T20:36:44,Zarautz,Expense,clothing,-325.38,-11161.09
buyer_2,Carmen,40,ES56209544069065867779,TRX_N-00638-949924562348,2024-10-07T17:34:19,Zarautz,Basic services,water,-63.35,-11224.44
buyer_2,Carmen,40,ES56209544069065867779,TRX_N-00639-329555576506,2024-10-07T12:51:20,Zarautz,Basic services,gas,-46.35,-11270.79
buyer_2,Carmen,40,ES56209544069065867779,TRX_N-00640-59790456050,2024-10-08T18:19:34,Zarautz,Expense,transport,-64.63,-11335.42
buyer_3,Ana,35,ES22209579234312411751,TRX_N-00001-311775659946,2020-01-01T13:33:47,Amurrio,transfer,Salary,2222.18,5055.43
buyer_3,Ana,35,ES22209579234312411751,TRX_N-00002-128446466606,2020-01-01T13:33:47,Amurrio,transfer,Partner Salary,2217.53,7272.96
buyer_3,Ana,35,ES22209579234312411751,TRX_N-00003-995378074966,2020-01-02T08:14:33,Amurrio,Expense,food,-579.36,6693.6
buyer_3,Ana,35,ES22209579234312411751,TRX_N-00004-719074184937,2020-01-03T14:02:47,Amurrio,Expense,transport,-80.7,6612.9
buyer_3,Ana,35,ES22209579234312411751,TRX_N-00005-943112357296,2020-01-05T10:52:33,Amurrio,Housing,Rent,-1347.14,5265.76
buyer_3,Ana,35,ES22209579234312411751,TRX_N-00006-381819483309,2020-01-05T16:56:37,Durango,Expense,clothing,-215.81,5049.95
buyer_3,Ana,35,ES22209579234312411751,TRX_N-00007-139872585608,2020-01-06T22:02:18,Amurrio,Basic services,gas,-80.33,4969.62
buyer_3,Ana,35,ES22209579234312411751,TRX_N-00008-172531933600,2020-01-07T14:29:34,Amurrio,Basic services,electricity,-127.33,4842.29
buyer_3,Ana,35,ES22209579234312411751,TRX_N-00009-214739216865,2020-01-31T09:54:08,Amurrio,Expense,leisure,-289.0,4553.29
buyer_3,Ana,35,ES22209579234312411751,TRX_N-00010-827498355735,2020-02-01T20:52:15,Amurrio,transfer,Salary,2222.18,6775.47
buyer_3,Ana,35,ES22209579234312411751,TRX_N-00011-880133513458,2020-02-01T20:52:15,Amurrio,transfer,Partner Salary,2217.53,8993.0
buyer_3,Ana,35,ES22209579234312411751,TRX_N-00012-606657920421,2020-02-03T17:57:10,Amurrio,Expense,food,-153.76,8839.24
buyer_3,Ana,35,ES22209579234312411751,TRX_N-00013-8894529618,2020-02-05T13:18:29,Amurrio,Housing,Rent,-1347.14,7492.1
buyer_3,Ana,35,ES22209579234312411751,TRX_N-00014-849201246060,2020-02-05T19:28:49,Amurrio,Basic services,electricity,-82.75,7409.35
buyer_3,Ana,35,ES22209579234312411751,TRX_N-00015-552820220223,2020-02-06T09:39:53,Amurrio,Basic services,electricity,-46.7,7362.65
buyer_3,Ana,35,ES22209579234312411751,TRX_N-00016-175157339978,2020-02-06T11:47:23,Amurrio,Basic services,phone,-41.37,7321.28
buyer_3,Ana,35,ES22209579234312411751,TRX_N-00017-15793334668,2020-02-07T17:18:28,Amurrio,Basic services,electricity,-118.1,7203.18
buyer_3,Ana,35,ES22209579234312411751,TRX_N-00018-885491161607,2020-02-22T02:17:29,Amurrio,Expense,travel,-476.1,6727.08
buyer_3,Ana,35,ES22209579234312411751,TRX_N-00019-437628759729,2020-02-22T09:46:42,Bermeo,Expense,gifts,-408.16,6318.92
buyer_3,Ana,35,ES22209579234312411751,TRX_N-00020-226221766815,2020-02-23T17:35:24,Amurrio,Expense,food,-558.98,5759.94
buyer_3,Ana,35,ES22209579234312411751,TRX_N-00021-730645436025,2020-03-01T10:05:11,Amurrio,transfer,Salary,2222.18,7982.12
buyer_3,Ana,35,ES22209579234312411751,TRX_N-00022-105563851224,2020-03-01T10:05:11,Amurrio,transfer,Partner Salary,2217.53,10199.65
buyer_3,Ana,35,ES22209579234312411751,TRX_N-00023-599176082808,2020-03-01T10:05:11,Amurrio,transfer,Extra Income,222.22,10421.87
buyer_3,Ana,35,ES22209579234312411751,TRX_N-00024-571685876281,2020-03-05T11:56:43,Amurrio,Housing,Rent,-1347.14,9074.73
buyer_3,Ana,35,ES22209579234312411751,TRX_N-00025-337583777838,2020-03-05T20:13:40,Amurrio,Basic services,water,-75.11,8999.62
buyer_3,Ana,35,ES22209579234312411751,TRX_N-00026-293473805705,2020-03-05T13:39:22,Amurrio,Basic services,electricity,-20.12,8979.5
buyer_3,Ana,35,ES22209579234312411751,TRX_N-00027-23692867362,2020-03-05T14:41:33,Lasarte-Oria,Expense,appliances,-321.57,8657.93
buyer_3,Ana,35,ES22209579234312411751,TRX_N-00028-972049578217,2020-03-06T12:38:21,Amurrio,Basic services,gas,-55.4,8602.53
buyer_3,Ana,35,ES22209579234312411751,TRX_N-00029-465147240143,2020-03-07T09:57:57,Amurrio,Basic services,water,-17.22,8585.31
buyer_3,Ana,35,ES22209579234312411751,TRX_N-00030-622566660946,2020-03-07T09:33:06,Amurrio,Basic services,internet,-71.31,8514.0
buyer_3,Ana,35,ES22209579234312411751,TRX_N-00031-103980644548,2020-03-09T15:54:24,Amurrio,Expense,transport,-75.99,8438.01
buyer_3,Ana,35,ES22209579234312411751,TRX_N-00032-531732204327,2020-04-01T22:49:02,Amurrio,transfer,Salary,2222.18,10660.19
buyer_3,Ana,35,ES22209579234312411751,TRX_N-00033-610178686822,2020-04-01T22:49:02,Amurrio,transfer,Partner Salary,2217.53,12877.72
buyer_3,Ana,35,ES22209579234312411751,TRX_N-00034-46519873372,2020-04-03T01:16:33,Amurrio,Expense,leisure,-266.74,12610.98
buyer_3,Ana,35,ES22209579234312411751,TRX_N-00035-330243617008,2020-04-05T15:48:08,Amurrio,Housing,Rent,-1347.14,11263.84
buyer_3,Ana,35,ES22209579234312411751,TRX_N-00036-768982187902,2020-04-05T22:20:53,Amurrio,Basic services,electricity,-26.82,11237.02
buyer_3,Ana,35,ES22209579234312411751,TRX_N-00037-842080877634,2020-04-06T12:54:32,Amurrio,Basic services,water,-19.61,11217.41
buyer_3,Ana,35,ES22209579234312411751,TRX_N-00038-862713442017,2020-04-06T15:37:12,Amurrio,Basic services,internet,-68.76,11148.65
buyer_3,Ana,35,ES22209579234312411751,TRX_N-00039-6199738625,2020-04-07T16:58:38,Amurrio,Basic services,gas,-77.48,11071.17
buyer_3,Ana,35,ES22209579234312411751,TRX_N-00040-665638616084,2020-04-18T19:30:00,Amurrio,Expense,transport,-191.02,10880.15
buyer_3,Ana,35,ES22209579234312411751,TRX_N-00041-272377865479,2020-04-25T17:35:21,Amurrio,Expense,transport,-178.77,10701.38
buyer_3,Ana,35,ES22209579234312411751,TRX_N-00042-553183965862,2020-05-01T11:55:16,Amurrio,transfer,Salary,2222.18,12923.56
buyer_3,Ana,35,ES22209579234312411751,TRX_N-00043-516794110127,2020-05-01T11:55:16,Amurrio,transfer,Partner Salary,2217.53,15141.09
buyer_3,Ana,35,ES22209579234312411751,TRX_N-00044-4435783271,2020-05-05T18:38:19,Amurrio,Housing,Rent,-1347.14,13793.95
buyer_3,Ana,35,ES22209579234312411751,TRX_N-00045-779394716595,2020-05-05T17:27:22,Amurrio,Basic services,gas,-96.82,13697.13
buyer_3,Ana,35,ES22209579234312411751,TRX_N-00046-220008358687,2020-05-06T12:40:31,Amurrio,Basic services,water,-16.72,13680.41
buyer_3,Ana,35,ES22209579234312411751,TRX_N-00047-278604709323,2020-05-06T20:16:16,Amurrio,Basic services,internet,-36.08,13644.33
buyer_3,Ana,35,ES22209579234312411751,TRX_N-00048-298986599502,2020-05-07T17:55:03,Amurrio,Basic services,water,-67.82,13576.51
buyer_3,Ana,35,ES22209579234312411751,TRX_N-00049-492504512322,2020-05-07T09:06:26,Amurrio,Basic services,gas,-44.53,13531.98
buyer_3,Ana,35,ES22209579234312411751,TRX_N-00050-688038307371,2020-05-07T12:24:28,Amurrio,Basic services,phone,-35.36,13496.62
buyer_3,Ana,35,ES22209579234312411751,TRX_N-00051-767454494686,2020-05-09T14:50:45,Amurrio,Expense,repairs,-623.71,12872.91
buyer_3,Ana,35,ES22209579234312411751,TRX_N-00052-581663554097,2020-05-11T19:59:34,Amurrio,Expense,transport,-132.41,12740.5
buyer_3,Ana,35,ES22209579234312411751,TRX_N-00053-508733325993,2020-05-23T10:11:51,Amurrio,Expense,transport,-121.7,12618.8
buyer_3,Ana,35,ES22209579234312411751,TRX_N-00054-448020770055,2020-06-01T10:38:56,Amurrio,transfer,Salary,2222.18,14840.98
buyer_3,Ana,35,ES22209579234312411751,TRX_N-00055-919190087614,2020-06-01T10:38:56,Amurrio,transfer,Partner Salary,2217.53,17058.51
buyer_3,Ana,35,ES22209579234312411751,TRX_N-00056-256633102501,2020-06-01T10:38:56,Amurrio,transfer,Extra Income,222.22,17280.73
buyer_3,Ana,35,ES22209579234312411751,TRX_N-00057-567074051620,2020-06-01T10:38:56,Amurrio,transfer,Bonus,2128.72,19409.45
buyer_3,Ana,35,ES22209579234312411751,TRX_N-00058-251351278138,2020-06-05T08:07:14,Amurrio,Housing,Rent,-1347.14,18062.31
buyer_3,Ana,35,ES22209579234312411751,TRX_N-00059-973228358012,2020-06-05T21:38:45,Amurrio,Basic services,electricity,-81.66,17980.65
buyer_3,Ana,35,ES22209579234312411751,TRX_N-00060-411069274106,2020-06-05T20:10:33,Amurrio,Basic services,internet,-61.95,17918.7
buyer_3,Ana,35,ES22209579234312411751,TRX_N-00061-583134885568,2020-06-05T12:11:53,Errenteria,Expense,food,-441.95,17476.75
buyer_3,Ana,35,ES22209579234312411751,TRX_N-00062-839020819279,2020-06-06T20:58:20,Amurrio,Basic services,gas,-54.32,17422.43
buyer_3,Ana,35,ES22209579234312411751,TRX_N-00063-999659970311,2020-06-06T17:29:45,Amurrio,Basic services,internet,-33.78,17388.65
buyer_3,Ana,35,ES22209579234312411751,TRX_N-00064-681402858187,2020-06-07T12:19:34,Amurrio,Basic services,water,-13.36,17375.29
buyer_3,Ana,35,ES22209579234312411751,TRX_N-00065-48227954312,2020-06-07T00:17:02,Amurrio,Basic services,internet,-37.28,17338.01
buyer_3,Ana,35,ES22209579234312411751,TRX_N-00066-787011937481,2020-06-07T09:41:04,Amurrio,Basic services,phone,-66.21,17271.8
buyer_3,Ana,35,ES22209579234312411751,TRX_N-00067-48613298636,2020-06-07T15:59:50,Amurrio,Expense,repairs,-556.35,16715.45
buyer_3,Ana,35,ES22209579234312411751,TRX_N-00068-350843445729,2020-07-01T13:56:25,Amurrio,transfer,Salary,2222.18,18937.63
buyer_3,Ana,35,ES22209579234312411751,TRX_N-00069-738772036629,2020-07-01T13:56:25,Amurrio,transfer,Partner Salary,2217.53,21155.16
buyer_3,Ana,35,ES22209579234312411751,TRX_N-00070-590213895323,2020-07-05T17:14:42,Amurrio,Housing,Rent,-1347.14,19808.02
buyer_3,Ana,35,ES22209579234312411751,TRX_N-00071-734236917159,2020-07-05T11:02:04,Amurrio,Basic services,internet,-58.23,19749.79
buyer_3,Ana,35,ES22209579234312411751,TRX_N-00072-607174034636,2020-07-05T13:09:07,Amurrio,Expense,transport,-151.15,19598.64
buyer_3,Ana,35,ES22209579234312411751,TRX_N-00073-346974728103,2020-07-06T14:25:57,Amurrio,Basic services,water,-75.66,19522.98
buyer_3,Ana,35,ES22209579234312411751,TRX_N-00074-143362261754,2020-07-06T14:17:29,Amurrio,Basic services,electricity,-39.13,19483.85
buyer_3,Ana,35,ES22209579234312411751,TRX_N-00075-692092739139,2020-07-06T18:23:55,Amurrio,Expense,healthcare,-263.96,19219.89
buyer_3,Ana,35,ES22209579234312411751,TRX_N-00076-651898704564,2020-07-07T17:48:08,Amurrio,Basic services,water,-54.19,19165.7
buyer_3,Ana,35,ES22209579234312411751,TRX_N-00077-275002490688,2020-07-07T15:00:32,Amurrio,Basic services,electricity,-50.0,19115.7
buyer_3,Ana,35,ES22209579234312411751,TRX_N-00078-123228547632,2020-07-07T11:28:39,Amurrio,Basic services,gas,-55.03,19060.67
buyer_3,Ana,35,ES22209579234312411751,TRX_N-00079-110188672717,2020-07-07T19:42:42,Amurrio,Basic services,internet,-76.63,18984.04
buyer_3,Ana,35,ES22209579234312411751,TRX_N-00080-731831965903,2020-07-09T11:01:28,Amurrio,Expense,food,-464.87,18519.17
buyer_3,Ana,35,ES22209579234312411751,TRX_N-00081-66969319302,2020-07-24T15:34:30,Portugalete,Expense,leisure,-67.14,18452.03
buyer_3,Ana,35,ES22209579234312411751,TRX_N-00082-858032948270,2020-07-26T16:35:10,Elciego,Expense,gifts,-35.93,18416.1
buyer_3,Ana,35,ES22209579234312411751,TRX_N-00083-266064190719,2020-08-01T10:32:03,Amurrio,transfer,Salary,2222.18,20638.28
buyer_3,Ana,35,ES22209579234312411751,TRX_N-00084-774601039103,2020-08-01T10:32:03,Amurrio,transfer,Partner Salary,2217.53,22855.81
buyer_3,Ana,35,ES22209579234312411751,TRX_N-00085-767773533202,2020-08-01T10:32:03,Amurrio,transfer,Extra Income,222.22,23078.03
buyer_3,Ana,35,ES22209579234312411751,TRX_N-00086-498236714706,2020-08-01T11:15:40,Amurrio,Expense,transport,-183.73,22894.3
buyer_3,Ana,35,ES22209579234312411751,TRX_N-00087-601168169384,2020-08-05T09:48:13,Amurrio,Housing,Rent,-1347.14,21547.16
buyer_3,Ana,35,ES22209579234312411751,TRX_N-00088-210028244034,2020-08-05T10:20:16,Amurrio,Basic services,electricity,-103.79,21443.37
buyer_3,Ana,35,ES22209579234312411751,TRX_N-00089-574155253270,2020-08-06T17:11:59,Amurrio,Basic services,gas,-34.94,21408.43
buyer_3,Ana,35,ES22209579234312411751,TRX_N-00090-698913131254,2020-08-07T14:42:15,Amurrio,Basic services,electricity,-135.14,21273.29
buyer_3,Ana,35,ES22209579234312411751,TRX_N-00091-72292021208,2020-08-14T11:38:33,Amurrio,Expense,healthcare,-344.11,20929.18
buyer_3,Ana,35,ES22209579234312411751,TRX_N-00092-646732879634,2020-08-19T12:40:30,Amurrio,Expense,education,-649.61,20279.57
buyer_3,Ana,35,ES22209579234312411751,TRX_N-00093-147558218001,2020-08-28T17:00:49,Amurrio,Expense,healthcare,-273.16,20006.41
buyer_3,Ana,35,ES22209579234312411751,TRX_N-00094-150070793010,2020-09-01T20:02:04,Amurrio,transfer,Salary,2222.18,22228.59
buyer_3,Ana,35,ES22209579234312411751,TRX_N-00095-668142371190,2020-09-01T20:02:04,Amurrio,transfer,Partner Salary,2217.53,24446.12
buyer_3,Ana,35,ES22209579234312411751,TRX_N-00096-586741105551,2020-09-05T16:29:45,Amurrio,Housing,Rent,-1347.14,23098.98
buyer_3,Ana,35,ES22209579234312411751,TRX_N-00097-210407651310,2020-09-07T08:04:30,Amurrio,Basic services,electricity,-108.4,22990.58
buyer_3,Ana,35,ES22209579234312411751,TRX_N-00098-632536128441,2020-09-07T02:19:02,Amurrio,Basic services,gas,-61.27,22929.31
buyer_3,Ana,35,ES22209579234312411751,TRX_N-00099-371710847815,2020-09-08T10:49:22,Amurrio,Expense,leisure,-220.23,22709.08
buyer_3,Ana,35,ES22209579234312411751,TRX_N-00100-369343666527,2020-09-09T15:36:06,Amurrio,Expense,transport,-185.05,22524.03
buyer_3,Ana,35,ES22209579234312411751,TRX_N-00101-612802899523,2020-09-24T17:15:06,Santurtzi,Expense,clothing,-441.45,22082.58
buyer_3,Ana,35,ES22209579234312411751,TRX_N-00102-998186501793,2020-10-01T00:04:51,Amurrio,transfer,Salary,2222.18,24304.76
buyer_3,Ana,35,ES22209579234312411751,TRX_N-00103-537126894440,2020-10-01T00:04:51,Amurrio,transfer,Partner Salary,2217.53,26522.29
buyer_3,Ana,35,ES22209579234312411751,TRX_N-00104-856076130404,2020-10-01T00:04:51,Amurrio,transfer,Extra Income,222.22,26744.51
buyer_3,Ana,35,ES22209579234312411751,TRX_N-00105-16207511313,2020-10-05T17:02:02,Amurrio,Housing,Rent,-1347.14,25397.37
buyer_3,Ana,35,ES22209579234312411751,TRX_N-00106-156072242044,2020-10-05T17:01:07,Amurrio,Basic services,gas,-52.4,25344.97
buyer_3,Ana,35,ES22209579234312411751,TRX_N-00107-256748398373,2020-10-06T19:33:03,Amurrio,Basic services,gas,-19.7,25325.27
buyer_3,Ana,35,ES22209579234312411751,TRX_N-00108-989342695475,2020-10-06T23:57:04,Amurrio,Basic services,internet,-62.32,25262.95
buyer_3,Ana,35,ES22209579234312411751,TRX_N-00109-543710198524,2020-10-07T19:36:41,Amurrio,Basic services,water,-13.31,25249.64
buyer_3,Ana,35,ES22209579234312411751,TRX_N-00110-185195745361,2020-10-07T12:54:28,Amurrio,Basic services,electricity,-90.98,25158.66
buyer_3,Ana,35,ES22209579234312411751,TRX_N-00111-333236820331,2020-10-08T12:19:41,Amurrio,Expense,education,-825.9,24332.76
buyer_3,Ana,35,ES22209579234312411751,TRX_N-00112-193944599982,2020-10-19T08:29:04,Amurrio,Expense,transport,-79.31,24253.45
buyer_3,Ana,35,ES22209579234312411751,TRX_N-00113-588883267981,2020-10-24T18:52:31,Amurrio,Expense,travel,-1640.8,22612.65
buyer_3,Ana,35,ES22209579234312411751,TRX_N-00114-533072996359,2020-10-27T22:47:19,Amurrio,Expense,transport,-174.28,22438.37
buyer_3,Ana,35,ES22209579234312411751,TRX_N-00115-24939034025,2020-10-30T17:27:27,Amurrio,Expense,gifts,-76.87,22361.5
buyer_3,Ana,35,ES22209579234312411751,TRX_N-00116-765387604835,2020-11-01T14:00:48,Amurrio,transfer,Salary,2222.18,24583.68
buyer_3,Ana,35,ES22209579234312411751,TRX_N-00117-759344714918,2020-11-01T14:00:48,Amurrio,transfer,Partner Salary,2217.53,26801.21
buyer_3,Ana,35,ES22209579234312411751,TRX_N-00118-424751645081,2020-11-01T18:02:06,Amurrio,Expense,food,-333.96,26467.25
buyer_3,Ana,35,ES22209579234312411751,TRX_N-00119-547411229605,2020-11-05T08:01:37,Amurrio,Housing,Rent,-1347.14,25120.11
buyer_3,Ana,35,ES22209579234312411751,TRX_N-00120-692918182761,2020-11-05T21:45:58,Amurrio,Basic services,water,-63.61,25056.5
buyer_3,Ana,35,ES22209579234312411751,TRX_N-00121-619338618663,2020-11-05T10:36:24,Amurrio,Basic services,gas,-26.48,25030.02
buyer_3,Ana,35,ES22209579234312411751,TRX_N-00122-535114971358,2020-11-06T08:07:08,Amurrio,Basic services,gas,-73.72,24956.3
buyer_3,Ana,35,ES22209579234312411751,TRX_N-00123-841508047332,2020-11-08T11:56:22,Amurrio,Expense,gifts,-337.24,24619.06
buyer_3,Ana,35,ES22209579234312411751,TRX_N-00124-750110324717,2020-11-14T20:53:18,Amurrio,Expense,leisure,-165.39,24453.67
buyer_3,Ana,35,ES22209579234312411751,TRX_N-00125-377984928541,2020-11-30T07:18:04,Amurrio,Expense,transport,-69.34,24384.33
buyer_3,Ana,35,ES22209579234312411751,TRX_N-00126-598705217645,2020-12-01T17:05:32,Amurrio,transfer,Salary,2222.18,26606.51
buyer_3,Ana,35,ES22209579234312411751,TRX_N-00127-754397015913,2020-12-01T17:05:32,Amurrio,transfer,Partner Salary,2217.53,28824.04
buyer_3,Ana,35,ES22209579234312411751,TRX_N-00128-53936419872,2020-12-01T17:05:32,Amurrio,transfer,Extra Income,222.22,29046.26
buyer_3,Ana,35,ES22209579234312411751,TRX_N-00129-782640508337,2020-12-01T17:05:32,Amurrio,transfer,Bonus,2222.35,31268.61
buyer_3,Ana,35,ES22209579234312411751,TRX_N-00130-430981270305,2020-12-05T18:35:48,Amurrio,Housing,Rent,-1347.14,29921.47
buyer_3,Ana,35,ES22209579234312411751,TRX_N-00131-850015544144,2020-12-05T04:53:07,Amurrio,Basic services,water,-56.1,29865.37
buyer_3,Ana,35,ES22209579234312411751,TRX_N-00132-578801225507,2020-12-05T17:53:00,Amurrio,Basic services,gas,-42.47,29822.9
buyer_3,Ana,35,ES22209579234312411751,TRX_N-00133-114454790398,2020-12-05T02:34:35,Amurrio,Basic services,internet,-75.32,29747.58
buyer_3,Ana,35,ES22209579234312411751,TRX_N-00134-426363398988,2020-12-05T20:04:08,Amurrio,Basic services,phone,-39.16,29708.42
buyer_3,Ana,35,ES22209579234312411751,TRX_N-00135-228002026205,2020-12-06T16:18:55,Amurrio,Basic services,water,-31.92,29676.5
buyer_3,Ana,35,ES22209579234312411751,TRX_N-00136-525662727920,2020-12-06T12:49:37,Amurrio,Basic services,gas,-67.29,29609.21
buyer_3,Ana,35,ES22209579234312411751,TRX_N-00137-584824295726,2020-12-06T15:49:42,Amurrio,Basic services,phone,-43.61,29565.6
buyer_3,Ana,35,ES22209579234312411751,TRX_N-00138-540392667386,2020-12-07T18:53:34,Amurrio,Basic services,internet,-39.06,29526.54
buyer_3,Ana,35,ES22209579234312411751,TRX_N-00139-388978610614,2020-12-10T23:31:02,Basauri,Expense,leisure,-27.83,29498.71
buyer_3,Ana,35,ES22209579234312411751,TRX_N-00140-807525839594,2020-12-16T19:34:29,Amurrio,Expense,food,-627.57,28871.14
buyer_3,Ana,35,ES22209579234312411751,TRX_N-00141-217493130987,2020-12-17T15:10:08,Bermeo,Expense,transport,-186.22,28684.92
buyer_3,Ana,35,ES22209579234312411751,TRX_N-00142-973000504955,2020-12-25T15:02:50,Amurrio,Expense,food,-173.26,28511.66
buyer_3,Ana,35,ES22209579234312411751,TRX_N-00143-906660916802,2020-12-27T03:55:59,Amurrio,Expense,transport,-32.81,28478.85
buyer_3,Ana,35,ES22209579234312411751,TRX_N-00144-772808045519,2021-01-01T18:39:52,Amurrio,transfer,Salary,2222.18,30701.03
buyer_3,Ana,35,ES22209579234312411751,TRX_N-00145-704355740135,2021-01-01T18:39:52,Amurrio,transfer,Partner Salary,2217.53,32918.56
buyer_3,Ana,35,ES22209579234312411751,TRX_N-00146-702931342632,2021-01-03T13:04:37,Amurrio,Expense,food,-311.45,32607.11
buyer_3,Ana,35,ES22209579234312411751,TRX_N-00147-569709070417,2021-01-05T18:53:42,Amurrio,Housing,Rent,-1347.14,31259.97
buyer_3,Ana,35,ES22209579234312411751,TRX_N-00148-140014758006,2021-01-05T19:05:45,Amurrio,Expense,clothing,-266.37,30993.6
buyer_3,Ana,35,ES22209579234312411751,TRX_N-00149-865148969263,2021-01-07T02:57:37,Amurrio,Basic services,water,-54.42,30939.18
buyer_3,Ana,35,ES22209579234312411751,TRX_N-00150-250856441233,2021-01-07T17:20:03,Amurrio,Basic services,gas,-92.49,30846.69
buyer_3,Ana,35,ES22209579234312411751,TRX_N-00151-796856291549,2021-01-08T12:54:28,Amurrio,Expense,appliances,-1577.5,29269.19
buyer_3,Ana,35,ES22209579234312411751,TRX_N-00152-835932195985,2021-01-21T10:05:01,Amurrio,Expense,clothing,-458.12,28811.07
buyer_3,Ana,35,ES22209579234312411751,TRX_N-00153-764713037162,2021-01-25T16:45:19,Amurrio,Expense,food,-132.76,28678.31
buyer_3,Ana,35,ES22209579234312411751,TRX_N-00154-237834738940,2021-02-01T11:47:25,Amurrio,transfer,Salary,2222.18,30900.49
buyer_3,Ana,35,ES22209579234312411751,TRX_N-00155-112182454722,2021-02-01T11:47:25,Amurrio,transfer,Partner Salary,2217.53,33118.02
buyer_3,Ana,35,ES22209579234312411751,TRX_N-00156-256450183147,2021-02-05T16:36:22,Amurrio,Housing,Rent,-1347.14,31770.88
buyer_3,Ana,35,ES22209579234312411751,TRX_N-00157-532398957371,2021-02-06T11:13:55,Amurrio,Basic services,electricity,-24.37,31746.51
buyer_3,Ana,35,ES22209579234312411751,TRX_N-00158-593577507062,2021-02-06T23:43:49,Amurrio,Basic services,gas,-37.72,31708.79
buyer_3,Ana,35,ES22209579234312411751,TRX_N-00159-374126885190,2021-02-06T09:00:13,Amurrio,Basic services,internet,-37.32,31671.47
buyer_3,Ana,35,ES22209579234312411751,TRX_N-00160-200986693,2021-02-06T20:28:29,Amurrio,Basic services,phone,-31.98,31639.49
buyer_3,Ana,35,ES22209579234312411751,TRX_N-00161-541604170531,2021-02-07T20:50:26,Amurrio,Basic services,electricity,-20.82,31618.67
buyer_3,Ana,35,ES22209579234312411751,TRX_N-00162-526703757511,2021-02-07T01:43:13,Amurrio,Basic services,gas,-21.85,31596.82
buyer_3,Ana,35,ES22209579234312411751,TRX_N-00163-621584641195,2021-02-07T17:07:24,Amurrio,Basic services,internet,-71.24,31525.58
buyer_3,Ana,35,ES22209579234312411751,TRX_N-00164-436899403157,2021-02-07T11:34:08,Amurrio,Basic services,phone,-92.99,31432.59
buyer_3,Ana,35,ES22209579234312411751,TRX_N-00165-17107529504,2021-02-12T08:09:10,Lasarte-Oria,Expense,leisure,-296.44,31136.15
buyer_3,Ana,35,ES22209579234312411751,TRX_N-00166-933269371699,2021-02-22T09:25:33,Amurrio,Expense,food,-662.69,30473.46
buyer_3,Ana,35,ES22209579234312411751,TRX_N-00167-34341553171,2021-03-01T07:53:37,Amurrio,transfer,Salary,2222.18,32695.64
buyer_3,Ana,35,ES22209579234312411751,TRX_N-00168-411990904502,2021-03-01T07:53:37,Amurrio,transfer,Partner Salary,2217.53,34913.17
buyer_3,Ana,35,ES22209579234312411751,TRX_N-00169-392609725320,2021-03-01T07:53:37,Amurrio,transfer,Extra Income,222.22,35135.39
buyer_3,Ana,35,ES22209579234312411751,TRX_N-00170-328621303561,2021-03-05T20:57:31,Amurrio,Housing,Rent,-1347.14,33788.25
buyer_3,Ana,35,ES22209579234312411751,TRX_N-00171-742609319387,2021-03-05T01:11:31,Amurrio,Basic services,electricity,-111.82,33676.43
buyer_3,Ana,35,ES22209579234312411751,TRX_N-00172-414517584867,2021-03-05T20:13:24,Amurrio,Basic services,gas,-73.82,33602.61
buyer_3,Ana,35,ES22209579234312411751,TRX_N-00173-279195035358,2021-03-05T18:35:07,Amurrio,Basic services,internet,-50.93,33551.68
buyer_3,Ana,35,ES22209579234312411751,TRX_N-00174-141059184158,2021-03-05T08:30:49,Amurrio,Basic services,phone,-35.09,33516.59
buyer_3,Ana,35,ES22209579234312411751,TRX_N-00175-392157492774,2021-03-06T11:54:03,Amurrio,Basic services,water,-63.88,33452.71
buyer_3,Ana,35,ES22209579234312411751,TRX_N-00176-49208690533,2021-03-06T20:29:22,Amurrio,Basic services,internet,-34.83,33417.88
buyer_3,Ana,35,ES22209579234312411751,TRX_N-00177-857936746969,2021-03-07T19:29:08,Amurrio,Basic services,electricity,-20.45,33397.43
buyer_3,Ana,35,ES22209579234312411751,TRX_N-00178-494447805218,2021-03-11T13:06:37,Amurrio,Expense,transport,-130.33,33267.1
buyer_3,Ana,35,ES22209579234312411751,TRX_N-00179-967847595213,2021-03-21T13:45:07,Amurrio,Expense,transport,-70.23,33196.87
buyer_3,Ana,35,ES22209579234312411751,TRX_N-00180-540902381309,2021-03-26T19:01:20,Amurrio,Expense,food,-558.24,32638.63
buyer_3,Ana,35,ES22209579234312411751,TRX_N-00181-547759692110,2021-04-01T02:57:20,Amurrio,transfer,Salary,2222.18,34860.81
buyer_3,Ana,35,ES22209579234312411751,TRX_N-00182-432318467674,2021-04-01T02:57:20,Amurrio,transfer,Partner Salary,2217.53,37078.34
buyer_3,Ana,35,ES22209579234312411751,TRX_N-00183-141839699108,2021-04-03T17:15:23,Amurrio,Expense,leisure,-249.92,36828.42
buyer_3,Ana,35,ES22209579234312411751,TRX_N-00184-131711345372,2021-04-05T14:22:35,Amurrio,Housing,Rent,-1347.14,35481.28
buyer_3,Ana,35,ES22209579234312411751,TRX_N-00185-349194167557,2021-04-05T18:48:29,Amurrio,Basic services,water,-20.43,35460.85
buyer_3,Ana,35,ES22209579234312411751,TRX_N-00186-716736363228,2021-04-05T12:28:28,Amurrio,Basic services,phone,-73.26,35387.59
buyer_3,Ana,35,ES22209579234312411751,TRX_N-00187-359137316167,2021-04-06T20:28:40,Amurrio,Basic services,water,-78.72,35308.87
buyer_3,Ana,35,ES22209579234312411751,TRX_N-00188-835959165266,2021-04-07T18:59:50,Amurrio,Basic services,water,-25.8,35283.07
buyer_3,Ana,35,ES22209579234312411751,TRX_N-00189-834380688967,2021-04-12T15:43:27,Llodio,Expense,transport,-48.7,35234.37
buyer_3,Ana,35,ES22209579234312411751,TRX_N-00190-441144459717,2021-04-17T09:35:14,Amurrio,Expense,leisure,-204.24,35030.13
buyer_3,Ana,35,ES22209579234312411751,TRX_N-00191-261395545401,2021-05-01T15:57:22,Amurrio,transfer,Salary,2222.18,37252.31
buyer_3,Ana,35,ES22209579234312411751,TRX_N-00192-540588607547,2021-05-01T15:57:22,Amurrio,transfer,Partner Salary,2217.53,39469.84
buyer_3,Ana,35,ES22209579234312411751,TRX_N-00193-437959692708,2021-05-05T16:38:17,Amurrio,Housing,Rent,-1347.14,38122.7
buyer_3,Ana,35,ES22209579234312411751,TRX_N-00194-578951773824,2021-05-05T16:46:12,Amurrio,Basic services,water,-49.17,38073.53
buyer_3,Ana,35,ES22209579234312411751,TRX_N-00195-824694497281,2021-05-05T20:30:25,Amurrio,Basic services,phone,-69.67,38003.86
buyer_3,Ana,35,ES22209579234312411751,TRX_N-00196-808370963610,2021-05-06T22:20:34,Amurrio,Basic services,water,-29.24,37974.62
buyer_3,Ana,35,ES22209579234312411751,TRX_N-00197-884449418086,2021-05-06T18:10:13,Amurrio,Basic services,phone,-81.55,37893.07
buyer_3,Ana,35,ES22209579234312411751,TRX_N-00198-686164997799,2021-05-07T12:54:39,Amurrio,Basic services,internet,-52.71,37840.36
buyer_3,Ana,35,ES22209579234312411751,TRX_N-00199-83364213281,2021-05-07T14:56:41,Amurrio,Expense,food,-592.09,37248.27
buyer_3,Ana,35,ES22209579234312411751,TRX_N-00200-461752263362,2021-05-10T20:36:00,Amurrio,Expense,transport,-103.42,37144.85
buyer_3,Ana,35,ES22209579234312411751,TRX_N-00201-324996617190,2021-05-16T13:01:50,Amurrio,Expense,food,-483.75,36661.1
buyer_3,Ana,35,ES22209579234312411751,TRX_N-00202-642694884329,2021-05-20T16:00:10,Amurrio,Expense,clothing,-319.51,36341.59
buyer_3,Ana,35,ES22209579234312411751,TRX_N-00203-230502721319,2021-05-22T06:57:48,Amurrio,Expense,transport,-32.22,36309.37
buyer_3,Ana,35,ES22209579234312411751,TRX_N-00204-176058276254,2021-05-26T18:31:08,Amurrio,Expense,leisure,-228.37,36081.0
buyer_3,Ana,35,ES22209579234312411751,TRX_N-00205-454288494580,2021-05-31T12:13:04,Amurrio,Expense,clothing,-177.47,35903.53
buyer_3,Ana,35,ES22209579234312411751,TRX_N-00206-983543425524,2021-06-01T17:07:03,Amurrio,transfer,Salary,2222.18,38125.71
buyer_3,Ana,35,ES22209579234312411751,TRX_N-00207-159106975211,2021-06-01T17:07:03,Amurrio,transfer,Partner Salary,2217.53,40343.24
buyer_3,Ana,35,ES22209579234312411751,TRX_N-00208-927861761588,2021-06-01T17:07:03,Amurrio,transfer,Extra Income,222.22,40565.46
buyer_3,Ana,35,ES22209579234312411751,TRX_N-00209-424709236525,2021-06-01T17:07:03,Amurrio,transfer,Bonus,2429.19,42994.65
buyer_3,Ana,35,ES22209579234312411751,TRX_N-00210-321451583215,2021-06-05T14:19:18,Amurrio,Housing,Rent,-1347.14,41647.51
buyer_3,Ana,35,ES22209579234312411751,TRX_N-00211-280883150654,2021-06-05T16:26:02,Amurrio,Basic services,water,-12.37,41635.14
buyer_3,Ana,35,ES22209579234312411751,TRX_N-00212-902736110290,2021-06-05T11:51:01,Amurrio,Basic services,internet,-50.62,41584.52
buyer_3,Ana,35,ES22209579234312411751,TRX_N-00213-546428430932,2021-06-05T08:31:05,Leioa,Expense,food,-655.07,40929.45
buyer_3,Ana,35,ES22209579234312411751,TRX_N-00214-22054494225,2021-06-06T17:40:37,Amurrio,Basic services,water,-49.06,40880.39
buyer_3,Ana,35,ES22209579234312411751,TRX_N-00215-377901132906,2021-06-06T08:18:13,Amurrio,Basic services,electricity,-86.87,40793.52
buyer_3,Ana,35,ES22209579234312411751,TRX_N-00216-556120241720,2021-06-06T10:39:28,Amurrio,Basic services,gas,-44.3,40749.22
buyer_3,Ana,35,ES22209579234312411751,TRX_N-00217-765644904705,2021-06-07T11:18:54,Amurrio,Basic services,water,-50.25,40698.97
buyer_3,Ana,35,ES22209579234312411751,TRX_N-00218-922785199813,2021-06-07T10:02:10,Amurrio,Basic services,phone,-29.27,40669.7
buyer_3,Ana,35,ES22209579234312411751,TRX_N-00219-558121798734,2021-06-16T12:19:06,Amurrio,Expense,transport,-22.72,40646.98
buyer_3,Ana,35,ES22209579234312411751,TRX_N-00220-752276360293,2021-06-24T10:52:58,Amurrio,Expense,appliances,-833.12,39813.86
buyer_3,Ana,35,ES22209579234312411751,TRX_N-00221-790871721863,2021-07-01T11:06:51,Amurrio,transfer,Salary,2222.18,42036.04
buyer_3,Ana,35,ES22209579234312411751,TRX_N-00222-151783466701,2021-07-01T11:06:51,Amurrio,transfer,Partner Salary,2217.53,44253.57
buyer_3,Ana,35,ES22209579234312411751,TRX_N-00223-69733250391,2021-07-05T18:37:45,Amurrio,Housing,Rent,-1347.14,42906.43
buyer_3,Ana,35,ES22209579234312411751,TRX_N-00224-218424942622,2021-07-05T14:18:07,Amurrio,Basic services,electricity,-73.83,42832.6
buyer_3,Ana,35,ES22209579234312411751,TRX_N-00225-377907600037,2021-07-05T11:40:47,Amurrio,Basic services,gas,-23.81,42808.79
buyer_3,Ana,35,ES22209579234312411751,TRX_N-00226-485543591431,2021-07-06T18:23:05,Amurrio,Basic services,water,-12.76,42796.03
buyer_3,Ana,35,ES22209579234312411751,TRX_N-00227-712562452371,2021-07-06T19:53:02,Amurrio,Basic services,internet,-31.38,42764.65
buyer_3,Ana,35,ES22209579234312411751,TRX_N-00228-185787753954,2021-07-07T03:58:03,Amurrio,Basic services,water,-11.8,42752.85
buyer_3,Ana,35,ES22209579234312411751,TRX_N-00229-849709126073,2021-07-07T15:07:26,Amurrio,Basic services,phone,-74.97,42677.88
buyer_3,Ana,35,ES22209579234312411751,TRX_N-00230-900022979930,2021-07-08T15:06:47,Amurrio,Expense,leisure,-277.19,42400.69
buyer_3,Ana,35,ES22209579234312411751,TRX_N-00231-722441951070,2021-07-13T16:31:06,Hernani,Expense,food,-363.1,42037.59
buyer_3,Ana,35,ES22209579234312411751,TRX_N-00232-899676984357,2021-07-18T19:13:25,Errenteria,Expense,transport,-46.78,41990.81
buyer_3,Ana,35,ES22209579234312411751,TRX_N-00233-859293391089,2021-07-23T08:53:01,Amurrio,Expense,gifts,-193.23,41797.58
buyer_3,Ana,35,ES22209579234312411751,TRX_N-00234-125052922669,2021-07-27T09:37:55,Amurrio,Expense,food,-123.95,41673.63
buyer_3,Ana,35,ES22209579234312411751,TRX_N-00235-646629309344,2021-07-31T09:56:22,Amurrio,Expense,food,-552.55,41121.08
buyer_3,Ana,35,ES22209579234312411751,TRX_N-00236-659078699750,2021-07-31T15:16:02,Amurrio,Expense,transport,-24.16,41096.92
buyer_3,Ana,35,ES22209579234312411751,TRX_N-00237-438730471473,2021-08-01T21:46:20,Amurrio,transfer,Salary,2222.18,43319.1
buyer_3,Ana,35,ES22209579234312411751,TRX_N-00238-692235023830,2021-08-01T21:46:20,Amurrio,transfer,Partner Salary,2217.53,45536.63
buyer_3,Ana,35,ES22209579234312411751,TRX_N-00239-954909641383,2021-08-01T21:46:20,Amurrio,transfer,Extra Income,222.22,45758.85
buyer_3,Ana,35,ES22209579234312411751,TRX_N-00240-373991265776,2021-08-03T18:00:07,Errenteria,Expense,clothing,-135.06,45623.79
buyer_3,Ana,35,ES22209579234312411751,TRX_N-00241-22772989031,2021-08-05T10:59:51,Amurrio,Housing,Rent,-1347.14,44276.65
buyer_3,Ana,35,ES22209579234312411751,TRX_N-00242-543930998344,2021-08-05T17:19:04,Amurrio,Basic services,water,-46.82,44229.83
buyer_3,Ana,35,ES22209579234312411751,TRX_N-00243-775829788577,2021-08-05T15:16:56,Amurrio,Basic services,internet,-43.73,44186.1
buyer_3,Ana,35,ES22209579234312411751,TRX_N-00244-758112465653,2021-08-07T06:22:38,Amurrio,Basic services,gas,-75.86,44110.24
buyer_3,Ana,35,ES22209579234312411751,TRX_N-00245-600338424279,2021-08-07T13:22:48,Amurrio,Basic services,internet,-51.68,44058.56
buyer_3,Ana,35,ES22209579234312411751,TRX_N-00246-291123276794,2021-08-22T15:33:24,Amurrio,Expense,repairs,-466.8,43591.76
buyer_3,Ana,35,ES22209579234312411751,TRX_N-00247-21173156572,2021-09-01T13:57:13,Amurrio,transfer,Salary,2222.18,45813.94
buyer_3,Ana,35,ES22209579234312411751,TRX_N-00248-930860766344,2021-09-01T13:57:13,Amurrio,transfer,Partner Salary,2217.53,48031.47
buyer_3,Ana,35,ES22209579234312411751,TRX_N-00249-821645618939,2021-09-02T16:10:07,Amurrio,Expense,clothing,-78.4,47953.07
buyer_3,Ana,35,ES22209579234312411751,TRX_N-00250-128605728879,2021-09-03T10:57:05,Amurrio,Expense,food,-354.35,47598.72
buyer_3,Ana,35,ES22209579234312411751,TRX_N-00251-937507478901,2021-09-05T17:18:41,Amurrio,Housing,Rent,-1347.14,46251.58
buyer_3,Ana,35,ES22209579234312411751,TRX_N-00252-852229872818,2021-09-05T12:31:26,Amurrio,Basic services,internet,-30.37,46221.21
buyer_3,Ana,35,ES22209579234312411751,TRX_N-00253-537293784305,2021-09-06T13:20:16,Amurrio,Basic services,water,-12.04,46209.17
buyer_3,Ana,35,ES22209579234312411751,TRX_N-00254-821072589,2021-09-07T14:00:26,Amurrio,Basic services,water,-12.79,46196.38
buyer_3,Ana,35,ES22209579234312411751,TRX_N-00255-105977089299,2021-09-07T18:27:40,Amurrio,Expense,food,-617.1,45579.28
buyer_3,Ana,35,ES22209579234312411751,TRX_N-00256-171335829046,2021-09-07T18:03:46,Amurrio,Expense,gifts,-463.56,45115.72
buyer_3,Ana,35,ES22209579234312411751,TRX_N-00257-978089674677,2021-09-09T20:04:01,Amurrio,Expense,clothing,-412.12,44703.6
buyer_3,Ana,35,ES22209579234312411751,TRX_N-00258-930400987766,2021-09-24T09:09:30,Amurrio,Expense,transport,-144.76,44558.84
buyer_3,Ana,35,ES22209579234312411751,TRX_N-00259-860972246942,2021-10-01T04:53:04,Amurrio,transfer,Salary,2222.18,46781.02
buyer_3,Ana,35,ES22209579234312411751,TRX_N-00260-480782481734,2021-10-01T04:53:04,Amurrio,transfer,Partner Salary,2217.53,48998.55
buyer_3,Ana,35,ES22209579234312411751,TRX_N-00261-181744166219,2021-10-01T04:53:04,Amurrio,transfer,Extra Income,222.22,49220.77
buyer_3,Ana,35,ES22209579234312411751,TRX_N-00262-170478721160,2021-10-05T18:25:17,Amurrio,Housing,Rent,-1347.14,47873.63
buyer_3,Ana,35,ES22209579234312411751,TRX_N-00263-289504252783,2021-10-05T16:17:01,Amurrio,Basic services,electricity,-59.27,47814.36
buyer_3,Ana,35,ES22209579234312411751,TRX_N-00264-521207850523,2021-10-06T16:06:38,Amurrio,Basic services,electricity,-57.1,47757.26
buyer_3,Ana,35,ES22209579234312411751,TRX_N-00265-702710197853,2021-10-06T22:26:22,Amurrio,Basic services,internet,-79.89,47677.37
buyer_3,Ana,35,ES22209579234312411751,TRX_N-00266-144480098192,2021-10-06T20:54:22,Amurrio,Basic services,phone,-47.82,47629.55
buyer_3,Ana,35,ES22209579234312411751,TRX_N-00267-572916651659,2021-10-09T14:11:41,Amurrio,Expense,transport,-116.09,47513.46
buyer_3,Ana,35,ES22209579234312411751,TRX_N-00268-991403272294,2021-10-23T08:51:12,Amurrio,Expense,food,-722.47,46790.99
buyer_3,Ana,35,ES22209579234312411751,TRX_N-00269-427419193277,2021-10-25T20:30:00,Amurrio,Expense,healthcare,-293.51,46497.48
buyer_3,Ana,35,ES22209579234312411751,TRX_N-00270-870858804576,2021-11-01T12:56:23,Amurrio,transfer,Salary,2222.18,48719.66
buyer_3,Ana,35,ES22209579234312411751,TRX_N-00271-593627393109,2021-11-01T12:56:23,Amurrio,transfer,Partner Salary,2217.53,50937.19
buyer_3,Ana,35,ES22209579234312411751,TRX_N-00272-509583749890,2021-11-03T09:04:33,Amurrio,Expense,transport,-20.79,50916.4
buyer_3,Ana,35,ES22209579234312411751,TRX_N-00273-595125255606,2021-11-05T10:19:51,Amurrio,Housing,Rent,-1347.14,49569.26
buyer_3,Ana,35,ES22209579234312411751,TRX_N-00274-581422604703,2021-11-05T06:45:46,Amurrio,Basic services,water,-12.38,49556.88
buyer_3,Ana,35,ES22209579234312411751,TRX_N-00275-995803046428,2021-11-05T19:02:18,Amurrio,Basic services,gas,-42.92,49513.96
buyer_3,Ana,35,ES22209579234312411751,TRX_N-00276-875465269045,2021-11-05T10:22:57,Amurrio,Basic services,internet,-76.48,49437.48
buyer_3,Ana,35,ES22209579234312411751,TRX_N-00277-217838683683,2021-11-06T14:15:56,Amurrio,Basic services,water,-44.2,49393.28
buyer_3,Ana,35,ES22209579234312411751,TRX_N-00278-63309492116,2021-11-06T18:06:00,Amurrio,Basic services,electricity,-137.18,49256.1
buyer_3,Ana,35,ES22209579234312411751,TRX_N-00279-63872192733,2021-11-06T21:03:46,Amurrio,Basic services,internet,-37.77,49218.33
buyer_3,Ana,35,ES22209579234312411751,TRX_N-00280-821510554631,2021-11-06T03:41:00,Amurrio,Basic services,phone,-86.16,49132.17
buyer_3,Ana,35,ES22209579234312411751,TRX_N-00281-896407489773,2021-11-07T14:42:14,Amurrio,Basic services,gas,-62.49,49069.68
buyer_3,Ana,35,ES22209579234312411751,TRX_N-00282-197108330418,2021-11-07T08:49:54,Amurrio,Basic services,internet,-72.38,48997.3
buyer_3,Ana,35,ES22209579234312411751,TRX_N-00283-13360727648,2021-11-07T22:47:46,Amurrio,Basic services,phone,-81.35,48915.95
buyer_3,Ana,35,ES22209579234312411751,TRX_N-00284-59596668901,2021-11-07T09:12:59,Amurrio,Expense,food,-526.71,48389.24
buyer_3,Ana,35,ES22209579234312411751,TRX_N-00285-825579378802,2021-11-09T18:57:57,Amurrio,Expense,education,-430.92,47958.32
buyer_3,Ana,35,ES22209579234312411751,TRX_N-00286-476713043053,2021-11-11T09:19:03,Amurrio,Expense,food,-138.71,47819.61
buyer_3,Ana,35,ES22209579234312411751,TRX_N-00287-890606294244,2021-11-19T18:11:29,Pasaia,Expense,transport,-98.43,47721.18
buyer_3,Ana,35,ES22209579234312411751,TRX_N-00288-509341223890,2021-11-23T10:07:57,Amurrio,Expense,food,-370.32,47350.86
buyer_3,Ana,35,ES22209579234312411751,TRX_N-00289-304191166935,2021-11-26T11:12:47,Amurrio,Expense,healthcare,-377.07,46973.79
buyer_3,Ana,35,ES22209579234312411751,TRX_N-00290-778428234543,2021-12-01T12:22:00,Amurrio,transfer,Salary,2222.18,49195.97
buyer_3,Ana,35,ES22209579234312411751,TRX_N-00291-984068276225,2021-12-01T12:22:00,Amurrio,transfer,Partner Salary,2217.53,51413.5
buyer_3,Ana,35,ES22209579234312411751,TRX_N-00292-160443100237,2021-12-01T12:22:00,Amurrio,transfer,Bonus,2259.49,53672.99
buyer_3,Ana,35,ES22209579234312411751,TRX_N-00293-564339603132,2021-12-05T18:40:00,Amurrio,Housing,Rent,-1347.14,52325.85
buyer_3,Ana,35,ES22209579234312411751,TRX_N-00294-14304797305,2021-12-05T18:17:03,Amurrio,Basic services,water,-28.54,52297.31
buyer_3,Ana,35,ES22209579234312411751,TRX_N-00295-918234890648,2021-12-05T23:08:56,Amurrio,Basic services,internet,-78.84,52218.47
buyer_3,Ana,35,ES22209579234312411751,TRX_N-00296-358397614684,2021-12-06T12:57:19,Amurrio,Basic services,water,-50.41,52168.06
buyer_3,Ana,35,ES22209579234312411751,TRX_N-00297-445857126593,2021-12-06T20:19:07,Amurrio,Basic services,phone,-66.63,52101.43
buyer_3,Ana,35,ES22209579234312411751,TRX_N-00298-388179466235,2021-12-07T18:41:43,Amurrio,Basic services,internet,-34.31,52067.12
buyer_3,Ana,35,ES22209579234312411751,TRX_N-00299-324552104854,2021-12-07T15:10:36,Amurrio,Basic services,phone,-96.33,51970.79
buyer_3,Ana,35,ES22209579234312411751,TRX_N-00300-284781315209,2021-12-08T16:15:48,Zarautz,Expense,healthcare,-367.53,51603.26
buyer_3,Ana,35,ES22209579234312411751,TRX_N-00301-319857444437,2021-12-22T15:44:50,Amurrio,Expense,transport,-193.36,51409.9
buyer_3,Ana,35,ES22209579234312411751,TRX_N-00302-172011199391,2021-12-25T09:43:10,Amurrio,Expense,clothing,-290.6,51119.3
buyer_3,Ana,35,ES22209579234312411751,TRX_N-00303-233024009996,2021-12-27T14:57:15,Hondarribia,Expense,transport,-166.17,50953.13
buyer_3,Ana,35,ES22209579234312411751,TRX_N-00304-845531464290,2022-01-01T11:06:15,Amurrio,transfer,Salary,2222.18,53175.31
buyer_3,Ana,35,ES22209579234312411751,TRX_N-00305-219942712444,2022-01-01T11:06:15,Amurrio,transfer,Partner Salary,2217.53,55392.84
buyer_3,Ana,35,ES22209579234312411751,TRX_N-00306-751649981847,2022-01-01T11:06:15,Amurrio,transfer,Extra Income,222.22,55615.06
buyer_3,Ana,35,ES22209579234312411751,TRX_N-00307-796177143361,2022-01-05T03:45:02,Amurrio,Housing,Rent,-1347.14,54267.92
buyer_3,Ana,35,ES22209579234312411751,TRX_N-00308-696985890149,2022-01-05T21:45:15,Amurrio,Basic services,electricity,-144.39,54123.53
buyer_3,Ana,35,ES22209579234312411751,TRX_N-00309-146991536933,2022-01-06T15:20:16,Amurrio,Basic services,gas,-56.8,54066.73
buyer_3,Ana,35,ES22209579234312411751,TRX_N-00310-301196310766,2022-01-06T19:35:18,Amurrio,Basic services,phone,-79.71,53987.02
buyer_3,Ana,35,ES22209579234312411751,TRX_N-00311-312074085634,2022-01-07T15:37:18,Amurrio,Basic services,electricity,-122.26,53864.76
buyer_3,Ana,35,ES22209579234312411751,TRX_N-00312-702951353974,2022-01-07T12:48:35,Amurrio,Basic services,gas,-90.64,53774.12
buyer_3,Ana,35,ES22209579234312411751,TRX_N-00313-893708777522,2022-01-07T15:30:59,Amurrio,Basic services,internet,-31.22,53742.9
buyer_3,Ana,35,ES22209579234312411751,TRX_N-00314-699602180426,2022-01-08T11:32:37,Amurrio,Expense,leisure,-252.01,53490.89
buyer_3,Ana,35,ES22209579234312411751,TRX_N-00315-816331770130,2022-01-17T23:58:00,Amurrio,Expense,education,-773.06,52717.83
buyer_3,Ana,35,ES22209579234312411751,TRX_N-00316-757334649310,2022-02-01T17:24:16,Amurrio,transfer,Salary,2222.18,54940.01
buyer_3,Ana,35,ES22209579234312411751,TRX_N-00317-915800927815,2022-02-01T17:24:16,Amurrio,transfer,Partner Salary,2217.53,57157.54
buyer_3,Ana,35,ES22209579234312411751,TRX_N-00318-540296754742,2022-02-05T16:29:01,Amurrio,Housing,Rent,-1347.14,55810.4
buyer_3,Ana,35,ES22209579234312411751,TRX_N-00319-45039992099,2022-02-05T14:05:54,Amurrio,Basic services,water,-78.13,55732.27
buyer_3,Ana,35,ES22209579234312411751,TRX_N-00320-228622846130,2022-02-05T14:06:40,Amurrio,Basic services,internet,-36.2,55696.07
buyer_3,Ana,35,ES22209579234312411751,TRX_N-00321-798816098028,2022-02-05T12:37:08,Amurrio,Basic services,phone,-30.19,55665.88
buyer_3,Ana,35,ES22209579234312411751,TRX_N-00322-184062990340,2022-02-06T16:24:41,Amurrio,Basic services,electricity,-103.34,55562.54
buyer_3,Ana,35,ES22209579234312411751,TRX_N-00323-420126795512,2022-02-06T21:43:55,Amurrio,Basic services,gas,-34.62,55527.92
buyer_3,Ana,35,ES22209579234312411751,TRX_N-00324-828735374787,2022-02-06T23:48:44,Amurrio,Basic services,internet,-42.25,55485.67
buyer_3,Ana,35,ES22209579234312411751,TRX_N-00325-642576160643,2022-02-06T15:14:28,Berango,Expense,healthcare,-399.32,55086.35
buyer_3,Ana,35,ES22209579234312411751,TRX_N-00326-823194610560,2022-02-07T14:35:41,Amurrio,Basic services,electricity,-76.61,55009.74
buyer_3,Ana,35,ES22209579234312411751,TRX_N-00327-976284950459,2022-02-07T11:49:53,Leioa,Expense,gifts,-243.74,54766.0
buyer_3,Ana,35,ES22209579234312411751,TRX_N-00328-102377669445,2022-02-12T08:35:10,Amurrio,Expense,clothing,-129.44,54636.56
buyer_3,Ana,35,ES22209579234312411751,TRX_N-00329-470181105555,2022-03-01T16:53:30,Amurrio,transfer,Salary,2222.18,56858.74
buyer_3,Ana,35,ES22209579234312411751,TRX_N-00330-249433313309,2022-03-01T16:53:30,Amurrio,transfer,Partner Salary,2217.53,59076.27
buyer_3,Ana,35,ES22209579234312411751,TRX_N-00331-343468122788,2022-03-01T16:53:30,Amurrio,transfer,Extra Income,222.22,59298.49
buyer_3,Ana,35,ES22209579234312411751,TRX_N-00332-835900275217,2022-03-02T15:36:11,Amurrio,Expense,healthcare,-144.68,59153.81
buyer_3,Ana,35,ES22209579234312411751,TRX_N-00333-299795332845,2022-03-04T08:32:11,Sestao,Expense,clothing,-285.1,58868.71
buyer_3,Ana,35,ES22209579234312411751,TRX_N-00334-373516768375,2022-03-05T14:38:32,Amurrio,Housing,Rent,-1347.14,57521.57
buyer_3,Ana,35,ES22209579234312411751,TRX_N-00335-256392011818,2022-03-05T14:42:39,Amurrio,Basic services,gas,-50.25,57471.32
buyer_3,Ana,35,ES22209579234312411751,TRX_N-00336-283700483752,2022-03-06T08:18:07,Amurrio,Basic services,electricity,-111.16,57360.16
buyer_3,Ana,35,ES22209579234312411751,TRX_N-00337-995576473041,2022-03-06T17:21:49,Amurrio,Basic services,gas,-55.63,57304.53
buyer_3,Ana,35,ES22209579234312411751,TRX_N-00338-113443874366,2022-03-07T14:15:16,Amurrio,Basic services,water,-53.3,57251.23
buyer_3,Ana,35,ES22209579234312411751,TRX_N-00339-886023785919,2022-03-07T18:29:19,Amurrio,Basic services,electricity,-100.72,57150.51
buyer_3,Ana,35,ES22209579234312411751,TRX_N-00340-863090247984,2022-03-07T10:43:58,Amurrio,Basic services,internet,-50.72,57099.79
buyer_3,Ana,35,ES22209579234312411751,TRX_N-00341-675450158259,2022-03-11T09:14:07,Amurrio,Expense,transport,-156.51,56943.28
buyer_3,Ana,35,ES22209579234312411751,TRX_N-00342-269332994623,2022-03-20T02:25:04,Amurrio,Expense,repairs,-91.34,56851.94
buyer_3,Ana,35,ES22209579234312411751,TRX_N-00343-793344764635,2022-04-01T09:13:07,Amurrio,transfer,Salary,2222.18,59074.12
buyer_3,Ana,35,ES22209579234312411751,TRX_N-00344-777569858605,2022-04-01T09:13:07,Amurrio,transfer,Partner Salary,2217.53,61291.65
buyer_3,Ana,35,ES22209579234312411751,TRX_N-00345-650548092310,2022-04-05T14:25:46,Amurrio,Housing,Rent,-1347.14,59944.51
buyer_3,Ana,35,ES22209579234312411751,TRX_N-00346-796548215314,2022-04-05T12:01:21,Amurrio,Basic services,water,-21.66,59922.85
buyer_3,Ana,35,ES22209579234312411751,TRX_N-00347-786542130367,2022-04-06T19:18:27,Amurrio,Basic services,internet,-33.75,59889.1
buyer_3,Ana,35,ES22209579234312411751,TRX_N-00348-884856056975,2022-04-07T17:14:05,Amurrio,Basic services,water,-18.68,59870.42
buyer_3,Ana,35,ES22209579234312411751,TRX_N-00349-341605248863,2022-04-07T16:57:54,Amurrio,Basic services,gas,-17.65,59852.77
buyer_3,Ana,35,ES22209579234312411751,TRX_N-00350-401757002558,2022-04-07T05:50:20,Amurrio,Basic services,internet,-36.4,59816.37
buyer_3,Ana,35,ES22209579234312411751,TRX_N-00351-577428501102,2022-04-07T08:06:59,Amurrio,Basic services,phone,-26.73,59789.64
buyer_3,Ana,35,ES22209579234312411751,TRX_N-00352-71395444003,2022-04-11T18:30:46,Amurrio,Expense,food,-541.44,59248.2
buyer_3,Ana,35,ES22209579234312411751,TRX_N-00353-76020390521,2022-05-01T16:41:33,Amurrio,transfer,Salary,2222.18,61470.38
buyer_3,Ana,35,ES22209579234312411751,TRX_N-00354-551516346162,2022-05-01T16:41:33,Amurrio,transfer,Partner Salary,2217.53,63687.91
buyer_3,Ana,35,ES22209579234312411751,TRX_N-00355-392819261069,2022-05-02T19:43:55,Amurrio,Expense,transport,-152.51,63535.4
buyer_3,Ana,35,ES22209579234312411751,TRX_N-00356-837644509329,2022-05-05T15:28:57,Amurrio,Housing,Rent,-1347.14,62188.26
buyer_3,Ana,35,ES22209579234312411751,TRX_N-00357-103487964959,2022-05-05T19:33:15,Amurrio,Basic services,gas,-59.98,62128.28
buyer_3,Ana,35,ES22209579234312411751,TRX_N-00358-293056336506,2022-05-05T12:27:51,Amurrio,Basic services,internet,-46.23,62082.05
buyer_3,Ana,35,ES22209579234312411751,TRX_N-00359-610057176864,2022-05-07T15:52:05,Amurrio,Basic services,electricity,-127.32,61954.73
buyer_3,Ana,35,ES22209579234312411751,TRX_N-00360-172628282593,2022-05-07T16:26:06,Amurrio,Expense,transport,-56.94,61897.79
buyer_3,Ana,35,ES22209579234312411751,TRX_N-00361-490821978835,2022-05-10T18:16:18,Amurrio,Expense,food,-733.06,61164.73
buyer_3,Ana,35,ES22209579234312411751,TRX_N-00362-312958998092,2022-05-22T09:52:30,Amurrio,Expense,transport,-93.72,61071.01
buyer_3,Ana,35,ES22209579234312411751,TRX_N-00363-561076587710,2022-05-26T10:25:32,Amurrio,Expense,healthcare,-271.41,60799.6
buyer_3,Ana,35,ES22209579234312411751,TRX_N-00364-13280736619,2022-05-30T09:59:06,Amurrio,Expense,clothing,-164.53,60635.07
buyer_3,Ana,35,ES22209579234312411751,TRX_N-00365-807390377070,2022-06-01T07:52:39,Amurrio,transfer,Salary,2222.18,62857.25
buyer_3,Ana,35,ES22209579234312411751,TRX_N-00366-169296745316,2022-06-01T07:52:39,Amurrio,transfer,Partner Salary,2217.53,65074.78
buyer_3,Ana,35,ES22209579234312411751,TRX_N-00367-640653402872,2022-06-01T07:52:39,Amurrio,transfer,Extra Income,222.22,65297.0
buyer_3,Ana,35,ES22209579234312411751,TRX_N-00368-395071127872,2022-06-01T07:52:39,Amurrio,transfer,Bonus,2354.58,67651.58
buyer_3,Ana,35,ES22209579234312411751,TRX_N-00369-496814885681,2022-06-05T20:47:35,Amurrio,Housing,Rent,-1347.14,66304.44
buyer_3,Ana,35,ES22209579234312411751,TRX_N-00370-346358463937,2022-06-05T19:19:00,Amurrio,Basic services,electricity,-69.38,66235.06
buyer_3,Ana,35,ES22209579234312411751,TRX_N-00371-155850682954,2022-06-05T17:30:58,Amurrio,Basic services,internet,-61.29,66173.77
buyer_3,Ana,35,ES22209579234312411751,TRX_N-00372-441968806602,2022-06-05T11:11:17,Amurrio,Basic services,phone,-90.76,66083.01
buyer_3,Ana,35,ES22209579234312411751,TRX_N-00373-122052917013,2022-06-06T17:57:50,Amurrio,Basic services,water,-70.02,66012.99
buyer_3,Ana,35,ES22209579234312411751,TRX_N-00374-502846177019,2022-06-06T20:25:42,Amurrio,Basic services,electricity,-113.24,65899.75
buyer_3,Ana,35,ES22209579234312411751,TRX_N-00375-355479289083,2022-06-09T11:47:17,Amurrio,Expense,food,-577.32,65322.43
buyer_3,Ana,35,ES22209579234312411751,TRX_N-00376-58079115748,2022-06-20T20:24:21,Leioa,Expense,healthcare,-387.2,64935.23
buyer_3,Ana,35,ES22209579234312411751,TRX_N-00377-44772684232,2022-06-23T20:25:34,Amurrio,Expense,clothing,-182.96,64752.27
buyer_3,Ana,35,ES22209579234312411751,TRX_N-00378-124975238062,2022-07-01T13:34:53,Amurrio,transfer,Salary,2222.18,66974.45
buyer_3,Ana,35,ES22209579234312411751,TRX_N-00379-686010477494,2022-07-01T13:34:53,Amurrio,transfer,Partner Salary,2217.53,69191.98
buyer_3,Ana,35,ES22209579234312411751,TRX_N-00380-576422079179,2022-07-05T13:47:21,Amurrio,Housing,Rent,-1347.14,67844.84
buyer_3,Ana,35,ES22209579234312411751,TRX_N-00381-357123481625,2022-07-05T21:24:19,Amurrio,Basic services,electricity,-73.46,67771.38
buyer_3,Ana,35,ES22209579234312411751,TRX_N-00382-841189378968,2022-07-05T20:00:11,Amurrio,Basic services,gas,-69.87,67701.51
buyer_3,Ana,35,ES22209579234312411751,TRX_N-00383-779180154443,2022-07-06T10:16:53,Amurrio,Basic services,water,-13.77,67687.74
buyer_3,Ana,35,ES22209579234312411751,TRX_N-00384-852931515198,2022-07-07T10:52:23,Amurrio,Basic services,water,-20.71,67667.03
buyer_3,Ana,35,ES22209579234312411751,TRX_N-00385-176171044661,2022-07-07T17:37:36,Amurrio,Basic services,phone,-84.3,67582.73
buyer_3,Ana,35,ES22209579234312411751,TRX_N-00386-181006526931,2022-07-07T10:26:04,Amurrio,Expense,food,-660.13,66922.6
buyer_3,Ana,35,ES22209579234312411751,TRX_N-00387-582140878986,2022-07-28T19:22:54,Amurrio,Expense,education,-701.0,66221.6
buyer_3,Ana,35,ES22209579234312411751,TRX_N-00388-696439219412,2022-08-01T02:18:38,Amurrio,transfer,Salary,2222.18,68443.78
buyer_3,Ana,35,ES22209579234312411751,TRX_N-00389-185461027369,2022-08-01T02:18:38,Amurrio,transfer,Partner Salary,2217.53,70661.31
buyer_3,Ana,35,ES22209579234312411751,TRX_N-00390-155207486570,2022-08-01T02:18:38,Amurrio,transfer,Extra Income,222.22,70883.53
buyer_3,Ana,35,ES22209579234312411751,TRX_N-00391-363815668358,2022-08-04T12:39:07,Amurrio,Expense,food,-429.56,70453.97
buyer_3,Ana,35,ES22209579234312411751,TRX_N-00392-778321894218,2022-08-05T20:18:56,Amurrio,Housing,Rent,-1347.14,69106.83
buyer_3,Ana,35,ES22209579234312411751,TRX_N-00393-981058482620,2022-08-05T09:15:35,Amurrio,Basic services,water,-19.54,69087.29
buyer_3,Ana,35,ES22209579234312411751,TRX_N-00394-169412546721,2022-08-05T19:30:01,Amurrio,Basic services,electricity,-22.82,69064.47
buyer_3,Ana,35,ES22209579234312411751,TRX_N-00395-403728777075,2022-08-05T09:59:07,Amurrio,Basic services,gas,-85.39,68979.08
buyer_3,Ana,35,ES22209579234312411751,TRX_N-00396-692538564498,2022-08-06T16:35:03,Amurrio,Basic services,internet,-75.52,68903.56
buyer_3,Ana,35,ES22209579234312411751,TRX_N-00397-780252947336,2022-08-07T16:01:17,Amurrio,Basic services,electricity,-98.09,68805.47
buyer_3,Ana,35,ES22209579234312411751,TRX_N-00398-770690530692,2022-08-07T10:06:39,Amurrio,Basic services,gas,-81.65,68723.82
buyer_3,Ana,35,ES22209579234312411751,TRX_N-00399-102474928742,2022-08-19T03:16:53,Amurrio,Expense,transport,-166.6,68557.22
buyer_3,Ana,35,ES22209579234312411751,TRX_N-00400-134804366425,2022-09-01T18:12:48,Amurrio,transfer,Salary,2222.18,70779.4
buyer_3,Ana,35,ES22209579234312411751,TRX_N-00401-807968980835,2022-09-01T18:12:48,Amurrio,transfer,Partner Salary,2217.53,72996.93
buyer_3,Ana,35,ES22209579234312411751,TRX_N-00402-684457171652,2022-09-04T12:58:42,Santurtzi,Expense,leisure,-79.73,72917.2
buyer_3,Ana,35,ES22209579234312411751,TRX_N-00403-902616037944,2022-09-05T08:09:39,Amurrio,Housing,Rent,-1347.14,71570.06
buyer_3,Ana,35,ES22209579234312411751,TRX_N-00404-70287609086,2022-09-05T04:40:31,Amurrio,Basic services,phone,-99.22,71470.84
buyer_3,Ana,35,ES22209579234312411751,TRX_N-00405-111381285612,2022-09-06T02:22:56,Amurrio,Basic services,water,-12.02,71458.82
buyer_3,Ana,35,ES22209579234312411751,TRX_N-00406-187137534616,2022-09-21T14:48:11,Amurrio,Expense,food,-343.51,71115.31
buyer_3,Ana,35,ES22209579234312411751,TRX_N-00407-231681918750,2022-09-22T09:15:55,Amurrio,Expense,food,-663.03,70452.28
buyer_3,Ana,35,ES22209579234312411751,TRX_N-00408-925604018223,2022-09-22T16:57:39,Zarautz,Expense,leisure,-72.73,70379.55
buyer_3,Ana,35,ES22209579234312411751,TRX_N-00409-816848106837,2022-09-23T15:04:37,Amurrio,Expense,food,-187.01,70192.54
buyer_3,Ana,35,ES22209579234312411751,TRX_N-00410-219098135581,2022-09-26T15:40:20,Amurrio,Expense,education,-575.78,69616.76
buyer_3,Ana,35,ES22209579234312411751,TRX_N-00411-595877477950,2022-10-01T16:13:22,Amurrio,transfer,Salary,2222.18,71838.94
buyer_3,Ana,35,ES22209579234312411751,TRX_N-00412-349657200914,2022-10-01T16:13:22,Amurrio,transfer,Partner Salary,2217.53,74056.47
buyer_3,Ana,35,ES22209579234312411751,TRX_N-00413-972497955126,2022-10-05T05:51:01,Amurrio,Housing,Rent,-1347.14,72709.33
buyer_3,Ana,35,ES22209579234312411751,TRX_N-00414-593168556105,2022-10-05T18:20:57,Amurrio,Basic services,gas,-48.4,72660.93
buyer_3,Ana,35,ES22209579234312411751,TRX_N-00415-632814779587,2022-10-05T15:46:49,Amurrio,Basic services,phone,-63.43,72597.5
buyer_3,Ana,35,ES22209579234312411751,TRX_N-00416-174652951095,2022-10-06T20:25:13,Amurrio,Basic services,water,-33.03,72564.47
buyer_3,Ana,35,ES22209579234312411751,TRX_N-00417-255728628569,2022-10-06T08:10:00,Amurrio,Basic services,internet,-40.98,72523.49
buyer_3,Ana,35,ES22209579234312411751,TRX_N-00418-955400463758,2022-10-07T11:32:12,Amurrio,Basic services,water,-77.45,72446.04
buyer_3,Ana,35,ES22209579234312411751,TRX_N-00419-803976807343,2022-10-07T11:44:55,Amurrio,Basic services,electricity,-138.7,72307.34
buyer_3,Ana,35,ES22209579234312411751,TRX_N-00420-869754065359,2022-11-01T14:28:31,Amurrio,transfer,Salary,2222.18,74529.52
buyer_3,Ana,35,ES22209579234312411751,TRX_N-00421-450751876475,2022-11-01T14:28:31,Amurrio,transfer,Partner Salary,2217.53,76747.05
buyer_3,Ana,35,ES22209579234312411751,TRX_N-00422-701817144275,2022-11-01T14:28:31,Amurrio,transfer,Extra Income,222.22,76969.27
buyer_3,Ana,35,ES22209579234312411751,TRX_N-00423-238644081033,2022-11-02T13:54:06,Amurrio,Expense,food,-793.49,76175.78
buyer_3,Ana,35,ES22209579234312411751,TRX_N-00424-612997888044,2022-11-03T16:08:29,Amurrio,Expense,healthcare,-321.23,75854.55
buyer_3,Ana,35,ES22209579234312411751,TRX_N-00425-891416128075,2022-11-05T14:59:52,Amurrio,Housing,Rent,-1347.14,74507.41
buyer_3,Ana,35,ES22209579234312411751,TRX_N-00426-288865534106,2022-11-05T16:49:12,Amurrio,Basic services,water,-23.19,74484.22
buyer_3,Ana,35,ES22209579234312411751,TRX_N-00427-739220806892,2022-11-07T17:46:35,Amurrio,Basic services,water,-14.02,74470.2
buyer_3,Ana,35,ES22209579234312411751,TRX_N-00428-835152708770,2022-11-07T08:26:32,Amurrio,Basic services,gas,-71.69,74398.51
buyer_3,Ana,35,ES22209579234312411751,TRX_N-00429-371503598182,2022-11-07T10:56:11,Amurrio,Basic services,internet,-78.34,74320.17
buyer_3,Ana,35,ES22209579234312411751,TRX_N-00430-299058018118,2022-11-12T14:35:38,Llodio,Expense,education,-654.5,73665.67
buyer_3,Ana,35,ES22209579234312411751,TRX_N-00431-40432583136,2022-11-24T17:13:58,Amurrio,Expense,food,-524.56,73141.11
buyer_3,Ana,35,ES22209579234312411751,TRX_N-00432-666016369357,2022-12-01T13:31:45,Amurrio,transfer,Salary,2222.18,75363.29
buyer_3,Ana,35,ES22209579234312411751,TRX_N-00433-586747147952,2022-12-01T13:31:45,Amurrio,transfer,Partner Salary,2217.53,77580.82
buyer_3,Ana,35,ES22209579234312411751,TRX_N-00434-15823874060,2022-12-01T13:31:45,Amurrio,transfer,Bonus,2361.67,79942.49
buyer_3,Ana,35,ES22209579234312411751,TRX_N-00435-232926755742,2022-12-03T21:52:59,Sopela,Expense,food,-100.47,79842.02
buyer_3,Ana,35,ES22209579234312411751,TRX_N-00436-788663200713,2022-12-05T10:24:10,Amurrio,Housing,Rent,-1347.14,78494.88
buyer_3,Ana,35,ES22209579234312411751,TRX_N-00437-616613087529,2022-12-05T11:04:16,Amurrio,Basic services,electricity,-136.34,78358.54
buyer_3,Ana,35,ES22209579234312411751,TRX_N-00438-169343342647,2022-12-05T20:41:36,Amurrio,Basic services,internet,-49.03,78309.51
buyer_3,Ana,35,ES22209579234312411751,TRX_N-00439-732096559337,2022-12-06T15:07:03,Amurrio,Basic services,water,-45.97,78263.54
buyer_3,Ana,35,ES22209579234312411751,TRX_N-00440-691650062342,2022-12-07T16:02:24,Amurrio,Basic services,phone,-23.32,78240.22
buyer_3,Ana,35,ES22209579234312411751,TRX_N-00441-618588742303,2023-01-01T20:56:55,Amurrio,transfer,Salary,2222.18,80462.4
buyer_3,Ana,35,ES22209579234312411751,TRX_N-00442-253786254905,2023-01-01T20:56:55,Amurrio,transfer,Partner Salary,2217.53,82679.93
buyer_3,Ana,35,ES22209579234312411751,TRX_N-00443-61000442470,2023-01-01T20:56:55,Amurrio,transfer,Extra Income,222.22,82902.15
buyer_3,Ana,35,ES22209579234312411751,TRX_N-00444-117640744616,2023-01-05T08:50:54,Amurrio,Housing,Rent,-1347.14,81555.01
buyer_3,Ana,35,ES22209579234312411751,TRX_N-00445-303936023657,2023-01-05T11:31:42,Amurrio,Basic services,water,-45.96,81509.05
buyer_3,Ana,35,ES22209579234312411751,TRX_N-00446-704893605220,2023-01-05T18:03:14,Amurrio,Basic services,electricity,-136.77,81372.28
buyer_3,Ana,35,ES22209579234312411751,TRX_N-00447-405461132771,2023-01-06T11:56:34,Amurrio,Basic services,gas,-77.64,81294.64
buyer_3,Ana,35,ES22209579234312411751,TRX_N-00448-463389670503,2023-01-06T17:45:12,Amurrio,Basic services,internet,-39.55,81255.09
buyer_3,Ana,35,ES22209579234312411751,TRX_N-00449-693843000555,2023-01-06T02:26:22,Amurrio,Expense,food,-217.88,81037.21
buyer_3,Ana,35,ES22209579234312411751,TRX_N-00450-296976805794,2023-01-07T14:51:06,Amurrio,Basic services,water,-39.23,80997.98
buyer_3,Ana,35,ES22209579234312411751,TRX_N-00451-506430886142,2023-01-07T13:34:33,Amurrio,Basic services,internet,-48.15,80949.83
buyer_3,Ana,35,ES22209579234312411751,TRX_N-00452-386987514833,2023-01-16T12:55:39,Amurrio,Expense,food,-574.83,80375.0
buyer_3,Ana,35,ES22209579234312411751,TRX_N-00453-504594650902,2023-01-18T08:51:15,Amurrio,Expense,food,-273.3,80101.7
buyer_3,Ana,35,ES22209579234312411751,TRX_N-00454-140665030391,2023-01-24T16:15:21,Amurrio,Expense,transport,-119.92,79981.78
buyer_3,Ana,35,ES22209579234312411751,TRX_N-00455-254904524464,2023-02-01T10:10:56,Amurrio,transfer,Salary,2222.18,82203.96
buyer_3,Ana,35,ES22209579234312411751,TRX_N-00456-864451707690,2023-02-01T10:10:56,Amurrio,transfer,Partner Salary,2217.53,84421.49
buyer_3,Ana,35,ES22209579234312411751,TRX_N-00457-38436946667,2023-02-03T21:54:28,Amurrio,Expense,transport,-175.23,84246.26
buyer_3,Ana,35,ES22209579234312411751,TRX_N-00458-91268632822,2023-02-05T21:08:20,Amurrio,Housing,Rent,-1347.14,82899.12
buyer_3,Ana,35,ES22209579234312411751,TRX_N-00459-420589299427,2023-02-06T19:52:18,Amurrio,Basic services,gas,-52.79,82846.33
buyer_3,Ana,35,ES22209579234312411751,TRX_N-00460-905287934566,2023-02-06T05:30:58,Amurrio,Basic services,internet,-71.32,82775.01
buyer_3,Ana,35,ES22209579234312411751,TRX_N-00461-791109683749,2023-02-07T15:49:32,Amurrio,Basic services,gas,-61.89,82713.12
buyer_3,Ana,35,ES22209579234312411751,TRX_N-00462-261744175806,2023-02-07T19:32:32,Amurrio,Basic services,phone,-48.26,82664.86
buyer_3,Ana,35,ES22209579234312411751,TRX_N-00463-211006139126,2023-02-17T07:30:41,Amurrio,Expense,clothing,-189.23,82475.63
buyer_3,Ana,35,ES22209579234312411751,TRX_N-00464-342703767338,2023-02-20T11:15:12,Amurrio,Expense,leisure,-193.84,82281.79
buyer_3,Ana,35,ES22209579234312411751,TRX_N-00465-276280587006,2023-02-23T15:26:32,Amurrio,Expense,healthcare,-242.37,82039.42
buyer_3,Ana,35,ES22209579234312411751,TRX_N-00466-546937772959,2023-02-27T22:00:18,Amurrio,Expense,food,-212.15,81827.27
buyer_3,Ana,35,ES22209579234312411751,TRX_N-00467-358937122510,2023-03-01T18:45:28,Amurrio,transfer,Salary,2222.18,84049.45
buyer_3,Ana,35,ES22209579234312411751,TRX_N-00468-174284394479,2023-03-01T18:45:28,Amurrio,transfer,Partner Salary,2217.53,86266.98
buyer_3,Ana,35,ES22209579234312411751,TRX_N-00469-973281050879,2023-03-01T18:45:28,Amurrio,transfer,Extra Income,222.22,86489.2
buyer_3,Ana,35,ES22209579234312411751,TRX_N-00470-391323409053,2023-03-05T19:20:56,Amurrio,Housing,Rent,-1347.14,85142.06
buyer_3,Ana,35,ES22209579234312411751,TRX_N-00471-988467653730,2023-03-05T16:34:29,Amurrio,Basic services,water,-29.97,85112.09
buyer_3,Ana,35,ES22209579234312411751,TRX_N-00472-565461996839,2023-03-05T23:33:58,Amurrio,Basic services,electricity,-134.77,84977.32
buyer_3,Ana,35,ES22209579234312411751,TRX_N-00473-738809206168,2023-03-06T17:40:29,Amurrio,Basic services,water,-21.14,84956.18
buyer_3,Ana,35,ES22209579234312411751,TRX_N-00474-710289838757,2023-03-06T11:14:00,Amurrio,Basic services,electricity,-68.39,84887.79
buyer_3,Ana,35,ES22209579234312411751,TRX_N-00475-122604317913,2023-03-06T19:53:04,Amurrio,Basic services,phone,-81.31,84806.48
buyer_3,Ana,35,ES22209579234312411751,TRX_N-00476-713773570474,2023-03-07T20:34:36,Amurrio,Basic services,electricity,-144.6,84661.88
buyer_3,Ana,35,ES22209579234312411751,TRX_N-00477-586648015813,2023-03-15T19:24:38,Berango,Expense,repairs,-209.8,84452.08
buyer_3,Ana,35,ES22209579234312411751,TRX_N-00478-19621668981,2023-03-26T03:09:22,Salvatierra/Agurain,Expense,transport,-99.83,84352.25
buyer_3,Ana,35,ES22209579234312411751,TRX_N-00479-760296101531,2023-03-28T20:23:58,Amurrio,Expense,leisure,-116.25,84236.0
buyer_3,Ana,35,ES22209579234312411751,TRX_N-00480-355570616528,2023-04-01T11:13:24,Amurrio,transfer,Salary,2222.18,86458.18
buyer_3,Ana,35,ES22209579234312411751,TRX_N-00481-366444991654,2023-04-01T11:13:24,Amurrio,transfer,Partner Salary,2217.53,88675.71
buyer_3,Ana,35,ES22209579234312411751,TRX_N-00482-352480519186,2023-04-05T18:52:28,Amurrio,Housing,Rent,-1347.14,87328.57
buyer_3,Ana,35,ES22209579234312411751,TRX_N-00483-565387412148,2023-04-05T19:15:31,Amurrio,Basic services,water,-68.47,87260.1
buyer_3,Ana,35,ES22209579234312411751,TRX_N-00484-788209373305,2023-04-05T14:14:13,Amurrio,Basic services,gas,-34.1,87226.0
buyer_3,Ana,35,ES22209579234312411751,TRX_N-00485-774803659067,2023-04-05T15:08:21,Amurrio,Basic services,internet,-78.47,87147.53
buyer_3,Ana,35,ES22209579234312411751,TRX_N-00486-172208436281,2023-04-06T19:53:32,Amurrio,Basic services,water,-46.19,87101.34
buyer_3,Ana,35,ES22209579234312411751,TRX_N-00487-74726170544,2023-04-06T13:25:01,Amurrio,Basic services,gas,-55.0,87046.34
buyer_3,Ana,35,ES22209579234312411751,TRX_N-00488-492930331573,2023-04-06T19:57:56,Amurrio,Basic services,internet,-51.33,86995.01
buyer_3,Ana,35,ES22209579234312411751,TRX_N-00489-31317594812,2023-04-07T16:20:36,Amurrio,Basic services,electricity,-61.83,86933.18
buyer_3,Ana,35,ES22209579234312411751,TRX_N-00490-740501357436,2023-04-07T17:48:46,Amurrio,Basic services,gas,-48.24,86884.94
buyer_3,Ana,35,ES22209579234312411751,TRX_N-00491-74702679848,2023-04-07T14:36:23,Amurrio,Basic services,internet,-78.64,86806.3
buyer_3,Ana,35,ES22209579234312411751,TRX_N-00492-41905696263,2023-05-01T06:24:26,Amurrio,transfer,Salary,2222.18,89028.48
buyer_3,Ana,35,ES22209579234312411751,TRX_N-00493-215322679471,2023-05-01T06:24:26,Amurrio,transfer,Partner Salary,2217.53,91246.01
buyer_3,Ana,35,ES22209579234312411751,TRX_N-00494-537359340722,2023-05-01T06:24:26,Amurrio,transfer,Extra Income,222.22,91468.23
buyer_3,Ana,35,ES22209579234312411751,TRX_N-00495-468398050819,2023-05-05T17:33:25,Amurrio,Housing,Rent,-1347.14,90121.09
buyer_3,Ana,35,ES22209579234312411751,TRX_N-00496-757221992194,2023-05-06T16:04:56,Amurrio,Basic services,water,-70.48,90050.61
buyer_3,Ana,35,ES22209579234312411751,TRX_N-00497-611032106098,2023-05-06T10:47:44,Amurrio,Basic services,electricity,-124.08,89926.53
buyer_3,Ana,35,ES22209579234312411751,TRX_N-00498-783415854414,2023-05-07T11:16:14,Amurrio,Basic services,water,-60.05,89866.48
buyer_3,Ana,35,ES22209579234312411751,TRX_N-00499-48126671001,2023-05-19T12:19:52,Salvatierra/Agurain,Expense,education,-728.7,89137.78
buyer_3,Ana,35,ES22209579234312411751,TRX_N-00500-942277771558,2023-06-01T15:45:07,Amurrio,transfer,Salary,2222.18,91359.96
buyer_3,Ana,35,ES22209579234312411751,TRX_N-00501-172811221071,2023-06-01T15:45:07,Amurrio,transfer,Partner Salary,2217.53,93577.49
buyer_3,Ana,35,ES22209579234312411751,TRX_N-00502-245145711587,2023-06-01T15:45:07,Amurrio,transfer,Bonus,2088.15,95665.64
buyer_3,Ana,35,ES22209579234312411751,TRX_N-00503-20616292939,2023-06-05T18:28:57,Amurrio,Housing,Rent,-1347.14,94318.5
buyer_3,Ana,35,ES22209579234312411751,TRX_N-00504-682135569973,2023-06-05T13:00:55,Amurrio,Basic services,water,-12.86,94305.64
buyer_3,Ana,35,ES22209579234312411751,TRX_N-00505-447496988174,2023-06-05T18:31:57,Amurrio,Basic services,internet,-63.54,94242.1
buyer_3,Ana,35,ES22209579234312411751,TRX_N-00506-673143126210,2023-06-05T08:30:51,Amurrio,Basic services,phone,-69.73,94172.37
buyer_3,Ana,35,ES22209579234312411751,TRX_N-00507-576864587923,2023-06-07T12:15:12,Amurrio,Basic services,gas,-87.77,94084.6
buyer_3,Ana,35,ES22209579234312411751,TRX_N-00508-389966982801,2023-06-07T11:12:09,Amurrio,Basic services,phone,-67.93,94016.67
buyer_3,Ana,35,ES22209579234312411751,TRX_N-00509-237211505930,2023-06-09T18:12:34,Amurrio,Expense,clothing,-409.32,93607.35
buyer_3,Ana,35,ES22209579234312411751,TRX_N-00510-919492003194,2023-06-12T18:11:02,Amurrio,Expense,transport,-99.53,93507.82
buyer_3,Ana,35,ES22209579234312411751,TRX_N-00511-88455335333,2023-06-25T16:37:04,Amurrio,Expense,food,-189.69,93318.13
buyer_3,Ana,35,ES22209579234312411751,TRX_N-00512-698275614588,2023-07-01T17:11:33,Amurrio,transfer,Salary,2222.18,95540.31
buyer_3,Ana,35,ES22209579234312411751,TRX_N-00513-354746035663,2023-07-01T17:11:33,Amurrio,transfer,Partner Salary,2217.53,97757.84
buyer_3,Ana,35,ES22209579234312411751,TRX_N-00514-958245186149,2023-07-05T09:12:11,Amurrio,Housing,Rent,-1347.14,96410.7
buyer_3,Ana,35,ES22209579234312411751,TRX_N-00515-757548724199,2023-07-05T18:46:03,Amurrio,Basic services,internet,-34.44,96376.26
buyer_3,Ana,35,ES22209579234312411751,TRX_N-00516-433120449468,2023-07-07T23:56:17,Amurrio,Basic services,electricity,-118.71,96257.55
buyer_3,Ana,35,ES22209579234312411751,TRX_N-00517-296608116928,2023-07-07T15:18:05,Amurrio,Basic services,phone,-59.73,96197.82
buyer_3,Ana,35,ES22209579234312411751,TRX_N-00518-894439677386,2023-07-14T20:14:56,Amurrio,Expense,repairs,-893.64,95304.18
buyer_3,Ana,35,ES22209579234312411751,TRX_N-00519-641191951670,2023-07-20T15:20:45,Amurrio,Expense,transport,-198.58,95105.6
buyer_3,Ana,35,ES22209579234312411751,TRX_N-00520-137870256444,2023-08-01T18:53:07,Amurrio,transfer,Salary,2222.18,97327.78
buyer_3,Ana,35,ES22209579234312411751,TRX_N-00521-113647404172,2023-08-01T18:53:07,Amurrio,transfer,Partner Salary,2217.53,99545.31
buyer_3,Ana,35,ES22209579234312411751,TRX_N-00522-322903295059,2023-08-01T18:53:07,Amurrio,transfer,Extra Income,222.22,99767.53
buyer_3,Ana,35,ES22209579234312411751,TRX_N-00523-862648633624,2023-08-04T09:34:16,Amurrio,Expense,food,-215.91,99551.62
buyer_3,Ana,35,ES22209579234312411751,TRX_N-00524-644872423442,2023-08-04T19:46:11,Amurrio,Expense,transport,-141.25,99410.37
buyer_3,Ana,35,ES22209579234312411751,TRX_N-00525-785265766153,2023-08-05T08:16:01,Amurrio,Housing,Rent,-1347.14,98063.23
buyer_3,Ana,35,ES22209579234312411751,TRX_N-00526-992382555661,2023-08-05T17:21:21,Amurrio,Basic services,gas,-39.36,98023.87
buyer_3,Ana,35,ES22209579234312411751,TRX_N-00527-226234047132,2023-08-06T08:54:33,Amurrio,Basic services,electricity,-137.92,97885.95
buyer_3,Ana,35,ES22209579234312411751,TRX_N-00528-218177059814,2023-08-06T08:41:55,Amurrio,Basic services,internet,-49.23,97836.72
buyer_3,Ana,35,ES22209579234312411751,TRX_N-00529-846595015055,2023-08-06T12:13:08,Amurrio,Basic services,phone,-74.77,97761.95
buyer_3,Ana,35,ES22209579234312411751,TRX_N-00530-582437293691,2023-08-07T21:08:38,Amurrio,Basic services,phone,-23.55,97738.4
buyer_3,Ana,35,ES22209579234312411751,TRX_N-00531-316958950429,2023-08-25T21:29:08,Amurrio,Expense,repairs,-706.58,97031.82
buyer_3,Ana,35,ES22209579234312411751,TRX_N-00532-248654639605,2023-08-29T17:42:44,Amurrio,Expense,food,-590.04,96441.78
buyer_3,Ana,35,ES22209579234312411751,TRX_N-00533-856405189274,2023-09-01T11:43:25,Amurrio,transfer,Salary,2222.18,98663.96
buyer_3,Ana,35,ES22209579234312411751,TRX_N-00534-127477923246,2023-09-01T11:43:25,Amurrio,transfer,Partner Salary,2217.53,100881.49
buyer_3,Ana,35,ES22209579234312411751,TRX_N-00535-926199695403,2023-09-05T08:09:33,Amurrio,Housing,Rent,-1347.14,99534.35
buyer_3,Ana,35,ES22209579234312411751,TRX_N-00536-31806654450,2023-09-05T14:45:58,Amurrio,Basic services,water,-20.1,99514.25
buyer_3,Ana,35,ES22209579234312411751,TRX_N-00537-404091533812,2023-09-05T20:49:01,Amurrio,Basic services,electricity,-31.55,99482.7
buyer_3,Ana,35,ES22209579234312411751,TRX_N-00538-378108919840,2023-09-05T12:54:06,Amurrio,Basic services,gas,-16.3,99466.4
buyer_3,Ana,35,ES22209579234312411751,TRX_N-00539-881123788488,2023-09-05T14:05:55,Amurrio,Basic services,phone,-62.5,99403.9
buyer_3,Ana,35,ES22209579234312411751,TRX_N-00540-590513688913,2023-09-06T09:52:24,Amurrio,Basic services,water,-24.47,99379.43
buyer_3,Ana,35,ES22209579234312411751,TRX_N-00541-954361422757,2023-09-06T13:41:43,Amurrio,Basic services,gas,-58.52,99320.91
buyer_3,Ana,35,ES22209579234312411751,TRX_N-00542-273817875763,2023-09-06T09:27:38,Amurrio,Basic services,phone,-23.95,99296.96
buyer_3,Ana,35,ES22209579234312411751,TRX_N-00543-675752808128,2023-09-07T15:17:10,Amurrio,Basic services,electricity,-30.05,99266.91
buyer_3,Ana,35,ES22209579234312411751,TRX_N-00544-923761636663,2023-09-07T15:43:11,Amurrio,Basic services,phone,-47.52,99219.39
buyer_3,Ana,35,ES22209579234312411751,TRX_N-00545-297262196331,2023-09-17T09:15:36,Amurrio,Expense,transport,-133.87,99085.52
buyer_3,Ana,35,ES22209579234312411751,TRX_N-00546-802166171557,2023-09-19T14:54:33,Amurrio,Expense,appliances,-1724.09,97361.43
buyer_3,Ana,35,ES22209579234312411751,TRX_N-00547-411582592847,2023-09-23T11:14:17,Amurrio,Expense,food,-515.25,96846.18
buyer_3,Ana,35,ES22209579234312411751,TRX_N-00548-299911947659,2023-09-24T15:57:04,Irun,Expense,food,-227.56,96618.62
buyer_3,Ana,35,ES22209579234312411751,TRX_N-00549-754351660619,2023-10-01T14:18:09,Amurrio,transfer,Salary,2222.18,98840.8
buyer_3,Ana,35,ES22209579234312411751,TRX_N-00550-276378695667,2023-10-01T14:18:09,Amurrio,transfer,Partner Salary,2217.53,101058.33
buyer_3,Ana,35,ES22209579234312411751,TRX_N-00551-758716530986,2023-10-01T14:18:09,Amurrio,transfer,Extra Income,222.22,101280.55
buyer_3,Ana,35,ES22209579234312411751,TRX_N-00552-775553199783,2023-10-05T10:58:33,Amurrio,Housing,Rent,-1347.14,99933.41
buyer_3,Ana,35,ES22209579234312411751,TRX_N-00553-664102650117,2023-10-05T08:54:16,Amurrio,Basic services,water,-33.09,99900.32
buyer_3,Ana,35,ES22209579234312411751,TRX_N-00554-350449957145,2023-10-06T09:30:21,Amurrio,Basic services,phone,-40.52,99859.8
buyer_3,Ana,35,ES22209579234312411751,TRX_N-00555-35684452496,2023-10-12T01:35:16,Amurrio,Expense,leisure,-129.47,99730.33
buyer_3,Ana,35,ES22209579234312411751,TRX_N-00556-987675571466,2023-10-22T13:43:36,Amurrio,Expense,food,-297.14,99433.19
buyer_3,Ana,35,ES22209579234312411751,TRX_N-00557-641648323227,2023-10-29T16:40:24,Galdakao,Expense,clothing,-434.92,98998.27
buyer_3,Ana,35,ES22209579234312411751,TRX_N-00558-665808813222,2023-11-01T15:39:11,Amurrio,transfer,Salary,2222.18,101220.45
buyer_3,Ana,35,ES22209579234312411751,TRX_N-00559-432114411489,2023-11-01T15:39:11,Amurrio,transfer,Partner Salary,2217.53,103437.98
buyer_3,Ana,35,ES22209579234312411751,TRX_N-00560-662961206725,2023-11-05T13:09:04,Amurrio,Housing,Rent,-1347.14,102090.84
buyer_3,Ana,35,ES22209579234312411751,TRX_N-00561-81813796903,2023-11-05T12:24:05,Amurrio,Basic services,electricity,-24.02,102066.82
buyer_3,Ana,35,ES22209579234312411751,TRX_N-00562-923091704761,2023-11-05T18:35:19,Amurrio,Basic services,gas,-28.33,102038.49
buyer_3,Ana,35,ES22209579234312411751,TRX_N-00563-955566811951,2023-11-05T11:32:30,Portugalete,Expense,leisure,-63.01,101975.48
buyer_3,Ana,35,ES22209579234312411751,TRX_N-00564-478578758553,2023-11-07T14:22:57,Amurrio,Basic services,electricity,-102.17,101873.31
buyer_3,Ana,35,ES22209579234312411751,TRX_N-00565-575745594823,2023-11-08T21:31:08,Amurrio,Expense,education,-854.03,101019.28
buyer_3,Ana,35,ES22209579234312411751,TRX_N-00566-990284587925,2023-11-14T21:55:32,Amurrio,Expense,healthcare,-151.24,100868.04
buyer_3,Ana,35,ES22209579234312411751,TRX_N-00567-253049820429,2023-12-01T17:46:46,Amurrio,transfer,Salary,2222.18,103090.22
buyer_3,Ana,35,ES22209579234312411751,TRX_N-00568-623439610165,2023-12-01T17:46:46,Amurrio,transfer,Partner Salary,2217.53,105307.75
buyer_3,Ana,35,ES22209579234312411751,TRX_N-00569-963264726446,2023-12-01T17:46:46,Amurrio,transfer,Extra Income,222.22,105529.97
buyer_3,Ana,35,ES22209579234312411751,TRX_N-00570-970416613251,2023-12-01T17:46:46,Amurrio,transfer,Bonus,2362.19,107892.16
buyer_3,Ana,35,ES22209579234312411751,TRX_N-00571-608234104881,2023-12-05T08:39:27,Amurrio,Housing,Rent,-1347.14,106545.02
buyer_3,Ana,35,ES22209579234312411751,TRX_N-00572-147226481639,2023-12-05T10:08:54,Amurrio,Basic services,gas,-53.35,106491.67
buyer_3,Ana,35,ES22209579234312411751,TRX_N-00573-969390583444,2023-12-05T09:58:39,Amurrio,Basic services,internet,-35.05,106456.62
buyer_3,Ana,35,ES22209579234312411751,TRX_N-00574-562708113665,2023-12-06T18:31:49,Amurrio,Basic services,water,-15.97,106440.65
buyer_3,Ana,35,ES22209579234312411751,TRX_N-00575-777583540127,2023-12-06T12:13:31,Amurrio,Basic services,electricity,-24.34,106416.31
buyer_3,Ana,35,ES22209579234312411751,TRX_N-00576-85989604026,2023-12-06T11:01:36,Amurrio,Basic services,gas,-83.34,106332.97
buyer_3,Ana,35,ES22209579234312411751,TRX_N-00577-920331106353,2023-12-06T09:30:57,Amurrio,Basic services,internet,-52.66,106280.31
buyer_3,Ana,35,ES22209579234312411751,TRX_N-00578-594021505657,2023-12-06T20:28:14,Amurrio,Expense,appliances,-1796.48,104483.83
buyer_3,Ana,35,ES22209579234312411751,TRX_N-00579-695167745405,2023-12-07T16:45:02,Amurrio,Basic services,electricity,-89.09,104394.74
buyer_3,Ana,35,ES22209579234312411751,TRX_N-00580-697314840929,2023-12-07T14:20:21,Amurrio,Basic services,gas,-36.73,104358.01
buyer_3,Ana,35,ES22209579234312411751,TRX_N-00581-335103613926,2023-12-27T14:26:00,Amurrio,Expense,food,-235.62,104122.39
buyer_3,Ana,35,ES22209579234312411751,TRX_N-00582-831265566575,2023-12-28T20:38:50,Amurrio,Expense,transport,-171.7,103950.69
buyer_3,Ana,35,ES22209579234312411751,TRX_N-00583-621040257198,2023-12-31T16:56:50,Amurrio,Expense,healthcare,-130.76,103819.93
buyer_3,Ana,35,ES22209579234312411751,TRX_N-00584-454897122999,2024-01-01T11:18:43,Amurrio,transfer,Salary,2222.18,106042.11
buyer_3,Ana,35,ES22209579234312411751,TRX_N-00585-328558696559,2024-01-01T11:18:43,Amurrio,transfer,Partner Salary,2217.53,108259.64
buyer_3,Ana,35,ES22209579234312411751,TRX_N-00586-373930703723,2024-01-05T18:13:28,Amurrio,Housing,Rent,-1347.14,106912.5
buyer_3,Ana,35,ES22209579234312411751,TRX_N-00587-663806708613,2024-01-05T15:05:45,Amurrio,Basic services,water,-49.63,106862.87
buyer_3,Ana,35,ES22209579234312411751,TRX_N-00588-969646758199,2024-01-05T14:26:22,Amurrio,Basic services,gas,-19.18,106843.69
buyer_3,Ana,35,ES22209579234312411751,TRX_N-00589-115535797602,2024-01-05T12:12:19,Amurrio,Basic services,phone,-77.2,106766.49
buyer_3,Ana,35,ES22209579234312411751,TRX_N-00590-962619200956,2024-01-06T10:06:00,Amurrio,Basic services,internet,-76.12,106690.37
buyer_3,Ana,35,ES22209579234312411751,TRX_N-00591-320610133107,2024-01-07T13:45:24,Amurrio,Basic services,internet,-55.37,106635.0
buyer_3,Ana,35,ES22209579234312411751,TRX_N-00592-663024274746,2024-01-09T20:40:29,Amurrio,Expense,healthcare,-84.11,106550.89
buyer_3,Ana,35,ES22209579234312411751,TRX_N-00593-714382297073,2024-02-01T10:01:47,Amurrio,transfer,Salary,2222.18,108773.07
buyer_3,Ana,35,ES22209579234312411751,TRX_N-00594-108535307181,2024-02-01T10:01:47,Amurrio,transfer,Partner Salary,2217.53,110990.6
buyer_3,Ana,35,ES22209579234312411751,TRX_N-00595-683199527047,2024-02-05T21:47:58,Amurrio,Housing,Rent,-1347.14,109643.46
buyer_3,Ana,35,ES22209579234312411751,TRX_N-00596-767462736163,2024-02-05T10:12:33,Amurrio,Basic services,internet,-63.56,109579.9
buyer_3,Ana,35,ES22209579234312411751,TRX_N-00597-726737233218,2024-02-05T18:05:55,Amurrio,Expense,food,-785.17,108794.73
buyer_3,Ana,35,ES22209579234312411751,TRX_N-00598-68595009019,2024-02-06T10:52:02,Amurrio,Basic services,phone,-76.68,108718.05
buyer_3,Ana,35,ES22209579234312411751,TRX_N-00599-929959680092,2024-02-07T09:50:57,Amurrio,Basic services,water,-52.41,108665.64
buyer_3,Ana,35,ES22209579234312411751,TRX_N-00600-445075233741,2024-02-07T23:20:11,Amurrio,Basic services,electricity,-122.23,108543.41
buyer_3,Ana,35,ES22209579234312411751,TRX_N-00601-65071730374,2024-02-07T08:55:40,Amurrio,Basic services,phone,-49.37,108494.04
buyer_3,Ana,35,ES22209579234312411751,TRX_N-00602-771676045396,2024-02-09T14:24:42,Amurrio,Expense,food,-614.8,107879.24
buyer_3,Ana,35,ES22209579234312411751,TRX_N-00603-146525481943,2024-02-21T17:46:37,Amurrio,Expense,leisure,-101.36,107777.88
buyer_3,Ana,35,ES22209579234312411751,TRX_N-00604-900288174880,2024-03-01T08:35:07,Amurrio,transfer,Salary,2222.18,110000.06
buyer_3,Ana,35,ES22209579234312411751,TRX_N-00605-379369266143,2024-03-01T08:35:07,Amurrio,transfer,Partner Salary,2217.53,112217.59
buyer_3,Ana,35,ES22209579234312411751,TRX_N-00606-928414331178,2024-03-01T08:35:07,Amurrio,transfer,Extra Income,222.22,112439.81
buyer_3,Ana,35,ES22209579234312411751,TRX_N-00607-674287493401,2024-03-02T18:06:56,Amurrio,Expense,food,-659.13,111780.68
buyer_3,Ana,35,ES22209579234312411751,TRX_N-00608-676088079081,2024-03-05T17:42:07,Amurrio,Housing,Rent,-1347.14,110433.54
buyer_3,Ana,35,ES22209579234312411751,TRX_N-00609-742984759621,2024-03-05T17:25:12,Amurrio,Basic services,electricity,-63.83,110369.71
buyer_3,Ana,35,ES22209579234312411751,TRX_N-00610-266906538555,2024-03-05T15:12:10,Amurrio,Basic services,phone,-87.18,110282.53
buyer_3,Ana,35,ES22209579234312411751,TRX_N-00611-908063006357,2024-03-06T09:02:43,Amurrio,Basic services,phone,-41.57,110240.96
buyer_3,Ana,35,ES22209579234312411751,TRX_N-00612-78493374559,2024-03-07T11:04:54,Amurrio,Basic services,water,-67.4,110173.56
buyer_3,Ana,35,ES22209579234312411751,TRX_N-00613-295682673328,2024-03-07T11:09:52,Amurrio,Basic services,gas,-66.99,110106.57
buyer_3,Ana,35,ES22209579234312411751,TRX_N-00614-788303770647,2024-03-07T10:57:50,Amurrio,Basic services,phone,-78.56,110028.01
buyer_3,Ana,35,ES22209579234312411751,TRX_N-00615-200217792464,2024-03-18T11:21:06,Amurrio,Expense,food,-264.22,109763.79
buyer_3,Ana,35,ES22209579234312411751,TRX_N-00616-702283081470,2024-03-30T12:41:29,Amurrio,Expense,food,-634.68,109129.11
buyer_3,Ana,35,ES22209579234312411751,TRX_N-00617-913970905806,2024-04-01T10:57:34,Amurrio,transfer,Salary,2222.18,111351.29
buyer_3,Ana,35,ES22209579234312411751,TRX_N-00618-478699093400,2024-04-01T10:57:34,Amurrio,transfer,Partner Salary,2217.53,113568.82
buyer_3,Ana,35,ES22209579234312411751,TRX_N-00619-320849944506,2024-04-02T17:57:59,Amurrio,Expense,transport,-25.75,113543.07
buyer_3,Ana,35,ES22209579234312411751,TRX_N-00620-254876487275,2024-04-05T08:23:57,Amurrio,Housing,Rent,-1347.14,112195.93
buyer_3,Ana,35,ES22209579234312411751,TRX_N-00621-644460772885,2024-04-05T18:28:00,Amurrio,Basic services,internet,-33.26,112162.67
buyer_3,Ana,35,ES22209579234312411751,TRX_N-00622-206489150284,2024-04-06T14:33:13,Amurrio,Basic services,water,-55.28,112107.39
buyer_3,Ana,35,ES22209579234312411751,TRX_N-00623-782988520414,2024-04-06T04:19:06,Amurrio,Basic services,internet,-40.98,112066.41
buyer_3,Ana,35,ES22209579234312411751,TRX_N-00624-571176406977,2024-04-06T03:51:47,Amurrio,Basic services,phone,-71.3,111995.11
buyer_3,Ana,35,ES22209579234312411751,TRX_N-00625-907540028721,2024-04-07T11:04:46,Amurrio,Basic services,phone,-35.96,111959.15
buyer_3,Ana,35,ES22209579234312411751,TRX_N-00626-961102738067,2024-04-07T08:07:12,Amurrio,Expense,clothing,-337.35,111621.8
buyer_3,Ana,35,ES22209579234312411751,TRX_N-00627-141136435964,2024-04-14T14:56:04,Getxo,Expense,food,-567.25,111054.55
buyer_3,Ana,35,ES22209579234312411751,TRX_N-00628-317308339513,2024-04-28T02:08:14,Amurrio,Expense,food,-699.87,110354.68
buyer_3,Ana,35,ES22209579234312411751,TRX_N-00629-647834824156,2024-04-28T18:37:47,Irun,Expense,repairs,-128.82,110225.86
buyer_3,Ana,35,ES22209579234312411751,TRX_N-00630-817185559681,2024-04-30T11:49:03,Barakaldo,Expense,transport,-72.79,110153.07
buyer_3,Ana,35,ES22209579234312411751,TRX_N-00631-590773746544,2024-05-01T09:21:44,Amurrio,transfer,Salary,2222.18,112375.25
buyer_3,Ana,35,ES22209579234312411751,TRX_N-00632-460735353994,2024-05-01T09:21:44,Amurrio,transfer,Partner Salary,2217.53,114592.78
buyer_3,Ana,35,ES22209579234312411751,TRX_N-00633-546271806217,2024-05-05T10:40:20,Amurrio,Housing,Rent,-1347.14,113245.64
buyer_3,Ana,35,ES22209579234312411751,TRX_N-00634-964005558718,2024-05-06T14:56:56,Amurrio,Basic services,water,-47.1,113198.54
buyer_3,Ana,35,ES22209579234312411751,TRX_N-00635-99063750844,2024-05-06T12:04:00,Amurrio,Basic services,electricity,-63.88,113134.66
buyer_3,Ana,35,ES22209579234312411751,TRX_N-00636-836805536790,2024-05-06T15:51:24,Amurrio,Basic services,internet,-73.65,113061.01
buyer_3,Ana,35,ES22209579234312411751,TRX_N-00637-182532351501,2024-05-07T11:09:54,Amurrio,Basic services,water,-60.67,113000.34
buyer_3,Ana,35,ES22209579234312411751,TRX_N-00638-918845374427,2024-05-07T08:22:26,Amurrio,Basic services,gas,-44.1,112956.24
buyer_3,Ana,35,ES22209579234312411751,TRX_N-00639-736776078933,2024-05-07T10:08:42,Amurrio,Expense,food,-159.74,112796.5
buyer_3,Ana,35,ES22209579234312411751,TRX_N-00640-558826872719,2024-05-08T22:50:50,Eibar,Expense,leisure,-115.05,112681.45
buyer_3,Ana,35,ES22209579234312411751,TRX_N-00641-147158446809,2024-05-12T20:38:11,Amurrio,Expense,leisure,-231.86,112449.59
buyer_3,Ana,35,ES22209579234312411751,TRX_N-00642-895765670411,2024-05-18T09:43:27,Amurrio,Expense,gifts,-450.12,111999.47
buyer_3,Ana,35,ES22209579234312411751,TRX_N-00643-869417306054,2024-06-01T11:09:15,Amurrio,transfer,Salary,2222.18,114221.65
buyer_3,Ana,35,ES22209579234312411751,TRX_N-00644-227067539898,2024-06-01T11:09:15,Amurrio,transfer,Partner Salary,2217.53,116439.18
buyer_3,Ana,35,ES22209579234312411751,TRX_N-00645-124913215699,2024-06-01T11:09:15,Amurrio,transfer,Extra Income,222.22,116661.4
buyer_3,Ana,35,ES22209579234312411751,TRX_N-00646-193672988156,2024-06-01T11:09:15,Amurrio,transfer,Bonus,2255.17,118916.57
buyer_3,Ana,35,ES22209579234312411751,TRX_N-00647-912832591737,2024-06-04T20:03:12,Amurrio,Expense,transport,-179.93,118736.64
buyer_3,Ana,35,ES22209579234312411751,TRX_N-00648-274133499854,2024-06-05T14:04:42,Amurrio,Housing,Rent,-1347.14,117389.5
buyer_3,Ana,35,ES22209579234312411751,TRX_N-00649-710732281313,2024-06-05T13:21:30,Amurrio,Basic services,electricity,-48.64,117340.86
buyer_3,Ana,35,ES22209579234312411751,TRX_N-00650-795825342052,2024-06-05T10:19:10,Amurrio,Basic services,gas,-18.98,117321.88
buyer_3,Ana,35,ES22209579234312411751,TRX_N-00651-648663240610,2024-06-05T18:41:59,Amurrio,Basic services,phone,-90.34,117231.54
buyer_3,Ana,35,ES22209579234312411751,TRX_N-00652-410022294234,2024-06-05T12:38:54,Amurrio,Expense,leisure,-286.25,116945.29
buyer_3,Ana,35,ES22209579234312411751,TRX_N-00653-463935840477,2024-06-07T12:51:22,Amurrio,Basic services,water,-77.53,116867.76
buyer_3,Ana,35,ES22209579234312411751,TRX_N-00654-46172013533,2024-06-07T14:53:23,Amurrio,Basic services,internet,-79.66,116788.1
buyer_3,Ana,35,ES22209579234312411751,TRX_N-00655-938915240742,2024-06-07T19:26:02,Amurrio,Basic services,phone,-89.47,116698.63
buyer_3,Ana,35,ES22209579234312411751,TRX_N-00656-310431650269,2024-06-25T22:07:24,Amurrio,Expense,clothing,-195.7,116502.93
buyer_3,Ana,35,ES22209579234312411751,TRX_N-00657-578668798959,2024-06-28T13:57:04,Amurrio,Expense,food,-352.59,116150.34
buyer_3,Ana,35,ES22209579234312411751,TRX_N-00658-341438564751,2024-07-01T15:42:09,Amurrio,transfer,Salary,2222.18,118372.52
buyer_3,Ana,35,ES22209579234312411751,TRX_N-00659-809529921872,2024-07-01T15:42:09,Amurrio,transfer,Partner Salary,2217.53,120590.05
buyer_3,Ana,35,ES22209579234312411751,TRX_N-00660-159102921589,2024-07-04T05:59:39,Lasarte-Oria,Expense,transport,-22.53,120567.52
buyer_3,Ana,35,ES22209579234312411751,TRX_N-00661-573792970415,2024-07-05T19:12:09,Amurrio,Housing,Rent,-1347.14,119220.38
buyer_3,Ana,35,ES22209579234312411751,TRX_N-00662-298919269230,2024-07-05T04:57:55,Amurrio,Basic services,water,-15.8,119204.58
buyer_3,Ana,35,ES22209579234312411751,TRX_N-00663-498309052895,2024-07-05T04:48:22,Amurrio,Basic services,electricity,-97.91,119106.67
buyer_3,Ana,35,ES22209579234312411751,TRX_N-00664-805920615783,2024-07-06T10:20:40,Amurrio,Basic services,electricity,-48.62,119058.05
buyer_3,Ana,35,ES22209579234312411751,TRX_N-00665-387742487774,2024-07-06T09:58:46,Amurrio,Basic services,phone,-26.26,119031.79
buyer_3,Ana,35,ES22209579234312411751,TRX_N-00666-931862465648,2024-07-07T11:06:59,Amurrio,Basic services,electricity,-57.45,118974.34
buyer_3,Ana,35,ES22209579234312411751,TRX_N-00667-610383330501,2024-07-07T17:38:31,Amurrio,Basic services,internet,-78.18,118896.16
buyer_3,Ana,35,ES22209579234312411751,TRX_N-00668-791798186106,2024-07-08T20:15:59,Santurtzi,Expense,transport,-61.22,118834.94
buyer_3,Ana,35,ES22209579234312411751,TRX_N-00669-795405500607,2024-07-09T08:53:48,Amurrio,Expense,healthcare,-309.75,118525.19
buyer_3,Ana,35,ES22209579234312411751,TRX_N-00670-878261157823,2024-08-01T19:40:58,Amurrio,transfer,Salary,2222.18,120747.37
buyer_3,Ana,35,ES22209579234312411751,TRX_N-00671-360302135277,2024-08-01T19:40:58,Amurrio,transfer,Partner Salary,2217.53,122964.9
buyer_3,Ana,35,ES22209579234312411751,TRX_N-00672-740412957893,2024-08-01T19:40:58,Amurrio,transfer,Extra Income,222.22,123187.12
buyer_3,Ana,35,ES22209579234312411751,TRX_N-00673-485227249499,2024-08-05T17:23:46,Amurrio,Housing,Rent,-1347.14,121839.98
buyer_3,Ana,35,ES22209579234312411751,TRX_N-00674-623229771746,2024-08-05T16:44:42,Amurrio,Basic services,water,-15.56,121824.42
buyer_3,Ana,35,ES22209579234312411751,TRX_N-00675-582387306863,2024-08-05T06:49:08,Amurrio,Basic services,phone,-35.09,121789.33
buyer_3,Ana,35,ES22209579234312411751,TRX_N-00676-885705969480,2024-08-05T15:49:12,Bilbao,Expense,food,-528.44,121260.89
buyer_3,Ana,35,ES22209579234312411751,TRX_N-00677-966737198218,2024-08-06T10:42:54,Amurrio,Basic services,phone,-79.27,121181.62
buyer_3,Ana,35,ES22209579234312411751,TRX_N-00678-667317494352,2024-08-07T20:54:21,Lasarte-Oria,Expense,transport,-159.55,121022.07
buyer_3,Ana,35,ES22209579234312411751,TRX_N-00679-943979427103,2024-08-13T23:36:59,Amurrio,Expense,clothing,-356.29,120665.78
buyer_3,Ana,35,ES22209579234312411751,TRX_N-00680-957360122523,2024-08-19T13:52:12,Amurrio,Expense,gifts,-433.12,120232.66
buyer_3,Ana,35,ES22209579234312411751,TRX_N-00681-26348383151,2024-09-01T20:43:06,Amurrio,transfer,Salary,2222.18,122454.84
buyer_3,Ana,35,ES22209579234312411751,TRX_N-00682-41496251208,2024-09-01T20:43:06,Amurrio,transfer,Partner Salary,2217.53,124672.37
buyer_3,Ana,35,ES22209579234312411751,TRX_N-00683-35705449381,2024-09-05T15:19:54,Amurrio,Housing,Rent,-1347.14,123325.23
buyer_3,Ana,35,ES22209579234312411751,TRX_N-00684-799693398238,2024-09-07T07:28:45,Amurrio,Basic services,internet,-30.28,123294.95
buyer_3,Ana,35,ES22209579234312411751,TRX_N-00685-691312119,2024-09-07T09:10:59,Amurrio,Basic services,phone,-22.66,123272.29
buyer_3,Ana,35,ES22209579234312411751,TRX_N-00686-30636787885,2024-09-12T16:00:45,Amurrio,Expense,food,-620.84,122651.45
buyer_3,Ana,35,ES22209579234312411751,TRX_N-00687-792841578006,2024-09-18T11:20:46,Amurrio,Expense,transport,-190.78,122460.67
buyer_3,Ana,35,ES22209579234312411751,TRX_N-00688-630530851023,2024-09-23T17:10:17,Amurrio,Expense,transport,-137.96,122322.71
buyer_3,Ana,35,ES22209579234312411751,TRX_N-00689-28602977042,2024-09-24T14:32:18,Amurrio,Expense,transport,-20.89,122301.82
buyer_3,Ana,35,ES22209579234312411751,TRX_N-00690-84253793069,2024-09-26T12:05:57,Amurrio,Expense,repairs,-565.13,121736.69
buyer_3,Ana,35,ES22209579234312411751,TRX_N-00691-261216393376,2024-09-28T02:19:28,Amurrio,Expense,transport,-178.89,121557.8
buyer_3,Ana,35,ES22209579234312411751,TRX_N-00692-766213014375,2024-10-01T12:31:23,Amurrio,transfer,Salary,2222.18,123779.98
buyer_3,Ana,35,ES22209579234312411751,TRX_N-00693-776360693257,2024-10-01T12:31:23,Amurrio,transfer,Partner Salary,2217.53,125997.51
buyer_3,Ana,35,ES22209579234312411751,TRX_N-00694-444102603897,2024-10-02T20:19:55,Amurrio,Expense,travel,-1867.91,124129.6
buyer_3,Ana,35,ES22209579234312411751,TRX_N-00695-851613781241,2024-10-05T12:26:25,Amurrio,Housing,Rent,-1347.14,122782.46
buyer_3,Ana,35,ES22209579234312411751,TRX_N-00696-727722953472,2024-10-06T15:12:31,Amurrio,Basic services,water,-50.42,122732.04
buyer_3,Ana,35,ES22209579234312411751,TRX_N-00697-930362384061,2024-10-06T17:00:10,Amurrio,Basic services,electricity,-45.81,122686.23
buyer_3,Ana,35,ES22209579234312411751,TRX_N-00698-896011723139,2024-10-06T14:51:31,Amurrio,Basic services,phone,-27.34,122658.89
buyer_4,Jorge,50,ES66209532250731308914,TRX_N-00001-653335752470,2020-01-01T12:48:21,Galdakao,transfer,Salary,2836.23,9476.52
buyer_4,Jorge,50,ES66209532250731308914,TRX_N-00002-784001674144,2020-01-01T12:48:21,Galdakao,transfer,Partner Salary,2836.62,12313.14
buyer_4,Jorge,50,ES66209532250731308914,TRX_N-00003-573499963440,2020-01-05T04:21:30,Galdakao,Housing,Mortgage,-893.54,11419.6
buyer_4,Jorge,50,ES66209532250731308914,TRX_N-00004-671857642947,2020-01-05T18:52:18,Galdakao,Basic services,gas,-73.3,11346.3
buyer_4,Jorge,50,ES66209532250731308914,TRX_N-00005-786372032077,2020-01-05T12:44:45,Galdakao,Basic services,internet,-64.63,11281.67
buyer_4,Jorge,50,ES66209532250731308914,TRX_N-00006-567277082422,2020-01-05T16:57:29,Galdakao,Basic services,phone,-45.43,11236.24
buyer_4,Jorge,50,ES66209532250731308914,TRX_N-00007-974738161423,2020-01-06T21:28:03,Galdakao,Basic services,gas,-20.08,11216.16
buyer_4,Jorge,50,ES66209532250731308914,TRX_N-00008-189036515589,2020-01-06T23:35:29,Galdakao,Basic services,internet,-67.02,11149.14
buyer_4,Jorge,50,ES66209532250731308914,TRX_N-00009-508770519346,2020-01-06T14:47:19,Galdakao,Basic services,phone,-75.03,11074.11
buyer_4,Jorge,50,ES66209532250731308914,TRX_N-00010-861456560008,2020-01-07T20:14:34,Galdakao,Basic services,electricity,-138.45,10935.66
buyer_4,Jorge,50,ES66209532250731308914,TRX_N-00011-595685404569,2020-01-07T15:12:25,Galdakao,Basic services,gas,-60.52,10875.14
buyer_4,Jorge,50,ES66209532250731308914,TRX_N-00012-239794644526,2020-01-07T08:56:53,Galdakao,Basic services,internet,-73.82,10801.32
buyer_4,Jorge,50,ES66209532250731308914,TRX_N-00013-851596088779,2020-01-07T13:35:32,Galdakao,Basic services,phone,-43.32,10758.0
buyer_4,Jorge,50,ES66209532250731308914,TRX_N-00014-932990430756,2020-01-09T18:44:07,Galdakao,Expense,leisure,-72.27,10685.73
buyer_4,Jorge,50,ES66209532250731308914,TRX_N-00015-365524600516,2020-01-16T15:41:21,Berango,Expense,food,-192.14,10493.59
buyer_4,Jorge,50,ES66209532250731308914,TRX_N-00016-329121736114,2020-01-23T14:47:34,Galdakao,Expense,education,-333.51,10160.08
buyer_4,Jorge,50,ES66209532250731308914,TRX_N-00017-959301067828,2020-01-23T20:54:58,Zuia,Expense,appliances,-494.12,9665.96
buyer_4,Jorge,50,ES66209532250731308914,TRX_N-00018-351261345376,2020-01-25T06:38:35,Galdakao,Expense,clothing,-213.88,9452.08
buyer_4,Jorge,50,ES66209532250731308914,TRX_N-00019-72148156290,2020-01-25T11:05:21,Galdakao,Expense,repairs,-161.33,9290.75
buyer_4,Jorge,50,ES66209532250731308914,TRX_N-00020-485688063705,2020-01-28T04:23:46,Getxo,Expense,education,-196.61,9094.14
buyer_4,Jorge,50,ES66209532250731308914,TRX_N-00021-971548213474,2020-02-01T23:53:03,Galdakao,transfer,Salary,2836.23,11930.37
buyer_4,Jorge,50,ES66209532250731308914,TRX_N-00022-301756751064,2020-02-01T23:53:03,Galdakao,transfer,Partner Salary,2836.62,14766.99
buyer_4,Jorge,50,ES66209532250731308914,TRX_N-00023-597859895049,2020-02-05T03:27:22,Galdakao,Housing,Mortgage,-893.54,13873.45
buyer_4,Jorge,50,ES66209532250731308914,TRX_N-00024-363053554757,2020-02-05T12:10:19,Galdakao,Basic services,phone,-39.04,13834.41
buyer_4,Jorge,50,ES66209532250731308914,TRX_N-00025-196662590197,2020-02-06T09:30:24,Galdakao,Basic services,water,-49.9,13784.51
buyer_4,Jorge,50,ES66209532250731308914,TRX_N-00026-569003291016,2020-02-06T22:11:14,Galdakao,Basic services,phone,-96.88,13687.63
buyer_4,Jorge,50,ES66209532250731308914,TRX_N-00027-30167818356,2020-02-13T22:45:48,Galdakao,Expense,food,-684.26,13003.37
buyer_4,Jorge,50,ES66209532250731308914,TRX_N-00028-706374113112,2020-03-01T18:58:37,Galdakao,transfer,Salary,2836.23,15839.6
buyer_4,Jorge,50,ES66209532250731308914,TRX_N-00029-735803612081,2020-03-01T18:58:37,Galdakao,transfer,Partner Salary,2836.62,18676.22
buyer_4,Jorge,50,ES66209532250731308914,TRX_N-00030-3768402852,2020-03-01T18:58:37,Galdakao,transfer,Extra Income,283.62,18959.84
buyer_4,Jorge,50,ES66209532250731308914,TRX_N-00031-450788661273,2020-03-05T17:05:55,Galdakao,Housing,Mortgage,-893.54,18066.3
buyer_4,Jorge,50,ES66209532250731308914,TRX_N-00032-990741578090,2020-03-06T19:45:32,Galdakao,Basic services,internet,-74.81,17991.49
buyer_4,Jorge,50,ES66209532250731308914,TRX_N-00033-924964225880,2020-03-07T09:22:42,Galdakao,Basic services,phone,-64.97,17926.52
buyer_4,Jorge,50,ES66209532250731308914,TRX_N-00034-784494243500,2020-03-24T12:03:53,Galdakao,Expense,food,-741.14,17185.38
buyer_4,Jorge,50,ES66209532250731308914,TRX_N-00035-930027425887,2020-04-01T19:52:18,Galdakao,transfer,Salary,2836.23,20021.61
buyer_4,Jorge,50,ES66209532250731308914,TRX_N-00036-708043786196,2020-04-01T19:52:18,Galdakao,transfer,Partner Salary,2836.62,22858.23
buyer_4,Jorge,50,ES66209532250731308914,TRX_N-00037-887297967056,2020-04-04T18:44:30,Galdakao,Expense,leisure,-124.47,22733.76
buyer_4,Jorge,50,ES66209532250731308914,TRX_N-00038-801227453872,2020-04-05T04:08:16,Galdakao,Housing,Mortgage,-893.54,21840.22
buyer_4,Jorge,50,ES66209532250731308914,TRX_N-00039-928747739149,2020-04-05T09:20:30,Galdakao,Basic services,gas,-23.65,21816.57
buyer_4,Jorge,50,ES66209532250731308914,TRX_N-00040-701689189461,2020-04-05T15:42:30,Galdakao,Basic services,phone,-79.77,21736.8
buyer_4,Jorge,50,ES66209532250731308914,TRX_N-00041-384183613429,2020-04-06T13:15:11,Galdakao,Basic services,water,-61.08,21675.72
buyer_4,Jorge,50,ES66209532250731308914,TRX_N-00042-280305010695,2020-04-06T23:41:23,Galdakao,Basic services,internet,-70.49,21605.23
buyer_4,Jorge,50,ES66209532250731308914,TRX_N-00043-411978195702,2020-04-06T11:37:39,Galdakao,Basic services,phone,-74.69,21530.54
buyer_4,Jorge,50,ES66209532250731308914,TRX_N-00044-51111764698,2020-04-07T16:41:12,Galdakao,Basic services,internet,-69.91,21460.63
buyer_4,Jorge,50,ES66209532250731308914,TRX_N-00045-501586359600,2020-04-07T14:44:16,Galdakao,Basic services,phone,-69.1,21391.53
buyer_4,Jorge,50,ES66209532250731308914,TRX_N-00046-988071682587,2020-04-09T15:43:06,Galdakao,Expense,healthcare,-213.0,21178.53
buyer_4,Jorge,50,ES66209532250731308914,TRX_N-00047-414575374198,2020-04-10T09:00:44,Galdakao,Expense,clothing,-99.92,21078.61
buyer_4,Jorge,50,ES66209532250731308914,TRX_N-00048-447304817727,2020-04-13T09:21:56,Irun,Expense,food,-410.05,20668.56
buyer_4,Jorge,50,ES66209532250731308914,TRX_N-00049-643811689414,2020-05-01T23:39:43,Galdakao,transfer,Salary,2836.23,23504.79
buyer_4,Jorge,50,ES66209532250731308914,TRX_N-00050-792868726859,2020-05-01T23:39:43,Galdakao,transfer,Partner Salary,2836.62,26341.41
buyer_4,Jorge,50,ES66209532250731308914,TRX_N-00051-718889727471,2020-05-02T22:19:20,Galdakao,Expense,food,-139.66,26201.75
buyer_4,Jorge,50,ES66209532250731308914,TRX_N-00052-763000141082,2020-05-05T19:24:10,Galdakao,Housing,Mortgage,-893.54,25308.21
buyer_4,Jorge,50,ES66209532250731308914,TRX_N-00053-779035090553,2020-05-05T19:01:07,Galdakao,Basic services,electricity,-33.24,25274.97
buyer_4,Jorge,50,ES66209532250731308914,TRX_N-00054-807162739570,2020-05-05T14:43:54,Galdakao,Expense,transport,-199.33,25075.64
buyer_4,Jorge,50,ES66209532250731308914,TRX_N-00055-714715943067,2020-05-06T12:51:51,Galdakao,Basic services,water,-53.61,25022.03
buyer_4,Jorge,50,ES66209532250731308914,TRX_N-00056-367319057601,2020-05-07T21:03:28,Galdakao,Expense,transport,-56.04,24965.99
buyer_4,Jorge,50,ES66209532250731308914,TRX_N-00057-383283987065,2020-05-09T09:49:17,Galdakao,Expense,food,-147.56,24818.43
buyer_4,Jorge,50,ES66209532250731308914,TRX_N-00058-857562271471,2020-05-27T18:19:06,Sestao,Expense,clothing,-67.36,24751.07
buyer_4,Jorge,50,ES66209532250731308914,TRX_N-00059-128550042591,2020-05-28T17:28:27,Llodio,Expense,travel,-784.81,23966.26
buyer_4,Jorge,50,ES66209532250731308914,TRX_N-00060-875275794816,2020-06-01T13:16:19,Galdakao,transfer,Salary,2836.23,26802.49
buyer_4,Jorge,50,ES66209532250731308914,TRX_N-00061-158163211161,2020-06-01T13:16:19,Galdakao,transfer,Partner Salary,2836.62,29639.11
buyer_4,Jorge,50,ES66209532250731308914,TRX_N-00062-564143185249,2020-06-01T13:16:19,Galdakao,transfer,Extra Income,283.62,29922.73
buyer_4,Jorge,50,ES66209532250731308914,TRX_N-00063-513833601827,2020-06-01T13:16:19,Galdakao,transfer,Bonus,2586.43,32509.16
buyer_4,Jorge,50,ES66209532250731308914,TRX_N-00064-987850698852,2020-06-05T11:29:20,Galdakao,Housing,Mortgage,-893.54,31615.62
buyer_4,Jorge,50,ES66209532250731308914,TRX_N-00065-446792849138,2020-06-05T22:35:35,Galdakao,Basic services,gas,-92.18,31523.44
buyer_4,Jorge,50,ES66209532250731308914,TRX_N-00066-236384012634,2020-06-06T14:14:28,Galdakao,Basic services,electricity,-149.42,31374.02
buyer_4,Jorge,50,ES66209532250731308914,TRX_N-00067-474791887960,2020-06-06T15:49:20,Galdakao,Basic services,phone,-63.09,31310.93
buyer_4,Jorge,50,ES66209532250731308914,TRX_N-00068-729781361336,2020-06-11T09:20:15,Galdakao,Expense,repairs,-644.59,30666.34
buyer_4,Jorge,50,ES66209532250731308914,TRX_N-00069-34049080050,2020-06-15T19:06:32,Galdakao,Expense,transport,-41.94,30624.4
buyer_4,Jorge,50,ES66209532250731308914,TRX_N-00070-344108218548,2020-06-24T12:07:52,Irun,Expense,repairs,-319.43,30304.97
buyer_4,Jorge,50,ES66209532250731308914,TRX_N-00071-904915498498,2020-06-25T12:08:13,Galdakao,Expense,education,-120.18,30184.79
buyer_4,Jorge,50,ES66209532250731308914,TRX_N-00072-132891667807,2020-07-01T03:41:29,Galdakao,transfer,Salary,2836.23,33021.02
buyer_4,Jorge,50,ES66209532250731308914,TRX_N-00073-8453700112,2020-07-01T03:41:29,Galdakao,transfer,Partner Salary,2836.62,35857.64
buyer_4,Jorge,50,ES66209532250731308914,TRX_N-00074-458577389091,2020-07-05T10:10:47,Galdakao,Housing,Mortgage,-893.54,34964.1
buyer_4,Jorge,50,ES66209532250731308914,TRX_N-00075-319967311141,2020-07-05T15:51:27,Galdakao,Basic services,gas,-33.07,34931.03
buyer_4,Jorge,50,ES66209532250731308914,TRX_N-00076-760502973672,2020-07-06T17:16:39,Galdakao,Basic services,electricity,-62.88,34868.15
buyer_4,Jorge,50,ES66209532250731308914,TRX_N-00077-294271332314,2020-07-06T17:18:18,Galdakao,Basic services,internet,-45.15,34823.0
buyer_4,Jorge,50,ES66209532250731308914,TRX_N-00078-558350324765,2020-07-06T17:38:14,Galdakao,Basic services,phone,-86.43,34736.57
buyer_4,Jorge,50,ES66209532250731308914,TRX_N-00079-129516997641,2020-07-07T12:28:50,Galdakao,Basic services,gas,-95.99,34640.58
buyer_4,Jorge,50,ES66209532250731308914,TRX_N-00080-583646490079,2020-07-11T18:24:11,Galdakao,Expense,leisure,-58.2,34582.38
buyer_4,Jorge,50,ES66209532250731308914,TRX_N-00081-235252184090,2020-07-15T20:16:45,Galdakao,Expense,transport,-156.49,34425.89
buyer_4,Jorge,50,ES66209532250731308914,TRX_N-00082-906967836562,2020-07-15T15:35:28,Galdakao,Expense,healthcare,-273.5,34152.39
buyer_4,Jorge,50,ES66209532250731308914,TRX_N-00083-387874503353,2020-07-21T10:47:52,Galdakao,Expense,leisure,-208.78,33943.61
buyer_4,Jorge,50,ES66209532250731308914,TRX_N-00084-141693074261,2020-07-23T17:02:46,Galdakao,Expense,education,-564.04,33379.57
buyer_4,Jorge,50,ES66209532250731308914,TRX_N-00085-118664204355,2020-07-30T23:57:45,Galdakao,Expense,food,-385.76,32993.81
buyer_4,Jorge,50,ES66209532250731308914,TRX_N-00086-959374004908,2020-08-01T18:17:42,Galdakao,transfer,Salary,2836.23,35830.04
buyer_4,Jorge,50,ES66209532250731308914,TRX_N-00087-653340492651,2020-08-01T18:17:42,Galdakao,transfer,Partner Salary,2836.62,38666.66
buyer_4,Jorge,50,ES66209532250731308914,TRX_N-00088-768299358201,2020-08-05T19:31:43,Galdakao,Housing,Mortgage,-893.54,37773.12
buyer_4,Jorge,50,ES66209532250731308914,TRX_N-00089-231931454703,2020-08-05T10:25:37,Galdakao,Basic services,water,-78.36,37694.76
buyer_4,Jorge,50,ES66209532250731308914,TRX_N-00090-993734945108,2020-08-06T11:04:03,Galdakao,Basic services,electricity,-94.4,37600.36
buyer_4,Jorge,50,ES66209532250731308914,TRX_N-00091-654101751114,2020-08-06T12:53:40,Galdakao,Basic services,phone,-81.69,37518.67
buyer_4,Jorge,50,ES66209532250731308914,TRX_N-00092-408453508637,2020-08-06T12:30:17,Leioa,Expense,education,-104.82,37413.85
buyer_4,Jorge,50,ES66209532250731308914,TRX_N-00093-53692582289,2020-08-07T00:48:55,Galdakao,Basic services,internet,-30.75,37383.1
buyer_4,Jorge,50,ES66209532250731308914,TRX_N-00094-222560530469,2020-08-15T11:22:00,Mungia,Expense,leisure,-147.46,37235.64
buyer_4,Jorge,50,ES66209532250731308914,TRX_N-00095-809677042003,2020-08-20T09:53:30,Galdakao,Expense,leisure,-114.58,37121.06
buyer_4,Jorge,50,ES66209532250731308914,TRX_N-00096-495599900958,2020-08-24T17:57:34,Galdakao,Expense,transport,-160.74,36960.32
buyer_4,Jorge,50,ES66209532250731308914,TRX_N-00097-668183287874,2020-09-01T18:38:49,Galdakao,transfer,Salary,2836.23,39796.55
buyer_4,Jorge,50,ES66209532250731308914,TRX_N-00098-75504950828,2020-09-01T18:38:49,Galdakao,transfer,Partner Salary,2836.62,42633.17
buyer_4,Jorge,50,ES66209532250731308914,TRX_N-00099-306224811111,2020-09-01T18:38:49,Galdakao,transfer,Extra Income,283.62,42916.79
buyer_4,Jorge,50,ES66209532250731308914,TRX_N-00100-771034569739,2020-09-05T10:28:40,Galdakao,Housing,Mortgage,-893.54,42023.25
buyer_4,Jorge,50,ES66209532250731308914,TRX_N-00101-423560939929,2020-09-05T16:04:07,Galdakao,Basic services,electricity,-65.63,41957.62
buyer_4,Jorge,50,ES66209532250731308914,TRX_N-00102-630078815770,2020-09-05T12:48:02,Galdakao,Basic services,gas,-55.69,41901.93
buyer_4,Jorge,50,ES66209532250731308914,TRX_N-00103-990782914803,2020-09-06T20:01:02,Galdakao,Basic services,internet,-52.94,41848.99
buyer_4,Jorge,50,ES66209532250731308914,TRX_N-00104-237954477159,2020-09-06T17:12:15,Galdakao,Basic services,phone,-22.84,41826.15
buyer_4,Jorge,50,ES66209532250731308914,TRX_N-00105-173165451175,2020-09-06T10:46:55,Galdakao,Expense,leisure,-195.19,41630.96
buyer_4,Jorge,50,ES66209532250731308914,TRX_N-00106-965685098114,2020-09-07T20:26:12,Galdakao,Basic services,water,-46.9,41584.06
buyer_4,Jorge,50,ES66209532250731308914,TRX_N-00107-580925488276,2020-09-07T12:56:53,Galdakao,Basic services,gas,-71.86,41512.2
buyer_4,Jorge,50,ES66209532250731308914,TRX_N-00108-28987299772,2020-09-07T09:37:52,Galdakao,Basic services,phone,-50.49,41461.71
buyer_4,Jorge,50,ES66209532250731308914,TRX_N-00109-183794470037,2020-09-09T10:44:45,Galdakao,Expense,education,-589.7,40872.01
buyer_4,Jorge,50,ES66209532250731308914,TRX_N-00110-921737095961,2020-09-14T15:18:59,Galdakao,Expense,food,-301.21,40570.8
buyer_4,Jorge,50,ES66209532250731308914,TRX_N-00111-179412452964,2020-09-14T02:47:29,Galdakao,Expense,clothing,-271.73,40299.07
buyer_4,Jorge,50,ES66209532250731308914,TRX_N-00112-876348020693,2020-10-01T17:13:04,Galdakao,transfer,Salary,2836.23,43135.3
buyer_4,Jorge,50,ES66209532250731308914,TRX_N-00113-771245952065,2020-10-01T17:13:04,Galdakao,transfer,Partner Salary,2836.62,45971.92
buyer_4,Jorge,50,ES66209532250731308914,TRX_N-00114-287891116715,2020-10-05T12:26:27,Galdakao,Housing,Mortgage,-893.54,45078.38
buyer_4,Jorge,50,ES66209532250731308914,TRX_N-00115-934000878344,2020-10-05T17:37:42,Galdakao,Basic services,water,-65.92,45012.46
buyer_4,Jorge,50,ES66209532250731308914,TRX_N-00116-882332022738,2020-10-05T11:03:20,Galdakao,Basic services,electricity,-32.9,44979.56
buyer_4,Jorge,50,ES66209532250731308914,TRX_N-00117-192714476456,2020-10-05T12:13:43,Galdakao,Basic services,internet,-43.19,44936.37
buyer_4,Jorge,50,ES66209532250731308914,TRX_N-00118-382083052835,2020-10-05T18:11:54,Galdakao,Basic services,phone,-46.28,44890.09
buyer_4,Jorge,50,ES66209532250731308914,TRX_N-00119-423551714951,2020-10-06T20:36:56,Galdakao,Basic services,internet,-75.49,44814.6
buyer_4,Jorge,50,ES66209532250731308914,TRX_N-00120-973659062278,2020-10-06T14:07:20,Galdakao,Basic services,phone,-78.38,44736.22
buyer_4,Jorge,50,ES66209532250731308914,TRX_N-00121-391755336857,2020-10-14T18:33:00,Galdakao,Expense,transport,-196.77,44539.45
buyer_4,Jorge,50,ES66209532250731308914,TRX_N-00122-274984424442,2020-10-27T10:55:25,Galdakao,Expense,transport,-56.98,44482.47
buyer_4,Jorge,50,ES66209532250731308914,TRX_N-00123-724923099635,2020-11-01T19:05:13,Galdakao,transfer,Salary,2836.23,47318.7
buyer_4,Jorge,50,ES66209532250731308914,TRX_N-00124-91022753209,2020-11-01T19:05:13,Galdakao,transfer,Partner Salary,2836.62,50155.32
buyer_4,Jorge,50,ES66209532250731308914,TRX_N-00125-909665846884,2020-11-01T19:05:13,Galdakao,transfer,Extra Income,283.62,50438.94
buyer_4,Jorge,50,ES66209532250731308914,TRX_N-00126-875924418840,2020-11-05T16:30:23,Galdakao,Housing,Mortgage,-893.54,49545.4
buyer_4,Jorge,50,ES66209532250731308914,TRX_N-00127-739573922697,2020-11-05T12:42:28,Galdakao,Basic services,water,-60.25,49485.15
buyer_4,Jorge,50,ES66209532250731308914,TRX_N-00128-1059350959,2020-11-06T15:58:18,Galdakao,Basic services,phone,-29.87,49455.28
buyer_4,Jorge,50,ES66209532250731308914,TRX_N-00129-591601484324,2020-11-07T08:49:18,Galdakao,Basic services,water,-21.35,49433.93
buyer_4,Jorge,50,ES66209532250731308914,TRX_N-00130-625859126190,2020-11-18T23:50:09,Galdakao,Expense,healthcare,-72.82,49361.11
buyer_4,Jorge,50,ES66209532250731308914,TRX_N-00131-353360112107,2020-11-25T06:57:16,Sopela,Expense,education,-796.16,48564.95
buyer_4,Jorge,50,ES66209532250731308914,TRX_N-00132-314700789515,2020-12-01T16:03:43,Galdakao,transfer,Salary,2836.23,51401.18
buyer_4,Jorge,50,ES66209532250731308914,TRX_N-00133-638909100829,2020-12-01T16:03:43,Galdakao,transfer,Partner Salary,2836.62,54237.8
buyer_4,Jorge,50,ES66209532250731308914,TRX_N-00134-884023746160,2020-12-01T16:03:43,Galdakao,transfer,Bonus,2946.89,57184.69
buyer_4,Jorge,50,ES66209532250731308914,TRX_N-00135-8675572304,2020-12-01T11:08:55,Galdakao,Expense,food,-180.53,57004.16
buyer_4,Jorge,50,ES66209532250731308914,TRX_N-00136-699217617143,2020-12-05T13:39:00,Galdakao,Housing,Mortgage,-893.54,56110.62
buyer_4,Jorge,50,ES66209532250731308914,TRX_N-00137-944192055151,2020-12-05T09:41:10,Galdakao,Basic services,water,-13.65,56096.97
buyer_4,Jorge,50,ES66209532250731308914,TRX_N-00138-165283092732,2020-12-06T15:07:41,Galdakao,Basic services,water,-68.01,56028.96
buyer_4,Jorge,50,ES66209532250731308914,TRX_N-00139-47403360476,2020-12-06T11:22:33,Galdakao,Basic services,gas,-68.43,55960.53
buyer_4,Jorge,50,ES66209532250731308914,TRX_N-00140-157061590729,2020-12-06T22:02:49,Galdakao,Basic services,internet,-77.4,55883.13
buyer_4,Jorge,50,ES66209532250731308914,TRX_N-00141-960859245326,2020-12-06T16:22:32,Galdakao,Basic services,phone,-83.54,55799.59
buyer_4,Jorge,50,ES66209532250731308914,TRX_N-00142-30468847692,2020-12-07T10:23:55,Galdakao,Basic services,electricity,-110.0,55689.59
buyer_4,Jorge,50,ES66209532250731308914,TRX_N-00143-739316450861,2020-12-07T17:04:26,Galdakao,Basic services,gas,-31.33,55658.26
buyer_4,Jorge,50,ES66209532250731308914,TRX_N-00144-344108858486,2020-12-07T18:28:27,Galdakao,Basic services,phone,-27.5,55630.76
buyer_4,Jorge,50,ES66209532250731308914,TRX_N-00145-943388598893,2020-12-09T13:02:55,Galdakao,Expense,transport,-125.29,55505.47
buyer_4,Jorge,50,ES66209532250731308914,TRX_N-00146-366989195926,2020-12-15T17:51:55,Galdakao,Expense,transport,-170.58,55334.89
buyer_4,Jorge,50,ES66209532250731308914,TRX_N-00147-256711396983,2020-12-30T12:11:37,Galdakao,Expense,leisure,-146.83,55188.06
buyer_4,Jorge,50,ES66209532250731308914,TRX_N-00148-557792605638,2021-01-01T09:06:27,Galdakao,transfer,Salary,2836.23,58024.29
buyer_4,Jorge,50,ES66209532250731308914,TRX_N-00149-590747905263,2021-01-01T09:06:27,Galdakao,transfer,Partner Salary,2836.62,60860.91
buyer_4,Jorge,50,ES66209532250731308914,TRX_N-00150-895892064640,2021-01-05T00:40:51,Galdakao,Housing,Mortgage,-893.54,59967.37
buyer_4,Jorge,50,ES66209532250731308914,TRX_N-00151-335598901767,2021-01-05T11:04:57,Galdakao,Basic services,phone,-99.15,59868.22
buyer_4,Jorge,50,ES66209532250731308914,TRX_N-00152-382529831480,2021-01-06T19:55:08,Galdakao,Basic services,water,-54.46,59813.76
buyer_4,Jorge,50,ES66209532250731308914,TRX_N-00153-98730967913,2021-01-07T10:19:35,Galdakao,Basic services,phone,-59.33,59754.43
buyer_4,Jorge,50,ES66209532250731308914,TRX_N-00154-631466415806,2021-01-13T20:52:18,Galdakao,Expense,leisure,-114.9,59639.53
buyer_4,Jorge,50,ES66209532250731308914,TRX_N-00155-711223690212,2021-01-15T15:34:41,Donostia,Expense,education,-722.24,58917.29
buyer_4,Jorge,50,ES66209532250731308914,TRX_N-00156-35812611726,2021-01-24T17:02:09,Galdakao,Expense,food,-260.47,58656.82
buyer_4,Jorge,50,ES66209532250731308914,TRX_N-00157-200848468573,2021-01-24T16:17:28,Galdakao,Expense,leisure,-44.39,58612.43
buyer_4,Jorge,50,ES66209532250731308914,TRX_N-00158-338842391348,2021-01-26T11:18:41,Galdakao,Expense,food,-564.87,58047.56
buyer_4,Jorge,50,ES66209532250731308914,TRX_N-00159-187258115806,2021-02-01T07:28:01,Galdakao,transfer,Salary,2836.23,60883.79
buyer_4,Jorge,50,ES66209532250731308914,TRX_N-00160-548461614531,2021-02-01T07:28:01,Galdakao,transfer,Partner Salary,2836.62,63720.41
buyer_4,Jorge,50,ES66209532250731308914,TRX_N-00161-244138406879,2021-02-01T07:28:01,Galdakao,transfer,Extra Income,283.62,64004.03
buyer_4,Jorge,50,ES66209532250731308914,TRX_N-00162-408883449378,2021-02-05T13:27:36,Galdakao,Housing,Mortgage,-893.54,63110.49
buyer_4,Jorge,50,ES66209532250731308914,TRX_N-00163-585445468749,2021-02-05T09:40:57,Galdakao,Basic services,water,-20.79,63089.7
buyer_4,Jorge,50,ES66209532250731308914,TRX_N-00164-621055857437,2021-02-05T13:13:53,Galdakao,Basic services,electricity,-103.52,62986.18
buyer_4,Jorge,50,ES66209532250731308914,TRX_N-00165-198088718307,2021-02-05T18:48:00,Galdakao,Basic services,gas,-37.72,62948.46
buyer_4,Jorge,50,ES66209532250731308914,TRX_N-00166-224419686444,2021-02-05T20:43:27,Galdakao,Basic services,internet,-34.97,62913.49
buyer_4,Jorge,50,ES66209532250731308914,TRX_N-00167-551319232470,2021-02-06T14:38:43,Galdakao,Basic services,electricity,-148.16,62765.33
buyer_4,Jorge,50,ES66209532250731308914,TRX_N-00168-50514924988,2021-02-06T18:53:13,Galdakao,Basic services,gas,-83.62,62681.71
buyer_4,Jorge,50,ES66209532250731308914,TRX_N-00169-380280012915,2021-02-07T12:54:59,Galdakao,Basic services,gas,-29.06,62652.65
buyer_4,Jorge,50,ES66209532250731308914,TRX_N-00170-507330717915,2021-02-07T09:12:27,Galdakao,Basic services,internet,-74.16,62578.49
buyer_4,Jorge,50,ES66209532250731308914,TRX_N-00171-448510850508,2021-02-07T14:07:30,Galdakao,Basic services,phone,-30.48,62548.01
buyer_4,Jorge,50,ES66209532250731308914,TRX_N-00172-56049846230,2021-02-11T19:52:36,Galdakao,Expense,food,-221.54,62326.47
buyer_4,Jorge,50,ES66209532250731308914,TRX_N-00173-399957496409,2021-02-18T20:17:52,Galdakao,Expense,transport,-96.11,62230.36
buyer_4,Jorge,50,ES66209532250731308914,TRX_N-00174-825373634041,2021-02-27T13:59:50,Amurrio,Expense,healthcare,-105.4,62124.96
buyer_4,Jorge,50,ES66209532250731308914,TRX_N-00175-943904775905,2021-03-01T08:08:03,Galdakao,transfer,Salary,2836.23,64961.19
buyer_4,Jorge,50,ES66209532250731308914,TRX_N-00176-919312431227,2021-03-01T08:08:03,Galdakao,transfer,Partner Salary,2836.62,67797.81
buyer_4,Jorge,50,ES66209532250731308914,TRX_N-00177-378113628009,2021-03-05T18:16:42,Galdakao,Housing,Mortgage,-893.54,66904.27
buyer_4,Jorge,50,ES66209532250731308914,TRX_N-00178-529747267180,2021-03-05T12:24:24,Galdakao,Basic services,gas,-67.24,66837.03
buyer_4,Jorge,50,ES66209532250731308914,TRX_N-00179-807830419002,2021-03-05T08:30:39,Galdakao,Basic services,internet,-56.47,66780.56
buyer_4,Jorge,50,ES66209532250731308914,TRX_N-00180-172588208100,2021-03-05T13:54:17,Galdakao,Basic services,phone,-39.32,66741.24
buyer_4,Jorge,50,ES66209532250731308914,TRX_N-00181-789104734139,2021-03-06T17:33:31,Galdakao,Basic services,electricity,-40.68,66700.56
buyer_4,Jorge,50,ES66209532250731308914,TRX_N-00182-543696702277,2021-03-06T17:19:00,Galdakao,Basic services,internet,-79.58,66620.98
buyer_4,Jorge,50,ES66209532250731308914,TRX_N-00183-190678932163,2021-03-07T08:03:10,Galdakao,Basic services,water,-40.01,66580.97
buyer_4,Jorge,50,ES66209532250731308914,TRX_N-00184-797257200092,2021-03-07T16:05:37,Galdakao,Basic services,gas,-99.73,66481.24
buyer_4,Jorge,50,ES66209532250731308914,TRX_N-00185-962934136172,2021-03-31T10:47:57,Galdakao,Expense,food,-710.1,65771.14
buyer_4,Jorge,50,ES66209532250731308914,TRX_N-00186-535720945470,2021-03-31T11:04:17,Galdakao,Expense,transport,-101.99,65669.15
buyer_4,Jorge,50,ES66209532250731308914,TRX_N-00187-38889088095,2021-04-01T17:17:47,Galdakao,transfer,Salary,2836.23,68505.38
buyer_4,Jorge,50,ES66209532250731308914,TRX_N-00188-647550723555,2021-04-01T17:17:47,Galdakao,transfer,Partner Salary,2836.62,71342.0
buyer_4,Jorge,50,ES66209532250731308914,TRX_N-00189-211221387707,2021-04-05T08:25:36,Galdakao,Housing,Mortgage,-893.54,70448.46
buyer_4,Jorge,50,ES66209532250731308914,TRX_N-00190-740920513322,2021-04-05T15:27:25,Galdakao,Basic services,electricity,-117.5,70330.96
buyer_4,Jorge,50,ES66209532250731308914,TRX_N-00191-676960316052,2021-04-05T11:15:20,Galdakao,Basic services,gas,-63.1,70267.86
buyer_4,Jorge,50,ES66209532250731308914,TRX_N-00192-492967358998,2021-04-06T15:55:17,Galdakao,Basic services,water,-54.27,70213.59
buyer_4,Jorge,50,ES66209532250731308914,TRX_N-00193-785331155459,2021-04-07T21:18:22,Galdakao,Basic services,water,-47.74,70165.85
buyer_4,Jorge,50,ES66209532250731308914,TRX_N-00194-658415704144,2021-04-11T08:04:46,Galdakao,Expense,transport,-74.46,70091.39
buyer_4,Jorge,50,ES66209532250731308914,TRX_N-00195-736724502592,2021-04-13T09:19:55,Galdakao,Expense,food,-748.14,69343.25
buyer_4,Jorge,50,ES66209532250731308914,TRX_N-00196-619812087000,2021-04-17T19:21:31,Galdakao,Expense,clothing,-343.56,68999.69
buyer_4,Jorge,50,ES66209532250731308914,TRX_N-00197-301184389198,2021-05-01T09:21:26,Galdakao,transfer,Salary,2836.23,71835.92
buyer_4,Jorge,50,ES66209532250731308914,TRX_N-00198-813930768630,2021-05-01T09:21:26,Galdakao,transfer,Partner Salary,2836.62,74672.54
buyer_4,Jorge,50,ES66209532250731308914,TRX_N-00199-317241144467,2021-05-01T09:21:26,Galdakao,transfer,Extra Income,283.62,74956.16
buyer_4,Jorge,50,ES66209532250731308914,TRX_N-00200-897161018005,2021-05-04T13:51:04,Galdakao,Expense,healthcare,-191.07,74765.09
buyer_4,Jorge,50,ES66209532250731308914,TRX_N-00201-11231435906,2021-05-05T02:22:38,Galdakao,Housing,Mortgage,-893.54,73871.55
buyer_4,Jorge,50,ES66209532250731308914,TRX_N-00202-994279354531,2021-05-05T12:21:54,Galdakao,Basic services,electricity,-128.64,73742.91
buyer_4,Jorge,50,ES66209532250731308914,TRX_N-00203-161434751931,2021-05-06T17:04:47,Galdakao,Expense,transport,-117.08,73625.83
buyer_4,Jorge,50,ES66209532250731308914,TRX_N-00204-718417102043,2021-05-07T15:09:35,Galdakao,Basic services,internet,-44.21,73581.62
buyer_4,Jorge,50,ES66209532250731308914,TRX_N-00205-131205341809,2021-05-26T11:48:57,Galdakao,Expense,travel,-2450.31,71131.31
buyer_4,Jorge,50,ES66209532250731308914,TRX_N-00206-85858270470,2021-05-29T11:42:41,Galdakao,Expense,healthcare,-280.68,70850.63
buyer_4,Jorge,50,ES66209532250731308914,TRX_N-00207-835069946263,2021-06-01T19:38:20,Galdakao,transfer,Salary,2836.23,73686.86
buyer_4,Jorge,50,ES66209532250731308914,TRX_N-00208-421268219140,2021-06-01T19:38:20,Galdakao,transfer,Partner Salary,2836.62,76523.48
buyer_4,Jorge,50,ES66209532250731308914,TRX_N-00209-759511245051,2021-06-01T19:38:20,Galdakao,transfer,Bonus,2710.32,79233.8
buyer_4,Jorge,50,ES66209532250731308914,TRX_N-00210-520852387059,2021-06-05T15:05:16,Galdakao,Housing,Mortgage,-893.54,78340.26
buyer_4,Jorge,50,ES66209532250731308914,TRX_N-00211-477891054601,2021-06-05T20:11:51,Galdakao,Basic services,electricity,-43.45,78296.81
buyer_4,Jorge,50,ES66209532250731308914,TRX_N-00212-363451154859,2021-06-06T10:02:29,Iruña de Oca,Expense,transport,-189.33,78107.48
buyer_4,Jorge,50,ES66209532250731308914,TRX_N-00213-105391009446,2021-06-22T14:19:58,Galdakao,Expense,food,-525.57,77581.91
buyer_4,Jorge,50,ES66209532250731308914,TRX_N-00214-630781976717,2021-07-01T09:38:34,Galdakao,transfer,Salary,2836.23,80418.14
buyer_4,Jorge,50,ES66209532250731308914,TRX_N-00215-384323333939,2021-07-01T09:38:34,Galdakao,transfer,Partner Salary,2836.62,83254.76
buyer_4,Jorge,50,ES66209532250731308914,TRX_N-00216-683556965397,2021-07-05T09:51:56,Galdakao,Housing,Mortgage,-893.54,82361.22
buyer_4,Jorge,50,ES66209532250731308914,TRX_N-00217-743659601358,2021-07-05T18:15:46,Galdakao,Basic services,electricity,-89.92,82271.3
buyer_4,Jorge,50,ES66209532250731308914,TRX_N-00218-739503477079,2021-07-06T10:34:07,Galdakao,Basic services,water,-49.92,82221.38
buyer_4,Jorge,50,ES66209532250731308914,TRX_N-00219-212530113665,2021-07-06T12:57:48,Galdakao,Basic services,electricity,-63.09,82158.29
buyer_4,Jorge,50,ES66209532250731308914,TRX_N-00220-578244918631,2021-07-06T23:30:53,Galdakao,Basic services,phone,-33.71,82124.58
buyer_4,Jorge,50,ES66209532250731308914,TRX_N-00221-372292412892,2021-07-07T10:34:27,Galdakao,Basic services,electricity,-126.6,81997.98
buyer_4,Jorge,50,ES66209532250731308914,TRX_N-00222-467196027718,2021-07-07T06:04:16,Galdakao,Basic services,internet,-58.47,81939.51
buyer_4,Jorge,50,ES66209532250731308914,TRX_N-00223-878576456335,2021-07-07T18:06:54,Galdakao,Basic services,phone,-49.49,81890.02
buyer_4,Jorge,50,ES66209532250731308914,TRX_N-00224-826513932852,2021-08-01T08:05:00,Galdakao,transfer,Salary,2836.23,84726.25
buyer_4,Jorge,50,ES66209532250731308914,TRX_N-00225-915978471699,2021-08-01T08:05:00,Galdakao,transfer,Partner Salary,2836.62,87562.87
buyer_4,Jorge,50,ES66209532250731308914,TRX_N-00226-844252066483,2021-08-01T08:05:00,Galdakao,transfer,Extra Income,283.62,87846.49
buyer_4,Jorge,50,ES66209532250731308914,TRX_N-00227-440258575385,2021-08-05T10:10:54,Galdakao,Housing,Mortgage,-893.54,86952.95
buyer_4,Jorge,50,ES66209532250731308914,TRX_N-00228-294759342248,2021-08-05T17:37:10,Galdakao,Basic services,electricity,-95.98,86856.97
buyer_4,Jorge,50,ES66209532250731308914,TRX_N-00229-880368183742,2021-08-06T20:25:14,Galdakao,Basic services,gas,-25.47,86831.5
buyer_4,Jorge,50,ES66209532250731308914,TRX_N-00230-480017854362,2021-08-06T13:59:50,Galdakao,Basic services,phone,-42.55,86788.95
buyer_4,Jorge,50,ES66209532250731308914,TRX_N-00231-732513784686,2021-08-07T22:54:36,Galdakao,Basic services,gas,-15.24,86773.71
buyer_4,Jorge,50,ES66209532250731308914,TRX_N-00232-353755134801,2021-08-15T15:25:09,Portugalete,Expense,food,-461.72,86311.99
buyer_4,Jorge,50,ES66209532250731308914,TRX_N-00233-894564727330,2021-08-17T08:43:13,Donostia,Expense,food,-786.22,85525.77
buyer_4,Jorge,50,ES66209532250731308914,TRX_N-00234-538252670884,2021-08-24T14:48:30,Galdakao,Expense,clothing,-416.63,85109.14
buyer_4,Jorge,50,ES66209532250731308914,TRX_N-00235-887193455978,2021-09-01T10:00:51,Galdakao,transfer,Salary,2836.23,87945.37
buyer_4,Jorge,50,ES66209532250731308914,TRX_N-00236-10890301547,2021-09-01T10:00:51,Galdakao,transfer,Partner Salary,2836.62,90781.99
buyer_4,Jorge,50,ES66209532250731308914,TRX_N-00237-390051944989,2021-09-05T16:14:47,Galdakao,Housing,Mortgage,-893.54,89888.45
buyer_4,Jorge,50,ES66209532250731308914,TRX_N-00238-281439758582,2021-09-06T17:15:10,Galdakao,Basic services,water,-29.57,89858.88
buyer_4,Jorge,50,ES66209532250731308914,TRX_N-00239-779633497433,2021-09-06T18:51:22,Galdakao,Basic services,electricity,-130.18,89728.7
buyer_4,Jorge,50,ES66209532250731308914,TRX_N-00240-859370748993,2021-09-07T19:03:50,Lasarte-Oria,Expense,healthcare,-183.01,89545.69
buyer_4,Jorge,50,ES66209532250731308914,TRX_N-00241-444035059959,2021-09-08T10:28:40,Barakaldo,Expense,transport,-105.09,89440.6
buyer_4,Jorge,50,ES66209532250731308914,TRX_N-00242-980459089764,2021-09-14T19:57:19,Errenteria,Expense,appliances,-1140.5,88300.1
buyer_4,Jorge,50,ES66209532250731308914,TRX_N-00243-507148150218,2021-09-23T10:47:42,Galdakao,Expense,food,-170.52,88129.58
buyer_4,Jorge,50,ES66209532250731308914,TRX_N-00244-451732595910,2021-09-24T15:52:17,Galdakao,Expense,food,-409.44,87720.14
buyer_4,Jorge,50,ES66209532250731308914,TRX_N-00245-249913684781,2021-09-30T17:35:10,Galdakao,Expense,healthcare,-303.12,87417.02
buyer_4,Jorge,50,ES66209532250731308914,TRX_N-00246-616023696910,2021-10-01T15:05:08,Galdakao,transfer,Salary,2836.23,90253.25
buyer_4,Jorge,50,ES66209532250731308914,TRX_N-00247-106739237269,2021-10-01T15:05:08,Galdakao,transfer,Partner Salary,2836.62,93089.87
buyer_4,Jorge,50,ES66209532250731308914,TRX_N-00248-90229431748,2021-10-01T15:05:08,Galdakao,transfer,Extra Income,283.62,93373.49
buyer_4,Jorge,50,ES66209532250731308914,TRX_N-00249-734270580263,2021-10-05T09:41:38,Galdakao,Housing,Mortgage,-893.54,92479.95
buyer_4,Jorge,50,ES66209532250731308914,TRX_N-00250-883579823077,2021-10-06T09:15:41,Galdakao,Basic services,gas,-50.49,92429.46
buyer_4,Jorge,50,ES66209532250731308914,TRX_N-00251-843537491315,2021-10-06T08:34:48,Galdakao,Basic services,internet,-58.04,92371.42
buyer_4,Jorge,50,ES66209532250731308914,TRX_N-00252-425392899395,2021-10-07T20:19:24,Galdakao,Basic services,water,-63.1,92308.32
buyer_4,Jorge,50,ES66209532250731308914,TRX_N-00253-258082652231,2021-10-07T14:24:50,Galdakao,Expense,clothing,-30.63,92277.69
buyer_4,Jorge,50,ES66209532250731308914,TRX_N-00254-22193487261,2021-10-09T16:48:29,Galdakao,Expense,leisure,-24.31,92253.38
buyer_4,Jorge,50,ES66209532250731308914,TRX_N-00255-96534204685,2021-10-12T09:28:46,Galdakao,Expense,food,-479.99,91773.39
buyer_4,Jorge,50,ES66209532250731308914,TRX_N-00256-959738656540,2021-10-19T09:45:52,Galdakao,Expense,gifts,-396.15,91377.24
buyer_4,Jorge,50,ES66209532250731308914,TRX_N-00257-505049932059,2021-10-30T14:56:06,Galdakao,Expense,food,-486.9,90890.34
buyer_4,Jorge,50,ES66209532250731308914,TRX_N-00258-123266643291,2021-11-01T20:45:41,Galdakao,transfer,Salary,2836.23,93726.57
buyer_4,Jorge,50,ES66209532250731308914,TRX_N-00259-897550467039,2021-11-01T20:45:41,Galdakao,transfer,Partner Salary,2836.62,96563.19
buyer_4,Jorge,50,ES66209532250731308914,TRX_N-00260-296288638017,2021-11-05T19:27:35,Galdakao,Housing,Mortgage,-893.54,95669.65
buyer_4,Jorge,50,ES66209532250731308914,TRX_N-00261-230986270410,2021-11-05T08:15:57,Galdakao,Basic services,water,-14.81,95654.84
buyer_4,Jorge,50,ES66209532250731308914,TRX_N-00262-945881486508,2021-11-07T02:44:51,Galdakao,Basic services,electricity,-75.64,95579.2
buyer_4,Jorge,50,ES66209532250731308914,TRX_N-00263-849790810611,2021-11-08T15:02:02,Santurtzi,Expense,leisure,-92.13,95487.07
buyer_4,Jorge,50,ES66209532250731308914,TRX_N-00264-77575287427,2021-12-01T08:51:17,Galdakao,transfer,Salary,2836.23,98323.3
buyer_4,Jorge,50,ES66209532250731308914,TRX_N-00265-697612864493,2021-12-01T08:51:17,Galdakao,transfer,Partner Salary,2836.62,101159.92
buyer_4,Jorge,50,ES66209532250731308914,TRX_N-00266-789379713851,2021-12-01T08:51:17,Galdakao,transfer,Bonus,2893.77,104053.69
buyer_4,Jorge,50,ES66209532250731308914,TRX_N-00267-445721373233,2021-12-03T11:36:33,Galdakao,Expense,food,-242.31,103811.38
buyer_4,Jorge,50,ES66209532250731308914,TRX_N-00268-290011427949,2021-12-05T10:10:47,Galdakao,Housing,Mortgage,-893.54,102917.84
buyer_4,Jorge,50,ES66209532250731308914,TRX_N-00269-229179048479,2021-12-05T11:34:16,Galdakao,Basic services,water,-58.88,102858.96
buyer_4,Jorge,50,ES66209532250731308914,TRX_N-00270-291569988415,2021-12-05T10:14:17,Galdakao,Basic services,gas,-60.2,102798.76
buyer_4,Jorge,50,ES66209532250731308914,TRX_N-00271-284079288947,2021-12-06T20:02:38,Galdakao,Basic services,electricity,-44.88,102753.88
buyer_4,Jorge,50,ES66209532250731308914,TRX_N-00272-276421905176,2021-12-06T15:31:51,Galdakao,Expense,repairs,-756.78,101997.1
buyer_4,Jorge,50,ES66209532250731308914,TRX_N-00273-229135468327,2021-12-07T22:57:43,Galdakao,Basic services,electricity,-84.52,101912.58
buyer_4,Jorge,50,ES66209532250731308914,TRX_N-00274-31487510172,2021-12-07T12:27:10,Galdakao,Basic services,gas,-33.08,101879.5
buyer_4,Jorge,50,ES66209532250731308914,TRX_N-00275-357246327286,2021-12-17T14:27:49,Zuia,Expense,food,-207.3,101672.2
buyer_4,Jorge,50,ES66209532250731308914,TRX_N-00276-398064220891,2022-01-01T15:06:48,Galdakao,transfer,Salary,2836.23,104508.43
buyer_4,Jorge,50,ES66209532250731308914,TRX_N-00277-495704278946,2022-01-01T15:06:48,Galdakao,transfer,Partner Salary,2836.62,107345.05
buyer_4,Jorge,50,ES66209532250731308914,TRX_N-00278-73709195314,2022-01-01T15:06:48,Galdakao,transfer,Extra Income,283.62,107628.67
buyer_4,Jorge,50,ES66209532250731308914,TRX_N-00279-784241987961,2022-01-05T19:32:23,Galdakao,Housing,Mortgage,-893.54,106735.13
buyer_4,Jorge,50,ES66209532250731308914,TRX_N-00280-931741337391,2022-01-05T17:50:40,Galdakao,Basic services,water,-47.63,106687.5
buyer_4,Jorge,50,ES66209532250731308914,TRX_N-00281-285342808967,2022-01-05T18:54:37,Galdakao,Basic services,phone,-26.0,106661.5
buyer_4,Jorge,50,ES66209532250731308914,TRX_N-00282-733425757320,2022-01-07T16:39:17,Galdakao,Basic services,electricity,-118.07,106543.43
buyer_4,Jorge,50,ES66209532250731308914,TRX_N-00283-813353986712,2022-01-07T18:02:10,Galdakao,Basic services,phone,-43.42,106500.01
buyer_4,Jorge,50,ES66209532250731308914,TRX_N-00284-748925360687,2022-01-16T23:31:15,Galdakao,Expense,leisure,-122.26,106377.75
buyer_4,Jorge,50,ES66209532250731308914,TRX_N-00285-89167646376,2022-01-19T15:17:40,Hondarribia,Expense,gifts,-384.17,105993.58
buyer_4,Jorge,50,ES66209532250731308914,TRX_N-00286-832728589268,2022-02-01T13:45:33,Galdakao,transfer,Salary,2836.23,108829.81
buyer_4,Jorge,50,ES66209532250731308914,TRX_N-00287-155693860510,2022-02-01T13:45:33,Galdakao,transfer,Partner Salary,2836.62,111666.43
buyer_4,Jorge,50,ES66209532250731308914,TRX_N-00288-371005692081,2022-02-05T20:34:30,Galdakao,Housing,Mortgage,-893.54,110772.89
buyer_4,Jorge,50,ES66209532250731308914,TRX_N-00289-752948851052,2022-02-05T18:38:20,Galdakao,Basic services,electricity,-131.77,110641.12
buyer_4,Jorge,50,ES66209532250731308914,TRX_N-00290-897807633770,2022-02-05T18:49:16,Galdakao,Basic services,gas,-59.4,110581.72
buyer_4,Jorge,50,ES66209532250731308914,TRX_N-00291-255738806177,2022-02-05T08:09:10,Galdakao,Basic services,internet,-68.5,110513.22
buyer_4,Jorge,50,ES66209532250731308914,TRX_N-00292-711225032738,2022-02-06T12:08:17,Galdakao,Basic services,electricity,-131.14,110382.08
buyer_4,Jorge,50,ES66209532250731308914,TRX_N-00293-107781211233,2022-02-06T09:49:04,Galdakao,Basic services,internet,-46.21,110335.87
buyer_4,Jorge,50,ES66209532250731308914,TRX_N-00294-210269349099,2022-02-07T11:28:19,Galdakao,Basic services,gas,-36.7,110299.17
buyer_4,Jorge,50,ES66209532250731308914,TRX_N-00295-434527330644,2022-02-07T12:27:24,Galdakao,Basic services,internet,-56.39,110242.78
buyer_4,Jorge,50,ES66209532250731308914,TRX_N-00296-137615652183,2022-02-11T10:37:42,Getxo,Expense,food,-206.94,110035.84
buyer_4,Jorge,50,ES66209532250731308914,TRX_N-00297-499621457381,2022-02-13T09:12:39,Arrasate/Mondragon,Expense,transport,-24.95,110010.89
buyer_4,Jorge,50,ES66209532250731308914,TRX_N-00298-654500950617,2022-03-01T17:04:10,Galdakao,transfer,Salary,2836.23,112847.12
buyer_4,Jorge,50,ES66209532250731308914,TRX_N-00299-827353578321,2022-03-01T17:04:10,Galdakao,transfer,Partner Salary,2836.62,115683.74
buyer_4,Jorge,50,ES66209532250731308914,TRX_N-00300-840769441677,2022-03-01T17:04:10,Galdakao,transfer,Extra Income,283.62,115967.36
buyer_4,Jorge,50,ES66209532250731308914,TRX_N-00301-811520537651,2022-03-01T15:18:52,Galdakao,Expense,food,-737.35,115230.01
buyer_4,Jorge,50,ES66209532250731308914,TRX_N-00302-812907719223,2022-03-05T19:26:50,Galdakao,Housing,Mortgage,-893.54,114336.47
buyer_4,Jorge,50,ES66209532250731308914,TRX_N-00303-673045052253,2022-03-05T16:58:09,Galdakao,Basic services,water,-54.26,114282.21
buyer_4,Jorge,50,ES66209532250731308914,TRX_N-00304-240429028319,2022-03-06T16:56:34,Galdakao,Basic services,water,-44.91,114237.3
buyer_4,Jorge,50,ES66209532250731308914,TRX_N-00305-305674286182,2022-03-06T19:13:18,Galdakao,Basic services,electricity,-73.26,114164.04
buyer_4,Jorge,50,ES66209532250731308914,TRX_N-00306-381285285178,2022-03-06T09:10:17,Galdakao,Basic services,internet,-33.79,114130.25
buyer_4,Jorge,50,ES66209532250731308914,TRX_N-00307-689778634769,2022-03-06T09:32:25,Galdakao,Basic services,phone,-66.19,114064.06
buyer_4,Jorge,50,ES66209532250731308914,TRX_N-00308-136482171881,2022-03-06T11:28:34,Galdakao,Expense,healthcare,-163.84,113900.22
buyer_4,Jorge,50,ES66209532250731308914,TRX_N-00309-641819291201,2022-03-07T15:00:07,Galdakao,Basic services,phone,-43.25,113856.97
buyer_4,Jorge,50,ES66209532250731308914,TRX_N-00310-474148918799,2022-03-24T10:10:47,Galdakao,Expense,leisure,-121.75,113735.22
buyer_4,Jorge,50,ES66209532250731308914,TRX_N-00311-217968816209,2022-03-24T11:25:18,Galdakao,Expense,clothing,-264.01,113471.21
buyer_4,Jorge,50,ES66209532250731308914,TRX_N-00312-744301312811,2022-03-28T13:12:20,Andoain,Expense,healthcare,-210.71,113260.5
buyer_4,Jorge,50,ES66209532250731308914,TRX_N-00313-732161274972,2022-04-01T11:06:02,Galdakao,transfer,Salary,2836.23,116096.73
buyer_4,Jorge,50,ES66209532250731308914,TRX_N-00314-665306128722,2022-04-01T11:06:02,Galdakao,transfer,Partner Salary,2836.62,118933.35
buyer_4,Jorge,50,ES66209532250731308914,TRX_N-00315-154268227451,2022-04-05T11:46:19,Galdakao,Housing,Mortgage,-893.54,118039.81
buyer_4,Jorge,50,ES66209532250731308914,TRX_N-00316-612510331405,2022-04-05T20:44:20,Galdakao,Basic services,water,-34.2,118005.61
buyer_4,Jorge,50,ES66209532250731308914,TRX_N-00317-888103446662,2022-04-05T20:19:27,Galdakao,Basic services,gas,-88.25,117917.36
buyer_4,Jorge,50,ES66209532250731308914,TRX_N-00318-547514111013,2022-04-06T19:29:19,Galdakao,Basic services,water,-20.68,117896.68
buyer_4,Jorge,50,ES66209532250731308914,TRX_N-00319-955792112325,2022-04-06T13:45:24,Galdakao,Basic services,electricity,-72.21,117824.47
buyer_4,Jorge,50,ES66209532250731308914,TRX_N-00320-543095523023,2022-04-06T16:51:02,Galdakao,Basic services,internet,-56.89,117767.58
buyer_4,Jorge,50,ES66209532250731308914,TRX_N-00321-879730706858,2022-04-06T10:51:41,Galdakao,Basic services,phone,-96.57,117671.01
buyer_4,Jorge,50,ES66209532250731308914,TRX_N-00322-316919922770,2022-04-06T13:38:20,Galdakao,Expense,travel,-2852.41,114818.6
buyer_4,Jorge,50,ES66209532250731308914,TRX_N-00323-831648264933,2022-04-07T11:17:48,Galdakao,Basic services,water,-42.93,114775.67
buyer_4,Jorge,50,ES66209532250731308914,TRX_N-00324-350187752054,2022-04-07T14:01:55,Galdakao,Basic services,gas,-39.51,114736.16
buyer_4,Jorge,50,ES66209532250731308914,TRX_N-00325-775109211753,2022-04-16T10:20:45,Galdakao,Expense,gifts,-316.46,114419.7
buyer_4,Jorge,50,ES66209532250731308914,TRX_N-00326-795172674035,2022-04-23T16:09:52,Galdakao,Expense,food,-639.69,113780.01
buyer_4,Jorge,50,ES66209532250731308914,TRX_N-00327-46624060052,2022-04-30T16:22:48,Galdakao,Expense,appliances,-816.19,112963.82
buyer_4,Jorge,50,ES66209532250731308914,TRX_N-00328-366443061874,2022-05-01T20:21:45,Galdakao,transfer,Salary,2836.23,115800.05
buyer_4,Jorge,50,ES66209532250731308914,TRX_N-00329-668855007869,2022-05-01T20:21:45,Galdakao,transfer,Partner Salary,2836.62,118636.67
buyer_4,Jorge,50,ES66209532250731308914,TRX_N-00330-553514210597,2022-05-01T20:21:45,Galdakao,transfer,Extra Income,283.62,118920.29
buyer_4,Jorge,50,ES66209532250731308914,TRX_N-00331-731127399625,2022-05-05T20:27:26,Galdakao,Housing,Mortgage,-893.54,118026.75
buyer_4,Jorge,50,ES66209532250731308914,TRX_N-00332-358788042926,2022-05-05T13:19:32,Galdakao,Basic services,internet,-67.23,117959.52
buyer_4,Jorge,50,ES66209532250731308914,TRX_N-00333-768797043189,2022-05-06T21:00:37,Galdakao,Basic services,electricity,-98.48,117861.04
buyer_4,Jorge,50,ES66209532250731308914,TRX_N-00334-468865783047,2022-05-06T13:34:15,Galdakao,Expense,gifts,-481.93,117379.11
buyer_4,Jorge,50,ES66209532250731308914,TRX_N-00335-854662686287,2022-05-07T18:54:03,Galdakao,Basic services,electricity,-59.86,117319.25
buyer_4,Jorge,50,ES66209532250731308914,TRX_N-00336-512483801353,2022-05-07T09:03:40,Galdakao,Basic services,internet,-76.53,117242.72
buyer_4,Jorge,50,ES66209532250731308914,TRX_N-00337-182570668537,2022-05-08T16:07:44,Galdakao,Expense,leisure,-64.67,117178.05
buyer_4,Jorge,50,ES66209532250731308914,TRX_N-00338-911206990137,2022-05-09T11:24:45,Galdakao,Expense,leisure,-178.58,116999.47
buyer_4,Jorge,50,ES66209532250731308914,TRX_N-00339-528031699519,2022-05-28T04:30:24,Galdakao,Expense,food,-750.84,116248.63
buyer_4,Jorge,50,ES66209532250731308914,TRX_N-00340-174948548522,2022-06-01T17:29:52,Galdakao,transfer,Salary,2836.23,119084.86
buyer_4,Jorge,50,ES66209532250731308914,TRX_N-00341-16516452672,2022-06-01T17:29:52,Galdakao,transfer,Partner Salary,2836.62,121921.48
buyer_4,Jorge,50,ES66209532250731308914,TRX_N-00342-157030260526,2022-06-01T17:29:52,Galdakao,transfer,Bonus,2751.4,124672.88
buyer_4,Jorge,50,ES66209532250731308914,TRX_N-00343-857411836724,2022-06-05T09:47:33,Galdakao,Housing,Mortgage,-893.54,123779.34
buyer_4,Jorge,50,ES66209532250731308914,TRX_N-00344-739933201756,2022-06-05T22:41:11,Galdakao,Basic services,electricity,-76.82,123702.52
buyer_4,Jorge,50,ES66209532250731308914,TRX_N-00345-646610723198,2022-06-05T20:43:49,Galdakao,Basic services,gas,-80.94,123621.58
buyer_4,Jorge,50,ES66209532250731308914,TRX_N-00346-388047389731,2022-06-05T20:08:28,Galdakao,Expense,transport,-27.89,123593.69
buyer_4,Jorge,50,ES66209532250731308914,TRX_N-00347-10039479514,2022-06-06T12:41:56,Galdakao,Basic services,gas,-49.87,123543.82
buyer_4,Jorge,50,ES66209532250731308914,TRX_N-00348-971890228155,2022-06-06T17:05:09,Galdakao,Basic services,phone,-97.33,123446.49
buyer_4,Jorge,50,ES66209532250731308914,TRX_N-00349-957222993246,2022-06-07T16:07:01,Galdakao,Basic services,water,-56.8,123389.69
buyer_4,Jorge,50,ES66209532250731308914,TRX_N-00350-350277214568,2022-06-07T11:08:18,Galdakao,Basic services,electricity,-60.06,123329.63
buyer_4,Jorge,50,ES66209532250731308914,TRX_N-00351-299644868710,2022-06-11T18:33:06,Galdakao,Expense,clothing,-421.03,122908.6
buyer_4,Jorge,50,ES66209532250731308914,TRX_N-00352-425083636611,2022-06-21T06:42:42,Eibar,Expense,food,-483.36,122425.24
buyer_4,Jorge,50,ES66209532250731308914,TRX_N-00353-561631498066,2022-06-23T17:38:21,Llodio,Expense,leisure,-61.82,122363.42
buyer_4,Jorge,50,ES66209532250731308914,TRX_N-00354-816737356261,2022-07-01T17:52:53,Galdakao,transfer,Salary,2836.23,125199.65
buyer_4,Jorge,50,ES66209532250731308914,TRX_N-00355-189068744042,2022-07-01T17:52:53,Galdakao,transfer,Partner Salary,2836.62,128036.27
buyer_4,Jorge,50,ES66209532250731308914,TRX_N-00356-483737133499,2022-07-04T10:59:07,Galdakao,Expense,food,-468.07,127568.2
buyer_4,Jorge,50,ES66209532250731308914,TRX_N-00357-869170665822,2022-07-05T12:45:04,Galdakao,Housing,Mortgage,-893.54,126674.66
buyer_4,Jorge,50,ES66209532250731308914,TRX_N-00358-679319485861,2022-07-05T10:42:02,Galdakao,Basic services,gas,-96.2,126578.46
buyer_4,Jorge,50,ES66209532250731308914,TRX_N-00359-668294784438,2022-07-05T11:13:14,Galdakao,Expense,clothing,-493.71,126084.75
buyer_4,Jorge,50,ES66209532250731308914,TRX_N-00360-840886400660,2022-07-06T20:44:54,Galdakao,Basic services,water,-10.68,126074.07
buyer_4,Jorge,50,ES66209532250731308914,TRX_N-00361-912104126522,2022-07-06T13:28:16,Galdakao,Basic services,gas,-27.43,126046.64
buyer_4,Jorge,50,ES66209532250731308914,TRX_N-00362-192960624296,2022-07-06T10:09:26,Galdakao,Basic services,internet,-52.55,125994.09
buyer_4,Jorge,50,ES66209532250731308914,TRX_N-00363-555842363409,2022-07-07T21:46:46,Galdakao,Expense,food,-259.36,125734.73
buyer_4,Jorge,50,ES66209532250731308914,TRX_N-00364-227686541241,2022-07-13T03:19:45,Amurrio,Expense,food,-685.98,125048.75
buyer_4,Jorge,50,ES66209532250731308914,TRX_N-00365-836261778734,2022-07-19T07:14:36,Galdakao,Expense,transport,-52.39,124996.36
buyer_4,Jorge,50,ES66209532250731308914,TRX_N-00366-803157784910,2022-07-25T19:14:38,Galdakao,Expense,food,-717.02,124279.34
buyer_4,Jorge,50,ES66209532250731308914,TRX_N-00367-510699154157,2022-07-25T12:31:02,Galdakao,Expense,clothing,-68.88,124210.46
buyer_4,Jorge,50,ES66209532250731308914,TRX_N-00368-329926446432,2022-08-01T20:20:11,Galdakao,transfer,Salary,2836.23,127046.69
buyer_4,Jorge,50,ES66209532250731308914,TRX_N-00369-40581659457,2022-08-01T20:20:11,Galdakao,transfer,Partner Salary,2836.62,129883.31
buyer_4,Jorge,50,ES66209532250731308914,TRX_N-00370-284021572128,2022-08-01T20:20:11,Galdakao,transfer,Extra Income,283.62,130166.93
buyer_4,Jorge,50,ES66209532250731308914,TRX_N-00371-834248742614,2022-08-03T07:59:12,Galdakao,Expense,food,-499.98,129666.95
buyer_4,Jorge,50,ES66209532250731308914,TRX_N-00372-189418751506,2022-08-05T08:27:55,Galdakao,Housing,Mortgage,-893.54,128773.41
buyer_4,Jorge,50,ES66209532250731308914,TRX_N-00373-662395656613,2022-08-06T17:38:43,Galdakao,Basic services,water,-45.52,128727.89
buyer_4,Jorge,50,ES66209532250731308914,TRX_N-00374-92987636573,2022-08-16T14:20:59,Galdakao,Expense,food,-126.31,128601.58
buyer_4,Jorge,50,ES66209532250731308914,TRX_N-00375-149569333517,2022-08-22T18:06:36,Lasarte-Oria,Expense,travel,-931.17,127670.41
buyer_4,Jorge,50,ES66209532250731308914,TRX_N-00376-121348003582,2022-09-01T16:20:08,Galdakao,transfer,Salary,2836.23,130506.64
buyer_4,Jorge,50,ES66209532250731308914,TRX_N-00377-478938646469,2022-09-01T16:20:08,Galdakao,transfer,Partner Salary,2836.62,133343.26
buyer_4,Jorge,50,ES66209532250731308914,TRX_N-00378-26503352434,2022-09-05T18:47:01,Galdakao,Housing,Mortgage,-893.54,132449.72
buyer_4,Jorge,50,ES66209532250731308914,TRX_N-00379-840900532509,2022-09-05T08:47:44,Galdakao,Basic services,electricity,-60.8,132388.92
buyer_4,Jorge,50,ES66209532250731308914,TRX_N-00380-616435940529,2022-09-05T14:49:45,Galdakao,Basic services,phone,-70.14,132318.78
buyer_4,Jorge,50,ES66209532250731308914,TRX_N-00381-214263650218,2022-09-06T18:24:17,Galdakao,Basic services,water,-25.9,132292.88
buyer_4,Jorge,50,ES66209532250731308914,TRX_N-00382-88281940154,2022-09-06T14:35:40,Galdakao,Basic services,internet,-39.2,132253.68
buyer_4,Jorge,50,ES66209532250731308914,TRX_N-00383-810512290128,2022-09-07T12:41:28,Galdakao,Basic services,water,-40.4,132213.28
buyer_4,Jorge,50,ES66209532250731308914,TRX_N-00384-851534044340,2022-09-07T17:30:26,Galdakao,Basic services,electricity,-99.55,132113.73
buyer_4,Jorge,50,ES66209532250731308914,TRX_N-00385-770628486075,2022-09-07T10:10:28,Galdakao,Basic services,phone,-44.87,132068.86
buyer_4,Jorge,50,ES66209532250731308914,TRX_N-00386-428316893206,2022-09-19T05:01:55,Galdakao,Expense,leisure,-143.47,131925.39
buyer_4,Jorge,50,ES66209532250731308914,TRX_N-00387-731797354108,2022-10-01T20:43:40,Galdakao,transfer,Salary,2836.23,134761.62
buyer_4,Jorge,50,ES66209532250731308914,TRX_N-00388-205049893208,2022-10-01T20:43:40,Galdakao,transfer,Partner Salary,2836.62,137598.24
buyer_4,Jorge,50,ES66209532250731308914,TRX_N-00389-45165477819,2022-10-01T20:43:40,Galdakao,transfer,Extra Income,283.62,137881.86
buyer_4,Jorge,50,ES66209532250731308914,TRX_N-00390-698602945446,2022-10-05T12:30:15,Galdakao,Housing,Mortgage,-893.54,136988.32
buyer_4,Jorge,50,ES66209532250731308914,TRX_N-00391-574736479132,2022-10-07T16:12:35,Galdakao,Basic services,water,-10.98,136977.34
buyer_4,Jorge,50,ES66209532250731308914,TRX_N-00392-789769227567,2022-10-12T19:41:05,Galdakao,Expense,travel,-1251.79,135725.55
buyer_4,Jorge,50,ES66209532250731308914,TRX_N-00393-7424607367,2022-10-23T10:36:21,Leioa,Expense,leisure,-16.7,135708.85
buyer_4,Jorge,50,ES66209532250731308914,TRX_N-00394-588871968696,2022-11-01T18:54:49,Galdakao,transfer,Salary,2836.23,138545.08
buyer_4,Jorge,50,ES66209532250731308914,TRX_N-00395-138409934865,2022-11-01T18:54:49,Galdakao,transfer,Partner Salary,2836.62,141381.7
buyer_4,Jorge,50,ES66209532250731308914,TRX_N-00396-863915996051,2022-11-05T20:52:34,Galdakao,Housing,Mortgage,-893.54,140488.16
buyer_4,Jorge,50,ES66209532250731308914,TRX_N-00397-749682970096,2022-11-05T09:02:20,Galdakao,Basic services,internet,-73.79,140414.37
buyer_4,Jorge,50,ES66209532250731308914,TRX_N-00398-807638321611,2022-11-05T13:05:38,Galdakao,Basic services,phone,-61.37,140353.0
buyer_4,Jorge,50,ES66209532250731308914,TRX_N-00399-136920776902,2022-11-06T17:32:56,Galdakao,Basic services,electricity,-78.9,140274.1
buyer_4,Jorge,50,ES66209532250731308914,TRX_N-00400-120001316317,2022-11-06T17:44:44,Galdakao,Basic services,phone,-78.72,140195.38
buyer_4,Jorge,50,ES66209532250731308914,TRX_N-00401-61586589467,2022-11-07T18:00:07,Galdakao,Basic services,water,-61.63,140133.75
buyer_4,Jorge,50,ES66209532250731308914,TRX_N-00402-686449009116,2022-11-07T13:30:02,Galdakao,Basic services,phone,-97.75,140036.0
buyer_4,Jorge,50,ES66209532250731308914,TRX_N-00403-820773959822,2022-11-09T04:25:27,Galdakao,Expense,leisure,-85.5,139950.5
buyer_4,Jorge,50,ES66209532250731308914,TRX_N-00404-807765171130,2022-11-17T18:57:37,Galdakao,Expense,education,-155.32,139795.18
buyer_4,Jorge,50,ES66209532250731308914,TRX_N-00405-640684527214,2022-11-23T12:14:24,Irun,Expense,food,-103.4,139691.78
buyer_4,Jorge,50,ES66209532250731308914,TRX_N-00406-441379803951,2022-11-27T03:23:17,Galdakao,Expense,food,-740.15,138951.63
buyer_4,Jorge,50,ES66209532250731308914,TRX_N-00407-166227362190,2022-12-01T13:44:10,Galdakao,transfer,Salary,2836.23,141787.86
buyer_4,Jorge,50,ES66209532250731308914,TRX_N-00408-180970432616,2022-12-01T13:44:10,Galdakao,transfer,Partner Salary,2836.62,144624.48
buyer_4,Jorge,50,ES66209532250731308914,TRX_N-00409-19606776572,2022-12-01T13:44:10,Galdakao,transfer,Bonus,2800.34,147424.82
buyer_4,Jorge,50,ES66209532250731308914,TRX_N-00410-484089521478,2022-12-05T17:05:02,Galdakao,Housing,Mortgage,-893.54,146531.28
buyer_4,Jorge,50,ES66209532250731308914,TRX_N-00411-907045951419,2022-12-05T09:16:25,Galdakao,Basic services,gas,-51.9,146479.38
buyer_4,Jorge,50,ES66209532250731308914,TRX_N-00412-361029855008,2022-12-06T05:40:22,Galdakao,Basic services,water,-18.06,146461.32
buyer_4,Jorge,50,ES66209532250731308914,TRX_N-00413-742508340407,2022-12-06T11:48:38,Galdakao,Basic services,electricity,-128.93,146332.39
buyer_4,Jorge,50,ES66209532250731308914,TRX_N-00414-404016568872,2022-12-07T14:23:02,Galdakao,Basic services,gas,-74.55,146257.84
buyer_4,Jorge,50,ES66209532250731308914,TRX_N-00415-708788001665,2022-12-24T19:57:51,Galdakao,Expense,education,-837.06,145420.78
buyer_4,Jorge,50,ES66209532250731308914,TRX_N-00416-566524380936,2022-12-25T16:08:45,Erandio,Expense,clothing,-373.71,145047.07
buyer_4,Jorge,50,ES66209532250731308914,TRX_N-00417-609561879198,2022-12-30T16:08:43,Galdakao,Expense,education,-684.45,144362.62
buyer_4,Jorge,50,ES66209532250731308914,TRX_N-00418-963531843993,2023-01-01T08:18:56,Galdakao,transfer,Salary,2836.23,147198.85
buyer_4,Jorge,50,ES66209532250731308914,TRX_N-00419-752762376884,2023-01-01T08:18:56,Galdakao,transfer,Partner Salary,2836.62,150035.47
buyer_4,Jorge,50,ES66209532250731308914,TRX_N-00420-630829723928,2023-01-01T08:18:56,Galdakao,transfer,Extra Income,283.62,150319.09
buyer_4,Jorge,50,ES66209532250731308914,TRX_N-00421-127600681579,2023-01-05T18:51:23,Galdakao,Housing,Mortgage,-893.54,149425.55
buyer_4,Jorge,50,ES66209532250731308914,TRX_N-00422-787895086451,2023-01-05T13:28:38,Galdakao,Basic services,electricity,-147.09,149278.46
buyer_4,Jorge,50,ES66209532250731308914,TRX_N-00423-114702165357,2023-01-07T11:36:03,Galdakao,Basic services,gas,-44.43,149234.03
buyer_4,Jorge,50,ES66209532250731308914,TRX_N-00424-631248377887,2023-01-22T09:04:28,Galdakao,Expense,food,-580.21,148653.82
buyer_4,Jorge,50,ES66209532250731308914,TRX_N-00425-996860366295,2023-01-29T10:18:48,Galdakao,Expense,transport,-77.71,148576.11
buyer_4,Jorge,50,ES66209532250731308914,TRX_N-00426-867240553291,2023-02-01T13:11:47,Galdakao,transfer,Salary,2836.23,151412.34
buyer_4,Jorge,50,ES66209532250731308914,TRX_N-00427-202101971464,2023-02-01T13:11:47,Galdakao,transfer,Partner Salary,2836.62,154248.96
buyer_4,Jorge,50,ES66209532250731308914,TRX_N-00428-115832272841,2023-02-05T19:14:20,Galdakao,Housing,Mortgage,-893.54,153355.42
buyer_4,Jorge,50,ES66209532250731308914,TRX_N-00429-88078831711,2023-02-06T16:36:11,Galdakao,Basic services,electricity,-136.07,153219.35
buyer_4,Jorge,50,ES66209532250731308914,TRX_N-00430-287346679728,2023-02-06T12:16:51,Galdakao,Basic services,gas,-79.09,153140.26
buyer_4,Jorge,50,ES66209532250731308914,TRX_N-00431-156654812240,2023-02-06T23:45:05,Galdakao,Basic services,internet,-71.43,153068.83
buyer_4,Jorge,50,ES66209532250731308914,TRX_N-00432-967564177271,2023-02-06T08:50:24,Galdakao,Basic services,phone,-76.5,152992.33
buyer_4,Jorge,50,ES66209532250731308914,TRX_N-00433-298688164391,2023-02-07T15:35:15,Galdakao,Basic services,water,-68.97,152923.36
buyer_4,Jorge,50,ES66209532250731308914,TRX_N-00434-558399493873,2023-02-07T08:28:14,Galdakao,Basic services,electricity,-69.36,152854.0
buyer_4,Jorge,50,ES66209532250731308914,TRX_N-00435-673739379435,2023-02-08T17:17:15,Sopela,Expense,food,-362.22,152491.78
buyer_4,Jorge,50,ES66209532250731308914,TRX_N-00436-676643998727,2023-02-13T14:53:21,Galdakao,Expense,food,-676.14,151815.64
buyer_4,Jorge,50,ES66209532250731308914,TRX_N-00437-47990666524,2023-02-16T18:10:12,Galdakao,Expense,education,-911.12,150904.52
buyer_4,Jorge,50,ES66209532250731308914,TRX_N-00438-27733357159,2023-02-28T12:09:57,Galdakao,Expense,education,-804.59,150099.93
buyer_4,Jorge,50,ES66209532250731308914,TRX_N-00439-692021608533,2023-03-01T16:03:46,Galdakao,transfer,Salary,2836.23,152936.16
buyer_4,Jorge,50,ES66209532250731308914,TRX_N-00440-876868045067,2023-03-01T16:03:46,Galdakao,transfer,Partner Salary,2836.62,155772.78
buyer_4,Jorge,50,ES66209532250731308914,TRX_N-00441-110786941555,2023-03-01T16:03:46,Galdakao,transfer,Extra Income,283.62,156056.4
buyer_4,Jorge,50,ES66209532250731308914,TRX_N-00442-750849182623,2023-03-05T16:34:49,Galdakao,Housing,Mortgage,-893.54,155162.86
buyer_4,Jorge,50,ES66209532250731308914,TRX_N-00443-435933620639,2023-03-05T19:05:20,Galdakao,Basic services,gas,-51.58,155111.28
buyer_4,Jorge,50,ES66209532250731308914,TRX_N-00444-5969019018,2023-03-07T08:51:31,Galdakao,Basic services,electricity,-27.51,155083.77
buyer_4,Jorge,50,ES66209532250731308914,TRX_N-00445-786537520393,2023-03-07T09:31:14,Elciego,Expense,gifts,-93.78,154989.99
buyer_4,Jorge,50,ES66209532250731308914,TRX_N-00446-123773788380,2023-04-01T08:29:30,Galdakao,transfer,Salary,2836.23,157826.22
buyer_4,Jorge,50,ES66209532250731308914,TRX_N-00447-697543657975,2023-04-01T08:29:30,Galdakao,transfer,Partner Salary,2836.62,160662.84
buyer_4,Jorge,50,ES66209532250731308914,TRX_N-00448-745334756053,2023-04-05T18:00:35,Galdakao,Housing,Mortgage,-893.54,159769.3
buyer_4,Jorge,50,ES66209532250731308914,TRX_N-00449-44606739474,2023-04-05T04:16:03,Galdakao,Basic services,water,-75.8,159693.5
buyer_4,Jorge,50,ES66209532250731308914,TRX_N-00450-797139744810,2023-04-05T11:04:31,Galdakao,Basic services,electricity,-114.87,159578.63
buyer_4,Jorge,50,ES66209532250731308914,TRX_N-00451-806786562701,2023-04-05T14:46:40,Galdakao,Basic services,gas,-52.73,159525.9
buyer_4,Jorge,50,ES66209532250731308914,TRX_N-00452-430527455717,2023-04-05T09:37:54,Galdakao,Basic services,internet,-46.52,159479.38
buyer_4,Jorge,50,ES66209532250731308914,TRX_N-00453-389304798118,2023-04-06T08:01:03,Galdakao,Basic services,electricity,-59.96,159419.42
buyer_4,Jorge,50,ES66209532250731308914,TRX_N-00454-393419612222,2023-04-06T09:01:14,Galdakao,Basic services,gas,-60.75,159358.67
buyer_4,Jorge,50,ES66209532250731308914,TRX_N-00455-405871429117,2023-04-06T08:48:47,Galdakao,Expense,food,-104.21,159254.46
buyer_4,Jorge,50,ES66209532250731308914,TRX_N-00456-692415316816,2023-04-07T20:50:21,Galdakao,Basic services,gas,-44.11,159210.35
buyer_4,Jorge,50,ES66209532250731308914,TRX_N-00457-825000248304,2023-04-07T16:52:54,Galdakao,Basic services,internet,-59.33,159151.02
buyer_4,Jorge,50,ES66209532250731308914,TRX_N-00458-649236076545,2023-04-13T14:43:48,Llodio,Expense,food,-653.76,158497.26
buyer_4,Jorge,50,ES66209532250731308914,TRX_N-00459-162300114194,2023-04-30T11:16:38,Galdakao,Expense,clothing,-260.35,158236.91
buyer_4,Jorge,50,ES66209532250731308914,TRX_N-00460-478607288253,2023-05-01T15:53:10,Galdakao,transfer,Salary,2836.23,161073.14
buyer_4,Jorge,50,ES66209532250731308914,TRX_N-00461-489366972833,2023-05-01T15:53:10,Galdakao,transfer,Partner Salary,2836.62,163909.76
buyer_4,Jorge,50,ES66209532250731308914,TRX_N-00462-77016822020,2023-05-01T13:52:47,Galdakao,Expense,healthcare,-106.42,163803.34
buyer_4,Jorge,50,ES66209532250731308914,TRX_N-00463-642373230789,2023-05-03T11:07:41,Labastida/Bastida,Expense,clothing,-483.22,163320.12
buyer_4,Jorge,50,ES66209532250731308914,TRX_N-00464-200984618316,2023-05-05T18:50:27,Galdakao,Housing,Mortgage,-893.54,162426.58
buyer_4,Jorge,50,ES66209532250731308914,TRX_N-00465-24840654143,2023-05-05T16:48:38,Galdakao,Basic services,water,-71.59,162354.99
buyer_4,Jorge,50,ES66209532250731308914,TRX_N-00466-133793842920,2023-05-05T23:37:12,Galdakao,Basic services,electricity,-60.5,162294.49
buyer_4,Jorge,50,ES66209532250731308914,TRX_N-00467-910952096258,2023-05-05T15:48:48,Galdakao,Basic services,gas,-85.37,162209.12
buyer_4,Jorge,50,ES66209532250731308914,TRX_N-00468-907617486746,2023-05-06T19:50:23,Galdakao,Basic services,water,-41.18,162167.94
buyer_4,Jorge,50,ES66209532250731308914,TRX_N-00469-359805875017,2023-05-06T14:32:44,Galdakao,Basic services,internet,-52.35,162115.59
buyer_4,Jorge,50,ES66209532250731308914,TRX_N-00470-521233589390,2023-05-07T06:33:39,Galdakao,Basic services,internet,-53.93,162061.66
buyer_4,Jorge,50,ES66209532250731308914,TRX_N-00471-899659635224,2023-05-11T11:21:08,Hernani,Expense,clothing,-292.61,161769.05
buyer_4,Jorge,50,ES66209532250731308914,TRX_N-00472-890351535204,2023-05-16T13:09:06,Galdakao,Expense,healthcare,-232.42,161536.63
buyer_4,Jorge,50,ES66209532250731308914,TRX_N-00473-465938768200,2023-05-30T20:43:51,Galdakao,Expense,food,-382.56,161154.07
buyer_4,Jorge,50,ES66209532250731308914,TRX_N-00474-968700985329,2023-06-01T18:34:59,Galdakao,transfer,Salary,2836.23,163990.3
buyer_4,Jorge,50,ES66209532250731308914,TRX_N-00475-127556497487,2023-06-01T18:34:59,Galdakao,transfer,Partner Salary,2836.62,166826.92
buyer_4,Jorge,50,ES66209532250731308914,TRX_N-00476-711856441244,2023-06-01T18:34:59,Galdakao,transfer,Extra Income,283.62,167110.54
buyer_4,Jorge,50,ES66209532250731308914,TRX_N-00477-753316424142,2023-06-01T18:34:59,Galdakao,transfer,Bonus,2589.47,169700.01
buyer_4,Jorge,50,ES66209532250731308914,TRX_N-00478-773117226024,2023-06-05T15:03:27,Galdakao,Housing,Mortgage,-893.54,168806.47
buyer_4,Jorge,50,ES66209532250731308914,TRX_N-00479-936435067961,2023-06-05T09:51:45,Galdakao,Basic services,gas,-30.86,168775.61
buyer_4,Jorge,50,ES66209532250731308914,TRX_N-00480-699884682523,2023-06-05T08:33:55,Galdakao,Basic services,internet,-66.55,168709.06
buyer_4,Jorge,50,ES66209532250731308914,TRX_N-00481-833020918260,2023-06-05T15:57:25,Galdakao,Basic services,phone,-87.0,168622.06
buyer_4,Jorge,50,ES66209532250731308914,TRX_N-00482-197227589452,2023-06-06T15:07:05,Galdakao,Basic services,electricity,-124.3,168497.76
buyer_4,Jorge,50,ES66209532250731308914,TRX_N-00483-96251260161,2023-06-06T14:28:15,Galdakao,Basic services,gas,-94.81,168402.95
buyer_4,Jorge,50,ES66209532250731308914,TRX_N-00484-851456783133,2023-06-06T08:25:02,Galdakao,Basic services,phone,-83.77,168319.18
buyer_4,Jorge,50,ES66209532250731308914,TRX_N-00485-503183154260,2023-06-07T10:05:40,Galdakao,Basic services,electricity,-136.0,168183.18
buyer_4,Jorge,50,ES66209532250731308914,TRX_N-00486-100525059810,2023-06-09T18:29:24,Galdakao,Expense,transport,-46.24,168136.94
buyer_4,Jorge,50,ES66209532250731308914,TRX_N-00487-163301039561,2023-06-20T08:57:38,Galdakao,Expense,transport,-163.91,167973.03
buyer_4,Jorge,50,ES66209532250731308914,TRX_N-00488-869852314242,2023-06-24T11:15:29,Galdakao,Expense,food,-334.71,167638.32
buyer_4,Jorge,50,ES66209532250731308914,TRX_N-00489-738618406887,2023-07-01T13:07:51,Galdakao,transfer,Salary,2836.23,170474.55
buyer_4,Jorge,50,ES66209532250731308914,TRX_N-00490-481543439321,2023-07-01T13:07:51,Galdakao,transfer,Partner Salary,2836.62,173311.17
buyer_4,Jorge,50,ES66209532250731308914,TRX_N-00491-116280583721,2023-07-04T01:05:41,Galdakao,Expense,education,-937.78,172373.39
buyer_4,Jorge,50,ES66209532250731308914,TRX_N-00492-777208444885,2023-07-05T20:23:58,Galdakao,Housing,Mortgage,-893.54,171479.85
buyer_4,Jorge,50,ES66209532250731308914,TRX_N-00493-791864805840,2023-07-05T19:41:45,Galdakao,Basic services,water,-77.53,171402.32
buyer_4,Jorge,50,ES66209532250731308914,TRX_N-00494-814155311691,2023-07-05T10:37:45,Galdakao,Basic services,internet,-43.82,171358.5
buyer_4,Jorge,50,ES66209532250731308914,TRX_N-00495-448628922258,2023-07-06T11:37:00,Galdakao,Basic services,electricity,-43.14,171315.36
buyer_4,Jorge,50,ES66209532250731308914,TRX_N-00496-83547193941,2023-07-06T18:48:49,Galdakao,Basic services,phone,-93.12,171222.24
buyer_4,Jorge,50,ES66209532250731308914,TRX_N-00497-276861758124,2023-07-06T14:29:34,Iruña de Oca,Expense,clothing,-183.37,171038.87
buyer_4,Jorge,50,ES66209532250731308914,TRX_N-00498-63471191300,2023-07-07T04:21:54,Galdakao,Basic services,gas,-53.55,170985.32
buyer_4,Jorge,50,ES66209532250731308914,TRX_N-00499-225107272436,2023-07-07T09:17:58,Galdakao,Basic services,phone,-37.45,170947.87
buyer_4,Jorge,50,ES66209532250731308914,TRX_N-00500-642602077440,2023-07-30T13:37:30,Galdakao,Expense,gifts,-43.29,170904.58
buyer_4,Jorge,50,ES66209532250731308914,TRX_N-00501-155362845089,2023-08-01T16:21:46,Galdakao,transfer,Salary,2836.23,173740.81
buyer_4,Jorge,50,ES66209532250731308914,TRX_N-00502-554396706768,2023-08-01T16:21:46,Galdakao,transfer,Partner Salary,2836.62,176577.43
buyer_4,Jorge,50,ES66209532250731308914,TRX_N-00503-443673953895,2023-08-01T16:21:46,Galdakao,transfer,Extra Income,283.62,176861.05
buyer_4,Jorge,50,ES66209532250731308914,TRX_N-00504-127697948174,2023-08-02T21:18:37,Galdakao,Expense,transport,-59.41,176801.64
buyer_4,Jorge,50,ES66209532250731308914,TRX_N-00505-844894867886,2023-08-05T11:51:09,Galdakao,Housing,Mortgage,-893.54,175908.1
buyer_4,Jorge,50,ES66209532250731308914,TRX_N-00506-63356756332,2023-08-05T09:28:50,Galdakao,Basic services,gas,-47.92,175860.18
buyer_4,Jorge,50,ES66209532250731308914,TRX_N-00507-967100938028,2023-08-06T15:08:38,Galdakao,Basic services,electricity,-73.07,175787.11
buyer_4,Jorge,50,ES66209532250731308914,TRX_N-00508-754135256069,2023-08-06T11:13:10,Galdakao,Basic services,phone,-77.14,175709.97
buyer_4,Jorge,50,ES66209532250731308914,TRX_N-00509-14221763452,2023-08-07T17:33:07,Galdakao,Basic services,phone,-64.88,175645.09
buyer_4,Jorge,50,ES66209532250731308914,TRX_N-00510-130254923203,2023-08-29T14:16:38,Galdakao,Expense,food,-178.87,175466.22
buyer_4,Jorge,50,ES66209532250731308914,TRX_N-00511-260481106570,2023-09-01T11:09:10,Galdakao,transfer,Salary,2836.23,178302.45
buyer_4,Jorge,50,ES66209532250731308914,TRX_N-00512-375771663515,2023-09-01T11:09:10,Galdakao,transfer,Partner Salary,2836.62,181139.07
buyer_4,Jorge,50,ES66209532250731308914,TRX_N-00513-378771153101,2023-09-05T10:31:07,Galdakao,Housing,Mortgage,-893.54,180245.53
buyer_4,Jorge,50,ES66209532250731308914,TRX_N-00514-449790862447,2023-09-05T12:17:47,Galdakao,Basic services,internet,-46.64,180198.89
buyer_4,Jorge,50,ES66209532250731308914,TRX_N-00515-465781266652,2023-09-05T09:35:53,Galdakao,Basic services,phone,-99.28,180099.61
buyer_4,Jorge,50,ES66209532250731308914,TRX_N-00516-99039164303,2023-09-06T09:27:56,Galdakao,Basic services,electricity,-23.34,180076.27
buyer_4,Jorge,50,ES66209532250731308914,TRX_N-00517-686013497434,2023-09-06T15:25:48,Galdakao,Basic services,internet,-75.52,180000.75
buyer_4,Jorge,50,ES66209532250731308914,TRX_N-00518-742386334417,2023-09-06T11:37:09,Galdakao,Basic services,phone,-64.01,179936.74
buyer_4,Jorge,50,ES66209532250731308914,TRX_N-00519-752168666142,2023-09-13T10:51:31,Galdakao,Expense,transport,-181.91,179754.83
buyer_4,Jorge,50,ES66209532250731308914,TRX_N-00520-537164608111,2023-09-21T13:02:08,Galdakao,Expense,food,-595.16,179159.67
buyer_4,Jorge,50,ES66209532250731308914,TRX_N-00521-514111406355,2023-09-29T14:42:55,Galdakao,Expense,transport,-165.08,178994.59
buyer_4,Jorge,50,ES66209532250731308914,TRX_N-00522-719889599789,2023-10-01T09:28:01,Galdakao,transfer,Salary,2836.23,181830.82
buyer_4,Jorge,50,ES66209532250731308914,TRX_N-00523-690015654437,2023-10-01T09:28:01,Galdakao,transfer,Partner Salary,2836.62,184667.44
buyer_4,Jorge,50,ES66209532250731308914,TRX_N-00524-441851812524,2023-10-01T09:28:01,Galdakao,transfer,Extra Income,283.62,184951.06
buyer_4,Jorge,50,ES66209532250731308914,TRX_N-00525-415020346491,2023-10-01T19:01:20,Vitoria-Gasteiz,Expense,leisure,-114.11,184836.95
buyer_4,Jorge,50,ES66209532250731308914,TRX_N-00526-692573962026,2023-10-01T12:01:34,Galdakao,Expense,gifts,-355.39,184481.56
buyer_4,Jorge,50,ES66209532250731308914,TRX_N-00527-498043583156,2023-10-05T08:27:27,Galdakao,Housing,Mortgage,-893.54,183588.02
buyer_4,Jorge,50,ES66209532250731308914,TRX_N-00528-211319562782,2023-10-05T01:39:54,Galdakao,Basic services,water,-22.39,183565.63
buyer_4,Jorge,50,ES66209532250731308914,TRX_N-00529-936638748984,2023-10-05T04:19:19,Galdakao,Basic services,gas,-57.6,183508.03
buyer_4,Jorge,50,ES66209532250731308914,TRX_N-00530-902303930328,2023-10-05T08:48:01,Galdakao,Basic services,phone,-71.88,183436.15
buyer_4,Jorge,50,ES66209532250731308914,TRX_N-00531-95945004219,2023-10-06T13:43:32,Galdakao,Basic services,gas,-42.41,183393.74
buyer_4,Jorge,50,ES66209532250731308914,TRX_N-00532-47386169892,2023-10-10T16:40:13,Galdakao,Expense,food,-321.98,183071.76
buyer_4,Jorge,50,ES66209532250731308914,TRX_N-00533-308755832646,2023-10-28T20:39:28,Galdakao,Expense,transport,-168.49,182903.27
buyer_4,Jorge,50,ES66209532250731308914,TRX_N-00534-900787136342,2023-10-31T13:16:32,Galdakao,Expense,transport,-140.76,182762.51
buyer_4,Jorge,50,ES66209532250731308914,TRX_N-00535-28840010866,2023-11-01T22:42:17,Galdakao,transfer,Salary,2836.23,185598.74
buyer_4,Jorge,50,ES66209532250731308914,TRX_N-00536-234168046025,2023-11-01T22:42:17,Galdakao,transfer,Partner Salary,2836.62,188435.36
buyer_4,Jorge,50,ES66209532250731308914,TRX_N-00537-406158716820,2023-11-02T08:29:03,Galdakao,Expense,transport,-145.04,188290.32
buyer_4,Jorge,50,ES66209532250731308914,TRX_N-00538-768765224862,2023-11-03T06:46:05,Galdakao,Expense,leisure,-281.36,188008.96
buyer_4,Jorge,50,ES66209532250731308914,TRX_N-00539-378696852512,2023-11-05T07:37:07,Galdakao,Housing,Mortgage,-893.54,187115.42
buyer_4,Jorge,50,ES66209532250731308914,TRX_N-00540-754295307869,2023-11-05T17:21:34,Galdakao,Basic services,water,-39.56,187075.86
buyer_4,Jorge,50,ES66209532250731308914,TRX_N-00541-139302612907,2023-11-06T23:26:02,Galdakao,Basic services,electricity,-131.78,186944.08
buyer_4,Jorge,50,ES66209532250731308914,TRX_N-00542-458380429194,2023-11-06T12:02:21,Galdakao,Basic services,internet,-63.0,186881.08
buyer_4,Jorge,50,ES66209532250731308914,TRX_N-00543-827063688506,2023-11-06T09:37:13,Galdakao,Basic services,phone,-88.73,186792.35
buyer_4,Jorge,50,ES66209532250731308914,TRX_N-00544-60810418623,2023-11-07T17:37:29,Galdakao,Basic services,gas,-44.34,186748.01
buyer_4,Jorge,50,ES66209532250731308914,TRX_N-00545-343096422824,2023-11-07T22:02:48,Galdakao,Basic services,internet,-35.71,186712.3
buyer_4,Jorge,50,ES66209532250731308914,TRX_N-00546-938334293738,2023-11-07T11:40:20,Galdakao,Basic services,phone,-74.87,186637.43
buyer_4,Jorge,50,ES66209532250731308914,TRX_N-00547-271777264174,2023-11-15T10:57:32,Galdakao,Expense,food,-180.1,186457.33
buyer_4,Jorge,50,ES66209532250731308914,TRX_N-00548-721242517095,2023-11-19T13:08:41,Galdakao,Expense,repairs,-744.28,185713.05
buyer_4,Jorge,50,ES66209532250731308914,TRX_N-00549-765352054557,2023-11-22T14:13:34,Galdakao,Expense,food,-314.96,185398.09
buyer_4,Jorge,50,ES66209532250731308914,TRX_N-00550-843357787691,2023-11-27T13:53:09,Galdakao,Expense,appliances,-1166.15,184231.94
buyer_4,Jorge,50,ES66209532250731308914,TRX_N-00551-8719596683,2023-12-01T10:50:55,Galdakao,transfer,Salary,2836.23,187068.17
buyer_4,Jorge,50,ES66209532250731308914,TRX_N-00552-456752116045,2023-12-01T10:50:55,Galdakao,transfer,Partner Salary,2836.62,189904.79
buyer_4,Jorge,50,ES66209532250731308914,TRX_N-00553-60845497535,2023-12-01T10:50:55,Galdakao,transfer,Bonus,3080.18,192984.97
buyer_4,Jorge,50,ES66209532250731308914,TRX_N-00554-272789765925,2023-12-05T17:13:10,Galdakao,Housing,Mortgage,-893.54,192091.43
buyer_4,Jorge,50,ES66209532250731308914,TRX_N-00555-977398900217,2023-12-05T15:31:35,Galdakao,Basic services,gas,-78.79,192012.64
buyer_4,Jorge,50,ES66209532250731308914,TRX_N-00556-437561659094,2023-12-05T21:38:17,Galdakao,Basic services,internet,-75.61,191937.03
buyer_4,Jorge,50,ES66209532250731308914,TRX_N-00557-212789074968,2023-12-06T09:05:09,Galdakao,Basic services,gas,-53.72,191883.31
buyer_4,Jorge,50,ES66209532250731308914,TRX_N-00558-875753986022,2023-12-06T20:38:08,Galdakao,Basic services,phone,-71.01,191812.3
buyer_4,Jorge,50,ES66209532250731308914,TRX_N-00559-382450428786,2023-12-07T22:58:14,Galdakao,Basic services,internet,-36.78,191775.52
buyer_4,Jorge,50,ES66209532250731308914,TRX_N-00560-5976562629,2023-12-07T20:29:54,Galdakao,Basic services,phone,-99.41,191676.11
buyer_4,Jorge,50,ES66209532250731308914,TRX_N-00561-348485524652,2023-12-17T14:09:40,Galdakao,Expense,leisure,-170.46,191505.65
buyer_4,Jorge,50,ES66209532250731308914,TRX_N-00562-566804505404,2023-12-18T11:57:48,Galdakao,Expense,leisure,-38.56,191467.09
buyer_4,Jorge,50,ES66209532250731308914,TRX_N-00563-87153952498,2023-12-23T08:53:26,Galdakao,Expense,travel,-2471.66,188995.43
buyer_4,Jorge,50,ES66209532250731308914,TRX_N-00564-841572855621,2023-12-28T14:12:20,Galdakao,Expense,repairs,-218.25,188777.18
buyer_4,Jorge,50,ES66209532250731308914,TRX_N-00565-174725549880,2023-12-28T11:40:11,Galdakao,Expense,gifts,-206.38,188570.8
buyer_4,Jorge,50,ES66209532250731308914,TRX_N-00566-401328780650,2024-01-01T17:49:44,Galdakao,transfer,Salary,2836.23,191407.03
buyer_4,Jorge,50,ES66209532250731308914,TRX_N-00567-591999705743,2024-01-01T17:49:44,Galdakao,transfer,Partner Salary,2836.62,194243.65
buyer_4,Jorge,50,ES66209532250731308914,TRX_N-00568-465269861870,2024-01-01T17:49:44,Galdakao,transfer,Extra Income,283.62,194527.27
buyer_4,Jorge,50,ES66209532250731308914,TRX_N-00569-913164958060,2024-01-05T16:33:37,Galdakao,Housing,Mortgage,-893.54,193633.73
buyer_4,Jorge,50,ES66209532250731308914,TRX_N-00570-219595804818,2024-01-05T05:55:30,Galdakao,Basic services,electricity,-66.24,193567.49
buyer_4,Jorge,50,ES66209532250731308914,TRX_N-00571-217052521882,2024-01-05T15:31:44,Galdakao,Basic services,internet,-44.74,193522.75
buyer_4,Jorge,50,ES66209532250731308914,TRX_N-00572-253179645087,2024-01-05T17:50:16,Galdakao,Basic services,phone,-74.65,193448.1
buyer_4,Jorge,50,ES66209532250731308914,TRX_N-00573-711963035696,2024-01-05T12:02:31,Galdakao,Expense,food,-284.62,193163.48
buyer_4,Jorge,50,ES66209532250731308914,TRX_N-00574-254112235311,2024-01-06T17:16:39,Galdakao,Basic services,water,-69.08,193094.4
buyer_4,Jorge,50,ES66209532250731308914,TRX_N-00575-73911207851,2024-01-06T08:33:19,Galdakao,Basic services,phone,-67.97,193026.43
buyer_4,Jorge,50,ES66209532250731308914,TRX_N-00576-601949811587,2024-01-07T10:25:43,Galdakao,Basic services,electricity,-64.2,192962.23
buyer_4,Jorge,50,ES66209532250731308914,TRX_N-00577-782062898894,2024-01-07T12:36:24,Galdakao,Basic services,gas,-16.64,192945.59
buyer_4,Jorge,50,ES66209532250731308914,TRX_N-00578-576824696470,2024-01-07T20:42:14,Galdakao,Basic services,internet,-42.3,192903.29
buyer_4,Jorge,50,ES66209532250731308914,TRX_N-00579-341849101418,2024-01-07T19:32:10,Galdakao,Basic services,phone,-58.17,192845.12
buyer_4,Jorge,50,ES66209532250731308914,TRX_N-00580-248154801143,2024-01-11T20:19:17,Galdakao,Expense,leisure,-187.35,192657.77
buyer_4,Jorge,50,ES66209532250731308914,TRX_N-00581-976222082773,2024-01-28T09:26:00,Galdakao,Expense,clothing,-171.13,192486.64
buyer_4,Jorge,50,ES66209532250731308914,TRX_N-00582-245423588258,2024-02-01T14:16:24,Galdakao,transfer,Salary,2836.23,195322.87
buyer_4,Jorge,50,ES66209532250731308914,TRX_N-00583-685572062415,2024-02-01T14:16:24,Galdakao,transfer,Partner Salary,2836.62,198159.49
buyer_4,Jorge,50,ES66209532250731308914,TRX_N-00584-152554715141,2024-02-05T21:20:14,Galdakao,Housing,Mortgage,-893.54,197265.95
buyer_4,Jorge,50,ES66209532250731308914,TRX_N-00585-193398810387,2024-02-05T23:52:44,Galdakao,Basic services,gas,-17.47,197248.48
buyer_4,Jorge,50,ES66209532250731308914,TRX_N-00586-453622279849,2024-02-05T18:56:16,Galdakao,Basic services,internet,-37.39,197211.09
buyer_4,Jorge,50,ES66209532250731308914,TRX_N-00587-755105446805,2024-02-05T13:18:06,Galdakao,Expense,gifts,-143.17,197067.92
buyer_4,Jorge,50,ES66209532250731308914,TRX_N-00588-749150434594,2024-02-06T12:02:14,Galdakao,Basic services,water,-59.26,197008.66
buyer_4,Jorge,50,ES66209532250731308914,TRX_N-00589-645493640904,2024-02-06T20:27:56,Galdakao,Basic services,phone,-65.56,196943.1
buyer_4,Jorge,50,ES66209532250731308914,TRX_N-00590-934774310384,2024-02-07T16:28:02,Galdakao,Basic services,water,-12.1,196931.0
buyer_4,Jorge,50,ES66209532250731308914,TRX_N-00591-970146853622,2024-02-07T13:58:28,Galdakao,Basic services,gas,-27.5,196903.5
buyer_4,Jorge,50,ES66209532250731308914,TRX_N-00592-156271525553,2024-02-07T19:51:43,Galdakao,Basic services,internet,-59.29,196844.21
buyer_4,Jorge,50,ES66209532250731308914,TRX_N-00593-655476207271,2024-02-10T12:02:16,Galdakao,Expense,leisure,-227.55,196616.66
buyer_4,Jorge,50,ES66209532250731308914,TRX_N-00594-756506879174,2024-02-29T20:11:32,Barakaldo,Expense,food,-291.89,196324.77
buyer_4,Jorge,50,ES66209532250731308914,TRX_N-00595-86802988403,2024-03-01T09:23:14,Galdakao,transfer,Salary,2836.23,199161.0
buyer_4,Jorge,50,ES66209532250731308914,TRX_N-00596-112659450385,2024-03-01T09:23:14,Galdakao,transfer,Partner Salary,2836.62,201997.62
buyer_4,Jorge,50,ES66209532250731308914,TRX_N-00597-876938336421,2024-03-01T09:23:14,Galdakao,transfer,Extra Income,283.62,202281.24
buyer_4,Jorge,50,ES66209532250731308914,TRX_N-00598-679214227566,2024-03-05T21:38:03,Galdakao,Housing,Mortgage,-893.54,201387.7
buyer_4,Jorge,50,ES66209532250731308914,TRX_N-00599-600987179453,2024-03-05T13:08:30,Galdakao,Basic services,water,-78.17,201309.53
buyer_4,Jorge,50,ES66209532250731308914,TRX_N-00600-646549921020,2024-03-05T08:48:22,Galdakao,Basic services,electricity,-79.54,201229.99
buyer_4,Jorge,50,ES66209532250731308914,TRX_N-00601-153058171332,2024-03-05T20:21:14,Galdakao,Expense,leisure,-132.35,201097.64
buyer_4,Jorge,50,ES66209532250731308914,TRX_N-00602-610331434397,2024-03-06T17:12:24,Galdakao,Basic services,electricity,-57.7,201039.94
buyer_4,Jorge,50,ES66209532250731308914,TRX_N-00603-553509960256,2024-03-06T20:33:24,Galdakao,Basic services,phone,-38.52,201001.42
buyer_4,Jorge,50,ES66209532250731308914,TRX_N-00604-616531724462,2024-03-06T03:05:43,Galdakao,Expense,education,-782.58,200218.84
buyer_4,Jorge,50,ES66209532250731308914,TRX_N-00605-723591083351,2024-03-07T18:16:46,Galdakao,Basic services,water,-65.53,200153.31
buyer_4,Jorge,50,ES66209532250731308914,TRX_N-00606-776148126039,2024-03-07T08:46:03,Galdakao,Basic services,gas,-98.48,200054.83
buyer_4,Jorge,50,ES66209532250731308914,TRX_N-00607-983603240917,2024-03-07T15:25:01,Sopela,Expense,food,-311.4,199743.43
buyer_4,Jorge,50,ES66209532250731308914,TRX_N-00608-486730099522,2024-03-07T17:30:47,Galdakao,Expense,leisure,-108.46,199634.97
buyer_4,Jorge,50,ES66209532250731308914,TRX_N-00609-973777098574,2024-03-13T19:55:03,Galdakao,Expense,transport,-60.95,199574.02
buyer_4,Jorge,50,ES66209532250731308914,TRX_N-00610-768706039723,2024-03-13T17:00:15,Galdakao,Expense,healthcare,-235.7,199338.32
buyer_4,Jorge,50,ES66209532250731308914,TRX_N-00611-832055276742,2024-03-19T16:29:25,Galdakao,Expense,food,-269.62,199068.7
buyer_4,Jorge,50,ES66209532250731308914,TRX_N-00612-95348224837,2024-03-27T08:30:10,Galdakao,Expense,food,-617.66,198451.04
buyer_4,Jorge,50,ES66209532250731308914,TRX_N-00613-298981421663,2024-04-01T18:17:12,Galdakao,transfer,Salary,2836.23,201287.27
buyer_4,Jorge,50,ES66209532250731308914,TRX_N-00614-552396516491,2024-04-01T18:17:12,Galdakao,transfer,Partner Salary,2836.62,204123.89
buyer_4,Jorge,50,ES66209532250731308914,TRX_N-00615-578182011583,2024-04-05T10:09:32,Galdakao,Housing,Mortgage,-893.54,203230.35
buyer_4,Jorge,50,ES66209532250731308914,TRX_N-00616-186777173176,2024-04-05T08:47:36,Galdakao,Basic services,water,-59.43,203170.92
buyer_4,Jorge,50,ES66209532250731308914,TRX_N-00617-388708863008,2024-04-05T11:34:25,Galdakao,Expense,healthcare,-53.56,203117.36
buyer_4,Jorge,50,ES66209532250731308914,TRX_N-00618-509911486241,2024-04-07T10:16:35,Galdakao,Basic services,gas,-46.87,203070.49
buyer_4,Jorge,50,ES66209532250731308914,TRX_N-00619-183908167852,2024-04-09T13:34:59,Galdakao,Expense,healthcare,-88.25,202982.24
buyer_4,Jorge,50,ES66209532250731308914,TRX_N-00620-764662723660,2024-04-12T09:05:58,Galdakao,Expense,repairs,-721.95,202260.29
buyer_4,Jorge,50,ES66209532250731308914,TRX_N-00621-109647232461,2024-04-20T19:05:54,Galdakao,Expense,clothing,-290.73,201969.56
buyer_4,Jorge,50,ES66209532250731308914,TRX_N-00622-349207058079,2024-04-26T16:09:42,Galdakao,Expense,gifts,-43.9,201925.66
buyer_4,Jorge,50,ES66209532250731308914,TRX_N-00623-766724197934,2024-04-29T20:51:39,Bermeo,Expense,clothing,-389.93,201535.73
buyer_4,Jorge,50,ES66209532250731308914,TRX_N-00624-160786251846,2024-04-29T08:01:37,Galdakao,Expense,healthcare,-211.29,201324.44
buyer_4,Jorge,50,ES66209532250731308914,TRX_N-00625-45524784090,2024-05-01T09:04:44,Galdakao,transfer,Salary,2836.23,204160.67
buyer_4,Jorge,50,ES66209532250731308914,TRX_N-00626-514998369792,2024-05-01T09:04:44,Galdakao,transfer,Partner Salary,2836.62,206997.29
buyer_4,Jorge,50,ES66209532250731308914,TRX_N-00627-717922874874,2024-05-03T11:26:01,Salvatierra/Agurain,Expense,transport,-109.31,206887.98
buyer_4,Jorge,50,ES66209532250731308914,TRX_N-00628-724285177479,2024-05-05T18:18:38,Galdakao,Housing,Mortgage,-893.54,205994.44
buyer_4,Jorge,50,ES66209532250731308914,TRX_N-00629-968314462003,2024-05-05T23:17:09,Galdakao,Basic services,water,-46.43,205948.01
buyer_4,Jorge,50,ES66209532250731308914,TRX_N-00630-910125416384,2024-05-05T21:52:51,Galdakao,Basic services,phone,-51.94,205896.07
buyer_4,Jorge,50,ES66209532250731308914,TRX_N-00631-873606436008,2024-05-05T14:12:16,Iruña de Oca,Expense,food,-523.9,205372.17
buyer_4,Jorge,50,ES66209532250731308914,TRX_N-00632-745569492091,2024-05-06T18:06:39,Galdakao,Basic services,internet,-52.42,205319.75
buyer_4,Jorge,50,ES66209532250731308914,TRX_N-00633-504562303288,2024-05-07T15:33:30,Galdakao,Basic services,internet,-61.4,205258.35
buyer_4,Jorge,50,ES66209532250731308914,TRX_N-00634-18477462268,2024-05-09T15:45:16,Galdakao,Expense,healthcare,-301.15,204957.2
buyer_4,Jorge,50,ES66209532250731308914,TRX_N-00635-720726288339,2024-06-01T18:19:04,Galdakao,transfer,Salary,2836.23,207793.43
buyer_4,Jorge,50,ES66209532250731308914,TRX_N-00636-386607694398,2024-06-01T18:19:04,Galdakao,transfer,Partner Salary,2836.62,210630.05
buyer_4,Jorge,50,ES66209532250731308914,TRX_N-00637-171704673369,2024-06-01T18:19:04,Galdakao,transfer,Extra Income,283.62,210913.67
buyer_4,Jorge,50,ES66209532250731308914,TRX_N-00638-161071605728,2024-06-01T18:19:04,Galdakao,transfer,Bonus,2914.57,213828.24
buyer_4,Jorge,50,ES66209532250731308914,TRX_N-00639-75849759190,2024-06-03T19:31:42,Errenteria,Expense,healthcare,-35.02,213793.22
buyer_4,Jorge,50,ES66209532250731308914,TRX_N-00640-287578128882,2024-06-05T17:55:02,Galdakao,Housing,Mortgage,-893.54,212899.68
buyer_4,Jorge,50,ES66209532250731308914,TRX_N-00641-421719632465,2024-06-05T23:56:27,Galdakao,Basic services,water,-37.74,212861.94
buyer_4,Jorge,50,ES66209532250731308914,TRX_N-00642-524975684072,2024-06-05T02:17:25,Galdakao,Basic services,gas,-16.19,212845.75
buyer_4,Jorge,50,ES66209532250731308914,TRX_N-00643-672239483332,2024-06-06T17:42:35,Galdakao,Basic services,water,-67.38,212778.37
buyer_4,Jorge,50,ES66209532250731308914,TRX_N-00644-166648017740,2024-06-06T20:21:40,Galdakao,Basic services,electricity,-95.21,212683.16
buyer_4,Jorge,50,ES66209532250731308914,TRX_N-00645-773287553363,2024-06-07T12:10:43,Galdakao,Basic services,water,-30.54,212652.62
buyer_4,Jorge,50,ES66209532250731308914,TRX_N-00646-70064427871,2024-06-07T08:35:14,Galdakao,Basic services,gas,-27.0,212625.62
buyer_4,Jorge,50,ES66209532250731308914,TRX_N-00647-633295109712,2024-06-07T16:58:05,Galdakao,Basic services,internet,-73.71,212551.91
buyer_4,Jorge,50,ES66209532250731308914,TRX_N-00648-485509780342,2024-06-10T10:33:53,Mungia,Expense,gifts,-309.5,212242.41
buyer_4,Jorge,50,ES66209532250731308914,TRX_N-00649-215318080285,2024-06-13T23:01:45,Galdakao,Expense,leisure,-285.55,211956.86
buyer_4,Jorge,50,ES66209532250731308914,TRX_N-00650-776030419519,2024-06-16T20:24:24,Galdakao,Expense,food,-595.83,211361.03
buyer_4,Jorge,50,ES66209532250731308914,TRX_N-00651-494462650079,2024-06-29T17:16:30,Galdakao,Expense,gifts,-188.24,211172.79
buyer_4,Jorge,50,ES66209532250731308914,TRX_N-00652-836407690324,2024-07-01T15:55:46,Galdakao,transfer,Salary,2836.23,214009.02
buyer_4,Jorge,50,ES66209532250731308914,TRX_N-00653-745474749989,2024-07-01T15:55:46,Galdakao,transfer,Partner Salary,2836.62,216845.64
buyer_4,Jorge,50,ES66209532250731308914,TRX_N-00654-942365752717,2024-07-04T20:52:46,Getxo,Expense,clothing,-482.4,216363.24
buyer_4,Jorge,50,ES66209532250731308914,TRX_N-00655-44715960580,2024-07-05T09:06:09,Galdakao,Housing,Mortgage,-893.54,215469.7
buyer_4,Jorge,50,ES66209532250731308914,TRX_N-00656-793709989895,2024-07-05T17:22:35,Galdakao,Basic services,electricity,-114.87,215354.83
buyer_4,Jorge,50,ES66209532250731308914,TRX_N-00657-409126088790,2024-07-05T17:52:25,Galdakao,Basic services,phone,-49.24,215305.59
buyer_4,Jorge,50,ES66209532250731308914,TRX_N-00658-190429162055,2024-07-06T10:52:14,Galdakao,Basic services,gas,-45.28,215260.31
buyer_4,Jorge,50,ES66209532250731308914,TRX_N-00659-641371691839,2024-07-07T10:00:47,Galdakao,Basic services,water,-68.98,215191.33
buyer_4,Jorge,50,ES66209532250731308914,TRX_N-00660-985251036836,2024-07-10T12:37:54,Galdakao,Expense,healthcare,-222.98,214968.35
buyer_4,Jorge,50,ES66209532250731308914,TRX_N-00661-418434520908,2024-07-19T21:32:54,Galdakao,Expense,food,-265.64,214702.71
buyer_4,Jorge,50,ES66209532250731308914,TRX_N-00662-364572102594,2024-07-31T16:52:50,Galdakao,Expense,food,-371.31,214331.4
buyer_4,Jorge,50,ES66209532250731308914,TRX_N-00663-151387775907,2024-08-01T09:02:54,Galdakao,transfer,Salary,2836.23,217167.63
buyer_4,Jorge,50,ES66209532250731308914,TRX_N-00664-961451744839,2024-08-01T09:02:54,Galdakao,transfer,Partner Salary,2836.62,220004.25
buyer_4,Jorge,50,ES66209532250731308914,TRX_N-00665-893863212817,2024-08-01T09:02:54,Galdakao,transfer,Extra Income,283.62,220287.87
buyer_4,Jorge,50,ES66209532250731308914,TRX_N-00666-780226369145,2024-08-02T18:53:57,Barakaldo,Expense,clothing,-126.78,220161.09
buyer_4,Jorge,50,ES66209532250731308914,TRX_N-00667-669857923714,2024-08-04T17:07:42,Galdakao,Expense,leisure,-197.76,219963.33
buyer_4,Jorge,50,ES66209532250731308914,TRX_N-00668-132960261225,2024-08-05T08:50:12,Galdakao,Housing,Mortgage,-893.54,219069.79
buyer_4,Jorge,50,ES66209532250731308914,TRX_N-00669-22544241661,2024-08-05T13:00:30,Galdakao,Basic services,gas,-56.05,219013.74
buyer_4,Jorge,50,ES66209532250731308914,TRX_N-00670-16802081907,2024-08-05T17:15:26,Galdakao,Basic services,internet,-64.52,218949.22
buyer_4,Jorge,50,ES66209532250731308914,TRX_N-00671-638551252329,2024-08-05T16:16:09,Oyón-Oion,Expense,transport,-145.06,218804.16
buyer_4,Jorge,50,ES66209532250731308914,TRX_N-00672-389424211185,2024-08-06T17:01:17,Galdakao,Basic services,water,-29.62,218774.54
buyer_4,Jorge,50,ES66209532250731308914,TRX_N-00673-86885855496,2024-08-06T05:10:23,Galdakao,Basic services,gas,-65.78,218708.76
buyer_4,Jorge,50,ES66209532250731308914,TRX_N-00674-505603851148,2024-08-06T15:04:48,Galdakao,Basic services,internet,-58.52,218650.24
buyer_4,Jorge,50,ES66209532250731308914,TRX_N-00675-98587631114,2024-08-06T13:26:49,Galdakao,Basic services,phone,-46.8,218603.44
buyer_4,Jorge,50,ES66209532250731308914,TRX_N-00676-943371102166,2024-09-01T12:04:56,Galdakao,transfer,Salary,2836.23,221439.67
buyer_4,Jorge,50,ES66209532250731308914,TRX_N-00677-133259470205,2024-09-01T12:04:56,Galdakao,transfer,Partner Salary,2836.62,224276.29
buyer_4,Jorge,50,ES66209532250731308914,TRX_N-00678-179885978139,2024-09-05T05:06:16,Galdakao,Housing,Mortgage,-893.54,223382.75
buyer_4,Jorge,50,ES66209532250731308914,TRX_N-00679-496857005378,2024-09-06T08:07:52,Galdakao,Basic services,internet,-67.73,223315.02
buyer_4,Jorge,50,ES66209532250731308914,TRX_N-00680-241864157919,2024-09-07T17:31:05,Galdakao,Basic services,internet,-48.81,223266.21
buyer_4,Jorge,50,ES66209532250731308914,TRX_N-00681-488051436865,2024-09-07T15:06:16,Galdakao,Basic services,phone,-49.93,223216.28
buyer_4,Jorge,50,ES66209532250731308914,TRX_N-00682-585020083396,2024-09-16T17:24:32,Berango,Expense,clothing,-493.77,222722.51
buyer_4,Jorge,50,ES66209532250731308914,TRX_N-00683-246931041266,2024-09-27T23:15:04,Galdakao,Expense,transport,-166.58,222555.93
buyer_4,Jorge,50,ES66209532250731308914,TRX_N-00684-999916436210,2024-10-01T08:49:19,Galdakao,transfer,Salary,2836.23,225392.16
buyer_4,Jorge,50,ES66209532250731308914,TRX_N-00685-481203817397,2024-10-01T08:49:19,Galdakao,transfer,Partner Salary,2836.62,228228.78
buyer_4,Jorge,50,ES66209532250731308914,TRX_N-00686-440840102958,2024-10-05T15:42:01,Galdakao,Housing,Mortgage,-893.54,227335.24
buyer_4,Jorge,50,ES66209532250731308914,TRX_N-00687-178520173787,2024-10-05T20:29:18,Galdakao,Basic services,electricity,-30.47,227304.77
buyer_4,Jorge,50,ES66209532250731308914,TRX_N-00688-860481361578,2024-10-05T08:13:11,Galdakao,Basic services,gas,-46.21,227258.56
buyer_4,Jorge,50,ES66209532250731308914,TRX_N-00689-601651095926,2024-10-05T13:28:04,Oyón-Oion,Expense,healthcare,-318.8,226939.76
buyer_4,Jorge,50,ES66209532250731308914,TRX_N-00690-263216110520,2024-10-06T11:12:23,Galdakao,Basic services,water,-49.04,226890.72
buyer_4,Jorge,50,ES66209532250731308914,TRX_N-00691-654231688628,2024-10-07T19:26:46,Galdakao,Basic services,water,-74.75,226815.97
buyer_4,Jorge,50,ES66209532250731308914,TRX_N-00692-391941778008,2024-10-07T23:58:11,Galdakao,Basic services,electricity,-85.92,226730.05
buyer_4,Jorge,50,ES66209532250731308914,TRX_N-00693-76029775365,2024-10-07T08:14:28,Galdakao,Basic services,internet,-31.01,226699.04
buyer_5,Sara,30,ES23209571107854547123,TRX_N-00001-427832498896,2020-01-01T08:46:37,Donostia,transfer,Salary,3412.57,16741.11
buyer_5,Sara,30,ES23209571107854547123,TRX_N-00002-869580056994,2020-01-01T08:46:37,Donostia,transfer,Partner Salary,3943.03,20684.14
buyer_5,Sara,30,ES23209571107854547123,TRX_N-00003-927769057460,2020-01-05T11:52:10,Donostia,Housing,Mortgage,-501.19,20182.95
buyer_5,Sara,30,ES23209571107854547123,TRX_N-00004-150876690482,2020-01-05T17:59:08,Donostia,Basic services,internet,-68.91,20114.04
buyer_5,Sara,30,ES23209571107854547123,TRX_N-00005-994371219878,2020-01-06T06:16:01,Donostia,Basic services,water,-34.47,20079.57
buyer_5,Sara,30,ES23209571107854547123,TRX_N-00006-209943831487,2020-01-06T14:51:16,Donostia,Basic services,gas,-17.73,20061.84
buyer_5,Sara,30,ES23209571107854547123,TRX_N-00007-718101173484,2020-01-06T04:28:40,Donostia,Basic services,internet,-46.13,20015.71
buyer_5,Sara,30,ES23209571107854547123,TRX_N-00008-325993557457,2020-01-06T23:21:31,Donostia,Basic services,phone,-99.31,19916.4
buyer_5,Sara,30,ES23209571107854547123,TRX_N-00009-252925237663,2020-01-07T10:18:36,Donostia,Expense,travel,-240.04,19676.36
buyer_5,Sara,30,ES23209571107854547123,TRX_N-00010-274770240192,2020-01-11T00:26:42,Pasaia,Expense,food,-385.48,19290.88
buyer_5,Sara,30,ES23209571107854547123,TRX_N-00011-397006918781,2020-01-17T09:42:20,Donostia,Expense,leisure,-34.66,19256.22
buyer_5,Sara,30,ES23209571107854547123,TRX_N-00012-553130265775,2020-02-01T08:07:56,Donostia,transfer,Salary,3412.57,22668.79
buyer_5,Sara,30,ES23209571107854547123,TRX_N-00013-374517386496,2020-02-01T08:07:56,Donostia,transfer,Partner Salary,3943.03,26611.82
buyer_5,Sara,30,ES23209571107854547123,TRX_N-00014-971706304918,2020-02-03T10:18:25,Donostia,Expense,transport,-141.98,26469.84
buyer_5,Sara,30,ES23209571107854547123,TRX_N-00015-624258833735,2020-02-05T15:02:57,Donostia,Housing,Mortgage,-501.19,25968.65
buyer_5,Sara,30,ES23209571107854547123,TRX_N-00016-175274204127,2020-02-05T17:49:34,Donostia,Basic services,water,-60.86,25907.79
buyer_5,Sara,30,ES23209571107854547123,TRX_N-00017-481271257048,2020-02-05T15:39:06,Donostia,Basic services,electricity,-126.44,25781.35
buyer_5,Sara,30,ES23209571107854547123,TRX_N-00018-200786197873,2020-02-05T09:37:48,Donostia,Basic services,internet,-70.93,25710.42
buyer_5,Sara,30,ES23209571107854547123,TRX_N-00019-368441846725,2020-02-06T13:23:44,Donostia,Basic services,electricity,-141.26,25569.16
buyer_5,Sara,30,ES23209571107854547123,TRX_N-00020-296226702780,2020-02-06T16:22:03,Donostia,Basic services,gas,-16.64,25552.52
buyer_5,Sara,30,ES23209571107854547123,TRX_N-00021-772839553429,2020-02-06T09:51:37,Donostia,Basic services,phone,-93.8,25458.72
buyer_5,Sara,30,ES23209571107854547123,TRX_N-00022-852508392379,2020-02-07T11:50:23,Donostia,Basic services,internet,-65.49,25393.23
buyer_5,Sara,30,ES23209571107854547123,TRX_N-00023-149628117768,2020-02-20T17:58:16,Donostia,Expense,food,-584.02,24809.21
buyer_5,Sara,30,ES23209571107854547123,TRX_N-00024-270508989422,2020-02-28T20:17:10,Donostia,Expense,leisure,-73.18,24736.03
buyer_5,Sara,30,ES23209571107854547123,TRX_N-00025-800530143806,2020-03-01T17:21:34,Donostia,transfer,Salary,3412.57,28148.6
buyer_5,Sara,30,ES23209571107854547123,TRX_N-00026-755004440330,2020-03-01T17:21:34,Donostia,transfer,Partner Salary,3943.03,32091.63
buyer_5,Sara,30,ES23209571107854547123,TRX_N-00027-826563362804,2020-03-01T17:21:34,Donostia,transfer,Extra Income,341.26,32432.89
buyer_5,Sara,30,ES23209571107854547123,TRX_N-00028-704412651441,2020-03-01T19:19:02,Errenteria,Expense,food,-123.54,32309.35
buyer_5,Sara,30,ES23209571107854547123,TRX_N-00029-815228530765,2020-03-04T14:13:30,Donostia,Expense,clothing,-489.62,31819.73
buyer_5,Sara,30,ES23209571107854547123,TRX_N-00030-886730816906,2020-03-05T10:43:09,Donostia,Housing,Mortgage,-501.19,31318.54
buyer_5,Sara,30,ES23209571107854547123,TRX_N-00031-945723110081,2020-03-05T13:20:09,Donostia,Basic services,water,-12.01,31306.53
buyer_5,Sara,30,ES23209571107854547123,TRX_N-00032-169493752317,2020-03-05T18:05:00,Donostia,Basic services,electricity,-140.19,31166.34
buyer_5,Sara,30,ES23209571107854547123,TRX_N-00033-583725389810,2020-03-05T18:04:31,Donostia,Basic services,phone,-50.7,31115.64
buyer_5,Sara,30,ES23209571107854547123,TRX_N-00034-263597636425,2020-03-06T11:25:46,Donostia,Basic services,internet,-34.78,31080.86
buyer_5,Sara,30,ES23209571107854547123,TRX_N-00035-85134491422,2020-03-06T10:13:53,Alegría-Dulantzi,Expense,repairs,-612.11,30468.75
buyer_5,Sara,30,ES23209571107854547123,TRX_N-00036-568522254841,2020-03-07T04:36:21,Donostia,Basic services,electricity,-126.28,30342.47
buyer_5,Sara,30,ES23209571107854547123,TRX_N-00037-389254017947,2020-03-07T18:51:48,Donostia,Basic services,internet,-36.19,30306.28
buyer_5,Sara,30,ES23209571107854547123,TRX_N-00038-575942485572,2020-03-08T09:40:50,Donostia,Expense,leisure,-155.11,30151.17
buyer_5,Sara,30,ES23209571107854547123,TRX_N-00039-94457144053,2020-03-14T20:42:04,Donostia,Expense,clothing,-481.79,29669.38
buyer_5,Sara,30,ES23209571107854547123,TRX_N-00040-543219804264,2020-03-22T08:32:29,Donostia,Expense,transport,-129.2,29540.18
buyer_5,Sara,30,ES23209571107854547123,TRX_N-00041-397068884188,2020-03-27T08:30:59,Donostia,Expense,food,-620.29,28919.89
buyer_5,Sara,30,ES23209571107854547123,TRX_N-00042-914536107164,2020-04-01T16:26:15,Donostia,transfer,Salary,3412.57,32332.46
buyer_5,Sara,30,ES23209571107854547123,TRX_N-00043-778005101768,2020-04-01T16:26:15,Donostia,transfer,Partner Salary,3943.03,36275.49
buyer_5,Sara,30,ES23209571107854547123,TRX_N-00044-440862116727,2020-04-05T14:25:26,Donostia,Housing,Mortgage,-501.19,35774.3
buyer_5,Sara,30,ES23209571107854547123,TRX_N-00045-670534053335,2020-04-05T14:50:48,Donostia,Basic services,water,-72.91,35701.39
buyer_5,Sara,30,ES23209571107854547123,TRX_N-00046-794773770275,2020-04-06T03:20:21,Donostia,Basic services,gas,-29.65,35671.74
buyer_5,Sara,30,ES23209571107854547123,TRX_N-00047-914177312081,2020-04-06T19:45:51,Donostia,Basic services,internet,-49.63,35622.11
buyer_5,Sara,30,ES23209571107854547123,TRX_N-00048-503606754697,2020-04-07T18:48:45,Donostia,Basic services,water,-65.15,35556.96
buyer_5,Sara,30,ES23209571107854547123,TRX_N-00049-118736425439,2020-04-08T20:12:49,Donostia,Expense,transport,-140.67,35416.29
buyer_5,Sara,30,ES23209571107854547123,TRX_N-00050-863977857441,2020-04-23T23:42:58,Donostia,Expense,education,-303.56,35112.73
buyer_5,Sara,30,ES23209571107854547123,TRX_N-00051-876740558132,2020-04-24T20:48:44,Donostia,Expense,food,-466.44,34646.29
buyer_5,Sara,30,ES23209571107854547123,TRX_N-00052-53129727802,2020-05-01T08:16:43,Donostia,transfer,Salary,3412.57,38058.86
buyer_5,Sara,30,ES23209571107854547123,TRX_N-00053-780800990628,2020-05-01T08:16:43,Donostia,transfer,Partner Salary,3943.03,42001.89
buyer_5,Sara,30,ES23209571107854547123,TRX_N-00054-614024526345,2020-05-01T08:16:43,Donostia,transfer,Extra Income,341.26,42343.15
buyer_5,Sara,30,ES23209571107854547123,TRX_N-00055-950231040649,2020-05-03T18:10:00,Errenteria,Expense,leisure,-162.62,42180.53
buyer_5,Sara,30,ES23209571107854547123,TRX_N-00056-883781511349,2020-05-05T12:45:31,Donostia,Housing,Mortgage,-501.19,41679.34
buyer_5,Sara,30,ES23209571107854547123,TRX_N-00057-53845350853,2020-05-05T20:33:16,Donostia,Expense,food,-266.1,41413.24
buyer_5,Sara,30,ES23209571107854547123,TRX_N-00058-270731790396,2020-05-06T10:58:21,Donostia,Basic services,phone,-80.01,41333.23
buyer_5,Sara,30,ES23209571107854547123,TRX_N-00059-844681571011,2020-05-07T20:58:42,Donostia,Basic services,water,-49.09,41284.14
buyer_5,Sara,30,ES23209571107854547123,TRX_N-00060-302147374317,2020-05-07T11:57:13,Donostia,Basic services,internet,-76.04,41208.1
buyer_5,Sara,30,ES23209571107854547123,TRX_N-00061-800731900894,2020-05-14T00:12:28,Elciego,Expense,food,-540.17,40667.93
buyer_5,Sara,30,ES23209571107854547123,TRX_N-00062-997048367183,2020-05-31T20:55:15,Donostia,Expense,transport,-50.47,40617.46
buyer_5,Sara,30,ES23209571107854547123,TRX_N-00063-416915868088,2020-06-01T09:48:25,Donostia,transfer,Salary,3412.57,44030.03
buyer_5,Sara,30,ES23209571107854547123,TRX_N-00064-364774547644,2020-06-01T09:48:25,Donostia,transfer,Partner Salary,3943.03,47973.06
buyer_5,Sara,30,ES23209571107854547123,TRX_N-00065-757307611585,2020-06-01T09:48:25,Donostia,transfer,Bonus,3655.93,51628.99
buyer_5,Sara,30,ES23209571107854547123,TRX_N-00066-62847779288,2020-06-05T15:59:10,Donostia,Housing,Mortgage,-501.19,51127.8
buyer_5,Sara,30,ES23209571107854547123,TRX_N-00067-877698845171,2020-06-05T10:53:44,Donostia,Basic services,internet,-57.4,51070.4
buyer_5,Sara,30,ES23209571107854547123,TRX_N-00068-683318781058,2020-06-07T17:25:04,Donostia,Basic services,electricity,-57.11,51013.29
buyer_5,Sara,30,ES23209571107854547123,TRX_N-00069-261186061580,2020-06-07T11:27:47,Donostia,Basic services,internet,-44.45,50968.84
buyer_5,Sara,30,ES23209571107854547123,TRX_N-00070-39800905830,2020-06-22T19:32:06,Donostia,Expense,leisure,-279.1,50689.74
buyer_5,Sara,30,ES23209571107854547123,TRX_N-00071-713999948870,2020-06-24T18:57:40,Donostia,Expense,food,-424.66,50265.08
buyer_5,Sara,30,ES23209571107854547123,TRX_N-00072-55689807252,2020-06-30T09:31:13,Donostia,Expense,food,-148.41,50116.67
buyer_5,Sara,30,ES23209571107854547123,TRX_N-00073-583213814094,2020-07-01T21:49:46,Donostia,transfer,Salary,3412.57,53529.24
buyer_5,Sara,30,ES23209571107854547123,TRX_N-00074-538357803811,2020-07-01T21:49:46,Donostia,transfer,Partner Salary,3943.03,57472.27
buyer_5,Sara,30,ES23209571107854547123,TRX_N-00075-892807922793,2020-07-01T21:49:46,Donostia,transfer,Extra Income,341.26,57813.53
buyer_5,Sara,30,ES23209571107854547123,TRX_N-00076-987272963160,2020-07-05T15:36:05,Donostia,Housing,Mortgage,-501.19,57312.34
buyer_5,Sara,30,ES23209571107854547123,TRX_N-00077-826548986525,2020-07-05T08:12:54,Donostia,Basic services,gas,-24.87,57287.47
buyer_5,Sara,30,ES23209571107854547123,TRX_N-00078-968256883611,2020-07-06T18:51:16,Donostia,Basic services,electricity,-37.65,57249.82
buyer_5,Sara,30,ES23209571107854547123,TRX_N-00079-113498834752,2020-07-07T18:11:46,Donostia,Basic services,electricity,-116.2,57133.62
buyer_5,Sara,30,ES23209571107854547123,TRX_N-00080-570850371377,2020-07-07T09:31:21,Donostia,Basic services,gas,-37.92,57095.7
buyer_5,Sara,30,ES23209571107854547123,TRX_N-00081-729182171775,2020-07-07T17:22:43,Donostia,Basic services,internet,-38.09,57057.61
buyer_5,Sara,30,ES23209571107854547123,TRX_N-00082-890547962115,2020-07-07T13:23:19,Donostia,Basic services,phone,-58.65,56998.96
buyer_5,Sara,30,ES23209571107854547123,TRX_N-00083-499049803257,2020-07-09T15:18:19,Donostia,Expense,clothing,-446.59,56552.37
buyer_5,Sara,30,ES23209571107854547123,TRX_N-00084-933908626660,2020-07-13T14:06:52,Donostia,Expense,transport,-101.71,56450.66
buyer_5,Sara,30,ES23209571107854547123,TRX_N-00085-174946561875,2020-07-16T11:11:44,Bilbao,Expense,food,-556.33,55894.33
buyer_5,Sara,30,ES23209571107854547123,TRX_N-00086-644503453417,2020-07-20T09:19:30,Donostia,Expense,leisure,-45.76,55848.57
buyer_5,Sara,30,ES23209571107854547123,TRX_N-00087-76381075604,2020-07-24T19:10:16,Donostia,Expense,transport,-184.2,55664.37
buyer_5,Sara,30,ES23209571107854547123,TRX_N-00088-58046697672,2020-07-25T23:04:39,Donostia,Expense,gifts,-117.28,55547.09
buyer_5,Sara,30,ES23209571107854547123,TRX_N-00089-79449526914,2020-08-01T11:39:23,Donostia,transfer,Salary,3412.57,58959.66
buyer_5,Sara,30,ES23209571107854547123,TRX_N-00090-885440733390,2020-08-01T11:39:23,Donostia,transfer,Partner Salary,3943.03,62902.69
buyer_5,Sara,30,ES23209571107854547123,TRX_N-00091-999739167789,2020-08-02T19:05:16,Amurrio,Expense,food,-148.53,62754.16
buyer_5,Sara,30,ES23209571107854547123,TRX_N-00092-219968229671,2020-08-03T12:18:20,Donostia,Expense,leisure,-39.75,62714.41
buyer_5,Sara,30,ES23209571107854547123,TRX_N-00093-796646556430,2020-08-05T17:19:43,Donostia,Housing,Mortgage,-501.19,62213.22
buyer_5,Sara,30,ES23209571107854547123,TRX_N-00094-951112195838,2020-08-06T13:06:04,Donostia,Basic services,water,-10.66,62202.56
buyer_5,Sara,30,ES23209571107854547123,TRX_N-00095-436146372442,2020-08-06T19:28:14,Donostia,Basic services,gas,-78.52,62124.04
buyer_5,Sara,30,ES23209571107854547123,TRX_N-00096-388075582314,2020-08-06T12:38:51,Donostia,Basic services,internet,-38.04,62086.0
buyer_5,Sara,30,ES23209571107854547123,TRX_N-00097-245703795210,2020-08-14T22:42:54,Donostia,Expense,leisure,-66.85,62019.15
buyer_5,Sara,30,ES23209571107854547123,TRX_N-00098-963907589923,2020-08-15T08:03:23,Donostia,Expense,food,-730.66,61288.49
buyer_5,Sara,30,ES23209571107854547123,TRX_N-00099-235951163264,2020-08-19T17:52:27,Donostia,Expense,transport,-104.98,61183.51
buyer_5,Sara,30,ES23209571107854547123,TRX_N-00100-239307692751,2020-08-21T15:51:01,Donostia,Expense,appliances,-1617.68,59565.83
buyer_5,Sara,30,ES23209571107854547123,TRX_N-00101-436743273431,2020-08-23T10:40:43,Donostia,Expense,transport,-43.89,59521.94
buyer_5,Sara,30,ES23209571107854547123,TRX_N-00102-690367201549,2020-09-01T11:42:01,Donostia,transfer,Salary,3412.57,62934.51
buyer_5,Sara,30,ES23209571107854547123,TRX_N-00103-188068436551,2020-09-01T11:42:01,Donostia,transfer,Partner Salary,3943.03,66877.54
buyer_5,Sara,30,ES23209571107854547123,TRX_N-00104-728188776546,2020-09-01T11:42:01,Donostia,transfer,Extra Income,341.26,67218.8
buyer_5,Sara,30,ES23209571107854547123,TRX_N-00105-312746155021,2020-09-03T11:45:03,Donostia,Expense,transport,-180.08,67038.72
buyer_5,Sara,30,ES23209571107854547123,TRX_N-00106-105787834037,2020-09-04T09:28:24,Donostia,Expense,food,-503.14,66535.58
buyer_5,Sara,30,ES23209571107854547123,TRX_N-00107-532608392635,2020-09-05T10:30:03,Donostia,Housing,Mortgage,-501.19,66034.39
buyer_5,Sara,30,ES23209571107854547123,TRX_N-00108-228869160846,2020-09-05T01:35:24,Donostia,Basic services,electricity,-73.61,65960.78
buyer_5,Sara,30,ES23209571107854547123,TRX_N-00109-714973301148,2020-09-05T03:56:26,Donostia,Basic services,phone,-94.98,65865.8
buyer_5,Sara,30,ES23209571107854547123,TRX_N-00110-544739106150,2020-09-06T23:10:09,Donostia,Expense,transport,-109.35,65756.45
buyer_5,Sara,30,ES23209571107854547123,TRX_N-00111-84193340858,2020-09-07T09:00:04,Donostia,Basic services,electricity,-126.31,65630.14
buyer_5,Sara,30,ES23209571107854547123,TRX_N-00112-455947998817,2020-09-07T06:16:02,Donostia,Basic services,phone,-72.2,65557.94
buyer_5,Sara,30,ES23209571107854547123,TRX_N-00113-571946769738,2020-10-01T15:44:09,Donostia,transfer,Salary,3412.57,68970.51
buyer_5,Sara,30,ES23209571107854547123,TRX_N-00114-239765226047,2020-10-01T15:44:09,Donostia,transfer,Partner Salary,3943.03,72913.54
buyer_5,Sara,30,ES23209571107854547123,TRX_N-00115-799071534105,2020-10-05T14:06:14,Donostia,Housing,Mortgage,-501.19,72412.35
buyer_5,Sara,30,ES23209571107854547123,TRX_N-00116-563670888272,2020-10-05T09:33:57,Donostia,Basic services,gas,-83.43,72328.92
buyer_5,Sara,30,ES23209571107854547123,TRX_N-00117-740218513755,2020-10-06T20:48:50,Donostia,Basic services,water,-41.45,72287.47
buyer_5,Sara,30,ES23209571107854547123,TRX_N-00118-738663860577,2020-10-06T14:26:04,Donostia,Basic services,electricity,-24.13,72263.34
buyer_5,Sara,30,ES23209571107854547123,TRX_N-00119-900730765579,2020-10-07T11:41:17,Donostia,Basic services,electricity,-33.07,72230.27
buyer_5,Sara,30,ES23209571107854547123,TRX_N-00120-870084328201,2020-10-07T11:28:02,Donostia,Basic services,gas,-84.96,72145.31
buyer_5,Sara,30,ES23209571107854547123,TRX_N-00121-279290367645,2020-10-07T19:19:02,Donostia,Basic services,internet,-64.55,72080.76
buyer_5,Sara,30,ES23209571107854547123,TRX_N-00122-311692120988,2020-10-07T15:56:41,Donostia,Expense,clothing,-310.42,71770.34
buyer_5,Sara,30,ES23209571107854547123,TRX_N-00123-133155818803,2020-10-14T15:15:05,Donostia,Expense,clothing,-48.27,71722.07
buyer_5,Sara,30,ES23209571107854547123,TRX_N-00124-71413794418,2020-10-15T16:35:05,Donostia,Expense,transport,-131.39,71590.68
buyer_5,Sara,30,ES23209571107854547123,TRX_N-00125-816411765603,2020-11-01T16:57:09,Donostia,transfer,Salary,3412.57,75003.25
buyer_5,Sara,30,ES23209571107854547123,TRX_N-00126-445519936727,2020-11-01T16:57:09,Donostia,transfer,Partner Salary,3943.03,78946.28
buyer_5,Sara,30,ES23209571107854547123,TRX_N-00127-315691219823,2020-11-01T16:57:09,Donostia,transfer,Extra Income,341.26,79287.54
buyer_5,Sara,30,ES23209571107854547123,TRX_N-00128-410617564271,2020-11-05T14:01:44,Donostia,Housing,Mortgage,-501.19,78786.35
buyer_5,Sara,30,ES23209571107854547123,TRX_N-00129-393176713486,2020-11-05T10:13:05,Donostia,Basic services,internet,-52.02,78734.33
buyer_5,Sara,30,ES23209571107854547123,TRX_N-00130-291054739054,2020-11-06T14:59:12,Donostia,Basic services,water,-18.14,78716.19
buyer_5,Sara,30,ES23209571107854547123,TRX_N-00131-928950378573,2020-11-06T05:54:48,Donostia,Basic services,electricity,-66.73,78649.46
buyer_5,Sara,30,ES23209571107854547123,TRX_N-00132-453469249368,2020-11-06T12:28:46,Donostia,Basic services,internet,-55.74,78593.72
buyer_5,Sara,30,ES23209571107854547123,TRX_N-00133-609881187804,2020-11-06T08:15:06,Donostia,Basic services,phone,-24.55,78569.17
buyer_5,Sara,30,ES23209571107854547123,TRX_N-00134-826582214871,2020-11-07T14:34:10,Donostia,Basic services,internet,-42.59,78526.58
buyer_5,Sara,30,ES23209571107854547123,TRX_N-00135-967967644639,2020-11-16T14:50:31,Donostia,Expense,food,-334.48,78192.1
buyer_5,Sara,30,ES23209571107854547123,TRX_N-00136-128770123360,2020-12-01T02:12:54,Donostia,transfer,Salary,3412.57,81604.67
buyer_5,Sara,30,ES23209571107854547123,TRX_N-00137-819613373913,2020-12-01T02:12:54,Donostia,transfer,Partner Salary,3943.03,85547.7
buyer_5,Sara,30,ES23209571107854547123,TRX_N-00138-75242759642,2020-12-01T02:12:54,Donostia,transfer,Bonus,3290.96,88838.66
buyer_5,Sara,30,ES23209571107854547123,TRX_N-00139-465582782023,2020-12-01T15:46:01,Eibar,Expense,leisure,-32.13,88806.53
buyer_5,Sara,30,ES23209571107854547123,TRX_N-00140-938738300044,2020-12-05T12:28:36,Donostia,Housing,Mortgage,-501.19,88305.34
buyer_5,Sara,30,ES23209571107854547123,TRX_N-00141-723322495158,2020-12-05T15:53:58,Donostia,Basic services,water,-51.72,88253.62
buyer_5,Sara,30,ES23209571107854547123,TRX_N-00142-867375001875,2020-12-05T19:06:20,Donostia,Basic services,electricity,-106.46,88147.16
buyer_5,Sara,30,ES23209571107854547123,TRX_N-00143-925264114193,2020-12-05T00:17:20,Donostia,Basic services,phone,-60.62,88086.54
buyer_5,Sara,30,ES23209571107854547123,TRX_N-00144-662186161213,2020-12-05T09:15:11,Donostia,Expense,travel,-1317.1,86769.44
buyer_5,Sara,30,ES23209571107854547123,TRX_N-00145-550521001385,2020-12-06T13:31:08,Donostia,Basic services,water,-75.34,86694.1
buyer_5,Sara,30,ES23209571107854547123,TRX_N-00146-494142219474,2020-12-07T21:10:10,Donostia,Basic services,electricity,-55.75,86638.35
buyer_5,Sara,30,ES23209571107854547123,TRX_N-00147-938120359193,2020-12-07T19:13:53,Donostia,Basic services,gas,-70.24,86568.11
buyer_5,Sara,30,ES23209571107854547123,TRX_N-00148-237674755190,2020-12-07T20:21:35,Donostia,Basic services,internet,-45.25,86522.86
buyer_5,Sara,30,ES23209571107854547123,TRX_N-00149-498871298472,2020-12-18T08:30:15,Santurtzi,Expense,food,-655.37,85867.49
buyer_5,Sara,30,ES23209571107854547123,TRX_N-00150-731622446979,2020-12-19T08:45:16,Donostia,Expense,leisure,-210.19,85657.3
buyer_5,Sara,30,ES23209571107854547123,TRX_N-00151-151072222384,2020-12-24T21:44:30,Sestao,Expense,healthcare,-275.24,85382.06
buyer_5,Sara,30,ES23209571107854547123,TRX_N-00152-693105130259,2020-12-29T14:49:55,Labastida/Bastida,Expense,leisure,-253.12,85128.94
buyer_5,Sara,30,ES23209571107854547123,TRX_N-00153-378826674034,2020-12-30T12:05:34,Donostia,Expense,clothing,-428.06,84700.88
buyer_5,Sara,30,ES23209571107854547123,TRX_N-00154-687425211114,2021-01-01T15:23:12,Donostia,transfer,Salary,3412.57,88113.45
buyer_5,Sara,30,ES23209571107854547123,TRX_N-00155-862639999646,2021-01-01T15:23:12,Donostia,transfer,Partner Salary,3943.03,92056.48
buyer_5,Sara,30,ES23209571107854547123,TRX_N-00156-197861629493,2021-01-05T11:37:26,Donostia,Housing,Mortgage,-501.19,91555.29
buyer_5,Sara,30,ES23209571107854547123,TRX_N-00157-299018032479,2021-01-05T21:34:45,Donostia,Basic services,gas,-81.11,91474.18
buyer_5,Sara,30,ES23209571107854547123,TRX_N-00158-695951746107,2021-01-06T08:25:01,Donostia,Basic services,electricity,-54.07,91420.11
buyer_5,Sara,30,ES23209571107854547123,TRX_N-00159-948630656178,2021-01-07T23:25:30,Donostia,Basic services,phone,-40.72,91379.39
buyer_5,Sara,30,ES23209571107854547123,TRX_N-00160-114922566740,2021-01-13T11:01:31,Donostia,Expense,transport,-165.83,91213.56
buyer_5,Sara,30,ES23209571107854547123,TRX_N-00161-828781524852,2021-01-18T15:53:06,Donostia,Expense,transport,-160.28,91053.28
buyer_5,Sara,30,ES23209571107854547123,TRX_N-00162-135549658285,2021-01-26T15:50:41,Donostia,Expense,leisure,-240.29,90812.99
buyer_5,Sara,30,ES23209571107854547123,TRX_N-00163-119941005187,2021-02-01T20:17:23,Donostia,transfer,Salary,3412.57,94225.56
buyer_5,Sara,30,ES23209571107854547123,TRX_N-00164-952682247002,2021-02-01T20:17:23,Donostia,transfer,Partner Salary,3943.03,98168.59
buyer_5,Sara,30,ES23209571107854547123,TRX_N-00165-744919505283,2021-02-01T20:17:23,Donostia,transfer,Extra Income,341.26,98509.85
buyer_5,Sara,30,ES23209571107854547123,TRX_N-00166-680926186124,2021-02-05T16:13:25,Donostia,Housing,Mortgage,-501.19,98008.66
buyer_5,Sara,30,ES23209571107854547123,TRX_N-00167-619825958309,2021-02-06T10:52:34,Donostia,Basic services,electricity,-144.23,97864.43
buyer_5,Sara,30,ES23209571107854547123,TRX_N-00168-877202661182,2021-02-06T00:06:19,Donostia,Basic services,gas,-51.18,97813.25
buyer_5,Sara,30,ES23209571107854547123,TRX_N-00169-673763820103,2021-02-07T13:00:00,Donostia,Basic services,water,-61.64,97751.61
buyer_5,Sara,30,ES23209571107854547123,TRX_N-00170-520924567070,2021-02-08T12:45:13,Donostia,Expense,leisure,-284.8,97466.81
buyer_5,Sara,30,ES23209571107854547123,TRX_N-00171-605462827629,2021-02-25T19:51:05,Sopela,Expense,healthcare,-292.04,97174.77
buyer_5,Sara,30,ES23209571107854547123,TRX_N-00172-414862659407,2021-02-28T20:03:33,Donostia,Expense,transport,-93.54,97081.23
buyer_5,Sara,30,ES23209571107854547123,TRX_N-00173-891690777512,2021-03-01T13:25:29,Donostia,transfer,Salary,3412.57,100493.8
buyer_5,Sara,30,ES23209571107854547123,TRX_N-00174-369398413240,2021-03-01T13:25:29,Donostia,transfer,Partner Salary,3943.03,104436.83
buyer_5,Sara,30,ES23209571107854547123,TRX_N-00175-669154176324,2021-03-05T09:04:45,Donostia,Housing,Mortgage,-501.19,103935.64
buyer_5,Sara,30,ES23209571107854547123,TRX_N-00176-177619531875,2021-03-05T11:34:26,Donostia,Basic services,water,-45.92,103889.72
buyer_5,Sara,30,ES23209571107854547123,TRX_N-00177-110904171749,2021-03-05T10:08:11,Donostia,Basic services,electricity,-61.21,103828.51
buyer_5,Sara,30,ES23209571107854547123,TRX_N-00178-257819288354,2021-03-05T16:25:53,Donostia,Basic services,internet,-41.67,103786.84
buyer_5,Sara,30,ES23209571107854547123,TRX_N-00179-104365790741,2021-03-07T19:46:41,Donostia,Basic services,gas,-39.3,103747.54
buyer_5,Sara,30,ES23209571107854547123,TRX_N-00180-30694986017,2021-03-18T17:16:11,Donostia,Expense,food,-521.61,103225.93
buyer_5,Sara,30,ES23209571107854547123,TRX_N-00181-65587761904,2021-03-21T18:32:06,Donostia,Expense,repairs,-158.36,103067.57
buyer_5,Sara,30,ES23209571107854547123,TRX_N-00182-163830594665,2021-03-30T11:22:35,Donostia,Expense,repairs,-705.55,102362.02
buyer_5,Sara,30,ES23209571107854547123,TRX_N-00183-920973078376,2021-03-31T14:47:08,Donostia,Expense,clothing,-379.87,101982.15
buyer_5,Sara,30,ES23209571107854547123,TRX_N-00184-821717213926,2021-04-01T12:03:03,Donostia,transfer,Salary,3412.57,105394.72
buyer_5,Sara,30,ES23209571107854547123,TRX_N-00185-21943759104,2021-04-01T12:03:03,Donostia,transfer,Partner Salary,3943.03,109337.75
buyer_5,Sara,30,ES23209571107854547123,TRX_N-00186-779127216057,2021-04-05T11:38:33,Donostia,Housing,Mortgage,-501.19,108836.56
buyer_5,Sara,30,ES23209571107854547123,TRX_N-00187-889840373560,2021-04-05T20:38:36,Donostia,Basic services,internet,-64.14,108772.42
buyer_5,Sara,30,ES23209571107854547123,TRX_N-00188-719400698884,2021-04-06T20:52:32,Donostia,Basic services,gas,-74.05,108698.37
buyer_5,Sara,30,ES23209571107854547123,TRX_N-00189-381464922314,2021-04-07T12:50:50,Donostia,Basic services,phone,-70.3,108628.07
buyer_5,Sara,30,ES23209571107854547123,TRX_N-00190-99899432623,2021-04-21T22:36:20,Getxo,Expense,healthcare,-348.03,108280.04
buyer_5,Sara,30,ES23209571107854547123,TRX_N-00191-657297459664,2021-05-01T09:39:14,Donostia,transfer,Salary,3412.57,111692.61
buyer_5,Sara,30,ES23209571107854547123,TRX_N-00192-822156365226,2021-05-01T09:39:14,Donostia,transfer,Partner Salary,3943.03,115635.64
buyer_5,Sara,30,ES23209571107854547123,TRX_N-00193-924530362197,2021-05-01T09:39:14,Donostia,transfer,Extra Income,341.26,115976.9
buyer_5,Sara,30,ES23209571107854547123,TRX_N-00194-542820109032,2021-05-05T18:13:45,Donostia,Housing,Mortgage,-501.19,115475.71
buyer_5,Sara,30,ES23209571107854547123,TRX_N-00195-587528157802,2021-05-06T14:46:12,Donostia,Basic services,water,-66.45,115409.26
buyer_5,Sara,30,ES23209571107854547123,TRX_N-00196-811329949711,2021-05-06T12:46:07,Donostia,Basic services,electricity,-80.38,115328.88
buyer_5,Sara,30,ES23209571107854547123,TRX_N-00197-129465485470,2021-05-07T23:44:43,Donostia,Basic services,internet,-59.63,115269.25
buyer_5,Sara,30,ES23209571107854547123,TRX_N-00198-724215882247,2021-05-21T08:40:07,Donostia,Expense,leisure,-287.57,114981.68
buyer_5,Sara,30,ES23209571107854547123,TRX_N-00199-10448812795,2021-06-01T14:18:21,Donostia,transfer,Salary,3412.57,118394.25
buyer_5,Sara,30,ES23209571107854547123,TRX_N-00200-341504773838,2021-06-01T14:18:21,Donostia,transfer,Partner Salary,3943.03,122337.28
buyer_5,Sara,30,ES23209571107854547123,TRX_N-00201-332248088187,2021-06-01T14:18:21,Donostia,transfer,Bonus,3437.59,125774.87
buyer_5,Sara,30,ES23209571107854547123,TRX_N-00202-592491789173,2021-06-05T16:18:02,Donostia,Housing,Mortgage,-501.19,125273.68
buyer_5,Sara,30,ES23209571107854547123,TRX_N-00203-362876529647,2021-06-05T14:38:38,Donostia,Basic services,electricity,-26.02,125247.66
buyer_5,Sara,30,ES23209571107854547123,TRX_N-00204-458593557167,2021-06-06T16:59:42,Donostia,Basic services,electricity,-60.88,125186.78
buyer_5,Sara,30,ES23209571107854547123,TRX_N-00205-353907728284,2021-06-06T09:00:46,Donostia,Basic services,gas,-23.08,125163.7
buyer_5,Sara,30,ES23209571107854547123,TRX_N-00206-731444684324,2021-06-06T13:27:54,Donostia,Basic services,phone,-98.44,125065.26
buyer_5,Sara,30,ES23209571107854547123,TRX_N-00207-239855879011,2021-06-07T18:57:49,Donostia,Basic services,gas,-62.3,125002.96
buyer_5,Sara,30,ES23209571107854547123,TRX_N-00208-462806546306,2021-06-11T10:02:33,Donostia,Expense,transport,-79.5,124923.46
buyer_5,Sara,30,ES23209571107854547123,TRX_N-00209-713151428999,2021-06-12T15:13:04,Donostia,Expense,food,-529.07,124394.39
buyer_5,Sara,30,ES23209571107854547123,TRX_N-00210-482781373608,2021-06-14T14:15:39,Donostia,Expense,food,-119.55,124274.84
buyer_5,Sara,30,ES23209571107854547123,TRX_N-00211-48698780049,2021-06-15T14:52:56,Donostia,Expense,leisure,-183.0,124091.84
buyer_5,Sara,30,ES23209571107854547123,TRX_N-00212-17107621293,2021-06-18T11:03:10,Llodio,Expense,transport,-156.34,123935.5
buyer_5,Sara,30,ES23209571107854547123,TRX_N-00213-445031730002,2021-06-26T15:14:53,Alegría-Dulantzi,Expense,clothing,-470.59,123464.91
buyer_5,Sara,30,ES23209571107854547123,TRX_N-00214-13113648572,2021-07-01T13:04:29,Donostia,transfer,Salary,3412.57,126877.48
buyer_5,Sara,30,ES23209571107854547123,TRX_N-00215-942660178833,2021-07-01T13:04:29,Donostia,transfer,Partner Salary,3943.03,130820.51
buyer_5,Sara,30,ES23209571107854547123,TRX_N-00216-104662181500,2021-07-01T13:04:29,Donostia,transfer,Extra Income,341.26,131161.77
buyer_5,Sara,30,ES23209571107854547123,TRX_N-00217-641815654972,2021-07-01T13:39:52,Donostia,Expense,transport,-34.49,131127.28
buyer_5,Sara,30,ES23209571107854547123,TRX_N-00218-831586572895,2021-07-04T14:21:37,Donostia,Expense,food,-715.58,130411.7
buyer_5,Sara,30,ES23209571107854547123,TRX_N-00219-417265920272,2021-07-05T08:50:49,Donostia,Housing,Mortgage,-501.19,129910.51
buyer_5,Sara,30,ES23209571107854547123,TRX_N-00220-680429056651,2021-07-06T14:47:27,Donostia,Basic services,electricity,-115.24,129795.27
buyer_5,Sara,30,ES23209571107854547123,TRX_N-00221-444346901759,2021-07-06T21:42:46,Donostia,Basic services,gas,-61.99,129733.28
buyer_5,Sara,30,ES23209571107854547123,TRX_N-00222-736611621137,2021-07-07T22:55:20,Donostia,Basic services,electricity,-92.83,129640.45
buyer_5,Sara,30,ES23209571107854547123,TRX_N-00223-327534376592,2021-07-18T16:43:10,Donostia,Expense,clothing,-75.71,129564.74
buyer_5,Sara,30,ES23209571107854547123,TRX_N-00224-327303312445,2021-07-20T12:52:07,Galdakao,Expense,transport,-99.77,129464.97
buyer_5,Sara,30,ES23209571107854547123,TRX_N-00225-79638381731,2021-08-01T04:31:14,Donostia,transfer,Salary,3412.57,132877.54
buyer_5,Sara,30,ES23209571107854547123,TRX_N-00226-42285117790,2021-08-01T04:31:14,Donostia,transfer,Partner Salary,3943.03,136820.57
buyer_5,Sara,30,ES23209571107854547123,TRX_N-00227-42272143095,2021-08-05T17:45:25,Donostia,Housing,Mortgage,-501.19,136319.38
buyer_5,Sara,30,ES23209571107854547123,TRX_N-00228-645300786567,2021-08-05T11:13:57,Donostia,Basic services,electricity,-100.02,136219.36
buyer_5,Sara,30,ES23209571107854547123,TRX_N-00229-548679598207,2021-08-05T09:26:20,Donostia,Basic services,gas,-96.27,136123.09
buyer_5,Sara,30,ES23209571107854547123,TRX_N-00230-420624285297,2021-08-06T16:13:52,Donostia,Basic services,gas,-52.63,136070.46
buyer_5,Sara,30,ES23209571107854547123,TRX_N-00231-903033681427,2021-08-07T20:55:48,Donostia,Basic services,water,-78.96,135991.5
buyer_5,Sara,30,ES23209571107854547123,TRX_N-00232-290247182343,2021-08-07T18:15:23,Donostia,Basic services,phone,-39.36,135952.14
buyer_5,Sara,30,ES23209571107854547123,TRX_N-00233-52149629887,2021-08-12T14:51:14,Donostia,Expense,healthcare,-313.78,135638.36
buyer_5,Sara,30,ES23209571107854547123,TRX_N-00234-512792357773,2021-08-13T08:49:24,Donostia,Expense,food,-276.33,135362.03
buyer_5,Sara,30,ES23209571107854547123,TRX_N-00235-750186524334,2021-08-22T12:27:24,Barakaldo,Expense,leisure,-16.36,135345.67
buyer_5,Sara,30,ES23209571107854547123,TRX_N-00236-87887506014,2021-08-31T01:03:44,Donostia,Expense,clothing,-300.03,135045.64
buyer_5,Sara,30,ES23209571107854547123,TRX_N-00237-373954185716,2021-09-01T21:25:40,Donostia,transfer,Salary,3412.57,138458.21
buyer_5,Sara,30,ES23209571107854547123,TRX_N-00238-417519905108,2021-09-01T21:25:40,Donostia,transfer,Partner Salary,3943.03,142401.24
buyer_5,Sara,30,ES23209571107854547123,TRX_N-00239-447590190981,2021-09-02T23:53:58,Donostia,Expense,food,-249.77,142151.47
buyer_5,Sara,30,ES23209571107854547123,TRX_N-00240-273247010187,2021-09-05T10:15:58,Donostia,Housing,Mortgage,-501.19,141650.28
buyer_5,Sara,30,ES23209571107854547123,TRX_N-00241-929958746295,2021-09-05T09:08:15,Donostia,Basic services,water,-63.72,141586.56
buyer_5,Sara,30,ES23209571107854547123,TRX_N-00242-736995265596,2021-09-05T12:45:11,Donostia,Basic services,gas,-48.19,141538.37
buyer_5,Sara,30,ES23209571107854547123,TRX_N-00243-569419411970,2021-09-06T08:49:03,Donostia,Basic services,electricity,-139.49,141398.88
buyer_5,Sara,30,ES23209571107854547123,TRX_N-00244-746613982504,2021-09-06T18:53:32,Donostia,Basic services,internet,-38.8,141360.08
buyer_5,Sara,30,ES23209571107854547123,TRX_N-00245-469666715663,2021-09-07T20:45:37,Donostia,Basic services,electricity,-60.95,141299.13
buyer_5,Sara,30,ES23209571107854547123,TRX_N-00246-449701391350,2021-09-07T21:14:29,Donostia,Basic services,gas,-18.09,141281.04
buyer_5,Sara,30,ES23209571107854547123,TRX_N-00247-198575835496,2021-09-19T11:16:16,Donostia,Expense,food,-217.75,141063.29
buyer_5,Sara,30,ES23209571107854547123,TRX_N-00248-34275484914,2021-09-20T16:25:44,Donostia,Expense,clothing,-93.82,140969.47
buyer_5,Sara,30,ES23209571107854547123,TRX_N-00249-885514119674,2021-09-27T10:52:49,Leioa,Expense,education,-246.13,140723.34
buyer_5,Sara,30,ES23209571107854547123,TRX_N-00250-752759582527,2021-10-01T09:11:01,Donostia,transfer,Salary,3412.57,144135.91
buyer_5,Sara,30,ES23209571107854547123,TRX_N-00251-960270427251,2021-10-01T09:11:01,Donostia,transfer,Partner Salary,3943.03,148078.94
buyer_5,Sara,30,ES23209571107854547123,TRX_N-00252-696225952619,2021-10-01T09:11:01,Donostia,transfer,Extra Income,341.26,148420.2
buyer_5,Sara,30,ES23209571107854547123,TRX_N-00253-703275677031,2021-10-05T14:51:21,Donostia,Housing,Mortgage,-501.19,147919.01
buyer_5,Sara,30,ES23209571107854547123,TRX_N-00254-942641452988,2021-10-06T19:45:50,Donostia,Basic services,electricity,-36.76,147882.25
buyer_5,Sara,30,ES23209571107854547123,TRX_N-00255-708628662605,2021-10-06T16:07:14,Donostia,Basic services,internet,-51.77,147830.48
buyer_5,Sara,30,ES23209571107854547123,TRX_N-00256-43733354618,2021-10-07T22:21:49,Donostia,Basic services,gas,-85.09,147745.39
buyer_5,Sara,30,ES23209571107854547123,TRX_N-00257-110122236357,2021-10-07T14:01:22,Donostia,Basic services,internet,-73.25,147672.14
buyer_5,Sara,30,ES23209571107854547123,TRX_N-00258-443768233963,2021-10-07T17:40:48,Donostia,Basic services,phone,-91.4,147580.74
buyer_5,Sara,30,ES23209571107854547123,TRX_N-00259-112228126536,2021-10-11T09:21:03,Donostia,Expense,food,-156.08,147424.66
buyer_5,Sara,30,ES23209571107854547123,TRX_N-00260-646596137832,2021-10-14T22:32:01,Donostia,Expense,repairs,-105.6,147319.06
buyer_5,Sara,30,ES23209571107854547123,TRX_N-00261-321598169579,2021-10-25T10:38:56,Donostia,Expense,transport,-81.72,147237.34
buyer_5,Sara,30,ES23209571107854547123,TRX_N-00262-640090560392,2021-11-01T09:45:09,Donostia,transfer,Salary,3412.57,150649.91
buyer_5,Sara,30,ES23209571107854547123,TRX_N-00263-536547862393,2021-11-01T09:45:09,Donostia,transfer,Partner Salary,3943.03,154592.94
buyer_5,Sara,30,ES23209571107854547123,TRX_N-00264-957803170234,2021-11-03T10:27:29,Donostia,Expense,education,-609.47,153983.47
buyer_5,Sara,30,ES23209571107854547123,TRX_N-00265-58320145877,2021-11-05T20:06:49,Donostia,Housing,Mortgage,-501.19,153482.28
buyer_5,Sara,30,ES23209571107854547123,TRX_N-00266-873581853455,2021-11-05T16:11:18,Donostia,Basic services,internet,-36.38,153445.9
buyer_5,Sara,30,ES23209571107854547123,TRX_N-00267-108172938948,2021-11-05T11:17:00,Donostia,Basic services,phone,-91.31,153354.59
buyer_5,Sara,30,ES23209571107854547123,TRX_N-00268-350007262272,2021-11-05T20:52:54,Donostia,Expense,leisure,-67.59,153287.0
buyer_5,Sara,30,ES23209571107854547123,TRX_N-00269-661540438293,2021-11-06T14:15:16,Donostia,Basic services,electricity,-44.43,153242.57
buyer_5,Sara,30,ES23209571107854547123,TRX_N-00270-487281076823,2021-11-06T10:28:31,Donostia,Basic services,phone,-69.21,153173.36
buyer_5,Sara,30,ES23209571107854547123,TRX_N-00271-249180175818,2021-11-07T15:12:25,Donostia,Basic services,gas,-84.01,153089.35
buyer_5,Sara,30,ES23209571107854547123,TRX_N-00272-359163935288,2021-11-13T22:48:32,Getxo,Expense,transport,-68.84,153020.51
buyer_5,Sara,30,ES23209571107854547123,TRX_N-00273-191447588624,2021-11-26T12:22:08,Donostia,Expense,food,-557.92,152462.59
buyer_5,Sara,30,ES23209571107854547123,TRX_N-00274-139768359291,2021-12-01T19:19:29,Donostia,transfer,Salary,3412.57,155875.16
buyer_5,Sara,30,ES23209571107854547123,TRX_N-00275-847993231983,2021-12-01T19:19:29,Donostia,transfer,Partner Salary,3943.03,159818.19
buyer_5,Sara,30,ES23209571107854547123,TRX_N-00276-163173973443,2021-12-01T19:19:29,Donostia,transfer,Extra Income,341.26,160159.45
buyer_5,Sara,30,ES23209571107854547123,TRX_N-00277-443983802600,2021-12-01T19:19:29,Donostia,transfer,Bonus,3610.07,163769.52
buyer_5,Sara,30,ES23209571107854547123,TRX_N-00278-886268309858,2021-12-05T05:54:24,Donostia,Housing,Mortgage,-501.19,163268.33
buyer_5,Sara,30,ES23209571107854547123,TRX_N-00279-791742530676,2021-12-05T07:46:17,Donostia,Basic services,phone,-34.83,163233.5
buyer_5,Sara,30,ES23209571107854547123,TRX_N-00280-943585177553,2021-12-06T12:37:54,Donostia,Basic services,internet,-75.56,163157.94
buyer_5,Sara,30,ES23209571107854547123,TRX_N-00281-354456068733,2021-12-08T19:12:23,Donostia,Expense,transport,-165.74,162992.2
buyer_5,Sara,30,ES23209571107854547123,TRX_N-00282-579590495402,2021-12-14T19:24:20,Donostia,Expense,leisure,-66.23,162925.97
buyer_5,Sara,30,ES23209571107854547123,TRX_N-00283-405633832198,2021-12-14T15:24:31,Donostia,Expense,repairs,-654.49,162271.48
buyer_5,Sara,30,ES23209571107854547123,TRX_N-00284-941565222698,2022-01-01T04:53:58,Donostia,transfer,Salary,3412.57,165684.05
buyer_5,Sara,30,ES23209571107854547123,TRX_N-00285-794505014127,2022-01-01T04:53:58,Donostia,transfer,Partner Salary,3943.03,169627.08
buyer_5,Sara,30,ES23209571107854547123,TRX_N-00286-174220715735,2022-01-03T17:28:25,Donostia,Expense,transport,-53.08,169574.0
buyer_5,Sara,30,ES23209571107854547123,TRX_N-00287-225902389543,2022-01-05T15:04:56,Donostia,Housing,Mortgage,-501.19,169072.81
buyer_5,Sara,30,ES23209571107854547123,TRX_N-00288-821068940346,2022-01-05T13:03:26,Donostia,Basic services,internet,-70.41,169002.4
buyer_5,Sara,30,ES23209571107854547123,TRX_N-00289-708969761099,2022-01-06T10:09:14,Donostia,Basic services,water,-25.92,168976.48
buyer_5,Sara,30,ES23209571107854547123,TRX_N-00290-382424633792,2022-01-06T15:33:50,Donostia,Expense,healthcare,-98.23,168878.25
buyer_5,Sara,30,ES23209571107854547123,TRX_N-00291-792949784792,2022-01-19T03:47:40,Donostia,Expense,food,-455.96,168422.29
buyer_5,Sara,30,ES23209571107854547123,TRX_N-00292-424694027893,2022-01-24T11:07:18,Donostia,Expense,transport,-82.03,168340.26
buyer_5,Sara,30,ES23209571107854547123,TRX_N-00293-701937776646,2022-02-01T18:57:54,Donostia,transfer,Salary,3412.57,171752.83
buyer_5,Sara,30,ES23209571107854547123,TRX_N-00294-254798955342,2022-02-01T18:57:54,Donostia,transfer,Partner Salary,3943.03,175695.86
buyer_5,Sara,30,ES23209571107854547123,TRX_N-00295-606461894597,2022-02-01T18:57:54,Donostia,transfer,Extra Income,341.26,176037.12
buyer_5,Sara,30,ES23209571107854547123,TRX_N-00296-289883844613,2022-02-05T06:13:08,Donostia,Housing,Mortgage,-501.19,175535.93
buyer_5,Sara,30,ES23209571107854547123,TRX_N-00297-112403591779,2022-02-05T08:50:32,Donostia,Basic services,gas,-85.96,175449.97
buyer_5,Sara,30,ES23209571107854547123,TRX_N-00298-609063231392,2022-02-05T15:25:40,Donostia,Basic services,internet,-32.72,175417.25
buyer_5,Sara,30,ES23209571107854547123,TRX_N-00299-486876771364,2022-02-06T09:49:52,Donostia,Basic services,phone,-70.11,175347.14
buyer_5,Sara,30,ES23209571107854547123,TRX_N-00300-296925097958,2022-02-07T09:23:46,Donostia,Basic services,water,-22.65,175324.49
buyer_5,Sara,30,ES23209571107854547123,TRX_N-00301-523402457180,2022-02-07T15:47:47,Donostia,Basic services,electricity,-134.53,175189.96
buyer_5,Sara,30,ES23209571107854547123,TRX_N-00302-447886096491,2022-02-07T05:37:15,Donostia,Basic services,gas,-36.93,175153.03
buyer_5,Sara,30,ES23209571107854547123,TRX_N-00303-509748187873,2022-02-07T21:19:35,Donostia,Basic services,internet,-60.57,175092.46
buyer_5,Sara,30,ES23209571107854547123,TRX_N-00304-335457315428,2022-02-09T19:52:04,Leioa,Expense,leisure,-294.92,174797.54
buyer_5,Sara,30,ES23209571107854547123,TRX_N-00305-548837983737,2022-02-12T12:09:24,Donostia,Expense,food,-343.3,174454.24
buyer_5,Sara,30,ES23209571107854547123,TRX_N-00306-254428431741,2022-03-01T14:12:26,Donostia,transfer,Salary,3412.57,177866.81
buyer_5,Sara,30,ES23209571107854547123,TRX_N-00307-501353132824,2022-03-01T14:12:26,Donostia,transfer,Partner Salary,3943.03,181809.84
buyer_5,Sara,30,ES23209571107854547123,TRX_N-00308-779003961328,2022-03-02T12:25:07,Donostia,Expense,leisure,-238.5,181571.34
buyer_5,Sara,30,ES23209571107854547123,TRX_N-00309-389471694402,2022-03-05T20:55:22,Donostia,Housing,Mortgage,-501.19,181070.15
buyer_5,Sara,30,ES23209571107854547123,TRX_N-00310-110270020683,2022-03-06T12:48:46,Donostia,Basic services,water,-65.96,181004.19
buyer_5,Sara,30,ES23209571107854547123,TRX_N-00311-972198458707,2022-03-06T20:00:28,Donostia,Basic services,internet,-75.2,180928.99
buyer_5,Sara,30,ES23209571107854547123,TRX_N-00312-362932600663,2022-03-07T09:55:21,Donostia,Basic services,phone,-38.54,180890.45
buyer_5,Sara,30,ES23209571107854547123,TRX_N-00313-231752535890,2022-03-26T07:31:31,Berango,Expense,transport,-41.46,180848.99
buyer_5,Sara,30,ES23209571107854547123,TRX_N-00314-626923446057,2022-04-01T20:10:52,Donostia,transfer,Salary,3412.57,184261.56
buyer_5,Sara,30,ES23209571107854547123,TRX_N-00315-862366288134,2022-04-01T20:10:52,Donostia,transfer,Partner Salary,3943.03,188204.59
buyer_5,Sara,30,ES23209571107854547123,TRX_N-00316-824384359361,2022-04-01T20:10:52,Donostia,transfer,Extra Income,341.26,188545.85
buyer_5,Sara,30,ES23209571107854547123,TRX_N-00317-827057578355,2022-04-01T22:43:36,Donostia,Expense,education,-145.7,188400.15
buyer_5,Sara,30,ES23209571107854547123,TRX_N-00318-848290740101,2022-04-05T10:12:30,Donostia,Housing,Mortgage,-501.19,187898.96
buyer_5,Sara,30,ES23209571107854547123,TRX_N-00319-654633413794,2022-04-05T16:48:11,Donostia,Basic services,water,-25.08,187873.88
buyer_5,Sara,30,ES23209571107854547123,TRX_N-00320-352855026709,2022-04-05T19:04:07,Donostia,Basic services,electricity,-80.17,187793.71
buyer_5,Sara,30,ES23209571107854547123,TRX_N-00321-512633903152,2022-04-05T19:34:12,Donostia,Basic services,gas,-39.9,187753.81
buyer_5,Sara,30,ES23209571107854547123,TRX_N-00322-353753068017,2022-04-05T04:21:46,Donostia,Basic services,phone,-56.47,187697.34
buyer_5,Sara,30,ES23209571107854547123,TRX_N-00323-16799633035,2022-04-06T09:49:11,Donostia,Basic services,water,-46.74,187650.6
buyer_5,Sara,30,ES23209571107854547123,TRX_N-00324-956391650540,2022-04-07T12:11:01,Donostia,Basic services,water,-37.0,187613.6
buyer_5,Sara,30,ES23209571107854547123,TRX_N-00325-27730276570,2022-04-07T08:47:10,Donostia,Basic services,gas,-46.15,187567.45
buyer_5,Sara,30,ES23209571107854547123,TRX_N-00326-234189710529,2022-04-15T16:09:29,Donostia,Expense,transport,-163.05,187404.4
buyer_5,Sara,30,ES23209571107854547123,TRX_N-00327-286351913939,2022-04-22T19:03:52,Donostia,Expense,leisure,-108.95,187295.45
buyer_5,Sara,30,ES23209571107854547123,TRX_N-00328-80416617257,2022-04-28T21:17:59,Donostia,Expense,transport,-39.82,187255.63
buyer_5,Sara,30,ES23209571107854547123,TRX_N-00329-127268454472,2022-05-01T00:43:53,Donostia,transfer,Salary,3412.57,190668.2
buyer_5,Sara,30,ES23209571107854547123,TRX_N-00330-990767214392,2022-05-01T00:43:53,Donostia,transfer,Partner Salary,3943.03,194611.23
buyer_5,Sara,30,ES23209571107854547123,TRX_N-00331-648842996324,2022-05-05T21:08:32,Donostia,Housing,Mortgage,-501.19,194110.04
buyer_5,Sara,30,ES23209571107854547123,TRX_N-00332-999516299894,2022-05-05T10:21:10,Donostia,Basic services,water,-44.5,194065.54
buyer_5,Sara,30,ES23209571107854547123,TRX_N-00333-691914031511,2022-05-05T18:27:26,Donostia,Basic services,electricity,-84.73,193980.81
buyer_5,Sara,30,ES23209571107854547123,TRX_N-00334-252159125199,2022-05-06T08:14:39,Donostia,Basic services,internet,-65.43,193915.38
buyer_5,Sara,30,ES23209571107854547123,TRX_N-00335-64884024788,2022-05-06T14:27:08,Donostia,Basic services,phone,-63.57,193851.81
buyer_5,Sara,30,ES23209571107854547123,TRX_N-00336-334352578414,2022-05-06T11:22:58,Donostia,Expense,healthcare,-27.28,193824.53
buyer_5,Sara,30,ES23209571107854547123,TRX_N-00337-384382929632,2022-06-01T16:19:33,Donostia,transfer,Salary,3412.57,197237.1
buyer_5,Sara,30,ES23209571107854547123,TRX_N-00338-118879305756,2022-06-01T16:19:33,Donostia,transfer,Partner Salary,3943.03,201180.13
buyer_5,Sara,30,ES23209571107854547123,TRX_N-00339-197099181357,2022-06-01T16:19:33,Donostia,transfer,Bonus,3202.94,204383.07
buyer_5,Sara,30,ES23209571107854547123,TRX_N-00340-26570537420,2022-06-04T21:41:00,Errenteria,Expense,food,-612.04,203771.03
buyer_5,Sara,30,ES23209571107854547123,TRX_N-00341-41116242386,2022-06-05T14:49:31,Donostia,Housing,Mortgage,-501.19,203269.84
buyer_5,Sara,30,ES23209571107854547123,TRX_N-00342-208577111585,2022-06-05T18:17:58,Donostia,Basic services,internet,-33.37,203236.47
buyer_5,Sara,30,ES23209571107854547123,TRX_N-00343-223961914081,2022-06-06T19:11:26,Donostia,Basic services,internet,-49.45,203187.02
buyer_5,Sara,30,ES23209571107854547123,TRX_N-00344-586008020901,2022-06-24T08:15:14,Donostia,Expense,repairs,-774.87,202412.15
buyer_5,Sara,30,ES23209571107854547123,TRX_N-00345-100241939007,2022-06-26T11:55:39,Donostia,Expense,leisure,-87.72,202324.43
buyer_5,Sara,30,ES23209571107854547123,TRX_N-00346-66070831065,2022-07-01T20:58:41,Donostia,transfer,Salary,3412.57,205737.0
buyer_5,Sara,30,ES23209571107854547123,TRX_N-00347-577530316767,2022-07-01T20:58:41,Donostia,transfer,Partner Salary,3943.03,209680.03
buyer_5,Sara,30,ES23209571107854547123,TRX_N-00348-526354771148,2022-07-01T20:58:41,Donostia,transfer,Extra Income,341.26,210021.29
buyer_5,Sara,30,ES23209571107854547123,TRX_N-00349-241452456841,2022-07-01T08:43:49,Donostia,Expense,transport,-100.23,209921.06
buyer_5,Sara,30,ES23209571107854547123,TRX_N-00350-562173472400,2022-07-05T13:26:53,Donostia,Housing,Mortgage,-501.19,209419.87
buyer_5,Sara,30,ES23209571107854547123,TRX_N-00351-166475986443,2022-07-05T09:51:04,Donostia,Basic services,electricity,-45.12,209374.75
buyer_5,Sara,30,ES23209571107854547123,TRX_N-00352-7408459810,2022-07-06T12:36:55,Donostia,Basic services,water,-33.22,209341.53
buyer_5,Sara,30,ES23209571107854547123,TRX_N-00353-36560468077,2022-07-07T19:49:06,Donostia,Basic services,electricity,-139.13,209202.4
buyer_5,Sara,30,ES23209571107854547123,TRX_N-00354-886114053317,2022-07-07T10:08:19,Donostia,Basic services,gas,-84.74,209117.66
buyer_5,Sara,30,ES23209571107854547123,TRX_N-00355-117551303923,2022-07-14T18:01:00,Donostia,Expense,food,-273.0,208844.66
buyer_5,Sara,30,ES23209571107854547123,TRX_N-00356-343856113496,2022-07-18T13:56:39,Hondarribia,Expense,transport,-99.36,208745.3
buyer_5,Sara,30,ES23209571107854547123,TRX_N-00357-65604939743,2022-08-01T18:14:32,Donostia,transfer,Salary,3412.57,212157.87
buyer_5,Sara,30,ES23209571107854547123,TRX_N-00358-471693674443,2022-08-01T18:14:32,Donostia,transfer,Partner Salary,3943.03,216100.9
buyer_5,Sara,30,ES23209571107854547123,TRX_N-00359-806601329063,2022-08-05T11:10:39,Donostia,Housing,Mortgage,-501.19,215599.71
buyer_5,Sara,30,ES23209571107854547123,TRX_N-00360-724126073426,2022-08-05T19:18:46,Donostia,Basic services,electricity,-109.1,215490.61
buyer_5,Sara,30,ES23209571107854547123,TRX_N-00361-249443093486,2022-08-05T18:46:28,Donostia,Basic services,gas,-23.63,215466.98
buyer_5,Sara,30,ES23209571107854547123,TRX_N-00362-850510173503,2022-08-05T13:13:54,Donostia,Basic services,internet,-33.54,215433.44
buyer_5,Sara,30,ES23209571107854547123,TRX_N-00363-644493321129,2022-08-05T17:07:22,Donostia,Basic services,phone,-83.64,215349.8
buyer_5,Sara,30,ES23209571107854547123,TRX_N-00364-794957724211,2022-08-06T12:56:21,Donostia,Basic services,electricity,-67.89,215281.91
buyer_5,Sara,30,ES23209571107854547123,TRX_N-00365-292756816255,2022-08-06T18:45:27,Donostia,Expense,leisure,-84.5,215197.41
buyer_5,Sara,30,ES23209571107854547123,TRX_N-00366-971126283398,2022-08-07T21:30:05,Donostia,Basic services,electricity,-135.02,215062.39
buyer_5,Sara,30,ES23209571107854547123,TRX_N-00367-102046897547,2022-08-07T11:52:13,Donostia,Basic services,internet,-31.6,215030.79
buyer_5,Sara,30,ES23209571107854547123,TRX_N-00368-290808345137,2022-08-07T10:56:16,Donostia,Basic services,phone,-76.78,214954.01
buyer_5,Sara,30,ES23209571107854547123,TRX_N-00369-549026775216,2022-08-17T13:04:51,Donostia,Expense,transport,-173.23,214780.78
buyer_5,Sara,30,ES23209571107854547123,TRX_N-00370-385359992171,2022-08-17T20:29:58,Irun,Expense,leisure,-78.75,214702.03
buyer_5,Sara,30,ES23209571107854547123,TRX_N-00371-303295972109,2022-08-18T19:37:41,Andoain,Expense,transport,-96.68,214605.35
buyer_5,Sara,30,ES23209571107854547123,TRX_N-00372-564770868371,2022-08-20T08:44:13,Donostia,Expense,clothing,-68.29,214537.06
buyer_5,Sara,30,ES23209571107854547123,TRX_N-00373-934231645663,2022-09-01T19:43:23,Donostia,transfer,Salary,3412.57,217949.63
buyer_5,Sara,30,ES23209571107854547123,TRX_N-00374-482325041348,2022-09-01T19:43:23,Donostia,transfer,Partner Salary,3943.03,221892.66
buyer_5,Sara,30,ES23209571107854547123,TRX_N-00375-684178720167,2022-09-01T19:43:23,Donostia,transfer,Extra Income,341.26,222233.92
buyer_5,Sara,30,ES23209571107854547123,TRX_N-00376-90944591239,2022-09-05T17:05:12,Donostia,Housing,Mortgage,-501.19,221732.73
buyer_5,Sara,30,ES23209571107854547123,TRX_N-00377-328527976271,2022-09-05T18:21:17,Donostia,Basic services,water,-19.31,221713.42
buyer_5,Sara,30,ES23209571107854547123,TRX_N-00378-529630287961,2022-09-05T12:42:50,Donostia,Basic services,electricity,-108.41,221605.01
buyer_5,Sara,30,ES23209571107854547123,TRX_N-00379-351939451348,2022-09-06T15:55:56,Donostia,Basic services,water,-48.63,221556.38
buyer_5,Sara,30,ES23209571107854547123,TRX_N-00380-154456480287,2022-09-06T22:11:25,Donostia,Basic services,gas,-64.68,221491.7
buyer_5,Sara,30,ES23209571107854547123,TRX_N-00381-706922766826,2022-09-06T14:05:51,Donostia,Basic services,phone,-28.25,221463.45
buyer_5,Sara,30,ES23209571107854547123,TRX_N-00382-799618709516,2022-09-11T10:18:28,Donostia,Expense,education,-265.15,221198.3
buyer_5,Sara,30,ES23209571107854547123,TRX_N-00383-402894468598,2022-09-24T16:38:03,Donostia,Expense,appliances,-371.39,220826.91
buyer_5,Sara,30,ES23209571107854547123,TRX_N-00384-627643835760,2022-10-01T19:04:33,Donostia,transfer,Salary,3412.57,224239.48
buyer_5,Sara,30,ES23209571107854547123,TRX_N-00385-73138413452,2022-10-01T19:04:33,Donostia,transfer,Partner Salary,3943.03,228182.51
buyer_5,Sara,30,ES23209571107854547123,TRX_N-00386-977985153008,2022-10-01T13:20:49,Donostia,Expense,leisure,-136.57,228045.94
buyer_5,Sara,30,ES23209571107854547123,TRX_N-00387-548100401738,2022-10-05T09:14:11,Donostia,Housing,Mortgage,-501.19,227544.75
buyer_5,Sara,30,ES23209571107854547123,TRX_N-00388-453747135954,2022-10-05T21:36:45,Donostia,Expense,travel,-2507.89,225036.86
buyer_5,Sara,30,ES23209571107854547123,TRX_N-00389-238198252805,2022-10-06T09:26:30,Donostia,Basic services,water,-36.64,225000.22
buyer_5,Sara,30,ES23209571107854547123,TRX_N-00390-440031161896,2022-10-06T10:39:02,Donostia,Basic services,phone,-92.99,224907.23
buyer_5,Sara,30,ES23209571107854547123,TRX_N-00391-21049585408,2022-10-07T13:56:57,Donostia,Basic services,electricity,-106.54,224800.69
buyer_5,Sara,30,ES23209571107854547123,TRX_N-00392-171696683347,2022-10-07T20:16:31,Donostia,Basic services,gas,-50.71,224749.98
buyer_5,Sara,30,ES23209571107854547123,TRX_N-00393-980919755904,2022-10-07T08:07:50,Donostia,Basic services,internet,-44.28,224705.7
buyer_5,Sara,30,ES23209571107854547123,TRX_N-00394-654424933043,2022-10-07T15:06:48,Donostia,Basic services,phone,-73.94,224631.76
buyer_5,Sara,30,ES23209571107854547123,TRX_N-00395-320209832212,2022-10-08T12:52:59,Santurtzi,Expense,appliances,-1973.14,222658.62
buyer_5,Sara,30,ES23209571107854547123,TRX_N-00396-972063351091,2022-10-17T18:40:39,Donostia,Expense,food,-663.49,221995.13
buyer_5,Sara,30,ES23209571107854547123,TRX_N-00397-919073523693,2022-10-18T08:42:47,Salvatierra/Agurain,Expense,transport,-187.45,221807.68
buyer_5,Sara,30,ES23209571107854547123,TRX_N-00398-173615172271,2022-10-24T13:02:59,Donostia,Expense,healthcare,-255.88,221551.8
buyer_5,Sara,30,ES23209571107854547123,TRX_N-00399-756716187362,2022-10-25T05:06:00,Donostia,Expense,clothing,-320.98,221230.82
buyer_5,Sara,30,ES23209571107854547123,TRX_N-00400-887966695568,2022-10-30T12:55:11,Donostia,Expense,clothing,-285.68,220945.14
buyer_5,Sara,30,ES23209571107854547123,TRX_N-00401-712140635128,2022-11-01T17:12:31,Donostia,transfer,Salary,3412.57,224357.71
buyer_5,Sara,30,ES23209571107854547123,TRX_N-00402-840669319615,2022-11-01T17:12:31,Donostia,transfer,Partner Salary,3943.03,228300.74
buyer_5,Sara,30,ES23209571107854547123,TRX_N-00403-17875563079,2022-11-01T17:12:31,Donostia,transfer,Extra Income,341.26,228642.0
buyer_5,Sara,30,ES23209571107854547123,TRX_N-00404-704324493165,2022-11-05T07:36:58,Donostia,Housing,Mortgage,-501.19,228140.81
buyer_5,Sara,30,ES23209571107854547123,TRX_N-00405-466178824911,2022-11-05T08:02:58,Donostia,Basic services,gas,-55.41,228085.4
buyer_5,Sara,30,ES23209571107854547123,TRX_N-00406-124714179980,2022-11-06T11:07:50,Donostia,Basic services,electricity,-77.86,228007.54
buyer_5,Sara,30,ES23209571107854547123,TRX_N-00407-360753657575,2022-11-07T16:01:45,Donostia,Basic services,electricity,-70.53,227937.01
buyer_5,Sara,30,ES23209571107854547123,TRX_N-00408-911210787175,2022-11-21T09:27:03,Donostia,Expense,transport,-117.49,227819.52
buyer_5,Sara,30,ES23209571107854547123,TRX_N-00409-772545794762,2022-11-23T12:00:41,Donostia,Expense,leisure,-150.65,227668.87
buyer_5,Sara,30,ES23209571107854547123,TRX_N-00410-244194814229,2022-11-27T04:26:03,Donostia,Expense,food,-552.36,227116.51
buyer_5,Sara,30,ES23209571107854547123,TRX_N-00411-484139333815,2022-11-28T13:53:40,Donostia,Expense,clothing,-295.62,226820.89
buyer_5,Sara,30,ES23209571107854547123,TRX_N-00412-987106356866,2022-11-28T13:46:08,Donostia,Expense,healthcare,-283.59,226537.3
buyer_5,Sara,30,ES23209571107854547123,TRX_N-00413-333441413131,2022-12-01T19:31:45,Donostia,transfer,Salary,3412.57,229949.87
buyer_5,Sara,30,ES23209571107854547123,TRX_N-00414-907746190828,2022-12-01T19:31:45,Donostia,transfer,Partner Salary,3943.03,233892.9
buyer_5,Sara,30,ES23209571107854547123,TRX_N-00415-896706848980,2022-12-01T19:31:45,Donostia,transfer,Bonus,3356.43,237249.33
buyer_5,Sara,30,ES23209571107854547123,TRX_N-00416-516560385311,2022-12-05T14:02:15,Donostia,Housing,Mortgage,-501.19,236748.14
buyer_5,Sara,30,ES23209571107854547123,TRX_N-00417-36004843652,2022-12-05T14:59:22,Donostia,Basic services,gas,-63.46,236684.68
buyer_5,Sara,30,ES23209571107854547123,TRX_N-00418-378358532885,2022-12-05T13:00:36,Donostia,Basic services,phone,-27.46,236657.22
buyer_5,Sara,30,ES23209571107854547123,TRX_N-00419-749173240775,2022-12-06T18:48:33,Donostia,Basic services,water,-28.61,236628.61
buyer_5,Sara,30,ES23209571107854547123,TRX_N-00420-763010159591,2022-12-06T21:20:08,Donostia,Basic services,phone,-63.12,236565.49
buyer_5,Sara,30,ES23209571107854547123,TRX_N-00421-958256489196,2022-12-07T15:01:09,Donostia,Basic services,gas,-23.71,236541.78
buyer_5,Sara,30,ES23209571107854547123,TRX_N-00422-870465479907,2022-12-07T01:48:57,Donostia,Expense,healthcare,-345.45,236196.33
buyer_5,Sara,30,ES23209571107854547123,TRX_N-00423-14953407379,2022-12-09T19:54:12,Donostia,Expense,gifts,-434.69,235761.64
buyer_5,Sara,30,ES23209571107854547123,TRX_N-00424-48580061074,2022-12-19T00:08:15,Getxo,Expense,transport,-20.33,235741.31
buyer_5,Sara,30,ES23209571107854547123,TRX_N-00425-80167903175,2022-12-23T09:21:03,Donostia,Expense,education,-209.15,235532.16
buyer_5,Sara,30,ES23209571107854547123,TRX_N-00426-254233647329,2022-12-27T15:27:45,Donostia,Expense,transport,-20.82,235511.34
buyer_5,Sara,30,ES23209571107854547123,TRX_N-00427-588047259316,2022-12-31T09:46:02,Donostia,Expense,healthcare,-25.03,235486.31
buyer_5,Sara,30,ES23209571107854547123,TRX_N-00428-549333368825,2023-01-01T12:24:04,Donostia,transfer,Salary,3412.57,238898.88
buyer_5,Sara,30,ES23209571107854547123,TRX_N-00429-984487301828,2023-01-01T12:24:04,Donostia,transfer,Partner Salary,3943.03,242841.91
buyer_5,Sara,30,ES23209571107854547123,TRX_N-00430-491930619104,2023-01-01T12:24:04,Donostia,transfer,Extra Income,341.26,243183.17
buyer_5,Sara,30,ES23209571107854547123,TRX_N-00431-243309249770,2023-01-05T08:42:43,Donostia,Housing,Mortgage,-501.19,242681.98
buyer_5,Sara,30,ES23209571107854547123,TRX_N-00432-903489435569,2023-01-05T20:56:39,Donostia,Basic services,water,-74.62,242607.36
buyer_5,Sara,30,ES23209571107854547123,TRX_N-00433-203068573083,2023-01-05T22:36:37,Donostia,Basic services,electricity,-46.57,242560.79
buyer_5,Sara,30,ES23209571107854547123,TRX_N-00434-755121348330,2023-01-05T18:13:54,Donostia,Basic services,gas,-37.65,242523.14
buyer_5,Sara,30,ES23209571107854547123,TRX_N-00435-88688485528,2023-01-07T18:48:57,Donostia,Basic services,gas,-50.72,242472.42
buyer_5,Sara,30,ES23209571107854547123,TRX_N-00436-49165533272,2023-01-07T12:43:40,Donostia,Basic services,internet,-34.45,242437.97
buyer_5,Sara,30,ES23209571107854547123,TRX_N-00437-912332348936,2023-01-17T17:13:33,Donostia,Expense,transport,-96.35,242341.62
buyer_5,Sara,30,ES23209571107854547123,TRX_N-00438-321966230596,2023-02-01T10:04:30,Donostia,transfer,Salary,3412.57,245754.19
buyer_5,Sara,30,ES23209571107854547123,TRX_N-00439-758413296040,2023-02-01T10:04:30,Donostia,transfer,Partner Salary,3943.03,249697.22
buyer_5,Sara,30,ES23209571107854547123,TRX_N-00440-632424232596,2023-02-05T20:33:48,Donostia,Housing,Mortgage,-501.19,249196.03
buyer_5,Sara,30,ES23209571107854547123,TRX_N-00441-27420747469,2023-02-05T09:47:38,Donostia,Basic services,electricity,-64.53,249131.5
buyer_5,Sara,30,ES23209571107854547123,TRX_N-00442-631013677328,2023-02-05T10:00:17,Donostia,Basic services,internet,-31.25,249100.25
buyer_5,Sara,30,ES23209571107854547123,TRX_N-00443-656807850756,2023-02-05T23:11:28,Donostia,Basic services,phone,-67.09,249033.16
buyer_5,Sara,30,ES23209571107854547123,TRX_N-00444-354853487116,2023-02-06T17:42:09,Donostia,Basic services,electricity,-91.79,248941.37
buyer_5,Sara,30,ES23209571107854547123,TRX_N-00445-127640407570,2023-02-06T12:05:49,Donostia,Basic services,gas,-69.85,248871.52
buyer_5,Sara,30,ES23209571107854547123,TRX_N-00446-289596270572,2023-02-07T14:22:56,Donostia,Basic services,gas,-55.79,248815.73
buyer_5,Sara,30,ES23209571107854547123,TRX_N-00447-159478167275,2023-02-07T16:54:45,Donostia,Expense,leisure,-165.27,248650.46
buyer_5,Sara,30,ES23209571107854547123,TRX_N-00448-495944332418,2023-02-09T15:27:25,Donostia,Expense,transport,-23.42,248627.04
buyer_5,Sara,30,ES23209571107854547123,TRX_N-00449-58979853908,2023-02-11T13:41:05,Donostia,Expense,leisure,-296.33,248330.71
buyer_5,Sara,30,ES23209571107854547123,TRX_N-00450-833095660463,2023-02-22T10:31:16,Leioa,Expense,food,-713.68,247617.03
buyer_5,Sara,30,ES23209571107854547123,TRX_N-00451-417417052149,2023-02-23T11:58:13,Donostia,Expense,food,-463.73,247153.3
buyer_5,Sara,30,ES23209571107854547123,TRX_N-00452-118284901548,2023-03-01T22:45:23,Donostia,transfer,Salary,3412.57,250565.87
buyer_5,Sara,30,ES23209571107854547123,TRX_N-00453-321280004519,2023-03-01T22:45:23,Donostia,transfer,Partner Salary,3943.03,254508.9
buyer_5,Sara,30,ES23209571107854547123,TRX_N-00454-344201173889,2023-03-01T22:45:23,Donostia,transfer,Extra Income,341.26,254850.16
buyer_5,Sara,30,ES23209571107854547123,TRX_N-00455-141160133220,2023-03-02T23:50:04,Donostia,Expense,healthcare,-243.66,254606.5
buyer_5,Sara,30,ES23209571107854547123,TRX_N-00456-416343020592,2023-03-05T09:44:22,Donostia,Housing,Mortgage,-501.19,254105.31
buyer_5,Sara,30,ES23209571107854547123,TRX_N-00457-73440430556,2023-03-05T13:48:26,Donostia,Basic services,internet,-32.34,254072.97
buyer_5,Sara,30,ES23209571107854547123,TRX_N-00458-755230878820,2023-03-06T16:37:10,Donostia,Basic services,water,-22.22,254050.75
buyer_5,Sara,30,ES23209571107854547123,TRX_N-00459-896880524763,2023-03-06T17:32:01,Donostia,Basic services,electricity,-109.57,253941.18
buyer_5,Sara,30,ES23209571107854547123,TRX_N-00460-634305656843,2023-03-06T16:52:03,Donostia,Basic services,gas,-36.14,253905.04
buyer_5,Sara,30,ES23209571107854547123,TRX_N-00461-157784941106,2023-03-06T12:43:12,Donostia,Basic services,internet,-71.47,253833.57
buyer_5,Sara,30,ES23209571107854547123,TRX_N-00462-648808576421,2023-03-07T14:08:10,Donostia,Basic services,gas,-47.42,253786.15
buyer_5,Sara,30,ES23209571107854547123,TRX_N-00463-236040893626,2023-03-07T13:49:56,Donostia,Basic services,internet,-45.94,253740.21
buyer_5,Sara,30,ES23209571107854547123,TRX_N-00464-369967495970,2023-03-08T19:56:49,Donostia,Expense,food,-379.69,253360.52
buyer_5,Sara,30,ES23209571107854547123,TRX_N-00465-494012585425,2023-03-09T20:05:09,Donostia,Expense,transport,-188.83,253171.69
buyer_5,Sara,30,ES23209571107854547123,TRX_N-00466-537283159813,2023-03-10T19:51:41,Donostia,Expense,food,-691.33,252480.36
buyer_5,Sara,30,ES23209571107854547123,TRX_N-00467-333981675771,2023-04-01T02:58:09,Donostia,transfer,Salary,3412.57,255892.93
buyer_5,Sara,30,ES23209571107854547123,TRX_N-00468-69409093580,2023-04-01T02:58:09,Donostia,transfer,Partner Salary,3943.03,259835.96
buyer_5,Sara,30,ES23209571107854547123,TRX_N-00469-644723653035,2023-04-05T13:19:22,Donostia,Housing,Mortgage,-501.19,259334.77
buyer_5,Sara,30,ES23209571107854547123,TRX_N-00470-43108861508,2023-04-05T09:24:58,Donostia,Basic services,electricity,-88.02,259246.75
buyer_5,Sara,30,ES23209571107854547123,TRX_N-00471-857689217166,2023-04-06T09:01:32,Donostia,Expense,transport,-53.18,259193.57
buyer_5,Sara,30,ES23209571107854547123,TRX_N-00472-53681615770,2023-04-07T10:15:28,Donostia,Basic services,phone,-61.75,259131.82
buyer_5,Sara,30,ES23209571107854547123,TRX_N-00473-569727351446,2023-04-07T19:56:21,Donostia,Expense,transport,-53.3,259078.52
buyer_5,Sara,30,ES23209571107854547123,TRX_N-00474-803247591829,2023-04-07T18:06:14,Portugalete,Expense,leisure,-175.49,258903.03
buyer_5,Sara,30,ES23209571107854547123,TRX_N-00475-326880787273,2023-04-23T13:41:38,Donostia,Expense,leisure,-155.5,258747.53
buyer_5,Sara,30,ES23209571107854547123,TRX_N-00476-556425167377,2023-04-26T18:23:12,Donostia,Expense,transport,-187.65,258559.88
buyer_5,Sara,30,ES23209571107854547123,TRX_N-00477-572195186794,2023-05-01T12:51:10,Donostia,transfer,Salary,3412.57,261972.45
buyer_5,Sara,30,ES23209571107854547123,TRX_N-00478-573416327956,2023-05-01T12:51:10,Donostia,transfer,Partner Salary,3943.03,265915.48
buyer_5,Sara,30,ES23209571107854547123,TRX_N-00479-401695621935,2023-05-01T12:51:10,Donostia,transfer,Extra Income,341.26,266256.74
buyer_5,Sara,30,ES23209571107854547123,TRX_N-00480-727698587165,2023-05-05T18:51:15,Donostia,Housing,Mortgage,-501.19,265755.55
buyer_5,Sara,30,ES23209571107854547123,TRX_N-00481-691219676316,2023-05-05T13:07:50,Donostia,Basic services,water,-58.07,265697.48
buyer_5,Sara,30,ES23209571107854547123,TRX_N-00482-377409804455,2023-05-05T03:51:04,Donostia,Basic services,electricity,-54.84,265642.64
buyer_5,Sara,30,ES23209571107854547123,TRX_N-00483-41635157640,2023-05-05T08:24:04,Donostia,Basic services,internet,-62.99,265579.65
buyer_5,Sara,30,ES23209571107854547123,TRX_N-00484-509144116498,2023-05-06T09:43:21,Donostia,Basic services,internet,-49.16,265530.49
buyer_5,Sara,30,ES23209571107854547123,TRX_N-00485-345030666036,2023-05-06T19:32:55,Donostia,Basic services,phone,-88.11,265442.38
buyer_5,Sara,30,ES23209571107854547123,TRX_N-00486-553827133680,2023-05-07T12:59:21,Donostia,Basic services,phone,-50.47,265391.91
buyer_5,Sara,30,ES23209571107854547123,TRX_N-00487-409432171547,2023-05-12T10:50:31,Donostia,Expense,transport,-171.44,265220.47
buyer_5,Sara,30,ES23209571107854547123,TRX_N-00488-782456592516,2023-05-28T14:29:18,Andoain,Expense,leisure,-258.32,264962.15
buyer_5,Sara,30,ES23209571107854547123,TRX_N-00489-51912635120,2023-06-01T14:42:19,Donostia,transfer,Salary,3412.57,268374.72
buyer_5,Sara,30,ES23209571107854547123,TRX_N-00490-867956006505,2023-06-01T14:42:19,Donostia,transfer,Partner Salary,3943.03,272317.75
buyer_5,Sara,30,ES23209571107854547123,TRX_N-00491-263233716855,2023-06-01T14:42:19,Donostia,transfer,Bonus,3706.71,276024.46
buyer_5,Sara,30,ES23209571107854547123,TRX_N-00492-132840736466,2023-06-02T05:57:59,Donostia,Expense,transport,-134.0,275890.46
buyer_5,Sara,30,ES23209571107854547123,TRX_N-00493-84369621228,2023-06-05T09:33:59,Donostia,Housing,Mortgage,-501.19,275389.27
buyer_5,Sara,30,ES23209571107854547123,TRX_N-00494-469093005546,2023-06-05T10:31:09,Donostia,Basic services,gas,-63.47,275325.8
buyer_5,Sara,30,ES23209571107854547123,TRX_N-00495-729097256014,2023-06-06T20:13:19,Donostia,Basic services,water,-59.15,275266.65
buyer_5,Sara,30,ES23209571107854547123,TRX_N-00496-876896217230,2023-06-07T12:51:24,Donostia,Basic services,electricity,-57.19,275209.46
buyer_5,Sara,30,ES23209571107854547123,TRX_N-00497-670262792532,2023-06-07T10:44:15,Donostia,Basic services,phone,-64.48,275144.98
buyer_5,Sara,30,ES23209571107854547123,TRX_N-00498-968338534976,2023-06-08T10:35:22,Donostia,Expense,food,-727.54,274417.44
buyer_5,Sara,30,ES23209571107854547123,TRX_N-00499-185389263807,2023-06-16T19:04:35,Lasarte-Oria,Expense,food,-224.64,274192.8
buyer_5,Sara,30,ES23209571107854547123,TRX_N-00500-670093964440,2023-06-19T06:53:50,Donostia,Expense,leisure,-92.92,274099.88
buyer_5,Sara,30,ES23209571107854547123,TRX_N-00501-948691158541,2023-07-01T10:46:55,Donostia,transfer,Salary,3412.57,277512.45
buyer_5,Sara,30,ES23209571107854547123,TRX_N-00502-784912832729,2023-07-01T10:46:55,Donostia,transfer,Partner Salary,3943.03,281455.48
buyer_5,Sara,30,ES23209571107854547123,TRX_N-00503-398719048322,2023-07-01T10:46:55,Donostia,transfer,Extra Income,341.26,281796.74
buyer_5,Sara,30,ES23209571107854547123,TRX_N-00504-45306767049,2023-07-05T08:49:56,Donostia,Housing,Mortgage,-501.19,281295.55
buyer_5,Sara,30,ES23209571107854547123,TRX_N-00505-235470197606,2023-07-05T00:13:20,Donostia,Basic services,gas,-66.55,281229.0
buyer_5,Sara,30,ES23209571107854547123,TRX_N-00506-923115884182,2023-07-05T06:20:59,Donostia,Expense,education,-449.42,280779.58
buyer_5,Sara,30,ES23209571107854547123,TRX_N-00507-403263967128,2023-07-06T18:00:02,Donostia,Basic services,electricity,-99.91,280679.67
buyer_5,Sara,30,ES23209571107854547123,TRX_N-00508-556137860021,2023-07-07T23:43:28,Donostia,Basic services,water,-19.73,280659.94
buyer_5,Sara,30,ES23209571107854547123,TRX_N-00509-209344136110,2023-07-07T19:47:18,Donostia,Basic services,electricity,-106.26,280553.68
buyer_5,Sara,30,ES23209571107854547123,TRX_N-00510-32492471715,2023-07-22T13:37:42,Donostia,Expense,healthcare,-276.62,280277.06
buyer_5,Sara,30,ES23209571107854547123,TRX_N-00511-496102846891,2023-07-24T03:13:16,Salvatierra/Agurain,Expense,leisure,-69.45,280207.61
buyer_5,Sara,30,ES23209571107854547123,TRX_N-00512-845823030949,2023-07-28T13:28:16,Donostia,Expense,food,-679.84,279527.77
buyer_5,Sara,30,ES23209571107854547123,TRX_N-00513-742239282656,2023-08-01T10:33:34,Donostia,transfer,Salary,3412.57,282940.34
buyer_5,Sara,30,ES23209571107854547123,TRX_N-00514-800443068998,2023-08-01T10:33:34,Donostia,transfer,Partner Salary,3943.03,286883.37
buyer_5,Sara,30,ES23209571107854547123,TRX_N-00515-431253289643,2023-08-03T13:45:07,Donostia,Expense,food,-169.91,286713.46
buyer_5,Sara,30,ES23209571107854547123,TRX_N-00516-838211770548,2023-08-05T20:22:43,Donostia,Housing,Mortgage,-501.19,286212.27
buyer_5,Sara,30,ES23209571107854547123,TRX_N-00517-258124614081,2023-08-05T16:06:23,Donostia,Basic services,gas,-49.23,286163.04
buyer_5,Sara,30,ES23209571107854547123,TRX_N-00518-921933448674,2023-08-06T12:27:01,Donostia,Basic services,electricity,-137.26,286025.78
buyer_5,Sara,30,ES23209571107854547123,TRX_N-00519-629436017892,2023-08-06T13:10:29,Donostia,Basic services,gas,-63.3,285962.48
buyer_5,Sara,30,ES23209571107854547123,TRX_N-00520-828893687214,2023-08-06T16:18:49,Donostia,Basic services,internet,-65.64,285896.84
buyer_5,Sara,30,ES23209571107854547123,TRX_N-00521-889717439153,2023-08-06T11:24:24,Donostia,Basic services,phone,-90.47,285806.37
buyer_5,Sara,30,ES23209571107854547123,TRX_N-00522-422464875123,2023-08-07T12:27:19,Donostia,Basic services,water,-48.7,285757.67
buyer_5,Sara,30,ES23209571107854547123,TRX_N-00523-924490109082,2023-08-07T13:34:31,Mungia,Expense,food,-591.13,285166.54
buyer_5,Sara,30,ES23209571107854547123,TRX_N-00524-535429556826,2023-08-09T19:56:43,Donostia,Expense,food,-267.52,284899.02
buyer_5,Sara,30,ES23209571107854547123,TRX_N-00525-432926250340,2023-08-10T10:18:11,Donostia,Expense,transport,-99.74,284799.28
buyer_5,Sara,30,ES23209571107854547123,TRX_N-00526-197759001841,2023-09-01T17:45:59,Donostia,transfer,Salary,3412.57,288211.85
buyer_5,Sara,30,ES23209571107854547123,TRX_N-00527-644946854436,2023-09-01T17:45:59,Donostia,transfer,Partner Salary,3943.03,292154.88
buyer_5,Sara,30,ES23209571107854547123,TRX_N-00528-646363605793,2023-09-01T17:45:59,Donostia,transfer,Extra Income,341.26,292496.14
buyer_5,Sara,30,ES23209571107854547123,TRX_N-00529-366490778068,2023-09-03T12:53:02,Donostia,Expense,leisure,-226.3,292269.84
buyer_5,Sara,30,ES23209571107854547123,TRX_N-00530-211625727139,2023-09-05T04:17:12,Donostia,Housing,Mortgage,-501.19,291768.65
buyer_5,Sara,30,ES23209571107854547123,TRX_N-00531-625071134495,2023-09-05T12:44:12,Donostia,Basic services,water,-69.38,291699.27
buyer_5,Sara,30,ES23209571107854547123,TRX_N-00532-717690729753,2023-09-06T15:51:29,Donostia,Basic services,water,-30.05,291669.22
buyer_5,Sara,30,ES23209571107854547123,TRX_N-00533-88089687599,2023-09-06T11:18:00,Donostia,Basic services,gas,-46.78,291622.44
buyer_5,Sara,30,ES23209571107854547123,TRX_N-00534-693118257162,2023-09-07T14:24:14,Donostia,Basic services,water,-22.35,291600.09
buyer_5,Sara,30,ES23209571107854547123,TRX_N-00535-609260710348,2023-09-07T06:52:43,Donostia,Basic services,electricity,-114.2,291485.89
buyer_5,Sara,30,ES23209571107854547123,TRX_N-00536-954551215305,2023-09-07T19:14:57,Donostia,Basic services,gas,-52.49,291433.4
buyer_5,Sara,30,ES23209571107854547123,TRX_N-00537-667478443638,2023-09-07T08:42:06,Donostia,Basic services,internet,-50.47,291382.93
buyer_5,Sara,30,ES23209571107854547123,TRX_N-00538-903807063657,2023-09-07T19:42:25,Donostia,Expense,transport,-44.78,291338.15
buyer_5,Sara,30,ES23209571107854547123,TRX_N-00539-253171871062,2023-09-11T19:12:26,Donostia,Expense,transport,-118.7,291219.45
buyer_5,Sara,30,ES23209571107854547123,TRX_N-00540-754787852231,2023-09-11T12:13:22,Getxo,Expense,leisure,-242.52,290976.93
buyer_5,Sara,30,ES23209571107854547123,TRX_N-00541-583465302549,2023-09-17T23:56:39,Donostia,Expense,repairs,-357.97,290618.96
buyer_5,Sara,30,ES23209571107854547123,TRX_N-00542-41603909337,2023-09-18T20:07:14,Donostia,Expense,food,-454.56,290164.4
buyer_5,Sara,30,ES23209571107854547123,TRX_N-00543-922905357236,2023-10-01T16:03:09,Donostia,transfer,Salary,3412.57,293576.97
buyer_5,Sara,30,ES23209571107854547123,TRX_N-00544-581001429158,2023-10-01T16:03:09,Donostia,transfer,Partner Salary,3943.03,297520.0
buyer_5,Sara,30,ES23209571107854547123,TRX_N-00545-290674759495,2023-10-01T18:05:27,Donostia,Expense,food,-469.27,297050.73
buyer_5,Sara,30,ES23209571107854547123,TRX_N-00546-965610568655,2023-10-03T09:54:35,Donostia,Expense,repairs,-918.24,296132.49
buyer_5,Sara,30,ES23209571107854547123,TRX_N-00547-702806303226,2023-10-04T15:20:01,Amurrio,Expense,food,-597.83,295534.66
buyer_5,Sara,30,ES23209571107854547123,TRX_N-00548-962466560450,2023-10-04T13:53:20,Donostia,Expense,clothing,-40.85,295493.81
buyer_5,Sara,30,ES23209571107854547123,TRX_N-00549-674284730007,2023-10-05T17:26:38,Donostia,Housing,Mortgage,-501.19,294992.62
buyer_5,Sara,30,ES23209571107854547123,TRX_N-00550-350926032283,2023-10-06T12:11:19,Donostia,Basic services,water,-49.42,294943.2
buyer_5,Sara,30,ES23209571107854547123,TRX_N-00551-799853019733,2023-10-06T14:25:31,Donostia,Basic services,electricity,-106.13,294837.07
buyer_5,Sara,30,ES23209571107854547123,TRX_N-00552-140071233149,2023-10-06T08:19:47,Donostia,Basic services,internet,-79.06,294758.01
buyer_5,Sara,30,ES23209571107854547123,TRX_N-00553-743937359806,2023-10-07T18:42:21,Donostia,Basic services,internet,-61.23,294696.78
buyer_5,Sara,30,ES23209571107854547123,TRX_N-00554-433486880264,2023-10-11T08:23:02,Donostia,Expense,food,-376.66,294320.12
buyer_5,Sara,30,ES23209571107854547123,TRX_N-00555-832911216258,2023-10-18T19:25:16,Donostia,Expense,food,-192.79,294127.33
buyer_5,Sara,30,ES23209571107854547123,TRX_N-00556-714988056020,2023-10-18T14:34:09,Donostia,Expense,transport,-137.4,293989.93
buyer_5,Sara,30,ES23209571107854547123,TRX_N-00557-623516599447,2023-11-01T12:42:20,Donostia,transfer,Salary,3412.57,297402.5
buyer_5,Sara,30,ES23209571107854547123,TRX_N-00558-988304090648,2023-11-01T12:42:20,Donostia,transfer,Partner Salary,3943.03,301345.53
buyer_5,Sara,30,ES23209571107854547123,TRX_N-00559-159685046711,2023-11-01T12:42:20,Donostia,transfer,Extra Income,341.26,301686.79
buyer_5,Sara,30,ES23209571107854547123,TRX_N-00560-635293182813,2023-11-05T20:10:17,Donostia,Housing,Mortgage,-501.19,301185.6
buyer_5,Sara,30,ES23209571107854547123,TRX_N-00561-906656725317,2023-11-05T20:35:46,Donostia,Basic services,internet,-42.26,301143.34
buyer_5,Sara,30,ES23209571107854547123,TRX_N-00562-992998635487,2023-11-06T10:50:51,Donostia,Basic services,electricity,-139.38,301003.96
buyer_5,Sara,30,ES23209571107854547123,TRX_N-00563-961824571097,2023-11-06T13:11:54,Donostia,Basic services,gas,-80.84,300923.12
buyer_5,Sara,30,ES23209571107854547123,TRX_N-00564-62454353939,2023-11-06T15:30:55,Donostia,Basic services,internet,-74.8,300848.32
buyer_5,Sara,30,ES23209571107854547123,TRX_N-00565-855295920211,2023-11-07T16:47:19,Donostia,Basic services,water,-51.5,300796.82
buyer_5,Sara,30,ES23209571107854547123,TRX_N-00566-322304891571,2023-11-07T17:36:17,Donostia,Basic services,internet,-48.88,300747.94
buyer_5,Sara,30,ES23209571107854547123,TRX_N-00567-313198600288,2023-11-16T17:13:53,Donostia,Expense,food,-188.27,300559.67
buyer_5,Sara,30,ES23209571107854547123,TRX_N-00568-572863338063,2023-11-16T12:55:47,Donostia,Expense,travel,-2480.08,298079.59
buyer_5,Sara,30,ES23209571107854547123,TRX_N-00569-26998966827,2023-11-20T13:05:39,Errenteria,Expense,transport,-147.88,297931.71
buyer_5,Sara,30,ES23209571107854547123,TRX_N-00570-126706210304,2023-12-01T18:57:37,Donostia,transfer,Salary,3412.57,301344.28
buyer_5,Sara,30,ES23209571107854547123,TRX_N-00571-232399968918,2023-12-01T18:57:37,Donostia,transfer,Partner Salary,3943.03,305287.31
buyer_5,Sara,30,ES23209571107854547123,TRX_N-00572-956313784866,2023-12-01T18:57:37,Donostia,transfer,Bonus,3599.47,308886.78
buyer_5,Sara,30,ES23209571107854547123,TRX_N-00573-180576894776,2023-12-03T11:13:18,Donostia,Expense,food,-691.43,308195.35
buyer_5,Sara,30,ES23209571107854547123,TRX_N-00574-768089929427,2023-12-05T13:44:52,Donostia,Housing,Mortgage,-501.19,307694.16
buyer_5,Sara,30,ES23209571107854547123,TRX_N-00575-336222745461,2023-12-05T19:51:14,Donostia,Basic services,electricity,-26.02,307668.14
buyer_5,Sara,30,ES23209571107854547123,TRX_N-00576-180965518004,2023-12-05T19:56:53,Donostia,Basic services,internet,-69.19,307598.95
buyer_5,Sara,30,ES23209571107854547123,TRX_N-00577-80401132983,2023-12-06T18:57:05,Donostia,Basic services,electricity,-56.52,307542.43
buyer_5,Sara,30,ES23209571107854547123,TRX_N-00578-12557566930,2023-12-06T11:53:56,Donostia,Basic services,gas,-77.68,307464.75
buyer_5,Sara,30,ES23209571107854547123,TRX_N-00579-364419078731,2023-12-06T21:01:47,Donostia,Basic services,internet,-65.45,307399.3
buyer_5,Sara,30,ES23209571107854547123,TRX_N-00580-724486357062,2024-01-01T15:31:57,Donostia,transfer,Salary,3412.57,310811.87
buyer_5,Sara,30,ES23209571107854547123,TRX_N-00581-376658990745,2024-01-01T15:31:57,Donostia,transfer,Partner Salary,3943.03,314754.9
buyer_5,Sara,30,ES23209571107854547123,TRX_N-00582-435158187230,2024-01-01T15:31:57,Donostia,transfer,Extra Income,341.26,315096.16
buyer_5,Sara,30,ES23209571107854547123,TRX_N-00583-800166250156,2024-01-05T07:10:09,Donostia,Housing,Mortgage,-501.19,314594.97
buyer_5,Sara,30,ES23209571107854547123,TRX_N-00584-28226950882,2024-01-06T16:37:03,Donostia,Basic services,electricity,-99.88,314495.09
buyer_5,Sara,30,ES23209571107854547123,TRX_N-00585-6173600916,2024-01-06T22:01:07,Donostia,Basic services,internet,-70.86,314424.23
buyer_5,Sara,30,ES23209571107854547123,TRX_N-00586-285707275633,2024-01-07T15:22:11,Donostia,Basic services,gas,-69.92,314354.31
buyer_5,Sara,30,ES23209571107854547123,TRX_N-00587-285473535076,2024-01-23T20:04:55,Donostia,Expense,repairs,-357.56,313996.75
buyer_5,Sara,30,ES23209571107854547123,TRX_N-00588-526416738217,2024-02-01T15:39:03,Donostia,transfer,Salary,3412.57,317409.32
buyer_5,Sara,30,ES23209571107854547123,TRX_N-00589-78063441003,2024-02-01T15:39:03,Donostia,transfer,Partner Salary,3943.03,321352.35
buyer_5,Sara,30,ES23209571107854547123,TRX_N-00590-985878005497,2024-02-02T02:36:43,Donostia,Expense,transport,-117.06,321235.29
buyer_5,Sara,30,ES23209571107854547123,TRX_N-00591-934844574117,2024-02-05T08:41:01,Donostia,Housing,Mortgage,-501.19,320734.1
buyer_5,Sara,30,ES23209571107854547123,TRX_N-00592-356099090720,2024-02-05T14:30:29,Donostia,Basic services,phone,-45.29,320688.81
buyer_5,Sara,30,ES23209571107854547123,TRX_N-00593-51902166950,2024-02-06T09:10:35,Donostia,Basic services,electricity,-99.87,320588.94
buyer_5,Sara,30,ES23209571107854547123,TRX_N-00594-909974577865,2024-02-06T20:39:48,Donostia,Basic services,gas,-22.6,320566.34
buyer_5,Sara,30,ES23209571107854547123,TRX_N-00595-117959392011,2024-02-07T18:52:56,Donostia,Basic services,water,-71.42,320494.92
buyer_5,Sara,30,ES23209571107854547123,TRX_N-00596-608770627277,2024-02-07T08:43:57,Donostia,Basic services,electricity,-26.64,320468.28
buyer_5,Sara,30,ES23209571107854547123,TRX_N-00597-228231241587,2024-02-07T15:35:20,Donostia,Basic services,gas,-57.26,320411.02
buyer_5,Sara,30,ES23209571107854547123,TRX_N-00598-202512428956,2024-02-09T04:00:47,Donostia,Expense,food,-700.54,319710.48
buyer_5,Sara,30,ES23209571107854547123,TRX_N-00599-157671758242,2024-02-10T14:19:21,Labastida/Bastida,Expense,transport,-75.95,319634.53
buyer_5,Sara,30,ES23209571107854547123,TRX_N-00600-970617141840,2024-02-13T17:35:49,Getxo,Expense,gifts,-88.84,319545.69
buyer_5,Sara,30,ES23209571107854547123,TRX_N-00601-421686066637,2024-02-20T16:08:04,Donostia,Expense,transport,-26.26,319519.43
buyer_5,Sara,30,ES23209571107854547123,TRX_N-00602-280792309936,2024-02-25T15:05:47,Santurtzi,Expense,travel,-868.12,318651.31
buyer_5,Sara,30,ES23209571107854547123,TRX_N-00603-290870089570,2024-02-28T15:05:46,Donostia,Expense,transport,-80.27,318571.04
buyer_5,Sara,30,ES23209571107854547123,TRX_N-00604-925975916439,2024-03-01T18:42:37,Donostia,transfer,Salary,3412.57,321983.61
buyer_5,Sara,30,ES23209571107854547123,TRX_N-00605-316674195260,2024-03-01T18:42:37,Donostia,transfer,Partner Salary,3943.03,325926.64
buyer_5,Sara,30,ES23209571107854547123,TRX_N-00606-416616847526,2024-03-01T18:42:37,Donostia,transfer,Extra Income,341.26,326267.9
buyer_5,Sara,30,ES23209571107854547123,TRX_N-00607-183495722381,2024-03-05T14:34:32,Donostia,Housing,Mortgage,-501.19,325766.71
buyer_5,Sara,30,ES23209571107854547123,TRX_N-00608-218926347538,2024-03-06T22:38:15,Donostia,Basic services,water,-34.04,325732.67
buyer_5,Sara,30,ES23209571107854547123,TRX_N-00609-994780488471,2024-03-06T20:08:53,Donostia,Basic services,electricity,-83.6,325649.07
buyer_5,Sara,30,ES23209571107854547123,TRX_N-00610-90096313436,2024-03-06T10:32:10,Donostia,Basic services,gas,-17.09,325631.98
buyer_5,Sara,30,ES23209571107854547123,TRX_N-00611-427759588458,2024-03-06T07:12:51,Donostia,Basic services,phone,-38.99,325592.99
buyer_5,Sara,30,ES23209571107854547123,TRX_N-00612-882420126350,2024-03-07T14:52:06,Donostia,Basic services,electricity,-144.19,325448.8
buyer_5,Sara,30,ES23209571107854547123,TRX_N-00613-387743135730,2024-03-07T18:32:04,Donostia,Basic services,internet,-75.13,325373.67
buyer_5,Sara,30,ES23209571107854547123,TRX_N-00614-203627763881,2024-03-19T18:17:50,Iruña de Oca,Expense,transport,-131.61,325242.06
buyer_5,Sara,30,ES23209571107854547123,TRX_N-00615-680642736897,2024-03-29T17:57:24,Donostia,Expense,transport,-85.25,325156.81
buyer_5,Sara,30,ES23209571107854547123,TRX_N-00616-113140330483,2024-03-29T12:14:41,Donostia,Expense,gifts,-410.79,324746.02
buyer_5,Sara,30,ES23209571107854547123,TRX_N-00617-618772490395,2024-04-01T20:23:39,Donostia,transfer,Salary,3412.57,328158.59
buyer_5,Sara,30,ES23209571107854547123,TRX_N-00618-176041708918,2024-04-01T20:23:39,Donostia,transfer,Partner Salary,3943.03,332101.62
buyer_5,Sara,30,ES23209571107854547123,TRX_N-00619-954032082707,2024-04-05T01:44:36,Donostia,Housing,Mortgage,-501.19,331600.43
buyer_5,Sara,30,ES23209571107854547123,TRX_N-00620-863824244232,2024-04-05T17:33:16,Donostia,Basic services,water,-54.66,331545.77
buyer_5,Sara,30,ES23209571107854547123,TRX_N-00621-736262349743,2024-04-05T09:03:49,Donostia,Basic services,electricity,-118.24,331427.53
buyer_5,Sara,30,ES23209571107854547123,TRX_N-00622-142722957108,2024-04-05T15:01:29,Donostia,Basic services,phone,-21.09,331406.44
buyer_5,Sara,30,ES23209571107854547123,TRX_N-00623-785988084550,2024-04-12T20:04:23,Donostia,Expense,transport,-161.16,331245.28
buyer_5,Sara,30,ES23209571107854547123,TRX_N-00624-687748664558,2024-04-13T00:01:47,Donostia,Expense,clothing,-479.31,330765.97
buyer_5,Sara,30,ES23209571107854547123,TRX_N-00625-953049279592,2024-04-17T12:55:46,Donostia,Expense,food,-557.8,330208.17
buyer_5,Sara,30,ES23209571107854547123,TRX_N-00626-192007368833,2024-04-20T19:19:32,Donostia,Expense,clothing,-113.64,330094.53
buyer_5,Sara,30,ES23209571107854547123,TRX_N-00627-189252709745,2024-05-01T12:43:01,Donostia,transfer,Salary,3412.57,333507.1
buyer_5,Sara,30,ES23209571107854547123,TRX_N-00628-416586527831,2024-05-01T12:43:01,Donostia,transfer,Partner Salary,3943.03,337450.13
buyer_5,Sara,30,ES23209571107854547123,TRX_N-00629-243805682228,2024-05-01T12:43:01,Donostia,transfer,Extra Income,341.26,337791.39
buyer_5,Sara,30,ES23209571107854547123,TRX_N-00630-587290974695,2024-05-05T10:23:15,Donostia,Housing,Mortgage,-501.19,337290.2
buyer_5,Sara,30,ES23209571107854547123,TRX_N-00631-338750410295,2024-05-05T22:28:17,Donostia,Basic services,electricity,-91.07,337199.13
buyer_5,Sara,30,ES23209571107854547123,TRX_N-00632-388617200466,2024-05-05T16:22:36,Donostia,Basic services,internet,-33.6,337165.53
buyer_5,Sara,30,ES23209571107854547123,TRX_N-00633-347032261154,2024-05-06T11:29:01,Donostia,Basic services,gas,-62.87,337102.66
buyer_5,Sara,30,ES23209571107854547123,TRX_N-00634-525849268077,2024-05-07T09:21:06,Donostia,Basic services,internet,-72.44,337030.22
buyer_5,Sara,30,ES23209571107854547123,TRX_N-00635-246053009910,2024-05-25T10:19:45,Donostia,Expense,healthcare,-37.64,336992.58
buyer_5,Sara,30,ES23209571107854547123,TRX_N-00636-836018996248,2024-06-01T09:25:11,Donostia,transfer,Salary,3412.57,340405.15
buyer_5,Sara,30,ES23209571107854547123,TRX_N-00637-786276182487,2024-06-01T09:25:11,Donostia,transfer,Partner Salary,3943.03,344348.18
buyer_5,Sara,30,ES23209571107854547123,TRX_N-00638-543273307964,2024-06-01T09:25:11,Donostia,transfer,Bonus,3294.98,347643.16
buyer_5,Sara,30,ES23209571107854547123,TRX_N-00639-504706199383,2024-06-05T12:45:01,Donostia,Housing,Mortgage,-501.19,347141.97
buyer_5,Sara,30,ES23209571107854547123,TRX_N-00640-988209809511,2024-06-05T10:07:03,Donostia,Basic services,water,-48.73,347093.24
buyer_5,Sara,30,ES23209571107854547123,TRX_N-00641-822987925946,2024-06-05T20:50:19,Donostia,Basic services,electricity,-94.2,346999.04
buyer_5,Sara,30,ES23209571107854547123,TRX_N-00642-251259465441,2024-06-05T12:44:58,Donostia,Basic services,gas,-48.46,346950.58
buyer_5,Sara,30,ES23209571107854547123,TRX_N-00643-128750413186,2024-06-05T10:34:46,Donostia,Basic services,internet,-67.97,346882.61
buyer_5,Sara,30,ES23209571107854547123,TRX_N-00644-511095988745,2024-06-06T11:45:45,Donostia,Basic services,water,-72.98,346809.63
buyer_5,Sara,30,ES23209571107854547123,TRX_N-00645-810553286952,2024-06-07T12:17:56,Donostia,Basic services,water,-14.15,346795.48
buyer_5,Sara,30,ES23209571107854547123,TRX_N-00646-654871060301,2024-06-07T12:14:50,Donostia,Basic services,gas,-21.27,346774.21
buyer_5,Sara,30,ES23209571107854547123,TRX_N-00647-246387196279,2024-06-07T14:18:15,Donostia,Basic services,phone,-20.74,346753.47
buyer_5,Sara,30,ES23209571107854547123,TRX_N-00648-63874199759,2024-06-07T20:39:49,Donostia,Expense,travel,-2079.33,344674.14
buyer_5,Sara,30,ES23209571107854547123,TRX_N-00649-810871798560,2024-06-26T09:37:00,Donostia,Expense,food,-685.3,343988.84
buyer_5,Sara,30,ES23209571107854547123,TRX_N-00650-790626145297,2024-06-29T03:20:40,Donostia,Expense,healthcare,-338.57,343650.27
buyer_5,Sara,30,ES23209571107854547123,TRX_N-00651-470937690223,2024-07-01T11:03:49,Donostia,transfer,Salary,3412.57,347062.84
buyer_5,Sara,30,ES23209571107854547123,TRX_N-00652-874823972352,2024-07-01T11:03:49,Donostia,transfer,Partner Salary,3943.03,351005.87
buyer_5,Sara,30,ES23209571107854547123,TRX_N-00653-630517118359,2024-07-01T02:34:47,Salvatierra/Agurain,Expense,leisure,-242.77,350763.1
buyer_5,Sara,30,ES23209571107854547123,TRX_N-00654-297772915436,2024-07-05T16:42:26,Donostia,Housing,Mortgage,-501.19,350261.91
buyer_5,Sara,30,ES23209571107854547123,TRX_N-00655-282240219837,2024-07-05T22:29:58,Donostia,Basic services,electricity,-139.64,350122.27
buyer_5,Sara,30,ES23209571107854547123,TRX_N-00656-885455414860,2024-07-05T12:33:33,Donostia,Basic services,gas,-66.22,350056.05
buyer_5,Sara,30,ES23209571107854547123,TRX_N-00657-144696452247,2024-07-05T13:52:24,Donostia,Basic services,phone,-44.02,350012.03
buyer_5,Sara,30,ES23209571107854547123,TRX_N-00658-84055264371,2024-07-06T15:03:56,Donostia,Basic services,electricity,-121.23,349890.8
buyer_5,Sara,30,ES23209571107854547123,TRX_N-00659-980214600769,2024-07-10T14:53:36,Donostia,Expense,transport,-50.38,349840.42
buyer_5,Sara,30,ES23209571107854547123,TRX_N-00660-967050111852,2024-07-21T02:12:02,Donostia,Expense,transport,-130.38,349710.04
buyer_5,Sara,30,ES23209571107854547123,TRX_N-00661-513223916673,2024-07-24T22:55:18,Zarautz,Expense,food,-648.78,349061.26
buyer_5,Sara,30,ES23209571107854547123,TRX_N-00662-152381210404,2024-07-29T09:23:49,Donostia,Expense,leisure,-203.49,348857.77
buyer_5,Sara,30,ES23209571107854547123,TRX_N-00663-875918555276,2024-08-01T05:10:48,Donostia,transfer,Salary,3412.57,352270.34
buyer_5,Sara,30,ES23209571107854547123,TRX_N-00664-490198898540,2024-08-01T05:10:48,Donostia,transfer,Partner Salary,3943.03,356213.37
buyer_5,Sara,30,ES23209571107854547123,TRX_N-00665-756203642837,2024-08-01T05:10:48,Donostia,transfer,Extra Income,341.26,356554.63
buyer_5,Sara,30,ES23209571107854547123,TRX_N-00666-625336441524,2024-08-04T12:39:26,Donostia,Expense,transport,-148.12,356406.51
buyer_5,Sara,30,ES23209571107854547123,TRX_N-00667-937842005110,2024-08-05T02:51:17,Donostia,Housing,Mortgage,-501.19,355905.32
buyer_5,Sara,30,ES23209571107854547123,TRX_N-00668-910613514121,2024-08-05T14:04:49,Donostia,Basic services,water,-53.75,355851.57
buyer_5,Sara,30,ES23209571107854547123,TRX_N-00669-994714479304,2024-08-05T19:08:26,Donostia,Basic services,gas,-82.57,355769.0
buyer_5,Sara,30,ES23209571107854547123,TRX_N-00670-839035322041,2024-08-06T11:01:16,Donostia,Basic services,water,-72.89,355696.11
buyer_5,Sara,30,ES23209571107854547123,TRX_N-00671-152116877787,2024-08-06T12:00:05,Donostia,Basic services,gas,-70.81,355625.3
buyer_5,Sara,30,ES23209571107854547123,TRX_N-00672-743991590791,2024-08-07T11:25:13,Donostia,Basic services,internet,-55.93,355569.37
buyer_5,Sara,30,ES23209571107854547123,TRX_N-00673-662575223558,2024-08-07T17:21:28,Donostia,Basic services,phone,-39.93,355529.44
buyer_5,Sara,30,ES23209571107854547123,TRX_N-00674-608082098843,2024-08-22T23:11:22,Donostia,Expense,leisure,-55.6,355473.84
buyer_5,Sara,30,ES23209571107854547123,TRX_N-00675-331674890978,2024-08-30T10:48:52,Donostia,Expense,transport,-115.45,355358.39
buyer_5,Sara,30,ES23209571107854547123,TRX_N-00676-978308983956,2024-09-01T10:30:31,Donostia,transfer,Salary,3412.57,358770.96
buyer_5,Sara,30,ES23209571107854547123,TRX_N-00677-443557695483,2024-09-01T10:30:31,Donostia,transfer,Partner Salary,3943.03,362713.99
buyer_5,Sara,30,ES23209571107854547123,TRX_N-00678-358490445690,2024-09-02T16:58:29,Donostia,Expense,food,-388.59,362325.4
buyer_5,Sara,30,ES23209571107854547123,TRX_N-00679-74302435812,2024-09-03T16:58:41,Donostia,Expense,leisure,-41.36,362284.04
buyer_5,Sara,30,ES23209571107854547123,TRX_N-00680-351911836028,2024-09-05T02:16:25,Donostia,Housing,Mortgage,-501.19,361782.85
buyer_5,Sara,30,ES23209571107854547123,TRX_N-00681-824289854219,2024-09-05T08:07:48,Donostia,Basic services,electricity,-46.09,361736.76
buyer_5,Sara,30,ES23209571107854547123,TRX_N-00682-129878189820,2024-09-06T02:30:04,Donostia,Basic services,phone,-95.87,361640.89
buyer_5,Sara,30,ES23209571107854547123,TRX_N-00683-622873645974,2024-09-07T13:09:58,Donostia,Basic services,gas,-35.12,361605.77
buyer_5,Sara,30,ES23209571107854547123,TRX_N-00684-370210453469,2024-09-08T14:57:29,Oyón-Oion,Expense,leisure,-213.81,361391.96
buyer_5,Sara,30,ES23209571107854547123,TRX_N-00685-343164796119,2024-09-15T20:09:51,Donostia,Expense,clothing,-61.49,361330.47
buyer_5,Sara,30,ES23209571107854547123,TRX_N-00686-121571556316,2024-10-01T10:21:23,Donostia,transfer,Salary,3412.57,364743.04
buyer_5,Sara,30,ES23209571107854547123,TRX_N-00687-7178049115,2024-10-01T10:21:23,Donostia,transfer,Partner Salary,3943.03,368686.07
buyer_5,Sara,30,ES23209571107854547123,TRX_N-00688-528708903425,2024-10-01T10:21:23,Donostia,transfer,Extra Income,341.26,369027.33
buyer_5,Sara,30,ES23209571107854547123,TRX_N-00689-999139586554,2024-10-02T09:59:39,Donostia,Expense,transport,-63.47,368963.86
buyer_5,Sara,30,ES23209571107854547123,TRX_N-00690-997892432811,2024-10-05T19:51:16,Donostia,Housing,Mortgage,-501.19,368462.67
buyer_5,Sara,30,ES23209571107854547123,TRX_N-00691-395632697783,2024-10-05T13:27:04,Donostia,Basic services,electricity,-141.11,368321.56
buyer_5,Sara,30,ES23209571107854547123,TRX_N-00692-721614160033,2024-10-05T15:25:29,Donostia,Basic services,gas,-48.63,368272.93
buyer_5,Sara,30,ES23209571107854547123,TRX_N-00693-909758474432,2024-10-06T08:25:03,Donostia,Basic services,water,-10.1,368262.83
buyer_5,Sara,30,ES23209571107854547123,TRX_N-00694-575960288012,2024-10-06T15:20:39,Donostia,Basic services,gas,-17.46,368245.37
buyer_5,Sara,30,ES23209571107854547123,TRX_N-00695-236769341878,2024-10-06T18:52:15,Donostia,Expense,transport,-56.14,368189.23
buyer_5,Sara,30,ES23209571107854547123,TRX_N-00696-44851256961,2024-10-07T13:34:13,Donostia,Basic services,gas,-67.49,368121.74
buyer_6,Manuel,45,ES43209562886882777603,TRX_N-00001-651240278147,2020-01-01T19:50:26,Vitoria-Gasteiz,transfer,Salary,1304.67,2010.59
buyer_6,Manuel,45,ES43209562886882777603,TRX_N-00002-557184918397,2020-01-05T09:06:17,Vitoria-Gasteiz,Housing,Rent,-733.63,1276.96
buyer_6,Manuel,45,ES43209562886882777603,TRX_N-00003-184785954266,2020-01-05T03:15:03,Vitoria-Gasteiz,Basic services,electricity,-89.1,1187.86
buyer_6,Manuel,45,ES43209562886882777603,TRX_N-00004-919190568891,2020-01-05T11:00:45,Vitoria-Gasteiz,Basic services,gas,-59.38,1128.48
buyer_6,Manuel,45,ES43209562886882777603,TRX_N-00005-574063967607,2020-01-06T00:32:40,Vitoria-Gasteiz,Basic services,electricity,-125.87,1002.61
buyer_6,Manuel,45,ES43209562886882777603,TRX_N-00006-428762299584,2020-01-10T14:22:24,Vitoria-Gasteiz,Expense,leisure,-206.52,796.09
buyer_6,Manuel,45,ES43209562886882777603,TRX_N-00007-870791268296,2020-01-13T16:49:01,Vitoria-Gasteiz,Expense,leisure,-243.79,552.3
buyer_6,Manuel,45,ES43209562886882777603,TRX_N-00008-109355323510,2020-01-19T20:14:29,Vitoria-Gasteiz,Expense,education,-333.95,218.35
buyer_6,Manuel,45,ES43209562886882777603,TRX_N-00009-97652220168,2020-01-25T23:09:24,Vitoria-Gasteiz,Expense,food,-186.08,32.27
buyer_6,Manuel,45,ES43209562886882777603,TRX_N-00010-557980944798,2020-02-01T15:56:23,Vitoria-Gasteiz,transfer,Salary,1304.67,1336.94
buyer_6,Manuel,45,ES43209562886882777603,TRX_N-00011-218513869902,2020-02-05T16:39:10,Vitoria-Gasteiz,Housing,Rent,-733.63,603.31
buyer_6,Manuel,45,ES43209562886882777603,TRX_N-00012-657601932644,2020-02-06T14:21:53,Vitoria-Gasteiz,Basic services,internet,-42.22,561.09
buyer_6,Manuel,45,ES43209562886882777603,TRX_N-00013-249327924520,2020-02-12T14:35:39,Vitoria-Gasteiz,Expense,gifts,-118.88,442.21
buyer_6,Manuel,45,ES43209562886882777603,TRX_N-00014-147773360087,2020-02-17T18:19:24,Vitoria-Gasteiz,Expense,food,-649.05,-206.84
buyer_6,Manuel,45,ES43209562886882777603,TRX_N-00015-935113856387,2020-02-19T02:12:02,Vitoria-Gasteiz,Expense,healthcare,-63.57,-270.41
buyer_6,Manuel,45,ES43209562886882777603,TRX_N-00016-127647938065,2020-02-26T16:25:15,Andoain,Expense,leisure,-194.31,-464.72
buyer_6,Manuel,45,ES43209562886882777603,TRX_N-00017-221958738045,2020-03-01T14:22:07,Vitoria-Gasteiz,transfer,Salary,1304.67,839.95
buyer_6,Manuel,45,ES43209562886882777603,TRX_N-00018-3263472970,2020-03-01T14:22:07,Vitoria-Gasteiz,transfer,Extra Income,130.47,970.42
buyer_6,Manuel,45,ES43209562886882777603,TRX_N-00019-137512010224,2020-03-05T22:40:59,Vitoria-Gasteiz,Housing,Rent,-733.63,236.79
buyer_6,Manuel,45,ES43209562886882777603,TRX_N-00020-557442287929,2020-03-05T18:10:50,Vitoria-Gasteiz,Basic services,gas,-50.6,186.19
buyer_6,Manuel,45,ES43209562886882777603,TRX_N-00021-127318883582,2020-03-05T18:53:13,Vitoria-Gasteiz,Basic services,internet,-39.94,146.25
buyer_6,Manuel,45,ES43209562886882777603,TRX_N-00022-655826810899,2020-03-05T09:23:33,Vitoria-Gasteiz,Basic services,phone,-93.98,52.27
buyer_6,Manuel,45,ES43209562886882777603,TRX_N-00023-770004963807,2020-03-05T12:55:28,Vitoria-Gasteiz,Expense,education,-111.87,-59.6
buyer_6,Manuel,45,ES43209562886882777603,TRX_N-00024-97715916966,2020-03-06T16:28:34,Vitoria-Gasteiz,Basic services,gas,-28.54,-88.14
buyer_6,Manuel,45,ES43209562886882777603,TRX_N-00025-47237211164,2020-03-06T09:17:14,Vitoria-Gasteiz,Basic services,phone,-95.07,-183.21
buyer_6,Manuel,45,ES43209562886882777603,TRX_N-00026-998721804848,2020-03-07T10:03:05,Vitoria-Gasteiz,Basic services,internet,-35.48,-218.69
buyer_6,Manuel,45,ES43209562886882777603,TRX_N-00027-290386493731,2020-03-08T10:59:42,Galdakao,Expense,leisure,-117.31,-336.0
buyer_6,Manuel,45,ES43209562886882777603,TRX_N-00028-197776078113,2020-03-18T20:55:48,Vitoria-Gasteiz,Expense,food,-461.53,-797.53
buyer_6,Manuel,45,ES43209562886882777603,TRX_N-00029-372694373200,2020-03-19T23:38:04,Vitoria-Gasteiz,Expense,food,-612.29,-1409.82
buyer_6,Manuel,45,ES43209562886882777603,TRX_N-00030-701288802036,2020-03-27T10:15:50,Pasaia,Expense,food,-103.96,-1513.78
buyer_6,Manuel,45,ES43209562886882777603,TRX_N-00031-804132927240,2020-03-28T19:58:04,Vitoria-Gasteiz,Expense,food,-348.63,-1862.41
buyer_6,Manuel,45,ES43209562886882777603,TRX_N-00032-957197001441,2020-04-01T17:29:36,Vitoria-Gasteiz,transfer,Salary,1304.67,-557.74
buyer_6,Manuel,45,ES43209562886882777603,TRX_N-00033-648715971347,2020-04-05T17:42:01,Vitoria-Gasteiz,Housing,Rent,-733.63,-1291.37
buyer_6,Manuel,45,ES43209562886882777603,TRX_N-00034-700352369634,2020-04-05T11:52:42,Vitoria-Gasteiz,Basic services,phone,-69.49,-1360.86
buyer_6,Manuel,45,ES43209562886882777603,TRX_N-00035-111972063802,2020-04-06T15:41:49,Vitoria-Gasteiz,Basic services,electricity,-62.11,-1422.97
buyer_6,Manuel,45,ES43209562886882777603,TRX_N-00036-695935503436,2020-04-06T13:43:54,Vitoria-Gasteiz,Basic services,gas,-81.68,-1504.65
buyer_6,Manuel,45,ES43209562886882777603,TRX_N-00037-426399636272,2020-04-06T23:42:22,Vitoria-Gasteiz,Basic services,phone,-21.51,-1526.16
buyer_6,Manuel,45,ES43209562886882777603,TRX_N-00038-568691862994,2020-04-06T09:59:26,Vitoria-Gasteiz,Expense,transport,-187.68,-1713.84
buyer_6,Manuel,45,ES43209562886882777603,TRX_N-00039-195176714104,2020-04-07T17:00:11,Vitoria-Gasteiz,Basic services,gas,-70.1,-1783.94
buyer_6,Manuel,45,ES43209562886882777603,TRX_N-00040-198122853329,2020-04-07T20:39:53,Vitoria-Gasteiz,Basic services,phone,-68.98,-1852.92
buyer_6,Manuel,45,ES43209562886882777603,TRX_N-00041-494416085334,2020-04-09T13:29:28,Vitoria-Gasteiz,Expense,travel,-2758.75,-4611.67
buyer_6,Manuel,45,ES43209562886882777603,TRX_N-00042-872366298903,2020-04-20T10:26:43,Sopela,Expense,clothing,-357.21,-4968.88
buyer_6,Manuel,45,ES43209562886882777603,TRX_N-00043-248018088109,2020-04-23T20:58:19,Vitoria-Gasteiz,Expense,food,-393.86,-5362.74
buyer_6,Manuel,45,ES43209562886882777603,TRX_N-00044-130859889551,2020-04-24T09:11:03,Vitoria-Gasteiz,Expense,repairs,-294.37,-5657.11
buyer_6,Manuel,45,ES43209562886882777603,TRX_N-00045-812817884224,2020-04-26T09:43:58,Vitoria-Gasteiz,Expense,transport,-122.76,-5779.87
buyer_6,Manuel,45,ES43209562886882777603,TRX_N-00046-650610914307,2020-05-01T00:56:38,Vitoria-Gasteiz,transfer,Salary,1304.67,-4475.2
buyer_6,Manuel,45,ES43209562886882777603,TRX_N-00047-852195373141,2020-05-05T00:57:52,Vitoria-Gasteiz,Housing,Rent,-733.63,-5208.83
buyer_6,Manuel,45,ES43209562886882777603,TRX_N-00048-367440458743,2020-05-05T00:39:52,Vitoria-Gasteiz,Basic services,internet,-78.87,-5287.7
buyer_6,Manuel,45,ES43209562886882777603,TRX_N-00049-558385035465,2020-05-07T15:25:25,Vitoria-Gasteiz,Basic services,phone,-60.0,-5347.7
buyer_6,Manuel,45,ES43209562886882777603,TRX_N-00050-266258041525,2020-05-23T08:27:06,Vitoria-Gasteiz,Expense,appliances,-1841.61,-7189.31
buyer_6,Manuel,45,ES43209562886882777603,TRX_N-00051-639708619240,2020-06-01T04:13:30,Vitoria-Gasteiz,transfer,Salary,1304.67,-5884.64
buyer_6,Manuel,45,ES43209562886882777603,TRX_N-00052-636924190536,2020-06-01T04:13:30,Vitoria-Gasteiz,transfer,Extra Income,130.47,-5754.17
buyer_6,Manuel,45,ES43209562886882777603,TRX_N-00053-303971052526,2020-06-01T04:13:30,Vitoria-Gasteiz,transfer,Bonus,1267.66,-4486.51
buyer_6,Manuel,45,ES43209562886882777603,TRX_N-00054-328090962592,2020-06-05T08:20:57,Vitoria-Gasteiz,Housing,Rent,-733.63,-5220.14
buyer_6,Manuel,45,ES43209562886882777603,TRX_N-00055-515853013928,2020-06-05T16:40:18,Vitoria-Gasteiz,Basic services,water,-18.34,-5238.48
buyer_6,Manuel,45,ES43209562886882777603,TRX_N-00056-995258254095,2020-06-05T06:39:02,Vitoria-Gasteiz,Basic services,gas,-42.87,-5281.35
buyer_6,Manuel,45,ES43209562886882777603,TRX_N-00057-766530737058,2020-06-05T23:24:23,Vitoria-Gasteiz,Basic services,internet,-30.22,-5311.57
buyer_6,Manuel,45,ES43209562886882777603,TRX_N-00058-649760577164,2020-06-06T20:09:02,Vitoria-Gasteiz,Basic services,electricity,-87.54,-5399.11
buyer_6,Manuel,45,ES43209562886882777603,TRX_N-00059-759911613846,2020-06-06T15:39:32,Vitoria-Gasteiz,Basic services,phone,-61.79,-5460.9
buyer_6,Manuel,45,ES43209562886882777603,TRX_N-00060-596576654067,2020-06-07T16:47:10,Vitoria-Gasteiz,Basic services,internet,-31.38,-5492.28
buyer_6,Manuel,45,ES43209562886882777603,TRX_N-00061-403639978943,2020-06-10T16:30:14,Vitoria-Gasteiz,Expense,clothing,-60.75,-5553.03
buyer_6,Manuel,45,ES43209562886882777603,TRX_N-00062-816131723342,2020-07-01T15:55:50,Vitoria-Gasteiz,transfer,Salary,1304.67,-4248.36
buyer_6,Manuel,45,ES43209562886882777603,TRX_N-00063-668950099842,2020-07-05T17:07:43,Vitoria-Gasteiz,Housing,Rent,-733.63,-4981.99
buyer_6,Manuel,45,ES43209562886882777603,TRX_N-00064-120854238684,2020-07-05T19:43:48,Vitoria-Gasteiz,Basic services,water,-44.1,-5026.09
buyer_6,Manuel,45,ES43209562886882777603,TRX_N-00065-553853072897,2020-07-05T12:32:17,Vitoria-Gasteiz,Basic services,electricity,-22.43,-5048.52
buyer_6,Manuel,45,ES43209562886882777603,TRX_N-00066-208384915515,2020-07-05T22:49:10,Vitoria-Gasteiz,Basic services,gas,-51.8,-5100.32
buyer_6,Manuel,45,ES43209562886882777603,TRX_N-00067-869852427437,2020-07-05T16:45:21,Vitoria-Gasteiz,Basic services,internet,-38.45,-5138.77
buyer_6,Manuel,45,ES43209562886882777603,TRX_N-00068-203411805242,2020-07-06T14:49:05,Vitoria-Gasteiz,Basic services,water,-68.0,-5206.77
buyer_6,Manuel,45,ES43209562886882777603,TRX_N-00069-8025072341,2020-07-06T14:43:20,Vitoria-Gasteiz,Basic services,gas,-59.14,-5265.91
buyer_6,Manuel,45,ES43209562886882777603,TRX_N-00070-158849375853,2020-07-06T22:24:31,Vitoria-Gasteiz,Basic services,internet,-30.28,-5296.19
buyer_6,Manuel,45,ES43209562886882777603,TRX_N-00071-54141891714,2020-07-06T12:53:43,Vitoria-Gasteiz,Basic services,phone,-24.05,-5320.24
buyer_6,Manuel,45,ES43209562886882777603,TRX_N-00072-305564944584,2020-07-07T18:38:05,Vitoria-Gasteiz,Basic services,water,-14.37,-5334.61
buyer_6,Manuel,45,ES43209562886882777603,TRX_N-00073-426016634274,2020-08-01T06:50:49,Vitoria-Gasteiz,transfer,Salary,1304.67,-4029.94
buyer_6,Manuel,45,ES43209562886882777603,TRX_N-00074-37213140676,2020-08-01T06:50:49,Vitoria-Gasteiz,transfer,Extra Income,130.47,-3899.47
buyer_6,Manuel,45,ES43209562886882777603,TRX_N-00075-443393207614,2020-08-05T09:39:47,Vitoria-Gasteiz,Housing,Rent,-733.63,-4633.1
buyer_6,Manuel,45,ES43209562886882777603,TRX_N-00076-993790268497,2020-08-05T06:34:16,Vitoria-Gasteiz,Basic services,internet,-75.0,-4708.1
buyer_6,Manuel,45,ES43209562886882777603,TRX_N-00077-553565471283,2020-08-06T23:47:10,Vitoria-Gasteiz,Basic services,gas,-47.28,-4755.38
buyer_6,Manuel,45,ES43209562886882777603,TRX_N-00078-93610781587,2020-08-06T16:35:34,Vitoria-Gasteiz,Basic services,internet,-60.61,-4815.99
buyer_6,Manuel,45,ES43209562886882777603,TRX_N-00079-412726974180,2020-08-06T13:53:35,Vitoria-Gasteiz,Basic services,phone,-43.13,-4859.12
buyer_6,Manuel,45,ES43209562886882777603,TRX_N-00080-108960402177,2020-08-07T10:35:45,Vitoria-Gasteiz,Basic services,water,-21.85,-4880.97
buyer_6,Manuel,45,ES43209562886882777603,TRX_N-00081-940207893555,2020-08-07T20:13:34,Vitoria-Gasteiz,Basic services,electricity,-32.84,-4913.81
buyer_6,Manuel,45,ES43209562886882777603,TRX_N-00082-588863767530,2020-08-07T17:48:13,Vitoria-Gasteiz,Basic services,gas,-39.91,-4953.72
buyer_6,Manuel,45,ES43209562886882777603,TRX_N-00083-611417401210,2020-08-07T14:14:54,Vitoria-Gasteiz,Basic services,internet,-34.11,-4987.83
buyer_6,Manuel,45,ES43209562886882777603,TRX_N-00084-24441236248,2020-08-11T20:05:02,Vitoria-Gasteiz,Expense,leisure,-89.49,-5077.32
buyer_6,Manuel,45,ES43209562886882777603,TRX_N-00085-314808461796,2020-08-16T12:24:52,Vitoria-Gasteiz,Expense,transport,-169.92,-5247.24
buyer_6,Manuel,45,ES43209562886882777603,TRX_N-00086-968915881558,2020-08-22T08:29:13,Mungia,Expense,repairs,-605.27,-5852.51
buyer_6,Manuel,45,ES43209562886882777603,TRX_N-00087-876237395954,2020-08-27T11:06:17,Santurtzi,Expense,gifts,-45.61,-5898.12
buyer_6,Manuel,45,ES43209562886882777603,TRX_N-00088-259002863619,2020-09-01T10:41:40,Vitoria-Gasteiz,transfer,Salary,1304.67,-4593.45
buyer_6,Manuel,45,ES43209562886882777603,TRX_N-00089-343773204922,2020-09-05T00:48:18,Vitoria-Gasteiz,Housing,Rent,-733.63,-5327.08
buyer_6,Manuel,45,ES43209562886882777603,TRX_N-00090-620741070485,2020-09-05T12:20:53,Vitoria-Gasteiz,Basic services,internet,-77.94,-5405.02
buyer_6,Manuel,45,ES43209562886882777603,TRX_N-00091-901013215742,2020-09-06T08:12:34,Vitoria-Gasteiz,Basic services,water,-17.84,-5422.86
buyer_6,Manuel,45,ES43209562886882777603,TRX_N-00092-32764186664,2020-09-06T20:35:34,Vitoria-Gasteiz,Basic services,phone,-56.65,-5479.51
buyer_6,Manuel,45,ES43209562886882777603,TRX_N-00093-187696329476,2020-09-07T17:50:53,Vitoria-Gasteiz,Basic services,internet,-76.7,-5556.21
buyer_6,Manuel,45,ES43209562886882777603,TRX_N-00094-764405224925,2020-09-07T09:13:44,Vitoria-Gasteiz,Basic services,phone,-27.92,-5584.13
buyer_6,Manuel,45,ES43209562886882777603,TRX_N-00095-529783017392,2020-09-08T08:53:47,Vitoria-Gasteiz,Expense,transport,-26.63,-5610.76
buyer_6,Manuel,45,ES43209562886882777603,TRX_N-00096-790249087109,2020-09-26T15:13:42,Eibar,Expense,clothing,-408.48,-6019.24
buyer_6,Manuel,45,ES43209562886882777603,TRX_N-00097-493430123425,2020-09-29T15:44:54,Vitoria-Gasteiz,Expense,travel,-1212.59,-7231.83
buyer_6,Manuel,45,ES43209562886882777603,TRX_N-00098-796925491610,2020-10-01T01:04:52,Vitoria-Gasteiz,transfer,Salary,1304.67,-5927.16
buyer_6,Manuel,45,ES43209562886882777603,TRX_N-00099-78045122386,2020-10-05T12:51:44,Vitoria-Gasteiz,Housing,Rent,-733.63,-6660.79
buyer_6,Manuel,45,ES43209562886882777603,TRX_N-00100-533417910340,2020-10-05T10:21:14,Vitoria-Gasteiz,Basic services,water,-26.34,-6687.13
buyer_6,Manuel,45,ES43209562886882777603,TRX_N-00101-410237739863,2020-10-05T08:57:51,Vitoria-Gasteiz,Basic services,electricity,-26.72,-6713.85
buyer_6,Manuel,45,ES43209562886882777603,TRX_N-00102-128984260948,2020-10-05T10:25:14,Vitoria-Gasteiz,Basic services,gas,-80.01,-6793.86
buyer_6,Manuel,45,ES43209562886882777603,TRX_N-00103-724875572457,2020-10-05T14:38:26,Vitoria-Gasteiz,Basic services,phone,-28.63,-6822.49
buyer_6,Manuel,45,ES43209562886882777603,TRX_N-00104-40099915469,2020-10-06T14:53:58,Vitoria-Gasteiz,Basic services,phone,-86.42,-6908.91
buyer_6,Manuel,45,ES43209562886882777603,TRX_N-00105-790705587422,2020-10-07T18:18:25,Vitoria-Gasteiz,Basic services,internet,-67.24,-6976.15
buyer_6,Manuel,45,ES43209562886882777603,TRX_N-00106-124644963228,2020-10-07T17:15:50,Vitoria-Gasteiz,Basic services,phone,-44.83,-7020.98
buyer_6,Manuel,45,ES43209562886882777603,TRX_N-00107-54232214500,2020-10-08T17:54:44,Vitoria-Gasteiz,Expense,healthcare,-353.9,-7374.88
buyer_6,Manuel,45,ES43209562886882777603,TRX_N-00108-182316372908,2020-10-11T22:38:13,Vitoria-Gasteiz,Expense,gifts,-422.08,-7796.96
buyer_6,Manuel,45,ES43209562886882777603,TRX_N-00109-692449031916,2020-10-12T04:21:06,Vitoria-Gasteiz,Expense,clothing,-445.18,-8242.14
buyer_6,Manuel,45,ES43209562886882777603,TRX_N-00110-161773211917,2020-10-21T16:30:07,Vitoria-Gasteiz,Expense,clothing,-172.83,-8414.97
buyer_6,Manuel,45,ES43209562886882777603,TRX_N-00111-823296587626,2020-11-01T19:09:05,Vitoria-Gasteiz,transfer,Salary,1304.67,-7110.3
buyer_6,Manuel,45,ES43209562886882777603,TRX_N-00112-93367245364,2020-11-01T19:09:05,Vitoria-Gasteiz,transfer,Extra Income,130.47,-6979.83
buyer_6,Manuel,45,ES43209562886882777603,TRX_N-00113-815006289039,2020-11-02T08:38:53,Vitoria-Gasteiz,Expense,leisure,-103.94,-7083.77
buyer_6,Manuel,45,ES43209562886882777603,TRX_N-00114-305911232716,2020-11-05T21:47:49,Vitoria-Gasteiz,Housing,Rent,-733.63,-7817.4
buyer_6,Manuel,45,ES43209562886882777603,TRX_N-00115-480321944990,2020-11-05T10:54:18,Vitoria-Gasteiz,Basic services,water,-46.98,-7864.38
buyer_6,Manuel,45,ES43209562886882777603,TRX_N-00116-912112509861,2020-11-05T00:09:14,Vitoria-Gasteiz,Basic services,internet,-68.15,-7932.53
buyer_6,Manuel,45,ES43209562886882777603,TRX_N-00117-658733467144,2020-11-07T12:32:17,Vitoria-Gasteiz,Basic services,electricity,-104.09,-8036.62
buyer_6,Manuel,45,ES43209562886882777603,TRX_N-00118-455040520879,2020-11-07T09:22:53,Vitoria-Gasteiz,Basic services,internet,-62.07,-8098.69
buyer_6,Manuel,45,ES43209562886882777603,TRX_N-00119-450411431940,2020-11-07T09:01:56,Vitoria-Gasteiz,Basic services,phone,-36.17,-8134.86
buyer_6,Manuel,45,ES43209562886882777603,TRX_N-00120-454948228438,2020-11-14T19:45:09,Vitoria-Gasteiz,Expense,food,-123.89,-8258.75
buyer_6,Manuel,45,ES43209562886882777603,TRX_N-00121-467646108212,2020-11-23T18:08:03,Vitoria-Gasteiz,Expense,transport,-72.53,-8331.28
buyer_6,Manuel,45,ES43209562886882777603,TRX_N-00122-13359473398,2020-12-01T12:11:57,Vitoria-Gasteiz,transfer,Salary,1304.67,-7026.61
buyer_6,Manuel,45,ES43209562886882777603,TRX_N-00123-408824810975,2020-12-01T12:11:57,Vitoria-Gasteiz,transfer,Bonus,1250.72,-5775.89
buyer_6,Manuel,45,ES43209562886882777603,TRX_N-00124-958827612632,2020-12-05T15:34:42,Vitoria-Gasteiz,Housing,Rent,-733.63,-6509.52
buyer_6,Manuel,45,ES43209562886882777603,TRX_N-00125-271638635977,2020-12-06T06:26:38,Vitoria-Gasteiz,Basic services,water,-34.17,-6543.69
buyer_6,Manuel,45,ES43209562886882777603,TRX_N-00126-666806785625,2020-12-07T12:35:17,Vitoria-Gasteiz,Basic services,gas,-85.98,-6629.67
buyer_6,Manuel,45,ES43209562886882777603,TRX_N-00127-207242764324,2020-12-08T20:05:51,Vitoria-Gasteiz,Expense,food,-724.97,-7354.64
buyer_6,Manuel,45,ES43209562886882777603,TRX_N-00128-838138808671,2020-12-21T20:30:36,Vitoria-Gasteiz,Expense,leisure,-30.35,-7384.99
buyer_6,Manuel,45,ES43209562886882777603,TRX_N-00129-128188125811,2020-12-24T10:12:39,Arrasate/Mondragon,Expense,healthcare,-229.55,-7614.54
buyer_6,Manuel,45,ES43209562886882777603,TRX_N-00130-622823885944,2021-01-01T11:02:27,Vitoria-Gasteiz,transfer,Salary,1304.67,-6309.87
buyer_6,Manuel,45,ES43209562886882777603,TRX_N-00131-807792128114,2021-01-01T17:18:57,Vitoria-Gasteiz,Expense,transport,-79.36,-6389.23
buyer_6,Manuel,45,ES43209562886882777603,TRX_N-00132-582818399153,2021-01-05T20:18:18,Vitoria-Gasteiz,Housing,Rent,-733.63,-7122.86
buyer_6,Manuel,45,ES43209562886882777603,TRX_N-00133-440059072456,2021-01-05T20:21:52,Vitoria-Gasteiz,Basic services,water,-39.71,-7162.57
buyer_6,Manuel,45,ES43209562886882777603,TRX_N-00134-271150072611,2021-01-06T13:55:31,Vitoria-Gasteiz,Basic services,electricity,-43.96,-7206.53
buyer_6,Manuel,45,ES43209562886882777603,TRX_N-00135-586120139091,2021-01-06T09:05:14,Vitoria-Gasteiz,Basic services,gas,-18.25,-7224.78
buyer_6,Manuel,45,ES43209562886882777603,TRX_N-00136-33421024411,2021-01-06T18:27:32,Vitoria-Gasteiz,Basic services,phone,-42.31,-7267.09
buyer_6,Manuel,45,ES43209562886882777603,TRX_N-00137-304138875330,2021-01-06T21:20:22,Mungia,Expense,clothing,-77.25,-7344.34
buyer_6,Manuel,45,ES43209562886882777603,TRX_N-00138-791852472674,2021-01-07T08:25:48,Vitoria-Gasteiz,Basic services,water,-71.15,-7415.49
buyer_6,Manuel,45,ES43209562886882777603,TRX_N-00139-826282174698,2021-01-07T16:32:08,Vitoria-Gasteiz,Basic services,gas,-24.17,-7439.66
buyer_6,Manuel,45,ES43209562886882777603,TRX_N-00140-173869116709,2021-01-07T20:21:40,Vitoria-Gasteiz,Basic services,phone,-91.39,-7531.05
buyer_6,Manuel,45,ES43209562886882777603,TRX_N-00141-862478173005,2021-01-07T19:44:30,Vitoria-Gasteiz,Expense,leisure,-11.16,-7542.21
buyer_6,Manuel,45,ES43209562886882777603,TRX_N-00142-342685926751,2021-01-20T18:45:13,Vitoria-Gasteiz,Expense,food,-514.83,-8057.04
buyer_6,Manuel,45,ES43209562886882777603,TRX_N-00143-888196052605,2021-01-21T09:20:14,Vitoria-Gasteiz,Expense,education,-761.29,-8818.33
buyer_6,Manuel,45,ES43209562886882777603,TRX_N-00144-675934511229,2021-01-23T15:56:41,Vitoria-Gasteiz,Expense,transport,-114.59,-8932.92
buyer_6,Manuel,45,ES43209562886882777603,TRX_N-00145-172821018025,2021-01-23T12:34:59,Errenteria,Expense,clothing,-306.4,-9239.32
buyer_6,Manuel,45,ES43209562886882777603,TRX_N-00146-281823823356,2021-02-01T12:11:41,Vitoria-Gasteiz,transfer,Salary,1304.67,-7934.65
buyer_6,Manuel,45,ES43209562886882777603,TRX_N-00147-935870488859,2021-02-01T12:11:41,Vitoria-Gasteiz,transfer,Extra Income,130.47,-7804.18
buyer_6,Manuel,45,ES43209562886882777603,TRX_N-00148-466561043789,2021-02-05T20:51:56,Vitoria-Gasteiz,Housing,Rent,-733.63,-8537.81
buyer_6,Manuel,45,ES43209562886882777603,TRX_N-00149-917587668402,2021-02-05T18:05:33,Vitoria-Gasteiz,Basic services,electricity,-90.86,-8628.67
buyer_6,Manuel,45,ES43209562886882777603,TRX_N-00150-561940683269,2021-02-05T15:50:22,Vitoria-Gasteiz,Basic services,phone,-27.85,-8656.52
buyer_6,Manuel,45,ES43209562886882777603,TRX_N-00151-908777682466,2021-02-06T16:12:17,Vitoria-Gasteiz,Basic services,internet,-69.7,-8726.22
buyer_6,Manuel,45,ES43209562886882777603,TRX_N-00152-395414984034,2021-02-06T08:40:30,Vitoria-Gasteiz,Basic services,phone,-35.17,-8761.39
buyer_6,Manuel,45,ES43209562886882777603,TRX_N-00153-139664719411,2021-02-07T08:55:12,Vitoria-Gasteiz,Basic services,water,-41.75,-8803.14
buyer_6,Manuel,45,ES43209562886882777603,TRX_N-00154-110053787123,2021-02-07T19:47:59,Vitoria-Gasteiz,Expense,education,-844.86,-9648.0
buyer_6,Manuel,45,ES43209562886882777603,TRX_N-00155-772311385522,2021-02-10T22:19:01,Vitoria-Gasteiz,Expense,food,-206.82,-9854.82
buyer_6,Manuel,45,ES43209562886882777603,TRX_N-00156-32549464903,2021-02-17T22:38:23,Vitoria-Gasteiz,Expense,healthcare,-207.85,-10062.67
buyer_6,Manuel,45,ES43209562886882777603,TRX_N-00157-452991081018,2021-03-01T19:46:13,Vitoria-Gasteiz,transfer,Salary,1304.67,-8758.0
buyer_6,Manuel,45,ES43209562886882777603,TRX_N-00158-375176400597,2021-03-05T14:57:47,Vitoria-Gasteiz,Housing,Rent,-733.63,-9491.63
buyer_6,Manuel,45,ES43209562886882777603,TRX_N-00159-211417974977,2021-03-05T15:48:22,Vitoria-Gasteiz,Basic services,water,-69.59,-9561.22
buyer_6,Manuel,45,ES43209562886882777603,TRX_N-00160-611647659435,2021-03-05T22:18:25,Vitoria-Gasteiz,Basic services,phone,-34.75,-9595.97
buyer_6,Manuel,45,ES43209562886882777603,TRX_N-00161-401687576352,2021-03-06T15:42:29,Vitoria-Gasteiz,Basic services,gas,-21.82,-9617.79
buyer_6,Manuel,45,ES43209562886882777603,TRX_N-00162-434785883655,2021-03-07T17:49:10,Vitoria-Gasteiz,Basic services,internet,-32.04,-9649.83
buyer_6,Manuel,45,ES43209562886882777603,TRX_N-00163-78049580533,2021-03-22T12:13:38,Vitoria-Gasteiz,Expense,transport,-31.81,-9681.64
buyer_6,Manuel,45,ES43209562886882777603,TRX_N-00164-461712517462,2021-03-25T14:05:23,Vitoria-Gasteiz,Expense,transport,-84.0,-9765.64
buyer_6,Manuel,45,ES43209562886882777603,TRX_N-00165-218709082733,2021-03-31T19:51:08,Vitoria-Gasteiz,Expense,transport,-178.29,-9943.93
buyer_6,Manuel,45,ES43209562886882777603,TRX_N-00166-326829489434,2021-04-01T22:15:50,Vitoria-Gasteiz,transfer,Salary,1304.67,-8639.26
buyer_6,Manuel,45,ES43209562886882777603,TRX_N-00167-102556679627,2021-04-02T10:03:06,Vitoria-Gasteiz,Expense,food,-390.02,-9029.28
buyer_6,Manuel,45,ES43209562886882777603,TRX_N-00168-343275538735,2021-04-05T12:29:50,Vitoria-Gasteiz,Housing,Rent,-733.63,-9762.91
buyer_6,Manuel,45,ES43209562886882777603,TRX_N-00169-868223741082,2021-04-05T18:13:05,Vitoria-Gasteiz,Basic services,electricity,-59.94,-9822.85
buyer_6,Manuel,45,ES43209562886882777603,TRX_N-00170-136025361478,2021-04-05T17:23:37,Vitoria-Gasteiz,Basic services,gas,-69.06,-9891.91
buyer_6,Manuel,45,ES43209562886882777603,TRX_N-00171-522724079826,2021-04-05T10:06:15,Vitoria-Gasteiz,Basic services,internet,-75.44,-9967.35
buyer_6,Manuel,45,ES43209562886882777603,TRX_N-00172-799631605110,2021-04-06T13:45:42,Vitoria-Gasteiz,Basic services,water,-61.31,-10028.66
buyer_6,Manuel,45,ES43209562886882777603,TRX_N-00173-941742553018,2021-04-06T11:57:40,Vitoria-Gasteiz,Basic services,electricity,-91.37,-10120.03
buyer_6,Manuel,45,ES43209562886882777603,TRX_N-00174-347487400006,2021-04-06T14:32:48,Vitoria-Gasteiz,Basic services,internet,-58.14,-10178.17
buyer_6,Manuel,45,ES43209562886882777603,TRX_N-00175-8067472044,2021-04-07T16:34:34,Vitoria-Gasteiz,Basic services,internet,-60.91,-10239.08
buyer_6,Manuel,45,ES43209562886882777603,TRX_N-00176-818043155829,2021-05-01T10:11:09,Vitoria-Gasteiz,transfer,Salary,1304.67,-8934.41
buyer_6,Manuel,45,ES43209562886882777603,TRX_N-00177-405827771026,2021-05-01T10:11:09,Vitoria-Gasteiz,transfer,Extra Income,130.47,-8803.94
buyer_6,Manuel,45,ES43209562886882777603,TRX_N-00178-356919358478,2021-05-05T13:38:03,Vitoria-Gasteiz,Housing,Rent,-733.63,-9537.57
buyer_6,Manuel,45,ES43209562886882777603,TRX_N-00179-6030281846,2021-05-05T20:20:14,Vitoria-Gasteiz,Basic services,gas,-92.91,-9630.48
buyer_6,Manuel,45,ES43209562886882777603,TRX_N-00180-256981894525,2021-05-06T11:02:27,Vitoria-Gasteiz,Basic services,electricity,-147.96,-9778.44
buyer_6,Manuel,45,ES43209562886882777603,TRX_N-00181-269568712780,2021-05-06T09:29:21,Vitoria-Gasteiz,Basic services,gas,-25.42,-9803.86
buyer_6,Manuel,45,ES43209562886882777603,TRX_N-00182-547208697540,2021-05-06T22:52:57,Vitoria-Gasteiz,Basic services,internet,-61.2,-9865.06
buyer_6,Manuel,45,ES43209562886882777603,TRX_N-00183-409144070745,2021-05-06T17:15:56,Vitoria-Gasteiz,Expense,food,-643.57,-10508.63
buyer_6,Manuel,45,ES43209562886882777603,TRX_N-00184-386922264689,2021-05-07T13:31:42,Vitoria-Gasteiz,Basic services,electricity,-145.41,-10654.04
buyer_6,Manuel,45,ES43209562886882777603,TRX_N-00185-803171584935,2021-05-13T19:15:27,Vitoria-Gasteiz,Expense,transport,-95.78,-10749.82
buyer_6,Manuel,45,ES43209562886882777603,TRX_N-00186-456499770883,2021-05-14T11:57:26,Getxo,Expense,gifts,-87.43,-10837.25
buyer_6,Manuel,45,ES43209562886882777603,TRX_N-00187-122500826593,2021-05-15T12:03:11,Vitoria-Gasteiz,Expense,leisure,-53.75,-10891.0
buyer_6,Manuel,45,ES43209562886882777603,TRX_N-00188-440551902251,2021-05-17T14:36:53,Vitoria-Gasteiz,Expense,food,-505.04,-11396.04
buyer_6,Manuel,45,ES43209562886882777603,TRX_N-00189-959888259608,2021-05-17T10:09:58,Vitoria-Gasteiz,Expense,education,-709.67,-12105.71
buyer_6,Manuel,45,ES43209562886882777603,TRX_N-00190-638825545049,2021-05-20T08:20:03,Vitoria-Gasteiz,Expense,clothing,-438.37,-12544.08
buyer_6,Manuel,45,ES43209562886882777603,TRX_N-00191-513780565741,2021-05-21T10:18:45,Hondarribia,Expense,clothing,-493.42,-13037.5
buyer_6,Manuel,45,ES43209562886882777603,TRX_N-00192-728005426344,2021-05-28T11:31:46,Vitoria-Gasteiz,Expense,education,-190.34,-13227.84
buyer_6,Manuel,45,ES43209562886882777603,TRX_N-00193-667459741895,2021-06-01T17:38:38,Vitoria-Gasteiz,transfer,Salary,1304.67,-11923.17
buyer_6,Manuel,45,ES43209562886882777603,TRX_N-00194-275067756000,2021-06-01T17:38:38,Vitoria-Gasteiz,transfer,Bonus,1391.5,-10531.67
buyer_6,Manuel,45,ES43209562886882777603,TRX_N-00195-827536723022,2021-06-02T15:59:34,Sopela,Expense,leisure,-20.81,-10552.48
buyer_6,Manuel,45,ES43209562886882777603,TRX_N-00196-305959295164,2021-06-05T19:47:32,Vitoria-Gasteiz,Housing,Rent,-733.63,-11286.11
buyer_6,Manuel,45,ES43209562886882777603,TRX_N-00197-508559532867,2021-06-05T18:47:47,Vitoria-Gasteiz,Basic services,water,-45.49,-11331.6
buyer_6,Manuel,45,ES43209562886882777603,TRX_N-00198-221378871433,2021-06-05T10:50:11,Vitoria-Gasteiz,Basic services,electricity,-102.82,-11434.42
buyer_6,Manuel,45,ES43209562886882777603,TRX_N-00199-740197122121,2021-06-06T05:06:55,Vitoria-Gasteiz,Basic services,phone,-78.5,-11512.92
buyer_6,Manuel,45,ES43209562886882777603,TRX_N-00200-62536069346,2021-06-07T12:36:39,Vitoria-Gasteiz,Basic services,water,-64.48,-11577.4
buyer_6,Manuel,45,ES43209562886882777603,TRX_N-00201-529581116905,2021-06-07T08:44:00,Vitoria-Gasteiz,Basic services,electricity,-91.11,-11668.51
buyer_6,Manuel,45,ES43209562886882777603,TRX_N-00202-332326226112,2021-06-07T20:56:05,Vitoria-Gasteiz,Basic services,gas,-61.55,-11730.06
buyer_6,Manuel,45,ES43209562886882777603,TRX_N-00203-198569364280,2021-06-09T10:20:02,Vitoria-Gasteiz,Expense,clothing,-318.96,-12049.02
buyer_6,Manuel,45,ES43209562886882777603,TRX_N-00204-803542868494,2021-06-23T11:03:39,Elciego,Expense,food,-792.72,-12841.74
buyer_6,Manuel,45,ES43209562886882777603,TRX_N-00205-585509789773,2021-06-27T13:22:53,Vitoria-Gasteiz,Expense,healthcare,-363.68,-13205.42
buyer_6,Manuel,45,ES43209562886882777603,TRX_N-00206-540443275761,2021-07-01T12:31:02,Vitoria-Gasteiz,transfer,Salary,1304.67,-11900.75
buyer_6,Manuel,45,ES43209562886882777603,TRX_N-00207-636554076684,2021-07-01T12:31:02,Vitoria-Gasteiz,transfer,Extra Income,130.47,-11770.28
buyer_6,Manuel,45,ES43209562886882777603,TRX_N-00208-620691192633,2021-07-01T11:02:50,Vitoria-Gasteiz,Expense,clothing,-246.93,-12017.21
buyer_6,Manuel,45,ES43209562886882777603,TRX_N-00209-94008908991,2021-07-05T20:35:34,Vitoria-Gasteiz,Housing,Rent,-733.63,-12750.84
buyer_6,Manuel,45,ES43209562886882777603,TRX_N-00210-644107825927,2021-07-06T19:28:37,Vitoria-Gasteiz,Basic services,water,-41.34,-12792.18
buyer_6,Manuel,45,ES43209562886882777603,TRX_N-00211-152706685829,2021-07-06T21:53:22,Vitoria-Gasteiz,Basic services,internet,-66.48,-12858.66
buyer_6,Manuel,45,ES43209562886882777603,TRX_N-00212-289563744695,2021-07-07T15:17:53,Vitoria-Gasteiz,Expense,transport,-94.6,-12953.26
buyer_6,Manuel,45,ES43209562886882777603,TRX_N-00213-56722613245,2021-07-15T13:59:07,Vitoria-Gasteiz,Expense,transport,-168.44,-13121.7
buyer_6,Manuel,45,ES43209562886882777603,TRX_N-00214-870669308541,2021-08-01T23:11:04,Vitoria-Gasteiz,transfer,Salary,1304.67,-11817.03
buyer_6,Manuel,45,ES43209562886882777603,TRX_N-00215-269630098368,2021-08-02T12:47:22,Vitoria-Gasteiz,Expense,leisure,-62.79,-11879.82
buyer_6,Manuel,45,ES43209562886882777603,TRX_N-00216-908982258831,2021-08-05T19:13:46,Vitoria-Gasteiz,Housing,Rent,-733.63,-12613.45
buyer_6,Manuel,45,ES43209562886882777603,TRX_N-00217-403399878788,2021-08-05T18:59:26,Vitoria-Gasteiz,Basic services,water,-39.28,-12652.73
buyer_6,Manuel,45,ES43209562886882777603,TRX_N-00218-999482214419,2021-08-05T19:20:22,Vitoria-Gasteiz,Basic services,internet,-64.61,-12717.34
buyer_6,Manuel,45,ES43209562886882777603,TRX_N-00219-282431585741,2021-08-05T08:47:20,Vitoria-Gasteiz,Basic services,phone,-92.55,-12809.89
buyer_6,Manuel,45,ES43209562886882777603,TRX_N-00220-195147225923,2021-08-06T08:59:07,Vitoria-Gasteiz,Basic services,electricity,-107.52,-12917.41
buyer_6,Manuel,45,ES43209562886882777603,TRX_N-00221-177745775000,2021-08-06T10:46:40,Vitoria-Gasteiz,Basic services,internet,-46.11,-12963.52
buyer_6,Manuel,45,ES43209562886882777603,TRX_N-00222-840192373137,2021-08-06T15:42:04,Vitoria-Gasteiz,Basic services,phone,-30.65,-12994.17
buyer_6,Manuel,45,ES43209562886882777603,TRX_N-00223-551994143256,2021-08-07T19:44:08,Vitoria-Gasteiz,Basic services,electricity,-82.08,-13076.25
buyer_6,Manuel,45,ES43209562886882777603,TRX_N-00224-730582079806,2021-08-07T08:32:40,Vitoria-Gasteiz,Basic services,gas,-43.34,-13119.59
buyer_6,Manuel,45,ES43209562886882777603,TRX_N-00225-806450835975,2021-08-07T11:40:40,Vitoria-Gasteiz,Basic services,internet,-30.41,-13150.0
buyer_6,Manuel,45,ES43209562886882777603,TRX_N-00226-289776039804,2021-09-01T22:09:04,Vitoria-Gasteiz,transfer,Salary,1304.67,-11845.33
buyer_6,Manuel,45,ES43209562886882777603,TRX_N-00227-304405017701,2021-09-01T22:09:04,Vitoria-Gasteiz,transfer,Extra Income,130.47,-11714.86
buyer_6,Manuel,45,ES43209562886882777603,TRX_N-00228-147478001221,2021-09-05T18:35:56,Vitoria-Gasteiz,Housing,Rent,-733.63,-12448.49
buyer_6,Manuel,45,ES43209562886882777603,TRX_N-00229-759444126984,2021-09-05T13:28:43,Vitoria-Gasteiz,Basic services,electricity,-53.7,-12502.19
buyer_6,Manuel,45,ES43209562886882777603,TRX_N-00230-245171703557,2021-09-05T02:07:08,Vitoria-Gasteiz,Basic services,internet,-74.66,-12576.85
buyer_6,Manuel,45,ES43209562886882777603,TRX_N-00231-470882745043,2021-09-05T08:18:16,Vitoria-Gasteiz,Basic services,phone,-26.82,-12603.67
buyer_6,Manuel,45,ES43209562886882777603,TRX_N-00232-205203805446,2021-09-07T20:19:02,Vitoria-Gasteiz,Basic services,water,-65.82,-12669.49
buyer_6,Manuel,45,ES43209562886882777603,TRX_N-00233-400638773936,2021-09-07T18:12:12,Vitoria-Gasteiz,Basic services,internet,-34.4,-12703.89
buyer_6,Manuel,45,ES43209562886882777603,TRX_N-00234-275123840584,2021-09-30T20:17:12,Vitoria-Gasteiz,Expense,leisure,-213.26,-12917.15
buyer_6,Manuel,45,ES43209562886882777603,TRX_N-00235-174603765621,2021-10-01T13:52:25,Vitoria-Gasteiz,transfer,Salary,1304.67,-11612.48
buyer_6,Manuel,45,ES43209562886882777603,TRX_N-00236-445374766770,2021-10-03T15:18:19,Vitoria-Gasteiz,Expense,leisure,-222.23,-11834.71
buyer_6,Manuel,45,ES43209562886882777603,TRX_N-00237-50970282832,2021-10-05T11:26:23,Vitoria-Gasteiz,Housing,Rent,-733.63,-12568.34
buyer_6,Manuel,45,ES43209562886882777603,TRX_N-00238-751432940087,2021-10-06T09:26:25,Vitoria-Gasteiz,Basic services,water,-22.22,-12590.56
buyer_6,Manuel,45,ES43209562886882777603,TRX_N-00239-948512234361,2021-10-06T08:22:05,Vitoria-Gasteiz,Basic services,electricity,-123.89,-12714.45
buyer_6,Manuel,45,ES43209562886882777603,TRX_N-00240-44146021758,2021-10-06T18:11:24,Vitoria-Gasteiz,Basic services,gas,-64.73,-12779.18
buyer_6,Manuel,45,ES43209562886882777603,TRX_N-00241-857946263466,2021-10-07T08:40:59,Vitoria-Gasteiz,Basic services,water,-21.77,-12800.95
buyer_6,Manuel,45,ES43209562886882777603,TRX_N-00242-897716538380,2021-10-07T21:59:39,Vitoria-Gasteiz,Basic services,phone,-25.48,-12826.43
buyer_6,Manuel,45,ES43209562886882777603,TRX_N-00243-572953606732,2021-10-20T00:49:09,Vitoria-Gasteiz,Expense,leisure,-30.2,-12856.63
buyer_6,Manuel,45,ES43209562886882777603,TRX_N-00244-640767874326,2021-10-25T14:41:45,Oyón-Oion,Expense,food,-534.07,-13390.7
buyer_6,Manuel,45,ES43209562886882777603,TRX_N-00245-536503376414,2021-10-27T14:59:02,Zarautz,Expense,healthcare,-345.63,-13736.33
buyer_6,Manuel,45,ES43209562886882777603,TRX_N-00246-227943792609,2021-10-28T15:31:02,Vitoria-Gasteiz,Expense,transport,-47.8,-13784.13
buyer_6,Manuel,45,ES43209562886882777603,TRX_N-00247-677289905513,2021-11-01T17:37:27,Vitoria-Gasteiz,transfer,Salary,1304.67,-12479.46
buyer_6,Manuel,45,ES43209562886882777603,TRX_N-00248-697317933657,2021-11-05T13:30:58,Vitoria-Gasteiz,Housing,Rent,-733.63,-13213.09
buyer_6,Manuel,45,ES43209562886882777603,TRX_N-00249-409398741159,2021-11-06T10:44:59,Vitoria-Gasteiz,Basic services,water,-78.21,-13291.3
buyer_6,Manuel,45,ES43209562886882777603,TRX_N-00250-59598357830,2021-11-06T23:27:36,Vitoria-Gasteiz,Basic services,electricity,-116.17,-13407.47
buyer_6,Manuel,45,ES43209562886882777603,TRX_N-00251-267981667595,2021-11-06T19:41:55,Vitoria-Gasteiz,Basic services,internet,-78.43,-13485.9
buyer_6,Manuel,45,ES43209562886882777603,TRX_N-00252-533482092978,2021-11-07T04:49:44,Vitoria-Gasteiz,Basic services,water,-68.26,-13554.16
buyer_6,Manuel,45,ES43209562886882777603,TRX_N-00253-566155143904,2021-11-08T10:00:40,Vitoria-Gasteiz,Expense,clothing,-296.8,-13850.96
buyer_6,Manuel,45,ES43209562886882777603,TRX_N-00254-469371093325,2021-11-23T04:49:59,Vitoria-Gasteiz,Expense,leisure,-230.17,-14081.13
buyer_6,Manuel,45,ES43209562886882777603,TRX_N-00255-578633319947,2021-11-27T05:07:53,Basauri,Expense,healthcare,-274.88,-14356.01
buyer_6,Manuel,45,ES43209562886882777603,TRX_N-00256-181772714079,2021-12-01T16:18:13,Vitoria-Gasteiz,transfer,Salary,1304.67,-13051.34
buyer_6,Manuel,45,ES43209562886882777603,TRX_N-00257-380843194888,2021-12-01T16:18:13,Vitoria-Gasteiz,transfer,Extra Income,130.47,-12920.87
buyer_6,Manuel,45,ES43209562886882777603,TRX_N-00258-410080286222,2021-12-01T16:18:13,Vitoria-Gasteiz,transfer,Bonus,1361.2,-11559.67
buyer_6,Manuel,45,ES43209562886882777603,TRX_N-00259-245770487726,2021-12-03T17:10:49,Vitoria-Gasteiz,Expense,transport,-133.2,-11692.87
buyer_6,Manuel,45,ES43209562886882777603,TRX_N-00260-699797848477,2021-12-05T14:44:40,Vitoria-Gasteiz,Housing,Rent,-733.63,-12426.5
buyer_6,Manuel,45,ES43209562886882777603,TRX_N-00261-980577014049,2021-12-05T12:44:23,Vitoria-Gasteiz,Basic services,water,-55.55,-12482.05
buyer_6,Manuel,45,ES43209562886882777603,TRX_N-00262-844475161317,2021-12-05T02:51:54,Vitoria-Gasteiz,Basic services,electricity,-127.23,-12609.28
buyer_6,Manuel,45,ES43209562886882777603,TRX_N-00263-648435706880,2021-12-05T09:08:53,Vitoria-Gasteiz,Basic services,gas,-64.28,-12673.56
buyer_6,Manuel,45,ES43209562886882777603,TRX_N-00264-487102135215,2021-12-05T10:05:23,Vitoria-Gasteiz,Basic services,phone,-26.66,-12700.22
buyer_6,Manuel,45,ES43209562886882777603,TRX_N-00265-633237737342,2021-12-05T13:29:16,Vitoria-Gasteiz,Expense,transport,-142.78,-12843.0
buyer_6,Manuel,45,ES43209562886882777603,TRX_N-00266-173364429618,2021-12-06T11:09:35,Vitoria-Gasteiz,Expense,food,-796.55,-13639.55
buyer_6,Manuel,45,ES43209562886882777603,TRX_N-00267-156784264332,2021-12-07T16:48:23,Vitoria-Gasteiz,Basic services,gas,-44.82,-13684.37
buyer_6,Manuel,45,ES43209562886882777603,TRX_N-00268-283687491559,2021-12-07T23:50:50,Vitoria-Gasteiz,Basic services,phone,-95.54,-13779.91
buyer_6,Manuel,45,ES43209562886882777603,TRX_N-00269-708259753483,2021-12-07T18:29:02,Vitoria-Gasteiz,Expense,food,-283.76,-14063.67
buyer_6,Manuel,45,ES43209562886882777603,TRX_N-00270-281528068426,2021-12-09T13:48:16,Vitoria-Gasteiz,Expense,travel,-1604.03,-15667.7
buyer_6,Manuel,45,ES43209562886882777603,TRX_N-00271-212737983023,2021-12-14T12:57:45,Vitoria-Gasteiz,Expense,transport,-43.9,-15711.6
buyer_6,Manuel,45,ES43209562886882777603,TRX_N-00272-817890514052,2021-12-24T08:00:04,Berango,Expense,food,-770.96,-16482.56
buyer_6,Manuel,45,ES43209562886882777603,TRX_N-00273-414832260701,2022-01-01T21:24:30,Vitoria-Gasteiz,transfer,Salary,1304.67,-15177.89
buyer_6,Manuel,45,ES43209562886882777603,TRX_N-00274-30852252095,2022-01-03T14:48:39,Vitoria-Gasteiz,Expense,clothing,-334.27,-15512.16
buyer_6,Manuel,45,ES43209562886882777603,TRX_N-00275-579566752241,2022-01-05T13:08:56,Vitoria-Gasteiz,Housing,Rent,-733.63,-16245.79
buyer_6,Manuel,45,ES43209562886882777603,TRX_N-00276-92954039178,2022-01-05T05:03:36,Vitoria-Gasteiz,Basic services,water,-75.48,-16321.27
buyer_6,Manuel,45,ES43209562886882777603,TRX_N-00277-194724819002,2022-01-07T15:49:28,Vitoria-Gasteiz,Basic services,water,-61.82,-16383.09
buyer_6,Manuel,45,ES43209562886882777603,TRX_N-00278-819620221387,2022-01-11T12:56:57,Vitoria-Gasteiz,Expense,transport,-38.57,-16421.66
buyer_6,Manuel,45,ES43209562886882777603,TRX_N-00279-109592682113,2022-01-11T15:30:49,Vitoria-Gasteiz,Expense,healthcare,-249.13,-16670.79
buyer_6,Manuel,45,ES43209562886882777603,TRX_N-00280-671240583475,2022-01-13T08:20:34,Vitoria-Gasteiz,Expense,appliances,-1739.23,-18410.02
buyer_6,Manuel,45,ES43209562886882777603,TRX_N-00281-917359667963,2022-01-14T08:14:53,Vitoria-Gasteiz,Expense,food,-278.37,-18688.39
buyer_6,Manuel,45,ES43209562886882777603,TRX_N-00282-112995697031,2022-02-01T18:24:13,Vitoria-Gasteiz,transfer,Salary,1304.67,-17383.72
buyer_6,Manuel,45,ES43209562886882777603,TRX_N-00283-797194122170,2022-02-03T16:59:52,Vitoria-Gasteiz,Expense,leisure,-130.35,-17514.07
buyer_6,Manuel,45,ES43209562886882777603,TRX_N-00284-928885893407,2022-02-05T08:42:42,Vitoria-Gasteiz,Housing,Rent,-733.63,-18247.7
buyer_6,Manuel,45,ES43209562886882777603,TRX_N-00285-809054518173,2022-02-05T12:17:05,Vitoria-Gasteiz,Basic services,internet,-43.37,-18291.07
buyer_6,Manuel,45,ES43209562886882777603,TRX_N-00286-997137950657,2022-02-06T19:30:46,Vitoria-Gasteiz,Basic services,electricity,-63.43,-18354.5
buyer_6,Manuel,45,ES43209562886882777603,TRX_N-00287-810292877001,2022-02-06T06:54:43,Vitoria-Gasteiz,Basic services,internet,-48.64,-18403.14
buyer_6,Manuel,45,ES43209562886882777603,TRX_N-00288-340899471255,2022-02-10T10:25:08,Vitoria-Gasteiz,Expense,clothing,-49.17,-18452.31
buyer_6,Manuel,45,ES43209562886882777603,TRX_N-00289-375158230374,2022-02-24T08:37:39,Vitoria-Gasteiz,Expense,clothing,-491.6,-18943.91
buyer_6,Manuel,45,ES43209562886882777603,TRX_N-00290-82640751367,2022-03-01T02:35:39,Vitoria-Gasteiz,transfer,Salary,1304.67,-17639.24
buyer_6,Manuel,45,ES43209562886882777603,TRX_N-00291-440722340487,2022-03-01T02:35:39,Vitoria-Gasteiz,transfer,Extra Income,130.47,-17508.77
buyer_6,Manuel,45,ES43209562886882777603,TRX_N-00292-192714114864,2022-03-02T08:21:39,Sestao,Expense,transport,-22.76,-17531.53
buyer_6,Manuel,45,ES43209562886882777603,TRX_N-00293-102225951621,2022-03-05T11:07:54,Vitoria-Gasteiz,Housing,Rent,-733.63,-18265.16
buyer_6,Manuel,45,ES43209562886882777603,TRX_N-00294-147600548575,2022-03-05T16:50:01,Vitoria-Gasteiz,Basic services,electricity,-129.09,-18394.25
buyer_6,Manuel,45,ES43209562886882777603,TRX_N-00295-610822290835,2022-03-05T11:16:01,Vitoria-Gasteiz,Basic services,phone,-65.72,-18459.97
buyer_6,Manuel,45,ES43209562886882777603,TRX_N-00296-326381142948,2022-03-06T08:16:06,Vitoria-Gasteiz,Basic services,gas,-95.48,-18555.45
buyer_6,Manuel,45,ES43209562886882777603,TRX_N-00297-776486348448,2022-03-06T13:15:06,Vitoria-Gasteiz,Basic services,phone,-63.12,-18618.57
buyer_6,Manuel,45,ES43209562886882777603,TRX_N-00298-438815439913,2022-03-06T20:14:29,Vitoria-Gasteiz,Expense,food,-570.14,-19188.71
buyer_6,Manuel,45,ES43209562886882777603,TRX_N-00299-150521283971,2022-03-07T15:38:43,Vitoria-Gasteiz,Basic services,electricity,-97.05,-19285.76
buyer_6,Manuel,45,ES43209562886882777603,TRX_N-00300-155718366150,2022-03-07T21:55:10,Vitoria-Gasteiz,Basic services,phone,-79.64,-19365.4
buyer_6,Manuel,45,ES43209562886882777603,TRX_N-00301-715903000788,2022-03-15T09:31:03,Eibar,Expense,food,-266.1,-19631.5
buyer_6,Manuel,45,ES43209562886882777603,TRX_N-00302-373373309679,2022-03-27T19:16:00,Vitoria-Gasteiz,Expense,clothing,-444.03,-20075.53
buyer_6,Manuel,45,ES43209562886882777603,TRX_N-00303-969249012005,2022-03-30T12:13:23,Vitoria-Gasteiz,Expense,food,-559.94,-20635.47
buyer_6,Manuel,45,ES43209562886882777603,TRX_N-00304-105365318385,2022-03-31T01:15:35,Vitoria-Gasteiz,Expense,leisure,-159.77,-20795.24
buyer_6,Manuel,45,ES43209562886882777603,TRX_N-00305-327933943167,2022-04-01T17:47:31,Vitoria-Gasteiz,transfer,Salary,1304.67,-19490.57
buyer_6,Manuel,45,ES43209562886882777603,TRX_N-00306-76128017748,2022-04-05T12:55:50,Vitoria-Gasteiz,Housing,Rent,-733.63,-20224.2
buyer_6,Manuel,45,ES43209562886882777603,TRX_N-00307-149637924370,2022-04-05T11:40:39,Vitoria-Gasteiz,Basic services,water,-38.89,-20263.09
buyer_6,Manuel,45,ES43209562886882777603,TRX_N-00308-718802044522,2022-04-05T17:16:09,Vitoria-Gasteiz,Basic services,internet,-48.55,-20311.64
buyer_6,Manuel,45,ES43209562886882777603,TRX_N-00309-453642269013,2022-04-07T20:03:33,Vitoria-Gasteiz,Basic services,gas,-70.82,-20382.46
buyer_6,Manuel,45,ES43209562886882777603,TRX_N-00310-388318607548,2022-04-10T14:04:51,Vitoria-Gasteiz,Expense,education,-114.07,-20496.53
buyer_6,Manuel,45,ES43209562886882777603,TRX_N-00311-362521668580,2022-04-13T08:16:33,Vitoria-Gasteiz,Expense,transport,-46.21,-20542.74
buyer_6,Manuel,45,ES43209562886882777603,TRX_N-00312-153577932754,2022-04-21T09:35:21,Vitoria-Gasteiz,Expense,transport,-52.57,-20595.31
buyer_6,Manuel,45,ES43209562886882777603,TRX_N-00313-449793796538,2022-04-25T23:19:37,Vitoria-Gasteiz,Expense,leisure,-171.84,-20767.15
buyer_6,Manuel,45,ES43209562886882777603,TRX_N-00314-332946434581,2022-04-25T16:08:48,Vitoria-Gasteiz,Expense,repairs,-695.96,-21463.11
buyer_6,Manuel,45,ES43209562886882777603,TRX_N-00315-71852416193,2022-04-27T19:08:22,Hondarribia,Expense,repairs,-311.9,-21775.01
buyer_6,Manuel,45,ES43209562886882777603,TRX_N-00316-942693748672,2022-04-28T10:25:14,Vitoria-Gasteiz,Expense,leisure,-100.45,-21875.46
buyer_6,Manuel,45,ES43209562886882777603,TRX_N-00317-31102655258,2022-05-01T09:54:25,Vitoria-Gasteiz,transfer,Salary,1304.67,-20570.79
buyer_6,Manuel,45,ES43209562886882777603,TRX_N-00318-848409219405,2022-05-05T16:28:30,Vitoria-Gasteiz,Housing,Rent,-733.63,-21304.42
buyer_6,Manuel,45,ES43209562886882777603,TRX_N-00319-712382500253,2022-05-05T17:23:36,Vitoria-Gasteiz,Basic services,internet,-52.31,-21356.73
buyer_6,Manuel,45,ES43209562886882777603,TRX_N-00320-812222956758,2022-05-06T09:39:43,Vitoria-Gasteiz,Basic services,water,-26.2,-21382.93
buyer_6,Manuel,45,ES43209562886882777603,TRX_N-00321-640500785309,2022-05-06T22:44:48,Vitoria-Gasteiz,Basic services,electricity,-22.06,-21404.99
buyer_6,Manuel,45,ES43209562886882777603,TRX_N-00322-720274030849,2022-05-06T17:50:24,Vitoria-Gasteiz,Basic services,gas,-74.16,-21479.15
buyer_6,Manuel,45,ES43209562886882777603,TRX_N-00323-159937519982,2022-05-06T18:08:07,Vitoria-Gasteiz,Basic services,internet,-58.48,-21537.63
buyer_6,Manuel,45,ES43209562886882777603,TRX_N-00324-122556911261,2022-05-07T23:01:13,Vitoria-Gasteiz,Basic services,water,-28.4,-21566.03
buyer_6,Manuel,45,ES43209562886882777603,TRX_N-00325-389756511089,2022-05-07T14:53:36,Vitoria-Gasteiz,Basic services,electricity,-67.52,-21633.55
buyer_6,Manuel,45,ES43209562886882777603,TRX_N-00326-935820398520,2022-05-07T15:08:07,Vitoria-Gasteiz,Basic services,gas,-35.62,-21669.17
buyer_6,Manuel,45,ES43209562886882777603,TRX_N-00327-237443957240,2022-06-01T20:40:10,Vitoria-Gasteiz,transfer,Salary,1304.67,-20364.5
buyer_6,Manuel,45,ES43209562886882777603,TRX_N-00328-529211984865,2022-06-01T20:40:10,Vitoria-Gasteiz,transfer,Extra Income,130.47,-20234.03
buyer_6,Manuel,45,ES43209562886882777603,TRX_N-00329-768485345570,2022-06-01T20:40:10,Vitoria-Gasteiz,transfer,Bonus,1361.2,-18872.83
buyer_6,Manuel,45,ES43209562886882777603,TRX_N-00330-14266919021,2022-06-05T12:31:33,Vitoria-Gasteiz,Housing,Rent,-733.63,-19606.46
buyer_6,Manuel,45,ES43209562886882777603,TRX_N-00331-341700842706,2022-06-05T09:16:40,Vitoria-Gasteiz,Basic services,water,-46.51,-19652.97
buyer_6,Manuel,45,ES43209562886882777603,TRX_N-00332-811740245807,2022-06-05T15:55:47,Vitoria-Gasteiz,Basic services,electricity,-96.88,-19749.85
buyer_6,Manuel,45,ES43209562886882777603,TRX_N-00333-285794063314,2022-06-05T11:22:06,Vitoria-Gasteiz,Basic services,internet,-75.53,-19825.38
buyer_6,Manuel,45,ES43209562886882777603,TRX_N-00334-330352810734,2022-06-05T08:41:26,Vitoria-Gasteiz,Basic services,phone,-54.15,-19879.53
buyer_6,Manuel,45,ES43209562886882777603,TRX_N-00335-758405069694,2022-06-06T15:41:30,Vitoria-Gasteiz,Basic services,water,-22.37,-19901.9
buyer_6,Manuel,45,ES43209562886882777603,TRX_N-00336-545525120190,2022-06-06T19:58:20,Vitoria-Gasteiz,Basic services,gas,-49.53,-19951.43
buyer_6,Manuel,45,ES43209562886882777603,TRX_N-00337-597544452551,2022-06-06T17:11:43,Vitoria-Gasteiz,Expense,leisure,-165.03,-20116.46
buyer_6,Manuel,45,ES43209562886882777603,TRX_N-00338-439468048500,2022-06-07T08:56:45,Vitoria-Gasteiz,Basic services,electricity,-148.95,-20265.41
buyer_6,Manuel,45,ES43209562886882777603,TRX_N-00339-423086366202,2022-06-07T12:04:49,Vitoria-Gasteiz,Basic services,internet,-52.87,-20318.28
buyer_6,Manuel,45,ES43209562886882777603,TRX_N-00340-94257228089,2022-06-15T09:59:19,Basauri,Expense,clothing,-99.43,-20417.71
buyer_6,Manuel,45,ES43209562886882777603,TRX_N-00341-556021236592,2022-06-29T13:31:01,Vitoria-Gasteiz,Expense,transport,-30.0,-20447.71
buyer_6,Manuel,45,ES43209562886882777603,TRX_N-00342-610581238742,2022-07-01T19:07:14,Vitoria-Gasteiz,transfer,Salary,1304.67,-19143.04
buyer_6,Manuel,45,ES43209562886882777603,TRX_N-00343-804973206233,2022-07-01T20:04:35,Vitoria-Gasteiz,Expense,leisure,-126.83,-19269.87
buyer_6,Manuel,45,ES43209562886882777603,TRX_N-00344-499114715040,2022-07-05T15:35:04,Vitoria-Gasteiz,Housing,Rent,-733.63,-20003.5
buyer_6,Manuel,45,ES43209562886882777603,TRX_N-00345-563252410647,2022-07-05T11:36:07,Vitoria-Gasteiz,Basic services,electricity,-126.99,-20130.49
buyer_6,Manuel,45,ES43209562886882777603,TRX_N-00346-241189033335,2022-07-05T16:20:46,Vitoria-Gasteiz,Basic services,gas,-56.57,-20187.06
buyer_6,Manuel,45,ES43209562886882777603,TRX_N-00347-28153482749,2022-07-05T19:38:12,Vitoria-Gasteiz,Basic services,internet,-60.24,-20247.3
buyer_6,Manuel,45,ES43209562886882777603,TRX_N-00348-976975063373,2022-07-06T20:38:50,Vitoria-Gasteiz,Basic services,electricity,-76.51,-20323.81
buyer_6,Manuel,45,ES43209562886882777603,TRX_N-00349-339625590950,2022-07-06T13:00:37,Vitoria-Gasteiz,Basic services,phone,-48.91,-20372.72
buyer_6,Manuel,45,ES43209562886882777603,TRX_N-00350-274411402488,2022-07-06T12:36:44,Vitoria-Gasteiz,Expense,travel,-1151.42,-21524.14
buyer_6,Manuel,45,ES43209562886882777603,TRX_N-00351-909329832299,2022-07-21T16:06:57,Vitoria-Gasteiz,Expense,food,-563.85,-22087.99
buyer_6,Manuel,45,ES43209562886882777603,TRX_N-00352-881072864642,2022-07-28T09:45:22,Zuia,Expense,gifts,-26.46,-22114.45
buyer_6,Manuel,45,ES43209562886882777603,TRX_N-00353-285835015003,2022-08-01T20:29:59,Vitoria-Gasteiz,transfer,Salary,1304.67,-20809.78
buyer_6,Manuel,45,ES43209562886882777603,TRX_N-00354-849558204136,2022-08-05T15:15:47,Vitoria-Gasteiz,Housing,Rent,-733.63,-21543.41
buyer_6,Manuel,45,ES43209562886882777603,TRX_N-00355-694283513384,2022-08-05T20:45:05,Vitoria-Gasteiz,Basic services,water,-10.17,-21553.58
buyer_6,Manuel,45,ES43209562886882777603,TRX_N-00356-984447018292,2022-08-05T09:37:09,Vitoria-Gasteiz,Basic services,internet,-72.81,-21626.39
buyer_6,Manuel,45,ES43209562886882777603,TRX_N-00357-895029321490,2022-08-07T18:56:49,Vitoria-Gasteiz,Basic services,electricity,-103.48,-21729.87
buyer_6,Manuel,45,ES43209562886882777603,TRX_N-00358-388903174746,2022-08-07T19:36:14,Vitoria-Gasteiz,Basic services,gas,-71.94,-21801.81
buyer_6,Manuel,45,ES43209562886882777603,TRX_N-00359-700375005892,2022-08-12T13:57:25,Durango,Expense,healthcare,-339.86,-22141.67
buyer_6,Manuel,45,ES43209562886882777603,TRX_N-00360-452751477441,2022-08-18T18:18:25,Vitoria-Gasteiz,Expense,repairs,-618.51,-22760.18
buyer_6,Manuel,45,ES43209562886882777603,TRX_N-00361-462755337573,2022-08-25T10:19:32,Vitoria-Gasteiz,Expense,leisure,-87.95,-22848.13
buyer_6,Manuel,45,ES43209562886882777603,TRX_N-00362-126953359413,2022-09-01T18:13:56,Vitoria-Gasteiz,transfer,Salary,1304.67,-21543.46
buyer_6,Manuel,45,ES43209562886882777603,TRX_N-00363-683446050378,2022-09-01T18:13:56,Vitoria-Gasteiz,transfer,Extra Income,130.47,-21412.99
buyer_6,Manuel,45,ES43209562886882777603,TRX_N-00364-936683601272,2022-09-03T11:31:03,Vitoria-Gasteiz,Expense,transport,-142.65,-21555.64
buyer_6,Manuel,45,ES43209562886882777603,TRX_N-00365-899740093982,2022-09-05T20:11:48,Vitoria-Gasteiz,Housing,Rent,-733.63,-22289.27
buyer_6,Manuel,45,ES43209562886882777603,TRX_N-00366-35611527463,2022-09-05T22:35:26,Vitoria-Gasteiz,Basic services,phone,-88.45,-22377.72
buyer_6,Manuel,45,ES43209562886882777603,TRX_N-00367-502510676914,2022-09-06T13:07:22,Vitoria-Gasteiz,Basic services,water,-61.33,-22439.05
buyer_6,Manuel,45,ES43209562886882777603,TRX_N-00368-86239251585,2022-09-06T23:17:40,Vitoria-Gasteiz,Basic services,gas,-17.64,-22456.69
buyer_6,Manuel,45,ES43209562886882777603,TRX_N-00369-210685561208,2022-09-06T03:32:18,Vitoria-Gasteiz,Basic services,internet,-50.78,-22507.47
buyer_6,Manuel,45,ES43209562886882777603,TRX_N-00370-349676592514,2022-09-07T21:22:31,Vitoria-Gasteiz,Basic services,water,-35.91,-22543.38
buyer_6,Manuel,45,ES43209562886882777603,TRX_N-00371-70179894471,2022-09-07T14:08:52,Vitoria-Gasteiz,Basic services,electricity,-99.86,-22643.24
buyer_6,Manuel,45,ES43209562886882777603,TRX_N-00372-159231517050,2022-09-17T18:09:29,Vitoria-Gasteiz,Expense,gifts,-128.42,-22771.66
buyer_6,Manuel,45,ES43209562886882777603,TRX_N-00373-212376058066,2022-09-29T12:44:08,Vitoria-Gasteiz,Expense,food,-548.6,-23320.26
buyer_6,Manuel,45,ES43209562886882777603,TRX_N-00374-182414285971,2022-10-01T14:46:40,Vitoria-Gasteiz,transfer,Salary,1304.67,-22015.59
buyer_6,Manuel,45,ES43209562886882777603,TRX_N-00375-190625656067,2022-10-05T13:18:38,Vitoria-Gasteiz,Housing,Rent,-733.63,-22749.22
buyer_6,Manuel,45,ES43209562886882777603,TRX_N-00376-222895943819,2022-10-05T23:03:15,Vitoria-Gasteiz,Basic services,electricity,-144.97,-22894.19
buyer_6,Manuel,45,ES43209562886882777603,TRX_N-00377-366700640034,2022-10-05T15:22:42,Vitoria-Gasteiz,Basic services,gas,-74.07,-22968.26
buyer_6,Manuel,45,ES43209562886882777603,TRX_N-00378-20869355354,2022-10-05T13:00:39,Vitoria-Gasteiz,Basic services,internet,-64.13,-23032.39
buyer_6,Manuel,45,ES43209562886882777603,TRX_N-00379-157173175444,2022-10-05T08:46:07,Vitoria-Gasteiz,Basic services,phone,-23.53,-23055.92
buyer_6,Manuel,45,ES43209562886882777603,TRX_N-00380-917819199167,2022-10-06T14:47:28,Vitoria-Gasteiz,Basic services,gas,-40.71,-23096.63
buyer_6,Manuel,45,ES43209562886882777603,TRX_N-00381-720614593605,2022-10-06T03:37:28,Vitoria-Gasteiz,Basic services,phone,-24.72,-23121.35
buyer_6,Manuel,45,ES43209562886882777603,TRX_N-00382-396832752720,2022-10-07T13:52:26,Vitoria-Gasteiz,Basic services,water,-77.89,-23199.24
buyer_6,Manuel,45,ES43209562886882777603,TRX_N-00383-901988790931,2022-10-07T02:00:28,Vitoria-Gasteiz,Basic services,electricity,-73.07,-23272.31
buyer_6,Manuel,45,ES43209562886882777603,TRX_N-00384-808167056130,2022-10-24T18:12:26,Vitoria-Gasteiz,Expense,leisure,-231.34,-23503.65
buyer_6,Manuel,45,ES43209562886882777603,TRX_N-00385-307932247070,2022-10-27T03:49:36,Vitoria-Gasteiz,Expense,gifts,-153.95,-23657.6
buyer_6,Manuel,45,ES43209562886882777603,TRX_N-00386-448438478748,2022-11-01T04:00:59,Vitoria-Gasteiz,transfer,Salary,1304.67,-22352.93
buyer_6,Manuel,45,ES43209562886882777603,TRX_N-00387-850979020454,2022-11-01T04:00:59,Vitoria-Gasteiz,transfer,Extra Income,130.47,-22222.46
buyer_6,Manuel,45,ES43209562886882777603,TRX_N-00388-927441592594,2022-11-05T14:27:13,Vitoria-Gasteiz,Housing,Rent,-733.63,-22956.09
buyer_6,Manuel,45,ES43209562886882777603,TRX_N-00389-822413014557,2022-11-05T14:09:59,Vitoria-Gasteiz,Basic services,gas,-60.25,-23016.34
buyer_6,Manuel,45,ES43209562886882777603,TRX_N-00390-873447629775,2022-11-07T13:46:20,Vitoria-Gasteiz,Basic services,water,-37.37,-23053.71
buyer_6,Manuel,45,ES43209562886882777603,TRX_N-00391-249603481979,2022-11-07T18:46:37,Vitoria-Gasteiz,Basic services,electricity,-117.97,-23171.68
buyer_6,Manuel,45,ES43209562886882777603,TRX_N-00392-379191358035,2022-11-07T10:23:06,Vitoria-Gasteiz,Basic services,internet,-65.29,-23236.97
buyer_6,Manuel,45,ES43209562886882777603,TRX_N-00393-380824866914,2022-11-16T00:45:30,Vitoria-Gasteiz,Expense,travel,-2341.85,-25578.82
buyer_6,Manuel,45,ES43209562886882777603,TRX_N-00394-152561822112,2022-11-19T13:26:02,Vitoria-Gasteiz,Expense,food,-409.3,-25988.12
buyer_6,Manuel,45,ES43209562886882777603,TRX_N-00395-895500820730,2022-11-22T17:39:05,Vitoria-Gasteiz,Expense,leisure,-165.77,-26153.89
buyer_6,Manuel,45,ES43209562886882777603,TRX_N-00396-631079192089,2022-11-30T13:30:08,Vitoria-Gasteiz,Expense,transport,-27.91,-26181.8
buyer_6,Manuel,45,ES43209562886882777603,TRX_N-00397-345349483338,2022-12-01T23:06:20,Vitoria-Gasteiz,transfer,Salary,1304.67,-24877.13
buyer_6,Manuel,45,ES43209562886882777603,TRX_N-00398-643662244479,2022-12-01T23:06:20,Vitoria-Gasteiz,transfer,Bonus,1363.08,-23514.05
buyer_6,Manuel,45,ES43209562886882777603,TRX_N-00399-213245565916,2022-12-05T15:22:14,Vitoria-Gasteiz,Housing,Rent,-733.63,-24247.68
buyer_6,Manuel,45,ES43209562886882777603,TRX_N-00400-6298732444,2022-12-05T11:13:06,Vitoria-Gasteiz,Basic services,internet,-48.47,-24296.15
buyer_6,Manuel,45,ES43209562886882777603,TRX_N-00401-267651450319,2022-12-05T17:47:03,Vitoria-Gasteiz,Basic services,phone,-27.5,-24323.65
buyer_6,Manuel,45,ES43209562886882777603,TRX_N-00402-227810601750,2022-12-06T22:36:26,Vitoria-Gasteiz,Basic services,phone,-92.38,-24416.03
buyer_6,Manuel,45,ES43209562886882777603,TRX_N-00403-369864304403,2022-12-07T15:04:45,Vitoria-Gasteiz,Basic services,phone,-39.82,-24455.85
buyer_6,Manuel,45,ES43209562886882777603,TRX_N-00404-614591128101,2022-12-08T10:36:15,Vitoria-Gasteiz,Expense,transport,-199.03,-24654.88
buyer_6,Manuel,45,ES43209562886882777603,TRX_N-00405-669338552308,2022-12-16T16:25:10,Vitoria-Gasteiz,Expense,food,-487.44,-25142.32
buyer_6,Manuel,45,ES43209562886882777603,TRX_N-00406-228920897511,2022-12-21T23:49:42,Vitoria-Gasteiz,Expense,transport,-55.86,-25198.18
buyer_6,Manuel,45,ES43209562886882777603,TRX_N-00407-564390938130,2023-01-01T14:02:19,Vitoria-Gasteiz,transfer,Salary,1304.67,-23893.51
buyer_6,Manuel,45,ES43209562886882777603,TRX_N-00408-904117444731,2023-01-01T14:02:19,Vitoria-Gasteiz,transfer,Extra Income,130.47,-23763.04
buyer_6,Manuel,45,ES43209562886882777603,TRX_N-00409-429360210138,2023-01-01T15:43:37,Vitoria-Gasteiz,Expense,food,-487.91,-24250.95
buyer_6,Manuel,45,ES43209562886882777603,TRX_N-00410-78236341802,2023-01-05T17:39:09,Vitoria-Gasteiz,Housing,Rent,-733.63,-24984.58
buyer_6,Manuel,45,ES43209562886882777603,TRX_N-00411-426808472114,2023-01-05T13:05:52,Vitoria-Gasteiz,Basic services,electricity,-131.31,-25115.89
buyer_6,Manuel,45,ES43209562886882777603,TRX_N-00412-523556063587,2023-01-06T17:27:51,Vitoria-Gasteiz,Basic services,water,-40.42,-25156.31
buyer_6,Manuel,45,ES43209562886882777603,TRX_N-00413-735440724427,2023-01-06T14:22:30,Vitoria-Gasteiz,Basic services,internet,-70.1,-25226.41
buyer_6,Manuel,45,ES43209562886882777603,TRX_N-00414-923667739081,2023-01-07T08:04:56,Vitoria-Gasteiz,Basic services,gas,-87.49,-25313.9
buyer_6,Manuel,45,ES43209562886882777603,TRX_N-00415-757107815921,2023-01-07T18:39:37,Vitoria-Gasteiz,Basic services,internet,-56.83,-25370.73
buyer_6,Manuel,45,ES43209562886882777603,TRX_N-00416-626052754625,2023-01-14T14:10:11,Vitoria-Gasteiz,Expense,food,-471.63,-25842.36
buyer_6,Manuel,45,ES43209562886882777603,TRX_N-00417-519103670142,2023-01-18T11:39:08,Vitoria-Gasteiz,Expense,healthcare,-259.88,-26102.24
buyer_6,Manuel,45,ES43209562886882777603,TRX_N-00418-412143582809,2023-01-25T16:50:36,Vitoria-Gasteiz,Expense,food,-175.5,-26277.74
buyer_6,Manuel,45,ES43209562886882777603,TRX_N-00419-790694411573,2023-01-26T09:37:54,Vitoria-Gasteiz,Expense,food,-431.77,-26709.51
buyer_6,Manuel,45,ES43209562886882777603,TRX_N-00420-469865935592,2023-01-30T16:22:09,Vitoria-Gasteiz,Expense,clothing,-372.0,-27081.51
buyer_6,Manuel,45,ES43209562886882777603,TRX_N-00421-173303642711,2023-02-01T22:57:13,Vitoria-Gasteiz,transfer,Salary,1304.67,-25776.84
buyer_6,Manuel,45,ES43209562886882777603,TRX_N-00422-274804090057,2023-02-05T12:02:00,Vitoria-Gasteiz,Housing,Rent,-733.63,-26510.47
buyer_6,Manuel,45,ES43209562886882777603,TRX_N-00423-443155985698,2023-02-05T19:36:15,Vitoria-Gasteiz,Basic services,phone,-62.64,-26573.11
buyer_6,Manuel,45,ES43209562886882777603,TRX_N-00424-213904232194,2023-02-06T13:25:42,Vitoria-Gasteiz,Basic services,water,-78.2,-26651.31
buyer_6,Manuel,45,ES43209562886882777603,TRX_N-00425-202138686339,2023-02-06T11:25:27,Vitoria-Gasteiz,Basic services,electricity,-51.58,-26702.89
buyer_6,Manuel,45,ES43209562886882777603,TRX_N-00426-660210013810,2023-02-07T13:14:07,Vitoria-Gasteiz,Basic services,gas,-86.03,-26788.92
buyer_6,Manuel,45,ES43209562886882777603,TRX_N-00427-24588156355,2023-03-01T17:02:05,Vitoria-Gasteiz,transfer,Salary,1304.67,-25484.25
buyer_6,Manuel,45,ES43209562886882777603,TRX_N-00428-89226282991,2023-03-01T10:03:30,Vitoria-Gasteiz,Expense,transport,-164.39,-25648.64
buyer_6,Manuel,45,ES43209562886882777603,TRX_N-00429-306808979327,2023-03-05T14:14:13,Vitoria-Gasteiz,Housing,Rent,-733.63,-26382.27
buyer_6,Manuel,45,ES43209562886882777603,TRX_N-00430-466443419532,2023-03-05T15:24:15,Vitoria-Gasteiz,Basic services,internet,-37.03,-26419.3
buyer_6,Manuel,45,ES43209562886882777603,TRX_N-00431-579727802092,2023-03-05T02:15:39,Vitoria-Gasteiz,Basic services,phone,-46.35,-26465.65
buyer_6,Manuel,45,ES43209562886882777603,TRX_N-00432-29161659910,2023-03-06T12:27:20,Vitoria-Gasteiz,Basic services,internet,-58.44,-26524.09
buyer_6,Manuel,45,ES43209562886882777603,TRX_N-00433-343539348466,2023-03-06T10:38:16,Vitoria-Gasteiz,Basic services,phone,-84.24,-26608.33
buyer_6,Manuel,45,ES43209562886882777603,TRX_N-00434-977011208218,2023-03-07T20:55:30,Vitoria-Gasteiz,Basic services,water,-42.39,-26650.72
buyer_6,Manuel,45,ES43209562886882777603,TRX_N-00435-528645898749,2023-03-07T11:45:10,Vitoria-Gasteiz,Basic services,electricity,-51.16,-26701.88
buyer_6,Manuel,45,ES43209562886882777603,TRX_N-00436-393795744333,2023-03-07T16:17:53,Vitoria-Gasteiz,Basic services,phone,-33.2,-26735.08
buyer_6,Manuel,45,ES43209562886882777603,TRX_N-00437-146752133838,2023-03-23T11:26:57,Vitoria-Gasteiz,Expense,transport,-184.99,-26920.07
buyer_6,Manuel,45,ES43209562886882777603,TRX_N-00438-66435453798,2023-03-26T17:34:02,Vitoria-Gasteiz,Expense,transport,-101.5,-27021.57
buyer_6,Manuel,45,ES43209562886882777603,TRX_N-00439-516998646462,2023-04-01T07:16:08,Vitoria-Gasteiz,transfer,Salary,1304.67,-25716.9
buyer_6,Manuel,45,ES43209562886882777603,TRX_N-00440-183588338991,2023-04-01T07:16:08,Vitoria-Gasteiz,transfer,Extra Income,130.47,-25586.43
buyer_6,Manuel,45,ES43209562886882777603,TRX_N-00441-216003890469,2023-04-05T17:47:53,Vitoria-Gasteiz,Housing,Rent,-733.63,-26320.06
buyer_6,Manuel,45,ES43209562886882777603,TRX_N-00442-453769224274,2023-04-06T19:45:15,Vitoria-Gasteiz,Basic services,water,-30.57,-26350.63
buyer_6,Manuel,45,ES43209562886882777603,TRX_N-00443-514338687004,2023-04-06T09:25:14,Vitoria-Gasteiz,Basic services,gas,-32.18,-26382.81
buyer_6,Manuel,45,ES43209562886882777603,TRX_N-00444-398581360713,2023-04-06T20:03:00,Vitoria-Gasteiz,Basic services,internet,-62.82,-26445.63
buyer_6,Manuel,45,ES43209562886882777603,TRX_N-00445-321922067621,2023-04-07T07:51:12,Vitoria-Gasteiz,Basic services,electricity,-89.83,-26535.46
buyer_6,Manuel,45,ES43209562886882777603,TRX_N-00446-340001187170,2023-04-07T13:57:24,Vitoria-Gasteiz,Basic services,gas,-53.36,-26588.82
buyer_6,Manuel,45,ES43209562886882777603,TRX_N-00447-836517645330,2023-04-07T08:17:11,Vitoria-Gasteiz,Basic services,phone,-52.98,-26641.8
buyer_6,Manuel,45,ES43209562886882777603,TRX_N-00448-600402223032,2023-04-14T10:22:01,Vitoria-Gasteiz,Expense,transport,-169.92,-26811.72
buyer_6,Manuel,45,ES43209562886882777603,TRX_N-00449-588740367683,2023-04-19T17:06:33,Vitoria-Gasteiz,Expense,transport,-188.26,-26999.98
buyer_6,Manuel,45,ES43209562886882777603,TRX_N-00450-799195341649,2023-04-29T22:23:42,Vitoria-Gasteiz,Expense,leisure,-232.07,-27232.05
buyer_6,Manuel,45,ES43209562886882777603,TRX_N-00451-218980243485,2023-05-01T19:12:16,Vitoria-Gasteiz,transfer,Salary,1304.67,-25927.38
buyer_6,Manuel,45,ES43209562886882777603,TRX_N-00452-895238901945,2023-05-05T11:01:39,Vitoria-Gasteiz,Housing,Rent,-733.63,-26661.01
buyer_6,Manuel,45,ES43209562886882777603,TRX_N-00453-282738548105,2023-05-06T12:07:28,Vitoria-Gasteiz,Basic services,phone,-75.78,-26736.79
buyer_6,Manuel,45,ES43209562886882777603,TRX_N-00454-331883247816,2023-05-07T20:23:21,Vitoria-Gasteiz,Basic services,water,-14.7,-26751.49
buyer_6,Manuel,45,ES43209562886882777603,TRX_N-00455-691733706225,2023-05-07T12:01:15,Vitoria-Gasteiz,Basic services,electricity,-83.38,-26834.87
buyer_6,Manuel,45,ES43209562886882777603,TRX_N-00456-925760890146,2023-05-07T21:15:28,Vitoria-Gasteiz,Basic services,gas,-64.89,-26899.76
buyer_6,Manuel,45,ES43209562886882777603,TRX_N-00457-596291524555,2023-05-07T20:23:59,Vitoria-Gasteiz,Basic services,internet,-56.66,-26956.42
buyer_6,Manuel,45,ES43209562886882777603,TRX_N-00458-1670413670,2023-05-07T12:08:56,Vitoria-Gasteiz,Basic services,phone,-79.54,-27035.96
buyer_6,Manuel,45,ES43209562886882777603,TRX_N-00459-106242071396,2023-05-15T16:49:25,Vitoria-Gasteiz,Expense,food,-642.64,-27678.6
buyer_6,Manuel,45,ES43209562886882777603,TRX_N-00460-837131205004,2023-05-21T10:54:46,Sestao,Expense,healthcare,-109.78,-27788.38
buyer_6,Manuel,45,ES43209562886882777603,TRX_N-00461-684338180811,2023-05-26T11:11:32,Vitoria-Gasteiz,Expense,clothing,-151.43,-27939.81
buyer_6,Manuel,45,ES43209562886882777603,TRX_N-00462-51546886674,2023-06-01T04:01:05,Vitoria-Gasteiz,transfer,Salary,1304.67,-26635.14
buyer_6,Manuel,45,ES43209562886882777603,TRX_N-00463-47891281942,2023-06-01T04:01:05,Vitoria-Gasteiz,transfer,Extra Income,130.47,-26504.67
buyer_6,Manuel,45,ES43209562886882777603,TRX_N-00464-268519391067,2023-06-01T04:01:05,Vitoria-Gasteiz,transfer,Bonus,1302.36,-25202.31
buyer_6,Manuel,45,ES43209562886882777603,TRX_N-00465-876651296862,2023-06-05T23:38:04,Vitoria-Gasteiz,Housing,Rent,-733.63,-25935.94
buyer_6,Manuel,45,ES43209562886882777603,TRX_N-00466-811157785281,2023-06-06T19:44:42,Vitoria-Gasteiz,Basic services,water,-65.67,-26001.61
buyer_6,Manuel,45,ES43209562886882777603,TRX_N-00467-548800229278,2023-06-06T14:53:15,Vitoria-Gasteiz,Basic services,gas,-60.47,-26062.08
buyer_6,Manuel,45,ES43209562886882777603,TRX_N-00468-23091733871,2023-06-06T07:24:11,Vitoria-Gasteiz,Basic services,phone,-24.6,-26086.68
buyer_6,Manuel,45,ES43209562886882777603,TRX_N-00469-846685621731,2023-06-07T11:05:25,Vitoria-Gasteiz,Basic services,electricity,-106.85,-26193.53
buyer_6,Manuel,45,ES43209562886882777603,TRX_N-00470-359145052325,2023-07-01T17:45:46,Vitoria-Gasteiz,transfer,Salary,1304.67,-24888.86
buyer_6,Manuel,45,ES43209562886882777603,TRX_N-00471-418331410606,2023-07-05T10:02:16,Vitoria-Gasteiz,Housing,Rent,-733.63,-25622.49
buyer_6,Manuel,45,ES43209562886882777603,TRX_N-00472-451909831317,2023-07-05T13:32:50,Vitoria-Gasteiz,Basic services,electricity,-130.32,-25752.81
buyer_6,Manuel,45,ES43209562886882777603,TRX_N-00473-808055964610,2023-07-06T11:00:20,Vitoria-Gasteiz,Basic services,internet,-53.64,-25806.45
buyer_6,Manuel,45,ES43209562886882777603,TRX_N-00474-200064370100,2023-07-07T11:11:02,Vitoria-Gasteiz,Basic services,water,-58.35,-25864.8
buyer_6,Manuel,45,ES43209562886882777603,TRX_N-00475-31126270838,2023-07-07T11:48:24,Vitoria-Gasteiz,Basic services,gas,-30.65,-25895.45
buyer_6,Manuel,45,ES43209562886882777603,TRX_N-00476-508620975288,2023-07-09T14:17:28,Vitoria-Gasteiz,Expense,healthcare,-94.19,-25989.64
buyer_6,Manuel,45,ES43209562886882777603,TRX_N-00477-137629605090,2023-08-01T17:26:44,Vitoria-Gasteiz,transfer,Salary,1304.67,-24684.97
buyer_6,Manuel,45,ES43209562886882777603,TRX_N-00478-68771870668,2023-08-01T17:26:44,Vitoria-Gasteiz,transfer,Extra Income,130.47,-24554.5
buyer_6,Manuel,45,ES43209562886882777603,TRX_N-00479-723241378673,2023-08-01T18:38:36,Vitoria-Gasteiz,Expense,food,-222.97,-24777.47
buyer_6,Manuel,45,ES43209562886882777603,TRX_N-00480-622113803351,2023-08-01T20:31:54,Vitoria-Gasteiz,Expense,transport,-106.84,-24884.31
buyer_6,Manuel,45,ES43209562886882777603,TRX_N-00481-238863573873,2023-08-03T16:05:57,Vitoria-Gasteiz,Expense,food,-724.89,-25609.2
buyer_6,Manuel,45,ES43209562886882777603,TRX_N-00482-10934590916,2023-08-05T16:07:26,Vitoria-Gasteiz,Housing,Rent,-733.63,-26342.83
buyer_6,Manuel,45,ES43209562886882777603,TRX_N-00483-563895546208,2023-08-05T10:28:41,Vitoria-Gasteiz,Basic services,gas,-83.04,-26425.87
buyer_6,Manuel,45,ES43209562886882777603,TRX_N-00484-958535280127,2023-08-05T12:19:21,Vitoria-Gasteiz,Basic services,phone,-75.16,-26501.03
buyer_6,Manuel,45,ES43209562886882777603,TRX_N-00485-170242526973,2023-08-06T17:45:29,Vitoria-Gasteiz,Basic services,electricity,-100.84,-26601.87
buyer_6,Manuel,45,ES43209562886882777603,TRX_N-00486-556107941108,2023-08-07T19:30:04,Vitoria-Gasteiz,Basic services,water,-33.08,-26634.95
buyer_6,Manuel,45,ES43209562886882777603,TRX_N-00487-738320195020,2023-08-14T15:37:11,Vitoria-Gasteiz,Expense,healthcare,-64.63,-26699.58
buyer_6,Manuel,45,ES43209562886882777603,TRX_N-00488-403986665807,2023-08-28T01:11:50,Vitoria-Gasteiz,Expense,repairs,-695.75,-27395.33
buyer_6,Manuel,45,ES43209562886882777603,TRX_N-00489-903380809458,2023-09-01T13:36:40,Vitoria-Gasteiz,transfer,Salary,1304.67,-26090.66
buyer_6,Manuel,45,ES43209562886882777603,TRX_N-00490-177218401268,2023-09-05T18:03:38,Vitoria-Gasteiz,Housing,Rent,-733.63,-26824.29
buyer_6,Manuel,45,ES43209562886882777603,TRX_N-00491-63721189180,2023-09-05T11:31:24,Vitoria-Gasteiz,Basic services,electricity,-140.54,-26964.83
buyer_6,Manuel,45,ES43209562886882777603,TRX_N-00492-851165386872,2023-09-05T18:09:50,Vitoria-Gasteiz,Basic services,phone,-54.21,-27019.04
buyer_6,Manuel,45,ES43209562886882777603,TRX_N-00493-134648752930,2023-09-06T18:16:16,Vitoria-Gasteiz,Basic services,internet,-62.17,-27081.21
buyer_6,Manuel,45,ES43209562886882777603,TRX_N-00494-631228058939,2023-09-07T17:39:23,Vitoria-Gasteiz,Basic services,water,-35.35,-27116.56
buyer_6,Manuel,45,ES43209562886882777603,TRX_N-00495-317610642570,2023-09-07T19:49:21,Vitoria-Gasteiz,Basic services,internet,-71.96,-27188.52
buyer_6,Manuel,45,ES43209562886882777603,TRX_N-00496-29560658347,2023-09-12T08:24:06,Vitoria-Gasteiz,Expense,leisure,-95.64,-27284.16
buyer_6,Manuel,45,ES43209562886882777603,TRX_N-00497-459654747047,2023-09-27T10:41:18,Vitoria-Gasteiz,Expense,travel,-1177.73,-28461.89
buyer_6,Manuel,45,ES43209562886882777603,TRX_N-00498-952473892517,2023-10-01T20:01:48,Vitoria-Gasteiz,transfer,Salary,1304.67,-27157.22
buyer_6,Manuel,45,ES43209562886882777603,TRX_N-00499-55550844557,2023-10-01T20:01:48,Vitoria-Gasteiz,transfer,Extra Income,130.47,-27026.75
buyer_6,Manuel,45,ES43209562886882777603,TRX_N-00500-781703643720,2023-10-05T08:39:16,Vitoria-Gasteiz,Housing,Rent,-733.63,-27760.38
buyer_6,Manuel,45,ES43209562886882777603,TRX_N-00501-491256318412,2023-10-05T17:34:54,Vitoria-Gasteiz,Basic services,water,-42.31,-27802.69
buyer_6,Manuel,45,ES43209562886882777603,TRX_N-00502-88680225611,2023-10-05T14:37:00,Vitoria-Gasteiz,Basic services,internet,-72.37,-27875.06
buyer_6,Manuel,45,ES43209562886882777603,TRX_N-00503-488930812474,2023-10-06T08:28:18,Vitoria-Gasteiz,Basic services,water,-75.04,-27950.1
buyer_6,Manuel,45,ES43209562886882777603,TRX_N-00504-956930059724,2023-10-06T09:14:29,Vitoria-Gasteiz,Basic services,electricity,-63.2,-28013.3
buyer_6,Manuel,45,ES43209562886882777603,TRX_N-00505-863559470960,2023-10-07T16:22:51,Vitoria-Gasteiz,Basic services,water,-56.68,-28069.98
buyer_6,Manuel,45,ES43209562886882777603,TRX_N-00506-614738779214,2023-10-07T00:50:04,Vitoria-Gasteiz,Basic services,gas,-70.37,-28140.35
buyer_6,Manuel,45,ES43209562886882777603,TRX_N-00507-857198472858,2023-10-07T12:26:27,Vitoria-Gasteiz,Basic services,internet,-46.94,-28187.29
buyer_6,Manuel,45,ES43209562886882777603,TRX_N-00508-783078336444,2023-10-10T19:08:00,Vitoria-Gasteiz,Expense,transport,-43.99,-28231.28
buyer_6,Manuel,45,ES43209562886882777603,TRX_N-00509-245912551994,2023-11-01T11:22:55,Vitoria-Gasteiz,transfer,Salary,1304.67,-26926.61
buyer_6,Manuel,45,ES43209562886882777603,TRX_N-00510-924008758019,2023-11-05T14:02:59,Vitoria-Gasteiz,Housing,Rent,-733.63,-27660.24
buyer_6,Manuel,45,ES43209562886882777603,TRX_N-00511-672244273059,2023-11-05T11:11:03,Vitoria-Gasteiz,Basic services,water,-67.33,-27727.57
buyer_6,Manuel,45,ES43209562886882777603,TRX_N-00512-366221300452,2023-11-05T22:48:32,Vitoria-Gasteiz,Basic services,internet,-67.39,-27794.96
buyer_6,Manuel,45,ES43209562886882777603,TRX_N-00513-31549560918,2023-11-05T22:06:33,Vitoria-Gasteiz,Basic services,phone,-34.14,-27829.1
buyer_6,Manuel,45,ES43209562886882777603,TRX_N-00514-904408773621,2023-11-06T17:43:29,Vitoria-Gasteiz,Basic services,electricity,-40.13,-27869.23
buyer_6,Manuel,45,ES43209562886882777603,TRX_N-00515-918533753707,2023-11-06T16:57:14,Vitoria-Gasteiz,Basic services,internet,-74.15,-27943.38
buyer_6,Manuel,45,ES43209562886882777603,TRX_N-00516-367634855541,2023-11-06T15:55:05,Vitoria-Gasteiz,Basic services,phone,-63.57,-28006.95
buyer_6,Manuel,45,ES43209562886882777603,TRX_N-00517-603334319030,2023-11-07T21:26:51,Vitoria-Gasteiz,Basic services,internet,-63.55,-28070.5
buyer_6,Manuel,45,ES43209562886882777603,TRX_N-00518-585782563602,2023-11-17T14:38:19,Vitoria-Gasteiz,Expense,food,-344.7,-28415.2
buyer_6,Manuel,45,ES43209562886882777603,TRX_N-00519-427179415557,2023-11-24T18:54:19,Vitoria-Gasteiz,Expense,transport,-146.43,-28561.63
buyer_6,Manuel,45,ES43209562886882777603,TRX_N-00520-55032449967,2023-12-01T16:51:24,Vitoria-Gasteiz,transfer,Salary,1304.67,-27256.96
buyer_6,Manuel,45,ES43209562886882777603,TRX_N-00521-260360528468,2023-12-01T16:51:24,Vitoria-Gasteiz,transfer,Bonus,1291.22,-25965.74
buyer_6,Manuel,45,ES43209562886882777603,TRX_N-00522-536773565628,2023-12-02T17:07:06,Vitoria-Gasteiz,Expense,healthcare,-286.8,-26252.54
buyer_6,Manuel,45,ES43209562886882777603,TRX_N-00523-450588390941,2023-12-05T13:39:48,Vitoria-Gasteiz,Housing,Rent,-733.63,-26986.17
buyer_6,Manuel,45,ES43209562886882777603,TRX_N-00524-152326380610,2023-12-05T17:10:19,Vitoria-Gasteiz,Basic services,water,-58.48,-27044.65
buyer_6,Manuel,45,ES43209562886882777603,TRX_N-00525-769937483920,2023-12-05T23:26:00,Vitoria-Gasteiz,Basic services,electricity,-83.63,-27128.28
buyer_6,Manuel,45,ES43209562886882777603,TRX_N-00526-341579285263,2023-12-05T09:59:54,Vitoria-Gasteiz,Basic services,phone,-53.74,-27182.02
buyer_6,Manuel,45,ES43209562886882777603,TRX_N-00527-934145014479,2023-12-06T18:04:20,Vitoria-Gasteiz,Basic services,internet,-72.23,-27254.25
buyer_6,Manuel,45,ES43209562886882777603,TRX_N-00528-2600983337,2023-12-07T15:57:55,Vitoria-Gasteiz,Basic services,electricity,-112.4,-27366.65
buyer_6,Manuel,45,ES43209562886882777603,TRX_N-00529-796108033790,2023-12-07T16:50:27,Vitoria-Gasteiz,Basic services,phone,-82.91,-27449.56
buyer_6,Manuel,45,ES43209562886882777603,TRX_N-00530-547621253791,2024-01-01T16:06:38,Vitoria-Gasteiz,transfer,Salary,1304.67,-26144.89
buyer_6,Manuel,45,ES43209562886882777603,TRX_N-00531-284457233527,2024-01-01T16:06:38,Vitoria-Gasteiz,transfer,Extra Income,130.47,-26014.42
buyer_6,Manuel,45,ES43209562886882777603,TRX_N-00532-441406785498,2024-01-05T22:37:48,Vitoria-Gasteiz,Housing,Rent,-733.63,-26748.05
buyer_6,Manuel,45,ES43209562886882777603,TRX_N-00533-4769319735,2024-01-05T18:42:43,Vitoria-Gasteiz,Basic services,water,-14.35,-26762.4
buyer_6,Manuel,45,ES43209562886882777603,TRX_N-00534-805616842114,2024-01-05T08:46:01,Vitoria-Gasteiz,Basic services,gas,-89.48,-26851.88
buyer_6,Manuel,45,ES43209562886882777603,TRX_N-00535-990753737280,2024-01-05T08:26:34,Vitoria-Gasteiz,Basic services,internet,-58.64,-26910.52
buyer_6,Manuel,45,ES43209562886882777603,TRX_N-00536-370011661302,2024-01-05T18:51:04,Vitoria-Gasteiz,Expense,clothing,-323.12,-27233.64
buyer_6,Manuel,45,ES43209562886882777603,TRX_N-00537-621303500669,2024-01-06T21:31:02,Vitoria-Gasteiz,Basic services,internet,-61.82,-27295.46
buyer_6,Manuel,45,ES43209562886882777603,TRX_N-00538-570535269595,2024-01-07T06:28:01,Vitoria-Gasteiz,Basic services,electricity,-83.02,-27378.48
buyer_6,Manuel,45,ES43209562886882777603,TRX_N-00539-492889331214,2024-01-07T17:02:33,Vitoria-Gasteiz,Basic services,gas,-49.09,-27427.57
buyer_6,Manuel,45,ES43209562886882777603,TRX_N-00540-401275672331,2024-01-07T19:30:46,Vitoria-Gasteiz,Basic services,phone,-93.09,-27520.66
buyer_6,Manuel,45,ES43209562886882777603,TRX_N-00541-517100544851,2024-01-07T14:28:46,Iruña de Oca,Expense,food,-710.18,-28230.84
buyer_6,Manuel,45,ES43209562886882777603,TRX_N-00542-156024333862,2024-01-12T18:51:00,Zuia,Expense,repairs,-607.04,-28837.88
buyer_6,Manuel,45,ES43209562886882777603,TRX_N-00543-707010670805,2024-02-01T02:39:14,Vitoria-Gasteiz,transfer,Salary,1304.67,-27533.21
buyer_6,Manuel,45,ES43209562886882777603,TRX_N-00544-843875483779,2024-02-03T10:03:14,Vitoria-Gasteiz,Expense,education,-333.41,-27866.62
buyer_6,Manuel,45,ES43209562886882777603,TRX_N-00545-989790913411,2024-02-05T18:09:14,Vitoria-Gasteiz,Housing,Rent,-733.63,-28600.25
buyer_6,Manuel,45,ES43209562886882777603,TRX_N-00546-33233383043,2024-02-05T11:45:09,Vitoria-Gasteiz,Basic services,electricity,-144.04,-28744.29
buyer_6,Manuel,45,ES43209562886882777603,TRX_N-00547-593072240795,2024-02-06T06:36:01,Vitoria-Gasteiz,Basic services,gas,-33.78,-28778.07
buyer_6,Manuel,45,ES43209562886882777603,TRX_N-00548-808683329155,2024-02-06T19:42:10,Vitoria-Gasteiz,Basic services,internet,-75.6,-28853.67
buyer_6,Manuel,45,ES43209562886882777603,TRX_N-00549-540285546841,2024-02-07T09:42:54,Vitoria-Gasteiz,Basic services,gas,-31.29,-28884.96
buyer_6,Manuel,45,ES43209562886882777603,TRX_N-00550-64818867423,2024-02-07T14:31:07,Vitoria-Gasteiz,Basic services,internet,-31.84,-28916.8
buyer_6,Manuel,45,ES43209562886882777603,TRX_N-00551-263953057827,2024-02-16T16:54:36,Vitoria-Gasteiz,Expense,transport,-105.33,-29022.13
buyer_6,Manuel,45,ES43209562886882777603,TRX_N-00552-367079178912,2024-02-23T18:04:18,Vitoria-Gasteiz,Expense,education,-858.88,-29881.01
buyer_6,Manuel,45,ES43209562886882777603,TRX_N-00553-439088552579,2024-02-25T16:20:57,Vitoria-Gasteiz,Expense,transport,-137.77,-30018.78
buyer_6,Manuel,45,ES43209562886882777603,TRX_N-00554-955027146378,2024-02-27T23:42:34,Vitoria-Gasteiz,Expense,leisure,-205.52,-30224.3
buyer_6,Manuel,45,ES43209562886882777603,TRX_N-00555-313239386469,2024-03-01T17:54:09,Vitoria-Gasteiz,transfer,Salary,1304.67,-28919.63
buyer_6,Manuel,45,ES43209562886882777603,TRX_N-00556-838200104689,2024-03-01T17:54:09,Vitoria-Gasteiz,transfer,Extra Income,130.47,-28789.16
buyer_6,Manuel,45,ES43209562886882777603,TRX_N-00557-786521580603,2024-03-04T21:36:23,Portugalete,Expense,transport,-149.03,-28938.19
buyer_6,Manuel,45,ES43209562886882777603,TRX_N-00558-836938396407,2024-03-05T17:52:40,Vitoria-Gasteiz,Housing,Rent,-733.63,-29671.82
buyer_6,Manuel,45,ES43209562886882777603,TRX_N-00559-781515911754,2024-03-05T17:07:24,Vitoria-Gasteiz,Basic services,water,-23.22,-29695.04
buyer_6,Manuel,45,ES43209562886882777603,TRX_N-00560-568429100321,2024-03-05T11:42:09,Vitoria-Gasteiz,Basic services,electricity,-82.47,-29777.51
buyer_6,Manuel,45,ES43209562886882777603,TRX_N-00561-949060901735,2024-03-05T22:49:30,Vitoria-Gasteiz,Basic services,phone,-88.36,-29865.87
buyer_6,Manuel,45,ES43209562886882777603,TRX_N-00562-331444119477,2024-03-06T18:29:56,Vitoria-Gasteiz,Basic services,electricity,-72.59,-29938.46
buyer_6,Manuel,45,ES43209562886882777603,TRX_N-00563-452537279495,2024-03-06T08:45:08,Vitoria-Gasteiz,Basic services,internet,-38.09,-29976.55
buyer_6,Manuel,45,ES43209562886882777603,TRX_N-00564-573682889491,2024-03-07T12:13:45,Vitoria-Gasteiz,Basic services,internet,-71.34,-30047.89
buyer_6,Manuel,45,ES43209562886882777603,TRX_N-00565-499694718495,2024-03-11T12:38:43,Vitoria-Gasteiz,Expense,food,-462.91,-30510.8
buyer_6,Manuel,45,ES43209562886882777603,TRX_N-00566-847131732361,2024-03-12T12:11:46,Vitoria-Gasteiz,Expense,clothing,-197.5,-30708.3
buyer_6,Manuel,45,ES43209562886882777603,TRX_N-00567-874713615839,2024-03-13T16:38:18,Vitoria-Gasteiz,Expense,clothing,-269.23,-30977.53
buyer_6,Manuel,45,ES43209562886882777603,TRX_N-00568-960981705641,2024-03-20T18:20:56,Durango,Expense,food,-547.86,-31525.39
buyer_6,Manuel,45,ES43209562886882777603,TRX_N-00569-987579399611,2024-03-27T20:12:10,Vitoria-Gasteiz,Expense,food,-202.77,-31728.16
buyer_6,Manuel,45,ES43209562886882777603,TRX_N-00570-847608219578,2024-03-28T14:22:11,Vitoria-Gasteiz,Expense,transport,-113.35,-31841.51
buyer_6,Manuel,45,ES43209562886882777603,TRX_N-00571-155202565948,2024-03-29T13:42:47,Vitoria-Gasteiz,Expense,food,-269.7,-32111.21
buyer_6,Manuel,45,ES43209562886882777603,TRX_N-00572-913006585498,2024-03-29T16:13:21,Vitoria-Gasteiz,Expense,transport,-78.17,-32189.38
buyer_6,Manuel,45,ES43209562886882777603,TRX_N-00573-438674917733,2024-04-01T19:43:38,Vitoria-Gasteiz,transfer,Salary,1304.67,-30884.71
buyer_6,Manuel,45,ES43209562886882777603,TRX_N-00574-938593983959,2024-04-05T15:47:49,Vitoria-Gasteiz,Housing,Rent,-733.63,-31618.34
buyer_6,Manuel,45,ES43209562886882777603,TRX_N-00575-31602343378,2024-04-05T12:08:18,Vitoria-Gasteiz,Basic services,water,-57.05,-31675.39
buyer_6,Manuel,45,ES43209562886882777603,TRX_N-00576-612672302634,2024-04-05T20:20:44,Vitoria-Gasteiz,Basic services,electricity,-86.74,-31762.13
buyer_6,Manuel,45,ES43209562886882777603,TRX_N-00577-451737614206,2024-04-05T14:06:15,Vitoria-Gasteiz,Basic services,internet,-55.53,-31817.66
buyer_6,Manuel,45,ES43209562886882777603,TRX_N-00578-972277415978,2024-04-05T16:59:32,Vitoria-Gasteiz,Expense,healthcare,-286.44,-32104.1
buyer_6,Manuel,45,ES43209562886882777603,TRX_N-00579-429220473960,2024-04-06T09:48:20,Vitoria-Gasteiz,Basic services,water,-56.48,-32160.58
buyer_6,Manuel,45,ES43209562886882777603,TRX_N-00580-226021532153,2024-04-07T17:57:09,Vitoria-Gasteiz,Basic services,electricity,-144.04,-32304.62
buyer_6,Manuel,45,ES43209562886882777603,TRX_N-00581-902618839933,2024-04-07T21:39:06,Vitoria-Gasteiz,Basic services,phone,-26.41,-32331.03
buyer_6,Manuel,45,ES43209562886882777603,TRX_N-00582-247456889073,2024-04-08T05:39:03,Vitoria-Gasteiz,Expense,food,-718.25,-33049.28
buyer_6,Manuel,45,ES43209562886882777603,TRX_N-00583-293826120426,2024-04-12T16:03:19,Vitoria-Gasteiz,Expense,transport,-152.54,-33201.82
buyer_6,Manuel,45,ES43209562886882777603,TRX_N-00584-143064306030,2024-04-21T12:34:58,Vitoria-Gasteiz,Expense,clothing,-482.06,-33683.88
buyer_6,Manuel,45,ES43209562886882777603,TRX_N-00585-122459294529,2024-04-23T02:53:05,Hondarribia,Expense,clothing,-408.72,-34092.6
buyer_6,Manuel,45,ES43209562886882777603,TRX_N-00586-541267787922,2024-04-25T13:13:30,Vitoria-Gasteiz,Expense,healthcare,-248.96,-34341.56
buyer_6,Manuel,45,ES43209562886882777603,TRX_N-00587-130024214164,2024-04-29T07:27:25,Donostia,Expense,clothing,-319.69,-34661.25
buyer_6,Manuel,45,ES43209562886882777603,TRX_N-00588-655275583470,2024-04-30T11:58:11,Vitoria-Gasteiz,Expense,healthcare,-303.95,-34965.2
buyer_6,Manuel,45,ES43209562886882777603,TRX_N-00589-664746600814,2024-05-01T08:47:55,Vitoria-Gasteiz,transfer,Salary,1304.67,-33660.53
buyer_6,Manuel,45,ES43209562886882777603,TRX_N-00590-625609293015,2024-05-04T17:17:10,Zarautz,Expense,food,-475.62,-34136.15
buyer_6,Manuel,45,ES43209562886882777603,TRX_N-00591-325909540986,2024-05-04T08:42:01,Zarautz,Expense,transport,-197.11,-34333.26
buyer_6,Manuel,45,ES43209562886882777603,TRX_N-00592-487543392133,2024-05-04T19:47:32,Vitoria-Gasteiz,Expense,leisure,-109.97,-34443.23
buyer_6,Manuel,45,ES43209562886882777603,TRX_N-00593-139311679675,2024-05-05T08:10:40,Vitoria-Gasteiz,Housing,Rent,-733.63,-35176.86
buyer_6,Manuel,45,ES43209562886882777603,TRX_N-00594-390977495123,2024-05-05T11:42:15,Vitoria-Gasteiz,Basic services,internet,-69.67,-35246.53
buyer_6,Manuel,45,ES43209562886882777603,TRX_N-00595-348125698846,2024-05-06T19:58:52,Vitoria-Gasteiz,Basic services,internet,-49.83,-35296.36
buyer_6,Manuel,45,ES43209562886882777603,TRX_N-00596-703215604746,2024-05-07T12:07:00,Vitoria-Gasteiz,Basic services,water,-34.28,-35330.64
buyer_6,Manuel,45,ES43209562886882777603,TRX_N-00597-873960615607,2024-05-15T12:05:51,Vitoria-Gasteiz,Expense,transport,-138.59,-35469.23
buyer_6,Manuel,45,ES43209562886882777603,TRX_N-00598-449896272607,2024-05-28T14:17:27,Vitoria-Gasteiz,Expense,repairs,-907.75,-36376.98
buyer_6,Manuel,45,ES43209562886882777603,TRX_N-00599-319828336138,2024-06-01T10:37:02,Vitoria-Gasteiz,transfer,Salary,1304.67,-35072.31
buyer_6,Manuel,45,ES43209562886882777603,TRX_N-00600-777469848110,2024-06-01T10:37:02,Vitoria-Gasteiz,transfer,Extra Income,130.47,-34941.84
buyer_6,Manuel,45,ES43209562886882777603,TRX_N-00601-905095074168,2024-06-01T10:37:02,Vitoria-Gasteiz,transfer,Bonus,1404.96,-33536.88
buyer_6,Manuel,45,ES43209562886882777603,TRX_N-00602-327937770917,2024-06-05T16:17:20,Vitoria-Gasteiz,Housing,Rent,-733.63,-34270.51
buyer_6,Manuel,45,ES43209562886882777603,TRX_N-00603-438199475657,2024-06-05T20:16:05,Vitoria-Gasteiz,Basic services,electricity,-74.2,-34344.71
buyer_6,Manuel,45,ES43209562886882777603,TRX_N-00604-735764674906,2024-06-05T19:04:49,Vitoria-Gasteiz,Basic services,internet,-56.97,-34401.68
buyer_6,Manuel,45,ES43209562886882777603,TRX_N-00605-797541166016,2024-06-06T18:20:39,Vitoria-Gasteiz,Basic services,electricity,-39.92,-34441.6
buyer_6,Manuel,45,ES43209562886882777603,TRX_N-00606-77313283459,2024-06-06T20:01:08,Vitoria-Gasteiz,Basic services,internet,-77.83,-34519.43
buyer_6,Manuel,45,ES43209562886882777603,TRX_N-00607-803164254611,2024-06-06T12:31:03,Vitoria-Gasteiz,Expense,leisure,-14.35,-34533.78
buyer_6,Manuel,45,ES43209562886882777603,TRX_N-00608-921942485026,2024-06-07T17:04:50,Vitoria-Gasteiz,Basic services,water,-49.14,-34582.92
buyer_6,Manuel,45,ES43209562886882777603,TRX_N-00609-200194430307,2024-06-07T20:23:47,Vitoria-Gasteiz,Basic services,electricity,-66.68,-34649.6
buyer_6,Manuel,45,ES43209562886882777603,TRX_N-00610-685150194255,2024-06-07T13:03:20,Vitoria-Gasteiz,Expense,education,-810.79,-35460.39
buyer_6,Manuel,45,ES43209562886882777603,TRX_N-00611-953564658894,2024-07-01T12:52:04,Vitoria-Gasteiz,transfer,Salary,1304.67,-34155.72
buyer_6,Manuel,45,ES43209562886882777603,TRX_N-00612-957257739882,2024-07-05T18:30:34,Vitoria-Gasteiz,Housing,Rent,-733.63,-34889.35
buyer_6,Manuel,45,ES43209562886882777603,TRX_N-00613-205989056767,2024-07-05T06:07:17,Vitoria-Gasteiz,Basic services,water,-28.11,-34917.46
buyer_6,Manuel,45,ES43209562886882777603,TRX_N-00614-3061562187,2024-07-05T16:05:25,Vitoria-Gasteiz,Basic services,electricity,-53.68,-34971.14
buyer_6,Manuel,45,ES43209562886882777603,TRX_N-00615-433077397629,2024-07-05T18:06:08,Vitoria-Gasteiz,Basic services,gas,-87.22,-35058.36
buyer_6,Manuel,45,ES43209562886882777603,TRX_N-00616-606814334160,2024-07-05T08:50:38,Vitoria-Gasteiz,Basic services,internet,-58.6,-35116.96
buyer_6,Manuel,45,ES43209562886882777603,TRX_N-00617-421893416821,2024-07-06T13:42:51,Vitoria-Gasteiz,Basic services,gas,-96.83,-35213.79
buyer_6,Manuel,45,ES43209562886882777603,TRX_N-00618-79067133113,2024-07-06T13:10:00,Vitoria-Gasteiz,Basic services,internet,-60.19,-35273.98
buyer_6,Manuel,45,ES43209562886882777603,TRX_N-00619-802947451819,2024-07-07T23:31:46,Vitoria-Gasteiz,Basic services,water,-48.16,-35322.14
buyer_6,Manuel,45,ES43209562886882777603,TRX_N-00620-246066210395,2024-07-07T11:39:42,Vitoria-Gasteiz,Basic services,gas,-68.1,-35390.24
buyer_6,Manuel,45,ES43209562886882777603,TRX_N-00621-346275136081,2024-07-07T17:53:44,Vitoria-Gasteiz,Basic services,phone,-46.23,-35436.47
buyer_6,Manuel,45,ES43209562886882777603,TRX_N-00622-43363744874,2024-07-09T08:59:37,Vitoria-Gasteiz,Expense,transport,-127.07,-35563.54
buyer_6,Manuel,45,ES43209562886882777603,TRX_N-00623-573194998099,2024-07-16T18:19:33,Vitoria-Gasteiz,Expense,food,-768.29,-36331.83
buyer_6,Manuel,45,ES43209562886882777603,TRX_N-00624-830440535118,2024-07-25T18:16:54,Vitoria-Gasteiz,Expense,travel,-1010.58,-37342.41
buyer_6,Manuel,45,ES43209562886882777603,TRX_N-00625-794326907840,2024-07-30T20:20:44,Vitoria-Gasteiz,Expense,clothing,-106.33,-37448.74
buyer_6,Manuel,45,ES43209562886882777603,TRX_N-00626-586193823593,2024-08-01T13:05:45,Vitoria-Gasteiz,transfer,Salary,1304.67,-36144.07
buyer_6,Manuel,45,ES43209562886882777603,TRX_N-00627-453990917757,2024-08-01T13:46:13,Vitoria-Gasteiz,Expense,food,-684.32,-36828.39
buyer_6,Manuel,45,ES43209562886882777603,TRX_N-00628-582888700936,2024-08-05T08:44:54,Vitoria-Gasteiz,Housing,Rent,-733.63,-37562.02
buyer_6,Manuel,45,ES43209562886882777603,TRX_N-00629-297995766623,2024-08-05T19:50:31,Vitoria-Gasteiz,Basic services,water,-74.99,-37637.01
buyer_6,Manuel,45,ES43209562886882777603,TRX_N-00630-108109238307,2024-08-05T13:19:31,Vitoria-Gasteiz,Basic services,gas,-96.46,-37733.47
buyer_6,Manuel,45,ES43209562886882777603,TRX_N-00631-932963610048,2024-08-05T04:47:47,Vitoria-Gasteiz,Basic services,internet,-43.29,-37776.76
buyer_6,Manuel,45,ES43209562886882777603,TRX_N-00632-20683368155,2024-08-07T01:32:13,Vitoria-Gasteiz,Basic services,water,-44.13,-37820.89
buyer_6,Manuel,45,ES43209562886882777603,TRX_N-00633-27453031489,2024-08-09T22:24:00,Vitoria-Gasteiz,Expense,healthcare,-259.85,-38080.74
buyer_6,Manuel,45,ES43209562886882777603,TRX_N-00634-924301678273,2024-08-23T19:44:28,Vitoria-Gasteiz,Expense,leisure,-217.62,-38298.36
buyer_6,Manuel,45,ES43209562886882777603,TRX_N-00635-186615604803,2024-08-25T09:24:21,Vitoria-Gasteiz,Expense,leisure,-61.56,-38359.92
buyer_6,Manuel,45,ES43209562886882777603,TRX_N-00636-969718090496,2024-08-28T19:17:55,Vitoria-Gasteiz,Expense,transport,-62.86,-38422.78
buyer_6,Manuel,45,ES43209562886882777603,TRX_N-00637-170608197112,2024-09-01T08:13:24,Vitoria-Gasteiz,transfer,Salary,1304.67,-37118.11
buyer_6,Manuel,45,ES43209562886882777603,TRX_N-00638-3377013045,2024-09-01T08:13:24,Vitoria-Gasteiz,transfer,Extra Income,130.47,-36987.64
buyer_6,Manuel,45,ES43209562886882777603,TRX_N-00639-537179491124,2024-09-05T08:27:44,Vitoria-Gasteiz,Housing,Rent,-733.63,-37721.27
buyer_6,Manuel,45,ES43209562886882777603,TRX_N-00640-89014785354,2024-09-05T18:03:49,Vitoria-Gasteiz,Basic services,electricity,-132.65,-37853.92
buyer_6,Manuel,45,ES43209562886882777603,TRX_N-00641-514708387701,2024-09-05T10:43:07,Vitoria-Gasteiz,Basic services,gas,-64.65,-37918.57
buyer_6,Manuel,45,ES43209562886882777603,TRX_N-00642-669469548401,2024-09-06T10:40:52,Vitoria-Gasteiz,Basic services,internet,-67.2,-37985.77
buyer_6,Manuel,45,ES43209562886882777603,TRX_N-00643-261026693342,2024-09-07T21:20:10,Vitoria-Gasteiz,Basic services,electricity,-107.06,-38092.83
buyer_6,Manuel,45,ES43209562886882777603,TRX_N-00644-398030566357,2024-09-14T16:11:36,Sestao,Expense,food,-354.12,-38446.95
buyer_6,Manuel,45,ES43209562886882777603,TRX_N-00645-126433444044,2024-09-24T12:48:48,Vitoria-Gasteiz,Expense,repairs,-761.37,-39208.32
buyer_6,Manuel,45,ES43209562886882777603,TRX_N-00646-601721063862,2024-09-25T17:48:02,Berango,Expense,food,-617.83,-39826.15
buyer_6,Manuel,45,ES43209562886882777603,TRX_N-00647-581195973257,2024-09-26T12:52:04,Vitoria-Gasteiz,Expense,travel,-2201.58,-42027.73
buyer_6,Manuel,45,ES43209562886882777603,TRX_N-00648-800287685753,2024-10-01T18:37:03,Vitoria-Gasteiz,transfer,Salary,1304.67,-40723.06
buyer_6,Manuel,45,ES43209562886882777603,TRX_N-00649-935001036636,2024-10-02T09:35:20,Pasaia,Expense,travel,-912.12,-41635.18
buyer_6,Manuel,45,ES43209562886882777603,TRX_N-00650-220606698500,2024-10-04T17:14:41,Vitoria-Gasteiz,Expense,gifts,-53.3,-41688.48
buyer_6,Manuel,45,ES43209562886882777603,TRX_N-00651-646751513702,2024-10-05T14:05:19,Vitoria-Gasteiz,Housing,Rent,-733.63,-42422.11
buyer_6,Manuel,45,ES43209562886882777603,TRX_N-00652-772550769983,2024-10-05T21:09:31,Vitoria-Gasteiz,Basic services,electricity,-71.6,-42493.71
buyer_6,Manuel,45,ES43209562886882777603,TRX_N-00653-802752228839,2024-10-05T11:50:17,Vitoria-Gasteiz,Basic services,gas,-97.32,-42591.03
buyer_6,Manuel,45,ES43209562886882777603,TRX_N-00654-959382048219,2024-10-06T20:05:45,Vitoria-Gasteiz,Basic services,water,-15.99,-42607.02
buyer_6,Manuel,45,ES43209562886882777603,TRX_N-00655-374670057135,2024-10-06T15:48:55,Vitoria-Gasteiz,Basic services,electricity,-104.12,-42711.14
buyer_6,Manuel,45,ES43209562886882777603,TRX_N-00656-522958864012,2024-10-07T10:25:12,Vitoria-Gasteiz,Basic services,water,-23.66,-42734.8
buyer_6,Manuel,45,ES43209562886882777603,TRX_N-00657-691748073421,2024-10-07T12:42:40,Vitoria-Gasteiz,Basic services,electricity,-47.46,-42782.26
buyer_7,María,56,ES32209538214206674989,TRX_N-00001-670604240174,2020-01-01T13:49:18,Portugalete,transfer,Salary,3020.95,7057.72
buyer_7,María,56,ES32209538214206674989,TRX_N-00002-456239100021,2020-01-01T13:49:18,Portugalete,transfer,Partner Salary,3026.13,10083.85
buyer_7,María,56,ES32209538214206674989,TRX_N-00003-185111851862,2020-01-05T11:56:26,Portugalete,Housing,Mortgage,-1805.98,8277.87
buyer_7,María,56,ES32209538214206674989,TRX_N-00004-191728737150,2020-01-06T21:38:28,Portugalete,Basic services,internet,-49.7,8228.17
buyer_7,María,56,ES32209538214206674989,TRX_N-00005-477843915411,2020-01-06T16:38:47,Portugalete,Expense,food,-342.9,7885.27
buyer_7,María,56,ES32209538214206674989,TRX_N-00006-732412043916,2020-01-07T17:06:34,Portugalete,Basic services,phone,-20.52,7864.75
buyer_7,María,56,ES32209538214206674989,TRX_N-00007-77377313562,2020-01-19T10:35:28,Portugalete,Expense,transport,-121.09,7743.66
buyer_7,María,56,ES32209538214206674989,TRX_N-00008-413846210623,2020-01-26T19:58:40,Galdakao,Expense,leisure,-201.7,7541.96
buyer_7,María,56,ES32209538214206674989,TRX_N-00009-4784273003,2020-01-31T18:15:54,Portugalete,Expense,clothing,-379.4,7162.56
buyer_7,María,56,ES32209538214206674989,TRX_N-00010-433072674324,2020-02-01T17:15:31,Portugalete,transfer,Salary,3020.95,10183.51
buyer_7,María,56,ES32209538214206674989,TRX_N-00011-50047033353,2020-02-01T17:15:31,Portugalete,transfer,Partner Salary,3026.13,13209.64
buyer_7,María,56,ES32209538214206674989,TRX_N-00012-374602131583,2020-02-02T12:23:49,Portugalete,Expense,leisure,-272.96,12936.68
buyer_7,María,56,ES32209538214206674989,TRX_N-00013-502110308877,2020-02-05T02:40:54,Portugalete,Housing,Mortgage,-1805.98,11130.7
buyer_7,María,56,ES32209538214206674989,TRX_N-00014-916743988299,2020-02-05T08:40:22,Portugalete,Basic services,electricity,-90.0,11040.7
buyer_7,María,56,ES32209538214206674989,TRX_N-00015-144035129144,2020-02-05T14:26:17,Portugalete,Basic services,gas,-68.0,10972.7
buyer_7,María,56,ES32209538214206674989,TRX_N-00016-840822242621,2020-02-05T16:48:40,Portugalete,Basic services,internet,-60.6,10912.1
buyer_7,María,56,ES32209538214206674989,TRX_N-00017-534934989677,2020-02-05T14:34:18,Portugalete,Basic services,phone,-68.46,10843.64
buyer_7,María,56,ES32209538214206674989,TRX_N-00018-941631296310,2020-02-06T16:40:19,Portugalete,Basic services,water,-57.38,10786.26
buyer_7,María,56,ES32209538214206674989,TRX_N-00019-227775535799,2020-02-06T22:09:48,Portugalete,Basic services,internet,-38.77,10747.49
buyer_7,María,56,ES32209538214206674989,TRX_N-00020-437753783790,2020-02-07T11:07:10,Portugalete,Basic services,internet,-71.86,10675.63
buyer_7,María,56,ES32209538214206674989,TRX_N-00021-188130074168,2020-02-10T16:19:11,Portugalete,Expense,healthcare,-96.19,10579.44
buyer_7,María,56,ES32209538214206674989,TRX_N-00022-522304171686,2020-02-27T15:09:29,Portugalete,Expense,food,-673.67,9905.77
buyer_7,María,56,ES32209538214206674989,TRX_N-00023-154119237170,2020-02-28T19:55:54,Portugalete,Expense,repairs,-716.97,9188.8
buyer_7,María,56,ES32209538214206674989,TRX_N-00024-237559068044,2020-03-01T00:25:49,Portugalete,transfer,Salary,3020.95,12209.75
buyer_7,María,56,ES32209538214206674989,TRX_N-00025-171184863269,2020-03-01T00:25:49,Portugalete,transfer,Partner Salary,3026.13,15235.88
buyer_7,María,56,ES32209538214206674989,TRX_N-00026-956648490294,2020-03-01T00:25:49,Portugalete,transfer,Extra Income,302.09,15537.97
buyer_7,María,56,ES32209538214206674989,TRX_N-00027-967820092250,2020-03-05T22:25:55,Portugalete,Housing,Mortgage,-1805.98,13731.99
buyer_7,María,56,ES32209538214206674989,TRX_N-00028-439914444171,2020-03-05T16:54:45,Portugalete,Basic services,internet,-56.3,13675.69
buyer_7,María,56,ES32209538214206674989,TRX_N-00029-532964746663,2020-03-05T17:40:11,Portugalete,Basic services,phone,-68.37,13607.32
buyer_7,María,56,ES32209538214206674989,TRX_N-00030-223681346135,2020-03-06T09:31:19,Portugalete,Basic services,electricity,-37.37,13569.95
buyer_7,María,56,ES32209538214206674989,TRX_N-00031-178233042200,2020-03-06T11:09:24,Portugalete,Basic services,phone,-20.2,13549.75
buyer_7,María,56,ES32209538214206674989,TRX_N-00032-430468187549,2020-03-07T18:06:39,Portugalete,Basic services,water,-69.96,13479.79
buyer_7,María,56,ES32209538214206674989,TRX_N-00033-680742979089,2020-03-07T07:05:02,Portugalete,Basic services,electricity,-51.56,13428.23
buyer_7,María,56,ES32209538214206674989,TRX_N-00034-143233241397,2020-03-07T16:11:53,Portugalete,Basic services,gas,-45.86,13382.37
buyer_7,María,56,ES32209538214206674989,TRX_N-00035-117129519040,2020-03-07T18:59:12,Portugalete,Basic services,internet,-38.44,13343.93
buyer_7,María,56,ES32209538214206674989,TRX_N-00036-799765324964,2020-03-12T20:04:58,Portugalete,Expense,food,-300.72,13043.21
buyer_7,María,56,ES32209538214206674989,TRX_N-00037-630336756695,2020-03-13T14:02:00,Alegría-Dulantzi,Expense,food,-285.91,12757.3
buyer_7,María,56,ES32209538214206674989,TRX_N-00038-69728966732,2020-04-01T08:50:45,Portugalete,transfer,Salary,3020.95,15778.25
buyer_7,María,56,ES32209538214206674989,TRX_N-00039-300776310707,2020-04-01T08:50:45,Portugalete,transfer,Partner Salary,3026.13,18804.38
buyer_7,María,56,ES32209538214206674989,TRX_N-00040-200598473784,2020-04-05T15:19:45,Portugalete,Housing,Mortgage,-1805.98,16998.4
buyer_7,María,56,ES32209538214206674989,TRX_N-00041-996454158163,2020-04-05T07:35:35,Portugalete,Basic services,water,-45.42,16952.98
buyer_7,María,56,ES32209538214206674989,TRX_N-00042-466348667937,2020-04-05T12:34:31,Portugalete,Basic services,gas,-22.62,16930.36
buyer_7,María,56,ES32209538214206674989,TRX_N-00043-647716455293,2020-04-05T17:39:37,Portugalete,Basic services,internet,-66.09,16864.27
buyer_7,María,56,ES32209538214206674989,TRX_N-00044-942298629593,2020-04-05T09:49:14,Portugalete,Basic services,phone,-29.31,16834.96
buyer_7,María,56,ES32209538214206674989,TRX_N-00045-34704455884,2020-04-06T17:00:15,Portugalete,Basic services,water,-55.61,16779.35
buyer_7,María,56,ES32209538214206674989,TRX_N-00046-741940550805,2020-04-06T22:37:15,Portugalete,Basic services,phone,-60.64,16718.71
buyer_7,María,56,ES32209538214206674989,TRX_N-00047-437946290266,2020-04-07T08:45:27,Portugalete,Basic services,electricity,-72.65,16646.06
buyer_7,María,56,ES32209538214206674989,TRX_N-00048-634867942276,2020-04-07T18:34:46,Portugalete,Expense,healthcare,-282.22,16363.84
buyer_7,María,56,ES32209538214206674989,TRX_N-00049-909574268509,2020-04-18T18:40:24,Portugalete,Expense,leisure,-85.37,16278.47
buyer_7,María,56,ES32209538214206674989,TRX_N-00050-267482187135,2020-04-21T15:13:25,Portugalete,Expense,food,-354.2,15924.27
buyer_7,María,56,ES32209538214206674989,TRX_N-00051-833626112311,2020-04-21T18:35:42,Portugalete,Expense,transport,-127.74,15796.53
buyer_7,María,56,ES32209538214206674989,TRX_N-00052-71617617429,2020-04-27T19:21:24,Portugalete,Expense,leisure,-122.5,15674.03
buyer_7,María,56,ES32209538214206674989,TRX_N-00053-230214534666,2020-05-01T15:52:36,Portugalete,transfer,Salary,3020.95,18694.98
buyer_7,María,56,ES32209538214206674989,TRX_N-00054-631678638084,2020-05-01T15:52:36,Portugalete,transfer,Partner Salary,3026.13,21721.11
buyer_7,María,56,ES32209538214206674989,TRX_N-00055-735845047093,2020-05-05T18:41:56,Portugalete,Housing,Mortgage,-1805.98,19915.13
buyer_7,María,56,ES32209538214206674989,TRX_N-00056-446052098757,2020-05-05T10:23:50,Portugalete,Basic services,electricity,-34.45,19880.68
buyer_7,María,56,ES32209538214206674989,TRX_N-00057-656613324983,2020-05-05T15:36:14,Portugalete,Basic services,gas,-98.45,19782.23
buyer_7,María,56,ES32209538214206674989,TRX_N-00058-203399541932,2020-05-05T18:18:16,Portugalete,Basic services,internet,-52.53,19729.7
buyer_7,María,56,ES32209538214206674989,TRX_N-00059-984094616382,2020-05-05T08:56:49,Portugalete,Basic services,phone,-25.18,19704.52
buyer_7,María,56,ES32209538214206674989,TRX_N-00060-885412721745,2020-05-07T17:06:23,Portugalete,Basic services,water,-51.99,19652.53
buyer_7,María,56,ES32209538214206674989,TRX_N-00061-796128767203,2020-05-07T11:55:17,Portugalete,Expense,transport,-172.53,19480.0
buyer_7,María,56,ES32209538214206674989,TRX_N-00062-17469159592,2020-05-09T16:33:57,Portugalete,Expense,leisure,-78.95,19401.05
buyer_7,María,56,ES32209538214206674989,TRX_N-00063-815804822214,2020-05-10T16:52:52,Portugalete,Expense,leisure,-217.59,19183.46
buyer_7,María,56,ES32209538214206674989,TRX_N-00064-857541928185,2020-05-22T01:59:04,Portugalete,Expense,transport,-126.41,19057.05
buyer_7,María,56,ES32209538214206674989,TRX_N-00065-495983830804,2020-05-23T14:03:21,Portugalete,Expense,leisure,-72.58,18984.47
buyer_7,María,56,ES32209538214206674989,TRX_N-00066-253796147889,2020-06-01T16:37:51,Portugalete,transfer,Salary,3020.95,22005.42
buyer_7,María,56,ES32209538214206674989,TRX_N-00067-341615943791,2020-06-01T16:37:51,Portugalete,transfer,Partner Salary,3026.13,25031.55
buyer_7,María,56,ES32209538214206674989,TRX_N-00068-679284787403,2020-06-01T16:37:51,Portugalete,transfer,Extra Income,302.09,25333.64
buyer_7,María,56,ES32209538214206674989,TRX_N-00069-243743295323,2020-06-01T16:37:51,Portugalete,transfer,Bonus,2986.2,28319.84
buyer_7,María,56,ES32209538214206674989,TRX_N-00070-371993961124,2020-06-05T11:05:13,Portugalete,Housing,Mortgage,-1805.98,26513.86
buyer_7,María,56,ES32209538214206674989,TRX_N-00071-697346998228,2020-06-05T13:25:24,Portugalete,Basic services,water,-57.65,26456.21
buyer_7,María,56,ES32209538214206674989,TRX_N-00072-987308829592,2020-06-05T11:01:59,Portugalete,Basic services,phone,-74.83,26381.38
buyer_7,María,56,ES32209538214206674989,TRX_N-00073-857252473130,2020-06-06T19:26:54,Portugalete,Basic services,water,-41.66,26339.72
buyer_7,María,56,ES32209538214206674989,TRX_N-00074-510483282654,2020-06-06T13:53:53,Portugalete,Basic services,gas,-80.98,26258.74
buyer_7,María,56,ES32209538214206674989,TRX_N-00075-953600761474,2020-06-07T21:36:46,Portugalete,Basic services,water,-17.22,26241.52
buyer_7,María,56,ES32209538214206674989,TRX_N-00076-365417471831,2020-06-07T09:06:12,Portugalete,Basic services,phone,-94.28,26147.24
buyer_7,María,56,ES32209538214206674989,TRX_N-00077-881484663716,2020-06-08T08:20:45,Portugalete,Expense,transport,-48.55,26098.69
buyer_7,María,56,ES32209538214206674989,TRX_N-00078-945448817202,2020-07-01T08:35:49,Portugalete,transfer,Salary,3020.95,29119.64
buyer_7,María,56,ES32209538214206674989,TRX_N-00079-991771580583,2020-07-01T08:35:49,Portugalete,transfer,Partner Salary,3026.13,32145.77
buyer_7,María,56,ES32209538214206674989,TRX_N-00080-943059640479,2020-07-01T18:04:04,Amurrio,Expense,leisure,-265.22,31880.55
buyer_7,María,56,ES32209538214206674989,TRX_N-00081-442482866417,2020-07-05T23:59:36,Portugalete,Housing,Mortgage,-1805.98,30074.57
buyer_7,María,56,ES32209538214206674989,TRX_N-00082-974497009018,2020-07-05T17:42:06,Portugalete,Basic services,gas,-31.69,30042.88
buyer_7,María,56,ES32209538214206674989,TRX_N-00083-767198537007,2020-07-06T19:58:07,Portugalete,Basic services,internet,-73.6,29969.28
buyer_7,María,56,ES32209538214206674989,TRX_N-00084-719464080585,2020-07-22T21:04:13,Berango,Expense,food,-515.0,29454.28
buyer_7,María,56,ES32209538214206674989,TRX_N-00085-575573624010,2020-07-22T08:01:51,Portugalete,Expense,transport,-100.23,29354.05
buyer_7,María,56,ES32209538214206674989,TRX_N-00086-532470293339,2020-07-28T09:57:40,Portugalete,Expense,food,-254.09,29099.96
buyer_7,María,56,ES32209538214206674989,TRX_N-00087-605974347624,2020-07-29T13:38:39,Portugalete,Expense,food,-544.67,28555.29
buyer_7,María,56,ES32209538214206674989,TRX_N-00088-300146680584,2020-08-01T14:30:34,Portugalete,transfer,Salary,3020.95,31576.24
buyer_7,María,56,ES32209538214206674989,TRX_N-00089-614990777537,2020-08-01T14:30:34,Portugalete,transfer,Partner Salary,3026.13,34602.37
buyer_7,María,56,ES32209538214206674989,TRX_N-00090-86211051233,2020-08-05T19:48:59,Portugalete,Housing,Mortgage,-1805.98,32796.39
buyer_7,María,56,ES32209538214206674989,TRX_N-00091-886608073765,2020-08-06T10:13:31,Portugalete,Basic services,electricity,-88.25,32708.14
buyer_7,María,56,ES32209538214206674989,TRX_N-00092-281897850895,2020-08-07T02:08:22,Portugalete,Basic services,water,-18.25,32689.89
buyer_7,María,56,ES32209538214206674989,TRX_N-00093-221577480541,2020-08-07T22:51:56,Portugalete,Basic services,electricity,-43.6,32646.29
buyer_7,María,56,ES32209538214206674989,TRX_N-00094-262902987235,2020-08-07T19:37:34,Portugalete,Basic services,gas,-24.51,32621.78
buyer_7,María,56,ES32209538214206674989,TRX_N-00095-240562791857,2020-08-07T14:34:43,Portugalete,Basic services,internet,-57.99,32563.79
buyer_7,María,56,ES32209538214206674989,TRX_N-00096-447932368831,2020-08-07T09:04:06,Portugalete,Basic services,phone,-33.12,32530.67
buyer_7,María,56,ES32209538214206674989,TRX_N-00097-562980309378,2020-08-11T11:44:04,Portugalete,Expense,food,-209.59,32321.08
buyer_7,María,56,ES32209538214206674989,TRX_N-00098-544373219153,2020-08-13T12:28:59,Elciego,Expense,food,-278.45,32042.63
buyer_7,María,56,ES32209538214206674989,TRX_N-00099-493409224159,2020-08-15T12:24:21,Portugalete,Expense,clothing,-105.02,31937.61
buyer_7,María,56,ES32209538214206674989,TRX_N-00100-922135618863,2020-09-01T15:17:33,Portugalete,transfer,Salary,3020.95,34958.56
buyer_7,María,56,ES32209538214206674989,TRX_N-00101-473928854140,2020-09-01T15:17:33,Portugalete,transfer,Partner Salary,3026.13,37984.69
buyer_7,María,56,ES32209538214206674989,TRX_N-00102-777547663050,2020-09-01T15:17:33,Portugalete,transfer,Extra Income,302.09,38286.78
buyer_7,María,56,ES32209538214206674989,TRX_N-00103-258113580093,2020-09-02T15:04:21,Portugalete,Expense,healthcare,-114.75,38172.03
buyer_7,María,56,ES32209538214206674989,TRX_N-00104-336678886091,2020-09-05T10:34:36,Portugalete,Housing,Mortgage,-1805.98,36366.05
buyer_7,María,56,ES32209538214206674989,TRX_N-00105-172450260485,2020-09-05T08:13:40,Portugalete,Expense,food,-220.14,36145.91
buyer_7,María,56,ES32209538214206674989,TRX_N-00106-770815817959,2020-09-06T09:20:49,Portugalete,Basic services,water,-17.3,36128.61
buyer_7,María,56,ES32209538214206674989,TRX_N-00107-651352282583,2020-09-06T15:16:55,Portugalete,Basic services,electricity,-64.04,36064.57
buyer_7,María,56,ES32209538214206674989,TRX_N-00108-295803396530,2020-09-06T11:24:01,Portugalete,Basic services,internet,-57.91,36006.66
buyer_7,María,56,ES32209538214206674989,TRX_N-00109-9258774537,2020-09-07T13:19:43,Portugalete,Basic services,water,-23.94,35982.72
buyer_7,María,56,ES32209538214206674989,TRX_N-00110-651310708126,2020-09-12T14:35:46,Eibar,Expense,food,-194.08,35788.64
buyer_7,María,56,ES32209538214206674989,TRX_N-00111-449384929184,2020-10-01T08:09:48,Portugalete,transfer,Salary,3020.95,38809.59
buyer_7,María,56,ES32209538214206674989,TRX_N-00112-477169967420,2020-10-01T08:09:48,Portugalete,transfer,Partner Salary,3026.13,41835.72
buyer_7,María,56,ES32209538214206674989,TRX_N-00113-620019090597,2020-10-01T12:09:03,Portugalete,Expense,clothing,-183.55,41652.17
buyer_7,María,56,ES32209538214206674989,TRX_N-00114-119433137601,2020-10-05T18:17:14,Portugalete,Housing,Mortgage,-1805.98,39846.19
buyer_7,María,56,ES32209538214206674989,TRX_N-00115-342965711212,2020-10-06T20:58:34,Portugalete,Basic services,water,-15.37,39830.82
buyer_7,María,56,ES32209538214206674989,TRX_N-00116-184855830332,2020-10-06T22:56:33,Portugalete,Basic services,electricity,-143.94,39686.88
buyer_7,María,56,ES32209538214206674989,TRX_N-00117-978247279442,2020-10-06T11:04:58,Portugalete,Basic services,phone,-85.04,39601.84
buyer_7,María,56,ES32209538214206674989,TRX_N-00118-98385765470,2020-10-07T10:42:01,Portugalete,Basic services,water,-39.26,39562.58
buyer_7,María,56,ES32209538214206674989,TRX_N-00119-86711551547,2020-10-07T19:13:32,Portugalete,Basic services,phone,-40.98,39521.6
buyer_7,María,56,ES32209538214206674989,TRX_N-00120-582363773756,2020-10-23T12:27:10,Portugalete,Expense,transport,-48.13,39473.47
buyer_7,María,56,ES32209538214206674989,TRX_N-00121-890186241627,2020-11-01T19:06:36,Portugalete,transfer,Salary,3020.95,42494.42
buyer_7,María,56,ES32209538214206674989,TRX_N-00122-374825124880,2020-11-01T19:06:36,Portugalete,transfer,Partner Salary,3026.13,45520.55
buyer_7,María,56,ES32209538214206674989,TRX_N-00123-337834398995,2020-11-04T20:05:16,Irun,Expense,food,-176.58,45343.97
buyer_7,María,56,ES32209538214206674989,TRX_N-00124-32647879002,2020-11-05T11:37:55,Portugalete,Housing,Mortgage,-1805.98,43537.99
buyer_7,María,56,ES32209538214206674989,TRX_N-00125-368443842395,2020-11-05T21:41:14,Portugalete,Basic services,water,-24.34,43513.65
buyer_7,María,56,ES32209538214206674989,TRX_N-00126-762282062756,2020-11-05T13:05:22,Portugalete,Basic services,gas,-55.17,43458.48
buyer_7,María,56,ES32209538214206674989,TRX_N-00127-562616466694,2020-11-05T19:11:14,Portugalete,Basic services,internet,-58.86,43399.62
buyer_7,María,56,ES32209538214206674989,TRX_N-00128-200079077945,2020-11-06T12:24:03,Portugalete,Basic services,electricity,-112.96,43286.66
buyer_7,María,56,ES32209538214206674989,TRX_N-00129-65960657640,2020-11-06T11:51:55,Portugalete,Basic services,gas,-15.39,43271.27
buyer_7,María,56,ES32209538214206674989,TRX_N-00130-804657001128,2020-11-06T23:45:14,Portugalete,Expense,leisure,-64.48,43206.79
buyer_7,María,56,ES32209538214206674989,TRX_N-00131-649205780846,2020-11-07T13:48:52,Portugalete,Basic services,electricity,-143.32,43063.47
buyer_7,María,56,ES32209538214206674989,TRX_N-00132-672355147030,2020-11-07T19:10:18,Portugalete,Basic services,internet,-73.42,42990.05
buyer_7,María,56,ES32209538214206674989,TRX_N-00133-87133443248,2020-11-10T19:54:24,Erandio,Expense,clothing,-278.86,42711.19
buyer_7,María,56,ES32209538214206674989,TRX_N-00134-506041184462,2020-11-23T17:53:15,Portugalete,Expense,food,-151.2,42559.99
buyer_7,María,56,ES32209538214206674989,TRX_N-00135-684807787241,2020-12-01T15:32:27,Portugalete,transfer,Salary,3020.95,45580.94
buyer_7,María,56,ES32209538214206674989,TRX_N-00136-972225998485,2020-12-01T15:32:27,Portugalete,transfer,Partner Salary,3026.13,48607.07
buyer_7,María,56,ES32209538214206674989,TRX_N-00137-687383937966,2020-12-01T15:32:27,Portugalete,transfer,Extra Income,302.09,48909.16
buyer_7,María,56,ES32209538214206674989,TRX_N-00138-484892719522,2020-12-01T15:32:27,Portugalete,transfer,Bonus,2869.89,51779.05
buyer_7,María,56,ES32209538214206674989,TRX_N-00139-475357425399,2020-12-01T10:38:21,Portugalete,Expense,clothing,-355.48,51423.57
buyer_7,María,56,ES32209538214206674989,TRX_N-00140-960162438225,2020-12-01T15:14:42,Portugalete,Expense,healthcare,-99.79,51323.78
buyer_7,María,56,ES32209538214206674989,TRX_N-00141-851330318122,2020-12-04T04:42:49,Portugalete,Expense,food,-186.38,51137.4
buyer_7,María,56,ES32209538214206674989,TRX_N-00142-109590521110,2020-12-05T13:01:51,Portugalete,Housing,Mortgage,-1805.98,49331.42
buyer_7,María,56,ES32209538214206674989,TRX_N-00143-661134329522,2020-12-05T13:13:22,Portugalete,Basic services,phone,-90.13,49241.29
buyer_7,María,56,ES32209538214206674989,TRX_N-00144-547935389297,2020-12-06T11:27:28,Portugalete,Basic services,electricity,-30.04,49211.25
buyer_7,María,56,ES32209538214206674989,TRX_N-00145-468063839121,2020-12-07T11:59:44,Portugalete,Basic services,water,-48.26,49162.99
buyer_7,María,56,ES32209538214206674989,TRX_N-00146-997381704431,2020-12-07T09:50:03,Portugalete,Basic services,electricity,-146.9,49016.09
buyer_7,María,56,ES32209538214206674989,TRX_N-00147-483712899033,2020-12-07T10:27:38,Portugalete,Basic services,phone,-44.4,48971.69
buyer_7,María,56,ES32209538214206674989,TRX_N-00148-184031239837,2020-12-15T16:49:15,Portugalete,Expense,food,-299.56,48672.13
buyer_7,María,56,ES32209538214206674989,TRX_N-00149-359015378157,2020-12-16T14:03:07,Portugalete,Expense,clothing,-220.75,48451.38
buyer_7,María,56,ES32209538214206674989,TRX_N-00150-731446920753,2020-12-18T15:08:18,Portugalete,Expense,healthcare,-236.88,48214.5
buyer_7,María,56,ES32209538214206674989,TRX_N-00151-542566395171,2020-12-27T17:35:41,Portugalete,Expense,transport,-41.93,48172.57
buyer_7,María,56,ES32209538214206674989,TRX_N-00152-391685545622,2021-01-01T17:45:55,Portugalete,transfer,Salary,3020.95,51193.52
buyer_7,María,56,ES32209538214206674989,TRX_N-00153-267973269737,2021-01-01T17:45:55,Portugalete,transfer,Partner Salary,3026.13,54219.65
buyer_7,María,56,ES32209538214206674989,TRX_N-00154-10638680182,2021-01-05T12:27:45,Portugalete,Housing,Mortgage,-1805.98,52413.67
buyer_7,María,56,ES32209538214206674989,TRX_N-00155-437159602571,2021-01-05T16:19:57,Portugalete,Basic services,gas,-25.07,52388.6
buyer_7,María,56,ES32209538214206674989,TRX_N-00156-373470016344,2021-01-05T22:28:14,Portugalete,Basic services,internet,-57.88,52330.72
buyer_7,María,56,ES32209538214206674989,TRX_N-00157-733186929373,2021-01-05T16:10:20,Portugalete,Basic services,phone,-34.67,52296.05
buyer_7,María,56,ES32209538214206674989,TRX_N-00158-614361557878,2021-01-06T09:54:47,Portugalete,Basic services,water,-34.45,52261.6
buyer_7,María,56,ES32209538214206674989,TRX_N-00159-676363440301,2021-01-06T19:49:03,Portugalete,Basic services,phone,-73.79,52187.81
buyer_7,María,56,ES32209538214206674989,TRX_N-00160-430036227463,2021-01-23T18:33:47,Portugalete,Expense,transport,-183.77,52004.04
buyer_7,María,56,ES32209538214206674989,TRX_N-00161-281252502153,2021-02-01T18:15:09,Portugalete,transfer,Salary,3020.95,55024.99
buyer_7,María,56,ES32209538214206674989,TRX_N-00162-1077624910,2021-02-01T18:15:09,Portugalete,transfer,Partner Salary,3026.13,58051.12
buyer_7,María,56,ES32209538214206674989,TRX_N-00163-83451678292,2021-02-03T17:30:20,Portugalete,Expense,transport,-141.76,57909.36
buyer_7,María,56,ES32209538214206674989,TRX_N-00164-516111572746,2021-02-05T10:37:44,Portugalete,Housing,Mortgage,-1805.98,56103.38
buyer_7,María,56,ES32209538214206674989,TRX_N-00165-108912310518,2021-02-05T17:04:01,Portugalete,Basic services,electricity,-121.32,55982.06
buyer_7,María,56,ES32209538214206674989,TRX_N-00166-938495095575,2021-02-05T17:56:30,Portugalete,Basic services,internet,-61.99,55920.07
buyer_7,María,56,ES32209538214206674989,TRX_N-00167-677501555440,2021-02-06T15:58:52,Portugalete,Basic services,electricity,-100.45,55819.62
buyer_7,María,56,ES32209538214206674989,TRX_N-00168-579980269014,2021-02-07T18:19:41,Portugalete,Basic services,gas,-79.46,55740.16
buyer_7,María,56,ES32209538214206674989,TRX_N-00169-83004871243,2021-02-07T09:41:07,Portugalete,Basic services,internet,-36.4,55703.76
buyer_7,María,56,ES32209538214206674989,TRX_N-00170-509533324473,2021-02-12T01:08:06,Portugalete,Expense,healthcare,-124.1,55579.66
buyer_7,María,56,ES32209538214206674989,TRX_N-00171-14433656230,2021-02-13T18:52:16,Portugalete,Expense,healthcare,-70.28,55509.38
buyer_7,María,56,ES32209538214206674989,TRX_N-00172-682621598591,2021-02-15T16:49:21,Portugalete,Expense,food,-674.83,54834.55
buyer_7,María,56,ES32209538214206674989,TRX_N-00173-823264592294,2021-02-15T19:09:04,Portugalete,Expense,gifts,-316.21,54518.34
buyer_7,María,56,ES32209538214206674989,TRX_N-00174-836426902332,2021-03-01T09:14:57,Portugalete,transfer,Salary,3020.95,57539.29
buyer_7,María,56,ES32209538214206674989,TRX_N-00175-239836260351,2021-03-01T09:14:57,Portugalete,transfer,Partner Salary,3026.13,60565.42
buyer_7,María,56,ES32209538214206674989,TRX_N-00176-199515962770,2021-03-01T09:14:57,Portugalete,transfer,Extra Income,302.09,60867.51
buyer_7,María,56,ES32209538214206674989,TRX_N-00177-366217110707,2021-03-05T18:53:14,Portugalete,Housing,Mortgage,-1805.98,59061.53
buyer_7,María,56,ES32209538214206674989,TRX_N-00178-503102385351,2021-03-05T10:05:44,Portugalete,Basic services,electricity,-128.22,58933.31
buyer_7,María,56,ES32209538214206674989,TRX_N-00179-672900386729,2021-03-05T16:45:42,Portugalete,Basic services,gas,-19.79,58913.52
buyer_7,María,56,ES32209538214206674989,TRX_N-00180-41380412997,2021-03-05T20:05:18,Portugalete,Basic services,phone,-60.53,58852.99
buyer_7,María,56,ES32209538214206674989,TRX_N-00181-827152207243,2021-03-06T23:36:26,Portugalete,Basic services,electricity,-48.2,58804.79
buyer_7,María,56,ES32209538214206674989,TRX_N-00182-818426523518,2021-03-06T16:33:16,Portugalete,Basic services,phone,-72.68,58732.11
buyer_7,María,56,ES32209538214206674989,TRX_N-00183-873923929211,2021-03-07T10:02:33,Portugalete,Basic services,water,-46.03,58686.08
buyer_7,María,56,ES32209538214206674989,TRX_N-00184-47631069496,2021-03-07T08:14:52,Portugalete,Basic services,phone,-89.06,58597.02
buyer_7,María,56,ES32209538214206674989,TRX_N-00185-883483559004,2021-03-10T13:39:02,Portugalete,Expense,gifts,-128.03,58468.99
buyer_7,María,56,ES32209538214206674989,TRX_N-00186-453087199332,2021-03-15T03:46:10,Sestao,Expense,transport,-133.64,58335.35
buyer_7,María,56,ES32209538214206674989,TRX_N-00187-278832989742,2021-03-16T19:45:56,Portugalete,Expense,food,-660.56,57674.79
buyer_7,María,56,ES32209538214206674989,TRX_N-00188-922414592810,2021-04-01T18:29:00,Portugalete,transfer,Salary,3020.95,60695.74
buyer_7,María,56,ES32209538214206674989,TRX_N-00189-588390901182,2021-04-01T18:29:00,Portugalete,transfer,Partner Salary,3026.13,63721.87
buyer_7,María,56,ES32209538214206674989,TRX_N-00190-13515142405,2021-04-02T14:26:58,Portugalete,Expense,food,-273.0,63448.87
buyer_7,María,56,ES32209538214206674989,TRX_N-00191-753086607936,2021-04-05T18:53:17,Portugalete,Housing,Mortgage,-1805.98,61642.89
buyer_7,María,56,ES32209538214206674989,TRX_N-00192-717546553424,2021-04-05T02:24:58,Portugalete,Basic services,water,-15.32,61627.57
buyer_7,María,56,ES32209538214206674989,TRX_N-00193-24986209638,2021-04-05T13:27:51,Portugalete,Basic services,gas,-31.05,61596.52
buyer_7,María,56,ES32209538214206674989,TRX_N-00194-424181473520,2021-04-05T20:25:23,Portugalete,Expense,transport,-21.8,61574.72
buyer_7,María,56,ES32209538214206674989,TRX_N-00195-55402581516,2021-04-07T01:22:23,Portugalete,Basic services,gas,-18.95,61555.77
buyer_7,María,56,ES32209538214206674989,TRX_N-00196-296887004188,2021-04-24T17:28:16,Portugalete,Expense,food,-185.1,61370.67
buyer_7,María,56,ES32209538214206674989,TRX_N-00197-240979311648,2021-04-24T13:39:18,Portugalete,Expense,clothing,-370.9,60999.77
buyer_7,María,56,ES32209538214206674989,TRX_N-00198-70137702708,2021-04-27T20:20:42,Portugalete,Expense,transport,-121.94,60877.83
buyer_7,María,56,ES32209538214206674989,TRX_N-00199-409711741295,2021-04-29T14:49:27,Portugalete,Expense,transport,-34.98,60842.85
buyer_7,María,56,ES32209538214206674989,TRX_N-00200-1106733133,2021-05-01T12:52:20,Portugalete,transfer,Salary,3020.95,63863.8
buyer_7,María,56,ES32209538214206674989,TRX_N-00201-743134154434,2021-05-01T12:52:20,Portugalete,transfer,Partner Salary,3026.13,66889.93
buyer_7,María,56,ES32209538214206674989,TRX_N-00202-706527849927,2021-05-01T12:52:20,Portugalete,transfer,Extra Income,302.09,67192.02
buyer_7,María,56,ES32209538214206674989,TRX_N-00203-205523864506,2021-05-05T10:52:35,Portugalete,Housing,Mortgage,-1805.98,65386.04
buyer_7,María,56,ES32209538214206674989,TRX_N-00204-528829069657,2021-05-05T04:29:08,Portugalete,Basic services,electricity,-115.69,65270.35
buyer_7,María,56,ES32209538214206674989,TRX_N-00205-355575376935,2021-05-05T11:21:49,Portugalete,Basic services,gas,-44.58,65225.77
buyer_7,María,56,ES32209538214206674989,TRX_N-00206-211959305132,2021-05-05T15:29:25,Portugalete,Basic services,phone,-63.03,65162.74
buyer_7,María,56,ES32209538214206674989,TRX_N-00207-606021354569,2021-05-06T20:07:32,Portugalete,Basic services,water,-18.25,65144.49
buyer_7,María,56,ES32209538214206674989,TRX_N-00208-305682598611,2021-05-06T15:25:00,Portugalete,Basic services,electricity,-50.99,65093.5
buyer_7,María,56,ES32209538214206674989,TRX_N-00209-531036483599,2021-05-06T18:58:08,Portugalete,Basic services,phone,-49.53,65043.97
buyer_7,María,56,ES32209538214206674989,TRX_N-00210-630443377469,2021-05-07T19:18:32,Portugalete,Basic services,internet,-43.77,65000.2
buyer_7,María,56,ES32209538214206674989,TRX_N-00211-945629679031,2021-05-12T17:36:58,Bilbao,Expense,leisure,-167.11,64833.09
buyer_7,María,56,ES32209538214206674989,TRX_N-00212-328684896457,2021-05-13T03:53:32,Portugalete,Expense,transport,-70.97,64762.12
buyer_7,María,56,ES32209538214206674989,TRX_N-00213-162458570047,2021-05-14T02:36:05,Portugalete,Expense,repairs,-858.43,63903.69
buyer_7,María,56,ES32209538214206674989,TRX_N-00214-532828585464,2021-05-15T04:46:02,Sopela,Expense,food,-325.11,63578.58
buyer_7,María,56,ES32209538214206674989,TRX_N-00215-169536620300,2021-05-19T20:14:37,Bermeo,Expense,transport,-121.09,63457.49
buyer_7,María,56,ES32209538214206674989,TRX_N-00216-577307351812,2021-05-23T20:11:55,Portugalete,Expense,food,-400.36,63057.13
buyer_7,María,56,ES32209538214206674989,TRX_N-00217-154904556049,2021-05-27T11:30:40,Portugalete,Expense,food,-119.86,62937.27
buyer_7,María,56,ES32209538214206674989,TRX_N-00218-973215066422,2021-05-29T19:01:26,Salvatierra/Agurain,Expense,food,-144.24,62793.03
buyer_7,María,56,ES32209538214206674989,TRX_N-00219-635525429000,2021-06-01T08:40:05,Portugalete,transfer,Salary,3020.95,65813.98
buyer_7,María,56,ES32209538214206674989,TRX_N-00220-959336946292,2021-06-01T08:40:05,Portugalete,transfer,Partner Salary,3026.13,68840.11
buyer_7,María,56,ES32209538214206674989,TRX_N-00221-640270007713,2021-06-01T08:40:05,Portugalete,transfer,Bonus,2885.31,71725.42
buyer_7,María,56,ES32209538214206674989,TRX_N-00222-651487831652,2021-06-03T14:24:38,Portugalete,Expense,food,-728.73,70996.69
buyer_7,María,56,ES32209538214206674989,TRX_N-00223-535338205208,2021-06-04T12:41:54,Portugalete,Expense,transport,-136.44,70860.25
buyer_7,María,56,ES32209538214206674989,TRX_N-00224-485969307968,2021-06-05T11:02:22,Portugalete,Housing,Mortgage,-1805.98,69054.27
buyer_7,María,56,ES32209538214206674989,TRX_N-00225-717109568866,2021-06-05T09:48:50,Portugalete,Basic services,water,-15.65,69038.62
buyer_7,María,56,ES32209538214206674989,TRX_N-00226-537938872960,2021-06-05T13:21:09,Portugalete,Basic services,gas,-65.03,68973.59
buyer_7,María,56,ES32209538214206674989,TRX_N-00227-322804097066,2021-06-06T11:46:30,Portugalete,Basic services,gas,-69.06,68904.53
buyer_7,María,56,ES32209538214206674989,TRX_N-00228-536632490822,2021-06-07T12:27:38,Portugalete,Basic services,electricity,-148.4,68756.13
buyer_7,María,56,ES32209538214206674989,TRX_N-00229-739287678447,2021-06-10T01:26:38,Portugalete,Expense,clothing,-450.22,68305.91
buyer_7,María,56,ES32209538214206674989,TRX_N-00230-688946761464,2021-06-16T20:03:18,Portugalete,Expense,healthcare,-274.64,68031.27
buyer_7,María,56,ES32209538214206674989,TRX_N-00231-135616519436,2021-06-19T17:32:59,Portugalete,Expense,healthcare,-218.26,67813.01
buyer_7,María,56,ES32209538214206674989,TRX_N-00232-438713058557,2021-07-01T09:18:38,Portugalete,transfer,Salary,3020.95,70833.96
buyer_7,María,56,ES32209538214206674989,TRX_N-00233-55932386312,2021-07-01T09:18:38,Portugalete,transfer,Partner Salary,3026.13,73860.09
buyer_7,María,56,ES32209538214206674989,TRX_N-00234-448705144477,2021-07-01T08:54:35,Portugalete,Expense,food,-725.36,73134.73
buyer_7,María,56,ES32209538214206674989,TRX_N-00235-398305419904,2021-07-03T14:41:03,Portugalete,Expense,food,-687.53,72447.2
buyer_7,María,56,ES32209538214206674989,TRX_N-00236-903552097256,2021-07-05T09:16:51,Portugalete,Housing,Mortgage,-1805.98,70641.22
buyer_7,María,56,ES32209538214206674989,TRX_N-00237-618020343148,2021-07-05T16:53:53,Portugalete,Basic services,electricity,-105.47,70535.75
buyer_7,María,56,ES32209538214206674989,TRX_N-00238-531196336636,2021-07-06T22:54:39,Portugalete,Basic services,gas,-60.49,70475.26
buyer_7,María,56,ES32209538214206674989,TRX_N-00239-194775376922,2021-07-07T16:48:46,Portugalete,Basic services,electricity,-63.61,70411.65
buyer_7,María,56,ES32209538214206674989,TRX_N-00240-242065990946,2021-07-13T23:28:30,Portugalete,Expense,food,-302.89,70108.76
buyer_7,María,56,ES32209538214206674989,TRX_N-00241-5431488723,2021-07-20T09:41:59,Portugalete,Expense,healthcare,-293.06,69815.7
buyer_7,María,56,ES32209538214206674989,TRX_N-00242-369300734194,2021-07-28T21:38:17,Alegría-Dulantzi,Expense,leisure,-224.87,69590.83
buyer_7,María,56,ES32209538214206674989,TRX_N-00243-183117422450,2021-07-30T10:14:06,Portugalete,Expense,leisure,-162.68,69428.15
buyer_7,María,56,ES32209538214206674989,TRX_N-00244-310858982141,2021-08-01T15:19:22,Portugalete,transfer,Salary,3020.95,72449.1
buyer_7,María,56,ES32209538214206674989,TRX_N-00245-713400777064,2021-08-01T15:19:22,Portugalete,transfer,Partner Salary,3026.13,75475.23
buyer_7,María,56,ES32209538214206674989,TRX_N-00246-808237847934,2021-08-01T15:19:22,Portugalete,transfer,Extra Income,302.09,75777.32
buyer_7,María,56,ES32209538214206674989,TRX_N-00247-203362437444,2021-08-01T17:52:22,Santurtzi,Expense,transport,-126.54,75650.78
buyer_7,María,56,ES32209538214206674989,TRX_N-00248-768486347936,2021-08-05T22:29:35,Portugalete,Housing,Mortgage,-1805.98,73844.8
buyer_7,María,56,ES32209538214206674989,TRX_N-00249-597545379564,2021-08-05T06:01:49,Portugalete,Basic services,water,-44.49,73800.31
buyer_7,María,56,ES32209538214206674989,TRX_N-00250-264011250588,2021-08-05T01:47:34,Portugalete,Basic services,electricity,-48.82,73751.49
buyer_7,María,56,ES32209538214206674989,TRX_N-00251-670185197259,2021-08-06T16:23:46,Portugalete,Basic services,phone,-85.69,73665.8
buyer_7,María,56,ES32209538214206674989,TRX_N-00252-800187181152,2021-08-06T03:08:52,Portugalete,Expense,leisure,-20.11,73645.69
buyer_7,María,56,ES32209538214206674989,TRX_N-00253-252270974385,2021-08-07T11:32:43,Portugalete,Basic services,electricity,-53.04,73592.65
buyer_7,María,56,ES32209538214206674989,TRX_N-00254-787645280934,2021-08-07T05:00:32,Portugalete,Basic services,phone,-89.55,73503.1
buyer_7,María,56,ES32209538214206674989,TRX_N-00255-831359995199,2021-08-14T16:38:49,Portugalete,Expense,food,-612.51,72890.59
buyer_7,María,56,ES32209538214206674989,TRX_N-00256-900154204149,2021-09-01T19:45:19,Portugalete,transfer,Salary,3020.95,75911.54
buyer_7,María,56,ES32209538214206674989,TRX_N-00257-952892289771,2021-09-01T19:45:19,Portugalete,transfer,Partner Salary,3026.13,78937.67
buyer_7,María,56,ES32209538214206674989,TRX_N-00258-361053745507,2021-09-03T13:11:22,Portugalete,Expense,leisure,-15.73,78921.94
buyer_7,María,56,ES32209538214206674989,TRX_N-00259-322437954530,2021-09-05T08:19:29,Portugalete,Housing,Mortgage,-1805.98,77115.96
buyer_7,María,56,ES32209538214206674989,TRX_N-00260-774379094515,2021-09-06T12:14:55,Portugalete,Basic services,internet,-52.33,77063.63
buyer_7,María,56,ES32209538214206674989,TRX_N-00261-374092942490,2021-09-07T21:55:10,Portugalete,Basic services,water,-38.46,77025.17
buyer_7,María,56,ES32209538214206674989,TRX_N-00262-422853773116,2021-09-07T20:08:45,Portugalete,Basic services,electricity,-57.0,76968.17
buyer_7,María,56,ES32209538214206674989,TRX_N-00263-981661033186,2021-09-07T05:32:07,Portugalete,Basic services,phone,-67.49,76900.68
buyer_7,María,56,ES32209538214206674989,TRX_N-00264-45564142072,2021-09-10T12:11:08,Hondarribia,Expense,food,-233.15,76667.53
buyer_7,María,56,ES32209538214206674989,TRX_N-00265-409686241487,2021-09-14T14:27:32,Portugalete,Expense,transport,-74.13,76593.4
buyer_7,María,56,ES32209538214206674989,TRX_N-00266-504585688926,2021-10-01T12:01:16,Portugalete,transfer,Salary,3020.95,79614.35
buyer_7,María,56,ES32209538214206674989,TRX_N-00267-557989148706,2021-10-01T12:01:16,Portugalete,transfer,Partner Salary,3026.13,82640.48
buyer_7,María,56,ES32209538214206674989,TRX_N-00268-158357277848,2021-10-05T22:33:55,Portugalete,Housing,Mortgage,-1805.98,80834.5
buyer_7,María,56,ES32209538214206674989,TRX_N-00269-720311107571,2021-10-05T11:20:27,Portugalete,Basic services,electricity,-147.31,80687.19
buyer_7,María,56,ES32209538214206674989,TRX_N-00270-311069564328,2021-10-05T14:58:22,Portugalete,Basic services,internet,-45.67,80641.52
buyer_7,María,56,ES32209538214206674989,TRX_N-00271-110780600717,2021-10-05T10:06:25,Portugalete,Basic services,phone,-46.93,80594.59
buyer_7,María,56,ES32209538214206674989,TRX_N-00272-401951251,2021-10-06T19:16:04,Portugalete,Basic services,electricity,-86.43,80508.16
buyer_7,María,56,ES32209538214206674989,TRX_N-00273-959930972393,2021-10-06T10:32:54,Portugalete,Basic services,internet,-34.68,80473.48
buyer_7,María,56,ES32209538214206674989,TRX_N-00274-893612842246,2021-10-07T17:51:30,Portugalete,Basic services,water,-69.77,80403.71
buyer_7,María,56,ES32209538214206674989,TRX_N-00275-650322699172,2021-10-07T19:39:26,Portugalete,Basic services,gas,-88.91,80314.8
buyer_7,María,56,ES32209538214206674989,TRX_N-00276-152860638190,2021-10-09T23:52:49,Portugalete,Expense,clothing,-452.65,79862.15
buyer_7,María,56,ES32209538214206674989,TRX_N-00277-592941580907,2021-10-18T19:48:32,Portugalete,Expense,healthcare,-192.45,79669.7
buyer_7,María,56,ES32209538214206674989,TRX_N-00278-935065041266,2021-10-21T20:32:20,Portugalete,Expense,leisure,-34.72,79634.98
buyer_7,María,56,ES32209538214206674989,TRX_N-00279-835507685595,2021-10-28T20:54:42,Portugalete,Expense,transport,-115.73,79519.25
buyer_7,María,56,ES32209538214206674989,TRX_N-00280-351583727876,2021-10-30T11:30:39,Portugalete,Expense,gifts,-107.49,79411.76
buyer_7,María,56,ES32209538214206674989,TRX_N-00281-380642572569,2021-11-01T11:33:18,Portugalete,transfer,Salary,3020.95,82432.71
buyer_7,María,56,ES32209538214206674989,TRX_N-00282-362469427925,2021-11-01T11:33:18,Portugalete,transfer,Partner Salary,3026.13,85458.84
buyer_7,María,56,ES32209538214206674989,TRX_N-00283-966514853484,2021-11-01T11:33:18,Portugalete,transfer,Extra Income,302.09,85760.93
buyer_7,María,56,ES32209538214206674989,TRX_N-00284-116672077052,2021-11-04T09:38:26,Portugalete,Expense,travel,-2692.89,83068.04
buyer_7,María,56,ES32209538214206674989,TRX_N-00285-211859862459,2021-11-05T13:04:27,Portugalete,Housing,Mortgage,-1805.98,81262.06
buyer_7,María,56,ES32209538214206674989,TRX_N-00286-993467810908,2021-11-05T11:38:14,Portugalete,Basic services,electricity,-38.04,81224.02
buyer_7,María,56,ES32209538214206674989,TRX_N-00287-664258767365,2021-11-06T19:36:57,Portugalete,Basic services,internet,-40.76,81183.26
buyer_7,María,56,ES32209538214206674989,TRX_N-00288-348071964005,2021-11-24T11:44:04,Portugalete,Expense,food,-327.33,80855.93
buyer_7,María,56,ES32209538214206674989,TRX_N-00289-20576409294,2021-11-24T14:26:00,Eibar,Expense,transport,-69.54,80786.39
buyer_7,María,56,ES32209538214206674989,TRX_N-00290-372763689847,2021-11-25T08:29:49,Portugalete,Expense,leisure,-276.67,80509.72
buyer_7,María,56,ES32209538214206674989,TRX_N-00291-268105216838,2021-11-25T09:30:53,Portugalete,Expense,clothing,-263.56,80246.16
buyer_7,María,56,ES32209538214206674989,TRX_N-00292-421169939061,2021-12-01T15:53:42,Portugalete,transfer,Salary,3020.95,83267.11
buyer_7,María,56,ES32209538214206674989,TRX_N-00293-475274325500,2021-12-01T15:53:42,Portugalete,transfer,Partner Salary,3026.13,86293.24
buyer_7,María,56,ES32209538214206674989,TRX_N-00294-88322386816,2021-12-01T15:53:42,Portugalete,transfer,Bonus,3154.78,89448.02
buyer_7,María,56,ES32209538214206674989,TRX_N-00295-666608434389,2021-12-05T19:17:02,Portugalete,Housing,Mortgage,-1805.98,87642.04
buyer_7,María,56,ES32209538214206674989,TRX_N-00296-935564406792,2021-12-05T09:14:31,Portugalete,Basic services,gas,-77.0,87565.04
buyer_7,María,56,ES32209538214206674989,TRX_N-00297-621400396328,2021-12-06T14:28:26,Portugalete,Basic services,water,-53.7,87511.34
buyer_7,María,56,ES32209538214206674989,TRX_N-00298-568681054967,2021-12-06T11:09:13,Portugalete,Basic services,internet,-66.92,87444.42
buyer_7,María,56,ES32209538214206674989,TRX_N-00299-34441189559,2021-12-06T14:27:38,Portugalete,Basic services,phone,-82.83,87361.59
buyer_7,María,56,ES32209538214206674989,TRX_N-00300-928600638512,2021-12-07T13:57:01,Portugalete,Basic services,internet,-58.21,87303.38
buyer_7,María,56,ES32209538214206674989,TRX_N-00301-497780280413,2021-12-07T12:59:36,Portugalete,Basic services,phone,-66.82,87236.56
buyer_7,María,56,ES32209538214206674989,TRX_N-00302-350854832846,2021-12-16T16:38:23,Portugalete,Expense,healthcare,-213.45,87023.11
buyer_7,María,56,ES32209538214206674989,TRX_N-00303-740653766987,2021-12-25T13:48:48,Portugalete,Expense,healthcare,-313.62,86709.49
buyer_7,María,56,ES32209538214206674989,TRX_N-00304-340203292147,2022-01-01T08:17:30,Portugalete,transfer,Salary,3020.95,89730.44
buyer_7,María,56,ES32209538214206674989,TRX_N-00305-454635490882,2022-01-01T08:17:30,Portugalete,transfer,Partner Salary,3026.13,92756.57
buyer_7,María,56,ES32209538214206674989,TRX_N-00306-119883587359,2022-01-01T08:17:30,Portugalete,transfer,Extra Income,302.09,93058.66
buyer_7,María,56,ES32209538214206674989,TRX_N-00307-409972388824,2022-01-02T22:34:16,Portugalete,Expense,travel,-2237.47,90821.19
buyer_7,María,56,ES32209538214206674989,TRX_N-00308-499122228853,2022-01-05T07:52:02,Portugalete,Housing,Mortgage,-1805.98,89015.21
buyer_7,María,56,ES32209538214206674989,TRX_N-00309-664765522378,2022-01-05T20:47:32,Portugalete,Basic services,electricity,-51.21,88964.0
buyer_7,María,56,ES32209538214206674989,TRX_N-00310-339799816115,2022-01-06T18:02:22,Portugalete,Basic services,phone,-44.62,88919.38
buyer_7,María,56,ES32209538214206674989,TRX_N-00311-165916043448,2022-01-07T05:00:48,Portugalete,Basic services,water,-61.21,88858.17
buyer_7,María,56,ES32209538214206674989,TRX_N-00312-200064539083,2022-01-07T00:21:47,Portugalete,Basic services,electricity,-61.25,88796.92
buyer_7,María,56,ES32209538214206674989,TRX_N-00313-829462391287,2022-01-07T21:20:17,Portugalete,Basic services,gas,-41.33,88755.59
buyer_7,María,56,ES32209538214206674989,TRX_N-00314-23429832408,2022-01-07T08:46:34,Portugalete,Basic services,internet,-76.04,88679.55
buyer_7,María,56,ES32209538214206674989,TRX_N-00315-996704812572,2022-01-14T18:59:32,Portugalete,Expense,healthcare,-381.58,88297.97
buyer_7,María,56,ES32209538214206674989,TRX_N-00316-293359456461,2022-01-28T18:42:15,Portugalete,Expense,education,-610.26,87687.71
buyer_7,María,56,ES32209538214206674989,TRX_N-00317-447404231604,2022-01-30T15:05:27,Portugalete,Expense,food,-703.74,86983.97
buyer_7,María,56,ES32209538214206674989,TRX_N-00318-592465595473,2022-01-30T16:40:43,Portugalete,Expense,clothing,-96.26,86887.71
buyer_7,María,56,ES32209538214206674989,TRX_N-00319-608162218819,2022-02-01T09:55:11,Portugalete,transfer,Salary,3020.95,89908.66
buyer_7,María,56,ES32209538214206674989,TRX_N-00320-840862540306,2022-02-01T09:55:11,Portugalete,transfer,Partner Salary,3026.13,92934.79
buyer_7,María,56,ES32209538214206674989,TRX_N-00321-797985822208,2022-02-05T20:01:33,Portugalete,Housing,Mortgage,-1805.98,91128.81
buyer_7,María,56,ES32209538214206674989,TRX_N-00322-384904739720,2022-02-05T12:50:53,Portugalete,Basic services,electricity,-144.09,90984.72
buyer_7,María,56,ES32209538214206674989,TRX_N-00323-551980102606,2022-02-06T16:02:09,Portugalete,Basic services,electricity,-136.78,90847.94
buyer_7,María,56,ES32209538214206674989,TRX_N-00324-571529951948,2022-02-06T14:30:59,Portugalete,Basic services,gas,-50.81,90797.13
buyer_7,María,56,ES32209538214206674989,TRX_N-00325-457970737706,2022-02-06T19:48:20,Portugalete,Basic services,phone,-89.83,90707.3
buyer_7,María,56,ES32209538214206674989,TRX_N-00326-274394746796,2022-02-07T10:03:15,Portugalete,Basic services,water,-61.0,90646.3
buyer_7,María,56,ES32209538214206674989,TRX_N-00327-313526968899,2022-02-07T13:51:46,Portugalete,Basic services,gas,-66.21,90580.09
buyer_7,María,56,ES32209538214206674989,TRX_N-00328-934013804035,2022-02-07T16:54:40,Portugalete,Basic services,phone,-71.44,90508.65
buyer_7,María,56,ES32209538214206674989,TRX_N-00329-402826107568,2022-02-15T14:52:02,Lasarte-Oria,Expense,food,-622.3,89886.35
buyer_7,María,56,ES32209538214206674989,TRX_N-00330-788402355387,2022-02-22T12:59:19,Portugalete,Expense,clothing,-170.98,89715.37
buyer_7,María,56,ES32209538214206674989,TRX_N-00331-750267474066,2022-03-01T14:34:32,Portugalete,transfer,Salary,3020.95,92736.32
buyer_7,María,56,ES32209538214206674989,TRX_N-00332-310343550575,2022-03-01T14:34:32,Portugalete,transfer,Partner Salary,3026.13,95762.45
buyer_7,María,56,ES32209538214206674989,TRX_N-00333-856322885340,2022-03-01T14:34:32,Portugalete,transfer,Extra Income,302.09,96064.54
buyer_7,María,56,ES32209538214206674989,TRX_N-00334-43541944606,2022-03-03T11:17:14,Portugalete,Expense,leisure,-198.02,95866.52
buyer_7,María,56,ES32209538214206674989,TRX_N-00335-705633928211,2022-03-03T16:41:42,Portugalete,Expense,clothing,-408.99,95457.53
buyer_7,María,56,ES32209538214206674989,TRX_N-00336-659246732441,2022-03-05T03:48:24,Portugalete,Housing,Mortgage,-1805.98,93651.55
buyer_7,María,56,ES32209538214206674989,TRX_N-00337-130967403096,2022-03-06T17:17:47,Portugalete,Expense,education,-652.31,92999.24
buyer_7,María,56,ES32209538214206674989,TRX_N-00338-957554812384,2022-03-07T09:30:06,Portugalete,Basic services,water,-42.98,92956.26
buyer_7,María,56,ES32209538214206674989,TRX_N-00339-309514883589,2022-03-07T09:49:29,Portugalete,Basic services,electricity,-26.45,92929.81
buyer_7,María,56,ES32209538214206674989,TRX_N-00340-198698900410,2022-03-07T19:19:46,Portugalete,Basic services,gas,-29.46,92900.35
buyer_7,María,56,ES32209538214206674989,TRX_N-00341-612977967201,2022-03-07T13:27:22,Portugalete,Basic services,internet,-32.13,92868.22
buyer_7,María,56,ES32209538214206674989,TRX_N-00342-669098440877,2022-03-07T08:04:44,Portugalete,Basic services,phone,-74.6,92793.62
buyer_7,María,56,ES32209538214206674989,TRX_N-00343-198329244737,2022-03-13T14:28:30,Portugalete,Expense,food,-386.6,92407.02
buyer_7,María,56,ES32209538214206674989,TRX_N-00344-990831109474,2022-03-20T06:18:15,Portugalete,Expense,transport,-141.98,92265.04
buyer_7,María,56,ES32209538214206674989,TRX_N-00345-521320021716,2022-03-23T19:01:14,Portugalete,Expense,clothing,-447.51,91817.53
buyer_7,María,56,ES32209538214206674989,TRX_N-00346-458557918047,2022-04-01T12:41:25,Portugalete,transfer,Salary,3020.95,94838.48
buyer_7,María,56,ES32209538214206674989,TRX_N-00347-708920136098,2022-04-01T12:41:25,Portugalete,transfer,Partner Salary,3026.13,97864.61
buyer_7,María,56,ES32209538214206674989,TRX_N-00348-174307801624,2022-04-05T19:54:17,Portugalete,Housing,Mortgage,-1805.98,96058.63
buyer_7,María,56,ES32209538214206674989,TRX_N-00349-169600203640,2022-04-05T21:20:33,Portugalete,Basic services,water,-30.73,96027.9
buyer_7,María,56,ES32209538214206674989,TRX_N-00350-474418681500,2022-04-05T00:00:19,Portugalete,Basic services,phone,-45.77,95982.13
buyer_7,María,56,ES32209538214206674989,TRX_N-00351-570943951823,2022-04-06T20:35:44,Portugalete,Basic services,water,-60.81,95921.32
buyer_7,María,56,ES32209538214206674989,TRX_N-00352-497004576941,2022-04-06T19:20:39,Portugalete,Basic services,electricity,-58.35,95862.97
buyer_7,María,56,ES32209538214206674989,TRX_N-00353-671032245305,2022-04-07T10:50:54,Portugalete,Basic services,internet,-48.96,95814.01
buyer_7,María,56,ES32209538214206674989,TRX_N-00354-735544148069,2022-04-07T22:51:07,Portugalete,Basic services,phone,-96.18,95717.83
buyer_7,María,56,ES32209538214206674989,TRX_N-00355-598057793978,2022-04-11T20:07:36,Portugalete,Expense,leisure,-122.99,95594.84
buyer_7,María,56,ES32209538214206674989,TRX_N-00356-795496582393,2022-04-18T21:23:26,Erandio,Expense,food,-262.12,95332.72
buyer_7,María,56,ES32209538214206674989,TRX_N-00357-213883988271,2022-04-19T20:06:33,Portugalete,Expense,transport,-26.8,95305.92
buyer_7,María,56,ES32209538214206674989,TRX_N-00358-586662847176,2022-05-01T16:37:43,Portugalete,transfer,Salary,3020.95,98326.87
buyer_7,María,56,ES32209538214206674989,TRX_N-00359-995717666263,2022-05-01T16:37:43,Portugalete,transfer,Partner Salary,3026.13,101353.0
buyer_7,María,56,ES32209538214206674989,TRX_N-00360-105683254901,2022-05-01T16:37:43,Portugalete,transfer,Extra Income,302.09,101655.09
buyer_7,María,56,ES32209538214206674989,TRX_N-00361-351488302926,2022-05-05T16:36:29,Portugalete,Housing,Mortgage,-1805.98,99849.11
buyer_7,María,56,ES32209538214206674989,TRX_N-00362-432151878606,2022-05-05T08:29:00,Portugalete,Basic services,electricity,-35.67,99813.44
buyer_7,María,56,ES32209538214206674989,TRX_N-00363-481478995880,2022-05-05T19:33:15,Portugalete,Basic services,phone,-46.92,99766.52
buyer_7,María,56,ES32209538214206674989,TRX_N-00364-179098333900,2022-05-06T19:32:27,Portugalete,Basic services,electricity,-107.38,99659.14
buyer_7,María,56,ES32209538214206674989,TRX_N-00365-831609073944,2022-05-11T19:05:13,Portugalete,Expense,food,-682.4,98976.74
buyer_7,María,56,ES32209538214206674989,TRX_N-00366-623230698609,2022-05-14T09:20:33,Portugalete,Expense,education,-484.48,98492.26
buyer_7,María,56,ES32209538214206674989,TRX_N-00367-375272255148,2022-05-21T21:14:59,Portugalete,Expense,travel,-259.73,98232.53
buyer_7,María,56,ES32209538214206674989,TRX_N-00368-417958841295,2022-05-28T11:26:44,Portugalete,Expense,clothing,-343.58,97888.95
buyer_7,María,56,ES32209538214206674989,TRX_N-00369-180697625473,2022-06-01T01:14:26,Portugalete,transfer,Salary,3020.95,100909.9
buyer_7,María,56,ES32209538214206674989,TRX_N-00370-704313623093,2022-06-01T01:14:26,Portugalete,transfer,Partner Salary,3026.13,103936.03
buyer_7,María,56,ES32209538214206674989,TRX_N-00371-811429458048,2022-06-01T01:14:26,Portugalete,transfer,Bonus,2719.53,106655.56
buyer_7,María,56,ES32209538214206674989,TRX_N-00372-266458359501,2022-06-05T15:17:32,Portugalete,Housing,Mortgage,-1805.98,104849.58
buyer_7,María,56,ES32209538214206674989,TRX_N-00373-955146312355,2022-06-05T15:06:22,Portugalete,Basic services,water,-43.69,104805.89
buyer_7,María,56,ES32209538214206674989,TRX_N-00374-778213142498,2022-06-05T20:56:25,Portugalete,Basic services,phone,-23.63,104782.26
buyer_7,María,56,ES32209538214206674989,TRX_N-00375-92072482899,2022-06-05T11:27:42,Santurtzi,Expense,food,-522.72,104259.54
buyer_7,María,56,ES32209538214206674989,TRX_N-00376-320385697843,2022-06-06T21:25:19,Portugalete,Basic services,water,-31.67,104227.87
buyer_7,María,56,ES32209538214206674989,TRX_N-00377-602436797515,2022-06-06T19:21:57,Portugalete,Basic services,internet,-39.06,104188.81
buyer_7,María,56,ES32209538214206674989,TRX_N-00378-699271550652,2022-06-12T14:48:57,Portugalete,Expense,transport,-119.47,104069.34
buyer_7,María,56,ES32209538214206674989,TRX_N-00379-228838641978,2022-06-18T14:28:31,Portugalete,Expense,gifts,-443.21,103626.13
buyer_7,María,56,ES32209538214206674989,TRX_N-00380-899879553668,2022-07-01T14:27:59,Portugalete,transfer,Salary,3020.95,106647.08
buyer_7,María,56,ES32209538214206674989,TRX_N-00381-213585219780,2022-07-01T14:27:59,Portugalete,transfer,Partner Salary,3026.13,109673.21
buyer_7,María,56,ES32209538214206674989,TRX_N-00382-986242778892,2022-07-04T10:12:09,Portugalete,Expense,leisure,-143.16,109530.05
buyer_7,María,56,ES32209538214206674989,TRX_N-00383-54168400652,2022-07-05T14:39:52,Portugalete,Housing,Mortgage,-1805.98,107724.07
buyer_7,María,56,ES32209538214206674989,TRX_N-00384-572129675753,2022-07-05T09:26:21,Portugalete,Basic services,electricity,-41.86,107682.21
buyer_7,María,56,ES32209538214206674989,TRX_N-00385-939176313677,2022-07-05T04:07:27,Portugalete,Basic services,gas,-51.35,107630.86
buyer_7,María,56,ES32209538214206674989,TRX_N-00386-967482492753,2022-07-05T23:35:28,Portugalete,Basic services,internet,-64.54,107566.32
buyer_7,María,56,ES32209538214206674989,TRX_N-00387-66479142362,2022-07-05T16:13:25,Portugalete,Basic services,phone,-90.48,107475.84
buyer_7,María,56,ES32209538214206674989,TRX_N-00388-778706945751,2022-07-06T17:00:29,Portugalete,Basic services,water,-66.04,107409.8
buyer_7,María,56,ES32209538214206674989,TRX_N-00389-14230885187,2022-07-06T11:23:04,Portugalete,Basic services,electricity,-39.68,107370.12
buyer_7,María,56,ES32209538214206674989,TRX_N-00390-965883747089,2022-07-06T18:11:46,Portugalete,Basic services,internet,-30.75,107339.37
buyer_7,María,56,ES32209538214206674989,TRX_N-00391-806822398753,2022-07-07T09:07:53,Portugalete,Basic services,water,-36.73,107302.64
buyer_7,María,56,ES32209538214206674989,TRX_N-00392-39875242981,2022-07-07T19:20:41,Portugalete,Basic services,phone,-79.79,107222.85
buyer_7,María,56,ES32209538214206674989,TRX_N-00393-195257218674,2022-07-13T20:52:44,Portugalete,Expense,food,-753.96,106468.89
buyer_7,María,56,ES32209538214206674989,TRX_N-00394-351353693830,2022-07-15T17:09:37,Galdakao,Expense,transport,-182.16,106286.73
buyer_7,María,56,ES32209538214206674989,TRX_N-00395-970834224190,2022-07-16T11:57:44,Portugalete,Expense,healthcare,-81.6,106205.13
buyer_7,María,56,ES32209538214206674989,TRX_N-00396-809103032971,2022-07-22T08:27:36,Portugalete,Expense,leisure,-272.41,105932.72
buyer_7,María,56,ES32209538214206674989,TRX_N-00397-586504609632,2022-07-27T08:37:06,Portugalete,Expense,transport,-141.52,105791.2
buyer_7,María,56,ES32209538214206674989,TRX_N-00398-5907841564,2022-07-28T20:40:54,Portugalete,Expense,transport,-118.48,105672.72
buyer_7,María,56,ES32209538214206674989,TRX_N-00399-60538738273,2022-07-29T13:26:32,Portugalete,Expense,leisure,-140.05,105532.67
buyer_7,María,56,ES32209538214206674989,TRX_N-00400-5346676398,2022-08-01T11:20:02,Portugalete,transfer,Salary,3020.95,108553.62
buyer_7,María,56,ES32209538214206674989,TRX_N-00401-53858046588,2022-08-01T11:20:02,Portugalete,transfer,Partner Salary,3026.13,111579.75
buyer_7,María,56,ES32209538214206674989,TRX_N-00402-242530524880,2022-08-01T11:20:02,Portugalete,transfer,Extra Income,302.09,111881.84
buyer_7,María,56,ES32209538214206674989,TRX_N-00403-649932494795,2022-08-01T19:41:48,Portugalete,Expense,healthcare,-354.41,111527.43
buyer_7,María,56,ES32209538214206674989,TRX_N-00404-445131266096,2022-08-04T19:49:50,Portugalete,Expense,food,-260.11,111267.32
buyer_7,María,56,ES32209538214206674989,TRX_N-00405-703914316252,2022-08-05T18:12:34,Portugalete,Housing,Mortgage,-1805.98,109461.34
buyer_7,María,56,ES32209538214206674989,TRX_N-00406-784661242795,2022-08-05T18:55:45,Portugalete,Basic services,water,-77.55,109383.79
buyer_7,María,56,ES32209538214206674989,TRX_N-00407-728148657079,2022-08-05T09:14:36,Portugalete,Basic services,electricity,-111.88,109271.91
buyer_7,María,56,ES32209538214206674989,TRX_N-00408-730908692908,2022-08-06T16:43:11,Portugalete,Basic services,phone,-60.02,109211.89
buyer_7,María,56,ES32209538214206674989,TRX_N-00409-716059286982,2022-08-07T11:42:44,Portugalete,Basic services,water,-21.21,109190.68
buyer_7,María,56,ES32209538214206674989,TRX_N-00410-803365080612,2022-08-07T10:36:25,Portugalete,Basic services,phone,-87.38,109103.3
buyer_7,María,56,ES32209538214206674989,TRX_N-00411-205325274400,2022-08-15T09:47:07,Portugalete,Expense,clothing,-222.62,108880.68
buyer_7,María,56,ES32209538214206674989,TRX_N-00412-400580518743,2022-08-16T08:30:19,Labastida/Bastida,Expense,clothing,-195.72,108684.96
buyer_7,María,56,ES32209538214206674989,TRX_N-00413-423981392258,2022-08-24T07:03:46,Getxo,Expense,healthcare,-311.43,108373.53
buyer_7,María,56,ES32209538214206674989,TRX_N-00414-931753931469,2022-08-27T18:07:15,Portugalete,Expense,leisure,-245.59,108127.94
buyer_7,María,56,ES32209538214206674989,TRX_N-00415-238094437727,2022-08-28T10:28:14,Portugalete,Expense,leisure,-120.2,108007.74
buyer_7,María,56,ES32209538214206674989,TRX_N-00416-903256880111,2022-09-01T12:01:35,Portugalete,transfer,Salary,3020.95,111028.69
buyer_7,María,56,ES32209538214206674989,TRX_N-00417-873702162908,2022-09-01T12:01:35,Portugalete,transfer,Partner Salary,3026.13,114054.82
buyer_7,María,56,ES32209538214206674989,TRX_N-00418-263783355083,2022-09-02T03:19:45,Portugalete,Expense,leisure,-69.85,113984.97
buyer_7,María,56,ES32209538214206674989,TRX_N-00419-838646705033,2022-09-04T06:12:25,Portugalete,Expense,food,-366.45,113618.52
buyer_7,María,56,ES32209538214206674989,TRX_N-00420-796238644933,2022-09-05T01:53:36,Portugalete,Housing,Mortgage,-1805.98,111812.54
buyer_7,María,56,ES32209538214206674989,TRX_N-00421-133933046842,2022-09-05T16:38:18,Portugalete,Basic services,internet,-76.4,111736.14
buyer_7,María,56,ES32209538214206674989,TRX_N-00422-385770409683,2022-09-05T08:18:38,Portugalete,Basic services,phone,-33.44,111702.7
buyer_7,María,56,ES32209538214206674989,TRX_N-00423-204580184367,2022-09-05T17:46:36,Portugalete,Expense,transport,-50.6,111652.1
buyer_7,María,56,ES32209538214206674989,TRX_N-00424-657863811764,2022-09-06T12:51:50,Portugalete,Basic services,water,-10.56,111641.54
buyer_7,María,56,ES32209538214206674989,TRX_N-00425-685120456307,2022-09-06T10:41:02,Portugalete,Basic services,phone,-65.1,111576.44
buyer_7,María,56,ES32209538214206674989,TRX_N-00426-902381016979,2022-09-07T10:25:27,Portugalete,Basic services,water,-60.66,111515.78
buyer_7,María,56,ES32209538214206674989,TRX_N-00427-738369346758,2022-09-07T18:03:44,Portugalete,Basic services,electricity,-136.91,111378.87
buyer_7,María,56,ES32209538214206674989,TRX_N-00428-480332231062,2022-09-07T08:46:51,Portugalete,Basic services,phone,-38.47,111340.4
buyer_7,María,56,ES32209538214206674989,TRX_N-00429-110253158286,2022-09-07T17:41:01,Portugalete,Expense,education,-126.33,111214.07
buyer_7,María,56,ES32209538214206674989,TRX_N-00430-437858083372,2022-09-08T15:16:56,Portugalete,Expense,transport,-199.82,111014.25
buyer_7,María,56,ES32209538214206674989,TRX_N-00431-694055033321,2022-09-13T18:17:33,Portugalete,Expense,transport,-167.22,110847.03
buyer_7,María,56,ES32209538214206674989,TRX_N-00432-700728857683,2022-09-19T20:47:52,Portugalete,Expense,leisure,-138.52,110708.51
buyer_7,María,56,ES32209538214206674989,TRX_N-00433-502806531173,2022-09-27T16:33:02,Portugalete,Expense,leisure,-40.41,110668.1
buyer_7,María,56,ES32209538214206674989,TRX_N-00434-801683584015,2022-09-28T10:07:00,Portugalete,Expense,food,-737.33,109930.77
buyer_7,María,56,ES32209538214206674989,TRX_N-00435-825754937911,2022-09-28T09:51:41,Portugalete,Expense,transport,-145.14,109785.63
buyer_7,María,56,ES32209538214206674989,TRX_N-00436-333941850145,2022-09-29T17:56:14,Lasarte-Oria,Expense,healthcare,-201.34,109584.29
buyer_7,María,56,ES32209538214206674989,TRX_N-00437-669762237220,2022-10-01T13:44:38,Portugalete,transfer,Salary,3020.95,112605.24
buyer_7,María,56,ES32209538214206674989,TRX_N-00438-871690681678,2022-10-01T13:44:38,Portugalete,transfer,Partner Salary,3026.13,115631.37
buyer_7,María,56,ES32209538214206674989,TRX_N-00439-384264793713,2022-10-05T10:43:30,Portugalete,Housing,Mortgage,-1805.98,113825.39
buyer_7,María,56,ES32209538214206674989,TRX_N-00440-17505481773,2022-10-05T12:52:55,Portugalete,Basic services,internet,-77.27,113748.12
buyer_7,María,56,ES32209538214206674989,TRX_N-00441-818520717320,2022-10-06T09:00:46,Portugalete,Basic services,water,-64.26,113683.86
buyer_7,María,56,ES32209538214206674989,TRX_N-00442-316504951213,2022-10-06T01:25:25,Portugalete,Basic services,electricity,-115.8,113568.06
buyer_7,María,56,ES32209538214206674989,TRX_N-00443-325724636235,2022-10-07T00:07:07,Portugalete,Basic services,water,-62.47,113505.59
buyer_7,María,56,ES32209538214206674989,TRX_N-00444-287395780981,2022-10-07T13:27:31,Portugalete,Basic services,electricity,-101.73,113403.86
buyer_7,María,56,ES32209538214206674989,TRX_N-00445-435540739216,2022-10-22T12:55:57,Portugalete,Expense,travel,-1183.18,112220.68
buyer_7,María,56,ES32209538214206674989,TRX_N-00446-439057573393,2022-10-31T10:36:20,Portugalete,Expense,transport,-174.33,112046.35
buyer_7,María,56,ES32209538214206674989,TRX_N-00447-425156813879,2022-11-01T14:43:58,Portugalete,transfer,Salary,3020.95,115067.3
buyer_7,María,56,ES32209538214206674989,TRX_N-00448-959397448404,2022-11-01T14:43:58,Portugalete,transfer,Partner Salary,3026.13,118093.43
buyer_7,María,56,ES32209538214206674989,TRX_N-00449-873069886397,2022-11-01T14:43:58,Portugalete,transfer,Extra Income,302.09,118395.52
buyer_7,María,56,ES32209538214206674989,TRX_N-00450-389729257071,2022-11-02T19:16:37,Portugalete,Expense,transport,-182.18,118213.34
buyer_7,María,56,ES32209538214206674989,TRX_N-00451-436185829638,2022-11-02T13:52:12,Portugalete,Expense,healthcare,-75.69,118137.65
buyer_7,María,56,ES32209538214206674989,TRX_N-00452-641020915810,2022-11-05T18:48:29,Portugalete,Housing,Mortgage,-1805.98,116331.67
buyer_7,María,56,ES32209538214206674989,TRX_N-00453-860975327113,2022-11-05T13:02:03,Portugalete,Basic services,water,-50.36,116281.31
buyer_7,María,56,ES32209538214206674989,TRX_N-00454-667678276359,2022-11-06T08:28:54,Portugalete,Basic services,electricity,-64.22,116217.09
buyer_7,María,56,ES32209538214206674989,TRX_N-00455-967723344985,2022-11-06T12:20:05,Portugalete,Basic services,gas,-47.63,116169.46
buyer_7,María,56,ES32209538214206674989,TRX_N-00456-139527630165,2022-11-06T08:17:34,Portugalete,Expense,gifts,-386.48,115782.98
buyer_7,María,56,ES32209538214206674989,TRX_N-00457-453439511373,2022-11-07T16:53:57,Portugalete,Basic services,gas,-61.39,115721.59
buyer_7,María,56,ES32209538214206674989,TRX_N-00458-744096435562,2022-11-07T09:25:56,Portugalete,Basic services,phone,-56.0,115665.59
buyer_7,María,56,ES32209538214206674989,TRX_N-00459-112181157099,2022-11-07T09:31:45,Portugalete,Expense,transport,-197.21,115468.38
buyer_7,María,56,ES32209538214206674989,TRX_N-00460-479275713111,2022-11-10T10:38:21,Amurrio,Expense,transport,-198.61,115269.77
buyer_7,María,56,ES32209538214206674989,TRX_N-00461-269770490688,2022-11-11T14:58:53,Zarautz,Expense,healthcare,-61.95,115207.82
buyer_7,María,56,ES32209538214206674989,TRX_N-00462-733301376120,2022-11-13T17:26:45,Pasaia,Expense,transport,-57.0,115150.82
buyer_7,María,56,ES32209538214206674989,TRX_N-00463-160372537522,2022-12-01T16:06:24,Portugalete,transfer,Salary,3020.95,118171.77
buyer_7,María,56,ES32209538214206674989,TRX_N-00464-133572144536,2022-12-01T16:06:24,Portugalete,transfer,Partner Salary,3026.13,121197.9
buyer_7,María,56,ES32209538214206674989,TRX_N-00465-895047385348,2022-12-01T16:06:24,Portugalete,transfer,Bonus,3012.95,124210.85
buyer_7,María,56,ES32209538214206674989,TRX_N-00466-886803153577,2022-12-05T09:50:45,Portugalete,Housing,Mortgage,-1805.98,122404.87
buyer_7,María,56,ES32209538214206674989,TRX_N-00467-583668517887,2022-12-05T19:44:27,Portugalete,Basic services,water,-46.78,122358.09
buyer_7,María,56,ES32209538214206674989,TRX_N-00468-451907242426,2022-12-05T12:40:22,Portugalete,Basic services,electricity,-51.73,122306.36
buyer_7,María,56,ES32209538214206674989,TRX_N-00469-224036234606,2022-12-05T08:12:08,Portugalete,Basic services,phone,-33.19,122273.17
buyer_7,María,56,ES32209538214206674989,TRX_N-00470-916705960366,2022-12-05T16:12:35,Portugalete,Expense,transport,-124.11,122149.06
buyer_7,María,56,ES32209538214206674989,TRX_N-00471-728007445999,2022-12-06T10:21:06,Portugalete,Basic services,internet,-46.08,122102.98
buyer_7,María,56,ES32209538214206674989,TRX_N-00472-433470656374,2022-12-07T18:12:27,Portugalete,Basic services,electricity,-27.96,122075.02
buyer_7,María,56,ES32209538214206674989,TRX_N-00473-237100823288,2022-12-07T16:12:39,Portugalete,Basic services,gas,-67.1,122007.92
buyer_7,María,56,ES32209538214206674989,TRX_N-00474-693258748156,2022-12-20T20:41:09,Portugalete,Expense,transport,-162.11,121845.81
buyer_7,María,56,ES32209538214206674989,TRX_N-00475-106251736892,2022-12-23T13:25:34,Portugalete,Expense,leisure,-187.58,121658.23
buyer_7,María,56,ES32209538214206674989,TRX_N-00476-787900624381,2022-12-25T09:27:01,Elciego,Expense,leisure,-105.31,121552.92
buyer_7,María,56,ES32209538214206674989,TRX_N-00477-563727172740,2022-12-31T17:34:48,Barakaldo,Expense,leisure,-123.17,121429.75
buyer_7,María,56,ES32209538214206674989,TRX_N-00478-622131447224,2023-01-01T20:52:27,Portugalete,transfer,Salary,3020.95,124450.7
buyer_7,María,56,ES32209538214206674989,TRX_N-00479-613451034961,2023-01-01T20:52:27,Portugalete,transfer,Partner Salary,3026.13,127476.83
buyer_7,María,56,ES32209538214206674989,TRX_N-00480-583903488078,2023-01-01T20:52:27,Portugalete,transfer,Extra Income,302.09,127778.92
buyer_7,María,56,ES32209538214206674989,TRX_N-00481-181652751384,2023-01-05T09:03:02,Portugalete,Housing,Mortgage,-1805.98,125972.94
buyer_7,María,56,ES32209538214206674989,TRX_N-00482-814250291585,2023-01-05T09:53:26,Portugalete,Basic services,water,-22.61,125950.33
buyer_7,María,56,ES32209538214206674989,TRX_N-00483-639170712872,2023-01-05T13:19:56,Portugalete,Basic services,internet,-30.63,125919.7
buyer_7,María,56,ES32209538214206674989,TRX_N-00484-988443286761,2023-01-06T19:47:31,Portugalete,Basic services,electricity,-113.64,125806.06
buyer_7,María,56,ES32209538214206674989,TRX_N-00485-517595691429,2023-01-06T23:37:53,Portugalete,Basic services,gas,-89.24,125716.82
buyer_7,María,56,ES32209538214206674989,TRX_N-00486-536268252980,2023-01-06T12:29:02,Portugalete,Basic services,phone,-36.67,125680.15
buyer_7,María,56,ES32209538214206674989,TRX_N-00487-894509399219,2023-01-07T06:47:36,Portugalete,Basic services,water,-30.57,125649.58
buyer_7,María,56,ES32209538214206674989,TRX_N-00488-4701022568,2023-01-07T17:22:37,Portugalete,Basic services,phone,-78.35,125571.23
buyer_7,María,56,ES32209538214206674989,TRX_N-00489-217980024989,2023-01-11T09:49:27,Portugalete,Expense,repairs,-120.48,125450.75
buyer_7,María,56,ES32209538214206674989,TRX_N-00490-822749431606,2023-01-18T08:16:28,Portugalete,Expense,leisure,-289.4,125161.35
buyer_7,María,56,ES32209538214206674989,TRX_N-00491-384341905508,2023-01-30T15:25:17,Portugalete,Expense,clothing,-169.61,124991.74
buyer_7,María,56,ES32209538214206674989,TRX_N-00492-858437115298,2023-02-01T02:10:26,Portugalete,transfer,Salary,3020.95,128012.69
buyer_7,María,56,ES32209538214206674989,TRX_N-00493-64253733958,2023-02-01T02:10:26,Portugalete,transfer,Partner Salary,3026.13,131038.82
buyer_7,María,56,ES32209538214206674989,TRX_N-00494-923659447406,2023-02-05T19:53:56,Portugalete,Housing,Mortgage,-1805.98,129232.84
buyer_7,María,56,ES32209538214206674989,TRX_N-00495-380194973002,2023-02-05T18:28:54,Portugalete,Basic services,water,-78.63,129154.21
buyer_7,María,56,ES32209538214206674989,TRX_N-00496-233735583945,2023-02-05T03:05:47,Portugalete,Basic services,internet,-39.08,129115.13
buyer_7,María,56,ES32209538214206674989,TRX_N-00497-720165766489,2023-02-06T14:40:58,Portugalete,Basic services,electricity,-97.74,129017.39
buyer_7,María,56,ES32209538214206674989,TRX_N-00498-264436950568,2023-02-07T18:43:31,Portugalete,Basic services,gas,-83.5,128933.89
buyer_7,María,56,ES32209538214206674989,TRX_N-00499-61655350487,2023-02-13T13:42:27,Portugalete,Expense,food,-688.69,128245.2
buyer_7,María,56,ES32209538214206674989,TRX_N-00500-390306935254,2023-03-01T15:04:33,Portugalete,transfer,Salary,3020.95,131266.15
buyer_7,María,56,ES32209538214206674989,TRX_N-00501-746876125960,2023-03-01T15:04:33,Portugalete,transfer,Partner Salary,3026.13,134292.28
buyer_7,María,56,ES32209538214206674989,TRX_N-00502-916593434973,2023-03-01T15:04:33,Portugalete,transfer,Extra Income,302.09,134594.37
buyer_7,María,56,ES32209538214206674989,TRX_N-00503-403166301959,2023-03-05T13:40:50,Portugalete,Housing,Mortgage,-1805.98,132788.39
buyer_7,María,56,ES32209538214206674989,TRX_N-00504-57038151861,2023-03-05T17:41:08,Portugalete,Basic services,gas,-64.78,132723.61
buyer_7,María,56,ES32209538214206674989,TRX_N-00505-31295654412,2023-03-05T04:44:12,Portugalete,Basic services,phone,-46.8,132676.81
buyer_7,María,56,ES32209538214206674989,TRX_N-00506-450269286053,2023-03-06T22:34:31,Portugalete,Basic services,water,-39.68,132637.13
buyer_7,María,56,ES32209538214206674989,TRX_N-00507-983213433457,2023-03-07T19:13:00,Portugalete,Basic services,water,-51.28,132585.85
buyer_7,María,56,ES32209538214206674989,TRX_N-00508-788198294358,2023-03-12T11:30:13,Portugalete,Expense,food,-642.65,131943.2
buyer_7,María,56,ES32209538214206674989,TRX_N-00509-66276965497,2023-03-21T19:47:20,Portugalete,Expense,food,-108.98,131834.22
buyer_7,María,56,ES32209538214206674989,TRX_N-00510-120067262290,2023-03-27T22:07:08,Portugalete,Expense,leisure,-274.56,131559.66
buyer_7,María,56,ES32209538214206674989,TRX_N-00511-806034563525,2023-03-31T20:36:43,Portugalete,Expense,transport,-175.36,131384.3
buyer_7,María,56,ES32209538214206674989,TRX_N-00512-902184287022,2023-04-01T09:14:02,Portugalete,transfer,Salary,3020.95,134405.25
buyer_7,María,56,ES32209538214206674989,TRX_N-00513-490036170426,2023-04-01T09:14:02,Portugalete,transfer,Partner Salary,3026.13,137431.38
buyer_7,María,56,ES32209538214206674989,TRX_N-00514-239540683378,2023-04-05T15:38:33,Portugalete,Housing,Mortgage,-1805.98,135625.4
buyer_7,María,56,ES32209538214206674989,TRX_N-00515-182200224417,2023-04-05T17:05:02,Portugalete,Basic services,electricity,-104.5,135520.9
buyer_7,María,56,ES32209538214206674989,TRX_N-00516-86706927225,2023-04-06T13:37:48,Portugalete,Basic services,water,-41.43,135479.47
buyer_7,María,56,ES32209538214206674989,TRX_N-00517-24100708446,2023-04-06T14:10:38,Portugalete,Basic services,electricity,-109.7,135369.77
buyer_7,María,56,ES32209538214206674989,TRX_N-00518-865449576684,2023-04-06T22:28:54,Portugalete,Basic services,internet,-66.05,135303.72
buyer_7,María,56,ES32209538214206674989,TRX_N-00519-257416625948,2023-04-06T12:00:55,Portugalete,Basic services,phone,-65.31,135238.41
buyer_7,María,56,ES32209538214206674989,TRX_N-00520-666992095415,2023-04-07T19:58:34,Portugalete,Basic services,water,-12.21,135226.2
buyer_7,María,56,ES32209538214206674989,TRX_N-00521-595232649812,2023-04-11T14:26:50,Portugalete,Expense,healthcare,-344.77,134881.43
buyer_7,María,56,ES32209538214206674989,TRX_N-00522-36740817811,2023-04-14T15:07:16,Portugalete,Expense,leisure,-61.99,134819.44
buyer_7,María,56,ES32209538214206674989,TRX_N-00523-922219485541,2023-04-15T13:41:33,Portugalete,Expense,food,-166.13,134653.31
buyer_7,María,56,ES32209538214206674989,TRX_N-00524-328081007503,2023-04-22T00:36:02,Portugalete,Expense,clothing,-222.8,134430.51
buyer_7,María,56,ES32209538214206674989,TRX_N-00525-424966621898,2023-04-27T20:55:41,Bermeo,Expense,food,-583.86,133846.65
buyer_7,María,56,ES32209538214206674989,TRX_N-00526-397531884931,2023-05-01T16:41:02,Portugalete,transfer,Salary,3020.95,136867.6
buyer_7,María,56,ES32209538214206674989,TRX_N-00527-348871734463,2023-05-01T16:41:02,Portugalete,transfer,Partner Salary,3026.13,139893.73
buyer_7,María,56,ES32209538214206674989,TRX_N-00528-121561207926,2023-05-05T16:30:28,Portugalete,Housing,Mortgage,-1805.98,138087.75
buyer_7,María,56,ES32209538214206674989,TRX_N-00529-337999506977,2023-05-05T18:23:45,Portugalete,Basic services,internet,-49.9,138037.85
buyer_7,María,56,ES32209538214206674989,TRX_N-00530-325871841139,2023-05-06T21:09:40,Portugalete,Basic services,electricity,-94.97,137942.88
buyer_7,María,56,ES32209538214206674989,TRX_N-00531-640891906203,2023-05-06T18:32:09,Portugalete,Basic services,gas,-19.13,137923.75
buyer_7,María,56,ES32209538214206674989,TRX_N-00532-980791342504,2023-05-06T16:06:27,Portugalete,Expense,transport,-161.64,137762.11
buyer_7,María,56,ES32209538214206674989,TRX_N-00533-228295932676,2023-05-30T11:28:02,Portugalete,Expense,transport,-89.96,137672.15
buyer_7,María,56,ES32209538214206674989,TRX_N-00534-993787082124,2023-06-01T14:20:04,Portugalete,transfer,Salary,3020.95,140693.1
buyer_7,María,56,ES32209538214206674989,TRX_N-00535-551894139225,2023-06-01T14:20:04,Portugalete,transfer,Partner Salary,3026.13,143719.23
buyer_7,María,56,ES32209538214206674989,TRX_N-00536-362678730578,2023-06-01T14:20:04,Portugalete,transfer,Extra Income,302.09,144021.32
buyer_7,María,56,ES32209538214206674989,TRX_N-00537-963220111245,2023-06-01T14:20:04,Portugalete,transfer,Bonus,2761.34,146782.66
buyer_7,María,56,ES32209538214206674989,TRX_N-00538-582000400067,2023-06-02T10:40:57,Portugalete,Expense,repairs,-476.03,146306.63
buyer_7,María,56,ES32209538214206674989,TRX_N-00539-47334854644,2023-06-05T08:54:35,Portugalete,Housing,Mortgage,-1805.98,144500.65
buyer_7,María,56,ES32209538214206674989,TRX_N-00540-987129495025,2023-06-05T11:45:34,Portugalete,Basic services,gas,-51.95,144448.7
buyer_7,María,56,ES32209538214206674989,TRX_N-00541-726065869862,2023-06-06T22:22:50,Portugalete,Basic services,phone,-61.61,144387.09
buyer_7,María,56,ES32209538214206674989,TRX_N-00542-750991292400,2023-06-19T10:06:01,Portugalete,Expense,clothing,-74.62,144312.47
buyer_7,María,56,ES32209538214206674989,TRX_N-00543-833531104477,2023-06-21T13:07:22,Portugalete,Expense,transport,-54.08,144258.39
buyer_7,María,56,ES32209538214206674989,TRX_N-00544-550174180426,2023-07-01T08:50:13,Portugalete,transfer,Salary,3020.95,147279.34
buyer_7,María,56,ES32209538214206674989,TRX_N-00545-331161495514,2023-07-01T08:50:13,Portugalete,transfer,Partner Salary,3026.13,150305.47
buyer_7,María,56,ES32209538214206674989,TRX_N-00546-913199560210,2023-07-05T19:06:02,Portugalete,Housing,Mortgage,-1805.98,148499.49
buyer_7,María,56,ES32209538214206674989,TRX_N-00547-592792412270,2023-07-05T20:45:01,Portugalete,Basic services,water,-27.76,148471.73
buyer_7,María,56,ES32209538214206674989,TRX_N-00548-821650537042,2023-07-05T19:06:02,Portugalete,Basic services,electricity,-117.34,148354.39
buyer_7,María,56,ES32209538214206674989,TRX_N-00549-92825871753,2023-07-05T15:53:56,Portugalete,Basic services,internet,-54.53,148299.86
buyer_7,María,56,ES32209538214206674989,TRX_N-00550-457185513736,2023-07-06T08:05:28,Portugalete,Basic services,gas,-54.59,148245.27
buyer_7,María,56,ES32209538214206674989,TRX_N-00551-874308424362,2023-07-07T11:10:15,Portugalete,Basic services,gas,-24.7,148220.57
buyer_7,María,56,ES32209538214206674989,TRX_N-00552-114999502819,2023-07-12T13:49:13,Zarautz,Expense,leisure,-43.89,148176.68
buyer_7,María,56,ES32209538214206674989,TRX_N-00553-911830169454,2023-07-13T10:03:37,Portugalete,Expense,transport,-150.11,148026.57
buyer_7,María,56,ES32209538214206674989,TRX_N-00554-224329218276,2023-07-23T05:58:05,Portugalete,Expense,transport,-74.56,147952.01
buyer_7,María,56,ES32209538214206674989,TRX_N-00555-885377109549,2023-07-31T22:06:12,Portugalete,Expense,repairs,-621.88,147330.13
buyer_7,María,56,ES32209538214206674989,TRX_N-00556-309418891550,2023-08-01T11:07:50,Portugalete,transfer,Salary,3020.95,150351.08
buyer_7,María,56,ES32209538214206674989,TRX_N-00557-683970419355,2023-08-01T11:07:50,Portugalete,transfer,Partner Salary,3026.13,153377.21
buyer_7,María,56,ES32209538214206674989,TRX_N-00558-887613519731,2023-08-01T11:07:50,Portugalete,transfer,Extra Income,302.09,153679.3
buyer_7,María,56,ES32209538214206674989,TRX_N-00559-365296582037,2023-08-05T09:35:54,Portugalete,Housing,Mortgage,-1805.98,151873.32
buyer_7,María,56,ES32209538214206674989,TRX_N-00560-78254905658,2023-08-05T16:08:31,Portugalete,Basic services,water,-79.13,151794.19
buyer_7,María,56,ES32209538214206674989,TRX_N-00561-224613145994,2023-08-05T00:42:34,Portugalete,Basic services,electricity,-80.0,151714.19
buyer_7,María,56,ES32209538214206674989,TRX_N-00562-30151602417,2023-08-05T00:01:33,Portugalete,Basic services,internet,-68.81,151645.38
buyer_7,María,56,ES32209538214206674989,TRX_N-00563-399987596165,2023-08-05T09:29:20,Portugalete,Basic services,phone,-99.01,151546.37
buyer_7,María,56,ES32209538214206674989,TRX_N-00564-69709745187,2023-08-06T10:22:11,Portugalete,Basic services,electricity,-38.4,151507.97
buyer_7,María,56,ES32209538214206674989,TRX_N-00565-666220956515,2023-08-06T17:09:51,Portugalete,Basic services,phone,-29.35,151478.62
buyer_7,María,56,ES32209538214206674989,TRX_N-00566-733492022899,2023-08-07T18:59:03,Portugalete,Basic services,gas,-60.04,151418.58
buyer_7,María,56,ES32209538214206674989,TRX_N-00567-667264423007,2023-08-07T17:21:26,Portugalete,Basic services,internet,-61.88,151356.7
buyer_7,María,56,ES32209538214206674989,TRX_N-00568-147721079042,2023-08-10T14:37:26,Bermeo,Expense,clothing,-326.0,151030.7
buyer_7,María,56,ES32209538214206674989,TRX_N-00569-345900024438,2023-09-01T12:12:27,Portugalete,transfer,Salary,3020.95,154051.65
buyer_7,María,56,ES32209538214206674989,TRX_N-00570-969233442842,2023-09-01T12:12:27,Portugalete,transfer,Partner Salary,3026.13,157077.78
buyer_7,María,56,ES32209538214206674989,TRX_N-00571-678837171282,2023-09-05T15:03:17,Portugalete,Housing,Mortgage,-1805.98,155271.8
buyer_7,María,56,ES32209538214206674989,TRX_N-00572-35275813585,2023-09-05T07:19:47,Portugalete,Basic services,water,-41.48,155230.32
buyer_7,María,56,ES32209538214206674989,TRX_N-00573-793367331650,2023-09-05T08:16:01,Portugalete,Basic services,electricity,-119.32,155111.0
buyer_7,María,56,ES32209538214206674989,TRX_N-00574-960060639136,2023-09-05T08:04:55,Portugalete,Basic services,internet,-30.17,155080.83
buyer_7,María,56,ES32209538214206674989,TRX_N-00575-550154814008,2023-09-05T02:55:47,Portugalete,Expense,clothing,-50.22,155030.61
buyer_7,María,56,ES32209538214206674989,TRX_N-00576-384975078750,2023-09-06T15:15:03,Portugalete,Basic services,phone,-54.85,154975.76
buyer_7,María,56,ES32209538214206674989,TRX_N-00577-120462181003,2023-09-07T09:56:12,Portugalete,Basic services,gas,-25.1,154950.66
buyer_7,María,56,ES32209538214206674989,TRX_N-00578-299455143154,2023-09-25T10:51:13,Portugalete,Expense,leisure,-92.84,154857.82
buyer_7,María,56,ES32209538214206674989,TRX_N-00579-753538510819,2023-09-26T09:43:11,Portugalete,Expense,leisure,-105.01,154752.81
buyer_7,María,56,ES32209538214206674989,TRX_N-00580-562837947819,2023-09-27T20:56:06,Portugalete,Expense,gifts,-471.01,154281.8
buyer_7,María,56,ES32209538214206674989,TRX_N-00581-93982865188,2023-10-01T19:20:36,Portugalete,transfer,Salary,3020.95,157302.75
buyer_7,María,56,ES32209538214206674989,TRX_N-00582-638707430611,2023-10-01T19:20:36,Portugalete,transfer,Partner Salary,3026.13,160328.88
buyer_7,María,56,ES32209538214206674989,TRX_N-00583-44491631192,2023-10-01T12:10:55,Portugalete,Expense,repairs,-391.69,159937.19
buyer_7,María,56,ES32209538214206674989,TRX_N-00584-690110562183,2023-10-02T15:26:07,Zarautz,Expense,leisure,-223.47,159713.72
buyer_7,María,56,ES32209538214206674989,TRX_N-00585-696624390111,2023-10-05T18:11:30,Portugalete,Housing,Mortgage,-1805.98,157907.74
buyer_7,María,56,ES32209538214206674989,TRX_N-00586-335308867645,2023-10-05T10:22:26,Portugalete,Basic services,water,-68.75,157838.99
buyer_7,María,56,ES32209538214206674989,TRX_N-00587-646593631383,2023-10-06T12:06:27,Portugalete,Basic services,water,-55.54,157783.45
buyer_7,María,56,ES32209538214206674989,TRX_N-00588-495054198013,2023-10-06T11:49:01,Portugalete,Basic services,electricity,-28.43,157755.02
buyer_7,María,56,ES32209538214206674989,TRX_N-00589-536163051965,2023-10-06T10:13:52,Portugalete,Basic services,gas,-46.31,157708.71
buyer_7,María,56,ES32209538214206674989,TRX_N-00590-107280479861,2023-10-06T15:54:46,Portugalete,Basic services,phone,-30.06,157678.65
buyer_7,María,56,ES32209538214206674989,TRX_N-00591-487278523126,2023-10-07T18:30:26,Portugalete,Basic services,electricity,-135.66,157542.99
buyer_7,María,56,ES32209538214206674989,TRX_N-00592-368213557759,2023-10-07T18:29:42,Portugalete,Basic services,internet,-40.97,157502.02
buyer_7,María,56,ES32209538214206674989,TRX_N-00593-792498392071,2023-10-09T19:48:41,Portugalete,Expense,clothing,-403.29,157098.73
buyer_7,María,56,ES32209538214206674989,TRX_N-00594-223362758287,2023-10-15T18:10:34,Portugalete,Expense,education,-54.81,157043.92
buyer_7,María,56,ES32209538214206674989,TRX_N-00595-863429430042,2023-11-01T12:58:25,Portugalete,transfer,Salary,3020.95,160064.87
buyer_7,María,56,ES32209538214206674989,TRX_N-00596-903378445445,2023-11-01T12:58:25,Portugalete,transfer,Partner Salary,3026.13,163091.0
buyer_7,María,56,ES32209538214206674989,TRX_N-00597-61123347610,2023-11-01T12:58:25,Portugalete,transfer,Extra Income,302.09,163393.09
buyer_7,María,56,ES32209538214206674989,TRX_N-00598-732969239463,2023-11-05T11:46:14,Portugalete,Housing,Mortgage,-1805.98,161587.11
buyer_7,María,56,ES32209538214206674989,TRX_N-00599-46304689123,2023-11-05T14:04:29,Portugalete,Basic services,internet,-59.62,161527.49
buyer_7,María,56,ES32209538214206674989,TRX_N-00600-237977808,2023-11-06T15:13:53,Portugalete,Basic services,water,-36.36,161491.13
buyer_7,María,56,ES32209538214206674989,TRX_N-00601-101480959118,2023-11-06T08:08:04,Portugalete,Basic services,electricity,-38.08,161453.05
buyer_7,María,56,ES32209538214206674989,TRX_N-00602-847011723486,2023-11-06T15:35:05,Portugalete,Basic services,gas,-86.65,161366.4
buyer_7,María,56,ES32209538214206674989,TRX_N-00603-291818267383,2023-11-12T00:04:13,Portugalete,Expense,leisure,-48.49,161317.91
buyer_7,María,56,ES32209538214206674989,TRX_N-00604-135014783777,2023-11-13T04:53:06,Oyón-Oion,Expense,food,-763.74,160554.17
buyer_7,María,56,ES32209538214206674989,TRX_N-00605-915508363185,2023-11-19T03:51:31,Portugalete,Expense,food,-674.91,159879.26
buyer_7,María,56,ES32209538214206674989,TRX_N-00606-923807247687,2023-11-20T13:56:40,Portugalete,Expense,education,-336.0,159543.26
buyer_7,María,56,ES32209538214206674989,TRX_N-00607-393370059040,2023-12-01T09:03:47,Portugalete,transfer,Salary,3020.95,162564.21
buyer_7,María,56,ES32209538214206674989,TRX_N-00608-462177807005,2023-12-01T09:03:47,Portugalete,transfer,Partner Salary,3026.13,165590.34
buyer_7,María,56,ES32209538214206674989,TRX_N-00609-452449904752,2023-12-01T09:03:47,Portugalete,transfer,Bonus,2980.97,168571.31
buyer_7,María,56,ES32209538214206674989,TRX_N-00610-537946757941,2023-12-05T10:32:06,Portugalete,Housing,Mortgage,-1805.98,166765.33
buyer_7,María,56,ES32209538214206674989,TRX_N-00611-612387402869,2023-12-05T15:16:51,Portugalete,Basic services,water,-61.39,166703.94
buyer_7,María,56,ES32209538214206674989,TRX_N-00612-394679935691,2023-12-05T08:10:48,Portugalete,Basic services,gas,-27.69,166676.25
buyer_7,María,56,ES32209538214206674989,TRX_N-00613-423153231843,2023-12-06T01:22:49,Portugalete,Basic services,electricity,-35.24,166641.01
buyer_7,María,56,ES32209538214206674989,TRX_N-00614-656181140985,2023-12-06T21:17:39,Portugalete,Basic services,internet,-61.11,166579.9
buyer_7,María,56,ES32209538214206674989,TRX_N-00615-963574459917,2023-12-06T10:08:07,Portugalete,Basic services,phone,-65.69,166514.21
buyer_7,María,56,ES32209538214206674989,TRX_N-00616-544368851243,2023-12-06T14:47:55,Portugalete,Expense,education,-941.05,165573.16
buyer_7,María,56,ES32209538214206674989,TRX_N-00617-818121061807,2023-12-07T10:02:16,Portugalete,Basic services,electricity,-20.46,165552.7
buyer_7,María,56,ES32209538214206674989,TRX_N-00618-142421174251,2023-12-07T13:34:12,Portugalete,Basic services,gas,-89.32,165463.38
buyer_7,María,56,ES32209538214206674989,TRX_N-00619-584674633177,2023-12-07T16:42:57,Portugalete,Basic services,internet,-71.5,165391.88
buyer_7,María,56,ES32209538214206674989,TRX_N-00620-848189749937,2023-12-18T09:21:26,Portugalete,Expense,food,-789.83,164602.05
buyer_7,María,56,ES32209538214206674989,TRX_N-00621-136412841549,2024-01-01T13:13:29,Portugalete,transfer,Salary,3020.95,167623.0
buyer_7,María,56,ES32209538214206674989,TRX_N-00622-444989579533,2024-01-01T13:13:29,Portugalete,transfer,Partner Salary,3026.13,170649.13
buyer_7,María,56,ES32209538214206674989,TRX_N-00623-213653710802,2024-01-01T13:13:29,Portugalete,transfer,Extra Income,302.09,170951.22
buyer_7,María,56,ES32209538214206674989,TRX_N-00624-808893558320,2024-01-05T09:42:14,Portugalete,Housing,Mortgage,-1805.98,169145.24
buyer_7,María,56,ES32209538214206674989,TRX_N-00625-244324652119,2024-01-06T16:11:49,Portugalete,Basic services,phone,-54.78,169090.46
buyer_7,María,56,ES32209538214206674989,TRX_N-00626-858360298173,2024-01-07T08:28:48,Portugalete,Basic services,electricity,-87.68,169002.78
buyer_7,María,56,ES32209538214206674989,TRX_N-00627-140484180465,2024-01-07T14:07:25,Portugalete,Basic services,gas,-22.79,168979.99
buyer_7,María,56,ES32209538214206674989,TRX_N-00628-828348064897,2024-01-07T09:21:47,Portugalete,Basic services,internet,-74.17,168905.82
buyer_7,María,56,ES32209538214206674989,TRX_N-00629-102520142082,2024-01-11T19:21:21,Salvatierra/Agurain,Expense,transport,-135.12,168770.7
buyer_7,María,56,ES32209538214206674989,TRX_N-00630-636316110248,2024-01-17T09:04:28,Portugalete,Expense,transport,-186.0,168584.7
buyer_7,María,56,ES32209538214206674989,TRX_N-00631-288346149576,2024-01-19T22:19:49,Portugalete,Expense,transport,-76.19,168508.51
buyer_7,María,56,ES32209538214206674989,TRX_N-00632-969276014652,2024-01-20T21:10:48,Portugalete,Expense,transport,-70.66,168437.85
buyer_7,María,56,ES32209538214206674989,TRX_N-00633-833220950662,2024-01-23T13:50:53,Portugalete,Expense,food,-761.16,167676.69
buyer_7,María,56,ES32209538214206674989,TRX_N-00634-565181254113,2024-01-24T13:51:21,Portugalete,Expense,transport,-132.67,167544.02
buyer_7,María,56,ES32209538214206674989,TRX_N-00635-975266100693,2024-01-27T05:35:48,Portugalete,Expense,appliances,-1072.42,166471.6
buyer_7,María,56,ES32209538214206674989,TRX_N-00636-839540156059,2024-02-01T23:36:05,Portugalete,transfer,Salary,3020.95,169492.55
buyer_7,María,56,ES32209538214206674989,TRX_N-00637-322122483979,2024-02-01T23:36:05,Portugalete,transfer,Partner Salary,3026.13,172518.68
buyer_7,María,56,ES32209538214206674989,TRX_N-00638-333081563549,2024-02-05T11:03:27,Portugalete,Housing,Mortgage,-1805.98,170712.7
buyer_7,María,56,ES32209538214206674989,TRX_N-00639-188968837423,2024-02-05T22:44:00,Portugalete,Basic services,gas,-42.03,170670.67
buyer_7,María,56,ES32209538214206674989,TRX_N-00640-570875941622,2024-02-05T11:33:51,Portugalete,Basic services,phone,-40.26,170630.41
buyer_7,María,56,ES32209538214206674989,TRX_N-00641-857098671037,2024-02-06T11:00:41,Portugalete,Basic services,water,-78.05,170552.36
buyer_7,María,56,ES32209538214206674989,TRX_N-00642-321674456168,2024-02-06T23:02:54,Portugalete,Basic services,internet,-39.71,170512.65
buyer_7,María,56,ES32209538214206674989,TRX_N-00643-539982471318,2024-02-07T22:18:41,Portugalete,Basic services,water,-56.38,170456.27
buyer_7,María,56,ES32209538214206674989,TRX_N-00644-62061607939,2024-02-07T00:29:52,Portugalete,Basic services,electricity,-61.71,170394.56
buyer_7,María,56,ES32209538214206674989,TRX_N-00645-780940602868,2024-02-07T11:15:36,Portugalete,Basic services,internet,-45.39,170349.17
buyer_7,María,56,ES32209538214206674989,TRX_N-00646-644907207339,2024-02-14T14:40:46,Portugalete,Expense,transport,-52.98,170296.19
buyer_7,María,56,ES32209538214206674989,TRX_N-00647-310166573607,2024-02-18T12:38:59,Portugalete,Expense,clothing,-102.57,170193.62
buyer_7,María,56,ES32209538214206674989,TRX_N-00648-956179548483,2024-02-29T16:34:13,Vitoria-Gasteiz,Expense,transport,-91.25,170102.37
buyer_7,María,56,ES32209538214206674989,TRX_N-00649-887601026251,2024-03-01T08:36:42,Portugalete,transfer,Salary,3020.95,173123.32
buyer_7,María,56,ES32209538214206674989,TRX_N-00650-971531716029,2024-03-01T08:36:42,Portugalete,transfer,Partner Salary,3026.13,176149.45
buyer_7,María,56,ES32209538214206674989,TRX_N-00651-37543574697,2024-03-01T08:36:42,Portugalete,transfer,Extra Income,302.09,176451.54
buyer_7,María,56,ES32209538214206674989,TRX_N-00652-259810614444,2024-03-05T19:21:55,Portugalete,Housing,Mortgage,-1805.98,174645.56
buyer_7,María,56,ES32209538214206674989,TRX_N-00653-848051691885,2024-03-05T20:37:53,Portugalete,Basic services,gas,-80.8,174564.76
buyer_7,María,56,ES32209538214206674989,TRX_N-00654-40159823486,2024-03-06T16:54:21,Portugalete,Basic services,water,-23.58,174541.18
buyer_7,María,56,ES32209538214206674989,TRX_N-00655-588377006235,2024-03-06T22:05:10,Portugalete,Basic services,electricity,-32.44,174508.74
buyer_7,María,56,ES32209538214206674989,TRX_N-00656-208587259502,2024-03-07T08:47:38,Portugalete,Basic services,water,-74.55,174434.19
buyer_7,María,56,ES32209538214206674989,TRX_N-00657-781154535996,2024-03-07T22:12:39,Portugalete,Basic services,electricity,-44.65,174389.54
buyer_7,María,56,ES32209538214206674989,TRX_N-00658-71275288594,2024-03-09T16:49:48,Portugalete,Expense,healthcare,-72.15,174317.39
buyer_7,María,56,ES32209538214206674989,TRX_N-00659-829334858185,2024-03-15T20:20:10,Portugalete,Expense,transport,-91.69,174225.7
buyer_7,María,56,ES32209538214206674989,TRX_N-00660-92152819362,2024-03-21T09:54:11,Basauri,Expense,healthcare,-360.1,173865.6
buyer_7,María,56,ES32209538214206674989,TRX_N-00661-126748359217,2024-03-24T20:42:17,Portugalete,Expense,leisure,-298.97,173566.63
buyer_7,María,56,ES32209538214206674989,TRX_N-00662-98819594116,2024-04-01T14:28:05,Portugalete,transfer,Salary,3020.95,176587.58
buyer_7,María,56,ES32209538214206674989,TRX_N-00663-105176748439,2024-04-01T14:28:05,Portugalete,transfer,Partner Salary,3026.13,179613.71
buyer_7,María,56,ES32209538214206674989,TRX_N-00664-977444611291,2024-04-05T13:13:54,Portugalete,Housing,Mortgage,-1805.98,177807.73
buyer_7,María,56,ES32209538214206674989,TRX_N-00665-960015160214,2024-04-05T09:05:54,Portugalete,Basic services,water,-24.19,177783.54
buyer_7,María,56,ES32209538214206674989,TRX_N-00666-888472344462,2024-04-05T13:17:36,Portugalete,Basic services,internet,-63.19,177720.35
buyer_7,María,56,ES32209538214206674989,TRX_N-00667-682966392682,2024-04-05T09:18:23,Portugalete,Basic services,phone,-89.6,177630.75
buyer_7,María,56,ES32209538214206674989,TRX_N-00668-781329853808,2024-04-06T18:11:17,Portugalete,Basic services,phone,-61.03,177569.72
buyer_7,María,56,ES32209538214206674989,TRX_N-00669-469423251688,2024-04-07T20:09:01,Portugalete,Basic services,gas,-84.34,177485.38
buyer_7,María,56,ES32209538214206674989,TRX_N-00670-82735496177,2024-04-07T12:53:14,Portugalete,Basic services,internet,-40.33,177445.05
buyer_7,María,56,ES32209538214206674989,TRX_N-00671-808733197992,2024-04-08T13:09:45,Portugalete,Expense,leisure,-173.71,177271.34
buyer_7,María,56,ES32209538214206674989,TRX_N-00672-83241486320,2024-04-10T13:50:21,Portugalete,Expense,travel,-323.81,176947.53
buyer_7,María,56,ES32209538214206674989,TRX_N-00673-288263633264,2024-04-26T18:56:47,Portugalete,Expense,transport,-74.75,176872.78
buyer_7,María,56,ES32209538214206674989,TRX_N-00674-520185353278,2024-04-27T13:00:09,Portugalete,Expense,transport,-152.46,176720.32
buyer_7,María,56,ES32209538214206674989,TRX_N-00675-206688225335,2024-05-01T09:18:45,Portugalete,transfer,Salary,3020.95,179741.27
buyer_7,María,56,ES32209538214206674989,TRX_N-00676-989085723076,2024-05-01T09:18:45,Portugalete,transfer,Partner Salary,3026.13,182767.4
buyer_7,María,56,ES32209538214206674989,TRX_N-00677-635224478402,2024-05-05T12:06:34,Portugalete,Housing,Mortgage,-1805.98,180961.42
buyer_7,María,56,ES32209538214206674989,TRX_N-00678-39967411102,2024-05-05T18:07:22,Portugalete,Basic services,gas,-53.13,180908.29
buyer_7,María,56,ES32209538214206674989,TRX_N-00679-987272072981,2024-05-05T18:19:56,Portugalete,Basic services,phone,-33.99,180874.3
buyer_7,María,56,ES32209538214206674989,TRX_N-00680-991146226092,2024-05-06T07:42:33,Portugalete,Basic services,electricity,-120.04,180754.26
buyer_7,María,56,ES32209538214206674989,TRX_N-00681-453883021568,2024-05-06T17:31:40,Portugalete,Basic services,phone,-92.66,180661.6
buyer_7,María,56,ES32209538214206674989,TRX_N-00682-389766909306,2024-05-17T14:24:20,Portugalete,Expense,food,-165.37,180496.23
buyer_7,María,56,ES32209538214206674989,TRX_N-00683-785361722557,2024-05-21T18:52:07,Portugalete,Expense,gifts,-395.72,180100.51
buyer_7,María,56,ES32209538214206674989,TRX_N-00684-568012535624,2024-05-26T18:44:58,Portugalete,Expense,food,-246.44,179854.07
buyer_7,María,56,ES32209538214206674989,TRX_N-00685-148939124142,2024-06-01T11:37:11,Portugalete,transfer,Salary,3020.95,182875.02
buyer_7,María,56,ES32209538214206674989,TRX_N-00686-994260579838,2024-06-01T11:37:11,Portugalete,transfer,Partner Salary,3026.13,185901.15
buyer_7,María,56,ES32209538214206674989,TRX_N-00687-508295276038,2024-06-01T11:37:11,Portugalete,transfer,Extra Income,302.09,186203.24
buyer_7,María,56,ES32209538214206674989,TRX_N-00688-666416075715,2024-06-01T11:37:11,Portugalete,transfer,Bonus,2955.33,189158.57
buyer_7,María,56,ES32209538214206674989,TRX_N-00689-43325372622,2024-06-05T14:01:09,Portugalete,Housing,Mortgage,-1805.98,187352.59
buyer_7,María,56,ES32209538214206674989,TRX_N-00690-534197888611,2024-06-05T08:14:19,Portugalete,Basic services,gas,-82.58,187270.01
buyer_7,María,56,ES32209538214206674989,TRX_N-00691-659765868090,2024-06-06T16:21:16,Portugalete,Basic services,water,-30.22,187239.79
buyer_7,María,56,ES32209538214206674989,TRX_N-00692-67904240428,2024-06-07T20:39:46,Portugalete,Basic services,water,-41.35,187198.44
buyer_7,María,56,ES32209538214206674989,TRX_N-00693-6555731454,2024-06-07T20:51:19,Portugalete,Basic services,electricity,-22.84,187175.6
buyer_7,María,56,ES32209538214206674989,TRX_N-00694-264330379523,2024-06-07T16:53:52,Portugalete,Basic services,internet,-52.92,187122.68
buyer_7,María,56,ES32209538214206674989,TRX_N-00695-419097534422,2024-06-15T14:32:54,Portugalete,Expense,clothing,-496.5,186626.18
buyer_7,María,56,ES32209538214206674989,TRX_N-00696-227191840365,2024-06-19T13:15:55,Hernani,Expense,leisure,-285.76,186340.42
buyer_7,María,56,ES32209538214206674989,TRX_N-00697-145116324521,2024-06-24T13:43:56,Hernani,Expense,leisure,-15.14,186325.28
buyer_7,María,56,ES32209538214206674989,TRX_N-00698-686797960437,2024-07-01T08:03:39,Portugalete,transfer,Salary,3020.95,189346.23
buyer_7,María,56,ES32209538214206674989,TRX_N-00699-821410386410,2024-07-01T08:03:39,Portugalete,transfer,Partner Salary,3026.13,192372.36
buyer_7,María,56,ES32209538214206674989,TRX_N-00700-709459645149,2024-07-04T14:38:33,Errenteria,Expense,repairs,-606.98,191765.38
buyer_7,María,56,ES32209538214206674989,TRX_N-00701-485498332907,2024-07-05T10:44:21,Portugalete,Housing,Mortgage,-1805.98,189959.4
buyer_7,María,56,ES32209538214206674989,TRX_N-00702-283400262170,2024-07-05T11:01:05,Portugalete,Basic services,internet,-54.96,189904.44
buyer_7,María,56,ES32209538214206674989,TRX_N-00703-233228184104,2024-07-05T18:26:26,Portugalete,Expense,leisure,-168.13,189736.31
buyer_7,María,56,ES32209538214206674989,TRX_N-00704-224916212456,2024-07-06T11:31:16,Portugalete,Basic services,electricity,-35.57,189700.74
buyer_7,María,56,ES32209538214206674989,TRX_N-00705-343549122681,2024-07-06T18:54:49,Portugalete,Basic services,internet,-30.98,189669.76
buyer_7,María,56,ES32209538214206674989,TRX_N-00706-894164397847,2024-07-07T15:26:36,Portugalete,Basic services,electricity,-39.78,189629.98
buyer_7,María,56,ES32209538214206674989,TRX_N-00707-22931914045,2024-07-07T16:02:42,Portugalete,Basic services,gas,-35.58,189594.4
buyer_7,María,56,ES32209538214206674989,TRX_N-00708-122372316766,2024-07-07T16:30:12,Portugalete,Basic services,internet,-54.33,189540.07
buyer_7,María,56,ES32209538214206674989,TRX_N-00709-29754465368,2024-07-10T19:06:21,Portugalete,Expense,healthcare,-217.43,189322.64
buyer_7,María,56,ES32209538214206674989,TRX_N-00710-518750181907,2024-08-01T14:15:09,Portugalete,transfer,Salary,3020.95,192343.59
buyer_7,María,56,ES32209538214206674989,TRX_N-00711-884361201441,2024-08-01T14:15:09,Portugalete,transfer,Partner Salary,3026.13,195369.72
buyer_7,María,56,ES32209538214206674989,TRX_N-00712-605254794416,2024-08-05T04:44:08,Portugalete,Housing,Mortgage,-1805.98,193563.74
buyer_7,María,56,ES32209538214206674989,TRX_N-00713-817796505799,2024-08-06T08:29:34,Portugalete,Basic services,electricity,-24.49,193539.25
buyer_7,María,56,ES32209538214206674989,TRX_N-00714-643012450572,2024-08-07T16:40:03,Portugalete,Basic services,electricity,-125.12,193414.13
buyer_7,María,56,ES32209538214206674989,TRX_N-00715-312088936097,2024-08-07T10:04:47,Portugalete,Basic services,internet,-59.25,193354.88
buyer_7,María,56,ES32209538214206674989,TRX_N-00716-526614494432,2024-08-11T14:03:54,Basauri,Expense,leisure,-250.9,193103.98
buyer_7,María,56,ES32209538214206674989,TRX_N-00717-946943019589,2024-08-14T17:57:42,Portugalete,Expense,gifts,-462.78,192641.2
buyer_7,María,56,ES32209538214206674989,TRX_N-00718-32424935166,2024-08-26T23:42:55,Portugalete,Expense,clothing,-102.09,192539.11
buyer_7,María,56,ES32209538214206674989,TRX_N-00719-553064333051,2024-08-26T10:22:24,Portugalete,Expense,travel,-1024.53,191514.58
buyer_7,María,56,ES32209538214206674989,TRX_N-00720-576675757604,2024-08-30T09:34:59,Portugalete,Expense,gifts,-481.34,191033.24
buyer_7,María,56,ES32209538214206674989,TRX_N-00721-465125494988,2024-09-01T12:13:07,Portugalete,transfer,Salary,3020.95,194054.19
buyer_7,María,56,ES32209538214206674989,TRX_N-00722-249584071939,2024-09-01T12:13:07,Portugalete,transfer,Partner Salary,3026.13,197080.32
buyer_7,María,56,ES32209538214206674989,TRX_N-00723-524621873284,2024-09-01T12:13:07,Portugalete,transfer,Extra Income,302.09,197382.41
buyer_7,María,56,ES32209538214206674989,TRX_N-00724-736747189038,2024-09-01T20:46:15,Donostia,Expense,gifts,-271.58,197110.83
buyer_7,María,56,ES32209538214206674989,TRX_N-00725-986893786528,2024-09-05T12:24:20,Portugalete,Housing,Mortgage,-1805.98,195304.85
buyer_7,María,56,ES32209538214206674989,TRX_N-00726-33686959286,2024-09-05T19:43:46,Portugalete,Basic services,electricity,-149.03,195155.82
buyer_7,María,56,ES32209538214206674989,TRX_N-00727-260641748080,2024-09-05T15:40:04,Portugalete,Basic services,phone,-21.14,195134.68
buyer_7,María,56,ES32209538214206674989,TRX_N-00728-268486701509,2024-09-07T08:38:55,Portugalete,Basic services,electricity,-72.43,195062.25
buyer_7,María,56,ES32209538214206674989,TRX_N-00729-523192042324,2024-09-07T06:07:19,Portugalete,Basic services,internet,-58.05,195004.2
buyer_7,María,56,ES32209538214206674989,TRX_N-00730-539241391716,2024-09-22T11:56:16,Portugalete,Expense,leisure,-177.55,194826.65
buyer_7,María,56,ES32209538214206674989,TRX_N-00731-584067747618,2024-09-27T14:44:38,Portugalete,Expense,transport,-181.92,194644.73
buyer_7,María,56,ES32209538214206674989,TRX_N-00732-571941575248,2024-09-29T14:05:32,Portugalete,Expense,transport,-84.53,194560.2
buyer_7,María,56,ES32209538214206674989,TRX_N-00733-992312682824,2024-09-30T18:15:10,Portugalete,Expense,transport,-64.07,194496.13
buyer_7,María,56,ES32209538214206674989,TRX_N-00734-950724293030,2024-10-01T23:33:16,Portugalete,transfer,Salary,3020.95,197517.08
buyer_7,María,56,ES32209538214206674989,TRX_N-00735-468054098022,2024-10-01T23:33:16,Portugalete,transfer,Partner Salary,3026.13,200543.21
buyer_7,María,56,ES32209538214206674989,TRX_N-00736-333696395374,2024-10-05T10:08:51,Portugalete,Housing,Mortgage,-1805.98,198737.23
buyer_7,María,56,ES32209538214206674989,TRX_N-00737-428499850724,2024-10-05T12:25:58,Portugalete,Basic services,water,-58.99,198678.24
buyer_7,María,56,ES32209538214206674989,TRX_N-00738-512498456823,2024-10-05T03:50:17,Portugalete,Basic services,gas,-81.52,198596.72
buyer_7,María,56,ES32209538214206674989,TRX_N-00739-50418091764,2024-10-05T08:06:09,Portugalete,Basic services,internet,-59.09,198537.63
buyer_7,María,56,ES32209538214206674989,TRX_N-00740-701644464207,2024-10-05T18:16:40,Portugalete,Basic services,phone,-74.56,198463.07
buyer_7,María,56,ES32209538214206674989,TRX_N-00741-738610644548,2024-10-06T08:21:47,Portugalete,Basic services,electricity,-22.38,198440.69
buyer_7,María,56,ES32209538214206674989,TRX_N-00742-429011593949,2024-10-06T18:57:22,Portugalete,Basic services,gas,-89.5,198351.19
buyer_7,María,56,ES32209538214206674989,TRX_N-00743-372954783281,2024-10-07T06:41:49,Portugalete,Basic services,gas,-32.57,198318.62
buyer_8,Antonio,45,ES63209538933051215051,TRX_N-00001-866629800608,2020-01-01T18:24:27,Labastida,transfer,Salary,2006.51,3204.81
buyer_8,Antonio,45,ES63209538933051215051,TRX_N-00002-14942954449,2020-01-01T09:42:39,Labastida,Expense,transport,-157.7,3047.11
buyer_8,Antonio,45,ES63209538933051215051,TRX_N-00003-688424613370,2020-01-05T19:30:45,Labastida,Housing,Mortgage,-979.0,2068.11
buyer_8,Antonio,45,ES63209538933051215051,TRX_N-00004-147704233073,2020-01-05T09:55:10,Labastida,Basic services,phone,-43.91,2024.2
buyer_8,Antonio,45,ES63209538933051215051,TRX_N-00005-500915286322,2020-01-05T09:28:10,Pasaia,Expense,food,-575.58,1448.62
buyer_8,Antonio,45,ES63209538933051215051,TRX_N-00006-338079571435,2020-01-06T20:24:32,Labastida,Basic services,water,-23.86,1424.76
buyer_8,Antonio,45,ES63209538933051215051,TRX_N-00007-225959095110,2020-01-06T22:58:50,Labastida,Basic services,gas,-90.9,1333.86
buyer_8,Antonio,45,ES63209538933051215051,TRX_N-00008-80520309108,2020-01-06T10:32:58,Labastida,Basic services,internet,-52.0,1281.86
buyer_8,Antonio,45,ES63209538933051215051,TRX_N-00009-587631259647,2020-01-06T14:15:41,Labastida,Expense,gifts,-252.66,1029.2
buyer_8,Antonio,45,ES63209538933051215051,TRX_N-00010-842169429389,2020-01-07T20:05:18,Labastida,Basic services,phone,-48.82,980.38
buyer_8,Antonio,45,ES63209538933051215051,TRX_N-00011-732429753658,2020-01-15T16:48:32,Labastida,Expense,leisure,-261.77,718.61
buyer_8,Antonio,45,ES63209538933051215051,TRX_N-00012-455521966293,2020-01-20T20:18:54,Durango,Expense,leisure,-211.01,507.6
buyer_8,Antonio,45,ES63209538933051215051,TRX_N-00013-221409051338,2020-01-29T16:36:24,Labastida,Expense,gifts,-327.53,180.07
buyer_8,Antonio,45,ES63209538933051215051,TRX_N-00014-133829074268,2020-02-01T10:10:01,Labastida,transfer,Salary,2006.51,2186.58
buyer_8,Antonio,45,ES63209538933051215051,TRX_N-00015-778966071205,2020-02-01T10:10:01,Labastida,transfer,Extra Income,200.65,2387.23
buyer_8,Antonio,45,ES63209538933051215051,TRX_N-00016-411647412595,2020-02-01T13:26:34,Labastida,Expense,leisure,-222.09,2165.14
buyer_8,Antonio,45,ES63209538933051215051,TRX_N-00017-101435372790,2020-02-03T18:42:30,Labastida,Expense,education,-763.33,1401.81
buyer_8,Antonio,45,ES63209538933051215051,TRX_N-00018-784081604977,2020-02-05T13:13:54,Labastida,Housing,Mortgage,-979.0,422.81
buyer_8,Antonio,45,ES63209538933051215051,TRX_N-00019-85246830803,2020-02-05T10:04:55,Labastida,Basic services,phone,-39.03,383.78
buyer_8,Antonio,45,ES63209538933051215051,TRX_N-00020-755568478052,2020-02-06T19:44:45,Labastida,Basic services,internet,-45.45,338.33
buyer_8,Antonio,45,ES63209538933051215051,TRX_N-00021-233288735240,2020-02-07T14:48:48,Labastida,Basic services,water,-50.85,287.48
buyer_8,Antonio,45,ES63209538933051215051,TRX_N-00022-964276600000,2020-02-07T09:14:38,Labastida,Basic services,gas,-74.35,213.13
buyer_8,Antonio,45,ES63209538933051215051,TRX_N-00023-888318132046,2020-02-14T13:23:07,Labastida,Expense,transport,-102.64,110.49
buyer_8,Antonio,45,ES63209538933051215051,TRX_N-00024-992958798099,2020-03-01T17:19:39,Labastida,transfer,Salary,2006.51,2117.0
buyer_8,Antonio,45,ES63209538933051215051,TRX_N-00025-276586836781,2020-03-05T14:08:03,Labastida,Housing,Mortgage,-979.0,1138.0
buyer_8,Antonio,45,ES63209538933051215051,TRX_N-00026-505269747813,2020-03-06T21:59:15,Labastida,Basic services,water,-58.33,1079.67
buyer_8,Antonio,45,ES63209538933051215051,TRX_N-00027-476678185484,2020-03-06T14:26:22,Labastida,Basic services,internet,-72.5,1007.17
buyer_8,Antonio,45,ES63209538933051215051,TRX_N-00028-860837043550,2020-03-06T10:53:42,Labastida,Basic services,phone,-64.82,942.35
buyer_8,Antonio,45,ES63209538933051215051,TRX_N-00029-652470167126,2020-03-06T15:27:47,Irun,Expense,transport,-76.17,866.18
buyer_8,Antonio,45,ES63209538933051215051,TRX_N-00030-341746246036,2020-03-07T18:49:57,Labastida,Basic services,gas,-16.64,849.54
buyer_8,Antonio,45,ES63209538933051215051,TRX_N-00031-263832813203,2020-03-07T09:22:16,Labastida,Basic services,internet,-72.22,777.32
buyer_8,Antonio,45,ES63209538933051215051,TRX_N-00032-687181638950,2020-03-07T09:40:49,Labastida,Basic services,phone,-73.48,703.84
buyer_8,Antonio,45,ES63209538933051215051,TRX_N-00033-469467684914,2020-03-08T04:49:49,Labastida,Expense,transport,-85.82,618.02
buyer_8,Antonio,45,ES63209538933051215051,TRX_N-00034-105755593437,2020-03-21T18:43:57,Labastida,Expense,gifts,-89.89,528.13
buyer_8,Antonio,45,ES63209538933051215051,TRX_N-00035-170565543438,2020-03-27T09:09:00,Labastida,Expense,clothing,-157.37,370.76
buyer_8,Antonio,45,ES63209538933051215051,TRX_N-00036-812137079096,2020-04-01T19:50:37,Labastida,transfer,Salary,2006.51,2377.27
buyer_8,Antonio,45,ES63209538933051215051,TRX_N-00037-242462137200,2020-04-05T09:42:09,Labastida,Housing,Mortgage,-979.0,1398.27
buyer_8,Antonio,45,ES63209538933051215051,TRX_N-00038-246398400528,2020-04-05T12:06:05,Labastida,Basic services,gas,-82.79,1315.48
buyer_8,Antonio,45,ES63209538933051215051,TRX_N-00039-528039342126,2020-04-05T14:33:02,Labastida,Expense,gifts,-149.93,1165.55
buyer_8,Antonio,45,ES63209538933051215051,TRX_N-00040-253333442921,2020-04-06T17:28:35,Labastida,Basic services,electricity,-97.83,1067.72
buyer_8,Antonio,45,ES63209538933051215051,TRX_N-00041-981671153335,2020-04-06T08:00:23,Labastida,Basic services,gas,-89.0,978.72
buyer_8,Antonio,45,ES63209538933051215051,TRX_N-00042-384040265020,2020-04-06T15:37:36,Labastida,Expense,food,-555.51,423.21
buyer_8,Antonio,45,ES63209538933051215051,TRX_N-00043-365934013903,2020-04-07T17:07:06,Labastida,Basic services,water,-40.59,382.62
buyer_8,Antonio,45,ES63209538933051215051,TRX_N-00044-154842589483,2020-04-11T12:27:53,Labastida,Expense,healthcare,-111.4,271.22
buyer_8,Antonio,45,ES63209538933051215051,TRX_N-00045-63353747275,2020-05-01T05:13:41,Labastida,transfer,Salary,2006.51,2277.73
buyer_8,Antonio,45,ES63209538933051215051,TRX_N-00046-82328386244,2020-05-01T05:13:41,Labastida,transfer,Extra Income,200.65,2478.38
buyer_8,Antonio,45,ES63209538933051215051,TRX_N-00047-939610417013,2020-05-05T00:47:21,Labastida,Housing,Mortgage,-979.0,1499.38
buyer_8,Antonio,45,ES63209538933051215051,TRX_N-00048-632710451708,2020-05-05T20:56:00,Labastida,Basic services,gas,-74.18,1425.2
buyer_8,Antonio,45,ES63209538933051215051,TRX_N-00049-777994118322,2020-05-06T16:48:21,Labastida,Basic services,electricity,-133.52,1291.68
buyer_8,Antonio,45,ES63209538933051215051,TRX_N-00050-436830865440,2020-05-06T21:50:45,Labastida,Basic services,gas,-22.98,1268.7
buyer_8,Antonio,45,ES63209538933051215051,TRX_N-00051-477635989133,2020-05-07T18:03:32,Portugalete,Expense,clothing,-42.7,1226.0
buyer_8,Antonio,45,ES63209538933051215051,TRX_N-00052-725249916144,2020-05-22T16:54:21,Labastida,Expense,food,-726.86,499.14
buyer_8,Antonio,45,ES63209538933051215051,TRX_N-00053-30808670148,2020-06-01T17:33:49,Labastida,transfer,Salary,2006.51,2505.65
buyer_8,Antonio,45,ES63209538933051215051,TRX_N-00054-93394168454,2020-06-01T17:33:49,Labastida,transfer,Bonus,2181.93,4687.58
buyer_8,Antonio,45,ES63209538933051215051,TRX_N-00055-698568906076,2020-06-01T16:20:38,Labastida,Expense,transport,-147.43,4540.15
buyer_8,Antonio,45,ES63209538933051215051,TRX_N-00056-907604571493,2020-06-03T19:17:39,Labastida,Expense,food,-202.62,4337.53
buyer_8,Antonio,45,ES63209538933051215051,TRX_N-00057-375606931224,2020-06-05T05:07:04,Labastida,Housing,Mortgage,-979.0,3358.53
buyer_8,Antonio,45,ES63209538933051215051,TRX_N-00058-858358295451,2020-06-05T18:56:55,Labastida,Basic services,gas,-88.53,3270.0
buyer_8,Antonio,45,ES63209538933051215051,TRX_N-00059-431495812210,2020-06-06T14:19:27,Labastida,Basic services,water,-75.24,3194.76
buyer_8,Antonio,45,ES63209538933051215051,TRX_N-00060-124643951262,2020-06-06T10:54:39,Labastida,Basic services,internet,-40.01,3154.75
buyer_8,Antonio,45,ES63209538933051215051,TRX_N-00061-640078994349,2020-06-07T07:01:06,Labastida,Basic services,water,-46.74,3108.01
buyer_8,Antonio,45,ES63209538933051215051,TRX_N-00062-905223781690,2020-06-11T11:37:47,Labastida,Expense,food,-101.68,3006.33
buyer_8,Antonio,45,ES63209538933051215051,TRX_N-00063-380389020974,2020-06-17T17:19:30,Labastida,Expense,leisure,-156.36,2849.97
buyer_8,Antonio,45,ES63209538933051215051,TRX_N-00064-781528950366,2020-06-22T18:05:01,Labastida,Expense,repairs,-73.69,2776.28
buyer_8,Antonio,45,ES63209538933051215051,TRX_N-00065-485363575308,2020-06-24T10:42:00,Labastida,Expense,food,-114.2,2662.08
buyer_8,Antonio,45,ES63209538933051215051,TRX_N-00066-260914821500,2020-07-01T15:02:34,Labastida,transfer,Salary,2006.51,4668.59
buyer_8,Antonio,45,ES63209538933051215051,TRX_N-00067-297220661311,2020-07-01T14:18:20,Labastida,Expense,food,-144.89,4523.7
buyer_8,Antonio,45,ES63209538933051215051,TRX_N-00068-329361514155,2020-07-05T12:39:01,Labastida,Housing,Mortgage,-979.0,3544.7
buyer_8,Antonio,45,ES63209538933051215051,TRX_N-00069-152729315015,2020-07-05T05:26:49,Labastida,Basic services,electricity,-128.21,3416.49
buyer_8,Antonio,45,ES63209538933051215051,TRX_N-00070-153193986411,2020-07-05T12:36:12,Labastida,Basic services,internet,-53.78,3362.71
buyer_8,Antonio,45,ES63209538933051215051,TRX_N-00071-357277360637,2020-07-05T09:58:00,Labastida,Basic services,phone,-63.55,3299.16
buyer_8,Antonio,45,ES63209538933051215051,TRX_N-00072-902198625357,2020-07-06T09:46:48,Getxo,Expense,transport,-174.76,3124.4
buyer_8,Antonio,45,ES63209538933051215051,TRX_N-00073-666927211817,2020-07-07T10:16:46,Labastida,Basic services,water,-73.45,3050.95
buyer_8,Antonio,45,ES63209538933051215051,TRX_N-00074-488120258070,2020-07-07T12:35:21,Labastida,Basic services,electricity,-112.15,2938.8
buyer_8,Antonio,45,ES63209538933051215051,TRX_N-00075-764336951495,2020-07-07T11:56:43,Labastida,Basic services,gas,-77.81,2860.99
buyer_8,Antonio,45,ES63209538933051215051,TRX_N-00076-173782677857,2020-07-07T14:28:24,Labastida,Basic services,internet,-53.31,2807.68
buyer_8,Antonio,45,ES63209538933051215051,TRX_N-00077-2718492469,2020-07-18T09:49:59,Labastida,Expense,clothing,-259.63,2548.05
buyer_8,Antonio,45,ES63209538933051215051,TRX_N-00078-513971442779,2020-07-24T15:18:10,Labastida,Expense,education,-892.08,1655.97
buyer_8,Antonio,45,ES63209538933051215051,TRX_N-00079-130204793247,2020-08-01T08:08:00,Labastida,transfer,Salary,2006.51,3662.48
buyer_8,Antonio,45,ES63209538933051215051,TRX_N-00080-377873786359,2020-08-01T08:08:00,Labastida,transfer,Extra Income,200.65,3863.13
buyer_8,Antonio,45,ES63209538933051215051,TRX_N-00081-60942563361,2020-08-03T23:20:31,Barakaldo,Expense,food,-211.57,3651.56
buyer_8,Antonio,45,ES63209538933051215051,TRX_N-00082-680664962834,2020-08-05T09:08:02,Labastida,Housing,Mortgage,-979.0,2672.56
buyer_8,Antonio,45,ES63209538933051215051,TRX_N-00083-812450934083,2020-08-05T03:20:30,Labastida,Basic services,internet,-62.96,2609.6
buyer_8,Antonio,45,ES63209538933051215051,TRX_N-00084-221569011879,2020-08-05T12:01:31,Labastida,Basic services,phone,-28.41,2581.19
buyer_8,Antonio,45,ES63209538933051215051,TRX_N-00085-4144799912,2020-08-06T19:13:11,Labastida,Basic services,electricity,-32.24,2548.95
buyer_8,Antonio,45,ES63209538933051215051,TRX_N-00086-282516182755,2020-08-06T16:52:52,Labastida,Basic services,internet,-56.73,2492.22
buyer_8,Antonio,45,ES63209538933051215051,TRX_N-00087-679393029301,2020-08-07T10:33:55,Labastida,Basic services,water,-72.2,2420.02
buyer_8,Antonio,45,ES63209538933051215051,TRX_N-00088-357782259707,2020-08-25T16:56:45,Labastida,Expense,transport,-159.16,2260.86
buyer_8,Antonio,45,ES63209538933051215051,TRX_N-00089-108981525008,2020-08-28T08:05:05,Labastida,Expense,transport,-76.46,2184.4
buyer_8,Antonio,45,ES63209538933051215051,TRX_N-00090-544102851558,2020-08-31T19:15:53,Labastida,Expense,transport,-102.64,2081.76
buyer_8,Antonio,45,ES63209538933051215051,TRX_N-00091-353670744689,2020-09-01T08:42:14,Labastida,transfer,Salary,2006.51,4088.27
buyer_8,Antonio,45,ES63209538933051215051,TRX_N-00092-547774687629,2020-09-05T16:06:16,Labastida,Housing,Mortgage,-979.0,3109.27
buyer_8,Antonio,45,ES63209538933051215051,TRX_N-00093-755710198786,2020-09-05T14:04:27,Labastida,Basic services,internet,-64.04,3045.23
buyer_8,Antonio,45,ES63209538933051215051,TRX_N-00094-658257242359,2020-09-05T11:47:51,Labastida,Basic services,phone,-84.25,2960.98
buyer_8,Antonio,45,ES63209538933051215051,TRX_N-00095-454095436459,2020-09-06T17:49:09,Labastida,Basic services,electricity,-87.01,2873.97
buyer_8,Antonio,45,ES63209538933051215051,TRX_N-00096-914899223393,2020-09-22T04:20:04,Labastida,Expense,transport,-160.19,2713.78
buyer_8,Antonio,45,ES63209538933051215051,TRX_N-00097-418264715059,2020-09-22T22:04:54,Labastida,Expense,gifts,-118.22,2595.56
buyer_8,Antonio,45,ES63209538933051215051,TRX_N-00098-685127055640,2020-09-28T15:18:28,Labastida,Expense,education,-888.69,1706.87
buyer_8,Antonio,45,ES63209538933051215051,TRX_N-00099-737379750671,2020-09-30T20:27:57,Labastida,Expense,food,-545.99,1160.88
buyer_8,Antonio,45,ES63209538933051215051,TRX_N-00100-224513203594,2020-10-01T17:09:30,Labastida,transfer,Salary,2006.51,3167.39
buyer_8,Antonio,45,ES63209538933051215051,TRX_N-00101-323628440398,2020-10-01T17:09:30,Labastida,transfer,Extra Income,200.65,3368.04
buyer_8,Antonio,45,ES63209538933051215051,TRX_N-00102-569840571673,2020-10-04T08:08:39,Bilbao,Expense,repairs,-950.94,2417.1
buyer_8,Antonio,45,ES63209538933051215051,TRX_N-00103-973097986198,2020-10-05T12:20:54,Labastida,Housing,Mortgage,-979.0,1438.1
buyer_8,Antonio,45,ES63209538933051215051,TRX_N-00104-947241489600,2020-10-05T08:50:18,Labastida,Basic services,electricity,-56.78,1381.32
buyer_8,Antonio,45,ES63209538933051215051,TRX_N-00105-540080289315,2020-10-05T13:18:27,Labastida,Basic services,phone,-90.72,1290.6
buyer_8,Antonio,45,ES63209538933051215051,TRX_N-00106-692264008841,2020-10-06T19:43:53,Labastida,Basic services,electricity,-125.78,1164.82
buyer_8,Antonio,45,ES63209538933051215051,TRX_N-00107-540033703303,2020-10-07T15:34:38,Labastida,Basic services,water,-36.7,1128.12
buyer_8,Antonio,45,ES63209538933051215051,TRX_N-00108-285456576862,2020-10-07T12:05:42,Labastida,Basic services,phone,-98.27,1029.85
buyer_8,Antonio,45,ES63209538933051215051,TRX_N-00109-462695428555,2020-10-08T16:15:15,Labastida,Expense,leisure,-32.35,997.5
buyer_8,Antonio,45,ES63209538933051215051,TRX_N-00110-624907679325,2020-10-12T13:47:56,Labastida,Expense,food,-655.94,341.56
buyer_8,Antonio,45,ES63209538933051215051,TRX_N-00111-729864418771,2020-10-23T09:26:26,Labastida,Expense,healthcare,-346.64,-5.08
buyer_8,Antonio,45,ES63209538933051215051,TRX_N-00112-377406131875,2020-10-25T00:10:04,Labastida,Expense,transport,-43.77,-48.85
buyer_8,Antonio,45,ES63209538933051215051,TRX_N-00113-459665645048,2020-11-01T19:52:28,Labastida,transfer,Salary,2006.51,1957.66
buyer_8,Antonio,45,ES63209538933051215051,TRX_N-00114-508572827200,2020-11-02T08:58:39,Labastida,Expense,gifts,-491.9,1465.76
buyer_8,Antonio,45,ES63209538933051215051,TRX_N-00115-117412909005,2020-11-03T18:21:12,Labastida,Expense,food,-557.9,907.86
buyer_8,Antonio,45,ES63209538933051215051,TRX_N-00116-812569376882,2020-11-05T13:01:30,Labastida,Housing,Mortgage,-979.0,-71.14
buyer_8,Antonio,45,ES63209538933051215051,TRX_N-00117-663881824707,2020-11-05T17:34:37,Labastida,Basic services,water,-43.06,-114.2
buyer_8,Antonio,45,ES63209538933051215051,TRX_N-00118-192033464556,2020-11-05T15:43:10,Labastida,Basic services,electricity,-59.85,-174.05
buyer_8,Antonio,45,ES63209538933051215051,TRX_N-00119-349290196411,2020-11-05T17:48:35,Labastida,Basic services,internet,-58.93,-232.98
buyer_8,Antonio,45,ES63209538933051215051,TRX_N-00120-756658070149,2020-11-05T17:36:26,Labastida,Basic services,phone,-76.87,-309.85
buyer_8,Antonio,45,ES63209538933051215051,TRX_N-00121-80373268531,2020-11-05T12:40:16,Elciego,Expense,leisure,-296.02,-605.87
buyer_8,Antonio,45,ES63209538933051215051,TRX_N-00122-443039692752,2020-11-06T09:48:49,Labastida,Basic services,water,-34.95,-640.82
buyer_8,Antonio,45,ES63209538933051215051,TRX_N-00123-420050708288,2020-11-06T13:27:58,Labastida,Basic services,electricity,-107.43,-748.25
buyer_8,Antonio,45,ES63209538933051215051,TRX_N-00124-756904736565,2020-11-06T14:26:43,Labastida,Basic services,gas,-26.68,-774.93
buyer_8,Antonio,45,ES63209538933051215051,TRX_N-00125-907573811791,2020-11-06T14:24:35,Getxo,Expense,transport,-173.6,-948.53
buyer_8,Antonio,45,ES63209538933051215051,TRX_N-00126-284862732810,2020-11-07T22:36:55,Labastida,Basic services,water,-12.01,-960.54
buyer_8,Antonio,45,ES63209538933051215051,TRX_N-00127-746852994852,2020-11-13T11:13:46,Labastida,Expense,food,-373.23,-1333.77
buyer_8,Antonio,45,ES63209538933051215051,TRX_N-00128-317255624044,2020-11-22T16:16:00,Labastida,Expense,healthcare,-236.33,-1570.1
buyer_8,Antonio,45,ES63209538933051215051,TRX_N-00129-697576349263,2020-11-22T01:56:55,Labastida,Expense,travel,-1751.91,-3322.01
buyer_8,Antonio,45,ES63209538933051215051,TRX_N-00130-153223151989,2020-12-01T16:33:33,Labastida,transfer,Salary,2006.51,-1315.5
buyer_8,Antonio,45,ES63209538933051215051,TRX_N-00131-635306742704,2020-12-01T16:33:33,Labastida,transfer,Bonus,1970.86,655.36
buyer_8,Antonio,45,ES63209538933051215051,TRX_N-00132-763848867460,2020-12-05T18:38:04,Labastida,Housing,Mortgage,-979.0,-323.64
buyer_8,Antonio,45,ES63209538933051215051,TRX_N-00133-194229888304,2020-12-05T13:43:42,Labastida,Basic services,phone,-82.42,-406.06
buyer_8,Antonio,45,ES63209538933051215051,TRX_N-00134-939521955573,2020-12-06T11:03:18,Labastida,Basic services,gas,-90.91,-496.97
buyer_8,Antonio,45,ES63209538933051215051,TRX_N-00135-240432159765,2020-12-06T16:41:38,Labastida,Basic services,internet,-74.0,-570.97
buyer_8,Antonio,45,ES63209538933051215051,TRX_N-00136-806934540335,2020-12-07T09:40:09,Labastida,Basic services,gas,-71.56,-642.53
buyer_8,Antonio,45,ES63209538933051215051,TRX_N-00137-513823120496,2020-12-07T01:38:24,Labastida,Basic services,phone,-63.4,-705.93
buyer_8,Antonio,45,ES63209538933051215051,TRX_N-00138-936574458495,2020-12-09T09:30:20,Labastida,Expense,gifts,-402.13,-1108.06
buyer_8,Antonio,45,ES63209538933051215051,TRX_N-00139-274214217856,2020-12-15T09:59:04,Labastida,Expense,food,-414.1,-1522.16
buyer_8,Antonio,45,ES63209538933051215051,TRX_N-00140-130656328914,2020-12-23T11:48:15,Labastida,Expense,food,-582.36,-2104.52
buyer_8,Antonio,45,ES63209538933051215051,TRX_N-00141-953604188386,2021-01-01T17:06:47,Labastida,transfer,Salary,2006.51,-98.01
buyer_8,Antonio,45,ES63209538933051215051,TRX_N-00142-802879830431,2021-01-01T17:06:47,Labastida,transfer,Extra Income,200.65,102.64
buyer_8,Antonio,45,ES63209538933051215051,TRX_N-00143-471596509077,2021-01-01T22:55:52,Labastida,Expense,clothing,-53.64,49.0
buyer_8,Antonio,45,ES63209538933051215051,TRX_N-00144-959295863500,2021-01-05T19:23:06,Labastida,Housing,Mortgage,-979.0,-930.0
buyer_8,Antonio,45,ES63209538933051215051,TRX_N-00145-152211456372,2021-01-05T20:39:57,Labastida,Basic services,electricity,-117.8,-1047.8
buyer_8,Antonio,45,ES63209538933051215051,TRX_N-00146-997242086180,2021-01-05T19:51:44,Labastida,Basic services,phone,-20.67,-1068.47
buyer_8,Antonio,45,ES63209538933051215051,TRX_N-00147-550764495531,2021-01-06T15:11:20,Labastida,Basic services,gas,-58.62,-1127.09
buyer_8,Antonio,45,ES63209538933051215051,TRX_N-00148-24105791379,2021-01-07T10:53:56,Labastida,Basic services,gas,-39.43,-1166.52
buyer_8,Antonio,45,ES63209538933051215051,TRX_N-00149-252085029927,2021-01-07T01:17:30,Labastida,Basic services,internet,-60.13,-1226.65
buyer_8,Antonio,45,ES63209538933051215051,TRX_N-00150-772393317061,2021-01-10T10:07:28,Labastida,Expense,education,-607.17,-1833.82
buyer_8,Antonio,45,ES63209538933051215051,TRX_N-00151-798142508685,2021-01-21T14:59:12,Labastida,Expense,clothing,-131.0,-1964.82
buyer_8,Antonio,45,ES63209538933051215051,TRX_N-00152-422073569058,2021-01-24T09:51:47,Labastida,Expense,healthcare,-87.34,-2052.16
buyer_8,Antonio,45,ES63209538933051215051,TRX_N-00153-51735464576,2021-02-01T12:37:41,Labastida,transfer,Salary,2006.51,-45.65
buyer_8,Antonio,45,ES63209538933051215051,TRX_N-00154-458592381418,2021-02-04T19:13:05,Labastida,Expense,leisure,-119.56,-165.21
buyer_8,Antonio,45,ES63209538933051215051,TRX_N-00155-562177981874,2021-02-05T10:31:35,Labastida,Housing,Mortgage,-979.0,-1144.21
buyer_8,Antonio,45,ES63209538933051215051,TRX_N-00156-79553126367,2021-02-05T12:38:59,Labastida,Basic services,electricity,-25.56,-1169.77
buyer_8,Antonio,45,ES63209538933051215051,TRX_N-00157-431929526983,2021-02-06T14:29:39,Labastida,Basic services,gas,-88.83,-1258.6
buyer_8,Antonio,45,ES63209538933051215051,TRX_N-00158-255798880651,2021-02-07T01:16:40,Labastida,Basic services,water,-60.03,-1318.63
buyer_8,Antonio,45,ES63209538933051215051,TRX_N-00159-506880477985,2021-02-07T16:39:19,Labastida,Basic services,electricity,-38.73,-1357.36
buyer_8,Antonio,45,ES63209538933051215051,TRX_N-00160-105646642356,2021-02-07T09:26:58,Labastida,Basic services,internet,-56.38,-1413.74
buyer_8,Antonio,45,ES63209538933051215051,TRX_N-00161-405231861728,2021-02-07T18:56:27,Labastida,Basic services,phone,-33.96,-1447.7
buyer_8,Antonio,45,ES63209538933051215051,TRX_N-00162-83767592432,2021-02-08T11:40:17,Labastida,Expense,transport,-174.59,-1622.29
buyer_8,Antonio,45,ES63209538933051215051,TRX_N-00163-315531675468,2021-02-23T17:11:08,Labastida,Expense,food,-135.09,-1757.38
buyer_8,Antonio,45,ES63209538933051215051,TRX_N-00164-626349935391,2021-02-24T13:23:05,Labastida,Expense,food,-433.26,-2190.64
buyer_8,Antonio,45,ES63209538933051215051,TRX_N-00165-525354600893,2021-03-01T08:28:19,Labastida,transfer,Salary,2006.51,-184.13
buyer_8,Antonio,45,ES63209538933051215051,TRX_N-00166-251807945571,2021-03-01T08:28:19,Labastida,transfer,Extra Income,200.65,16.52
buyer_8,Antonio,45,ES63209538933051215051,TRX_N-00167-197044596636,2021-03-04T08:18:50,Labastida,Expense,leisure,-227.11,-210.59
buyer_8,Antonio,45,ES63209538933051215051,TRX_N-00168-323806748883,2021-03-05T17:00:22,Labastida,Housing,Mortgage,-979.0,-1189.59
buyer_8,Antonio,45,ES63209538933051215051,TRX_N-00169-513653133653,2021-03-05T19:06:22,Labastida,Basic services,water,-75.17,-1264.76
buyer_8,Antonio,45,ES63209538933051215051,TRX_N-00170-877850511459,2021-03-05T20:18:57,Labastida,Basic services,internet,-79.57,-1344.33
buyer_8,Antonio,45,ES63209538933051215051,TRX_N-00171-667491061818,2021-03-05T15:14:00,Labastida,Basic services,phone,-52.69,-1397.02
buyer_8,Antonio,45,ES63209538933051215051,TRX_N-00172-935244533630,2021-03-06T21:38:32,Labastida,Basic services,water,-21.46,-1418.48
buyer_8,Antonio,45,ES63209538933051215051,TRX_N-00173-881612385083,2021-03-06T21:05:49,Labastida,Basic services,gas,-90.2,-1508.68
buyer_8,Antonio,45,ES63209538933051215051,TRX_N-00174-360036638813,2021-03-06T15:41:45,Labastida,Basic services,phone,-69.72,-1578.4
buyer_8,Antonio,45,ES63209538933051215051,TRX_N-00175-122124024055,2021-03-07T14:54:05,Labastida,Basic services,electricity,-95.03,-1673.43
buyer_8,Antonio,45,ES63209538933051215051,TRX_N-00176-261121144140,2021-03-08T09:12:03,Labastida,Expense,gifts,-473.11,-2146.54
buyer_8,Antonio,45,ES63209538933051215051,TRX_N-00177-310632794880,2021-03-11T10:07:07,Labastida,Expense,leisure,-215.99,-2362.53
buyer_8,Antonio,45,ES63209538933051215051,TRX_N-00178-141398015322,2021-03-18T08:57:26,Labastida,Expense,clothing,-249.2,-2611.73
buyer_8,Antonio,45,ES63209538933051215051,TRX_N-00179-78657749879,2021-03-25T11:26:20,Labastida,Expense,food,-516.07,-3127.8
buyer_8,Antonio,45,ES63209538933051215051,TRX_N-00180-147421625654,2021-03-30T08:06:45,Labastida,Expense,transport,-65.3,-3193.1
buyer_8,Antonio,45,ES63209538933051215051,TRX_N-00181-951638966320,2021-03-31T16:20:50,Amurrio,Expense,healthcare,-37.55,-3230.65
buyer_8,Antonio,45,ES63209538933051215051,TRX_N-00182-703368980898,2021-04-01T08:24:57,Labastida,transfer,Salary,2006.51,-1224.14
buyer_8,Antonio,45,ES63209538933051215051,TRX_N-00183-581240142697,2021-04-05T15:09:01,Labastida,Housing,Mortgage,-979.0,-2203.14
buyer_8,Antonio,45,ES63209538933051215051,TRX_N-00184-259061265258,2021-04-05T19:25:22,Labastida,Basic services,gas,-70.69,-2273.83
buyer_8,Antonio,45,ES63209538933051215051,TRX_N-00185-172291416693,2021-04-05T18:00:08,Labastida,Basic services,internet,-47.38,-2321.21
buyer_8,Antonio,45,ES63209538933051215051,TRX_N-00186-468748961213,2021-04-07T08:37:47,Labastida,Basic services,water,-12.6,-2333.81
buyer_8,Antonio,45,ES63209538933051215051,TRX_N-00187-497533994865,2021-04-07T03:58:26,Labastida,Basic services,electricity,-25.02,-2358.83
buyer_8,Antonio,45,ES63209538933051215051,TRX_N-00188-770458978021,2021-04-07T12:15:45,Labastida,Basic services,gas,-93.14,-2451.97
buyer_8,Antonio,45,ES63209538933051215051,TRX_N-00189-188404006085,2021-04-23T09:55:42,Labastida,Expense,transport,-166.52,-2618.49
buyer_8,Antonio,45,ES63209538933051215051,TRX_N-00190-247514915010,2021-04-24T13:53:13,Durango,Expense,food,-386.86,-3005.35
buyer_8,Antonio,45,ES63209538933051215051,TRX_N-00191-402364215413,2021-05-01T07:43:15,Labastida,transfer,Salary,2006.51,-998.84
buyer_8,Antonio,45,ES63209538933051215051,TRX_N-00192-610797755005,2021-05-01T07:43:15,Labastida,transfer,Extra Income,200.65,-798.19
buyer_8,Antonio,45,ES63209538933051215051,TRX_N-00193-166300818002,2021-05-05T09:24:42,Labastida,Housing,Mortgage,-979.0,-1777.19
buyer_8,Antonio,45,ES63209538933051215051,TRX_N-00194-587284151794,2021-05-05T11:56:31,Labastida,Basic services,internet,-71.62,-1848.81
buyer_8,Antonio,45,ES63209538933051215051,TRX_N-00195-554625119379,2021-05-06T22:41:10,Labastida,Basic services,gas,-70.51,-1919.32
buyer_8,Antonio,45,ES63209538933051215051,TRX_N-00196-494484633836,2021-05-06T20:54:13,Labastida,Basic services,phone,-60.06,-1979.38
buyer_8,Antonio,45,ES63209538933051215051,TRX_N-00197-959590271886,2021-05-07T14:30:10,Labastida,Basic services,electricity,-88.38,-2067.76
buyer_8,Antonio,45,ES63209538933051215051,TRX_N-00198-243614729624,2021-05-07T17:41:54,Labastida,Basic services,gas,-60.78,-2128.54
buyer_8,Antonio,45,ES63209538933051215051,TRX_N-00199-775669916399,2021-05-07T20:47:04,Labastida,Basic services,internet,-57.84,-2186.38
buyer_8,Antonio,45,ES63209538933051215051,TRX_N-00200-911834911900,2021-05-15T10:07:46,Labastida,Expense,clothing,-64.17,-2250.55
buyer_8,Antonio,45,ES63209538933051215051,TRX_N-00201-129391618522,2021-05-24T13:17:19,Labastida,Expense,gifts,-371.57,-2622.12
buyer_8,Antonio,45,ES63209538933051215051,TRX_N-00202-216106587993,2021-05-31T20:07:45,Labastida,Expense,transport,-45.92,-2668.04
buyer_8,Antonio,45,ES63209538933051215051,TRX_N-00203-345505106100,2021-06-01T04:21:11,Labastida,transfer,Salary,2006.51,-661.53
buyer_8,Antonio,45,ES63209538933051215051,TRX_N-00204-2910864405,2021-06-01T04:21:11,Labastida,transfer,Bonus,2197.25,1535.72
buyer_8,Antonio,45,ES63209538933051215051,TRX_N-00205-755216945504,2021-06-01T08:38:57,Labastida,Expense,transport,-186.3,1349.42
buyer_8,Antonio,45,ES63209538933051215051,TRX_N-00206-201148002372,2021-06-05T10:35:06,Labastida,Housing,Mortgage,-979.0,370.42
buyer_8,Antonio,45,ES63209538933051215051,TRX_N-00207-993176874057,2021-06-05T19:16:17,Labastida,Basic services,internet,-31.09,339.33
buyer_8,Antonio,45,ES63209538933051215051,TRX_N-00208-706928354774,2021-06-06T16:31:50,Labastida,Expense,transport,-126.66,212.67
buyer_8,Antonio,45,ES63209538933051215051,TRX_N-00209-906824662869,2021-06-10T20:59:32,Elciego,Expense,clothing,-74.73,137.94
buyer_8,Antonio,45,ES63209538933051215051,TRX_N-00210-846474017586,2021-06-13T15:46:32,Labastida,Expense,food,-177.37,-39.43
buyer_8,Antonio,45,ES63209538933051215051,TRX_N-00211-64927866121,2021-07-01T13:19:09,Labastida,transfer,Salary,2006.51,1967.08
buyer_8,Antonio,45,ES63209538933051215051,TRX_N-00212-89362520264,2021-07-01T13:19:09,Labastida,transfer,Extra Income,200.65,2167.73
buyer_8,Antonio,45,ES63209538933051215051,TRX_N-00213-241119920608,2021-07-05T08:12:12,Labastida,Housing,Mortgage,-979.0,1188.73
buyer_8,Antonio,45,ES63209538933051215051,TRX_N-00214-379957862647,2021-07-05T19:27:06,Labastida,Basic services,water,-78.9,1109.83
buyer_8,Antonio,45,ES63209538933051215051,TRX_N-00215-751031250211,2021-07-05T22:00:18,Labastida,Basic services,electricity,-122.03,987.8
buyer_8,Antonio,45,ES63209538933051215051,TRX_N-00216-722473176123,2021-07-06T11:32:51,Labastida,Basic services,electricity,-103.91,883.89
buyer_8,Antonio,45,ES63209538933051215051,TRX_N-00217-851817063942,2021-07-06T10:18:03,Labastida,Basic services,gas,-57.03,826.86
buyer_8,Antonio,45,ES63209538933051215051,TRX_N-00218-446251119711,2021-07-06T12:58:44,Labastida,Basic services,phone,-51.64,775.22
buyer_8,Antonio,45,ES63209538933051215051,TRX_N-00219-739871323288,2021-07-07T11:55:38,Labastida,Basic services,gas,-42.64,732.58
buyer_8,Antonio,45,ES63209538933051215051,TRX_N-00220-774705373178,2021-07-13T10:25:26,Salvatierra/Agurain,Expense,travel,-2662.95,-1930.37
buyer_8,Antonio,45,ES63209538933051215051,TRX_N-00221-757899115935,2021-07-15T15:07:31,Labastida,Expense,food,-344.27,-2274.64
buyer_8,Antonio,45,ES63209538933051215051,TRX_N-00222-12377631202,2021-07-27T14:02:58,Labastida,Expense,transport,-133.41,-2408.05
buyer_8,Antonio,45,ES63209538933051215051,TRX_N-00223-1670747999,2021-07-29T15:53:23,Labastida,Expense,transport,-162.12,-2570.17
buyer_8,Antonio,45,ES63209538933051215051,TRX_N-00224-573248848251,2021-07-30T20:19:24,Labastida,Expense,transport,-194.23,-2764.4
buyer_8,Antonio,45,ES63209538933051215051,TRX_N-00225-360341927210,2021-08-01T19:26:33,Labastida,transfer,Salary,2006.51,-757.89
buyer_8,Antonio,45,ES63209538933051215051,TRX_N-00226-75925714765,2021-08-05T12:00:04,Labastida,Housing,Mortgage,-979.0,-1736.89
buyer_8,Antonio,45,ES63209538933051215051,TRX_N-00227-525657640330,2021-08-05T18:58:48,Labastida,Basic services,electricity,-102.51,-1839.4
buyer_8,Antonio,45,ES63209538933051215051,TRX_N-00228-346435722853,2021-08-06T04:57:16,Labastida,Basic services,water,-52.38,-1891.78
buyer_8,Antonio,45,ES63209538933051215051,TRX_N-00229-342830409858,2021-08-06T08:22:34,Labastida,Basic services,electricity,-82.91,-1974.69
buyer_8,Antonio,45,ES63209538933051215051,TRX_N-00230-136618369254,2021-08-06T19:34:58,Labastida,Basic services,internet,-69.94,-2044.63
buyer_8,Antonio,45,ES63209538933051215051,TRX_N-00231-285590254870,2021-08-06T17:59:26,Labastida,Basic services,phone,-45.57,-2090.2
buyer_8,Antonio,45,ES63209538933051215051,TRX_N-00232-211185086902,2021-08-07T08:58:13,Labastida,Basic services,internet,-74.06,-2164.26
buyer_8,Antonio,45,ES63209538933051215051,TRX_N-00233-153044844927,2021-08-07T07:13:19,Labastida,Basic services,phone,-39.25,-2203.51
buyer_8,Antonio,45,ES63209538933051215051,TRX_N-00234-728819396027,2021-08-08T20:10:37,Labastida,Expense,clothing,-428.55,-2632.06
buyer_8,Antonio,45,ES63209538933051215051,TRX_N-00235-845765797250,2021-08-10T11:35:06,Labastida,Expense,leisure,-111.09,-2743.15
buyer_8,Antonio,45,ES63209538933051215051,TRX_N-00236-108963694143,2021-08-25T15:18:41,Labastida,Expense,food,-201.11,-2944.26
buyer_8,Antonio,45,ES63209538933051215051,TRX_N-00237-217793836032,2021-08-25T12:53:39,Labastida,Expense,healthcare,-353.06,-3297.32
buyer_8,Antonio,45,ES63209538933051215051,TRX_N-00238-773343988534,2021-08-26T16:38:55,Labastida,Expense,transport,-134.85,-3432.17
buyer_8,Antonio,45,ES63209538933051215051,TRX_N-00239-291144361993,2021-08-30T19:28:26,Galdakao,Expense,clothing,-449.97,-3882.14
buyer_8,Antonio,45,ES63209538933051215051,TRX_N-00240-672478387772,2021-09-01T08:29:56,Labastida,transfer,Salary,2006.51,-1875.63
buyer_8,Antonio,45,ES63209538933051215051,TRX_N-00241-212946725751,2021-09-01T08:29:56,Labastida,transfer,Extra Income,200.65,-1674.98
buyer_8,Antonio,45,ES63209538933051215051,TRX_N-00242-338613743041,2021-09-05T15:59:41,Labastida,Housing,Mortgage,-979.0,-2653.98
buyer_8,Antonio,45,ES63209538933051215051,TRX_N-00243-897505716487,2021-09-05T10:13:31,Labastida,Basic services,water,-21.46,-2675.44
buyer_8,Antonio,45,ES63209538933051215051,TRX_N-00244-400388763074,2021-09-05T23:17:49,Labastida,Basic services,internet,-35.03,-2710.47
buyer_8,Antonio,45,ES63209538933051215051,TRX_N-00245-116373511218,2021-09-06T21:53:37,Labastida,Basic services,water,-49.44,-2759.91
buyer_8,Antonio,45,ES63209538933051215051,TRX_N-00246-387510435885,2021-09-06T10:21:10,Labastida,Basic services,internet,-79.91,-2839.82
buyer_8,Antonio,45,ES63209538933051215051,TRX_N-00247-872938379698,2021-09-07T17:59:23,Labastida,Basic services,gas,-66.35,-2906.17
buyer_8,Antonio,45,ES63209538933051215051,TRX_N-00248-905627552018,2021-09-13T09:41:52,Labastida,Expense,travel,-2140.6,-5046.77
buyer_8,Antonio,45,ES63209538933051215051,TRX_N-00249-501223910956,2021-09-15T18:46:58,Labastida,Expense,transport,-194.67,-5241.44
buyer_8,Antonio,45,ES63209538933051215051,TRX_N-00250-151210746756,2021-09-18T13:35:22,Labastida,Expense,leisure,-298.42,-5539.86
buyer_8,Antonio,45,ES63209538933051215051,TRX_N-00251-573778212236,2021-09-21T08:14:01,Labastida,Expense,food,-727.73,-6267.59
buyer_8,Antonio,45,ES63209538933051215051,TRX_N-00252-606460773665,2021-10-01T21:42:19,Labastida,transfer,Salary,2006.51,-4261.08
buyer_8,Antonio,45,ES63209538933051215051,TRX_N-00253-803607956033,2021-10-05T13:51:43,Labastida,Housing,Mortgage,-979.0,-5240.08
buyer_8,Antonio,45,ES63209538933051215051,TRX_N-00254-491112784174,2021-10-05T10:29:13,Labastida,Basic services,water,-47.04,-5287.12
buyer_8,Antonio,45,ES63209538933051215051,TRX_N-00255-253293618396,2021-10-06T15:02:41,Labastida,Basic services,gas,-35.5,-5322.62
buyer_8,Antonio,45,ES63209538933051215051,TRX_N-00256-283633366142,2021-10-06T17:49:59,Labastida,Basic services,internet,-60.25,-5382.87
buyer_8,Antonio,45,ES63209538933051215051,TRX_N-00257-624879624890,2021-10-18T17:56:57,Labastida,Expense,food,-442.09,-5824.96
buyer_8,Antonio,45,ES63209538933051215051,TRX_N-00258-503928653150,2021-11-01T03:24:33,Labastida,transfer,Salary,2006.51,-3818.45
buyer_8,Antonio,45,ES63209538933051215051,TRX_N-00259-774231363149,2021-11-05T09:18:48,Labastida,Housing,Mortgage,-979.0,-4797.45
buyer_8,Antonio,45,ES63209538933051215051,TRX_N-00260-469051957954,2021-11-05T05:34:55,Labastida,Basic services,electricity,-56.09,-4853.54
buyer_8,Antonio,45,ES63209538933051215051,TRX_N-00261-150761405319,2021-11-06T18:52:01,Labastida,Basic services,electricity,-141.84,-4995.38
buyer_8,Antonio,45,ES63209538933051215051,TRX_N-00262-394732673799,2021-11-06T13:59:04,Labastida,Basic services,internet,-75.71,-5071.09
buyer_8,Antonio,45,ES63209538933051215051,TRX_N-00263-963982411290,2021-11-18T13:00:54,Labastida,Expense,food,-738.37,-5809.46
buyer_8,Antonio,45,ES63209538933051215051,TRX_N-00264-667441893704,2021-12-01T09:17:11,Labastida,transfer,Salary,2006.51,-3802.95
buyer_8,Antonio,45,ES63209538933051215051,TRX_N-00265-742250933827,2021-12-01T09:17:11,Labastida,transfer,Extra Income,200.65,-3602.3
buyer_8,Antonio,45,ES63209538933051215051,TRX_N-00266-268253122818,2021-12-01T09:17:11,Labastida,transfer,Bonus,1878.6,-1723.7
buyer_8,Antonio,45,ES63209538933051215051,TRX_N-00267-867129826239,2021-12-05T17:09:12,Labastida,Housing,Mortgage,-979.0,-2702.7
buyer_8,Antonio,45,ES63209538933051215051,TRX_N-00268-619604807989,2021-12-05T19:07:12,Labastida,Basic services,electricity,-148.94,-2851.64
buyer_8,Antonio,45,ES63209538933051215051,TRX_N-00269-443109620890,2021-12-06T10:09:53,Labastida,Basic services,electricity,-78.88,-2930.52
buyer_8,Antonio,45,ES63209538933051215051,TRX_N-00270-719361808241,2021-12-06T13:25:38,Labastida,Basic services,gas,-53.37,-2983.89
buyer_8,Antonio,45,ES63209538933051215051,TRX_N-00271-846251948009,2021-12-06T10:35:51,Labastida,Basic services,internet,-39.84,-3023.73
buyer_8,Antonio,45,ES63209538933051215051,TRX_N-00272-767472513798,2021-12-07T08:55:34,Labastida,Basic services,electricity,-135.22,-3158.95
buyer_8,Antonio,45,ES63209538933051215051,TRX_N-00273-208352407599,2021-12-07T00:26:29,Labastida,Basic services,gas,-98.03,-3256.98
buyer_8,Antonio,45,ES63209538933051215051,TRX_N-00274-91964553467,2021-12-10T19:44:24,Labastida,Expense,food,-316.67,-3573.65
buyer_8,Antonio,45,ES63209538933051215051,TRX_N-00275-338325915444,2022-01-01T19:36:18,Labastida,transfer,Salary,2006.51,-1567.14
buyer_8,Antonio,45,ES63209538933051215051,TRX_N-00276-113223170720,2022-01-05T14:23:31,Labastida,Housing,Mortgage,-979.0,-2546.14
buyer_8,Antonio,45,ES63209538933051215051,TRX_N-00277-831154453394,2022-01-05T18:12:28,Labastida,Basic services,electricity,-49.85,-2595.99
buyer_8,Antonio,45,ES63209538933051215051,TRX_N-00278-421785492476,2022-01-05T20:24:48,Labastida,Basic services,gas,-99.6,-2695.59
buyer_8,Antonio,45,ES63209538933051215051,TRX_N-00279-58375755415,2022-01-06T09:52:51,Labastida,Basic services,internet,-70.57,-2766.16
buyer_8,Antonio,45,ES63209538933051215051,TRX_N-00280-507029186159,2022-01-07T08:49:26,Labastida,Basic services,electricity,-118.62,-2884.78
buyer_8,Antonio,45,ES63209538933051215051,TRX_N-00281-911924825040,2022-01-07T23:42:26,Labastida,Basic services,internet,-45.58,-2930.36
buyer_8,Antonio,45,ES63209538933051215051,TRX_N-00282-255538876126,2022-01-09T15:59:46,Labastida,Expense,leisure,-233.69,-3164.05
buyer_8,Antonio,45,ES63209538933051215051,TRX_N-00283-149403915639,2022-01-12T22:32:50,Labastida,Expense,travel,-531.63,-3695.68
buyer_8,Antonio,45,ES63209538933051215051,TRX_N-00284-257693565139,2022-01-17T09:58:36,Labastida,Expense,transport,-80.26,-3775.94
buyer_8,Antonio,45,ES63209538933051215051,TRX_N-00285-172569873063,2022-01-21T20:05:04,Labastida,Expense,leisure,-83.19,-3859.13
buyer_8,Antonio,45,ES63209538933051215051,TRX_N-00286-473590897410,2022-02-01T12:03:41,Labastida,transfer,Salary,2006.51,-1852.62
buyer_8,Antonio,45,ES63209538933051215051,TRX_N-00287-838711592130,2022-02-05T10:12:43,Labastida,Housing,Mortgage,-979.0,-2831.62
buyer_8,Antonio,45,ES63209538933051215051,TRX_N-00288-50625999093,2022-02-05T19:22:21,Labastida,Basic services,water,-31.28,-2862.9
buyer_8,Antonio,45,ES63209538933051215051,TRX_N-00289-753738631043,2022-02-05T14:40:43,Labastida,Basic services,electricity,-46.21,-2909.11
buyer_8,Antonio,45,ES63209538933051215051,TRX_N-00290-662968283131,2022-02-05T17:36:00,Labastida,Basic services,internet,-36.58,-2945.69
buyer_8,Antonio,45,ES63209538933051215051,TRX_N-00291-28942182336,2022-02-06T17:53:35,Labastida,Basic services,water,-78.15,-3023.84
buyer_8,Antonio,45,ES63209538933051215051,TRX_N-00292-760479682458,2022-02-06T23:05:31,Labastida,Basic services,gas,-39.65,-3063.49
buyer_8,Antonio,45,ES63209538933051215051,TRX_N-00293-998016351960,2022-02-06T09:37:10,Labastida,Basic services,internet,-66.63,-3130.12
buyer_8,Antonio,45,ES63209538933051215051,TRX_N-00294-498789330305,2022-02-07T09:24:25,Labastida,Basic services,internet,-32.47,-3162.59
buyer_8,Antonio,45,ES63209538933051215051,TRX_N-00295-539152214787,2022-02-07T16:02:28,Labastida,Basic services,phone,-76.27,-3238.86
buyer_8,Antonio,45,ES63209538933051215051,TRX_N-00296-152745924921,2022-02-09T15:50:00,Labastida,Expense,leisure,-88.49,-3327.35
buyer_8,Antonio,45,ES63209538933051215051,TRX_N-00297-31626752722,2022-02-10T08:44:30,Labastida,Expense,healthcare,-164.01,-3491.36
buyer_8,Antonio,45,ES63209538933051215051,TRX_N-00298-57492557894,2022-02-11T17:48:27,Labastida,Expense,healthcare,-270.05,-3761.41
buyer_8,Antonio,45,ES63209538933051215051,TRX_N-00299-489978572676,2022-03-01T10:18:02,Labastida,transfer,Salary,2006.51,-1754.9
buyer_8,Antonio,45,ES63209538933051215051,TRX_N-00300-871501644864,2022-03-01T10:18:02,Labastida,transfer,Extra Income,200.65,-1554.25
buyer_8,Antonio,45,ES63209538933051215051,TRX_N-00301-494852943696,2022-03-01T20:04:43,Donostia,Expense,education,-141.73,-1695.98
buyer_8,Antonio,45,ES63209538933051215051,TRX_N-00302-413407975469,2022-03-05T14:35:56,Labastida,Housing,Mortgage,-979.0,-2674.98
buyer_8,Antonio,45,ES63209538933051215051,TRX_N-00303-494471129887,2022-03-05T19:06:44,Labastida,Basic services,gas,-31.47,-2706.45
buyer_8,Antonio,45,ES63209538933051215051,TRX_N-00304-670845045172,2022-03-05T14:26:22,Labastida,Basic services,internet,-39.72,-2746.17
buyer_8,Antonio,45,ES63209538933051215051,TRX_N-00305-619742579755,2022-03-05T08:44:15,Labastida,Basic services,phone,-94.54,-2840.71
buyer_8,Antonio,45,ES63209538933051215051,TRX_N-00306-521906314118,2022-03-06T20:58:09,Labastida,Basic services,electricity,-69.71,-2910.42
buyer_8,Antonio,45,ES63209538933051215051,TRX_N-00307-187729520001,2022-03-06T16:23:14,Labastida,Basic services,gas,-18.1,-2928.52
buyer_8,Antonio,45,ES63209538933051215051,TRX_N-00308-735161442297,2022-03-07T22:01:06,Labastida,Basic services,internet,-46.84,-2975.36
buyer_8,Antonio,45,ES63209538933051215051,TRX_N-00309-218508387831,2022-03-13T12:04:24,Hernani,Expense,transport,-99.44,-3074.8
buyer_8,Antonio,45,ES63209538933051215051,TRX_N-00310-305983329766,2022-03-18T16:54:31,Labastida,Expense,healthcare,-89.6,-3164.4
buyer_8,Antonio,45,ES63209538933051215051,TRX_N-00311-41744847609,2022-03-19T11:17:54,Labastida,Expense,healthcare,-261.27,-3425.67
buyer_8,Antonio,45,ES63209538933051215051,TRX_N-00312-114895101978,2022-03-22T20:06:46,Labastida,Expense,transport,-122.47,-3548.14
buyer_8,Antonio,45,ES63209538933051215051,TRX_N-00313-9907667129,2022-04-01T18:08:22,Labastida,transfer,Salary,2006.51,-1541.63
buyer_8,Antonio,45,ES63209538933051215051,TRX_N-00314-563742758552,2022-04-05T12:10:03,Labastida,Housing,Mortgage,-979.0,-2520.63
buyer_8,Antonio,45,ES63209538933051215051,TRX_N-00315-258378810104,2022-04-05T15:54:29,Labastida,Basic services,water,-66.89,-2587.52
buyer_8,Antonio,45,ES63209538933051215051,TRX_N-00316-978975821663,2022-04-05T20:38:59,Labastida,Basic services,phone,-37.09,-2624.61
buyer_8,Antonio,45,ES63209538933051215051,TRX_N-00317-605782896122,2022-04-06T11:31:27,Labastida,Basic services,internet,-55.71,-2680.32
buyer_8,Antonio,45,ES63209538933051215051,TRX_N-00318-574752518649,2022-04-06T11:15:01,Labastida,Expense,gifts,-220.79,-2901.11
buyer_8,Antonio,45,ES63209538933051215051,TRX_N-00319-221861818866,2022-04-07T22:34:06,Labastida,Basic services,phone,-49.63,-2950.74
buyer_8,Antonio,45,ES63209538933051215051,TRX_N-00320-987668968868,2022-04-11T20:22:53,Labastida,Expense,clothing,-499.5,-3450.24
buyer_8,Antonio,45,ES63209538933051215051,TRX_N-00321-814086937214,2022-05-01T11:26:10,Labastida,transfer,Salary,2006.51,-1443.73
buyer_8,Antonio,45,ES63209538933051215051,TRX_N-00322-951662477690,2022-05-01T20:36:07,Berango,Expense,transport,-183.45,-1627.18
buyer_8,Antonio,45,ES63209538933051215051,TRX_N-00323-883771434635,2022-05-03T15:24:44,Donostia,Expense,clothing,-361.39,-1988.57
buyer_8,Antonio,45,ES63209538933051215051,TRX_N-00324-496897447439,2022-05-05T14:59:29,Labastida,Housing,Mortgage,-979.0,-2967.57
buyer_8,Antonio,45,ES63209538933051215051,TRX_N-00325-853312790008,2022-05-05T12:03:51,Labastida,Basic services,electricity,-44.91,-3012.48
buyer_8,Antonio,45,ES63209538933051215051,TRX_N-00326-783715822965,2022-05-05T12:38:20,Labastida,Basic services,gas,-62.31,-3074.79
buyer_8,Antonio,45,ES63209538933051215051,TRX_N-00327-589846760452,2022-05-05T17:46:23,Labastida,Basic services,internet,-59.22,-3134.01
buyer_8,Antonio,45,ES63209538933051215051,TRX_N-00328-913668419266,2022-05-05T09:46:49,Labastida,Basic services,phone,-40.08,-3174.09
buyer_8,Antonio,45,ES63209538933051215051,TRX_N-00329-215893596982,2022-05-06T10:18:32,Labastida,Basic services,water,-42.6,-3216.69
buyer_8,Antonio,45,ES63209538933051215051,TRX_N-00330-344775016151,2022-05-06T10:42:50,Labastida,Basic services,gas,-52.72,-3269.41
buyer_8,Antonio,45,ES63209538933051215051,TRX_N-00331-430424271989,2022-05-07T17:47:25,Labastida,Basic services,water,-40.94,-3310.35
buyer_8,Antonio,45,ES63209538933051215051,TRX_N-00332-238953730506,2022-05-07T08:18:36,Labastida,Basic services,phone,-58.39,-3368.74
buyer_8,Antonio,45,ES63209538933051215051,TRX_N-00333-800374144207,2022-05-16T16:16:13,Labastida,Expense,healthcare,-332.16,-3700.9
buyer_8,Antonio,45,ES63209538933051215051,TRX_N-00334-521581177026,2022-06-01T11:45:07,Labastida,transfer,Salary,2006.51,-1694.39
buyer_8,Antonio,45,ES63209538933051215051,TRX_N-00335-118322448018,2022-06-01T11:45:07,Labastida,transfer,Extra Income,200.65,-1493.74
buyer_8,Antonio,45,ES63209538933051215051,TRX_N-00336-976397764932,2022-06-01T11:45:07,Labastida,transfer,Bonus,1980.27,486.53
buyer_8,Antonio,45,ES63209538933051215051,TRX_N-00337-895915031085,2022-06-05T12:51:55,Labastida,Housing,Mortgage,-979.0,-492.47
buyer_8,Antonio,45,ES63209538933051215051,TRX_N-00338-502263397522,2022-06-05T10:30:47,Labastida,Basic services,electricity,-91.8,-584.27
buyer_8,Antonio,45,ES63209538933051215051,TRX_N-00339-90132192194,2022-06-05T15:34:34,Labastida,Basic services,internet,-38.23,-622.5
buyer_8,Antonio,45,ES63209538933051215051,TRX_N-00340-224220928774,2022-06-06T17:25:52,Labastida,Basic services,gas,-91.61,-714.11
buyer_8,Antonio,45,ES63209538933051215051,TRX_N-00341-731594995772,2022-06-06T11:50:58,Labastida,Basic services,internet,-34.82,-748.93
buyer_8,Antonio,45,ES63209538933051215051,TRX_N-00342-699652118576,2022-06-07T11:41:53,Labastida,Basic services,internet,-52.95,-801.88
buyer_8,Antonio,45,ES63209538933051215051,TRX_N-00343-160451893110,2022-06-15T15:44:35,Sestao,Expense,food,-768.27,-1570.15
buyer_8,Antonio,45,ES63209538933051215051,TRX_N-00344-377829090573,2022-06-18T15:05:39,Labastida,Expense,food,-399.6,-1969.75
buyer_8,Antonio,45,ES63209538933051215051,TRX_N-00345-813875305045,2022-06-25T08:58:36,Labastida,Expense,education,-201.01,-2170.76
buyer_8,Antonio,45,ES63209538933051215051,TRX_N-00346-327409685871,2022-06-27T10:37:55,Getxo,Expense,leisure,-216.96,-2387.72
buyer_8,Antonio,45,ES63209538933051215051,TRX_N-00347-545365210798,2022-07-01T15:02:56,Labastida,transfer,Salary,2006.51,-381.21
buyer_8,Antonio,45,ES63209538933051215051,TRX_N-00348-879364902300,2022-07-03T17:16:11,Labastida,Expense,transport,-72.32,-453.53
buyer_8,Antonio,45,ES63209538933051215051,TRX_N-00349-934677675561,2022-07-05T14:17:32,Labastida,Housing,Mortgage,-979.0,-1432.53
buyer_8,Antonio,45,ES63209538933051215051,TRX_N-00350-774837644565,2022-07-05T15:00:51,Labastida,Basic services,phone,-26.33,-1458.86
buyer_8,Antonio,45,ES63209538933051215051,TRX_N-00351-546069741197,2022-07-06T19:27:40,Labastida,Basic services,internet,-67.2,-1526.06
buyer_8,Antonio,45,ES63209538933051215051,TRX_N-00352-762207550855,2022-07-06T09:39:06,Labastida,Basic services,phone,-99.29,-1625.35
buyer_8,Antonio,45,ES63209538933051215051,TRX_N-00353-941348953649,2022-07-07T12:31:35,Labastida,Basic services,water,-78.09,-1703.44
buyer_8,Antonio,45,ES63209538933051215051,TRX_N-00354-230300745711,2022-07-07T16:47:51,Labastida,Basic services,gas,-18.95,-1722.39
buyer_8,Antonio,45,ES63209538933051215051,TRX_N-00355-909995762324,2022-07-07T16:16:20,Labastida,Basic services,phone,-48.58,-1770.97
buyer_8,Antonio,45,ES63209538933051215051,TRX_N-00356-964690849518,2022-07-16T08:38:18,Labastida,Expense,clothing,-451.74,-2222.71
buyer_8,Antonio,45,ES63209538933051215051,TRX_N-00357-116631633827,2022-07-21T20:16:07,Bermeo,Expense,transport,-95.29,-2318.0
buyer_8,Antonio,45,ES63209538933051215051,TRX_N-00358-878827757314,2022-08-01T11:16:28,Labastida,transfer,Salary,2006.51,-311.49
buyer_8,Antonio,45,ES63209538933051215051,TRX_N-00359-569110356408,2022-08-04T09:28:51,Irun,Expense,transport,-55.19,-366.68
buyer_8,Antonio,45,ES63209538933051215051,TRX_N-00360-194146172789,2022-08-05T10:08:33,Labastida,Housing,Mortgage,-979.0,-1345.68
buyer_8,Antonio,45,ES63209538933051215051,TRX_N-00361-23632767026,2022-08-05T13:17:39,Labastida,Basic services,water,-10.97,-1356.65
buyer_8,Antonio,45,ES63209538933051215051,TRX_N-00362-917917081283,2022-08-05T11:45:09,Labastida,Basic services,gas,-68.11,-1424.76
buyer_8,Antonio,45,ES63209538933051215051,TRX_N-00363-512583392719,2022-08-07T12:15:52,Labastida,Basic services,water,-18.62,-1443.38
buyer_8,Antonio,45,ES63209538933051215051,TRX_N-00364-589726690488,2022-08-07T21:02:51,Labastida,Basic services,gas,-61.32,-1504.7
buyer_8,Antonio,45,ES63209538933051215051,TRX_N-00365-548718507664,2022-08-07T03:45:34,Labastida,Basic services,internet,-62.73,-1567.43
buyer_8,Antonio,45,ES63209538933051215051,TRX_N-00366-431611319158,2022-08-15T20:58:49,Labastida,Expense,healthcare,-193.74,-1761.17
buyer_8,Antonio,45,ES63209538933051215051,TRX_N-00367-714048576265,2022-08-30T18:02:22,Labastida,Expense,repairs,-220.18,-1981.35
buyer_8,Antonio,45,ES63209538933051215051,TRX_N-00368-382133788547,2022-09-01T11:14:01,Labastida,transfer,Salary,2006.51,25.16
buyer_8,Antonio,45,ES63209538933051215051,TRX_N-00369-386192440030,2022-09-01T11:14:01,Labastida,transfer,Extra Income,200.65,225.81
buyer_8,Antonio,45,ES63209538933051215051,TRX_N-00370-659903936802,2022-09-05T10:49:26,Labastida,Housing,Mortgage,-979.0,-753.19
buyer_8,Antonio,45,ES63209538933051215051,TRX_N-00371-870555213032,2022-09-05T09:05:01,Labastida,Basic services,water,-11.35,-764.54
buyer_8,Antonio,45,ES63209538933051215051,TRX_N-00372-409438792143,2022-09-05T04:06:54,Labastida,Basic services,internet,-60.87,-825.41
buyer_8,Antonio,45,ES63209538933051215051,TRX_N-00373-756477607064,2022-09-06T08:46:52,Labastida,Basic services,internet,-57.51,-882.92
buyer_8,Antonio,45,ES63209538933051215051,TRX_N-00374-191829966711,2022-09-07T19:50:46,Labastida,Basic services,internet,-41.86,-924.78
buyer_8,Antonio,45,ES63209538933051215051,TRX_N-00375-443040559926,2022-09-08T11:48:41,Labastida,Expense,education,-200.71,-1125.49
buyer_8,Antonio,45,ES63209538933051215051,TRX_N-00376-696457887342,2022-09-22T18:49:36,Labastida,Expense,food,-429.73,-1555.22
buyer_8,Antonio,45,ES63209538933051215051,TRX_N-00377-352074562215,2022-10-01T14:35:27,Labastida,transfer,Salary,2006.51,451.29
buyer_8,Antonio,45,ES63209538933051215051,TRX_N-00378-891063786142,2022-10-05T11:09:15,Labastida,Housing,Mortgage,-979.0,-527.71
buyer_8,Antonio,45,ES63209538933051215051,TRX_N-00379-125340667325,2022-10-05T12:11:31,Labastida,Basic services,electricity,-110.68,-638.39
buyer_8,Antonio,45,ES63209538933051215051,TRX_N-00380-208602575826,2022-10-05T12:41:10,Labastida,Basic services,gas,-17.65,-656.04
buyer_8,Antonio,45,ES63209538933051215051,TRX_N-00381-552996108551,2022-10-05T18:50:49,Labastida,Basic services,phone,-86.73,-742.77
buyer_8,Antonio,45,ES63209538933051215051,TRX_N-00382-470223047729,2022-10-07T11:12:17,Labastida,Basic services,gas,-66.63,-809.4
buyer_8,Antonio,45,ES63209538933051215051,TRX_N-00383-693663839248,2022-10-07T14:10:46,Labastida,Basic services,internet,-48.94,-858.34
buyer_8,Antonio,45,ES63209538933051215051,TRX_N-00384-987168809795,2022-10-21T09:48:58,Labastida,Expense,leisure,-246.39,-1104.73
buyer_8,Antonio,45,ES63209538933051215051,TRX_N-00385-253629248005,2022-10-23T13:24:28,Labastida,Expense,food,-224.35,-1329.08
buyer_8,Antonio,45,ES63209538933051215051,TRX_N-00386-627464369796,2022-11-01T13:54:56,Labastida,transfer,Salary,2006.51,677.43
buyer_8,Antonio,45,ES63209538933051215051,TRX_N-00387-873496226329,2022-11-01T13:54:56,Labastida,transfer,Extra Income,200.65,878.08
buyer_8,Antonio,45,ES63209538933051215051,TRX_N-00388-777314247974,2022-11-05T16:28:27,Labastida,Housing,Mortgage,-979.0,-100.92
buyer_8,Antonio,45,ES63209538933051215051,TRX_N-00389-343872869199,2022-11-05T16:16:55,Labastida,Basic services,gas,-63.74,-164.66
buyer_8,Antonio,45,ES63209538933051215051,TRX_N-00390-968030362536,2022-11-05T20:20:34,Labastida,Basic services,phone,-41.04,-205.7
buyer_8,Antonio,45,ES63209538933051215051,TRX_N-00391-861410905785,2022-11-06T11:45:43,Labastida,Basic services,electricity,-137.62,-343.32
buyer_8,Antonio,45,ES63209538933051215051,TRX_N-00392-594392064300,2022-11-06T14:39:48,Labastida,Basic services,gas,-49.01,-392.33
buyer_8,Antonio,45,ES63209538933051215051,TRX_N-00393-224644431991,2022-11-07T15:57:19,Labastida,Basic services,electricity,-145.3,-537.63
buyer_8,Antonio,45,ES63209538933051215051,TRX_N-00394-482223317369,2022-11-07T15:43:02,Labastida,Basic services,gas,-35.13,-572.76
buyer_8,Antonio,45,ES63209538933051215051,TRX_N-00395-41603460309,2022-11-07T10:14:35,Labastida,Basic services,phone,-73.0,-645.76
buyer_8,Antonio,45,ES63209538933051215051,TRX_N-00396-346568667705,2022-11-17T14:59:35,Labastida,Expense,food,-707.25,-1353.01
buyer_8,Antonio,45,ES63209538933051215051,TRX_N-00397-40277536977,2022-11-20T05:20:50,Mungia,Expense,food,-739.47,-2092.48
buyer_8,Antonio,45,ES63209538933051215051,TRX_N-00398-721005696921,2022-12-01T11:49:37,Labastida,transfer,Salary,2006.51,-85.97
buyer_8,Antonio,45,ES63209538933051215051,TRX_N-00399-370813516538,2022-12-01T11:49:37,Labastida,transfer,Bonus,2113.67,2027.7
buyer_8,Antonio,45,ES63209538933051215051,TRX_N-00400-774106116986,2022-12-05T16:36:05,Labastida,Housing,Mortgage,-979.0,1048.7
buyer_8,Antonio,45,ES63209538933051215051,TRX_N-00401-756458999592,2022-12-05T00:35:44,Labastida,Basic services,water,-55.66,993.04
buyer_8,Antonio,45,ES63209538933051215051,TRX_N-00402-327144635277,2022-12-05T12:29:27,Labastida,Basic services,electricity,-109.66,883.38
buyer_8,Antonio,45,ES63209538933051215051,TRX_N-00403-526570419705,2022-12-05T08:51:40,Labastida,Basic services,phone,-52.8,830.58
buyer_8,Antonio,45,ES63209538933051215051,TRX_N-00404-330781218061,2022-12-06T17:29:29,Labastida,Basic services,gas,-96.52,734.06
buyer_8,Antonio,45,ES63209538933051215051,TRX_N-00405-919814917207,2022-12-07T13:23:25,Labastida,Basic services,phone,-38.49,695.57
buyer_8,Antonio,45,ES63209538933051215051,TRX_N-00406-812629084192,2022-12-07T02:33:11,Labastida,Expense,leisure,-295.91,399.66
buyer_8,Antonio,45,ES63209538933051215051,TRX_N-00407-492901617124,2022-12-21T14:14:44,Labastida,Expense,transport,-141.32,258.34
buyer_8,Antonio,45,ES63209538933051215051,TRX_N-00408-778032484781,2023-01-01T13:20:47,Labastida,transfer,Salary,2006.51,2264.85
buyer_8,Antonio,45,ES63209538933051215051,TRX_N-00409-307131508918,2023-01-01T13:20:47,Labastida,transfer,Extra Income,200.65,2465.5
buyer_8,Antonio,45,ES63209538933051215051,TRX_N-00410-757714820317,2023-01-02T08:32:11,Labastida,Expense,transport,-181.85,2283.65
buyer_8,Antonio,45,ES63209538933051215051,TRX_N-00411-419855519700,2023-01-04T15:57:33,Labastida,Expense,clothing,-192.54,2091.11
buyer_8,Antonio,45,ES63209538933051215051,TRX_N-00412-580332864024,2023-01-05T16:27:39,Labastida,Housing,Mortgage,-979.0,1112.11
buyer_8,Antonio,45,ES63209538933051215051,TRX_N-00413-50107525540,2023-01-05T01:28:18,Labastida,Basic services,electricity,-75.39,1036.72
buyer_8,Antonio,45,ES63209538933051215051,TRX_N-00414-371358002270,2023-01-05T11:49:49,Labastida,Basic services,gas,-34.79,1001.93
buyer_8,Antonio,45,ES63209538933051215051,TRX_N-00415-423844912268,2023-01-06T16:21:23,Labastida,Basic services,internet,-62.2,939.73
buyer_8,Antonio,45,ES63209538933051215051,TRX_N-00416-107218714721,2023-01-25T15:55:45,Labastida,Expense,food,-239.67,700.06
buyer_8,Antonio,45,ES63209538933051215051,TRX_N-00417-618649000756,2023-02-01T13:32:37,Labastida,transfer,Salary,2006.51,2706.57
buyer_8,Antonio,45,ES63209538933051215051,TRX_N-00418-373418772153,2023-02-05T15:18:02,Labastida,Housing,Mortgage,-979.0,1727.57
buyer_8,Antonio,45,ES63209538933051215051,TRX_N-00419-32144950063,2023-02-05T19:58:41,Labastida,Basic services,water,-68.82,1658.75
buyer_8,Antonio,45,ES63209538933051215051,TRX_N-00420-880241665665,2023-02-05T20:22:13,Labastida,Basic services,internet,-58.03,1600.72
buyer_8,Antonio,45,ES63209538933051215051,TRX_N-00421-996040794483,2023-02-27T12:52:03,Labastida,Expense,appliances,-1595.08,5.64
buyer_8,Antonio,45,ES63209538933051215051,TRX_N-00422-287149001112,2023-03-01T18:07:31,Labastida,transfer,Salary,2006.51,2012.15
buyer_8,Antonio,45,ES63209538933051215051,TRX_N-00423-440672843340,2023-03-01T18:07:31,Labastida,transfer,Extra Income,200.65,2212.8
buyer_8,Antonio,45,ES63209538933051215051,TRX_N-00424-52597686192,2023-03-04T12:10:00,Galdakao,Expense,healthcare,-238.65,1974.15
buyer_8,Antonio,45,ES63209538933051215051,TRX_N-00425-138159013122,2023-03-05T00:44:32,Labastida,Housing,Mortgage,-979.0,995.15
buyer_8,Antonio,45,ES63209538933051215051,TRX_N-00426-956903473413,2023-03-05T08:05:12,Labastida,Basic services,electricity,-110.56,884.59
buyer_8,Antonio,45,ES63209538933051215051,TRX_N-00427-473567621737,2023-03-05T23:03:50,Labastida,Basic services,internet,-61.92,822.67
buyer_8,Antonio,45,ES63209538933051215051,TRX_N-00428-174367160090,2023-03-06T17:41:56,Labastida,Basic services,gas,-17.01,805.66
buyer_8,Antonio,45,ES63209538933051215051,TRX_N-00429-332403159211,2023-03-06T10:24:00,Labastida,Basic services,internet,-64.45,741.21
buyer_8,Antonio,45,ES63209538933051215051,TRX_N-00430-998720864218,2023-03-06T17:41:54,Labastida,Basic services,phone,-51.3,689.91
buyer_8,Antonio,45,ES63209538933051215051,TRX_N-00431-633762685781,2023-03-06T21:40:01,Labastida,Expense,healthcare,-78.03,611.88
buyer_8,Antonio,45,ES63209538933051215051,TRX_N-00432-100867077804,2023-03-07T17:11:23,Labastida,Basic services,water,-74.6,537.28
buyer_8,Antonio,45,ES63209538933051215051,TRX_N-00433-569733890092,2023-03-07T13:43:18,Labastida,Basic services,gas,-70.01,467.27
buyer_8,Antonio,45,ES63209538933051215051,TRX_N-00434-235769950393,2023-03-07T11:11:39,Labastida,Basic services,internet,-31.08,436.19
buyer_8,Antonio,45,ES63209538933051215051,TRX_N-00435-520761973776,2023-03-07T09:00:30,Labastida,Basic services,phone,-35.27,400.92
buyer_8,Antonio,45,ES63209538933051215051,TRX_N-00436-229265832637,2023-03-16T11:43:09,Labastida,Expense,food,-641.04,-240.12
buyer_8,Antonio,45,ES63209538933051215051,TRX_N-00437-812333049968,2023-03-21T09:49:41,Labastida,Expense,gifts,-190.97,-431.09
buyer_8,Antonio,45,ES63209538933051215051,TRX_N-00438-334175850723,2023-03-22T08:01:53,Labastida,Expense,transport,-162.28,-593.37
buyer_8,Antonio,45,ES63209538933051215051,TRX_N-00439-870378042178,2023-03-24T21:18:32,Labastida,Expense,transport,-89.14,-682.51
buyer_8,Antonio,45,ES63209538933051215051,TRX_N-00440-566378340735,2023-04-01T21:23:35,Labastida,transfer,Salary,2006.51,1324.0
buyer_8,Antonio,45,ES63209538933051215051,TRX_N-00441-547277587964,2023-04-05T14:11:51,Labastida,Housing,Mortgage,-979.0,345.0
buyer_8,Antonio,45,ES63209538933051215051,TRX_N-00442-947900585654,2023-04-06T17:00:24,Labastida,Basic services,water,-12.44,332.56
buyer_8,Antonio,45,ES63209538933051215051,TRX_N-00443-635685257251,2023-04-06T11:44:35,Labastida,Basic services,gas,-78.1,254.46
buyer_8,Antonio,45,ES63209538933051215051,TRX_N-00444-803977751315,2023-04-06T09:02:25,Labastida,Basic services,internet,-66.57,187.89
buyer_8,Antonio,45,ES63209538933051215051,TRX_N-00445-600480194765,2023-04-06T09:40:33,Labastida,Expense,transport,-118.78,69.11
buyer_8,Antonio,45,ES63209538933051215051,TRX_N-00446-917251985185,2023-04-06T08:23:36,Labastida,Expense,clothing,-456.13,-387.02
buyer_8,Antonio,45,ES63209538933051215051,TRX_N-00447-70420700908,2023-04-07T10:35:52,Labastida,Basic services,electricity,-31.75,-418.77
buyer_8,Antonio,45,ES63209538933051215051,TRX_N-00448-917053225084,2023-04-09T08:14:37,Irun,Expense,transport,-144.4,-563.17
buyer_8,Antonio,45,ES63209538933051215051,TRX_N-00449-536067439501,2023-04-13T17:06:50,Labastida,Expense,food,-737.71,-1300.88
buyer_8,Antonio,45,ES63209538933051215051,TRX_N-00450-829530771768,2023-04-15T08:36:49,Labastida,Expense,transport,-169.04,-1469.92
buyer_8,Antonio,45,ES63209538933051215051,TRX_N-00451-681945226861,2023-04-22T14:14:32,Erandio,Expense,food,-388.51,-1858.43
buyer_8,Antonio,45,ES63209538933051215051,TRX_N-00452-204148474337,2023-04-24T17:49:48,Labastida,Expense,leisure,-45.94,-1904.37
buyer_8,Antonio,45,ES63209538933051215051,TRX_N-00453-15892346984,2023-05-01T16:11:25,Labastida,transfer,Salary,2006.51,102.14
buyer_8,Antonio,45,ES63209538933051215051,TRX_N-00454-875602745973,2023-05-01T16:11:25,Labastida,transfer,Extra Income,200.65,302.79
buyer_8,Antonio,45,ES63209538933051215051,TRX_N-00455-831736108962,2023-05-05T20:21:28,Labastida,Housing,Mortgage,-979.0,-676.21
buyer_8,Antonio,45,ES63209538933051215051,TRX_N-00456-128639626854,2023-05-05T20:13:08,Labastida,Basic services,gas,-35.22,-711.43
buyer_8,Antonio,45,ES63209538933051215051,TRX_N-00457-218148775059,2023-05-05T09:37:52,Labastida,Basic services,internet,-32.24,-743.67
buyer_8,Antonio,45,ES63209538933051215051,TRX_N-00458-469267277031,2023-05-06T15:33:13,Labastida,Basic services,gas,-69.5,-813.17
buyer_8,Antonio,45,ES63209538933051215051,TRX_N-00459-561624624132,2023-05-06T13:23:33,Labastida,Basic services,internet,-74.53,-887.7
buyer_8,Antonio,45,ES63209538933051215051,TRX_N-00460-354309345815,2023-05-07T20:40:08,Labastida,Basic services,water,-53.65,-941.35
buyer_8,Antonio,45,ES63209538933051215051,TRX_N-00461-438961775719,2023-05-07T20:34:01,Labastida,Basic services,gas,-16.7,-958.05
buyer_8,Antonio,45,ES63209538933051215051,TRX_N-00462-853449623632,2023-05-12T13:34:54,Labastida,Expense,leisure,-258.81,-1216.86
buyer_8,Antonio,45,ES63209538933051215051,TRX_N-00463-397018484399,2023-05-17T16:00:42,Labastida,Expense,food,-125.85,-1342.71
buyer_8,Antonio,45,ES63209538933051215051,TRX_N-00464-588894523269,2023-05-19T12:12:16,Labastida,Expense,gifts,-379.73,-1722.44
buyer_8,Antonio,45,ES63209538933051215051,TRX_N-00465-336673362090,2023-05-29T16:56:27,Labastida,Expense,transport,-46.16,-1768.6
buyer_8,Antonio,45,ES63209538933051215051,TRX_N-00466-510562218882,2023-06-01T07:24:28,Labastida,transfer,Salary,2006.51,237.91
buyer_8,Antonio,45,ES63209538933051215051,TRX_N-00467-407885234011,2023-06-01T07:24:28,Labastida,transfer,Bonus,2177.27,2415.18
buyer_8,Antonio,45,ES63209538933051215051,TRX_N-00468-382855190773,2023-06-03T10:24:44,Labastida,Expense,healthcare,-230.32,2184.86
buyer_8,Antonio,45,ES63209538933051215051,TRX_N-00469-178052142647,2023-06-05T11:35:55,Labastida,Housing,Mortgage,-979.0,1205.86
buyer_8,Antonio,45,ES63209538933051215051,TRX_N-00470-319230145703,2023-06-05T13:10:08,Labastida,Basic services,electricity,-101.01,1104.85
buyer_8,Antonio,45,ES63209538933051215051,TRX_N-00471-807271915674,2023-06-05T02:25:11,Labastida,Basic services,internet,-48.87,1055.98
buyer_8,Antonio,45,ES63209538933051215051,TRX_N-00472-168337047218,2023-06-07T14:17:15,Labastida,Basic services,phone,-40.48,1015.5
buyer_8,Antonio,45,ES63209538933051215051,TRX_N-00473-448931112376,2023-06-10T16:44:29,Portugalete,Expense,transport,-159.17,856.33
buyer_8,Antonio,45,ES63209538933051215051,TRX_N-00474-588228187842,2023-06-10T13:01:41,Labastida,Expense,clothing,-295.67,560.66
buyer_8,Antonio,45,ES63209538933051215051,TRX_N-00475-340330015830,2023-06-16T19:20:07,Labastida,Expense,leisure,-104.09,456.57
buyer_8,Antonio,45,ES63209538933051215051,TRX_N-00476-204708715458,2023-06-21T09:51:22,Labastida,Expense,gifts,-333.42,123.15
buyer_8,Antonio,45,ES63209538933051215051,TRX_N-00477-631561672015,2023-06-27T21:27:32,Labastida,Expense,food,-361.91,-238.76
buyer_8,Antonio,45,ES63209538933051215051,TRX_N-00478-61396296826,2023-06-28T16:54:17,Durango,Expense,food,-573.33,-812.09
buyer_8,Antonio,45,ES63209538933051215051,TRX_N-00479-339398933553,2023-06-29T15:14:52,Labastida,Expense,transport,-40.67,-852.76
buyer_8,Antonio,45,ES63209538933051215051,TRX_N-00480-426721348176,2023-06-30T14:09:37,Labastida,Expense,clothing,-306.98,-1159.74
buyer_8,Antonio,45,ES63209538933051215051,TRX_N-00481-60374258610,2023-07-01T23:56:45,Labastida,transfer,Salary,2006.51,846.77
buyer_8,Antonio,45,ES63209538933051215051,TRX_N-00482-887802997548,2023-07-01T23:56:45,Labastida,transfer,Extra Income,200.65,1047.42
buyer_8,Antonio,45,ES63209538933051215051,TRX_N-00483-767162960201,2023-07-05T10:29:42,Labastida,Housing,Mortgage,-979.0,68.42
buyer_8,Antonio,45,ES63209538933051215051,TRX_N-00484-188140402814,2023-07-05T11:54:21,Labastida,Basic services,electricity,-34.51,33.91
buyer_8,Antonio,45,ES63209538933051215051,TRX_N-00485-892882239000,2023-07-05T13:27:13,Labastida,Basic services,gas,-61.97,-28.06
buyer_8,Antonio,45,ES63209538933051215051,TRX_N-00486-863191399244,2023-07-05T16:06:56,Labastida,Basic services,internet,-55.8,-83.86
buyer_8,Antonio,45,ES63209538933051215051,TRX_N-00487-142088300812,2023-07-06T21:52:49,Labastida,Basic services,phone,-89.09,-172.95
buyer_8,Antonio,45,ES63209538933051215051,TRX_N-00488-792584193770,2023-07-07T15:32:50,Labastida,Basic services,electricity,-96.31,-269.26
buyer_8,Antonio,45,ES63209538933051215051,TRX_N-00489-931526978903,2023-07-07T10:46:32,Labastida,Basic services,phone,-50.55,-319.81
buyer_8,Antonio,45,ES63209538933051215051,TRX_N-00490-289687391406,2023-07-13T15:43:41,Eibar,Expense,food,-161.55,-481.36
buyer_8,Antonio,45,ES63209538933051215051,TRX_N-00491-813111341143,2023-07-15T10:59:44,Labastida,Expense,healthcare,-271.25,-752.61
buyer_8,Antonio,45,ES63209538933051215051,TRX_N-00492-64580022861,2023-07-20T10:24:12,Labastida,Expense,leisure,-193.18,-945.79
buyer_8,Antonio,45,ES63209538933051215051,TRX_N-00493-341424305292,2023-07-22T22:16:21,Labastida,Expense,travel,-1741.58,-2687.37
buyer_8,Antonio,45,ES63209538933051215051,TRX_N-00494-276706784695,2023-07-26T13:07:53,Irun,Expense,transport,-24.58,-2711.95
buyer_8,Antonio,45,ES63209538933051215051,TRX_N-00495-502374833014,2023-07-27T12:18:16,Labastida,Expense,leisure,-76.95,-2788.9
buyer_8,Antonio,45,ES63209538933051215051,TRX_N-00496-504760709301,2023-08-01T02:10:59,Labastida,transfer,Salary,2006.51,-782.39
buyer_8,Antonio,45,ES63209538933051215051,TRX_N-00497-766920995276,2023-08-05T17:25:00,Labastida,Housing,Mortgage,-979.0,-1761.39
buyer_8,Antonio,45,ES63209538933051215051,TRX_N-00498-601318817520,2023-08-05T14:33:04,Labastida,Basic services,water,-54.61,-1816.0
buyer_8,Antonio,45,ES63209538933051215051,TRX_N-00499-913241061036,2023-08-05T10:02:41,Labastida,Basic services,gas,-78.93,-1894.93
buyer_8,Antonio,45,ES63209538933051215051,TRX_N-00500-271656236255,2023-08-05T12:20:59,Labastida,Basic services,phone,-53.12,-1948.05
buyer_8,Antonio,45,ES63209538933051215051,TRX_N-00501-68665309797,2023-08-06T11:22:43,Labastida,Basic services,gas,-53.44,-2001.49
buyer_8,Antonio,45,ES63209538933051215051,TRX_N-00502-355224156980,2023-08-06T18:25:51,Labastida,Basic services,phone,-85.16,-2086.65
buyer_8,Antonio,45,ES63209538933051215051,TRX_N-00503-897015823785,2023-08-07T18:55:03,Labastida,Basic services,gas,-49.18,-2135.83
buyer_8,Antonio,45,ES63209538933051215051,TRX_N-00504-722043073553,2023-08-07T18:14:41,Labastida,Basic services,internet,-69.61,-2205.44
buyer_8,Antonio,45,ES63209538933051215051,TRX_N-00505-787061438189,2023-08-08T20:41:05,Labastida,Expense,transport,-150.73,-2356.17
buyer_8,Antonio,45,ES63209538933051215051,TRX_N-00506-180466987258,2023-08-17T18:29:50,Labastida,Expense,food,-579.64,-2935.81
buyer_8,Antonio,45,ES63209538933051215051,TRX_N-00507-263224026723,2023-08-18T10:26:25,Labastida,Expense,healthcare,-334.09,-3269.9
buyer_8,Antonio,45,ES63209538933051215051,TRX_N-00508-342696474863,2023-08-29T16:55:47,Labastida,Expense,food,-384.53,-3654.43
buyer_8,Antonio,45,ES63209538933051215051,TRX_N-00509-494185594003,2023-09-01T20:15:43,Labastida,transfer,Salary,2006.51,-1647.92
buyer_8,Antonio,45,ES63209538933051215051,TRX_N-00510-567860958797,2023-09-05T17:12:14,Labastida,Housing,Mortgage,-979.0,-2626.92
buyer_8,Antonio,45,ES63209538933051215051,TRX_N-00511-726804793155,2023-09-05T17:19:28,Labastida,Basic services,gas,-90.72,-2717.64
buyer_8,Antonio,45,ES63209538933051215051,TRX_N-00512-826727251083,2023-09-05T16:44:43,Labastida,Basic services,internet,-48.67,-2766.31
buyer_8,Antonio,45,ES63209538933051215051,TRX_N-00513-181139990676,2023-09-05T15:23:54,Labastida,Basic services,phone,-46.07,-2812.38
buyer_8,Antonio,45,ES63209538933051215051,TRX_N-00514-385624221120,2023-09-05T13:27:12,Labastida,Expense,food,-136.37,-2948.75
buyer_8,Antonio,45,ES63209538933051215051,TRX_N-00515-216136880160,2023-09-05T22:36:41,Amurrio,Expense,travel,-1829.48,-4778.23
buyer_8,Antonio,45,ES63209538933051215051,TRX_N-00516-412998330683,2023-09-06T23:02:01,Labastida,Basic services,internet,-49.71,-4827.94
buyer_8,Antonio,45,ES63209538933051215051,TRX_N-00517-170921130600,2023-09-06T16:41:31,Labastida,Expense,clothing,-332.62,-5160.56
buyer_8,Antonio,45,ES63209538933051215051,TRX_N-00518-935535873612,2023-09-07T10:42:52,Labastida,Basic services,water,-42.14,-5202.7
buyer_8,Antonio,45,ES63209538933051215051,TRX_N-00519-72639066386,2023-09-24T17:48:00,Labastida,Expense,food,-517.54,-5720.24
buyer_8,Antonio,45,ES63209538933051215051,TRX_N-00520-252386273218,2023-09-26T04:54:21,Labastida,Expense,food,-658.81,-6379.05
buyer_8,Antonio,45,ES63209538933051215051,TRX_N-00521-694159726219,2023-09-26T20:26:19,Labastida,Expense,healthcare,-60.71,-6439.76
buyer_8,Antonio,45,ES63209538933051215051,TRX_N-00522-270045446043,2023-10-01T12:58:54,Labastida,transfer,Salary,2006.51,-4433.25
buyer_8,Antonio,45,ES63209538933051215051,TRX_N-00523-414868904530,2023-10-01T12:58:54,Labastida,transfer,Extra Income,200.65,-4232.6
buyer_8,Antonio,45,ES63209538933051215051,TRX_N-00524-761979752195,2023-10-05T17:59:55,Labastida,Housing,Mortgage,-979.0,-5211.6
buyer_8,Antonio,45,ES63209538933051215051,TRX_N-00525-976634405257,2023-10-05T16:59:54,Labastida,Basic services,gas,-63.96,-5275.56
buyer_8,Antonio,45,ES63209538933051215051,TRX_N-00526-370174208371,2023-10-07T08:56:38,Labastida,Basic services,water,-69.06,-5344.62
buyer_8,Antonio,45,ES63209538933051215051,TRX_N-00527-744849925277,2023-10-07T18:56:15,Labastida,Basic services,electricity,-26.03,-5370.65
buyer_8,Antonio,45,ES63209538933051215051,TRX_N-00528-208809629901,2023-10-12T11:21:21,Labastida,Expense,food,-207.07,-5577.72
buyer_8,Antonio,45,ES63209538933051215051,TRX_N-00529-601120679777,2023-11-01T08:34:39,Labastida,transfer,Salary,2006.51,-3571.21
buyer_8,Antonio,45,ES63209538933051215051,TRX_N-00530-194284480910,2023-11-05T14:42:49,Labastida,Housing,Mortgage,-979.0,-4550.21
buyer_8,Antonio,45,ES63209538933051215051,TRX_N-00531-228701177935,2023-11-05T08:50:12,Labastida,Basic services,electricity,-87.03,-4637.24
buyer_8,Antonio,45,ES63209538933051215051,TRX_N-00532-941924199385,2023-11-05T14:47:45,Labastida,Basic services,internet,-77.96,-4715.2
buyer_8,Antonio,45,ES63209538933051215051,TRX_N-00533-317569405282,2023-11-06T19:15:20,Labastida,Basic services,internet,-52.61,-4767.81
buyer_8,Antonio,45,ES63209538933051215051,TRX_N-00534-569811285032,2023-11-06T16:28:29,Labastida,Basic services,phone,-68.43,-4836.24
buyer_8,Antonio,45,ES63209538933051215051,TRX_N-00535-502306967321,2023-11-07T09:29:36,Labastida,Basic services,internet,-65.35,-4901.59
buyer_8,Antonio,45,ES63209538933051215051,TRX_N-00536-793538941429,2023-11-07T21:28:03,Oyón-Oion,Expense,transport,-195.77,-5097.36
buyer_8,Antonio,45,ES63209538933051215051,TRX_N-00537-887581473686,2023-11-11T11:17:57,Labastida,Expense,clothing,-330.47,-5427.83
buyer_8,Antonio,45,ES63209538933051215051,TRX_N-00538-360036207092,2023-12-01T10:24:55,Labastida,transfer,Salary,2006.51,-3421.32
buyer_8,Antonio,45,ES63209538933051215051,TRX_N-00539-894183445396,2023-12-01T10:24:55,Labastida,transfer,Extra Income,200.65,-3220.67
buyer_8,Antonio,45,ES63209538933051215051,TRX_N-00540-277562001136,2023-12-01T10:24:55,Labastida,transfer,Bonus,1824.92,-1395.75
buyer_8,Antonio,45,ES63209538933051215051,TRX_N-00541-494890655617,2023-12-05T19:21:31,Labastida,Housing,Mortgage,-979.0,-2374.75
buyer_8,Antonio,45,ES63209538933051215051,TRX_N-00542-109614166094,2023-12-05T18:06:50,Labastida,Basic services,water,-33.32,-2408.07
buyer_8,Antonio,45,ES63209538933051215051,TRX_N-00543-236746967765,2023-12-06T09:01:10,Labastida,Basic services,water,-25.04,-2433.11
buyer_8,Antonio,45,ES63209538933051215051,TRX_N-00544-94360739917,2023-12-06T20:32:14,Labastida,Basic services,internet,-41.21,-2474.32
buyer_8,Antonio,45,ES63209538933051215051,TRX_N-00545-15164914310,2023-12-06T12:13:05,Labastida,Basic services,phone,-84.54,-2558.86
buyer_8,Antonio,45,ES63209538933051215051,TRX_N-00546-408347947958,2023-12-07T08:57:57,Labastida,Basic services,electricity,-143.38,-2702.24
buyer_8,Antonio,45,ES63209538933051215051,TRX_N-00547-983466008906,2023-12-07T14:57:28,Labastida,Basic services,gas,-57.27,-2759.51
buyer_8,Antonio,45,ES63209538933051215051,TRX_N-00548-522562128668,2023-12-07T13:10:34,Labastida,Basic services,internet,-37.37,-2796.88
buyer_8,Antonio,45,ES63209538933051215051,TRX_N-00549-284731410397,2023-12-11T13:26:41,Labastida,Expense,clothing,-329.7,-3126.58
buyer_8,Antonio,45,ES63209538933051215051,TRX_N-00550-585736428060,2023-12-13T21:07:28,Labastida,Expense,appliances,-496.21,-3622.79
buyer_8,Antonio,45,ES63209538933051215051,TRX_N-00551-959286362739,2023-12-16T11:27:06,Labastida,Expense,healthcare,-48.14,-3670.93
buyer_8,Antonio,45,ES63209538933051215051,TRX_N-00552-810287316087,2023-12-29T19:00:13,Labastida,Expense,clothing,-261.62,-3932.55
buyer_8,Antonio,45,ES63209538933051215051,TRX_N-00553-996594121359,2024-01-01T06:00:10,Labastida,transfer,Salary,2006.51,-1926.04
buyer_8,Antonio,45,ES63209538933051215051,TRX_N-00554-754713678909,2024-01-01T18:05:24,Labastida,Expense,clothing,-294.17,-2220.21
buyer_8,Antonio,45,ES63209538933051215051,TRX_N-00555-271530735380,2024-01-05T18:07:20,Labastida,Housing,Mortgage,-979.0,-3199.21
buyer_8,Antonio,45,ES63209538933051215051,TRX_N-00556-516196732160,2024-01-05T13:50:56,Labastida,Basic services,electricity,-60.23,-3259.44
buyer_8,Antonio,45,ES63209538933051215051,TRX_N-00557-648254197258,2024-01-06T10:46:06,Labastida,Basic services,electricity,-57.2,-3316.64
buyer_8,Antonio,45,ES63209538933051215051,TRX_N-00558-612464821754,2024-01-06T20:51:53,Labastida,Basic services,gas,-17.98,-3334.62
buyer_8,Antonio,45,ES63209538933051215051,TRX_N-00559-108919437273,2024-01-07T19:41:05,Labastida,Basic services,gas,-63.3,-3397.92
buyer_8,Antonio,45,ES63209538933051215051,TRX_N-00560-482487264690,2024-01-26T19:23:28,Labastida,Expense,food,-586.16,-3984.08
buyer_8,Antonio,45,ES63209538933051215051,TRX_N-00561-713741138334,2024-01-27T13:35:31,Labastida,Expense,healthcare,-362.19,-4346.27
buyer_8,Antonio,45,ES63209538933051215051,TRX_N-00562-163126046072,2024-01-29T12:05:18,Labastida,Expense,clothing,-407.83,-4754.1
buyer_8,Antonio,45,ES63209538933051215051,TRX_N-00563-112073864120,2024-02-01T17:27:58,Labastida,transfer,Salary,2006.51,-2747.59
buyer_8,Antonio,45,ES63209538933051215051,TRX_N-00564-5053799553,2024-02-01T17:27:58,Labastida,transfer,Extra Income,200.65,-2546.94
buyer_8,Antonio,45,ES63209538933051215051,TRX_N-00565-592725185672,2024-02-03T01:39:07,Labastida,Expense,food,-285.59,-2832.53
buyer_8,Antonio,45,ES63209538933051215051,TRX_N-00566-422551505953,2024-02-05T20:51:05,Labastida,Housing,Mortgage,-979.0,-3811.53
buyer_8,Antonio,45,ES63209538933051215051,TRX_N-00567-521267648420,2024-02-05T08:45:14,Labastida,Basic services,phone,-55.21,-3866.74
buyer_8,Antonio,45,ES63209538933051215051,TRX_N-00568-532818756264,2024-02-05T17:38:08,Labastida,Expense,leisure,-295.51,-4162.25
buyer_8,Antonio,45,ES63209538933051215051,TRX_N-00569-186756169921,2024-02-06T20:32:13,Labastida,Basic services,water,-31.01,-4193.26
buyer_8,Antonio,45,ES63209538933051215051,TRX_N-00570-192552686559,2024-02-06T11:32:03,Labastida,Basic services,electricity,-21.77,-4215.03
buyer_8,Antonio,45,ES63209538933051215051,TRX_N-00571-409347398846,2024-02-06T10:14:15,Labastida,Basic services,internet,-59.4,-4274.43
buyer_8,Antonio,45,ES63209538933051215051,TRX_N-00572-891671361950,2024-02-06T15:14:12,Labastida,Basic services,phone,-59.04,-4333.47
buyer_8,Antonio,45,ES63209538933051215051,TRX_N-00573-808454482974,2024-02-07T08:48:35,Labastida,Basic services,electricity,-119.19,-4452.66
buyer_8,Antonio,45,ES63209538933051215051,TRX_N-00574-485018240223,2024-02-07T10:15:32,Labastida,Basic services,gas,-81.94,-4534.6
buyer_8,Antonio,45,ES63209538933051215051,TRX_N-00575-72365873791,2024-02-15T14:08:08,Labastida,Expense,transport,-146.35,-4680.95
buyer_8,Antonio,45,ES63209538933051215051,TRX_N-00576-918770973656,2024-02-19T17:08:03,Labastida,Expense,leisure,-132.01,-4812.96
buyer_8,Antonio,45,ES63209538933051215051,TRX_N-00577-781051579666,2024-03-01T20:33:10,Labastida,transfer,Salary,2006.51,-2806.45
buyer_8,Antonio,45,ES63209538933051215051,TRX_N-00578-157709175164,2024-03-05T22:53:27,Labastida,Housing,Mortgage,-979.0,-3785.45
buyer_8,Antonio,45,ES63209538933051215051,TRX_N-00579-217405506315,2024-03-05T18:59:26,Labastida,Basic services,water,-11.89,-3797.34
buyer_8,Antonio,45,ES63209538933051215051,TRX_N-00580-493753357886,2024-03-05T02:40:03,Labastida,Basic services,internet,-45.65,-3842.99
buyer_8,Antonio,45,ES63209538933051215051,TRX_N-00581-177870725112,2024-03-06T11:39:12,Labastida,Basic services,electricity,-146.25,-3989.24
buyer_8,Antonio,45,ES63209538933051215051,TRX_N-00582-468735656443,2024-03-06T08:13:35,Labastida,Basic services,internet,-52.2,-4041.44
buyer_8,Antonio,45,ES63209538933051215051,TRX_N-00583-186115952435,2024-03-06T09:23:51,Labastida,Basic services,phone,-84.32,-4125.76
buyer_8,Antonio,45,ES63209538933051215051,TRX_N-00584-772744184092,2024-03-07T19:02:31,Labastida,Basic services,water,-31.14,-4156.9
buyer_8,Antonio,45,ES63209538933051215051,TRX_N-00585-438041383402,2024-03-07T18:17:08,Labastida,Basic services,internet,-53.8,-4210.7
buyer_8,Antonio,45,ES63209538933051215051,TRX_N-00586-603089701990,2024-03-13T22:32:53,Salvatierra/Agurain,Expense,food,-383.09,-4593.79
buyer_8,Antonio,45,ES63209538933051215051,TRX_N-00587-890292247581,2024-04-01T21:23:23,Labastida,transfer,Salary,2006.51,-2587.28
buyer_8,Antonio,45,ES63209538933051215051,TRX_N-00588-208997651058,2024-04-05T11:05:17,Labastida,Housing,Mortgage,-979.0,-3566.28
buyer_8,Antonio,45,ES63209538933051215051,TRX_N-00589-326380918750,2024-04-06T17:06:06,Labastida,Basic services,water,-14.91,-3581.19
buyer_8,Antonio,45,ES63209538933051215051,TRX_N-00590-780934572795,2024-04-06T11:42:17,Labastida,Basic services,electricity,-72.16,-3653.35
buyer_8,Antonio,45,ES63209538933051215051,TRX_N-00591-49916859016,2024-04-07T10:17:40,Labastida,Basic services,electricity,-127.08,-3780.43
buyer_8,Antonio,45,ES63209538933051215051,TRX_N-00592-198773321407,2024-04-07T13:59:14,Labastida,Basic services,internet,-51.96,-3832.39
buyer_8,Antonio,45,ES63209538933051215051,TRX_N-00593-429882850008,2024-04-07T13:53:10,Labastida,Basic services,phone,-54.0,-3886.39
buyer_8,Antonio,45,ES63209538933051215051,TRX_N-00594-198145947315,2024-04-16T16:50:58,Labastida,Expense,healthcare,-43.14,-3929.53
buyer_8,Antonio,45,ES63209538933051215051,TRX_N-00595-209643175780,2024-04-29T23:49:52,Labastida,Expense,clothing,-236.37,-4165.9
buyer_8,Antonio,45,ES63209538933051215051,TRX_N-00596-523979903881,2024-05-01T14:52:58,Labastida,transfer,Salary,2006.51,-2159.39
buyer_8,Antonio,45,ES63209538933051215051,TRX_N-00597-374195733794,2024-05-01T14:52:58,Labastida,transfer,Extra Income,200.65,-1958.74
buyer_8,Antonio,45,ES63209538933051215051,TRX_N-00598-907405875396,2024-05-04T17:34:51,Labastida,Expense,food,-147.54,-2106.28
buyer_8,Antonio,45,ES63209538933051215051,TRX_N-00599-698331000847,2024-05-05T09:57:14,Labastida,Housing,Mortgage,-979.0,-3085.28
buyer_8,Antonio,45,ES63209538933051215051,TRX_N-00600-820040550218,2024-05-05T10:33:17,Labastida,Basic services,gas,-97.93,-3183.21
buyer_8,Antonio,45,ES63209538933051215051,TRX_N-00601-737955033033,2024-05-05T18:05:13,Labastida,Basic services,phone,-88.36,-3271.57
buyer_8,Antonio,45,ES63209538933051215051,TRX_N-00602-39473660340,2024-05-06T15:15:59,Labastida,Basic services,gas,-88.39,-3359.96
buyer_8,Antonio,45,ES63209538933051215051,TRX_N-00603-198031236017,2024-05-07T19:36:05,Labastida,Basic services,electricity,-90.57,-3450.53
buyer_8,Antonio,45,ES63209538933051215051,TRX_N-00604-182697290133,2024-05-07T11:17:37,Labastida,Basic services,gas,-39.67,-3490.2
buyer_8,Antonio,45,ES63209538933051215051,TRX_N-00605-823804149317,2024-05-07T16:37:26,Labastida,Basic services,internet,-65.06,-3555.26
buyer_8,Antonio,45,ES63209538933051215051,TRX_N-00606-633207762190,2024-05-09T08:31:58,Labastida,Expense,food,-528.05,-4083.31
buyer_8,Antonio,45,ES63209538933051215051,TRX_N-00607-89507324082,2024-05-11T12:25:21,Labastida,Expense,clothing,-112.0,-4195.31
buyer_8,Antonio,45,ES63209538933051215051,TRX_N-00608-368684861173,2024-05-18T19:37:31,Labastida,Expense,clothing,-144.97,-4340.28
buyer_8,Antonio,45,ES63209538933051215051,TRX_N-00609-714691293423,2024-05-19T12:35:20,Labastida,Expense,gifts,-415.14,-4755.42
buyer_8,Antonio,45,ES63209538933051215051,TRX_N-00610-726838154103,2024-05-20T10:28:18,Labastida,Expense,transport,-55.0,-4810.42
buyer_8,Antonio,45,ES63209538933051215051,TRX_N-00611-938058531968,2024-05-25T18:07:07,Labastida,Expense,clothing,-242.78,-5053.2
buyer_8,Antonio,45,ES63209538933051215051,TRX_N-00612-604882469042,2024-06-01T04:21:11,Labastida,transfer,Salary,2006.51,-3046.69
buyer_8,Antonio,45,ES63209538933051215051,TRX_N-00613-153906274781,2024-06-01T04:21:11,Labastida,transfer,Bonus,1808.26,-1238.43
buyer_8,Antonio,45,ES63209538933051215051,TRX_N-00614-98594598824,2024-06-03T19:30:19,Labastida,Expense,transport,-49.45,-1287.88
buyer_8,Antonio,45,ES63209538933051215051,TRX_N-00615-334031743817,2024-06-04T08:11:07,Labastida,Expense,transport,-130.95,-1418.83
buyer_8,Antonio,45,ES63209538933051215051,TRX_N-00616-357869360705,2024-06-04T08:05:59,Labastida,Expense,leisure,-165.29,-1584.12
buyer_8,Antonio,45,ES63209538933051215051,TRX_N-00617-285287747334,2024-06-05T11:20:49,Labastida,Housing,Mortgage,-979.0,-2563.12
buyer_8,Antonio,45,ES63209538933051215051,TRX_N-00618-313975260150,2024-06-05T00:00:36,Labastida,Basic services,internet,-33.52,-2596.64
buyer_8,Antonio,45,ES63209538933051215051,TRX_N-00619-883149556271,2024-06-05T16:27:34,Labastida,Basic services,phone,-65.56,-2662.2
buyer_8,Antonio,45,ES63209538933051215051,TRX_N-00620-669157167154,2024-06-05T08:37:28,Labastida,Expense,food,-619.34,-3281.54
buyer_8,Antonio,45,ES63209538933051215051,TRX_N-00621-862631818231,2024-06-06T10:25:41,Labastida,Basic services,water,-57.51,-3339.05
buyer_8,Antonio,45,ES63209538933051215051,TRX_N-00622-665597580433,2024-06-06T16:03:12,Labastida,Basic services,electricity,-89.42,-3428.47
buyer_8,Antonio,45,ES63209538933051215051,TRX_N-00623-28200585836,2024-06-06T14:41:05,Labastida,Basic services,gas,-37.45,-3465.92
buyer_8,Antonio,45,ES63209538933051215051,TRX_N-00624-477729014361,2024-06-06T18:49:17,Labastida,Basic services,phone,-73.1,-3539.02
buyer_8,Antonio,45,ES63209538933051215051,TRX_N-00625-380613767745,2024-06-07T13:41:55,Labastida,Basic services,water,-18.94,-3557.96
buyer_8,Antonio,45,ES63209538933051215051,TRX_N-00626-681162243211,2024-06-07T01:22:45,Labastida,Basic services,gas,-52.95,-3610.91
buyer_8,Antonio,45,ES63209538933051215051,TRX_N-00627-649395743861,2024-06-07T10:15:29,Labastida,Basic services,phone,-58.54,-3669.45
buyer_8,Antonio,45,ES63209538933051215051,TRX_N-00628-677052315666,2024-06-18T20:48:51,Labastida,Expense,repairs,-935.96,-4605.41
buyer_8,Antonio,45,ES63209538933051215051,TRX_N-00629-987014425582,2024-06-27T17:16:43,Labastida,Expense,leisure,-251.1,-4856.51
buyer_8,Antonio,45,ES63209538933051215051,TRX_N-00630-279756194085,2024-06-30T09:34:36,Labastida,Expense,food,-459.48,-5315.99
buyer_8,Antonio,45,ES63209538933051215051,TRX_N-00631-454344855286,2024-07-01T08:09:49,Labastida,transfer,Salary,2006.51,-3309.48
buyer_8,Antonio,45,ES63209538933051215051,TRX_N-00632-694242388902,2024-07-05T20:40:08,Labastida,Housing,Mortgage,-979.0,-4288.48
buyer_8,Antonio,45,ES63209538933051215051,TRX_N-00633-488890077181,2024-07-05T16:56:14,Labastida,Basic services,water,-13.68,-4302.16
buyer_8,Antonio,45,ES63209538933051215051,TRX_N-00634-397633431458,2024-07-05T18:06:47,Labastida,Basic services,gas,-45.68,-4347.84
buyer_8,Antonio,45,ES63209538933051215051,TRX_N-00635-741227976119,2024-07-05T12:12:30,Labastida,Basic services,internet,-74.66,-4422.5
buyer_8,Antonio,45,ES63209538933051215051,TRX_N-00636-389538130493,2024-07-06T13:56:26,Labastida,Basic services,water,-21.46,-4443.96
buyer_8,Antonio,45,ES63209538933051215051,TRX_N-00637-687811677053,2024-07-06T13:15:37,Labastida,Basic services,gas,-71.51,-4515.47
buyer_8,Antonio,45,ES63209538933051215051,TRX_N-00638-250052280496,2024-07-06T08:47:57,Labastida,Expense,food,-509.38,-5024.85
buyer_8,Antonio,45,ES63209538933051215051,TRX_N-00639-792511813893,2024-07-07T09:57:56,Labastida,Basic services,water,-34.82,-5059.67
buyer_8,Antonio,45,ES63209538933051215051,TRX_N-00640-495579126275,2024-07-07T17:42:06,Labastida,Basic services,gas,-21.79,-5081.46
buyer_8,Antonio,45,ES63209538933051215051,TRX_N-00641-223637025107,2024-07-07T15:10:22,Labastida,Basic services,internet,-67.93,-5149.39
buyer_8,Antonio,45,ES63209538933051215051,TRX_N-00642-420614482126,2024-07-07T19:12:31,Labastida,Basic services,phone,-72.96,-5222.35
buyer_8,Antonio,45,ES63209538933051215051,TRX_N-00643-774444463957,2024-07-25T17:27:18,Labastida,Expense,food,-226.44,-5448.79
buyer_8,Antonio,45,ES63209538933051215051,TRX_N-00644-636969571056,2024-07-25T00:47:26,Labastida,Expense,repairs,-993.69,-6442.48
buyer_8,Antonio,45,ES63209538933051215051,TRX_N-00645-417977905071,2024-07-27T13:21:53,Labastida,Expense,transport,-48.7,-6491.18
buyer_8,Antonio,45,ES63209538933051215051,TRX_N-00646-894380006158,2024-08-01T21:17:02,Labastida,transfer,Salary,2006.51,-4484.67
buyer_8,Antonio,45,ES63209538933051215051,TRX_N-00647-230276428428,2024-08-01T21:17:02,Labastida,transfer,Extra Income,200.65,-4284.02
buyer_8,Antonio,45,ES63209538933051215051,TRX_N-00648-32877877599,2024-08-01T11:20:22,Labastida,Expense,healthcare,-91.9,-4375.92
buyer_8,Antonio,45,ES63209538933051215051,TRX_N-00649-832161024404,2024-08-02T14:10:47,Labastida,Expense,food,-630.8,-5006.72
buyer_8,Antonio,45,ES63209538933051215051,TRX_N-00650-777869141598,2024-08-05T11:00:18,Labastida,Housing,Mortgage,-979.0,-5985.72
buyer_8,Antonio,45,ES63209538933051215051,TRX_N-00651-804148921419,2024-08-05T13:18:00,Labastida,Basic services,water,-38.14,-6023.86
buyer_8,Antonio,45,ES63209538933051215051,TRX_N-00652-276395147429,2024-08-05T09:47:57,Labastida,Basic services,electricity,-26.55,-6050.41
buyer_8,Antonio,45,ES63209538933051215051,TRX_N-00653-439910616397,2024-08-06T22:46:07,Labastida,Basic services,electricity,-112.71,-6163.12
buyer_8,Antonio,45,ES63209538933051215051,TRX_N-00654-100750131476,2024-08-06T19:03:01,Labastida,Basic services,gas,-85.8,-6248.92
buyer_8,Antonio,45,ES63209538933051215051,TRX_N-00655-776759672309,2024-08-06T13:52:29,Labastida,Basic services,internet,-31.84,-6280.76
buyer_8,Antonio,45,ES63209538933051215051,TRX_N-00656-711956019569,2024-08-07T05:11:49,Labastida,Basic services,internet,-45.18,-6325.94
buyer_8,Antonio,45,ES63209538933051215051,TRX_N-00657-372763995322,2024-08-16T09:47:22,Labastida,Expense,healthcare,-238.48,-6564.42
buyer_8,Antonio,45,ES63209538933051215051,TRX_N-00658-531972834014,2024-08-19T17:11:58,Labastida,Expense,food,-754.04,-7318.46
buyer_8,Antonio,45,ES63209538933051215051,TRX_N-00659-901104982457,2024-08-19T11:26:31,Vitoria-Gasteiz,Expense,transport,-147.15,-7465.61
buyer_8,Antonio,45,ES63209538933051215051,TRX_N-00660-944489456499,2024-08-27T19:08:09,Labastida,Expense,clothing,-367.09,-7832.7
buyer_8,Antonio,45,ES63209538933051215051,TRX_N-00661-657948789008,2024-08-30T15:50:07,Labastida,Expense,transport,-196.06,-8028.76
buyer_8,Antonio,45,ES63209538933051215051,TRX_N-00662-750868287884,2024-08-31T21:27:46,Labastida,Expense,food,-674.18,-8702.94
buyer_8,Antonio,45,ES63209538933051215051,TRX_N-00663-871951396130,2024-09-01T12:58:21,Labastida,transfer,Salary,2006.51,-6696.43
buyer_8,Antonio,45,ES63209538933051215051,TRX_N-00664-804128592355,2024-09-05T10:56:11,Labastida,Housing,Mortgage,-979.0,-7675.43
buyer_8,Antonio,45,ES63209538933051215051,TRX_N-00665-51361094660,2024-09-05T13:59:48,Labastida,Basic services,internet,-55.52,-7730.95
buyer_8,Antonio,45,ES63209538933051215051,TRX_N-00666-74580370269,2024-09-06T19:24:23,Labastida,Basic services,water,-35.72,-7766.67
buyer_8,Antonio,45,ES63209538933051215051,TRX_N-00667-55447400852,2024-09-06T19:52:36,Labastida,Basic services,electricity,-20.22,-7786.89
buyer_8,Antonio,45,ES63209538933051215051,TRX_N-00668-107439684935,2024-09-06T13:58:13,Labastida,Basic services,gas,-81.29,-7868.18
buyer_8,Antonio,45,ES63209538933051215051,TRX_N-00669-375966205335,2024-09-07T20:20:17,Labastida,Basic services,water,-22.1,-7890.28
buyer_8,Antonio,45,ES63209538933051215051,TRX_N-00670-310606159938,2024-09-07T15:41:27,Labastida,Basic services,gas,-16.16,-7906.44
buyer_8,Antonio,45,ES63209538933051215051,TRX_N-00671-473498513352,2024-09-15T20:49:29,Labastida,Expense,food,-105.42,-8011.86
buyer_8,Antonio,45,ES63209538933051215051,TRX_N-00672-850948256388,2024-09-26T11:55:50,Labastida,Expense,healthcare,-360.5,-8372.36
buyer_8,Antonio,45,ES63209538933051215051,TRX_N-00673-597291244342,2024-09-27T14:53:35,Oyón-Oion,Expense,transport,-102.71,-8475.07
buyer_8,Antonio,45,ES63209538933051215051,TRX_N-00674-193555970005,2024-09-28T08:24:07,Barakaldo,Expense,food,-208.17,-8683.24
buyer_8,Antonio,45,ES63209538933051215051,TRX_N-00675-978401639343,2024-10-01T12:20:30,Labastida,transfer,Salary,2006.51,-6676.73
buyer_8,Antonio,45,ES63209538933051215051,TRX_N-00676-190729395692,2024-10-01T12:20:30,Labastida,transfer,Extra Income,200.65,-6476.08
buyer_8,Antonio,45,ES63209538933051215051,TRX_N-00677-622739539732,2024-10-05T09:26:55,Labastida,Housing,Mortgage,-979.0,-7455.08
buyer_8,Antonio,45,ES63209538933051215051,TRX_N-00678-322744360048,2024-10-05T18:50:01,Labastida,Basic services,water,-17.44,-7472.52
buyer_8,Antonio,45,ES63209538933051215051,TRX_N-00679-464106470869,2024-10-05T22:48:01,Labastida,Basic services,electricity,-129.74,-7602.26
buyer_8,Antonio,45,ES63209538933051215051,TRX_N-00680-372574790535,2024-10-05T00:44:30,Labastida,Basic services,gas,-80.01,-7682.27
buyer_8,Antonio,45,ES63209538933051215051,TRX_N-00681-127188771096,2024-10-06T16:45:24,Labastida,Basic services,water,-39.05,-7721.32
buyer_8,Antonio,45,ES63209538933051215051,TRX_N-00682-297498651215,2024-10-06T20:13:02,Labastida,Basic services,phone,-55.38,-7776.7
buyer_8,Antonio,45,ES63209538933051215051,TRX_N-00683-222450425051,2024-10-07T19:19:45,Labastida,Basic services,water,-17.63,-7794.33
buyer_8,Antonio,45,ES63209538933051215051,TRX_N-00684-938563860915,2024-10-07T19:42:38,Labastida,Basic services,gas,-66.97,-7861.3
buyer_8,Antonio,45,ES63209538933051215051,TRX_N-00685-436910334589,2024-10-07T11:36:32,Labastida,Basic services,phone,-32.76,-7894.06
buyer_8,Antonio,45,ES63209538933051215051,TRX_N-00686-618926158599,2024-10-07T13:52:19,Labastida,Expense,transport,-155.3,-8049.36
