profile,name,age,iban,trx_id,timestamp,city,trx_type,trx_cat,amount_eur,balance
buyer_1,Luis,28,ES28209538501931917716,TRX_N-00001-79024306,2022-01-01T15:42:42,Bilbao,incomes,salary,1514.99,3052.46
buyer_1,Luis,28,ES28209538501931917716,TRX_N-00002-50372512,2022-01-01T15:42:42,Bilbao,incomes,salary_partner,1015.63,4068.09
buyer_1,Luis,28,ES28209538501931917716,TRX_N-00003-14129794,2022-01-02T16:52:05,Bilbao,Expense,leisure,-41.49,4026.6
buyer_1,Luis,28,ES28209538501931917716,TRX_N-00004-43511102,2022-01-04T12:17:16,Bilbao,expenses,mortgage,-928.53,3098.07
buyer_1,Luis,28,ES28209538501931917716,TRX_N-00005-13921612,2022-01-05T15:33:25,Bilbao,expenses,gas,-40.21,3057.86
buyer_1,Luis,28,ES28209538501931917716,TRX_N-00006-60137715,2022-01-05T13:33:52,Bilbao,expenses,phone,-43.92,3013.94
buyer_1,Luis,28,ES28209538501931917716,TRX_N-00007-66773463,2022-01-06T10:33:25,Bilbao,expenses,electricity,-25.11,2988.83
buyer_1,Luis,28,ES28209538501931917716,TRX_N-00008-46306403,2022-01-07T13:38:44,Bilbao,Expense,transport,-52.91,2935.92
buyer_1,Luis,28,ES28209538501931917716,TRX_N-00009-75770553,2022-01-08T16:25:49,Bilbao,expenses,water,-27.65,2908.27
buyer_1,Luis,28,ES28209538501931917716,TRX_N-00010-28039099,2022-01-08T14:15:09,Bilbao,expenses,internet,-42.0,2866.27
buyer_1,Luis,28,ES28209538501931917716,TRX_N-00011-19011278,2022-01-10T18:23:24,Bilbao,Expense,transport,-67.31,2798.96
buyer_1,Luis,28,ES28209538501931917716,TRX_N-00012-44168606,2022-01-10T01:57:33,Bilbao,Expense,cash,-100.0,2698.96
buyer_1,Luis,28,ES28209538501931917716,TRX_N-00013-25136885,2022-01-10T18:50:43,Bilbao,Expense,gifts,-739.77,1959.19
buyer_1,Luis,28,ES28209538501931917716,TRX_N-00014-79462236,2022-01-11T13:19:42,Bilbao,Expense,food,-66.28,1892.91
buyer_1,Luis,28,ES28209538501931917716,TRX_N-00015-85044142,2022-01-11T11:41:39,Bilbao,Expense,clothing,-53.06,1839.85
buyer_1,Luis,28,ES28209538501931917716,TRX_N-00016-33967447,2022-01-13T17:58:58,Leioa,Expense,transport,-76.49,1763.36
buyer_1,Luis,28,ES28209538501931917716,TRX_N-00017-72110225,2022-01-13T18:16:20,Bilbao,Expense,clothing,-150.64,1612.72
buyer_1,Luis,28,ES28209538501931917716,TRX_N-00018-83735247,2022-01-13T09:29:49,Bilbao,Expense,cash,-100.0,1512.72
buyer_1,Luis,28,ES28209538501931917716,TRX_N-00019-03152167,2022-01-17T14:21:50,Bilbao,Expense,transport,-75.9,1436.82
buyer_1,Luis,28,ES28209538501931917716,TRX_N-00020-96205398,2022-01-19T20:45:24,Bilbao,Expense,cash,-100.0,1336.82
buyer_1,Luis,28,ES28209538501931917716,TRX_N-00021-39539677,2022-01-20T08:26:01,Bilbao,Expense,cash,-100.0,1236.82
buyer_1,Luis,28,ES28209538501931917716,TRX_N-00022-63137606,2022-01-21T23:10:51,Bilbao,Expense,food,-106.22,1130.6
buyer_1,Luis,28,ES28209538501931917716,TRX_N-00023-94003786,2022-01-23T15:20:49,Errenteria,Expense,transport,-77.0,1053.6
buyer_1,Luis,28,ES28209538501931917716,TRX_N-00024-91701713,2022-01-25T19:14:10,Bilbao,Expense,healthcare,-68.98,984.62
buyer_1,Luis,28,ES28209538501931917716,TRX_N-00025-46778552,2022-01-26T10:21:20,Bilbao,Expense,clothing,-133.93,850.69
buyer_1,Luis,28,ES28209538501931917716,TRX_N-00026-27932312,2022-01-27T08:22:57,Bilbao,Expense,cash,-100.0,750.69
buyer_1,Luis,28,ES28209538501931917716,TRX_N-00027-52708377,2022-01-28T18:24:17,Sestao,Expense,cash,-100.0,650.69
buyer_1,Luis,28,ES28209538501931917716,TRX_N-00028-87709452,2022-01-30T21:07:39,Bilbao,Expense,cash,-100.0,550.69
buyer_1,Luis,28,ES28209538501931917716,TRX_N-00029-28035850,2022-02-01T16:21:41,Bilbao,incomes,salary,1514.99,2065.68
buyer_1,Luis,28,ES28209538501931917716,TRX_N-00030-43262508,2022-02-01T16:21:41,Bilbao,incomes,salary_partner,1015.63,3081.31
buyer_1,Luis,28,ES28209538501931917716,TRX_N-00031-26022098,2022-02-01T18:29:13,Bilbao,Expense,food,-108.72,2972.59
buyer_1,Luis,28,ES28209538501931917716,TRX_N-00032-58917274,2022-02-01T15:10:18,Bilbao,Expense,leisure,-33.51,2939.08
buyer_1,Luis,28,ES28209538501931917716,TRX_N-00033-19776152,2022-02-01T20:53:41,Bilbao,Expense,cash,-100.0,2839.08
buyer_1,Luis,28,ES28209538501931917716,TRX_N-00034-90831690,2022-02-04T17:55:57,Bilbao,expenses,mortgage,-928.53,1910.55
buyer_1,Luis,28,ES28209538501931917716,TRX_N-00035-53295177,2022-02-05T16:14:10,Bilbao,expenses,gas,-91.51,1819.04
buyer_1,Luis,28,ES28209538501931917716,TRX_N-00036-28142816,2022-02-05T15:54:41,Vitoria-Gasteiz,Expense,clothing,-77.41,1741.63
buyer_1,Luis,28,ES28209538501931917716,TRX_N-00037-77343584,2022-02-05T16:03:14,Bilbao,expenses,children,-246.55,1495.08
buyer_1,Luis,28,ES28209538501931917716,TRX_N-00038-90254766,2022-02-07T02:06:50,Durango,Expense,food,-61.65,1433.43
buyer_1,Luis,28,ES28209538501931917716,TRX_N-00039-71030090,2022-02-08T20:37:25,Bilbao,expenses,electricity,-32.11,1401.32
buyer_1,Luis,28,ES28209538501931917716,TRX_N-00040-03052755,2022-02-08T08:54:35,Bilbao,expenses,internet,-42.0,1359.32
buyer_1,Luis,28,ES28209538501931917716,TRX_N-00041-61424147,2022-02-08T11:28:05,Bilbao,expenses,water,-27.52,1331.8
buyer_1,Luis,28,ES28209538501931917716,TRX_N-00042-16866372,2022-02-08T10:18:31,Bilbao,expenses,phone,-35.38,1296.42
buyer_1,Luis,28,ES28209538501931917716,TRX_N-00043-81884693,2022-02-08T13:15:41,Bilbao,Expense,food,-122.72,1173.7
buyer_1,Luis,28,ES28209538501931917716,TRX_N-00044-47082291,2022-02-08T11:33:34,Bilbao,Expense,healthcare,-177.33,996.37
buyer_1,Luis,28,ES28209538501931917716,TRX_N-00045-37862317,2022-02-10T12:12:26,Bilbao,Expense,cash,-100.0,896.37
buyer_1,Luis,28,ES28209538501931917716,TRX_N-00046-35021141,2022-02-11T18:54:41,Bilbao,Expense,cash,-100.0,796.37
buyer_1,Luis,28,ES28209538501931917716,TRX_N-00047-53225345,2022-02-11T20:49:18,Bilbao,Expense,appliances,-392.2,404.17
buyer_1,Luis,28,ES28209538501931917716,TRX_N-00048-06281241,2022-02-11T23:08:44,Bilbao,expenses,children,-198.51,205.66
buyer_1,Luis,28,ES28209538501931917716,TRX_N-00049-35530740,2022-02-14T14:39:57,Bilbao,Expense,food,-76.89,128.77
buyer_1,Luis,28,ES28209538501931917716,TRX_N-00050-37322288,2022-02-14T17:10:50,Bilbao,Expense,cash,-100.0,28.77
buyer_1,Luis,28,ES28209538501931917716,TRX_N-00051-76622057,2022-02-15T22:52:34,Bilbao,Expense,food,-90.43,-61.66
buyer_1,Luis,28,ES28209538501931917716,TRX_N-00052-44236165,2022-02-15T16:12:54,Llodio,Expense,leisure,-72.52,-134.18
buyer_1,Luis,28,ES28209538501931917716,TRX_N-00053-26129004,2022-02-15T22:34:38,Bilbao,Expense,cash,-100.0,-234.18
buyer_1,Luis,28,ES28209538501931917716,TRX_N-00054-79846327,2022-02-20T15:55:37,Sestao,Expense,clothing,-99.4,-333.58
buyer_1,Luis,28,ES28209538501931917716,TRX_N-00055-70637092,2022-02-21T01:09:21,Bilbao,Expense,repairs,-187.64,-521.22
buyer_1,Luis,28,ES28209538501931917716,TRX_N-00056-45866368,2022-02-22T13:40:13,Bilbao,Expense,leisure,-71.21,-592.43
buyer_1,Luis,28,ES28209538501931917716,TRX_N-00057-44498773,2022-02-23T05:59:36,Errenteria,Expense,transport,-82.76,-675.19
buyer_1,Luis,28,ES28209538501931917716,TRX_N-00058-77466348,2022-02-25T09:38:08,Oy√≥n-Oion,Expense,food,-103.91,-779.1
buyer_1,Luis,28,ES28209538501931917716,TRX_N-00059-51864008,2022-02-25T10:45:03,Bilbao,Expense,clothing,-159.58,-938.68
buyer_1,Luis,28,ES28209538501931917716,TRX_N-00060-09730614,2022-02-26T20:27:02,Bilbao,Expense,transport,-42.7,-981.38
buyer_1,Luis,28,ES28209538501931917716,TRX_N-00061-28491378,2022-02-28T08:32:08,Pasaia,Expense,transport,-53.47,-1034.85
buyer_1,Luis,28,ES28209538501931917716,TRX_N-00062-83954300,2022-03-01T18:09:33,Bilbao,incomes,salary,1514.99,480.14
buyer_1,Luis,28,ES28209538501931917716,TRX_N-00063-24949586,2022-03-01T18:09:33,Bilbao,incomes,salary_partner,1015.63,1495.77
buyer_1,Luis,28,ES28209538501931917716,TRX_N-00064-47863110,2022-03-01T18:09:33,Bilbao,incomes,extra_income,159.05,1654.82
buyer_1,Luis,28,ES28209538501931917716,TRX_N-00065-04085718,2022-03-02T18:01:45,Bilbao,Expense,food,-64.0,1590.82
buyer_1,Luis,28,ES28209538501931917716,TRX_N-00066-41678734,2022-03-02T14:49:45,Bilbao,Expense,transport,-65.12,1525.7
buyer_1,Luis,28,ES28209538501931917716,TRX_N-00067-21518995,2022-03-04T12:45:52,Bilbao,expenses,mortgage,-928.53,597.17
buyer_1,Luis,28,ES28209538501931917716,TRX_N-00068-15602312,2022-03-04T14:15:35,Bilbao,Expense,gifts,-778.55,-181.38
buyer_1,Luis,28,ES28209538501931917716,TRX_N-00069-19150912,2022-03-05T11:12:01,Bilbao,expenses,water,-40.04,-221.42
buyer_1,Luis,28,ES28209538501931917716,TRX_N-00070-29658348,2022-03-05T11:51:47,Bilbao,expenses,electricity,-25.79,-247.21
buyer_1,Luis,28,ES28209538501931917716,TRX_N-00071-32092756,2022-03-06T18:26:23,Eibar,Expense,leisure,-78.85,-326.06
buyer_1,Luis,28,ES28209538501931917716,TRX_N-00072-51212717,2022-03-07T08:32:47,Bilbao,Expense,leisure,-84.64,-410.7
buyer_1,Luis,28,ES28209538501931917716,TRX_N-00073-54798868,2022-03-08T17:01:26,Bilbao,expenses,gas,-82.07,-492.77
buyer_1,Luis,28,ES28209538501931917716,TRX_N-00074-91694263,2022-03-08T17:16:10,Bilbao,expenses,internet,-42.0,-534.77
buyer_1,Luis,28,ES28209538501931917716,TRX_N-00075-05102007,2022-03-08T18:04:54,Bilbao,expenses,phone,-34.85,-569.62
buyer_1,Luis,28,ES28209538501931917716,TRX_N-00076-20103084,2022-03-10T11:33:28,Bilbao,Expense,food,-65.77,-635.39
buyer_1,Luis,28,ES28209538501931917716,TRX_N-00077-83808635,2022-03-10T08:35:42,Bilbao,Expense,gifts,-840.38,-1475.77
buyer_1,Luis,28,ES28209538501931917716,TRX_N-00078-82935130,2022-03-11T18:29:26,Bilbao,Expense,cash,-100.0,-1575.77
buyer_1,Luis,28,ES28209538501931917716,TRX_N-00079-11747566,2022-03-11T23:16:28,Bilbao,Expense,gifts,-95.2,-1670.97
buyer_1,Luis,28,ES28209538501931917716,TRX_N-00080-33337006,2022-03-12T15:01:26,Bilbao,Expense,food,-69.19,-1740.16
buyer_1,Luis,28,ES28209538501931917716,TRX_N-00081-80585455,2022-03-12T03:23:51,Bilbao,Expense,travel,-784.76,-2524.92
buyer_1,Luis,28,ES28209538501931917716,TRX_N-00082-45258330,2022-03-13T08:09:58,Labastida,Expense,leisure,-52.67,-2577.59
buyer_1,Luis,28,ES28209538501931917716,TRX_N-00083-38267908,2022-03-20T17:28:11,Eibar,Expense,food,-74.94,-2652.53
buyer_1,Luis,28,ES28209538501931917716,TRX_N-00084-71852938,2022-03-21T10:51:17,Bilbao,Expense,education,-48.99,-2701.52
buyer_1,Luis,28,ES28209538501931917716,TRX_N-00085-82982733,2022-03-22T10:55:24,Bilbao,Expense,food,-63.6,-2765.12
buyer_1,Luis,28,ES28209538501931917716,TRX_N-00086-94387960,2022-03-22T12:57:07,Bilbao,Expense,clothing,-75.27,-2840.39
buyer_1,Luis,28,ES28209538501931917716,TRX_N-00087-04036411,2022-03-23T18:26:58,Bilbao,Expense,cash,-100.0,-2940.39
buyer_1,Luis,28,ES28209538501931917716,TRX_N-00088-81272443,2022-03-23T20:30:49,Bilbao,Expense,repairs,-143.26,-3083.65
buyer_1,Luis,28,ES28209538501931917716,TRX_N-00089-42345544,2022-03-24T20:00:24,Alegr√≠a-Dulantzi,Expense,leisure,-43.61,-3127.26
buyer_1,Luis,28,ES28209538501931917716,TRX_N-00090-25974785,2022-03-26T11:50:23,Leioa,Expense,healthcare,-104.61,-3231.87
buyer_1,Luis,28,ES28209538501931917716,TRX_N-00091-29958124,2022-03-27T19:07:43,Bilbao,Expense,clothing,-61.71,-3293.58
buyer_1,Luis,28,ES28209538501931917716,TRX_N-00092-44780845,2022-03-27T10:41:17,Bilbao,expenses,children,-261.68,-3555.26
buyer_1,Luis,28,ES28209538501931917716,TRX_N-00093-58484912,2022-03-28T11:48:17,Bilbao,Expense,appliances,-229.7,-3784.96
buyer_1,Luis,28,ES28209538501931917716,TRX_N-00094-40511351,2022-03-29T18:38:59,Bilbao,Expense,transport,-80.86,-3865.82
buyer_1,Luis,28,ES28209538501931917716,TRX_N-00095-99580479,2022-03-29T11:54:13,Bilbao,Expense,appliances,-201.57,-4067.39
buyer_1,Luis,28,ES28209538501931917716,TRX_N-00096-39620041,2022-03-31T00:23:30,Zuia,Expense,repairs,-235.88,-4303.27
buyer_1,Luis,28,ES28209538501931917716,TRX_N-00097-34925889,2022-04-01T17:40:26,Bilbao,incomes,salary,1514.99,-2788.28
buyer_1,Luis,28,ES28209538501931917716,TRX_N-00098-16259642,2022-04-01T17:40:26,Bilbao,incomes,salary_partner,1015.63,-1772.65
buyer_1,Luis,28,ES28209538501931917716,TRX_N-00099-47452851,2022-04-01T08:28:29,Bilbao,Expense,gifts,-58.66,-1831.31
buyer_1,Luis,28,ES28209538501931917716,TRX_N-00100-41180337,2022-04-03T19:33:17,Bilbao,Expense,transport,-59.21,-1890.52
buyer_1,Luis,28,ES28209538501931917716,TRX_N-00101-19033322,2022-04-03T22:30:22,Bilbao,Expense,cash,-100.0,-1990.52
buyer_1,Luis,28,ES28209538501931917716,TRX_N-00102-85576361,2022-04-03T19:46:16,Bilbao,Expense,gifts,-252.75,-2243.27
buyer_1,Luis,28,ES28209538501931917716,TRX_N-00103-39602826,2022-04-04T19:34:00,Bilbao,expenses,mortgage,-928.53,-3171.8
buyer_1,Luis,28,ES28209538501931917716,TRX_N-00104-06134708,2022-04-04T12:26:17,Oy√≥n-Oion,Expense,food,-72.23,-3244.03
buyer_1,Luis,28,ES28209538501931917716,TRX_N-00105-69122233,2022-04-04T14:29:21,Bilbao,Expense,appliances,-419.41,-3663.44
buyer_1,Luis,28,ES28209538501931917716,TRX_N-00106-67791006,2022-04-05T18:20:37,Bilbao,expenses,water,-21.59,-3685.03
buyer_1,Luis,28,ES28209538501931917716,TRX_N-00107-61355631,2022-04-05T13:11:16,Bilbao,expenses,internet,-42.0,-3727.03
buyer_1,Luis,28,ES28209538501931917716,TRX_N-00108-26354986,2022-04-06T10:08:59,Bilbao,Expense,cash,-100.0,-3827.03
buyer_1,Luis,28,ES28209538501931917716,TRX_N-00109-28627294,2022-04-08T15:20:46,Bilbao,expenses,electricity,-31.64,-3858.67
buyer_1,Luis,28,ES28209538501931917716,TRX_N-00110-03146628,2022-04-08T18:13:26,Bilbao,expenses,gas,-57.74,-3916.41
buyer_1,Luis,28,ES28209538501931917716,TRX_N-00111-14119236,2022-04-08T08:29:48,Bilbao,expenses,phone,-31.4,-3947.81
buyer_1,Luis,28,ES28209538501931917716,TRX_N-00112-34342035,2022-04-08T17:42:01,Bilbao,Expense,cash,-100.0,-4047.81
buyer_1,Luis,28,ES28209538501931917716,TRX_N-00113-49215553,2022-04-08T06:28:26,Bilbao,Expense,repairs,-181.98,-4229.79
buyer_1,Luis,28,ES28209538501931917716,TRX_N-00114-26693392,2022-04-09T16:47:35,Bilbao,Expense,clothing,-73.95,-4303.74
buyer_1,Luis,28,ES28209538501931917716,TRX_N-00115-66279411,2022-04-13T19:14:17,Bilbao,Expense,leisure,-46.12,-4349.86
buyer_1,Luis,28,ES28209538501931917716,TRX_N-00116-95397611,2022-04-13T18:21:18,Bilbao,Expense,appliances,-297.27,-4647.13
buyer_1,Luis,28,ES28209538501931917716,TRX_N-00117-47152995,2022-04-14T17:37:06,Bilbao,Expense,cash,-100.0,-4747.13
buyer_1,Luis,28,ES28209538501931917716,TRX_N-00118-36010038,2022-04-15T03:56:11,Andoain,Expense,gifts,-84.86,-4831.99
buyer_1,Luis,28,ES28209538501931917716,TRX_N-00119-87332264,2022-04-17T14:21:29,Bilbao,Expense,cash,-100.0,-4931.99
buyer_1,Luis,28,ES28209538501931917716,TRX_N-00120-50690299,2022-04-19T18:32:17,Bilbao,Expense,transport,-89.5,-5021.49
buyer_1,Luis,28,ES28209538501931917716,TRX_N-00121-91205055,2022-04-19T19:02:26,Bilbao,Expense,leisure,-47.72,-5069.21
buyer_1,Luis,28,ES28209538501931917716,TRX_N-00122-49204439,2022-04-19T16:02:19,Bilbao,Expense,repairs,-171.74,-5240.95
buyer_1,Luis,28,ES28209538501931917716,TRX_N-00123-37769683,2022-04-20T14:45:36,Bilbao,Expense,food,-122.52,-5363.47
buyer_1,Luis,28,ES28209538501931917716,TRX_N-00124-09664478,2022-04-21T03:09:49,Bilbao,Expense,food,-80.9,-5444.37
buyer_1,Luis,28,ES28209538501931917716,TRX_N-00125-41569706,2022-04-21T14:01:52,Bilbao,Expense,transport,-44.42,-5488.79
buyer_1,Luis,28,ES28209538501931917716,TRX_N-00126-64057321,2022-04-21T00:43:18,Durango,Expense,clothing,-84.32,-5573.11
buyer_1,Luis,28,ES28209538501931917716,TRX_N-00127-34635349,2022-04-21T10:09:19,Bilbao,Expense,repairs,-120.74,-5693.85
buyer_1,Luis,28,ES28209538501931917716,TRX_N-00128-50318137,2022-04-21T11:56:25,Bilbao,Expense,gifts,-485.16,-6179.01
buyer_1,Luis,28,ES28209538501931917716,TRX_N-00129-58389840,2022-04-22T11:47:32,Bilbao,Expense,leisure,-73.41,-6252.42
buyer_1,Luis,28,ES28209538501931917716,TRX_N-00130-12258348,2022-04-23T09:50:53,Bilbao,Expense,food,-87.3,-6339.72
buyer_1,Luis,28,ES28209538501931917716,TRX_N-00131-92951214,2022-04-23T13:28:47,Bilbao,Expense,healthcare,-121.39,-6461.11
buyer_1,Luis,28,ES28209538501931917716,TRX_N-00132-78954681,2022-04-24T17:48:07,Donostia,Expense,transport,-51.71,-6512.82
buyer_1,Luis,28,ES28209538501931917716,TRX_N-00133-19008145,2022-04-24T19:36:00,Bilbao,Expense,cash,-100.0,-6612.82
buyer_1,Luis,28,ES28209538501931917716,TRX_N-00134-74474517,2022-04-24T14:13:34,Bilbao,Expense,gifts,-542.21,-7155.03
buyer_1,Luis,28,ES28209538501931917716,TRX_N-00135-25885805,2022-04-25T09:56:28,Mungia,Expense,cash,-100.0,-7255.03
buyer_1,Luis,28,ES28209538501931917716,TRX_N-00136-91756156,2022-04-26T17:35:37,Bilbao,Expense,clothing,-78.85,-7333.88
buyer_1,Luis,28,ES28209538501931917716,TRX_N-00137-13490161,2022-04-28T13:49:05,Bilbao,Expense,transport,-55.41,-7389.29
buyer_1,Luis,28,ES28209538501931917716,TRX_N-00138-74142828,2022-04-29T14:32:22,Bilbao,Expense,repairs,-34.22,-7423.51
buyer_1,Luis,28,ES28209538501931917716,TRX_N-00139-62724364,2022-05-01T08:02:16,Bilbao,incomes,salary,1514.99,-5908.52
buyer_1,Luis,28,ES28209538501931917716,TRX_N-00140-59556576,2022-05-01T08:02:16,Bilbao,incomes,salary_partner,1015.63,-4892.89
buyer_1,Luis,28,ES28209538501931917716,TRX_N-00141-87588624,2022-05-04T15:51:17,Bilbao,expenses,mortgage,-928.53,-5821.42
buyer_1,Luis,28,ES28209538501931917716,TRX_N-00142-72058833,2022-05-04T17:05:42,Bilbao,Expense,transport,-50.15,-5871.57
buyer_1,Luis,28,ES28209538501931917716,TRX_N-00143-00670896,2022-05-04T08:38:54,Bermeo,Expense,leisure,-41.01,-5912.58
buyer_1,Luis,28,ES28209538501931917716,TRX_N-00144-70477681,2022-05-04T08:49:19,Bilbao,Expense,repairs,-164.13,-6076.71
buyer_1,Luis,28,ES28209538501931917716,TRX_N-00145-63704429,2022-05-05T04:34:20,Bilbao,expenses,gas,-104.43,-6181.14
buyer_1,Luis,28,ES28209538501931917716,TRX_N-00146-92149754,2022-05-05T03:23:31,Arrasate,Expense,gifts,-340.03,-6521.17
buyer_1,Luis,28,ES28209538501931917716,TRX_N-00147-78363936,2022-05-07T20:28:05,Bilbao,expenses,water,-35.71,-6556.88
buyer_1,Luis,28,ES28209538501931917716,TRX_N-00148-41904224,2022-05-07T11:18:42,Bilbao,Expense,leisure,-78.03,-6634.91
buyer_1,Luis,28,ES28209538501931917716,TRX_N-00149-43536474,2022-05-07T16:19:35,Bilbao,Expense,healthcare,-153.92,-6788.83
buyer_1,Luis,28,ES28209538501931917716,TRX_N-00150-74966113,2022-05-08T17:00:00,Bilbao,expenses,electricity,-24.56,-6813.39
buyer_1,Luis,28,ES28209538501931917716,TRX_N-00151-85288651,2022-05-08T13:54:52,Bilbao,expenses,internet,-42.0,-6855.39
buyer_1,Luis,28,ES28209538501931917716,TRX_N-00152-14753428,2022-05-08T16:23:46,Bilbao,expenses,phone,-43.68,-6899.07
buyer_1,Luis,28,ES28209538501931917716,TRX_N-00153-67654506,2022-05-08T09:15:12,Bilbao,Expense,food,-83.31,-6982.38
buyer_1,Luis,28,ES28209538501931917716,TRX_N-00154-98981628,2022-05-08T11:44:07,Bilbao,Expense,cash,-100.0,-7082.38
buyer_1,Luis,28,ES28209538501931917716,TRX_N-00155-84271810,2022-05-08T10:35:33,Bilbao,Expense,repairs,-323.46,-7405.84
buyer_1,Luis,28,ES28209538501931917716,TRX_N-00156-80965495,2022-05-09T10:31:00,Bilbao,Expense,food,-90.89,-7496.73
buyer_1,Luis,28,ES28209538501931917716,TRX_N-00157-91181272,2022-05-10T15:13:26,Salvatierra/Agurain,Expense,food,-90.86,-7587.59
buyer_1,Luis,28,ES28209538501931917716,TRX_N-00158-09905828,2022-05-10T08:41:33,Bilbao,Expense,leisure,-41.25,-7628.84
buyer_1,Luis,28,ES28209538501931917716,TRX_N-00159-60561517,2022-05-11T19:23:00,Bilbao,Expense,gifts,-570.58,-8199.42
buyer_1,Luis,28,ES28209538501931917716,TRX_N-00160-99358206,2022-05-12T15:35:56,Bilbao,Expense,repairs,-46.16,-8245.58
buyer_1,Luis,28,ES28209538501931917716,TRX_N-00161-20505144,2022-05-14T11:33:35,Bilbao,Expense,leisure,-20.36,-8265.94
buyer_1,Luis,28,ES28209538501931917716,TRX_N-00162-41819049,2022-05-15T12:05:02,Bilbao,Expense,food,-90.04,-8355.98
buyer_1,Luis,28,ES28209538501931917716,TRX_N-00163-17428098,2022-05-15T23:43:43,Bilbao,Expense,leisure,-26.59,-8382.57
buyer_1,Luis,28,ES28209538501931917716,TRX_N-00164-02359083,2022-05-16T19:12:14,Hernani,Expense,gifts,-340.53,-8723.1
buyer_1,Luis,28,ES28209538501931917716,TRX_N-00165-82978610,2022-05-17T08:44:38,Bilbao,Expense,cash,-100.0,-8823.1
buyer_1,Luis,28,ES28209538501931917716,TRX_N-00166-03154846,2022-05-18T09:31:59,Bilbao,Expense,gifts,-107.26,-8930.36
buyer_1,Luis,28,ES28209538501931917716,TRX_N-00167-81446009,2022-05-19T08:36:10,Bilbao,Expense,food,-61.97,-8992.33
buyer_1,Luis,28,ES28209538501931917716,TRX_N-00168-98667265,2022-05-23T14:31:48,Bilbao,Expense,transport,-58.34,-9050.67
buyer_1,Luis,28,ES28209538501931917716,TRX_N-00169-49436872,2022-05-23T19:03:19,Bilbao,Expense,repairs,-285.74,-9336.41
buyer_1,Luis,28,ES28209538501931917716,TRX_N-00170-17491662,2022-05-24T22:55:54,Bilbao,Expense,food,-119.71,-9456.12
buyer_1,Luis,28,ES28209538501931917716,TRX_N-00171-02885936,2022-05-26T02:08:52,Pasaia,Expense,cash,-100.0,-9556.12
buyer_1,Luis,28,ES28209538501931917716,TRX_N-00172-36370702,2022-05-27T08:21:25,Bilbao,Expense,leisure,-38.39,-9594.51
buyer_1,Luis,28,ES28209538501931917716,TRX_N-00173-09118519,2022-05-30T19:54:34,Bilbao,Expense,gifts,-575.74,-10170.25
buyer_1,Luis,28,ES28209538501931917716,TRX_N-00174-11060840,2022-05-31T06:07:22,Bilbao,Expense,transport,-63.1,-10233.35
buyer_1,Luis,28,ES28209538501931917716,TRX_N-00175-00901870,2022-06-01T05:04:15,Bilbao,incomes,salary,1514.99,-8718.36
buyer_1,Luis,28,ES28209538501931917716,TRX_N-00176-64393932,2022-06-01T05:04:15,Bilbao,incomes,salary_partner,1015.63,-7702.73
buyer_1,Luis,28,ES28209538501931917716,TRX_N-00177-50461148,2022-06-01T05:04:15,Bilbao,incomes,salary_bonus,1159.16,-6543.57
buyer_1,Luis,28,ES28209538501931917716,TRX_N-00178-57416575,2022-06-01T05:04:15,Bilbao,incomes,salary_partner_bonus,730.37,-5813.2
buyer_1,Luis,28,ES28209538501931917716,TRX_N-00179-04048488,2022-06-01T19:44:11,Bilbao,Expense,gifts,-842.04,-6655.24
buyer_1,Luis,28,ES28209538501931917716,TRX_N-00180-43001221,2022-06-02T09:33:25,Bilbao,expenses,taxes,-1461.64,-8116.88
buyer_1,Luis,28,ES28209538501931917716,TRX_N-00181-71398102,2022-06-02T22:27:24,Bilbao,expenses,insurance,-540.87,-8657.75
buyer_1,Luis,28,ES28209538501931917716,TRX_N-00182-44044494,2022-06-04T09:35:00,Bilbao,expenses,mortgage,-928.53,-9586.28
buyer_1,Luis,28,ES28209538501931917716,TRX_N-00183-65964019,2022-06-05T14:55:06,Bilbao,expenses,electricity,-31.69,-9617.97
buyer_1,Luis,28,ES28209538501931917716,TRX_N-00184-90121681,2022-06-05T04:29:22,Bilbao,Expense,food,-121.81,-9739.78
buyer_1,Luis,28,ES28209538501931917716,TRX_N-00185-72917048,2022-06-05T13:03:08,Arrasate,Expense,leisure,-72.23,-9812.01
buyer_1,Luis,28,ES28209538501931917716,TRX_N-00186-93342087,2022-06-06T15:57:01,Bilbao,expenses,gas,-58.88,-9870.89
buyer_1,Luis,28,ES28209538501931917716,TRX_N-00187-97064360,2022-06-06T10:02:17,Bilbao,expenses,internet,-42.0,-9912.89
buyer_1,Luis,28,ES28209538501931917716,TRX_N-00188-07677200,2022-06-06T10:39:17,Bilbao,expenses,phone,-35.44,-9948.33
buyer_1,Luis,28,ES28209538501931917716,TRX_N-00189-31791641,2022-06-07T18:44:13,Bilbao,Expense,clothing,-95.56,-10043.89
buyer_1,Luis,28,ES28209538501931917716,TRX_N-00190-73725879,2022-06-07T20:03:53,Arrasate,Expense,cash,-100.0,-10143.89
buyer_1,Luis,28,ES28209538501931917716,TRX_N-00191-03891864,2022-06-08T07:43:36,Bilbao,expenses,water,-38.54,-10182.43
buyer_1,Luis,28,ES28209538501931917716,TRX_N-00192-09154451,2022-06-09T14:35:31,Bilbao,Expense,transport,-46.4,-10228.83
buyer_1,Luis,28,ES28209538501931917716,TRX_N-00193-22979556,2022-06-10T13:22:41,Bilbao,Expense,clothing,-125.08,-10353.91
buyer_1,Luis,28,ES28209538501931917716,TRX_N-00194-08276017,2022-06-10T10:06:04,Bilbao,Expense,repairs,-284.18,-10638.09
buyer_1,Luis,28,ES28209538501931917716,TRX_N-00195-27559192,2022-06-11T15:26:44,Zarautz,Expense,food,-114.65,-10752.74
buyer_1,Luis,28,ES28209538501931917716,TRX_N-00196-78643137,2022-06-11T12:23:26,Bilbao,expenses,children,-228.0,-10980.74
buyer_1,Luis,28,ES28209538501931917716,TRX_N-00197-82067043,2022-06-12T20:37:01,Bilbao,Expense,transport,-79.33,-11060.07
buyer_1,Luis,28,ES28209538501931917716,TRX_N-00198-05761749,2022-06-12T15:22:44,Bilbao,Expense,cash,-100.0,-11160.07
buyer_1,Luis,28,ES28209538501931917716,TRX_N-00199-00287396,2022-06-13T22:40:13,Bilbao,Expense,repairs,-48.76,-11208.83
buyer_1,Luis,28,ES28209538501931917716,TRX_N-00200-14763782,2022-06-13T14:30:33,Bilbao,Expense,gifts,-524.08,-11732.91
buyer_1,Luis,28,ES28209538501931917716,TRX_N-00201-92697244,2022-06-14T09:59:32,Bilbao,Expense,education,-73.77,-11806.68
buyer_1,Luis,28,ES28209538501931917716,TRX_N-00202-03080716,2022-06-14T13:02:49,Bilbao,Expense,repairs,-64.17,-11870.85
buyer_1,Luis,28,ES28209538501931917716,TRX_N-00203-50890949,2022-06-21T03:23:44,Bilbao,Expense,leisure,-28.64,-11899.49
buyer_1,Luis,28,ES28209538501931917716,TRX_N-00204-27656849,2022-06-22T09:23:06,Bilbao,Expense,leisure,-67.95,-11967.44
buyer_1,Luis,28,ES28209538501931917716,TRX_N-00205-86111338,2022-06-24T08:50:30,Bilbao,Expense,transport,-43.63,-12011.07
buyer_1,Luis,28,ES28209538501931917716,TRX_N-00206-48919482,2022-06-25T11:55:29,Bilbao,Expense,transport,-68.66,-12079.73
buyer_1,Luis,28,ES28209538501931917716,TRX_N-00207-39285382,2022-06-27T20:37:58,Mungia,Expense,clothing,-84.91,-12164.64
buyer_1,Luis,28,ES28209538501931917716,TRX_N-00208-40698777,2022-06-28T19:48:03,Bilbao,Expense,cash,-100.0,-12264.64
buyer_1,Luis,28,ES28209538501931917716,TRX_N-00209-77882077,2022-06-29T09:12:35,Bilbao,Expense,transport,-55.84,-12320.48
buyer_1,Luis,28,ES28209538501931917716,TRX_N-00210-66571745,2022-06-29T10:56:53,Bilbao,Expense,leisure,-42.04,-12362.52
buyer_1,Luis,28,ES28209538501931917716,TRX_N-00211-93539672,2022-07-01T19:48:22,Bilbao,incomes,salary,1514.99,-10847.53
buyer_1,Luis,28,ES28209538501931917716,TRX_N-00212-24023307,2022-07-01T19:48:22,Bilbao,incomes,salary_partner,1015.63,-9831.9
buyer_1,Luis,28,ES28209538501931917716,TRX_N-00213-38109252,2022-07-01T19:48:22,Bilbao,incomes,extra_income,159.05,-9672.85
buyer_1,Luis,28,ES28209538501931917716,TRX_N-00214-75985239,2022-07-02T14:31:05,Bilbao,Expense,clothing,-110.22,-9783.07
buyer_1,Luis,28,ES28209538501931917716,TRX_N-00215-24215880,2022-07-04T03:07:35,Bilbao,expenses,mortgage,-928.53,-10711.6
buyer_1,Luis,28,ES28209538501931917716,TRX_N-00216-65574942,2022-07-04T16:00:12,Bilbao,Expense,gifts,-489.48,-11201.08
buyer_1,Luis,28,ES28209538501931917716,TRX_N-00217-67924619,2022-07-05T22:38:40,Bilbao,expenses,electricity,-46.64,-11247.72
buyer_1,Luis,28,ES28209538501931917716,TRX_N-00218-17988409,2022-07-06T22:17:59,Bilbao,Expense,education,-64.63,-11312.35
buyer_1,Luis,28,ES28209538501931917716,TRX_N-00219-53403712,2022-07-07T11:51:48,Bilbao,Expense,cash,-100.0,-11412.35
buyer_1,Luis,28,ES28209538501931917716,TRX_N-00220-81346983,2022-07-08T01:48:46,Bilbao,expenses,water,-37.36,-11449.71
buyer_1,Luis,28,ES28209538501931917716,TRX_N-00221-29408815,2022-07-08T17:48:26,Bilbao,expenses,gas,-111.23,-11560.94
buyer_1,Luis,28,ES28209538501931917716,TRX_N-00222-71326778,2022-07-08T20:25:08,Bilbao,expenses,internet,-42.0,-11602.94
buyer_1,Luis,28,ES28209538501931917716,TRX_N-00223-88636333,2022-07-08T12:53:16,Bilbao,expenses,phone,-30.75,-11633.69
buyer_1,Luis,28,ES28209538501931917716,TRX_N-00224-81619056,2022-07-08T17:38:04,Bilbao,Expense,healthcare,-61.6,-11695.29
buyer_1,Luis,28,ES28209538501931917716,TRX_N-00225-67157392,2022-07-09T14:47:45,Basauri,Expense,travel,-1539.76,-13235.05
buyer_1,Luis,28,ES28209538501931917716,TRX_N-00226-24936240,2022-07-12T09:58:39,Hernani,Expense,healthcare,-44.17,-13279.22
buyer_1,Luis,28,ES28209538501931917716,TRX_N-00227-14084135,2022-07-12T17:00:45,Bilbao,Expense,appliances,-370.52,-13649.74
buyer_1,Luis,28,ES28209538501931917716,TRX_N-00228-45432926,2022-07-14T21:22:03,Durango,Expense,food,-111.92,-13761.66
buyer_1,Luis,28,ES28209538501931917716,TRX_N-00229-73946311,2022-07-15T14:48:10,Bilbao,Expense,cash,-100.0,-13861.66
buyer_1,Luis,28,ES28209538501931917716,TRX_N-00230-74113288,2022-07-16T22:43:57,Bilbao,Expense,food,-88.51,-13950.17
buyer_1,Luis,28,ES28209538501931917716,TRX_N-00231-25585904,2022-07-16T17:45:59,Bilbao,Expense,cash,-100.0,-14050.17
buyer_1,Luis,28,ES28209538501931917716,TRX_N-00232-23253973,2022-07-17T16:47:11,Andoain,Expense,travel,-1160.14,-15210.31
buyer_1,Luis,28,ES28209538501931917716,TRX_N-00233-26441276,2022-07-20T20:34:55,Bilbao,Expense,appliances,-389.13,-15599.44
buyer_1,Luis,28,ES28209538501931917716,TRX_N-00234-68393274,2022-07-20T11:30:43,Bilbao,Expense,repairs,-193.64,-15793.08
buyer_1,Luis,28,ES28209538501931917716,TRX_N-00235-32099242,2022-07-21T14:18:21,Portugalete,Expense,leisure,-65.88,-15858.96
buyer_1,Luis,28,ES28209538501931917716,TRX_N-00236-30660746,2022-07-21T08:54:00,Bilbao,Expense,education,-62.17,-15921.13
buyer_1,Luis,28,ES28209538501931917716,TRX_N-00237-16673571,2022-07-24T16:02:52,Bilbao,Expense,food,-117.58,-16038.71
buyer_1,Luis,28,ES28209538501931917716,TRX_N-00238-05628637,2022-07-24T09:14:59,Bilbao,Expense,education,-46.22,-16084.93
buyer_1,Luis,28,ES28209538501931917716,TRX_N-00239-88337972,2022-07-24T15:29:36,Bilbao,Expense,repairs,-249.78,-16334.71
buyer_1,Luis,28,ES28209538501931917716,TRX_N-00240-14796860,2022-07-26T14:34:24,Bilbao,Expense,cash,-100.0,-16434.71
buyer_1,Luis,28,ES28209538501931917716,TRX_N-00241-57901532,2022-07-27T12:08:43,Bilbao,Expense,transport,-50.21,-16484.92
buyer_1,Luis,28,ES28209538501931917716,TRX_N-00242-29700428,2022-07-28T16:52:40,Bilbao,Expense,leisure,-71.87,-16556.79
buyer_1,Luis,28,ES28209538501931917716,TRX_N-00243-23877518,2022-07-29T09:37:29,Bilbao,Expense,repairs,-40.53,-16597.32
buyer_1,Luis,28,ES28209538501931917716,TRX_N-00244-91050448,2022-07-29T08:10:45,Bilbao,Expense,gifts,-711.96,-17309.28
buyer_1,Luis,28,ES28209538501931917716,TRX_N-00245-03469534,2022-07-30T18:43:19,Bilbao,Expense,food,-112.41,-17421.69
buyer_1,Luis,28,ES28209538501931917716,TRX_N-00246-02909020,2022-07-31T19:16:14,Bilbao,Expense,leisure,-69.63,-17491.32
buyer_1,Luis,28,ES28209538501931917716,TRX_N-00247-86683657,2022-08-01T23:27:46,Bilbao,incomes,salary,1514.99,-15976.33
buyer_1,Luis,28,ES28209538501931917716,TRX_N-00248-09437749,2022-08-01T23:27:46,Bilbao,incomes,salary_partner,1015.63,-14960.7
buyer_1,Luis,28,ES28209538501931917716,TRX_N-00249-83395540,2022-08-02T21:35:21,Bilbao,Expense,transport,-44.22,-15004.92
buyer_1,Luis,28,ES28209538501931917716,TRX_N-00250-42131598,2022-08-02T11:01:27,Bilbao,Expense,leisure,-62.23,-15067.15
buyer_1,Luis,28,ES28209538501931917716,TRX_N-00251-39013376,2022-08-02T18:09:18,Bilbao,Expense,healthcare,-176.35,-15243.5
buyer_1,Luis,28,ES28209538501931917716,TRX_N-00252-63151167,2022-08-04T14:44:33,Bilbao,expenses,mortgage,-928.53,-16172.03
buyer_1,Luis,28,ES28209538501931917716,TRX_N-00253-62605341,2022-08-04T20:45:38,Bilbao,Expense,cash,-100.0,-16272.03
buyer_1,Luis,28,ES28209538501931917716,TRX_N-00254-42576567,2022-08-05T18:24:07,Bilbao,expenses,gas,-58.32,-16330.35
buyer_1,Luis,28,ES28209538501931917716,TRX_N-00255-69599944,2022-08-07T00:34:52,Bilbao,expenses,water,-33.99,-16364.34
buyer_1,Luis,28,ES28209538501931917716,TRX_N-00256-07191019,2022-08-07T15:01:21,Bilbao,expenses,internet,-42.0,-16406.34
buyer_1,Luis,28,ES28209538501931917716,TRX_N-00257-03254352,2022-08-07T16:44:42,Bilbao,expenses,phone,-36.09,-16442.43
buyer_1,Luis,28,ES28209538501931917716,TRX_N-00258-70051971,2022-08-07T12:25:02,Bilbao,Expense,food,-113.43,-16555.86
buyer_1,Luis,28,ES28209538501931917716,TRX_N-00259-60688053,2022-08-07T18:45:37,Bilbao,Expense,leisure,-51.06,-16606.92
buyer_1,Luis,28,ES28209538501931917716,TRX_N-00260-46995741,2022-08-08T17:09:04,Bilbao,expenses,electricity,-31.44,-16638.36
buyer_1,Luis,28,ES28209538501931917716,TRX_N-00261-69155411,2022-08-10T12:00:57,Bilbao,Expense,cash,-100.0,-16738.36
buyer_1,Luis,28,ES28209538501931917716,TRX_N-00262-42751057,2022-08-11T09:44:10,Bilbao,Expense,food,-85.97,-16824.33
buyer_1,Luis,28,ES28209538501931917716,TRX_N-00263-25274731,2022-08-11T21:43:15,Bilbao,Expense,cash,-100.0,-16924.33
buyer_1,Luis,28,ES28209538501931917716,TRX_N-00264-72977621,2022-08-12T14:15:40,Hondarribia,Expense,cash,-100.0,-17024.33
buyer_1,Luis,28,ES28209538501931917716,TRX_N-00265-53243225,2022-08-13T15:50:57,Bilbao,Expense,food,-105.4,-17129.73
buyer_1,Luis,28,ES28209538501931917716,TRX_N-00266-05425799,2022-08-15T12:53:28,Bilbao,Expense,repairs,-202.68,-17332.41
buyer_1,Luis,28,ES28209538501931917716,TRX_N-00267-39728088,2022-08-16T17:33:00,Bilbao,Expense,transport,-83.71,-17416.12
buyer_1,Luis,28,ES28209538501931917716,TRX_N-00268-82566327,2022-08-18T20:12:51,Bilbao,Expense,leisure,-71.87,-17487.99
buyer_1,Luis,28,ES28209538501931917716,TRX_N-00269-67452317,2022-08-19T17:24:16,Bilbao,Expense,clothing,-124.9,-17612.89
buyer_1,Luis,28,ES28209538501931917716,TRX_N-00270-68509554,2022-08-21T23:23:36,Bilbao,Expense,food,-75.5,-17688.39
buyer_1,Luis,28,ES28209538501931917716,TRX_N-00271-85827382,2022-08-25T14:31:37,Bilbao,Expense,cash,-100.0,-17788.39
buyer_1,Luis,28,ES28209538501931917716,TRX_N-00272-91439583,2022-08-28T09:50:19,Bilbao,Expense,food,-69.81,-17858.2
buyer_1,Luis,28,ES28209538501931917716,TRX_N-00273-99916137,2022-08-28T21:48:40,Bilbao,Expense,cash,-100.0,-17958.2
buyer_1,Luis,28,ES28209538501931917716,TRX_N-00274-13167858,2022-08-30T15:14:55,Bilbao,Expense,clothing,-76.41,-18034.61
buyer_1,Luis,28,ES28209538501931917716,TRX_N-00275-62178708,2022-08-31T13:01:29,Bilbao,Expense,transport,-85.84,-18120.45
buyer_1,Luis,28,ES28209538501931917716,TRX_N-00276-45343188,2022-08-31T21:39:17,Bilbao,Expense,cash,-100.0,-18220.45
buyer_1,Luis,28,ES28209538501931917716,TRX_N-00277-23362566,2022-09-01T07:10:26,Bilbao,incomes,salary,1514.99,-16705.46
buyer_1,Luis,28,ES28209538501931917716,TRX_N-00278-90342410,2022-09-01T07:10:26,Bilbao,incomes,salary_partner,1015.63,-15689.83
buyer_1,Luis,28,ES28209538501931917716,TRX_N-00279-82211661,2022-09-02T06:07:08,Bilbao,Expense,repairs,-274.65,-15964.48
buyer_1,Luis,28,ES28209538501931917716,TRX_N-00280-59699333,2022-09-03T18:32:59,Salvatierra/Agurain,Expense,gifts,-568.91,-16533.39
buyer_1,Luis,28,ES28209538501931917716,TRX_N-00281-70621322,2022-09-04T21:54:49,Bilbao,expenses,mortgage,-928.53,-17461.92
buyer_1,Luis,28,ES28209538501931917716,TRX_N-00282-00983139,2022-09-05T08:14:02,Bilbao,expenses,internet,-42.0,-17503.92
buyer_1,Luis,28,ES28209538501931917716,TRX_N-00283-75573451,2022-09-06T16:32:46,Bilbao,expenses,water,-26.38,-17530.3
buyer_1,Luis,28,ES28209538501931917716,TRX_N-00284-93487846,2022-09-06T15:52:38,Bilbao,Expense,leisure,-75.02,-17605.32
buyer_1,Luis,28,ES28209538501931917716,TRX_N-00285-87588997,2022-09-07T13:57:49,Bilbao,Expense,transport,-82.25,-17687.57
buyer_1,Luis,28,ES28209538501931917716,TRX_N-00286-04807378,2022-09-07T12:43:43,Bilbao,expenses,children,-133.12,-17820.69
buyer_1,Luis,28,ES28209538501931917716,TRX_N-00287-32768291,2022-09-08T11:15:50,Bilbao,expenses,phone,-38.49,-17859.18
buyer_1,Luis,28,ES28209538501931917716,TRX_N-00288-46803887,2022-09-08T14:30:26,Bilbao,expenses,electricity,-69.12,-17928.3
buyer_1,Luis,28,ES28209538501931917716,TRX_N-00289-20887515,2022-09-08T18:24:16,Bilbao,expenses,gas,-74.93,-18003.23
buyer_1,Luis,28,ES28209538501931917716,TRX_N-00290-05652192,2022-09-08T08:54:49,Bilbao,Expense,travel,-353.8,-18357.03
buyer_1,Luis,28,ES28209538501931917716,TRX_N-00291-96719526,2022-09-09T12:50:14,Bilbao,Expense,transport,-47.48,-18404.51
buyer_1,Luis,28,ES28209538501931917716,TRX_N-00292-70358033,2022-09-09T16:52:12,Bilbao,Expense,cash,-100.0,-18504.51
buyer_1,Luis,28,ES28209538501931917716,TRX_N-00293-78103981,2022-09-10T20:22:55,Bilbao,Expense,cash,-100.0,-18604.51
buyer_1,Luis,28,ES28209538501931917716,TRX_N-00294-00020501,2022-09-10T19:49:50,Alegr√≠a-Dulantzi,Expense,gifts,-416.61,-19021.12
buyer_1,Luis,28,ES28209538501931917716,TRX_N-00295-46275215,2022-09-11T12:52:29,Salvatierra/Agurain,Expense,food,-64.44,-19085.56
buyer_1,Luis,28,ES28209538501931917716,TRX_N-00296-45031839,2022-09-13T14:01:35,Bilbao,Expense,transport,-71.85,-19157.41
buyer_1,Luis,28,ES28209538501931917716,TRX_N-00297-60068445,2022-09-14T19:01:56,Bilbao,Expense,cash,-100.0,-19257.41
buyer_1,Luis,28,ES28209538501931917716,TRX_N-00298-63699692,2022-09-16T15:30:21,Bilbao,Expense,transport,-54.57,-19311.98
buyer_1,Luis,28,ES28209538501931917716,TRX_N-00299-06452112,2022-09-16T17:04:51,Bilbao,Expense,leisure,-58.14,-19370.12
buyer_1,Luis,28,ES28209538501931917716,TRX_N-00300-82252322,2022-09-16T13:41:33,Bilbao,Expense,clothing,-129.65,-19499.77
buyer_1,Luis,28,ES28209538501931917716,TRX_N-00301-96875906,2022-09-17T00:45:29,Berango,Expense,leisure,-45.04,-19544.81
buyer_1,Luis,28,ES28209538501931917716,TRX_N-00302-51764309,2022-09-18T22:37:48,Bilbao,expenses,children,-211.63,-19756.44
buyer_1,Luis,28,ES28209538501931917716,TRX_N-00303-28509905,2022-09-20T14:02:55,Bilbao,Expense,food,-90.25,-19846.69
buyer_1,Luis,28,ES28209538501931917716,TRX_N-00304-71919471,2022-09-22T10:56:01,Bilbao,Expense,cash,-100.0,-19946.69
buyer_1,Luis,28,ES28209538501931917716,TRX_N-00305-45658438,2022-09-23T18:35:44,Bilbao,Expense,food,-107.34,-20054.03
buyer_1,Luis,28,ES28209538501931917716,TRX_N-00306-57424963,2022-09-23T16:35:52,Alegr√≠a-Dulantzi,Expense,leisure,-83.48,-20137.51
buyer_1,Luis,28,ES28209538501931917716,TRX_N-00307-00880577,2022-09-23T11:36:34,Bilbao,Expense,education,-54.51,-20192.02
buyer_1,Luis,28,ES28209538501931917716,TRX_N-00308-57820020,2022-09-24T20:26:38,Donostia,Expense,cash,-100.0,-20292.02
buyer_1,Luis,28,ES28209538501931917716,TRX_N-00309-14411813,2022-09-25T06:13:14,Bilbao,Expense,leisure,-58.93,-20350.95
buyer_1,Luis,28,ES28209538501931917716,TRX_N-00310-13826240,2022-09-25T09:57:02,Bilbao,Expense,clothing,-148.65,-20499.6
buyer_1,Luis,28,ES28209538501931917716,TRX_N-00311-82432467,2022-09-29T18:18:59,Bilbao,Expense,food,-75.92,-20575.52
buyer_1,Luis,28,ES28209538501931917716,TRX_N-00312-42444927,2022-09-29T18:40:29,Bilbao,Expense,leisure,-46.89,-20622.41
buyer_1,Luis,28,ES28209538501931917716,TRX_N-00313-89103972,2022-09-30T22:06:53,Bilbao,Expense,appliances,-285.51,-20907.92
buyer_1,Luis,28,ES28209538501931917716,TRX_N-00314-75630430,2022-10-01T08:00:31,Bilbao,incomes,salary,1514.99,-19392.93
buyer_1,Luis,28,ES28209538501931917716,TRX_N-00315-78228107,2022-10-01T08:00:31,Bilbao,incomes,salary_partner,1015.63,-18377.3
buyer_1,Luis,28,ES28209538501931917716,TRX_N-00316-48011462,2022-10-01T15:21:01,Bilbao,Expense,transport,-53.57,-18430.87
buyer_1,Luis,28,ES28209538501931917716,TRX_N-00317-52283020,2022-10-01T11:33:05,Bilbao,Expense,education,-43.63,-18474.5
buyer_1,Luis,28,ES28209538501931917716,TRX_N-00318-94873009,2022-10-04T18:41:34,Bilbao,expenses,mortgage,-928.53,-19403.03
buyer_1,Luis,28,ES28209538501931917716,TRX_N-00319-05380558,2022-10-04T11:21:59,Bilbao,Expense,repairs,-139.85,-19542.88
buyer_1,Luis,28,ES28209538501931917716,TRX_N-00320-08039294,2022-10-05T11:17:19,Bilbao,expenses,water,-27.64,-19570.52
buyer_1,Luis,28,ES28209538501931917716,TRX_N-00321-18625584,2022-10-07T15:21:40,Bilbao,Expense,education,-71.02,-19641.54
buyer_1,Luis,28,ES28209538501931917716,TRX_N-00322-34437174,2022-10-08T08:33:47,Bilbao,expenses,internet,-42.0,-19683.54
buyer_1,Luis,28,ES28209538501931917716,TRX_N-00323-67616582,2022-10-08T12:32:05,Bilbao,expenses,phone,-43.37,-19726.91
buyer_1,Luis,28,ES28209538501931917716,TRX_N-00324-52124918,2022-10-08T18:36:27,Bilbao,expenses,electricity,-45.13,-19772.04
buyer_1,Luis,28,ES28209538501931917716,TRX_N-00325-86597486,2022-10-08T14:41:49,Bilbao,expenses,gas,-107.5,-19879.54
buyer_1,Luis,28,ES28209538501931917716,TRX_N-00326-31113677,2022-10-09T12:37:37,Bilbao,Expense,leisure,-71.91,-19951.45
buyer_1,Luis,28,ES28209538501931917716,TRX_N-00327-75763213,2022-10-09T17:56:20,Bilbao,Expense,cash,-100.0,-20051.45
buyer_1,Luis,28,ES28209538501931917716,TRX_N-00328-76506682,2022-10-10T11:58:04,Salvatierra/Agurain,Expense,transport,-89.84,-20141.29
buyer_1,Luis,28,ES28209538501931917716,TRX_N-00329-76482393,2022-10-10T20:17:41,Bilbao,Expense,education,-57.84,-20199.13
buyer_1,Luis,28,ES28209538501931917716,TRX_N-00330-60655106,2022-10-12T13:17:43,Bilbao,Expense,transport,-84.01,-20283.14
buyer_1,Luis,28,ES28209538501931917716,TRX_N-00331-63382438,2022-10-13T08:19:05,Bilbao,Expense,clothing,-134.39,-20417.53
buyer_1,Luis,28,ES28209538501931917716,TRX_N-00332-08963471,2022-10-14T17:19:24,Bilbao,Expense,repairs,-65.22,-20482.75
buyer_1,Luis,28,ES28209538501931917716,TRX_N-00333-74271361,2022-10-15T11:26:10,Bilbao,Expense,cash,-100.0,-20582.75
buyer_1,Luis,28,ES28209538501931917716,TRX_N-00334-23660606,2022-10-18T21:29:45,Bilbao,Expense,transport,-55.87,-20638.62
buyer_1,Luis,28,ES28209538501931917716,TRX_N-00335-56486616,2022-10-19T06:37:33,Bilbao,Expense,food,-101.86,-20740.48
buyer_1,Luis,28,ES28209538501931917716,TRX_N-00336-55264871,2022-10-21T15:44:13,Bilbao,Expense,food,-79.13,-20819.61
buyer_1,Luis,28,ES28209538501931917716,TRX_N-00337-71001366,2022-10-22T16:39:55,Bilbao,Expense,repairs,-211.53,-21031.14
buyer_1,Luis,28,ES28209538501931917716,TRX_N-00338-45152085,2022-10-23T00:44:37,Bilbao,Expense,travel,-1892.12,-22923.26
buyer_1,Luis,28,ES28209538501931917716,TRX_N-00339-38057506,2022-10-25T21:40:53,Irun,Expense,food,-101.54,-23024.8
buyer_1,Luis,28,ES28209538501931917716,TRX_N-00340-61610988,2022-10-26T22:59:18,Bilbao,expenses,children,-56.95,-23081.75
buyer_1,Luis,28,ES28209538501931917716,TRX_N-00341-84230435,2022-10-28T11:53:44,Bilbao,Expense,transport,-53.24,-23134.99
buyer_1,Luis,28,ES28209538501931917716,TRX_N-00342-87564430,2022-10-31T11:32:29,Bilbao,Expense,leisure,-57.41,-23192.4
buyer_1,Luis,28,ES28209538501931917716,TRX_N-00343-29313591,2022-11-01T08:35:55,Bilbao,incomes,salary,1514.99,-21677.41
buyer_1,Luis,28,ES28209538501931917716,TRX_N-00344-58046730,2022-11-01T08:35:55,Bilbao,incomes,salary_partner,1015.63,-20661.78
buyer_1,Luis,28,ES28209538501931917716,TRX_N-00345-87109655,2022-11-01T08:35:55,Bilbao,incomes,extra_income,159.05,-20502.73
buyer_1,Luis,28,ES28209538501931917716,TRX_N-00346-71281008,2022-11-01T12:07:24,Bilbao,Expense,cash,-100.0,-20602.73
buyer_1,Luis,28,ES28209538501931917716,TRX_N-00347-99506871,2022-11-03T10:12:17,Bilbao,Expense,clothing,-155.92,-20758.65
buyer_1,Luis,28,ES28209538501931917716,TRX_N-00348-68582482,2022-11-04T15:39:15,Bilbao,expenses,mortgage,-928.53,-21687.18
buyer_1,Luis,28,ES28209538501931917716,TRX_N-00349-39028148,2022-11-04T15:13:07,Bilbao,Expense,leisure,-72.27,-21759.45
buyer_1,Luis,28,ES28209538501931917716,TRX_N-00350-25105277,2022-11-05T12:28:36,Iru√±a de Oca,Expense,cash,-100.0,-21859.45
buyer_1,Luis,28,ES28209538501931917716,TRX_N-00351-82655031,2022-11-06T10:38:20,Bilbao,expenses,gas,-88.77,-21948.22
buyer_1,Luis,28,ES28209538501931917716,TRX_N-00352-52055128,2022-11-06T14:19:50,Bilbao,expenses,internet,-42.0,-21990.22
buyer_1,Luis,28,ES28209538501931917716,TRX_N-00353-95769173,2022-11-08T18:35:42,Bilbao,expenses,water,-41.46,-22031.68
buyer_1,Luis,28,ES28209538501931917716,TRX_N-00354-49634141,2022-11-08T16:17:46,Bilbao,expenses,electricity,-84.07,-22115.75
buyer_1,Luis,28,ES28209538501931917716,TRX_N-00355-42930961,2022-11-08T16:47:37,Bilbao,expenses,phone,-40.16,-22155.91
buyer_1,Luis,28,ES28209538501931917716,TRX_N-00356-27606433,2022-11-08T16:22:32,Bilbao,Expense,leisure,-44.99,-22200.9
buyer_1,Luis,28,ES28209538501931917716,TRX_N-00357-19626204,2022-11-08T23:11:01,Amurrio,Expense,repairs,-250.93,-22451.83
buyer_1,Luis,28,ES28209538501931917716,TRX_N-00358-81835790,2022-11-11T17:33:11,Bilbao,Expense,healthcare,-62.15,-22513.98
buyer_1,Luis,28,ES28209538501931917716,TRX_N-00359-92503041,2022-11-13T16:57:46,Bilbao,Expense,leisure,-60.52,-22574.5
buyer_1,Luis,28,ES28209538501931917716,TRX_N-00360-83720730,2022-11-14T05:22:50,Irun,Expense,transport,-50.52,-22625.02
buyer_1,Luis,28,ES28209538501931917716,TRX_N-00361-06665006,2022-11-14T09:48:58,Bilbao,Expense,leisure,-23.65,-22648.67
buyer_1,Luis,28,ES28209538501931917716,TRX_N-00362-24620066,2022-11-16T09:59:56,Bilbao,Expense,food,-74.68,-22723.35
buyer_1,Luis,28,ES28209538501931917716,TRX_N-00363-18762563,2022-11-18T14:44:48,Mungia,Expense,food,-60.79,-22784.14
buyer_1,Luis,28,ES28209538501931917716,TRX_N-00364-31920413,2022-11-18T10:03:54,Bilbao,Expense,repairs,-299.99,-23084.13
buyer_1,Luis,28,ES28209538501931917716,TRX_N-00365-79101995,2022-11-21T22:17:19,Sopela,Expense,food,-122.65,-23206.78
buyer_1,Luis,28,ES28209538501931917716,TRX_N-00366-74836588,2022-11-24T15:48:15,Bilbao,Expense,food,-100.82,-23307.6
buyer_1,Luis,28,ES28209538501931917716,TRX_N-00367-99776113,2022-11-24T20:08:14,Bilbao,Expense,cash,-100.0,-23407.6
buyer_1,Luis,28,ES28209538501931917716,TRX_N-00368-30757329,2022-11-26T09:21:05,Bilbao,Expense,leisure,-64.63,-23472.23
buyer_1,Luis,28,ES28209538501931917716,TRX_N-00369-14798770,2022-11-26T14:10:09,Bilbao,Expense,clothing,-127.77,-23600.0
buyer_1,Luis,28,ES28209538501931917716,TRX_N-00370-53250541,2022-11-28T23:25:32,Bilbao,Expense,cash,-100.0,-23700.0
buyer_1,Luis,28,ES28209538501931917716,TRX_N-00371-91502164,2022-11-29T18:30:09,Leioa,Expense,travel,-1442.59,-25142.59
buyer_1,Luis,28,ES28209538501931917716,TRX_N-00372-85485901,2022-11-30T15:19:25,Lasarte-Oria,Expense,cash,-100.0,-25242.59
buyer_1,Luis,28,ES28209538501931917716,TRX_N-00373-95484802,2022-12-01T09:10:25,Bilbao,incomes,salary,1514.99,-23727.6
buyer_1,Luis,28,ES28209538501931917716,TRX_N-00374-41844381,2022-12-01T09:10:25,Bilbao,incomes,salary_partner,1015.63,-22711.97
buyer_1,Luis,28,ES28209538501931917716,TRX_N-00375-42260479,2022-12-01T09:10:25,Bilbao,incomes,salary_bonus,1137.39,-21574.58
buyer_1,Luis,28,ES28209538501931917716,TRX_N-00376-32597327,2022-12-01T09:10:25,Bilbao,incomes,salary_partner_bonus,803.87,-20770.71
buyer_1,Luis,28,ES28209538501931917716,TRX_N-00377-02046524,2022-12-01T14:20:53,Bilbao,Expense,food,-88.65,-20859.36
buyer_1,Luis,28,ES28209538501931917716,TRX_N-00378-35830535,2022-12-01T14:30:11,Bilbao,Expense,transport,-42.65,-20902.01
buyer_1,Luis,28,ES28209538501931917716,TRX_N-00379-77817164,2022-12-01T00:45:04,Bilbao,Expense,cash,-100.0,-21002.01
buyer_1,Luis,28,ES28209538501931917716,TRX_N-00380-56897326,2022-12-02T20:20:54,Amurrio,Expense,food,-83.54,-21085.55
buyer_1,Luis,28,ES28209538501931917716,TRX_N-00381-43915683,2022-12-02T14:22:25,Bilbao,Expense,leisure,-46.75,-21132.3
buyer_1,Luis,28,ES28209538501931917716,TRX_N-00382-00948496,2022-12-04T09:46:12,Bilbao,expenses,mortgage,-928.53,-22060.83
buyer_1,Luis,28,ES28209538501931917716,TRX_N-00383-24475189,2022-12-04T13:50:34,Bilbao,Expense,food,-104.57,-22165.4
buyer_1,Luis,28,ES28209538501931917716,TRX_N-00384-20714795,2022-12-04T09:00:26,Bilbao,Expense,repairs,-270.18,-22435.58
buyer_1,Luis,28,ES28209538501931917716,TRX_N-00385-93060785,2022-12-06T12:41:39,Bilbao,expenses,electricity,-61.27,-22496.85
buyer_1,Luis,28,ES28209538501931917716,TRX_N-00386-63600824,2022-12-06T09:47:26,Bilbao,expenses,gas,-50.59,-22547.44
buyer_1,Luis,28,ES28209538501931917716,TRX_N-00387-36996650,2022-12-06T16:49:05,Bilbao,Expense,education,-72.03,-22619.47
buyer_1,Luis,28,ES28209538501931917716,TRX_N-00388-08930803,2022-12-07T06:14:11,Bilbao,expenses,water,-43.61,-22663.08
buyer_1,Luis,28,ES28209538501931917716,TRX_N-00389-50572157,2022-12-07T20:41:52,Bilbao,expenses,internet,-42.0,-22705.08
buyer_1,Luis,28,ES28209538501931917716,TRX_N-00390-98369240,2022-12-07T14:39:06,Bilbao,Expense,transport,-82.3,-22787.38
buyer_1,Luis,28,ES28209538501931917716,TRX_N-00391-76261571,2022-12-07T15:13:11,Bilbao,Expense,leisure,-40.37,-22827.75
buyer_1,Luis,28,ES28209538501931917716,TRX_N-00392-87846608,2022-12-07T10:15:52,Bilbao,Expense,cash,-100.0,-22927.75
buyer_1,Luis,28,ES28209538501931917716,TRX_N-00393-92799917,2022-12-08T13:56:53,Bilbao,expenses,phone,-35.5,-22963.25
buyer_1,Luis,28,ES28209538501931917716,TRX_N-00394-09559664,2022-12-09T17:13:39,Bilbao,Expense,transport,-44.86,-23008.11
buyer_1,Luis,28,ES28209538501931917716,TRX_N-00395-02758766,2022-12-09T09:42:06,Bilbao,Expense,gifts,-600.19,-23608.3
buyer_1,Luis,28,ES28209538501931917716,TRX_N-00396-07582539,2022-12-10T19:38:38,Bilbao,Expense,food,-62.38,-23670.68
buyer_1,Luis,28,ES28209538501931917716,TRX_N-00397-29839965,2022-12-10T11:41:08,Iru√±a de Oca,Expense,cash,-100.0,-23770.68
buyer_1,Luis,28,ES28209538501931917716,TRX_N-00398-62273396,2022-12-11T11:02:08,Bilbao,Expense,cash,-100.0,-23870.68
buyer_1,Luis,28,ES28209538501931917716,TRX_N-00399-69161876,2022-12-11T12:41:06,Santurtzi,Expense,repairs,-180.82,-24051.5
buyer_1,Luis,28,ES28209538501931917716,TRX_N-00400-87176691,2022-12-13T08:49:19,Bilbao,Expense,education,-57.7,-24109.2
buyer_1,Luis,28,ES28209538501931917716,TRX_N-00401-88008547,2022-12-13T01:38:52,Bilbao,Expense,cash,-100.0,-24209.2
buyer_1,Luis,28,ES28209538501931917716,TRX_N-00402-72749961,2022-12-13T08:42:48,Bilbao,Expense,repairs,-103.23,-24312.43
buyer_1,Luis,28,ES28209538501931917716,TRX_N-00403-86739695,2022-12-17T15:37:15,Basauri,Expense,healthcare,-137.77,-24450.2
buyer_1,Luis,28,ES28209538501931917716,TRX_N-00404-22022615,2022-12-17T10:13:42,Andoain,Expense,repairs,-29.29,-24479.49
buyer_1,Luis,28,ES28209538501931917716,TRX_N-00405-03880616,2022-12-18T18:16:41,Bilbao,Expense,food,-84.95,-24564.44
buyer_1,Luis,28,ES28209538501931917716,TRX_N-00406-24699080,2022-12-19T15:39:16,Bilbao,Expense,cash,-100.0,-24664.44
buyer_1,Luis,28,ES28209538501931917716,TRX_N-00407-18345681,2022-12-20T12:44:46,Bilbao,Expense,leisure,-63.45,-24727.89
buyer_1,Luis,28,ES28209538501931917716,TRX_N-00408-17686321,2022-12-21T20:32:24,Bilbao,Expense,leisure,-74.2,-24802.09
buyer_1,Luis,28,ES28209538501931917716,TRX_N-00409-70154562,2022-12-21T20:31:17,Bilbao,Expense,gifts,-381.7,-25183.79
buyer_1,Luis,28,ES28209538501931917716,TRX_N-00410-29998294,2022-12-22T14:59:16,Bilbao,Expense,food,-81.94,-25265.73
buyer_1,Luis,28,ES28209538501931917716,TRX_N-00411-61038305,2022-12-22T09:20:31,Bilbao,Expense,cash,-100.0,-25365.73
buyer_1,Luis,28,ES28209538501931917716,TRX_N-00412-17714778,2022-12-23T11:47:06,Bilbao,Expense,gifts,-290.0,-25655.73
buyer_1,Luis,28,ES28209538501931917716,TRX_N-00413-98369766,2022-12-24T13:47:51,Bilbao,Expense,transport,-45.11,-25700.84
buyer_1,Luis,28,ES28209538501931917716,TRX_N-00414-77454863,2023-01-01T14:50:31,Bilbao,incomes,salary,1573.35,-24127.49
buyer_1,Luis,28,ES28209538501931917716,TRX_N-00415-72532435,2023-01-01T14:50:31,Bilbao,incomes,salary_partner,1054.75,-23072.74
buyer_1,Luis,28,ES28209538501931917716,TRX_N-00416-29759397,2023-01-01T15:30:39,Bilbao,Expense,healthcare,-160.76,-23233.5
buyer_1,Luis,28,ES28209538501931917716,TRX_N-00417-17594703,2023-01-01T08:05:06,Bilbao,Expense,cash,-100.0,-23333.5
buyer_1,Luis,28,ES28209538501931917716,TRX_N-00418-61774975,2023-01-02T17:41:39,Bilbao,expenses,children,-191.91,-23525.41
buyer_1,Luis,28,ES28209538501931917716,TRX_N-00419-00454981,2023-01-04T14:00:05,Bilbao,expenses,mortgage,-928.53,-24453.94
buyer_1,Luis,28,ES28209538501931917716,TRX_N-00420-39271673,2023-01-04T14:36:30,Bilbao,Expense,leisure,-58.64,-24512.58
buyer_1,Luis,28,ES28209538501931917716,TRX_N-00421-53194183,2023-01-05T15:18:24,Lasarte-Oria,Expense,food,-67.55,-24580.13
buyer_1,Luis,28,ES28209538501931917716,TRX_N-00422-11098843,2023-01-05T09:17:35,Bilbao,Expense,cash,-100.0,-24680.13
buyer_1,Luis,28,ES28209538501931917716,TRX_N-00423-40594287,2023-01-06T10:28:07,Bilbao,expenses,water,-26.47,-24706.6
buyer_1,Luis,28,ES28209538501931917716,TRX_N-00424-96841396,2023-01-06T14:00:54,Bilbao,expenses,electricity,-21.59,-24728.19
buyer_1,Luis,28,ES28209538501931917716,TRX_N-00425-55359802,2023-01-06T15:31:21,Bilbao,Expense,food,-101.97,-24830.16
buyer_1,Luis,28,ES28209538501931917716,TRX_N-00426-97786791,2023-01-07T12:45:12,Bilbao,Expense,cash,-100.0,-24930.16
buyer_1,Luis,28,ES28209538501931917716,TRX_N-00427-63917784,2023-01-07T17:46:36,Bilbao,expenses,children,-213.19,-25143.35
buyer_1,Luis,28,ES28209538501931917716,TRX_N-00428-50482961,2023-01-08T14:37:20,Bilbao,expenses,gas,-87.45,-25230.8
buyer_1,Luis,28,ES28209538501931917716,TRX_N-00429-39311057,2023-01-08T15:20:07,Bilbao,expenses,internet,-42.0,-25272.8
buyer_1,Luis,28,ES28209538501931917716,TRX_N-00430-73229586,2023-01-08T15:39:23,Bilbao,expenses,phone,-33.36,-25306.16
buyer_1,Luis,28,ES28209538501931917716,TRX_N-00431-34460559,2023-01-08T20:51:05,Bilbao,Expense,cash,-100.0,-25406.16
buyer_1,Luis,28,ES28209538501931917716,TRX_N-00432-01410833,2023-01-10T14:41:07,Bilbao,Expense,cash,-100.0,-25506.16
buyer_1,Luis,28,ES28209538501931917716,TRX_N-00433-95574726,2023-01-10T14:59:31,Bilbao,Expense,repairs,-322.57,-25828.73
buyer_1,Luis,28,ES28209538501931917716,TRX_N-00434-18024120,2023-01-11T12:48:42,Bilbao,Expense,transport,-48.48,-25877.21
buyer_1,Luis,28,ES28209538501931917716,TRX_N-00435-81427181,2023-01-15T18:49:26,Bilbao,Expense,cash,-100.0,-25977.21
buyer_1,Luis,28,ES28209538501931917716,TRX_N-00436-73945732,2023-01-15T19:14:32,Bilbao,Expense,gifts,-694.19,-26671.4
buyer_1,Luis,28,ES28209538501931917716,TRX_N-00437-78775876,2023-01-16T12:07:26,Bilbao,Expense,food,-119.2,-26790.6
buyer_1,Luis,28,ES28209538501931917716,TRX_N-00438-99330494,2023-01-16T23:38:19,Bilbao,Expense,transport,-45.64,-26836.24
buyer_1,Luis,28,ES28209538501931917716,TRX_N-00439-24649759,2023-01-16T10:11:13,Bilbao,Expense,cash,-100.0,-26936.24
buyer_1,Luis,28,ES28209538501931917716,TRX_N-00440-33857607,2023-01-17T21:15:45,Bilbao,Expense,leisure,-73.44,-27009.68
buyer_1,Luis,28,ES28209538501931917716,TRX_N-00441-66631929,2023-01-21T21:28:51,Bilbao,Expense,transport,-89.74,-27099.42
buyer_1,Luis,28,ES28209538501931917716,TRX_N-00442-46389865,2023-01-21T18:22:31,Bilbao,Expense,gifts,-121.62,-27221.04
buyer_1,Luis,28,ES28209538501931917716,TRX_N-00443-81062033,2023-01-22T13:42:50,Bilbao,Expense,cash,-100.0,-27321.04
buyer_1,Luis,28,ES28209538501931917716,TRX_N-00444-32410544,2023-01-24T18:49:39,Durango,Expense,cash,-100.0,-27421.04
buyer_1,Luis,28,ES28209538501931917716,TRX_N-00445-87170001,2023-01-25T08:09:22,Bilbao,Expense,repairs,-262.01,-27683.05
buyer_1,Luis,28,ES28209538501931917716,TRX_N-00446-19863610,2023-01-26T17:58:29,Hondarribia,Expense,cash,-100.0,-27783.05
buyer_1,Luis,28,ES28209538501931917716,TRX_N-00447-99793716,2023-01-26T09:37:16,Bilbao,Expense,gifts,-385.39,-28168.44
buyer_1,Luis,28,ES28209538501931917716,TRX_N-00448-79415683,2023-01-27T15:58:20,Bilbao,Expense,repairs,-41.62,-28210.06
buyer_1,Luis,28,ES28209538501931917716,TRX_N-00449-52064624,2023-01-28T15:14:36,Bilbao,Expense,food,-64.24,-28274.3
buyer_1,Luis,28,ES28209538501931917716,TRX_N-00450-26288945,2023-01-28T15:50:01,Portugalete,Expense,transport,-59.24,-28333.54
buyer_1,Luis,28,ES28209538501931917716,TRX_N-00451-24817873,2023-01-29T15:40:23,Bilbao,Expense,leisure,-83.39,-28416.93
buyer_1,Luis,28,ES28209538501931917716,TRX_N-00452-41993049,2023-01-30T02:28:36,Bilbao,Expense,repairs,-156.87,-28573.8
buyer_1,Luis,28,ES28209538501931917716,TRX_N-00453-45437710,2023-01-31T13:02:05,Bilbao,Expense,leisure,-45.21,-28619.01
buyer_1,Luis,28,ES28209538501931917716,TRX_N-00454-66170052,2023-02-01T10:09:40,Bilbao,incomes,salary,1573.35,-27045.66
buyer_1,Luis,28,ES28209538501931917716,TRX_N-00455-10215840,2023-02-01T10:09:40,Bilbao,incomes,salary_partner,1054.75,-25990.91
buyer_1,Luis,28,ES28209538501931917716,TRX_N-00456-66717321,2023-02-04T17:14:17,Bilbao,expenses,mortgage,-928.53,-26919.44
buyer_1,Luis,28,ES28209538501931917716,TRX_N-00457-89967352,2023-02-04T20:58:11,Vitoria-Gasteiz,Expense,clothing,-113.1,-27032.54
buyer_1,Luis,28,ES28209538501931917716,TRX_N-00458-35219641,2023-02-04T08:40:09,Bilbao,Expense,travel,-1781.21,-28813.75
buyer_1,Luis,28,ES28209538501931917716,TRX_N-00459-40169669,2023-02-05T09:08:06,Bilbao,Expense,leisure,-27.37,-28841.12
buyer_1,Luis,28,ES28209538501931917716,TRX_N-00460-73439834,2023-02-05T16:15:45,Bilbao,Expense,travel,-1717.88,-30559.0
buyer_1,Luis,28,ES28209538501931917716,TRX_N-00461-42822334,2023-02-06T11:49:10,Bilbao,expenses,water,-22.98,-30581.98
buyer_1,Luis,28,ES28209538501931917716,TRX_N-00462-66849075,2023-02-06T21:19:31,Bilbao,expenses,electricity,-26.26,-30608.24
buyer_1,Luis,28,ES28209538501931917716,TRX_N-00463-67780515,2023-02-07T16:52:02,Bilbao,expenses,internet,-42.0,-30650.24
buyer_1,Luis,28,ES28209538501931917716,TRX_N-00464-22383754,2023-02-08T16:50:40,Bilbao,expenses,gas,-82.1,-30732.34
buyer_1,Luis,28,ES28209538501931917716,TRX_N-00465-91769931,2023-02-08T18:24:33,Bilbao,expenses,phone,-37.83,-30770.17
buyer_1,Luis,28,ES28209538501931917716,TRX_N-00466-58601380,2023-02-09T07:01:22,Bilbao,Expense,leisure,-48.47,-30818.64
buyer_1,Luis,28,ES28209538501931917716,TRX_N-00467-32371084,2023-02-10T16:16:06,Bilbao,Expense,food,-96.41,-30915.05
buyer_1,Luis,28,ES28209538501931917716,TRX_N-00468-10258940,2023-02-12T18:14:33,Bilbao,Expense,food,-65.48,-30980.53
buyer_1,Luis,28,ES28209538501931917716,TRX_N-00469-76771278,2023-02-13T19:00:42,Santurtzi,Expense,food,-85.82,-31066.35
buyer_1,Luis,28,ES28209538501931917716,TRX_N-00470-16214580,2023-02-13T18:25:27,Bilbao,Expense,transport,-86.75,-31153.1
buyer_1,Luis,28,ES28209538501931917716,TRX_N-00471-51380394,2023-02-13T18:47:46,Pasaia,Expense,education,-62.12,-31215.22
buyer_1,Luis,28,ES28209538501931917716,TRX_N-00472-80598553,2023-02-13T18:24:23,Bilbao,Expense,cash,-100.0,-31315.22
buyer_1,Luis,28,ES28209538501931917716,TRX_N-00473-01292397,2023-02-15T15:58:59,Bilbao,Expense,cash,-100.0,-31415.22
buyer_1,Luis,28,ES28209538501931917716,TRX_N-00474-07293674,2023-02-15T10:46:10,Bilbao,Expense,repairs,-271.02,-31686.24
buyer_1,Luis,28,ES28209538501931917716,TRX_N-00475-67454598,2023-02-16T21:00:59,Bilbao,Expense,food,-89.9,-31776.14
buyer_1,Luis,28,ES28209538501931917716,TRX_N-00476-01161678,2023-02-16T15:45:26,Bilbao,expenses,children,-243.19,-32019.33
buyer_1,Luis,28,ES28209538501931917716,TRX_N-00477-77951207,2023-02-17T10:26:25,Bilbao,Expense,transport,-88.92,-32108.25
buyer_1,Luis,28,ES28209538501931917716,TRX_N-00478-84935074,2023-02-18T17:04:22,Bilbao,Expense,cash,-100.0,-32208.25
buyer_1,Luis,28,ES28209538501931917716,TRX_N-00479-33511497,2023-02-19T13:48:29,Bilbao,Expense,food,-75.83,-32284.08
buyer_1,Luis,28,ES28209538501931917716,TRX_N-00480-23329579,2023-02-19T14:27:09,Bilbao,Expense,transport,-76.69,-32360.77
buyer_1,Luis,28,ES28209538501931917716,TRX_N-00481-60884136,2023-02-19T08:00:38,Santurtzi,Expense,cash,-100.0,-32460.77
buyer_1,Luis,28,ES28209538501931917716,TRX_N-00482-41503061,2023-02-22T10:42:16,Bilbao,Expense,clothing,-130.54,-32591.31
buyer_1,Luis,28,ES28209538501931917716,TRX_N-00483-24728306,2023-02-22T23:05:22,Bilbao,Expense,cash,-100.0,-32691.31
buyer_1,Luis,28,ES28209538501931917716,TRX_N-00484-21189226,2023-02-23T17:24:41,Bilbao,Expense,food,-105.94,-32797.25
buyer_1,Luis,28,ES28209538501931917716,TRX_N-00485-92095080,2023-02-23T19:34:51,Bilbao,Expense,leisure,-81.23,-32878.48
buyer_1,Luis,28,ES28209538501931917716,TRX_N-00486-67175234,2023-02-26T19:48:55,Bilbao,Expense,leisure,-37.95,-32916.43
buyer_1,Luis,28,ES28209538501931917716,TRX_N-00487-16961832,2023-02-26T02:45:23,Bilbao,Expense,repairs,-170.74,-33087.17
buyer_1,Luis,28,ES28209538501931917716,TRX_N-00488-74896254,2023-02-27T19:04:05,Bilbao,Expense,appliances,-130.95,-33218.12
buyer_1,Luis,28,ES28209538501931917716,TRX_N-00489-56661825,2023-03-01T23:59:05,Bilbao,incomes,salary,1573.35,-31644.77
buyer_1,Luis,28,ES28209538501931917716,TRX_N-00490-69970637,2023-03-01T23:59:05,Bilbao,incomes,salary_partner,1054.75,-30590.02
buyer_1,Luis,28,ES28209538501931917716,TRX_N-00491-30272523,2023-03-01T23:59:05,Bilbao,incomes,extra_income,159.05,-30430.97
buyer_1,Luis,28,ES28209538501931917716,TRX_N-00492-79465386,2023-03-01T21:40:01,Bilbao,Expense,food,-74.5,-30505.47
buyer_1,Luis,28,ES28209538501931917716,TRX_N-00493-67883998,2023-03-04T03:10:17,Bilbao,expenses,mortgage,-928.53,-31434.0
buyer_1,Luis,28,ES28209538501931917716,TRX_N-00494-64446478,2023-03-05T13:56:10,Bilbao,expenses,internet,-42.0,-31476.0
buyer_1,Luis,28,ES28209538501931917716,TRX_N-00495-76166864,2023-03-05T13:10:23,Bilbao,expenses,phone,-35.72,-31511.72
buyer_1,Luis,28,ES28209538501931917716,TRX_N-00496-98819477,2023-03-06T08:45:13,Bilbao,expenses,water,-43.63,-31555.35
buyer_1,Luis,28,ES28209538501931917716,TRX_N-00497-84876646,2023-03-06T06:51:40,Eibar,Expense,leisure,-54.12,-31609.47
buyer_1,Luis,28,ES28209538501931917716,TRX_N-00498-05615312,2023-03-07T13:19:04,Bilbao,Expense,leisure,-59.65,-31669.12
buyer_1,Luis,28,ES28209538501931917716,TRX_N-00499-88743259,2023-03-08T15:22:21,Bilbao,expenses,electricity,-22.13,-31691.25
buyer_1,Luis,28,ES28209538501931917716,TRX_N-00500-66378459,2023-03-08T11:48:41,Bilbao,expenses,gas,-96.18,-31787.43
buyer_1,Luis,28,ES28209538501931917716,TRX_N-00501-16874366,2023-03-08T17:50:06,Bilbao,Expense,healthcare,-146.29,-31933.72
buyer_1,Luis,28,ES28209538501931917716,TRX_N-00502-62650331,2023-03-08T22:28:02,Bilbao,Expense,gifts,-846.54,-32780.26
buyer_1,Luis,28,ES28209538501931917716,TRX_N-00503-70983728,2023-03-09T11:48:13,Bilbao,Expense,transport,-40.18,-32820.44
buyer_1,Luis,28,ES28209538501931917716,TRX_N-00504-85427712,2023-03-09T11:37:50,Bilbao,Expense,cash,-100.0,-32920.44
buyer_1,Luis,28,ES28209538501931917716,TRX_N-00505-51303787,2023-03-10T14:46:24,Bilbao,Expense,leisure,-39.99,-32960.43
buyer_1,Luis,28,ES28209538501931917716,TRX_N-00506-30259566,2023-03-10T08:10:35,Pasaia,Expense,cash,-100.0,-33060.43
buyer_1,Luis,28,ES28209538501931917716,TRX_N-00507-48692796,2023-03-11T16:45:16,Bilbao,Expense,cash,-100.0,-33160.43
buyer_1,Luis,28,ES28209538501931917716,TRX_N-00508-04744925,2023-03-12T13:46:59,Labastida,Expense,leisure,-55.4,-33215.83
buyer_1,Luis,28,ES28209538501931917716,TRX_N-00509-85114100,2023-03-13T18:34:35,Bilbao,Expense,cash,-100.0,-33315.83
buyer_1,Luis,28,ES28209538501931917716,TRX_N-00510-80048238,2023-03-14T18:29:29,Alegr√≠a-Dulantzi,Expense,leisure,-27.66,-33343.49
buyer_1,Luis,28,ES28209538501931917716,TRX_N-00511-00140735,2023-03-15T23:27:19,Bilbao,Expense,repairs,-52.37,-33395.86
buyer_1,Luis,28,ES28209538501931917716,TRX_N-00512-14039194,2023-03-16T08:52:23,Bilbao,Expense,food,-87.43,-33483.29
buyer_1,Luis,28,ES28209538501931917716,TRX_N-00513-44289093,2023-03-17T15:35:06,Bilbao,Expense,repairs,-28.97,-33512.26
buyer_1,Luis,28,ES28209538501931917716,TRX_N-00514-37555731,2023-03-19T08:43:59,Elciego,Expense,transport,-59.63,-33571.89
buyer_1,Luis,28,ES28209538501931917716,TRX_N-00515-63288936,2023-03-20T13:58:10,Bilbao,Expense,transport,-51.64,-33623.53
buyer_1,Luis,28,ES28209538501931917716,TRX_N-00516-51056527,2023-03-20T09:31:04,Bilbao,Expense,cash,-100.0,-33723.53
buyer_1,Luis,28,ES28209538501931917716,TRX_N-00517-38809373,2023-03-24T07:39:05,Bilbao,Expense,transport,-72.71,-33796.24
buyer_1,Luis,28,ES28209538501931917716,TRX_N-00518-29420163,2023-03-24T14:01:34,Oy√≥n-Oion,Expense,healthcare,-147.41,-33943.65
buyer_1,Luis,28,ES28209538501931917716,TRX_N-00519-82325282,2023-03-25T18:20:46,Bilbao,Expense,education,-56.47,-34000.12
buyer_1,Luis,28,ES28209538501931917716,TRX_N-00520-56437191,2023-03-25T05:25:35,Bilbao,Expense,cash,-100.0,-34100.12
buyer_1,Luis,28,ES28209538501931917716,TRX_N-00521-37246369,2023-03-27T15:24:18,Bilbao,Expense,transport,-56.15,-34156.27
buyer_1,Luis,28,ES28209538501931917716,TRX_N-00522-09825533,2023-03-28T19:15:53,Bilbao,Expense,cash,-100.0,-34256.27
buyer_1,Luis,28,ES28209538501931917716,TRX_N-00523-61330805,2023-03-31T18:26:02,Bilbao,Expense,transport,-60.0,-34316.27
buyer_1,Luis,28,ES28209538501931917716,TRX_N-00524-17612279,2023-04-01T08:28:11,Bilbao,incomes,salary,1573.35,-32742.92
buyer_1,Luis,28,ES28209538501931917716,TRX_N-00525-51619844,2023-04-01T08:28:11,Bilbao,incomes,salary_partner,1054.75,-31688.17
buyer_1,Luis,28,ES28209538501931917716,TRX_N-00526-36498048,2023-04-02T08:37:53,Bilbao,Expense,transport,-78.44,-31766.61
buyer_1,Luis,28,ES28209538501931917716,TRX_N-00527-41765352,2023-04-03T07:45:47,Bilbao,Expense,transport,-88.4,-31855.01
buyer_1,Luis,28,ES28209538501931917716,TRX_N-00528-99216397,2023-04-04T08:51:59,Bilbao,expenses,mortgage,-928.53,-32783.54
buyer_1,Luis,28,ES28209538501931917716,TRX_N-00529-36686044,2023-04-04T08:31:00,Bilbao,Expense,food,-61.36,-32844.9
buyer_1,Luis,28,ES28209538501931917716,TRX_N-00530-37042541,2023-04-04T13:53:47,Bilbao,Expense,leisure,-18.59,-32863.49
buyer_1,Luis,28,ES28209538501931917716,TRX_N-00531-24041930,2023-04-05T10:09:04,Bilbao,Expense,food,-72.08,-32935.57
buyer_1,Luis,28,ES28209538501931917716,TRX_N-00532-17768564,2023-04-05T12:39:36,Bilbao,Expense,gifts,-606.43,-33542.0
buyer_1,Luis,28,ES28209538501931917716,TRX_N-00533-72832428,2023-04-06T17:44:40,Bilbao,expenses,electricity,-50.92,-33592.92
buyer_1,Luis,28,ES28209538501931917716,TRX_N-00534-54297273,2023-04-07T20:54:06,Bilbao,Expense,cash,-100.0,-33692.92
buyer_1,Luis,28,ES28209538501931917716,TRX_N-00535-52605346,2023-04-08T17:36:54,Bilbao,expenses,internet,-42.0,-33734.92
buyer_1,Luis,28,ES28209538501931917716,TRX_N-00536-06604263,2023-04-08T12:27:44,Bilbao,expenses,water,-20.77,-33755.69
buyer_1,Luis,28,ES28209538501931917716,TRX_N-00537-88431224,2023-04-08T10:07:19,Bilbao,expenses,gas,-90.35,-33846.04
buyer_1,Luis,28,ES28209538501931917716,TRX_N-00538-25175909,2023-04-08T20:33:42,Bilbao,expenses,phone,-43.88,-33889.92
buyer_1,Luis,28,ES28209538501931917716,TRX_N-00539-72432472,2023-04-13T11:33:24,Bilbao,Expense,food,-114.41,-34004.33
buyer_1,Luis,28,ES28209538501931917716,TRX_N-00540-20664653,2023-04-13T09:50:26,Bilbao,Expense,cash,-100.0,-34104.33
buyer_1,Luis,28,ES28209538501931917716,TRX_N-00541-39621094,2023-04-14T23:36:02,Bilbao,Expense,leisure,-19.62,-34123.95
buyer_1,Luis,28,ES28209538501931917716,TRX_N-00542-32746895,2023-04-15T14:25:58,Labastida,Expense,transport,-67.71,-34191.66
buyer_1,Luis,28,ES28209538501931917716,TRX_N-00543-07051246,2023-04-15T14:37:57,Bermeo,Expense,leisure,-46.65,-34238.31
buyer_1,Luis,28,ES28209538501931917716,TRX_N-00544-41660761,2023-04-15T13:59:45,Bilbao,Expense,repairs,-82.26,-34320.57
buyer_1,Luis,28,ES28209538501931917716,TRX_N-00545-72204173,2023-04-17T15:32:39,Bilbao,Expense,food,-97.82,-34418.39
buyer_1,Luis,28,ES28209538501931917716,TRX_N-00546-82965200,2023-04-17T21:22:40,Bilbao,Expense,leisure,-22.24,-34440.63
buyer_1,Luis,28,ES28209538501931917716,TRX_N-00547-55754547,2023-04-17T08:39:46,Bilbao,expenses,children,-236.82,-34677.45
buyer_1,Luis,28,ES28209538501931917716,TRX_N-00548-06235933,2023-04-20T16:48:53,Bilbao,Expense,healthcare,-38.75,-34716.2
buyer_1,Luis,28,ES28209538501931917716,TRX_N-00549-95377064,2023-04-21T23:09:14,Bilbao,Expense,cash,-100.0,-34816.2
buyer_1,Luis,28,ES28209538501931917716,TRX_N-00550-67808494,2023-04-22T19:54:10,Bilbao,Expense,leisure,-34.96,-34851.16
buyer_1,Luis,28,ES28209538501931917716,TRX_N-00551-74472078,2023-04-22T18:40:55,Bilbao,Expense,clothing,-67.92,-34919.08
buyer_1,Luis,28,ES28209538501931917716,TRX_N-00552-36195192,2023-04-22T10:52:53,Bilbao,Expense,cash,-100.0,-35019.08
buyer_1,Luis,28,ES28209538501931917716,TRX_N-00553-50260560,2023-04-24T19:49:17,Pasaia,Expense,travel,-1825.91,-36844.99
buyer_1,Luis,28,ES28209538501931917716,TRX_N-00554-89405246,2023-04-25T08:02:12,Bilbao,Expense,transport,-82.52,-36927.51
buyer_1,Luis,28,ES28209538501931917716,TRX_N-00555-45243180,2023-04-25T17:17:25,Bilbao,Expense,cash,-100.0,-37027.51
buyer_1,Luis,28,ES28209538501931917716,TRX_N-00556-95790820,2023-04-25T15:33:15,Lasarte-Oria,Expense,appliances,-219.12,-37246.63
buyer_1,Luis,28,ES28209538501931917716,TRX_N-00557-98975628,2023-04-28T21:39:34,Barakaldo,Expense,clothing,-55.97,-37302.6
buyer_1,Luis,28,ES28209538501931917716,TRX_N-00558-82016034,2023-05-01T16:45:19,Bilbao,incomes,salary,1573.35,-35729.25
buyer_1,Luis,28,ES28209538501931917716,TRX_N-00559-65368422,2023-05-01T16:45:19,Bilbao,incomes,salary_partner,1054.75,-34674.5
buyer_1,Luis,28,ES28209538501931917716,TRX_N-00560-36674655,2023-05-02T10:35:28,Bilbao,Expense,gifts,-452.73,-35127.23
buyer_1,Luis,28,ES28209538501931917716,TRX_N-00561-43938231,2023-05-04T13:21:43,Bilbao,expenses,mortgage,-928.53,-36055.76
buyer_1,Luis,28,ES28209538501931917716,TRX_N-00562-57521754,2023-05-04T19:50:06,Bilbao,Expense,transport,-71.49,-36127.25
buyer_1,Luis,28,ES28209538501931917716,TRX_N-00563-89684856,2023-05-05T13:45:05,Bilbao,expenses,phone,-40.49,-36167.74
buyer_1,Luis,28,ES28209538501931917716,TRX_N-00564-74763680,2023-05-05T18:35:11,Iru√±a de Oca,Expense,education,-64.19,-36231.93
buyer_1,Luis,28,ES28209538501931917716,TRX_N-00565-28002476,2023-05-05T20:22:30,Bilbao,expenses,children,-155.79,-36387.72
buyer_1,Luis,28,ES28209538501931917716,TRX_N-00566-91346103,2023-05-06T08:07:00,Bilbao,expenses,internet,-42.0,-36429.72
buyer_1,Luis,28,ES28209538501931917716,TRX_N-00567-86031637,2023-05-06T20:01:09,Bilbao,Expense,leisure,-38.57,-36468.29
buyer_1,Luis,28,ES28209538501931917716,TRX_N-00568-19243405,2023-05-07T13:11:54,Bilbao,expenses,electricity,-28.29,-36496.58
buyer_1,Luis,28,ES28209538501931917716,TRX_N-00569-22786998,2023-05-07T16:57:03,Sestao,Expense,leisure,-49.21,-36545.79
buyer_1,Luis,28,ES28209538501931917716,TRX_N-00570-75026020,2023-05-07T21:44:47,Salvatierra/Agurain,Expense,cash,-100.0,-36645.79
buyer_1,Luis,28,ES28209538501931917716,TRX_N-00571-63967485,2023-05-08T17:33:14,Bilbao,expenses,water,-33.75,-36679.54
buyer_1,Luis,28,ES28209538501931917716,TRX_N-00572-51549865,2023-05-08T07:37:28,Bilbao,expenses,gas,-98.73,-36778.27
buyer_1,Luis,28,ES28209538501931917716,TRX_N-00573-69388895,2023-05-10T08:39:46,Bilbao,Expense,transport,-42.7,-36820.97
buyer_1,Luis,28,ES28209538501931917716,TRX_N-00574-42067435,2023-05-10T13:32:22,Bilbao,Expense,education,-53.92,-36874.89
buyer_1,Luis,28,ES28209538501931917716,TRX_N-00575-43120560,2023-05-11T01:20:47,Bilbao,Expense,clothing,-127.98,-37002.87
buyer_1,Luis,28,ES28209538501931917716,TRX_N-00576-20836363,2023-05-11T21:56:55,Bilbao,Expense,cash,-100.0,-37102.87
buyer_1,Luis,28,ES28209538501931917716,TRX_N-00577-17796885,2023-05-11T10:12:34,Bilbao,expenses,children,-233.55,-37336.42
buyer_1,Luis,28,ES28209538501931917716,TRX_N-00578-34988368,2023-05-12T13:09:15,Eibar,Expense,transport,-71.8,-37408.22
buyer_1,Luis,28,ES28209538501931917716,TRX_N-00579-14865683,2023-05-13T23:26:35,Bilbao,Expense,leisure,-43.64,-37451.86
buyer_1,Luis,28,ES28209538501931917716,TRX_N-00580-39025002,2023-05-14T11:54:33,Bilbao,Expense,leisure,-59.64,-37511.5
buyer_1,Luis,28,ES28209538501931917716,TRX_N-00581-06883198,2023-05-14T11:40:13,Bilbao,Expense,education,-68.61,-37580.11
buyer_1,Luis,28,ES28209538501931917716,TRX_N-00582-43321506,2023-05-14T20:06:03,Labastida,Expense,cash,-100.0,-37680.11
buyer_1,Luis,28,ES28209538501931917716,TRX_N-00583-86310796,2023-05-16T17:24:13,Bilbao,Expense,repairs,-171.0,-37851.11
buyer_1,Luis,28,ES28209538501931917716,TRX_N-00584-48386869,2023-05-18T21:58:19,Bilbao,Expense,clothing,-54.79,-37905.9
buyer_1,Luis,28,ES28209538501931917716,TRX_N-00585-82620813,2023-05-18T09:39:39,Bilbao,Expense,repairs,-159.95,-38065.85
buyer_1,Luis,28,ES28209538501931917716,TRX_N-00586-37914716,2023-05-20T09:42:44,Oy√≥n-Oion,Expense,transport,-62.79,-38128.64
buyer_1,Luis,28,ES28209538501931917716,TRX_N-00587-20329931,2023-05-21T08:48:50,Bilbao,Expense,food,-97.63,-38226.27
buyer_1,Luis,28,ES28209538501931917716,TRX_N-00588-10556536,2023-05-21T18:05:44,Zuia,Expense,leisure,-46.89,-38273.16
buyer_1,Luis,28,ES28209538501931917716,TRX_N-00589-47880403,2023-05-24T10:43:47,Bilbao,Expense,food,-84.75,-38357.91
buyer_1,Luis,28,ES28209538501931917716,TRX_N-00590-18146522,2023-05-26T18:20:01,Bilbao,Expense,leisure,-54.83,-38412.74
buyer_1,Luis,28,ES28209538501931917716,TRX_N-00591-53392712,2023-05-26T09:59:48,Bilbao,Expense,healthcare,-74.64,-38487.38
buyer_1,Luis,28,ES28209538501931917716,TRX_N-00592-45454171,2023-05-27T20:43:48,Bilbao,Expense,food,-118.61,-38605.99
buyer_1,Luis,28,ES28209538501931917716,TRX_N-00593-94890089,2023-05-27T11:22:50,Bilbao,Expense,transport,-45.22,-38651.21
buyer_1,Luis,28,ES28209538501931917716,TRX_N-00594-60212905,2023-05-27T13:28:54,Getxo,Expense,cash,-100.0,-38751.21
buyer_1,Luis,28,ES28209538501931917716,TRX_N-00595-81164927,2023-05-28T19:24:10,Bilbao,Expense,food,-114.82,-38866.03
buyer_1,Luis,28,ES28209538501931917716,TRX_N-00596-72300633,2023-05-30T08:36:49,Bilbao,Expense,transport,-73.37,-38939.4
buyer_1,Luis,28,ES28209538501931917716,TRX_N-00597-23619074,2023-05-30T17:33:38,Bilbao,Expense,gifts,-83.83,-39023.23
buyer_1,Luis,28,ES28209538501931917716,TRX_N-00598-97182673,2023-05-31T17:55:19,Bilbao,Expense,leisure,-84.87,-39108.1
buyer_1,Luis,28,ES28209538501931917716,TRX_N-00599-70226299,2023-06-01T14:49:29,Bilbao,incomes,salary,1573.35,-37534.75
buyer_1,Luis,28,ES28209538501931917716,TRX_N-00600-20952849,2023-06-01T14:49:29,Bilbao,incomes,salary_partner,1054.75,-36480.0
buyer_1,Luis,28,ES28209538501931917716,TRX_N-00601-24284650,2023-06-01T14:49:29,Bilbao,incomes,extra_income,159.05,-36320.95
buyer_1,Luis,28,ES28209538501931917716,TRX_N-00602-27178482,2023-06-01T14:49:29,Bilbao,incomes,salary_bonus,1227.39,-35093.56
buyer_1,Luis,28,ES28209538501931917716,TRX_N-00603-44124724,2023-06-01T14:49:29,Bilbao,incomes,salary_partner_bonus,757.81,-34335.75
buyer_1,Luis,28,ES28209538501931917716,TRX_N-00604-99443967,2023-06-01T21:03:34,Bilbao,expenses,taxes,-1748.93,-36084.68
buyer_1,Luis,28,ES28209538501931917716,TRX_N-00605-58367928,2023-06-01T12:42:02,Bilbao,expenses,insurance,-335.57,-36420.25
buyer_1,Luis,28,ES28209538501931917716,TRX_N-00606-16105630,2023-06-01T18:08:06,Bilbao,Expense,cash,-100.0,-36520.25
buyer_1,Luis,28,ES28209538501931917716,TRX_N-00607-31220842,2023-06-02T19:26:27,Bilbao,Expense,food,-77.33,-36597.58
buyer_1,Luis,28,ES28209538501931917716,TRX_N-00608-33761959,2023-06-04T11:44:48,Bilbao,expenses,mortgage,-928.53,-37526.11
buyer_1,Luis,28,ES28209538501931917716,TRX_N-00609-45725045,2023-06-04T14:30:43,Bilbao,Expense,transport,-61.79,-37587.9
buyer_1,Luis,28,ES28209538501931917716,TRX_N-00610-05702246,2023-06-05T09:55:54,Bilbao,expenses,water,-37.5,-37625.4
buyer_1,Luis,28,ES28209538501931917716,TRX_N-00611-97820135,2023-06-05T22:35:09,Bilbao,expenses,gas,-101.05,-37726.45
buyer_1,Luis,28,ES28209538501931917716,TRX_N-00612-12681885,2023-06-05T17:17:33,Labastida,Expense,transport,-69.45,-37795.9
buyer_1,Luis,28,ES28209538501931917716,TRX_N-00613-98321864,2023-06-06T15:33:15,Bilbao,expenses,electricity,-66.1,-37862.0
buyer_1,Luis,28,ES28209538501931917716,TRX_N-00614-28607834,2023-06-07T23:17:30,Bilbao,expenses,phone,-33.16,-37895.16
buyer_1,Luis,28,ES28209538501931917716,TRX_N-00615-79310938,2023-06-07T18:24:11,Bilbao,Expense,transport,-79.66,-37974.82
buyer_1,Luis,28,ES28209538501931917716,TRX_N-00616-95706927,2023-06-07T11:09:13,Bilbao,Expense,leisure,-24.67,-37999.49
buyer_1,Luis,28,ES28209538501931917716,TRX_N-00617-50889767,2023-06-08T16:51:37,Bilbao,expenses,internet,-42.0,-38041.49
buyer_1,Luis,28,ES28209538501931917716,TRX_N-00618-60563481,2023-06-08T16:56:18,Bilbao,Expense,cash,-100.0,-38141.49
buyer_1,Luis,28,ES28209538501931917716,TRX_N-00619-96428044,2023-06-09T11:26:54,Salvatierra/Agurain,Expense,food,-75.39,-38216.88
buyer_1,Luis,28,ES28209538501931917716,TRX_N-00620-36603231,2023-06-09T18:41:26,Bilbao,Expense,cash,-100.0,-38316.88
buyer_1,Luis,28,ES28209538501931917716,TRX_N-00621-57336619,2023-06-11T08:09:59,Zarautz,Expense,cash,-100.0,-38416.88
buyer_1,Luis,28,ES28209538501931917716,TRX_N-00622-70058327,2023-06-12T18:35:09,Mungia,Expense,cash,-100.0,-38516.88
buyer_1,Luis,28,ES28209538501931917716,TRX_N-00623-56124693,2023-06-13T08:07:38,Durango,Expense,repairs,-77.13,-38594.01
buyer_1,Luis,28,ES28209538501931917716,TRX_N-00624-23106218,2023-06-14T13:02:44,Andoain,Expense,appliances,-91.94,-38685.95
buyer_1,Luis,28,ES28209538501931917716,TRX_N-00625-14951321,2023-06-15T04:38:23,Bilbao,Expense,food,-86.79,-38772.74
buyer_1,Luis,28,ES28209538501931917716,TRX_N-00626-15446984,2023-06-15T18:54:05,Bilbao,Expense,transport,-71.68,-38844.42
buyer_1,Luis,28,ES28209538501931917716,TRX_N-00627-51053465,2023-06-18T14:03:58,Bilbao,Expense,leisure,-67.92,-38912.34
buyer_1,Luis,28,ES28209538501931917716,TRX_N-00628-19036695,2023-06-20T14:47:37,Galdakao,Expense,transport,-80.78,-38993.12
buyer_1,Luis,28,ES28209538501931917716,TRX_N-00629-05877132,2023-06-20T21:39:57,Bilbao,Expense,cash,-100.0,-39093.12
buyer_1,Luis,28,ES28209538501931917716,TRX_N-00630-91880573,2023-06-21T13:58:58,Bilbao,Expense,cash,-100.0,-39193.12
buyer_1,Luis,28,ES28209538501931917716,TRX_N-00631-52317263,2023-06-25T12:40:47,Bilbao,Expense,leisure,-27.56,-39220.68
buyer_1,Luis,28,ES28209538501931917716,TRX_N-00632-98539862,2023-06-26T19:55:26,Bilbao,Expense,food,-66.04,-39286.72
buyer_1,Luis,28,ES28209538501931917716,TRX_N-00633-42395144,2023-06-29T15:50:55,Bilbao,Expense,leisure,-74.12,-39360.84
buyer_1,Luis,28,ES28209538501931917716,TRX_N-00634-22582216,2023-06-30T03:19:46,Bilbao,Expense,food,-90.44,-39451.28
buyer_1,Luis,28,ES28209538501931917716,TRX_N-00635-31380254,2023-07-01T11:32:48,Bilbao,incomes,salary,1573.35,-37877.93
buyer_1,Luis,28,ES28209538501931917716,TRX_N-00636-04758986,2023-07-01T11:32:48,Bilbao,incomes,salary_partner,1054.75,-36823.18
buyer_1,Luis,28,ES28209538501931917716,TRX_N-00637-91082245,2023-07-04T21:49:20,Bilbao,expenses,mortgage,-928.53,-37751.71
buyer_1,Luis,28,ES28209538501931917716,TRX_N-00638-80539195,2023-07-04T08:35:08,Bilbao,Expense,leisure,-51.33,-37803.04
buyer_1,Luis,28,ES28209538501931917716,TRX_N-00639-06619060,2023-07-05T19:29:35,Bilbao,expenses,gas,-41.16,-37844.2
buyer_1,Luis,28,ES28209538501931917716,TRX_N-00640-45864452,2023-07-05T20:26:43,Bilbao,expenses,internet,-42.0,-37886.2
buyer_1,Luis,28,ES28209538501931917716,TRX_N-00641-24556705,2023-07-06T23:58:25,Bilbao,expenses,phone,-32.89,-37919.09
buyer_1,Luis,28,ES28209538501931917716,TRX_N-00642-23967288,2023-07-06T20:07:08,Bilbao,Expense,cash,-100.0,-38019.09
buyer_1,Luis,28,ES28209538501931917716,TRX_N-00643-08598081,2023-07-07T18:53:31,Bilbao,Expense,cash,-100.0,-38119.09
buyer_1,Luis,28,ES28209538501931917716,TRX_N-00644-68873613,2023-07-08T21:09:25,Bilbao,expenses,water,-40.19,-38159.28
buyer_1,Luis,28,ES28209538501931917716,TRX_N-00645-79825635,2023-07-08T09:27:35,Bilbao,expenses,electricity,-79.17,-38238.45
buyer_1,Luis,28,ES28209538501931917716,TRX_N-00646-81021952,2023-07-08T11:35:44,Bilbao,Expense,food,-82.9,-38321.35
buyer_1,Luis,28,ES28209538501931917716,TRX_N-00647-31171277,2023-07-08T12:33:36,Bilbao,Expense,transport,-49.84,-38371.19
buyer_1,Luis,28,ES28209538501931917716,TRX_N-00648-61952386,2023-07-09T15:53:39,Bilbao,Expense,gifts,-751.02,-39122.21
buyer_1,Luis,28,ES28209538501931917716,TRX_N-00649-66360123,2023-07-10T16:08:24,Bilbao,Expense,clothing,-130.81,-39253.02
buyer_1,Luis,28,ES28209538501931917716,TRX_N-00650-64738693,2023-07-10T13:55:14,Bilbao,Expense,healthcare,-89.03,-39342.05
buyer_1,Luis,28,ES28209538501931917716,TRX_N-00651-39725297,2023-07-10T20:06:55,Bilbao,Expense,cash,-100.0,-39442.05
buyer_1,Luis,28,ES28209538501931917716,TRX_N-00652-52367491,2023-07-11T09:41:06,Eibar,Expense,transport,-73.59,-39515.64
buyer_1,Luis,28,ES28209538501931917716,TRX_N-00653-32561298,2023-07-12T11:21:32,Galdakao,Expense,cash,-100.0,-39615.64
buyer_1,Luis,28,ES28209538501931917716,TRX_N-00654-58136868,2023-07-12T08:47:46,Bilbao,Expense,repairs,-134.94,-39750.58
buyer_1,Luis,28,ES28209538501931917716,TRX_N-00655-79610957,2023-07-13T16:05:18,Bilbao,Expense,food,-121.88,-39872.46
buyer_1,Luis,28,ES28209538501931917716,TRX_N-00656-15037573,2023-07-14T15:40:15,Bilbao,Expense,food,-112.34,-39984.8
buyer_1,Luis,28,ES28209538501931917716,TRX_N-00657-35652937,2023-07-14T12:08:08,Bilbao,Expense,healthcare,-167.85,-40152.65
buyer_1,Luis,28,ES28209538501931917716,TRX_N-00658-99425860,2023-07-15T20:12:43,Irun,Expense,gifts,-647.47,-40800.12
buyer_1,Luis,28,ES28209538501931917716,TRX_N-00659-07317992,2023-07-17T17:30:49,Galdakao,Expense,cash,-100.0,-40900.12
buyer_1,Luis,28,ES28209538501931917716,TRX_N-00660-47595835,2023-07-19T18:39:13,Bilbao,Expense,food,-70.02,-40970.14
buyer_1,Luis,28,ES28209538501931917716,TRX_N-00661-87034820,2023-07-20T14:05:11,Bilbao,Expense,food,-69.06,-41039.2
buyer_1,Luis,28,ES28209538501931917716,TRX_N-00662-63703227,2023-07-22T19:00:38,Bilbao,Expense,food,-88.97,-41128.17
buyer_1,Luis,28,ES28209538501931917716,TRX_N-00663-59210105,2023-07-22T10:19:56,Bilbao,Expense,leisure,-40.59,-41168.76
buyer_1,Luis,28,ES28209538501931917716,TRX_N-00664-05137193,2023-07-22T12:29:00,Bilbao,Expense,healthcare,-111.21,-41279.97
buyer_1,Luis,28,ES28209538501931917716,TRX_N-00665-85175463,2023-07-23T15:00:23,Bilbao,Expense,food,-114.66,-41394.63
buyer_1,Luis,28,ES28209538501931917716,TRX_N-00666-67487878,2023-07-26T16:38:17,Bilbao,Expense,healthcare,-187.89,-41582.52
buyer_1,Luis,28,ES28209538501931917716,TRX_N-00667-11030627,2023-07-26T19:59:46,Bilbao,Expense,education,-50.18,-41632.7
buyer_1,Luis,28,ES28209538501931917716,TRX_N-00668-42015762,2023-07-28T17:38:01,Bilbao,Expense,education,-69.44,-41702.14
buyer_1,Luis,28,ES28209538501931917716,TRX_N-00669-43779304,2023-07-29T18:35:31,Andoain,Expense,gifts,-245.32,-41947.46
buyer_1,Luis,28,ES28209538501931917716,TRX_N-00670-46799487,2023-07-30T16:26:52,Bilbao,Expense,food,-103.14,-42050.6
buyer_1,Luis,28,ES28209538501931917716,TRX_N-00671-34649710,2023-08-01T15:55:48,Bilbao,incomes,salary,1573.35,-40477.25
buyer_1,Luis,28,ES28209538501931917716,TRX_N-00672-90493957,2023-08-01T15:55:48,Bilbao,incomes,salary_partner,1054.75,-39422.5
buyer_1,Luis,28,ES28209538501931917716,TRX_N-00673-76205715,2023-08-01T18:46:49,Bilbao,Expense,cash,-100.0,-39522.5
buyer_1,Luis,28,ES28209538501931917716,TRX_N-00674-90107472,2023-08-03T09:41:45,Bilbao,Expense,food,-85.11,-39607.61
buyer_1,Luis,28,ES28209538501931917716,TRX_N-00675-34928302,2023-08-03T11:31:59,Bilbao,Expense,transport,-49.67,-39657.28
buyer_1,Luis,28,ES28209538501931917716,TRX_N-00676-67430800,2023-08-03T09:49:26,Bilbao,Expense,leisure,-80.9,-39738.18
buyer_1,Luis,28,ES28209538501931917716,TRX_N-00677-02127787,2023-08-03T13:10:53,Bilbao,Expense,cash,-100.0,-39838.18
buyer_1,Luis,28,ES28209538501931917716,TRX_N-00678-56693879,2023-08-04T20:01:33,Bilbao,expenses,mortgage,-928.53,-40766.71
buyer_1,Luis,28,ES28209538501931917716,TRX_N-00679-35132672,2023-08-04T08:49:43,Bilbao,Expense,leisure,-59.97,-40826.68
buyer_1,Luis,28,ES28209538501931917716,TRX_N-00680-32958303,2023-08-05T19:49:10,Bilbao,Expense,clothing,-145.61,-40972.29
buyer_1,Luis,28,ES28209538501931917716,TRX_N-00681-35384241,2023-08-06T14:40:45,Bilbao,expenses,phone,-33.67,-41005.96
buyer_1,Luis,28,ES28209538501931917716,TRX_N-00682-40838372,2023-08-06T11:17:10,Iru√±a de Oca,Expense,transport,-51.76,-41057.72
buyer_1,Luis,28,ES28209538501931917716,TRX_N-00683-95413584,2023-08-06T19:42:39,Getxo,Expense,travel,-1326.83,-42384.55
buyer_1,Luis,28,ES28209538501931917716,TRX_N-00684-37728750,2023-08-08T13:57:19,Bilbao,expenses,water,-38.75,-42423.3
buyer_1,Luis,28,ES28209538501931917716,TRX_N-00685-15558668,2023-08-08T10:00:28,Bilbao,expenses,electricity,-28.8,-42452.1
buyer_1,Luis,28,ES28209538501931917716,TRX_N-00686-92651208,2023-08-08T11:56:36,Bilbao,expenses,internet,-42.0,-42494.1
buyer_1,Luis,28,ES28209538501931917716,TRX_N-00687-35101015,2023-08-08T20:54:54,Bilbao,expenses,gas,-38.92,-42533.02
buyer_1,Luis,28,ES28209538501931917716,TRX_N-00688-90636445,2023-08-08T16:10:17,Bilbao,Expense,leisure,-41.84,-42574.86
buyer_1,Luis,28,ES28209538501931917716,TRX_N-00689-83082015,2023-08-10T22:31:03,Bilbao,Expense,gifts,-727.54,-43302.4
buyer_1,Luis,28,ES28209538501931917716,TRX_N-00690-53201837,2023-08-10T09:55:42,Bilbao,expenses,children,-221.5,-43523.9
buyer_1,Luis,28,ES28209538501931917716,TRX_N-00691-54475973,2023-08-14T14:44:42,Bilbao,Expense,healthcare,-126.24,-43650.14
buyer_1,Luis,28,ES28209538501931917716,TRX_N-00692-69036410,2023-08-14T18:02:35,Eibar,Expense,cash,-100.0,-43750.14
buyer_1,Luis,28,ES28209538501931917716,TRX_N-00693-45300198,2023-08-17T09:48:43,Bilbao,Expense,travel,-376.53,-44126.67
buyer_1,Luis,28,ES28209538501931917716,TRX_N-00694-73096323,2023-08-19T14:25:28,Bilbao,expenses,children,-98.66,-44225.33
buyer_1,Luis,28,ES28209538501931917716,TRX_N-00695-38541003,2023-08-20T02:05:57,Bilbao,Expense,repairs,-214.32,-44439.65
buyer_1,Luis,28,ES28209538501931917716,TRX_N-00696-13115172,2023-08-21T14:11:01,Bilbao,Expense,food,-80.02,-44519.67
buyer_1,Luis,28,ES28209538501931917716,TRX_N-00697-63734976,2023-08-21T17:41:39,Bilbao,Expense,leisure,-66.08,-44585.75
buyer_1,Luis,28,ES28209538501931917716,TRX_N-00698-13255305,2023-08-21T20:29:27,Bilbao,Expense,education,-67.2,-44652.95
buyer_1,Luis,28,ES28209538501931917716,TRX_N-00699-00727208,2023-08-21T17:43:31,Bilbao,Expense,travel,-662.0,-45314.95
buyer_1,Luis,28,ES28209538501931917716,TRX_N-00700-51527221,2023-08-22T15:17:44,Bilbao,Expense,repairs,-297.77,-45612.72
buyer_1,Luis,28,ES28209538501931917716,TRX_N-00701-12423591,2023-08-23T19:28:08,Bilbao,Expense,repairs,-298.41,-45911.13
buyer_1,Luis,28,ES28209538501931917716,TRX_N-00702-00082334,2023-08-25T17:38:50,Leioa,Expense,leisure,-66.05,-45977.18
buyer_1,Luis,28,ES28209538501931917716,TRX_N-00703-41984279,2023-08-26T20:33:12,Bilbao,Expense,cash,-100.0,-46077.18
buyer_1,Luis,28,ES28209538501931917716,TRX_N-00704-29124034,2023-08-26T14:31:13,Bilbao,Expense,repairs,-66.62,-46143.8
buyer_1,Luis,28,ES28209538501931917716,TRX_N-00705-59391368,2023-08-27T12:28:05,Sestao,Expense,food,-78.89,-46222.69
buyer_1,Luis,28,ES28209538501931917716,TRX_N-00706-21497674,2023-08-28T09:17:52,Bilbao,Expense,leisure,-70.85,-46293.54
buyer_1,Luis,28,ES28209538501931917716,TRX_N-00707-54794667,2023-08-29T14:12:12,Bilbao,Expense,transport,-77.72,-46371.26
buyer_1,Luis,28,ES28209538501931917716,TRX_N-00708-56833467,2023-08-31T15:35:33,Bilbao,Expense,clothing,-153.38,-46524.64
buyer_1,Luis,28,ES28209538501931917716,TRX_N-00709-85380578,2023-08-31T15:44:35,Bilbao,Expense,healthcare,-140.74,-46665.38
buyer_1,Luis,28,ES28209538501931917716,TRX_N-00710-46417131,2023-09-01T17:55:10,Bilbao,incomes,salary,1573.35,-45092.03
buyer_1,Luis,28,ES28209538501931917716,TRX_N-00711-84092683,2023-09-01T17:55:10,Bilbao,incomes,salary_partner,1054.75,-44037.28
buyer_1,Luis,28,ES28209538501931917716,TRX_N-00712-32277050,2023-09-01T17:55:10,Bilbao,incomes,extra_income,159.05,-43878.23
buyer_1,Luis,28,ES28209538501931917716,TRX_N-00713-31344763,2023-09-01T21:38:35,Bilbao,Expense,cash,-100.0,-43978.23
buyer_1,Luis,28,ES28209538501931917716,TRX_N-00714-97639707,2023-09-01T14:53:19,Bilbao,Expense,repairs,-183.33,-44161.56
buyer_1,Luis,28,ES28209538501931917716,TRX_N-00715-04894295,2023-09-02T14:43:50,Bilbao,Expense,education,-43.35,-44204.91
buyer_1,Luis,28,ES28209538501931917716,TRX_N-00716-97943878,2023-09-02T11:53:48,Bilbao,Expense,cash,-100.0,-44304.91
buyer_1,Luis,28,ES28209538501931917716,TRX_N-00717-18862688,2023-09-02T04:06:24,Bilbao,Expense,repairs,-155.92,-44460.83
buyer_1,Luis,28,ES28209538501931917716,TRX_N-00718-52300696,2023-09-03T11:28:56,Bilbao,Expense,food,-92.58,-44553.41
buyer_1,Luis,28,ES28209538501931917716,TRX_N-00719-54507471,2023-09-04T22:04:43,Bilbao,expenses,mortgage,-928.53,-45481.94
buyer_1,Luis,28,ES28209538501931917716,TRX_N-00720-06505772,2023-09-05T17:07:42,Bilbao,expenses,electricity,-79.04,-45560.98
buyer_1,Luis,28,ES28209538501931917716,TRX_N-00721-28586914,2023-09-06T17:00:35,Bilbao,Expense,clothing,-96.83,-45657.81
buyer_1,Luis,28,ES28209538501931917716,TRX_N-00722-60864563,2023-09-06T15:28:52,Bilbao,Expense,gifts,-29.14,-45686.95
buyer_1,Luis,28,ES28209538501931917716,TRX_N-00723-45091621,2023-09-07T01:56:40,Bilbao,expenses,phone,-44.39,-45731.34
buyer_1,Luis,28,ES28209538501931917716,TRX_N-00724-63360697,2023-09-08T11:51:46,Bilbao,expenses,water,-22.98,-45754.32
buyer_1,Luis,28,ES28209538501931917716,TRX_N-00725-95253305,2023-09-08T00:55:29,Bilbao,expenses,gas,-105.99,-45860.31
buyer_1,Luis,28,ES28209538501931917716,TRX_N-00726-40605129,2023-09-08T20:09:54,Bilbao,expenses,internet,-42.0,-45902.31
buyer_1,Luis,28,ES28209538501931917716,TRX_N-00727-48518312,2023-09-08T20:16:50,Bilbao,Expense,transport,-55.95,-45958.26
buyer_1,Luis,28,ES28209538501931917716,TRX_N-00728-08216335,2023-09-10T09:34:38,Bilbao,Expense,food,-79.74,-46038.0
buyer_1,Luis,28,ES28209538501931917716,TRX_N-00729-91992042,2023-09-10T20:15:10,Bilbao,Expense,transport,-43.68,-46081.68
buyer_1,Luis,28,ES28209538501931917716,TRX_N-00730-58222703,2023-09-11T12:52:47,Barakaldo,Expense,cash,-100.0,-46181.68
buyer_1,Luis,28,ES28209538501931917716,TRX_N-00731-14636380,2023-09-13T16:25:14,Bilbao,Expense,leisure,-78.2,-46259.88
buyer_1,Luis,28,ES28209538501931917716,TRX_N-00732-38520427,2023-09-14T10:32:59,Bilbao,Expense,cash,-100.0,-46359.88
buyer_1,Luis,28,ES28209538501931917716,TRX_N-00733-69640953,2023-09-15T14:09:56,Bilbao,Expense,transport,-50.51,-46410.39
buyer_1,Luis,28,ES28209538501931917716,TRX_N-00734-22966553,2023-09-18T20:51:45,Bilbao,Expense,food,-86.53,-46496.92
buyer_1,Luis,28,ES28209538501931917716,TRX_N-00735-64790264,2023-09-19T15:01:41,Bilbao,Expense,food,-123.51,-46620.43
buyer_1,Luis,28,ES28209538501931917716,TRX_N-00736-78828992,2023-09-19T19:34:17,Bilbao,Expense,cash,-100.0,-46720.43
buyer_1,Luis,28,ES28209538501931917716,TRX_N-00737-14082044,2023-09-21T09:18:48,Bilbao,Expense,transport,-54.08,-46774.51
buyer_1,Luis,28,ES28209538501931917716,TRX_N-00738-84636531,2023-09-21T12:37:09,Bilbao,Expense,cash,-100.0,-46874.51
buyer_1,Luis,28,ES28209538501931917716,TRX_N-00739-94993440,2023-09-22T12:04:51,Bilbao,Expense,transport,-41.46,-46915.97
buyer_1,Luis,28,ES28209538501931917716,TRX_N-00740-83083808,2023-09-23T15:29:01,Berango,Expense,food,-64.97,-46980.94
buyer_1,Luis,28,ES28209538501931917716,TRX_N-00741-65352743,2023-09-23T14:32:23,Alegr√≠a-Dulantzi,Expense,cash,-100.0,-47080.94
buyer_1,Luis,28,ES28209538501931917716,TRX_N-00742-32859286,2023-09-24T15:02:43,Bilbao,Expense,repairs,-278.09,-47359.03
buyer_1,Luis,28,ES28209538501931917716,TRX_N-00743-08962622,2023-09-25T16:48:05,Bilbao,Expense,education,-56.42,-47415.45
buyer_1,Luis,28,ES28209538501931917716,TRX_N-00744-84686402,2023-09-25T18:42:04,Bilbao,Expense,cash,-100.0,-47515.45
buyer_1,Luis,28,ES28209538501931917716,TRX_N-00745-54646632,2023-09-25T15:02:22,Sopela,Expense,repairs,-57.59,-47573.04
buyer_1,Luis,28,ES28209538501931917716,TRX_N-00746-37390980,2023-09-27T16:27:05,Bilbao,Expense,food,-91.33,-47664.37
buyer_1,Luis,28,ES28209538501931917716,TRX_N-00747-48706808,2023-09-30T08:21:29,Bilbao,Expense,cash,-100.0,-47764.37
buyer_1,Luis,28,ES28209538501931917716,TRX_N-00748-04429318,2023-10-01T19:43:32,Bilbao,incomes,salary,1573.35,-46191.02
buyer_1,Luis,28,ES28209538501931917716,TRX_N-00749-44450448,2023-10-01T19:43:32,Bilbao,incomes,salary_partner,1054.75,-45136.27
buyer_1,Luis,28,ES28209538501931917716,TRX_N-00750-86285295,2023-10-04T17:46:35,Bilbao,expenses,mortgage,-928.53,-46064.8
buyer_1,Luis,28,ES28209538501931917716,TRX_N-00751-64432186,2023-10-05T20:15:57,Bilbao,expenses,water,-41.09,-46105.89
buyer_1,Luis,28,ES28209538501931917716,TRX_N-00752-65599116,2023-10-05T12:31:47,Bilbao,expenses,electricity,-32.02,-46137.91
buyer_1,Luis,28,ES28209538501931917716,TRX_N-00753-67757879,2023-10-05T12:24:06,Bilbao,expenses,gas,-98.8,-46236.71
buyer_1,Luis,28,ES28209538501931917716,TRX_N-00754-05014118,2023-10-05T12:59:08,Bilbao,Expense,clothing,-77.88,-46314.59
buyer_1,Luis,28,ES28209538501931917716,TRX_N-00755-33637734,2023-10-05T16:40:12,Bilbao,Expense,cash,-100.0,-46414.59
buyer_1,Luis,28,ES28209538501931917716,TRX_N-00756-85758835,2023-10-06T14:15:00,Bilbao,Expense,food,-62.7,-46477.29
buyer_1,Luis,28,ES28209538501931917716,TRX_N-00757-60896156,2023-10-07T22:51:55,Bilbao,expenses,internet,-42.0,-46519.29
buyer_1,Luis,28,ES28209538501931917716,TRX_N-00758-40625364,2023-10-07T11:56:38,Bilbao,expenses,phone,-35.62,-46554.91
buyer_1,Luis,28,ES28209538501931917716,TRX_N-00759-79298489,2023-10-07T18:15:57,Bilbao,Expense,clothing,-49.39,-46604.3
buyer_1,Luis,28,ES28209538501931917716,TRX_N-00760-01211857,2023-10-08T12:06:40,Bilbao,Expense,cash,-100.0,-46704.3
buyer_1,Luis,28,ES28209538501931917716,TRX_N-00761-75546914,2023-10-10T17:37:25,Bilbao,Expense,leisure,-66.02,-46770.32
buyer_1,Luis,28,ES28209538501931917716,TRX_N-00762-91631031,2023-10-10T22:00:43,Bilbao,Expense,cash,-100.0,-46870.32
buyer_1,Luis,28,ES28209538501931917716,TRX_N-00763-98962244,2023-10-13T13:36:17,Bilbao,Expense,transport,-89.54,-46959.86
buyer_1,Luis,28,ES28209538501931917716,TRX_N-00764-44741844,2023-10-13T14:51:15,Bilbao,Expense,healthcare,-69.08,-47028.94
buyer_1,Luis,28,ES28209538501931917716,TRX_N-00765-87159503,2023-10-14T14:36:00,Sopela,Expense,leisure,-83.87,-47112.81
buyer_1,Luis,28,ES28209538501931917716,TRX_N-00766-58864507,2023-10-14T17:24:33,Bilbao,Expense,cash,-100.0,-47212.81
buyer_1,Luis,28,ES28209538501931917716,TRX_N-00767-72505064,2023-10-14T16:45:55,Bilbao,Expense,repairs,-332.88,-47545.69
buyer_1,Luis,28,ES28209538501931917716,TRX_N-00768-21310010,2023-10-17T10:50:27,Berango,Expense,repairs,-157.38,-47703.07
buyer_1,Luis,28,ES28209538501931917716,TRX_N-00769-12384030,2023-10-18T10:41:00,Bilbao,Expense,cash,-100.0,-47803.07
buyer_1,Luis,28,ES28209538501931917716,TRX_N-00770-97209774,2023-10-19T01:12:52,Bilbao,Expense,healthcare,-134.62,-47937.69
buyer_1,Luis,28,ES28209538501931917716,TRX_N-00771-16346465,2023-10-19T22:56:43,Labastida,Expense,cash,-100.0,-48037.69
buyer_1,Luis,28,ES28209538501931917716,TRX_N-00772-22299623,2023-10-20T04:55:51,Bilbao,Expense,leisure,-63.23,-48100.92
buyer_1,Luis,28,ES28209538501931917716,TRX_N-00773-08135855,2023-10-21T09:30:04,Bilbao,Expense,cash,-100.0,-48200.92
buyer_1,Luis,28,ES28209538501931917716,TRX_N-00774-83940635,2023-10-22T08:42:31,Bilbao,Expense,leisure,-49.48,-48250.4
buyer_1,Luis,28,ES28209538501931917716,TRX_N-00775-20076303,2023-10-22T13:25:01,Zuia,Expense,repairs,-55.9,-48306.3
buyer_1,Luis,28,ES28209538501931917716,TRX_N-00776-91700809,2023-10-24T14:27:11,Bilbao,Expense,appliances,-334.4,-48640.7
buyer_1,Luis,28,ES28209538501931917716,TRX_N-00777-14642848,2023-10-26T16:43:20,Bilbao,Expense,food,-66.85,-48707.55
buyer_1,Luis,28,ES28209538501931917716,TRX_N-00778-71225727,2023-10-28T12:43:00,Hondarribia,Expense,clothing,-76.7,-48784.25
buyer_1,Luis,28,ES28209538501931917716,TRX_N-00779-15554903,2023-10-29T14:00:47,Bilbao,Expense,repairs,-60.8,-48845.05
buyer_1,Luis,28,ES28209538501931917716,TRX_N-00780-62868795,2023-10-30T14:45:37,Bilbao,Expense,cash,-100.0,-48945.05
buyer_1,Luis,28,ES28209538501931917716,TRX_N-00781-06721454,2023-11-01T14:46:55,Bilbao,incomes,salary,1573.35,-47371.7
buyer_1,Luis,28,ES28209538501931917716,TRX_N-00782-87492813,2023-11-01T14:46:55,Bilbao,incomes,salary_partner,1054.75,-46316.95
buyer_1,Luis,28,ES28209538501931917716,TRX_N-00783-97608885,2023-11-01T15:23:50,Bilbao,Expense,cash,-100.0,-46416.95
buyer_1,Luis,28,ES28209538501931917716,TRX_N-00784-54035686,2023-11-04T13:04:33,Bilbao,expenses,mortgage,-928.53,-47345.48
buyer_1,Luis,28,ES28209538501931917716,TRX_N-00785-71410853,2023-11-05T16:07:26,Bilbao,expenses,gas,-52.69,-47398.17
buyer_1,Luis,28,ES28209538501931917716,TRX_N-00786-22463975,2023-11-05T15:56:17,Bilbao,expenses,phone,-39.01,-47437.18
buyer_1,Luis,28,ES28209538501931917716,TRX_N-00787-15655216,2023-11-05T10:26:23,Bilbao,Expense,food,-123.54,-47560.72
buyer_1,Luis,28,ES28209538501931917716,TRX_N-00788-88962486,2023-11-06T12:08:33,Mungia,Expense,food,-80.08,-47640.8
buyer_1,Luis,28,ES28209538501931917716,TRX_N-00789-25080155,2023-11-07T21:46:04,Bilbao,expenses,water,-36.42,-47677.22
buyer_1,Luis,28,ES28209538501931917716,TRX_N-00790-69121151,2023-11-07T22:45:26,Bilbao,Expense,healthcare,-88.34,-47765.56
buyer_1,Luis,28,ES28209538501931917716,TRX_N-00791-47147189,2023-11-08T07:00:29,Bilbao,expenses,electricity,-87.35,-47852.91
buyer_1,Luis,28,ES28209538501931917716,TRX_N-00792-75281371,2023-11-08T13:27:49,Bilbao,expenses,internet,-42.0,-47894.91
buyer_1,Luis,28,ES28209538501931917716,TRX_N-00793-13542571,2023-11-09T08:42:47,Bilbao,Expense,cash,-100.0,-47994.91
buyer_1,Luis,28,ES28209538501931917716,TRX_N-00794-91705736,2023-11-10T20:25:13,Bilbao,Expense,education,-75.25,-48070.16
buyer_1,Luis,28,ES28209538501931917716,TRX_N-00795-55903113,2023-11-12T19:50:34,Bilbao,Expense,transport,-57.84,-48128.0
buyer_1,Luis,28,ES28209538501931917716,TRX_N-00796-69609218,2023-11-12T06:17:31,Bilbao,Expense,cash,-100.0,-48228.0
buyer_1,Luis,28,ES28209538501931917716,TRX_N-00797-18311954,2023-11-13T08:31:04,Bilbao,Expense,transport,-75.4,-48303.4
buyer_1,Luis,28,ES28209538501931917716,TRX_N-00798-06256883,2023-11-13T10:53:30,Portugalete,Expense,repairs,-282.84,-48586.24
buyer_1,Luis,28,ES28209538501931917716,TRX_N-00799-79455265,2023-11-14T10:30:55,Bilbao,Expense,cash,-100.0,-48686.24
buyer_1,Luis,28,ES28209538501931917716,TRX_N-00800-09271339,2023-11-16T20:12:48,Bilbao,Expense,leisure,-71.86,-48758.1
buyer_1,Luis,28,ES28209538501931917716,TRX_N-00801-51128488,2023-11-18T15:20:46,Elciego,Expense,transport,-63.14,-48821.24
buyer_1,Luis,28,ES28209538501931917716,TRX_N-00802-86483411,2023-11-18T13:25:39,Bermeo,Expense,cash,-100.0,-48921.24
buyer_1,Luis,28,ES28209538501931917716,TRX_N-00803-55960400,2023-11-19T09:06:54,Bilbao,Expense,transport,-59.37,-48980.61
buyer_1,Luis,28,ES28209538501931917716,TRX_N-00804-60783650,2023-11-19T10:12:39,Bilbao,Expense,clothing,-146.03,-49126.64
buyer_1,Luis,28,ES28209538501931917716,TRX_N-00805-24857765,2023-11-21T17:33:09,Bilbao,Expense,cash,-100.0,-49226.64
buyer_1,Luis,28,ES28209538501931917716,TRX_N-00806-30348884,2023-11-22T11:14:57,Eibar,Expense,leisure,-43.99,-49270.63
buyer_1,Luis,28,ES28209538501931917716,TRX_N-00807-07461726,2023-11-22T09:01:57,Bilbao,Expense,clothing,-62.44,-49333.07
buyer_1,Luis,28,ES28209538501931917716,TRX_N-00808-36599643,2023-11-26T09:52:01,Bilbao,Expense,food,-124.47,-49457.54
buyer_1,Luis,28,ES28209538501931917716,TRX_N-00809-44366041,2023-11-26T18:46:29,Bilbao,Expense,healthcare,-103.78,-49561.32
buyer_1,Luis,28,ES28209538501931917716,TRX_N-00810-89827806,2023-11-26T11:59:44,Bilbao,Expense,gifts,-604.92,-50166.24
buyer_1,Luis,28,ES28209538501931917716,TRX_N-00811-31063414,2023-11-28T03:20:28,Bilbao,Expense,leisure,-29.56,-50195.8
buyer_1,Luis,28,ES28209538501931917716,TRX_N-00812-14642562,2023-11-29T18:09:50,Getxo,Expense,food,-63.63,-50259.43
buyer_1,Luis,28,ES28209538501931917716,TRX_N-00813-52943929,2023-11-30T10:49:23,Bilbao,Expense,food,-116.18,-50375.61
buyer_1,Luis,28,ES28209538501931917716,TRX_N-00814-34238575,2023-11-30T08:53:27,Bilbao,Expense,leisure,-57.79,-50433.4
buyer_1,Luis,28,ES28209538501931917716,TRX_N-00815-22795029,2023-12-01T12:15:25,Bilbao,incomes,salary,1573.35,-48860.05
buyer_1,Luis,28,ES28209538501931917716,TRX_N-00816-96587486,2023-12-01T12:15:25,Bilbao,incomes,salary_partner,1054.75,-47805.3
buyer_1,Luis,28,ES28209538501931917716,TRX_N-00817-38612492,2023-12-01T12:15:25,Bilbao,incomes,salary_bonus,1201.02,-46604.28
buyer_1,Luis,28,ES28209538501931917716,TRX_N-00818-96316212,2023-12-01T12:15:25,Bilbao,incomes,salary_partner_bonus,746.3,-45857.98
buyer_1,Luis,28,ES28209538501931917716,TRX_N-00819-12708826,2023-12-02T09:10:52,Bilbao,Expense,transport,-48.42,-45906.4
buyer_1,Luis,28,ES28209538501931917716,TRX_N-00820-10170807,2023-12-02T10:02:06,Bilbao,Expense,gifts,-559.88,-46466.28
buyer_1,Luis,28,ES28209538501931917716,TRX_N-00821-33648166,2023-12-04T19:24:39,Bilbao,expenses,mortgage,-928.53,-47394.81
buyer_1,Luis,28,ES28209538501931917716,TRX_N-00822-99896941,2023-12-04T16:47:04,Bilbao,Expense,transport,-85.12,-47479.93
buyer_1,Luis,28,ES28209538501931917716,TRX_N-00823-08278793,2023-12-05T17:33:14,Bilbao,expenses,phone,-36.48,-47516.41
buyer_1,Luis,28,ES28209538501931917716,TRX_N-00824-45243705,2023-12-05T17:00:36,Bilbao,Expense,transport,-44.81,-47561.22
buyer_1,Luis,28,ES28209538501931917716,TRX_N-00825-79881486,2023-12-05T09:11:17,Bilbao,Expense,cash,-100.0,-47661.22
buyer_1,Luis,28,ES28209538501931917716,TRX_N-00826-81558143,2023-12-06T10:17:24,Bilbao,expenses,gas,-89.88,-47751.1
buyer_1,Luis,28,ES28209538501931917716,TRX_N-00827-09338959,2023-12-06T14:34:05,Bilbao,Expense,food,-108.08,-47859.18
buyer_1,Luis,28,ES28209538501931917716,TRX_N-00828-49567436,2023-12-07T19:56:23,Basauri,Expense,food,-63.88,-47923.06
buyer_1,Luis,28,ES28209538501931917716,TRX_N-00829-09247055,2023-12-07T19:42:36,Bilbao,Expense,cash,-100.0,-48023.06
buyer_1,Luis,28,ES28209538501931917716,TRX_N-00830-43460206,2023-12-07T19:13:45,Bilbao,expenses,children,-110.61,-48133.67
buyer_1,Luis,28,ES28209538501931917716,TRX_N-00831-71658431,2023-12-08T23:42:20,Bilbao,expenses,electricity,-63.83,-48197.5
buyer_1,Luis,28,ES28209538501931917716,TRX_N-00832-49679113,2023-12-08T05:16:40,Bilbao,expenses,internet,-42.0,-48239.5
buyer_1,Luis,28,ES28209538501931917716,TRX_N-00833-93093840,2023-12-08T15:08:14,Bilbao,expenses,water,-33.63,-48273.13
buyer_1,Luis,28,ES28209538501931917716,TRX_N-00834-12939201,2023-12-08T08:47:18,Galdakao,Expense,clothing,-75.68,-48348.81
buyer_1,Luis,28,ES28209538501931917716,TRX_N-00835-79419049,2023-12-08T19:58:01,Arrasate,Expense,cash,-100.0,-48448.81
buyer_1,Luis,28,ES28209538501931917716,TRX_N-00836-64632915,2023-12-09T02:05:38,Lasarte-Oria,Expense,cash,-100.0,-48548.81
buyer_1,Luis,28,ES28209538501931917716,TRX_N-00837-91321535,2023-12-09T11:58:25,Bilbao,Expense,appliances,-303.95,-48852.76
buyer_1,Luis,28,ES28209538501931917716,TRX_N-00838-45805181,2023-12-11T23:05:20,Sestao,Expense,cash,-100.0,-48952.76
buyer_1,Luis,28,ES28209538501931917716,TRX_N-00839-57609485,2023-12-12T12:28:55,Berango,Expense,transport,-66.45,-49019.21
buyer_1,Luis,28,ES28209538501931917716,TRX_N-00840-50374034,2023-12-12T19:16:19,Bilbao,Expense,cash,-100.0,-49119.21
buyer_1,Luis,28,ES28209538501931917716,TRX_N-00841-73020701,2023-12-13T17:04:30,Basauri,Expense,transport,-53.3,-49172.51
buyer_1,Luis,28,ES28209538501931917716,TRX_N-00842-39163366,2023-12-14T09:57:46,Elciego,Expense,cash,-100.0,-49272.51
buyer_1,Luis,28,ES28209538501931917716,TRX_N-00843-46487476,2023-12-14T10:15:20,Bilbao,Expense,repairs,-88.12,-49360.63
buyer_1,Luis,28,ES28209538501931917716,TRX_N-00844-21801910,2023-12-15T17:00:00,Bilbao,Expense,education,-50.91,-49411.54
buyer_1,Luis,28,ES28209538501931917716,TRX_N-00845-85310624,2023-12-15T15:35:53,Bilbao,Expense,cash,-100.0,-49511.54
buyer_1,Luis,28,ES28209538501931917716,TRX_N-00846-76659852,2023-12-17T04:01:51,Bilbao,Expense,appliances,-381.39,-49892.93
buyer_1,Luis,28,ES28209538501931917716,TRX_N-00847-53698888,2023-12-18T20:50:49,Irun,Expense,travel,-539.36,-50432.29
buyer_1,Luis,28,ES28209538501931917716,TRX_N-00848-77856388,2023-12-20T01:59:55,Bilbao,Expense,food,-117.9,-50550.19
buyer_1,Luis,28,ES28209538501931917716,TRX_N-00849-02000700,2023-12-20T17:11:51,Bilbao,Expense,cash,-100.0,-50650.19
buyer_1,Luis,28,ES28209538501931917716,TRX_N-00850-09184125,2023-12-21T19:06:07,Hondarribia,Expense,cash,-100.0,-50750.19
buyer_1,Luis,28,ES28209538501931917716,TRX_N-00851-19012352,2023-12-21T15:26:38,Lasarte-Oria,Expense,repairs,-62.12,-50812.31
buyer_1,Luis,28,ES28209538501931917716,TRX_N-00852-25171703,2023-12-22T18:11:01,Bilbao,Expense,gifts,-265.59,-51077.9
buyer_1,Luis,28,ES28209538501931917716,TRX_N-00853-82473084,2023-12-24T09:08:29,Bilbao,Expense,transport,-68.24,-51146.14
buyer_1,Luis,28,ES28209538501931917716,TRX_N-00854-41465620,2023-12-24T12:34:04,Bilbao,Expense,cash,-100.0,-51246.14
buyer_1,Luis,28,ES28209538501931917716,TRX_N-00855-65636348,2023-12-25T21:48:10,Bilbao,Expense,cash,-100.0,-51346.14
buyer_1,Luis,28,ES28209538501931917716,TRX_N-00856-12219558,2023-12-26T19:04:20,Bilbao,Expense,food,-119.6,-51465.74
buyer_1,Luis,28,ES28209538501931917716,TRX_N-00857-86349212,2023-12-29T14:20:21,Bilbao,Expense,leisure,-60.2,-51525.94
buyer_1,Luis,28,ES28209538501931917716,TRX_N-00858-76138688,2023-12-31T12:10:31,Bilbao,Expense,healthcare,-92.43,-51618.37
buyer_1,Luis,28,ES28209538501931917716,TRX_N-00859-73441824,2023-12-31T11:55:04,Bilbao,Expense,repairs,-238.76,-51857.13
buyer_1,Luis,28,ES28209538501931917716,TRX_N-00860-34476728,2024-01-01T13:05:32,Bilbao,incomes,salary,1622.04,-50235.09
buyer_1,Luis,28,ES28209538501931917716,TRX_N-00861-90839421,2024-01-01T13:05:32,Bilbao,incomes,salary_partner,1087.39,-49147.7
buyer_1,Luis,28,ES28209538501931917716,TRX_N-00862-97644582,2024-01-01T13:05:32,Bilbao,incomes,extra_income,159.05,-48988.65
buyer_1,Luis,28,ES28209538501931917716,TRX_N-00863-66374093,2024-01-01T18:42:03,Bilbao,Expense,food,-100.89,-49089.54
buyer_1,Luis,28,ES28209538501931917716,TRX_N-00864-74540667,2024-01-04T12:22:18,Bilbao,expenses,mortgage,-928.53,-50018.07
buyer_1,Luis,28,ES28209538501931917716,TRX_N-00865-77566116,2024-01-04T19:26:52,Bilbao,Expense,repairs,-293.01,-50311.08
buyer_1,Luis,28,ES28209538501931917716,TRX_N-00866-59810927,2024-01-05T13:02:08,Bilbao,expenses,electricity,-40.12,-50351.2
buyer_1,Luis,28,ES28209538501931917716,TRX_N-00867-82157689,2024-01-05T09:58:36,Bilbao,expenses,internet,-42.0,-50393.2
buyer_1,Luis,28,ES28209538501931917716,TRX_N-00868-89742010,2024-01-05T22:18:43,Bilbao,Expense,leisure,-30.46,-50423.66
buyer_1,Luis,28,ES28209538501931917716,TRX_N-00869-36005483,2024-01-06T10:31:51,Bilbao,expenses,gas,-92.42,-50516.08
buyer_1,Luis,28,ES28209538501931917716,TRX_N-00870-53628348,2024-01-07T08:44:58,Bilbao,expenses,water,-40.96,-50557.04
buyer_1,Luis,28,ES28209538501931917716,TRX_N-00871-70272280,2024-01-07T10:09:13,Bilbao,Expense,transport,-48.93,-50605.97
buyer_1,Luis,28,ES28209538501931917716,TRX_N-00872-63447526,2024-01-08T15:06:45,Bilbao,expenses,phone,-35.3,-50641.27
buyer_1,Luis,28,ES28209538501931917716,TRX_N-00873-80090248,2024-01-08T12:30:58,Bilbao,Expense,cash,-100.0,-50741.27
buyer_1,Luis,28,ES28209538501931917716,TRX_N-00874-63310272,2024-01-10T15:38:21,Bilbao,Expense,cash,-100.0,-50841.27
buyer_1,Luis,28,ES28209538501931917716,TRX_N-00875-02800364,2024-01-13T09:32:58,Bilbao,Expense,clothing,-75.34,-50916.61
buyer_1,Luis,28,ES28209538501931917716,TRX_N-00876-39351209,2024-01-13T18:38:49,Bilbao,Expense,healthcare,-123.73,-51040.34
buyer_1,Luis,28,ES28209538501931917716,TRX_N-00877-81487986,2024-01-14T14:58:09,Iru√±a de Oca,Expense,repairs,-248.97,-51289.31
buyer_1,Luis,28,ES28209538501931917716,TRX_N-00878-45955793,2024-01-15T18:20:17,Bilbao,Expense,transport,-78.81,-51368.12
buyer_1,Luis,28,ES28209538501931917716,TRX_N-00879-13987789,2024-01-16T16:38:38,Bilbao,Expense,appliances,-111.48,-51479.6
buyer_1,Luis,28,ES28209538501931917716,TRX_N-00880-56402654,2024-01-17T15:44:29,Bilbao,Expense,appliances,-314.56,-51794.16
buyer_1,Luis,28,ES28209538501931917716,TRX_N-00881-26545720,2024-01-18T20:04:32,Llodio,Expense,transport,-89.44,-51883.6
buyer_1,Luis,28,ES28209538501931917716,TRX_N-00882-05984870,2024-01-19T08:10:54,Bilbao,Expense,food,-64.75,-51948.35
buyer_1,Luis,28,ES28209538501931917716,TRX_N-00883-33843634,2024-01-19T16:31:25,Bilbao,Expense,cash,-100.0,-52048.35
buyer_1,Luis,28,ES28209538501931917716,TRX_N-00884-29579201,2024-01-19T10:33:53,Labastida,Expense,gifts,-558.76,-52607.11
buyer_1,Luis,28,ES28209538501931917716,TRX_N-00885-73502778,2024-01-20T18:11:47,Bilbao,Expense,education,-76.53,-52683.64
buyer_1,Luis,28,ES28209538501931917716,TRX_N-00886-87116247,2024-01-21T10:42:48,Bilbao,Expense,food,-106.3,-52789.94
buyer_1,Luis,28,ES28209538501931917716,TRX_N-00887-22378503,2024-01-21T00:44:51,Bilbao,Expense,cash,-100.0,-52889.94
buyer_1,Luis,28,ES28209538501931917716,TRX_N-00888-94881277,2024-01-24T14:21:43,Bilbao,Expense,food,-110.8,-53000.74
buyer_1,Luis,28,ES28209538501931917716,TRX_N-00889-50685022,2024-01-27T03:48:11,Bilbao,Expense,transport,-61.28,-53062.02
buyer_1,Luis,28,ES28209538501931917716,TRX_N-00890-57225787,2024-01-27T12:12:10,Bilbao,Expense,cash,-100.0,-53162.02
buyer_1,Luis,28,ES28209538501931917716,TRX_N-00891-78276821,2024-01-28T10:29:58,Bilbao,Expense,food,-80.33,-53242.35
buyer_1,Luis,28,ES28209538501931917716,TRX_N-00892-54050120,2024-01-28T10:45:07,Bilbao,Expense,transport,-42.67,-53285.02
buyer_1,Luis,28,ES28209538501931917716,TRX_N-00893-15571319,2024-01-29T09:23:58,Bilbao,Expense,leisure,-20.14,-53305.16
buyer_1,Luis,28,ES28209538501931917716,TRX_N-00894-30384952,2024-01-29T04:52:46,Bilbao,Expense,cash,-100.0,-53405.16
buyer_1,Luis,28,ES28209538501931917716,TRX_N-00895-68831390,2024-02-01T11:08:39,Bilbao,incomes,salary,1622.04,-51783.12
buyer_1,Luis,28,ES28209538501931917716,TRX_N-00896-80191702,2024-02-01T11:08:39,Bilbao,incomes,salary_partner,1087.39,-50695.73
buyer_1,Luis,28,ES28209538501931917716,TRX_N-00897-26784673,2024-02-01T14:52:08,Erandio,Expense,food,-85.28,-50781.01
buyer_1,Luis,28,ES28209538501931917716,TRX_N-00898-97251853,2024-02-02T12:08:22,Bilbao,Expense,cash,-100.0,-50881.01
buyer_1,Luis,28,ES28209538501931917716,TRX_N-00899-25310976,2024-02-04T17:48:40,Bilbao,expenses,mortgage,-928.53,-51809.54
buyer_1,Luis,28,ES28209538501931917716,TRX_N-00900-54865159,2024-02-05T14:27:53,Bilbao,Expense,food,-116.08,-51925.62
buyer_1,Luis,28,ES28209538501931917716,TRX_N-00901-49135531,2024-02-05T19:27:06,Bilbao,Expense,cash,-100.0,-52025.62
buyer_1,Luis,28,ES28209538501931917716,TRX_N-00902-81683649,2024-02-07T16:29:37,Bilbao,expenses,gas,-81.02,-52106.64
buyer_1,Luis,28,ES28209538501931917716,TRX_N-00903-09148977,2024-02-07T12:43:20,Bilbao,Expense,appliances,-377.87,-52484.51
buyer_1,Luis,28,ES28209538501931917716,TRX_N-00904-70543602,2024-02-08T13:33:49,Bilbao,expenses,water,-26.54,-52511.05
buyer_1,Luis,28,ES28209538501931917716,TRX_N-00905-59958391,2024-02-08T14:09:32,Bilbao,expenses,internet,-42.0,-52553.05
buyer_1,Luis,28,ES28209538501931917716,TRX_N-00906-33757430,2024-02-08T08:28:16,Bilbao,expenses,electricity,-73.69,-52626.74
buyer_1,Luis,28,ES28209538501931917716,TRX_N-00907-45189594,2024-02-08T20:51:15,Bilbao,expenses,phone,-44.67,-52671.41
buyer_1,Luis,28,ES28209538501931917716,TRX_N-00908-02419116,2024-02-09T17:09:54,Bilbao,Expense,cash,-100.0,-52771.41
buyer_1,Luis,28,ES28209538501931917716,TRX_N-00909-90455194,2024-02-10T17:20:42,Bilbao,Expense,gifts,-685.83,-53457.24
buyer_1,Luis,28,ES28209538501931917716,TRX_N-00910-99434970,2024-02-11T12:47:34,Bilbao,Expense,cash,-100.0,-53557.24
buyer_1,Luis,28,ES28209538501931917716,TRX_N-00911-93742480,2024-02-11T06:23:10,Bilbao,Expense,gifts,-808.84,-54366.08
buyer_1,Luis,28,ES28209538501931917716,TRX_N-00912-30574365,2024-02-12T16:37:20,Bilbao,Expense,transport,-40.01,-54406.09
buyer_1,Luis,28,ES28209538501931917716,TRX_N-00913-02456349,2024-02-14T22:32:12,Bilbao,Expense,education,-43.99,-54450.08
buyer_1,Luis,28,ES28209538501931917716,TRX_N-00914-04280734,2024-02-16T23:16:26,Elciego,Expense,leisure,-81.09,-54531.17
buyer_1,Luis,28,ES28209538501931917716,TRX_N-00915-63922852,2024-02-19T16:31:25,Bilbao,Expense,healthcare,-120.05,-54651.22
buyer_1,Luis,28,ES28209538501931917716,TRX_N-00916-09659460,2024-02-19T01:21:15,Bilbao,Expense,repairs,-220.27,-54871.49
buyer_1,Luis,28,ES28209538501931917716,TRX_N-00917-70469007,2024-02-20T13:42:37,Bilbao,Expense,leisure,-18.66,-54890.15
buyer_1,Luis,28,ES28209538501931917716,TRX_N-00918-11256996,2024-02-20T23:33:17,Bilbao,Expense,cash,-100.0,-54990.15
buyer_1,Luis,28,ES28209538501931917716,TRX_N-00919-59963451,2024-02-22T06:24:43,Sopela,Expense,clothing,-141.75,-55131.9
buyer_1,Luis,28,ES28209538501931917716,TRX_N-00920-21486779,2024-02-22T19:12:58,Bilbao,Expense,cash,-100.0,-55231.9
buyer_1,Luis,28,ES28209538501931917716,TRX_N-00921-27889250,2024-02-23T11:50:20,Vitoria-Gasteiz,Expense,cash,-100.0,-55331.9
buyer_1,Luis,28,ES28209538501931917716,TRX_N-00922-38273888,2024-02-24T08:04:39,Bilbao,Expense,leisure,-77.87,-55409.77
buyer_1,Luis,28,ES28209538501931917716,TRX_N-00923-23555605,2024-02-29T15:00:35,Bilbao,Expense,leisure,-79.13,-55488.9
buyer_1,Luis,28,ES28209538501931917716,TRX_N-00924-06061517,2024-03-01T05:04:26,Bilbao,incomes,salary,1622.04,-53866.86
buyer_1,Luis,28,ES28209538501931917716,TRX_N-00925-14564845,2024-03-01T05:04:26,Bilbao,incomes,salary_partner,1087.39,-52779.47
buyer_1,Luis,28,ES28209538501931917716,TRX_N-00926-56610536,2024-03-01T10:56:19,Bilbao,Expense,food,-64.77,-52844.24
buyer_1,Luis,28,ES28209538501931917716,TRX_N-00927-93367721,2024-03-03T17:43:56,Bilbao,Expense,leisure,-81.31,-52925.55
buyer_1,Luis,28,ES28209538501931917716,TRX_N-00928-86176262,2024-03-04T06:34:11,Bilbao,expenses,mortgage,-928.53,-53854.08
buyer_1,Luis,28,ES28209538501931917716,TRX_N-00929-87280703,2024-03-04T15:48:07,Bilbao,Expense,leisure,-83.35,-53937.43
buyer_1,Luis,28,ES28209538501931917716,TRX_N-00930-88034198,2024-03-04T10:43:04,Bilbao,Expense,clothing,-158.01,-54095.44
buyer_1,Luis,28,ES28209538501931917716,TRX_N-00931-85550122,2024-03-04T10:10:22,Santurtzi,Expense,repairs,-239.76,-54335.2
buyer_1,Luis,28,ES28209538501931917716,TRX_N-00932-89953578,2024-03-05T10:21:37,Bilbao,expenses,gas,-59.88,-54395.08
buyer_1,Luis,28,ES28209538501931917716,TRX_N-00933-07200966,2024-03-06T12:41:06,Bilbao,expenses,phone,-38.51,-54433.59
buyer_1,Luis,28,ES28209538501931917716,TRX_N-00934-49424276,2024-03-06T08:39:41,Bilbao,Expense,leisure,-35.46,-54469.05
buyer_1,Luis,28,ES28209538501931917716,TRX_N-00935-59128764,2024-03-07T11:33:49,Bilbao,expenses,electricity,-31.01,-54500.06
buyer_1,Luis,28,ES28209538501931917716,TRX_N-00936-38299053,2024-03-07T01:33:47,Bilbao,Expense,transport,-81.22,-54581.28
buyer_1,Luis,28,ES28209538501931917716,TRX_N-00937-58055946,2024-03-08T11:56:37,Bilbao,expenses,water,-44.33,-54625.61
buyer_1,Luis,28,ES28209538501931917716,TRX_N-00938-90654804,2024-03-08T18:49:40,Bilbao,expenses,internet,-42.0,-54667.61
buyer_1,Luis,28,ES28209538501931917716,TRX_N-00939-84939596,2024-03-09T20:25:44,Bilbao,Expense,repairs,-218.04,-54885.65
buyer_1,Luis,28,ES28209538501931917716,TRX_N-00940-49964434,2024-03-10T05:16:13,Bilbao,Expense,education,-62.4,-54948.05
buyer_1,Luis,28,ES28209538501931917716,TRX_N-00941-67586637,2024-03-10T13:24:34,Bilbao,Expense,repairs,-97.64,-55045.69
buyer_1,Luis,28,ES28209538501931917716,TRX_N-00942-47388998,2024-03-11T13:09:35,Zarautz,Expense,leisure,-28.27,-55073.96
buyer_1,Luis,28,ES28209538501931917716,TRX_N-00943-23148970,2024-03-15T22:30:16,Bilbao,Expense,transport,-66.14,-55140.1
buyer_1,Luis,28,ES28209538501931917716,TRX_N-00944-66331081,2024-03-17T08:53:08,Bilbao,Expense,leisure,-68.38,-55208.48
buyer_1,Luis,28,ES28209538501931917716,TRX_N-00945-53124919,2024-03-18T09:23:48,Bilbao,Expense,appliances,-389.09,-55597.57
buyer_1,Luis,28,ES28209538501931917716,TRX_N-00946-28919578,2024-03-19T18:49:50,Bilbao,Expense,food,-79.41,-55676.98
buyer_1,Luis,28,ES28209538501931917716,TRX_N-00947-63786767,2024-03-19T06:16:37,Bilbao,Expense,cash,-100.0,-55776.98
buyer_1,Luis,28,ES28209538501931917716,TRX_N-00948-98617983,2024-03-20T19:16:11,Bilbao,Expense,travel,-942.65,-56719.63
buyer_1,Luis,28,ES28209538501931917716,TRX_N-00949-89014486,2024-03-20T08:34:22,Bilbao,expenses,children,-77.33,-56796.96
buyer_1,Luis,28,ES28209538501931917716,TRX_N-00950-26805517,2024-03-24T09:22:45,Bilbao,Expense,food,-78.61,-56875.57
buyer_1,Luis,28,ES28209538501931917716,TRX_N-00951-11938612,2024-03-24T10:20:42,Irun,Expense,repairs,-141.96,-57017.53
buyer_1,Luis,28,ES28209538501931917716,TRX_N-00952-50165363,2024-03-25T10:02:10,Bilbao,Expense,transport,-63.0,-57080.53
buyer_1,Luis,28,ES28209538501931917716,TRX_N-00953-28682198,2024-03-26T17:25:22,Bilbao,Expense,food,-71.05,-57151.58
buyer_1,Luis,28,ES28209538501931917716,TRX_N-00954-77527403,2024-03-27T20:01:38,Bilbao,Expense,cash,-100.0,-57251.58
buyer_1,Luis,28,ES28209538501931917716,TRX_N-00955-12255076,2024-03-28T23:07:51,Bilbao,Expense,food,-67.73,-57319.31
buyer_1,Luis,28,ES28209538501931917716,TRX_N-00956-37820776,2024-03-29T17:21:14,Bilbao,Expense,education,-48.23,-57367.54
buyer_1,Luis,28,ES28209538501931917716,TRX_N-00957-75602144,2024-03-30T13:59:39,Elciego,Expense,food,-109.24,-57476.78
buyer_1,Luis,28,ES28209538501931917716,TRX_N-00958-83968441,2024-03-30T10:11:20,Bilbao,Expense,gifts,-144.13,-57620.91
buyer_1,Luis,28,ES28209538501931917716,TRX_N-00959-36356282,2024-03-31T20:25:39,Bilbao,Expense,education,-59.35,-57680.26
buyer_1,Luis,28,ES28209538501931917716,TRX_N-00960-16114596,2024-04-01T15:53:40,Bilbao,incomes,salary,1622.04,-56058.22
buyer_1,Luis,28,ES28209538501931917716,TRX_N-00961-97365378,2024-04-01T15:53:40,Bilbao,incomes,salary_partner,1087.39,-54970.83
buyer_1,Luis,28,ES28209538501931917716,TRX_N-00962-99761729,2024-04-01T15:53:40,Bilbao,incomes,extra_income,159.05,-54811.78
buyer_1,Luis,28,ES28209538501931917716,TRX_N-00963-12919719,2024-04-02T16:23:57,Bilbao,Expense,food,-102.29,-54914.07
buyer_1,Luis,28,ES28209538501931917716,TRX_N-00964-49519628,2024-04-02T14:02:47,Bilbao,Expense,cash,-100.0,-55014.07
buyer_1,Luis,28,ES28209538501931917716,TRX_N-00965-14409766,2024-04-04T13:55:24,Bilbao,expenses,mortgage,-928.53,-55942.6
buyer_1,Luis,28,ES28209538501931917716,TRX_N-00966-43584914,2024-04-04T01:48:26,Bilbao,Expense,cash,-100.0,-56042.6
buyer_1,Luis,28,ES28209538501931917716,TRX_N-00967-56747386,2024-04-05T16:22:34,Bilbao,expenses,gas,-57.19,-56099.79
buyer_1,Luis,28,ES28209538501931917716,TRX_N-00968-27089875,2024-04-05T01:45:19,Bilbao,expenses,phone,-34.79,-56134.58
buyer_1,Luis,28,ES28209538501931917716,TRX_N-00969-51114346,2024-04-05T23:49:32,Bilbao,Expense,travel,-644.82,-56779.4
buyer_1,Luis,28,ES28209538501931917716,TRX_N-00970-41953442,2024-04-06T19:27:35,Bilbao,expenses,water,-33.44,-56812.84
buyer_1,Luis,28,ES28209538501931917716,TRX_N-00971-89335929,2024-04-08T17:34:19,Bilbao,expenses,internet,-42.0,-56854.84
buyer_1,Luis,28,ES28209538501931917716,TRX_N-00972-25846606,2024-04-08T11:44:54,Bilbao,expenses,electricity,-46.12,-56900.96
buyer_1,Luis,28,ES28209538501931917716,TRX_N-00973-84469856,2024-04-10T11:09:03,Bilbao,Expense,cash,-100.0,-57000.96
buyer_1,Luis,28,ES28209538501931917716,TRX_N-00974-53889832,2024-04-10T05:02:04,Bilbao,expenses,children,-224.41,-57225.37
buyer_1,Luis,28,ES28209538501931917716,TRX_N-00975-08122054,2024-04-12T11:34:11,Bilbao,Expense,leisure,-78.24,-57303.61
buyer_1,Luis,28,ES28209538501931917716,TRX_N-00976-35567906,2024-04-12T18:58:20,Bilbao,Expense,appliances,-168.25,-57471.86
buyer_1,Luis,28,ES28209538501931917716,TRX_N-00977-66693589,2024-04-13T09:12:34,Sestao,Expense,education,-58.85,-57530.71
buyer_1,Luis,28,ES28209538501931917716,TRX_N-00978-23473651,2024-04-13T19:41:07,Bilbao,Expense,cash,-100.0,-57630.71
buyer_1,Luis,28,ES28209538501931917716,TRX_N-00979-71557389,2024-04-15T14:13:43,Bilbao,expenses,children,-148.78,-57779.49
buyer_1,Luis,28,ES28209538501931917716,TRX_N-00980-51598519,2024-04-16T18:17:11,Bilbao,Expense,gifts,-627.21,-58406.7
buyer_1,Luis,28,ES28209538501931917716,TRX_N-00981-49695593,2024-04-17T20:43:55,Bilbao,Expense,transport,-83.03,-58489.73
buyer_1,Luis,28,ES28209538501931917716,TRX_N-00982-42356505,2024-04-19T13:53:35,Oy√≥n-Oion,Expense,cash,-100.0,-58589.73
buyer_1,Luis,28,ES28209538501931917716,TRX_N-00983-10050431,2024-04-20T19:11:53,Salvatierra/Agurain,Expense,cash,-100.0,-58689.73
buyer_1,Luis,28,ES28209538501931917716,TRX_N-00984-99354675,2024-04-22T08:25:38,Portugalete,Expense,healthcare,-105.07,-58794.8
buyer_1,Luis,28,ES28209538501931917716,TRX_N-00985-28451424,2024-04-26T15:44:47,Bilbao,Expense,transport,-50.6,-58845.4
buyer_1,Luis,28,ES28209538501931917716,TRX_N-00986-12361407,2024-04-26T09:06:13,Bilbao,Expense,education,-43.86,-58889.26
buyer_1,Luis,28,ES28209538501931917716,TRX_N-00987-20945550,2024-04-26T14:42:54,Bilbao,Expense,appliances,-100.58,-58989.84
buyer_1,Luis,28,ES28209538501931917716,TRX_N-00988-42854615,2024-04-27T17:30:03,Bilbao,Expense,clothing,-101.19,-59091.03
buyer_1,Luis,28,ES28209538501931917716,TRX_N-00989-68950949,2024-04-28T15:12:08,Bilbao,Expense,cash,-100.0,-59191.03
buyer_1,Luis,28,ES28209538501931917716,TRX_N-00990-92920624,2024-05-01T16:56:37,Bilbao,incomes,salary,1622.04,-57568.99
buyer_1,Luis,28,ES28209538501931917716,TRX_N-00991-89664355,2024-05-01T16:56:37,Bilbao,incomes,salary_partner,1087.39,-56481.6
buyer_1,Luis,28,ES28209538501931917716,TRX_N-00992-74031749,2024-05-01T19:13:47,Bilbao,Expense,clothing,-139.64,-56621.24
buyer_1,Luis,28,ES28209538501931917716,TRX_N-00993-97263425,2024-05-01T18:38:10,Lasarte-Oria,Expense,cash,-100.0,-56721.24
buyer_1,Luis,28,ES28209538501931917716,TRX_N-00994-60314005,2024-05-03T11:22:24,Bilbao,Expense,repairs,-71.77,-56793.01
buyer_1,Luis,28,ES28209538501931917716,TRX_N-00995-53206078,2024-05-04T14:18:27,Bilbao,expenses,mortgage,-928.53,-57721.54
buyer_1,Luis,28,ES28209538501931917716,TRX_N-00996-80426576,2024-05-04T12:55:55,Bilbao,Expense,leisure,-43.31,-57764.85
buyer_1,Luis,28,ES28209538501931917716,TRX_N-00997-56685625,2024-05-05T11:31:50,Bilbao,expenses,internet,-42.0,-57806.85
buyer_1,Luis,28,ES28209538501931917716,TRX_N-00998-94539465,2024-05-05T19:47:15,Alegr√≠a-Dulantzi,Expense,leisure,-82.7,-57889.55
buyer_1,Luis,28,ES28209538501931917716,TRX_N-00999-98733282,2024-05-06T14:32:02,Bilbao,expenses,electricity,-76.18,-57965.73
buyer_1,Luis,28,ES28209538501931917716,TRX_N-01000-09810898,2024-05-06T21:05:04,Bilbao,Expense,food,-112.11,-58077.84
buyer_1,Luis,28,ES28209538501931917716,TRX_N-01001-46616427,2024-05-07T12:22:43,Bilbao,expenses,phone,-39.87,-58117.71
buyer_1,Luis,28,ES28209538501931917716,TRX_N-01002-55860111,2024-05-07T13:04:30,Arrasate,Expense,repairs,-151.51,-58269.22
buyer_1,Luis,28,ES28209538501931917716,TRX_N-01003-71588569,2024-05-08T05:57:17,Bilbao,expenses,water,-29.21,-58298.43
buyer_1,Luis,28,ES28209538501931917716,TRX_N-01004-82384847,2024-05-08T08:13:41,Bilbao,expenses,gas,-104.75,-58403.18
buyer_1,Luis,28,ES28209538501931917716,TRX_N-01005-90991094,2024-05-09T14:30:35,Bilbao,Expense,food,-83.29,-58486.47
buyer_1,Luis,28,ES28209538501931917716,TRX_N-01006-71752432,2024-05-11T14:44:00,Bilbao,Expense,education,-42.73,-58529.2
buyer_1,Luis,28,ES28209538501931917716,TRX_N-01007-58700015,2024-05-12T22:16:30,Bilbao,Expense,leisure,-25.54,-58554.74
buyer_1,Luis,28,ES28209538501931917716,TRX_N-01008-78804990,2024-05-14T19:21:29,Bilbao,Expense,cash,-100.0,-58654.74
buyer_1,Luis,28,ES28209538501931917716,TRX_N-01009-29156102,2024-05-15T10:28:44,Labastida,Expense,leisure,-21.63,-58676.37
buyer_1,Luis,28,ES28209538501931917716,TRX_N-01010-57858515,2024-05-17T16:22:15,Lasarte-Oria,Expense,leisure,-61.85,-58738.22
buyer_1,Luis,28,ES28209538501931917716,TRX_N-01011-58904186,2024-05-17T16:05:19,Bilbao,Expense,education,-78.19,-58816.41
buyer_1,Luis,28,ES28209538501931917716,TRX_N-01012-38772923,2024-05-18T19:18:35,Bilbao,Expense,leisure,-72.61,-58889.02
buyer_1,Luis,28,ES28209538501931917716,TRX_N-01013-59529149,2024-05-19T19:01:12,Bilbao,Expense,leisure,-48.92,-58937.94
buyer_1,Luis,28,ES28209538501931917716,TRX_N-01014-62968297,2024-05-19T13:23:45,Bilbao,Expense,cash,-100.0,-59037.94
buyer_1,Luis,28,ES28209538501931917716,TRX_N-01015-90007002,2024-05-20T09:23:08,Bilbao,Expense,food,-79.29,-59117.23
buyer_1,Luis,28,ES28209538501931917716,TRX_N-01016-02831860,2024-05-21T08:55:23,Bilbao,Expense,food,-72.62,-59189.85
buyer_1,Luis,28,ES28209538501931917716,TRX_N-01017-16053295,2024-05-21T09:05:09,Bilbao,Expense,leisure,-43.65,-59233.5
buyer_1,Luis,28,ES28209538501931917716,TRX_N-01018-32676625,2024-05-22T21:23:15,Bilbao,Expense,cash,-100.0,-59333.5
buyer_1,Luis,28,ES28209538501931917716,TRX_N-01019-35985547,2024-05-23T10:32:57,Errenteria,Expense,cash,-100.0,-59433.5
buyer_1,Luis,28,ES28209538501931917716,TRX_N-01020-29275758,2024-05-25T17:16:30,Bilbao,Expense,leisure,-21.06,-59454.56
buyer_1,Luis,28,ES28209538501931917716,TRX_N-01021-99775508,2024-05-26T15:41:02,Bilbao,Expense,leisure,-70.11,-59524.67
buyer_1,Luis,28,ES28209538501931917716,TRX_N-01022-57407832,2024-05-27T20:30:25,Bilbao,Expense,appliances,-95.19,-59619.86
buyer_1,Luis,28,ES28209538501931917716,TRX_N-01023-00326962,2024-05-27T09:38:55,Bilbao,expenses,children,-244.93,-59864.79
buyer_1,Luis,28,ES28209538501931917716,TRX_N-01024-35977192,2024-05-29T20:55:40,Bilbao,Expense,travel,-766.06,-60630.85
buyer_1,Luis,28,ES28209538501931917716,TRX_N-01025-48488525,2024-05-31T17:26:58,Bilbao,Expense,leisure,-34.98,-60665.83
buyer_1,Luis,28,ES28209538501931917716,TRX_N-01026-12696093,2024-05-31T12:03:22,Bilbao,Expense,clothing,-119.48,-60785.31
buyer_1,Luis,28,ES28209538501931917716,TRX_N-01027-71370454,2024-05-31T16:50:41,Leioa,Expense,gifts,-627.0,-61412.31
buyer_1,Luis,28,ES28209538501931917716,TRX_N-01028-12584252,2024-06-01T07:57:24,Bilbao,incomes,salary,1622.04,-59790.27
buyer_1,Luis,28,ES28209538501931917716,TRX_N-01029-39451069,2024-06-01T07:57:24,Bilbao,incomes,salary_partner,1087.39,-58702.88
buyer_1,Luis,28,ES28209538501931917716,TRX_N-01030-48694522,2024-06-01T07:57:24,Bilbao,incomes,salary_bonus,1139.71,-57563.17
buyer_1,Luis,28,ES28209538501931917716,TRX_N-01031-72133047,2024-06-01T07:57:24,Bilbao,incomes,salary_partner_bonus,834.04,-56729.13
buyer_1,Luis,28,ES28209538501931917716,TRX_N-01032-51578900,2024-06-03T17:15:46,Bilbao,expenses,taxes,-1696.17,-58425.3
buyer_1,Luis,28,ES28209538501931917716,TRX_N-01033-95724486,2024-06-03T16:13:42,Bilbao,expenses,insurance,-324.8,-58750.1
buyer_1,Luis,28,ES28209538501931917716,TRX_N-01034-38249457,2024-06-03T16:34:37,Pasaia,Expense,leisure,-79.3,-58829.4
buyer_1,Luis,28,ES28209538501931917716,TRX_N-01035-98049228,2024-06-04T17:25:00,Bilbao,expenses,mortgage,-928.53,-59757.93
buyer_1,Luis,28,ES28209538501931917716,TRX_N-01036-32020891,2024-06-06T23:01:33,Bilbao,expenses,internet,-42.0,-59799.93
buyer_1,Luis,28,ES28209538501931917716,TRX_N-01037-90570674,2024-06-06T12:57:17,Bilbao,Expense,cash,-100.0,-59899.93
buyer_1,Luis,28,ES28209538501931917716,TRX_N-01038-13584035,2024-06-07T21:16:30,Bermeo,Expense,food,-119.45,-60019.38
buyer_1,Luis,28,ES28209538501931917716,TRX_N-01039-15265406,2024-06-07T13:38:41,Bilbao,Expense,cash,-100.0,-60119.38
buyer_1,Luis,28,ES28209538501931917716,TRX_N-01040-48810139,2024-06-07T19:03:47,Bilbao,Expense,appliances,-77.15,-60196.53
buyer_1,Luis,28,ES28209538501931917716,TRX_N-01041-80582409,2024-06-08T05:57:44,Bilbao,expenses,electricity,-22.31,-60218.84
buyer_1,Luis,28,ES28209538501931917716,TRX_N-01042-86783687,2024-06-08T06:57:19,Bilbao,expenses,phone,-38.91,-60257.75
buyer_1,Luis,28,ES28209538501931917716,TRX_N-01043-34828889,2024-06-08T21:46:14,Bilbao,expenses,water,-28.32,-60286.07
buyer_1,Luis,28,ES28209538501931917716,TRX_N-01044-47085910,2024-06-08T17:37:44,Bilbao,expenses,gas,-45.1,-60331.17
buyer_1,Luis,28,ES28209538501931917716,TRX_N-01045-46451773,2024-06-10T10:07:39,Bilbao,Expense,food,-81.99,-60413.16
buyer_1,Luis,28,ES28209538501931917716,TRX_N-01046-29666554,2024-06-12T18:39:09,Bilbao,Expense,repairs,-71.29,-60484.45
buyer_1,Luis,28,ES28209538501931917716,TRX_N-01047-02346456,2024-06-15T22:23:00,Iru√±a de Oca,Expense,food,-64.6,-60549.05
buyer_1,Luis,28,ES28209538501931917716,TRX_N-01048-22698317,2024-06-15T16:08:09,Bilbao,Expense,transport,-79.25,-60628.3
buyer_1,Luis,28,ES28209538501931917716,TRX_N-01049-61640426,2024-06-16T14:14:56,Bilbao,Expense,leisure,-35.64,-60663.94
buyer_1,Luis,28,ES28209538501931917716,TRX_N-01050-71834049,2024-06-17T09:04:45,Bilbao,Expense,clothing,-62.85,-60726.79
buyer_1,Luis,28,ES28209538501931917716,TRX_N-01051-47439436,2024-06-17T08:16:21,Bilbao,Expense,cash,-100.0,-60826.79
buyer_1,Luis,28,ES28209538501931917716,TRX_N-01052-99573993,2024-06-18T22:48:47,Oy√≥n-Oion,Expense,food,-73.0,-60899.79
buyer_1,Luis,28,ES28209538501931917716,TRX_N-01053-17989580,2024-06-18T11:05:15,Bilbao,Expense,cash,-100.0,-60999.79
buyer_1,Luis,28,ES28209538501931917716,TRX_N-01054-39333695,2024-06-19T09:26:47,Bilbao,Expense,cash,-100.0,-61099.79
buyer_1,Luis,28,ES28209538501931917716,TRX_N-01055-92873141,2024-06-20T10:58:43,Bilbao,Expense,food,-99.34,-61199.13
buyer_1,Luis,28,ES28209538501931917716,TRX_N-01056-62646627,2024-06-22T10:40:03,Bilbao,Expense,food,-115.78,-61314.91
buyer_1,Luis,28,ES28209538501931917716,TRX_N-01057-48964632,2024-06-22T18:01:13,Bilbao,Expense,gifts,-778.51,-62093.42
buyer_1,Luis,28,ES28209538501931917716,TRX_N-01058-08507144,2024-06-23T17:46:33,Iru√±a de Oca,Expense,leisure,-18.1,-62111.52
buyer_1,Luis,28,ES28209538501931917716,TRX_N-01059-76542863,2024-06-25T20:03:39,Bilbao,Expense,leisure,-19.45,-62130.97
buyer_1,Luis,28,ES28209538501931917716,TRX_N-01060-34287213,2024-06-25T18:17:14,Salvatierra/Agurain,Expense,cash,-100.0,-62230.97
buyer_1,Luis,28,ES28209538501931917716,TRX_N-01061-59280081,2024-06-27T03:38:53,Bilbao,Expense,transport,-76.18,-62307.15
buyer_1,Luis,28,ES28209538501931917716,TRX_N-01062-06028157,2024-06-27T08:51:43,Bilbao,expenses,children,-259.33,-62566.48
buyer_1,Luis,28,ES28209538501931917716,TRX_N-01063-15820103,2024-06-28T12:09:17,Sopela,Expense,food,-77.86,-62644.34
buyer_1,Luis,28,ES28209538501931917716,TRX_N-01064-64784753,2024-06-29T09:49:56,Getxo,Expense,repairs,-171.78,-62816.12
buyer_1,Luis,28,ES28209538501931917716,TRX_N-01065-16991541,2024-06-30T16:19:06,Bilbao,Expense,transport,-84.66,-62900.78
buyer_1,Luis,28,ES28209538501931917716,TRX_N-01066-95852351,2024-07-01T09:17:05,Bilbao,incomes,salary,1622.04,-61278.74
buyer_1,Luis,28,ES28209538501931917716,TRX_N-01067-10466059,2024-07-01T09:17:05,Bilbao,incomes,salary_partner,1087.39,-60191.35
buyer_1,Luis,28,ES28209538501931917716,TRX_N-01068-70345824,2024-07-01T09:17:05,Bilbao,incomes,extra_income,159.05,-60032.3
buyer_1,Luis,28,ES28209538501931917716,TRX_N-01069-25455292,2024-07-01T13:34:19,Bilbao,Expense,transport,-81.56,-60113.86
buyer_1,Luis,28,ES28209538501931917716,TRX_N-01070-78587223,2024-07-03T15:28:22,Lasarte-Oria,Expense,clothing,-152.65,-60266.51
buyer_1,Luis,28,ES28209538501931917716,TRX_N-01071-58708097,2024-07-04T20:03:24,Bilbao,expenses,mortgage,-928.53,-61195.04
buyer_1,Luis,28,ES28209538501931917716,TRX_N-01072-70250731,2024-07-04T05:50:22,Bilbao,Expense,food,-106.1,-61301.14
buyer_1,Luis,28,ES28209538501931917716,TRX_N-01073-89865483,2024-07-04T20:41:47,Lasarte-Oria,Expense,cash,-100.0,-61401.14
buyer_1,Luis,28,ES28209538501931917716,TRX_N-01074-40265484,2024-07-05T08:48:43,Bilbao,Expense,appliances,-83.39,-61484.53
buyer_1,Luis,28,ES28209538501931917716,TRX_N-01075-09345128,2024-07-05T14:01:44,Andoain,Expense,repairs,-205.5,-61690.03
buyer_1,Luis,28,ES28209538501931917716,TRX_N-01076-53716285,2024-07-06T18:04:41,Bilbao,expenses,electricity,-63.69,-61753.72
buyer_1,Luis,28,ES28209538501931917716,TRX_N-01077-78491880,2024-07-06T10:24:19,Bilbao,expenses,children,-174.86,-61928.58
buyer_1,Luis,28,ES28209538501931917716,TRX_N-01078-24631879,2024-07-07T08:24:43,Bilbao,expenses,water,-38.85,-61967.43
buyer_1,Luis,28,ES28209538501931917716,TRX_N-01079-81415334,2024-07-07T17:23:16,Bilbao,expenses,phone,-36.85,-62004.28
buyer_1,Luis,28,ES28209538501931917716,TRX_N-01080-98455766,2024-07-07T10:20:42,Bilbao,Expense,food,-98.6,-62102.88
buyer_1,Luis,28,ES28209538501931917716,TRX_N-01081-10748067,2024-07-07T08:26:53,Eibar,Expense,transport,-65.44,-62168.32
buyer_1,Luis,28,ES28209538501931917716,TRX_N-01082-60043008,2024-07-07T11:13:40,Bilbao,Expense,cash,-100.0,-62268.32
buyer_1,Luis,28,ES28209538501931917716,TRX_N-01083-62570231,2024-07-08T11:00:34,Bilbao,expenses,gas,-50.21,-62318.53
buyer_1,Luis,28,ES28209538501931917716,TRX_N-01084-14381126,2024-07-08T16:13:17,Bilbao,expenses,internet,-42.0,-62360.53
buyer_1,Luis,28,ES28209538501931917716,TRX_N-01085-67490440,2024-07-10T06:31:23,Bilbao,Expense,cash,-100.0,-62460.53
buyer_1,Luis,28,ES28209538501931917716,TRX_N-01086-51210509,2024-07-13T15:31:06,Bilbao,Expense,repairs,-75.05,-62535.58
buyer_1,Luis,28,ES28209538501931917716,TRX_N-01087-61907827,2024-07-14T19:36:27,Bilbao,Expense,clothing,-66.63,-62602.21
buyer_1,Luis,28,ES28209538501931917716,TRX_N-01088-28732181,2024-07-15T11:22:29,Bilbao,Expense,food,-104.13,-62706.34
buyer_1,Luis,28,ES28209538501931917716,TRX_N-01089-86797146,2024-07-18T08:51:42,Bilbao,Expense,cash,-100.0,-62806.34
buyer_1,Luis,28,ES28209538501931917716,TRX_N-01090-24978340,2024-07-18T14:39:55,Bilbao,expenses,children,-211.18,-63017.52
buyer_1,Luis,28,ES28209538501931917716,TRX_N-01091-85978380,2024-07-21T19:40:28,Bilbao,Expense,transport,-87.93,-63105.45
buyer_1,Luis,28,ES28209538501931917716,TRX_N-01092-52360373,2024-07-22T11:26:28,Vitoria-Gasteiz,Expense,gifts,-309.43,-63414.88
buyer_1,Luis,28,ES28209538501931917716,TRX_N-01093-88838255,2024-07-23T09:48:21,Bilbao,Expense,food,-73.59,-63488.47
buyer_1,Luis,28,ES28209538501931917716,TRX_N-01094-55054397,2024-07-24T23:13:42,Bilbao,Expense,leisure,-58.97,-63547.44
buyer_1,Luis,28,ES28209538501931917716,TRX_N-01095-56157750,2024-07-24T10:17:05,Bilbao,Expense,repairs,-29.32,-63576.76
buyer_1,Luis,28,ES28209538501931917716,TRX_N-01096-61434775,2024-07-24T19:02:57,Berango,Expense,gifts,-178.18,-63754.94
buyer_1,Luis,28,ES28209538501931917716,TRX_N-01097-05098023,2024-07-26T11:07:42,Bilbao,Expense,transport,-43.53,-63798.47
buyer_1,Luis,28,ES28209538501931917716,TRX_N-01098-33259573,2024-07-26T09:31:13,Bilbao,Expense,travel,-1872.68,-65671.15
buyer_1,Luis,28,ES28209538501931917716,TRX_N-01099-23816087,2024-07-27T19:23:34,Bilbao,Expense,food,-75.75,-65746.9
buyer_1,Luis,28,ES28209538501931917716,TRX_N-01100-13075199,2024-07-28T08:11:34,Bilbao,Expense,leisure,-19.57,-65766.47
buyer_1,Luis,28,ES28209538501931917716,TRX_N-01101-85722175,2024-07-28T18:52:53,Bermeo,Expense,clothing,-98.96,-65865.43
buyer_1,Luis,28,ES28209538501931917716,TRX_N-01102-23009465,2024-07-30T21:06:36,Bilbao,Expense,food,-104.4,-65969.83
buyer_1,Luis,28,ES28209538501931917716,TRX_N-01103-60492935,2024-07-31T07:33:07,Bilbao,Expense,food,-124.76,-66094.59
buyer_1,Luis,28,ES28209538501931917716,TRX_N-01104-18313011,2024-07-31T11:21:14,Bilbao,Expense,leisure,-36.13,-66130.72
buyer_1,Luis,28,ES28209538501931917716,TRX_N-01105-89140545,2024-07-31T15:29:43,Bilbao,Expense,cash,-100.0,-66230.72
buyer_1,Luis,28,ES28209538501931917716,TRX_N-01106-42742423,2024-08-01T08:06:01,Bilbao,incomes,salary,1622.04,-64608.68
buyer_1,Luis,28,ES28209538501931917716,TRX_N-01107-45509553,2024-08-01T08:06:01,Bilbao,incomes,salary_partner,1087.39,-63521.29
buyer_1,Luis,28,ES28209538501931917716,TRX_N-01108-27772568,2024-08-01T14:37:34,Bilbao,Expense,appliances,-253.34,-63774.63
buyer_1,Luis,28,ES28209538501931917716,TRX_N-01109-53805083,2024-08-02T17:46:44,Bilbao,Expense,leisure,-62.91,-63837.54
buyer_1,Luis,28,ES28209538501931917716,TRX_N-01110-26918839,2024-08-04T00:04:40,Bilbao,expenses,mortgage,-928.53,-64766.07
buyer_1,Luis,28,ES28209538501931917716,TRX_N-01111-46698427,2024-08-06T19:58:30,Bilbao,expenses,electricity,-36.39,-64802.46
buyer_1,Luis,28,ES28209538501931917716,TRX_N-01112-17766780,2024-08-06T12:10:21,Bilbao,Expense,food,-110.72,-64913.18
buyer_1,Luis,28,ES28209538501931917716,TRX_N-01113-58582578,2024-08-06T13:35:35,Bilbao,Expense,leisure,-43.31,-64956.49
buyer_1,Luis,28,ES28209538501931917716,TRX_N-01114-04246824,2024-08-07T09:48:19,Bilbao,expenses,phone,-42.58,-64999.07
buyer_1,Luis,28,ES28209538501931917716,TRX_N-01115-26530045,2024-08-07T17:16:21,Bilbao,Expense,gifts,-673.27,-65672.34
buyer_1,Luis,28,ES28209538501931917716,TRX_N-01116-96118098,2024-08-08T16:56:13,Bilbao,expenses,water,-43.82,-65716.16
buyer_1,Luis,28,ES28209538501931917716,TRX_N-01117-60736124,2024-08-08T11:37:10,Bilbao,expenses,gas,-94.75,-65810.91
buyer_1,Luis,28,ES28209538501931917716,TRX_N-01118-43330268,2024-08-08T02:32:30,Bilbao,expenses,internet,-42.0,-65852.91
buyer_1,Luis,28,ES28209538501931917716,TRX_N-01119-77035509,2024-08-08T22:46:25,Bilbao,Expense,food,-99.18,-65952.09
buyer_1,Luis,28,ES28209538501931917716,TRX_N-01120-72849682,2024-08-08T12:31:24,Bilbao,Expense,appliances,-186.62,-66138.71
buyer_1,Luis,28,ES28209538501931917716,TRX_N-01121-07535051,2024-08-09T18:40:20,Bilbao,Expense,leisure,-68.0,-66206.71
buyer_1,Luis,28,ES28209538501931917716,TRX_N-01122-59672044,2024-08-10T13:12:31,Bilbao,Expense,food,-67.65,-66274.36
buyer_1,Luis,28,ES28209538501931917716,TRX_N-01123-77447269,2024-08-10T13:08:48,Bilbao,Expense,leisure,-30.78,-66305.14
buyer_1,Luis,28,ES28209538501931917716,TRX_N-01124-17277129,2024-08-11T20:48:48,Bilbao,Expense,food,-84.97,-66390.11
buyer_1,Luis,28,ES28209538501931917716,TRX_N-01125-65157789,2024-08-12T06:09:39,Bilbao,Expense,gifts,-344.24,-66734.35
buyer_1,Luis,28,ES28209538501931917716,TRX_N-01126-09245071,2024-08-15T16:22:55,Bilbao,Expense,cash,-100.0,-66834.35
buyer_1,Luis,28,ES28209538501931917716,TRX_N-01127-29371179,2024-08-16T18:10:56,Bilbao,Expense,food,-78.16,-66912.51
buyer_1,Luis,28,ES28209538501931917716,TRX_N-01128-29805121,2024-08-18T14:15:21,Bilbao,Expense,leisure,-79.37,-66991.88
buyer_1,Luis,28,ES28209538501931917716,TRX_N-01129-72873776,2024-08-20T08:36:44,Bilbao,Expense,cash,-100.0,-67091.88
buyer_1,Luis,28,ES28209538501931917716,TRX_N-01130-84598352,2024-08-21T22:26:57,Bilbao,Expense,food,-109.66,-67201.54
buyer_1,Luis,28,ES28209538501931917716,TRX_N-01131-18507636,2024-08-21T00:13:06,Hernani,Expense,healthcare,-75.61,-67277.15
buyer_1,Luis,28,ES28209538501931917716,TRX_N-01132-42886498,2024-08-23T13:28:51,Bilbao,Expense,gifts,-408.05,-67685.2
buyer_1,Luis,28,ES28209538501931917716,TRX_N-01133-72685024,2024-08-24T20:17:33,Bilbao,Expense,transport,-69.23,-67754.43
buyer_1,Luis,28,ES28209538501931917716,TRX_N-01134-41373451,2024-08-28T11:24:46,Bilbao,Expense,food,-74.98,-67829.41
buyer_1,Luis,28,ES28209538501931917716,TRX_N-01135-74569606,2024-08-30T22:57:29,Getxo,Expense,clothing,-100.53,-67929.94
buyer_1,Luis,28,ES28209538501931917716,TRX_N-01136-60653894,2024-08-31T17:39:47,Andoain,Expense,cash,-100.0,-68029.94
buyer_1,Luis,28,ES28209538501931917716,TRX_N-01137-99592161,2024-09-01T18:50:19,Bilbao,incomes,salary,1622.04,-66407.9
buyer_1,Luis,28,ES28209538501931917716,TRX_N-01138-96948062,2024-09-01T18:50:19,Bilbao,incomes,salary_partner,1087.39,-65320.51
buyer_1,Luis,28,ES28209538501931917716,TRX_N-01139-51323947,2024-09-01T09:21:25,Bilbao,Expense,leisure,-34.79,-65355.3
buyer_1,Luis,28,ES28209538501931917716,TRX_N-01140-40658093,2024-09-01T00:25:52,Bilbao,Expense,cash,-100.0,-65455.3
buyer_1,Luis,28,ES28209538501931917716,TRX_N-01141-79650510,2024-09-02T14:46:35,Bilbao,Expense,transport,-85.07,-65540.37
buyer_1,Luis,28,ES28209538501931917716,TRX_N-01142-36229193,2024-09-04T08:40:08,Bilbao,expenses,mortgage,-928.53,-66468.9
buyer_1,Luis,28,ES28209538501931917716,TRX_N-01143-88691645,2024-09-04T11:54:32,Bilbao,Expense,food,-119.82,-66588.72
buyer_1,Luis,28,ES28209538501931917716,TRX_N-01144-40284243,2024-09-06T16:45:25,Bilbao,Expense,leisure,-62.0,-66650.72
buyer_1,Luis,28,ES28209538501931917716,TRX_N-01145-12092292,2024-09-07T07:32:46,Bilbao,expenses,water,-32.73,-66683.45
buyer_1,Luis,28,ES28209538501931917716,TRX_N-01146-46776794,2024-09-07T19:31:05,Bilbao,expenses,electricity,-53.34,-66736.79
buyer_1,Luis,28,ES28209538501931917716,TRX_N-01147-35746170,2024-09-07T20:16:10,Bilbao,expenses,phone,-32.71,-66769.5
buyer_1,Luis,28,ES28209538501931917716,TRX_N-01148-72442353,2024-09-08T10:10:38,Bilbao,expenses,gas,-82.97,-66852.47
buyer_1,Luis,28,ES28209538501931917716,TRX_N-01149-00833625,2024-09-08T20:44:29,Bilbao,expenses,internet,-42.0,-66894.47
buyer_1,Luis,28,ES28209538501931917716,TRX_N-01150-93687017,2024-09-09T22:39:29,Bilbao,Expense,food,-76.04,-66970.51
buyer_1,Luis,28,ES28209538501931917716,TRX_N-01151-24989887,2024-09-09T17:16:41,Bilbao,Expense,repairs,-66.14,-67036.65
buyer_1,Luis,28,ES28209538501931917716,TRX_N-01152-07007516,2024-09-10T13:28:36,Bilbao,Expense,cash,-100.0,-67136.65
buyer_1,Luis,28,ES28209538501931917716,TRX_N-01153-91272762,2024-09-12T18:07:44,Bilbao,Expense,leisure,-35.69,-67172.34
buyer_1,Luis,28,ES28209538501931917716,TRX_N-01154-54686081,2024-09-15T03:30:24,Bilbao,Expense,cash,-100.0,-67272.34
buyer_1,Luis,28,ES28209538501931917716,TRX_N-01155-89263505,2024-09-17T11:39:15,Bilbao,Expense,repairs,-47.43,-67319.77
buyer_1,Luis,28,ES28209538501931917716,TRX_N-01156-77491261,2024-09-18T10:12:17,Bilbao,Expense,education,-57.09,-67376.86
buyer_1,Luis,28,ES28209538501931917716,TRX_N-01157-72222875,2024-09-18T08:46:30,Bilbao,expenses,children,-68.13,-67444.99
buyer_1,Luis,28,ES28209538501931917716,TRX_N-01158-55077795,2024-09-19T19:25:32,Bilbao,Expense,cash,-100.0,-67544.99
buyer_1,Luis,28,ES28209538501931917716,TRX_N-01159-85117644,2024-09-20T23:02:08,Bilbao,Expense,transport,-74.58,-67619.57
buyer_1,Luis,28,ES28209538501931917716,TRX_N-01160-51287062,2024-09-21T20:53:39,Bilbao,Expense,cash,-100.0,-67719.57
buyer_1,Luis,28,ES28209538501931917716,TRX_N-01161-98943363,2024-09-24T18:18:37,Bilbao,Expense,food,-98.58,-67818.15
buyer_1,Luis,28,ES28209538501931917716,TRX_N-01162-54230213,2024-09-25T08:34:14,Bilbao,Expense,cash,-100.0,-67918.15
buyer_1,Luis,28,ES28209538501931917716,TRX_N-01163-17443647,2024-09-26T16:18:37,Bilbao,Expense,cash,-100.0,-68018.15
buyer_1,Luis,28,ES28209538501931917716,TRX_N-01164-37884466,2024-09-30T09:05:33,Bilbao,Expense,cash,-100.0,-68118.15
buyer_1,Luis,28,ES28209538501931917716,TRX_N-01165-03254596,2024-10-01T17:30:48,Bilbao,incomes,salary,1622.04,-66496.11
buyer_1,Luis,28,ES28209538501931917716,TRX_N-01166-49146060,2024-10-01T17:30:48,Bilbao,incomes,salary_partner,1087.39,-65408.72
buyer_1,Luis,28,ES28209538501931917716,TRX_N-01167-45252879,2024-10-01T19:18:38,Bilbao,Expense,leisure,-76.65,-65485.37
buyer_1,Luis,28,ES28209538501931917716,TRX_N-01168-09737778,2024-10-01T15:51:29,Bilbao,Expense,cash,-100.0,-65585.37
buyer_1,Luis,28,ES28209538501931917716,TRX_N-01169-09132709,2024-10-03T16:40:32,Bilbao,Expense,transport,-46.03,-65631.4
buyer_1,Luis,28,ES28209538501931917716,TRX_N-01170-73699467,2024-10-03T12:55:48,Bilbao,Expense,leisure,-70.48,-65701.88
buyer_1,Luis,28,ES28209538501931917716,TRX_N-01171-44584766,2024-10-03T15:41:31,Bilbao,Expense,cash,-100.0,-65801.88
buyer_1,Luis,28,ES28209538501931917716,TRX_N-01172-29309615,2024-10-04T10:03:21,Bilbao,expenses,mortgage,-928.53,-66730.41
buyer_1,Luis,28,ES28209538501931917716,TRX_N-01173-67491470,2024-10-04T19:00:36,Bilbao,Expense,leisure,-51.84,-66782.25
buyer_1,Luis,28,ES28209538501931917716,TRX_N-01174-88710382,2024-10-06T08:15:35,Bilbao,Expense,transport,-60.65,-66842.9
buyer_1,Luis,28,ES28209538501931917716,TRX_N-01175-17515280,2024-10-07T19:03:28,Bilbao,expenses,electricity,-75.52,-66918.42
buyer_1,Luis,28,ES28209538501931917716,TRX_N-01176-54500129,2024-10-07T09:43:30,Erandio,Expense,repairs,-322.71,-67241.13
buyer_1,Luis,28,ES28209538501931917716,TRX_N-01177-81184423,2024-10-08T12:35:17,Bilbao,expenses,water,-34.39,-67275.52
buyer_1,Luis,28,ES28209538501931917716,TRX_N-01178-94535758,2024-10-08T12:19:17,Bilbao,expenses,gas,-91.44,-67366.96
buyer_1,Luis,28,ES28209538501931917716,TRX_N-01179-93135406,2024-10-08T11:47:22,Bilbao,expenses,internet,-42.0,-67408.96
buyer_1,Luis,28,ES28209538501931917716,TRX_N-01180-24557945,2024-10-08T03:48:20,Bilbao,expenses,phone,-32.77,-67441.73
buyer_2,Carmen,40,ES70209504723955028443,TRX_N-00001-06051609,2022-01-01T12:41:34,Zarautz,incomes,salary,1229.41,2989.75
buyer_2,Carmen,40,ES70209504723955028443,TRX_N-00002-78575943,2022-01-01T12:41:34,Zarautz,incomes,salary_partner,1490.12,4479.87
buyer_2,Carmen,40,ES70209504723955028443,TRX_N-00003-86760494,2022-01-01T16:36:23,Zarautz,Expense,gifts,-533.46,3946.41
buyer_2,Carmen,40,ES70209504723955028443,TRX_N-00004-51633332,2022-01-02T05:45:40,Zarautz,Expense,food,-96.22,3850.19
buyer_2,Carmen,40,ES70209504723955028443,TRX_N-00005-55108527,2022-01-04T11:28:57,Zarautz,expenses,mortgage,-1033.24,2816.95
buyer_2,Carmen,40,ES70209504723955028443,TRX_N-00006-28484643,2022-01-06T23:58:58,Zarautz,expenses,electricity,-44.43,2772.52
buyer_2,Carmen,40,ES70209504723955028443,TRX_N-00007-71145494,2022-01-06T18:26:16,Zarautz,Expense,education,-58.99,2713.53
buyer_2,Carmen,40,ES70209504723955028443,TRX_N-00008-52176300,2022-01-06T16:37:18,Zarautz,Expense,cash,-100.0,2613.53
buyer_2,Carmen,40,ES70209504723955028443,TRX_N-00009-11945228,2022-01-07T17:02:13,Zarautz,expenses,gas,-107.03,2506.5
buyer_2,Carmen,40,ES70209504723955028443,TRX_N-00010-99971300,2022-01-07T09:35:56,Zarautz,Expense,food,-68.98,2437.52
buyer_2,Carmen,40,ES70209504723955028443,TRX_N-00011-54678459,2022-01-08T08:39:59,Zarautz,expenses,water,-39.5,2398.02
buyer_2,Carmen,40,ES70209504723955028443,TRX_N-00012-88201867,2022-01-08T18:48:32,Zarautz,expenses,internet,-42.0,2356.02
buyer_2,Carmen,40,ES70209504723955028443,TRX_N-00013-02840293,2022-01-08T08:45:29,Zarautz,expenses,phone,-33.0,2323.02
buyer_2,Carmen,40,ES70209504723955028443,TRX_N-00014-06025575,2022-01-09T19:07:44,Zarautz,Expense,cash,-100.0,2223.02
buyer_2,Carmen,40,ES70209504723955028443,TRX_N-00015-31246091,2022-01-10T19:26:02,Elciego,Expense,leisure,-32.47,2190.55
buyer_2,Carmen,40,ES70209504723955028443,TRX_N-00016-47974802,2022-01-10T20:39:12,Zarautz,Expense,clothing,-152.3,2038.25
buyer_2,Carmen,40,ES70209504723955028443,TRX_N-00017-75675246,2022-01-11T12:35:07,Zarautz,Expense,cash,-100.0,1938.25
buyer_2,Carmen,40,ES70209504723955028443,TRX_N-00018-74647914,2022-01-13T07:37:38,Zarautz,Expense,repairs,-274.89,1663.36
buyer_2,Carmen,40,ES70209504723955028443,TRX_N-00019-39111342,2022-01-14T17:51:26,Zarautz,Expense,food,-86.44,1576.92
buyer_2,Carmen,40,ES70209504723955028443,TRX_N-00020-57624088,2022-01-14T17:16:53,Zarautz,Expense,cash,-100.0,1476.92
buyer_2,Carmen,40,ES70209504723955028443,TRX_N-00021-34082967,2022-01-16T19:49:19,Zarautz,Expense,cash,-100.0,1376.92
buyer_2,Carmen,40,ES70209504723955028443,TRX_N-00022-08387784,2022-01-17T14:01:31,Sestao,Expense,leisure,-40.35,1336.57
buyer_2,Carmen,40,ES70209504723955028443,TRX_N-00023-16432488,2022-01-17T19:49:57,Zarautz,Expense,education,-54.9,1281.67
buyer_2,Carmen,40,ES70209504723955028443,TRX_N-00024-04761641,2022-01-18T20:25:44,Zarautz,Expense,food,-65.76,1215.91
buyer_2,Carmen,40,ES70209504723955028443,TRX_N-00025-10001998,2022-01-20T12:08:13,Zarautz,Expense,food,-117.63,1098.28
buyer_2,Carmen,40,ES70209504723955028443,TRX_N-00026-40690192,2022-01-20T08:11:12,Bilbao,Expense,education,-64.55,1033.73
buyer_2,Carmen,40,ES70209504723955028443,TRX_N-00027-60334473,2022-01-21T06:41:04,Zarautz,Expense,repairs,-129.53,904.2
buyer_2,Carmen,40,ES70209504723955028443,TRX_N-00028-08204327,2022-01-21T12:58:40,Zarautz,Expense,gifts,-793.88,110.32
buyer_2,Carmen,40,ES70209504723955028443,TRX_N-00029-26569281,2022-01-23T11:11:35,Zarautz,Expense,cash,-100.0,10.32
buyer_2,Carmen,40,ES70209504723955028443,TRX_N-00030-97786768,2022-01-24T14:14:04,Zarautz,Expense,repairs,-248.47,-238.15
buyer_2,Carmen,40,ES70209504723955028443,TRX_N-00031-53427792,2022-01-28T22:05:42,Zarautz,expenses,children,-229.99,-468.14
buyer_2,Carmen,40,ES70209504723955028443,TRX_N-00032-36974677,2022-01-29T11:22:05,Zarautz,Expense,transport,-41.66,-509.8
buyer_2,Carmen,40,ES70209504723955028443,TRX_N-00033-25584347,2022-01-30T14:07:00,Zarautz,Expense,food,-97.78,-607.58
buyer_2,Carmen,40,ES70209504723955028443,TRX_N-00034-72091793,2022-01-30T09:46:04,Zarautz,Expense,transport,-69.2,-676.78
buyer_2,Carmen,40,ES70209504723955028443,TRX_N-00035-86935356,2022-02-01T12:17:04,Zarautz,incomes,salary,1229.41,552.63
buyer_2,Carmen,40,ES70209504723955028443,TRX_N-00036-69122743,2022-02-01T12:17:04,Zarautz,incomes,salary_partner,1490.12,2042.75
buyer_2,Carmen,40,ES70209504723955028443,TRX_N-00037-77391471,2022-02-02T10:27:48,Barakaldo,Expense,transport,-68.55,1974.2
buyer_2,Carmen,40,ES70209504723955028443,TRX_N-00038-21708060,2022-02-04T16:57:00,Zarautz,expenses,mortgage,-1033.24,940.96
buyer_2,Carmen,40,ES70209504723955028443,TRX_N-00039-97100112,2022-02-06T12:39:55,Zarautz,expenses,water,-36.98,903.98
buyer_2,Carmen,40,ES70209504723955028443,TRX_N-00040-95367487,2022-02-07T15:48:12,Zarautz,expenses,electricity,-85.73,818.25
buyer_2,Carmen,40,ES70209504723955028443,TRX_N-00041-44080127,2022-02-07T14:48:38,Zarautz,expenses,gas,-71.26,746.99
buyer_2,Carmen,40,ES70209504723955028443,TRX_N-00042-18721757,2022-02-08T17:48:18,Zarautz,expenses,internet,-42.0,704.99
buyer_2,Carmen,40,ES70209504723955028443,TRX_N-00043-65578139,2022-02-08T13:46:39,Zarautz,expenses,phone,-35.71,669.28
buyer_2,Carmen,40,ES70209504723955028443,TRX_N-00044-92498490,2022-02-08T13:15:39,Zarautz,Expense,food,-103.31,565.97
buyer_2,Carmen,40,ES70209504723955028443,TRX_N-00045-27862840,2022-02-08T13:06:50,Zarautz,Expense,leisure,-54.5,511.47
buyer_2,Carmen,40,ES70209504723955028443,TRX_N-00046-38197495,2022-02-11T09:32:03,Zarautz,Expense,leisure,-19.63,491.84
buyer_2,Carmen,40,ES70209504723955028443,TRX_N-00047-61730025,2022-02-12T16:13:37,Getxo,Expense,education,-47.74,444.1
buyer_2,Carmen,40,ES70209504723955028443,TRX_N-00048-79094254,2022-02-14T11:33:22,Zarautz,Expense,cash,-100.0,344.1
buyer_2,Carmen,40,ES70209504723955028443,TRX_N-00049-78160784,2022-02-17T12:15:58,Lasarte-Oria,Expense,leisure,-22.6,321.5
buyer_2,Carmen,40,ES70209504723955028443,TRX_N-00050-92664630,2022-02-17T01:16:41,Zarautz,Expense,cash,-100.0,221.5
buyer_2,Carmen,40,ES70209504723955028443,TRX_N-00051-99319760,2022-02-18T10:40:01,Zarautz,Expense,leisure,-34.11,187.39
buyer_2,Carmen,40,ES70209504723955028443,TRX_N-00052-84065368,2022-02-20T06:37:23,Zarautz,Expense,leisure,-49.94,137.45
buyer_2,Carmen,40,ES70209504723955028443,TRX_N-00053-23476125,2022-02-20T13:59:23,Zarautz,Expense,clothing,-153.6,-16.15
buyer_2,Carmen,40,ES70209504723955028443,TRX_N-00054-61604796,2022-02-21T15:26:53,Zarautz,Expense,food,-121.11,-137.26
buyer_2,Carmen,40,ES70209504723955028443,TRX_N-00055-54622236,2022-02-22T21:52:55,Zarautz,Expense,education,-50.21,-187.47
buyer_2,Carmen,40,ES70209504723955028443,TRX_N-00056-15133781,2022-02-23T12:39:46,Zarautz,Expense,food,-78.73,-266.2
buyer_2,Carmen,40,ES70209504723955028443,TRX_N-00057-35280097,2022-02-25T17:18:46,Zarautz,Expense,transport,-53.72,-319.92
buyer_2,Carmen,40,ES70209504723955028443,TRX_N-00058-80108071,2022-02-26T10:47:08,Zarautz,Expense,leisure,-34.0,-353.92
buyer_2,Carmen,40,ES70209504723955028443,TRX_N-00059-24737520,2022-02-26T17:45:23,Zarautz,Expense,cash,-100.0,-453.92
buyer_2,Carmen,40,ES70209504723955028443,TRX_N-00060-25933817,2022-02-27T20:38:50,Zarautz,Expense,transport,-62.75,-516.67
buyer_2,Carmen,40,ES70209504723955028443,TRX_N-00061-27444233,2022-02-27T18:16:44,Portugalete,Expense,leisure,-81.62,-598.29
buyer_2,Carmen,40,ES70209504723955028443,TRX_N-00062-77312548,2022-02-27T19:33:30,Zarautz,Expense,healthcare,-122.77,-721.06
buyer_2,Carmen,40,ES70209504723955028443,TRX_N-00063-60883241,2022-03-01T09:22:47,Zarautz,incomes,salary,1229.41,508.35
buyer_2,Carmen,40,ES70209504723955028443,TRX_N-00064-11529390,2022-03-01T09:22:47,Zarautz,incomes,salary_partner,1490.12,1998.47
buyer_2,Carmen,40,ES70209504723955028443,TRX_N-00065-41033028,2022-03-01T13:09:28,Zarautz,Expense,food,-109.58,1888.89
buyer_2,Carmen,40,ES70209504723955028443,TRX_N-00066-65890426,2022-03-02T14:19:14,Zarautz,Expense,food,-99.21,1789.68
buyer_2,Carmen,40,ES70209504723955028443,TRX_N-00067-35102345,2022-03-02T16:55:55,Zarautz,Expense,gifts,-741.93,1047.75
buyer_2,Carmen,40,ES70209504723955028443,TRX_N-00068-36548963,2022-03-04T08:22:04,Zarautz,expenses,mortgage,-1033.24,14.51
buyer_2,Carmen,40,ES70209504723955028443,TRX_N-00069-74062048,2022-03-04T20:32:24,Alegr√≠a-Dulantzi,Expense,food,-115.35,-100.84
buyer_2,Carmen,40,ES70209504723955028443,TRX_N-00070-04571636,2022-03-05T21:20:51,Zarautz,expenses,gas,-108.48,-209.32
buyer_2,Carmen,40,ES70209504723955028443,TRX_N-00071-36154647,2022-03-05T09:39:49,Zarautz,Expense,clothing,-148.87,-358.19
buyer_2,Carmen,40,ES70209504723955028443,TRX_N-00072-79609987,2022-03-05T15:59:35,Zarautz,Expense,cash,-100.0,-458.19
buyer_2,Carmen,40,ES70209504723955028443,TRX_N-00073-77402796,2022-03-07T16:07:00,Zarautz,expenses,water,-42.46,-500.65
buyer_2,Carmen,40,ES70209504723955028443,TRX_N-00074-16771209,2022-03-07T18:24:42,Zarautz,Expense,cash,-100.0,-600.65
buyer_2,Carmen,40,ES70209504723955028443,TRX_N-00075-15452897,2022-03-08T23:50:31,Zarautz,expenses,internet,-42.0,-642.65
buyer_2,Carmen,40,ES70209504723955028443,TRX_N-00076-88937016,2022-03-08T10:03:00,Zarautz,expenses,phone,-39.33,-681.98
buyer_2,Carmen,40,ES70209504723955028443,TRX_N-00077-51462276,2022-03-08T15:59:33,Zarautz,expenses,electricity,-55.38,-737.36
buyer_2,Carmen,40,ES70209504723955028443,TRX_N-00078-70492490,2022-03-10T18:07:00,Zarautz,Expense,cash,-100.0,-837.36
buyer_2,Carmen,40,ES70209504723955028443,TRX_N-00079-67887204,2022-03-10T13:42:23,Zarautz,Expense,gifts,-420.86,-1258.22
buyer_2,Carmen,40,ES70209504723955028443,TRX_N-00080-42361178,2022-03-11T13:17:16,Zarautz,Expense,leisure,-37.14,-1295.36
buyer_2,Carmen,40,ES70209504723955028443,TRX_N-00081-07487576,2022-03-13T13:13:33,Zarautz,Expense,food,-73.12,-1368.48
buyer_2,Carmen,40,ES70209504723955028443,TRX_N-00082-27051124,2022-03-13T23:01:15,Zarautz,Expense,healthcare,-137.17,-1505.65
buyer_2,Carmen,40,ES70209504723955028443,TRX_N-00083-10131208,2022-03-14T07:13:38,Zarautz,Expense,food,-70.25,-1575.9
buyer_2,Carmen,40,ES70209504723955028443,TRX_N-00084-17427914,2022-03-14T14:32:52,Zarautz,Expense,transport,-72.05,-1647.95
buyer_2,Carmen,40,ES70209504723955028443,TRX_N-00085-36925882,2022-03-15T15:01:18,Sopela,Expense,leisure,-24.44,-1672.39
buyer_2,Carmen,40,ES70209504723955028443,TRX_N-00086-69342933,2022-03-15T10:34:30,Zarautz,Expense,clothing,-96.48,-1768.87
buyer_2,Carmen,40,ES70209504723955028443,TRX_N-00087-03762521,2022-03-17T13:06:37,Zarautz,Expense,transport,-55.11,-1823.98
buyer_2,Carmen,40,ES70209504723955028443,TRX_N-00088-23076234,2022-03-18T09:19:06,Zarautz,Expense,cash,-100.0,-1923.98
buyer_2,Carmen,40,ES70209504723955028443,TRX_N-00089-26641491,2022-03-19T20:31:32,Zarautz,Expense,leisure,-68.04,-1992.02
buyer_2,Carmen,40,ES70209504723955028443,TRX_N-00090-47025878,2022-03-19T15:39:37,Zarautz,Expense,gifts,-693.35,-2685.37
buyer_2,Carmen,40,ES70209504723955028443,TRX_N-00091-60991909,2022-03-23T11:31:01,Zarautz,Expense,leisure,-40.17,-2725.54
buyer_2,Carmen,40,ES70209504723955028443,TRX_N-00092-04533455,2022-03-23T20:23:01,Zarautz,Expense,education,-62.46,-2788.0
buyer_2,Carmen,40,ES70209504723955028443,TRX_N-00093-98948756,2022-03-24T14:40:44,Zarautz,Expense,repairs,-246.93,-3034.93
buyer_2,Carmen,40,ES70209504723955028443,TRX_N-00094-87976278,2022-03-25T09:45:27,Zarautz,Expense,gifts,-31.92,-3066.85
buyer_2,Carmen,40,ES70209504723955028443,TRX_N-00095-43625392,2022-03-27T20:17:46,Zarautz,Expense,food,-90.91,-3157.76
buyer_2,Carmen,40,ES70209504723955028443,TRX_N-00096-60367626,2022-03-27T12:53:48,Zarautz,Expense,leisure,-68.35,-3226.11
buyer_2,Carmen,40,ES70209504723955028443,TRX_N-00097-38452464,2022-03-28T12:32:00,Zarautz,Expense,food,-91.88,-3317.99
buyer_2,Carmen,40,ES70209504723955028443,TRX_N-00098-24201255,2022-03-29T11:46:08,Eibar,Expense,food,-105.03,-3423.02
buyer_2,Carmen,40,ES70209504723955028443,TRX_N-00099-28868415,2022-03-29T16:48:55,Hondarribia,Expense,education,-54.85,-3477.87
buyer_2,Carmen,40,ES70209504723955028443,TRX_N-00100-38564793,2022-03-29T23:08:17,Zarautz,Expense,travel,-1162.65,-4640.52
buyer_2,Carmen,40,ES70209504723955028443,TRX_N-00101-59346333,2022-03-31T19:34:22,Zarautz,Expense,cash,-100.0,-4740.52
buyer_2,Carmen,40,ES70209504723955028443,TRX_N-00102-75574526,2022-04-01T09:14:46,Zarautz,incomes,salary,1229.41,-3511.11
buyer_2,Carmen,40,ES70209504723955028443,TRX_N-00103-73000208,2022-04-01T09:14:46,Zarautz,incomes,salary_partner,1490.12,-2020.99
buyer_2,Carmen,40,ES70209504723955028443,TRX_N-00104-34119151,2022-04-01T09:14:46,Zarautz,incomes,extra_income,122.27,-1898.72
buyer_2,Carmen,40,ES70209504723955028443,TRX_N-00105-06408942,2022-04-01T20:50:43,Eibar,Expense,food,-104.64,-2003.36
buyer_2,Carmen,40,ES70209504723955028443,TRX_N-00106-03992661,2022-04-04T13:24:24,Zarautz,expenses,mortgage,-1033.24,-3036.6
buyer_2,Carmen,40,ES70209504723955028443,TRX_N-00107-44714822,2022-04-05T16:02:44,Zarautz,expenses,water,-32.05,-3068.65
buyer_2,Carmen,40,ES70209504723955028443,TRX_N-00108-19748825,2022-04-05T15:04:05,Zarautz,expenses,internet,-42.0,-3110.65
buyer_2,Carmen,40,ES70209504723955028443,TRX_N-00109-15306396,2022-04-06T16:17:11,Zarautz,expenses,phone,-30.64,-3141.29
buyer_2,Carmen,40,ES70209504723955028443,TRX_N-00110-58292084,2022-04-06T10:09:25,Zarautz,Expense,leisure,-62.8,-3204.09
buyer_2,Carmen,40,ES70209504723955028443,TRX_N-00111-42974927,2022-04-06T10:36:19,Zarautz,Expense,education,-46.67,-3250.76
buyer_2,Carmen,40,ES70209504723955028443,TRX_N-00112-02930011,2022-04-07T12:18:41,Zarautz,expenses,gas,-58.03,-3308.79
buyer_2,Carmen,40,ES70209504723955028443,TRX_N-00113-47488447,2022-04-08T08:19:18,Zarautz,expenses,electricity,-37.11,-3345.9
buyer_2,Carmen,40,ES70209504723955028443,TRX_N-00114-55757144,2022-04-08T13:21:08,Zarautz,Expense,clothing,-139.36,-3485.26
buyer_2,Carmen,40,ES70209504723955028443,TRX_N-00115-11418245,2022-04-08T13:12:46,Zarautz,Expense,gifts,-327.69,-3812.95
buyer_2,Carmen,40,ES70209504723955028443,TRX_N-00116-72379730,2022-04-09T22:53:27,Zarautz,Expense,leisure,-41.08,-3854.03
buyer_2,Carmen,40,ES70209504723955028443,TRX_N-00117-12964736,2022-04-09T12:34:16,Zarautz,Expense,cash,-100.0,-3954.03
buyer_2,Carmen,40,ES70209504723955028443,TRX_N-00118-82283645,2022-04-12T14:03:57,Zarautz,expenses,children,-195.76,-4149.79
buyer_2,Carmen,40,ES70209504723955028443,TRX_N-00119-35120159,2022-04-13T19:01:57,Zarautz,Expense,cash,-100.0,-4249.79
buyer_2,Carmen,40,ES70209504723955028443,TRX_N-00120-50451415,2022-04-13T18:43:29,Zarautz,Expense,gifts,-670.33,-4920.12
buyer_2,Carmen,40,ES70209504723955028443,TRX_N-00121-39146945,2022-04-16T16:18:27,Zarautz,Expense,appliances,-122.83,-5042.95
buyer_2,Carmen,40,ES70209504723955028443,TRX_N-00122-85227782,2022-04-17T12:35:21,Zarautz,Expense,education,-59.32,-5102.27
buyer_2,Carmen,40,ES70209504723955028443,TRX_N-00123-65272464,2022-04-18T18:38:47,Zarautz,Expense,gifts,-354.97,-5457.24
buyer_2,Carmen,40,ES70209504723955028443,TRX_N-00124-55861397,2022-04-19T12:59:04,Zarautz,Expense,appliances,-349.99,-5807.23
buyer_2,Carmen,40,ES70209504723955028443,TRX_N-00125-85230925,2022-04-20T11:56:25,Zarautz,Expense,cash,-100.0,-5907.23
buyer_2,Carmen,40,ES70209504723955028443,TRX_N-00126-85708572,2022-04-24T16:43:51,Zarautz,Expense,food,-86.73,-5993.96
buyer_2,Carmen,40,ES70209504723955028443,TRX_N-00127-87521772,2022-04-25T19:17:06,Zarautz,Expense,transport,-67.16,-6061.12
buyer_2,Carmen,40,ES70209504723955028443,TRX_N-00128-26851370,2022-04-25T10:45:31,Zarautz,Expense,cash,-100.0,-6161.12
buyer_2,Carmen,40,ES70209504723955028443,TRX_N-00129-05468446,2022-04-27T18:56:21,Elciego,Expense,transport,-75.94,-6237.06
buyer_2,Carmen,40,ES70209504723955028443,TRX_N-00130-93077570,2022-04-30T20:58:34,Zarautz,Expense,healthcare,-73.02,-6310.08
buyer_2,Carmen,40,ES70209504723955028443,TRX_N-00131-33035000,2022-05-01T12:39:01,Zarautz,incomes,salary,1229.41,-5080.67
buyer_2,Carmen,40,ES70209504723955028443,TRX_N-00132-30980608,2022-05-01T12:39:01,Zarautz,incomes,salary_partner,1490.12,-3590.55
buyer_2,Carmen,40,ES70209504723955028443,TRX_N-00133-58925352,2022-05-02T13:26:14,Zarautz,Expense,cash,-100.0,-3690.55
buyer_2,Carmen,40,ES70209504723955028443,TRX_N-00134-92181826,2022-05-03T20:43:11,Hernani,Expense,leisure,-43.57,-3734.12
buyer_2,Carmen,40,ES70209504723955028443,TRX_N-00135-25371848,2022-05-04T08:51:52,Zarautz,expenses,mortgage,-1033.24,-4767.36
buyer_2,Carmen,40,ES70209504723955028443,TRX_N-00136-86507930,2022-05-04T11:25:46,Zarautz,Expense,healthcare,-72.41,-4839.77
buyer_2,Carmen,40,ES70209504723955028443,TRX_N-00137-49733401,2022-05-05T05:10:46,Zarautz,expenses,electricity,-35.59,-4875.36
buyer_2,Carmen,40,ES70209504723955028443,TRX_N-00138-32952973,2022-05-05T16:44:50,Zarautz,Expense,food,-88.82,-4964.18
buyer_2,Carmen,40,ES70209504723955028443,TRX_N-00139-17781450,2022-05-06T00:43:41,Zarautz,Expense,leisure,-32.1,-4996.28
buyer_2,Carmen,40,ES70209504723955028443,TRX_N-00140-92313439,2022-05-06T15:47:41,Zarautz,Expense,education,-67.8,-5064.08
buyer_2,Carmen,40,ES70209504723955028443,TRX_N-00141-89831688,2022-05-07T17:04:03,Zarautz,Expense,education,-56.89,-5120.97
buyer_2,Carmen,40,ES70209504723955028443,TRX_N-00142-04771696,2022-05-08T15:54:39,Zarautz,expenses,water,-40.41,-5161.38
buyer_2,Carmen,40,ES70209504723955028443,TRX_N-00143-47849752,2022-05-08T20:18:26,Zarautz,expenses,gas,-64.0,-5225.38
buyer_2,Carmen,40,ES70209504723955028443,TRX_N-00144-57295850,2022-05-08T12:58:58,Zarautz,expenses,internet,-42.0,-5267.38
buyer_2,Carmen,40,ES70209504723955028443,TRX_N-00145-53499913,2022-05-08T23:30:33,Zarautz,expenses,phone,-44.85,-5312.23
buyer_2,Carmen,40,ES70209504723955028443,TRX_N-00146-38319387,2022-05-08T20:35:53,Zarautz,Expense,leisure,-40.35,-5352.58
buyer_2,Carmen,40,ES70209504723955028443,TRX_N-00147-69701497,2022-05-12T23:11:31,Zarautz,Expense,cash,-100.0,-5452.58
buyer_2,Carmen,40,ES70209504723955028443,TRX_N-00148-72819544,2022-05-14T09:45:51,Llodio,Expense,cash,-100.0,-5552.58
buyer_2,Carmen,40,ES70209504723955028443,TRX_N-00149-88346940,2022-05-14T15:44:01,Zarautz,Expense,travel,-892.26,-6444.84
buyer_2,Carmen,40,ES70209504723955028443,TRX_N-00150-27576092,2022-05-17T19:43:05,Hondarribia,Expense,cash,-100.0,-6544.84
buyer_2,Carmen,40,ES70209504723955028443,TRX_N-00151-74897867,2022-05-18T18:26:37,Zarautz,Expense,cash,-100.0,-6644.84
buyer_2,Carmen,40,ES70209504723955028443,TRX_N-00152-23500764,2022-05-20T23:29:23,Zarautz,Expense,transport,-72.37,-6717.21
buyer_2,Carmen,40,ES70209504723955028443,TRX_N-00153-23952563,2022-05-22T12:33:41,Zarautz,Expense,leisure,-71.32,-6788.53
buyer_2,Carmen,40,ES70209504723955028443,TRX_N-00154-59374109,2022-05-22T21:59:32,Zarautz,Expense,cash,-100.0,-6888.53
buyer_2,Carmen,40,ES70209504723955028443,TRX_N-00155-71242392,2022-05-23T22:27:10,Zarautz,Expense,transport,-81.82,-6970.35
buyer_2,Carmen,40,ES70209504723955028443,TRX_N-00156-64203651,2022-05-24T10:50:44,Salvatierra/Agurain,Expense,gifts,-73.31,-7043.66
buyer_2,Carmen,40,ES70209504723955028443,TRX_N-00157-46005789,2022-05-25T22:41:57,Irun,Expense,food,-65.05,-7108.71
buyer_2,Carmen,40,ES70209504723955028443,TRX_N-00158-22069478,2022-05-25T14:01:16,Zarautz,Expense,gifts,-738.12,-7846.83
buyer_2,Carmen,40,ES70209504723955028443,TRX_N-00159-20681733,2022-05-26T08:36:37,Zarautz,Expense,transport,-78.85,-7925.68
buyer_2,Carmen,40,ES70209504723955028443,TRX_N-00160-47513687,2022-05-26T16:48:27,Zarautz,Expense,cash,-100.0,-8025.68
buyer_2,Carmen,40,ES70209504723955028443,TRX_N-00161-65774340,2022-05-27T16:48:33,Zarautz,Expense,clothing,-110.4,-8136.08
buyer_2,Carmen,40,ES70209504723955028443,TRX_N-00162-76835989,2022-05-27T16:16:51,Santurtzi,Expense,education,-74.85,-8210.93
buyer_2,Carmen,40,ES70209504723955028443,TRX_N-00163-33582607,2022-05-28T12:37:56,Zarautz,Expense,cash,-100.0,-8310.93
buyer_2,Carmen,40,ES70209504723955028443,TRX_N-00164-59621064,2022-05-30T18:11:33,Zarautz,Expense,gifts,-107.19,-8418.12
buyer_2,Carmen,40,ES70209504723955028443,TRX_N-00165-54086292,2022-05-31T15:46:07,Bilbao,Expense,clothing,-125.74,-8543.86
buyer_2,Carmen,40,ES70209504723955028443,TRX_N-00166-37462187,2022-06-01T14:23:49,Zarautz,incomes,salary,1229.41,-7314.45
buyer_2,Carmen,40,ES70209504723955028443,TRX_N-00167-35667663,2022-06-01T14:23:49,Zarautz,incomes,salary_partner,1490.12,-5824.33
buyer_2,Carmen,40,ES70209504723955028443,TRX_N-00168-30677106,2022-06-01T14:23:49,Zarautz,incomes,salary_bonus,873.82,-4950.51
buyer_2,Carmen,40,ES70209504723955028443,TRX_N-00169-39156177,2022-06-01T14:23:49,Zarautz,incomes,salary_partner_bonus,1079.56,-3870.95
buyer_2,Carmen,40,ES70209504723955028443,TRX_N-00170-18402588,2022-06-04T05:34:47,Zarautz,expenses,mortgage,-1033.24,-4904.19
buyer_2,Carmen,40,ES70209504723955028443,TRX_N-00171-78653137,2022-06-05T01:17:10,Zarautz,Expense,healthcare,-125.12,-5029.31
buyer_2,Carmen,40,ES70209504723955028443,TRX_N-00172-15374779,2022-06-06T17:08:07,Zarautz,Expense,food,-74.81,-5104.12
buyer_2,Carmen,40,ES70209504723955028443,TRX_N-00173-88826941,2022-06-06T18:07:31,Zarautz,Expense,gifts,-550.93,-5655.05
buyer_2,Carmen,40,ES70209504723955028443,TRX_N-00174-97131914,2022-06-07T09:44:29,Zarautz,Expense,transport,-48.37,-5703.42
buyer_2,Carmen,40,ES70209504723955028443,TRX_N-00175-44397519,2022-06-08T09:19:53,Zarautz,expenses,water,-37.61,-5741.03
buyer_2,Carmen,40,ES70209504723955028443,TRX_N-00176-81625600,2022-06-08T16:44:53,Zarautz,expenses,electricity,-24.76,-5765.79
buyer_2,Carmen,40,ES70209504723955028443,TRX_N-00177-57339634,2022-06-08T16:38:17,Zarautz,expenses,gas,-80.79,-5846.58
buyer_2,Carmen,40,ES70209504723955028443,TRX_N-00178-31196915,2022-06-08T09:17:57,Zarautz,expenses,internet,-42.0,-5888.58
buyer_2,Carmen,40,ES70209504723955028443,TRX_N-00179-03319519,2022-06-08T14:59:32,Zarautz,expenses,phone,-39.62,-5928.2
buyer_2,Carmen,40,ES70209504723955028443,TRX_N-00180-42281274,2022-06-09T08:30:12,Zarautz,Expense,transport,-43.05,-5971.25
buyer_2,Carmen,40,ES70209504723955028443,TRX_N-00181-64339268,2022-06-09T16:44:02,Zarautz,Expense,leisure,-35.49,-6006.74
buyer_2,Carmen,40,ES70209504723955028443,TRX_N-00182-91495283,2022-06-10T20:50:37,Zarautz,Expense,food,-66.44,-6073.18
buyer_2,Carmen,40,ES70209504723955028443,TRX_N-00183-01673333,2022-06-11T19:54:43,Zarautz,Expense,leisure,-64.65,-6137.83
buyer_2,Carmen,40,ES70209504723955028443,TRX_N-00184-03634407,2022-06-11T20:14:56,Zarautz,Expense,cash,-100.0,-6237.83
buyer_2,Carmen,40,ES70209504723955028443,TRX_N-00185-71040115,2022-06-12T14:54:31,Zarautz,Expense,healthcare,-66.25,-6304.08
buyer_2,Carmen,40,ES70209504723955028443,TRX_N-00186-59972413,2022-06-14T17:22:23,Zarautz,Expense,food,-65.6,-6369.68
buyer_2,Carmen,40,ES70209504723955028443,TRX_N-00187-87064962,2022-06-17T13:05:51,Zarautz,Expense,transport,-84.23,-6453.91
buyer_2,Carmen,40,ES70209504723955028443,TRX_N-00188-54323481,2022-06-17T16:26:40,Zarautz,Expense,cash,-100.0,-6553.91
buyer_2,Carmen,40,ES70209504723955028443,TRX_N-00189-52693558,2022-06-18T11:53:13,Zarautz,Expense,repairs,-144.02,-6697.93
buyer_2,Carmen,40,ES70209504723955028443,TRX_N-00190-57642107,2022-06-19T12:34:58,Zarautz,Expense,gifts,-426.97,-7124.9
buyer_2,Carmen,40,ES70209504723955028443,TRX_N-00191-30803949,2022-06-21T15:11:57,Zarautz,Expense,repairs,-35.98,-7160.88
buyer_2,Carmen,40,ES70209504723955028443,TRX_N-00192-10069826,2022-06-23T15:17:28,Zarautz,Expense,transport,-55.79,-7216.67
buyer_2,Carmen,40,ES70209504723955028443,TRX_N-00193-04879999,2022-06-23T15:01:18,Zarautz,Expense,education,-72.82,-7289.49
buyer_2,Carmen,40,ES70209504723955028443,TRX_N-00194-98822895,2022-06-25T05:09:44,Zarautz,Expense,transport,-77.12,-7366.61
buyer_2,Carmen,40,ES70209504723955028443,TRX_N-00195-10728989,2022-06-26T16:04:17,Zarautz,Expense,education,-68.98,-7435.59
buyer_2,Carmen,40,ES70209504723955028443,TRX_N-00196-51677538,2022-06-27T08:04:25,Zarautz,Expense,transport,-44.42,-7480.01
buyer_2,Carmen,40,ES70209504723955028443,TRX_N-00197-72436269,2022-06-29T15:43:57,Zarautz,Expense,leisure,-83.55,-7563.56
buyer_2,Carmen,40,ES70209504723955028443,TRX_N-00198-30905014,2022-06-29T16:11:59,Zarautz,Expense,gifts,-799.57,-8363.13
buyer_2,Carmen,40,ES70209504723955028443,TRX_N-00199-50594509,2022-06-30T21:48:52,Irun,Expense,food,-108.27,-8471.4
buyer_2,Carmen,40,ES70209504723955028443,TRX_N-00200-61918503,2022-07-01T16:05:46,Zarautz,incomes,salary,1229.41,-7241.99
buyer_2,Carmen,40,ES70209504723955028443,TRX_N-00201-84834299,2022-07-01T16:05:46,Zarautz,incomes,salary_partner,1490.12,-5751.87
buyer_2,Carmen,40,ES70209504723955028443,TRX_N-00202-97969643,2022-07-01T13:20:59,Zarautz,Expense,food,-115.97,-5867.84
buyer_2,Carmen,40,ES70209504723955028443,TRX_N-00203-13722123,2022-07-04T19:23:05,Zarautz,expenses,mortgage,-1033.24,-6901.08
buyer_2,Carmen,40,ES70209504723955028443,TRX_N-00204-15190522,2022-07-04T18:36:50,Zarautz,Expense,food,-105.21,-7006.29
buyer_2,Carmen,40,ES70209504723955028443,TRX_N-00205-76129506,2022-07-04T09:31:10,Zarautz,Expense,cash,-100.0,-7106.29
buyer_2,Carmen,40,ES70209504723955028443,TRX_N-00206-72006082,2022-07-05T02:56:33,Zarautz,expenses,water,-27.37,-7133.66
buyer_2,Carmen,40,ES70209504723955028443,TRX_N-00207-35187451,2022-07-05T18:53:52,Zarautz,Expense,leisure,-54.18,-7187.84
buyer_2,Carmen,40,ES70209504723955028443,TRX_N-00208-08437068,2022-07-05T03:50:48,Llodio,Expense,cash,-100.0,-7287.84
buyer_2,Carmen,40,ES70209504723955028443,TRX_N-00209-86098279,2022-07-05T10:24:28,Berango,Expense,appliances,-197.43,-7485.27
buyer_2,Carmen,40,ES70209504723955028443,TRX_N-00210-02563852,2022-07-06T19:59:07,Zarautz,expenses,electricity,-71.2,-7556.47
buyer_2,Carmen,40,ES70209504723955028443,TRX_N-00211-43240002,2022-07-06T10:43:12,Zarautz,Expense,food,-99.13,-7655.6
buyer_2,Carmen,40,ES70209504723955028443,TRX_N-00212-55203391,2022-07-06T00:33:10,Zarautz,Expense,education,-54.68,-7710.28
buyer_2,Carmen,40,ES70209504723955028443,TRX_N-00213-43823612,2022-07-07T09:58:11,Zarautz,Expense,clothing,-55.73,-7766.01
buyer_2,Carmen,40,ES70209504723955028443,TRX_N-00214-00411905,2022-07-08T09:19:38,Zarautz,expenses,internet,-42.0,-7808.01
buyer_2,Carmen,40,ES70209504723955028443,TRX_N-00215-00894185,2022-07-08T09:41:38,Zarautz,expenses,phone,-30.77,-7838.78
buyer_2,Carmen,40,ES70209504723955028443,TRX_N-00216-43752202,2022-07-08T17:58:03,Zarautz,expenses,gas,-71.15,-7909.93
buyer_2,Carmen,40,ES70209504723955028443,TRX_N-00217-64643435,2022-07-08T12:45:50,Zarautz,Expense,leisure,-35.23,-7945.16
buyer_2,Carmen,40,ES70209504723955028443,TRX_N-00218-37795149,2022-07-10T15:06:05,Zarautz,Expense,transport,-56.67,-8001.83
buyer_2,Carmen,40,ES70209504723955028443,TRX_N-00219-93436137,2022-07-11T20:22:51,Iru√±a de Oca,Expense,education,-67.46,-8069.29
buyer_2,Carmen,40,ES70209504723955028443,TRX_N-00220-66442869,2022-07-12T10:42:27,Zarautz,Expense,education,-43.57,-8112.86
buyer_2,Carmen,40,ES70209504723955028443,TRX_N-00221-85983606,2022-07-14T12:11:00,Zarautz,Expense,cash,-100.0,-8212.86
buyer_2,Carmen,40,ES70209504723955028443,TRX_N-00222-31546614,2022-07-15T17:51:44,Zarautz,Expense,education,-76.91,-8289.77
buyer_2,Carmen,40,ES70209504723955028443,TRX_N-00223-44573439,2022-07-15T11:54:46,Zarautz,Expense,cash,-100.0,-8389.77
buyer_2,Carmen,40,ES70209504723955028443,TRX_N-00224-28806477,2022-07-18T21:48:39,Zarautz,Expense,cash,-100.0,-8489.77
buyer_2,Carmen,40,ES70209504723955028443,TRX_N-00225-59224249,2022-07-23T18:35:00,Zarautz,Expense,leisure,-28.06,-8517.83
buyer_2,Carmen,40,ES70209504723955028443,TRX_N-00226-71089554,2022-07-24T09:42:30,Zarautz,Expense,leisure,-58.5,-8576.33
buyer_2,Carmen,40,ES70209504723955028443,TRX_N-00227-53639891,2022-07-24T09:58:47,Zarautz,Expense,cash,-100.0,-8676.33
buyer_2,Carmen,40,ES70209504723955028443,TRX_N-00228-05264681,2022-07-26T17:59:19,Berango,Expense,transport,-81.95,-8758.28
buyer_2,Carmen,40,ES70209504723955028443,TRX_N-00229-80257674,2022-07-26T09:40:07,Zarautz,Expense,education,-67.57,-8825.85
buyer_2,Carmen,40,ES70209504723955028443,TRX_N-00230-41653051,2022-07-26T20:48:02,Zarautz,Expense,cash,-100.0,-8925.85
buyer_2,Carmen,40,ES70209504723955028443,TRX_N-00231-00801046,2022-07-27T17:55:49,Zarautz,Expense,repairs,-53.1,-8978.95
buyer_2,Carmen,40,ES70209504723955028443,TRX_N-00232-43531665,2022-07-30T12:58:26,Portugalete,Expense,cash,-100.0,-9078.95
buyer_2,Carmen,40,ES70209504723955028443,TRX_N-00233-95829261,2022-07-30T15:57:38,Zarautz,Expense,gifts,-148.04,-9226.99
buyer_2,Carmen,40,ES70209504723955028443,TRX_N-00234-07601685,2022-07-31T17:51:21,Galdakao,Expense,leisure,-50.64,-9277.63
buyer_2,Carmen,40,ES70209504723955028443,TRX_N-00235-78461785,2022-07-31T18:07:22,Zarautz,Expense,clothing,-133.89,-9411.52
buyer_2,Carmen,40,ES70209504723955028443,TRX_N-00236-48798126,2022-08-01T15:08:44,Zarautz,incomes,salary,1229.41,-8182.11
buyer_2,Carmen,40,ES70209504723955028443,TRX_N-00237-59398930,2022-08-01T15:08:44,Zarautz,incomes,salary_partner,1490.12,-6691.99
buyer_2,Carmen,40,ES70209504723955028443,TRX_N-00238-38095288,2022-08-01T15:08:44,Zarautz,incomes,extra_income,122.27,-6569.72
buyer_2,Carmen,40,ES70209504723955028443,TRX_N-00239-85122468,2022-08-04T18:56:30,Zarautz,expenses,mortgage,-1033.24,-7602.96
buyer_2,Carmen,40,ES70209504723955028443,TRX_N-00240-78321742,2022-08-04T14:32:24,Zarautz,Expense,cash,-100.0,-7702.96
buyer_2,Carmen,40,ES70209504723955028443,TRX_N-00241-72164858,2022-08-06T23:59:43,Zarautz,expenses,electricity,-77.42,-7780.38
buyer_2,Carmen,40,ES70209504723955028443,TRX_N-00242-72995643,2022-08-06T20:16:20,Zarautz,expenses,internet,-42.0,-7822.38
buyer_2,Carmen,40,ES70209504723955028443,TRX_N-00243-09720034,2022-08-08T22:55:31,Zarautz,expenses,water,-21.43,-7843.81
buyer_2,Carmen,40,ES70209504723955028443,TRX_N-00244-82486590,2022-08-08T19:24:57,Zarautz,expenses,gas,-100.57,-7944.38
buyer_2,Carmen,40,ES70209504723955028443,TRX_N-00245-60453603,2022-08-08T08:44:42,Zarautz,expenses,phone,-40.62,-7985.0
buyer_2,Carmen,40,ES70209504723955028443,TRX_N-00246-24050623,2022-08-09T09:54:18,Zarautz,Expense,cash,-100.0,-8085.0
buyer_2,Carmen,40,ES70209504723955028443,TRX_N-00247-27228139,2022-08-09T18:13:40,Zarautz,Expense,gifts,-571.24,-8656.24
buyer_2,Carmen,40,ES70209504723955028443,TRX_N-00248-16566608,2022-08-11T10:45:21,Zarautz,Expense,leisure,-71.73,-8727.97
buyer_2,Carmen,40,ES70209504723955028443,TRX_N-00249-05699756,2022-08-13T19:16:48,Zarautz,Expense,clothing,-107.95,-8835.92
buyer_2,Carmen,40,ES70209504723955028443,TRX_N-00250-61602513,2022-08-14T12:28:15,Zarautz,Expense,food,-88.97,-8924.89
buyer_2,Carmen,40,ES70209504723955028443,TRX_N-00251-36994835,2022-08-14T14:51:49,Zarautz,Expense,transport,-81.32,-9006.21
buyer_2,Carmen,40,ES70209504723955028443,TRX_N-00252-40290020,2022-08-14T18:54:00,Zarautz,Expense,cash,-100.0,-9106.21
buyer_2,Carmen,40,ES70209504723955028443,TRX_N-00253-15006629,2022-08-15T09:32:58,Zarautz,Expense,cash,-100.0,-9206.21
buyer_2,Carmen,40,ES70209504723955028443,TRX_N-00254-57152448,2022-08-15T18:54:44,Zarautz,expenses,children,-217.08,-9423.29
buyer_2,Carmen,40,ES70209504723955028443,TRX_N-00255-51442110,2022-08-16T19:10:59,Zarautz,Expense,cash,-100.0,-9523.29
buyer_2,Carmen,40,ES70209504723955028443,TRX_N-00256-23799243,2022-08-17T17:04:30,Zarautz,Expense,food,-61.04,-9584.33
buyer_2,Carmen,40,ES70209504723955028443,TRX_N-00257-35718747,2022-08-17T18:03:58,Arrasate,Expense,transport,-61.34,-9645.67
buyer_2,Carmen,40,ES70209504723955028443,TRX_N-00258-48384669,2022-08-17T14:28:12,Zarautz,Expense,leisure,-74.76,-9720.43
buyer_2,Carmen,40,ES70209504723955028443,TRX_N-00259-61336125,2022-08-17T16:49:51,Zarautz,Expense,gifts,-241.01,-9961.44
buyer_2,Carmen,40,ES70209504723955028443,TRX_N-00260-83317294,2022-08-18T14:53:26,Zarautz,Expense,transport,-80.45,-10041.89
buyer_2,Carmen,40,ES70209504723955028443,TRX_N-00261-99518896,2022-08-18T16:14:36,Zarautz,Expense,healthcare,-58.77,-10100.66
buyer_2,Carmen,40,ES70209504723955028443,TRX_N-00262-15666102,2022-08-21T14:50:33,Barakaldo,Expense,leisure,-21.92,-10122.58
buyer_2,Carmen,40,ES70209504723955028443,TRX_N-00263-76404764,2022-08-21T14:44:51,Zarautz,Expense,gifts,-387.63,-10510.21
buyer_2,Carmen,40,ES70209504723955028443,TRX_N-00264-85576062,2022-08-22T12:20:57,Zarautz,Expense,food,-112.27,-10622.48
buyer_2,Carmen,40,ES70209504723955028443,TRX_N-00265-04918462,2022-08-22T13:45:23,Zarautz,Expense,cash,-100.0,-10722.48
buyer_2,Carmen,40,ES70209504723955028443,TRX_N-00266-94527761,2022-08-28T22:24:44,Zarautz,Expense,food,-84.03,-10806.51
buyer_2,Carmen,40,ES70209504723955028443,TRX_N-00267-09294975,2022-08-28T12:18:40,Donostia,Expense,cash,-100.0,-10906.51
buyer_2,Carmen,40,ES70209504723955028443,TRX_N-00268-34112822,2022-08-29T17:45:40,Arrasate,Expense,transport,-77.35,-10983.86
buyer_2,Carmen,40,ES70209504723955028443,TRX_N-00269-09166699,2022-08-30T12:32:18,Zarautz,Expense,cash,-100.0,-11083.86
buyer_2,Carmen,40,ES70209504723955028443,TRX_N-00270-94022497,2022-08-31T10:45:51,Zarautz,Expense,food,-94.62,-11178.48
buyer_2,Carmen,40,ES70209504723955028443,TRX_N-00271-50022081,2022-09-01T14:20:18,Zarautz,incomes,salary,1229.41,-9949.07
buyer_2,Carmen,40,ES70209504723955028443,TRX_N-00272-08792598,2022-09-01T14:20:18,Zarautz,incomes,salary_partner,1490.12,-8458.95
buyer_2,Carmen,40,ES70209504723955028443,TRX_N-00273-16433937,2022-09-03T16:17:54,Amurrio,Expense,transport,-40.46,-8499.41
buyer_2,Carmen,40,ES70209504723955028443,TRX_N-00274-39025573,2022-09-04T09:51:02,Zarautz,expenses,mortgage,-1033.24,-9532.65
buyer_2,Carmen,40,ES70209504723955028443,TRX_N-00275-34332899,2022-09-05T14:16:58,Zarautz,expenses,electricity,-28.68,-9561.33
buyer_2,Carmen,40,ES70209504723955028443,TRX_N-00276-98368618,2022-09-05T16:11:01,Zarautz,expenses,phone,-42.05,-9603.38
buyer_2,Carmen,40,ES70209504723955028443,TRX_N-00277-04831371,2022-09-06T09:25:53,Hondarribia,Expense,cash,-100.0,-9703.38
buyer_2,Carmen,40,ES70209504723955028443,TRX_N-00278-38668361,2022-09-08T19:06:02,Zarautz,expenses,water,-35.65,-9739.03
buyer_2,Carmen,40,ES70209504723955028443,TRX_N-00279-98362523,2022-09-08T17:18:42,Zarautz,expenses,gas,-68.01,-9807.04
buyer_2,Carmen,40,ES70209504723955028443,TRX_N-00280-37575250,2022-09-08T07:22:34,Zarautz,expenses,internet,-42.0,-9849.04
buyer_2,Carmen,40,ES70209504723955028443,TRX_N-00281-23138693,2022-09-13T19:03:42,Zarautz,Expense,cash,-100.0,-9949.04
buyer_2,Carmen,40,ES70209504723955028443,TRX_N-00282-17507372,2022-09-14T12:23:39,Zarautz,Expense,food,-93.13,-10042.17
buyer_2,Carmen,40,ES70209504723955028443,TRX_N-00283-84139235,2022-09-14T10:48:52,Alegr√≠a-Dulantzi,Expense,clothing,-140.57,-10182.74
buyer_2,Carmen,40,ES70209504723955028443,TRX_N-00284-50697582,2022-09-15T02:07:25,Vitoria-Gasteiz,Expense,food,-93.31,-10276.05
buyer_2,Carmen,40,ES70209504723955028443,TRX_N-00285-01473521,2022-09-16T15:13:52,Zarautz,Expense,food,-94.4,-10370.45
buyer_2,Carmen,40,ES70209504723955028443,TRX_N-00286-12144389,2022-09-17T15:05:43,Zarautz,Expense,transport,-81.2,-10451.65
buyer_2,Carmen,40,ES70209504723955028443,TRX_N-00287-64499631,2022-09-17T14:50:54,Zarautz,Expense,gifts,-77.87,-10529.52
buyer_2,Carmen,40,ES70209504723955028443,TRX_N-00288-48340910,2022-09-18T18:45:42,Zarautz,Expense,food,-123.99,-10653.51
buyer_2,Carmen,40,ES70209504723955028443,TRX_N-00289-02812421,2022-09-19T18:01:57,Zarautz,Expense,food,-82.76,-10736.27
buyer_2,Carmen,40,ES70209504723955028443,TRX_N-00290-45412122,2022-09-19T08:56:17,Zarautz,Expense,transport,-75.93,-10812.2
buyer_2,Carmen,40,ES70209504723955028443,TRX_N-00291-40285473,2022-09-19T04:11:25,Donostia,Expense,healthcare,-39.1,-10851.3
buyer_2,Carmen,40,ES70209504723955028443,TRX_N-00292-60832083,2022-09-19T12:22:08,Santurtzi,Expense,repairs,-263.0,-11114.3
buyer_2,Carmen,40,ES70209504723955028443,TRX_N-00293-48854858,2022-09-20T12:02:06,Zarautz,Expense,cash,-100.0,-11214.3
buyer_2,Carmen,40,ES70209504723955028443,TRX_N-00294-92135922,2022-09-22T12:57:22,Zarautz,Expense,gifts,-407.58,-11621.88
buyer_2,Carmen,40,ES70209504723955028443,TRX_N-00295-93134741,2022-09-24T08:37:07,Zarautz,Expense,cash,-100.0,-11721.88
buyer_2,Carmen,40,ES70209504723955028443,TRX_N-00296-77614175,2022-09-25T16:43:05,Berango,Expense,food,-75.5,-11797.38
buyer_2,Carmen,40,ES70209504723955028443,TRX_N-00297-69637698,2022-09-25T19:27:57,Zarautz,Expense,education,-53.27,-11850.65
buyer_2,Carmen,40,ES70209504723955028443,TRX_N-00298-04726431,2022-09-25T11:08:35,Zarautz,Expense,cash,-100.0,-11950.65
buyer_2,Carmen,40,ES70209504723955028443,TRX_N-00299-36555789,2022-09-26T18:06:07,Zarautz,Expense,appliances,-212.0,-12162.65
buyer_2,Carmen,40,ES70209504723955028443,TRX_N-00300-12758478,2022-09-26T12:33:21,Zarautz,Expense,repairs,-130.39,-12293.04
buyer_2,Carmen,40,ES70209504723955028443,TRX_N-00301-63948111,2022-09-27T18:54:43,Zarautz,Expense,clothing,-139.74,-12432.78
buyer_2,Carmen,40,ES70209504723955028443,TRX_N-00302-63931077,2022-09-27T13:42:11,Zarautz,Expense,cash,-100.0,-12532.78
buyer_2,Carmen,40,ES70209504723955028443,TRX_N-00303-11975312,2022-09-30T09:13:25,Zarautz,Expense,appliances,-95.42,-12628.2
buyer_2,Carmen,40,ES70209504723955028443,TRX_N-00304-43682264,2022-10-01T22:34:33,Zarautz,incomes,salary,1229.41,-11398.79
buyer_2,Carmen,40,ES70209504723955028443,TRX_N-00305-47822457,2022-10-01T22:34:33,Zarautz,incomes,salary_partner,1490.12,-9908.67
buyer_2,Carmen,40,ES70209504723955028443,TRX_N-00306-47014385,2022-10-01T17:04:46,Basauri,Expense,food,-77.63,-9986.3
buyer_2,Carmen,40,ES70209504723955028443,TRX_N-00307-12714840,2022-10-01T14:00:20,Zuia,Expense,healthcare,-133.53,-10119.83
buyer_2,Carmen,40,ES70209504723955028443,TRX_N-00308-22470064,2022-10-01T13:54:53,Zarautz,Expense,repairs,-205.54,-10325.37
buyer_2,Carmen,40,ES70209504723955028443,TRX_N-00309-47223709,2022-10-02T13:48:12,Irun,Expense,education,-62.0,-10387.37
buyer_2,Carmen,40,ES70209504723955028443,TRX_N-00310-05173717,2022-10-03T17:57:15,Zarautz,Expense,transport,-76.63,-10464.0
buyer_2,Carmen,40,ES70209504723955028443,TRX_N-00311-87315379,2022-10-03T19:30:43,Zarautz,Expense,education,-49.62,-10513.62
buyer_2,Carmen,40,ES70209504723955028443,TRX_N-00312-36998353,2022-10-04T13:21:46,Zarautz,expenses,mortgage,-1033.24,-11546.86
buyer_2,Carmen,40,ES70209504723955028443,TRX_N-00313-49366345,2022-10-04T19:30:20,Oy√≥n-Oion,Expense,leisure,-30.54,-11577.4
buyer_2,Carmen,40,ES70209504723955028443,TRX_N-00314-99246346,2022-10-05T09:08:15,Zarautz,Expense,repairs,-84.82,-11662.22
buyer_2,Carmen,40,ES70209504723955028443,TRX_N-00315-94852449,2022-10-06T20:07:36,Zarautz,expenses,water,-31.23,-11693.45
buyer_2,Carmen,40,ES70209504723955028443,TRX_N-00316-18670991,2022-10-07T19:13:51,Zarautz,Expense,transport,-50.1,-11743.55
buyer_2,Carmen,40,ES70209504723955028443,TRX_N-00317-97679678,2022-10-07T18:08:42,Sestao,Expense,leisure,-48.61,-11792.16
buyer_2,Carmen,40,ES70209504723955028443,TRX_N-00318-71417586,2022-10-08T10:45:39,Zarautz,expenses,phone,-34.17,-11826.33
buyer_2,Carmen,40,ES70209504723955028443,TRX_N-00319-76010377,2022-10-08T13:27:57,Zarautz,expenses,electricity,-33.99,-11860.32
buyer_2,Carmen,40,ES70209504723955028443,TRX_N-00320-21984276,2022-10-08T01:51:39,Zarautz,expenses,gas,-66.16,-11926.48
buyer_2,Carmen,40,ES70209504723955028443,TRX_N-00321-05397777,2022-10-08T11:35:19,Zarautz,expenses,internet,-42.0,-11968.48
buyer_2,Carmen,40,ES70209504723955028443,TRX_N-00322-65309632,2022-10-08T02:21:00,Basauri,Expense,gifts,-186.87,-12155.35
buyer_2,Carmen,40,ES70209504723955028443,TRX_N-00323-52347060,2022-10-09T10:00:08,Zarautz,Expense,cash,-100.0,-12255.35
buyer_2,Carmen,40,ES70209504723955028443,TRX_N-00324-93647101,2022-10-11T17:24:49,Zarautz,Expense,food,-83.96,-12339.31
buyer_2,Carmen,40,ES70209504723955028443,TRX_N-00325-23522781,2022-10-11T10:46:59,Zarautz,Expense,leisure,-54.02,-12393.33
buyer_2,Carmen,40,ES70209504723955028443,TRX_N-00326-19292341,2022-10-11T17:34:29,Zarautz,Expense,travel,-1821.07,-14214.4
buyer_2,Carmen,40,ES70209504723955028443,TRX_N-00327-71675196,2022-10-12T09:53:54,Zarautz,Expense,leisure,-71.88,-14286.28
buyer_2,Carmen,40,ES70209504723955028443,TRX_N-00328-36634290,2022-10-13T20:57:18,Zarautz,Expense,food,-108.61,-14394.89
buyer_2,Carmen,40,ES70209504723955028443,TRX_N-00329-69610843,2022-10-14T23:19:33,Zarautz,Expense,food,-77.71,-14472.6
buyer_2,Carmen,40,ES70209504723955028443,TRX_N-00330-11899897,2022-10-14T20:12:12,Bermeo,Expense,cash,-100.0,-14572.6
buyer_2,Carmen,40,ES70209504723955028443,TRX_N-00331-83090123,2022-10-17T14:38:09,Zarautz,Expense,clothing,-135.89,-14708.49
buyer_2,Carmen,40,ES70209504723955028443,TRX_N-00332-11436199,2022-10-18T22:40:58,Amurrio,Expense,cash,-100.0,-14808.49
buyer_2,Carmen,40,ES70209504723955028443,TRX_N-00333-26691932,2022-10-18T22:30:10,Zarautz,Expense,repairs,-289.41,-15097.9
buyer_2,Carmen,40,ES70209504723955028443,TRX_N-00334-13867168,2022-10-22T11:16:31,Basauri,Expense,food,-96.51,-15194.41
buyer_2,Carmen,40,ES70209504723955028443,TRX_N-00335-06998632,2022-10-22T10:46:28,Zarautz,Expense,transport,-70.29,-15264.7
buyer_2,Carmen,40,ES70209504723955028443,TRX_N-00336-81510417,2022-10-23T13:53:05,Zarautz,Expense,cash,-100.0,-15364.7
buyer_2,Carmen,40,ES70209504723955028443,TRX_N-00337-78670698,2022-10-25T15:05:50,Zarautz,expenses,children,-261.76,-15626.46
buyer_2,Carmen,40,ES70209504723955028443,TRX_N-00338-94869352,2022-10-26T14:34:59,Lasarte-Oria,Expense,leisure,-33.63,-15660.09
buyer_2,Carmen,40,ES70209504723955028443,TRX_N-00339-28744518,2022-10-26T09:43:35,Zarautz,Expense,cash,-100.0,-15760.09
buyer_2,Carmen,40,ES70209504723955028443,TRX_N-00340-74844393,2022-10-27T08:10:21,Zarautz,Expense,transport,-42.64,-15802.73
buyer_2,Carmen,40,ES70209504723955028443,TRX_N-00341-47938576,2022-10-27T08:37:48,Leioa,Expense,repairs,-40.07,-15842.8
buyer_2,Carmen,40,ES70209504723955028443,TRX_N-00342-15257147,2022-10-29T20:13:08,Zarautz,Expense,food,-121.14,-15963.94
buyer_2,Carmen,40,ES70209504723955028443,TRX_N-00343-45663746,2022-10-29T12:59:48,Vitoria-Gasteiz,Expense,repairs,-327.35,-16291.29
buyer_2,Carmen,40,ES70209504723955028443,TRX_N-00344-73832571,2022-10-29T14:43:27,Zarautz,Expense,gifts,-682.36,-16973.65
buyer_2,Carmen,40,ES70209504723955028443,TRX_N-00345-18170205,2022-10-31T17:46:25,Zarautz,Expense,transport,-73.34,-17046.99
buyer_2,Carmen,40,ES70209504723955028443,TRX_N-00346-77645264,2022-11-01T11:14:29,Zarautz,incomes,salary,1229.41,-15817.58
buyer_2,Carmen,40,ES70209504723955028443,TRX_N-00347-81384015,2022-11-01T11:14:29,Zarautz,incomes,salary_partner,1490.12,-14327.46
buyer_2,Carmen,40,ES70209504723955028443,TRX_N-00348-04083824,2022-11-01T17:14:15,Zarautz,Expense,repairs,-270.97,-14598.43
buyer_2,Carmen,40,ES70209504723955028443,TRX_N-00349-72191781,2022-11-02T15:24:47,Bilbao,Expense,leisure,-51.13,-14649.56
buyer_2,Carmen,40,ES70209504723955028443,TRX_N-00350-73808382,2022-11-02T14:22:21,Zarautz,Expense,healthcare,-169.4,-14818.96
buyer_2,Carmen,40,ES70209504723955028443,TRX_N-00351-01411411,2022-11-02T20:56:08,Sopela,Expense,cash,-100.0,-14918.96
buyer_2,Carmen,40,ES70209504723955028443,TRX_N-00352-72276633,2022-11-03T16:05:31,Zarautz,Expense,transport,-46.42,-14965.38
buyer_2,Carmen,40,ES70209504723955028443,TRX_N-00353-18403043,2022-11-04T22:08:40,Zarautz,expenses,mortgage,-1033.24,-15998.62
buyer_2,Carmen,40,ES70209504723955028443,TRX_N-00354-27057683,2022-11-04T21:54:00,Zarautz,Expense,clothing,-69.64,-16068.26
buyer_2,Carmen,40,ES70209504723955028443,TRX_N-00355-30714935,2022-11-05T03:43:48,Zarautz,expenses,water,-30.01,-16098.27
buyer_2,Carmen,40,ES70209504723955028443,TRX_N-00356-02731897,2022-11-05T02:14:18,Zarautz,Expense,cash,-100.0,-16198.27
buyer_2,Carmen,40,ES70209504723955028443,TRX_N-00357-76104675,2022-11-06T10:25:04,Zarautz,expenses,phone,-31.84,-16230.11
buyer_2,Carmen,40,ES70209504723955028443,TRX_N-00358-13720595,2022-11-06T04:22:03,Durango,Expense,food,-85.91,-16316.02
buyer_2,Carmen,40,ES70209504723955028443,TRX_N-00359-52016551,2022-11-07T10:54:02,Zarautz,Expense,food,-85.13,-16401.15
buyer_2,Carmen,40,ES70209504723955028443,TRX_N-00360-65353089,2022-11-08T09:02:09,Zarautz,expenses,internet,-42.0,-16443.15
buyer_2,Carmen,40,ES70209504723955028443,TRX_N-00361-99228473,2022-11-08T20:22:17,Zarautz,expenses,electricity,-76.22,-16519.37
buyer_2,Carmen,40,ES70209504723955028443,TRX_N-00362-36295732,2022-11-08T16:12:21,Zarautz,expenses,gas,-99.83,-16619.2
buyer_2,Carmen,40,ES70209504723955028443,TRX_N-00363-96848722,2022-11-08T16:52:40,Zarautz,Expense,leisure,-42.33,-16661.53
buyer_2,Carmen,40,ES70209504723955028443,TRX_N-00364-83102205,2022-11-08T13:59:32,Zarautz,Expense,cash,-100.0,-16761.53
buyer_2,Carmen,40,ES70209504723955028443,TRX_N-00365-66282090,2022-11-09T13:39:05,Zarautz,Expense,cash,-100.0,-16861.53
buyer_2,Carmen,40,ES70209504723955028443,TRX_N-00366-87523159,2022-11-10T15:00:02,Berango,Expense,clothing,-55.12,-16916.65
buyer_2,Carmen,40,ES70209504723955028443,TRX_N-00367-61762391,2022-11-10T15:29:50,Zarautz,Expense,cash,-100.0,-17016.65
buyer_2,Carmen,40,ES70209504723955028443,TRX_N-00368-24475390,2022-11-10T19:02:39,Zarautz,Expense,appliances,-234.78,-17251.43
buyer_2,Carmen,40,ES70209504723955028443,TRX_N-00369-20422871,2022-11-12T16:14:14,Zarautz,Expense,leisure,-23.99,-17275.42
buyer_2,Carmen,40,ES70209504723955028443,TRX_N-00370-82470534,2022-11-12T16:05:47,Zarautz,Expense,healthcare,-38.1,-17313.52
buyer_2,Carmen,40,ES70209504723955028443,TRX_N-00371-27818772,2022-11-12T17:18:49,Zarautz,expenses,children,-166.71,-17480.23
buyer_2,Carmen,40,ES70209504723955028443,TRX_N-00372-89134154,2022-11-13T17:25:13,Zarautz,Expense,food,-96.23,-17576.46
buyer_2,Carmen,40,ES70209504723955028443,TRX_N-00373-56684925,2022-11-13T18:31:19,Zarautz,Expense,leisure,-26.67,-17603.13
buyer_2,Carmen,40,ES70209504723955028443,TRX_N-00374-02150162,2022-11-13T13:47:59,Zarautz,Expense,education,-70.62,-17673.75
buyer_2,Carmen,40,ES70209504723955028443,TRX_N-00375-50043134,2022-11-15T19:02:41,Zarautz,Expense,transport,-73.2,-17746.95
buyer_2,Carmen,40,ES70209504723955028443,TRX_N-00376-10516951,2022-11-17T16:28:46,Zarautz,Expense,clothing,-129.93,-17876.88
buyer_2,Carmen,40,ES70209504723955028443,TRX_N-00377-76378511,2022-11-18T15:41:35,Zarautz,Expense,leisure,-38.11,-17914.99
buyer_2,Carmen,40,ES70209504723955028443,TRX_N-00378-90078140,2022-11-20T08:48:38,Zarautz,Expense,food,-85.15,-18000.14
buyer_2,Carmen,40,ES70209504723955028443,TRX_N-00379-39645935,2022-11-21T07:32:09,Zarautz,Expense,food,-70.05,-18070.19
buyer_2,Carmen,40,ES70209504723955028443,TRX_N-00380-02622991,2022-11-22T14:56:29,Zarautz,Expense,cash,-100.0,-18170.19
buyer_2,Carmen,40,ES70209504723955028443,TRX_N-00381-92060041,2022-11-26T20:40:11,Zarautz,Expense,food,-95.7,-18265.89
buyer_2,Carmen,40,ES70209504723955028443,TRX_N-00382-94095790,2022-11-27T09:59:47,Zarautz,Expense,cash,-100.0,-18365.89
buyer_2,Carmen,40,ES70209504723955028443,TRX_N-00383-33623441,2022-11-28T12:40:46,Zarautz,Expense,food,-94.06,-18459.95
buyer_2,Carmen,40,ES70209504723955028443,TRX_N-00384-16257387,2022-11-29T09:44:25,Zarautz,Expense,repairs,-194.13,-18654.08
buyer_2,Carmen,40,ES70209504723955028443,TRX_N-00385-96029277,2022-11-30T18:15:53,Zarautz,Expense,cash,-100.0,-18754.08
buyer_2,Carmen,40,ES70209504723955028443,TRX_N-00386-99283764,2022-11-30T18:57:03,Santurtzi,Expense,repairs,-192.25,-18946.33
buyer_2,Carmen,40,ES70209504723955028443,TRX_N-00387-98419495,2022-12-01T13:56:53,Zarautz,incomes,salary,1229.41,-17716.92
buyer_2,Carmen,40,ES70209504723955028443,TRX_N-00388-13202293,2022-12-01T13:56:53,Zarautz,incomes,salary_partner,1490.12,-16226.8
buyer_2,Carmen,40,ES70209504723955028443,TRX_N-00389-32808451,2022-12-01T13:56:53,Zarautz,incomes,extra_income,122.27,-16104.53
buyer_2,Carmen,40,ES70209504723955028443,TRX_N-00390-41571935,2022-12-01T13:56:53,Zarautz,incomes,salary_bonus,866.84,-15237.69
buyer_2,Carmen,40,ES70209504723955028443,TRX_N-00391-78473534,2022-12-01T13:56:53,Zarautz,incomes,salary_partner_bonus,1109.1,-14128.59
buyer_2,Carmen,40,ES70209504723955028443,TRX_N-00392-93553206,2022-12-01T09:46:23,Zarautz,Expense,clothing,-53.66,-14182.25
buyer_2,Carmen,40,ES70209504723955028443,TRX_N-00393-54457664,2022-12-02T21:40:10,Zarautz,expenses,children,-53.4,-14235.65
buyer_2,Carmen,40,ES70209504723955028443,TRX_N-00394-40108166,2022-12-03T08:16:50,Zarautz,Expense,repairs,-210.91,-14446.56
buyer_2,Carmen,40,ES70209504723955028443,TRX_N-00395-70060402,2022-12-04T10:51:36,Zarautz,expenses,mortgage,-1033.24,-15479.8
buyer_2,Carmen,40,ES70209504723955028443,TRX_N-00396-75421525,2022-12-05T09:25:43,Zarautz,expenses,water,-32.99,-15512.79
buyer_2,Carmen,40,ES70209504723955028443,TRX_N-00397-65543017,2022-12-05T14:27:10,Zarautz,expenses,electricity,-20.67,-15533.46
buyer_2,Carmen,40,ES70209504723955028443,TRX_N-00398-75650329,2022-12-05T19:13:33,Zarautz,Expense,food,-64.31,-15597.77
buyer_2,Carmen,40,ES70209504723955028443,TRX_N-00399-85592818,2022-12-05T22:40:11,Zarautz,Expense,cash,-100.0,-15697.77
buyer_2,Carmen,40,ES70209504723955028443,TRX_N-00400-06852702,2022-12-06T10:25:08,Zarautz,expenses,internet,-42.0,-15739.77
buyer_2,Carmen,40,ES70209504723955028443,TRX_N-00401-09349648,2022-12-06T18:16:58,Zarautz,Expense,repairs,-227.2,-15966.97
buyer_2,Carmen,40,ES70209504723955028443,TRX_N-00402-00816780,2022-12-07T15:55:40,Errenteria,Expense,cash,-100.0,-16066.97
buyer_2,Carmen,40,ES70209504723955028443,TRX_N-00403-53161012,2022-12-08T22:36:43,Zarautz,expenses,gas,-37.47,-16104.44
buyer_2,Carmen,40,ES70209504723955028443,TRX_N-00404-26096639,2022-12-08T12:01:05,Zarautz,expenses,phone,-30.19,-16134.63
buyer_2,Carmen,40,ES70209504723955028443,TRX_N-00405-62158499,2022-12-08T17:37:25,Zarautz,Expense,gifts,-342.67,-16477.3
buyer_2,Carmen,40,ES70209504723955028443,TRX_N-00406-99694839,2022-12-10T12:06:50,Zarautz,Expense,leisure,-84.3,-16561.6
buyer_2,Carmen,40,ES70209504723955028443,TRX_N-00407-04341264,2022-12-11T08:45:09,Zarautz,Expense,leisure,-25.34,-16586.94
buyer_2,Carmen,40,ES70209504723955028443,TRX_N-00408-73011625,2022-12-14T15:36:29,Zarautz,Expense,repairs,-39.1,-16626.04
buyer_2,Carmen,40,ES70209504723955028443,TRX_N-00409-84227462,2022-12-15T20:11:48,Zarautz,Expense,food,-88.19,-16714.23
buyer_2,Carmen,40,ES70209504723955028443,TRX_N-00410-40735532,2022-12-15T19:38:40,Zarautz,Expense,leisure,-24.58,-16738.81
buyer_2,Carmen,40,ES70209504723955028443,TRX_N-00411-09366025,2022-12-19T09:38:16,Zarautz,Expense,food,-64.77,-16803.58
buyer_2,Carmen,40,ES70209504723955028443,TRX_N-00412-69937987,2022-12-19T12:28:29,Zarautz,Expense,healthcare,-51.87,-16855.45
buyer_2,Carmen,40,ES70209504723955028443,TRX_N-00413-79341481,2022-12-19T22:32:42,Zarautz,Expense,appliances,-331.09,-17186.54
buyer_2,Carmen,40,ES70209504723955028443,TRX_N-00414-74381596,2022-12-20T18:44:44,Zarautz,Expense,cash,-100.0,-17286.54
buyer_2,Carmen,40,ES70209504723955028443,TRX_N-00415-96824087,2022-12-21T11:15:13,Zarautz,Expense,repairs,-79.87,-17366.41
buyer_2,Carmen,40,ES70209504723955028443,TRX_N-00416-66256185,2022-12-21T01:50:15,Zarautz,expenses,children,-242.55,-17608.96
buyer_2,Carmen,40,ES70209504723955028443,TRX_N-00417-33065606,2022-12-22T16:18:16,Zarautz,Expense,cash,-100.0,-17708.96
buyer_2,Carmen,40,ES70209504723955028443,TRX_N-00418-49318350,2022-12-24T08:21:55,Irun,Expense,food,-89.38,-17798.34
buyer_2,Carmen,40,ES70209504723955028443,TRX_N-00419-65149407,2022-12-24T18:42:29,Zarautz,Expense,cash,-100.0,-17898.34
buyer_2,Carmen,40,ES70209504723955028443,TRX_N-00420-44474660,2022-12-24T10:15:20,Zarautz,Expense,gifts,-510.77,-18409.11
buyer_2,Carmen,40,ES70209504723955028443,TRX_N-00421-22911511,2022-12-25T21:37:37,Sestao,Expense,food,-98.71,-18507.82
buyer_2,Carmen,40,ES70209504723955028443,TRX_N-00422-72016057,2022-12-25T10:47:39,Llodio,Expense,cash,-100.0,-18607.82
buyer_2,Carmen,40,ES70209504723955028443,TRX_N-00423-34213754,2022-12-25T12:47:17,Zarautz,Expense,repairs,-31.86,-18639.68
buyer_2,Carmen,40,ES70209504723955028443,TRX_N-00424-60613291,2022-12-26T06:37:51,Zarautz,Expense,food,-87.95,-18727.63
buyer_2,Carmen,40,ES70209504723955028443,TRX_N-00425-19856445,2022-12-29T20:41:15,Zarautz,Expense,food,-114.44,-18842.07
buyer_2,Carmen,40,ES70209504723955028443,TRX_N-00426-11197723,2022-12-29T08:58:19,Zarautz,Expense,transport,-77.85,-18919.92
buyer_2,Carmen,40,ES70209504723955028443,TRX_N-00427-36403861,2022-12-31T10:44:36,Zarautz,Expense,clothing,-85.47,-19005.39
buyer_2,Carmen,40,ES70209504723955028443,TRX_N-00428-04983563,2023-01-01T14:20:20,Zarautz,incomes,salary,1263.46,-17741.93
buyer_2,Carmen,40,ES70209504723955028443,TRX_N-00429-68956482,2023-01-01T14:20:20,Zarautz,incomes,salary_partner,1531.39,-16210.54
buyer_2,Carmen,40,ES70209504723955028443,TRX_N-00430-59636417,2023-01-03T17:02:42,Zarautz,Expense,leisure,-71.53,-16282.07
buyer_2,Carmen,40,ES70209504723955028443,TRX_N-00431-80776341,2023-01-04T20:33:37,Zarautz,expenses,mortgage,-1033.24,-17315.31
buyer_2,Carmen,40,ES70209504723955028443,TRX_N-00432-71106666,2023-01-05T10:42:35,Zarautz,Expense,cash,-100.0,-17415.31
buyer_2,Carmen,40,ES70209504723955028443,TRX_N-00433-26270948,2023-01-08T14:59:42,Zarautz,expenses,water,-43.05,-17458.36
buyer_2,Carmen,40,ES70209504723955028443,TRX_N-00434-49347571,2023-01-08T16:30:59,Zarautz,expenses,internet,-42.0,-17500.36
buyer_2,Carmen,40,ES70209504723955028443,TRX_N-00435-73783437,2023-01-08T08:44:16,Zarautz,expenses,electricity,-59.08,-17559.44
buyer_2,Carmen,40,ES70209504723955028443,TRX_N-00436-13543286,2023-01-08T19:14:21,Zarautz,expenses,gas,-105.45,-17664.89
buyer_2,Carmen,40,ES70209504723955028443,TRX_N-00437-89845024,2023-01-08T11:25:34,Zarautz,expenses,phone,-35.87,-17700.76
buyer_2,Carmen,40,ES70209504723955028443,TRX_N-00438-69612136,2023-01-08T19:05:46,Zarautz,Expense,food,-90.18,-17790.94
buyer_2,Carmen,40,ES70209504723955028443,TRX_N-00439-47142079,2023-01-08T18:48:16,Zarautz,Expense,gifts,-104.84,-17895.78
buyer_2,Carmen,40,ES70209504723955028443,TRX_N-00440-46479807,2023-01-09T19:13:44,Zarautz,Expense,education,-59.8,-17955.58
buyer_2,Carmen,40,ES70209504723955028443,TRX_N-00441-41998245,2023-01-10T23:27:03,Zarautz,Expense,transport,-57.98,-18013.56
buyer_2,Carmen,40,ES70209504723955028443,TRX_N-00442-78902685,2023-01-10T02:22:23,Zarautz,Expense,leisure,-35.29,-18048.85
buyer_2,Carmen,40,ES70209504723955028443,TRX_N-00443-35863572,2023-01-11T21:46:48,Mungia,Expense,clothing,-93.76,-18142.61
buyer_2,Carmen,40,ES70209504723955028443,TRX_N-00444-45747423,2023-01-14T06:22:14,Zarautz,Expense,gifts,-181.83,-18324.44
buyer_2,Carmen,40,ES70209504723955028443,TRX_N-00445-60403227,2023-01-15T15:03:35,Zarautz,Expense,food,-95.57,-18420.01
buyer_2,Carmen,40,ES70209504723955028443,TRX_N-00446-94400749,2023-01-15T18:01:32,Zarautz,Expense,repairs,-263.21,-18683.22
buyer_2,Carmen,40,ES70209504723955028443,TRX_N-00447-78132756,2023-01-16T17:06:16,Zarautz,Expense,cash,-100.0,-18783.22
buyer_2,Carmen,40,ES70209504723955028443,TRX_N-00448-99506255,2023-01-18T11:40:19,Zarautz,Expense,gifts,-637.74,-19420.96
buyer_2,Carmen,40,ES70209504723955028443,TRX_N-00449-43495165,2023-01-19T02:13:40,Zarautz,Expense,leisure,-61.58,-19482.54
buyer_2,Carmen,40,ES70209504723955028443,TRX_N-00450-59966217,2023-01-21T14:45:14,Zarautz,Expense,food,-90.81,-19573.35
buyer_2,Carmen,40,ES70209504723955028443,TRX_N-00451-01954466,2023-01-22T12:10:31,Zarautz,Expense,cash,-100.0,-19673.35
buyer_2,Carmen,40,ES70209504723955028443,TRX_N-00452-00776025,2023-01-22T12:25:13,Zarautz,Expense,repairs,-140.22,-19813.57
buyer_2,Carmen,40,ES70209504723955028443,TRX_N-00453-89570232,2023-01-23T16:54:19,Sopela,Expense,healthcare,-128.69,-19942.26
buyer_2,Carmen,40,ES70209504723955028443,TRX_N-00454-89361806,2023-01-24T04:58:52,Elciego,Expense,food,-110.41,-20052.67
buyer_2,Carmen,40,ES70209504723955028443,TRX_N-00455-17481046,2023-01-25T21:03:54,Zarautz,Expense,healthcare,-63.65,-20116.32
buyer_2,Carmen,40,ES70209504723955028443,TRX_N-00456-59098844,2023-01-26T18:12:36,Leioa,Expense,cash,-100.0,-20216.32
buyer_2,Carmen,40,ES70209504723955028443,TRX_N-00457-60516554,2023-01-26T22:22:57,Zarautz,Expense,repairs,-249.22,-20465.54
buyer_2,Carmen,40,ES70209504723955028443,TRX_N-00458-88001371,2023-01-28T14:42:00,Zarautz,Expense,food,-73.42,-20538.96
buyer_2,Carmen,40,ES70209504723955028443,TRX_N-00459-32156507,2023-01-29T12:51:22,Zarautz,Expense,leisure,-18.33,-20557.29
buyer_2,Carmen,40,ES70209504723955028443,TRX_N-00460-49781403,2023-01-29T12:41:17,Zarautz,Expense,appliances,-208.45,-20765.74
buyer_2,Carmen,40,ES70209504723955028443,TRX_N-00461-71122257,2023-01-29T14:23:02,Zarautz,Expense,gifts,-371.7,-21137.44
buyer_2,Carmen,40,ES70209504723955028443,TRX_N-00462-30457834,2023-01-30T17:24:26,Zarautz,Expense,food,-105.61,-21243.05
buyer_2,Carmen,40,ES70209504723955028443,TRX_N-00463-47497313,2023-01-30T09:33:44,Iru√±a de Oca,Expense,leisure,-31.53,-21274.58
buyer_2,Carmen,40,ES70209504723955028443,TRX_N-00464-37325665,2023-01-30T19:49:31,Zarautz,Expense,clothing,-142.13,-21416.71
buyer_2,Carmen,40,ES70209504723955028443,TRX_N-00465-17116921,2023-01-31T19:22:47,Zarautz,Expense,food,-61.75,-21478.46
buyer_2,Carmen,40,ES70209504723955028443,TRX_N-00466-47413090,2023-01-31T14:56:13,Zarautz,Expense,leisure,-18.75,-21497.21
buyer_2,Carmen,40,ES70209504723955028443,TRX_N-00467-47189020,2023-02-01T19:25:06,Zarautz,incomes,salary,1263.46,-20233.75
buyer_2,Carmen,40,ES70209504723955028443,TRX_N-00468-48436382,2023-02-01T19:25:06,Zarautz,incomes,salary_partner,1531.39,-18702.36
buyer_2,Carmen,40,ES70209504723955028443,TRX_N-00469-61413581,2023-02-01T05:08:53,Elciego,Expense,appliances,-86.01,-18788.37
buyer_2,Carmen,40,ES70209504723955028443,TRX_N-00470-72411437,2023-02-04T12:30:36,Zarautz,expenses,mortgage,-1033.24,-19821.61
buyer_2,Carmen,40,ES70209504723955028443,TRX_N-00471-07281319,2023-02-04T21:27:36,Zarautz,Expense,cash,-100.0,-19921.61
buyer_2,Carmen,40,ES70209504723955028443,TRX_N-00472-16279383,2023-02-05T20:25:08,Zarautz,expenses,water,-30.46,-19952.07
buyer_2,Carmen,40,ES70209504723955028443,TRX_N-00473-22038449,2023-02-06T09:24:08,Zarautz,expenses,electricity,-57.35,-20009.42
buyer_2,Carmen,40,ES70209504723955028443,TRX_N-00474-77296200,2023-02-06T15:50:26,Zarautz,Expense,healthcare,-166.45,-20175.87
buyer_2,Carmen,40,ES70209504723955028443,TRX_N-00475-40152063,2023-02-06T09:52:36,Zarautz,Expense,cash,-100.0,-20275.87
buyer_2,Carmen,40,ES70209504723955028443,TRX_N-00476-90073178,2023-02-07T11:01:30,Zarautz,expenses,phone,-41.68,-20317.55
buyer_2,Carmen,40,ES70209504723955028443,TRX_N-00477-67489242,2023-02-07T18:44:48,Zarautz,Expense,cash,-100.0,-20417.55
buyer_2,Carmen,40,ES70209504723955028443,TRX_N-00478-70627128,2023-02-08T05:53:03,Zarautz,expenses,gas,-100.78,-20518.33
buyer_2,Carmen,40,ES70209504723955028443,TRX_N-00479-96615743,2023-02-08T19:51:30,Zarautz,expenses,internet,-42.0,-20560.33
buyer_2,Carmen,40,ES70209504723955028443,TRX_N-00480-29415418,2023-02-09T17:27:57,Zarautz,Expense,leisure,-53.17,-20613.5
buyer_2,Carmen,40,ES70209504723955028443,TRX_N-00481-17701389,2023-02-11T19:40:12,Zarautz,Expense,education,-43.52,-20657.02
buyer_2,Carmen,40,ES70209504723955028443,TRX_N-00482-41360934,2023-02-12T12:40:22,Zarautz,Expense,gifts,-255.22,-20912.24
buyer_2,Carmen,40,ES70209504723955028443,TRX_N-00483-84554230,2023-02-14T12:48:29,Zarautz,Expense,food,-89.76,-21002.0
buyer_2,Carmen,40,ES70209504723955028443,TRX_N-00484-78585255,2023-02-15T15:32:57,Zarautz,Expense,leisure,-72.15,-21074.15
buyer_2,Carmen,40,ES70209504723955028443,TRX_N-00485-77522503,2023-02-15T20:11:17,Zarautz,Expense,cash,-100.0,-21174.15
buyer_2,Carmen,40,ES70209504723955028443,TRX_N-00486-48650634,2023-02-15T14:26:15,Barakaldo,Expense,repairs,-195.55,-21369.7
buyer_2,Carmen,40,ES70209504723955028443,TRX_N-00487-61987186,2023-02-15T19:43:30,Zarautz,Expense,gifts,-269.8,-21639.5
buyer_2,Carmen,40,ES70209504723955028443,TRX_N-00488-68201207,2023-02-17T21:24:48,Zarautz,Expense,education,-44.3,-21683.8
buyer_2,Carmen,40,ES70209504723955028443,TRX_N-00489-74107582,2023-02-19T21:04:04,Zarautz,Expense,clothing,-141.65,-21825.45
buyer_2,Carmen,40,ES70209504723955028443,TRX_N-00490-23229334,2023-02-23T17:10:00,Zarautz,Expense,food,-87.67,-21913.12
buyer_2,Carmen,40,ES70209504723955028443,TRX_N-00491-90716873,2023-02-26T16:29:05,Zarautz,Expense,repairs,-195.93,-22109.05
buyer_2,Carmen,40,ES70209504723955028443,TRX_N-00492-66575370,2023-02-28T18:57:44,Getxo,Expense,leisure,-84.35,-22193.4
buyer_2,Carmen,40,ES70209504723955028443,TRX_N-00493-67266715,2023-02-28T10:43:33,Durango,Expense,cash,-100.0,-22293.4
buyer_2,Carmen,40,ES70209504723955028443,TRX_N-00494-78695083,2023-03-01T20:56:05,Zarautz,incomes,salary,1263.46,-21029.94
buyer_2,Carmen,40,ES70209504723955028443,TRX_N-00495-31542819,2023-03-01T20:56:05,Zarautz,incomes,salary_partner,1531.39,-19498.55
buyer_2,Carmen,40,ES70209504723955028443,TRX_N-00496-97545022,2023-03-01T20:56:05,Zarautz,incomes,extra_income,122.27,-19376.28
buyer_2,Carmen,40,ES70209504723955028443,TRX_N-00497-31624459,2023-03-01T09:45:23,Zarautz,Expense,transport,-72.66,-19448.94
buyer_2,Carmen,40,ES70209504723955028443,TRX_N-00498-09762627,2023-03-04T03:11:13,Zarautz,expenses,mortgage,-1033.24,-20482.18
buyer_2,Carmen,40,ES70209504723955028443,TRX_N-00499-16960172,2023-03-04T11:21:10,Zarautz,Expense,cash,-100.0,-20582.18
buyer_2,Carmen,40,ES70209504723955028443,TRX_N-00500-40589065,2023-03-04T16:20:41,Zarautz,Expense,gifts,-541.63,-21123.81
buyer_2,Carmen,40,ES70209504723955028443,TRX_N-00501-35237511,2023-03-05T19:24:29,Zarautz,expenses,electricity,-71.68,-21195.49
buyer_2,Carmen,40,ES70209504723955028443,TRX_N-00502-98583499,2023-03-05T18:35:55,Zarautz,expenses,gas,-71.27,-21266.76
buyer_2,Carmen,40,ES70209504723955028443,TRX_N-00503-29008277,2023-03-05T19:02:09,Zarautz,expenses,internet,-42.0,-21308.76
buyer_2,Carmen,40,ES70209504723955028443,TRX_N-00504-34937196,2023-03-05T00:27:31,Zarautz,expenses,phone,-34.76,-21343.52
buyer_2,Carmen,40,ES70209504723955028443,TRX_N-00505-16672668,2023-03-06T09:02:21,Zarautz,expenses,water,-35.08,-21378.6
buyer_2,Carmen,40,ES70209504723955028443,TRX_N-00506-60247574,2023-03-06T18:14:40,Zarautz,Expense,transport,-42.82,-21421.42
buyer_2,Carmen,40,ES70209504723955028443,TRX_N-00507-73661091,2023-03-07T15:29:29,Errenteria,Expense,education,-50.47,-21471.89
buyer_2,Carmen,40,ES70209504723955028443,TRX_N-00508-07408073,2023-03-07T09:32:32,Zarautz,Expense,gifts,-160.34,-21632.23
buyer_2,Carmen,40,ES70209504723955028443,TRX_N-00509-22066082,2023-03-09T09:55:00,Zarautz,Expense,leisure,-63.03,-21695.26
buyer_2,Carmen,40,ES70209504723955028443,TRX_N-00510-76863826,2023-03-10T12:07:01,Zarautz,Expense,leisure,-83.03,-21778.29
buyer_2,Carmen,40,ES70209504723955028443,TRX_N-00511-54475832,2023-03-11T08:04:42,Zarautz,Expense,repairs,-204.16,-21982.45
buyer_2,Carmen,40,ES70209504723955028443,TRX_N-00512-85428246,2023-03-12T20:01:05,Zarautz,Expense,food,-63.06,-22045.51
buyer_2,Carmen,40,ES70209504723955028443,TRX_N-00513-32418525,2023-03-12T13:48:21,Zarautz,Expense,appliances,-408.21,-22453.72
buyer_2,Carmen,40,ES70209504723955028443,TRX_N-00514-27441221,2023-03-14T19:01:58,Zarautz,Expense,transport,-61.85,-22515.57
buyer_2,Carmen,40,ES70209504723955028443,TRX_N-00515-02366572,2023-03-16T13:28:13,Zarautz,Expense,cash,-100.0,-22615.57
buyer_2,Carmen,40,ES70209504723955028443,TRX_N-00516-26025182,2023-03-16T22:09:56,Zarautz,expenses,children,-129.86,-22745.43
buyer_2,Carmen,40,ES70209504723955028443,TRX_N-00517-77672319,2023-03-17T17:09:46,Zarautz,Expense,leisure,-49.11,-22794.54
buyer_2,Carmen,40,ES70209504723955028443,TRX_N-00518-95843540,2023-03-17T01:34:19,Zarautz,Expense,cash,-100.0,-22894.54
buyer_2,Carmen,40,ES70209504723955028443,TRX_N-00519-73027772,2023-03-17T13:48:58,Zarautz,expenses,children,-136.46,-23031.0
buyer_2,Carmen,40,ES70209504723955028443,TRX_N-00520-52726153,2023-03-18T08:48:10,Sestao,Expense,healthcare,-97.94,-23128.94
buyer_2,Carmen,40,ES70209504723955028443,TRX_N-00521-97256628,2023-03-19T09:22:59,Zarautz,Expense,food,-73.33,-23202.27
buyer_2,Carmen,40,ES70209504723955028443,TRX_N-00522-81549686,2023-03-20T20:41:53,Zarautz,Expense,appliances,-170.12,-23372.39
buyer_2,Carmen,40,ES70209504723955028443,TRX_N-00523-55549594,2023-03-21T17:49:25,Zarautz,Expense,transport,-64.63,-23437.02
buyer_2,Carmen,40,ES70209504723955028443,TRX_N-00524-59230249,2023-03-21T02:51:47,Zarautz,Expense,leisure,-76.01,-23513.03
buyer_2,Carmen,40,ES70209504723955028443,TRX_N-00525-73094599,2023-03-21T20:23:51,Zarautz,Expense,cash,-100.0,-23613.03
buyer_2,Carmen,40,ES70209504723955028443,TRX_N-00526-88569800,2023-03-21T19:20:00,Zarautz,Expense,repairs,-263.02,-23876.05
buyer_2,Carmen,40,ES70209504723955028443,TRX_N-00527-85731858,2023-03-21T10:18:03,Zarautz,Expense,gifts,-813.47,-24689.52
buyer_2,Carmen,40,ES70209504723955028443,TRX_N-00528-89970357,2023-03-22T11:15:30,Zarautz,Expense,education,-52.04,-24741.56
buyer_2,Carmen,40,ES70209504723955028443,TRX_N-00529-36907785,2023-03-23T12:58:36,Zarautz,Expense,healthcare,-144.48,-24886.04
buyer_2,Carmen,40,ES70209504723955028443,TRX_N-00530-77037045,2023-03-25T16:16:40,Zarautz,Expense,cash,-100.0,-24986.04
buyer_2,Carmen,40,ES70209504723955028443,TRX_N-00531-65314922,2023-03-26T08:03:43,Labastida,Expense,healthcare,-65.53,-25051.57
buyer_2,Carmen,40,ES70209504723955028443,TRX_N-00532-66856976,2023-03-27T16:16:23,Zarautz,Expense,education,-65.53,-25117.1
buyer_2,Carmen,40,ES70209504723955028443,TRX_N-00533-25473798,2023-03-27T12:34:01,Zarautz,Expense,gifts,-210.26,-25327.36
buyer_2,Carmen,40,ES70209504723955028443,TRX_N-00534-72618180,2023-03-28T19:14:30,Zarautz,Expense,repairs,-159.55,-25486.91
buyer_2,Carmen,40,ES70209504723955028443,TRX_N-00535-38101046,2023-03-29T22:19:30,Zarautz,Expense,clothing,-75.08,-25561.99
buyer_2,Carmen,40,ES70209504723955028443,TRX_N-00536-11527835,2023-03-30T17:11:47,Salvatierra/Agurain,Expense,travel,-778.71,-26340.7
buyer_2,Carmen,40,ES70209504723955028443,TRX_N-00537-66430545,2023-03-31T20:50:41,Zarautz,Expense,clothing,-137.44,-26478.14
buyer_2,Carmen,40,ES70209504723955028443,TRX_N-00538-57774755,2023-03-31T16:19:53,Oy√≥n-Oion,Expense,appliances,-146.07,-26624.21
buyer_2,Carmen,40,ES70209504723955028443,TRX_N-00539-13930478,2023-04-01T20:32:28,Zarautz,incomes,salary,1263.46,-25360.75
buyer_2,Carmen,40,ES70209504723955028443,TRX_N-00540-67071269,2023-04-01T20:32:28,Zarautz,incomes,salary_partner,1531.39,-23829.36
buyer_2,Carmen,40,ES70209504723955028443,TRX_N-00541-38281214,2023-04-03T08:15:45,Zarautz,Expense,food,-116.34,-23945.7
buyer_2,Carmen,40,ES70209504723955028443,TRX_N-00542-21222102,2023-04-04T09:30:59,Zarautz,expenses,mortgage,-1033.24,-24978.94
buyer_2,Carmen,40,ES70209504723955028443,TRX_N-00543-45843401,2023-04-04T10:30:47,Zarautz,Expense,food,-103.38,-25082.32
buyer_2,Carmen,40,ES70209504723955028443,TRX_N-00544-90264982,2023-04-04T15:00:52,Zarautz,Expense,cash,-100.0,-25182.32
buyer_2,Carmen,40,ES70209504723955028443,TRX_N-00545-19603422,2023-04-04T08:53:05,Iru√±a de Oca,Expense,gifts,-599.5,-25781.82
buyer_2,Carmen,40,ES70209504723955028443,TRX_N-00546-34943160,2023-04-05T13:22:41,Zarautz,expenses,water,-20.57,-25802.39
buyer_2,Carmen,40,ES70209504723955028443,TRX_N-00547-86534713,2023-04-05T10:09:31,Llodio,Expense,food,-66.68,-25869.07
buyer_2,Carmen,40,ES70209504723955028443,TRX_N-00548-77721071,2023-04-05T15:24:56,Zarautz,Expense,clothing,-144.07,-26013.14
buyer_2,Carmen,40,ES70209504723955028443,TRX_N-00549-59138292,2023-04-06T15:14:10,Zarautz,expenses,phone,-38.42,-26051.56
buyer_2,Carmen,40,ES70209504723955028443,TRX_N-00550-79614108,2023-04-06T08:54:36,Zarautz,Expense,transport,-47.19,-26098.75
buyer_2,Carmen,40,ES70209504723955028443,TRX_N-00551-08886693,2023-04-07T16:19:26,Zarautz,Expense,food,-120.66,-26219.41
buyer_2,Carmen,40,ES70209504723955028443,TRX_N-00552-35044148,2023-04-08T12:18:52,Zarautz,expenses,gas,-74.6,-26294.01
buyer_2,Carmen,40,ES70209504723955028443,TRX_N-00553-37016661,2023-04-08T15:50:25,Zarautz,expenses,electricity,-53.53,-26347.54
buyer_2,Carmen,40,ES70209504723955028443,TRX_N-00554-47706046,2023-04-08T03:36:39,Zarautz,expenses,internet,-42.0,-26389.54
buyer_2,Carmen,40,ES70209504723955028443,TRX_N-00555-16664869,2023-04-09T10:07:28,Zarautz,Expense,repairs,-123.48,-26513.02
buyer_2,Carmen,40,ES70209504723955028443,TRX_N-00556-60278120,2023-04-10T17:12:06,Zarautz,Expense,food,-94.94,-26607.96
buyer_2,Carmen,40,ES70209504723955028443,TRX_N-00557-89372165,2023-04-10T16:05:54,Zarautz,Expense,transport,-82.33,-26690.29
buyer_2,Carmen,40,ES70209504723955028443,TRX_N-00558-09841393,2023-04-10T13:19:41,Berango,Expense,education,-63.03,-26753.32
buyer_2,Carmen,40,ES70209504723955028443,TRX_N-00559-54356959,2023-04-11T11:23:04,Zarautz,Expense,appliances,-412.73,-27166.05
buyer_2,Carmen,40,ES70209504723955028443,TRX_N-00560-15233702,2023-04-14T09:22:46,Zarautz,Expense,repairs,-87.33,-27253.38
buyer_2,Carmen,40,ES70209504723955028443,TRX_N-00561-57283162,2023-04-15T18:11:22,Zarautz,Expense,transport,-80.8,-27334.18
buyer_2,Carmen,40,ES70209504723955028443,TRX_N-00562-23663604,2023-04-15T15:41:54,Zarautz,Expense,cash,-100.0,-27434.18
buyer_2,Carmen,40,ES70209504723955028443,TRX_N-00563-72128768,2023-04-16T10:27:17,Zarautz,Expense,clothing,-115.4,-27549.58
buyer_2,Carmen,40,ES70209504723955028443,TRX_N-00564-97715869,2023-04-16T20:10:13,Zarautz,Expense,cash,-100.0,-27649.58
buyer_2,Carmen,40,ES70209504723955028443,TRX_N-00565-06674628,2023-04-17T09:04:00,Zarautz,Expense,food,-64.34,-27713.92
buyer_2,Carmen,40,ES70209504723955028443,TRX_N-00566-23279323,2023-04-17T11:22:03,Zarautz,Expense,gifts,-748.55,-28462.47
buyer_2,Carmen,40,ES70209504723955028443,TRX_N-00567-05565793,2023-04-18T19:06:01,Zarautz,Expense,cash,-100.0,-28562.47
buyer_2,Carmen,40,ES70209504723955028443,TRX_N-00568-35527706,2023-04-18T16:47:10,Zarautz,Expense,repairs,-102.79,-28665.26
buyer_2,Carmen,40,ES70209504723955028443,TRX_N-00569-08892629,2023-04-19T20:02:15,Alegr√≠a-Dulantzi,Expense,education,-68.13,-28733.39
buyer_2,Carmen,40,ES70209504723955028443,TRX_N-00570-31925009,2023-04-20T10:50:28,Zarautz,Expense,transport,-68.16,-28801.55
buyer_2,Carmen,40,ES70209504723955028443,TRX_N-00571-90750184,2023-04-21T18:27:49,Zarautz,Expense,leisure,-78.27,-28879.82
buyer_2,Carmen,40,ES70209504723955028443,TRX_N-00572-01554251,2023-04-21T20:05:23,Zarautz,Expense,gifts,-462.1,-29341.92
buyer_2,Carmen,40,ES70209504723955028443,TRX_N-00573-69088845,2023-04-22T15:25:50,Zarautz,Expense,food,-62.59,-29404.51
buyer_2,Carmen,40,ES70209504723955028443,TRX_N-00574-57964367,2023-04-23T16:58:54,Zarautz,Expense,leisure,-39.46,-29443.97
buyer_2,Carmen,40,ES70209504723955028443,TRX_N-00575-79926959,2023-04-24T13:21:34,Zarautz,Expense,appliances,-331.46,-29775.43
buyer_2,Carmen,40,ES70209504723955028443,TRX_N-00576-54486291,2023-04-25T22:38:31,Zarautz,Expense,gifts,-771.85,-30547.28
buyer_2,Carmen,40,ES70209504723955028443,TRX_N-00577-29929988,2023-04-27T23:42:54,Zarautz,Expense,leisure,-53.03,-30600.31
buyer_2,Carmen,40,ES70209504723955028443,TRX_N-00578-64750044,2023-04-27T17:55:10,Zarautz,Expense,cash,-100.0,-30700.31
buyer_2,Carmen,40,ES70209504723955028443,TRX_N-00579-62812723,2023-04-28T09:15:32,Andoain,Expense,leisure,-41.5,-30741.81
buyer_2,Carmen,40,ES70209504723955028443,TRX_N-00580-19609614,2023-04-29T13:30:49,Pasaia,Expense,leisure,-35.49,-30777.3
buyer_2,Carmen,40,ES70209504723955028443,TRX_N-00581-77542967,2023-04-29T18:59:21,Zarautz,Expense,healthcare,-97.21,-30874.51
buyer_2,Carmen,40,ES70209504723955028443,TRX_N-00582-50894442,2023-05-01T18:11:58,Zarautz,incomes,salary,1263.46,-29611.05
buyer_2,Carmen,40,ES70209504723955028443,TRX_N-00583-40639697,2023-05-01T18:11:58,Zarautz,incomes,salary_partner,1531.39,-28079.66
buyer_2,Carmen,40,ES70209504723955028443,TRX_N-00584-11595880,2023-05-01T15:39:21,Zarautz,Expense,cash,-100.0,-28179.66
buyer_2,Carmen,40,ES70209504723955028443,TRX_N-00585-98526364,2023-05-02T12:18:51,Zarautz,Expense,leisure,-23.96,-28203.62
buyer_2,Carmen,40,ES70209504723955028443,TRX_N-00586-87230826,2023-05-03T21:58:45,Zarautz,Expense,healthcare,-140.43,-28344.05
buyer_2,Carmen,40,ES70209504723955028443,TRX_N-00587-24176503,2023-05-04T22:36:11,Zarautz,expenses,mortgage,-1033.24,-29377.29
buyer_2,Carmen,40,ES70209504723955028443,TRX_N-00588-62624735,2023-05-05T14:56:56,Zarautz,expenses,phone,-40.69,-29417.98
buyer_2,Carmen,40,ES70209504723955028443,TRX_N-00589-93561124,2023-05-06T13:37:46,Zarautz,expenses,electricity,-64.17,-29482.15
buyer_2,Carmen,40,ES70209504723955028443,TRX_N-00590-62404179,2023-05-06T19:34:09,Zarautz,expenses,internet,-42.0,-29524.15
buyer_2,Carmen,40,ES70209504723955028443,TRX_N-00591-71149163,2023-05-07T17:55:54,Zarautz,Expense,healthcare,-99.73,-29623.88
buyer_2,Carmen,40,ES70209504723955028443,TRX_N-00592-44646497,2023-05-08T20:40:22,Zarautz,expenses,water,-31.38,-29655.26
buyer_2,Carmen,40,ES70209504723955028443,TRX_N-00593-65861246,2023-05-08T01:53:51,Zarautz,expenses,gas,-36.17,-29691.43
buyer_2,Carmen,40,ES70209504723955028443,TRX_N-00594-23967421,2023-05-08T14:41:28,Zarautz,Expense,clothing,-144.36,-29835.79
buyer_2,Carmen,40,ES70209504723955028443,TRX_N-00595-25696711,2023-05-08T14:20:44,Zarautz,Expense,cash,-100.0,-29935.79
buyer_2,Carmen,40,ES70209504723955028443,TRX_N-00596-85845722,2023-05-09T16:02:39,Zarautz,Expense,leisure,-40.17,-29975.96
buyer_2,Carmen,40,ES70209504723955028443,TRX_N-00597-06159798,2023-05-11T23:38:06,Zarautz,expenses,children,-186.33,-30162.29
buyer_2,Carmen,40,ES70209504723955028443,TRX_N-00598-97842604,2023-05-12T05:52:56,Zarautz,Expense,cash,-100.0,-30262.29
buyer_2,Carmen,40,ES70209504723955028443,TRX_N-00599-85788484,2023-05-13T13:18:30,Basauri,Expense,cash,-100.0,-30362.29
buyer_2,Carmen,40,ES70209504723955028443,TRX_N-00600-04669568,2023-05-15T06:52:10,Zarautz,Expense,food,-86.21,-30448.5
buyer_2,Carmen,40,ES70209504723955028443,TRX_N-00601-93078455,2023-05-16T10:43:53,Zarautz,Expense,repairs,-110.23,-30558.73
buyer_2,Carmen,40,ES70209504723955028443,TRX_N-00602-34859776,2023-05-18T22:54:00,Mungia,Expense,cash,-100.0,-30658.73
buyer_2,Carmen,40,ES70209504723955028443,TRX_N-00603-30831969,2023-05-19T19:27:48,Arrasate,Expense,transport,-87.31,-30746.04
buyer_2,Carmen,40,ES70209504723955028443,TRX_N-00604-60497233,2023-05-19T15:33:42,Zarautz,expenses,children,-144.14,-30890.18
buyer_2,Carmen,40,ES70209504723955028443,TRX_N-00605-04705181,2023-05-20T09:31:58,Zarautz,Expense,leisure,-20.0,-30910.18
buyer_2,Carmen,40,ES70209504723955028443,TRX_N-00606-80978631,2023-05-22T11:11:44,Zarautz,Expense,healthcare,-53.21,-30963.39
buyer_2,Carmen,40,ES70209504723955028443,TRX_N-00607-61034813,2023-05-24T14:31:18,Zarautz,Expense,food,-86.58,-31049.97
buyer_2,Carmen,40,ES70209504723955028443,TRX_N-00608-47589798,2023-05-24T19:49:51,Zarautz,Expense,education,-75.63,-31125.6
buyer_2,Carmen,40,ES70209504723955028443,TRX_N-00609-25788126,2023-05-24T11:06:43,Zarautz,Expense,appliances,-95.18,-31220.78
buyer_2,Carmen,40,ES70209504723955028443,TRX_N-00610-96931022,2023-05-25T12:05:26,Sestao,Expense,gifts,-449.23,-31670.01
buyer_2,Carmen,40,ES70209504723955028443,TRX_N-00611-67346728,2023-05-27T15:15:17,Labastida,Expense,transport,-66.7,-31736.71
buyer_2,Carmen,40,ES70209504723955028443,TRX_N-00612-53912990,2023-05-30T09:09:05,Eibar,Expense,food,-114.62,-31851.33
buyer_2,Carmen,40,ES70209504723955028443,TRX_N-00613-52083491,2023-06-01T19:47:54,Zarautz,incomes,salary,1263.46,-30587.87
buyer_2,Carmen,40,ES70209504723955028443,TRX_N-00614-98387829,2023-06-01T19:47:54,Zarautz,incomes,salary_partner,1531.39,-29056.48
buyer_2,Carmen,40,ES70209504723955028443,TRX_N-00615-52095378,2023-06-01T19:47:54,Zarautz,incomes,salary_bonus,988.01,-28068.47
buyer_2,Carmen,40,ES70209504723955028443,TRX_N-00616-94442941,2023-06-01T19:47:54,Zarautz,incomes,salary_partner_bonus,1184.52,-26883.95
buyer_2,Carmen,40,ES70209504723955028443,TRX_N-00617-80876181,2023-06-01T08:26:40,Andoain,Expense,clothing,-113.58,-26997.53
buyer_2,Carmen,40,ES70209504723955028443,TRX_N-00618-52942916,2023-06-02T18:31:34,Zarautz,expenses,children,-134.69,-27132.22
buyer_2,Carmen,40,ES70209504723955028443,TRX_N-00619-20508258,2023-06-04T08:56:18,Zarautz,expenses,mortgage,-1033.24,-28165.46
buyer_2,Carmen,40,ES70209504723955028443,TRX_N-00620-38936230,2023-06-04T16:43:20,Zarautz,Expense,cash,-100.0,-28265.46
buyer_2,Carmen,40,ES70209504723955028443,TRX_N-00621-47444884,2023-06-04T15:45:11,Santurtzi,Expense,travel,-1119.43,-29384.89
buyer_2,Carmen,40,ES70209504723955028443,TRX_N-00622-84850539,2023-06-05T19:27:46,Zarautz,expenses,water,-38.44,-29423.33
buyer_2,Carmen,40,ES70209504723955028443,TRX_N-00623-05661326,2023-06-05T12:23:03,Zarautz,expenses,phone,-31.51,-29454.84
buyer_2,Carmen,40,ES70209504723955028443,TRX_N-00624-84524462,2023-06-06T09:21:15,Zarautz,expenses,electricity,-76.1,-29530.94
buyer_2,Carmen,40,ES70209504723955028443,TRX_N-00625-18147536,2023-06-06T18:00:07,Zarautz,expenses,internet,-42.0,-29572.94
buyer_2,Carmen,40,ES70209504723955028443,TRX_N-00626-72165300,2023-06-06T19:49:19,Zarautz,Expense,education,-50.15,-29623.09
buyer_2,Carmen,40,ES70209504723955028443,TRX_N-00627-77740772,2023-06-07T13:36:49,Zarautz,Expense,food,-88.06,-29711.15
buyer_2,Carmen,40,ES70209504723955028443,TRX_N-00628-50607892,2023-06-08T14:40:24,Zarautz,expenses,gas,-106.91,-29818.06
buyer_2,Carmen,40,ES70209504723955028443,TRX_N-00629-18782602,2023-06-09T14:33:30,Zarautz,Expense,clothing,-143.2,-29961.26
buyer_2,Carmen,40,ES70209504723955028443,TRX_N-00630-13028047,2023-06-09T23:47:49,Zarautz,Expense,healthcare,-122.06,-30083.32
buyer_2,Carmen,40,ES70209504723955028443,TRX_N-00631-16349183,2023-06-14T08:43:16,Zarautz,Expense,clothing,-77.18,-30160.5
buyer_2,Carmen,40,ES70209504723955028443,TRX_N-00632-31236585,2023-06-14T14:30:59,Zarautz,Expense,cash,-100.0,-30260.5
buyer_2,Carmen,40,ES70209504723955028443,TRX_N-00633-10348440,2023-06-15T19:47:31,Zarautz,Expense,food,-68.62,-30329.12
buyer_2,Carmen,40,ES70209504723955028443,TRX_N-00634-77387570,2023-06-15T11:36:32,Zarautz,expenses,children,-84.14,-30413.26
buyer_2,Carmen,40,ES70209504723955028443,TRX_N-00635-54841733,2023-06-16T16:18:12,Zarautz,Expense,leisure,-44.13,-30457.39
buyer_2,Carmen,40,ES70209504723955028443,TRX_N-00636-03764958,2023-06-18T18:58:20,Zarautz,Expense,food,-112.73,-30570.12
buyer_2,Carmen,40,ES70209504723955028443,TRX_N-00637-14270738,2023-06-18T12:13:51,Eibar,Expense,cash,-100.0,-30670.12
buyer_2,Carmen,40,ES70209504723955028443,TRX_N-00638-81327052,2023-06-20T22:01:20,Zarautz,Expense,travel,-828.23,-31498.35
buyer_2,Carmen,40,ES70209504723955028443,TRX_N-00639-04609460,2023-06-22T11:13:22,Zarautz,Expense,cash,-100.0,-31598.35
buyer_2,Carmen,40,ES70209504723955028443,TRX_N-00640-59283218,2023-06-23T09:37:49,Zarautz,Expense,leisure,-36.88,-31635.23
buyer_2,Carmen,40,ES70209504723955028443,TRX_N-00641-82377431,2023-06-24T08:43:29,Zarautz,Expense,education,-70.22,-31705.45
buyer_2,Carmen,40,ES70209504723955028443,TRX_N-00642-84451210,2023-06-25T14:37:01,Zarautz,Expense,cash,-100.0,-31805.45
buyer_2,Carmen,40,ES70209504723955028443,TRX_N-00643-95787903,2023-06-28T16:03:20,Zarautz,Expense,cash,-100.0,-31905.45
buyer_2,Carmen,40,ES70209504723955028443,TRX_N-00644-52254936,2023-06-29T11:25:50,Zarautz,Expense,cash,-100.0,-32005.45
buyer_2,Carmen,40,ES70209504723955028443,TRX_N-00645-41758891,2023-07-01T18:02:31,Zarautz,incomes,salary,1263.46,-30741.99
buyer_2,Carmen,40,ES70209504723955028443,TRX_N-00646-93317706,2023-07-01T18:02:31,Zarautz,incomes,salary_partner,1531.39,-29210.6
buyer_2,Carmen,40,ES70209504723955028443,TRX_N-00647-41473391,2023-07-01T18:02:31,Zarautz,incomes,extra_income,122.27,-29088.33
buyer_2,Carmen,40,ES70209504723955028443,TRX_N-00648-86048144,2023-07-02T20:31:04,Zarautz,Expense,repairs,-50.7,-29139.03
buyer_2,Carmen,40,ES70209504723955028443,TRX_N-00649-06160041,2023-07-03T13:25:07,Donostia,Expense,food,-121.25,-29260.28
buyer_2,Carmen,40,ES70209504723955028443,TRX_N-00650-40619275,2023-07-04T17:44:46,Zarautz,expenses,mortgage,-1033.24,-30293.52
buyer_2,Carmen,40,ES70209504723955028443,TRX_N-00651-46854726,2023-07-04T15:29:54,Zarautz,Expense,food,-64.91,-30358.43
buyer_2,Carmen,40,ES70209504723955028443,TRX_N-00652-70122748,2023-07-04T11:09:57,Zarautz,Expense,clothing,-119.98,-30478.41
buyer_2,Carmen,40,ES70209504723955028443,TRX_N-00653-26238423,2023-07-05T20:00:48,Zarautz,expenses,phone,-34.37,-30512.78
buyer_2,Carmen,40,ES70209504723955028443,TRX_N-00654-09070195,2023-07-05T16:27:39,Zarautz,Expense,food,-93.12,-30605.9
buyer_2,Carmen,40,ES70209504723955028443,TRX_N-00655-12024255,2023-07-05T09:10:44,Zarautz,Expense,leisure,-31.69,-30637.59
buyer_2,Carmen,40,ES70209504723955028443,TRX_N-00656-91344804,2023-07-05T12:59:38,Zarautz,Expense,appliances,-302.58,-30940.17
buyer_2,Carmen,40,ES70209504723955028443,TRX_N-00657-92873669,2023-07-07T11:16:32,Zarautz,expenses,water,-37.9,-30978.07
buyer_2,Carmen,40,ES70209504723955028443,TRX_N-00658-65375293,2023-07-07T12:08:00,Zarautz,expenses,gas,-80.29,-31058.36
buyer_2,Carmen,40,ES70209504723955028443,TRX_N-00659-56894041,2023-07-08T18:51:56,Zarautz,expenses,electricity,-55.04,-31113.4
buyer_2,Carmen,40,ES70209504723955028443,TRX_N-00660-04058030,2023-07-08T06:03:31,Zarautz,expenses,internet,-42.0,-31155.4
buyer_2,Carmen,40,ES70209504723955028443,TRX_N-00661-12421058,2023-07-09T08:16:54,Zarautz,Expense,transport,-48.05,-31203.45
buyer_2,Carmen,40,ES70209504723955028443,TRX_N-00662-35860743,2023-07-11T11:59:32,Zarautz,Expense,cash,-100.0,-31303.45
buyer_2,Carmen,40,ES70209504723955028443,TRX_N-00663-64065566,2023-07-11T16:42:12,Zarautz,expenses,children,-276.15,-31579.6
buyer_2,Carmen,40,ES70209504723955028443,TRX_N-00664-29638916,2023-07-13T20:09:57,Zarautz,Expense,leisure,-64.83,-31644.43
buyer_2,Carmen,40,ES70209504723955028443,TRX_N-00665-87828635,2023-07-13T23:37:42,Hernani,Expense,gifts,-537.31,-32181.74
buyer_2,Carmen,40,ES70209504723955028443,TRX_N-00666-04591192,2023-07-14T08:20:00,Zarautz,Expense,transport,-48.38,-32230.12
buyer_2,Carmen,40,ES70209504723955028443,TRX_N-00667-87257868,2023-07-14T12:49:58,Zarautz,Expense,cash,-100.0,-32330.12
buyer_2,Carmen,40,ES70209504723955028443,TRX_N-00668-84881264,2023-07-16T17:18:56,Zarautz,Expense,leisure,-53.06,-32383.18
buyer_2,Carmen,40,ES70209504723955028443,TRX_N-00669-82143203,2023-07-16T16:15:19,Zarautz,Expense,cash,-100.0,-32483.18
buyer_2,Carmen,40,ES70209504723955028443,TRX_N-00670-88757397,2023-07-18T15:23:22,Zarautz,Expense,leisure,-23.25,-32506.43
buyer_2,Carmen,40,ES70209504723955028443,TRX_N-00671-95327691,2023-07-18T20:48:56,Zarautz,Expense,cash,-100.0,-32606.43
buyer_2,Carmen,40,ES70209504723955028443,TRX_N-00672-36119162,2023-07-19T18:37:34,Mungia,Expense,transport,-65.06,-32671.49
buyer_2,Carmen,40,ES70209504723955028443,TRX_N-00673-22847061,2023-07-21T16:34:23,Zarautz,Expense,food,-103.98,-32775.47
buyer_2,Carmen,40,ES70209504723955028443,TRX_N-00674-81036597,2023-07-21T13:15:20,Erandio,Expense,cash,-100.0,-32875.47
buyer_2,Carmen,40,ES70209504723955028443,TRX_N-00675-00203682,2023-07-23T20:09:04,Getxo,Expense,food,-85.4,-32960.87
buyer_2,Carmen,40,ES70209504723955028443,TRX_N-00676-26932316,2023-07-23T18:17:20,Zarautz,Expense,clothing,-94.03,-33054.9
buyer_2,Carmen,40,ES70209504723955028443,TRX_N-00677-34551137,2023-07-24T19:06:12,Zarautz,Expense,food,-82.67,-33137.57
buyer_2,Carmen,40,ES70209504723955028443,TRX_N-00678-92047591,2023-07-25T20:46:22,Zarautz,Expense,repairs,-109.06,-33246.63
buyer_2,Carmen,40,ES70209504723955028443,TRX_N-00679-36452356,2023-07-27T20:27:13,Zarautz,Expense,repairs,-217.89,-33464.52
buyer_2,Carmen,40,ES70209504723955028443,TRX_N-00680-38057697,2023-07-28T22:14:26,Zarautz,Expense,leisure,-68.31,-33532.83
buyer_2,Carmen,40,ES70209504723955028443,TRX_N-00681-24208389,2023-07-30T16:14:59,Zarautz,Expense,gifts,-294.55,-33827.38
buyer_2,Carmen,40,ES70209504723955028443,TRX_N-00682-89291114,2023-07-31T14:00:30,Zarautz,Expense,food,-61.26,-33888.64
buyer_2,Carmen,40,ES70209504723955028443,TRX_N-00683-05022058,2023-08-01T20:45:10,Zarautz,incomes,salary,1263.46,-32625.18
buyer_2,Carmen,40,ES70209504723955028443,TRX_N-00684-53212607,2023-08-01T20:45:10,Zarautz,incomes,salary_partner,1531.39,-31093.79
buyer_2,Carmen,40,ES70209504723955028443,TRX_N-00685-21587395,2023-08-01T05:25:35,Barakaldo,Expense,repairs,-168.25,-31262.04
buyer_2,Carmen,40,ES70209504723955028443,TRX_N-00686-99905055,2023-08-02T14:54:45,Zarautz,Expense,transport,-80.73,-31342.77
buyer_2,Carmen,40,ES70209504723955028443,TRX_N-00687-06622539,2023-08-03T10:40:28,Zarautz,Expense,cash,-100.0,-31442.77
buyer_2,Carmen,40,ES70209504723955028443,TRX_N-00688-88066012,2023-08-04T19:45:02,Zarautz,expenses,mortgage,-1033.24,-32476.01
buyer_2,Carmen,40,ES70209504723955028443,TRX_N-00689-38172403,2023-08-04T17:38:33,Zarautz,Expense,clothing,-140.93,-32616.94
buyer_2,Carmen,40,ES70209504723955028443,TRX_N-00690-29152986,2023-08-04T13:17:27,Zarautz,Expense,education,-72.41,-32689.35
buyer_2,Carmen,40,ES70209504723955028443,TRX_N-00691-63360481,2023-08-05T16:45:36,Zarautz,expenses,gas,-59.21,-32748.56
buyer_2,Carmen,40,ES70209504723955028443,TRX_N-00692-68895907,2023-08-05T16:06:12,Zarautz,expenses,phone,-31.78,-32780.34
buyer_2,Carmen,40,ES70209504723955028443,TRX_N-00693-95684872,2023-08-06T17:52:05,Zarautz,expenses,water,-24.39,-32804.73
buyer_2,Carmen,40,ES70209504723955028443,TRX_N-00694-74069773,2023-08-06T10:02:01,Zarautz,expenses,internet,-42.0,-32846.73
buyer_2,Carmen,40,ES70209504723955028443,TRX_N-00695-19389926,2023-08-06T15:44:01,Zarautz,Expense,travel,-553.47,-33400.2
buyer_2,Carmen,40,ES70209504723955028443,TRX_N-00696-78849122,2023-08-07T15:31:16,Zarautz,Expense,transport,-74.67,-33474.87
buyer_2,Carmen,40,ES70209504723955028443,TRX_N-00697-89908010,2023-08-08T10:13:54,Zarautz,expenses,electricity,-25.53,-33500.4
buyer_2,Carmen,40,ES70209504723955028443,TRX_N-00698-63597768,2023-08-08T10:52:19,Zarautz,Expense,clothing,-92.2,-33592.6
buyer_2,Carmen,40,ES70209504723955028443,TRX_N-00699-46749134,2023-08-09T15:56:18,Zarautz,Expense,cash,-100.0,-33692.6
buyer_2,Carmen,40,ES70209504723955028443,TRX_N-00700-96750888,2023-08-10T18:24:20,Barakaldo,Expense,cash,-100.0,-33792.6
buyer_2,Carmen,40,ES70209504723955028443,TRX_N-00701-72676811,2023-08-11T09:34:19,Zarautz,Expense,leisure,-69.03,-33861.63
buyer_2,Carmen,40,ES70209504723955028443,TRX_N-00702-00800055,2023-08-11T00:35:20,Zarautz,Expense,repairs,-249.98,-34111.61
buyer_2,Carmen,40,ES70209504723955028443,TRX_N-00703-96980184,2023-08-12T11:48:57,Zarautz,Expense,healthcare,-95.25,-34206.86
buyer_2,Carmen,40,ES70209504723955028443,TRX_N-00704-42426312,2023-08-13T13:48:38,Zarautz,Expense,leisure,-36.98,-34243.84
buyer_2,Carmen,40,ES70209504723955028443,TRX_N-00705-34694752,2023-08-14T04:01:33,Zarautz,Expense,cash,-100.0,-34343.84
buyer_2,Carmen,40,ES70209504723955028443,TRX_N-00706-86292140,2023-08-16T20:55:17,Zarautz,Expense,transport,-52.94,-34396.78
buyer_2,Carmen,40,ES70209504723955028443,TRX_N-00707-53110835,2023-08-17T11:17:10,Zarautz,Expense,food,-100.2,-34496.98
buyer_2,Carmen,40,ES70209504723955028443,TRX_N-00708-68723797,2023-08-18T20:05:06,Zarautz,Expense,transport,-44.03,-34541.01
buyer_2,Carmen,40,ES70209504723955028443,TRX_N-00709-93018847,2023-08-18T13:01:26,Errenteria,Expense,healthcare,-81.25,-34622.26
buyer_2,Carmen,40,ES70209504723955028443,TRX_N-00710-59540984,2023-08-19T09:32:52,Zarautz,Expense,food,-69.92,-34692.18
buyer_2,Carmen,40,ES70209504723955028443,TRX_N-00711-06906926,2023-08-19T19:04:09,Zarautz,Expense,cash,-100.0,-34792.18
buyer_2,Carmen,40,ES70209504723955028443,TRX_N-00712-66293267,2023-08-20T20:46:18,Zarautz,Expense,education,-65.72,-34857.9
buyer_2,Carmen,40,ES70209504723955028443,TRX_N-00713-95933123,2023-08-24T16:42:38,Zarautz,Expense,food,-103.12,-34961.02
buyer_2,Carmen,40,ES70209504723955028443,TRX_N-00714-03484744,2023-08-25T12:48:16,Durango,Expense,education,-46.82,-35007.84
buyer_2,Carmen,40,ES70209504723955028443,TRX_N-00715-99168617,2023-08-26T10:49:36,Zarautz,expenses,children,-90.12,-35097.96
buyer_2,Carmen,40,ES70209504723955028443,TRX_N-00716-98404228,2023-08-29T11:08:28,Zarautz,Expense,cash,-100.0,-35197.96
buyer_2,Carmen,40,ES70209504723955028443,TRX_N-00717-32444906,2023-08-29T17:00:34,Zarautz,Expense,repairs,-274.36,-35472.32
buyer_2,Carmen,40,ES70209504723955028443,TRX_N-00718-50448297,2023-08-30T16:35:34,Zarautz,Expense,travel,-797.2,-36269.52
buyer_2,Carmen,40,ES70209504723955028443,TRX_N-00719-13424465,2023-08-31T15:10:08,Zarautz,Expense,clothing,-115.11,-36384.63
buyer_2,Carmen,40,ES70209504723955028443,TRX_N-00720-92089931,2023-08-31T16:11:44,Zarautz,Expense,education,-46.17,-36430.8
buyer_2,Carmen,40,ES70209504723955028443,TRX_N-00721-41597128,2023-09-01T08:30:41,Zarautz,incomes,salary,1263.46,-35167.34
buyer_2,Carmen,40,ES70209504723955028443,TRX_N-00722-35774729,2023-09-01T08:30:41,Zarautz,incomes,salary_partner,1531.39,-33635.95
buyer_2,Carmen,40,ES70209504723955028443,TRX_N-00723-71994576,2023-09-03T16:03:33,Zarautz,Expense,appliances,-158.56,-33794.51
buyer_2,Carmen,40,ES70209504723955028443,TRX_N-00724-77176631,2023-09-04T11:51:45,Zarautz,expenses,mortgage,-1033.24,-34827.75
buyer_2,Carmen,40,ES70209504723955028443,TRX_N-00725-13904040,2023-09-05T17:14:57,Zarautz,expenses,water,-22.53,-34850.28
buyer_2,Carmen,40,ES70209504723955028443,TRX_N-00726-96322977,2023-09-05T17:47:26,Zarautz,expenses,internet,-42.0,-34892.28
buyer_2,Carmen,40,ES70209504723955028443,TRX_N-00727-96491347,2023-09-05T08:15:08,Errenteria,Expense,clothing,-116.87,-35009.15
buyer_2,Carmen,40,ES70209504723955028443,TRX_N-00728-60671428,2023-09-05T11:37:10,Zarautz,Expense,cash,-100.0,-35109.15
buyer_2,Carmen,40,ES70209504723955028443,TRX_N-00729-53065249,2023-09-07T14:29:05,Zarautz,expenses,gas,-73.83,-35182.98
buyer_2,Carmen,40,ES70209504723955028443,TRX_N-00730-91207675,2023-09-07T16:03:06,Zarautz,Expense,food,-95.21,-35278.19
buyer_2,Carmen,40,ES70209504723955028443,TRX_N-00731-52970244,2023-09-08T20:05:03,Zarautz,expenses,electricity,-27.94,-35306.13
buyer_2,Carmen,40,ES70209504723955028443,TRX_N-00732-56661682,2023-09-08T12:17:21,Zarautz,expenses,phone,-44.52,-35350.65
buyer_2,Carmen,40,ES70209504723955028443,TRX_N-00733-55781033,2023-09-08T20:14:10,Irun,Expense,education,-74.56,-35425.21
buyer_2,Carmen,40,ES70209504723955028443,TRX_N-00734-07398273,2023-09-10T22:31:03,Zarautz,Expense,cash,-100.0,-35525.21
buyer_2,Carmen,40,ES70209504723955028443,TRX_N-00735-18703594,2023-09-14T21:53:11,Zarautz,Expense,cash,-100.0,-35625.21
buyer_2,Carmen,40,ES70209504723955028443,TRX_N-00736-45840851,2023-09-15T02:21:40,Oy√≥n-Oion,Expense,food,-77.62,-35702.83
buyer_2,Carmen,40,ES70209504723955028443,TRX_N-00737-71327446,2023-09-15T17:20:36,Zarautz,Expense,leisure,-84.37,-35787.2
buyer_2,Carmen,40,ES70209504723955028443,TRX_N-00738-79041063,2023-09-16T17:21:17,Zarautz,Expense,education,-49.02,-35836.22
buyer_2,Carmen,40,ES70209504723955028443,TRX_N-00739-69200824,2023-09-16T13:18:11,Zarautz,Expense,cash,-100.0,-35936.22
buyer_2,Carmen,40,ES70209504723955028443,TRX_N-00740-68862715,2023-09-18T10:47:08,Zarautz,Expense,food,-64.32,-36000.54
buyer_2,Carmen,40,ES70209504723955028443,TRX_N-00741-67163224,2023-09-18T08:42:18,Zarautz,Expense,repairs,-112.84,-36113.38
buyer_2,Carmen,40,ES70209504723955028443,TRX_N-00742-10750536,2023-09-20T21:08:33,Zarautz,Expense,leisure,-77.2,-36190.58
buyer_2,Carmen,40,ES70209504723955028443,TRX_N-00743-29724584,2023-09-20T05:44:47,Zarautz,Expense,cash,-100.0,-36290.58
buyer_2,Carmen,40,ES70209504723955028443,TRX_N-00744-67821177,2023-09-20T11:28:26,Zarautz,Expense,repairs,-136.66,-36427.24
buyer_2,Carmen,40,ES70209504723955028443,TRX_N-00745-53398110,2023-09-23T12:48:01,Zarautz,Expense,transport,-72.95,-36500.19
buyer_2,Carmen,40,ES70209504723955028443,TRX_N-00746-70202208,2023-09-23T20:50:53,Zarautz,Expense,leisure,-42.1,-36542.29
buyer_2,Carmen,40,ES70209504723955028443,TRX_N-00747-82332095,2023-09-27T17:23:39,Elciego,Expense,leisure,-50.42,-36592.71
buyer_2,Carmen,40,ES70209504723955028443,TRX_N-00748-97908717,2023-09-27T15:34:24,Zarautz,Expense,cash,-100.0,-36692.71
buyer_2,Carmen,40,ES70209504723955028443,TRX_N-00749-72554383,2023-09-28T11:24:31,Zarautz,Expense,transport,-59.78,-36752.49
buyer_2,Carmen,40,ES70209504723955028443,TRX_N-00750-42092174,2023-09-29T17:16:33,Zarautz,Expense,clothing,-71.24,-36823.73
buyer_2,Carmen,40,ES70209504723955028443,TRX_N-00751-18936365,2023-10-01T13:56:13,Zarautz,incomes,salary,1263.46,-35560.27
buyer_2,Carmen,40,ES70209504723955028443,TRX_N-00752-39139385,2023-10-01T13:56:13,Zarautz,incomes,salary_partner,1531.39,-34028.88
buyer_2,Carmen,40,ES70209504723955028443,TRX_N-00753-72584245,2023-10-01T13:56:13,Zarautz,incomes,extra_income,122.27,-33906.61
buyer_2,Carmen,40,ES70209504723955028443,TRX_N-00754-30893612,2023-10-01T17:23:34,Zarautz,expenses,children,-121.76,-34028.37
buyer_2,Carmen,40,ES70209504723955028443,TRX_N-00755-40827443,2023-10-02T20:40:07,Oy√≥n-Oion,Expense,transport,-85.76,-34114.13
buyer_2,Carmen,40,ES70209504723955028443,TRX_N-00756-32813693,2023-10-02T12:55:49,Zarautz,Expense,gifts,-599.39,-34713.52
buyer_2,Carmen,40,ES70209504723955028443,TRX_N-00757-77602086,2023-10-04T20:44:39,Zarautz,expenses,mortgage,-1033.24,-35746.76
buyer_2,Carmen,40,ES70209504723955028443,TRX_N-00758-03639716,2023-10-04T18:14:14,Berango,Expense,healthcare,-42.53,-35789.29
buyer_2,Carmen,40,ES70209504723955028443,TRX_N-00759-93743172,2023-10-04T10:49:09,Zarautz,Expense,cash,-100.0,-35889.29
buyer_2,Carmen,40,ES70209504723955028443,TRX_N-00760-61766507,2023-10-07T09:30:11,Zarautz,expenses,electricity,-87.74,-35977.03
buyer_2,Carmen,40,ES70209504723955028443,TRX_N-00761-08553835,2023-10-07T10:31:36,Zarautz,expenses,gas,-46.58,-36023.61
buyer_2,Carmen,40,ES70209504723955028443,TRX_N-00762-76570051,2023-10-07T15:10:37,Zarautz,Expense,education,-54.74,-36078.35
buyer_2,Carmen,40,ES70209504723955028443,TRX_N-00763-86952542,2023-10-08T19:57:56,Zarautz,expenses,internet,-42.0,-36120.35
buyer_2,Carmen,40,ES70209504723955028443,TRX_N-00764-53711239,2023-10-08T09:24:59,Zarautz,expenses,water,-33.64,-36153.99
buyer_2,Carmen,40,ES70209504723955028443,TRX_N-00765-44777634,2023-10-08T15:50:55,Zarautz,expenses,phone,-35.46,-36189.45
buyer_2,Carmen,40,ES70209504723955028443,TRX_N-00766-49993380,2023-10-08T03:22:37,Zarautz,Expense,cash,-100.0,-36289.45
buyer_2,Carmen,40,ES70209504723955028443,TRX_N-00767-09231913,2023-10-10T12:32:21,Alegr√≠a-Dulantzi,Expense,clothing,-120.05,-36409.5
buyer_2,Carmen,40,ES70209504723955028443,TRX_N-00768-13571777,2023-10-13T16:49:33,Zarautz,Expense,food,-86.63,-36496.13
buyer_2,Carmen,40,ES70209504723955028443,TRX_N-00769-99497813,2023-10-14T09:31:47,Zarautz,Expense,clothing,-63.14,-36559.27
buyer_2,Carmen,40,ES70209504723955028443,TRX_N-00770-98953488,2023-10-15T15:29:33,Zarautz,Expense,transport,-58.76,-36618.03
buyer_2,Carmen,40,ES70209504723955028443,TRX_N-00771-94187350,2023-10-15T15:41:37,Zarautz,Expense,leisure,-27.08,-36645.11
buyer_2,Carmen,40,ES70209504723955028443,TRX_N-00772-97433059,2023-10-15T15:10:53,Iru√±a de Oca,Expense,repairs,-90.77,-36735.88
buyer_2,Carmen,40,ES70209504723955028443,TRX_N-00773-18762523,2023-10-17T15:14:02,Zarautz,Expense,clothing,-154.45,-36890.33
buyer_2,Carmen,40,ES70209504723955028443,TRX_N-00774-13805830,2023-10-17T10:02:21,Zarautz,Expense,education,-65.78,-36956.11
buyer_2,Carmen,40,ES70209504723955028443,TRX_N-00775-32554238,2023-10-17T12:41:03,Labastida,Expense,repairs,-237.79,-37193.9
buyer_2,Carmen,40,ES70209504723955028443,TRX_N-00776-95041644,2023-10-18T14:35:28,Zarautz,Expense,clothing,-51.27,-37245.17
buyer_2,Carmen,40,ES70209504723955028443,TRX_N-00777-29644242,2023-10-19T15:00:45,Zarautz,Expense,cash,-100.0,-37345.17
buyer_2,Carmen,40,ES70209504723955028443,TRX_N-00778-20155114,2023-10-19T08:13:59,Zarautz,Expense,repairs,-61.17,-37406.34
buyer_2,Carmen,40,ES70209504723955028443,TRX_N-00779-16625270,2023-10-20T15:29:26,Zarautz,Expense,appliances,-138.03,-37544.37
buyer_2,Carmen,40,ES70209504723955028443,TRX_N-00780-04157465,2023-10-21T16:38:22,Zarautz,Expense,gifts,-381.54,-37925.91
buyer_2,Carmen,40,ES70209504723955028443,TRX_N-00781-30539646,2023-10-22T15:24:23,Zarautz,Expense,leisure,-38.01,-37963.92
buyer_2,Carmen,40,ES70209504723955028443,TRX_N-00782-24296489,2023-10-25T16:00:00,Zarautz,Expense,food,-65.27,-38029.19
buyer_2,Carmen,40,ES70209504723955028443,TRX_N-00783-42722935,2023-10-28T12:20:21,Zarautz,Expense,gifts,-110.01,-38139.2
buyer_2,Carmen,40,ES70209504723955028443,TRX_N-00784-59379840,2023-10-29T16:53:09,Zarautz,Expense,cash,-100.0,-38239.2
buyer_2,Carmen,40,ES70209504723955028443,TRX_N-00785-17189602,2023-10-31T20:27:04,Zarautz,Expense,repairs,-185.42,-38424.62
buyer_2,Carmen,40,ES70209504723955028443,TRX_N-00786-06261519,2023-11-01T04:52:53,Zarautz,incomes,salary,1263.46,-37161.16
buyer_2,Carmen,40,ES70209504723955028443,TRX_N-00787-03726588,2023-11-01T04:52:53,Zarautz,incomes,salary_partner,1531.39,-35629.77
buyer_2,Carmen,40,ES70209504723955028443,TRX_N-00788-58382594,2023-11-01T10:55:08,Zarautz,Expense,food,-110.38,-35740.15
buyer_2,Carmen,40,ES70209504723955028443,TRX_N-00789-88780134,2023-11-01T17:11:07,Llodio,Expense,repairs,-42.64,-35782.79
buyer_2,Carmen,40,ES70209504723955028443,TRX_N-00790-24701765,2023-11-02T19:04:24,Zarautz,Expense,cash,-100.0,-35882.79
buyer_2,Carmen,40,ES70209504723955028443,TRX_N-00791-36147984,2023-11-04T12:05:46,Zarautz,expenses,mortgage,-1033.24,-36916.03
buyer_2,Carmen,40,ES70209504723955028443,TRX_N-00792-24160137,2023-11-04T17:57:16,Zarautz,Expense,cash,-100.0,-37016.03
buyer_2,Carmen,40,ES70209504723955028443,TRX_N-00793-33101560,2023-11-05T13:42:42,Zarautz,expenses,phone,-33.41,-37049.44
buyer_2,Carmen,40,ES70209504723955028443,TRX_N-00794-67756174,2023-11-06T15:00:14,Zarautz,expenses,water,-35.43,-37084.87
buyer_2,Carmen,40,ES70209504723955028443,TRX_N-00795-79807407,2023-11-06T14:42:57,Zarautz,expenses,electricity,-75.34,-37160.21
buyer_2,Carmen,40,ES70209504723955028443,TRX_N-00796-06809317,2023-11-07T06:26:11,Zarautz,expenses,internet,-42.0,-37202.21
buyer_2,Carmen,40,ES70209504723955028443,TRX_N-00797-68538136,2023-11-07T13:50:03,Zarautz,Expense,education,-42.66,-37244.87
buyer_2,Carmen,40,ES70209504723955028443,TRX_N-00798-20970545,2023-11-07T18:49:31,Zarautz,Expense,gifts,-351.36,-37596.23
buyer_2,Carmen,40,ES70209504723955028443,TRX_N-00799-36374500,2023-11-08T12:11:04,Zarautz,expenses,gas,-45.57,-37641.8
buyer_2,Carmen,40,ES70209504723955028443,TRX_N-00800-13555274,2023-11-09T01:36:12,Zarautz,Expense,healthcare,-103.92,-37745.72
buyer_2,Carmen,40,ES70209504723955028443,TRX_N-00801-10261080,2023-11-11T19:34:34,Zarautz,Expense,food,-93.17,-37838.89
buyer_2,Carmen,40,ES70209504723955028443,TRX_N-00802-30196973,2023-11-11T20:50:42,Zarautz,Expense,cash,-100.0,-37938.89
buyer_2,Carmen,40,ES70209504723955028443,TRX_N-00803-26772468,2023-11-12T10:49:58,Berango,Expense,food,-67.04,-38005.93
buyer_2,Carmen,40,ES70209504723955028443,TRX_N-00804-23939248,2023-11-13T12:11:04,Zarautz,Expense,food,-103.3,-38109.23
buyer_2,Carmen,40,ES70209504723955028443,TRX_N-00805-39389530,2023-11-13T10:34:09,Zarautz,Expense,leisure,-56.08,-38165.31
buyer_2,Carmen,40,ES70209504723955028443,TRX_N-00806-20792929,2023-11-14T19:55:16,Donostia,Expense,food,-63.34,-38228.65
buyer_2,Carmen,40,ES70209504723955028443,TRX_N-00807-42786469,2023-11-17T11:30:21,Zarautz,Expense,leisure,-77.56,-38306.21
buyer_2,Carmen,40,ES70209504723955028443,TRX_N-00808-53999666,2023-11-18T18:56:12,Santurtzi,Expense,food,-76.34,-38382.55
buyer_2,Carmen,40,ES70209504723955028443,TRX_N-00809-50995290,2023-11-20T14:35:41,Zarautz,Expense,cash,-100.0,-38482.55
buyer_2,Carmen,40,ES70209504723955028443,TRX_N-00810-93669264,2023-11-20T09:54:51,Zarautz,expenses,children,-107.49,-38590.04
buyer_2,Carmen,40,ES70209504723955028443,TRX_N-00811-47073047,2023-11-22T11:07:46,Zarautz,Expense,transport,-54.04,-38644.08
buyer_2,Carmen,40,ES70209504723955028443,TRX_N-00812-46627985,2023-11-23T20:12:56,Zarautz,Expense,clothing,-100.56,-38744.64
buyer_2,Carmen,40,ES70209504723955028443,TRX_N-00813-12704583,2023-11-23T08:22:28,Durango,Expense,repairs,-162.23,-38906.87
buyer_2,Carmen,40,ES70209504723955028443,TRX_N-00814-25278464,2023-11-24T14:46:23,Zarautz,Expense,leisure,-68.05,-38974.92
buyer_2,Carmen,40,ES70209504723955028443,TRX_N-00815-34932818,2023-11-24T09:02:08,Erandio,Expense,cash,-100.0,-39074.92
buyer_2,Carmen,40,ES70209504723955028443,TRX_N-00816-32842376,2023-11-25T08:43:27,Barakaldo,Expense,gifts,-539.89,-39614.81
buyer_2,Carmen,40,ES70209504723955028443,TRX_N-00817-04057288,2023-11-27T08:59:13,Zarautz,Expense,healthcare,-77.36,-39692.17
buyer_2,Carmen,40,ES70209504723955028443,TRX_N-00818-22085463,2023-11-28T11:06:16,Hernani,Expense,food,-66.18,-39758.35
buyer_2,Carmen,40,ES70209504723955028443,TRX_N-00819-73268729,2023-11-30T18:30:14,Llodio,Expense,cash,-100.0,-39858.35
buyer_2,Carmen,40,ES70209504723955028443,TRX_N-00820-00885293,2023-12-01T11:54:01,Zarautz,incomes,salary,1263.46,-38594.89
buyer_2,Carmen,40,ES70209504723955028443,TRX_N-00821-63488036,2023-12-01T11:54:01,Zarautz,incomes,salary_partner,1531.39,-37063.5
buyer_2,Carmen,40,ES70209504723955028443,TRX_N-00822-54271354,2023-12-01T11:54:01,Zarautz,incomes,salary_bonus,933.93,-36129.57
buyer_2,Carmen,40,ES70209504723955028443,TRX_N-00823-66308325,2023-12-01T11:54:01,Zarautz,incomes,salary_partner_bonus,1167.92,-34961.65
buyer_2,Carmen,40,ES70209504723955028443,TRX_N-00824-10399858,2023-12-01T16:12:32,Zarautz,Expense,leisure,-70.53,-35032.18
buyer_2,Carmen,40,ES70209504723955028443,TRX_N-00825-66101743,2023-12-02T00:36:10,Llodio,Expense,food,-89.84,-35122.02
buyer_2,Carmen,40,ES70209504723955028443,TRX_N-00826-95600191,2023-12-03T11:12:04,Iru√±a de Oca,Expense,transport,-82.37,-35204.39
buyer_2,Carmen,40,ES70209504723955028443,TRX_N-00827-70379559,2023-12-03T17:54:47,Zarautz,Expense,cash,-100.0,-35304.39
buyer_2,Carmen,40,ES70209504723955028443,TRX_N-00828-15856059,2023-12-04T11:52:46,Zarautz,expenses,mortgage,-1033.24,-36337.63
buyer_2,Carmen,40,ES70209504723955028443,TRX_N-00829-75080700,2023-12-04T20:43:38,Zarautz,Expense,transport,-74.74,-36412.37
buyer_2,Carmen,40,ES70209504723955028443,TRX_N-00830-47582768,2023-12-05T17:09:08,Zarautz,Expense,leisure,-81.21,-36493.58
buyer_2,Carmen,40,ES70209504723955028443,TRX_N-00831-56980022,2023-12-05T09:16:45,Zarautz,expenses,children,-231.29,-36724.87
buyer_2,Carmen,40,ES70209504723955028443,TRX_N-00832-16984774,2023-12-06T08:49:55,Zarautz,expenses,electricity,-70.48,-36795.35
buyer_2,Carmen,40,ES70209504723955028443,TRX_N-00833-25694252,2023-12-06T11:00:14,Zarautz,expenses,phone,-30.54,-36825.89
buyer_2,Carmen,40,ES70209504723955028443,TRX_N-00834-37497427,2023-12-06T13:25:12,Zarautz,Expense,leisure,-59.78,-36885.67
buyer_2,Carmen,40,ES70209504723955028443,TRX_N-00835-27983576,2023-12-06T08:20:36,Zarautz,Expense,travel,-1285.95,-38171.62
buyer_2,Carmen,40,ES70209504723955028443,TRX_N-00836-44691208,2023-12-08T05:47:05,Zarautz,expenses,internet,-42.0,-38213.62
buyer_2,Carmen,40,ES70209504723955028443,TRX_N-00837-76917358,2023-12-08T17:20:08,Zarautz,expenses,water,-20.06,-38233.68
buyer_2,Carmen,40,ES70209504723955028443,TRX_N-00838-71737796,2023-12-08T14:33:44,Zarautz,expenses,gas,-91.66,-38325.34
buyer_2,Carmen,40,ES70209504723955028443,TRX_N-00839-62452665,2023-12-08T08:04:44,Zarautz,Expense,food,-101.57,-38426.91
buyer_2,Carmen,40,ES70209504723955028443,TRX_N-00840-23474263,2023-12-09T19:21:06,Zarautz,Expense,leisure,-38.97,-38465.88
buyer_2,Carmen,40,ES70209504723955028443,TRX_N-00841-64924565,2023-12-09T08:10:04,Zarautz,Expense,appliances,-371.2,-38837.08
buyer_2,Carmen,40,ES70209504723955028443,TRX_N-00842-70123827,2023-12-10T00:27:50,Zarautz,Expense,transport,-88.56,-38925.64
buyer_2,Carmen,40,ES70209504723955028443,TRX_N-00843-20217493,2023-12-10T15:31:33,Zarautz,Expense,gifts,-548.17,-39473.81
buyer_2,Carmen,40,ES70209504723955028443,TRX_N-00844-71528560,2023-12-11T16:43:09,Zarautz,Expense,transport,-82.8,-39556.61
buyer_2,Carmen,40,ES70209504723955028443,TRX_N-00845-07385491,2023-12-13T13:51:57,Zarautz,Expense,food,-105.11,-39661.72
buyer_2,Carmen,40,ES70209504723955028443,TRX_N-00846-42123205,2023-12-13T11:14:42,Pasaia,Expense,cash,-100.0,-39761.72
buyer_2,Carmen,40,ES70209504723955028443,TRX_N-00847-38117503,2023-12-15T23:53:51,Zarautz,Expense,food,-109.1,-39870.82
buyer_2,Carmen,40,ES70209504723955028443,TRX_N-00848-65051266,2023-12-15T10:21:07,Pasaia,Expense,cash,-100.0,-39970.82
buyer_2,Carmen,40,ES70209504723955028443,TRX_N-00849-20636039,2023-12-16T17:13:03,Arrasate,Expense,cash,-100.0,-40070.82
buyer_2,Carmen,40,ES70209504723955028443,TRX_N-00850-92997083,2023-12-16T13:57:42,Hondarribia,Expense,gifts,-795.56,-40866.38
buyer_2,Carmen,40,ES70209504723955028443,TRX_N-00851-56638906,2023-12-17T21:11:43,Zarautz,Expense,cash,-100.0,-40966.38
buyer_2,Carmen,40,ES70209504723955028443,TRX_N-00852-25693503,2023-12-17T14:14:55,Zarautz,Expense,gifts,-344.74,-41311.12
buyer_2,Carmen,40,ES70209504723955028443,TRX_N-00853-23504279,2023-12-18T14:50:54,Leioa,Expense,repairs,-71.74,-41382.86
buyer_2,Carmen,40,ES70209504723955028443,TRX_N-00854-56269694,2023-12-20T21:00:00,Zarautz,Expense,food,-90.84,-41473.7
buyer_2,Carmen,40,ES70209504723955028443,TRX_N-00855-13143184,2023-12-21T20:49:28,Zarautz,Expense,cash,-100.0,-41573.7
buyer_2,Carmen,40,ES70209504723955028443,TRX_N-00856-64903461,2023-12-23T14:51:09,Zarautz,Expense,leisure,-72.32,-41646.02
buyer_2,Carmen,40,ES70209504723955028443,TRX_N-00857-80132783,2023-12-23T21:27:24,Oy√≥n-Oion,Expense,healthcare,-124.17,-41770.19
buyer_2,Carmen,40,ES70209504723955028443,TRX_N-00858-52458441,2023-12-24T15:01:35,Zarautz,Expense,clothing,-98.03,-41868.22
buyer_2,Carmen,40,ES70209504723955028443,TRX_N-00859-42093949,2023-12-24T12:09:49,Zarautz,Expense,appliances,-363.81,-42232.03
buyer_2,Carmen,40,ES70209504723955028443,TRX_N-00860-88609089,2023-12-24T08:52:51,Pasaia,Expense,repairs,-328.45,-42560.48
buyer_2,Carmen,40,ES70209504723955028443,TRX_N-00861-52227872,2023-12-25T09:58:08,Zarautz,Expense,food,-90.74,-42651.22
buyer_2,Carmen,40,ES70209504723955028443,TRX_N-00862-26085420,2023-12-25T17:19:30,Zarautz,Expense,leisure,-62.71,-42713.93
buyer_2,Carmen,40,ES70209504723955028443,TRX_N-00863-58518524,2023-12-27T10:46:52,Zarautz,Expense,leisure,-68.55,-42782.48
buyer_2,Carmen,40,ES70209504723955028443,TRX_N-00864-94442970,2023-12-27T15:23:07,Zarautz,Expense,cash,-100.0,-42882.48
buyer_2,Carmen,40,ES70209504723955028443,TRX_N-00865-56878514,2023-12-28T10:05:23,Zarautz,Expense,transport,-45.22,-42927.7
buyer_2,Carmen,40,ES70209504723955028443,TRX_N-00866-03641184,2023-12-29T14:00:59,Zarautz,Expense,repairs,-28.55,-42956.25
buyer_2,Carmen,40,ES70209504723955028443,TRX_N-00867-68885419,2023-12-31T18:17:20,Zarautz,Expense,cash,-100.0,-43056.25
buyer_2,Carmen,40,ES70209504723955028443,TRX_N-00868-69160170,2024-01-01T12:19:03,Zarautz,incomes,salary,1300.39,-41755.86
buyer_2,Carmen,40,ES70209504723955028443,TRX_N-00869-03469878,2024-01-01T12:19:03,Zarautz,incomes,salary_partner,1576.15,-40179.71
buyer_2,Carmen,40,ES70209504723955028443,TRX_N-00870-48579535,2024-01-02T16:41:51,Zarautz,Expense,leisure,-61.08,-40240.79
buyer_2,Carmen,40,ES70209504723955028443,TRX_N-00871-89831740,2024-01-02T15:17:03,Zarautz,Expense,education,-53.01,-40293.8
buyer_2,Carmen,40,ES70209504723955028443,TRX_N-00872-68335217,2024-01-02T11:18:01,Zarautz,Expense,cash,-100.0,-40393.8
buyer_2,Carmen,40,ES70209504723955028443,TRX_N-00873-81728788,2024-01-02T13:29:47,Zarautz,Expense,repairs,-142.6,-40536.4
buyer_2,Carmen,40,ES70209504723955028443,TRX_N-00874-52360610,2024-01-03T17:59:56,Galdakao,Expense,food,-124.24,-40660.64
buyer_2,Carmen,40,ES70209504723955028443,TRX_N-00875-71077311,2024-01-03T16:45:43,Zarautz,Expense,healthcare,-145.56,-40806.2
buyer_2,Carmen,40,ES70209504723955028443,TRX_N-00876-57043679,2024-01-04T19:18:24,Zarautz,expenses,mortgage,-1033.24,-41839.44
buyer_2,Carmen,40,ES70209504723955028443,TRX_N-00877-87295114,2024-01-05T10:59:33,Zarautz,expenses,electricity,-78.5,-41917.94
buyer_2,Carmen,40,ES70209504723955028443,TRX_N-00878-42403576,2024-01-05T23:22:56,Zarautz,expenses,internet,-42.0,-41959.94
buyer_2,Carmen,40,ES70209504723955028443,TRX_N-00879-42043995,2024-01-06T20:35:51,Zarautz,expenses,phone,-44.45,-42004.39
buyer_2,Carmen,40,ES70209504723955028443,TRX_N-00880-31360976,2024-01-06T13:07:51,Zarautz,Expense,food,-114.88,-42119.27
buyer_2,Carmen,40,ES70209504723955028443,TRX_N-00881-48100932,2024-01-06T09:05:41,Zarautz,Expense,cash,-100.0,-42219.27
buyer_2,Carmen,40,ES70209504723955028443,TRX_N-00882-74313097,2024-01-07T20:52:39,Zarautz,expenses,gas,-60.14,-42279.41
buyer_2,Carmen,40,ES70209504723955028443,TRX_N-00883-10022799,2024-01-08T20:20:54,Zarautz,expenses,water,-31.44,-42310.85
buyer_2,Carmen,40,ES70209504723955028443,TRX_N-00884-44653434,2024-01-10T06:01:12,Zarautz,Expense,education,-66.25,-42377.1
buyer_2,Carmen,40,ES70209504723955028443,TRX_N-00885-39016033,2024-01-13T14:58:29,Zarautz,expenses,children,-169.24,-42546.34
buyer_2,Carmen,40,ES70209504723955028443,TRX_N-00886-64011453,2024-01-14T12:51:10,Zarautz,Expense,leisure,-80.25,-42626.59
buyer_2,Carmen,40,ES70209504723955028443,TRX_N-00887-97627807,2024-01-14T23:56:21,Zuia,Expense,clothing,-116.14,-42742.73
buyer_2,Carmen,40,ES70209504723955028443,TRX_N-00888-85062290,2024-01-14T17:30:46,Labastida,Expense,cash,-100.0,-42842.73
buyer_2,Carmen,40,ES70209504723955028443,TRX_N-00889-61404238,2024-01-15T22:14:29,Zarautz,Expense,food,-79.61,-42922.34
buyer_2,Carmen,40,ES70209504723955028443,TRX_N-00890-70508912,2024-01-15T13:47:56,Zarautz,Expense,leisure,-70.92,-42993.26
buyer_2,Carmen,40,ES70209504723955028443,TRX_N-00891-36471246,2024-01-15T20:59:49,Zarautz,expenses,children,-158.76,-43152.02
buyer_2,Carmen,40,ES70209504723955028443,TRX_N-00892-85078775,2024-01-16T14:24:02,Zarautz,Expense,leisure,-22.14,-43174.16
buyer_2,Carmen,40,ES70209504723955028443,TRX_N-00893-67958623,2024-01-16T09:32:27,Zarautz,Expense,repairs,-91.21,-43265.37
buyer_2,Carmen,40,ES70209504723955028443,TRX_N-00894-46307953,2024-01-17T14:28:18,Zarautz,Expense,leisure,-53.44,-43318.81
buyer_2,Carmen,40,ES70209504723955028443,TRX_N-00895-15169345,2024-01-18T09:39:44,Zarautz,Expense,education,-54.41,-43373.22
buyer_2,Carmen,40,ES70209504723955028443,TRX_N-00896-33506898,2024-01-19T16:17:41,Zarautz,Expense,food,-63.73,-43436.95
buyer_2,Carmen,40,ES70209504723955028443,TRX_N-00897-89995866,2024-01-19T08:30:09,Zarautz,Expense,leisure,-25.65,-43462.6
buyer_2,Carmen,40,ES70209504723955028443,TRX_N-00898-34635739,2024-01-19T10:04:04,Zuia,Expense,clothing,-125.13,-43587.73
buyer_2,Carmen,40,ES70209504723955028443,TRX_N-00899-75011264,2024-01-19T14:54:05,Zarautz,Expense,travel,-1494.86,-45082.59
buyer_2,Carmen,40,ES70209504723955028443,TRX_N-00900-15915987,2024-01-21T11:37:52,Zarautz,Expense,clothing,-96.79,-45179.38
buyer_2,Carmen,40,ES70209504723955028443,TRX_N-00901-58757132,2024-01-23T18:18:49,Zarautz,Expense,food,-108.08,-45287.46
buyer_2,Carmen,40,ES70209504723955028443,TRX_N-00902-99939885,2024-01-23T21:35:40,Zarautz,Expense,cash,-100.0,-45387.46
buyer_2,Carmen,40,ES70209504723955028443,TRX_N-00903-55913852,2024-01-23T08:49:14,Erandio,Expense,appliances,-206.62,-45594.08
buyer_2,Carmen,40,ES70209504723955028443,TRX_N-00904-01701120,2024-01-24T19:53:58,Zarautz,Expense,transport,-54.34,-45648.42
buyer_2,Carmen,40,ES70209504723955028443,TRX_N-00905-38547553,2024-01-24T19:48:33,Zarautz,Expense,healthcare,-167.1,-45815.52
buyer_2,Carmen,40,ES70209504723955028443,TRX_N-00906-39047421,2024-01-24T15:49:48,Zarautz,Expense,cash,-100.0,-45915.52
buyer_2,Carmen,40,ES70209504723955028443,TRX_N-00907-22288029,2024-01-25T15:40:32,Bilbao,Expense,cash,-100.0,-46015.52
buyer_2,Carmen,40,ES70209504723955028443,TRX_N-00908-26603702,2024-01-28T15:20:37,Zarautz,Expense,leisure,-31.52,-46047.04
buyer_2,Carmen,40,ES70209504723955028443,TRX_N-00909-07057433,2024-01-30T21:11:18,Zarautz,Expense,leisure,-19.31,-46066.35
buyer_2,Carmen,40,ES70209504723955028443,TRX_N-00910-13504708,2024-01-31T19:43:12,Zarautz,Expense,leisure,-67.37,-46133.72
buyer_2,Carmen,40,ES70209504723955028443,TRX_N-00911-91490560,2024-02-01T23:32:00,Zarautz,incomes,salary,1300.39,-44833.33
buyer_2,Carmen,40,ES70209504723955028443,TRX_N-00912-69560606,2024-02-01T23:32:00,Zarautz,incomes,salary_partner,1576.15,-43257.18
buyer_2,Carmen,40,ES70209504723955028443,TRX_N-00913-56630087,2024-02-01T23:32:00,Zarautz,incomes,extra_income,122.27,-43134.91
buyer_2,Carmen,40,ES70209504723955028443,TRX_N-00914-94783699,2024-02-01T12:38:23,Zarautz,Expense,repairs,-258.61,-43393.52
buyer_2,Carmen,40,ES70209504723955028443,TRX_N-00915-59863767,2024-02-03T17:12:13,Andoain,Expense,transport,-80.12,-43473.64
buyer_2,Carmen,40,ES70209504723955028443,TRX_N-00916-98682281,2024-02-03T15:16:33,Zarautz,Expense,cash,-100.0,-43573.64
buyer_2,Carmen,40,ES70209504723955028443,TRX_N-00917-70168312,2024-02-04T08:08:16,Zarautz,expenses,mortgage,-1033.24,-44606.88
buyer_2,Carmen,40,ES70209504723955028443,TRX_N-00918-30182937,2024-02-04T13:28:32,Zarautz,expenses,children,-247.01,-44853.89
buyer_2,Carmen,40,ES70209504723955028443,TRX_N-00919-25480630,2024-02-05T03:39:52,Zarautz,Expense,food,-103.42,-44957.31
buyer_2,Carmen,40,ES70209504723955028443,TRX_N-00920-49458749,2024-02-05T21:39:50,Zarautz,Expense,leisure,-19.43,-44976.74
buyer_2,Carmen,40,ES70209504723955028443,TRX_N-00921-32009377,2024-02-06T07:08:36,Zarautz,expenses,electricity,-29.43,-45006.17
buyer_2,Carmen,40,ES70209504723955028443,TRX_N-00922-79483941,2024-02-07T18:55:15,Zarautz,expenses,internet,-42.0,-45048.17
buyer_2,Carmen,40,ES70209504723955028443,TRX_N-00923-62317019,2024-02-07T02:14:08,Zarautz,expenses,phone,-43.41,-45091.58
buyer_2,Carmen,40,ES70209504723955028443,TRX_N-00924-06240216,2024-02-07T16:47:35,Irun,Expense,education,-74.73,-45166.31
buyer_2,Carmen,40,ES70209504723955028443,TRX_N-00925-64045712,2024-02-08T19:20:24,Zarautz,expenses,water,-30.22,-45196.53
buyer_2,Carmen,40,ES70209504723955028443,TRX_N-00926-80785251,2024-02-08T23:51:24,Zarautz,expenses,gas,-94.15,-45290.68
buyer_2,Carmen,40,ES70209504723955028443,TRX_N-00927-05342888,2024-02-10T09:15:06,Zarautz,Expense,food,-75.95,-45366.63
buyer_2,Carmen,40,ES70209504723955028443,TRX_N-00928-15461178,2024-02-10T21:19:47,Mungia,Expense,clothing,-49.39,-45416.02
buyer_2,Carmen,40,ES70209504723955028443,TRX_N-00929-46567971,2024-02-11T20:07:09,Zarautz,Expense,food,-115.88,-45531.9
buyer_2,Carmen,40,ES70209504723955028443,TRX_N-00930-78410019,2024-02-12T14:37:33,Labastida,Expense,food,-89.53,-45621.43
buyer_2,Carmen,40,ES70209504723955028443,TRX_N-00931-94292175,2024-02-12T20:27:06,Elciego,Expense,leisure,-64.25,-45685.68
buyer_2,Carmen,40,ES70209504723955028443,TRX_N-00932-53067510,2024-02-12T14:13:27,Zarautz,Expense,clothing,-149.07,-45834.75
buyer_2,Carmen,40,ES70209504723955028443,TRX_N-00933-35771150,2024-02-13T17:47:55,Zarautz,Expense,clothing,-102.28,-45937.03
buyer_2,Carmen,40,ES70209504723955028443,TRX_N-00934-72854491,2024-02-15T16:13:13,Zarautz,Expense,education,-59.12,-45996.15
buyer_2,Carmen,40,ES70209504723955028443,TRX_N-00935-48136340,2024-02-16T12:02:47,Zarautz,Expense,food,-104.37,-46100.52
buyer_2,Carmen,40,ES70209504723955028443,TRX_N-00936-87628904,2024-02-18T10:26:45,Zarautz,Expense,clothing,-158.93,-46259.45
buyer_2,Carmen,40,ES70209504723955028443,TRX_N-00937-00183323,2024-02-19T17:47:43,Pasaia,Expense,leisure,-74.64,-46334.09
buyer_2,Carmen,40,ES70209504723955028443,TRX_N-00938-44186697,2024-02-20T06:23:44,Zarautz,Expense,transport,-68.24,-46402.33
buyer_2,Carmen,40,ES70209504723955028443,TRX_N-00939-75048521,2024-02-20T16:56:05,Zarautz,Expense,leisure,-79.7,-46482.03
buyer_2,Carmen,40,ES70209504723955028443,TRX_N-00940-21464479,2024-02-20T08:28:24,Zarautz,Expense,education,-74.96,-46556.99
buyer_2,Carmen,40,ES70209504723955028443,TRX_N-00941-25277913,2024-02-22T08:29:08,Zarautz,Expense,gifts,-510.56,-47067.55
buyer_2,Carmen,40,ES70209504723955028443,TRX_N-00942-50954623,2024-02-23T15:07:00,Zarautz,Expense,food,-83.74,-47151.29
buyer_2,Carmen,40,ES70209504723955028443,TRX_N-00943-66647528,2024-02-23T20:53:34,Portugalete,Expense,appliances,-366.42,-47517.71
buyer_2,Carmen,40,ES70209504723955028443,TRX_N-00944-50386556,2024-02-25T14:53:46,Zarautz,Expense,clothing,-139.47,-47657.18
buyer_2,Carmen,40,ES70209504723955028443,TRX_N-00945-73912554,2024-02-25T03:52:09,Zarautz,Expense,healthcare,-164.29,-47821.47
buyer_2,Carmen,40,ES70209504723955028443,TRX_N-00946-43893680,2024-02-25T20:04:52,Zarautz,Expense,travel,-1471.54,-49293.01
buyer_2,Carmen,40,ES70209504723955028443,TRX_N-00947-51695339,2024-02-29T14:30:42,Arrasate,Expense,leisure,-33.52,-49326.53
buyer_2,Carmen,40,ES70209504723955028443,TRX_N-00948-32044409,2024-02-29T08:56:00,Zarautz,Expense,repairs,-310.99,-49637.52
buyer_2,Carmen,40,ES70209504723955028443,TRX_N-00949-86016843,2024-03-01T09:34:29,Zarautz,incomes,salary,1300.39,-48337.13
buyer_2,Carmen,40,ES70209504723955028443,TRX_N-00950-53181770,2024-03-01T09:34:29,Zarautz,incomes,salary_partner,1576.15,-46760.98
buyer_2,Carmen,40,ES70209504723955028443,TRX_N-00951-41586904,2024-03-01T23:15:14,Salvatierra/Agurain,Expense,leisure,-22.94,-46783.92
buyer_2,Carmen,40,ES70209504723955028443,TRX_N-00952-13097216,2024-03-02T18:39:38,Zarautz,Expense,transport,-63.58,-46847.5
buyer_2,Carmen,40,ES70209504723955028443,TRX_N-00953-99649677,2024-03-03T19:36:03,Zarautz,Expense,food,-122.49,-46969.99
buyer_2,Carmen,40,ES70209504723955028443,TRX_N-00954-95444411,2024-03-04T21:53:39,Zarautz,expenses,mortgage,-1033.24,-48003.23
buyer_2,Carmen,40,ES70209504723955028443,TRX_N-00955-74421100,2024-03-04T09:46:09,Zarautz,Expense,gifts,-827.5,-48830.73
buyer_2,Carmen,40,ES70209504723955028443,TRX_N-00956-90924108,2024-03-05T20:49:58,Zarautz,expenses,internet,-42.0,-48872.73
buyer_2,Carmen,40,ES70209504723955028443,TRX_N-00957-69731066,2024-03-05T20:35:17,Lasarte-Oria,Expense,food,-112.49,-48985.22
buyer_2,Carmen,40,ES70209504723955028443,TRX_N-00958-34653169,2024-03-05T12:20:30,Zarautz,Expense,transport,-43.78,-49029.0
buyer_2,Carmen,40,ES70209504723955028443,TRX_N-00959-30558358,2024-03-05T13:30:04,Zarautz,Expense,cash,-100.0,-49129.0
buyer_2,Carmen,40,ES70209504723955028443,TRX_N-00960-23159647,2024-03-06T23:17:33,Zarautz,expenses,water,-36.5,-49165.5
buyer_2,Carmen,40,ES70209504723955028443,TRX_N-00961-88846058,2024-03-06T09:45:03,Zarautz,expenses,electricity,-84.72,-49250.22
buyer_2,Carmen,40,ES70209504723955028443,TRX_N-00962-13193956,2024-03-07T15:19:48,Zarautz,expenses,gas,-70.71,-49320.93
buyer_2,Carmen,40,ES70209504723955028443,TRX_N-00963-58302680,2024-03-07T13:57:50,Zarautz,Expense,transport,-86.37,-49407.3
buyer_2,Carmen,40,ES70209504723955028443,TRX_N-00964-07632283,2024-03-07T12:58:11,Zarautz,Expense,cash,-100.0,-49507.3
buyer_2,Carmen,40,ES70209504723955028443,TRX_N-00965-04203915,2024-03-08T02:02:54,Zarautz,expenses,phone,-35.81,-49543.11
buyer_2,Carmen,40,ES70209504723955028443,TRX_N-00966-17429180,2024-03-08T22:37:55,Zarautz,Expense,cash,-100.0,-49643.11
buyer_2,Carmen,40,ES70209504723955028443,TRX_N-00967-87696333,2024-03-09T05:09:32,Zarautz,Expense,food,-78.73,-49721.84
buyer_2,Carmen,40,ES70209504723955028443,TRX_N-00968-52331567,2024-03-09T23:28:36,Zarautz,Expense,repairs,-142.59,-49864.43
buyer_2,Carmen,40,ES70209504723955028443,TRX_N-00969-89196980,2024-03-09T22:12:50,Zarautz,Expense,gifts,-453.04,-50317.47
buyer_2,Carmen,40,ES70209504723955028443,TRX_N-00970-72309390,2024-03-10T21:24:24,Bermeo,Expense,leisure,-22.58,-50340.05
buyer_2,Carmen,40,ES70209504723955028443,TRX_N-00971-16976018,2024-03-10T14:08:53,Erandio,Expense,gifts,-838.17,-51178.22
buyer_2,Carmen,40,ES70209504723955028443,TRX_N-00972-87781043,2024-03-11T18:21:38,Errenteria,Expense,cash,-100.0,-51278.22
buyer_2,Carmen,40,ES70209504723955028443,TRX_N-00973-90502124,2024-03-12T08:18:04,Zarautz,Expense,gifts,-103.38,-51381.6
buyer_2,Carmen,40,ES70209504723955028443,TRX_N-00974-48824736,2024-03-13T09:34:42,Zarautz,Expense,education,-48.49,-51430.09
buyer_2,Carmen,40,ES70209504723955028443,TRX_N-00975-76215580,2024-03-15T10:58:39,Zarautz,Expense,transport,-68.64,-51498.73
buyer_2,Carmen,40,ES70209504723955028443,TRX_N-00976-45220859,2024-03-17T02:27:09,Zarautz,Expense,repairs,-122.8,-51621.53
buyer_2,Carmen,40,ES70209504723955028443,TRX_N-00977-32970501,2024-03-18T10:54:45,Zarautz,Expense,cash,-100.0,-51721.53
buyer_2,Carmen,40,ES70209504723955028443,TRX_N-00978-13652963,2024-03-20T12:07:00,Zarautz,Expense,cash,-100.0,-51821.53
buyer_2,Carmen,40,ES70209504723955028443,TRX_N-00979-05026633,2024-03-21T13:23:50,Zarautz,Expense,food,-81.72,-51903.25
buyer_2,Carmen,40,ES70209504723955028443,TRX_N-00980-71418051,2024-03-21T22:50:26,Zarautz,Expense,transport,-50.88,-51954.13
buyer_2,Carmen,40,ES70209504723955028443,TRX_N-00981-43978699,2024-03-21T09:53:40,Zarautz,Expense,cash,-100.0,-52054.13
buyer_2,Carmen,40,ES70209504723955028443,TRX_N-00982-91289984,2024-03-24T18:21:33,Zarautz,Expense,healthcare,-98.56,-52152.69
buyer_2,Carmen,40,ES70209504723955028443,TRX_N-00983-07080354,2024-03-25T22:44:28,Hernani,Expense,gifts,-812.74,-52965.43
buyer_2,Carmen,40,ES70209504723955028443,TRX_N-00984-75803267,2024-03-28T08:57:02,Salvatierra/Agurain,Expense,food,-80.56,-53045.99
buyer_2,Carmen,40,ES70209504723955028443,TRX_N-00985-64854186,2024-03-28T08:12:04,Zarautz,Expense,appliances,-227.09,-53273.08
buyer_2,Carmen,40,ES70209504723955028443,TRX_N-00986-53007906,2024-03-29T15:05:50,Zarautz,Expense,cash,-100.0,-53373.08
buyer_2,Carmen,40,ES70209504723955028443,TRX_N-00987-53615954,2024-03-30T14:11:16,Zarautz,Expense,clothing,-81.05,-53454.13
buyer_2,Carmen,40,ES70209504723955028443,TRX_N-00988-70653770,2024-04-01T14:29:27,Zarautz,incomes,salary,1300.39,-52153.74
buyer_2,Carmen,40,ES70209504723955028443,TRX_N-00989-95307186,2024-04-01T14:29:27,Zarautz,incomes,salary_partner,1576.15,-50577.59
buyer_2,Carmen,40,ES70209504723955028443,TRX_N-00990-68581033,2024-04-02T12:19:39,Zarautz,Expense,leisure,-43.13,-50620.72
buyer_2,Carmen,40,ES70209504723955028443,TRX_N-00991-08295768,2024-04-02T15:16:58,Irun,Expense,healthcare,-157.29,-50778.01
buyer_2,Carmen,40,ES70209504723955028443,TRX_N-00992-00360277,2024-04-02T08:21:31,Zarautz,Expense,cash,-100.0,-50878.01
buyer_2,Carmen,40,ES70209504723955028443,TRX_N-00993-94652351,2024-04-03T11:15:18,Zarautz,Expense,food,-105.26,-50983.27
buyer_2,Carmen,40,ES70209504723955028443,TRX_N-00994-57164224,2024-04-03T16:12:33,Zarautz,Expense,leisure,-69.17,-51052.44
buyer_2,Carmen,40,ES70209504723955028443,TRX_N-00995-47468596,2024-04-03T20:00:18,Elciego,Expense,cash,-100.0,-51152.44
buyer_2,Carmen,40,ES70209504723955028443,TRX_N-00996-29963511,2024-04-04T18:18:45,Zarautz,expenses,mortgage,-1033.24,-52185.68
buyer_2,Carmen,40,ES70209504723955028443,TRX_N-00997-12526219,2024-04-05T23:22:48,Zarautz,expenses,water,-33.4,-52219.08
buyer_2,Carmen,40,ES70209504723955028443,TRX_N-00998-86313609,2024-04-05T11:12:39,Berango,Expense,healthcare,-165.99,-52385.07
buyer_2,Carmen,40,ES70209504723955028443,TRX_N-00999-20836326,2024-04-05T20:58:44,Zarautz,Expense,appliances,-385.37,-52770.44
buyer_2,Carmen,40,ES70209504723955028443,TRX_N-01000-19858846,2024-04-06T11:18:26,Zarautz,expenses,gas,-44.31,-52814.75
buyer_2,Carmen,40,ES70209504723955028443,TRX_N-01001-43297767,2024-04-07T10:06:07,Zarautz,expenses,electricity,-89.69,-52904.44
buyer_2,Carmen,40,ES70209504723955028443,TRX_N-01002-87221030,2024-04-07T09:58:26,Zarautz,expenses,children,-158.97,-53063.41
buyer_2,Carmen,40,ES70209504723955028443,TRX_N-01003-60695211,2024-04-08T11:07:56,Zarautz,expenses,internet,-42.0,-53105.41
buyer_2,Carmen,40,ES70209504723955028443,TRX_N-01004-05963337,2024-04-08T11:55:13,Zarautz,expenses,phone,-32.38,-53137.79
buyer_2,Carmen,40,ES70209504723955028443,TRX_N-01005-57461382,2024-04-08T16:08:21,Zarautz,Expense,food,-60.94,-53198.73
buyer_2,Carmen,40,ES70209504723955028443,TRX_N-01006-44771559,2024-04-09T11:55:20,Zarautz,Expense,healthcare,-114.39,-53313.12
buyer_2,Carmen,40,ES70209504723955028443,TRX_N-01007-45114937,2024-04-10T20:27:12,Zarautz,Expense,food,-75.81,-53388.93
buyer_2,Carmen,40,ES70209504723955028443,TRX_N-01008-22804459,2024-04-10T23:18:27,Eibar,Expense,transport,-81.74,-53470.67
buyer_2,Carmen,40,ES70209504723955028443,TRX_N-01009-05461835,2024-04-12T03:15:38,Zarautz,Expense,transport,-74.8,-53545.47
buyer_2,Carmen,40,ES70209504723955028443,TRX_N-01010-85941896,2024-04-12T22:30:45,Zarautz,Expense,gifts,-295.67,-53841.14
buyer_2,Carmen,40,ES70209504723955028443,TRX_N-01011-87377659,2024-04-13T13:41:23,Zarautz,Expense,healthcare,-188.36,-54029.5
buyer_2,Carmen,40,ES70209504723955028443,TRX_N-01012-33133764,2024-04-14T21:03:25,Bilbao,Expense,leisure,-28.7,-54058.2
buyer_2,Carmen,40,ES70209504723955028443,TRX_N-01013-44728401,2024-04-14T11:02:53,Zarautz,Expense,healthcare,-83.43,-54141.63
buyer_2,Carmen,40,ES70209504723955028443,TRX_N-01014-73017473,2024-04-14T16:55:15,Zarautz,Expense,cash,-100.0,-54241.63
buyer_2,Carmen,40,ES70209504723955028443,TRX_N-01015-77390804,2024-04-15T22:26:40,Portugalete,Expense,transport,-67.34,-54308.97
buyer_2,Carmen,40,ES70209504723955028443,TRX_N-01016-87259568,2024-04-17T13:33:29,Errenteria,Expense,repairs,-161.58,-54470.55
buyer_2,Carmen,40,ES70209504723955028443,TRX_N-01017-08207867,2024-04-18T17:19:05,Zarautz,Expense,cash,-100.0,-54570.55
buyer_2,Carmen,40,ES70209504723955028443,TRX_N-01018-45926726,2024-04-19T14:08:39,Leioa,Expense,leisure,-30.25,-54600.8
buyer_2,Carmen,40,ES70209504723955028443,TRX_N-01019-71817520,2024-04-19T09:42:53,Zarautz,Expense,clothing,-106.69,-54707.49
buyer_2,Carmen,40,ES70209504723955028443,TRX_N-01020-15845553,2024-04-19T08:49:47,Zarautz,Expense,cash,-100.0,-54807.49
buyer_2,Carmen,40,ES70209504723955028443,TRX_N-01021-11468342,2024-04-22T11:45:40,Zarautz,Expense,cash,-100.0,-54907.49
buyer_2,Carmen,40,ES70209504723955028443,TRX_N-01022-74529889,2024-04-23T08:11:44,Zarautz,Expense,food,-102.82,-55010.31
buyer_2,Carmen,40,ES70209504723955028443,TRX_N-01023-92173361,2024-04-24T08:01:54,Zarautz,Expense,transport,-72.34,-55082.65
buyer_2,Carmen,40,ES70209504723955028443,TRX_N-01024-35091167,2024-04-24T17:44:09,Eibar,Expense,cash,-100.0,-55182.65
buyer_2,Carmen,40,ES70209504723955028443,TRX_N-01025-06244260,2024-04-28T13:09:10,Zarautz,Expense,cash,-100.0,-55282.65
buyer_2,Carmen,40,ES70209504723955028443,TRX_N-01026-90409543,2024-04-29T10:38:36,Zarautz,Expense,cash,-100.0,-55382.65
buyer_2,Carmen,40,ES70209504723955028443,TRX_N-01027-41609836,2024-04-30T11:38:16,Zarautz,Expense,gifts,-703.0,-56085.65
buyer_2,Carmen,40,ES70209504723955028443,TRX_N-01028-00712805,2024-05-01T18:34:56,Zarautz,incomes,salary,1300.39,-54785.26
buyer_2,Carmen,40,ES70209504723955028443,TRX_N-01029-96361104,2024-05-01T18:34:56,Zarautz,incomes,salary_partner,1576.15,-53209.11
buyer_2,Carmen,40,ES70209504723955028443,TRX_N-01030-14752945,2024-05-03T00:06:05,Hondarribia,Expense,repairs,-124.49,-53333.6
buyer_2,Carmen,40,ES70209504723955028443,TRX_N-01031-40563421,2024-05-04T20:18:57,Zarautz,expenses,mortgage,-1033.24,-54366.84
buyer_2,Carmen,40,ES70209504723955028443,TRX_N-01032-65991474,2024-05-05T13:39:15,Zarautz,expenses,electricity,-50.88,-54417.72
buyer_2,Carmen,40,ES70209504723955028443,TRX_N-01033-33259483,2024-05-05T14:44:04,Zarautz,expenses,internet,-42.0,-54459.72
buyer_2,Carmen,40,ES70209504723955028443,TRX_N-01034-03392147,2024-05-05T23:03:26,Zarautz,expenses,phone,-37.98,-54497.7
buyer_2,Carmen,40,ES70209504723955028443,TRX_N-01035-20746121,2024-05-07T18:05:10,Zarautz,expenses,water,-31.12,-54528.82
buyer_2,Carmen,40,ES70209504723955028443,TRX_N-01036-80583924,2024-05-07T00:52:22,Zarautz,expenses,gas,-59.21,-54588.03
buyer_2,Carmen,40,ES70209504723955028443,TRX_N-01037-14979701,2024-05-08T14:18:53,Zarautz,Expense,transport,-60.97,-54649.0
buyer_2,Carmen,40,ES70209504723955028443,TRX_N-01038-46790061,2024-05-08T02:26:26,Hondarribia,Expense,cash,-100.0,-54749.0
buyer_2,Carmen,40,ES70209504723955028443,TRX_N-01039-68067780,2024-05-09T12:44:22,Bermeo,Expense,food,-80.01,-54829.01
buyer_2,Carmen,40,ES70209504723955028443,TRX_N-01040-39705298,2024-05-10T02:04:11,Zarautz,Expense,food,-121.58,-54950.59
buyer_2,Carmen,40,ES70209504723955028443,TRX_N-01041-81457020,2024-05-10T15:27:56,Zarautz,Expense,leisure,-44.13,-54994.72
buyer_2,Carmen,40,ES70209504723955028443,TRX_N-01042-33921310,2024-05-10T06:25:04,Zarautz,Expense,cash,-100.0,-55094.72
buyer_2,Carmen,40,ES70209504723955028443,TRX_N-01043-84100157,2024-05-12T10:17:13,Labastida,Expense,cash,-100.0,-55194.72
buyer_2,Carmen,40,ES70209504723955028443,TRX_N-01044-66635708,2024-05-12T15:52:03,Zarautz,expenses,children,-200.61,-55395.33
buyer_2,Carmen,40,ES70209504723955028443,TRX_N-01045-54485549,2024-05-13T09:13:41,Zarautz,Expense,food,-124.81,-55520.14
buyer_2,Carmen,40,ES70209504723955028443,TRX_N-01046-55810899,2024-05-15T15:56:01,Zarautz,Expense,food,-66.23,-55586.37
buyer_2,Carmen,40,ES70209504723955028443,TRX_N-01047-17627996,2024-05-20T03:50:35,Zarautz,Expense,food,-96.17,-55682.54
buyer_2,Carmen,40,ES70209504723955028443,TRX_N-01048-37632181,2024-05-24T12:53:30,Zarautz,Expense,food,-68.31,-55750.85
buyer_2,Carmen,40,ES70209504723955028443,TRX_N-01049-85294942,2024-05-25T17:26:30,Zarautz,Expense,leisure,-43.41,-55794.26
buyer_2,Carmen,40,ES70209504723955028443,TRX_N-01050-62074389,2024-05-25T13:26:01,Zarautz,expenses,children,-101.43,-55895.69
buyer_2,Carmen,40,ES70209504723955028443,TRX_N-01051-75308012,2024-05-27T11:52:06,Zarautz,Expense,food,-95.71,-55991.4
buyer_2,Carmen,40,ES70209504723955028443,TRX_N-01052-04997960,2024-05-28T18:19:02,Zarautz,Expense,food,-106.04,-56097.44
buyer_2,Carmen,40,ES70209504723955028443,TRX_N-01053-23855836,2024-05-29T12:17:12,Errenteria,Expense,clothing,-47.39,-56144.83
buyer_2,Carmen,40,ES70209504723955028443,TRX_N-01054-30589373,2024-05-30T10:16:08,Zarautz,Expense,healthcare,-73.43,-56218.26
buyer_2,Carmen,40,ES70209504723955028443,TRX_N-01055-27060322,2024-05-31T10:45:35,Zarautz,Expense,food,-66.43,-56284.69
buyer_2,Carmen,40,ES70209504723955028443,TRX_N-01056-58812674,2024-05-31T18:24:46,Bilbao,Expense,healthcare,-51.72,-56336.41
buyer_2,Carmen,40,ES70209504723955028443,TRX_N-01057-55104193,2024-06-01T01:38:56,Zarautz,incomes,salary,1300.39,-55036.02
buyer_2,Carmen,40,ES70209504723955028443,TRX_N-01058-54877527,2024-06-01T01:38:56,Zarautz,incomes,salary_partner,1576.15,-53459.87
buyer_2,Carmen,40,ES70209504723955028443,TRX_N-01059-03383047,2024-06-01T01:38:56,Zarautz,incomes,extra_income,122.27,-53337.6
buyer_2,Carmen,40,ES70209504723955028443,TRX_N-01060-13579411,2024-06-01T01:38:56,Zarautz,incomes,salary_bonus,911.18,-52426.42
buyer_2,Carmen,40,ES70209504723955028443,TRX_N-01061-01220438,2024-06-01T01:38:56,Zarautz,incomes,salary_partner_bonus,1111.83,-51314.59
buyer_2,Carmen,40,ES70209504723955028443,TRX_N-01062-19402361,2024-06-01T19:03:04,Oy√≥n-Oion,Expense,leisure,-71.92,-51386.51
buyer_2,Carmen,40,ES70209504723955028443,TRX_N-01063-16137072,2024-06-01T19:34:04,Zarautz,Expense,healthcare,-72.15,-51458.66
buyer_2,Carmen,40,ES70209504723955028443,TRX_N-01064-11321215,2024-06-01T17:19:47,Elciego,Expense,repairs,-133.56,-51592.22
buyer_2,Carmen,40,ES70209504723955028443,TRX_N-01065-46235661,2024-06-03T13:32:06,Zarautz,Expense,appliances,-139.34,-51731.56
buyer_2,Carmen,40,ES70209504723955028443,TRX_N-01066-33959005,2024-06-04T17:38:54,Zarautz,expenses,mortgage,-1033.24,-52764.8
buyer_2,Carmen,40,ES70209504723955028443,TRX_N-01067-68071179,2024-06-04T11:20:35,Zarautz,Expense,appliances,-183.34,-52948.14
buyer_2,Carmen,40,ES70209504723955028443,TRX_N-01068-43145089,2024-06-05T09:50:44,Zarautz,expenses,electricity,-30.56,-52978.7
buyer_2,Carmen,40,ES70209504723955028443,TRX_N-01069-83525087,2024-06-05T08:25:37,Zarautz,expenses,phone,-35.28,-53013.98
buyer_2,Carmen,40,ES70209504723955028443,TRX_N-01070-01905244,2024-06-05T22:43:02,Zarautz,Expense,repairs,-79.72,-53093.7
buyer_2,Carmen,40,ES70209504723955028443,TRX_N-01071-30615040,2024-06-06T15:04:40,Zarautz,expenses,water,-32.58,-53126.28
buyer_2,Carmen,40,ES70209504723955028443,TRX_N-01072-02168442,2024-06-07T08:04:00,Zarautz,expenses,internet,-42.0,-53168.28
buyer_2,Carmen,40,ES70209504723955028443,TRX_N-01073-83253493,2024-06-08T22:50:26,Zarautz,expenses,gas,-75.42,-53243.7
buyer_2,Carmen,40,ES70209504723955028443,TRX_N-01074-21398493,2024-06-08T06:36:56,Zarautz,Expense,food,-102.43,-53346.13
buyer_2,Carmen,40,ES70209504723955028443,TRX_N-01075-23926599,2024-06-08T16:24:11,Zarautz,Expense,cash,-100.0,-53446.13
buyer_2,Carmen,40,ES70209504723955028443,TRX_N-01076-87154616,2024-06-13T19:46:20,Zarautz,Expense,leisure,-52.98,-53499.11
buyer_2,Carmen,40,ES70209504723955028443,TRX_N-01077-83654090,2024-06-13T23:27:43,Zarautz,Expense,cash,-100.0,-53599.11
buyer_2,Carmen,40,ES70209504723955028443,TRX_N-01078-50657008,2024-06-16T11:58:19,Galdakao,Expense,education,-56.83,-53655.94
buyer_2,Carmen,40,ES70209504723955028443,TRX_N-01079-74050923,2024-06-17T15:44:32,Amurrio,Expense,leisure,-58.14,-53714.08
buyer_2,Carmen,40,ES70209504723955028443,TRX_N-01080-03205844,2024-06-17T13:40:14,Zarautz,Expense,gifts,-713.73,-54427.81
buyer_2,Carmen,40,ES70209504723955028443,TRX_N-01081-22985525,2024-06-18T09:14:22,Zarautz,Expense,leisure,-20.14,-54447.95
buyer_2,Carmen,40,ES70209504723955028443,TRX_N-01082-28276896,2024-06-18T08:56:03,Zarautz,Expense,travel,-637.17,-55085.12
buyer_2,Carmen,40,ES70209504723955028443,TRX_N-01083-12868623,2024-06-18T04:23:54,Zarautz,Expense,appliances,-352.55,-55437.67
buyer_2,Carmen,40,ES70209504723955028443,TRX_N-01084-09585387,2024-06-19T15:37:57,Zarautz,Expense,healthcare,-118.6,-55556.27
buyer_2,Carmen,40,ES70209504723955028443,TRX_N-01085-16361122,2024-06-19T10:02:15,Zarautz,Expense,cash,-100.0,-55656.27
buyer_2,Carmen,40,ES70209504723955028443,TRX_N-01086-03179001,2024-06-23T09:04:22,Zarautz,Expense,healthcare,-55.77,-55712.04
buyer_2,Carmen,40,ES70209504723955028443,TRX_N-01087-70370678,2024-06-24T11:55:35,Zarautz,Expense,transport,-76.79,-55788.83
buyer_2,Carmen,40,ES70209504723955028443,TRX_N-01088-91183733,2024-06-24T23:58:28,Zarautz,Expense,cash,-100.0,-55888.83
buyer_2,Carmen,40,ES70209504723955028443,TRX_N-01089-87770039,2024-06-25T08:23:57,Zarautz,Expense,cash,-100.0,-55988.83
buyer_2,Carmen,40,ES70209504723955028443,TRX_N-01090-34170480,2024-06-26T11:19:00,Zarautz,Expense,gifts,-252.33,-56241.16
buyer_2,Carmen,40,ES70209504723955028443,TRX_N-01091-98993373,2024-06-30T15:43:34,Zarautz,Expense,food,-107.7,-56348.86
buyer_2,Carmen,40,ES70209504723955028443,TRX_N-01092-02241546,2024-07-01T15:47:03,Zarautz,incomes,salary,1300.39,-55048.47
buyer_2,Carmen,40,ES70209504723955028443,TRX_N-01093-95081754,2024-07-01T15:47:03,Zarautz,incomes,salary_partner,1576.15,-53472.32
buyer_2,Carmen,40,ES70209504723955028443,TRX_N-01094-23758607,2024-07-02T13:07:45,Zarautz,Expense,food,-100.06,-53572.38
buyer_2,Carmen,40,ES70209504723955028443,TRX_N-01095-45516119,2024-07-04T16:38:38,Zarautz,expenses,mortgage,-1033.24,-54605.62
buyer_2,Carmen,40,ES70209504723955028443,TRX_N-01096-55298844,2024-07-04T14:04:49,Zarautz,Expense,leisure,-73.25,-54678.87
buyer_2,Carmen,40,ES70209504723955028443,TRX_N-01097-49469368,2024-07-05T08:58:22,Zarautz,Expense,gifts,-399.35,-55078.22
buyer_2,Carmen,40,ES70209504723955028443,TRX_N-01098-10004749,2024-07-07T09:35:05,Zarautz,expenses,phone,-42.18,-55120.4
buyer_2,Carmen,40,ES70209504723955028443,TRX_N-01099-82652615,2024-07-08T08:16:30,Zarautz,expenses,water,-32.93,-55153.33
buyer_2,Carmen,40,ES70209504723955028443,TRX_N-01100-33427891,2024-07-08T11:41:25,Zarautz,expenses,electricity,-69.62,-55222.95
buyer_2,Carmen,40,ES70209504723955028443,TRX_N-01101-64767582,2024-07-08T08:46:05,Zarautz,expenses,gas,-72.29,-55295.24
buyer_2,Carmen,40,ES70209504723955028443,TRX_N-01102-68939658,2024-07-08T11:44:50,Zarautz,expenses,internet,-42.0,-55337.24
buyer_2,Carmen,40,ES70209504723955028443,TRX_N-01103-75422835,2024-07-11T11:51:46,Zarautz,Expense,transport,-54.41,-55391.65
buyer_2,Carmen,40,ES70209504723955028443,TRX_N-01104-80509587,2024-07-12T13:50:45,Zarautz,Expense,food,-104.03,-55495.68
buyer_2,Carmen,40,ES70209504723955028443,TRX_N-01105-39405253,2024-07-12T18:01:29,Zarautz,Expense,repairs,-239.72,-55735.4
buyer_2,Carmen,40,ES70209504723955028443,TRX_N-01106-58873867,2024-07-13T10:24:35,Zarautz,Expense,transport,-40.48,-55775.88
buyer_2,Carmen,40,ES70209504723955028443,TRX_N-01107-56016343,2024-07-13T15:44:01,Zarautz,Expense,repairs,-165.0,-55940.88
buyer_2,Carmen,40,ES70209504723955028443,TRX_N-01108-55160070,2024-07-14T12:11:21,Zarautz,Expense,transport,-40.8,-55981.68
buyer_2,Carmen,40,ES70209504723955028443,TRX_N-01109-49228492,2024-07-14T17:42:59,Zarautz,Expense,travel,-925.68,-56907.36
buyer_2,Carmen,40,ES70209504723955028443,TRX_N-01110-09594595,2024-07-14T03:06:25,Zarautz,Expense,repairs,-172.76,-57080.12
buyer_2,Carmen,40,ES70209504723955028443,TRX_N-01111-23359132,2024-07-15T08:29:24,Zarautz,Expense,cash,-100.0,-57180.12
buyer_2,Carmen,40,ES70209504723955028443,TRX_N-01112-84722946,2024-07-16T12:53:00,Zarautz,Expense,cash,-100.0,-57280.12
buyer_2,Carmen,40,ES70209504723955028443,TRX_N-01113-06652083,2024-07-18T10:24:15,Zarautz,Expense,education,-66.29,-57346.41
buyer_2,Carmen,40,ES70209504723955028443,TRX_N-01114-44864551,2024-07-25T17:20:29,Zarautz,Expense,education,-67.65,-57414.06
buyer_2,Carmen,40,ES70209504723955028443,TRX_N-01115-41829940,2024-07-28T12:41:54,Zarautz,Expense,transport,-76.15,-57490.21
buyer_2,Carmen,40,ES70209504723955028443,TRX_N-01116-68930967,2024-07-28T08:31:02,Zarautz,Expense,leisure,-50.86,-57541.07
buyer_2,Carmen,40,ES70209504723955028443,TRX_N-01117-87629684,2024-07-28T05:47:15,Zarautz,Expense,cash,-100.0,-57641.07
buyer_2,Carmen,40,ES70209504723955028443,TRX_N-01118-77269373,2024-07-29T14:45:10,Zarautz,Expense,leisure,-62.43,-57703.5
buyer_2,Carmen,40,ES70209504723955028443,TRX_N-01119-84760930,2024-07-29T17:28:11,Elciego,Expense,cash,-100.0,-57803.5
buyer_2,Carmen,40,ES70209504723955028443,TRX_N-01120-14352583,2024-07-29T19:07:55,Zarautz,Expense,appliances,-284.73,-58088.23
buyer_2,Carmen,40,ES70209504723955028443,TRX_N-01121-47615600,2024-08-01T14:19:10,Zarautz,incomes,salary,1300.39,-56787.84
buyer_2,Carmen,40,ES70209504723955028443,TRX_N-01122-30232417,2024-08-01T14:19:10,Zarautz,incomes,salary_partner,1576.15,-55211.69
buyer_2,Carmen,40,ES70209504723955028443,TRX_N-01123-09076391,2024-08-04T20:16:52,Zarautz,expenses,mortgage,-1033.24,-56244.93
buyer_2,Carmen,40,ES70209504723955028443,TRX_N-01124-74806838,2024-08-04T09:33:41,Zarautz,Expense,cash,-100.0,-56344.93
buyer_2,Carmen,40,ES70209504723955028443,TRX_N-01125-17197452,2024-08-04T18:47:01,Zarautz,Expense,repairs,-180.08,-56525.01
buyer_2,Carmen,40,ES70209504723955028443,TRX_N-01126-13428847,2024-08-05T18:18:07,Zarautz,expenses,gas,-72.1,-56597.11
buyer_2,Carmen,40,ES70209504723955028443,TRX_N-01127-10226094,2024-08-05T18:54:59,Zarautz,expenses,internet,-42.0,-56639.11
buyer_2,Carmen,40,ES70209504723955028443,TRX_N-01128-97010519,2024-08-06T22:25:54,Zarautz,Expense,leisure,-80.25,-56719.36
buyer_2,Carmen,40,ES70209504723955028443,TRX_N-01129-85374347,2024-08-06T08:03:19,Zarautz,Expense,repairs,-227.54,-56946.9
buyer_2,Carmen,40,ES70209504723955028443,TRX_N-01130-56753519,2024-08-07T14:38:41,Zarautz,Expense,leisure,-59.59,-57006.49
buyer_2,Carmen,40,ES70209504723955028443,TRX_N-01131-87402762,2024-08-08T16:35:05,Zarautz,expenses,phone,-42.26,-57048.75
buyer_2,Carmen,40,ES70209504723955028443,TRX_N-01132-02011435,2024-08-08T13:24:46,Zarautz,expenses,water,-28.35,-57077.1
buyer_2,Carmen,40,ES70209504723955028443,TRX_N-01133-03845653,2024-08-08T13:47:02,Zarautz,expenses,electricity,-28.25,-57105.35
buyer_2,Carmen,40,ES70209504723955028443,TRX_N-01134-79846524,2024-08-08T13:00:47,Errenteria,Expense,repairs,-130.87,-57236.22
buyer_2,Carmen,40,ES70209504723955028443,TRX_N-01135-10257240,2024-08-09T16:05:45,Zarautz,Expense,food,-68.85,-57305.07
buyer_2,Carmen,40,ES70209504723955028443,TRX_N-01136-34328684,2024-08-10T12:34:02,Zarautz,Expense,transport,-89.55,-57394.62
buyer_2,Carmen,40,ES70209504723955028443,TRX_N-01137-86349596,2024-08-10T21:59:42,Zarautz,Expense,clothing,-85.84,-57480.46
buyer_2,Carmen,40,ES70209504723955028443,TRX_N-01138-02102358,2024-08-13T07:02:42,Zarautz,Expense,leisure,-64.8,-57545.26
buyer_2,Carmen,40,ES70209504723955028443,TRX_N-01139-60645020,2024-08-14T20:29:28,Zarautz,Expense,transport,-67.7,-57612.96
buyer_2,Carmen,40,ES70209504723955028443,TRX_N-01140-43453513,2024-08-16T17:08:08,Zarautz,Expense,gifts,-753.66,-58366.62
buyer_2,Carmen,40,ES70209504723955028443,TRX_N-01141-03156881,2024-08-17T11:35:23,Zarautz,Expense,food,-93.71,-58460.33
buyer_2,Carmen,40,ES70209504723955028443,TRX_N-01142-85378119,2024-08-17T15:45:15,Zarautz,Expense,healthcare,-136.14,-58596.47
buyer_2,Carmen,40,ES70209504723955028443,TRX_N-01143-89509804,2024-08-17T21:23:47,Oy√≥n-Oion,Expense,cash,-100.0,-58696.47
buyer_2,Carmen,40,ES70209504723955028443,TRX_N-01144-61759769,2024-08-18T10:31:41,Durango,Expense,repairs,-89.48,-58785.95
buyer_2,Carmen,40,ES70209504723955028443,TRX_N-01145-70116629,2024-08-19T11:10:03,Zarautz,Expense,repairs,-174.94,-58960.89
buyer_2,Carmen,40,ES70209504723955028443,TRX_N-01146-73685723,2024-08-21T16:05:13,Zarautz,Expense,leisure,-76.31,-59037.2
buyer_2,Carmen,40,ES70209504723955028443,TRX_N-01147-08836724,2024-08-22T22:57:35,Zarautz,Expense,food,-121.49,-59158.69
buyer_2,Carmen,40,ES70209504723955028443,TRX_N-01148-35360409,2024-08-23T20:26:58,Hondarribia,Expense,cash,-100.0,-59258.69
buyer_2,Carmen,40,ES70209504723955028443,TRX_N-01149-74640670,2024-08-25T14:23:23,Zarautz,Expense,leisure,-64.66,-59323.35
buyer_2,Carmen,40,ES70209504723955028443,TRX_N-01150-32598714,2024-08-26T16:49:55,Zarautz,Expense,gifts,-121.65,-59445.0
buyer_2,Carmen,40,ES70209504723955028443,TRX_N-01151-06483781,2024-08-27T15:18:28,Zarautz,Expense,transport,-68.19,-59513.19
buyer_2,Carmen,40,ES70209504723955028443,TRX_N-01152-36860486,2024-08-27T17:48:53,Zarautz,Expense,cash,-100.0,-59613.19
buyer_2,Carmen,40,ES70209504723955028443,TRX_N-01153-74168026,2024-08-28T20:43:01,Zarautz,Expense,food,-62.21,-59675.4
buyer_2,Carmen,40,ES70209504723955028443,TRX_N-01154-75512901,2024-08-30T11:19:50,Zarautz,Expense,transport,-45.67,-59721.07
buyer_2,Carmen,40,ES70209504723955028443,TRX_N-01155-60141510,2024-08-30T10:21:20,Zarautz,Expense,cash,-100.0,-59821.07
buyer_2,Carmen,40,ES70209504723955028443,TRX_N-01156-39090516,2024-09-01T17:24:32,Zarautz,incomes,salary,1300.39,-58520.68
buyer_2,Carmen,40,ES70209504723955028443,TRX_N-01157-15063795,2024-09-01T17:24:32,Zarautz,incomes,salary_partner,1576.15,-56944.53
buyer_2,Carmen,40,ES70209504723955028443,TRX_N-01158-22565995,2024-09-01T17:24:32,Zarautz,incomes,extra_income,122.27,-56822.26
buyer_2,Carmen,40,ES70209504723955028443,TRX_N-01159-02372268,2024-09-02T16:01:04,Zarautz,Expense,food,-82.49,-56904.75
buyer_2,Carmen,40,ES70209504723955028443,TRX_N-01160-33755972,2024-09-04T13:20:20,Zarautz,expenses,mortgage,-1033.24,-57937.99
buyer_2,Carmen,40,ES70209504723955028443,TRX_N-01161-22521930,2024-09-04T17:13:19,Zarautz,Expense,leisure,-78.63,-58016.62
buyer_2,Carmen,40,ES70209504723955028443,TRX_N-01162-53715131,2024-09-06T11:01:30,Zarautz,expenses,gas,-87.17,-58103.79
buyer_2,Carmen,40,ES70209504723955028443,TRX_N-01163-22263317,2024-09-06T14:11:50,Zarautz,expenses,internet,-42.0,-58145.79
buyer_2,Carmen,40,ES70209504723955028443,TRX_N-01164-90776718,2024-09-07T14:25:03,Zarautz,Expense,food,-88.97,-58234.76
buyer_2,Carmen,40,ES70209504723955028443,TRX_N-01165-17869467,2024-09-08T20:42:22,Zarautz,expenses,water,-36.85,-58271.61
buyer_2,Carmen,40,ES70209504723955028443,TRX_N-01166-24312963,2024-09-08T10:38:23,Zarautz,expenses,electricity,-83.29,-58354.9
buyer_2,Carmen,40,ES70209504723955028443,TRX_N-01167-74659074,2024-09-08T09:09:59,Zarautz,expenses,phone,-43.92,-58398.82
buyer_2,Carmen,40,ES70209504723955028443,TRX_N-01168-67572164,2024-09-09T20:11:02,Zarautz,Expense,leisure,-53.87,-58452.69
buyer_2,Carmen,40,ES70209504723955028443,TRX_N-01169-12938296,2024-09-09T23:19:43,Zarautz,Expense,appliances,-220.15,-58672.84
buyer_2,Carmen,40,ES70209504723955028443,TRX_N-01170-55761718,2024-09-14T08:20:49,Zarautz,Expense,transport,-46.55,-58719.39
buyer_2,Carmen,40,ES70209504723955028443,TRX_N-01171-44862214,2024-09-14T19:57:28,Zarautz,Expense,cash,-100.0,-58819.39
buyer_2,Carmen,40,ES70209504723955028443,TRX_N-01172-21874916,2024-09-16T19:53:24,Zarautz,Expense,transport,-79.31,-58898.7
buyer_2,Carmen,40,ES70209504723955028443,TRX_N-01173-07564782,2024-09-17T12:55:39,Zarautz,Expense,leisure,-30.56,-58929.26
buyer_2,Carmen,40,ES70209504723955028443,TRX_N-01174-26334140,2024-09-19T08:32:33,Zarautz,Expense,food,-97.95,-59027.21
buyer_2,Carmen,40,ES70209504723955028443,TRX_N-01175-73053679,2024-09-20T17:13:16,Zarautz,Expense,healthcare,-125.85,-59153.06
buyer_2,Carmen,40,ES70209504723955028443,TRX_N-01176-58885786,2024-09-21T11:08:39,Zarautz,Expense,food,-102.47,-59255.53
buyer_2,Carmen,40,ES70209504723955028443,TRX_N-01177-96917761,2024-09-22T11:59:42,Eibar,Expense,transport,-77.32,-59332.85
buyer_2,Carmen,40,ES70209504723955028443,TRX_N-01178-12369941,2024-09-22T18:10:52,Zarautz,Expense,leisure,-71.78,-59404.63
buyer_2,Carmen,40,ES70209504723955028443,TRX_N-01179-58360727,2024-09-22T12:24:03,Basauri,Expense,clothing,-58.66,-59463.29
buyer_2,Carmen,40,ES70209504723955028443,TRX_N-01180-63185948,2024-09-24T15:43:39,Durango,Expense,cash,-100.0,-59563.29
buyer_2,Carmen,40,ES70209504723955028443,TRX_N-01181-22649344,2024-09-25T20:49:31,Zarautz,Expense,leisure,-71.69,-59634.98
buyer_2,Carmen,40,ES70209504723955028443,TRX_N-01182-55152642,2024-09-25T19:46:33,Zarautz,Expense,cash,-100.0,-59734.98
buyer_2,Carmen,40,ES70209504723955028443,TRX_N-01183-90037327,2024-09-25T07:41:51,Zarautz,Expense,gifts,-505.81,-60240.79
buyer_2,Carmen,40,ES70209504723955028443,TRX_N-01184-81405073,2024-09-26T18:06:04,Zarautz,Expense,repairs,-207.85,-60448.64
buyer_2,Carmen,40,ES70209504723955028443,TRX_N-01185-91855537,2024-09-27T19:10:53,Zarautz,Expense,food,-117.05,-60565.69
buyer_2,Carmen,40,ES70209504723955028443,TRX_N-01186-31889516,2024-09-27T19:06:38,Pasaia,Expense,transport,-89.99,-60655.68
buyer_2,Carmen,40,ES70209504723955028443,TRX_N-01187-28236952,2024-09-28T14:08:55,Zarautz,Expense,food,-63.77,-60719.45
buyer_2,Carmen,40,ES70209504723955028443,TRX_N-01188-17706059,2024-09-29T11:47:04,Zarautz,Expense,clothing,-74.12,-60793.57
buyer_2,Carmen,40,ES70209504723955028443,TRX_N-01189-93433288,2024-09-29T19:42:39,Zarautz,Expense,cash,-100.0,-60893.57
buyer_2,Carmen,40,ES70209504723955028443,TRX_N-01190-10500411,2024-09-29T22:56:17,Zarautz,Expense,travel,-1781.61,-62675.18
buyer_2,Carmen,40,ES70209504723955028443,TRX_N-01191-46933573,2024-10-01T07:15:32,Zarautz,incomes,salary,1300.39,-61374.79
buyer_2,Carmen,40,ES70209504723955028443,TRX_N-01192-03458327,2024-10-01T07:15:32,Zarautz,incomes,salary_partner,1576.15,-59798.64
buyer_2,Carmen,40,ES70209504723955028443,TRX_N-01193-07705571,2024-10-03T06:25:22,Zarautz,Expense,cash,-100.0,-59898.64
buyer_2,Carmen,40,ES70209504723955028443,TRX_N-01194-81410579,2024-10-04T13:25:01,Zarautz,expenses,mortgage,-1033.24,-60931.88
buyer_2,Carmen,40,ES70209504723955028443,TRX_N-01195-08647687,2024-10-05T23:26:42,Zarautz,expenses,electricity,-49.27,-60981.15
buyer_2,Carmen,40,ES70209504723955028443,TRX_N-01196-75479703,2024-10-06T08:25:37,Zarautz,expenses,water,-23.52,-61004.67
buyer_2,Carmen,40,ES70209504723955028443,TRX_N-01197-99354602,2024-10-06T19:20:30,Zarautz,expenses,gas,-67.19,-61071.86
buyer_2,Carmen,40,ES70209504723955028443,TRX_N-01198-53548152,2024-10-06T08:07:25,Zarautz,Expense,food,-99.91,-61171.77
buyer_2,Carmen,40,ES70209504723955028443,TRX_N-01199-27619907,2024-10-06T10:53:16,Zarautz,Expense,cash,-100.0,-61271.77
buyer_2,Carmen,40,ES70209504723955028443,TRX_N-01200-98460965,2024-10-06T19:21:37,Zarautz,expenses,children,-218.29,-61490.06
buyer_2,Carmen,40,ES70209504723955028443,TRX_N-01201-79495627,2024-10-07T16:54:50,Zarautz,expenses,internet,-42.0,-61532.06
buyer_2,Carmen,40,ES70209504723955028443,TRX_N-01202-37470435,2024-10-07T18:47:33,Durango,Expense,cash,-100.0,-61632.06
buyer_2,Carmen,40,ES70209504723955028443,TRX_N-01203-31160599,2024-10-08T20:47:47,Zarautz,expenses,phone,-31.45,-61663.51
buyer_3,Ana,35,ES47209566635349086821,TRX_N-00001-63307861,2022-01-01T18:21:38,Amurrio,incomes,salary,1496.83,2531.29
buyer_3,Ana,35,ES47209566635349086821,TRX_N-00002-12747200,2022-01-01T18:21:38,Amurrio,incomes,salary_partner,1606.65,4137.94
buyer_3,Ana,35,ES47209566635349086821,TRX_N-00003-53469286,2022-01-01T10:08:50,Amurrio,Expense,leisure,-41.82,4096.12
buyer_3,Ana,35,ES47209566635349086821,TRX_N-00004-54003354,2022-01-02T13:37:41,Amurrio,Expense,cash,-100.0,3996.12
buyer_3,Ana,35,ES47209566635349086821,TRX_N-00005-11823966,2022-01-03T20:48:35,Sopela,Expense,repairs,-164.0,3832.12
buyer_3,Ana,35,ES47209566635349086821,TRX_N-00006-38657097,2022-01-04T20:42:45,Amurrio,expenses,mortgage,-865.74,2966.38
buyer_3,Ana,35,ES47209566635349086821,TRX_N-00007-55955329,2022-01-06T14:42:06,Amurrio,expenses,water,-44.63,2921.75
buyer_3,Ana,35,ES47209566635349086821,TRX_N-00008-74899313,2022-01-06T13:49:43,Amurrio,Expense,cash,-100.0,2821.75
buyer_3,Ana,35,ES47209566635349086821,TRX_N-00009-01913432,2022-01-07T23:21:56,Amurrio,expenses,electricity,-77.58,2744.17
buyer_3,Ana,35,ES47209566635349086821,TRX_N-00010-80700086,2022-01-08T14:40:23,Amurrio,expenses,internet,-42.0,2702.17
buyer_3,Ana,35,ES47209566635349086821,TRX_N-00011-29294455,2022-01-08T17:12:32,Amurrio,expenses,gas,-78.93,2623.24
buyer_3,Ana,35,ES47209566635349086821,TRX_N-00012-00289265,2022-01-08T06:58:14,Amurrio,expenses,phone,-39.63,2583.61
buyer_3,Ana,35,ES47209566635349086821,TRX_N-00013-57152042,2022-01-08T16:09:36,Alegr√≠a-Dulantzi,Expense,cash,-100.0,2483.61
buyer_3,Ana,35,ES47209566635349086821,TRX_N-00014-93150859,2022-01-08T10:10:00,Getxo,Expense,appliances,-390.22,2093.39
buyer_3,Ana,35,ES47209566635349086821,TRX_N-00015-15042008,2022-01-11T19:17:40,Amurrio,Expense,transport,-89.47,2003.92
buyer_3,Ana,35,ES47209566635349086821,TRX_N-00016-75762683,2022-01-14T14:18:46,Amurrio,Expense,leisure,-36.42,1967.5
buyer_3,Ana,35,ES47209566635349086821,TRX_N-00017-32352247,2022-01-18T16:13:36,Amurrio,Expense,appliances,-204.54,1762.96
buyer_3,Ana,35,ES47209566635349086821,TRX_N-00018-40765864,2022-01-23T18:52:00,Amurrio,Expense,gifts,-301.75,1461.21
buyer_3,Ana,35,ES47209566635349086821,TRX_N-00019-36759978,2022-01-26T20:16:03,Amurrio,Expense,food,-98.77,1362.44
buyer_3,Ana,35,ES47209566635349086821,TRX_N-00020-99261469,2022-01-26T09:52:43,Zuia,Expense,gifts,-474.84,887.6
buyer_3,Ana,35,ES47209566635349086821,TRX_N-00021-42815490,2022-01-28T11:33:24,Amurrio,Expense,leisure,-54.85,832.75
buyer_3,Ana,35,ES47209566635349086821,TRX_N-00022-32282829,2022-01-28T19:16:55,Arrasate,Expense,cash,-100.0,732.75
buyer_3,Ana,35,ES47209566635349086821,TRX_N-00023-74735828,2022-01-28T20:46:41,Amurrio,Expense,appliances,-313.09,419.66
buyer_3,Ana,35,ES47209566635349086821,TRX_N-00024-84718062,2022-02-01T06:51:59,Amurrio,incomes,salary,1496.83,1916.49
buyer_3,Ana,35,ES47209566635349086821,TRX_N-00025-26283508,2022-02-01T06:51:59,Amurrio,incomes,salary_partner,1606.65,3523.14
buyer_3,Ana,35,ES47209566635349086821,TRX_N-00026-71501095,2022-02-02T14:55:17,Amurrio,Expense,food,-117.09,3406.05
buyer_3,Ana,35,ES47209566635349086821,TRX_N-00027-12151675,2022-02-03T16:26:24,Mungia,Expense,transport,-54.47,3351.58
buyer_3,Ana,35,ES47209566635349086821,TRX_N-00028-26638472,2022-02-04T08:07:21,Amurrio,expenses,mortgage,-865.74,2485.84
buyer_3,Ana,35,ES47209566635349086821,TRX_N-00029-66378709,2022-02-04T18:34:32,Amurrio,Expense,cash,-100.0,2385.84
buyer_3,Ana,35,ES47209566635349086821,TRX_N-00030-55352958,2022-02-04T08:31:17,Amurrio,Expense,appliances,-345.76,2040.08
buyer_3,Ana,35,ES47209566635349086821,TRX_N-00031-31021107,2022-02-05T16:42:21,Amurrio,expenses,gas,-38.11,2001.97
buyer_3,Ana,35,ES47209566635349086821,TRX_N-00032-08568820,2022-02-05T16:08:50,Amurrio,Expense,gifts,-651.72,1350.25
buyer_3,Ana,35,ES47209566635349086821,TRX_N-00033-47987768,2022-02-06T11:59:31,Amurrio,expenses,water,-41.16,1309.09
buyer_3,Ana,35,ES47209566635349086821,TRX_N-00034-03651779,2022-02-06T14:49:21,Amurrio,expenses,children,-102.56,1206.53
buyer_3,Ana,35,ES47209566635349086821,TRX_N-00035-05987630,2022-02-07T13:23:39,Durango,Expense,food,-107.77,1098.76
buyer_3,Ana,35,ES47209566635349086821,TRX_N-00036-37160378,2022-02-07T16:58:21,Amurrio,Expense,gifts,-135.99,962.77
buyer_3,Ana,35,ES47209566635349086821,TRX_N-00037-66522604,2022-02-08T09:40:23,Amurrio,expenses,electricity,-24.52,938.25
buyer_3,Ana,35,ES47209566635349086821,TRX_N-00038-26078518,2022-02-08T10:59:11,Amurrio,expenses,internet,-42.0,896.25
buyer_3,Ana,35,ES47209566635349086821,TRX_N-00039-11956893,2022-02-08T14:55:01,Amurrio,expenses,phone,-41.12,855.13
buyer_3,Ana,35,ES47209566635349086821,TRX_N-00040-43827135,2022-02-08T18:54:55,Amurrio,Expense,food,-64.6,790.53
buyer_3,Ana,35,ES47209566635349086821,TRX_N-00041-33970048,2022-02-10T17:01:51,Iru√±a de Oca,Expense,clothing,-77.21,713.32
buyer_3,Ana,35,ES47209566635349086821,TRX_N-00042-09719774,2022-02-11T09:49:18,Amurrio,Expense,transport,-85.1,628.22
buyer_3,Ana,35,ES47209566635349086821,TRX_N-00043-35747261,2022-02-12T16:06:44,Amurrio,Expense,healthcare,-78.94,549.28
buyer_3,Ana,35,ES47209566635349086821,TRX_N-00044-94142520,2022-02-15T11:13:44,Amurrio,Expense,transport,-45.48,503.8
buyer_3,Ana,35,ES47209566635349086821,TRX_N-00045-05675477,2022-02-15T10:49:33,Amurrio,Expense,healthcare,-114.5,389.3
buyer_3,Ana,35,ES47209566635349086821,TRX_N-00046-62207582,2022-02-16T12:55:21,Amurrio,Expense,cash,-100.0,289.3
buyer_3,Ana,35,ES47209566635349086821,TRX_N-00047-18851770,2022-02-17T17:25:03,Amurrio,Expense,healthcare,-77.43,211.87
buyer_3,Ana,35,ES47209566635349086821,TRX_N-00048-70680791,2022-02-17T14:40:03,Amurrio,expenses,children,-188.08,23.79
buyer_3,Ana,35,ES47209566635349086821,TRX_N-00049-27019348,2022-02-19T15:09:40,Amurrio,Expense,clothing,-125.2,-101.41
buyer_3,Ana,35,ES47209566635349086821,TRX_N-00050-60736564,2022-02-20T11:22:59,Amurrio,Expense,leisure,-28.38,-129.79
buyer_3,Ana,35,ES47209566635349086821,TRX_N-00051-01746972,2022-02-21T11:57:03,Amurrio,Expense,food,-112.41,-242.2
buyer_3,Ana,35,ES47209566635349086821,TRX_N-00052-15624448,2022-02-21T12:28:52,Amurrio,Expense,transport,-46.34,-288.54
buyer_3,Ana,35,ES47209566635349086821,TRX_N-00053-51077104,2022-02-21T15:37:49,Bilbao,Expense,cash,-100.0,-388.54
buyer_3,Ana,35,ES47209566635349086821,TRX_N-00054-38219087,2022-02-21T18:53:05,Alegr√≠a-Dulantzi,Expense,repairs,-280.48,-669.02
buyer_3,Ana,35,ES47209566635349086821,TRX_N-00055-67273487,2022-02-21T17:27:43,Amurrio,Expense,gifts,-632.53,-1301.55
buyer_3,Ana,35,ES47209566635349086821,TRX_N-00056-24080136,2022-02-24T20:52:33,Bilbao,Expense,travel,-1640.45,-2942.0
buyer_3,Ana,35,ES47209566635349086821,TRX_N-00057-92546408,2022-02-25T16:00:04,Amurrio,Expense,transport,-42.16,-2984.16
buyer_3,Ana,35,ES47209566635349086821,TRX_N-00058-06380150,2022-02-26T14:42:36,Amurrio,Expense,transport,-53.4,-3037.56
buyer_3,Ana,35,ES47209566635349086821,TRX_N-00059-84476047,2022-02-27T10:34:46,Eibar,Expense,transport,-81.89,-3119.45
buyer_3,Ana,35,ES47209566635349086821,TRX_N-00060-72121433,2022-02-27T18:31:35,Amurrio,Expense,repairs,-157.69,-3277.14
buyer_3,Ana,35,ES47209566635349086821,TRX_N-00061-79906124,2022-02-28T19:19:56,Durango,Expense,cash,-100.0,-3377.14
buyer_3,Ana,35,ES47209566635349086821,TRX_N-00062-57594205,2022-03-01T13:24:20,Amurrio,incomes,salary,1496.83,-1880.31
buyer_3,Ana,35,ES47209566635349086821,TRX_N-00063-31318779,2022-03-01T13:24:20,Amurrio,incomes,salary_partner,1606.65,-273.66
buyer_3,Ana,35,ES47209566635349086821,TRX_N-00064-94696688,2022-03-02T22:01:43,Amurrio,Expense,leisure,-52.7,-326.36
buyer_3,Ana,35,ES47209566635349086821,TRX_N-00065-11013952,2022-03-02T16:34:05,Durango,Expense,cash,-100.0,-426.36
buyer_3,Ana,35,ES47209566635349086821,TRX_N-00066-97903134,2022-03-02T17:48:05,Amurrio,Expense,appliances,-157.68,-584.04
buyer_3,Ana,35,ES47209566635349086821,TRX_N-00067-20402765,2022-03-03T13:55:21,Amurrio,Expense,leisure,-52.54,-636.58
buyer_3,Ana,35,ES47209566635349086821,TRX_N-00068-92322105,2022-03-04T19:21:51,Amurrio,expenses,mortgage,-865.74,-1502.32
buyer_3,Ana,35,ES47209566635349086821,TRX_N-00069-63014147,2022-03-04T20:15:22,Amurrio,Expense,transport,-86.8,-1589.12
buyer_3,Ana,35,ES47209566635349086821,TRX_N-00070-58063592,2022-03-05T20:28:21,Amurrio,expenses,water,-36.34,-1625.46
buyer_3,Ana,35,ES47209566635349086821,TRX_N-00071-54213037,2022-03-06T12:03:57,Amurrio,expenses,electricity,-44.05,-1669.51
buyer_3,Ana,35,ES47209566635349086821,TRX_N-00072-65382344,2022-03-06T13:09:13,Amurrio,expenses,internet,-42.0,-1711.51
buyer_3,Ana,35,ES47209566635349086821,TRX_N-00073-42858237,2022-03-06T09:53:29,Llodio,Expense,food,-71.69,-1783.2
buyer_3,Ana,35,ES47209566635349086821,TRX_N-00074-91643390,2022-03-06T13:39:34,Amurrio,Expense,cash,-100.0,-1883.2
buyer_3,Ana,35,ES47209566635349086821,TRX_N-00075-88405767,2022-03-07T14:51:04,Amurrio,expenses,phone,-30.07,-1913.27
buyer_3,Ana,35,ES47209566635349086821,TRX_N-00076-38984268,2022-03-07T16:57:27,Amurrio,Expense,transport,-79.26,-1992.53
buyer_3,Ana,35,ES47209566635349086821,TRX_N-00077-45754800,2022-03-07T12:19:11,Amurrio,Expense,repairs,-320.46,-2312.99
buyer_3,Ana,35,ES47209566635349086821,TRX_N-00078-50026167,2022-03-08T20:39:01,Amurrio,expenses,gas,-82.15,-2395.14
buyer_3,Ana,35,ES47209566635349086821,TRX_N-00079-60120663,2022-03-08T22:28:53,Amurrio,Expense,transport,-89.36,-2484.5
buyer_3,Ana,35,ES47209566635349086821,TRX_N-00080-79284845,2022-03-09T19:40:56,Amurrio,Expense,transport,-56.87,-2541.37
buyer_3,Ana,35,ES47209566635349086821,TRX_N-00081-58489130,2022-03-09T16:39:30,Alegr√≠a-Dulantzi,Expense,repairs,-297.48,-2838.85
buyer_3,Ana,35,ES47209566635349086821,TRX_N-00082-49674525,2022-03-10T17:04:54,Amurrio,Expense,transport,-79.69,-2918.54
buyer_3,Ana,35,ES47209566635349086821,TRX_N-00083-49251713,2022-03-10T12:10:58,Sestao,Expense,leisure,-61.55,-2980.09
buyer_3,Ana,35,ES47209566635349086821,TRX_N-00084-61705543,2022-03-13T10:33:05,Amurrio,expenses,children,-248.7,-3228.79
buyer_3,Ana,35,ES47209566635349086821,TRX_N-00085-23230312,2022-03-14T11:50:06,Amurrio,Expense,cash,-100.0,-3328.79
buyer_3,Ana,35,ES47209566635349086821,TRX_N-00086-07575835,2022-03-15T18:04:58,Amurrio,expenses,children,-217.38,-3546.17
buyer_3,Ana,35,ES47209566635349086821,TRX_N-00087-39434616,2022-03-16T07:10:49,Sestao,Expense,healthcare,-175.39,-3721.56
buyer_3,Ana,35,ES47209566635349086821,TRX_N-00088-55913151,2022-03-18T11:51:14,Amurrio,Expense,cash,-100.0,-3821.56
buyer_3,Ana,35,ES47209566635349086821,TRX_N-00089-09465937,2022-03-19T16:29:30,Amurrio,Expense,clothing,-56.03,-3877.59
buyer_3,Ana,35,ES47209566635349086821,TRX_N-00090-06850054,2022-03-20T20:09:40,Amurrio,Expense,food,-92.04,-3969.63
buyer_3,Ana,35,ES47209566635349086821,TRX_N-00091-88055750,2022-03-20T17:01:02,Amurrio,Expense,gifts,-604.54,-4574.17
buyer_3,Ana,35,ES47209566635349086821,TRX_N-00092-75884718,2022-03-23T09:54:05,Amurrio,Expense,healthcare,-56.69,-4630.86
buyer_3,Ana,35,ES47209566635349086821,TRX_N-00093-25519935,2022-03-25T10:55:02,Errenteria,Expense,transport,-76.11,-4706.97
buyer_3,Ana,35,ES47209566635349086821,TRX_N-00094-77338703,2022-03-27T08:07:21,Amurrio,Expense,leisure,-67.78,-4774.75
buyer_3,Ana,35,ES47209566635349086821,TRX_N-00095-44273862,2022-03-28T12:26:36,Amurrio,Expense,healthcare,-127.43,-4902.18
buyer_3,Ana,35,ES47209566635349086821,TRX_N-00096-53030113,2022-03-28T11:55:40,Amurrio,Expense,cash,-100.0,-5002.18
buyer_3,Ana,35,ES47209566635349086821,TRX_N-00097-68174211,2022-03-30T17:07:25,Amurrio,Expense,leisure,-42.13,-5044.31
buyer_3,Ana,35,ES47209566635349086821,TRX_N-00098-69486138,2022-03-31T23:51:10,Amurrio,Expense,gifts,-827.88,-5872.19
buyer_3,Ana,35,ES47209566635349086821,TRX_N-00099-23881818,2022-04-01T16:43:46,Amurrio,incomes,salary,1496.83,-4375.36
buyer_3,Ana,35,ES47209566635349086821,TRX_N-00100-79704784,2022-04-01T16:43:46,Amurrio,incomes,salary_partner,1606.65,-2768.71
buyer_3,Ana,35,ES47209566635349086821,TRX_N-00101-73629696,2022-04-01T16:43:46,Amurrio,incomes,extra_income,171.11,-2597.6
buyer_3,Ana,35,ES47209566635349086821,TRX_N-00102-66317993,2022-04-02T03:05:15,Amurrio,Expense,repairs,-238.2,-2835.8
buyer_3,Ana,35,ES47209566635349086821,TRX_N-00103-30539812,2022-04-03T15:04:14,Galdakao,Expense,food,-111.56,-2947.36
buyer_3,Ana,35,ES47209566635349086821,TRX_N-00104-17711787,2022-04-03T06:40:33,Amurrio,Expense,repairs,-222.33,-3169.69
buyer_3,Ana,35,ES47209566635349086821,TRX_N-00105-57714552,2022-04-04T10:59:16,Amurrio,expenses,mortgage,-865.74,-4035.43
buyer_3,Ana,35,ES47209566635349086821,TRX_N-00106-87495447,2022-04-05T14:40:16,Amurrio,expenses,phone,-38.3,-4073.73
buyer_3,Ana,35,ES47209566635349086821,TRX_N-00107-35751523,2022-04-06T19:24:52,Amurrio,Expense,leisure,-61.55,-4135.28
buyer_3,Ana,35,ES47209566635349086821,TRX_N-00108-66380340,2022-04-08T20:42:09,Amurrio,expenses,gas,-55.59,-4190.87
buyer_3,Ana,35,ES47209566635349086821,TRX_N-00109-45998759,2022-04-08T14:45:07,Amurrio,expenses,water,-29.67,-4220.54
buyer_3,Ana,35,ES47209566635349086821,TRX_N-00110-48405576,2022-04-08T11:10:32,Amurrio,expenses,electricity,-39.37,-4259.91
buyer_3,Ana,35,ES47209566635349086821,TRX_N-00111-13936600,2022-04-08T12:15:03,Amurrio,expenses,internet,-42.0,-4301.91
buyer_3,Ana,35,ES47209566635349086821,TRX_N-00112-00912254,2022-04-09T13:40:17,Sopela,Expense,cash,-100.0,-4401.91
buyer_3,Ana,35,ES47209566635349086821,TRX_N-00113-85779543,2022-04-10T12:50:07,Durango,Expense,leisure,-63.84,-4465.75
buyer_3,Ana,35,ES47209566635349086821,TRX_N-00114-82508360,2022-04-11T15:09:06,Amurrio,Expense,travel,-1607.75,-6073.5
buyer_3,Ana,35,ES47209566635349086821,TRX_N-00115-63242427,2022-04-12T06:40:34,Amurrio,Expense,transport,-70.14,-6143.64
buyer_3,Ana,35,ES47209566635349086821,TRX_N-00116-23866370,2022-04-13T12:18:18,Amurrio,Expense,cash,-100.0,-6243.64
buyer_3,Ana,35,ES47209566635349086821,TRX_N-00117-44784940,2022-04-18T17:17:08,Amurrio,Expense,transport,-72.07,-6315.71
buyer_3,Ana,35,ES47209566635349086821,TRX_N-00118-77558683,2022-04-18T14:43:29,Portugalete,Expense,repairs,-155.54,-6471.25
buyer_3,Ana,35,ES47209566635349086821,TRX_N-00119-24718922,2022-04-18T22:36:55,Amurrio,Expense,gifts,-64.26,-6535.51
buyer_3,Ana,35,ES47209566635349086821,TRX_N-00120-40966052,2022-04-19T14:28:13,Portugalete,Expense,gifts,-345.47,-6880.98
buyer_3,Ana,35,ES47209566635349086821,TRX_N-00121-28624618,2022-04-20T08:35:52,Hernani,Expense,cash,-100.0,-6980.98
buyer_3,Ana,35,ES47209566635349086821,TRX_N-00122-66769583,2022-04-22T15:27:46,Amurrio,Expense,food,-122.03,-7103.01
buyer_3,Ana,35,ES47209566635349086821,TRX_N-00123-82418137,2022-04-22T07:57:19,Amurrio,Expense,transport,-73.15,-7176.16
buyer_3,Ana,35,ES47209566635349086821,TRX_N-00124-12884671,2022-04-22T11:05:11,Amurrio,Expense,gifts,-80.36,-7256.52
buyer_3,Ana,35,ES47209566635349086821,TRX_N-00125-62516878,2022-04-24T13:46:54,Amurrio,Expense,cash,-100.0,-7356.52
buyer_3,Ana,35,ES47209566635349086821,TRX_N-00126-06020968,2022-04-25T13:27:49,Amurrio,Expense,cash,-100.0,-7456.52
buyer_3,Ana,35,ES47209566635349086821,TRX_N-00127-53293406,2022-04-26T09:26:11,Amurrio,Expense,cash,-100.0,-7556.52
buyer_3,Ana,35,ES47209566635349086821,TRX_N-00128-52012820,2022-04-28T23:17:44,Sopela,Expense,transport,-77.28,-7633.8
buyer_3,Ana,35,ES47209566635349086821,TRX_N-00129-56134472,2022-04-29T00:29:53,Amurrio,Expense,leisure,-50.65,-7684.45
buyer_3,Ana,35,ES47209566635349086821,TRX_N-00130-35292894,2022-04-29T15:27:26,Amurrio,Expense,clothing,-108.2,-7792.65
buyer_3,Ana,35,ES47209566635349086821,TRX_N-00131-24619326,2022-04-29T08:24:43,Amurrio,Expense,gifts,-317.8,-8110.45
buyer_3,Ana,35,ES47209566635349086821,TRX_N-00132-56548799,2022-05-01T12:19:13,Amurrio,incomes,salary,1496.83,-6613.62
buyer_3,Ana,35,ES47209566635349086821,TRX_N-00133-84816054,2022-05-01T12:19:13,Amurrio,incomes,salary_partner,1606.65,-5006.97
buyer_3,Ana,35,ES47209566635349086821,TRX_N-00134-50621081,2022-05-01T11:51:03,Amurrio,Expense,leisure,-52.19,-5059.16
buyer_3,Ana,35,ES47209566635349086821,TRX_N-00135-56482580,2022-05-02T10:09:32,Vitoria-Gasteiz,Expense,gifts,-747.18,-5806.34
buyer_3,Ana,35,ES47209566635349086821,TRX_N-00136-16024188,2022-05-04T19:38:44,Amurrio,expenses,mortgage,-865.74,-6672.08
buyer_3,Ana,35,ES47209566635349086821,TRX_N-00137-79756413,2022-05-04T01:25:51,Amurrio,Expense,food,-68.83,-6740.91
buyer_3,Ana,35,ES47209566635349086821,TRX_N-00138-32035400,2022-05-04T04:07:04,Amurrio,Expense,transport,-82.83,-6823.74
buyer_3,Ana,35,ES47209566635349086821,TRX_N-00139-95909432,2022-05-05T14:17:25,Amurrio,expenses,water,-32.06,-6855.8
buyer_3,Ana,35,ES47209566635349086821,TRX_N-00140-82558771,2022-05-05T12:33:48,Amurrio,expenses,gas,-69.74,-6925.54
buyer_3,Ana,35,ES47209566635349086821,TRX_N-00141-44279530,2022-05-05T19:17:57,Amurrio,Expense,education,-64.35,-6989.89
buyer_3,Ana,35,ES47209566635349086821,TRX_N-00142-82066948,2022-05-06T10:08:12,Amurrio,Expense,gifts,-848.26,-7838.15
buyer_3,Ana,35,ES47209566635349086821,TRX_N-00143-63644727,2022-05-06T13:12:47,Amurrio,expenses,children,-209.08,-8047.23
buyer_3,Ana,35,ES47209566635349086821,TRX_N-00144-46319091,2022-05-07T03:29:00,Amurrio,expenses,internet,-42.0,-8089.23
buyer_3,Ana,35,ES47209566635349086821,TRX_N-00145-03798933,2022-05-07T10:53:41,Amurrio,Expense,cash,-100.0,-8189.23
buyer_3,Ana,35,ES47209566635349086821,TRX_N-00146-66273855,2022-05-08T19:45:57,Amurrio,expenses,electricity,-56.59,-8245.82
buyer_3,Ana,35,ES47209566635349086821,TRX_N-00147-90219212,2022-05-08T23:20:14,Amurrio,expenses,phone,-40.0,-8285.82
buyer_3,Ana,35,ES47209566635349086821,TRX_N-00148-65687353,2022-05-08T18:11:35,Amurrio,Expense,transport,-73.52,-8359.34
buyer_3,Ana,35,ES47209566635349086821,TRX_N-00149-23632147,2022-05-08T09:28:31,Amurrio,Expense,clothing,-46.18,-8405.52
buyer_3,Ana,35,ES47209566635349086821,TRX_N-00150-00792365,2022-05-09T08:46:27,Amurrio,expenses,children,-144.32,-8549.84
buyer_3,Ana,35,ES47209566635349086821,TRX_N-00151-94255050,2022-05-10T12:37:14,Amurrio,Expense,food,-83.85,-8633.69
buyer_3,Ana,35,ES47209566635349086821,TRX_N-00152-45956265,2022-05-11T19:05:36,Amurrio,Expense,healthcare,-65.11,-8698.8
buyer_3,Ana,35,ES47209566635349086821,TRX_N-00153-18027772,2022-05-12T17:08:46,Amurrio,Expense,cash,-100.0,-8798.8
buyer_3,Ana,35,ES47209566635349086821,TRX_N-00154-93849778,2022-05-13T18:04:24,Amurrio,Expense,leisure,-28.44,-8827.24
buyer_3,Ana,35,ES47209566635349086821,TRX_N-00155-75591568,2022-05-14T06:05:22,Amurrio,Expense,transport,-73.86,-8901.1
buyer_3,Ana,35,ES47209566635349086821,TRX_N-00156-05314257,2022-05-14T14:58:10,Amurrio,Expense,gifts,-391.31,-9292.41
buyer_3,Ana,35,ES47209566635349086821,TRX_N-00157-47354408,2022-05-16T17:25:55,Amurrio,Expense,cash,-100.0,-9392.41
buyer_3,Ana,35,ES47209566635349086821,TRX_N-00158-50472498,2022-05-16T12:34:31,Amurrio,Expense,gifts,-331.31,-9723.72
buyer_3,Ana,35,ES47209566635349086821,TRX_N-00159-61873726,2022-05-17T18:26:28,Amurrio,Expense,food,-70.95,-9794.67
buyer_3,Ana,35,ES47209566635349086821,TRX_N-00160-76670951,2022-05-17T20:26:09,Alegr√≠a-Dulantzi,Expense,cash,-100.0,-9894.67
buyer_3,Ana,35,ES47209566635349086821,TRX_N-00161-87307665,2022-05-18T14:41:49,Amurrio,Expense,clothing,-154.3,-10048.97
buyer_3,Ana,35,ES47209566635349086821,TRX_N-00162-06621660,2022-05-18T19:19:12,Amurrio,Expense,cash,-100.0,-10148.97
buyer_3,Ana,35,ES47209566635349086821,TRX_N-00163-20435402,2022-05-19T05:59:10,Amurrio,Expense,cash,-100.0,-10248.97
buyer_3,Ana,35,ES47209566635349086821,TRX_N-00164-96709289,2022-05-20T18:27:20,Amurrio,Expense,appliances,-170.78,-10419.75
buyer_3,Ana,35,ES47209566635349086821,TRX_N-00165-68031510,2022-05-20T18:35:23,Arrasate,Expense,repairs,-84.13,-10503.88
buyer_3,Ana,35,ES47209566635349086821,TRX_N-00166-91997621,2022-05-21T19:51:25,Amurrio,Expense,leisure,-58.11,-10561.99
buyer_3,Ana,35,ES47209566635349086821,TRX_N-00167-01514927,2022-05-21T12:07:47,Amurrio,Expense,cash,-100.0,-10661.99
buyer_3,Ana,35,ES47209566635349086821,TRX_N-00168-98380731,2022-05-22T20:52:44,Amurrio,Expense,education,-68.19,-10730.18
buyer_3,Ana,35,ES47209566635349086821,TRX_N-00169-39538106,2022-05-22T10:23:07,Amurrio,Expense,cash,-100.0,-10830.18
buyer_3,Ana,35,ES47209566635349086821,TRX_N-00170-75032221,2022-05-22T09:34:09,Amurrio,Expense,repairs,-102.16,-10932.34
buyer_3,Ana,35,ES47209566635349086821,TRX_N-00171-20412030,2022-05-25T04:16:50,Amurrio,Expense,leisure,-62.63,-10994.97
buyer_3,Ana,35,ES47209566635349086821,TRX_N-00172-29037403,2022-05-25T12:48:21,Amurrio,Expense,clothing,-104.15,-11099.12
buyer_3,Ana,35,ES47209566635349086821,TRX_N-00173-46673392,2022-05-26T14:24:03,Santurtzi,Expense,gifts,-600.76,-11699.88
buyer_3,Ana,35,ES47209566635349086821,TRX_N-00174-24987997,2022-05-27T19:16:51,Amurrio,Expense,cash,-100.0,-11799.88
buyer_3,Ana,35,ES47209566635349086821,TRX_N-00175-80662445,2022-05-29T20:31:15,Salvatierra/Agurain,Expense,gifts,-384.16,-12184.04
buyer_3,Ana,35,ES47209566635349086821,TRX_N-00176-37860141,2022-05-30T20:31:18,Amurrio,Expense,transport,-48.71,-12232.75
buyer_3,Ana,35,ES47209566635349086821,TRX_N-00177-72931908,2022-05-30T16:33:48,Amurrio,Expense,repairs,-175.28,-12408.03
buyer_3,Ana,35,ES47209566635349086821,TRX_N-00178-91672604,2022-06-01T09:31:00,Amurrio,incomes,salary,1496.83,-10911.2
buyer_3,Ana,35,ES47209566635349086821,TRX_N-00179-23111570,2022-06-01T09:31:00,Amurrio,incomes,salary_partner,1606.65,-9304.55
buyer_3,Ana,35,ES47209566635349086821,TRX_N-00180-83653895,2022-06-01T09:31:00,Amurrio,incomes,salary_bonus,1084.86,-8219.69
buyer_3,Ana,35,ES47209566635349086821,TRX_N-00181-12467069,2022-06-01T09:31:00,Amurrio,incomes,salary_partner_bonus,1134.58,-7085.11
buyer_3,Ana,35,ES47209566635349086821,TRX_N-00182-51346867,2022-06-03T20:20:00,Amurrio,Expense,travel,-1688.18,-8773.29
buyer_3,Ana,35,ES47209566635349086821,TRX_N-00183-07145970,2022-06-04T12:30:15,Amurrio,expenses,mortgage,-865.74,-9639.03
buyer_3,Ana,35,ES47209566635349086821,TRX_N-00184-27750638,2022-06-04T17:07:12,Amurrio,Expense,leisure,-52.95,-9691.98
buyer_3,Ana,35,ES47209566635349086821,TRX_N-00185-26533123,2022-06-05T10:12:33,Amurrio,expenses,electricity,-67.06,-9759.04
buyer_3,Ana,35,ES47209566635349086821,TRX_N-00186-86708951,2022-06-05T12:08:22,Amurrio,expenses,internet,-42.0,-9801.04
buyer_3,Ana,35,ES47209566635349086821,TRX_N-00187-48714126,2022-06-05T14:55:16,Amurrio,Expense,food,-78.21,-9879.25
buyer_3,Ana,35,ES47209566635349086821,TRX_N-00188-59585947,2022-06-06T13:33:41,Amurrio,expenses,phone,-39.99,-9919.24
buyer_3,Ana,35,ES47209566635349086821,TRX_N-00189-39112784,2022-06-06T02:41:01,Amurrio,Expense,food,-105.12,-10024.36
buyer_3,Ana,35,ES47209566635349086821,TRX_N-00190-42794836,2022-06-06T10:55:46,Amurrio,Expense,cash,-100.0,-10124.36
buyer_3,Ana,35,ES47209566635349086821,TRX_N-00191-54865791,2022-06-06T08:52:24,Sestao,Expense,gifts,-747.59,-10871.95
buyer_3,Ana,35,ES47209566635349086821,TRX_N-00192-23109336,2022-06-08T16:52:47,Amurrio,expenses,water,-35.04,-10906.99
buyer_3,Ana,35,ES47209566635349086821,TRX_N-00193-54779532,2022-06-08T10:29:45,Amurrio,expenses,gas,-41.53,-10948.52
buyer_3,Ana,35,ES47209566635349086821,TRX_N-00194-13916441,2022-06-08T20:12:12,Donostia,Expense,food,-119.28,-11067.8
buyer_3,Ana,35,ES47209566635349086821,TRX_N-00195-77012975,2022-06-09T23:40:58,Bilbao,Expense,education,-51.75,-11119.55
buyer_3,Ana,35,ES47209566635349086821,TRX_N-00196-80375256,2022-06-10T14:37:07,Irun,Expense,cash,-100.0,-11219.55
buyer_3,Ana,35,ES47209566635349086821,TRX_N-00197-49596902,2022-06-12T10:03:44,Amurrio,Expense,repairs,-95.19,-11314.74
buyer_3,Ana,35,ES47209566635349086821,TRX_N-00198-01602926,2022-06-13T17:38:16,Amurrio,Expense,cash,-100.0,-11414.74
buyer_3,Ana,35,ES47209566635349086821,TRX_N-00199-40623035,2022-06-13T17:27:03,Amurrio,Expense,repairs,-29.33,-11444.07
buyer_3,Ana,35,ES47209566635349086821,TRX_N-00200-37446543,2022-06-14T07:09:24,Amurrio,Expense,cash,-100.0,-11544.07
buyer_3,Ana,35,ES47209566635349086821,TRX_N-00201-39276551,2022-06-16T09:03:39,Amurrio,Expense,leisure,-28.98,-11573.05
buyer_3,Ana,35,ES47209566635349086821,TRX_N-00202-80312608,2022-06-17T18:54:22,Amurrio,Expense,food,-102.01,-11675.06
buyer_3,Ana,35,ES47209566635349086821,TRX_N-00203-47693081,2022-06-22T15:00:52,Amurrio,Expense,leisure,-18.4,-11693.46
buyer_3,Ana,35,ES47209566635349086821,TRX_N-00204-27934419,2022-06-24T15:35:49,Amurrio,Expense,transport,-68.25,-11761.71
buyer_3,Ana,35,ES47209566635349086821,TRX_N-00205-88507596,2022-06-25T16:35:29,Amurrio,Expense,food,-94.18,-11855.89
buyer_3,Ana,35,ES47209566635349086821,TRX_N-00206-93268339,2022-06-25T20:03:37,Amurrio,Expense,cash,-100.0,-11955.89
buyer_3,Ana,35,ES47209566635349086821,TRX_N-00207-48358903,2022-06-26T15:10:02,Amurrio,Expense,leisure,-79.54,-12035.43
buyer_3,Ana,35,ES47209566635349086821,TRX_N-00208-20824251,2022-06-28T18:06:11,Amurrio,expenses,children,-164.67,-12200.1
buyer_3,Ana,35,ES47209566635349086821,TRX_N-00209-52646278,2022-06-29T08:59:25,Amurrio,Expense,food,-93.85,-12293.95
buyer_3,Ana,35,ES47209566635349086821,TRX_N-00210-90652272,2022-06-29T22:52:32,Amurrio,Expense,cash,-100.0,-12393.95
buyer_3,Ana,35,ES47209566635349086821,TRX_N-00211-77038212,2022-07-01T12:30:25,Amurrio,incomes,salary,1496.83,-10897.12
buyer_3,Ana,35,ES47209566635349086821,TRX_N-00212-07222662,2022-07-01T12:30:25,Amurrio,incomes,salary_partner,1606.65,-9290.47
buyer_3,Ana,35,ES47209566635349086821,TRX_N-00213-23302385,2022-07-01T17:50:36,Amurrio,Expense,transport,-86.22,-9376.69
buyer_3,Ana,35,ES47209566635349086821,TRX_N-00214-56134668,2022-07-01T16:12:46,Salvatierra/Agurain,Expense,leisure,-49.43,-9426.12
buyer_3,Ana,35,ES47209566635349086821,TRX_N-00215-30438423,2022-07-02T12:15:43,Elciego,Expense,leisure,-80.07,-9506.19
buyer_3,Ana,35,ES47209566635349086821,TRX_N-00216-32521663,2022-07-02T13:11:46,Amurrio,Expense,travel,-959.26,-10465.45
buyer_3,Ana,35,ES47209566635349086821,TRX_N-00217-87633067,2022-07-04T21:35:32,Amurrio,expenses,mortgage,-865.74,-11331.19
buyer_3,Ana,35,ES47209566635349086821,TRX_N-00218-53108092,2022-07-04T18:07:51,Amurrio,Expense,leisure,-51.04,-11382.23
buyer_3,Ana,35,ES47209566635349086821,TRX_N-00219-60439454,2022-07-05T16:27:30,Amurrio,expenses,electricity,-49.19,-11431.42
buyer_3,Ana,35,ES47209566635349086821,TRX_N-00220-81959159,2022-07-05T19:36:48,Amurrio,expenses,gas,-77.23,-11508.65
buyer_3,Ana,35,ES47209566635349086821,TRX_N-00221-45520353,2022-07-06T12:09:49,Amurrio,expenses,internet,-42.0,-11550.65
buyer_3,Ana,35,ES47209566635349086821,TRX_N-00222-29763128,2022-07-06T17:03:00,Amurrio,expenses,phone,-30.29,-11580.94
buyer_3,Ana,35,ES47209566635349086821,TRX_N-00223-96427052,2022-07-06T17:55:32,Amurrio,Expense,cash,-100.0,-11680.94
buyer_3,Ana,35,ES47209566635349086821,TRX_N-00224-74400000,2022-07-07T05:03:12,Amurrio,Expense,food,-70.64,-11751.58
buyer_3,Ana,35,ES47209566635349086821,TRX_N-00225-06840992,2022-07-07T11:12:32,Amurrio,Expense,cash,-100.0,-11851.58
buyer_3,Ana,35,ES47209566635349086821,TRX_N-00226-38473702,2022-07-07T21:00:26,Amurrio,Expense,gifts,-361.22,-12212.8
buyer_3,Ana,35,ES47209566635349086821,TRX_N-00227-51094133,2022-07-08T16:49:27,Amurrio,expenses,water,-25.5,-12238.3
buyer_3,Ana,35,ES47209566635349086821,TRX_N-00228-61555067,2022-07-12T17:09:03,Amurrio,Expense,repairs,-120.04,-12358.34
buyer_3,Ana,35,ES47209566635349086821,TRX_N-00229-62125767,2022-07-13T13:47:04,Amurrio,Expense,leisure,-35.75,-12394.09
buyer_3,Ana,35,ES47209566635349086821,TRX_N-00230-96509163,2022-07-14T15:16:38,Sopela,Expense,leisure,-74.29,-12468.38
buyer_3,Ana,35,ES47209566635349086821,TRX_N-00231-69226880,2022-07-15T11:10:04,Amurrio,Expense,cash,-100.0,-12568.38
buyer_3,Ana,35,ES47209566635349086821,TRX_N-00232-59635258,2022-07-16T05:18:03,Amurrio,Expense,food,-89.28,-12657.66
buyer_3,Ana,35,ES47209566635349086821,TRX_N-00233-89264375,2022-07-17T12:05:54,Amurrio,Expense,food,-86.48,-12744.14
buyer_3,Ana,35,ES47209566635349086821,TRX_N-00234-37699379,2022-07-20T12:24:36,Amurrio,Expense,travel,-937.91,-13682.05
buyer_3,Ana,35,ES47209566635349086821,TRX_N-00235-79922498,2022-07-24T11:29:24,Amurrio,Expense,transport,-46.98,-13729.03
buyer_3,Ana,35,ES47209566635349086821,TRX_N-00236-37508134,2022-07-24T08:37:47,Amurrio,Expense,cash,-100.0,-13829.03
buyer_3,Ana,35,ES47209566635349086821,TRX_N-00237-05557323,2022-07-25T19:09:21,Amurrio,Expense,food,-101.35,-13930.38
buyer_3,Ana,35,ES47209566635349086821,TRX_N-00238-98500131,2022-07-26T06:08:54,Amurrio,Expense,clothing,-151.38,-14081.76
buyer_3,Ana,35,ES47209566635349086821,TRX_N-00239-36490023,2022-07-26T15:47:56,Amurrio,Expense,appliances,-104.45,-14186.21
buyer_3,Ana,35,ES47209566635349086821,TRX_N-00240-63110784,2022-07-27T15:45:17,Amurrio,Expense,cash,-100.0,-14286.21
buyer_3,Ana,35,ES47209566635349086821,TRX_N-00241-83051931,2022-07-28T18:05:42,Amurrio,Expense,leisure,-55.25,-14341.46
buyer_3,Ana,35,ES47209566635349086821,TRX_N-00242-53029966,2022-07-29T08:50:07,Amurrio,Expense,leisure,-69.84,-14411.3
buyer_3,Ana,35,ES47209566635349086821,TRX_N-00243-24846545,2022-07-30T11:50:08,Amurrio,Expense,repairs,-209.37,-14620.67
buyer_3,Ana,35,ES47209566635349086821,TRX_N-00244-02535250,2022-08-01T10:17:28,Amurrio,incomes,salary,1496.83,-13123.84
buyer_3,Ana,35,ES47209566635349086821,TRX_N-00245-52383813,2022-08-01T10:17:28,Amurrio,incomes,salary_partner,1606.65,-11517.19
buyer_3,Ana,35,ES47209566635349086821,TRX_N-00246-54021068,2022-08-01T10:17:28,Amurrio,incomes,extra_income,171.11,-11346.08
buyer_3,Ana,35,ES47209566635349086821,TRX_N-00247-62672106,2022-08-04T09:22:31,Amurrio,expenses,mortgage,-865.74,-12211.82
buyer_3,Ana,35,ES47209566635349086821,TRX_N-00248-30671024,2022-08-05T13:47:50,Amurrio,expenses,water,-25.11,-12236.93
buyer_3,Ana,35,ES47209566635349086821,TRX_N-00249-48512481,2022-08-05T19:49:22,Amurrio,expenses,internet,-42.0,-12278.93
buyer_3,Ana,35,ES47209566635349086821,TRX_N-00250-01331394,2022-08-05T11:45:08,Amurrio,expenses,phone,-37.11,-12316.04
buyer_3,Ana,35,ES47209566635349086821,TRX_N-00251-75970950,2022-08-07T10:59:12,Amurrio,Expense,healthcare,-158.81,-12474.85
buyer_3,Ana,35,ES47209566635349086821,TRX_N-00252-44144832,2022-08-08T10:22:33,Amurrio,expenses,electricity,-47.77,-12522.62
buyer_3,Ana,35,ES47209566635349086821,TRX_N-00253-18071564,2022-08-08T12:37:12,Amurrio,expenses,gas,-53.67,-12576.29
buyer_3,Ana,35,ES47209566635349086821,TRX_N-00254-43668851,2022-08-08T21:41:44,Amurrio,Expense,cash,-100.0,-12676.29
buyer_3,Ana,35,ES47209566635349086821,TRX_N-00255-96460677,2022-08-10T10:03:24,Amurrio,expenses,children,-102.82,-12779.11
buyer_3,Ana,35,ES47209566635349086821,TRX_N-00256-28465968,2022-08-12T14:22:07,Amurrio,expenses,children,-178.87,-12957.98
buyer_3,Ana,35,ES47209566635349086821,TRX_N-00257-77934210,2022-08-13T15:43:17,Erandio,Expense,cash,-100.0,-13057.98
buyer_3,Ana,35,ES47209566635349086821,TRX_N-00258-83721156,2022-08-13T11:40:36,Amurrio,expenses,children,-158.36,-13216.34
buyer_3,Ana,35,ES47209566635349086821,TRX_N-00259-30546228,2022-08-15T14:53:55,Amurrio,Expense,transport,-86.7,-13303.04
buyer_3,Ana,35,ES47209566635349086821,TRX_N-00260-76277436,2022-08-16T09:55:31,Amurrio,Expense,food,-121.6,-13424.64
buyer_3,Ana,35,ES47209566635349086821,TRX_N-00261-56221397,2022-08-16T11:39:01,Amurrio,Expense,cash,-100.0,-13524.64
buyer_3,Ana,35,ES47209566635349086821,TRX_N-00262-82763629,2022-08-19T13:22:58,Sestao,Expense,transport,-70.31,-13594.95
buyer_3,Ana,35,ES47209566635349086821,TRX_N-00263-46775557,2022-08-23T13:35:38,Donostia,Expense,food,-117.56,-13712.51
buyer_3,Ana,35,ES47209566635349086821,TRX_N-00264-78540041,2022-08-23T13:31:50,Amurrio,Expense,healthcare,-184.41,-13896.92
buyer_3,Ana,35,ES47209566635349086821,TRX_N-00265-52533397,2022-08-23T17:34:28,Amurrio,Expense,appliances,-403.41,-14300.33
buyer_3,Ana,35,ES47209566635349086821,TRX_N-00266-16396528,2022-08-24T03:34:48,Amurrio,Expense,leisure,-78.91,-14379.24
buyer_3,Ana,35,ES47209566635349086821,TRX_N-00267-32200130,2022-08-24T19:53:21,Amurrio,Expense,education,-48.34,-14427.58
buyer_3,Ana,35,ES47209566635349086821,TRX_N-00268-13201254,2022-08-25T13:15:06,Amurrio,Expense,gifts,-42.98,-14470.56
buyer_3,Ana,35,ES47209566635349086821,TRX_N-00269-62293721,2022-08-27T15:08:08,Santurtzi,Expense,gifts,-164.41,-14634.97
buyer_3,Ana,35,ES47209566635349086821,TRX_N-00270-05171927,2022-08-28T11:43:04,Amurrio,Expense,cash,-100.0,-14734.97
buyer_3,Ana,35,ES47209566635349086821,TRX_N-00271-32634505,2022-08-29T21:24:25,Amurrio,Expense,repairs,-274.47,-15009.44
buyer_3,Ana,35,ES47209566635349086821,TRX_N-00272-78909180,2022-08-30T09:01:46,Amurrio,expenses,children,-245.61,-15255.05
buyer_3,Ana,35,ES47209566635349086821,TRX_N-00273-96263084,2022-08-31T19:24:18,Amurrio,Expense,food,-60.8,-15315.85
buyer_3,Ana,35,ES47209566635349086821,TRX_N-00274-27390345,2022-09-01T16:29:17,Amurrio,incomes,salary,1496.83,-13819.02
buyer_3,Ana,35,ES47209566635349086821,TRX_N-00275-77968972,2022-09-01T16:29:17,Amurrio,incomes,salary_partner,1606.65,-12212.37
buyer_3,Ana,35,ES47209566635349086821,TRX_N-00276-39768293,2022-09-01T21:20:24,Amurrio,Expense,appliances,-409.54,-12621.91
buyer_3,Ana,35,ES47209566635349086821,TRX_N-00277-77701826,2022-09-03T16:08:50,Amurrio,Expense,food,-97.03,-12718.94
buyer_3,Ana,35,ES47209566635349086821,TRX_N-00278-07576754,2022-09-03T13:33:24,Amurrio,Expense,clothing,-71.59,-12790.53
buyer_3,Ana,35,ES47209566635349086821,TRX_N-00279-85604902,2022-09-04T12:41:17,Amurrio,expenses,mortgage,-865.74,-13656.27
buyer_3,Ana,35,ES47209566635349086821,TRX_N-00280-61725743,2022-09-05T10:44:46,Amurrio,expenses,water,-43.77,-13700.04
buyer_3,Ana,35,ES47209566635349086821,TRX_N-00281-64561625,2022-09-05T12:25:06,Amurrio,expenses,internet,-42.0,-13742.04
buyer_3,Ana,35,ES47209566635349086821,TRX_N-00282-56284028,2022-09-06T18:56:30,Amurrio,Expense,leisure,-71.91,-13813.95
buyer_3,Ana,35,ES47209566635349086821,TRX_N-00283-77922759,2022-09-06T10:49:57,Amurrio,Expense,appliances,-179.41,-13993.36
buyer_3,Ana,35,ES47209566635349086821,TRX_N-00284-14175771,2022-09-08T15:31:01,Amurrio,expenses,phone,-32.47,-14025.83
buyer_3,Ana,35,ES47209566635349086821,TRX_N-00285-26864964,2022-09-08T22:05:44,Amurrio,expenses,electricity,-59.29,-14085.12
buyer_3,Ana,35,ES47209566635349086821,TRX_N-00286-02204595,2022-09-08T01:02:21,Amurrio,expenses,gas,-94.84,-14179.96
buyer_3,Ana,35,ES47209566635349086821,TRX_N-00287-60968999,2022-09-15T18:51:02,Getxo,Expense,transport,-42.99,-14222.95
buyer_3,Ana,35,ES47209566635349086821,TRX_N-00288-30091784,2022-09-16T18:53:37,Zuia,Expense,cash,-100.0,-14322.95
buyer_3,Ana,35,ES47209566635349086821,TRX_N-00289-99883295,2022-09-17T22:47:57,Amurrio,Expense,cash,-100.0,-14422.95
buyer_3,Ana,35,ES47209566635349086821,TRX_N-00290-12750917,2022-09-18T11:01:31,Amurrio,Expense,repairs,-274.39,-14697.34
buyer_3,Ana,35,ES47209566635349086821,TRX_N-00291-29111677,2022-09-21T13:10:30,Errenteria,Expense,repairs,-69.22,-14766.56
buyer_3,Ana,35,ES47209566635349086821,TRX_N-00292-41928658,2022-09-22T09:39:16,Amurrio,Expense,leisure,-64.17,-14830.73
buyer_3,Ana,35,ES47209566635349086821,TRX_N-00293-60728058,2022-09-22T14:28:48,Getxo,Expense,education,-62.98,-14893.71
buyer_3,Ana,35,ES47209566635349086821,TRX_N-00294-48432775,2022-09-23T11:49:16,Amurrio,Expense,clothing,-63.19,-14956.9
buyer_3,Ana,35,ES47209566635349086821,TRX_N-00295-43815885,2022-09-23T18:01:42,Amurrio,Expense,cash,-100.0,-15056.9
buyer_3,Ana,35,ES47209566635349086821,TRX_N-00296-75957129,2022-09-25T13:45:05,Amurrio,Expense,healthcare,-64.79,-15121.69
buyer_3,Ana,35,ES47209566635349086821,TRX_N-00297-65555457,2022-09-27T18:34:42,Amurrio,Expense,food,-119.27,-15240.96
buyer_3,Ana,35,ES47209566635349086821,TRX_N-00298-70109611,2022-09-27T20:43:07,Amurrio,Expense,gifts,-342.88,-15583.84
buyer_3,Ana,35,ES47209566635349086821,TRX_N-00299-80428145,2022-09-28T20:54:31,Durango,Expense,leisure,-28.94,-15612.78
buyer_3,Ana,35,ES47209566635349086821,TRX_N-00300-32428501,2022-09-29T12:38:08,Amurrio,Expense,food,-62.88,-15675.66
buyer_3,Ana,35,ES47209566635349086821,TRX_N-00301-77737204,2022-10-01T12:55:50,Amurrio,incomes,salary,1496.83,-14178.83
buyer_3,Ana,35,ES47209566635349086821,TRX_N-00302-31758948,2022-10-01T12:55:50,Amurrio,incomes,salary_partner,1606.65,-12572.18
buyer_3,Ana,35,ES47209566635349086821,TRX_N-00303-38873260,2022-10-01T19:44:20,Amurrio,Expense,gifts,-466.37,-13038.55
buyer_3,Ana,35,ES47209566635349086821,TRX_N-00304-61193766,2022-10-01T22:33:26,Amurrio,expenses,children,-97.47,-13136.02
buyer_3,Ana,35,ES47209566635349086821,TRX_N-00305-94580128,2022-10-03T16:37:47,Amurrio,Expense,healthcare,-55.51,-13191.53
buyer_3,Ana,35,ES47209566635349086821,TRX_N-00306-09424169,2022-10-03T17:07:40,Amurrio,Expense,cash,-100.0,-13291.53
buyer_3,Ana,35,ES47209566635349086821,TRX_N-00307-05154714,2022-10-04T15:57:01,Amurrio,expenses,mortgage,-865.74,-14157.27
buyer_3,Ana,35,ES47209566635349086821,TRX_N-00308-41402131,2022-10-04T08:46:38,Amurrio,Expense,clothing,-50.47,-14207.74
buyer_3,Ana,35,ES47209566635349086821,TRX_N-00309-29537057,2022-10-05T12:01:52,Amurrio,expenses,water,-25.67,-14233.41
buyer_3,Ana,35,ES47209566635349086821,TRX_N-00310-63959153,2022-10-05T08:01:44,Amurrio,Expense,leisure,-75.85,-14309.26
buyer_3,Ana,35,ES47209566635349086821,TRX_N-00311-25387215,2022-10-06T21:58:50,Amurrio,expenses,gas,-81.36,-14390.62
buyer_3,Ana,35,ES47209566635349086821,TRX_N-00312-18679862,2022-10-06T15:35:22,Amurrio,expenses,internet,-42.0,-14432.62
buyer_3,Ana,35,ES47209566635349086821,TRX_N-00313-74394635,2022-10-07T13:29:15,Amurrio,expenses,electricity,-39.53,-14472.15
buyer_3,Ana,35,ES47209566635349086821,TRX_N-00314-85124895,2022-10-07T22:20:53,Amurrio,Expense,leisure,-76.32,-14548.47
buyer_3,Ana,35,ES47209566635349086821,TRX_N-00315-49387902,2022-10-08T19:34:08,Amurrio,expenses,phone,-37.53,-14586.0
buyer_3,Ana,35,ES47209566635349086821,TRX_N-00316-59610278,2022-10-10T16:14:05,Amurrio,Expense,food,-120.15,-14706.15
buyer_3,Ana,35,ES47209566635349086821,TRX_N-00317-25525379,2022-10-11T12:48:51,Amurrio,Expense,appliances,-167.47,-14873.62
buyer_3,Ana,35,ES47209566635349086821,TRX_N-00318-28460082,2022-10-12T11:55:43,Amurrio,Expense,cash,-100.0,-14973.62
buyer_3,Ana,35,ES47209566635349086821,TRX_N-00319-68928333,2022-10-13T15:49:54,Amurrio,Expense,leisure,-78.49,-15052.11
buyer_3,Ana,35,ES47209566635349086821,TRX_N-00320-49459311,2022-10-14T15:11:19,Amurrio,Expense,food,-80.1,-15132.21
buyer_3,Ana,35,ES47209566635349086821,TRX_N-00321-89192781,2022-10-15T14:26:57,Amurrio,Expense,transport,-60.94,-15193.15
buyer_3,Ana,35,ES47209566635349086821,TRX_N-00322-94730835,2022-10-22T05:14:27,Amurrio,Expense,food,-64.12,-15257.27
buyer_3,Ana,35,ES47209566635349086821,TRX_N-00323-77161629,2022-10-29T15:29:30,Amurrio,Expense,leisure,-81.44,-15338.71
buyer_3,Ana,35,ES47209566635349086821,TRX_N-00324-83271906,2022-10-31T13:27:39,Amurrio,Expense,leisure,-40.13,-15378.84
buyer_3,Ana,35,ES47209566635349086821,TRX_N-00325-20765104,2022-11-01T19:33:23,Amurrio,incomes,salary,1496.83,-13882.01
buyer_3,Ana,35,ES47209566635349086821,TRX_N-00326-62272438,2022-11-01T19:33:23,Amurrio,incomes,salary_partner,1606.65,-12275.36
buyer_3,Ana,35,ES47209566635349086821,TRX_N-00327-60166970,2022-11-02T19:30:55,Amurrio,Expense,leisure,-28.41,-12303.77
buyer_3,Ana,35,ES47209566635349086821,TRX_N-00328-92418913,2022-11-03T18:49:21,Donostia,Expense,cash,-100.0,-12403.77
buyer_3,Ana,35,ES47209566635349086821,TRX_N-00329-78838393,2022-11-04T19:49:07,Amurrio,expenses,mortgage,-865.74,-13269.51
buyer_3,Ana,35,ES47209566635349086821,TRX_N-00330-89598197,2022-11-04T12:47:20,Amurrio,Expense,gifts,-427.46,-13696.97
buyer_3,Ana,35,ES47209566635349086821,TRX_N-00331-69861289,2022-11-05T11:04:51,Amurrio,expenses,electricity,-74.45,-13771.42
buyer_3,Ana,35,ES47209566635349086821,TRX_N-00332-13805317,2022-11-06T16:47:46,Amurrio,expenses,water,-29.74,-13801.16
buyer_3,Ana,35,ES47209566635349086821,TRX_N-00333-41450650,2022-11-06T12:12:04,Amurrio,expenses,internet,-42.0,-13843.16
buyer_3,Ana,35,ES47209566635349086821,TRX_N-00334-81752433,2022-11-06T14:57:15,Amurrio,Expense,leisure,-75.42,-13918.58
buyer_3,Ana,35,ES47209566635349086821,TRX_N-00335-29019713,2022-11-07T10:26:25,Amurrio,expenses,gas,-66.98,-13985.56
buyer_3,Ana,35,ES47209566635349086821,TRX_N-00336-28418057,2022-11-07T19:49:04,Amurrio,Expense,food,-107.05,-14092.61
buyer_3,Ana,35,ES47209566635349086821,TRX_N-00337-98920594,2022-11-07T14:09:50,Amurrio,Expense,leisure,-79.42,-14172.03
buyer_3,Ana,35,ES47209566635349086821,TRX_N-00338-86468931,2022-11-07T19:51:26,Hondarribia,Expense,travel,-872.67,-15044.7
buyer_3,Ana,35,ES47209566635349086821,TRX_N-00339-37956348,2022-11-08T23:31:33,Amurrio,expenses,phone,-30.23,-15074.93
buyer_3,Ana,35,ES47209566635349086821,TRX_N-00340-22858181,2022-11-08T23:26:13,Amurrio,Expense,education,-76.57,-15151.5
buyer_3,Ana,35,ES47209566635349086821,TRX_N-00341-18694560,2022-11-09T13:39:44,Amurrio,Expense,cash,-100.0,-15251.5
buyer_3,Ana,35,ES47209566635349086821,TRX_N-00342-28534796,2022-11-09T12:08:07,Amurrio,Expense,appliances,-212.81,-15464.31
buyer_3,Ana,35,ES47209566635349086821,TRX_N-00343-83948987,2022-11-10T03:33:11,Amurrio,Expense,cash,-100.0,-15564.31
buyer_3,Ana,35,ES47209566635349086821,TRX_N-00344-77117715,2022-11-11T13:57:52,Amurrio,Expense,repairs,-150.49,-15714.8
buyer_3,Ana,35,ES47209566635349086821,TRX_N-00345-25296140,2022-11-12T11:56:08,Amurrio,Expense,cash,-100.0,-15814.8
buyer_3,Ana,35,ES47209566635349086821,TRX_N-00346-38014042,2022-11-15T08:24:33,Amurrio,Expense,transport,-85.12,-15899.92
buyer_3,Ana,35,ES47209566635349086821,TRX_N-00347-55568173,2022-11-15T14:48:09,Amurrio,Expense,repairs,-241.51,-16141.43
buyer_3,Ana,35,ES47209566635349086821,TRX_N-00348-12809108,2022-11-18T20:58:04,Amurrio,Expense,leisure,-63.55,-16204.98
buyer_3,Ana,35,ES47209566635349086821,TRX_N-00349-75298451,2022-11-18T15:25:31,Berango,Expense,appliances,-341.51,-16546.49
buyer_3,Ana,35,ES47209566635349086821,TRX_N-00350-38748034,2022-11-19T12:56:48,Amurrio,Expense,transport,-41.99,-16588.48
buyer_3,Ana,35,ES47209566635349086821,TRX_N-00351-92639959,2022-11-19T12:08:44,Amurrio,Expense,repairs,-33.37,-16621.85
buyer_3,Ana,35,ES47209566635349086821,TRX_N-00352-41199474,2022-11-22T10:04:15,Amurrio,Expense,cash,-100.0,-16721.85
buyer_3,Ana,35,ES47209566635349086821,TRX_N-00353-38733058,2022-11-23T07:09:39,Amurrio,Expense,clothing,-100.73,-16822.58
buyer_3,Ana,35,ES47209566635349086821,TRX_N-00354-78971406,2022-11-24T18:49:06,Hondarribia,Expense,transport,-72.09,-16894.67
buyer_3,Ana,35,ES47209566635349086821,TRX_N-00355-95468140,2022-11-24T16:21:51,Amurrio,Expense,cash,-100.0,-16994.67
buyer_3,Ana,35,ES47209566635349086821,TRX_N-00356-20041940,2022-11-25T16:47:40,Amurrio,Expense,transport,-61.6,-17056.27
buyer_3,Ana,35,ES47209566635349086821,TRX_N-00357-03881457,2022-11-25T08:10:47,Amurrio,Expense,leisure,-74.9,-17131.17
buyer_3,Ana,35,ES47209566635349086821,TRX_N-00358-88657192,2022-11-26T11:31:36,Amurrio,Expense,cash,-100.0,-17231.17
buyer_3,Ana,35,ES47209566635349086821,TRX_N-00359-87963147,2022-11-27T14:10:03,Erandio,Expense,leisure,-72.52,-17303.69
buyer_3,Ana,35,ES47209566635349086821,TRX_N-00360-37935526,2022-11-28T13:02:30,Amurrio,Expense,food,-61.55,-17365.24
buyer_3,Ana,35,ES47209566635349086821,TRX_N-00361-48694437,2022-11-28T09:26:28,Amurrio,Expense,leisure,-37.26,-17402.5
buyer_3,Ana,35,ES47209566635349086821,TRX_N-00362-66210790,2022-12-01T09:34:00,Amurrio,incomes,salary,1496.83,-15905.67
buyer_3,Ana,35,ES47209566635349086821,TRX_N-00363-41723151,2022-12-01T09:34:00,Amurrio,incomes,salary_partner,1606.65,-14299.02
buyer_3,Ana,35,ES47209566635349086821,TRX_N-00364-78731883,2022-12-01T09:34:00,Amurrio,incomes,extra_income,171.11,-14127.91
buyer_3,Ana,35,ES47209566635349086821,TRX_N-00365-78641591,2022-12-01T09:34:00,Amurrio,incomes,salary_bonus,1195.53,-12932.38
buyer_3,Ana,35,ES47209566635349086821,TRX_N-00366-21205033,2022-12-01T09:34:00,Amurrio,incomes,salary_partner_bonus,1197.14,-11735.24
buyer_3,Ana,35,ES47209566635349086821,TRX_N-00367-84524158,2022-12-03T10:08:37,Amurrio,Expense,food,-93.94,-11829.18
buyer_3,Ana,35,ES47209566635349086821,TRX_N-00368-58506005,2022-12-03T12:44:47,Amurrio,expenses,children,-242.37,-12071.55
buyer_3,Ana,35,ES47209566635349086821,TRX_N-00369-94763803,2022-12-04T17:23:23,Amurrio,expenses,mortgage,-865.74,-12937.29
buyer_3,Ana,35,ES47209566635349086821,TRX_N-00370-25301974,2022-12-05T10:20:23,Amurrio,expenses,water,-38.42,-12975.71
buyer_3,Ana,35,ES47209566635349086821,TRX_N-00371-65869387,2022-12-05T17:09:43,Amurrio,Expense,leisure,-26.38,-13002.09
buyer_3,Ana,35,ES47209566635349086821,TRX_N-00372-01517219,2022-12-07T13:55:30,Amurrio,Expense,education,-52.88,-13054.97
buyer_3,Ana,35,ES47209566635349086821,TRX_N-00373-22768823,2022-12-08T12:05:44,Amurrio,expenses,internet,-42.0,-13096.97
buyer_3,Ana,35,ES47209566635349086821,TRX_N-00374-24229900,2022-12-08T21:36:13,Amurrio,expenses,phone,-43.4,-13140.37
buyer_3,Ana,35,ES47209566635349086821,TRX_N-00375-45527405,2022-12-08T13:16:02,Amurrio,expenses,electricity,-49.97,-13190.34
buyer_3,Ana,35,ES47209566635349086821,TRX_N-00376-63126541,2022-12-08T07:53:11,Amurrio,expenses,gas,-65.33,-13255.67
buyer_3,Ana,35,ES47209566635349086821,TRX_N-00377-74646130,2022-12-08T15:26:06,Amurrio,Expense,leisure,-71.94,-13327.61
buyer_3,Ana,35,ES47209566635349086821,TRX_N-00378-62732801,2022-12-08T18:29:54,Amurrio,Expense,clothing,-82.83,-13410.44
buyer_3,Ana,35,ES47209566635349086821,TRX_N-00379-56185492,2022-12-08T15:57:27,Amurrio,Expense,cash,-100.0,-13510.44
buyer_3,Ana,35,ES47209566635349086821,TRX_N-00380-80871901,2022-12-09T09:42:50,Amurrio,Expense,food,-70.53,-13580.97
buyer_3,Ana,35,ES47209566635349086821,TRX_N-00381-04255303,2022-12-10T21:43:46,Amurrio,Expense,appliances,-197.41,-13778.38
buyer_3,Ana,35,ES47209566635349086821,TRX_N-00382-69044951,2022-12-12T23:18:00,Amurrio,Expense,transport,-57.91,-13836.29
buyer_3,Ana,35,ES47209566635349086821,TRX_N-00383-95051093,2022-12-12T12:27:12,Amurrio,Expense,clothing,-75.67,-13911.96
buyer_3,Ana,35,ES47209566635349086821,TRX_N-00384-56594842,2022-12-12T14:01:58,Amurrio,Expense,cash,-100.0,-14011.96
buyer_3,Ana,35,ES47209566635349086821,TRX_N-00385-24998175,2022-12-13T20:28:25,Amurrio,Expense,food,-97.77,-14109.73
buyer_3,Ana,35,ES47209566635349086821,TRX_N-00386-56446190,2022-12-13T08:01:47,Amurrio,Expense,cash,-100.0,-14209.73
buyer_3,Ana,35,ES47209566635349086821,TRX_N-00387-45381012,2022-12-16T17:59:47,Amurrio,Expense,education,-51.59,-14261.32
buyer_3,Ana,35,ES47209566635349086821,TRX_N-00388-18518966,2022-12-16T09:10:57,Amurrio,Expense,cash,-100.0,-14361.32
buyer_3,Ana,35,ES47209566635349086821,TRX_N-00389-73691639,2022-12-16T11:02:32,Amurrio,expenses,children,-105.2,-14466.52
buyer_3,Ana,35,ES47209566635349086821,TRX_N-00390-00459646,2022-12-19T10:48:22,Amurrio,Expense,cash,-100.0,-14566.52
buyer_3,Ana,35,ES47209566635349086821,TRX_N-00391-07484818,2022-12-22T03:47:35,Amurrio,Expense,clothing,-63.84,-14630.36
buyer_3,Ana,35,ES47209566635349086821,TRX_N-00392-52145469,2022-12-22T13:14:43,Amurrio,Expense,cash,-100.0,-14730.36
buyer_3,Ana,35,ES47209566635349086821,TRX_N-00393-45143856,2022-12-23T13:09:23,Sestao,Expense,transport,-50.37,-14780.73
buyer_3,Ana,35,ES47209566635349086821,TRX_N-00394-60812442,2022-12-23T09:00:24,Amurrio,Expense,gifts,-74.76,-14855.49
buyer_3,Ana,35,ES47209566635349086821,TRX_N-00395-80703568,2022-12-26T13:26:55,Amurrio,Expense,transport,-44.85,-14900.34
buyer_3,Ana,35,ES47209566635349086821,TRX_N-00396-16468845,2022-12-26T12:17:07,Hondarribia,Expense,leisure,-77.25,-14977.59
buyer_3,Ana,35,ES47209566635349086821,TRX_N-00397-24909625,2022-12-26T12:07:14,Amurrio,Expense,gifts,-147.74,-15125.33
buyer_3,Ana,35,ES47209566635349086821,TRX_N-00398-88539591,2022-12-27T14:10:07,Amurrio,Expense,gifts,-227.88,-15353.21
buyer_3,Ana,35,ES47209566635349086821,TRX_N-00399-49245344,2022-12-30T15:56:38,Amurrio,Expense,cash,-100.0,-15453.21
buyer_3,Ana,35,ES47209566635349086821,TRX_N-00400-55250993,2022-12-31T18:36:05,Amurrio,Expense,leisure,-24.68,-15477.89
buyer_3,Ana,35,ES47209566635349086821,TRX_N-00401-36256562,2022-12-31T11:42:04,Amurrio,Expense,travel,-597.41,-16075.3
buyer_3,Ana,35,ES47209566635349086821,TRX_N-00402-75804263,2023-01-01T11:09:08,Amurrio,incomes,salary,1529.54,-14545.76
buyer_3,Ana,35,ES47209566635349086821,TRX_N-00403-88155700,2023-01-01T11:09:08,Amurrio,incomes,salary_partner,1641.76,-12904.0
buyer_3,Ana,35,ES47209566635349086821,TRX_N-00404-80911855,2023-01-01T14:57:44,Amurrio,Expense,healthcare,-75.85,-12979.85
buyer_3,Ana,35,ES47209566635349086821,TRX_N-00405-55449562,2023-01-01T15:29:11,Amurrio,Expense,education,-67.02,-13046.87
buyer_3,Ana,35,ES47209566635349086821,TRX_N-00406-41655544,2023-01-02T15:58:28,Amurrio,Expense,food,-123.66,-13170.53
buyer_3,Ana,35,ES47209566635349086821,TRX_N-00407-94009625,2023-01-03T19:52:10,Amurrio,Expense,repairs,-121.03,-13291.56
buyer_3,Ana,35,ES47209566635349086821,TRX_N-00408-39241237,2023-01-04T20:09:42,Amurrio,expenses,mortgage,-865.74,-14157.3
buyer_3,Ana,35,ES47209566635349086821,TRX_N-00409-03201730,2023-01-04T15:08:34,Amurrio,Expense,food,-100.75,-14258.05
buyer_3,Ana,35,ES47209566635349086821,TRX_N-00410-13741172,2023-01-05T16:30:51,Amurrio,expenses,gas,-73.63,-14331.68
buyer_3,Ana,35,ES47209566635349086821,TRX_N-00411-47412153,2023-01-07T08:26:39,Amurrio,expenses,internet,-42.0,-14373.68
buyer_3,Ana,35,ES47209566635349086821,TRX_N-00412-54470408,2023-01-07T14:54:08,Amurrio,Expense,food,-100.78,-14474.46
buyer_3,Ana,35,ES47209566635349086821,TRX_N-00413-36003035,2023-01-07T03:31:26,Amurrio,Expense,transport,-60.54,-14535.0
buyer_3,Ana,35,ES47209566635349086821,TRX_N-00414-53147838,2023-01-08T01:58:15,Amurrio,expenses,water,-25.7,-14560.7
buyer_3,Ana,35,ES47209566635349086821,TRX_N-00415-82215778,2023-01-08T10:36:46,Amurrio,expenses,electricity,-68.1,-14628.8
buyer_3,Ana,35,ES47209566635349086821,TRX_N-00416-78737868,2023-01-08T18:13:54,Amurrio,expenses,phone,-39.22,-14668.02
buyer_3,Ana,35,ES47209566635349086821,TRX_N-00417-28166983,2023-01-08T12:31:54,Amurrio,Expense,transport,-63.57,-14731.59
buyer_3,Ana,35,ES47209566635349086821,TRX_N-00418-81157890,2023-01-08T17:44:01,Amurrio,Expense,healthcare,-40.99,-14772.58
buyer_3,Ana,35,ES47209566635349086821,TRX_N-00419-63380389,2023-01-08T15:55:16,Amurrio,Expense,cash,-100.0,-14872.58
buyer_3,Ana,35,ES47209566635349086821,TRX_N-00420-48402389,2023-01-11T13:56:25,Amurrio,Expense,transport,-41.79,-14914.37
buyer_3,Ana,35,ES47209566635349086821,TRX_N-00421-55435484,2023-01-14T13:52:14,Vitoria-Gasteiz,Expense,transport,-75.29,-14989.66
buyer_3,Ana,35,ES47209566635349086821,TRX_N-00422-61793916,2023-01-17T20:55:10,Amurrio,Expense,food,-100.26,-15089.92
buyer_3,Ana,35,ES47209566635349086821,TRX_N-00423-89292498,2023-01-17T16:29:29,Amurrio,Expense,cash,-100.0,-15189.92
buyer_3,Ana,35,ES47209566635349086821,TRX_N-00424-45922852,2023-01-19T04:20:05,Amurrio,Expense,leisure,-37.26,-15227.18
buyer_3,Ana,35,ES47209566635349086821,TRX_N-00425-85345529,2023-01-21T12:07:54,Amurrio,Expense,appliances,-328.17,-15555.35
buyer_3,Ana,35,ES47209566635349086821,TRX_N-00426-55389465,2023-01-23T20:12:58,Alegr√≠a-Dulantzi,Expense,healthcare,-128.18,-15683.53
buyer_3,Ana,35,ES47209566635349086821,TRX_N-00427-26938663,2023-01-23T16:16:52,Amurrio,Expense,cash,-100.0,-15783.53
buyer_3,Ana,35,ES47209566635349086821,TRX_N-00428-21102035,2023-01-25T10:11:57,Amurrio,Expense,healthcare,-115.24,-15898.77
buyer_3,Ana,35,ES47209566635349086821,TRX_N-00429-90606868,2023-01-26T21:40:22,Amurrio,Expense,appliances,-106.56,-16005.33
buyer_3,Ana,35,ES47209566635349086821,TRX_N-00430-83390359,2023-01-27T17:05:01,Amurrio,Expense,transport,-72.58,-16077.91
buyer_3,Ana,35,ES47209566635349086821,TRX_N-00431-14002829,2023-01-28T19:05:54,Sestao,Expense,food,-88.6,-16166.51
buyer_3,Ana,35,ES47209566635349086821,TRX_N-00432-77007950,2023-01-29T10:14:55,Amurrio,expenses,children,-133.64,-16300.15
buyer_3,Ana,35,ES47209566635349086821,TRX_N-00433-26647846,2023-01-30T15:06:38,Amurrio,Expense,gifts,-186.85,-16487.0
buyer_3,Ana,35,ES47209566635349086821,TRX_N-00434-76071814,2023-01-31T18:12:05,Amurrio,Expense,food,-70.53,-16557.53
buyer_3,Ana,35,ES47209566635349086821,TRX_N-00435-62833551,2023-01-31T16:50:25,Amurrio,expenses,children,-84.18,-16641.71
buyer_3,Ana,35,ES47209566635349086821,TRX_N-00436-45130686,2023-02-01T09:48:56,Amurrio,incomes,salary,1529.54,-15112.17
buyer_3,Ana,35,ES47209566635349086821,TRX_N-00437-69544978,2023-02-01T09:48:56,Amurrio,incomes,salary_partner,1641.76,-13470.41
buyer_3,Ana,35,ES47209566635349086821,TRX_N-00438-59524389,2023-02-02T09:55:38,Amurrio,Expense,healthcare,-157.26,-13627.67
buyer_3,Ana,35,ES47209566635349086821,TRX_N-00439-05975302,2023-02-02T20:23:40,Amurrio,Expense,cash,-100.0,-13727.67
buyer_3,Ana,35,ES47209566635349086821,TRX_N-00440-69553653,2023-02-03T14:42:05,Amurrio,Expense,appliances,-192.79,-13920.46
buyer_3,Ana,35,ES47209566635349086821,TRX_N-00441-42541957,2023-02-03T14:56:37,Amurrio,Expense,gifts,-790.44,-14710.9
buyer_3,Ana,35,ES47209566635349086821,TRX_N-00442-78612727,2023-02-04T12:24:58,Amurrio,expenses,mortgage,-865.74,-15576.64
buyer_3,Ana,35,ES47209566635349086821,TRX_N-00443-44163991,2023-02-05T20:17:45,Amurrio,Expense,transport,-56.32,-15632.96
buyer_3,Ana,35,ES47209566635349086821,TRX_N-00444-87452995,2023-02-05T11:42:04,Amurrio,Expense,cash,-100.0,-15732.96
buyer_3,Ana,35,ES47209566635349086821,TRX_N-00445-82163346,2023-02-06T19:35:00,Amurrio,expenses,water,-24.88,-15757.84
buyer_3,Ana,35,ES47209566635349086821,TRX_N-00446-24639012,2023-02-06T09:29:51,Amurrio,expenses,electricity,-28.2,-15786.04
buyer_3,Ana,35,ES47209566635349086821,TRX_N-00447-80735224,2023-02-07T13:47:22,Amurrio,expenses,gas,-92.4,-15878.44
buyer_3,Ana,35,ES47209566635349086821,TRX_N-00448-65263171,2023-02-07T15:24:47,Amurrio,expenses,phone,-36.47,-15914.91
buyer_3,Ana,35,ES47209566635349086821,TRX_N-00449-15851426,2023-02-07T12:58:12,Amurrio,Expense,leisure,-59.76,-15974.67
buyer_3,Ana,35,ES47209566635349086821,TRX_N-00450-01723774,2023-02-07T14:53:57,Amurrio,Expense,clothing,-139.06,-16113.73
buyer_3,Ana,35,ES47209566635349086821,TRX_N-00451-67707974,2023-02-08T18:37:50,Amurrio,expenses,internet,-42.0,-16155.73
buyer_3,Ana,35,ES47209566635349086821,TRX_N-00452-04136144,2023-02-08T08:12:07,Berango,Expense,repairs,-189.91,-16345.64
buyer_3,Ana,35,ES47209566635349086821,TRX_N-00453-41418127,2023-02-10T12:48:57,Zuia,Expense,clothing,-139.68,-16485.32
buyer_3,Ana,35,ES47209566635349086821,TRX_N-00454-27772906,2023-02-11T09:55:02,Amurrio,Expense,leisure,-77.19,-16562.51
buyer_3,Ana,35,ES47209566635349086821,TRX_N-00455-80542710,2023-02-14T18:16:19,Arrasate,Expense,cash,-100.0,-16662.51
buyer_3,Ana,35,ES47209566635349086821,TRX_N-00456-13095945,2023-02-14T20:11:09,Donostia,Expense,repairs,-210.7,-16873.21
buyer_3,Ana,35,ES47209566635349086821,TRX_N-00457-25357224,2023-02-15T10:44:52,Amurrio,Expense,leisure,-67.33,-16940.54
buyer_3,Ana,35,ES47209566635349086821,TRX_N-00458-18393183,2023-02-15T17:22:46,Amurrio,Expense,clothing,-53.98,-16994.52
buyer_3,Ana,35,ES47209566635349086821,TRX_N-00459-44034720,2023-02-16T22:26:30,Amurrio,Expense,clothing,-121.8,-17116.32
buyer_3,Ana,35,ES47209566635349086821,TRX_N-00460-75856704,2023-02-20T16:06:26,Amurrio,Expense,food,-76.66,-17192.98
buyer_3,Ana,35,ES47209566635349086821,TRX_N-00461-37298890,2023-02-21T12:09:52,Amurrio,Expense,cash,-100.0,-17292.98
buyer_3,Ana,35,ES47209566635349086821,TRX_N-00462-83357624,2023-02-21T09:51:14,Amurrio,Expense,appliances,-122.98,-17415.96
buyer_3,Ana,35,ES47209566635349086821,TRX_N-00463-68173494,2023-02-21T14:37:46,Amurrio,Expense,gifts,-830.95,-18246.91
buyer_3,Ana,35,ES47209566635349086821,TRX_N-00464-32317013,2023-02-22T17:42:32,Amurrio,Expense,food,-88.51,-18335.42
buyer_3,Ana,35,ES47209566635349086821,TRX_N-00465-60489542,2023-02-22T13:59:59,Amurrio,Expense,healthcare,-96.72,-18432.14
buyer_3,Ana,35,ES47209566635349086821,TRX_N-00466-88488687,2023-02-22T19:29:15,Amurrio,Expense,appliances,-350.1,-18782.24
buyer_3,Ana,35,ES47209566635349086821,TRX_N-00467-64143910,2023-02-24T11:08:09,Amurrio,Expense,transport,-50.33,-18832.57
buyer_3,Ana,35,ES47209566635349086821,TRX_N-00468-40805896,2023-02-24T18:24:51,Amurrio,expenses,children,-154.98,-18987.55
buyer_3,Ana,35,ES47209566635349086821,TRX_N-00469-66572983,2023-02-25T15:57:54,Amurrio,Expense,food,-100.49,-19088.04
buyer_3,Ana,35,ES47209566635349086821,TRX_N-00470-51100302,2023-02-25T13:14:03,Amurrio,Expense,cash,-100.0,-19188.04
buyer_3,Ana,35,ES47209566635349086821,TRX_N-00471-48354214,2023-02-26T09:56:40,Amurrio,Expense,food,-65.37,-19253.41
buyer_3,Ana,35,ES47209566635349086821,TRX_N-00472-94008848,2023-02-26T11:24:17,Amurrio,Expense,cash,-100.0,-19353.41
buyer_3,Ana,35,ES47209566635349086821,TRX_N-00473-86880902,2023-02-26T11:59:23,Amurrio,Expense,gifts,-442.84,-19796.25
buyer_3,Ana,35,ES47209566635349086821,TRX_N-00474-29423165,2023-02-27T15:55:22,Amurrio,Expense,food,-96.4,-19892.65
buyer_3,Ana,35,ES47209566635349086821,TRX_N-00475-06766111,2023-03-01T09:50:40,Amurrio,incomes,salary,1529.54,-18363.11
buyer_3,Ana,35,ES47209566635349086821,TRX_N-00476-07242888,2023-03-01T09:50:40,Amurrio,incomes,salary_partner,1641.76,-16721.35
buyer_3,Ana,35,ES47209566635349086821,TRX_N-00477-12207038,2023-03-01T09:50:40,Amurrio,incomes,extra_income,171.11,-16550.24
buyer_3,Ana,35,ES47209566635349086821,TRX_N-00478-56084366,2023-03-02T14:27:20,Amurrio,Expense,food,-115.03,-16665.27
buyer_3,Ana,35,ES47209566635349086821,TRX_N-00479-25802631,2023-03-02T12:07:05,Amurrio,Expense,cash,-100.0,-16765.27
buyer_3,Ana,35,ES47209566635349086821,TRX_N-00480-48470422,2023-03-03T10:37:31,Sopela,Expense,clothing,-126.34,-16891.61
buyer_3,Ana,35,ES47209566635349086821,TRX_N-00481-12971514,2023-03-04T04:15:13,Amurrio,expenses,mortgage,-865.74,-17757.35
buyer_3,Ana,35,ES47209566635349086821,TRX_N-00482-19569714,2023-03-05T13:04:45,Amurrio,expenses,phone,-39.17,-17796.52
buyer_3,Ana,35,ES47209566635349086821,TRX_N-00483-21544401,2023-03-05T17:34:53,Amurrio,Expense,leisure,-83.23,-17879.75
buyer_3,Ana,35,ES47209566635349086821,TRX_N-00484-48937597,2023-03-05T15:39:52,Errenteria,Expense,cash,-100.0,-17979.75
buyer_3,Ana,35,ES47209566635349086821,TRX_N-00485-28296626,2023-03-05T14:26:25,Amurrio,Expense,appliances,-375.29,-18355.04
buyer_3,Ana,35,ES47209566635349086821,TRX_N-00486-74286569,2023-03-05T14:47:53,Amurrio,expenses,children,-169.27,-18524.31
buyer_3,Ana,35,ES47209566635349086821,TRX_N-00487-09668373,2023-03-08T17:15:33,Amurrio,expenses,electricity,-56.16,-18580.47
buyer_3,Ana,35,ES47209566635349086821,TRX_N-00488-88978254,2023-03-08T16:46:42,Amurrio,expenses,internet,-42.0,-18622.47
buyer_3,Ana,35,ES47209566635349086821,TRX_N-00489-30242690,2023-03-08T19:04:13,Amurrio,expenses,water,-22.82,-18645.29
buyer_3,Ana,35,ES47209566635349086821,TRX_N-00490-77697385,2023-03-08T10:40:25,Amurrio,expenses,gas,-95.9,-18741.19
buyer_3,Ana,35,ES47209566635349086821,TRX_N-00491-87024404,2023-03-08T08:22:03,Amurrio,Expense,transport,-47.56,-18788.75
buyer_3,Ana,35,ES47209566635349086821,TRX_N-00492-93833815,2023-03-10T11:12:06,Amurrio,Expense,transport,-63.68,-18852.43
buyer_3,Ana,35,ES47209566635349086821,TRX_N-00493-50777216,2023-03-12T13:21:25,Amurrio,Expense,gifts,-807.13,-19659.56
buyer_3,Ana,35,ES47209566635349086821,TRX_N-00494-04053679,2023-03-14T12:33:49,Andoain,Expense,gifts,-231.02,-19890.58
buyer_3,Ana,35,ES47209566635349086821,TRX_N-00495-58990910,2023-03-15T23:50:23,Amurrio,Expense,food,-60.7,-19951.28
buyer_3,Ana,35,ES47209566635349086821,TRX_N-00496-96765957,2023-03-18T22:22:59,Amurrio,Expense,cash,-100.0,-20051.28
buyer_3,Ana,35,ES47209566635349086821,TRX_N-00497-12278091,2023-03-22T09:18:01,Amurrio,Expense,travel,-1856.9,-21908.18
buyer_3,Ana,35,ES47209566635349086821,TRX_N-00498-32711505,2023-03-26T08:44:30,Amurrio,Expense,cash,-100.0,-22008.18
buyer_3,Ana,35,ES47209566635349086821,TRX_N-00499-40214898,2023-03-27T08:22:32,Amurrio,Expense,clothing,-146.83,-22155.01
buyer_3,Ana,35,ES47209566635349086821,TRX_N-00500-01201611,2023-03-29T13:01:57,Amurrio,Expense,repairs,-171.19,-22326.2
buyer_3,Ana,35,ES47209566635349086821,TRX_N-00501-71514455,2023-03-30T08:03:59,Amurrio,Expense,food,-70.11,-22396.31
buyer_3,Ana,35,ES47209566635349086821,TRX_N-00502-63876536,2023-03-31T20:51:30,Amurrio,Expense,clothing,-49.88,-22446.19
buyer_3,Ana,35,ES47209566635349086821,TRX_N-00503-60098742,2023-04-01T20:18:29,Amurrio,incomes,salary,1529.54,-20916.65
buyer_3,Ana,35,ES47209566635349086821,TRX_N-00504-37126658,2023-04-01T20:18:29,Amurrio,incomes,salary_partner,1641.76,-19274.89
buyer_3,Ana,35,ES47209566635349086821,TRX_N-00505-79104481,2023-04-04T07:56:31,Amurrio,expenses,mortgage,-865.74,-20140.63
buyer_3,Ana,35,ES47209566635349086821,TRX_N-00506-63056683,2023-04-05T13:00:37,Amurrio,expenses,water,-34.45,-20175.08
buyer_3,Ana,35,ES47209566635349086821,TRX_N-00507-15995190,2023-04-05T14:58:20,Amurrio,expenses,electricity,-20.52,-20195.6
buyer_3,Ana,35,ES47209566635349086821,TRX_N-00508-80257449,2023-04-07T11:33:23,Amurrio,Expense,cash,-100.0,-20295.6
buyer_3,Ana,35,ES47209566635349086821,TRX_N-00509-26889280,2023-04-08T08:16:07,Amurrio,expenses,internet,-42.0,-20337.6
buyer_3,Ana,35,ES47209566635349086821,TRX_N-00510-78013102,2023-04-08T13:52:03,Amurrio,expenses,gas,-36.27,-20373.87
buyer_3,Ana,35,ES47209566635349086821,TRX_N-00511-04916955,2023-04-08T13:32:34,Amurrio,expenses,phone,-32.35,-20406.22
buyer_3,Ana,35,ES47209566635349086821,TRX_N-00512-37917381,2023-04-09T14:33:00,Amurrio,Expense,cash,-100.0,-20506.22
buyer_3,Ana,35,ES47209566635349086821,TRX_N-00513-21848550,2023-04-10T08:20:20,Amurrio,Expense,repairs,-114.91,-20621.13
buyer_3,Ana,35,ES47209566635349086821,TRX_N-00514-36829386,2023-04-11T08:33:10,Amurrio,Expense,education,-75.81,-20696.94
buyer_3,Ana,35,ES47209566635349086821,TRX_N-00515-60465269,2023-04-11T06:54:33,Amurrio,expenses,children,-122.64,-20819.58
buyer_3,Ana,35,ES47209566635349086821,TRX_N-00516-09057006,2023-04-12T11:36:48,Sestao,Expense,leisure,-63.83,-20883.41
buyer_3,Ana,35,ES47209566635349086821,TRX_N-00517-10581116,2023-04-12T16:20:56,Amurrio,Expense,cash,-100.0,-20983.41
buyer_3,Ana,35,ES47209566635349086821,TRX_N-00518-66590152,2023-04-14T18:42:08,Amurrio,Expense,travel,-1276.26,-22259.67
buyer_3,Ana,35,ES47209566635349086821,TRX_N-00519-47435057,2023-04-15T10:36:21,Amurrio,Expense,leisure,-38.76,-22298.43
buyer_3,Ana,35,ES47209566635349086821,TRX_N-00520-60120174,2023-04-15T09:48:40,Amurrio,Expense,clothing,-152.81,-22451.24
buyer_3,Ana,35,ES47209566635349086821,TRX_N-00521-04339602,2023-04-16T14:57:42,Amurrio,Expense,food,-108.23,-22559.47
buyer_3,Ana,35,ES47209566635349086821,TRX_N-00522-41017826,2023-04-18T20:31:21,Amurrio,Expense,education,-75.7,-22635.17
buyer_3,Ana,35,ES47209566635349086821,TRX_N-00523-01266791,2023-04-20T16:10:46,Amurrio,Expense,transport,-62.74,-22697.91
buyer_3,Ana,35,ES47209566635349086821,TRX_N-00524-20744046,2023-04-22T11:57:52,Amurrio,Expense,leisure,-48.04,-22745.95
buyer_3,Ana,35,ES47209566635349086821,TRX_N-00525-16850883,2023-04-23T19:29:42,Eibar,Expense,food,-119.57,-22865.52
buyer_3,Ana,35,ES47209566635349086821,TRX_N-00526-57178718,2023-04-29T17:24:32,Amurrio,Expense,transport,-84.35,-22949.87
buyer_3,Ana,35,ES47209566635349086821,TRX_N-00527-02614181,2023-04-30T16:04:29,Bilbao,Expense,repairs,-32.82,-22982.69
buyer_3,Ana,35,ES47209566635349086821,TRX_N-00528-29054675,2023-05-01T08:30:03,Amurrio,incomes,salary,1529.54,-21453.15
buyer_3,Ana,35,ES47209566635349086821,TRX_N-00529-69488937,2023-05-01T08:30:03,Amurrio,incomes,salary_partner,1641.76,-19811.39
buyer_3,Ana,35,ES47209566635349086821,TRX_N-00530-62290039,2023-05-01T12:53:15,Amurrio,Expense,food,-96.46,-19907.85
buyer_3,Ana,35,ES47209566635349086821,TRX_N-00531-25960613,2023-05-03T09:11:12,Amurrio,Expense,cash,-100.0,-20007.85
buyer_3,Ana,35,ES47209566635349086821,TRX_N-00532-53385481,2023-05-04T08:13:05,Amurrio,expenses,mortgage,-865.74,-20873.59
buyer_3,Ana,35,ES47209566635349086821,TRX_N-00533-51658273,2023-05-04T17:57:56,Portugalete,Expense,cash,-100.0,-20973.59
buyer_3,Ana,35,ES47209566635349086821,TRX_N-00534-51635814,2023-05-05T17:02:43,Amurrio,expenses,water,-32.24,-21005.83
buyer_3,Ana,35,ES47209566635349086821,TRX_N-00535-17785321,2023-05-05T20:41:54,Amurrio,expenses,internet,-42.0,-21047.83
buyer_3,Ana,35,ES47209566635349086821,TRX_N-00536-32230639,2023-05-06T15:59:23,Amurrio,expenses,phone,-42.47,-21090.3
buyer_3,Ana,35,ES47209566635349086821,TRX_N-00537-38845986,2023-05-06T22:00:46,Amurrio,Expense,leisure,-54.24,-21144.54
buyer_3,Ana,35,ES47209566635349086821,TRX_N-00538-64557366,2023-05-07T11:04:57,Amurrio,Expense,repairs,-233.08,-21377.62
buyer_3,Ana,35,ES47209566635349086821,TRX_N-00539-60730466,2023-05-08T15:09:12,Amurrio,expenses,gas,-73.49,-21451.11
buyer_3,Ana,35,ES47209566635349086821,TRX_N-00540-43050931,2023-05-08T19:07:22,Amurrio,expenses,electricity,-75.49,-21526.6
buyer_3,Ana,35,ES47209566635349086821,TRX_N-00541-18011991,2023-05-09T08:31:22,Amurrio,Expense,transport,-85.07,-21611.67
buyer_3,Ana,35,ES47209566635349086821,TRX_N-00542-18463662,2023-05-10T20:23:21,Zuia,Expense,transport,-64.29,-21675.96
buyer_3,Ana,35,ES47209566635349086821,TRX_N-00543-94988345,2023-05-11T10:52:27,Amurrio,Expense,leisure,-76.44,-21752.4
buyer_3,Ana,35,ES47209566635349086821,TRX_N-00544-92446249,2023-05-12T15:14:50,Amurrio,Expense,cash,-100.0,-21852.4
buyer_3,Ana,35,ES47209566635349086821,TRX_N-00545-62205179,2023-05-13T10:13:25,Amurrio,Expense,transport,-63.69,-21916.09
buyer_3,Ana,35,ES47209566635349086821,TRX_N-00546-94654051,2023-05-16T17:15:23,Amurrio,Expense,food,-105.57,-22021.66
buyer_3,Ana,35,ES47209566635349086821,TRX_N-00547-71829004,2023-05-18T15:29:29,Amurrio,Expense,transport,-85.35,-22107.01
buyer_3,Ana,35,ES47209566635349086821,TRX_N-00548-38627761,2023-05-18T14:23:08,Amurrio,Expense,cash,-100.0,-22207.01
buyer_3,Ana,35,ES47209566635349086821,TRX_N-00549-72832972,2023-05-20T15:10:46,Lasarte-Oria,Expense,transport,-60.69,-22267.7
buyer_3,Ana,35,ES47209566635349086821,TRX_N-00550-02313165,2023-05-20T13:49:53,Amurrio,Expense,cash,-100.0,-22367.7
buyer_3,Ana,35,ES47209566635349086821,TRX_N-00551-18784270,2023-05-20T18:15:10,Amurrio,expenses,children,-68.64,-22436.34
buyer_3,Ana,35,ES47209566635349086821,TRX_N-00552-04384160,2023-05-21T19:37:43,Amurrio,Expense,cash,-100.0,-22536.34
buyer_3,Ana,35,ES47209566635349086821,TRX_N-00553-74021252,2023-05-22T11:05:41,Amurrio,Expense,food,-87.21,-22623.55
buyer_3,Ana,35,ES47209566635349086821,TRX_N-00554-87233680,2023-05-23T12:27:19,Amurrio,Expense,repairs,-291.08,-22914.63
buyer_3,Ana,35,ES47209566635349086821,TRX_N-00555-85316658,2023-05-25T22:26:23,Amurrio,Expense,gifts,-254.24,-23168.87
buyer_3,Ana,35,ES47209566635349086821,TRX_N-00556-96052227,2023-05-26T15:44:08,Amurrio,expenses,children,-77.37,-23246.24
buyer_3,Ana,35,ES47209566635349086821,TRX_N-00557-51155742,2023-05-27T15:35:16,Amurrio,Expense,leisure,-84.26,-23330.5
buyer_3,Ana,35,ES47209566635349086821,TRX_N-00558-10196572,2023-05-28T17:18:04,Amurrio,Expense,clothing,-151.76,-23482.26
buyer_3,Ana,35,ES47209566635349086821,TRX_N-00559-64811383,2023-05-30T13:30:27,Amurrio,Expense,clothing,-105.2,-23587.46
buyer_3,Ana,35,ES47209566635349086821,TRX_N-00560-56026568,2023-05-31T19:50:16,Amurrio,Expense,cash,-100.0,-23687.46
buyer_3,Ana,35,ES47209566635349086821,TRX_N-00561-38170078,2023-06-01T09:37:50,Amurrio,incomes,salary,1529.54,-22157.92
buyer_3,Ana,35,ES47209566635349086821,TRX_N-00562-74919475,2023-06-01T09:37:50,Amurrio,incomes,salary_partner,1641.76,-20516.16
buyer_3,Ana,35,ES47209566635349086821,TRX_N-00563-27903359,2023-06-01T09:37:50,Amurrio,incomes,salary_bonus,1121.04,-19395.12
buyer_3,Ana,35,ES47209566635349086821,TRX_N-00564-09204461,2023-06-01T09:37:50,Amurrio,incomes,salary_partner_bonus,1154.98,-18240.14
buyer_3,Ana,35,ES47209566635349086821,TRX_N-00565-83657327,2023-06-01T11:41:39,Amurrio,Expense,cash,-100.0,-18340.14
buyer_3,Ana,35,ES47209566635349086821,TRX_N-00566-61361681,2023-06-02T18:07:35,Amurrio,Expense,appliances,-148.75,-18488.89
buyer_3,Ana,35,ES47209566635349086821,TRX_N-00567-87842142,2023-06-03T13:26:03,Amurrio,Expense,healthcare,-68.69,-18557.58
buyer_3,Ana,35,ES47209566635349086821,TRX_N-00568-48093558,2023-06-04T21:01:27,Amurrio,expenses,mortgage,-865.74,-19423.32
buyer_3,Ana,35,ES47209566635349086821,TRX_N-00569-46686390,2023-06-04T20:00:57,Amurrio,Expense,cash,-100.0,-19523.32
buyer_3,Ana,35,ES47209566635349086821,TRX_N-00570-09158920,2023-06-05T16:00:10,Amurrio,expenses,water,-42.86,-19566.18
buyer_3,Ana,35,ES47209566635349086821,TRX_N-00571-11380420,2023-06-05T15:20:54,Amurrio,expenses,gas,-76.53,-19642.71
buyer_3,Ana,35,ES47209566635349086821,TRX_N-00572-00166569,2023-06-05T12:39:05,Amurrio,expenses,internet,-42.0,-19684.71
buyer_3,Ana,35,ES47209566635349086821,TRX_N-00573-90939975,2023-06-05T19:20:00,Amurrio,expenses,children,-175.89,-19860.6
buyer_3,Ana,35,ES47209566635349086821,TRX_N-00574-23897285,2023-06-07T17:24:43,Amurrio,Expense,repairs,-112.13,-19972.73
buyer_3,Ana,35,ES47209566635349086821,TRX_N-00575-36125896,2023-06-08T13:31:47,Amurrio,expenses,electricity,-68.04,-20040.77
buyer_3,Ana,35,ES47209566635349086821,TRX_N-00576-68734790,2023-06-08T15:53:55,Amurrio,expenses,phone,-44.51,-20085.28
buyer_3,Ana,35,ES47209566635349086821,TRX_N-00577-00244106,2023-06-09T07:26:12,Amurrio,Expense,cash,-100.0,-20185.28
buyer_3,Ana,35,ES47209566635349086821,TRX_N-00578-87200958,2023-06-10T21:38:33,Amurrio,Expense,clothing,-109.92,-20295.2
buyer_3,Ana,35,ES47209566635349086821,TRX_N-00579-90519242,2023-06-11T13:55:19,Amurrio,Expense,food,-66.74,-20361.94
buyer_3,Ana,35,ES47209566635349086821,TRX_N-00580-12940693,2023-06-11T20:09:52,Amurrio,Expense,healthcare,-157.83,-20519.77
buyer_3,Ana,35,ES47209566635349086821,TRX_N-00581-64233298,2023-06-11T12:42:40,Amurrio,Expense,repairs,-233.63,-20753.4
buyer_3,Ana,35,ES47209566635349086821,TRX_N-00582-52032516,2023-06-12T03:31:29,Vitoria-Gasteiz,Expense,food,-70.49,-20823.89
buyer_3,Ana,35,ES47209566635349086821,TRX_N-00583-12383543,2023-06-13T13:04:49,Amurrio,Expense,food,-83.74,-20907.63
buyer_3,Ana,35,ES47209566635349086821,TRX_N-00584-57004105,2023-06-13T18:18:32,Amurrio,Expense,clothing,-133.45,-21041.08
buyer_3,Ana,35,ES47209566635349086821,TRX_N-00585-97522064,2023-06-14T17:15:03,Amurrio,Expense,gifts,-404.7,-21445.78
buyer_3,Ana,35,ES47209566635349086821,TRX_N-00586-53537421,2023-06-15T23:55:19,Amurrio,Expense,food,-78.02,-21523.8
buyer_3,Ana,35,ES47209566635349086821,TRX_N-00587-21519460,2023-06-17T23:05:29,Amurrio,Expense,gifts,-408.36,-21932.16
buyer_3,Ana,35,ES47209566635349086821,TRX_N-00588-99835665,2023-06-19T12:06:16,Amurrio,Expense,leisure,-38.16,-21970.32
buyer_3,Ana,35,ES47209566635349086821,TRX_N-00589-67442320,2023-06-26T10:16:37,Amurrio,Expense,education,-65.37,-22035.69
buyer_3,Ana,35,ES47209566635349086821,TRX_N-00590-59452547,2023-06-27T12:11:04,Amurrio,Expense,repairs,-195.67,-22231.36
buyer_3,Ana,35,ES47209566635349086821,TRX_N-00591-50100930,2023-06-29T11:59:09,Amurrio,Expense,cash,-100.0,-22331.36
buyer_3,Ana,35,ES47209566635349086821,TRX_N-00592-23846362,2023-06-29T12:29:12,Amurrio,Expense,repairs,-282.25,-22613.61
buyer_3,Ana,35,ES47209566635349086821,TRX_N-00593-53584495,2023-06-30T16:13:59,Sopela,Expense,transport,-82.39,-22696.0
buyer_3,Ana,35,ES47209566635349086821,TRX_N-00594-19881171,2023-06-30T12:05:23,Amurrio,Expense,appliances,-250.79,-22946.79
buyer_3,Ana,35,ES47209566635349086821,TRX_N-00595-22743272,2023-06-30T15:25:51,Amurrio,Expense,gifts,-160.7,-23107.49
buyer_3,Ana,35,ES47209566635349086821,TRX_N-00596-65118171,2023-07-01T01:20:59,Amurrio,incomes,salary,1529.54,-21577.95
buyer_3,Ana,35,ES47209566635349086821,TRX_N-00597-59432426,2023-07-01T01:20:59,Amurrio,incomes,salary_partner,1641.76,-19936.19
buyer_3,Ana,35,ES47209566635349086821,TRX_N-00598-78811311,2023-07-01T01:20:59,Amurrio,incomes,extra_income,171.11,-19765.08
buyer_3,Ana,35,ES47209566635349086821,TRX_N-00599-50294327,2023-07-01T11:55:52,Amurrio,Expense,education,-66.08,-19831.16
buyer_3,Ana,35,ES47209566635349086821,TRX_N-00600-50519084,2023-07-03T11:39:41,Amurrio,Expense,healthcare,-58.56,-19889.72
buyer_3,Ana,35,ES47209566635349086821,TRX_N-00601-14395446,2023-07-04T14:05:49,Amurrio,expenses,mortgage,-865.74,-20755.46
buyer_3,Ana,35,ES47209566635349086821,TRX_N-00602-39187401,2023-07-04T12:42:05,Amurrio,Expense,transport,-73.14,-20828.6
buyer_3,Ana,35,ES47209566635349086821,TRX_N-00603-92053304,2023-07-05T13:24:14,Amurrio,expenses,phone,-43.17,-20871.77
buyer_3,Ana,35,ES47209566635349086821,TRX_N-00604-51072843,2023-07-06T15:58:58,Amurrio,expenses,water,-25.34,-20897.11
buyer_3,Ana,35,ES47209566635349086821,TRX_N-00605-69602478,2023-07-06T00:41:55,Amurrio,Expense,food,-71.34,-20968.45
buyer_3,Ana,35,ES47209566635349086821,TRX_N-00606-05020296,2023-07-07T23:20:03,Amurrio,expenses,gas,-100.94,-21069.39
buyer_3,Ana,35,ES47209566635349086821,TRX_N-00607-64828531,2023-07-08T11:15:11,Amurrio,expenses,electricity,-89.62,-21159.01
buyer_3,Ana,35,ES47209566635349086821,TRX_N-00608-06746024,2023-07-08T08:05:33,Amurrio,expenses,internet,-42.0,-21201.01
buyer_3,Ana,35,ES47209566635349086821,TRX_N-00609-22547434,2023-07-08T15:29:54,Amurrio,Expense,food,-95.26,-21296.27
buyer_3,Ana,35,ES47209566635349086821,TRX_N-00610-32716568,2023-07-09T21:13:22,Amurrio,Expense,food,-66.64,-21362.91
buyer_3,Ana,35,ES47209566635349086821,TRX_N-00611-43307106,2023-07-10T13:47:35,Amurrio,Expense,food,-74.97,-21437.88
buyer_3,Ana,35,ES47209566635349086821,TRX_N-00612-29014220,2023-07-11T17:01:54,Alegr√≠a-Dulantzi,Expense,food,-107.14,-21545.02
buyer_3,Ana,35,ES47209566635349086821,TRX_N-00613-65244561,2023-07-11T08:02:33,Portugalete,Expense,leisure,-73.04,-21618.06
buyer_3,Ana,35,ES47209566635349086821,TRX_N-00614-26567999,2023-07-12T09:01:38,Zuia,Expense,transport,-48.05,-21666.11
buyer_3,Ana,35,ES47209566635349086821,TRX_N-00615-41726615,2023-07-12T10:07:20,Amurrio,Expense,leisure,-66.73,-21732.84
buyer_3,Ana,35,ES47209566635349086821,TRX_N-00616-22275157,2023-07-13T01:34:25,Amurrio,Expense,food,-96.44,-21829.28
buyer_3,Ana,35,ES47209566635349086821,TRX_N-00617-82674481,2023-07-13T23:49:27,Amurrio,Expense,cash,-100.0,-21929.28
buyer_3,Ana,35,ES47209566635349086821,TRX_N-00618-74448433,2023-07-15T08:00:18,Oy√≥n-Oion,Expense,cash,-100.0,-22029.28
buyer_3,Ana,35,ES47209566635349086821,TRX_N-00619-10387198,2023-07-16T17:53:53,Amurrio,Expense,clothing,-65.38,-22094.66
buyer_3,Ana,35,ES47209566635349086821,TRX_N-00620-19759508,2023-07-17T19:21:42,Hondarribia,Expense,food,-81.67,-22176.33
buyer_3,Ana,35,ES47209566635349086821,TRX_N-00621-58420357,2023-07-18T14:19:29,Durango,Expense,gifts,-110.66,-22286.99
buyer_3,Ana,35,ES47209566635349086821,TRX_N-00622-97359442,2023-07-21T18:36:01,Amurrio,Expense,clothing,-136.23,-22423.22
buyer_3,Ana,35,ES47209566635349086821,TRX_N-00623-69432426,2023-07-22T08:27:27,Amurrio,Expense,transport,-75.64,-22498.86
buyer_3,Ana,35,ES47209566635349086821,TRX_N-00624-15426569,2023-07-22T18:07:00,Amurrio,Expense,repairs,-290.5,-22789.36
buyer_3,Ana,35,ES47209566635349086821,TRX_N-00625-92275988,2023-07-23T15:36:35,Amurrio,Expense,leisure,-25.37,-22814.73
buyer_3,Ana,35,ES47209566635349086821,TRX_N-00626-44349145,2023-07-23T18:10:41,Amurrio,Expense,education,-70.64,-22885.37
buyer_3,Ana,35,ES47209566635349086821,TRX_N-00627-48969508,2023-07-23T21:44:56,Amurrio,Expense,cash,-100.0,-22985.37
buyer_3,Ana,35,ES47209566635349086821,TRX_N-00628-77147110,2023-07-24T11:50:19,Labastida,Expense,food,-100.86,-23086.23
buyer_3,Ana,35,ES47209566635349086821,TRX_N-00629-62827649,2023-07-24T23:23:07,Amurrio,Expense,gifts,-466.63,-23552.86
buyer_3,Ana,35,ES47209566635349086821,TRX_N-00630-00361778,2023-07-25T13:38:49,Amurrio,expenses,children,-205.53,-23758.39
buyer_3,Ana,35,ES47209566635349086821,TRX_N-00631-88746244,2023-07-26T09:25:43,Amurrio,Expense,clothing,-66.24,-23824.63
buyer_3,Ana,35,ES47209566635349086821,TRX_N-00632-27309435,2023-07-28T11:34:56,Amurrio,Expense,gifts,-704.85,-24529.48
buyer_3,Ana,35,ES47209566635349086821,TRX_N-00633-00954032,2023-07-30T18:27:21,Amurrio,Expense,cash,-100.0,-24629.48
buyer_3,Ana,35,ES47209566635349086821,TRX_N-00634-13977190,2023-07-31T21:12:55,Amurrio,Expense,food,-90.8,-24720.28
buyer_3,Ana,35,ES47209566635349086821,TRX_N-00635-79873705,2023-07-31T18:38:21,Amurrio,Expense,cash,-100.0,-24820.28
buyer_3,Ana,35,ES47209566635349086821,TRX_N-00636-37398986,2023-08-01T08:15:06,Amurrio,incomes,salary,1529.54,-23290.74
buyer_3,Ana,35,ES47209566635349086821,TRX_N-00637-81552886,2023-08-01T08:15:06,Amurrio,incomes,salary_partner,1641.76,-21648.98
buyer_3,Ana,35,ES47209566635349086821,TRX_N-00638-99474501,2023-08-01T09:13:30,Labastida,Expense,transport,-69.13,-21718.11
buyer_3,Ana,35,ES47209566635349086821,TRX_N-00639-93605454,2023-08-02T08:37:16,Amurrio,Expense,transport,-87.02,-21805.13
buyer_3,Ana,35,ES47209566635349086821,TRX_N-00640-01904140,2023-08-04T17:11:56,Amurrio,expenses,mortgage,-865.74,-22670.87
buyer_3,Ana,35,ES47209566635349086821,TRX_N-00641-05263373,2023-08-04T05:51:31,Andoain,Expense,transport,-44.46,-22715.33
buyer_3,Ana,35,ES47209566635349086821,TRX_N-00642-33946574,2023-08-05T18:57:29,Amurrio,expenses,phone,-39.12,-22754.45
buyer_3,Ana,35,ES47209566635349086821,TRX_N-00643-76341334,2023-08-05T15:19:10,Amurrio,Expense,food,-93.67,-22848.12
buyer_3,Ana,35,ES47209566635349086821,TRX_N-00644-69449559,2023-08-05T15:16:37,Amurrio,Expense,cash,-100.0,-22948.12
buyer_3,Ana,35,ES47209566635349086821,TRX_N-00645-99684667,2023-08-05T21:59:25,Amurrio,expenses,children,-50.27,-22998.39
buyer_3,Ana,35,ES47209566635349086821,TRX_N-00646-07120687,2023-08-06T14:59:32,Amurrio,Expense,clothing,-141.82,-23140.21
buyer_3,Ana,35,ES47209566635349086821,TRX_N-00647-43671185,2023-08-06T11:21:31,Iru√±a de Oca,Expense,cash,-100.0,-23240.21
buyer_3,Ana,35,ES47209566635349086821,TRX_N-00648-08573030,2023-08-06T17:05:50,Amurrio,Expense,gifts,-233.75,-23473.96
buyer_3,Ana,35,ES47209566635349086821,TRX_N-00649-71963606,2023-08-08T17:42:25,Amurrio,expenses,electricity,-57.85,-23531.81
buyer_3,Ana,35,ES47209566635349086821,TRX_N-00650-35248810,2023-08-08T09:17:26,Amurrio,expenses,water,-36.4,-23568.21
buyer_3,Ana,35,ES47209566635349086821,TRX_N-00651-03614192,2023-08-08T10:04:56,Amurrio,expenses,gas,-102.64,-23670.85
buyer_3,Ana,35,ES47209566635349086821,TRX_N-00652-07972843,2023-08-08T23:26:59,Amurrio,expenses,internet,-42.0,-23712.85
buyer_3,Ana,35,ES47209566635349086821,TRX_N-00653-82995778,2023-08-08T08:35:45,Amurrio,Expense,gifts,-414.35,-24127.2
buyer_3,Ana,35,ES47209566635349086821,TRX_N-00654-78977192,2023-08-09T00:23:26,Amurrio,Expense,education,-78.32,-24205.52
buyer_3,Ana,35,ES47209566635349086821,TRX_N-00655-86334586,2023-08-10T03:49:14,Amurrio,Expense,food,-89.93,-24295.45
buyer_3,Ana,35,ES47209566635349086821,TRX_N-00656-69724860,2023-08-10T13:05:15,Amurrio,Expense,transport,-61.29,-24356.74
buyer_3,Ana,35,ES47209566635349086821,TRX_N-00657-24986554,2023-08-11T14:40:19,Amurrio,Expense,leisure,-33.89,-24390.63
buyer_3,Ana,35,ES47209566635349086821,TRX_N-00658-62282742,2023-08-11T07:21:50,Basauri,Expense,gifts,-282.23,-24672.86
buyer_3,Ana,35,ES47209566635349086821,TRX_N-00659-85823947,2023-08-11T19:41:40,Amurrio,expenses,children,-130.3,-24803.16
buyer_3,Ana,35,ES47209566635349086821,TRX_N-00660-09416710,2023-08-12T19:01:14,Amurrio,Expense,food,-96.09,-24899.25
buyer_3,Ana,35,ES47209566635349086821,TRX_N-00661-43598358,2023-08-12T13:03:41,Hondarribia,Expense,gifts,-137.21,-25036.46
buyer_3,Ana,35,ES47209566635349086821,TRX_N-00662-83917896,2023-08-14T11:00:36,Amurrio,Expense,cash,-100.0,-25136.46
buyer_3,Ana,35,ES47209566635349086821,TRX_N-00663-73230728,2023-08-15T13:52:25,Amurrio,Expense,food,-75.63,-25212.09
buyer_3,Ana,35,ES47209566635349086821,TRX_N-00664-77259124,2023-08-17T17:59:19,Amurrio,Expense,transport,-53.98,-25266.07
buyer_3,Ana,35,ES47209566635349086821,TRX_N-00665-14391591,2023-08-20T13:57:10,Amurrio,Expense,clothing,-106.98,-25373.05
buyer_3,Ana,35,ES47209566635349086821,TRX_N-00666-63422406,2023-08-20T12:23:18,Amurrio,Expense,appliances,-207.47,-25580.52
buyer_3,Ana,35,ES47209566635349086821,TRX_N-00667-98860930,2023-08-21T21:07:58,Amurrio,Expense,leisure,-30.91,-25611.43
buyer_3,Ana,35,ES47209566635349086821,TRX_N-00668-50955535,2023-08-25T10:24:56,Amurrio,Expense,food,-70.96,-25682.39
buyer_3,Ana,35,ES47209566635349086821,TRX_N-00669-08368542,2023-08-27T18:17:29,Amurrio,Expense,leisure,-81.11,-25763.5
buyer_3,Ana,35,ES47209566635349086821,TRX_N-00670-63534023,2023-08-27T12:58:08,Amurrio,Expense,cash,-100.0,-25863.5
buyer_3,Ana,35,ES47209566635349086821,TRX_N-00671-50990075,2023-08-27T19:45:42,Amurrio,Expense,appliances,-298.05,-26161.55
buyer_3,Ana,35,ES47209566635349086821,TRX_N-00672-54681526,2023-08-28T12:51:25,Amurrio,Expense,transport,-66.49,-26228.04
buyer_3,Ana,35,ES47209566635349086821,TRX_N-00673-29507085,2023-08-28T06:41:39,Amurrio,Expense,leisure,-47.82,-26275.86
buyer_3,Ana,35,ES47209566635349086821,TRX_N-00674-23639980,2023-08-28T18:04:00,Amurrio,Expense,appliances,-372.93,-26648.79
buyer_3,Ana,35,ES47209566635349086821,TRX_N-00675-67214637,2023-09-01T19:26:55,Amurrio,incomes,salary,1529.54,-25119.25
buyer_3,Ana,35,ES47209566635349086821,TRX_N-00676-57512222,2023-09-01T19:26:55,Amurrio,incomes,salary_partner,1641.76,-23477.49
buyer_3,Ana,35,ES47209566635349086821,TRX_N-00677-03951681,2023-09-01T15:45:13,Amurrio,Expense,cash,-100.0,-23577.49
buyer_3,Ana,35,ES47209566635349086821,TRX_N-00678-38921276,2023-09-01T19:11:02,Amurrio,Expense,gifts,-219.42,-23796.91
buyer_3,Ana,35,ES47209566635349086821,TRX_N-00679-02974036,2023-09-02T12:42:32,Amurrio,Expense,gifts,-658.07,-24454.98
buyer_3,Ana,35,ES47209566635349086821,TRX_N-00680-66689163,2023-09-03T09:30:29,Amurrio,Expense,healthcare,-189.2,-24644.18
buyer_3,Ana,35,ES47209566635349086821,TRX_N-00681-68454859,2023-09-04T08:02:53,Amurrio,expenses,mortgage,-865.74,-25509.92
buyer_3,Ana,35,ES47209566635349086821,TRX_N-00682-96345908,2023-09-04T22:39:00,Amurrio,Expense,transport,-46.91,-25556.83
buyer_3,Ana,35,ES47209566635349086821,TRX_N-00683-93762367,2023-09-05T17:13:27,Amurrio,expenses,water,-43.09,-25599.92
buyer_3,Ana,35,ES47209566635349086821,TRX_N-00684-67469300,2023-09-06T22:09:12,Amurrio,expenses,electricity,-89.96,-25689.88
buyer_3,Ana,35,ES47209566635349086821,TRX_N-00685-82389222,2023-09-06T21:40:28,Amurrio,expenses,internet,-42.0,-25731.88
buyer_3,Ana,35,ES47209566635349086821,TRX_N-00686-94797310,2023-09-06T19:49:45,Amurrio,expenses,phone,-35.95,-25767.83
buyer_3,Ana,35,ES47209566635349086821,TRX_N-00687-11390887,2023-09-06T18:48:23,Amurrio,Expense,leisure,-47.1,-25814.93
buyer_3,Ana,35,ES47209566635349086821,TRX_N-00688-15251631,2023-09-07T17:13:54,Amurrio,expenses,gas,-48.46,-25863.39
buyer_3,Ana,35,ES47209566635349086821,TRX_N-00689-67153454,2023-09-08T11:28:52,Amurrio,Expense,cash,-100.0,-25963.39
buyer_3,Ana,35,ES47209566635349086821,TRX_N-00690-37463585,2023-09-08T09:33:46,Amurrio,expenses,children,-184.84,-26148.23
buyer_3,Ana,35,ES47209566635349086821,TRX_N-00691-26890026,2023-09-09T04:19:25,Amurrio,Expense,food,-74.57,-26222.8
buyer_3,Ana,35,ES47209566635349086821,TRX_N-00692-76335084,2023-09-09T13:07:40,Amurrio,Expense,transport,-71.19,-26293.99
buyer_3,Ana,35,ES47209566635349086821,TRX_N-00693-08044600,2023-09-09T17:49:23,Amurrio,Expense,education,-64.13,-26358.12
buyer_3,Ana,35,ES47209566635349086821,TRX_N-00694-57324643,2023-09-11T12:47:32,Amurrio,Expense,clothing,-53.88,-26412.0
buyer_3,Ana,35,ES47209566635349086821,TRX_N-00695-22417126,2023-09-13T14:36:47,Amurrio,Expense,cash,-100.0,-26512.0
buyer_3,Ana,35,ES47209566635349086821,TRX_N-00696-15787459,2023-09-14T11:40:50,Amurrio,Expense,appliances,-170.34,-26682.34
buyer_3,Ana,35,ES47209566635349086821,TRX_N-00697-51545726,2023-09-18T10:02:12,Amurrio,Expense,repairs,-59.45,-26741.79
buyer_3,Ana,35,ES47209566635349086821,TRX_N-00698-16227380,2023-09-19T11:41:35,Amurrio,Expense,repairs,-111.23,-26853.02
buyer_3,Ana,35,ES47209566635349086821,TRX_N-00699-58925280,2023-09-21T11:51:04,Amurrio,Expense,food,-122.09,-26975.11
buyer_3,Ana,35,ES47209566635349086821,TRX_N-00700-05949866,2023-09-22T14:44:31,Amurrio,Expense,transport,-49.4,-27024.51
buyer_3,Ana,35,ES47209566635349086821,TRX_N-00701-53129286,2023-09-22T18:05:08,Amurrio,Expense,cash,-100.0,-27124.51
buyer_3,Ana,35,ES47209566635349086821,TRX_N-00702-89547800,2023-09-23T14:07:50,Amurrio,Expense,education,-51.26,-27175.77
buyer_3,Ana,35,ES47209566635349086821,TRX_N-00703-79217182,2023-09-23T20:24:18,Alegr√≠a-Dulantzi,Expense,repairs,-151.55,-27327.32
buyer_3,Ana,35,ES47209566635349086821,TRX_N-00704-62401455,2023-09-25T19:20:51,Amurrio,Expense,leisure,-72.91,-27400.23
buyer_3,Ana,35,ES47209566635349086821,TRX_N-00705-82862472,2023-09-28T19:23:08,Bilbao,Expense,repairs,-65.76,-27465.99
buyer_3,Ana,35,ES47209566635349086821,TRX_N-00706-91767994,2023-09-29T01:19:52,Amurrio,Expense,transport,-88.65,-27554.64
buyer_3,Ana,35,ES47209566635349086821,TRX_N-00707-79891302,2023-09-30T13:06:15,Amurrio,Expense,food,-74.01,-27628.65
buyer_3,Ana,35,ES47209566635349086821,TRX_N-00708-37333250,2023-10-01T18:49:02,Amurrio,incomes,salary,1529.54,-26099.11
buyer_3,Ana,35,ES47209566635349086821,TRX_N-00709-37517071,2023-10-01T18:49:02,Amurrio,incomes,salary_partner,1641.76,-24457.35
buyer_3,Ana,35,ES47209566635349086821,TRX_N-00710-84818238,2023-10-01T18:49:02,Amurrio,incomes,extra_income,171.11,-24286.24
buyer_3,Ana,35,ES47209566635349086821,TRX_N-00711-55976974,2023-10-02T11:27:26,Amurrio,Expense,leisure,-22.1,-24308.34
buyer_3,Ana,35,ES47209566635349086821,TRX_N-00712-31913424,2023-10-02T14:29:51,Amurrio,Expense,clothing,-117.94,-24426.28
buyer_3,Ana,35,ES47209566635349086821,TRX_N-00713-32194984,2023-10-04T21:03:55,Amurrio,expenses,mortgage,-865.74,-25292.02
buyer_3,Ana,35,ES47209566635349086821,TRX_N-00714-08825054,2023-10-05T20:53:57,Amurrio,expenses,phone,-32.26,-25324.28
buyer_3,Ana,35,ES47209566635349086821,TRX_N-00715-90043355,2023-10-07T11:57:38,Amurrio,expenses,water,-42.88,-25367.16
buyer_3,Ana,35,ES47209566635349086821,TRX_N-00716-13556327,2023-10-07T08:44:48,Amurrio,expenses,electricity,-83.76,-25450.92
buyer_3,Ana,35,ES47209566635349086821,TRX_N-00717-65344906,2023-10-07T16:31:44,Amurrio,expenses,internet,-42.0,-25492.92
buyer_3,Ana,35,ES47209566635349086821,TRX_N-00718-65895565,2023-10-07T13:17:33,Errenteria,Expense,repairs,-153.23,-25646.15
buyer_3,Ana,35,ES47209566635349086821,TRX_N-00719-60085757,2023-10-08T19:18:00,Amurrio,expenses,gas,-96.54,-25742.69
buyer_3,Ana,35,ES47209566635349086821,TRX_N-00720-01312893,2023-10-08T09:35:53,Amurrio,Expense,gifts,-233.61,-25976.3
buyer_3,Ana,35,ES47209566635349086821,TRX_N-00721-22845155,2023-10-09T10:59:34,Amurrio,Expense,cash,-100.0,-26076.3
buyer_3,Ana,35,ES47209566635349086821,TRX_N-00722-26930031,2023-10-09T09:18:53,Sestao,Expense,repairs,-36.37,-26112.67
buyer_3,Ana,35,ES47209566635349086821,TRX_N-00723-12942390,2023-10-09T20:54:47,Amurrio,Expense,gifts,-116.76,-26229.43
buyer_3,Ana,35,ES47209566635349086821,TRX_N-00724-55023781,2023-10-10T09:35:50,Amurrio,Expense,repairs,-312.25,-26541.68
buyer_3,Ana,35,ES47209566635349086821,TRX_N-00725-62790651,2023-10-11T02:23:35,Amurrio,Expense,transport,-88.53,-26630.21
buyer_3,Ana,35,ES47209566635349086821,TRX_N-00726-86604731,2023-10-12T18:15:21,Amurrio,Expense,education,-56.37,-26686.58
buyer_3,Ana,35,ES47209566635349086821,TRX_N-00727-77571371,2023-10-12T18:22:02,Amurrio,Expense,cash,-100.0,-26786.58
buyer_3,Ana,35,ES47209566635349086821,TRX_N-00728-70738274,2023-10-13T19:17:16,Amurrio,Expense,leisure,-79.8,-26866.38
buyer_3,Ana,35,ES47209566635349086821,TRX_N-00729-04231176,2023-10-15T15:01:34,Durango,Expense,leisure,-44.94,-26911.32
buyer_3,Ana,35,ES47209566635349086821,TRX_N-00730-18560135,2023-10-16T09:55:51,Alegr√≠a-Dulantzi,Expense,leisure,-63.27,-26974.59
buyer_3,Ana,35,ES47209566635349086821,TRX_N-00731-56476508,2023-10-16T19:38:14,Amurrio,Expense,education,-62.98,-27037.57
buyer_3,Ana,35,ES47209566635349086821,TRX_N-00732-90728250,2023-10-18T00:26:18,Amurrio,Expense,clothing,-159.66,-27197.23
buyer_3,Ana,35,ES47209566635349086821,TRX_N-00733-70815299,2023-10-19T21:29:07,Amurrio,Expense,food,-81.3,-27278.53
buyer_3,Ana,35,ES47209566635349086821,TRX_N-00734-94095559,2023-10-22T16:22:36,Amurrio,Expense,leisure,-18.5,-27297.03
buyer_3,Ana,35,ES47209566635349086821,TRX_N-00735-02172973,2023-10-24T21:19:50,Amurrio,Expense,clothing,-116.79,-27413.82
buyer_3,Ana,35,ES47209566635349086821,TRX_N-00736-55991582,2023-10-25T13:42:14,Amurrio,Expense,transport,-49.11,-27462.93
buyer_3,Ana,35,ES47209566635349086821,TRX_N-00737-04016378,2023-10-27T12:15:19,Bilbao,Expense,food,-112.0,-27574.93
buyer_3,Ana,35,ES47209566635349086821,TRX_N-00738-43689811,2023-10-30T14:04:32,Amurrio,Expense,food,-68.63,-27643.56
buyer_3,Ana,35,ES47209566635349086821,TRX_N-00739-89617569,2023-10-31T14:53:50,Amurrio,Expense,transport,-75.35,-27718.91
buyer_3,Ana,35,ES47209566635349086821,TRX_N-00740-06589843,2023-10-31T17:59:45,Amurrio,Expense,leisure,-31.48,-27750.39
buyer_3,Ana,35,ES47209566635349086821,TRX_N-00741-18849479,2023-10-31T19:43:22,Amurrio,Expense,healthcare,-129.55,-27879.94
buyer_3,Ana,35,ES47209566635349086821,TRX_N-00742-47696692,2023-10-31T10:28:50,Amurrio,Expense,cash,-100.0,-27979.94
buyer_3,Ana,35,ES47209566635349086821,TRX_N-00743-25895071,2023-11-01T04:51:05,Amurrio,incomes,salary,1529.54,-26450.4
buyer_3,Ana,35,ES47209566635349086821,TRX_N-00744-39454924,2023-11-01T04:51:05,Amurrio,incomes,salary_partner,1641.76,-24808.64
buyer_3,Ana,35,ES47209566635349086821,TRX_N-00745-80763634,2023-11-01T16:06:24,Labastida,Expense,food,-108.39,-24917.03
buyer_3,Ana,35,ES47209566635349086821,TRX_N-00746-20458498,2023-11-01T18:23:59,Amurrio,Expense,leisure,-76.9,-24993.93
buyer_3,Ana,35,ES47209566635349086821,TRX_N-00747-53219610,2023-11-01T15:32:41,Amurrio,Expense,education,-44.25,-25038.18
buyer_3,Ana,35,ES47209566635349086821,TRX_N-00748-83409765,2023-11-03T19:30:27,Portugalete,Expense,gifts,-731.53,-25769.71
buyer_3,Ana,35,ES47209566635349086821,TRX_N-00749-17428536,2023-11-04T10:44:42,Amurrio,expenses,mortgage,-865.74,-26635.45
buyer_3,Ana,35,ES47209566635349086821,TRX_N-00750-60998971,2023-11-06T09:36:18,Amurrio,expenses,phone,-33.24,-26668.69
buyer_3,Ana,35,ES47209566635349086821,TRX_N-00751-39319694,2023-11-06T11:07:40,Amurrio,Expense,transport,-68.21,-26736.9
buyer_3,Ana,35,ES47209566635349086821,TRX_N-00752-41420871,2023-11-07T18:39:01,Amurrio,Expense,food,-86.38,-26823.28
buyer_3,Ana,35,ES47209566635349086821,TRX_N-00753-86088096,2023-11-07T20:55:55,Amurrio,Expense,travel,-825.54,-27648.82
buyer_3,Ana,35,ES47209566635349086821,TRX_N-00754-54651574,2023-11-08T06:17:57,Amurrio,expenses,gas,-43.69,-27692.51
buyer_3,Ana,35,ES47209566635349086821,TRX_N-00755-86208558,2023-11-08T06:07:27,Amurrio,expenses,internet,-42.0,-27734.51
buyer_3,Ana,35,ES47209566635349086821,TRX_N-00756-40924867,2023-11-08T11:27:03,Amurrio,expenses,water,-21.71,-27756.22
buyer_3,Ana,35,ES47209566635349086821,TRX_N-00757-07187160,2023-11-08T08:38:02,Amurrio,expenses,electricity,-68.99,-27825.21
buyer_3,Ana,35,ES47209566635349086821,TRX_N-00758-93856793,2023-11-08T16:39:52,Amurrio,Expense,cash,-100.0,-27925.21
buyer_3,Ana,35,ES47209566635349086821,TRX_N-00759-20180824,2023-11-09T21:43:03,Hernani,Expense,leisure,-72.64,-27997.85
buyer_3,Ana,35,ES47209566635349086821,TRX_N-00760-94800213,2023-11-09T14:58:27,Amurrio,Expense,clothing,-117.52,-28115.37
buyer_3,Ana,35,ES47209566635349086821,TRX_N-00761-07724277,2023-11-09T17:26:45,Amurrio,Expense,repairs,-141.81,-28257.18
buyer_3,Ana,35,ES47209566635349086821,TRX_N-00762-40704859,2023-11-10T10:11:44,Amurrio,Expense,transport,-56.29,-28313.47
buyer_3,Ana,35,ES47209566635349086821,TRX_N-00763-62502545,2023-11-10T14:02:41,Amurrio,Expense,leisure,-82.21,-28395.68
buyer_3,Ana,35,ES47209566635349086821,TRX_N-00764-02664135,2023-11-10T16:30:50,Amurrio,Expense,cash,-100.0,-28495.68
buyer_3,Ana,35,ES47209566635349086821,TRX_N-00765-76795235,2023-11-11T19:06:09,Amurrio,Expense,cash,-100.0,-28595.68
buyer_3,Ana,35,ES47209566635349086821,TRX_N-00766-11771100,2023-11-11T23:36:54,Amurrio,Expense,repairs,-225.96,-28821.64
buyer_3,Ana,35,ES47209566635349086821,TRX_N-00767-80615787,2023-11-12T17:09:51,Amurrio,expenses,children,-68.37,-28890.01
buyer_3,Ana,35,ES47209566635349086821,TRX_N-00768-37274404,2023-11-17T08:29:35,Amurrio,Expense,leisure,-23.82,-28913.83
buyer_3,Ana,35,ES47209566635349086821,TRX_N-00769-54373040,2023-11-18T09:43:42,Amurrio,Expense,food,-96.14,-29009.97
buyer_3,Ana,35,ES47209566635349086821,TRX_N-00770-17901671,2023-11-18T22:31:51,Amurrio,Expense,cash,-100.0,-29109.97
buyer_3,Ana,35,ES47209566635349086821,TRX_N-00771-33416272,2023-11-18T17:15:34,Amurrio,expenses,children,-234.04,-29344.01
buyer_3,Ana,35,ES47209566635349086821,TRX_N-00772-03061710,2023-11-21T03:53:31,Amurrio,Expense,gifts,-531.92,-29875.93
buyer_3,Ana,35,ES47209566635349086821,TRX_N-00773-59489273,2023-11-21T20:02:36,Amurrio,expenses,children,-151.78,-30027.71
buyer_3,Ana,35,ES47209566635349086821,TRX_N-00774-44036050,2023-11-22T10:34:07,Amurrio,Expense,travel,-1300.96,-31328.67
buyer_3,Ana,35,ES47209566635349086821,TRX_N-00775-52863403,2023-11-23T21:28:44,Pasaia,Expense,transport,-45.08,-31373.75
buyer_3,Ana,35,ES47209566635349086821,TRX_N-00776-97444525,2023-11-23T08:07:28,Amurrio,Expense,cash,-100.0,-31473.75
buyer_3,Ana,35,ES47209566635349086821,TRX_N-00777-46492922,2023-11-27T16:46:42,Amurrio,Expense,cash,-100.0,-31573.75
buyer_3,Ana,35,ES47209566635349086821,TRX_N-00778-26792361,2023-11-29T09:38:04,Amurrio,Expense,food,-63.56,-31637.31
buyer_3,Ana,35,ES47209566635349086821,TRX_N-00779-29941725,2023-12-01T10:51:27,Amurrio,incomes,salary,1529.54,-30107.77
buyer_3,Ana,35,ES47209566635349086821,TRX_N-00780-19939549,2023-12-01T10:51:27,Amurrio,incomes,salary_partner,1641.76,-28466.01
buyer_3,Ana,35,ES47209566635349086821,TRX_N-00781-23306996,2023-12-01T10:51:27,Amurrio,incomes,salary_bonus,1129.65,-27336.36
buyer_3,Ana,35,ES47209566635349086821,TRX_N-00782-49077606,2023-12-01T10:51:27,Amurrio,incomes,salary_partner_bonus,1192.37,-26143.99
buyer_3,Ana,35,ES47209566635349086821,TRX_N-00783-84823607,2023-12-04T14:34:23,Amurrio,expenses,mortgage,-865.74,-27009.73
buyer_3,Ana,35,ES47209566635349086821,TRX_N-00784-92947343,2023-12-06T10:49:40,Amurrio,expenses,electricity,-43.22,-27052.95
buyer_3,Ana,35,ES47209566635349086821,TRX_N-00785-26159870,2023-12-06T20:18:32,Amurrio,expenses,gas,-51.89,-27104.84
buyer_3,Ana,35,ES47209566635349086821,TRX_N-00786-86885942,2023-12-07T11:19:40,Amurrio,Expense,healthcare,-94.02,-27198.86
buyer_3,Ana,35,ES47209566635349086821,TRX_N-00787-31461384,2023-12-08T11:00:22,Amurrio,expenses,water,-22.88,-27221.74
buyer_3,Ana,35,ES47209566635349086821,TRX_N-00788-23509018,2023-12-08T20:09:24,Amurrio,expenses,internet,-42.0,-27263.74
buyer_3,Ana,35,ES47209566635349086821,TRX_N-00789-69862629,2023-12-08T10:47:09,Amurrio,expenses,phone,-36.32,-27300.06
buyer_3,Ana,35,ES47209566635349086821,TRX_N-00790-02423876,2023-12-08T15:08:33,Amurrio,Expense,gifts,-256.88,-27556.94
buyer_3,Ana,35,ES47209566635349086821,TRX_N-00791-88936744,2023-12-10T09:19:15,Amurrio,Expense,healthcare,-39.4,-27596.34
buyer_3,Ana,35,ES47209566635349086821,TRX_N-00792-18214386,2023-12-10T18:50:13,Amurrio,Expense,cash,-100.0,-27696.34
buyer_3,Ana,35,ES47209566635349086821,TRX_N-00793-56310505,2023-12-11T18:23:31,Amurrio,Expense,gifts,-628.36,-28324.7
buyer_3,Ana,35,ES47209566635349086821,TRX_N-00794-59310653,2023-12-12T20:45:39,Eibar,Expense,cash,-100.0,-28424.7
buyer_3,Ana,35,ES47209566635349086821,TRX_N-00795-25714650,2023-12-13T14:53:12,Amurrio,Expense,leisure,-32.67,-28457.37
buyer_3,Ana,35,ES47209566635349086821,TRX_N-00796-85878871,2023-12-15T09:05:40,Amurrio,Expense,transport,-65.06,-28522.43
buyer_3,Ana,35,ES47209566635349086821,TRX_N-00797-73626861,2023-12-16T18:34:29,Amurrio,Expense,gifts,-766.0,-29288.43
buyer_3,Ana,35,ES47209566635349086821,TRX_N-00798-76333426,2023-12-17T10:15:31,Amurrio,Expense,food,-92.23,-29380.66
buyer_3,Ana,35,ES47209566635349086821,TRX_N-00799-31203282,2023-12-17T08:14:03,Amurrio,Expense,cash,-100.0,-29480.66
buyer_3,Ana,35,ES47209566635349086821,TRX_N-00800-60777640,2023-12-19T23:47:51,Amurrio,Expense,transport,-42.92,-29523.58
buyer_3,Ana,35,ES47209566635349086821,TRX_N-00801-10729542,2023-12-20T19:29:43,Amurrio,Expense,cash,-100.0,-29623.58
buyer_3,Ana,35,ES47209566635349086821,TRX_N-00802-39983871,2023-12-21T09:55:04,Amurrio,Expense,food,-113.87,-29737.45
buyer_3,Ana,35,ES47209566635349086821,TRX_N-00803-19610584,2023-12-21T16:24:48,Bermeo,Expense,transport,-88.51,-29825.96
buyer_3,Ana,35,ES47209566635349086821,TRX_N-00804-11704684,2023-12-23T09:25:16,Labastida,Expense,food,-71.99,-29897.95
buyer_3,Ana,35,ES47209566635349086821,TRX_N-00805-44254409,2023-12-23T04:05:03,Amurrio,Expense,repairs,-168.76,-30066.71
buyer_3,Ana,35,ES47209566635349086821,TRX_N-00806-32661320,2023-12-24T05:36:13,Amurrio,Expense,leisure,-28.53,-30095.24
buyer_3,Ana,35,ES47209566635349086821,TRX_N-00807-87443750,2023-12-25T10:25:26,Alegr√≠a-Dulantzi,Expense,leisure,-20.74,-30115.98
buyer_3,Ana,35,ES47209566635349086821,TRX_N-00808-82107801,2023-12-26T20:40:59,Amurrio,Expense,gifts,-320.77,-30436.75
buyer_3,Ana,35,ES47209566635349086821,TRX_N-00809-53021224,2023-12-28T13:52:00,Amurrio,Expense,repairs,-241.73,-30678.48
buyer_3,Ana,35,ES47209566635349086821,TRX_N-00810-98794302,2023-12-29T17:51:20,Amurrio,Expense,healthcare,-56.33,-30734.81
buyer_3,Ana,35,ES47209566635349086821,TRX_N-00811-23808686,2023-12-31T09:53:30,Amurrio,Expense,repairs,-295.04,-31029.85
buyer_3,Ana,35,ES47209566635349086821,TRX_N-00812-10585768,2024-01-01T09:46:41,Amurrio,incomes,salary,1577.32,-29452.53
buyer_3,Ana,35,ES47209566635349086821,TRX_N-00813-51562898,2024-01-01T09:46:41,Amurrio,incomes,salary_partner,1693.04,-27759.49
buyer_3,Ana,35,ES47209566635349086821,TRX_N-00814-59216779,2024-01-01T09:46:41,Amurrio,incomes,extra_income,171.11,-27588.38
buyer_3,Ana,35,ES47209566635349086821,TRX_N-00815-39263972,2024-01-01T10:55:58,Amurrio,Expense,clothing,-116.47,-27704.85
buyer_3,Ana,35,ES47209566635349086821,TRX_N-00816-05964367,2024-01-02T16:19:40,Amurrio,Expense,cash,-100.0,-27804.85
buyer_3,Ana,35,ES47209566635349086821,TRX_N-00817-63523267,2024-01-03T21:58:22,Amurrio,Expense,transport,-76.58,-27881.43
buyer_3,Ana,35,ES47209566635349086821,TRX_N-00818-45080793,2024-01-03T23:10:42,Amurrio,Expense,gifts,-752.31,-28633.74
buyer_3,Ana,35,ES47209566635349086821,TRX_N-00819-53702397,2024-01-04T17:41:45,Amurrio,expenses,mortgage,-865.74,-29499.48
buyer_3,Ana,35,ES47209566635349086821,TRX_N-00820-23813167,2024-01-05T17:27:06,Amurrio,Expense,appliances,-373.27,-29872.75
buyer_3,Ana,35,ES47209566635349086821,TRX_N-00821-99051386,2024-01-06T14:37:18,Amurrio,expenses,water,-43.33,-29916.08
buyer_3,Ana,35,ES47209566635349086821,TRX_N-00822-79825542,2024-01-06T00:49:18,Amurrio,expenses,electricity,-45.94,-29962.02
buyer_3,Ana,35,ES47209566635349086821,TRX_N-00823-04025512,2024-01-06T11:11:36,Amurrio,Expense,food,-76.92,-30038.94
buyer_3,Ana,35,ES47209566635349086821,TRX_N-00824-50338483,2024-01-07T20:27:43,Amurrio,expenses,gas,-36.17,-30075.11
buyer_3,Ana,35,ES47209566635349086821,TRX_N-00825-90882263,2024-01-07T14:46:07,Amurrio,expenses,internet,-42.0,-30117.11
buyer_3,Ana,35,ES47209566635349086821,TRX_N-00826-91757440,2024-01-07T19:41:23,Amurrio,expenses,phone,-32.41,-30149.52
buyer_3,Ana,35,ES47209566635349086821,TRX_N-00827-99734486,2024-01-07T11:45:56,Amurrio,Expense,cash,-100.0,-30249.52
buyer_3,Ana,35,ES47209566635349086821,TRX_N-00828-51887054,2024-01-07T07:59:43,Amurrio,Expense,gifts,-265.29,-30514.81
buyer_3,Ana,35,ES47209566635349086821,TRX_N-00829-72028239,2024-01-08T13:20:10,Amurrio,Expense,clothing,-144.4,-30659.21
buyer_3,Ana,35,ES47209566635349086821,TRX_N-00830-49930292,2024-01-10T15:56:58,Amurrio,Expense,leisure,-77.46,-30736.67
buyer_3,Ana,35,ES47209566635349086821,TRX_N-00831-44097158,2024-01-10T13:48:50,Amurrio,Expense,cash,-100.0,-30836.67
buyer_3,Ana,35,ES47209566635349086821,TRX_N-00832-04803804,2024-01-12T16:52:13,Vitoria-Gasteiz,Expense,food,-115.3,-30951.97
buyer_3,Ana,35,ES47209566635349086821,TRX_N-00833-72042879,2024-01-12T21:03:43,Hernani,Expense,leisure,-76.41,-31028.38
buyer_3,Ana,35,ES47209566635349086821,TRX_N-00834-05093894,2024-01-13T20:04:03,Sopela,Expense,food,-89.12,-31117.5
buyer_3,Ana,35,ES47209566635349086821,TRX_N-00835-35352540,2024-01-14T14:26:53,Amurrio,Expense,leisure,-48.63,-31166.13
buyer_3,Ana,35,ES47209566635349086821,TRX_N-00836-30273095,2024-01-14T11:17:08,Amurrio,Expense,cash,-100.0,-31266.13
buyer_3,Ana,35,ES47209566635349086821,TRX_N-00837-57553209,2024-01-14T13:37:54,Amurrio,expenses,children,-193.95,-31460.08
buyer_3,Ana,35,ES47209566635349086821,TRX_N-00838-75013709,2024-01-16T13:42:58,Amurrio,Expense,cash,-100.0,-31560.08
buyer_3,Ana,35,ES47209566635349086821,TRX_N-00839-96607951,2024-01-18T15:43:58,Amurrio,Expense,education,-65.15,-31625.23
buyer_3,Ana,35,ES47209566635349086821,TRX_N-00840-16545798,2024-01-20T14:38:55,Amurrio,Expense,transport,-48.75,-31673.98
buyer_3,Ana,35,ES47209566635349086821,TRX_N-00841-49259119,2024-01-21T15:18:49,Amurrio,Expense,food,-107.62,-31781.6
buyer_3,Ana,35,ES47209566635349086821,TRX_N-00842-36972356,2024-01-22T15:52:24,Amurrio,Expense,cash,-100.0,-31881.6
buyer_3,Ana,35,ES47209566635349086821,TRX_N-00843-14757262,2024-01-22T19:29:41,Amurrio,expenses,children,-122.37,-32003.97
buyer_3,Ana,35,ES47209566635349086821,TRX_N-00844-18611966,2024-01-23T09:01:09,Amurrio,Expense,cash,-100.0,-32103.97
buyer_3,Ana,35,ES47209566635349086821,TRX_N-00845-06628442,2024-01-24T15:33:37,Amurrio,Expense,food,-112.47,-32216.44
buyer_3,Ana,35,ES47209566635349086821,TRX_N-00846-23095016,2024-01-24T22:34:18,Amurrio,Expense,transport,-53.04,-32269.48
buyer_3,Ana,35,ES47209566635349086821,TRX_N-00847-24169559,2024-01-24T09:27:13,Amurrio,Expense,leisure,-82.88,-32352.36
buyer_3,Ana,35,ES47209566635349086821,TRX_N-00848-43186523,2024-01-27T15:58:49,Amurrio,Expense,leisure,-39.64,-32392.0
buyer_3,Ana,35,ES47209566635349086821,TRX_N-00849-72186131,2024-01-28T18:29:44,Donostia,Expense,cash,-100.0,-32492.0
buyer_3,Ana,35,ES47209566635349086821,TRX_N-00850-70033272,2024-01-30T21:09:19,Arrasate,Expense,cash,-100.0,-32592.0
buyer_3,Ana,35,ES47209566635349086821,TRX_N-00851-94242101,2024-01-31T09:41:31,Amurrio,Expense,education,-49.96,-32641.96
buyer_3,Ana,35,ES47209566635349086821,TRX_N-00852-05358341,2024-01-31T19:31:51,Amurrio,Expense,gifts,-664.15,-33306.11
buyer_3,Ana,35,ES47209566635349086821,TRX_N-00853-86293719,2024-02-01T17:37:24,Amurrio,incomes,salary,1577.32,-31728.79
buyer_3,Ana,35,ES47209566635349086821,TRX_N-00854-57276983,2024-02-01T17:37:24,Amurrio,incomes,salary_partner,1693.04,-30035.75
buyer_3,Ana,35,ES47209566635349086821,TRX_N-00855-28333043,2024-02-01T06:53:51,Amurrio,Expense,leisure,-84.64,-30120.39
buyer_3,Ana,35,ES47209566635349086821,TRX_N-00856-20411135,2024-02-01T09:20:45,Amurrio,Expense,education,-56.79,-30177.18
buyer_3,Ana,35,ES47209566635349086821,TRX_N-00857-71395449,2024-02-01T18:31:08,Amurrio,expenses,children,-180.15,-30357.33
buyer_3,Ana,35,ES47209566635349086821,TRX_N-00858-69936300,2024-02-02T15:52:01,Amurrio,Expense,food,-115.18,-30472.51
buyer_3,Ana,35,ES47209566635349086821,TRX_N-00859-29481284,2024-02-04T08:33:40,Amurrio,expenses,mortgage,-865.74,-31338.25
buyer_3,Ana,35,ES47209566635349086821,TRX_N-00860-92446189,2024-02-05T10:59:24,Amurrio,expenses,gas,-95.06,-31433.31
buyer_3,Ana,35,ES47209566635349086821,TRX_N-00861-11026780,2024-02-07T11:56:59,Bermeo,Expense,food,-124.35,-31557.66
buyer_3,Ana,35,ES47209566635349086821,TRX_N-00862-62540191,2024-02-08T19:06:26,Amurrio,expenses,electricity,-34.47,-31592.13
buyer_3,Ana,35,ES47209566635349086821,TRX_N-00863-87758923,2024-02-08T22:36:24,Amurrio,expenses,water,-38.47,-31630.6
buyer_3,Ana,35,ES47209566635349086821,TRX_N-00864-84659102,2024-02-08T22:44:56,Amurrio,expenses,internet,-42.0,-31672.6
buyer_3,Ana,35,ES47209566635349086821,TRX_N-00865-52221778,2024-02-08T09:13:20,Amurrio,expenses,phone,-33.99,-31706.59
buyer_3,Ana,35,ES47209566635349086821,TRX_N-00866-16265898,2024-02-08T19:14:21,Getxo,Expense,transport,-76.64,-31783.23
buyer_3,Ana,35,ES47209566635349086821,TRX_N-00867-13753836,2024-02-09T08:35:33,Sopela,Expense,cash,-100.0,-31883.23
buyer_3,Ana,35,ES47209566635349086821,TRX_N-00868-57806481,2024-02-13T12:56:30,Amurrio,Expense,gifts,-272.93,-32156.16
buyer_3,Ana,35,ES47209566635349086821,TRX_N-00869-40388376,2024-02-15T11:44:24,Amurrio,Expense,appliances,-134.54,-32290.7
buyer_3,Ana,35,ES47209566635349086821,TRX_N-00870-60076483,2024-02-16T08:29:29,Amurrio,Expense,clothing,-131.33,-32422.03
buyer_3,Ana,35,ES47209566635349086821,TRX_N-00871-82028722,2024-02-18T18:21:22,Amurrio,Expense,food,-113.69,-32535.72
buyer_3,Ana,35,ES47209566635349086821,TRX_N-00872-13912274,2024-02-19T18:52:52,Amurrio,Expense,food,-88.51,-32624.23
buyer_3,Ana,35,ES47209566635349086821,TRX_N-00873-15672955,2024-02-20T11:47:04,Portugalete,Expense,leisure,-49.97,-32674.2
buyer_3,Ana,35,ES47209566635349086821,TRX_N-00874-98612525,2024-02-20T00:03:17,Zarautz,Expense,cash,-100.0,-32774.2
buyer_3,Ana,35,ES47209566635349086821,TRX_N-00875-80411650,2024-02-20T16:21:50,Amurrio,Expense,appliances,-117.02,-32891.22
buyer_3,Ana,35,ES47209566635349086821,TRX_N-00876-49134994,2024-02-22T04:07:05,Amurrio,Expense,education,-47.15,-32938.37
buyer_3,Ana,35,ES47209566635349086821,TRX_N-00877-18997035,2024-02-26T18:05:50,Amurrio,Expense,leisure,-50.83,-32989.2
buyer_3,Ana,35,ES47209566635349086821,TRX_N-00878-19043714,2024-02-27T11:17:11,Amurrio,Expense,transport,-79.21,-33068.41
buyer_3,Ana,35,ES47209566635349086821,TRX_N-00879-15888097,2024-02-29T11:20:54,Amurrio,Expense,repairs,-151.5,-33219.91
buyer_3,Ana,35,ES47209566635349086821,TRX_N-00880-56339281,2024-03-01T08:10:10,Amurrio,incomes,salary,1577.32,-31642.59
buyer_3,Ana,35,ES47209566635349086821,TRX_N-00881-94333295,2024-03-01T08:10:10,Amurrio,incomes,salary_partner,1693.04,-29949.55
buyer_3,Ana,35,ES47209566635349086821,TRX_N-00882-15760645,2024-03-01T14:43:39,Amurrio,Expense,gifts,-418.17,-30367.72
buyer_3,Ana,35,ES47209566635349086821,TRX_N-00883-21641229,2024-03-04T19:28:32,Amurrio,expenses,mortgage,-865.74,-31233.46
buyer_3,Ana,35,ES47209566635349086821,TRX_N-00884-74206996,2024-03-04T14:32:51,Sopela,Expense,travel,-1222.27,-32455.73
buyer_3,Ana,35,ES47209566635349086821,TRX_N-00885-77574147,2024-03-04T13:14:51,Amurrio,Expense,repairs,-177.43,-32633.16
buyer_3,Ana,35,ES47209566635349086821,TRX_N-00886-23488570,2024-03-04T10:34:55,Amurrio,expenses,children,-251.04,-32884.2
buyer_3,Ana,35,ES47209566635349086821,TRX_N-00887-70673671,2024-03-05T14:32:58,Amurrio,expenses,internet,-42.0,-32926.2
buyer_3,Ana,35,ES47209566635349086821,TRX_N-00888-93654371,2024-03-05T14:48:24,Amurrio,Expense,transport,-76.11,-33002.31
buyer_3,Ana,35,ES47209566635349086821,TRX_N-00889-00972789,2024-03-06T21:04:53,Amurrio,expenses,gas,-70.3,-33072.61
buyer_3,Ana,35,ES47209566635349086821,TRX_N-00890-62890985,2024-03-06T13:06:24,Amurrio,Expense,leisure,-55.7,-33128.31
buyer_3,Ana,35,ES47209566635349086821,TRX_N-00891-80862073,2024-03-08T20:54:36,Amurrio,expenses,water,-38.33,-33166.64
buyer_3,Ana,35,ES47209566635349086821,TRX_N-00892-71755117,2024-03-08T18:10:50,Amurrio,expenses,electricity,-74.69,-33241.33
buyer_3,Ana,35,ES47209566635349086821,TRX_N-00893-61649620,2024-03-08T11:32:31,Amurrio,expenses,phone,-30.26,-33271.59
buyer_3,Ana,35,ES47209566635349086821,TRX_N-00894-31297845,2024-03-08T12:06:51,Amurrio,Expense,repairs,-73.01,-33344.6
buyer_3,Ana,35,ES47209566635349086821,TRX_N-00895-23675915,2024-03-09T20:59:55,Amurrio,Expense,repairs,-169.3,-33513.9
buyer_3,Ana,35,ES47209566635349086821,TRX_N-00896-94632294,2024-03-10T15:30:58,Arrasate,Expense,clothing,-53.87,-33567.77
buyer_3,Ana,35,ES47209566635349086821,TRX_N-00897-58850505,2024-03-10T14:20:54,Amurrio,Expense,cash,-100.0,-33667.77
buyer_3,Ana,35,ES47209566635349086821,TRX_N-00898-54546915,2024-03-12T10:50:24,Amurrio,Expense,food,-82.33,-33750.1
buyer_3,Ana,35,ES47209566635349086821,TRX_N-00899-75674358,2024-03-12T14:18:54,Amurrio,Expense,gifts,-321.22,-34071.32
buyer_3,Ana,35,ES47209566635349086821,TRX_N-00900-95396599,2024-03-13T00:29:48,Alegr√≠a-Dulantzi,Expense,cash,-100.0,-34171.32
buyer_3,Ana,35,ES47209566635349086821,TRX_N-00901-62679881,2024-03-14T11:08:25,Amurrio,Expense,travel,-1417.48,-35588.8
buyer_3,Ana,35,ES47209566635349086821,TRX_N-00902-65094238,2024-03-17T13:07:25,Errenteria,Expense,food,-99.39,-35688.19
buyer_3,Ana,35,ES47209566635349086821,TRX_N-00903-38370919,2024-03-17T11:12:49,Sopela,Expense,clothing,-48.16,-35736.35
buyer_3,Ana,35,ES47209566635349086821,TRX_N-00904-71906164,2024-03-18T11:57:52,Amurrio,Expense,repairs,-266.21,-36002.56
buyer_3,Ana,35,ES47209566635349086821,TRX_N-00905-10602321,2024-03-19T14:19:10,Amurrio,Expense,food,-74.87,-36077.43
buyer_3,Ana,35,ES47209566635349086821,TRX_N-00906-44221537,2024-03-22T06:40:53,Amurrio,Expense,transport,-70.66,-36148.09
buyer_3,Ana,35,ES47209566635349086821,TRX_N-00907-40307047,2024-03-23T09:34:33,Amurrio,Expense,cash,-100.0,-36248.09
buyer_3,Ana,35,ES47209566635349086821,TRX_N-00908-12805815,2024-03-24T17:47:21,Amurrio,Expense,leisure,-60.68,-36308.77
buyer_3,Ana,35,ES47209566635349086821,TRX_N-00909-58717904,2024-03-25T08:15:45,Amurrio,Expense,food,-73.17,-36381.94
buyer_3,Ana,35,ES47209566635349086821,TRX_N-00910-22926855,2024-03-25T14:48:32,Amurrio,Expense,repairs,-259.81,-36641.75
buyer_3,Ana,35,ES47209566635349086821,TRX_N-00911-92135417,2024-03-26T10:39:55,Amurrio,Expense,gifts,-569.6,-37211.35
buyer_3,Ana,35,ES47209566635349086821,TRX_N-00912-58235093,2024-03-28T10:26:05,Amurrio,Expense,education,-49.13,-37260.48
buyer_3,Ana,35,ES47209566635349086821,TRX_N-00913-04207135,2024-03-28T18:20:10,Amurrio,Expense,gifts,-346.52,-37607.0
buyer_3,Ana,35,ES47209566635349086821,TRX_N-00914-91608445,2024-03-29T08:24:49,Amurrio,Expense,leisure,-77.85,-37684.85
buyer_3,Ana,35,ES47209566635349086821,TRX_N-00915-24907459,2024-03-30T12:39:52,Amurrio,Expense,transport,-41.02,-37725.87
buyer_3,Ana,35,ES47209566635349086821,TRX_N-00916-69272204,2024-03-31T12:08:04,Amurrio,Expense,leisure,-23.81,-37749.68
buyer_3,Ana,35,ES47209566635349086821,TRX_N-00917-86264051,2024-03-31T14:51:06,Arrasate,Expense,gifts,-26.94,-37776.62
buyer_3,Ana,35,ES47209566635349086821,TRX_N-00918-77467450,2024-04-01T17:28:54,Amurrio,incomes,salary,1577.32,-36199.3
buyer_3,Ana,35,ES47209566635349086821,TRX_N-00919-31574218,2024-04-01T17:28:54,Amurrio,incomes,salary_partner,1693.04,-34506.26
buyer_3,Ana,35,ES47209566635349086821,TRX_N-00920-52929921,2024-04-01T16:51:42,Amurrio,Expense,leisure,-47.75,-34554.01
buyer_3,Ana,35,ES47209566635349086821,TRX_N-00921-75695772,2024-04-03T20:51:51,Amurrio,Expense,transport,-41.02,-34595.03
buyer_3,Ana,35,ES47209566635349086821,TRX_N-00922-43147012,2024-04-03T17:53:24,Zuia,Expense,leisure,-18.18,-34613.21
buyer_3,Ana,35,ES47209566635349086821,TRX_N-00923-66466811,2024-04-03T08:32:55,Amurrio,Expense,repairs,-125.89,-34739.1
buyer_3,Ana,35,ES47209566635349086821,TRX_N-00924-66985062,2024-04-04T23:48:35,Amurrio,expenses,mortgage,-865.74,-35604.84
buyer_3,Ana,35,ES47209566635349086821,TRX_N-00925-58998702,2024-04-05T18:46:36,Amurrio,expenses,electricity,-87.27,-35692.11
buyer_3,Ana,35,ES47209566635349086821,TRX_N-00926-99657221,2024-04-05T14:25:10,Amurrio,expenses,gas,-32.68,-35724.79
buyer_3,Ana,35,ES47209566635349086821,TRX_N-00927-27919658,2024-04-05T09:32:34,Amurrio,expenses,internet,-42.0,-35766.79
buyer_3,Ana,35,ES47209566635349086821,TRX_N-00928-95494591,2024-04-06T01:03:22,Amurrio,expenses,water,-44.97,-35811.76
buyer_3,Ana,35,ES47209566635349086821,TRX_N-00929-51851223,2024-04-06T15:45:57,Amurrio,Expense,food,-64.61,-35876.37
buyer_3,Ana,35,ES47209566635349086821,TRX_N-00930-76073690,2024-04-06T17:16:53,Amurrio,Expense,appliances,-363.38,-36239.75
buyer_3,Ana,35,ES47209566635349086821,TRX_N-00931-58312086,2024-04-07T20:55:35,Amurrio,expenses,phone,-37.65,-36277.4
buyer_3,Ana,35,ES47209566635349086821,TRX_N-00932-59529827,2024-04-07T09:24:13,Amurrio,Expense,transport,-84.66,-36362.06
buyer_3,Ana,35,ES47209566635349086821,TRX_N-00933-48740526,2024-04-08T02:45:19,Amurrio,Expense,leisure,-44.07,-36406.13
buyer_3,Ana,35,ES47209566635349086821,TRX_N-00934-89366320,2024-04-10T11:18:24,Andoain,Expense,repairs,-315.39,-36721.52
buyer_3,Ana,35,ES47209566635349086821,TRX_N-00935-55850374,2024-04-12T15:55:42,Amurrio,Expense,cash,-100.0,-36821.52
buyer_3,Ana,35,ES47209566635349086821,TRX_N-00936-98832191,2024-04-15T16:20:31,Amurrio,Expense,healthcare,-105.79,-36927.31
buyer_3,Ana,35,ES47209566635349086821,TRX_N-00937-96049507,2024-04-16T14:30:37,Vitoria-Gasteiz,Expense,leisure,-52.31,-36979.62
buyer_3,Ana,35,ES47209566635349086821,TRX_N-00938-10797095,2024-04-16T08:23:08,Amurrio,Expense,repairs,-269.11,-37248.73
buyer_3,Ana,35,ES47209566635349086821,TRX_N-00939-61193126,2024-04-16T21:41:11,Amurrio,Expense,gifts,-76.28,-37325.01
buyer_3,Ana,35,ES47209566635349086821,TRX_N-00940-48078136,2024-04-18T17:17:49,Amurrio,Expense,leisure,-62.7,-37387.71
buyer_3,Ana,35,ES47209566635349086821,TRX_N-00941-18324846,2024-04-19T20:13:26,Amurrio,Expense,food,-121.39,-37509.1
buyer_3,Ana,35,ES47209566635349086821,TRX_N-00942-85026449,2024-04-19T21:51:13,Amurrio,Expense,clothing,-131.47,-37640.57
buyer_3,Ana,35,ES47209566635349086821,TRX_N-00943-04838622,2024-04-19T11:02:23,Amurrio,Expense,education,-55.14,-37695.71
buyer_3,Ana,35,ES47209566635349086821,TRX_N-00944-07174930,2024-04-20T17:22:07,Amurrio,Expense,food,-124.39,-37820.1
buyer_3,Ana,35,ES47209566635349086821,TRX_N-00945-83469400,2024-04-20T16:39:24,Amurrio,Expense,education,-46.42,-37866.52
buyer_3,Ana,35,ES47209566635349086821,TRX_N-00946-29015667,2024-04-21T08:20:06,Amurrio,Expense,leisure,-27.35,-37893.87
buyer_3,Ana,35,ES47209566635349086821,TRX_N-00947-76081182,2024-04-22T10:13:35,Amurrio,Expense,food,-123.67,-38017.54
buyer_3,Ana,35,ES47209566635349086821,TRX_N-00948-96329349,2024-04-22T15:59:49,Amurrio,Expense,cash,-100.0,-38117.54
buyer_3,Ana,35,ES47209566635349086821,TRX_N-00949-49559821,2024-04-22T12:19:38,Amurrio,Expense,gifts,-572.07,-38689.61
buyer_3,Ana,35,ES47209566635349086821,TRX_N-00950-37991344,2024-04-23T11:59:28,Amurrio,Expense,food,-118.4,-38808.01
buyer_3,Ana,35,ES47209566635349086821,TRX_N-00951-41289501,2024-04-23T09:29:35,Amurrio,Expense,repairs,-103.65,-38911.66
buyer_3,Ana,35,ES47209566635349086821,TRX_N-00952-87599104,2024-04-28T02:32:44,Amurrio,Expense,food,-70.67,-38982.33
buyer_3,Ana,35,ES47209566635349086821,TRX_N-00953-04056628,2024-04-29T07:44:34,Hernani,Expense,food,-115.36,-39097.69
buyer_3,Ana,35,ES47209566635349086821,TRX_N-00954-36274359,2024-05-01T16:09:59,Amurrio,incomes,salary,1577.32,-37520.37
buyer_3,Ana,35,ES47209566635349086821,TRX_N-00955-70728059,2024-05-01T16:09:59,Amurrio,incomes,salary_partner,1693.04,-35827.33
buyer_3,Ana,35,ES47209566635349086821,TRX_N-00956-88673928,2024-05-01T16:09:59,Amurrio,incomes,extra_income,171.11,-35656.22
buyer_3,Ana,35,ES47209566635349086821,TRX_N-00957-49648737,2024-05-02T08:19:22,Amurrio,Expense,food,-104.34,-35760.56
buyer_3,Ana,35,ES47209566635349086821,TRX_N-00958-33101795,2024-05-02T11:27:30,Amurrio,Expense,education,-64.79,-35825.35
buyer_3,Ana,35,ES47209566635349086821,TRX_N-00959-09010047,2024-05-03T17:08:00,Amurrio,Expense,food,-122.87,-35948.22
buyer_3,Ana,35,ES47209566635349086821,TRX_N-00960-67945044,2024-05-04T21:11:32,Amurrio,expenses,mortgage,-865.74,-36813.96
buyer_3,Ana,35,ES47209566635349086821,TRX_N-00961-90496152,2024-05-04T04:25:57,Amurrio,Expense,food,-96.64,-36910.6
buyer_3,Ana,35,ES47209566635349086821,TRX_N-00962-49526850,2024-05-05T09:08:18,Amurrio,Expense,leisure,-67.49,-36978.09
buyer_3,Ana,35,ES47209566635349086821,TRX_N-00963-63336392,2024-05-05T13:22:05,Amurrio,Expense,clothing,-158.75,-37136.84
buyer_3,Ana,35,ES47209566635349086821,TRX_N-00964-66763663,2024-05-06T13:15:47,Amurrio,expenses,gas,-83.6,-37220.44
buyer_3,Ana,35,ES47209566635349086821,TRX_N-00965-57756499,2024-05-06T16:45:03,Amurrio,Expense,transport,-50.34,-37270.78
buyer_3,Ana,35,ES47209566635349086821,TRX_N-00966-01501413,2024-05-06T22:27:34,Amurrio,Expense,leisure,-19.83,-37290.61
buyer_3,Ana,35,ES47209566635349086821,TRX_N-00967-73524086,2024-05-08T13:47:14,Amurrio,expenses,water,-32.96,-37323.57
buyer_3,Ana,35,ES47209566635349086821,TRX_N-00968-02104051,2024-05-08T19:45:18,Amurrio,expenses,electricity,-61.69,-37385.26
buyer_3,Ana,35,ES47209566635349086821,TRX_N-00969-19828593,2024-05-08T04:17:01,Amurrio,expenses,internet,-42.0,-37427.26
buyer_3,Ana,35,ES47209566635349086821,TRX_N-00970-92643737,2024-05-08T17:03:02,Amurrio,expenses,phone,-44.83,-37472.09
buyer_3,Ana,35,ES47209566635349086821,TRX_N-00971-33445144,2024-05-09T19:55:23,Amurrio,Expense,clothing,-144.93,-37617.02
buyer_3,Ana,35,ES47209566635349086821,TRX_N-00972-47775502,2024-05-09T09:51:26,Amurrio,expenses,children,-72.61,-37689.63
buyer_3,Ana,35,ES47209566635349086821,TRX_N-00973-94752396,2024-05-10T10:00:27,Amurrio,Expense,transport,-41.94,-37731.57
buyer_3,Ana,35,ES47209566635349086821,TRX_N-00974-28957492,2024-05-10T08:23:55,Amurrio,Expense,cash,-100.0,-37831.57
buyer_3,Ana,35,ES47209566635349086821,TRX_N-00975-72910976,2024-05-10T16:28:09,Amurrio,Expense,travel,-914.6,-38746.17
buyer_3,Ana,35,ES47209566635349086821,TRX_N-00976-08315777,2024-05-11T20:25:11,Amurrio,Expense,leisure,-31.32,-38777.49
buyer_3,Ana,35,ES47209566635349086821,TRX_N-00977-71788146,2024-05-12T09:04:33,Amurrio,Expense,transport,-55.08,-38832.57
buyer_3,Ana,35,ES47209566635349086821,TRX_N-00978-06096065,2024-05-12T18:03:05,Amurrio,Expense,leisure,-72.33,-38904.9
buyer_3,Ana,35,ES47209566635349086821,TRX_N-00979-07662736,2024-05-12T11:43:42,Amurrio,Expense,repairs,-298.77,-39203.67
buyer_3,Ana,35,ES47209566635349086821,TRX_N-00980-66849216,2024-05-12T16:47:47,Amurrio,expenses,children,-232.42,-39436.09
buyer_3,Ana,35,ES47209566635349086821,TRX_N-00981-88049162,2024-05-14T16:34:45,Amurrio,Expense,transport,-68.18,-39504.27
buyer_3,Ana,35,ES47209566635349086821,TRX_N-00982-48850185,2024-05-15T07:44:21,Amurrio,Expense,food,-95.36,-39599.63
buyer_3,Ana,35,ES47209566635349086821,TRX_N-00983-71133826,2024-05-15T03:21:48,Amurrio,Expense,cash,-100.0,-39699.63
buyer_3,Ana,35,ES47209566635349086821,TRX_N-00984-69004582,2024-05-16T18:02:57,Amurrio,Expense,leisure,-28.64,-39728.27
buyer_3,Ana,35,ES47209566635349086821,TRX_N-00985-05292294,2024-05-18T10:09:20,Amurrio,Expense,transport,-43.48,-39771.75
buyer_3,Ana,35,ES47209566635349086821,TRX_N-00986-36369604,2024-05-21T10:58:19,Amurrio,Expense,gifts,-312.45,-40084.2
buyer_3,Ana,35,ES47209566635349086821,TRX_N-00987-31237119,2024-05-22T18:19:29,Amurrio,Expense,cash,-100.0,-40184.2
buyer_3,Ana,35,ES47209566635349086821,TRX_N-00988-31954617,2024-05-23T16:40:30,Amurrio,Expense,repairs,-320.07,-40504.27
buyer_3,Ana,35,ES47209566635349086821,TRX_N-00989-74253917,2024-05-26T00:06:05,Elciego,Expense,transport,-84.17,-40588.44
buyer_3,Ana,35,ES47209566635349086821,TRX_N-00990-66654932,2024-05-26T16:48:12,Amurrio,Expense,healthcare,-44.94,-40633.38
buyer_3,Ana,35,ES47209566635349086821,TRX_N-00991-80126701,2024-05-26T19:07:04,Amurrio,Expense,repairs,-118.43,-40751.81
buyer_3,Ana,35,ES47209566635349086821,TRX_N-00992-30343632,2024-05-28T20:55:20,Amurrio,Expense,education,-52.02,-40803.83
buyer_3,Ana,35,ES47209566635349086821,TRX_N-00993-93878140,2024-05-29T16:44:53,Amurrio,Expense,leisure,-29.2,-40833.03
buyer_3,Ana,35,ES47209566635349086821,TRX_N-00994-56456497,2024-06-01T12:38:23,Amurrio,incomes,salary,1577.32,-39255.71
buyer_3,Ana,35,ES47209566635349086821,TRX_N-00995-62818819,2024-06-01T12:38:23,Amurrio,incomes,salary_partner,1693.04,-37562.67
buyer_3,Ana,35,ES47209566635349086821,TRX_N-00996-43364144,2024-06-01T12:38:23,Amurrio,incomes,salary_bonus,1127.85,-36434.82
buyer_3,Ana,35,ES47209566635349086821,TRX_N-00997-48481012,2024-06-01T12:38:23,Amurrio,incomes,salary_partner_bonus,1294.59,-35140.23
buyer_3,Ana,35,ES47209566635349086821,TRX_N-00998-99860822,2024-06-02T13:03:56,Amurrio,Expense,leisure,-19.23,-35159.46
buyer_3,Ana,35,ES47209566635349086821,TRX_N-00999-38631053,2024-06-02T11:34:52,Amurrio,Expense,travel,-475.19,-35634.65
buyer_3,Ana,35,ES47209566635349086821,TRX_N-01000-01568638,2024-06-02T01:29:28,Amurrio,Expense,repairs,-324.86,-35959.51
buyer_3,Ana,35,ES47209566635349086821,TRX_N-01001-82838138,2024-06-04T10:31:03,Amurrio,expenses,mortgage,-865.74,-36825.25
buyer_3,Ana,35,ES47209566635349086821,TRX_N-01002-47976137,2024-06-04T09:24:35,Amurrio,Expense,education,-67.0,-36892.25
buyer_3,Ana,35,ES47209566635349086821,TRX_N-01003-43843625,2024-06-05T02:23:17,Amurrio,expenses,water,-38.13,-36930.38
buyer_3,Ana,35,ES47209566635349086821,TRX_N-01004-98446046,2024-06-06T20:44:23,Amurrio,expenses,electricity,-64.24,-36994.62
buyer_3,Ana,35,ES47209566635349086821,TRX_N-01005-00016148,2024-06-06T12:33:24,Amurrio,expenses,phone,-34.43,-37029.05
buyer_3,Ana,35,ES47209566635349086821,TRX_N-01006-63297624,2024-06-06T18:54:45,Amurrio,Expense,food,-90.26,-37119.31
buyer_3,Ana,35,ES47209566635349086821,TRX_N-01007-00071411,2024-06-07T20:24:44,Amurrio,Expense,education,-47.0,-37166.31
buyer_3,Ana,35,ES47209566635349086821,TRX_N-01008-15166266,2024-06-07T06:57:03,Amurrio,Expense,cash,-100.0,-37266.31
buyer_3,Ana,35,ES47209566635349086821,TRX_N-01009-91714933,2024-06-07T15:08:54,Amurrio,Expense,appliances,-416.08,-37682.39
buyer_3,Ana,35,ES47209566635349086821,TRX_N-01010-33337391,2024-06-08T11:43:13,Amurrio,expenses,gas,-62.94,-37745.33
buyer_3,Ana,35,ES47209566635349086821,TRX_N-01011-44267361,2024-06-08T21:13:12,Amurrio,expenses,internet,-42.0,-37787.33
buyer_3,Ana,35,ES47209566635349086821,TRX_N-01012-56906547,2024-06-08T09:24:38,Amurrio,Expense,clothing,-83.44,-37870.77
buyer_3,Ana,35,ES47209566635349086821,TRX_N-01013-17467603,2024-06-12T12:30:02,Andoain,Expense,transport,-41.28,-37912.05
buyer_3,Ana,35,ES47209566635349086821,TRX_N-01014-36684548,2024-06-14T17:05:46,Amurrio,Expense,leisure,-74.22,-37986.27
buyer_3,Ana,35,ES47209566635349086821,TRX_N-01015-44850072,2024-06-15T19:24:32,Amurrio,expenses,children,-253.76,-38240.03
buyer_3,Ana,35,ES47209566635349086821,TRX_N-01016-45134797,2024-06-16T15:42:02,Zarautz,Expense,repairs,-206.49,-38446.52
buyer_3,Ana,35,ES47209566635349086821,TRX_N-01017-13306040,2024-06-16T10:47:50,Amurrio,Expense,gifts,-791.24,-39237.76
buyer_3,Ana,35,ES47209566635349086821,TRX_N-01018-44050852,2024-06-21T14:25:40,Amurrio,Expense,repairs,-54.84,-39292.6
buyer_3,Ana,35,ES47209566635349086821,TRX_N-01019-46832843,2024-06-22T17:39:19,Amurrio,Expense,education,-56.89,-39349.49
buyer_3,Ana,35,ES47209566635349086821,TRX_N-01020-27069337,2024-06-27T08:07:57,Labastida,Expense,food,-73.56,-39423.05
buyer_3,Ana,35,ES47209566635349086821,TRX_N-01021-17468588,2024-06-27T16:05:58,Amurrio,Expense,leisure,-59.28,-39482.33
buyer_3,Ana,35,ES47209566635349086821,TRX_N-01022-54394795,2024-06-28T09:34:49,Amurrio,Expense,cash,-100.0,-39582.33
buyer_3,Ana,35,ES47209566635349086821,TRX_N-01023-05488509,2024-06-30T17:34:32,Amurrio,Expense,repairs,-176.77,-39759.1
buyer_3,Ana,35,ES47209566635349086821,TRX_N-01024-85290381,2024-07-01T19:48:07,Amurrio,incomes,salary,1577.32,-38181.78
buyer_3,Ana,35,ES47209566635349086821,TRX_N-01025-14144101,2024-07-01T19:48:07,Amurrio,incomes,salary_partner,1693.04,-36488.74
buyer_3,Ana,35,ES47209566635349086821,TRX_N-01026-18731976,2024-07-02T09:08:12,Amurrio,Expense,appliances,-380.17,-36868.91
buyer_3,Ana,35,ES47209566635349086821,TRX_N-01027-24452382,2024-07-04T17:12:34,Amurrio,expenses,mortgage,-865.74,-37734.65
buyer_3,Ana,35,ES47209566635349086821,TRX_N-01028-71636545,2024-07-04T20:14:20,Amurrio,Expense,leisure,-65.85,-37800.5
buyer_3,Ana,35,ES47209566635349086821,TRX_N-01029-87948296,2024-07-04T08:42:59,Amurrio,expenses,children,-122.43,-37922.93
buyer_3,Ana,35,ES47209566635349086821,TRX_N-01030-92208443,2024-07-05T06:00:22,Amurrio,expenses,internet,-42.0,-37964.93
buyer_3,Ana,35,ES47209566635349086821,TRX_N-01031-85558127,2024-07-05T12:55:54,Amurrio,expenses,phone,-42.32,-38007.25
buyer_3,Ana,35,ES47209566635349086821,TRX_N-01032-54330295,2024-07-05T09:20:00,Amurrio,Expense,repairs,-268.72,-38275.97
buyer_3,Ana,35,ES47209566635349086821,TRX_N-01033-14337639,2024-07-07T08:04:27,Amurrio,expenses,electricity,-20.6,-38296.57
buyer_3,Ana,35,ES47209566635349086821,TRX_N-01034-69358335,2024-07-07T16:30:40,Amurrio,expenses,gas,-81.99,-38378.56
buyer_3,Ana,35,ES47209566635349086821,TRX_N-01035-75131380,2024-07-07T09:13:46,Amurrio,Expense,leisure,-60.88,-38439.44
buyer_3,Ana,35,ES47209566635349086821,TRX_N-01036-82488141,2024-07-08T20:40:51,Amurrio,expenses,water,-31.74,-38471.18
buyer_3,Ana,35,ES47209566635349086821,TRX_N-01037-86564697,2024-07-08T09:10:42,Amurrio,Expense,transport,-72.6,-38543.78
buyer_3,Ana,35,ES47209566635349086821,TRX_N-01038-06493949,2024-07-08T09:10:32,Amurrio,Expense,repairs,-188.33,-38732.11
buyer_3,Ana,35,ES47209566635349086821,TRX_N-01039-02836376,2024-07-11T11:53:31,Amurrio,Expense,food,-92.48,-38824.59
buyer_3,Ana,35,ES47209566635349086821,TRX_N-01040-93898850,2024-07-11T17:56:24,Amurrio,Expense,cash,-100.0,-38924.59
buyer_3,Ana,35,ES47209566635349086821,TRX_N-01041-50598475,2024-07-14T15:15:20,Amurrio,Expense,cash,-100.0,-39024.59
buyer_3,Ana,35,ES47209566635349086821,TRX_N-01042-99448240,2024-07-15T16:19:21,Amurrio,Expense,cash,-100.0,-39124.59
buyer_3,Ana,35,ES47209566635349086821,TRX_N-01043-83060471,2024-07-16T20:04:58,Amurrio,Expense,cash,-100.0,-39224.59
buyer_3,Ana,35,ES47209566635349086821,TRX_N-01044-27638075,2024-07-16T22:54:10,Amurrio,Expense,repairs,-235.93,-39460.52
buyer_3,Ana,35,ES47209566635349086821,TRX_N-01045-48289030,2024-07-18T12:38:12,Vitoria-Gasteiz,Expense,leisure,-47.24,-39507.76
buyer_3,Ana,35,ES47209566635349086821,TRX_N-01046-84064763,2024-07-18T09:32:42,Amurrio,Expense,clothing,-53.68,-39561.44
buyer_3,Ana,35,ES47209566635349086821,TRX_N-01047-49083018,2024-07-18T10:45:04,Amurrio,Expense,healthcare,-70.9,-39632.34
buyer_3,Ana,35,ES47209566635349086821,TRX_N-01048-85625445,2024-07-19T16:41:18,Amurrio,Expense,cash,-100.0,-39732.34
buyer_3,Ana,35,ES47209566635349086821,TRX_N-01049-64196746,2024-07-21T17:57:44,Amurrio,Expense,food,-99.14,-39831.48
buyer_3,Ana,35,ES47209566635349086821,TRX_N-01050-83483310,2024-07-21T23:55:52,Amurrio,Expense,gifts,-491.77,-40323.25
buyer_3,Ana,35,ES47209566635349086821,TRX_N-01051-59323919,2024-07-23T02:27:19,Amurrio,Expense,food,-102.36,-40425.61
buyer_3,Ana,35,ES47209566635349086821,TRX_N-01052-65508007,2024-07-27T22:45:04,Amurrio,Expense,cash,-100.0,-40525.61
buyer_3,Ana,35,ES47209566635349086821,TRX_N-01053-25708531,2024-08-01T16:49:54,Amurrio,incomes,salary,1577.32,-38948.29
buyer_3,Ana,35,ES47209566635349086821,TRX_N-01054-80029947,2024-08-01T16:49:54,Amurrio,incomes,salary_partner,1693.04,-37255.25
buyer_3,Ana,35,ES47209566635349086821,TRX_N-01055-26569323,2024-08-01T16:49:54,Amurrio,incomes,extra_income,171.11,-37084.14
buyer_3,Ana,35,ES47209566635349086821,TRX_N-01056-75618800,2024-08-02T10:18:48,Amurrio,Expense,repairs,-96.83,-37180.97
buyer_3,Ana,35,ES47209566635349086821,TRX_N-01057-48602867,2024-08-04T18:00:53,Amurrio,expenses,mortgage,-865.74,-38046.71
buyer_3,Ana,35,ES47209566635349086821,TRX_N-01058-37905482,2024-08-04T19:11:33,Amurrio,Expense,food,-99.53,-38146.24
buyer_3,Ana,35,ES47209566635349086821,TRX_N-01059-08156504,2024-08-05T01:12:43,Amurrio,expenses,internet,-42.0,-38188.24
buyer_3,Ana,35,ES47209566635349086821,TRX_N-01060-49956644,2024-08-05T10:35:14,Amurrio,Expense,cash,-100.0,-38288.24
buyer_3,Ana,35,ES47209566635349086821,TRX_N-01061-65668504,2024-08-06T11:56:17,Amurrio,expenses,gas,-51.53,-38339.77
buyer_3,Ana,35,ES47209566635349086821,TRX_N-01062-41441789,2024-08-06T12:48:11,Amurrio,Expense,food,-77.98,-38417.75
buyer_3,Ana,35,ES47209566635349086821,TRX_N-01063-37656778,2024-08-06T15:04:53,Lasarte-Oria,Expense,leisure,-43.13,-38460.88
buyer_3,Ana,35,ES47209566635349086821,TRX_N-01064-57825770,2024-08-07T15:44:49,Amurrio,Expense,food,-75.29,-38536.17
buyer_3,Ana,35,ES47209566635349086821,TRX_N-01065-38654064,2024-08-08T17:14:22,Amurrio,expenses,water,-22.62,-38558.79
buyer_3,Ana,35,ES47209566635349086821,TRX_N-01066-03927072,2024-08-08T08:17:20,Amurrio,expenses,electricity,-74.4,-38633.19
buyer_3,Ana,35,ES47209566635349086821,TRX_N-01067-78674455,2024-08-08T13:26:06,Amurrio,expenses,phone,-44.36,-38677.55
buyer_3,Ana,35,ES47209566635349086821,TRX_N-01068-85547126,2024-08-11T14:00:25,Amurrio,Expense,food,-95.13,-38772.68
buyer_3,Ana,35,ES47209566635349086821,TRX_N-01069-97750248,2024-08-11T13:22:16,Amurrio,Expense,cash,-100.0,-38872.68
buyer_3,Ana,35,ES47209566635349086821,TRX_N-01070-75004076,2024-08-13T16:31:47,Errenteria,Expense,cash,-100.0,-38972.68
buyer_3,Ana,35,ES47209566635349086821,TRX_N-01071-33910217,2024-08-17T15:08:12,Sestao,Expense,food,-117.1,-39089.78
buyer_3,Ana,35,ES47209566635349086821,TRX_N-01072-45559526,2024-08-18T11:20:25,Amurrio,Expense,food,-120.14,-39209.92
buyer_3,Ana,35,ES47209566635349086821,TRX_N-01073-66184596,2024-08-19T20:28:31,Labastida,Expense,transport,-40.81,-39250.73
buyer_3,Ana,35,ES47209566635349086821,TRX_N-01074-86394328,2024-08-19T17:03:26,Amurrio,Expense,appliances,-297.83,-39548.56
buyer_3,Ana,35,ES47209566635349086821,TRX_N-01075-94052033,2024-08-20T11:20:09,Amurrio,Expense,repairs,-74.41,-39622.97
buyer_3,Ana,35,ES47209566635349086821,TRX_N-01076-60504582,2024-08-21T18:31:57,Leioa,Expense,food,-97.92,-39720.89
buyer_3,Ana,35,ES47209566635349086821,TRX_N-01077-00248638,2024-08-24T07:41:26,Amurrio,Expense,cash,-100.0,-39820.89
buyer_3,Ana,35,ES47209566635349086821,TRX_N-01078-38000878,2024-08-25T18:38:36,Irun,Expense,food,-70.16,-39891.05
buyer_3,Ana,35,ES47209566635349086821,TRX_N-01079-75719750,2024-08-25T17:12:01,Amurrio,Expense,leisure,-76.84,-39967.89
buyer_3,Ana,35,ES47209566635349086821,TRX_N-01080-93010104,2024-08-25T18:23:25,Amurrio,Expense,cash,-100.0,-40067.89
buyer_3,Ana,35,ES47209566635349086821,TRX_N-01081-19221264,2024-08-25T09:41:06,Eibar,Expense,gifts,-721.86,-40789.75
buyer_3,Ana,35,ES47209566635349086821,TRX_N-01082-81120258,2024-08-26T12:36:40,Amurrio,Expense,repairs,-154.39,-40944.14
buyer_3,Ana,35,ES47209566635349086821,TRX_N-01083-01176950,2024-08-27T09:48:53,Amurrio,Expense,leisure,-81.18,-41025.32
buyer_3,Ana,35,ES47209566635349086821,TRX_N-01084-95965396,2024-08-27T04:32:13,Amurrio,Expense,repairs,-171.73,-41197.05
buyer_3,Ana,35,ES47209566635349086821,TRX_N-01085-22976613,2024-08-29T13:59:11,Amurrio,expenses,children,-54.74,-41251.79
buyer_3,Ana,35,ES47209566635349086821,TRX_N-01086-25043127,2024-08-31T11:31:58,Amurrio,Expense,cash,-100.0,-41351.79
buyer_3,Ana,35,ES47209566635349086821,TRX_N-01087-18601244,2024-09-01T15:21:09,Amurrio,incomes,salary,1577.32,-39774.47
buyer_3,Ana,35,ES47209566635349086821,TRX_N-01088-85771494,2024-09-01T15:21:09,Amurrio,incomes,salary_partner,1693.04,-38081.43
buyer_3,Ana,35,ES47209566635349086821,TRX_N-01089-65934398,2024-09-03T16:17:18,Amurrio,Expense,cash,-100.0,-38181.43
buyer_3,Ana,35,ES47209566635349086821,TRX_N-01090-15559078,2024-09-04T15:58:38,Amurrio,expenses,mortgage,-865.74,-39047.17
buyer_3,Ana,35,ES47209566635349086821,TRX_N-01091-29975852,2024-09-05T10:03:29,Amurrio,expenses,internet,-42.0,-39089.17
buyer_3,Ana,35,ES47209566635349086821,TRX_N-01092-79820724,2024-09-07T00:51:03,Amurrio,expenses,water,-26.79,-39115.96
buyer_3,Ana,35,ES47209566635349086821,TRX_N-01093-96526162,2024-09-08T12:15:48,Amurrio,expenses,phone,-33.83,-39149.79
buyer_3,Ana,35,ES47209566635349086821,TRX_N-01094-91888717,2024-09-08T20:53:25,Amurrio,expenses,electricity,-60.06,-39209.85
buyer_3,Ana,35,ES47209566635349086821,TRX_N-01095-06191220,2024-09-08T09:20:55,Amurrio,expenses,gas,-110.24,-39320.09
buyer_3,Ana,35,ES47209566635349086821,TRX_N-01096-15051004,2024-09-08T01:57:15,Amurrio,Expense,appliances,-83.44,-39403.53
buyer_3,Ana,35,ES47209566635349086821,TRX_N-01097-34565492,2024-09-09T10:02:32,Amurrio,Expense,gifts,-224.53,-39628.06
buyer_3,Ana,35,ES47209566635349086821,TRX_N-01098-15937642,2024-09-10T11:39:15,Amurrio,Expense,leisure,-23.78,-39651.84
buyer_3,Ana,35,ES47209566635349086821,TRX_N-01099-74961768,2024-09-11T23:12:49,Amurrio,Expense,transport,-44.87,-39696.71
buyer_3,Ana,35,ES47209566635349086821,TRX_N-01100-92547207,2024-09-12T09:07:14,Amurrio,Expense,food,-98.5,-39795.21
buyer_3,Ana,35,ES47209566635349086821,TRX_N-01101-60385816,2024-09-15T10:37:07,Amurrio,expenses,children,-73.46,-39868.67
buyer_3,Ana,35,ES47209566635349086821,TRX_N-01102-18405830,2024-09-17T10:54:30,Elciego,Expense,repairs,-111.84,-39980.51
buyer_3,Ana,35,ES47209566635349086821,TRX_N-01103-38095881,2024-09-17T21:32:47,Amurrio,expenses,children,-151.57,-40132.08
buyer_3,Ana,35,ES47209566635349086821,TRX_N-01104-15199251,2024-09-18T12:19:39,Amurrio,Expense,food,-60.66,-40192.74
buyer_3,Ana,35,ES47209566635349086821,TRX_N-01105-49434278,2024-09-19T19:00:34,Amurrio,Expense,food,-62.47,-40255.21
buyer_3,Ana,35,ES47209566635349086821,TRX_N-01106-85510038,2024-09-20T16:07:55,Labastida,Expense,leisure,-28.82,-40284.03
buyer_3,Ana,35,ES47209566635349086821,TRX_N-01107-43417987,2024-09-20T16:45:06,Amurrio,Expense,healthcare,-98.51,-40382.54
buyer_3,Ana,35,ES47209566635349086821,TRX_N-01108-82040163,2024-09-20T19:32:53,Andoain,Expense,cash,-100.0,-40482.54
buyer_3,Ana,35,ES47209566635349086821,TRX_N-01109-51006487,2024-09-21T11:56:04,Amurrio,Expense,cash,-100.0,-40582.54
buyer_3,Ana,35,ES47209566635349086821,TRX_N-01110-61606534,2024-09-21T13:01:29,Amurrio,Expense,gifts,-561.73,-41144.27
buyer_3,Ana,35,ES47209566635349086821,TRX_N-01111-54503243,2024-09-22T11:45:13,Amurrio,Expense,food,-121.26,-41265.53
buyer_3,Ana,35,ES47209566635349086821,TRX_N-01112-50099836,2024-09-23T18:15:17,Amurrio,Expense,appliances,-413.75,-41679.28
buyer_3,Ana,35,ES47209566635349086821,TRX_N-01113-61748190,2024-09-24T05:33:43,Amurrio,Expense,repairs,-94.39,-41773.67
buyer_3,Ana,35,ES47209566635349086821,TRX_N-01114-30987731,2024-09-24T17:46:51,Galdakao,Expense,gifts,-166.76,-41940.43
buyer_3,Ana,35,ES47209566635349086821,TRX_N-01115-34358324,2024-09-25T15:25:40,Amurrio,Expense,repairs,-78.37,-42018.8
buyer_3,Ana,35,ES47209566635349086821,TRX_N-01116-02919953,2024-09-27T19:49:57,Santurtzi,Expense,cash,-100.0,-42118.8
buyer_3,Ana,35,ES47209566635349086821,TRX_N-01117-63381523,2024-09-27T17:41:15,Iru√±a de Oca,Expense,gifts,-197.26,-42316.06
buyer_3,Ana,35,ES47209566635349086821,TRX_N-01118-09460657,2024-09-28T23:03:11,Amurrio,Expense,cash,-100.0,-42416.06
buyer_3,Ana,35,ES47209566635349086821,TRX_N-01119-15299809,2024-09-29T17:23:35,Amurrio,Expense,cash,-100.0,-42516.06
buyer_3,Ana,35,ES47209566635349086821,TRX_N-01120-28531698,2024-09-29T08:59:22,Amurrio,expenses,children,-100.82,-42616.88
buyer_3,Ana,35,ES47209566635349086821,TRX_N-01121-43511009,2024-10-01T10:05:11,Amurrio,incomes,salary,1577.32,-41039.56
buyer_3,Ana,35,ES47209566635349086821,TRX_N-01122-40859077,2024-10-01T10:05:11,Amurrio,incomes,salary_partner,1693.04,-39346.52
buyer_3,Ana,35,ES47209566635349086821,TRX_N-01123-03392502,2024-10-02T19:49:13,Hondarribia,Expense,leisure,-30.04,-39376.56
buyer_3,Ana,35,ES47209566635349086821,TRX_N-01124-84669800,2024-10-04T09:42:12,Amurrio,expenses,mortgage,-865.74,-40242.3
buyer_3,Ana,35,ES47209566635349086821,TRX_N-01125-60333763,2024-10-05T14:02:03,Amurrio,expenses,water,-27.7,-40270.0
buyer_3,Ana,35,ES47209566635349086821,TRX_N-01126-86518931,2024-10-05T12:15:07,Amurrio,expenses,electricity,-85.93,-40355.93
buyer_3,Ana,35,ES47209566635349086821,TRX_N-01127-01667619,2024-10-05T10:34:40,Amurrio,expenses,phone,-43.98,-40399.91
buyer_3,Ana,35,ES47209566635349086821,TRX_N-01128-54738262,2024-10-06T20:40:01,Amurrio,Expense,food,-90.82,-40490.73
buyer_3,Ana,35,ES47209566635349086821,TRX_N-01129-53020995,2024-10-07T13:31:49,Amurrio,Expense,transport,-63.39,-40554.12
buyer_3,Ana,35,ES47209566635349086821,TRX_N-01130-50436618,2024-10-08T13:17:25,Amurrio,expenses,internet,-42.0,-40596.12
buyer_3,Ana,35,ES47209566635349086821,TRX_N-01131-73657728,2024-10-08T12:33:15,Amurrio,expenses,gas,-38.06,-40634.18
buyer_4,Jorge,50,ES12209580187759187137,TRX_N-00001-30283068,2022-01-01T08:25:15,Galdakao,incomes,salary,1416.75,2417.34
buyer_4,Jorge,50,ES12209580187759187137,TRX_N-00002-50494213,2022-01-01T08:25:15,Galdakao,incomes,salary_partner,1651.66,4069.0
buyer_4,Jorge,50,ES12209580187759187137,TRX_N-00003-12148557,2022-01-01T15:15:47,Galdakao,Expense,cash,-100.0,3969.0
buyer_4,Jorge,50,ES12209580187759187137,TRX_N-00004-90146557,2022-01-04T09:03:48,Galdakao,expenses,mortgage,-1078.4,2890.6
buyer_4,Jorge,50,ES12209580187759187137,TRX_N-00005-17266974,2022-01-05T02:49:21,Galdakao,expenses,gas,-103.44,2787.16
buyer_4,Jorge,50,ES12209580187759187137,TRX_N-00006-54030617,2022-01-05T11:11:41,Galdakao,expenses,phone,-35.28,2751.88
buyer_4,Jorge,50,ES12209580187759187137,TRX_N-00007-49728597,2022-01-06T14:02:26,Galdakao,expenses,internet,-42.0,2709.88
buyer_4,Jorge,50,ES12209580187759187137,TRX_N-00008-63143805,2022-01-07T23:36:01,Galdakao,Expense,clothing,-154.45,2555.43
buyer_4,Jorge,50,ES12209580187759187137,TRX_N-00009-72476822,2022-01-08T16:08:01,Galdakao,expenses,water,-28.95,2526.48
buyer_4,Jorge,50,ES12209580187759187137,TRX_N-00010-31933033,2022-01-08T15:36:05,Galdakao,expenses,electricity,-30.05,2496.43
buyer_4,Jorge,50,ES12209580187759187137,TRX_N-00011-42571724,2022-01-10T10:50:53,Lasarte-Oria,Expense,transport,-85.77,2410.66
buyer_4,Jorge,50,ES12209580187759187137,TRX_N-00012-01972118,2022-01-13T10:11:37,Galdakao,Expense,gifts,-430.32,1980.34
buyer_4,Jorge,50,ES12209580187759187137,TRX_N-00013-58472176,2022-01-16T12:15:19,Galdakao,Expense,gifts,-184.76,1795.58
buyer_4,Jorge,50,ES12209580187759187137,TRX_N-00014-23106301,2022-01-17T13:13:42,Galdakao,Expense,cash,-100.0,1695.58
buyer_4,Jorge,50,ES12209580187759187137,TRX_N-00015-35762869,2022-01-18T15:17:39,Galdakao,expenses,children,-167.12,1528.46
buyer_4,Jorge,50,ES12209580187759187137,TRX_N-00016-77425926,2022-01-20T11:46:36,Andoain,Expense,cash,-100.0,1428.46
buyer_4,Jorge,50,ES12209580187759187137,TRX_N-00017-75274076,2022-01-21T22:15:54,Hernani,Expense,cash,-100.0,1328.46
buyer_4,Jorge,50,ES12209580187759187137,TRX_N-00018-29336102,2022-01-21T09:19:52,Galdakao,Expense,repairs,-47.78,1280.68
buyer_4,Jorge,50,ES12209580187759187137,TRX_N-00019-34606513,2022-01-22T22:49:04,Galdakao,Expense,repairs,-167.07,1113.61
buyer_4,Jorge,50,ES12209580187759187137,TRX_N-00020-75880898,2022-01-23T13:17:23,Leioa,Expense,transport,-68.67,1044.94
buyer_4,Jorge,50,ES12209580187759187137,TRX_N-00021-01170245,2022-01-24T11:39:24,Galdakao,Expense,cash,-100.0,944.94
buyer_4,Jorge,50,ES12209580187759187137,TRX_N-00022-16130227,2022-01-25T17:28:44,Galdakao,Expense,cash,-100.0,844.94
buyer_4,Jorge,50,ES12209580187759187137,TRX_N-00023-78978942,2022-01-27T06:59:40,Galdakao,Expense,education,-65.71,779.23
buyer_4,Jorge,50,ES12209580187759187137,TRX_N-00024-47378860,2022-01-31T18:10:18,Barakaldo,Expense,cash,-100.0,679.23
buyer_4,Jorge,50,ES12209580187759187137,TRX_N-00025-34733112,2022-01-31T18:35:41,Galdakao,Expense,repairs,-217.12,462.11
buyer_4,Jorge,50,ES12209580187759187137,TRX_N-00026-10309668,2022-01-31T13:24:28,Galdakao,Expense,gifts,-348.8,113.31
buyer_4,Jorge,50,ES12209580187759187137,TRX_N-00027-33764760,2022-02-01T19:56:04,Galdakao,incomes,salary,1416.75,1530.06
buyer_4,Jorge,50,ES12209580187759187137,TRX_N-00028-19650737,2022-02-01T19:56:04,Galdakao,incomes,salary_partner,1651.66,3181.72
buyer_4,Jorge,50,ES12209580187759187137,TRX_N-00029-58614817,2022-02-02T18:59:26,Galdakao,Expense,repairs,-73.7,3108.02
buyer_4,Jorge,50,ES12209580187759187137,TRX_N-00030-85877015,2022-02-02T18:20:46,Mungia,Expense,gifts,-34.16,3073.86
buyer_4,Jorge,50,ES12209580187759187137,TRX_N-00031-33843974,2022-02-04T16:17:03,Galdakao,expenses,mortgage,-1078.4,1995.46
buyer_4,Jorge,50,ES12209580187759187137,TRX_N-00032-42921519,2022-02-05T12:12:27,Galdakao,expenses,internet,-42.0,1953.46
buyer_4,Jorge,50,ES12209580187759187137,TRX_N-00033-73604432,2022-02-05T18:28:10,Bermeo,Expense,clothing,-92.5,1860.96
buyer_4,Jorge,50,ES12209580187759187137,TRX_N-00034-16356842,2022-02-05T18:57:05,Galdakao,Expense,cash,-100.0,1760.96
buyer_4,Jorge,50,ES12209580187759187137,TRX_N-00035-45450135,2022-02-05T20:08:14,Errenteria,Expense,gifts,-616.19,1144.77
buyer_4,Jorge,50,ES12209580187759187137,TRX_N-00036-87906678,2022-02-06T21:15:24,Galdakao,expenses,water,-25.5,1119.27
buyer_4,Jorge,50,ES12209580187759187137,TRX_N-00037-86768408,2022-02-06T11:20:45,Galdakao,expenses,gas,-53.01,1066.26
buyer_4,Jorge,50,ES12209580187759187137,TRX_N-00038-15477761,2022-02-06T18:21:15,Galdakao,Expense,transport,-76.51,989.75
buyer_4,Jorge,50,ES12209580187759187137,TRX_N-00039-64870351,2022-02-06T12:35:22,Galdakao,Expense,leisure,-82.5,907.25
buyer_4,Jorge,50,ES12209580187759187137,TRX_N-00040-64974796,2022-02-07T21:54:23,Galdakao,expenses,phone,-44.06,863.19
buyer_4,Jorge,50,ES12209580187759187137,TRX_N-00041-14299041,2022-02-08T09:06:21,Galdakao,expenses,electricity,-63.31,799.88
buyer_4,Jorge,50,ES12209580187759187137,TRX_N-00042-25457742,2022-02-10T23:38:22,Galdakao,Expense,food,-123.84,676.04
buyer_4,Jorge,50,ES12209580187759187137,TRX_N-00043-57818524,2022-02-11T23:38:07,Galdakao,Expense,leisure,-62.37,613.67
buyer_4,Jorge,50,ES12209580187759187137,TRX_N-00044-58303558,2022-02-11T09:34:20,Galdakao,Expense,repairs,-288.57,325.1
buyer_4,Jorge,50,ES12209580187759187137,TRX_N-00045-21602697,2022-02-12T03:57:43,Galdakao,Expense,cash,-100.0,225.1
buyer_4,Jorge,50,ES12209580187759187137,TRX_N-00046-51021769,2022-02-12T09:04:49,Galdakao,Expense,repairs,-119.34,105.76
buyer_4,Jorge,50,ES12209580187759187137,TRX_N-00047-74875230,2022-02-13T16:00:22,Galdakao,Expense,gifts,-73.75,32.01
buyer_4,Jorge,50,ES12209580187759187137,TRX_N-00048-56821113,2022-02-15T13:44:37,Galdakao,Expense,repairs,-314.51,-282.5
buyer_4,Jorge,50,ES12209580187759187137,TRX_N-00049-50918371,2022-02-16T03:20:08,Galdakao,Expense,clothing,-119.19,-401.69
buyer_4,Jorge,50,ES12209580187759187137,TRX_N-00050-95741708,2022-02-16T13:10:10,Andoain,Expense,repairs,-271.76,-673.45
buyer_4,Jorge,50,ES12209580187759187137,TRX_N-00051-85855916,2022-02-16T15:47:47,Sopela,Expense,gifts,-360.86,-1034.31
buyer_4,Jorge,50,ES12209580187759187137,TRX_N-00052-83465871,2022-02-17T22:33:40,Galdakao,Expense,leisure,-19.87,-1054.18
buyer_4,Jorge,50,ES12209580187759187137,TRX_N-00053-74257542,2022-02-18T20:18:06,Galdakao,Expense,food,-69.39,-1123.57
buyer_4,Jorge,50,ES12209580187759187137,TRX_N-00054-68697743,2022-02-20T12:25:08,Galdakao,Expense,leisure,-59.79,-1183.36
buyer_4,Jorge,50,ES12209580187759187137,TRX_N-00055-24903484,2022-02-21T11:01:31,Galdakao,Expense,transport,-50.01,-1233.37
buyer_4,Jorge,50,ES12209580187759187137,TRX_N-00056-52043544,2022-02-23T16:50:18,Galdakao,expenses,children,-204.92,-1438.29
buyer_4,Jorge,50,ES12209580187759187137,TRX_N-00057-77990396,2022-02-24T13:09:09,Galdakao,Expense,repairs,-236.78,-1675.07
buyer_4,Jorge,50,ES12209580187759187137,TRX_N-00058-19997658,2022-02-25T11:22:24,Alegr√≠a-Dulantzi,Expense,leisure,-46.87,-1721.94
buyer_4,Jorge,50,ES12209580187759187137,TRX_N-00059-84998577,2022-02-26T10:07:55,Galdakao,Expense,leisure,-67.62,-1789.56
buyer_4,Jorge,50,ES12209580187759187137,TRX_N-00060-78514992,2022-02-26T20:57:09,Galdakao,Expense,education,-70.72,-1860.28
buyer_4,Jorge,50,ES12209580187759187137,TRX_N-00061-99572940,2022-02-27T22:49:48,Galdakao,Expense,repairs,-75.22,-1935.5
buyer_4,Jorge,50,ES12209580187759187137,TRX_N-00062-80242245,2022-02-28T09:06:09,Galdakao,Expense,food,-119.84,-2055.34
buyer_4,Jorge,50,ES12209580187759187137,TRX_N-00063-71801430,2022-02-28T14:16:04,Galdakao,Expense,education,-54.04,-2109.38
buyer_4,Jorge,50,ES12209580187759187137,TRX_N-00064-93311276,2022-03-01T21:05:02,Galdakao,incomes,salary,1416.75,-692.63
buyer_4,Jorge,50,ES12209580187759187137,TRX_N-00065-04721679,2022-03-01T21:05:02,Galdakao,incomes,salary_partner,1651.66,959.03
buyer_4,Jorge,50,ES12209580187759187137,TRX_N-00066-61175995,2022-03-01T21:05:02,Galdakao,incomes,extra_income,172.78,1131.81
buyer_4,Jorge,50,ES12209580187759187137,TRX_N-00067-94533803,2022-03-01T11:42:40,Oy√≥n-Oion,Expense,food,-121.11,1010.7
buyer_4,Jorge,50,ES12209580187759187137,TRX_N-00068-84273524,2022-03-01T21:13:55,Galdakao,Expense,leisure,-40.54,970.16
buyer_4,Jorge,50,ES12209580187759187137,TRX_N-00069-31186362,2022-03-02T14:05:50,Galdakao,Expense,transport,-61.54,908.62
buyer_4,Jorge,50,ES12209580187759187137,TRX_N-00070-08513577,2022-03-02T00:47:35,Galdakao,Expense,healthcare,-119.95,788.67
buyer_4,Jorge,50,ES12209580187759187137,TRX_N-00071-34049472,2022-03-04T18:15:21,Galdakao,expenses,mortgage,-1078.4,-289.73
buyer_4,Jorge,50,ES12209580187759187137,TRX_N-00072-98547752,2022-03-04T18:00:38,Galdakao,Expense,transport,-45.78,-335.51
buyer_4,Jorge,50,ES12209580187759187137,TRX_N-00073-99775377,2022-03-05T17:46:11,Bilbao,Expense,gifts,-513.22,-848.73
buyer_4,Jorge,50,ES12209580187759187137,TRX_N-00074-65147008,2022-03-06T18:16:01,Galdakao,Expense,repairs,-99.21,-947.94
buyer_4,Jorge,50,ES12209580187759187137,TRX_N-00075-92356477,2022-03-06T09:54:20,Bilbao,Expense,gifts,-768.48,-1716.42
buyer_4,Jorge,50,ES12209580187759187137,TRX_N-00076-41067952,2022-03-07T23:23:30,Galdakao,expenses,water,-39.84,-1756.26
buyer_4,Jorge,50,ES12209580187759187137,TRX_N-00077-07295435,2022-03-07T16:02:31,Galdakao,expenses,gas,-78.9,-1835.16
buyer_4,Jorge,50,ES12209580187759187137,TRX_N-00078-47401402,2022-03-07T07:40:50,Galdakao,expenses,phone,-30.51,-1865.67
buyer_4,Jorge,50,ES12209580187759187137,TRX_N-00079-75157834,2022-03-07T10:17:28,Galdakao,Expense,food,-98.02,-1963.69
buyer_4,Jorge,50,ES12209580187759187137,TRX_N-00080-44088552,2022-03-07T15:50:12,Galdakao,Expense,clothing,-109.14,-2072.83
buyer_4,Jorge,50,ES12209580187759187137,TRX_N-00081-61595031,2022-03-08T20:53:10,Galdakao,expenses,electricity,-45.63,-2118.46
buyer_4,Jorge,50,ES12209580187759187137,TRX_N-00082-24525507,2022-03-08T10:40:41,Galdakao,expenses,internet,-42.0,-2160.46
buyer_4,Jorge,50,ES12209580187759187137,TRX_N-00083-15456944,2022-03-10T09:43:04,Galdakao,expenses,children,-73.94,-2234.4
buyer_4,Jorge,50,ES12209580187759187137,TRX_N-00084-17600707,2022-03-11T13:52:18,Vitoria-Gasteiz,Expense,food,-108.62,-2343.02
buyer_4,Jorge,50,ES12209580187759187137,TRX_N-00085-92704146,2022-03-13T09:15:38,Galdakao,Expense,food,-99.84,-2442.86
buyer_4,Jorge,50,ES12209580187759187137,TRX_N-00086-23550887,2022-03-14T12:12:14,Galdakao,Expense,cash,-100.0,-2542.86
buyer_4,Jorge,50,ES12209580187759187137,TRX_N-00087-64037136,2022-03-15T19:06:26,Galdakao,Expense,healthcare,-42.61,-2585.47
buyer_4,Jorge,50,ES12209580187759187137,TRX_N-00088-37968955,2022-03-17T13:30:36,Galdakao,Expense,transport,-50.7,-2636.17
buyer_4,Jorge,50,ES12209580187759187137,TRX_N-00089-78776113,2022-03-17T18:54:23,Galdakao,Expense,cash,-100.0,-2736.17
buyer_4,Jorge,50,ES12209580187759187137,TRX_N-00090-49023724,2022-03-18T16:11:12,Galdakao,Expense,repairs,-319.72,-3055.89
buyer_4,Jorge,50,ES12209580187759187137,TRX_N-00091-18130959,2022-03-19T07:52:23,Galdakao,Expense,food,-89.13,-3145.02
buyer_4,Jorge,50,ES12209580187759187137,TRX_N-00092-54287742,2022-03-20T16:11:11,Galdakao,Expense,gifts,-721.79,-3866.81
buyer_4,Jorge,50,ES12209580187759187137,TRX_N-00093-95103699,2022-03-21T06:31:18,Galdakao,Expense,healthcare,-57.46,-3924.27
buyer_4,Jorge,50,ES12209580187759187137,TRX_N-00094-09679772,2022-03-22T18:14:27,Galdakao,Expense,food,-109.04,-4033.31
buyer_4,Jorge,50,ES12209580187759187137,TRX_N-00095-07835292,2022-03-23T21:17:47,Galdakao,Expense,leisure,-48.23,-4081.54
buyer_4,Jorge,50,ES12209580187759187137,TRX_N-00096-68745825,2022-03-24T21:40:52,Galdakao,Expense,leisure,-68.75,-4150.29
buyer_4,Jorge,50,ES12209580187759187137,TRX_N-00097-24505650,2022-03-24T17:35:40,Galdakao,Expense,repairs,-296.09,-4446.38
buyer_4,Jorge,50,ES12209580187759187137,TRX_N-00098-15158843,2022-03-26T12:32:19,Irun,Expense,transport,-80.02,-4526.4
buyer_4,Jorge,50,ES12209580187759187137,TRX_N-00099-46489183,2022-03-26T10:35:51,Basauri,Expense,education,-62.75,-4589.15
buyer_4,Jorge,50,ES12209580187759187137,TRX_N-00100-36717459,2022-03-27T09:02:13,Galdakao,Expense,cash,-100.0,-4689.15
buyer_4,Jorge,50,ES12209580187759187137,TRX_N-00101-85531364,2022-03-28T09:01:39,Galdakao,Expense,food,-67.17,-4756.32
buyer_4,Jorge,50,ES12209580187759187137,TRX_N-00102-31252030,2022-03-31T08:06:39,Portugalete,Expense,leisure,-82.37,-4838.69
buyer_4,Jorge,50,ES12209580187759187137,TRX_N-00103-76865707,2022-04-01T09:31:17,Galdakao,incomes,salary,1416.75,-3421.94
buyer_4,Jorge,50,ES12209580187759187137,TRX_N-00104-26818910,2022-04-01T09:31:17,Galdakao,incomes,salary_partner,1651.66,-1770.28
buyer_4,Jorge,50,ES12209580187759187137,TRX_N-00105-17798985,2022-04-02T11:17:39,Galdakao,Expense,food,-119.64,-1889.92
buyer_4,Jorge,50,ES12209580187759187137,TRX_N-00106-09195587,2022-04-02T13:18:06,Galdakao,Expense,leisure,-53.05,-1942.97
buyer_4,Jorge,50,ES12209580187759187137,TRX_N-00107-62228234,2022-04-03T09:02:31,Galdakao,Expense,gifts,-53.24,-1996.21
buyer_4,Jorge,50,ES12209580187759187137,TRX_N-00108-77395275,2022-04-04T09:34:13,Galdakao,expenses,mortgage,-1078.4,-3074.61
buyer_4,Jorge,50,ES12209580187759187137,TRX_N-00109-13698298,2022-04-05T02:27:40,Irun,Expense,leisure,-45.68,-3120.29
buyer_4,Jorge,50,ES12209580187759187137,TRX_N-00110-26556271,2022-04-05T15:26:38,Galdakao,Expense,repairs,-322.23,-3442.52
buyer_4,Jorge,50,ES12209580187759187137,TRX_N-00111-89202856,2022-04-07T13:01:36,Galdakao,expenses,water,-26.47,-3468.99
buyer_4,Jorge,50,ES12209580187759187137,TRX_N-00112-06855309,2022-04-07T17:42:11,Galdakao,expenses,electricity,-81.18,-3550.17
buyer_4,Jorge,50,ES12209580187759187137,TRX_N-00113-60397599,2022-04-07T19:38:59,Galdakao,expenses,internet,-42.0,-3592.17
buyer_4,Jorge,50,ES12209580187759187137,TRX_N-00114-42256396,2022-04-07T10:59:23,Galdakao,expenses,phone,-39.69,-3631.86
buyer_4,Jorge,50,ES12209580187759187137,TRX_N-00115-45964482,2022-04-08T16:54:25,Galdakao,expenses,gas,-96.18,-3728.04
buyer_4,Jorge,50,ES12209580187759187137,TRX_N-00116-12408794,2022-04-08T23:16:41,Galdakao,Expense,food,-99.96,-3828.0
buyer_4,Jorge,50,ES12209580187759187137,TRX_N-00117-46156002,2022-04-08T10:08:28,Galdakao,Expense,cash,-100.0,-3928.0
buyer_4,Jorge,50,ES12209580187759187137,TRX_N-00118-75755413,2022-04-09T16:44:31,Galdakao,Expense,transport,-68.78,-3996.78
buyer_4,Jorge,50,ES12209580187759187137,TRX_N-00119-82015792,2022-04-13T02:00:15,Galdakao,Expense,leisure,-45.83,-4042.61
buyer_4,Jorge,50,ES12209580187759187137,TRX_N-00120-49163779,2022-04-13T17:25:06,Zuia,Expense,repairs,-202.71,-4245.32
buyer_4,Jorge,50,ES12209580187759187137,TRX_N-00121-51625354,2022-04-16T16:57:58,Galdakao,expenses,children,-261.22,-4506.54
buyer_4,Jorge,50,ES12209580187759187137,TRX_N-00122-01546432,2022-04-17T15:56:43,Galdakao,Expense,food,-79.73,-4586.27
buyer_4,Jorge,50,ES12209580187759187137,TRX_N-00123-43348020,2022-04-19T08:21:49,Galdakao,Expense,food,-77.05,-4663.32
buyer_4,Jorge,50,ES12209580187759187137,TRX_N-00124-87945357,2022-04-20T08:09:40,Galdakao,Expense,transport,-78.0,-4741.32
buyer_4,Jorge,50,ES12209580187759187137,TRX_N-00125-66591001,2022-04-20T17:50:42,Galdakao,expenses,children,-222.71,-4964.03
buyer_4,Jorge,50,ES12209580187759187137,TRX_N-00126-44411649,2022-04-21T06:37:19,Elciego,Expense,clothing,-116.87,-5080.9
buyer_4,Jorge,50,ES12209580187759187137,TRX_N-00127-92998319,2022-04-21T21:46:42,Galdakao,Expense,appliances,-185.26,-5266.16
buyer_4,Jorge,50,ES12209580187759187137,TRX_N-00128-87809294,2022-04-22T19:17:43,Galdakao,Expense,cash,-100.0,-5366.16
buyer_4,Jorge,50,ES12209580187759187137,TRX_N-00129-84175003,2022-04-23T13:07:04,Galdakao,Expense,cash,-100.0,-5466.16
buyer_4,Jorge,50,ES12209580187759187137,TRX_N-00130-10540131,2022-04-26T08:30:06,Galdakao,Expense,leisure,-44.54,-5510.7
buyer_4,Jorge,50,ES12209580187759187137,TRX_N-00131-11136977,2022-04-27T19:00:35,Irun,Expense,gifts,-230.52,-5741.22
buyer_4,Jorge,50,ES12209580187759187137,TRX_N-00132-85659070,2022-04-28T11:46:47,Andoain,Expense,gifts,-619.59,-6360.81
buyer_4,Jorge,50,ES12209580187759187137,TRX_N-00133-98703303,2022-05-01T19:42:47,Galdakao,incomes,salary,1416.75,-4944.06
buyer_4,Jorge,50,ES12209580187759187137,TRX_N-00134-01672990,2022-05-01T19:42:47,Galdakao,incomes,salary_partner,1651.66,-3292.4
buyer_4,Jorge,50,ES12209580187759187137,TRX_N-00135-33362993,2022-05-02T18:06:21,Galdakao,Expense,leisure,-54.31,-3346.71
buyer_4,Jorge,50,ES12209580187759187137,TRX_N-00136-55556783,2022-05-02T09:53:08,Galdakao,Expense,cash,-100.0,-3446.71
buyer_4,Jorge,50,ES12209580187759187137,TRX_N-00137-73961170,2022-05-02T13:36:48,Galdakao,expenses,children,-159.27,-3605.98
buyer_4,Jorge,50,ES12209580187759187137,TRX_N-00138-44888658,2022-05-04T01:35:26,Galdakao,expenses,mortgage,-1078.4,-4684.38
buyer_4,Jorge,50,ES12209580187759187137,TRX_N-00139-19896713,2022-05-04T13:26:34,Galdakao,Expense,food,-104.21,-4788.59
buyer_4,Jorge,50,ES12209580187759187137,TRX_N-00140-89850736,2022-05-05T17:44:45,Galdakao,expenses,water,-41.75,-4830.34
buyer_4,Jorge,50,ES12209580187759187137,TRX_N-00141-90769836,2022-05-05T16:17:53,Galdakao,expenses,phone,-36.27,-4866.61
buyer_4,Jorge,50,ES12209580187759187137,TRX_N-00142-35733800,2022-05-05T13:10:40,Galdakao,Expense,transport,-70.37,-4936.98
buyer_4,Jorge,50,ES12209580187759187137,TRX_N-00143-23662999,2022-05-05T21:06:45,Galdakao,expenses,children,-99.05,-5036.03
buyer_4,Jorge,50,ES12209580187759187137,TRX_N-00144-52557467,2022-05-07T11:47:38,Galdakao,expenses,electricity,-22.57,-5058.6
buyer_4,Jorge,50,ES12209580187759187137,TRX_N-00145-54841874,2022-05-08T11:52:11,Galdakao,expenses,internet,-42.0,-5100.6
buyer_4,Jorge,50,ES12209580187759187137,TRX_N-00146-23723221,2022-05-08T08:32:57,Galdakao,expenses,gas,-46.4,-5147.0
buyer_4,Jorge,50,ES12209580187759187137,TRX_N-00147-36303022,2022-05-08T11:35:57,Durango,Expense,cash,-100.0,-5247.0
buyer_4,Jorge,50,ES12209580187759187137,TRX_N-00148-00060868,2022-05-09T05:03:54,Galdakao,Expense,healthcare,-75.8,-5322.8
buyer_4,Jorge,50,ES12209580187759187137,TRX_N-00149-87951445,2022-05-09T08:15:05,Galdakao,Expense,cash,-100.0,-5422.8
buyer_4,Jorge,50,ES12209580187759187137,TRX_N-00150-13329424,2022-05-10T10:43:27,Galdakao,Expense,cash,-100.0,-5522.8
buyer_4,Jorge,50,ES12209580187759187137,TRX_N-00151-56243856,2022-05-10T11:03:06,Galdakao,Expense,repairs,-176.32,-5699.12
buyer_4,Jorge,50,ES12209580187759187137,TRX_N-00152-20269818,2022-05-11T18:58:55,Galdakao,Expense,cash,-100.0,-5799.12
buyer_4,Jorge,50,ES12209580187759187137,TRX_N-00153-01054924,2022-05-12T17:40:57,Galdakao,Expense,food,-95.67,-5894.79
buyer_4,Jorge,50,ES12209580187759187137,TRX_N-00154-36751758,2022-05-14T22:28:17,Galdakao,Expense,travel,-622.34,-6517.13
buyer_4,Jorge,50,ES12209580187759187137,TRX_N-00155-20075308,2022-05-14T11:56:11,Galdakao,Expense,gifts,-531.7,-7048.83
buyer_4,Jorge,50,ES12209580187759187137,TRX_N-00156-97686181,2022-05-15T09:39:28,Galdakao,Expense,food,-107.73,-7156.56
buyer_4,Jorge,50,ES12209580187759187137,TRX_N-00157-79390675,2022-05-16T05:37:56,Sestao,Expense,food,-91.16,-7247.72
buyer_4,Jorge,50,ES12209580187759187137,TRX_N-00158-84485908,2022-05-16T10:19:53,Galdakao,Expense,cash,-100.0,-7347.72
buyer_4,Jorge,50,ES12209580187759187137,TRX_N-00159-55903355,2022-05-16T13:09:24,Galdakao,Expense,travel,-1184.16,-8531.88
buyer_4,Jorge,50,ES12209580187759187137,TRX_N-00160-07533485,2022-05-17T01:10:50,Galdakao,Expense,travel,-1632.49,-10164.37
buyer_4,Jorge,50,ES12209580187759187137,TRX_N-00161-43991283,2022-05-21T11:06:34,Galdakao,Expense,food,-114.09,-10278.46
buyer_4,Jorge,50,ES12209580187759187137,TRX_N-00162-12126452,2022-05-22T13:42:29,Galdakao,Expense,cash,-100.0,-10378.46
buyer_4,Jorge,50,ES12209580187759187137,TRX_N-00163-43161793,2022-05-24T12:03:03,Galdakao,Expense,food,-65.21,-10443.67
buyer_4,Jorge,50,ES12209580187759187137,TRX_N-00164-06400590,2022-05-24T21:12:29,Galdakao,Expense,cash,-100.0,-10543.67
buyer_4,Jorge,50,ES12209580187759187137,TRX_N-00165-41213908,2022-05-25T12:11:44,Galdakao,Expense,cash,-100.0,-10643.67
buyer_4,Jorge,50,ES12209580187759187137,TRX_N-00166-30425481,2022-05-25T17:35:37,Galdakao,Expense,repairs,-214.95,-10858.62
buyer_4,Jorge,50,ES12209580187759187137,TRX_N-00167-88592161,2022-06-01T08:52:41,Galdakao,incomes,salary,1416.75,-9441.87
buyer_4,Jorge,50,ES12209580187759187137,TRX_N-00168-40385294,2022-06-01T08:52:41,Galdakao,incomes,salary_partner,1651.66,-7790.21
buyer_4,Jorge,50,ES12209580187759187137,TRX_N-00169-16375917,2022-06-01T08:52:41,Galdakao,incomes,extra_income,172.78,-7617.43
buyer_4,Jorge,50,ES12209580187759187137,TRX_N-00170-57165624,2022-06-01T08:52:41,Galdakao,incomes,salary_bonus,1046.26,-6571.17
buyer_4,Jorge,50,ES12209580187759187137,TRX_N-00171-22571544,2022-06-01T08:52:41,Galdakao,incomes,salary_partner_bonus,1283.08,-5288.09
buyer_4,Jorge,50,ES12209580187759187137,TRX_N-00172-79932471,2022-06-03T09:22:42,Galdakao,Expense,education,-42.37,-5330.46
buyer_4,Jorge,50,ES12209580187759187137,TRX_N-00173-72373976,2022-06-04T16:07:31,Galdakao,expenses,mortgage,-1078.4,-6408.86
buyer_4,Jorge,50,ES12209580187759187137,TRX_N-00174-75009477,2022-06-04T20:00:13,Galdakao,Expense,food,-120.32,-6529.18
buyer_4,Jorge,50,ES12209580187759187137,TRX_N-00175-20906183,2022-06-05T11:36:48,Galdakao,Expense,food,-85.79,-6614.97
buyer_4,Jorge,50,ES12209580187759187137,TRX_N-00176-45597260,2022-06-06T11:51:06,Galdakao,expenses,children,-178.72,-6793.69
buyer_4,Jorge,50,ES12209580187759187137,TRX_N-00177-20958492,2022-06-07T16:26:16,Galdakao,expenses,electricity,-31.2,-6824.89
buyer_4,Jorge,50,ES12209580187759187137,TRX_N-00178-40193633,2022-06-07T21:46:20,Galdakao,expenses,internet,-42.0,-6866.89
buyer_4,Jorge,50,ES12209580187759187137,TRX_N-00179-40065015,2022-06-08T16:29:42,Galdakao,expenses,gas,-100.12,-6967.01
buyer_4,Jorge,50,ES12209580187759187137,TRX_N-00180-81010667,2022-06-08T13:01:38,Galdakao,expenses,water,-37.92,-7004.93
buyer_4,Jorge,50,ES12209580187759187137,TRX_N-00181-55229610,2022-06-08T08:01:19,Galdakao,expenses,phone,-38.97,-7043.9
buyer_4,Jorge,50,ES12209580187759187137,TRX_N-00182-51194647,2022-06-08T09:54:51,Galdakao,Expense,clothing,-132.4,-7176.3
buyer_4,Jorge,50,ES12209580187759187137,TRX_N-00183-28296000,2022-06-11T11:47:57,Galdakao,expenses,children,-89.4,-7265.7
buyer_4,Jorge,50,ES12209580187759187137,TRX_N-00184-32104891,2022-06-12T16:12:00,Galdakao,Expense,food,-85.57,-7351.27
buyer_4,Jorge,50,ES12209580187759187137,TRX_N-00185-00379705,2022-06-13T19:51:15,Galdakao,Expense,food,-119.45,-7470.72
buyer_4,Jorge,50,ES12209580187759187137,TRX_N-00186-28419764,2022-06-15T10:16:37,Galdakao,Expense,food,-111.56,-7582.28
buyer_4,Jorge,50,ES12209580187759187137,TRX_N-00187-65022461,2022-06-17T15:09:03,Getxo,Expense,leisure,-77.67,-7659.95
buyer_4,Jorge,50,ES12209580187759187137,TRX_N-00188-72748497,2022-06-17T08:07:51,Lasarte-Oria,Expense,appliances,-356.73,-8016.68
buyer_4,Jorge,50,ES12209580187759187137,TRX_N-00189-44938883,2022-06-18T20:17:36,Galdakao,Expense,food,-68.43,-8085.11
buyer_4,Jorge,50,ES12209580187759187137,TRX_N-00190-90171092,2022-06-19T15:15:12,Galdakao,Expense,cash,-100.0,-8185.11
buyer_4,Jorge,50,ES12209580187759187137,TRX_N-00191-15355335,2022-06-21T06:34:16,Galdakao,Expense,food,-87.09,-8272.2
buyer_4,Jorge,50,ES12209580187759187137,TRX_N-00192-44448577,2022-06-22T23:15:33,Hernani,Expense,food,-124.71,-8396.91
buyer_4,Jorge,50,ES12209580187759187137,TRX_N-00193-48689038,2022-06-24T10:23:31,Galdakao,Expense,gifts,-549.61,-8946.52
buyer_4,Jorge,50,ES12209580187759187137,TRX_N-00194-31445759,2022-06-25T11:34:57,Galdakao,Expense,food,-115.01,-9061.53
buyer_4,Jorge,50,ES12209580187759187137,TRX_N-00195-83043648,2022-06-26T14:02:40,Iru√±a de Oca,Expense,cash,-100.0,-9161.53
buyer_4,Jorge,50,ES12209580187759187137,TRX_N-00196-64160455,2022-06-26T12:57:36,Galdakao,Expense,repairs,-185.8,-9347.33
buyer_4,Jorge,50,ES12209580187759187137,TRX_N-00197-09458309,2022-06-27T12:39:31,Galdakao,Expense,healthcare,-180.05,-9527.38
buyer_4,Jorge,50,ES12209580187759187137,TRX_N-00198-17807175,2022-06-27T09:16:57,Galdakao,expenses,children,-114.32,-9641.7
buyer_4,Jorge,50,ES12209580187759187137,TRX_N-00199-22628772,2022-06-30T06:03:19,Iru√±a de Oca,Expense,food,-70.22,-9711.92
buyer_4,Jorge,50,ES12209580187759187137,TRX_N-00200-81863184,2022-06-30T11:48:05,Irun,Expense,transport,-89.96,-9801.88
buyer_4,Jorge,50,ES12209580187759187137,TRX_N-00201-40959948,2022-07-01T14:36:07,Galdakao,incomes,salary,1416.75,-8385.13
buyer_4,Jorge,50,ES12209580187759187137,TRX_N-00202-47583439,2022-07-01T14:36:07,Galdakao,incomes,salary_partner,1651.66,-6733.47
buyer_4,Jorge,50,ES12209580187759187137,TRX_N-00203-37908288,2022-07-03T14:21:45,Galdakao,Expense,appliances,-315.46,-7048.93
buyer_4,Jorge,50,ES12209580187759187137,TRX_N-00204-06351101,2022-07-04T20:59:29,Galdakao,expenses,mortgage,-1078.4,-8127.33
buyer_4,Jorge,50,ES12209580187759187137,TRX_N-00205-64112226,2022-07-05T17:46:47,Galdakao,Expense,food,-109.82,-8237.15
buyer_4,Jorge,50,ES12209580187759187137,TRX_N-00206-28106623,2022-07-05T19:36:40,Galdakao,Expense,repairs,-107.11,-8344.26
buyer_4,Jorge,50,ES12209580187759187137,TRX_N-00207-16534456,2022-07-06T22:40:18,Galdakao,expenses,phone,-44.86,-8389.12
buyer_4,Jorge,50,ES12209580187759187137,TRX_N-00208-13106249,2022-07-06T21:26:59,Galdakao,Expense,leisure,-24.67,-8413.79
buyer_4,Jorge,50,ES12209580187759187137,TRX_N-00209-90210189,2022-07-06T08:07:01,Galdakao,expenses,children,-275.49,-8689.28
buyer_4,Jorge,50,ES12209580187759187137,TRX_N-00210-27478624,2022-07-07T13:10:55,Galdakao,expenses,gas,-49.68,-8738.96
buyer_4,Jorge,50,ES12209580187759187137,TRX_N-00211-83492744,2022-07-08T13:21:16,Galdakao,expenses,water,-42.57,-8781.53
buyer_4,Jorge,50,ES12209580187759187137,TRX_N-00212-87905780,2022-07-08T15:05:56,Galdakao,expenses,electricity,-38.33,-8819.86
buyer_4,Jorge,50,ES12209580187759187137,TRX_N-00213-87811288,2022-07-08T19:57:12,Galdakao,expenses,internet,-42.0,-8861.86
buyer_4,Jorge,50,ES12209580187759187137,TRX_N-00214-91692586,2022-07-08T16:30:18,Galdakao,Expense,cash,-100.0,-8961.86
buyer_4,Jorge,50,ES12209580187759187137,TRX_N-00215-78647973,2022-07-10T13:27:36,Hernani,Expense,transport,-72.12,-9033.98
buyer_4,Jorge,50,ES12209580187759187137,TRX_N-00216-64173577,2022-07-10T22:28:02,Arrasate,Expense,leisure,-38.82,-9072.8
buyer_4,Jorge,50,ES12209580187759187137,TRX_N-00217-18239098,2022-07-10T20:49:31,Galdakao,Expense,gifts,-70.64,-9143.44
buyer_4,Jorge,50,ES12209580187759187137,TRX_N-00218-93329454,2022-07-11T12:05:04,Galdakao,Expense,cash,-100.0,-9243.44
buyer_4,Jorge,50,ES12209580187759187137,TRX_N-00219-26754248,2022-07-12T09:55:56,Arrasate,Expense,leisure,-22.73,-9266.17
buyer_4,Jorge,50,ES12209580187759187137,TRX_N-00220-47360995,2022-07-13T06:00:45,Galdakao,Expense,transport,-55.81,-9321.98
buyer_4,Jorge,50,ES12209580187759187137,TRX_N-00221-27774175,2022-07-13T21:58:14,Andoain,Expense,cash,-100.0,-9421.98
buyer_4,Jorge,50,ES12209580187759187137,TRX_N-00222-28210095,2022-07-16T20:34:42,Galdakao,Expense,gifts,-588.18,-10010.16
buyer_4,Jorge,50,ES12209580187759187137,TRX_N-00223-22639428,2022-07-17T15:01:59,Galdakao,expenses,children,-151.53,-10161.69
buyer_4,Jorge,50,ES12209580187759187137,TRX_N-00224-43637193,2022-07-18T17:49:42,Galdakao,Expense,food,-106.72,-10268.41
buyer_4,Jorge,50,ES12209580187759187137,TRX_N-00225-12562806,2022-07-21T19:44:45,Galdakao,Expense,leisure,-33.83,-10302.24
buyer_4,Jorge,50,ES12209580187759187137,TRX_N-00226-71284831,2022-07-22T08:00:58,Galdakao,Expense,appliances,-339.12,-10641.36
buyer_4,Jorge,50,ES12209580187759187137,TRX_N-00227-18944608,2022-07-22T11:29:46,Galdakao,Expense,repairs,-88.02,-10729.38
buyer_4,Jorge,50,ES12209580187759187137,TRX_N-00228-86459051,2022-07-26T03:36:37,Galdakao,Expense,transport,-82.87,-10812.25
buyer_4,Jorge,50,ES12209580187759187137,TRX_N-00229-88909464,2022-07-26T13:04:33,Galdakao,Expense,leisure,-21.84,-10834.09
buyer_4,Jorge,50,ES12209580187759187137,TRX_N-00230-62700999,2022-07-26T14:01:59,Galdakao,Expense,gifts,-540.04,-11374.13
buyer_4,Jorge,50,ES12209580187759187137,TRX_N-00231-43892910,2022-07-28T11:25:44,Galdakao,Expense,cash,-100.0,-11474.13
buyer_4,Jorge,50,ES12209580187759187137,TRX_N-00232-04909855,2022-07-28T21:53:00,Eibar,Expense,repairs,-266.65,-11740.78
buyer_4,Jorge,50,ES12209580187759187137,TRX_N-00233-21358646,2022-07-29T12:04:45,Galdakao,Expense,repairs,-69.85,-11810.63
buyer_4,Jorge,50,ES12209580187759187137,TRX_N-00234-54749975,2022-07-30T08:07:16,Llodio,Expense,cash,-100.0,-11910.63
buyer_4,Jorge,50,ES12209580187759187137,TRX_N-00235-24334684,2022-07-30T08:17:58,Galdakao,Expense,gifts,-411.63,-12322.26
buyer_4,Jorge,50,ES12209580187759187137,TRX_N-00236-64332715,2022-08-01T09:07:04,Galdakao,incomes,salary,1416.75,-10905.51
buyer_4,Jorge,50,ES12209580187759187137,TRX_N-00237-36830272,2022-08-01T09:07:04,Galdakao,incomes,salary_partner,1651.66,-9253.85
buyer_4,Jorge,50,ES12209580187759187137,TRX_N-00238-56822468,2022-08-01T14:25:59,Galdakao,Expense,gifts,-101.6,-9355.45
buyer_4,Jorge,50,ES12209580187759187137,TRX_N-00239-32477724,2022-08-02T10:11:37,Labastida,Expense,transport,-56.25,-9411.7
buyer_4,Jorge,50,ES12209580187759187137,TRX_N-00240-72971533,2022-08-02T16:13:53,Galdakao,Expense,healthcare,-127.33,-9539.03
buyer_4,Jorge,50,ES12209580187759187137,TRX_N-00241-40324124,2022-08-03T18:57:55,Galdakao,Expense,food,-105.66,-9644.69
buyer_4,Jorge,50,ES12209580187759187137,TRX_N-00242-22827531,2022-08-03T13:02:09,Galdakao,Expense,clothing,-143.35,-9788.04
buyer_4,Jorge,50,ES12209580187759187137,TRX_N-00243-12991169,2022-08-03T16:33:57,Galdakao,Expense,cash,-100.0,-9888.04
buyer_4,Jorge,50,ES12209580187759187137,TRX_N-00244-45305741,2022-08-03T08:26:47,Galdakao,Expense,gifts,-435.08,-10323.12
buyer_4,Jorge,50,ES12209580187759187137,TRX_N-00245-91215741,2022-08-04T15:16:02,Galdakao,expenses,mortgage,-1078.4,-11401.52
buyer_4,Jorge,50,ES12209580187759187137,TRX_N-00246-99957390,2022-08-05T19:01:29,Galdakao,expenses,gas,-66.9,-11468.42
buyer_4,Jorge,50,ES12209580187759187137,TRX_N-00247-41507204,2022-08-05T14:26:01,Galdakao,expenses,phone,-40.43,-11508.85
buyer_4,Jorge,50,ES12209580187759187137,TRX_N-00248-90374870,2022-08-05T20:28:25,Sestao,Expense,food,-75.7,-11584.55
buyer_4,Jorge,50,ES12209580187759187137,TRX_N-00249-00376516,2022-08-06T19:31:24,Errenteria,Expense,food,-117.69,-11702.24
buyer_4,Jorge,50,ES12209580187759187137,TRX_N-00250-12444686,2022-08-06T14:57:08,Galdakao,Expense,leisure,-33.74,-11735.98
buyer_4,Jorge,50,ES12209580187759187137,TRX_N-00251-29880038,2022-08-06T15:01:59,Galdakao,Expense,education,-50.97,-11786.95
buyer_4,Jorge,50,ES12209580187759187137,TRX_N-00252-23076597,2022-08-06T11:46:54,Galdakao,Expense,cash,-100.0,-11886.95
buyer_4,Jorge,50,ES12209580187759187137,TRX_N-00253-93478172,2022-08-06T12:05:46,Galdakao,expenses,children,-179.71,-12066.66
buyer_4,Jorge,50,ES12209580187759187137,TRX_N-00254-09328202,2022-08-08T21:24:36,Galdakao,expenses,water,-21.25,-12087.91
buyer_4,Jorge,50,ES12209580187759187137,TRX_N-00255-78085849,2022-08-08T10:07:32,Galdakao,expenses,electricity,-48.31,-12136.22
buyer_4,Jorge,50,ES12209580187759187137,TRX_N-00256-00482630,2022-08-08T16:38:10,Galdakao,expenses,internet,-42.0,-12178.22
buyer_4,Jorge,50,ES12209580187759187137,TRX_N-00257-61537628,2022-08-08T08:06:07,Eibar,Expense,transport,-44.17,-12222.39
buyer_4,Jorge,50,ES12209580187759187137,TRX_N-00258-22697585,2022-08-11T19:41:00,Galdakao,Expense,clothing,-137.96,-12360.35
buyer_4,Jorge,50,ES12209580187759187137,TRX_N-00259-79465254,2022-08-12T18:03:39,Galdakao,expenses,children,-234.84,-12595.19
buyer_4,Jorge,50,ES12209580187759187137,TRX_N-00260-09467324,2022-08-13T17:44:23,Galdakao,Expense,food,-106.48,-12701.67
buyer_4,Jorge,50,ES12209580187759187137,TRX_N-00261-59894700,2022-08-15T16:32:44,Galdakao,Expense,clothing,-115.8,-12817.47
buyer_4,Jorge,50,ES12209580187759187137,TRX_N-00262-48772400,2022-08-15T15:17:56,Galdakao,Expense,education,-77.12,-12894.59
buyer_4,Jorge,50,ES12209580187759187137,TRX_N-00263-43377180,2022-08-18T11:06:44,Leioa,Expense,education,-65.43,-12960.02
buyer_4,Jorge,50,ES12209580187759187137,TRX_N-00264-47782102,2022-08-18T09:57:33,Berango,Expense,cash,-100.0,-13060.02
buyer_4,Jorge,50,ES12209580187759187137,TRX_N-00265-27424119,2022-08-20T10:30:29,Galdakao,Expense,repairs,-158.97,-13218.99
buyer_4,Jorge,50,ES12209580187759187137,TRX_N-00266-21982482,2022-08-21T18:48:00,Galdakao,Expense,leisure,-24.04,-13243.03
buyer_4,Jorge,50,ES12209580187759187137,TRX_N-00267-82375576,2022-08-23T20:14:43,Galdakao,Expense,food,-122.92,-13365.95
buyer_4,Jorge,50,ES12209580187759187137,TRX_N-00268-10290127,2022-08-23T11:23:14,Galdakao,Expense,transport,-71.09,-13437.04
buyer_4,Jorge,50,ES12209580187759187137,TRX_N-00269-89349441,2022-08-23T10:02:50,Galdakao,Expense,repairs,-228.67,-13665.71
buyer_4,Jorge,50,ES12209580187759187137,TRX_N-00270-02643344,2022-08-24T19:34:45,Galdakao,Expense,cash,-100.0,-13765.71
buyer_4,Jorge,50,ES12209580187759187137,TRX_N-00271-00113896,2022-08-24T23:25:25,Galdakao,expenses,children,-239.92,-14005.63
buyer_4,Jorge,50,ES12209580187759187137,TRX_N-00272-03458624,2022-08-25T12:09:18,Galdakao,Expense,clothing,-88.91,-14094.54
buyer_4,Jorge,50,ES12209580187759187137,TRX_N-00273-70500552,2022-08-25T15:15:15,Galdakao,Expense,cash,-100.0,-14194.54
buyer_4,Jorge,50,ES12209580187759187137,TRX_N-00274-32086611,2022-08-25T11:58:10,Galdakao,Expense,repairs,-218.57,-14413.11
buyer_4,Jorge,50,ES12209580187759187137,TRX_N-00275-01126467,2022-08-26T11:15:35,Galdakao,Expense,appliances,-158.95,-14572.06
buyer_4,Jorge,50,ES12209580187759187137,TRX_N-00276-09666380,2022-08-27T14:54:04,Labastida,Expense,food,-117.61,-14689.67
buyer_4,Jorge,50,ES12209580187759187137,TRX_N-00277-54848781,2022-08-28T17:38:11,Galdakao,Expense,travel,-1299.36,-15989.03
buyer_4,Jorge,50,ES12209580187759187137,TRX_N-00278-91368294,2022-08-30T11:18:02,Berango,Expense,cash,-100.0,-16089.03
buyer_4,Jorge,50,ES12209580187759187137,TRX_N-00279-88092882,2022-09-01T19:04:36,Galdakao,incomes,salary,1416.75,-14672.28
buyer_4,Jorge,50,ES12209580187759187137,TRX_N-00280-34922453,2022-09-01T19:04:36,Galdakao,incomes,salary_partner,1651.66,-13020.62
buyer_4,Jorge,50,ES12209580187759187137,TRX_N-00281-61592936,2022-09-01T19:04:36,Galdakao,incomes,extra_income,172.78,-12847.84
buyer_4,Jorge,50,ES12209580187759187137,TRX_N-00282-70218995,2022-09-03T11:59:57,Galdakao,Expense,transport,-40.04,-12887.88
buyer_4,Jorge,50,ES12209580187759187137,TRX_N-00283-56814248,2022-09-04T08:12:08,Galdakao,expenses,mortgage,-1078.4,-13966.28
buyer_4,Jorge,50,ES12209580187759187137,TRX_N-00284-29788990,2022-09-04T14:13:34,Galdakao,Expense,food,-96.81,-14063.09
buyer_4,Jorge,50,ES12209580187759187137,TRX_N-00285-19213812,2022-09-05T05:17:54,Galdakao,expenses,internet,-42.0,-14105.09
buyer_4,Jorge,50,ES12209580187759187137,TRX_N-00286-31302743,2022-09-06T15:40:36,Galdakao,expenses,phone,-33.25,-14138.34
buyer_4,Jorge,50,ES12209580187759187137,TRX_N-00287-29208834,2022-09-06T12:44:43,Galdakao,Expense,leisure,-29.79,-14168.13
buyer_4,Jorge,50,ES12209580187759187137,TRX_N-00288-56421552,2022-09-07T14:23:37,Galdakao,expenses,gas,-81.35,-14249.48
buyer_4,Jorge,50,ES12209580187759187137,TRX_N-00289-57078962,2022-09-07T17:31:46,Galdakao,Expense,food,-103.65,-14353.13
buyer_4,Jorge,50,ES12209580187759187137,TRX_N-00290-14061750,2022-09-08T15:58:49,Galdakao,expenses,water,-24.37,-14377.5
buyer_4,Jorge,50,ES12209580187759187137,TRX_N-00291-13008318,2022-09-08T01:36:12,Galdakao,expenses,electricity,-40.08,-14417.58
buyer_4,Jorge,50,ES12209580187759187137,TRX_N-00292-26309103,2022-09-11T01:20:37,Mungia,Expense,cash,-100.0,-14517.58
buyer_4,Jorge,50,ES12209580187759187137,TRX_N-00293-41318297,2022-09-16T08:05:00,Galdakao,Expense,cash,-100.0,-14617.58
buyer_4,Jorge,50,ES12209580187759187137,TRX_N-00294-43242636,2022-09-16T09:47:14,Galdakao,Expense,gifts,-401.16,-15018.74
buyer_4,Jorge,50,ES12209580187759187137,TRX_N-00295-31824350,2022-09-17T14:46:31,Galdakao,Expense,cash,-100.0,-15118.74
buyer_4,Jorge,50,ES12209580187759187137,TRX_N-00296-80421060,2022-09-18T18:54:46,Galdakao,expenses,children,-265.96,-15384.7
buyer_4,Jorge,50,ES12209580187759187137,TRX_N-00297-97052540,2022-09-20T13:20:40,Galdakao,Expense,repairs,-240.12,-15624.82
buyer_4,Jorge,50,ES12209580187759187137,TRX_N-00298-98484904,2022-09-21T17:05:07,Galdakao,Expense,appliances,-133.18,-15758.0
buyer_4,Jorge,50,ES12209580187759187137,TRX_N-00299-81793847,2022-09-24T04:22:13,Galdakao,Expense,leisure,-47.79,-15805.79
buyer_4,Jorge,50,ES12209580187759187137,TRX_N-00300-34031528,2022-09-25T13:37:47,Galdakao,expenses,children,-143.95,-15949.74
buyer_4,Jorge,50,ES12209580187759187137,TRX_N-00301-90084215,2022-09-26T03:31:34,Hondarribia,Expense,leisure,-39.11,-15988.85
buyer_4,Jorge,50,ES12209580187759187137,TRX_N-00302-11387642,2022-09-26T04:44:32,Galdakao,expenses,children,-248.3,-16237.15
buyer_4,Jorge,50,ES12209580187759187137,TRX_N-00303-30164504,2022-09-27T19:56:18,Galdakao,Expense,food,-122.24,-16359.39
buyer_4,Jorge,50,ES12209580187759187137,TRX_N-00304-76237664,2022-09-29T04:15:25,Galdakao,Expense,cash,-100.0,-16459.39
buyer_4,Jorge,50,ES12209580187759187137,TRX_N-00305-57240409,2022-09-30T16:36:18,Galdakao,Expense,cash,-100.0,-16559.39
buyer_4,Jorge,50,ES12209580187759187137,TRX_N-00306-51973377,2022-10-01T14:33:57,Galdakao,incomes,salary,1416.75,-15142.64
buyer_4,Jorge,50,ES12209580187759187137,TRX_N-00307-85283624,2022-10-01T14:33:57,Galdakao,incomes,salary_partner,1651.66,-13490.98
buyer_4,Jorge,50,ES12209580187759187137,TRX_N-00308-50183728,2022-10-01T11:00:41,Berango,Expense,food,-100.2,-13591.18
buyer_4,Jorge,50,ES12209580187759187137,TRX_N-00309-63975882,2022-10-02T08:07:16,Pasaia,Expense,travel,-528.23,-14119.41
buyer_4,Jorge,50,ES12209580187759187137,TRX_N-00310-21925883,2022-10-03T17:47:03,Galdakao,Expense,food,-91.96,-14211.37
buyer_4,Jorge,50,ES12209580187759187137,TRX_N-00311-19294554,2022-10-04T11:21:03,Galdakao,expenses,mortgage,-1078.4,-15289.77
buyer_4,Jorge,50,ES12209580187759187137,TRX_N-00312-42599469,2022-10-04T05:10:38,Galdakao,Expense,transport,-86.59,-15376.36
buyer_4,Jorge,50,ES12209580187759187137,TRX_N-00313-97897785,2022-10-04T00:42:30,Galdakao,Expense,education,-59.8,-15436.16
buyer_4,Jorge,50,ES12209580187759187137,TRX_N-00314-20951965,2022-10-04T08:02:29,Galdakao,Expense,cash,-100.0,-15536.16
buyer_4,Jorge,50,ES12209580187759187137,TRX_N-00315-42005317,2022-10-05T09:45:38,Galdakao,expenses,internet,-42.0,-15578.16
buyer_4,Jorge,50,ES12209580187759187137,TRX_N-00316-83589048,2022-10-06T09:39:20,Galdakao,expenses,electricity,-66.9,-15645.06
buyer_4,Jorge,50,ES12209580187759187137,TRX_N-00317-69109941,2022-10-06T13:14:32,Galdakao,expenses,phone,-42.98,-15688.04
buyer_4,Jorge,50,ES12209580187759187137,TRX_N-00318-58926739,2022-10-07T08:13:23,Durango,Expense,cash,-100.0,-15788.04
buyer_4,Jorge,50,ES12209580187759187137,TRX_N-00319-16855247,2022-10-08T20:58:07,Galdakao,expenses,water,-31.97,-15820.01
buyer_4,Jorge,50,ES12209580187759187137,TRX_N-00320-54287886,2022-10-08T18:27:00,Galdakao,expenses,gas,-85.21,-15905.22
buyer_4,Jorge,50,ES12209580187759187137,TRX_N-00321-17747781,2022-10-08T12:50:53,Labastida,Expense,cash,-100.0,-16005.22
buyer_4,Jorge,50,ES12209580187759187137,TRX_N-00322-42813769,2022-10-09T18:26:41,Galdakao,Expense,leisure,-77.16,-16082.38
buyer_4,Jorge,50,ES12209580187759187137,TRX_N-00323-28389657,2022-10-10T20:42:20,Galdakao,Expense,gifts,-108.59,-16190.97
buyer_4,Jorge,50,ES12209580187759187137,TRX_N-00324-16696888,2022-10-11T08:21:59,Galdakao,Expense,education,-44.37,-16235.34
buyer_4,Jorge,50,ES12209580187759187137,TRX_N-00325-26154957,2022-10-14T06:50:40,Galdakao,Expense,food,-82.44,-16317.78
buyer_4,Jorge,50,ES12209580187759187137,TRX_N-00326-18594777,2022-10-17T15:30:41,Portugalete,Expense,appliances,-389.19,-16706.97
buyer_4,Jorge,50,ES12209580187759187137,TRX_N-00327-05256275,2022-10-19T05:47:43,Zarautz,Expense,cash,-100.0,-16806.97
buyer_4,Jorge,50,ES12209580187759187137,TRX_N-00328-13834571,2022-10-21T19:12:17,Basauri,Expense,transport,-52.58,-16859.55
buyer_4,Jorge,50,ES12209580187759187137,TRX_N-00329-41347585,2022-10-22T12:18:56,Galdakao,Expense,food,-114.21,-16973.76
buyer_4,Jorge,50,ES12209580187759187137,TRX_N-00330-97291430,2022-10-22T15:57:20,Galdakao,Expense,transport,-55.54,-17029.3
buyer_4,Jorge,50,ES12209580187759187137,TRX_N-00331-73057000,2022-10-22T21:43:36,Galdakao,Expense,clothing,-45.67,-17074.97
buyer_4,Jorge,50,ES12209580187759187137,TRX_N-00332-50718941,2022-10-23T20:18:42,Erandio,Expense,education,-74.94,-17149.91
buyer_4,Jorge,50,ES12209580187759187137,TRX_N-00333-74846070,2022-10-23T14:06:04,Galdakao,Expense,cash,-100.0,-17249.91
buyer_4,Jorge,50,ES12209580187759187137,TRX_N-00334-26290184,2022-10-25T15:33:52,Galdakao,Expense,healthcare,-77.32,-17327.23
buyer_4,Jorge,50,ES12209580187759187137,TRX_N-00335-12042534,2022-10-26T13:45:06,Galdakao,Expense,food,-94.39,-17421.62
buyer_4,Jorge,50,ES12209580187759187137,TRX_N-00336-91515617,2022-10-27T13:45:39,Galdakao,Expense,education,-53.8,-17475.42
buyer_4,Jorge,50,ES12209580187759187137,TRX_N-00337-05658313,2022-10-28T15:00:12,Galdakao,Expense,food,-114.67,-17590.09
buyer_4,Jorge,50,ES12209580187759187137,TRX_N-00338-06616313,2022-10-29T11:03:57,Galdakao,Expense,food,-88.4,-17678.49
buyer_4,Jorge,50,ES12209580187759187137,TRX_N-00339-51639239,2022-10-31T13:53:44,Galdakao,Expense,food,-85.78,-17764.27
buyer_4,Jorge,50,ES12209580187759187137,TRX_N-00340-72633482,2022-10-31T15:26:38,Galdakao,Expense,leisure,-62.19,-17826.46
buyer_4,Jorge,50,ES12209580187759187137,TRX_N-00341-61437587,2022-10-31T14:14:15,Galdakao,Expense,clothing,-144.73,-17971.19
buyer_4,Jorge,50,ES12209580187759187137,TRX_N-00342-50853102,2022-11-01T22:03:58,Galdakao,incomes,salary,1416.75,-16554.44
buyer_4,Jorge,50,ES12209580187759187137,TRX_N-00343-13612424,2022-11-01T22:03:58,Galdakao,incomes,salary_partner,1651.66,-14902.78
buyer_4,Jorge,50,ES12209580187759187137,TRX_N-00344-57998829,2022-11-04T19:50:23,Galdakao,expenses,mortgage,-1078.4,-15981.18
buyer_4,Jorge,50,ES12209580187759187137,TRX_N-00345-63446488,2022-11-05T20:49:45,Galdakao,expenses,water,-32.85,-16014.03
buyer_4,Jorge,50,ES12209580187759187137,TRX_N-00346-68782757,2022-11-05T10:30:05,Galdakao,expenses,internet,-42.0,-16056.03
buyer_4,Jorge,50,ES12209580187759187137,TRX_N-00347-76918032,2022-11-05T11:37:27,Galdakao,Expense,leisure,-39.14,-16095.17
buyer_4,Jorge,50,ES12209580187759187137,TRX_N-00348-71481550,2022-11-06T09:32:49,Galdakao,Expense,cash,-100.0,-16195.17
buyer_4,Jorge,50,ES12209580187759187137,TRX_N-00349-89209252,2022-11-07T13:03:47,Galdakao,expenses,gas,-78.24,-16273.41
buyer_4,Jorge,50,ES12209580187759187137,TRX_N-00350-72551776,2022-11-08T19:37:32,Galdakao,expenses,electricity,-78.34,-16351.75
buyer_4,Jorge,50,ES12209580187759187137,TRX_N-00351-52419392,2022-11-08T16:25:42,Galdakao,expenses,phone,-44.62,-16396.37
buyer_4,Jorge,50,ES12209580187759187137,TRX_N-00352-14492355,2022-11-09T17:25:48,Galdakao,Expense,appliances,-275.5,-16671.87
buyer_4,Jorge,50,ES12209580187759187137,TRX_N-00353-74836969,2022-11-12T03:51:23,Leioa,Expense,food,-73.31,-16745.18
buyer_4,Jorge,50,ES12209580187759187137,TRX_N-00354-18972029,2022-11-12T11:07:37,Donostia,Expense,repairs,-85.63,-16830.81
buyer_4,Jorge,50,ES12209580187759187137,TRX_N-00355-34062694,2022-11-13T18:26:03,Galdakao,Expense,food,-92.26,-16923.07
buyer_4,Jorge,50,ES12209580187759187137,TRX_N-00356-44902930,2022-11-13T13:17:34,Hondarribia,Expense,leisure,-49.2,-16972.27
buyer_4,Jorge,50,ES12209580187759187137,TRX_N-00357-76362500,2022-11-13T14:49:50,Galdakao,Expense,appliances,-82.96,-17055.23
buyer_4,Jorge,50,ES12209580187759187137,TRX_N-00358-62013448,2022-11-14T13:39:20,Galdakao,Expense,transport,-47.07,-17102.3
buyer_4,Jorge,50,ES12209580187759187137,TRX_N-00359-89889024,2022-11-14T08:00:20,Galdakao,Expense,education,-45.53,-17147.83
buyer_4,Jorge,50,ES12209580187759187137,TRX_N-00360-01677274,2022-11-15T11:22:44,Galdakao,Expense,cash,-100.0,-17247.83
buyer_4,Jorge,50,ES12209580187759187137,TRX_N-00361-31479101,2022-11-16T10:31:00,Zarautz,Expense,food,-67.33,-17315.16
buyer_4,Jorge,50,ES12209580187759187137,TRX_N-00362-51551048,2022-11-16T09:46:47,Lasarte-Oria,Expense,leisure,-46.33,-17361.49
buyer_4,Jorge,50,ES12209580187759187137,TRX_N-00363-24248117,2022-11-17T00:00:47,Galdakao,Expense,repairs,-235.75,-17597.24
buyer_4,Jorge,50,ES12209580187759187137,TRX_N-00364-65666593,2022-11-18T21:23:14,Galdakao,Expense,transport,-49.82,-17647.06
buyer_4,Jorge,50,ES12209580187759187137,TRX_N-00365-99144043,2022-11-19T12:19:24,Galdakao,Expense,repairs,-191.28,-17838.34
buyer_4,Jorge,50,ES12209580187759187137,TRX_N-00366-57546944,2022-11-21T18:39:53,Galdakao,Expense,transport,-69.34,-17907.68
buyer_4,Jorge,50,ES12209580187759187137,TRX_N-00367-82743834,2022-11-21T18:13:01,Galdakao,Expense,cash,-100.0,-18007.68
buyer_4,Jorge,50,ES12209580187759187137,TRX_N-00368-64780791,2022-11-22T18:12:56,Vitoria-Gasteiz,Expense,leisure,-39.85,-18047.53
buyer_4,Jorge,50,ES12209580187759187137,TRX_N-00369-35230887,2022-11-22T00:19:25,Galdakao,Expense,cash,-100.0,-18147.53
buyer_4,Jorge,50,ES12209580187759187137,TRX_N-00370-70764449,2022-11-22T12:27:48,Galdakao,Expense,appliances,-209.54,-18357.07
buyer_4,Jorge,50,ES12209580187759187137,TRX_N-00371-28408685,2022-11-23T13:38:51,Galdakao,Expense,transport,-54.86,-18411.93
buyer_4,Jorge,50,ES12209580187759187137,TRX_N-00372-05178428,2022-11-23T20:28:38,Irun,Expense,education,-48.02,-18459.95
buyer_4,Jorge,50,ES12209580187759187137,TRX_N-00373-40727067,2022-11-24T15:19:35,Galdakao,Expense,food,-102.29,-18562.24
buyer_4,Jorge,50,ES12209580187759187137,TRX_N-00374-58966198,2022-11-24T12:04:19,Galdakao,Expense,leisure,-59.99,-18622.23
buyer_4,Jorge,50,ES12209580187759187137,TRX_N-00375-50914684,2022-11-25T09:06:34,Galdakao,Expense,transport,-82.03,-18704.26
buyer_4,Jorge,50,ES12209580187759187137,TRX_N-00376-28311298,2022-11-26T09:32:20,Zuia,Expense,food,-60.01,-18764.27
buyer_4,Jorge,50,ES12209580187759187137,TRX_N-00377-23093240,2022-11-26T12:19:05,Galdakao,Expense,leisure,-22.44,-18786.71
buyer_4,Jorge,50,ES12209580187759187137,TRX_N-00378-06746132,2022-11-27T10:50:16,Galdakao,Expense,leisure,-61.14,-18847.85
buyer_4,Jorge,50,ES12209580187759187137,TRX_N-00379-88772473,2022-11-27T18:12:47,Galdakao,Expense,cash,-100.0,-18947.85
buyer_4,Jorge,50,ES12209580187759187137,TRX_N-00380-70063438,2022-11-28T23:37:52,Galdakao,Expense,food,-78.55,-19026.4
buyer_4,Jorge,50,ES12209580187759187137,TRX_N-00381-53778561,2022-11-28T20:31:53,Iru√±a de Oca,Expense,leisure,-28.54,-19054.94
buyer_4,Jorge,50,ES12209580187759187137,TRX_N-00382-90329645,2022-11-28T04:38:21,Zarautz,Expense,healthcare,-115.14,-19170.08
buyer_4,Jorge,50,ES12209580187759187137,TRX_N-00383-53863684,2022-11-29T17:25:14,Galdakao,Expense,food,-96.0,-19266.08
buyer_4,Jorge,50,ES12209580187759187137,TRX_N-00384-83495198,2022-12-01T17:46:53,Galdakao,incomes,salary,1416.75,-17849.33
buyer_4,Jorge,50,ES12209580187759187137,TRX_N-00385-77464296,2022-12-01T17:46:53,Galdakao,incomes,salary_partner,1651.66,-16197.67
buyer_4,Jorge,50,ES12209580187759187137,TRX_N-00386-40278840,2022-12-01T17:46:53,Galdakao,incomes,extra_income,172.78,-16024.89
buyer_4,Jorge,50,ES12209580187759187137,TRX_N-00387-77336217,2022-12-01T17:46:53,Galdakao,incomes,salary_bonus,1039.64,-14985.25
buyer_4,Jorge,50,ES12209580187759187137,TRX_N-00388-45000244,2022-12-01T17:46:53,Galdakao,incomes,salary_partner_bonus,1291.1,-13694.15
buyer_4,Jorge,50,ES12209580187759187137,TRX_N-00389-25630899,2022-12-01T23:34:25,Galdakao,Expense,food,-97.89,-13792.04
buyer_4,Jorge,50,ES12209580187759187137,TRX_N-00390-41175981,2022-12-01T18:22:44,Galdakao,Expense,leisure,-66.49,-13858.53
buyer_4,Jorge,50,ES12209580187759187137,TRX_N-00391-57022163,2022-12-01T11:19:49,Galdakao,Expense,education,-47.72,-13906.25
buyer_4,Jorge,50,ES12209580187759187137,TRX_N-00392-29332009,2022-12-02T18:17:15,Oy√≥n-Oion,Expense,leisure,-60.53,-13966.78
buyer_4,Jorge,50,ES12209580187759187137,TRX_N-00393-29680007,2022-12-04T18:31:39,Galdakao,expenses,mortgage,-1078.4,-15045.18
buyer_4,Jorge,50,ES12209580187759187137,TRX_N-00394-12022145,2022-12-05T12:54:56,Galdakao,expenses,electricity,-30.77,-15075.95
buyer_4,Jorge,50,ES12209580187759187137,TRX_N-00395-86051596,2022-12-05T20:53:33,Galdakao,expenses,gas,-90.89,-15166.84
buyer_4,Jorge,50,ES12209580187759187137,TRX_N-00396-88499966,2022-12-05T08:44:17,Galdakao,Expense,transport,-49.06,-15215.9
buyer_4,Jorge,50,ES12209580187759187137,TRX_N-00397-11961921,2022-12-06T12:00:03,Galdakao,expenses,water,-35.57,-15251.47
buyer_4,Jorge,50,ES12209580187759187137,TRX_N-00398-54129995,2022-12-07T13:19:36,Galdakao,expenses,internet,-42.0,-15293.47
buyer_4,Jorge,50,ES12209580187759187137,TRX_N-00399-52605671,2022-12-07T18:53:16,Galdakao,Expense,leisure,-27.29,-15320.76
buyer_4,Jorge,50,ES12209580187759187137,TRX_N-00400-41469534,2022-12-07T08:39:52,Galdakao,Expense,repairs,-269.27,-15590.03
buyer_4,Jorge,50,ES12209580187759187137,TRX_N-00401-77442213,2022-12-07T09:38:46,Galdakao,expenses,children,-160.98,-15751.01
buyer_4,Jorge,50,ES12209580187759187137,TRX_N-00402-94653444,2022-12-08T19:16:12,Galdakao,expenses,phone,-36.34,-15787.35
buyer_4,Jorge,50,ES12209580187759187137,TRX_N-00403-51989941,2022-12-09T10:37:01,Donostia,Expense,gifts,-414.88,-16202.23
buyer_4,Jorge,50,ES12209580187759187137,TRX_N-00404-44651456,2022-12-10T22:34:05,Galdakao,Expense,transport,-62.55,-16264.78
buyer_4,Jorge,50,ES12209580187759187137,TRX_N-00405-75101452,2022-12-13T17:24:40,Galdakao,Expense,transport,-57.75,-16322.53
buyer_4,Jorge,50,ES12209580187759187137,TRX_N-00406-02026862,2022-12-13T16:34:57,Galdakao,Expense,gifts,-159.67,-16482.2
buyer_4,Jorge,50,ES12209580187759187137,TRX_N-00407-41186303,2022-12-14T17:52:34,Sopela,Expense,transport,-60.99,-16543.19
buyer_4,Jorge,50,ES12209580187759187137,TRX_N-00408-44854658,2022-12-14T11:41:56,Galdakao,Expense,cash,-100.0,-16643.19
buyer_4,Jorge,50,ES12209580187759187137,TRX_N-00409-68595673,2022-12-14T06:23:40,Galdakao,Expense,repairs,-105.7,-16748.89
buyer_4,Jorge,50,ES12209580187759187137,TRX_N-00410-43755697,2022-12-17T14:01:50,Galdakao,Expense,clothing,-118.0,-16866.89
buyer_4,Jorge,50,ES12209580187759187137,TRX_N-00411-19249058,2022-12-17T01:05:14,Galdakao,Expense,repairs,-235.98,-17102.87
buyer_4,Jorge,50,ES12209580187759187137,TRX_N-00412-62301381,2022-12-17T20:19:23,Galdakao,expenses,children,-75.8,-17178.67
buyer_4,Jorge,50,ES12209580187759187137,TRX_N-00413-45860435,2022-12-18T11:17:41,Galdakao,Expense,transport,-52.4,-17231.07
buyer_4,Jorge,50,ES12209580187759187137,TRX_N-00414-95966071,2022-12-18T20:35:24,Iru√±a de Oca,Expense,gifts,-227.26,-17458.33
buyer_4,Jorge,50,ES12209580187759187137,TRX_N-00415-89146674,2022-12-19T11:58:51,Donostia,Expense,clothing,-60.65,-17518.98
buyer_4,Jorge,50,ES12209580187759187137,TRX_N-00416-08520313,2022-12-19T15:04:38,Hondarribia,Expense,cash,-100.0,-17618.98
buyer_4,Jorge,50,ES12209580187759187137,TRX_N-00417-95139440,2022-12-20T12:58:26,Donostia,Expense,food,-102.36,-17721.34
buyer_4,Jorge,50,ES12209580187759187137,TRX_N-00418-14307244,2022-12-22T20:12:35,Galdakao,expenses,children,-206.78,-17928.12
buyer_4,Jorge,50,ES12209580187759187137,TRX_N-00419-29135516,2022-12-23T18:21:32,Galdakao,Expense,cash,-100.0,-18028.12
buyer_4,Jorge,50,ES12209580187759187137,TRX_N-00420-84738221,2022-12-24T13:30:20,Galdakao,Expense,food,-67.06,-18095.18
buyer_4,Jorge,50,ES12209580187759187137,TRX_N-00421-99710041,2022-12-27T11:45:47,Galdakao,Expense,gifts,-619.31,-18714.49
buyer_4,Jorge,50,ES12209580187759187137,TRX_N-00422-92559407,2022-12-28T20:01:21,Galdakao,Expense,education,-78.91,-18793.4
buyer_4,Jorge,50,ES12209580187759187137,TRX_N-00423-86947968,2022-12-29T10:49:58,Hernani,Expense,education,-59.36,-18852.76
buyer_4,Jorge,50,ES12209580187759187137,TRX_N-00424-18333864,2022-12-30T08:23:36,Galdakao,Expense,food,-79.56,-18932.32
buyer_4,Jorge,50,ES12209580187759187137,TRX_N-00425-33614435,2022-12-30T14:40:59,Galdakao,Expense,clothing,-45.73,-18978.05
buyer_4,Jorge,50,ES12209580187759187137,TRX_N-00426-55619858,2022-12-30T21:17:09,Galdakao,Expense,appliances,-76.4,-19054.45
buyer_4,Jorge,50,ES12209580187759187137,TRX_N-00427-41152093,2023-01-01T15:25:33,Galdakao,incomes,salary,1449.89,-17604.56
buyer_4,Jorge,50,ES12209580187759187137,TRX_N-00428-90249721,2023-01-01T15:25:33,Galdakao,incomes,salary_partner,1690.29,-15914.27
buyer_4,Jorge,50,ES12209580187759187137,TRX_N-00429-41374674,2023-01-01T10:58:21,Galdakao,Expense,food,-60.62,-15974.89
buyer_4,Jorge,50,ES12209580187759187137,TRX_N-00430-62453285,2023-01-02T23:25:04,Galdakao,Expense,food,-102.5,-16077.39
buyer_4,Jorge,50,ES12209580187759187137,TRX_N-00431-66930982,2023-01-02T04:28:58,Galdakao,expenses,children,-260.19,-16337.58
buyer_4,Jorge,50,ES12209580187759187137,TRX_N-00432-39803452,2023-01-03T19:38:08,Galdakao,expenses,children,-165.55,-16503.13
buyer_4,Jorge,50,ES12209580187759187137,TRX_N-00433-01657646,2023-01-04T21:33:09,Galdakao,expenses,mortgage,-1078.4,-17581.53
buyer_4,Jorge,50,ES12209580187759187137,TRX_N-00434-39497837,2023-01-05T17:33:42,Iru√±a de Oca,Expense,cash,-100.0,-17681.53
buyer_4,Jorge,50,ES12209580187759187137,TRX_N-00435-46098146,2023-01-06T22:37:23,Labastida,Expense,cash,-100.0,-17781.53
buyer_4,Jorge,50,ES12209580187759187137,TRX_N-00436-59541034,2023-01-06T10:27:18,Galdakao,Expense,repairs,-65.72,-17847.25
buyer_4,Jorge,50,ES12209580187759187137,TRX_N-00437-28469400,2023-01-07T08:28:31,Galdakao,expenses,electricity,-79.66,-17926.91
buyer_4,Jorge,50,ES12209580187759187137,TRX_N-00438-69838809,2023-01-07T13:59:18,Galdakao,Expense,leisure,-52.72,-17979.63
buyer_4,Jorge,50,ES12209580187759187137,TRX_N-00439-30446090,2023-01-07T06:42:50,Amurrio,Expense,repairs,-84.21,-18063.84
buyer_4,Jorge,50,ES12209580187759187137,TRX_N-00440-52833280,2023-01-08T18:55:52,Galdakao,expenses,water,-36.99,-18100.83
buyer_4,Jorge,50,ES12209580187759187137,TRX_N-00441-34980981,2023-01-08T23:33:26,Galdakao,expenses,gas,-94.5,-18195.33
buyer_4,Jorge,50,ES12209580187759187137,TRX_N-00442-29538674,2023-01-08T13:36:36,Galdakao,expenses,internet,-42.0,-18237.33
buyer_4,Jorge,50,ES12209580187759187137,TRX_N-00443-72435163,2023-01-08T14:13:12,Galdakao,expenses,phone,-44.72,-18282.05
buyer_4,Jorge,50,ES12209580187759187137,TRX_N-00444-00139674,2023-01-08T03:31:08,Erandio,Expense,travel,-1578.99,-19861.04
buyer_4,Jorge,50,ES12209580187759187137,TRX_N-00445-02478229,2023-01-09T13:13:35,Galdakao,Expense,food,-68.98,-19930.02
buyer_4,Jorge,50,ES12209580187759187137,TRX_N-00446-25712348,2023-01-11T08:00:47,Galdakao,Expense,transport,-61.21,-19991.23
buyer_4,Jorge,50,ES12209580187759187137,TRX_N-00447-21936818,2023-01-12T16:38:33,Galdakao,Expense,cash,-100.0,-20091.23
buyer_4,Jorge,50,ES12209580187759187137,TRX_N-00448-72690748,2023-01-13T10:40:25,Galdakao,Expense,transport,-84.26,-20175.49
buyer_4,Jorge,50,ES12209580187759187137,TRX_N-00449-54906735,2023-01-15T14:27:57,Galdakao,Expense,cash,-100.0,-20275.49
buyer_4,Jorge,50,ES12209580187759187137,TRX_N-00450-62205792,2023-01-16T15:49:50,Galdakao,Expense,cash,-100.0,-20375.49
buyer_4,Jorge,50,ES12209580187759187137,TRX_N-00451-48502284,2023-01-17T13:52:46,Galdakao,Expense,leisure,-36.46,-20411.95
buyer_4,Jorge,50,ES12209580187759187137,TRX_N-00452-93461743,2023-01-18T08:13:39,Mungia,Expense,appliances,-310.17,-20722.12
buyer_4,Jorge,50,ES12209580187759187137,TRX_N-00453-76272416,2023-01-19T18:36:50,Galdakao,Expense,food,-89.79,-20811.91
buyer_4,Jorge,50,ES12209580187759187137,TRX_N-00454-77396979,2023-01-25T07:34:15,Galdakao,Expense,leisure,-18.2,-20830.11
buyer_4,Jorge,50,ES12209580187759187137,TRX_N-00455-55318918,2023-01-28T19:49:30,Galdakao,Expense,food,-74.46,-20904.57
buyer_4,Jorge,50,ES12209580187759187137,TRX_N-00456-40797694,2023-01-28T18:26:10,Galdakao,Expense,appliances,-393.11,-21297.68
buyer_4,Jorge,50,ES12209580187759187137,TRX_N-00457-64969246,2023-01-28T13:01:59,Sopela,Expense,gifts,-593.01,-21890.69
buyer_4,Jorge,50,ES12209580187759187137,TRX_N-00458-77833147,2023-01-29T17:19:19,Galdakao,Expense,repairs,-156.52,-22047.21
buyer_4,Jorge,50,ES12209580187759187137,TRX_N-00459-71610469,2023-01-30T17:45:33,Galdakao,Expense,education,-59.53,-22106.74
buyer_4,Jorge,50,ES12209580187759187137,TRX_N-00460-48962300,2023-01-31T09:13:27,Zuia,Expense,food,-123.85,-22230.59
buyer_4,Jorge,50,ES12209580187759187137,TRX_N-00461-78104670,2023-02-01T18:31:39,Galdakao,incomes,salary,1449.89,-20780.7
buyer_4,Jorge,50,ES12209580187759187137,TRX_N-00462-46744397,2023-02-01T18:31:39,Galdakao,incomes,salary_partner,1690.29,-19090.41
buyer_4,Jorge,50,ES12209580187759187137,TRX_N-00463-08069116,2023-02-02T09:13:00,Galdakao,Expense,food,-60.56,-19150.97
buyer_4,Jorge,50,ES12209580187759187137,TRX_N-00464-32161967,2023-02-02T13:58:17,Labastida,Expense,travel,-1579.95,-20730.92
buyer_4,Jorge,50,ES12209580187759187137,TRX_N-00465-80651497,2023-02-02T20:47:18,Galdakao,Expense,gifts,-532.03,-21262.95
buyer_4,Jorge,50,ES12209580187759187137,TRX_N-00466-70197722,2023-02-03T12:49:01,Errenteria,Expense,transport,-41.64,-21304.59
buyer_4,Jorge,50,ES12209580187759187137,TRX_N-00467-11009331,2023-02-03T09:50:15,Galdakao,Expense,education,-72.81,-21377.4
buyer_4,Jorge,50,ES12209580187759187137,TRX_N-00468-14739062,2023-02-03T20:16:42,Galdakao,expenses,children,-61.55,-21438.95
buyer_4,Jorge,50,ES12209580187759187137,TRX_N-00469-46966672,2023-02-04T12:52:18,Galdakao,expenses,mortgage,-1078.4,-22517.35
buyer_4,Jorge,50,ES12209580187759187137,TRX_N-00470-53190417,2023-02-04T09:09:47,Galdakao,Expense,leisure,-43.52,-22560.87
buyer_4,Jorge,50,ES12209580187759187137,TRX_N-00471-83065913,2023-02-05T09:22:07,Galdakao,Expense,cash,-100.0,-22660.87
buyer_4,Jorge,50,ES12209580187759187137,TRX_N-00472-34042348,2023-02-05T15:08:45,Galdakao,Expense,gifts,-212.34,-22873.21
buyer_4,Jorge,50,ES12209580187759187137,TRX_N-00473-15361545,2023-02-06T21:23:21,Galdakao,Expense,transport,-80.55,-22953.76
buyer_4,Jorge,50,ES12209580187759187137,TRX_N-00474-09070457,2023-02-07T11:30:55,Galdakao,expenses,water,-29.6,-22983.36
buyer_4,Jorge,50,ES12209580187759187137,TRX_N-00475-12250169,2023-02-07T14:43:00,Basauri,Expense,food,-109.5,-23092.86
buyer_4,Jorge,50,ES12209580187759187137,TRX_N-00476-25485487,2023-02-07T09:22:31,Galdakao,Expense,leisure,-68.56,-23161.42
buyer_4,Jorge,50,ES12209580187759187137,TRX_N-00477-15426381,2023-02-08T08:29:24,Galdakao,expenses,gas,-109.32,-23270.74
buyer_4,Jorge,50,ES12209580187759187137,TRX_N-00478-68463973,2023-02-08T14:14:33,Galdakao,expenses,electricity,-25.01,-23295.75
buyer_4,Jorge,50,ES12209580187759187137,TRX_N-00479-37190367,2023-02-08T16:23:48,Galdakao,expenses,internet,-42.0,-23337.75
buyer_4,Jorge,50,ES12209580187759187137,TRX_N-00480-89832257,2023-02-08T19:24:36,Galdakao,expenses,phone,-36.33,-23374.08
buyer_4,Jorge,50,ES12209580187759187137,TRX_N-00481-99666952,2023-02-08T16:09:34,Galdakao,Expense,appliances,-288.31,-23662.39
buyer_4,Jorge,50,ES12209580187759187137,TRX_N-00482-34069217,2023-02-08T12:42:33,Galdakao,Expense,repairs,-94.11,-23756.5
buyer_4,Jorge,50,ES12209580187759187137,TRX_N-00483-25299004,2023-02-09T14:12:33,Galdakao,Expense,clothing,-123.02,-23879.52
buyer_4,Jorge,50,ES12209580187759187137,TRX_N-00484-70676112,2023-02-10T15:28:04,Galdakao,Expense,leisure,-72.02,-23951.54
buyer_4,Jorge,50,ES12209580187759187137,TRX_N-00485-12644392,2023-02-14T06:32:04,Galdakao,Expense,leisure,-32.12,-23983.66
buyer_4,Jorge,50,ES12209580187759187137,TRX_N-00486-27367348,2023-02-14T22:49:22,Galdakao,Expense,gifts,-809.6,-24793.26
buyer_4,Jorge,50,ES12209580187759187137,TRX_N-00487-12980438,2023-02-15T20:16:07,Sopela,Expense,food,-74.56,-24867.82
buyer_4,Jorge,50,ES12209580187759187137,TRX_N-00488-05253383,2023-02-15T19:45:26,Galdakao,Expense,education,-50.16,-24917.98
buyer_4,Jorge,50,ES12209580187759187137,TRX_N-00489-41578091,2023-02-16T15:51:38,Vitoria-Gasteiz,Expense,education,-58.32,-24976.3
buyer_4,Jorge,50,ES12209580187759187137,TRX_N-00490-35210272,2023-02-17T13:07:51,Galdakao,Expense,clothing,-132.27,-25108.57
buyer_4,Jorge,50,ES12209580187759187137,TRX_N-00491-08664137,2023-02-18T09:09:58,Alegr√≠a-Dulantzi,Expense,education,-70.71,-25179.28
buyer_4,Jorge,50,ES12209580187759187137,TRX_N-00492-79627956,2023-02-19T16:06:17,Pasaia,Expense,clothing,-115.62,-25294.9
buyer_4,Jorge,50,ES12209580187759187137,TRX_N-00493-20871270,2023-02-20T11:47:34,Galdakao,Expense,food,-124.91,-25419.81
buyer_4,Jorge,50,ES12209580187759187137,TRX_N-00494-68891464,2023-02-23T12:00:18,Galdakao,Expense,food,-83.71,-25503.52
buyer_4,Jorge,50,ES12209580187759187137,TRX_N-00495-54055090,2023-02-23T20:49:15,Galdakao,Expense,cash,-100.0,-25603.52
buyer_4,Jorge,50,ES12209580187759187137,TRX_N-00496-72239794,2023-02-24T11:04:51,Galdakao,Expense,food,-86.65,-25690.17
buyer_4,Jorge,50,ES12209580187759187137,TRX_N-00497-59682418,2023-02-27T15:37:59,Galdakao,Expense,education,-70.78,-25760.95
buyer_4,Jorge,50,ES12209580187759187137,TRX_N-00498-68337029,2023-03-01T11:40:05,Galdakao,incomes,salary,1449.89,-24311.06
buyer_4,Jorge,50,ES12209580187759187137,TRX_N-00499-94583059,2023-03-01T11:40:05,Galdakao,incomes,salary_partner,1690.29,-22620.77
buyer_4,Jorge,50,ES12209580187759187137,TRX_N-00500-21363782,2023-03-01T11:40:05,Galdakao,incomes,extra_income,172.78,-22447.99
buyer_4,Jorge,50,ES12209580187759187137,TRX_N-00501-05397365,2023-03-01T12:57:47,Galdakao,Expense,food,-70.59,-22518.58
buyer_4,Jorge,50,ES12209580187759187137,TRX_N-00502-39212570,2023-03-04T16:23:10,Galdakao,expenses,mortgage,-1078.4,-23596.98
buyer_4,Jorge,50,ES12209580187759187137,TRX_N-00503-41581657,2023-03-04T17:39:58,Galdakao,Expense,clothing,-73.98,-23670.96
buyer_4,Jorge,50,ES12209580187759187137,TRX_N-00504-78146878,2023-03-04T20:21:28,Galdakao,Expense,repairs,-227.6,-23898.56
buyer_4,Jorge,50,ES12209580187759187137,TRX_N-00505-97086380,2023-03-05T14:53:11,Galdakao,Expense,cash,-100.0,-23998.56
buyer_4,Jorge,50,ES12209580187759187137,TRX_N-00506-23627028,2023-03-06T12:01:16,Galdakao,expenses,gas,-61.36,-24059.92
buyer_4,Jorge,50,ES12209580187759187137,TRX_N-00507-93568260,2023-03-07T22:58:16,Galdakao,expenses,electricity,-50.46,-24110.38
buyer_4,Jorge,50,ES12209580187759187137,TRX_N-00508-30966140,2023-03-07T13:54:54,Galdakao,Expense,travel,-1390.38,-25500.76
buyer_4,Jorge,50,ES12209580187759187137,TRX_N-00509-60727631,2023-03-08T23:02:12,Galdakao,expenses,water,-40.25,-25541.01
buyer_4,Jorge,50,ES12209580187759187137,TRX_N-00510-04622350,2023-03-08T09:47:02,Galdakao,expenses,internet,-42.0,-25583.01
buyer_4,Jorge,50,ES12209580187759187137,TRX_N-00511-89587394,2023-03-08T15:36:03,Galdakao,expenses,phone,-41.28,-25624.29
buyer_4,Jorge,50,ES12209580187759187137,TRX_N-00512-57402835,2023-03-12T13:42:34,Galdakao,Expense,food,-102.53,-25726.82
buyer_4,Jorge,50,ES12209580187759187137,TRX_N-00513-39186487,2023-03-12T20:54:47,Galdakao,Expense,transport,-74.81,-25801.63
buyer_4,Jorge,50,ES12209580187759187137,TRX_N-00514-54359054,2023-03-12T12:31:13,Amurrio,Expense,travel,-878.06,-26679.69
buyer_4,Jorge,50,ES12209580187759187137,TRX_N-00515-27282271,2023-03-18T14:31:59,Galdakao,Expense,leisure,-52.28,-26731.97
buyer_4,Jorge,50,ES12209580187759187137,TRX_N-00516-28754603,2023-03-18T11:24:30,Galdakao,Expense,travel,-1453.63,-28185.6
buyer_4,Jorge,50,ES12209580187759187137,TRX_N-00517-58682281,2023-03-20T20:05:40,Galdakao,Expense,food,-123.51,-28309.11
buyer_4,Jorge,50,ES12209580187759187137,TRX_N-00518-34878266,2023-03-20T08:05:38,Mungia,Expense,leisure,-62.95,-28372.06
buyer_4,Jorge,50,ES12209580187759187137,TRX_N-00519-06176222,2023-03-21T08:14:28,Galdakao,Expense,healthcare,-152.03,-28524.09
buyer_4,Jorge,50,ES12209580187759187137,TRX_N-00520-23402271,2023-03-21T19:59:20,Hondarribia,Expense,appliances,-98.68,-28622.77
buyer_4,Jorge,50,ES12209580187759187137,TRX_N-00521-67816154,2023-03-22T16:41:20,Leioa,Expense,food,-109.45,-28732.22
buyer_4,Jorge,50,ES12209580187759187137,TRX_N-00522-61682657,2023-03-23T14:57:11,Galdakao,Expense,clothing,-70.73,-28802.95
buyer_4,Jorge,50,ES12209580187759187137,TRX_N-00523-64385191,2023-03-23T10:14:38,Llodio,Expense,gifts,-442.81,-29245.76
buyer_4,Jorge,50,ES12209580187759187137,TRX_N-00524-66856561,2023-03-24T19:30:08,Hernani,Expense,repairs,-257.18,-29502.94
buyer_4,Jorge,50,ES12209580187759187137,TRX_N-00525-02756836,2023-03-25T13:44:22,Galdakao,Expense,cash,-100.0,-29602.94
buyer_4,Jorge,50,ES12209580187759187137,TRX_N-00526-34829257,2023-03-26T10:02:34,Galdakao,Expense,cash,-100.0,-29702.94
buyer_4,Jorge,50,ES12209580187759187137,TRX_N-00527-18867757,2023-03-30T01:05:36,Galdakao,Expense,food,-124.17,-29827.11
buyer_4,Jorge,50,ES12209580187759187137,TRX_N-00528-70804110,2023-03-31T14:33:28,Galdakao,Expense,transport,-53.95,-29881.06
buyer_4,Jorge,50,ES12209580187759187137,TRX_N-00529-59752134,2023-04-01T08:55:05,Galdakao,incomes,salary,1449.89,-28431.17
buyer_4,Jorge,50,ES12209580187759187137,TRX_N-00530-05254616,2023-04-01T08:55:05,Galdakao,incomes,salary_partner,1690.29,-26740.88
buyer_4,Jorge,50,ES12209580187759187137,TRX_N-00531-47645642,2023-04-01T20:15:06,Andoain,Expense,clothing,-141.84,-26882.72
buyer_4,Jorge,50,ES12209580187759187137,TRX_N-00532-87450890,2023-04-03T19:28:20,Galdakao,Expense,food,-91.99,-26974.71
buyer_4,Jorge,50,ES12209580187759187137,TRX_N-00533-29695982,2023-04-03T10:10:00,Galdakao,Expense,leisure,-68.84,-27043.55
buyer_4,Jorge,50,ES12209580187759187137,TRX_N-00534-59742314,2023-04-03T18:11:36,Galdakao,Expense,gifts,-461.89,-27505.44
buyer_4,Jorge,50,ES12209580187759187137,TRX_N-00535-90452906,2023-04-04T19:17:18,Galdakao,expenses,mortgage,-1078.4,-28583.84
buyer_4,Jorge,50,ES12209580187759187137,TRX_N-00536-90780745,2023-04-04T11:12:55,Galdakao,Expense,food,-101.96,-28685.8
buyer_4,Jorge,50,ES12209580187759187137,TRX_N-00537-18737539,2023-04-05T20:39:56,Galdakao,expenses,water,-44.92,-28730.72
buyer_4,Jorge,50,ES12209580187759187137,TRX_N-00538-09743216,2023-04-05T19:38:44,Galdakao,expenses,internet,-42.0,-28772.72
buyer_4,Jorge,50,ES12209580187759187137,TRX_N-00539-10447375,2023-04-05T19:49:25,Berango,Expense,food,-84.76,-28857.48
buyer_4,Jorge,50,ES12209580187759187137,TRX_N-00540-81874808,2023-04-06T16:29:52,Galdakao,expenses,gas,-70.96,-28928.44
buyer_4,Jorge,50,ES12209580187759187137,TRX_N-00541-48028860,2023-04-06T01:56:16,Galdakao,expenses,phone,-32.76,-28961.2
buyer_4,Jorge,50,ES12209580187759187137,TRX_N-00542-22864006,2023-04-06T08:21:15,Galdakao,Expense,clothing,-120.65,-29081.85
buyer_4,Jorge,50,ES12209580187759187137,TRX_N-00543-84971696,2023-04-07T15:27:20,Galdakao,Expense,transport,-48.27,-29130.12
buyer_4,Jorge,50,ES12209580187759187137,TRX_N-00544-13082284,2023-04-08T18:41:49,Galdakao,expenses,electricity,-53.5,-29183.62
buyer_4,Jorge,50,ES12209580187759187137,TRX_N-00545-31502288,2023-04-08T08:44:49,Galdakao,Expense,cash,-100.0,-29283.62
buyer_4,Jorge,50,ES12209580187759187137,TRX_N-00546-43260167,2023-04-08T11:45:35,Galdakao,Expense,repairs,-231.15,-29514.77
buyer_4,Jorge,50,ES12209580187759187137,TRX_N-00547-34867433,2023-04-09T13:41:58,Galdakao,Expense,gifts,-246.12,-29760.89
buyer_4,Jorge,50,ES12209580187759187137,TRX_N-00548-95457400,2023-04-10T16:23:59,Galdakao,Expense,healthcare,-183.64,-29944.53
buyer_4,Jorge,50,ES12209580187759187137,TRX_N-00549-51281240,2023-04-10T17:47:23,Galdakao,Expense,appliances,-404.7,-30349.23
buyer_4,Jorge,50,ES12209580187759187137,TRX_N-00550-00434782,2023-04-11T08:11:57,Sestao,Expense,transport,-60.97,-30410.2
buyer_4,Jorge,50,ES12209580187759187137,TRX_N-00551-44635029,2023-04-11T20:53:48,Galdakao,Expense,cash,-100.0,-30510.2
buyer_4,Jorge,50,ES12209580187759187137,TRX_N-00552-33820865,2023-04-11T16:52:11,Galdakao,Expense,gifts,-29.28,-30539.48
buyer_4,Jorge,50,ES12209580187759187137,TRX_N-00553-87782560,2023-04-13T14:38:55,Galdakao,Expense,transport,-48.46,-30587.94
buyer_4,Jorge,50,ES12209580187759187137,TRX_N-00554-18068789,2023-04-17T08:40:00,Galdakao,Expense,repairs,-53.92,-30641.86
buyer_4,Jorge,50,ES12209580187759187137,TRX_N-00555-29941980,2023-04-19T08:10:09,Galdakao,Expense,food,-99.48,-30741.34
buyer_4,Jorge,50,ES12209580187759187137,TRX_N-00556-80998078,2023-04-19T16:14:35,Galdakao,Expense,healthcare,-126.58,-30867.92
buyer_4,Jorge,50,ES12209580187759187137,TRX_N-00557-40626511,2023-04-19T19:52:48,Galdakao,Expense,gifts,-452.75,-31320.67
buyer_4,Jorge,50,ES12209580187759187137,TRX_N-00558-73441011,2023-04-21T16:02:06,Galdakao,Expense,transport,-57.54,-31378.21
buyer_4,Jorge,50,ES12209580187759187137,TRX_N-00559-90043412,2023-04-22T15:21:21,Galdakao,Expense,leisure,-23.78,-31401.99
buyer_4,Jorge,50,ES12209580187759187137,TRX_N-00560-41525285,2023-04-23T17:18:36,Galdakao,Expense,leisure,-23.36,-31425.35
buyer_4,Jorge,50,ES12209580187759187137,TRX_N-00561-45227209,2023-04-23T13:26:01,Galdakao,Expense,repairs,-214.57,-31639.92
buyer_4,Jorge,50,ES12209580187759187137,TRX_N-00562-56091561,2023-04-25T17:15:59,Galdakao,Expense,food,-84.15,-31724.07
buyer_4,Jorge,50,ES12209580187759187137,TRX_N-00563-17959102,2023-04-25T20:27:26,Galdakao,Expense,leisure,-77.2,-31801.27
buyer_4,Jorge,50,ES12209580187759187137,TRX_N-00564-15796142,2023-04-26T11:54:58,Galdakao,Expense,cash,-100.0,-31901.27
buyer_4,Jorge,50,ES12209580187759187137,TRX_N-00565-58875655,2023-04-26T09:38:51,Galdakao,Expense,repairs,-132.67,-32033.94
buyer_4,Jorge,50,ES12209580187759187137,TRX_N-00566-99661435,2023-04-30T10:54:36,Barakaldo,Expense,cash,-100.0,-32133.94
buyer_4,Jorge,50,ES12209580187759187137,TRX_N-00567-87015648,2023-05-01T14:11:25,Galdakao,incomes,salary,1449.89,-30684.05
buyer_4,Jorge,50,ES12209580187759187137,TRX_N-00568-87187179,2023-05-01T14:11:25,Galdakao,incomes,salary_partner,1690.29,-28993.76
buyer_4,Jorge,50,ES12209580187759187137,TRX_N-00569-63464345,2023-05-01T15:19:17,Galdakao,expenses,children,-154.11,-29147.87
buyer_4,Jorge,50,ES12209580187759187137,TRX_N-00570-88971195,2023-05-03T02:42:39,Galdakao,Expense,food,-65.19,-29213.06
buyer_4,Jorge,50,ES12209580187759187137,TRX_N-00571-18651691,2023-05-04T11:16:30,Galdakao,expenses,mortgage,-1078.4,-30291.46
buyer_4,Jorge,50,ES12209580187759187137,TRX_N-00572-17462204,2023-05-05T11:59:17,Galdakao,expenses,gas,-38.57,-30330.03
buyer_4,Jorge,50,ES12209580187759187137,TRX_N-00573-76674655,2023-05-05T16:23:30,Galdakao,expenses,internet,-42.0,-30372.03
buyer_4,Jorge,50,ES12209580187759187137,TRX_N-00574-62334595,2023-05-06T21:14:57,Galdakao,expenses,water,-26.58,-30398.61
buyer_4,Jorge,50,ES12209580187759187137,TRX_N-00575-23583760,2023-05-06T21:02:52,Galdakao,Expense,transport,-81.91,-30480.52
buyer_4,Jorge,50,ES12209580187759187137,TRX_N-00576-66123906,2023-05-08T08:00:18,Galdakao,expenses,electricity,-24.1,-30504.62
buyer_4,Jorge,50,ES12209580187759187137,TRX_N-00577-89062910,2023-05-08T11:22:40,Galdakao,expenses,phone,-38.15,-30542.77
buyer_4,Jorge,50,ES12209580187759187137,TRX_N-00578-08731356,2023-05-08T17:09:09,Galdakao,Expense,transport,-44.35,-30587.12
buyer_4,Jorge,50,ES12209580187759187137,TRX_N-00579-16679430,2023-05-08T13:15:51,Getxo,Expense,clothing,-101.04,-30688.16
buyer_4,Jorge,50,ES12209580187759187137,TRX_N-00580-67386240,2023-05-09T15:22:33,Galdakao,Expense,gifts,-246.82,-30934.98
buyer_4,Jorge,50,ES12209580187759187137,TRX_N-00581-01933537,2023-05-12T12:41:26,Galdakao,Expense,education,-55.3,-30990.28
buyer_4,Jorge,50,ES12209580187759187137,TRX_N-00582-84011398,2023-05-12T14:51:48,Galdakao,Expense,appliances,-340.86,-31331.14
buyer_4,Jorge,50,ES12209580187759187137,TRX_N-00583-63863021,2023-05-13T13:15:55,Galdakao,Expense,cash,-100.0,-31431.14
buyer_4,Jorge,50,ES12209580187759187137,TRX_N-00584-37772259,2023-05-15T01:03:02,Iru√±a de Oca,Expense,repairs,-261.8,-31692.94
buyer_4,Jorge,50,ES12209580187759187137,TRX_N-00585-61712922,2023-05-18T18:22:47,Galdakao,Expense,food,-74.32,-31767.26
buyer_4,Jorge,50,ES12209580187759187137,TRX_N-00586-32905339,2023-05-18T14:35:02,Galdakao,Expense,clothing,-109.16,-31876.42
buyer_4,Jorge,50,ES12209580187759187137,TRX_N-00587-31555422,2023-05-18T09:09:23,Galdakao,Expense,gifts,-186.23,-32062.65
buyer_4,Jorge,50,ES12209580187759187137,TRX_N-00588-04384881,2023-05-19T13:35:26,Arrasate,Expense,repairs,-316.58,-32379.23
buyer_4,Jorge,50,ES12209580187759187137,TRX_N-00589-77128066,2023-05-20T12:52:26,Galdakao,Expense,transport,-72.65,-32451.88
buyer_4,Jorge,50,ES12209580187759187137,TRX_N-00590-85758793,2023-05-20T16:18:45,Galdakao,Expense,education,-51.78,-32503.66
buyer_4,Jorge,50,ES12209580187759187137,TRX_N-00591-12288939,2023-05-20T20:07:19,Galdakao,Expense,cash,-100.0,-32603.66
buyer_4,Jorge,50,ES12209580187759187137,TRX_N-00592-36735672,2023-05-21T06:07:57,Galdakao,Expense,food,-108.09,-32711.75
buyer_4,Jorge,50,ES12209580187759187137,TRX_N-00593-93897586,2023-05-23T08:42:23,Galdakao,Expense,repairs,-322.74,-33034.49
buyer_4,Jorge,50,ES12209580187759187137,TRX_N-00594-38775564,2023-05-24T08:20:53,Galdakao,Expense,food,-107.67,-33142.16
buyer_4,Jorge,50,ES12209580187759187137,TRX_N-00595-05004392,2023-05-24T20:39:44,Galdakao,Expense,gifts,-142.66,-33284.82
buyer_4,Jorge,50,ES12209580187759187137,TRX_N-00596-75394478,2023-05-25T16:43:46,Galdakao,Expense,food,-102.6,-33387.42
buyer_4,Jorge,50,ES12209580187759187137,TRX_N-00597-88554637,2023-05-25T09:20:29,Salvatierra/Agurain,Expense,travel,-1533.03,-34920.45
buyer_4,Jorge,50,ES12209580187759187137,TRX_N-00598-84545791,2023-05-28T21:51:44,Galdakao,Expense,cash,-100.0,-35020.45
buyer_4,Jorge,50,ES12209580187759187137,TRX_N-00599-85179500,2023-05-29T11:53:58,Erandio,Expense,cash,-100.0,-35120.45
buyer_4,Jorge,50,ES12209580187759187137,TRX_N-00600-47155876,2023-05-30T13:35:26,Galdakao,Expense,clothing,-113.54,-35233.99
buyer_4,Jorge,50,ES12209580187759187137,TRX_N-00601-58711727,2023-05-30T10:45:01,Galdakao,Expense,cash,-100.0,-35333.99
buyer_4,Jorge,50,ES12209580187759187137,TRX_N-00602-90700322,2023-05-30T16:21:45,Andoain,Expense,gifts,-796.07,-36130.06
buyer_4,Jorge,50,ES12209580187759187137,TRX_N-00603-29326725,2023-05-31T18:35:49,Galdakao,Expense,repairs,-91.93,-36221.99
buyer_4,Jorge,50,ES12209580187759187137,TRX_N-00604-67147175,2023-06-01T19:00:05,Galdakao,incomes,salary,1449.89,-34772.1
buyer_4,Jorge,50,ES12209580187759187137,TRX_N-00605-83637604,2023-06-01T19:00:05,Galdakao,incomes,salary_partner,1690.29,-33081.81
buyer_4,Jorge,50,ES12209580187759187137,TRX_N-00606-78314523,2023-06-01T19:00:05,Galdakao,incomes,extra_income,172.78,-32909.03
buyer_4,Jorge,50,ES12209580187759187137,TRX_N-00607-94511933,2023-06-01T19:00:05,Galdakao,incomes,salary_bonus,1110.38,-31798.65
buyer_4,Jorge,50,ES12209580187759187137,TRX_N-00608-54218326,2023-06-01T19:00:05,Galdakao,incomes,salary_partner_bonus,1281.12,-30517.53
buyer_4,Jorge,50,ES12209580187759187137,TRX_N-00609-15363036,2023-06-03T11:44:10,Galdakao,Expense,transport,-87.17,-30604.7
buyer_4,Jorge,50,ES12209580187759187137,TRX_N-00610-90802437,2023-06-03T14:07:54,Galdakao,Expense,repairs,-197.97,-30802.67
buyer_4,Jorge,50,ES12209580187759187137,TRX_N-00611-14877610,2023-06-04T10:13:14,Galdakao,expenses,mortgage,-1078.4,-31881.07
buyer_4,Jorge,50,ES12209580187759187137,TRX_N-00612-46918563,2023-06-05T11:28:46,Galdakao,expenses,gas,-112.68,-31993.75
buyer_4,Jorge,50,ES12209580187759187137,TRX_N-00613-76151212,2023-06-05T17:09:58,Galdakao,expenses,internet,-42.0,-32035.75
buyer_4,Jorge,50,ES12209580187759187137,TRX_N-00614-64919329,2023-06-05T19:34:03,Berango,Expense,leisure,-56.79,-32092.54
buyer_4,Jorge,50,ES12209580187759187137,TRX_N-00615-78631841,2023-06-05T12:27:34,Galdakao,Expense,repairs,-100.54,-32193.08
buyer_4,Jorge,50,ES12209580187759187137,TRX_N-00616-76848969,2023-06-06T05:08:14,Galdakao,expenses,electricity,-57.48,-32250.56
buyer_4,Jorge,50,ES12209580187759187137,TRX_N-00617-19415460,2023-06-07T18:59:13,Galdakao,Expense,education,-70.21,-32320.77
buyer_4,Jorge,50,ES12209580187759187137,TRX_N-00618-50526951,2023-06-07T23:04:02,Galdakao,Expense,cash,-100.0,-32420.77
buyer_4,Jorge,50,ES12209580187759187137,TRX_N-00619-52650299,2023-06-07T10:37:04,Irun,Expense,repairs,-301.51,-32722.28
buyer_4,Jorge,50,ES12209580187759187137,TRX_N-00620-15763233,2023-06-08T09:33:17,Galdakao,expenses,water,-33.12,-32755.4
buyer_4,Jorge,50,ES12209580187759187137,TRX_N-00621-39156181,2023-06-08T19:29:18,Galdakao,expenses,phone,-41.79,-32797.19
buyer_4,Jorge,50,ES12209580187759187137,TRX_N-00622-46106382,2023-06-08T16:21:00,Galdakao,Expense,cash,-100.0,-32897.19
buyer_4,Jorge,50,ES12209580187759187137,TRX_N-00623-83800934,2023-06-11T10:56:15,Errenteria,Expense,transport,-54.19,-32951.38
buyer_4,Jorge,50,ES12209580187759187137,TRX_N-00624-44347300,2023-06-12T22:31:34,Galdakao,Expense,transport,-74.11,-33025.49
buyer_4,Jorge,50,ES12209580187759187137,TRX_N-00625-42443769,2023-06-13T20:31:28,Galdakao,Expense,food,-122.1,-33147.59
buyer_4,Jorge,50,ES12209580187759187137,TRX_N-00626-02264787,2023-06-14T12:30:06,Galdakao,Expense,clothing,-76.96,-33224.55
buyer_4,Jorge,50,ES12209580187759187137,TRX_N-00627-72329580,2023-06-15T15:44:04,Llodio,Expense,food,-67.88,-33292.43
buyer_4,Jorge,50,ES12209580187759187137,TRX_N-00628-16453905,2023-06-15T19:46:22,Galdakao,Expense,healthcare,-39.44,-33331.87
buyer_4,Jorge,50,ES12209580187759187137,TRX_N-00629-47506820,2023-06-15T14:31:29,Galdakao,expenses,children,-192.67,-33524.54
buyer_4,Jorge,50,ES12209580187759187137,TRX_N-00630-07848378,2023-06-20T20:32:40,Galdakao,Expense,travel,-744.33,-34268.87
buyer_4,Jorge,50,ES12209580187759187137,TRX_N-00631-75210161,2023-06-22T14:55:12,Galdakao,Expense,food,-89.73,-34358.6
buyer_4,Jorge,50,ES12209580187759187137,TRX_N-00632-18429040,2023-06-23T17:59:11,Galdakao,Expense,food,-72.4,-34431.0
buyer_4,Jorge,50,ES12209580187759187137,TRX_N-00633-12439853,2023-06-24T18:15:10,Galdakao,Expense,repairs,-194.07,-34625.07
buyer_4,Jorge,50,ES12209580187759187137,TRX_N-00634-24454415,2023-06-25T17:36:03,Galdakao,Expense,leisure,-62.04,-34687.11
buyer_4,Jorge,50,ES12209580187759187137,TRX_N-00635-18940837,2023-06-25T09:43:55,Durango,Expense,cash,-100.0,-34787.11
buyer_4,Jorge,50,ES12209580187759187137,TRX_N-00636-51879713,2023-06-28T08:20:43,Galdakao,Expense,food,-61.77,-34848.88
buyer_4,Jorge,50,ES12209580187759187137,TRX_N-00637-27110640,2023-06-29T15:02:00,Galdakao,Expense,transport,-42.66,-34891.54
buyer_4,Jorge,50,ES12209580187759187137,TRX_N-00638-50049269,2023-06-30T09:40:50,Galdakao,Expense,transport,-75.62,-34967.16
buyer_4,Jorge,50,ES12209580187759187137,TRX_N-00639-66488163,2023-06-30T13:30:12,Galdakao,Expense,cash,-100.0,-35067.16
buyer_4,Jorge,50,ES12209580187759187137,TRX_N-00640-84303532,2023-07-01T12:08:22,Galdakao,incomes,salary,1449.89,-33617.27
buyer_4,Jorge,50,ES12209580187759187137,TRX_N-00641-95640287,2023-07-01T12:08:22,Galdakao,incomes,salary_partner,1690.29,-31926.98
buyer_4,Jorge,50,ES12209580187759187137,TRX_N-00642-45214458,2023-07-02T11:26:28,Galdakao,Expense,food,-100.71,-32027.69
buyer_4,Jorge,50,ES12209580187759187137,TRX_N-00643-59088483,2023-07-02T04:10:21,Santurtzi,Expense,cash,-100.0,-32127.69
buyer_4,Jorge,50,ES12209580187759187137,TRX_N-00644-31337872,2023-07-04T20:42:10,Galdakao,expenses,mortgage,-1078.4,-33206.09
buyer_4,Jorge,50,ES12209580187759187137,TRX_N-00645-25602072,2023-07-04T19:48:20,Portugalete,Expense,food,-117.11,-33323.2
buyer_4,Jorge,50,ES12209580187759187137,TRX_N-00646-22009742,2023-07-05T19:33:49,Galdakao,expenses,electricity,-72.4,-33395.6
buyer_4,Jorge,50,ES12209580187759187137,TRX_N-00647-39258812,2023-07-05T22:40:04,Galdakao,expenses,phone,-43.76,-33439.36
buyer_4,Jorge,50,ES12209580187759187137,TRX_N-00648-73550814,2023-07-05T18:16:27,Galdakao,Expense,transport,-77.41,-33516.77
buyer_4,Jorge,50,ES12209580187759187137,TRX_N-00649-14469269,2023-07-05T18:35:19,Galdakao,Expense,appliances,-202.4,-33719.17
buyer_4,Jorge,50,ES12209580187759187137,TRX_N-00650-98364748,2023-07-06T11:48:28,Galdakao,Expense,travel,-1365.9,-35085.07
buyer_4,Jorge,50,ES12209580187759187137,TRX_N-00651-14919800,2023-07-06T09:11:15,Galdakao,expenses,children,-120.96,-35206.03
buyer_4,Jorge,50,ES12209580187759187137,TRX_N-00652-28692158,2023-07-07T13:54:05,Galdakao,Expense,healthcare,-51.75,-35257.78
buyer_4,Jorge,50,ES12209580187759187137,TRX_N-00653-75892793,2023-07-07T09:58:23,Galdakao,Expense,appliances,-350.02,-35607.8
buyer_4,Jorge,50,ES12209580187759187137,TRX_N-00654-67516461,2023-07-07T23:05:41,Galdakao,expenses,children,-174.41,-35782.21
buyer_4,Jorge,50,ES12209580187759187137,TRX_N-00655-03563669,2023-07-08T16:23:59,Galdakao,expenses,gas,-91.61,-35873.82
buyer_4,Jorge,50,ES12209580187759187137,TRX_N-00656-13961692,2023-07-08T18:38:39,Galdakao,expenses,internet,-42.0,-35915.82
buyer_4,Jorge,50,ES12209580187759187137,TRX_N-00657-15646342,2023-07-08T17:30:05,Galdakao,expenses,water,-41.39,-35957.21
buyer_4,Jorge,50,ES12209580187759187137,TRX_N-00658-44222736,2023-07-08T12:56:14,Alegr√≠a-Dulantzi,Expense,food,-89.9,-36047.11
buyer_4,Jorge,50,ES12209580187759187137,TRX_N-00659-29310688,2023-07-09T01:23:54,Galdakao,Expense,travel,-335.17,-36382.28
buyer_4,Jorge,50,ES12209580187759187137,TRX_N-00660-37071006,2023-07-10T08:27:10,Galdakao,Expense,food,-106.31,-36488.59
buyer_4,Jorge,50,ES12209580187759187137,TRX_N-00661-64061019,2023-07-10T16:15:33,Galdakao,Expense,gifts,-74.43,-36563.02
buyer_4,Jorge,50,ES12209580187759187137,TRX_N-00662-35239523,2023-07-12T15:49:20,Lasarte-Oria,Expense,healthcare,-94.85,-36657.87
buyer_4,Jorge,50,ES12209580187759187137,TRX_N-00663-04231414,2023-07-15T13:55:18,Galdakao,Expense,gifts,-483.06,-37140.93
buyer_4,Jorge,50,ES12209580187759187137,TRX_N-00664-35033173,2023-07-17T13:05:01,Galdakao,Expense,leisure,-57.14,-37198.07
buyer_4,Jorge,50,ES12209580187759187137,TRX_N-00665-26294690,2023-07-20T10:48:36,Galdakao,Expense,food,-99.17,-37297.24
buyer_4,Jorge,50,ES12209580187759187137,TRX_N-00666-05188647,2023-07-20T09:43:27,Basauri,Expense,education,-67.04,-37364.28
buyer_4,Jorge,50,ES12209580187759187137,TRX_N-00667-31577660,2023-07-20T08:42:29,Basauri,Expense,cash,-100.0,-37464.28
buyer_4,Jorge,50,ES12209580187759187137,TRX_N-00668-67081934,2023-07-20T16:55:52,Iru√±a de Oca,Expense,repairs,-280.48,-37744.76
buyer_4,Jorge,50,ES12209580187759187137,TRX_N-00669-29897223,2023-07-21T17:15:44,Galdakao,Expense,gifts,-142.17,-37886.93
buyer_4,Jorge,50,ES12209580187759187137,TRX_N-00670-29523711,2023-07-23T09:54:24,Galdakao,Expense,food,-116.95,-38003.88
buyer_4,Jorge,50,ES12209580187759187137,TRX_N-00671-27002141,2023-07-23T18:49:37,Durango,Expense,healthcare,-75.62,-38079.5
buyer_4,Jorge,50,ES12209580187759187137,TRX_N-00672-05333890,2023-07-25T00:15:15,Galdakao,Expense,food,-92.99,-38172.49
buyer_4,Jorge,50,ES12209580187759187137,TRX_N-00673-11141593,2023-07-25T12:04:03,Galdakao,Expense,cash,-100.0,-38272.49
buyer_4,Jorge,50,ES12209580187759187137,TRX_N-00674-40285543,2023-07-26T18:14:40,Galdakao,Expense,food,-98.19,-38370.68
buyer_4,Jorge,50,ES12209580187759187137,TRX_N-00675-77369074,2023-07-28T11:26:10,Galdakao,Expense,cash,-100.0,-38470.68
buyer_4,Jorge,50,ES12209580187759187137,TRX_N-00676-22201282,2023-07-30T15:24:41,Santurtzi,Expense,leisure,-30.63,-38501.31
buyer_4,Jorge,50,ES12209580187759187137,TRX_N-00677-75230100,2023-07-30T15:09:57,Galdakao,Expense,education,-65.29,-38566.6
buyer_4,Jorge,50,ES12209580187759187137,TRX_N-00678-57046075,2023-08-01T14:37:45,Galdakao,incomes,salary,1449.89,-37116.71
buyer_4,Jorge,50,ES12209580187759187137,TRX_N-00679-04647036,2023-08-01T14:37:45,Galdakao,incomes,salary_partner,1690.29,-35426.42
buyer_4,Jorge,50,ES12209580187759187137,TRX_N-00680-45300070,2023-08-02T10:59:13,Galdakao,Expense,clothing,-109.05,-35535.47
buyer_4,Jorge,50,ES12209580187759187137,TRX_N-00681-27088801,2023-08-03T18:38:12,Galdakao,Expense,leisure,-54.26,-35589.73
buyer_4,Jorge,50,ES12209580187759187137,TRX_N-00682-47032893,2023-08-03T09:23:56,Galdakao,Expense,travel,-726.4,-36316.13
buyer_4,Jorge,50,ES12209580187759187137,TRX_N-00683-30340453,2023-08-04T18:37:32,Galdakao,expenses,mortgage,-1078.4,-37394.53
buyer_4,Jorge,50,ES12209580187759187137,TRX_N-00684-64765474,2023-08-04T09:36:07,Galdakao,Expense,transport,-60.18,-37454.71
buyer_4,Jorge,50,ES12209580187759187137,TRX_N-00685-37373902,2023-08-04T16:21:23,Galdakao,Expense,leisure,-67.2,-37521.91
buyer_4,Jorge,50,ES12209580187759187137,TRX_N-00686-19778758,2023-08-04T23:03:42,Galdakao,Expense,repairs,-29.69,-37551.6
buyer_4,Jorge,50,ES12209580187759187137,TRX_N-00687-66385877,2023-08-05T19:41:08,Galdakao,expenses,gas,-60.36,-37611.96
buyer_4,Jorge,50,ES12209580187759187137,TRX_N-00688-93704951,2023-08-05T20:29:59,Galdakao,Expense,cash,-100.0,-37711.96
buyer_4,Jorge,50,ES12209580187759187137,TRX_N-00689-48844586,2023-08-06T11:03:05,Galdakao,expenses,internet,-42.0,-37753.96
buyer_4,Jorge,50,ES12209580187759187137,TRX_N-00690-66863065,2023-08-06T14:17:37,Galdakao,expenses,phone,-31.79,-37785.75
buyer_4,Jorge,50,ES12209580187759187137,TRX_N-00691-18795046,2023-08-06T23:31:01,Galdakao,Expense,cash,-100.0,-37885.75
buyer_4,Jorge,50,ES12209580187759187137,TRX_N-00692-02183650,2023-08-07T17:34:59,Galdakao,expenses,water,-21.79,-37907.54
buyer_4,Jorge,50,ES12209580187759187137,TRX_N-00693-79964537,2023-08-07T16:19:16,Galdakao,expenses,electricity,-48.51,-37956.05
buyer_4,Jorge,50,ES12209580187759187137,TRX_N-00694-59710660,2023-08-07T18:46:50,Pasaia,Expense,leisure,-75.79,-38031.84
buyer_4,Jorge,50,ES12209580187759187137,TRX_N-00695-98674637,2023-08-07T20:43:01,Galdakao,Expense,education,-51.24,-38083.08
buyer_4,Jorge,50,ES12209580187759187137,TRX_N-00696-36201513,2023-08-07T16:55:11,Alegr√≠a-Dulantzi,Expense,repairs,-160.64,-38243.72
buyer_4,Jorge,50,ES12209580187759187137,TRX_N-00697-56742510,2023-08-08T11:14:01,Galdakao,Expense,transport,-75.86,-38319.58
buyer_4,Jorge,50,ES12209580187759187137,TRX_N-00698-45880247,2023-08-11T10:23:18,Galdakao,Expense,cash,-100.0,-38419.58
buyer_4,Jorge,50,ES12209580187759187137,TRX_N-00699-74642193,2023-08-12T11:50:29,Galdakao,Expense,food,-94.87,-38514.45
buyer_4,Jorge,50,ES12209580187759187137,TRX_N-00700-94234033,2023-08-12T16:38:30,Basauri,Expense,cash,-100.0,-38614.45
buyer_4,Jorge,50,ES12209580187759187137,TRX_N-00701-70009403,2023-08-12T17:24:23,Barakaldo,Expense,gifts,-652.5,-39266.95
buyer_4,Jorge,50,ES12209580187759187137,TRX_N-00702-30916179,2023-08-13T18:06:34,Galdakao,Expense,food,-61.65,-39328.6
buyer_4,Jorge,50,ES12209580187759187137,TRX_N-00703-08391275,2023-08-14T13:42:48,Galdakao,Expense,leisure,-51.85,-39380.45
buyer_4,Jorge,50,ES12209580187759187137,TRX_N-00704-24545365,2023-08-15T11:06:28,Galdakao,Expense,transport,-53.75,-39434.2
buyer_4,Jorge,50,ES12209580187759187137,TRX_N-00705-30755613,2023-08-15T03:33:02,Galdakao,Expense,healthcare,-138.38,-39572.58
buyer_4,Jorge,50,ES12209580187759187137,TRX_N-00706-20090061,2023-08-20T19:37:30,Galdakao,Expense,clothing,-77.84,-39650.42
buyer_4,Jorge,50,ES12209580187759187137,TRX_N-00707-46398468,2023-08-22T09:40:48,Galdakao,Expense,food,-107.76,-39758.18
buyer_4,Jorge,50,ES12209580187759187137,TRX_N-00708-27938561,2023-08-23T00:19:32,Galdakao,Expense,cash,-100.0,-39858.18
buyer_4,Jorge,50,ES12209580187759187137,TRX_N-00709-20516359,2023-08-25T19:35:04,Barakaldo,Expense,repairs,-127.52,-39985.7
buyer_4,Jorge,50,ES12209580187759187137,TRX_N-00710-09728977,2023-08-26T09:46:53,Galdakao,Expense,gifts,-289.95,-40275.65
buyer_4,Jorge,50,ES12209580187759187137,TRX_N-00711-72084908,2023-08-27T04:12:56,Galdakao,Expense,food,-111.43,-40387.08
buyer_4,Jorge,50,ES12209580187759187137,TRX_N-00712-18819367,2023-08-27T08:25:58,Galdakao,Expense,cash,-100.0,-40487.08
buyer_4,Jorge,50,ES12209580187759187137,TRX_N-00713-84683379,2023-08-27T14:39:53,Galdakao,Expense,repairs,-99.25,-40586.33
buyer_4,Jorge,50,ES12209580187759187137,TRX_N-00714-08582668,2023-08-28T09:19:03,Galdakao,Expense,repairs,-248.69,-40835.02
buyer_4,Jorge,50,ES12209580187759187137,TRX_N-00715-01124794,2023-08-29T17:43:17,Galdakao,Expense,transport,-53.6,-40888.62
buyer_4,Jorge,50,ES12209580187759187137,TRX_N-00716-93973307,2023-08-29T17:28:02,Oy√≥n-Oion,Expense,gifts,-721.2,-41609.82
buyer_4,Jorge,50,ES12209580187759187137,TRX_N-00717-97894247,2023-08-30T15:13:08,Sestao,Expense,repairs,-160.28,-41770.1
buyer_4,Jorge,50,ES12209580187759187137,TRX_N-00718-23198031,2023-08-31T16:11:46,Galdakao,Expense,transport,-66.89,-41836.99
buyer_4,Jorge,50,ES12209580187759187137,TRX_N-00719-31943263,2023-09-01T15:45:04,Galdakao,incomes,salary,1449.89,-40387.1
buyer_4,Jorge,50,ES12209580187759187137,TRX_N-00720-07521695,2023-09-01T15:45:04,Galdakao,incomes,salary_partner,1690.29,-38696.81
buyer_4,Jorge,50,ES12209580187759187137,TRX_N-00721-14818561,2023-09-01T15:45:04,Galdakao,incomes,extra_income,172.78,-38524.03
buyer_4,Jorge,50,ES12209580187759187137,TRX_N-00722-39962488,2023-09-01T08:51:56,Galdakao,Expense,food,-85.08,-38609.11
buyer_4,Jorge,50,ES12209580187759187137,TRX_N-00723-95220721,2023-09-02T16:17:11,Hondarribia,Expense,leisure,-23.89,-38633.0
buyer_4,Jorge,50,ES12209580187759187137,TRX_N-00724-14653866,2023-09-03T11:16:02,Galdakao,expenses,children,-266.27,-38899.27
buyer_4,Jorge,50,ES12209580187759187137,TRX_N-00725-12882339,2023-09-04T03:11:48,Galdakao,expenses,mortgage,-1078.4,-39977.67
buyer_4,Jorge,50,ES12209580187759187137,TRX_N-00726-92918696,2023-09-04T19:45:26,Galdakao,Expense,transport,-67.81,-40045.48
buyer_4,Jorge,50,ES12209580187759187137,TRX_N-00727-09460810,2023-09-05T15:00:34,Galdakao,expenses,electricity,-23.53,-40069.01
buyer_4,Jorge,50,ES12209580187759187137,TRX_N-00728-93360033,2023-09-05T16:21:29,Galdakao,Expense,leisure,-67.24,-40136.25
buyer_4,Jorge,50,ES12209580187759187137,TRX_N-00729-99173423,2023-09-05T10:35:58,Salvatierra/Agurain,Expense,cash,-100.0,-40236.25
buyer_4,Jorge,50,ES12209580187759187137,TRX_N-00730-61349235,2023-09-06T19:12:27,Galdakao,expenses,water,-30.74,-40266.99
buyer_4,Jorge,50,ES12209580187759187137,TRX_N-00731-41733276,2023-09-06T16:59:32,Galdakao,expenses,internet,-42.0,-40308.99
buyer_4,Jorge,50,ES12209580187759187137,TRX_N-00732-04184782,2023-09-06T19:48:24,Galdakao,expenses,phone,-37.61,-40346.6
buyer_4,Jorge,50,ES12209580187759187137,TRX_N-00733-60479457,2023-09-06T12:36:59,Galdakao,Expense,clothing,-115.11,-40461.71
buyer_4,Jorge,50,ES12209580187759187137,TRX_N-00734-31909933,2023-09-07T13:29:11,Galdakao,expenses,gas,-69.66,-40531.37
buyer_4,Jorge,50,ES12209580187759187137,TRX_N-00735-11968921,2023-09-07T15:08:45,Galdakao,Expense,transport,-56.16,-40587.53
buyer_4,Jorge,50,ES12209580187759187137,TRX_N-00736-21670330,2023-09-07T16:45:36,Galdakao,Expense,cash,-100.0,-40687.53
buyer_4,Jorge,50,ES12209580187759187137,TRX_N-00737-11438961,2023-09-08T13:29:53,Berango,Expense,food,-105.35,-40792.88
buyer_4,Jorge,50,ES12209580187759187137,TRX_N-00738-97108444,2023-09-09T21:25:22,Galdakao,Expense,food,-86.05,-40878.93
buyer_4,Jorge,50,ES12209580187759187137,TRX_N-00739-21394235,2023-09-10T15:28:04,Barakaldo,Expense,food,-80.05,-40958.98
buyer_4,Jorge,50,ES12209580187759187137,TRX_N-00740-95301728,2023-09-13T14:03:56,Galdakao,Expense,cash,-100.0,-41058.98
buyer_4,Jorge,50,ES12209580187759187137,TRX_N-00741-55031074,2023-09-14T20:45:06,Galdakao,Expense,transport,-77.76,-41136.74
buyer_4,Jorge,50,ES12209580187759187137,TRX_N-00742-05580556,2023-09-14T16:06:55,Irun,Expense,leisure,-59.09,-41195.83
buyer_4,Jorge,50,ES12209580187759187137,TRX_N-00743-26218639,2023-09-15T11:56:30,Sestao,Expense,cash,-100.0,-41295.83
buyer_4,Jorge,50,ES12209580187759187137,TRX_N-00744-34594740,2023-09-15T16:54:07,Galdakao,Expense,appliances,-257.59,-41553.42
buyer_4,Jorge,50,ES12209580187759187137,TRX_N-00745-00665356,2023-09-16T21:59:33,Galdakao,Expense,leisure,-29.56,-41582.98
buyer_4,Jorge,50,ES12209580187759187137,TRX_N-00746-70517581,2023-09-17T08:25:01,Galdakao,Expense,transport,-70.78,-41653.76
buyer_4,Jorge,50,ES12209580187759187137,TRX_N-00747-49962816,2023-09-18T16:33:46,Alegr√≠a-Dulantzi,Expense,food,-91.95,-41745.71
buyer_4,Jorge,50,ES12209580187759187137,TRX_N-00748-29799922,2023-09-19T13:04:26,Galdakao,Expense,leisure,-21.1,-41766.81
buyer_4,Jorge,50,ES12209580187759187137,TRX_N-00749-63205090,2023-09-19T12:46:47,Galdakao,Expense,clothing,-80.01,-41846.82
buyer_4,Jorge,50,ES12209580187759187137,TRX_N-00750-34993223,2023-09-20T12:28:58,Galdakao,Expense,cash,-100.0,-41946.82
buyer_4,Jorge,50,ES12209580187759187137,TRX_N-00751-98721472,2023-09-21T17:42:52,Galdakao,Expense,leisure,-77.73,-42024.55
buyer_4,Jorge,50,ES12209580187759187137,TRX_N-00752-64536472,2023-09-22T14:08:07,Galdakao,Expense,cash,-100.0,-42124.55
buyer_4,Jorge,50,ES12209580187759187137,TRX_N-00753-00857955,2023-09-24T18:05:44,Galdakao,Expense,cash,-100.0,-42224.55
buyer_4,Jorge,50,ES12209580187759187137,TRX_N-00754-29957101,2023-09-26T18:34:28,Galdakao,Expense,education,-78.87,-42303.42
buyer_4,Jorge,50,ES12209580187759187137,TRX_N-00755-80628404,2023-09-30T16:17:10,Galdakao,Expense,clothing,-124.13,-42427.55
buyer_4,Jorge,50,ES12209580187759187137,TRX_N-00756-71558308,2023-10-01T13:43:08,Galdakao,incomes,salary,1449.89,-40977.66
buyer_4,Jorge,50,ES12209580187759187137,TRX_N-00757-19568587,2023-10-01T13:43:08,Galdakao,incomes,salary_partner,1690.29,-39287.37
buyer_4,Jorge,50,ES12209580187759187137,TRX_N-00758-47078029,2023-10-01T19:14:59,Galdakao,Expense,food,-119.11,-39406.48
buyer_4,Jorge,50,ES12209580187759187137,TRX_N-00759-05427716,2023-10-02T17:24:41,Galdakao,Expense,transport,-74.41,-39480.89
buyer_4,Jorge,50,ES12209580187759187137,TRX_N-00760-56275858,2023-10-02T15:37:07,Galdakao,Expense,repairs,-267.83,-39748.72
buyer_4,Jorge,50,ES12209580187759187137,TRX_N-00761-07773185,2023-10-04T13:21:02,Galdakao,expenses,mortgage,-1078.4,-40827.12
buyer_4,Jorge,50,ES12209580187759187137,TRX_N-00762-05976366,2023-10-06T11:33:26,Galdakao,expenses,phone,-40.66,-40867.78
buyer_4,Jorge,50,ES12209580187759187137,TRX_N-00763-98072644,2023-10-08T19:27:34,Galdakao,expenses,water,-27.44,-40895.22
buyer_4,Jorge,50,ES12209580187759187137,TRX_N-00764-11413329,2023-10-08T18:37:04,Galdakao,expenses,electricity,-86.62,-40981.84
buyer_4,Jorge,50,ES12209580187759187137,TRX_N-00765-49691259,2023-10-08T14:10:43,Galdakao,expenses,gas,-106.88,-41088.72
buyer_4,Jorge,50,ES12209580187759187137,TRX_N-00766-92121730,2023-10-08T08:17:58,Galdakao,expenses,internet,-42.0,-41130.72
buyer_4,Jorge,50,ES12209580187759187137,TRX_N-00767-17989890,2023-10-10T13:16:07,Galdakao,Expense,education,-57.12,-41187.84
buyer_4,Jorge,50,ES12209580187759187137,TRX_N-00768-40925095,2023-10-10T17:41:17,Galdakao,Expense,travel,-1476.93,-42664.77
buyer_4,Jorge,50,ES12209580187759187137,TRX_N-00769-44905489,2023-10-10T14:54:12,Iru√±a de Oca,Expense,repairs,-125.29,-42790.06
buyer_4,Jorge,50,ES12209580187759187137,TRX_N-00770-17571984,2023-10-11T14:02:32,Galdakao,Expense,transport,-68.95,-42859.01
buyer_4,Jorge,50,ES12209580187759187137,TRX_N-00771-92942015,2023-10-11T11:58:50,Galdakao,Expense,leisure,-52.84,-42911.85
buyer_4,Jorge,50,ES12209580187759187137,TRX_N-00772-03550493,2023-10-14T13:21:57,Iru√±a de Oca,Expense,transport,-62.64,-42974.49
buyer_4,Jorge,50,ES12209580187759187137,TRX_N-00773-36324342,2023-10-15T08:59:29,Galdakao,Expense,leisure,-78.18,-43052.67
buyer_4,Jorge,50,ES12209580187759187137,TRX_N-00774-57370777,2023-10-16T19:45:45,Galdakao,Expense,cash,-100.0,-43152.67
buyer_4,Jorge,50,ES12209580187759187137,TRX_N-00775-66471347,2023-10-16T20:05:46,Galdakao,Expense,travel,-668.62,-43821.29
buyer_4,Jorge,50,ES12209580187759187137,TRX_N-00776-41222068,2023-10-18T20:34:48,Barakaldo,Expense,food,-66.02,-43887.31
buyer_4,Jorge,50,ES12209580187759187137,TRX_N-00777-90288544,2023-10-21T20:59:19,Galdakao,Expense,food,-104.6,-43991.91
buyer_4,Jorge,50,ES12209580187759187137,TRX_N-00778-63866654,2023-10-21T16:51:56,Galdakao,Expense,leisure,-33.6,-44025.51
buyer_4,Jorge,50,ES12209580187759187137,TRX_N-00779-31792718,2023-10-21T18:45:53,Galdakao,Expense,repairs,-206.52,-44232.03
buyer_4,Jorge,50,ES12209580187759187137,TRX_N-00780-03719119,2023-10-23T07:36:01,Galdakao,Expense,food,-82.88,-44314.91
buyer_4,Jorge,50,ES12209580187759187137,TRX_N-00781-74026369,2023-10-23T20:19:35,Galdakao,Expense,clothing,-125.96,-44440.87
buyer_4,Jorge,50,ES12209580187759187137,TRX_N-00782-62277043,2023-10-23T20:36:47,Galdakao,Expense,cash,-100.0,-44540.87
buyer_4,Jorge,50,ES12209580187759187137,TRX_N-00783-41218037,2023-10-24T10:35:28,Galdakao,Expense,food,-112.52,-44653.39
buyer_4,Jorge,50,ES12209580187759187137,TRX_N-00784-36783448,2023-10-24T12:01:30,Galdakao,Expense,transport,-59.7,-44713.09
buyer_4,Jorge,50,ES12209580187759187137,TRX_N-00785-95392804,2023-10-25T09:56:23,Galdakao,Expense,gifts,-576.63,-45289.72
buyer_4,Jorge,50,ES12209580187759187137,TRX_N-00786-57955417,2023-10-25T16:09:00,Galdakao,expenses,children,-75.55,-45365.27
buyer_4,Jorge,50,ES12209580187759187137,TRX_N-00787-71526699,2023-10-26T16:21:18,Galdakao,Expense,clothing,-159.07,-45524.34
buyer_4,Jorge,50,ES12209580187759187137,TRX_N-00788-72876571,2023-10-26T17:25:26,Galdakao,Expense,appliances,-403.56,-45927.9
buyer_4,Jorge,50,ES12209580187759187137,TRX_N-00789-33765535,2023-10-28T08:45:29,Galdakao,Expense,cash,-100.0,-46027.9
buyer_4,Jorge,50,ES12209580187759187137,TRX_N-00790-92749071,2023-10-29T09:35:35,Galdakao,Expense,food,-68.35,-46096.25
buyer_4,Jorge,50,ES12209580187759187137,TRX_N-00791-55865106,2023-10-30T13:56:25,Galdakao,expenses,children,-269.27,-46365.52
buyer_4,Jorge,50,ES12209580187759187137,TRX_N-00792-07867374,2023-10-31T18:13:20,Pasaia,Expense,repairs,-273.79,-46639.31
buyer_4,Jorge,50,ES12209580187759187137,TRX_N-00793-08391863,2023-11-01T20:41:04,Galdakao,incomes,salary,1449.89,-45189.42
buyer_4,Jorge,50,ES12209580187759187137,TRX_N-00794-18093675,2023-11-01T20:41:04,Galdakao,incomes,salary_partner,1690.29,-43499.13
buyer_4,Jorge,50,ES12209580187759187137,TRX_N-00795-37498668,2023-11-01T13:48:01,Galdakao,Expense,food,-119.6,-43618.73
buyer_4,Jorge,50,ES12209580187759187137,TRX_N-00796-76247065,2023-11-02T12:28:49,Galdakao,Expense,healthcare,-54.44,-43673.17
buyer_4,Jorge,50,ES12209580187759187137,TRX_N-00797-72046690,2023-11-03T23:55:46,Galdakao,Expense,education,-73.1,-43746.27
buyer_4,Jorge,50,ES12209580187759187137,TRX_N-00798-77370565,2023-11-04T13:35:38,Galdakao,expenses,mortgage,-1078.4,-44824.67
buyer_4,Jorge,50,ES12209580187759187137,TRX_N-00799-77800559,2023-11-04T19:23:17,Galdakao,Expense,food,-97.64,-44922.31
buyer_4,Jorge,50,ES12209580187759187137,TRX_N-00800-49975047,2023-11-05T17:05:12,Galdakao,expenses,electricity,-43.43,-44965.74
buyer_4,Jorge,50,ES12209580187759187137,TRX_N-00801-47052188,2023-11-05T19:26:39,Galdakao,expenses,phone,-37.31,-45003.05
buyer_4,Jorge,50,ES12209580187759187137,TRX_N-00802-84536779,2023-11-05T09:09:10,Mungia,Expense,cash,-100.0,-45103.05
buyer_4,Jorge,50,ES12209580187759187137,TRX_N-00803-42412329,2023-11-06T08:25:39,Galdakao,Expense,food,-122.99,-45226.04
buyer_4,Jorge,50,ES12209580187759187137,TRX_N-00804-35391995,2023-11-07T15:36:04,Galdakao,expenses,internet,-42.0,-45268.04
buyer_4,Jorge,50,ES12209580187759187137,TRX_N-00805-97485026,2023-11-07T14:04:02,Galdakao,Expense,leisure,-48.02,-45316.06
buyer_4,Jorge,50,ES12209580187759187137,TRX_N-00806-82614583,2023-11-08T20:17:18,Galdakao,expenses,water,-44.48,-45360.54
buyer_4,Jorge,50,ES12209580187759187137,TRX_N-00807-14630578,2023-11-08T20:52:34,Galdakao,expenses,gas,-49.23,-45409.77
buyer_4,Jorge,50,ES12209580187759187137,TRX_N-00808-28208212,2023-11-08T13:26:00,Galdakao,Expense,gifts,-303.26,-45713.03
buyer_4,Jorge,50,ES12209580187759187137,TRX_N-00809-91927461,2023-11-09T00:22:31,Galdakao,Expense,transport,-46.48,-45759.51
buyer_4,Jorge,50,ES12209580187759187137,TRX_N-00810-64413923,2023-11-09T20:18:42,Galdakao,Expense,education,-62.01,-45821.52
buyer_4,Jorge,50,ES12209580187759187137,TRX_N-00811-12176362,2023-11-12T23:55:30,Leioa,Expense,appliances,-81.87,-45903.39
buyer_4,Jorge,50,ES12209580187759187137,TRX_N-00812-81088437,2023-11-12T05:38:18,Galdakao,Expense,gifts,-253.88,-46157.27
buyer_4,Jorge,50,ES12209580187759187137,TRX_N-00813-13086625,2023-11-13T18:43:49,Galdakao,Expense,transport,-83.61,-46240.88
buyer_4,Jorge,50,ES12209580187759187137,TRX_N-00814-22481737,2023-11-13T16:23:46,Galdakao,Expense,cash,-100.0,-46340.88
buyer_4,Jorge,50,ES12209580187759187137,TRX_N-00815-75001985,2023-11-14T08:57:10,Galdakao,Expense,cash,-100.0,-46440.88
buyer_4,Jorge,50,ES12209580187759187137,TRX_N-00816-82084959,2023-11-14T18:26:53,Galdakao,Expense,appliances,-132.42,-46573.3
buyer_4,Jorge,50,ES12209580187759187137,TRX_N-00817-85746411,2023-11-15T12:06:34,Galdakao,Expense,healthcare,-109.11,-46682.41
buyer_4,Jorge,50,ES12209580187759187137,TRX_N-00818-96526369,2023-11-16T10:03:31,Galdakao,Expense,cash,-100.0,-46782.41
buyer_4,Jorge,50,ES12209580187759187137,TRX_N-00819-64420281,2023-11-17T05:49:37,Galdakao,Expense,healthcare,-155.69,-46938.1
buyer_4,Jorge,50,ES12209580187759187137,TRX_N-00820-20962895,2023-11-21T15:47:41,Amurrio,Expense,cash,-100.0,-47038.1
buyer_4,Jorge,50,ES12209580187759187137,TRX_N-00821-50357058,2023-11-22T20:42:02,Oy√≥n-Oion,Expense,clothing,-147.62,-47185.72
buyer_4,Jorge,50,ES12209580187759187137,TRX_N-00822-28202032,2023-11-24T19:39:16,Galdakao,Expense,food,-106.82,-47292.54
buyer_4,Jorge,50,ES12209580187759187137,TRX_N-00823-94298166,2023-11-24T19:08:06,Eibar,Expense,cash,-100.0,-47392.54
buyer_4,Jorge,50,ES12209580187759187137,TRX_N-00824-83789554,2023-11-25T16:21:18,Galdakao,Expense,food,-81.83,-47474.37
buyer_4,Jorge,50,ES12209580187759187137,TRX_N-00825-31121880,2023-11-25T18:19:32,Galdakao,Expense,cash,-100.0,-47574.37
buyer_4,Jorge,50,ES12209580187759187137,TRX_N-00826-27148350,2023-11-26T13:21:18,Galdakao,Expense,clothing,-152.96,-47727.33
buyer_4,Jorge,50,ES12209580187759187137,TRX_N-00827-60096886,2023-11-26T14:14:52,Galdakao,Expense,repairs,-318.72,-48046.05
buyer_4,Jorge,50,ES12209580187759187137,TRX_N-00828-14892048,2023-11-27T12:09:11,Galdakao,Expense,appliances,-375.53,-48421.58
buyer_4,Jorge,50,ES12209580187759187137,TRX_N-00829-71742680,2023-11-29T16:10:03,Galdakao,Expense,food,-69.33,-48490.91
buyer_4,Jorge,50,ES12209580187759187137,TRX_N-00830-34022957,2023-12-01T14:25:08,Galdakao,incomes,salary,1449.89,-47041.02
buyer_4,Jorge,50,ES12209580187759187137,TRX_N-00831-95423957,2023-12-01T14:25:08,Galdakao,incomes,salary_partner,1690.29,-45350.73
buyer_4,Jorge,50,ES12209580187759187137,TRX_N-00832-03170026,2023-12-01T14:25:08,Galdakao,incomes,extra_income,172.78,-45177.95
buyer_4,Jorge,50,ES12209580187759187137,TRX_N-00833-27488161,2023-12-01T14:25:08,Galdakao,incomes,salary_bonus,1104.83,-44073.12
buyer_4,Jorge,50,ES12209580187759187137,TRX_N-00834-43588141,2023-12-01T14:25:08,Galdakao,incomes,salary_partner_bonus,1229.27,-42843.85
buyer_4,Jorge,50,ES12209580187759187137,TRX_N-00835-52632339,2023-12-02T20:13:53,Galdakao,Expense,leisure,-41.04,-42884.89
buyer_4,Jorge,50,ES12209580187759187137,TRX_N-00836-26910890,2023-12-03T08:28:52,Portugalete,Expense,food,-89.12,-42974.01
buyer_4,Jorge,50,ES12209580187759187137,TRX_N-00837-57175682,2023-12-04T04:20:21,Galdakao,expenses,mortgage,-1078.4,-44052.41
buyer_4,Jorge,50,ES12209580187759187137,TRX_N-00838-86826720,2023-12-04T14:38:29,Galdakao,Expense,clothing,-90.04,-44142.45
buyer_4,Jorge,50,ES12209580187759187137,TRX_N-00839-17945229,2023-12-05T14:59:24,Galdakao,expenses,water,-26.21,-44168.66
buyer_4,Jorge,50,ES12209580187759187137,TRX_N-00840-38027212,2023-12-05T15:13:08,Galdakao,expenses,electricity,-80.52,-44249.18
buyer_4,Jorge,50,ES12209580187759187137,TRX_N-00841-71307006,2023-12-05T20:14:34,Galdakao,expenses,gas,-84.61,-44333.79
buyer_4,Jorge,50,ES12209580187759187137,TRX_N-00842-73961028,2023-12-05T10:06:20,Galdakao,Expense,leisure,-54.37,-44388.16
buyer_4,Jorge,50,ES12209580187759187137,TRX_N-00843-91943749,2023-12-06T10:58:12,Galdakao,expenses,phone,-38.15,-44426.31
buyer_4,Jorge,50,ES12209580187759187137,TRX_N-00844-19766746,2023-12-06T08:55:16,Galdakao,Expense,transport,-83.9,-44510.21
buyer_4,Jorge,50,ES12209580187759187137,TRX_N-00845-22715361,2023-12-08T05:25:11,Galdakao,expenses,internet,-42.0,-44552.21
buyer_4,Jorge,50,ES12209580187759187137,TRX_N-00846-66378417,2023-12-08T16:25:25,Galdakao,Expense,education,-67.74,-44619.95
buyer_4,Jorge,50,ES12209580187759187137,TRX_N-00847-88633607,2023-12-09T08:22:48,Portugalete,Expense,leisure,-68.92,-44688.87
buyer_4,Jorge,50,ES12209580187759187137,TRX_N-00848-55491333,2023-12-10T07:31:17,Galdakao,Expense,transport,-83.17,-44772.04
buyer_4,Jorge,50,ES12209580187759187137,TRX_N-00849-92264044,2023-12-10T10:41:38,Galdakao,Expense,leisure,-38.27,-44810.31
buyer_4,Jorge,50,ES12209580187759187137,TRX_N-00850-45806967,2023-12-10T11:53:45,Galdakao,Expense,clothing,-48.0,-44858.31
buyer_4,Jorge,50,ES12209580187759187137,TRX_N-00851-76650837,2023-12-10T09:09:51,Galdakao,Expense,repairs,-332.34,-45190.65
buyer_4,Jorge,50,ES12209580187759187137,TRX_N-00852-62773271,2023-12-11T03:23:51,Galdakao,Expense,education,-77.46,-45268.11
buyer_4,Jorge,50,ES12209580187759187137,TRX_N-00853-51286827,2023-12-11T13:33:30,Galdakao,Expense,appliances,-279.3,-45547.41
buyer_4,Jorge,50,ES12209580187759187137,TRX_N-00854-95659977,2023-12-14T14:28:59,Galdakao,Expense,transport,-58.57,-45605.98
buyer_4,Jorge,50,ES12209580187759187137,TRX_N-00855-72583499,2023-12-14T20:31:20,Galdakao,Expense,leisure,-24.85,-45630.83
buyer_4,Jorge,50,ES12209580187759187137,TRX_N-00856-24068562,2023-12-14T09:40:19,Galdakao,Expense,appliances,-76.34,-45707.17
buyer_4,Jorge,50,ES12209580187759187137,TRX_N-00857-75874708,2023-12-15T13:13:00,Galdakao,Expense,transport,-57.77,-45764.94
buyer_4,Jorge,50,ES12209580187759187137,TRX_N-00858-87360005,2023-12-15T09:11:16,Galdakao,Expense,cash,-100.0,-45864.94
buyer_4,Jorge,50,ES12209580187759187137,TRX_N-00859-19836408,2023-12-15T13:12:41,Erandio,Expense,repairs,-220.35,-46085.29
buyer_4,Jorge,50,ES12209580187759187137,TRX_N-00860-84345503,2023-12-17T10:15:03,Galdakao,Expense,education,-44.98,-46130.27
buyer_4,Jorge,50,ES12209580187759187137,TRX_N-00861-26358740,2023-12-17T12:15:20,Galdakao,Expense,cash,-100.0,-46230.27
buyer_4,Jorge,50,ES12209580187759187137,TRX_N-00862-58042640,2023-12-19T08:53:18,Galdakao,Expense,cash,-100.0,-46330.27
buyer_4,Jorge,50,ES12209580187759187137,TRX_N-00863-60996678,2023-12-20T14:39:26,Galdakao,Expense,cash,-100.0,-46430.27
buyer_4,Jorge,50,ES12209580187759187137,TRX_N-00864-73984493,2023-12-24T14:50:03,Galdakao,Expense,leisure,-44.91,-46475.18
buyer_4,Jorge,50,ES12209580187759187137,TRX_N-00865-91561781,2023-12-26T13:04:39,Galdakao,Expense,gifts,-83.98,-46559.16
buyer_4,Jorge,50,ES12209580187759187137,TRX_N-00866-46270460,2023-12-28T02:03:20,Galdakao,Expense,food,-123.02,-46682.18
buyer_4,Jorge,50,ES12209580187759187137,TRX_N-00867-48174231,2023-12-28T23:40:54,Galdakao,Expense,leisure,-78.99,-46761.17
buyer_4,Jorge,50,ES12209580187759187137,TRX_N-00868-82962528,2023-12-28T11:09:48,Galdakao,Expense,cash,-100.0,-46861.17
buyer_4,Jorge,50,ES12209580187759187137,TRX_N-00869-48711471,2023-12-29T19:57:32,Arrasate,Expense,transport,-51.88,-46913.05
buyer_4,Jorge,50,ES12209580187759187137,TRX_N-00870-41728020,2023-12-30T19:07:27,Galdakao,Expense,education,-78.95,-46992.0
buyer_4,Jorge,50,ES12209580187759187137,TRX_N-00871-89181437,2023-12-30T12:38:03,Galdakao,Expense,cash,-100.0,-47092.0
buyer_4,Jorge,50,ES12209580187759187137,TRX_N-00872-66787711,2024-01-01T17:44:48,Galdakao,incomes,salary,1497.63,-45594.37
buyer_4,Jorge,50,ES12209580187759187137,TRX_N-00873-78219767,2024-01-01T17:44:48,Galdakao,incomes,salary_partner,1745.94,-43848.43
buyer_4,Jorge,50,ES12209580187759187137,TRX_N-00874-19048667,2024-01-01T20:46:10,Galdakao,Expense,food,-115.64,-43964.07
buyer_4,Jorge,50,ES12209580187759187137,TRX_N-00875-97862138,2024-01-01T18:01:23,Galdakao,Expense,cash,-100.0,-44064.07
buyer_4,Jorge,50,ES12209580187759187137,TRX_N-00876-60943920,2024-01-02T08:12:12,Galdakao,Expense,food,-88.72,-44152.79
buyer_4,Jorge,50,ES12209580187759187137,TRX_N-00877-80406784,2024-01-02T16:04:39,Galdakao,Expense,transport,-71.92,-44224.71
buyer_4,Jorge,50,ES12209580187759187137,TRX_N-00878-21213688,2024-01-03T10:03:32,Alegr√≠a-Dulantzi,Expense,education,-78.26,-44302.97
buyer_4,Jorge,50,ES12209580187759187137,TRX_N-00879-64915639,2024-01-04T16:41:06,Galdakao,expenses,mortgage,-1078.4,-45381.37
buyer_4,Jorge,50,ES12209580187759187137,TRX_N-00880-14131170,2024-01-05T10:13:37,Galdakao,expenses,internet,-42.0,-45423.37
buyer_4,Jorge,50,ES12209580187759187137,TRX_N-00881-47414415,2024-01-05T16:18:31,Galdakao,Expense,leisure,-80.11,-45503.48
buyer_4,Jorge,50,ES12209580187759187137,TRX_N-00882-55208831,2024-01-06T20:04:39,Galdakao,expenses,electricity,-45.06,-45548.54
buyer_4,Jorge,50,ES12209580187759187137,TRX_N-00883-71168027,2024-01-06T09:14:26,Galdakao,expenses,phone,-43.92,-45592.46
buyer_4,Jorge,50,ES12209580187759187137,TRX_N-00884-16353865,2024-01-08T21:21:07,Galdakao,expenses,gas,-64.34,-45656.8
buyer_4,Jorge,50,ES12209580187759187137,TRX_N-00885-73035323,2024-01-08T09:23:24,Galdakao,expenses,water,-20.73,-45677.53
buyer_4,Jorge,50,ES12209580187759187137,TRX_N-00886-09821862,2024-01-12T19:53:48,Galdakao,Expense,leisure,-30.49,-45708.02
buyer_4,Jorge,50,ES12209580187759187137,TRX_N-00887-08865350,2024-01-12T14:26:13,Galdakao,Expense,healthcare,-184.61,-45892.63
buyer_4,Jorge,50,ES12209580187759187137,TRX_N-00888-54893301,2024-01-13T20:54:16,Iru√±a de Oca,Expense,cash,-100.0,-45992.63
buyer_4,Jorge,50,ES12209580187759187137,TRX_N-00889-27546523,2024-01-13T10:57:47,Galdakao,Expense,gifts,-620.56,-46613.19
buyer_4,Jorge,50,ES12209580187759187137,TRX_N-00890-47722929,2024-01-14T11:03:10,Galdakao,Expense,repairs,-187.29,-46800.48
buyer_4,Jorge,50,ES12209580187759187137,TRX_N-00891-36846029,2024-01-16T22:04:19,Galdakao,Expense,food,-119.28,-46919.76
buyer_4,Jorge,50,ES12209580187759187137,TRX_N-00892-53603718,2024-01-16T16:51:42,Salvatierra/Agurain,Expense,cash,-100.0,-47019.76
buyer_4,Jorge,50,ES12209580187759187137,TRX_N-00893-35339371,2024-01-17T19:41:03,Galdakao,Expense,leisure,-35.96,-47055.72
buyer_4,Jorge,50,ES12209580187759187137,TRX_N-00894-66038074,2024-01-18T09:01:36,Galdakao,Expense,leisure,-47.14,-47102.86
buyer_4,Jorge,50,ES12209580187759187137,TRX_N-00895-91931260,2024-01-19T17:04:56,Amurrio,Expense,gifts,-529.42,-47632.28
buyer_4,Jorge,50,ES12209580187759187137,TRX_N-00896-90962816,2024-01-20T10:55:13,Galdakao,Expense,transport,-65.77,-47698.05
buyer_4,Jorge,50,ES12209580187759187137,TRX_N-00897-00111980,2024-01-21T18:55:29,Galdakao,Expense,cash,-100.0,-47798.05
buyer_4,Jorge,50,ES12209580187759187137,TRX_N-00898-67129665,2024-01-22T12:15:09,Galdakao,Expense,education,-60.67,-47858.72
buyer_4,Jorge,50,ES12209580187759187137,TRX_N-00899-55411301,2024-01-26T03:27:32,Donostia,Expense,food,-110.89,-47969.61
buyer_4,Jorge,50,ES12209580187759187137,TRX_N-00900-67645958,2024-01-29T18:27:34,Galdakao,Expense,cash,-100.0,-48069.61
buyer_4,Jorge,50,ES12209580187759187137,TRX_N-00901-35360340,2024-02-01T10:23:15,Galdakao,incomes,salary,1497.63,-46571.98
buyer_4,Jorge,50,ES12209580187759187137,TRX_N-00902-28531739,2024-02-01T10:23:15,Galdakao,incomes,salary_partner,1745.94,-44826.04
buyer_4,Jorge,50,ES12209580187759187137,TRX_N-00903-64891309,2024-02-01T09:24:00,Galdakao,Expense,transport,-70.26,-44896.3
buyer_4,Jorge,50,ES12209580187759187137,TRX_N-00904-35967924,2024-02-01T18:54:13,Galdakao,Expense,clothing,-132.26,-45028.56
buyer_4,Jorge,50,ES12209580187759187137,TRX_N-00905-25381871,2024-02-02T20:28:39,Galdakao,Expense,healthcare,-144.35,-45172.91
buyer_4,Jorge,50,ES12209580187759187137,TRX_N-00906-55617332,2024-02-03T05:38:13,Galdakao,Expense,leisure,-33.67,-45206.58
buyer_4,Jorge,50,ES12209580187759187137,TRX_N-00907-00889187,2024-02-04T20:09:19,Galdakao,expenses,mortgage,-1078.4,-46284.98
buyer_4,Jorge,50,ES12209580187759187137,TRX_N-00908-78056580,2024-02-04T11:41:30,Galdakao,Expense,clothing,-79.57,-46364.55
buyer_4,Jorge,50,ES12209580187759187137,TRX_N-00909-64665613,2024-02-05T17:41:26,Galdakao,expenses,electricity,-69.17,-46433.72
buyer_4,Jorge,50,ES12209580187759187137,TRX_N-00910-13195228,2024-02-05T15:30:01,Galdakao,expenses,gas,-78.52,-46512.24
buyer_4,Jorge,50,ES12209580187759187137,TRX_N-00911-12631424,2024-02-05T13:03:54,Galdakao,expenses,phone,-35.29,-46547.53
buyer_4,Jorge,50,ES12209580187759187137,TRX_N-00912-20036397,2024-02-05T11:14:57,Galdakao,Expense,cash,-100.0,-46647.53
buyer_4,Jorge,50,ES12209580187759187137,TRX_N-00913-78300591,2024-02-06T11:39:52,Galdakao,expenses,water,-32.81,-46680.34
buyer_4,Jorge,50,ES12209580187759187137,TRX_N-00914-72932433,2024-02-07T08:39:44,Galdakao,expenses,internet,-42.0,-46722.34
buyer_4,Jorge,50,ES12209580187759187137,TRX_N-00915-07197126,2024-02-07T02:06:27,Galdakao,Expense,cash,-100.0,-46822.34
buyer_4,Jorge,50,ES12209580187759187137,TRX_N-00916-52822464,2024-02-08T05:58:12,Galdakao,Expense,leisure,-47.81,-46870.15
buyer_4,Jorge,50,ES12209580187759187137,TRX_N-00917-39649292,2024-02-08T10:36:08,Galdakao,Expense,healthcare,-131.3,-47001.45
buyer_4,Jorge,50,ES12209580187759187137,TRX_N-00918-63305893,2024-02-09T11:03:40,Galdakao,Expense,clothing,-120.47,-47121.92
buyer_4,Jorge,50,ES12209580187759187137,TRX_N-00919-93240105,2024-02-13T10:42:21,Galdakao,Expense,leisure,-57.52,-47179.44
buyer_4,Jorge,50,ES12209580187759187137,TRX_N-00920-72940244,2024-02-13T12:46:48,Galdakao,Expense,education,-71.56,-47251.0
buyer_4,Jorge,50,ES12209580187759187137,TRX_N-00921-15233062,2024-02-13T20:59:48,Galdakao,Expense,repairs,-142.87,-47393.87
buyer_4,Jorge,50,ES12209580187759187137,TRX_N-00922-88438299,2024-02-15T09:12:02,Galdakao,Expense,transport,-88.49,-47482.36
buyer_4,Jorge,50,ES12209580187759187137,TRX_N-00923-64029367,2024-02-16T01:37:19,Galdakao,Expense,transport,-84.81,-47567.17
buyer_4,Jorge,50,ES12209580187759187137,TRX_N-00924-80810532,2024-02-17T16:49:40,Galdakao,Expense,clothing,-97.76,-47664.93
buyer_4,Jorge,50,ES12209580187759187137,TRX_N-00925-82175559,2024-02-18T11:04:50,Hondarribia,Expense,leisure,-79.23,-47744.16
buyer_4,Jorge,50,ES12209580187759187137,TRX_N-00926-77830657,2024-02-19T07:19:49,Mungia,Expense,leisure,-38.72,-47782.88
buyer_4,Jorge,50,ES12209580187759187137,TRX_N-00927-05508874,2024-02-20T15:04:30,Galdakao,Expense,leisure,-68.91,-47851.79
buyer_4,Jorge,50,ES12209580187759187137,TRX_N-00928-05737959,2024-02-21T09:45:01,Galdakao,Expense,healthcare,-154.8,-48006.59
buyer_4,Jorge,50,ES12209580187759187137,TRX_N-00929-40412753,2024-02-22T10:19:53,Galdakao,Expense,leisure,-36.62,-48043.21
buyer_4,Jorge,50,ES12209580187759187137,TRX_N-00930-21868286,2024-02-22T16:46:15,Galdakao,Expense,cash,-100.0,-48143.21
buyer_4,Jorge,50,ES12209580187759187137,TRX_N-00931-52281691,2024-02-23T11:55:20,Galdakao,Expense,cash,-100.0,-48243.21
buyer_4,Jorge,50,ES12209580187759187137,TRX_N-00932-33402534,2024-02-24T23:34:37,Galdakao,Expense,cash,-100.0,-48343.21
buyer_4,Jorge,50,ES12209580187759187137,TRX_N-00933-05370665,2024-02-26T11:55:28,Mungia,Expense,food,-101.33,-48444.54
buyer_4,Jorge,50,ES12209580187759187137,TRX_N-00934-02249663,2024-02-28T23:02:37,Mungia,Expense,transport,-78.89,-48523.43
buyer_4,Jorge,50,ES12209580187759187137,TRX_N-00935-44045291,2024-02-28T16:00:19,Andoain,Expense,healthcare,-147.29,-48670.72
buyer_4,Jorge,50,ES12209580187759187137,TRX_N-00936-28023585,2024-03-01T23:21:43,Galdakao,incomes,salary,1497.63,-47173.09
buyer_4,Jorge,50,ES12209580187759187137,TRX_N-00937-36392273,2024-03-01T23:21:43,Galdakao,incomes,salary_partner,1745.94,-45427.15
buyer_4,Jorge,50,ES12209580187759187137,TRX_N-00938-28059158,2024-03-01T23:21:43,Galdakao,incomes,extra_income,172.78,-45254.37
buyer_4,Jorge,50,ES12209580187759187137,TRX_N-00939-29362178,2024-03-04T13:56:00,Galdakao,expenses,mortgage,-1078.4,-46332.77
buyer_4,Jorge,50,ES12209580187759187137,TRX_N-00940-21238029,2024-03-04T10:14:23,Galdakao,Expense,food,-84.58,-46417.35
buyer_4,Jorge,50,ES12209580187759187137,TRX_N-00941-14191221,2024-03-04T04:36:15,Galdakao,Expense,gifts,-641.96,-47059.31
buyer_4,Jorge,50,ES12209580187759187137,TRX_N-00942-03964521,2024-03-05T19:27:55,Galdakao,expenses,gas,-46.03,-47105.34
buyer_4,Jorge,50,ES12209580187759187137,TRX_N-00943-31489447,2024-03-05T20:39:05,Alegr√≠a-Dulantzi,Expense,clothing,-51.63,-47156.97
buyer_4,Jorge,50,ES12209580187759187137,TRX_N-00944-27325568,2024-03-06T13:13:48,Galdakao,expenses,electricity,-23.65,-47180.62
buyer_4,Jorge,50,ES12209580187759187137,TRX_N-00945-20080672,2024-03-07T09:31:30,Galdakao,Expense,transport,-59.96,-47240.58
buyer_4,Jorge,50,ES12209580187759187137,TRX_N-00946-87249273,2024-03-08T12:37:22,Galdakao,expenses,water,-27.07,-47267.65
buyer_4,Jorge,50,ES12209580187759187137,TRX_N-00947-94128490,2024-03-08T19:42:11,Galdakao,expenses,internet,-42.0,-47309.65
buyer_4,Jorge,50,ES12209580187759187137,TRX_N-00948-53465284,2024-03-08T23:35:09,Galdakao,expenses,phone,-38.57,-47348.22
buyer_4,Jorge,50,ES12209580187759187137,TRX_N-00949-80353652,2024-03-10T08:08:05,Galdakao,Expense,transport,-79.83,-47428.05
buyer_4,Jorge,50,ES12209580187759187137,TRX_N-00950-62991222,2024-03-12T12:34:43,Arrasate,Expense,food,-118.65,-47546.7
buyer_4,Jorge,50,ES12209580187759187137,TRX_N-00951-37657777,2024-03-12T23:24:59,Labastida,Expense,transport,-42.87,-47589.57
buyer_4,Jorge,50,ES12209580187759187137,TRX_N-00952-65253525,2024-03-12T16:50:18,Galdakao,Expense,leisure,-29.54,-47619.11
buyer_4,Jorge,50,ES12209580187759187137,TRX_N-00953-41191429,2024-03-12T23:56:21,Galdakao,Expense,gifts,-373.16,-47992.27
buyer_4,Jorge,50,ES12209580187759187137,TRX_N-00954-21861046,2024-03-13T04:23:18,Vitoria-Gasteiz,Expense,cash,-100.0,-48092.27
buyer_4,Jorge,50,ES12209580187759187137,TRX_N-00955-16039490,2024-03-14T12:01:22,Galdakao,Expense,food,-70.72,-48162.99
buyer_4,Jorge,50,ES12209580187759187137,TRX_N-00956-27815661,2024-03-16T16:02:57,Galdakao,Expense,cash,-100.0,-48262.99
buyer_4,Jorge,50,ES12209580187759187137,TRX_N-00957-59828830,2024-03-20T16:13:30,Galdakao,Expense,transport,-74.16,-48337.15
buyer_4,Jorge,50,ES12209580187759187137,TRX_N-00958-56862777,2024-03-20T18:04:10,Galdakao,Expense,leisure,-59.19,-48396.34
buyer_4,Jorge,50,ES12209580187759187137,TRX_N-00959-00763874,2024-03-21T16:56:38,Galdakao,expenses,children,-264.06,-48660.4
buyer_4,Jorge,50,ES12209580187759187137,TRX_N-00960-80036484,2024-03-22T20:45:03,Galdakao,Expense,food,-102.9,-48763.3
buyer_4,Jorge,50,ES12209580187759187137,TRX_N-00961-97525371,2024-03-22T14:41:52,Andoain,Expense,clothing,-157.95,-48921.25
buyer_4,Jorge,50,ES12209580187759187137,TRX_N-00962-58857527,2024-03-24T12:16:19,Galdakao,Expense,leisure,-73.59,-48994.84
buyer_4,Jorge,50,ES12209580187759187137,TRX_N-00963-29435626,2024-03-25T12:53:53,Amurrio,Expense,education,-68.89,-49063.73
buyer_4,Jorge,50,ES12209580187759187137,TRX_N-00964-81089968,2024-03-26T09:29:42,Galdakao,Expense,transport,-62.84,-49126.57
buyer_4,Jorge,50,ES12209580187759187137,TRX_N-00965-56586628,2024-03-26T15:41:57,Galdakao,Expense,cash,-100.0,-49226.57
buyer_4,Jorge,50,ES12209580187759187137,TRX_N-00966-77844815,2024-03-28T18:20:12,Galdakao,Expense,clothing,-101.08,-49327.65
buyer_4,Jorge,50,ES12209580187759187137,TRX_N-00967-70831478,2024-03-28T11:37:54,Durango,Expense,gifts,-697.43,-50025.08
buyer_4,Jorge,50,ES12209580187759187137,TRX_N-00968-23933358,2024-03-31T10:46:02,Galdakao,Expense,food,-77.38,-50102.46
buyer_4,Jorge,50,ES12209580187759187137,TRX_N-00969-95110615,2024-03-31T17:15:51,Galdakao,Expense,gifts,-741.81,-50844.27
buyer_4,Jorge,50,ES12209580187759187137,TRX_N-00970-23777885,2024-04-01T11:33:46,Galdakao,incomes,salary,1497.63,-49346.64
buyer_4,Jorge,50,ES12209580187759187137,TRX_N-00971-07072944,2024-04-01T11:33:46,Galdakao,incomes,salary_partner,1745.94,-47600.7
buyer_4,Jorge,50,ES12209580187759187137,TRX_N-00972-84395290,2024-04-01T15:53:30,Galdakao,Expense,cash,-100.0,-47700.7
buyer_4,Jorge,50,ES12209580187759187137,TRX_N-00973-48545479,2024-04-01T20:34:51,Galdakao,Expense,travel,-531.55,-48232.25
buyer_4,Jorge,50,ES12209580187759187137,TRX_N-00974-09609684,2024-04-02T00:16:34,Galdakao,Expense,appliances,-271.03,-48503.28
buyer_4,Jorge,50,ES12209580187759187137,TRX_N-00975-71036242,2024-04-03T10:43:29,Galdakao,Expense,cash,-100.0,-48603.28
buyer_4,Jorge,50,ES12209580187759187137,TRX_N-00976-58672304,2024-04-04T14:14:08,Galdakao,expenses,mortgage,-1078.4,-49681.68
buyer_4,Jorge,50,ES12209580187759187137,TRX_N-00977-12990343,2024-04-04T10:03:29,Galdakao,Expense,cash,-100.0,-49781.68
buyer_4,Jorge,50,ES12209580187759187137,TRX_N-00978-46130813,2024-04-04T08:58:19,Galdakao,Expense,appliances,-279.6,-50061.28
buyer_4,Jorge,50,ES12209580187759187137,TRX_N-00979-76047300,2024-04-05T16:51:31,Galdakao,expenses,internet,-42.0,-50103.28
buyer_4,Jorge,50,ES12209580187759187137,TRX_N-00980-04814305,2024-04-05T14:32:40,Galdakao,expenses,phone,-44.68,-50147.96
buyer_4,Jorge,50,ES12209580187759187137,TRX_N-00981-19449893,2024-04-06T08:42:31,Galdakao,expenses,water,-37.44,-50185.4
buyer_4,Jorge,50,ES12209580187759187137,TRX_N-00982-88425943,2024-04-06T13:16:27,Galdakao,expenses,gas,-105.45,-50290.85
buyer_4,Jorge,50,ES12209580187759187137,TRX_N-00983-26500373,2024-04-06T08:28:19,Galdakao,Expense,food,-108.91,-50399.76
buyer_4,Jorge,50,ES12209580187759187137,TRX_N-00984-95459507,2024-04-06T20:06:28,Galdakao,Expense,repairs,-166.07,-50565.83
buyer_4,Jorge,50,ES12209580187759187137,TRX_N-00985-54609396,2024-04-07T19:52:55,Galdakao,Expense,gifts,-577.25,-51143.08
buyer_4,Jorge,50,ES12209580187759187137,TRX_N-00986-55620414,2024-04-08T11:15:50,Galdakao,expenses,electricity,-33.65,-51176.73
buyer_4,Jorge,50,ES12209580187759187137,TRX_N-00987-80564735,2024-04-08T16:50:54,Galdakao,Expense,leisure,-43.86,-51220.59
buyer_4,Jorge,50,ES12209580187759187137,TRX_N-00988-12681821,2024-04-08T18:39:49,Galdakao,Expense,cash,-100.0,-51320.59
buyer_4,Jorge,50,ES12209580187759187137,TRX_N-00989-30019656,2024-04-12T19:32:24,Galdakao,Expense,appliances,-297.15,-51617.74
buyer_4,Jorge,50,ES12209580187759187137,TRX_N-00990-97077049,2024-04-12T23:38:28,Galdakao,Expense,gifts,-270.2,-51887.94
buyer_4,Jorge,50,ES12209580187759187137,TRX_N-00991-41592973,2024-04-13T09:57:15,Galdakao,Expense,transport,-70.88,-51958.82
buyer_4,Jorge,50,ES12209580187759187137,TRX_N-00992-65610587,2024-04-13T10:04:47,Galdakao,Expense,leisure,-72.27,-52031.09
buyer_4,Jorge,50,ES12209580187759187137,TRX_N-00993-90366651,2024-04-14T08:39:39,Galdakao,expenses,children,-110.09,-52141.18
buyer_4,Jorge,50,ES12209580187759187137,TRX_N-00994-91569000,2024-04-15T19:23:38,Galdakao,Expense,clothing,-146.59,-52287.77
buyer_4,Jorge,50,ES12209580187759187137,TRX_N-00995-93178758,2024-04-16T23:46:08,Galdakao,Expense,leisure,-38.06,-52325.83
buyer_4,Jorge,50,ES12209580187759187137,TRX_N-00996-59924053,2024-04-16T19:03:04,Galdakao,Expense,clothing,-50.16,-52375.99
buyer_4,Jorge,50,ES12209580187759187137,TRX_N-00997-27963868,2024-04-17T18:14:51,Salvatierra/Agurain,Expense,leisure,-19.72,-52395.71
buyer_4,Jorge,50,ES12209580187759187137,TRX_N-00998-96638067,2024-04-21T16:44:43,Galdakao,Expense,transport,-62.39,-52458.1
buyer_4,Jorge,50,ES12209580187759187137,TRX_N-00999-29346766,2024-04-22T17:58:32,Galdakao,Expense,food,-101.96,-52560.06
buyer_4,Jorge,50,ES12209580187759187137,TRX_N-01000-88917337,2024-04-23T11:07:06,Galdakao,expenses,children,-226.56,-52786.62
buyer_4,Jorge,50,ES12209580187759187137,TRX_N-01001-89483343,2024-04-24T11:25:11,Galdakao,Expense,leisure,-53.27,-52839.89
buyer_4,Jorge,50,ES12209580187759187137,TRX_N-01002-17091785,2024-04-25T11:51:11,Galdakao,Expense,leisure,-54.38,-52894.27
buyer_4,Jorge,50,ES12209580187759187137,TRX_N-01003-34971877,2024-04-27T09:45:39,Galdakao,Expense,education,-52.83,-52947.1
buyer_4,Jorge,50,ES12209580187759187137,TRX_N-01004-64935988,2024-04-27T19:25:36,Galdakao,Expense,repairs,-233.1,-53180.2
buyer_4,Jorge,50,ES12209580187759187137,TRX_N-01005-81552074,2024-04-29T14:20:38,Galdakao,Expense,leisure,-34.36,-53214.56
buyer_4,Jorge,50,ES12209580187759187137,TRX_N-01006-51173045,2024-05-01T10:05:54,Galdakao,incomes,salary,1497.63,-51716.93
buyer_4,Jorge,50,ES12209580187759187137,TRX_N-01007-50113770,2024-05-01T10:05:54,Galdakao,incomes,salary_partner,1745.94,-49970.99
buyer_4,Jorge,50,ES12209580187759187137,TRX_N-01008-70976851,2024-05-02T06:30:34,Galdakao,Expense,cash,-100.0,-50070.99
buyer_4,Jorge,50,ES12209580187759187137,TRX_N-01009-46677944,2024-05-02T11:56:47,Galdakao,Expense,gifts,-458.13,-50529.12
buyer_4,Jorge,50,ES12209580187759187137,TRX_N-01010-11780067,2024-05-03T19:02:55,Galdakao,Expense,cash,-100.0,-50629.12
buyer_4,Jorge,50,ES12209580187759187137,TRX_N-01011-20501625,2024-05-04T10:41:57,Galdakao,expenses,mortgage,-1078.4,-51707.52
buyer_4,Jorge,50,ES12209580187759187137,TRX_N-01012-98693915,2024-05-04T07:02:06,Galdakao,Expense,food,-92.2,-51799.72
buyer_4,Jorge,50,ES12209580187759187137,TRX_N-01013-95334547,2024-05-05T08:23:52,Galdakao,expenses,electricity,-49.82,-51849.54
buyer_4,Jorge,50,ES12209580187759187137,TRX_N-01014-94149905,2024-05-05T10:39:09,Galdakao,Expense,leisure,-83.49,-51933.03
buyer_4,Jorge,50,ES12209580187759187137,TRX_N-01015-34168302,2024-05-05T11:44:17,Galdakao,Expense,healthcare,-127.07,-52060.1
buyer_4,Jorge,50,ES12209580187759187137,TRX_N-01016-44495136,2024-05-07T18:17:44,Galdakao,expenses,gas,-55.96,-52116.06
buyer_4,Jorge,50,ES12209580187759187137,TRX_N-01017-43472024,2024-05-07T17:12:27,Galdakao,Expense,leisure,-77.41,-52193.47
buyer_4,Jorge,50,ES12209580187759187137,TRX_N-01018-66056072,2024-05-08T08:17:52,Galdakao,expenses,water,-34.63,-52228.1
buyer_4,Jorge,50,ES12209580187759187137,TRX_N-01019-09031818,2024-05-08T08:41:29,Galdakao,expenses,internet,-42.0,-52270.1
buyer_4,Jorge,50,ES12209580187759187137,TRX_N-01020-41674284,2024-05-08T17:24:41,Galdakao,expenses,phone,-30.82,-52300.92
buyer_4,Jorge,50,ES12209580187759187137,TRX_N-01021-66321748,2024-05-08T15:55:53,Galdakao,Expense,appliances,-396.99,-52697.91
buyer_4,Jorge,50,ES12209580187759187137,TRX_N-01022-07321716,2024-05-09T20:05:09,Galdakao,Expense,transport,-69.46,-52767.37
buyer_4,Jorge,50,ES12209580187759187137,TRX_N-01023-41437137,2024-05-09T19:12:05,Galdakao,Expense,clothing,-69.08,-52836.45
buyer_4,Jorge,50,ES12209580187759187137,TRX_N-01024-56633858,2024-05-10T18:37:56,Galdakao,Expense,education,-51.51,-52887.96
buyer_4,Jorge,50,ES12209580187759187137,TRX_N-01025-19332200,2024-05-10T08:24:17,Errenteria,Expense,gifts,-88.57,-52976.53
buyer_4,Jorge,50,ES12209580187759187137,TRX_N-01026-08512798,2024-05-11T12:41:37,Galdakao,Expense,transport,-63.78,-53040.31
buyer_4,Jorge,50,ES12209580187759187137,TRX_N-01027-89011151,2024-05-11T19:08:19,Galdakao,Expense,cash,-100.0,-53140.31
buyer_4,Jorge,50,ES12209580187759187137,TRX_N-01028-22435014,2024-05-12T10:53:36,Galdakao,Expense,food,-113.02,-53253.33
buyer_4,Jorge,50,ES12209580187759187137,TRX_N-01029-66040093,2024-05-14T06:08:41,Galdakao,Expense,appliances,-406.1,-53659.43
buyer_4,Jorge,50,ES12209580187759187137,TRX_N-01030-69294491,2024-05-14T17:15:57,Galdakao,Expense,gifts,-842.46,-54501.89
buyer_4,Jorge,50,ES12209580187759187137,TRX_N-01031-44913009,2024-05-15T13:24:48,Galdakao,Expense,food,-75.55,-54577.44
buyer_4,Jorge,50,ES12209580187759187137,TRX_N-01032-88757528,2024-05-15T18:59:40,Galdakao,Expense,transport,-45.61,-54623.05
buyer_4,Jorge,50,ES12209580187759187137,TRX_N-01033-68950920,2024-05-18T08:42:19,Galdakao,Expense,repairs,-200.23,-54823.28
buyer_4,Jorge,50,ES12209580187759187137,TRX_N-01034-38015705,2024-05-19T19:31:39,Galdakao,Expense,transport,-42.61,-54865.89
buyer_4,Jorge,50,ES12209580187759187137,TRX_N-01035-07046088,2024-05-19T13:42:45,Galdakao,Expense,cash,-100.0,-54965.89
buyer_4,Jorge,50,ES12209580187759187137,TRX_N-01036-60308608,2024-05-20T15:40:35,Galdakao,Expense,food,-119.36,-55085.25
buyer_4,Jorge,50,ES12209580187759187137,TRX_N-01037-81811479,2024-05-21T23:24:17,Andoain,Expense,leisure,-39.53,-55124.78
buyer_4,Jorge,50,ES12209580187759187137,TRX_N-01038-90535140,2024-05-22T10:04:21,Galdakao,Expense,leisure,-49.71,-55174.49
buyer_4,Jorge,50,ES12209580187759187137,TRX_N-01039-50126231,2024-05-24T01:39:07,Galdakao,Expense,appliances,-161.82,-55336.31
buyer_4,Jorge,50,ES12209580187759187137,TRX_N-01040-28643742,2024-05-25T16:15:12,Galdakao,Expense,cash,-100.0,-55436.31
buyer_4,Jorge,50,ES12209580187759187137,TRX_N-01041-69742880,2024-05-27T09:52:01,Galdakao,Expense,transport,-67.44,-55503.75
buyer_4,Jorge,50,ES12209580187759187137,TRX_N-01042-09913265,2024-05-27T16:26:30,Galdakao,Expense,cash,-100.0,-55603.75
buyer_4,Jorge,50,ES12209580187759187137,TRX_N-01043-70706037,2024-05-27T20:41:52,Galdakao,Expense,gifts,-689.02,-56292.77
buyer_4,Jorge,50,ES12209580187759187137,TRX_N-01044-33515118,2024-05-28T19:51:49,Galdakao,Expense,education,-69.41,-56362.18
buyer_4,Jorge,50,ES12209580187759187137,TRX_N-01045-63346902,2024-05-29T19:52:00,Galdakao,Expense,cash,-100.0,-56462.18
buyer_4,Jorge,50,ES12209580187759187137,TRX_N-01046-88190095,2024-05-30T09:07:01,Galdakao,Expense,travel,-1159.65,-57621.83
buyer_4,Jorge,50,ES12209580187759187137,TRX_N-01047-96149559,2024-05-31T17:29:34,Galdakao,Expense,leisure,-47.26,-57669.09
buyer_4,Jorge,50,ES12209580187759187137,TRX_N-01048-09150478,2024-06-01T14:07:35,Galdakao,incomes,salary,1497.63,-56171.46
buyer_4,Jorge,50,ES12209580187759187137,TRX_N-01049-22480487,2024-06-01T14:07:35,Galdakao,incomes,salary_partner,1745.94,-54425.52
buyer_4,Jorge,50,ES12209580187759187137,TRX_N-01050-02496738,2024-06-01T14:07:35,Galdakao,incomes,extra_income,172.78,-54252.74
buyer_4,Jorge,50,ES12209580187759187137,TRX_N-01051-43495072,2024-06-01T14:07:35,Galdakao,incomes,salary_bonus,1181.62,-53071.12
buyer_4,Jorge,50,ES12209580187759187137,TRX_N-01052-63913951,2024-06-01T14:07:35,Galdakao,incomes,salary_partner_bonus,1248.81,-51822.31
buyer_4,Jorge,50,ES12209580187759187137,TRX_N-01053-40736247,2024-06-02T15:16:47,Galdakao,Expense,cash,-100.0,-51922.31
buyer_4,Jorge,50,ES12209580187759187137,TRX_N-01054-30254734,2024-06-03T16:41:07,Galdakao,Expense,gifts,-691.7,-52614.01
buyer_4,Jorge,50,ES12209580187759187137,TRX_N-01055-88498233,2024-06-04T14:08:27,Galdakao,expenses,mortgage,-1078.4,-53692.41
buyer_4,Jorge,50,ES12209580187759187137,TRX_N-01056-41875671,2024-06-05T19:36:20,Galdakao,expenses,electricity,-76.29,-53768.7
buyer_4,Jorge,50,ES12209580187759187137,TRX_N-01057-38464156,2024-06-05T19:01:51,Galdakao,expenses,phone,-38.46,-53807.16
buyer_4,Jorge,50,ES12209580187759187137,TRX_N-01058-56995079,2024-06-05T20:49:20,Galdakao,Expense,leisure,-24.27,-53831.43
buyer_4,Jorge,50,ES12209580187759187137,TRX_N-01059-90385697,2024-06-05T22:21:18,Galdakao,Expense,repairs,-175.96,-54007.39
buyer_4,Jorge,50,ES12209580187759187137,TRX_N-01060-33714131,2024-06-06T08:59:11,Galdakao,Expense,repairs,-84.13,-54091.52
buyer_4,Jorge,50,ES12209580187759187137,TRX_N-01061-04845525,2024-06-07T10:37:07,Galdakao,expenses,internet,-42.0,-54133.52
buyer_4,Jorge,50,ES12209580187759187137,TRX_N-01062-46558130,2024-06-08T14:17:35,Galdakao,expenses,water,-44.99,-54178.51
buyer_4,Jorge,50,ES12209580187759187137,TRX_N-01063-77778583,2024-06-08T04:47:01,Galdakao,expenses,gas,-97.85,-54276.36
buyer_4,Jorge,50,ES12209580187759187137,TRX_N-01064-18834365,2024-06-08T17:45:22,Bilbao,Expense,appliances,-419.22,-54695.58
buyer_4,Jorge,50,ES12209580187759187137,TRX_N-01065-36558517,2024-06-09T04:23:17,Galdakao,Expense,food,-98.76,-54794.34
buyer_4,Jorge,50,ES12209580187759187137,TRX_N-01066-12147565,2024-06-09T13:30:26,Galdakao,Expense,leisure,-73.24,-54867.58
buyer_4,Jorge,50,ES12209580187759187137,TRX_N-01067-06668202,2024-06-10T11:48:15,Galdakao,Expense,education,-56.54,-54924.12
buyer_4,Jorge,50,ES12209580187759187137,TRX_N-01068-20677778,2024-06-11T17:34:43,Portugalete,Expense,transport,-73.82,-54997.94
buyer_4,Jorge,50,ES12209580187759187137,TRX_N-01069-79603502,2024-06-12T17:36:50,Galdakao,Expense,food,-108.67,-55106.61
buyer_4,Jorge,50,ES12209580187759187137,TRX_N-01070-08554820,2024-06-12T03:00:41,Galdakao,Expense,leisure,-64.69,-55171.3
buyer_4,Jorge,50,ES12209580187759187137,TRX_N-01071-46406926,2024-06-17T11:43:49,Galdakao,Expense,repairs,-67.15,-55238.45
buyer_4,Jorge,50,ES12209580187759187137,TRX_N-01072-35589713,2024-06-19T17:53:47,Galdakao,Expense,food,-104.5,-55342.95
buyer_4,Jorge,50,ES12209580187759187137,TRX_N-01073-51630589,2024-06-21T12:44:01,Galdakao,Expense,education,-65.13,-55408.08
buyer_4,Jorge,50,ES12209580187759187137,TRX_N-01074-69085664,2024-06-22T22:54:50,Galdakao,Expense,education,-78.08,-55486.16
buyer_4,Jorge,50,ES12209580187759187137,TRX_N-01075-45908082,2024-06-22T08:01:16,Galdakao,Expense,cash,-100.0,-55586.16
buyer_4,Jorge,50,ES12209580187759187137,TRX_N-01076-68438745,2024-06-23T17:12:40,Galdakao,Expense,food,-98.85,-55685.01
buyer_4,Jorge,50,ES12209580187759187137,TRX_N-01077-25919777,2024-06-24T19:37:05,Galdakao,Expense,food,-113.42,-55798.43
buyer_4,Jorge,50,ES12209580187759187137,TRX_N-01078-73011333,2024-06-24T11:12:43,Llodio,Expense,leisure,-31.41,-55829.84
buyer_4,Jorge,50,ES12209580187759187137,TRX_N-01079-85942323,2024-06-24T16:02:16,Galdakao,Expense,gifts,-438.72,-56268.56
buyer_4,Jorge,50,ES12209580187759187137,TRX_N-01080-58975070,2024-06-25T16:23:47,Galdakao,Expense,food,-123.91,-56392.47
buyer_4,Jorge,50,ES12209580187759187137,TRX_N-01081-82524902,2024-06-25T19:15:14,Galdakao,Expense,gifts,-361.7,-56754.17
buyer_4,Jorge,50,ES12209580187759187137,TRX_N-01082-04370376,2024-06-27T22:42:38,Galdakao,Expense,transport,-66.68,-56820.85
buyer_4,Jorge,50,ES12209580187759187137,TRX_N-01083-77931390,2024-06-28T08:26:27,Iru√±a de Oca,Expense,healthcare,-46.06,-56866.91
buyer_4,Jorge,50,ES12209580187759187137,TRX_N-01084-98379104,2024-06-29T16:25:19,Galdakao,Expense,gifts,-40.53,-56907.44
buyer_4,Jorge,50,ES12209580187759187137,TRX_N-01085-23206450,2024-06-30T20:02:03,Galdakao,Expense,food,-121.4,-57028.84
buyer_4,Jorge,50,ES12209580187759187137,TRX_N-01086-38982221,2024-06-30T19:33:03,Galdakao,Expense,cash,-100.0,-57128.84
buyer_4,Jorge,50,ES12209580187759187137,TRX_N-01087-78916363,2024-06-30T22:39:04,Sestao,Expense,repairs,-46.64,-57175.48
buyer_4,Jorge,50,ES12209580187759187137,TRX_N-01088-14260805,2024-07-01T18:32:40,Galdakao,incomes,salary,1497.63,-55677.85
buyer_4,Jorge,50,ES12209580187759187137,TRX_N-01089-58821254,2024-07-01T18:32:40,Galdakao,incomes,salary_partner,1745.94,-53931.91
buyer_4,Jorge,50,ES12209580187759187137,TRX_N-01090-74610959,2024-07-01T18:19:08,Galdakao,Expense,food,-114.11,-54046.02
buyer_4,Jorge,50,ES12209580187759187137,TRX_N-01091-87325837,2024-07-01T04:17:51,Lasarte-Oria,Expense,repairs,-162.41,-54208.43
buyer_4,Jorge,50,ES12209580187759187137,TRX_N-01092-73150126,2024-07-02T15:11:03,Galdakao,Expense,cash,-100.0,-54308.43
buyer_4,Jorge,50,ES12209580187759187137,TRX_N-01093-46083371,2024-07-04T11:49:03,Galdakao,expenses,mortgage,-1078.4,-55386.83
buyer_4,Jorge,50,ES12209580187759187137,TRX_N-01094-19526160,2024-07-05T18:20:35,Galdakao,expenses,water,-31.65,-55418.48
buyer_4,Jorge,50,ES12209580187759187137,TRX_N-01095-52535159,2024-07-05T19:22:11,Galdakao,expenses,electricity,-46.29,-55464.77
buyer_4,Jorge,50,ES12209580187759187137,TRX_N-01096-90244779,2024-07-06T08:09:08,Galdakao,Expense,cash,-100.0,-55564.77
buyer_4,Jorge,50,ES12209580187759187137,TRX_N-01097-68257700,2024-07-07T14:19:39,Galdakao,Expense,cash,-100.0,-55664.77
buyer_4,Jorge,50,ES12209580187759187137,TRX_N-01098-65938498,2024-07-08T14:26:54,Galdakao,expenses,gas,-71.03,-55735.8
buyer_4,Jorge,50,ES12209580187759187137,TRX_N-01099-21279905,2024-07-08T09:52:05,Galdakao,expenses,internet,-42.0,-55777.8
buyer_4,Jorge,50,ES12209580187759187137,TRX_N-01100-13587889,2024-07-08T03:00:14,Galdakao,expenses,phone,-43.54,-55821.34
buyer_4,Jorge,50,ES12209580187759187137,TRX_N-01101-31669615,2024-07-09T14:27:06,Galdakao,Expense,cash,-100.0,-55921.34
buyer_4,Jorge,50,ES12209580187759187137,TRX_N-01102-00351606,2024-07-10T16:20:19,Galdakao,Expense,clothing,-94.2,-56015.54
buyer_4,Jorge,50,ES12209580187759187137,TRX_N-01103-14185188,2024-07-11T20:32:35,Galdakao,expenses,children,-106.65,-56122.19
buyer_4,Jorge,50,ES12209580187759187137,TRX_N-01104-63026725,2024-07-13T13:05:16,Amurrio,Expense,food,-78.98,-56201.17
buyer_4,Jorge,50,ES12209580187759187137,TRX_N-01105-58155812,2024-07-13T13:47:22,Galdakao,Expense,transport,-40.99,-56242.16
buyer_4,Jorge,50,ES12209580187759187137,TRX_N-01106-97824787,2024-07-13T10:50:05,Galdakao,Expense,cash,-100.0,-56342.16
buyer_4,Jorge,50,ES12209580187759187137,TRX_N-01107-98674310,2024-07-18T14:19:15,Galdakao,Expense,food,-100.82,-56442.98
buyer_4,Jorge,50,ES12209580187759187137,TRX_N-01108-46999398,2024-07-18T20:25:31,Galdakao,Expense,repairs,-227.31,-56670.29
buyer_4,Jorge,50,ES12209580187759187137,TRX_N-01109-90160148,2024-07-19T08:08:30,Galdakao,Expense,cash,-100.0,-56770.29
buyer_4,Jorge,50,ES12209580187759187137,TRX_N-01110-90035249,2024-07-20T13:21:24,Hernani,Expense,gifts,-719.93,-57490.22
buyer_4,Jorge,50,ES12209580187759187137,TRX_N-01111-60492644,2024-07-22T16:31:39,Galdakao,Expense,education,-68.63,-57558.85
buyer_4,Jorge,50,ES12209580187759187137,TRX_N-01112-30448851,2024-07-23T09:59:56,Galdakao,Expense,cash,-100.0,-57658.85
buyer_4,Jorge,50,ES12209580187759187137,TRX_N-01113-58559409,2024-07-24T01:21:46,Elciego,Expense,food,-93.93,-57752.78
buyer_4,Jorge,50,ES12209580187759187137,TRX_N-01114-28529848,2024-07-24T12:06:37,Salvatierra/Agurain,Expense,cash,-100.0,-57852.78
buyer_4,Jorge,50,ES12209580187759187137,TRX_N-01115-94522670,2024-07-26T13:36:34,Galdakao,Expense,repairs,-182.9,-58035.68
buyer_4,Jorge,50,ES12209580187759187137,TRX_N-01116-62891538,2024-07-27T15:55:34,Galdakao,Expense,transport,-84.47,-58120.15
buyer_4,Jorge,50,ES12209580187759187137,TRX_N-01117-47245662,2024-07-27T09:59:55,Galdakao,Expense,cash,-100.0,-58220.15
buyer_4,Jorge,50,ES12209580187759187137,TRX_N-01118-87675379,2024-07-27T23:18:44,Galdakao,Expense,gifts,-382.71,-58602.86
buyer_4,Jorge,50,ES12209580187759187137,TRX_N-01119-55184181,2024-07-27T13:36:00,Galdakao,expenses,children,-224.85,-58827.71
buyer_4,Jorge,50,ES12209580187759187137,TRX_N-01120-57680506,2024-07-28T14:14:42,Galdakao,Expense,food,-69.46,-58897.17
buyer_4,Jorge,50,ES12209580187759187137,TRX_N-01121-34505108,2024-07-28T13:47:17,Galdakao,Expense,leisure,-38.95,-58936.12
buyer_4,Jorge,50,ES12209580187759187137,TRX_N-01122-88804973,2024-07-29T15:13:49,Galdakao,Expense,food,-74.45,-59010.57
buyer_4,Jorge,50,ES12209580187759187137,TRX_N-01123-11874640,2024-07-30T20:12:29,Galdakao,Expense,leisure,-49.54,-59060.11
buyer_4,Jorge,50,ES12209580187759187137,TRX_N-01124-89734815,2024-07-30T12:39:07,Galdakao,Expense,cash,-100.0,-59160.11
buyer_4,Jorge,50,ES12209580187759187137,TRX_N-01125-86440462,2024-07-31T11:41:04,Galdakao,Expense,food,-102.32,-59262.43
buyer_4,Jorge,50,ES12209580187759187137,TRX_N-01126-12261721,2024-07-31T23:21:56,Galdakao,Expense,cash,-100.0,-59362.43
buyer_4,Jorge,50,ES12209580187759187137,TRX_N-01127-83237869,2024-07-31T22:07:49,Galdakao,expenses,children,-79.36,-59441.79
buyer_4,Jorge,50,ES12209580187759187137,TRX_N-01128-28247354,2024-08-01T16:38:10,Galdakao,incomes,salary,1497.63,-57944.16
buyer_4,Jorge,50,ES12209580187759187137,TRX_N-01129-48264300,2024-08-01T16:38:10,Galdakao,incomes,salary_partner,1745.94,-56198.22
buyer_4,Jorge,50,ES12209580187759187137,TRX_N-01130-12531802,2024-08-01T16:39:08,Galdakao,Expense,transport,-85.08,-56283.3
buyer_4,Jorge,50,ES12209580187759187137,TRX_N-01131-77322530,2024-08-01T09:33:35,Galdakao,Expense,cash,-100.0,-56383.3
buyer_4,Jorge,50,ES12209580187759187137,TRX_N-01132-00196834,2024-08-02T10:47:18,Galdakao,Expense,cash,-100.0,-56483.3
buyer_4,Jorge,50,ES12209580187759187137,TRX_N-01133-25610450,2024-08-04T09:38:24,Galdakao,expenses,mortgage,-1078.4,-57561.7
buyer_4,Jorge,50,ES12209580187759187137,TRX_N-01134-06727693,2024-08-04T19:52:44,Galdakao,Expense,education,-47.07,-57608.77
buyer_4,Jorge,50,ES12209580187759187137,TRX_N-01135-76908635,2024-08-05T14:30:32,Galdakao,Expense,food,-123.49,-57732.26
buyer_4,Jorge,50,ES12209580187759187137,TRX_N-01136-77435059,2024-08-06T17:39:45,Galdakao,expenses,water,-35.41,-57767.67
buyer_4,Jorge,50,ES12209580187759187137,TRX_N-01137-47977657,2024-08-06T13:17:14,Galdakao,expenses,gas,-80.23,-57847.9
buyer_4,Jorge,50,ES12209580187759187137,TRX_N-01138-62565381,2024-08-06T12:43:58,Galdakao,expenses,internet,-42.0,-57889.9
buyer_4,Jorge,50,ES12209580187759187137,TRX_N-01139-02754814,2024-08-06T14:28:03,Galdakao,Expense,food,-96.3,-57986.2
buyer_4,Jorge,50,ES12209580187759187137,TRX_N-01140-84211993,2024-08-07T17:54:24,Galdakao,expenses,electricity,-50.99,-58037.19
buyer_4,Jorge,50,ES12209580187759187137,TRX_N-01141-02917939,2024-08-07T08:37:02,Galdakao,Expense,food,-107.1,-58144.29
buyer_4,Jorge,50,ES12209580187759187137,TRX_N-01142-61111202,2024-08-08T23:24:12,Galdakao,expenses,phone,-36.32,-58180.61
buyer_4,Jorge,50,ES12209580187759187137,TRX_N-01143-42683463,2024-08-08T23:36:41,Galdakao,Expense,appliances,-412.34,-58592.95
buyer_4,Jorge,50,ES12209580187759187137,TRX_N-01144-71803936,2024-08-11T15:16:02,Getxo,Expense,food,-121.15,-58714.1
buyer_4,Jorge,50,ES12209580187759187137,TRX_N-01145-81003756,2024-08-11T12:41:51,Galdakao,Expense,transport,-71.06,-58785.16
buyer_4,Jorge,50,ES12209580187759187137,TRX_N-01146-56168620,2024-08-11T16:35:18,Galdakao,Expense,leisure,-30.15,-58815.31
buyer_4,Jorge,50,ES12209580187759187137,TRX_N-01147-92787542,2024-08-16T08:03:53,Llodio,Expense,food,-92.77,-58908.08
buyer_4,Jorge,50,ES12209580187759187137,TRX_N-01148-56163621,2024-08-16T08:12:13,Galdakao,Expense,education,-69.83,-58977.91
buyer_4,Jorge,50,ES12209580187759187137,TRX_N-01149-51427299,2024-08-18T03:18:59,Portugalete,Expense,repairs,-182.44,-59160.35
buyer_4,Jorge,50,ES12209580187759187137,TRX_N-01150-31194238,2024-08-19T13:43:29,Zarautz,Expense,cash,-100.0,-59260.35
buyer_4,Jorge,50,ES12209580187759187137,TRX_N-01151-39234813,2024-08-20T13:29:03,Galdakao,Expense,healthcare,-162.48,-59422.83
buyer_4,Jorge,50,ES12209580187759187137,TRX_N-01152-55720877,2024-08-21T17:28:22,Galdakao,Expense,food,-77.3,-59500.13
buyer_4,Jorge,50,ES12209580187759187137,TRX_N-01153-98578706,2024-08-23T09:16:40,Galdakao,Expense,travel,-1489.07,-60989.2
buyer_4,Jorge,50,ES12209580187759187137,TRX_N-01154-24339162,2024-08-24T11:41:19,Galdakao,Expense,transport,-68.75,-61057.95
buyer_4,Jorge,50,ES12209580187759187137,TRX_N-01155-49129777,2024-08-25T19:55:32,Galdakao,Expense,education,-59.72,-61117.67
buyer_4,Jorge,50,ES12209580187759187137,TRX_N-01156-47877816,2024-08-27T11:07:09,Galdakao,Expense,food,-112.72,-61230.39
buyer_4,Jorge,50,ES12209580187759187137,TRX_N-01157-26945898,2024-08-28T18:19:31,Galdakao,Expense,clothing,-128.51,-61358.9
buyer_4,Jorge,50,ES12209580187759187137,TRX_N-01158-57054133,2024-08-31T18:12:40,Galdakao,Expense,food,-65.81,-61424.71
buyer_4,Jorge,50,ES12209580187759187137,TRX_N-01159-24241711,2024-08-31T01:17:16,Galdakao,Expense,transport,-82.2,-61506.91
buyer_4,Jorge,50,ES12209580187759187137,TRX_N-01160-78887464,2024-08-31T08:11:02,Galdakao,Expense,leisure,-61.48,-61568.39
buyer_4,Jorge,50,ES12209580187759187137,TRX_N-01161-75273216,2024-08-31T17:24:02,Galdakao,Expense,cash,-100.0,-61668.39
buyer_4,Jorge,50,ES12209580187759187137,TRX_N-01162-21582372,2024-09-01T21:51:01,Galdakao,incomes,salary,1497.63,-60170.76
buyer_4,Jorge,50,ES12209580187759187137,TRX_N-01163-44504274,2024-09-01T21:51:01,Galdakao,incomes,salary_partner,1745.94,-58424.82
buyer_4,Jorge,50,ES12209580187759187137,TRX_N-01164-84512802,2024-09-01T21:51:01,Galdakao,incomes,extra_income,172.78,-58252.04
buyer_4,Jorge,50,ES12209580187759187137,TRX_N-01165-19656496,2024-09-03T19:39:21,Galdakao,Expense,food,-94.71,-58346.75
buyer_4,Jorge,50,ES12209580187759187137,TRX_N-01166-26798901,2024-09-04T14:18:21,Galdakao,expenses,mortgage,-1078.4,-59425.15
buyer_4,Jorge,50,ES12209580187759187137,TRX_N-01167-53134664,2024-09-05T14:50:33,Galdakao,expenses,phone,-37.61,-59462.76
buyer_4,Jorge,50,ES12209580187759187137,TRX_N-01168-21107016,2024-09-05T20:24:54,Galdakao,Expense,cash,-100.0,-59562.76
buyer_4,Jorge,50,ES12209580187759187137,TRX_N-01169-99258624,2024-09-06T21:50:29,Galdakao,expenses,internet,-42.0,-59604.76
buyer_4,Jorge,50,ES12209580187759187137,TRX_N-01170-75458473,2024-09-06T23:30:17,Galdakao,Expense,cash,-100.0,-59704.76
buyer_4,Jorge,50,ES12209580187759187137,TRX_N-01171-86224119,2024-09-06T11:06:31,Berango,Expense,repairs,-296.42,-60001.18
buyer_4,Jorge,50,ES12209580187759187137,TRX_N-01172-46470438,2024-09-07T11:37:44,Galdakao,Expense,food,-63.49,-60064.67
buyer_4,Jorge,50,ES12209580187759187137,TRX_N-01173-48525395,2024-09-07T10:46:17,Galdakao,Expense,repairs,-168.39,-60233.06
buyer_4,Jorge,50,ES12209580187759187137,TRX_N-01174-41489402,2024-09-08T09:50:21,Galdakao,expenses,water,-26.15,-60259.21
buyer_4,Jorge,50,ES12209580187759187137,TRX_N-01175-60633213,2024-09-08T13:59:59,Galdakao,expenses,electricity,-60.94,-60320.15
buyer_4,Jorge,50,ES12209580187759187137,TRX_N-01176-82043454,2024-09-08T18:17:12,Galdakao,expenses,gas,-108.35,-60428.5
buyer_4,Jorge,50,ES12209580187759187137,TRX_N-01177-75319830,2024-09-09T22:10:33,Galdakao,Expense,transport,-48.02,-60476.52
buyer_4,Jorge,50,ES12209580187759187137,TRX_N-01178-57175699,2024-09-10T18:40:16,Galdakao,Expense,clothing,-77.15,-60553.67
buyer_4,Jorge,50,ES12209580187759187137,TRX_N-01179-28382434,2024-09-15T10:17:26,Galdakao,Expense,transport,-83.56,-60637.23
buyer_4,Jorge,50,ES12209580187759187137,TRX_N-01180-51348034,2024-09-15T19:38:24,Galdakao,Expense,healthcare,-144.56,-60781.79
buyer_4,Jorge,50,ES12209580187759187137,TRX_N-01181-78815035,2024-09-17T19:27:54,Galdakao,Expense,food,-113.2,-60894.99
buyer_4,Jorge,50,ES12209580187759187137,TRX_N-01182-72299542,2024-09-17T01:07:49,Galdakao,Expense,education,-50.95,-60945.94
buyer_4,Jorge,50,ES12209580187759187137,TRX_N-01183-71441918,2024-09-19T09:11:03,Galdakao,Expense,gifts,-77.87,-61023.81
buyer_4,Jorge,50,ES12209580187759187137,TRX_N-01184-85051626,2024-09-20T09:29:46,Galdakao,Expense,clothing,-103.08,-61126.89
buyer_4,Jorge,50,ES12209580187759187137,TRX_N-01185-49382977,2024-09-24T16:47:28,Galdakao,Expense,cash,-100.0,-61226.89
buyer_4,Jorge,50,ES12209580187759187137,TRX_N-01186-99015100,2024-09-25T14:07:10,Galdakao,Expense,cash,-100.0,-61326.89
buyer_4,Jorge,50,ES12209580187759187137,TRX_N-01187-14737930,2024-09-27T08:49:09,Galdakao,Expense,food,-84.47,-61411.36
buyer_4,Jorge,50,ES12209580187759187137,TRX_N-01188-88640955,2024-09-28T21:18:48,Galdakao,Expense,food,-110.13,-61521.49
buyer_4,Jorge,50,ES12209580187759187137,TRX_N-01189-05563770,2024-09-28T16:09:43,Galdakao,Expense,leisure,-57.14,-61578.63
buyer_4,Jorge,50,ES12209580187759187137,TRX_N-01190-48585237,2024-09-29T10:52:45,Galdakao,Expense,gifts,-156.1,-61734.73
buyer_4,Jorge,50,ES12209580187759187137,TRX_N-01191-30597316,2024-09-30T15:00:15,Galdakao,Expense,transport,-84.44,-61819.17
buyer_4,Jorge,50,ES12209580187759187137,TRX_N-01192-29222198,2024-10-01T14:09:53,Galdakao,incomes,salary,1497.63,-60321.54
buyer_4,Jorge,50,ES12209580187759187137,TRX_N-01193-68464767,2024-10-01T14:09:53,Galdakao,incomes,salary_partner,1745.94,-58575.6
buyer_4,Jorge,50,ES12209580187759187137,TRX_N-01194-47876774,2024-10-02T11:39:04,Galdakao,Expense,cash,-100.0,-58675.6
buyer_4,Jorge,50,ES12209580187759187137,TRX_N-01195-34843961,2024-10-04T18:23:09,Galdakao,expenses,mortgage,-1078.4,-59754.0
buyer_4,Jorge,50,ES12209580187759187137,TRX_N-01196-55051680,2024-10-05T19:20:32,Galdakao,expenses,gas,-102.5,-59856.5
buyer_4,Jorge,50,ES12209580187759187137,TRX_N-01197-08083718,2024-10-05T20:50:42,Galdakao,Expense,cash,-100.0,-59956.5
buyer_4,Jorge,50,ES12209580187759187137,TRX_N-01198-42935589,2024-10-06T18:53:46,Galdakao,expenses,phone,-43.74,-60000.24
buyer_4,Jorge,50,ES12209580187759187137,TRX_N-01199-05203003,2024-10-06T12:36:08,Galdakao,Expense,leisure,-19.94,-60020.18
buyer_4,Jorge,50,ES12209580187759187137,TRX_N-01200-76799844,2024-10-07T08:37:51,Getxo,Expense,appliances,-82.19,-60102.37
buyer_4,Jorge,50,ES12209580187759187137,TRX_N-01201-29609355,2024-10-07T13:20:36,Galdakao,Expense,repairs,-241.54,-60343.91
buyer_4,Jorge,50,ES12209580187759187137,TRX_N-01202-55527740,2024-10-08T14:56:53,Galdakao,expenses,water,-26.04,-60369.95
buyer_4,Jorge,50,ES12209580187759187137,TRX_N-01203-94862147,2024-10-08T15:59:03,Galdakao,expenses,electricity,-43.15,-60413.1
buyer_4,Jorge,50,ES12209580187759187137,TRX_N-01204-72596081,2024-10-08T17:50:08,Galdakao,expenses,internet,-42.0,-60455.1
buyer_4,Jorge,50,ES12209580187759187137,TRX_N-01205-12568819,2024-10-08T18:29:24,Galdakao,Expense,leisure,-61.82,-60516.92
buyer_5,Sara,30,ES05209525001173802889,TRX_N-00001-52722427,2022-01-01T21:59:08,Donostia,incomes,salary,1350.89,2772.7
buyer_5,Sara,30,ES05209525001173802889,TRX_N-00002-59830850,2022-01-01T21:59:08,Donostia,incomes,salary_partner,1138.18,3910.88
buyer_5,Sara,30,ES05209525001173802889,TRX_N-00003-04215284,2022-01-01T17:59:16,Donostia,Expense,food,-83.2,3827.68
buyer_5,Sara,30,ES05209525001173802889,TRX_N-00004-01414521,2022-01-03T16:58:13,Donostia,Expense,food,-74.12,3753.56
buyer_5,Sara,30,ES05209525001173802889,TRX_N-00005-20033411,2022-01-03T14:01:33,Donostia,Expense,transport,-82.58,3670.98
buyer_5,Sara,30,ES05209525001173802889,TRX_N-00006-01867760,2022-01-04T13:37:42,Donostia,expenses,mortgage,-726.47,2944.51
buyer_5,Sara,30,ES05209525001173802889,TRX_N-00007-73201685,2022-01-04T00:10:47,Donostia,Expense,food,-93.03,2851.48
buyer_5,Sara,30,ES05209525001173802889,TRX_N-00008-65826494,2022-01-04T15:18:28,Vitoria-Gasteiz,Expense,education,-77.04,2774.44
buyer_5,Sara,30,ES05209525001173802889,TRX_N-00009-90191196,2022-01-05T08:24:15,Donostia,Expense,food,-97.32,2677.12
buyer_5,Sara,30,ES05209525001173802889,TRX_N-00010-83065861,2022-01-05T16:46:18,Donostia,Expense,healthcare,-130.33,2546.79
buyer_5,Sara,30,ES05209525001173802889,TRX_N-00011-21280003,2022-01-05T10:57:39,Donostia,Expense,cash,-100.0,2446.79
buyer_5,Sara,30,ES05209525001173802889,TRX_N-00012-90522627,2022-01-06T18:26:41,Donostia,expenses,gas,-58.55,2388.24
buyer_5,Sara,30,ES05209525001173802889,TRX_N-00013-39531406,2022-01-06T10:51:40,Donostia,expenses,internet,-42.0,2346.24
buyer_5,Sara,30,ES05209525001173802889,TRX_N-00014-88713298,2022-01-06T15:31:31,Donostia,Expense,cash,-100.0,2246.24
buyer_5,Sara,30,ES05209525001173802889,TRX_N-00015-89149754,2022-01-06T01:15:01,Donostia,Expense,repairs,-84.31,2161.93
buyer_5,Sara,30,ES05209525001173802889,TRX_N-00016-65708565,2022-01-08T22:43:18,Donostia,expenses,water,-23.43,2138.5
buyer_5,Sara,30,ES05209525001173802889,TRX_N-00017-36188389,2022-01-08T18:11:09,Donostia,expenses,electricity,-51.71,2086.79
buyer_5,Sara,30,ES05209525001173802889,TRX_N-00018-24540325,2022-01-08T03:18:59,Donostia,expenses,phone,-44.51,2042.28
buyer_5,Sara,30,ES05209525001173802889,TRX_N-00019-49298597,2022-01-12T15:24:40,Pasaia,Expense,transport,-85.2,1957.08
buyer_5,Sara,30,ES05209525001173802889,TRX_N-00020-96910461,2022-01-13T17:36:08,Vitoria-Gasteiz,Expense,leisure,-30.61,1926.47
buyer_5,Sara,30,ES05209525001173802889,TRX_N-00021-17126615,2022-01-15T18:46:20,Donostia,Expense,food,-112.26,1814.21
buyer_5,Sara,30,ES05209525001173802889,TRX_N-00022-77866710,2022-01-15T09:34:39,Donostia,Expense,leisure,-35.19,1779.02
buyer_5,Sara,30,ES05209525001173802889,TRX_N-00023-75568706,2022-01-18T13:55:07,Donostia,Expense,repairs,-255.81,1523.21
buyer_5,Sara,30,ES05209525001173802889,TRX_N-00024-01439188,2022-01-19T01:31:25,Donostia,Expense,cash,-100.0,1423.21
buyer_5,Sara,30,ES05209525001173802889,TRX_N-00025-33939881,2022-01-20T10:11:05,Sopela,Expense,gifts,-375.03,1048.18
buyer_5,Sara,30,ES05209525001173802889,TRX_N-00026-36629503,2022-01-22T20:58:41,Donostia,Expense,cash,-100.0,948.18
buyer_5,Sara,30,ES05209525001173802889,TRX_N-00027-06522073,2022-01-23T13:54:03,Donostia,Expense,cash,-100.0,848.18
buyer_5,Sara,30,ES05209525001173802889,TRX_N-00028-87555904,2022-01-24T12:53:10,Galdakao,Expense,food,-107.77,740.41
buyer_5,Sara,30,ES05209525001173802889,TRX_N-00029-23670531,2022-01-26T21:28:41,Donostia,Expense,repairs,-273.47,466.94
buyer_5,Sara,30,ES05209525001173802889,TRX_N-00030-16620324,2022-01-26T16:07:00,Donostia,expenses,children,-105.71,361.23
buyer_5,Sara,30,ES05209525001173802889,TRX_N-00031-01778739,2022-02-01T12:32:46,Donostia,incomes,salary,1350.89,1712.12
buyer_5,Sara,30,ES05209525001173802889,TRX_N-00032-98235787,2022-02-01T12:32:46,Donostia,incomes,salary_partner,1138.18,2850.3
buyer_5,Sara,30,ES05209525001173802889,TRX_N-00033-40573771,2022-02-01T13:05:15,Donostia,Expense,leisure,-77.49,2772.81
buyer_5,Sara,30,ES05209525001173802889,TRX_N-00034-78820647,2022-02-03T09:11:48,Donostia,Expense,transport,-50.68,2722.13
buyer_5,Sara,30,ES05209525001173802889,TRX_N-00035-00357180,2022-02-04T08:24:53,Donostia,expenses,mortgage,-726.47,1995.66
buyer_5,Sara,30,ES05209525001173802889,TRX_N-00036-42930341,2022-02-04T14:27:13,Donostia,Expense,cash,-100.0,1895.66
buyer_5,Sara,30,ES05209525001173802889,TRX_N-00037-19972020,2022-02-05T10:52:51,Donostia,expenses,electricity,-48.91,1846.75
buyer_5,Sara,30,ES05209525001173802889,TRX_N-00038-92293976,2022-02-05T18:38:08,Donostia,expenses,phone,-31.01,1815.74
buyer_5,Sara,30,ES05209525001173802889,TRX_N-00039-31179087,2022-02-05T19:19:18,Basauri,Expense,transport,-70.3,1745.44
buyer_5,Sara,30,ES05209525001173802889,TRX_N-00040-93971986,2022-02-06T19:55:59,Donostia,expenses,internet,-42.0,1703.44
buyer_5,Sara,30,ES05209525001173802889,TRX_N-00041-15184412,2022-02-06T10:17:55,Donostia,Expense,leisure,-37.28,1666.16
buyer_5,Sara,30,ES05209525001173802889,TRX_N-00042-56149251,2022-02-07T17:17:51,Donostia,Expense,appliances,-93.04,1573.12
buyer_5,Sara,30,ES05209525001173802889,TRX_N-00043-74865868,2022-02-08T16:06:33,Donostia,expenses,gas,-83.87,1489.25
buyer_5,Sara,30,ES05209525001173802889,TRX_N-00044-48683404,2022-02-08T11:19:51,Donostia,expenses,water,-26.03,1463.22
buyer_5,Sara,30,ES05209525001173802889,TRX_N-00045-57777826,2022-02-09T14:36:08,Donostia,Expense,transport,-68.38,1394.84
buyer_5,Sara,30,ES05209525001173802889,TRX_N-00046-50875589,2022-02-09T10:50:10,Donostia,Expense,leisure,-23.56,1371.28
buyer_5,Sara,30,ES05209525001173802889,TRX_N-00047-51201267,2022-02-13T17:21:02,Donostia,Expense,food,-119.03,1252.25
buyer_5,Sara,30,ES05209525001173802889,TRX_N-00048-78984302,2022-02-15T20:42:24,Donostia,Expense,leisure,-83.72,1168.53
buyer_5,Sara,30,ES05209525001173802889,TRX_N-00049-05586332,2022-02-15T20:31:39,Donostia,Expense,clothing,-154.68,1013.85
buyer_5,Sara,30,ES05209525001173802889,TRX_N-00050-73753929,2022-02-15T11:33:45,Donostia,Expense,healthcare,-89.31,924.54
buyer_5,Sara,30,ES05209525001173802889,TRX_N-00051-25037986,2022-02-16T16:44:00,Donostia,Expense,repairs,-141.55,782.99
buyer_5,Sara,30,ES05209525001173802889,TRX_N-00052-62139993,2022-02-17T09:59:49,Donostia,Expense,leisure,-81.39,701.6
buyer_5,Sara,30,ES05209525001173802889,TRX_N-00053-88762726,2022-02-18T16:23:49,Donostia,Expense,food,-77.38,624.22
buyer_5,Sara,30,ES05209525001173802889,TRX_N-00054-43824272,2022-02-18T16:55:35,Eibar,Expense,cash,-100.0,524.22
buyer_5,Sara,30,ES05209525001173802889,TRX_N-00055-11549418,2022-02-21T17:18:51,Portugalete,Expense,leisure,-62.59,461.63
buyer_5,Sara,30,ES05209525001173802889,TRX_N-00056-04763947,2022-02-21T15:42:35,Donostia,Expense,cash,-100.0,361.63
buyer_5,Sara,30,ES05209525001173802889,TRX_N-00057-64010112,2022-02-22T18:02:41,Donostia,Expense,transport,-47.51,314.12
buyer_5,Sara,30,ES05209525001173802889,TRX_N-00058-64334245,2022-02-22T18:14:53,Donostia,Expense,leisure,-57.79,256.33
buyer_5,Sara,30,ES05209525001173802889,TRX_N-00059-02487495,2022-02-24T05:26:09,Donostia,Expense,leisure,-76.08,180.25
buyer_5,Sara,30,ES05209525001173802889,TRX_N-00060-50370689,2022-03-01T21:45:14,Donostia,incomes,salary,1350.89,1531.14
buyer_5,Sara,30,ES05209525001173802889,TRX_N-00061-30833436,2022-03-01T21:45:14,Donostia,incomes,salary_partner,1138.18,2669.32
buyer_5,Sara,30,ES05209525001173802889,TRX_N-00062-26466282,2022-03-01T21:45:14,Donostia,incomes,extra_income,151.29,2820.61
buyer_5,Sara,30,ES05209525001173802889,TRX_N-00063-32006464,2022-03-01T20:05:14,Donostia,Expense,food,-60.48,2760.13
buyer_5,Sara,30,ES05209525001173802889,TRX_N-00064-06402177,2022-03-01T14:18:51,Donostia,Expense,cash,-100.0,2660.13
buyer_5,Sara,30,ES05209525001173802889,TRX_N-00065-29125494,2022-03-01T15:22:13,Donostia,Expense,repairs,-316.43,2343.7
buyer_5,Sara,30,ES05209525001173802889,TRX_N-00066-95513468,2022-03-03T12:36:55,Donostia,Expense,food,-72.69,2271.01
buyer_5,Sara,30,ES05209525001173802889,TRX_N-00067-94579246,2022-03-04T12:38:41,Donostia,expenses,mortgage,-726.47,1544.54
buyer_5,Sara,30,ES05209525001173802889,TRX_N-00068-54289255,2022-03-05T12:58:49,Donostia,expenses,electricity,-56.8,1487.74
buyer_5,Sara,30,ES05209525001173802889,TRX_N-00069-02168001,2022-03-05T15:30:38,Donostia,Expense,clothing,-86.04,1401.7
buyer_5,Sara,30,ES05209525001173802889,TRX_N-00070-20465552,2022-03-05T11:40:49,Donostia,Expense,appliances,-81.75,1319.95
buyer_5,Sara,30,ES05209525001173802889,TRX_N-00071-85463781,2022-03-06T17:58:55,Donostia,expenses,phone,-44.61,1275.34
buyer_5,Sara,30,ES05209525001173802889,TRX_N-00072-64111208,2022-03-06T13:45:59,Donostia,Expense,food,-62.11,1213.23
buyer_5,Sara,30,ES05209525001173802889,TRX_N-00073-47303500,2022-03-06T07:02:23,Erandio,Expense,cash,-100.0,1113.23
buyer_5,Sara,30,ES05209525001173802889,TRX_N-00074-21836992,2022-03-08T19:59:21,Donostia,expenses,water,-43.05,1070.18
buyer_5,Sara,30,ES05209525001173802889,TRX_N-00075-22451807,2022-03-08T09:50:56,Donostia,expenses,gas,-98.74,971.44
buyer_5,Sara,30,ES05209525001173802889,TRX_N-00076-43074332,2022-03-08T20:37:25,Donostia,expenses,internet,-42.0,929.44
buyer_5,Sara,30,ES05209525001173802889,TRX_N-00077-81631732,2022-03-10T18:31:17,Donostia,Expense,transport,-50.47,878.97
buyer_5,Sara,30,ES05209525001173802889,TRX_N-00078-91578241,2022-03-11T08:52:06,Donostia,Expense,food,-76.51,802.46
buyer_5,Sara,30,ES05209525001173802889,TRX_N-00079-08915578,2022-03-14T10:23:44,Donostia,Expense,leisure,-78.98,723.48
buyer_5,Sara,30,ES05209525001173802889,TRX_N-00080-08448319,2022-03-14T20:08:42,Donostia,Expense,repairs,-265.13,458.35
buyer_5,Sara,30,ES05209525001173802889,TRX_N-00081-32810671,2022-03-14T11:22:00,Donostia,Expense,gifts,-618.62,-160.27
buyer_5,Sara,30,ES05209525001173802889,TRX_N-00082-10626707,2022-03-16T19:24:16,Donostia,Expense,transport,-60.16,-220.43
buyer_5,Sara,30,ES05209525001173802889,TRX_N-00083-27771509,2022-03-16T17:46:52,Donostia,Expense,cash,-100.0,-320.43
buyer_5,Sara,30,ES05209525001173802889,TRX_N-00084-89260191,2022-03-21T20:55:12,Donostia,Expense,gifts,-707.12,-1027.55
buyer_5,Sara,30,ES05209525001173802889,TRX_N-00085-20776265,2022-03-23T19:33:29,Donostia,Expense,education,-69.75,-1097.3
buyer_5,Sara,30,ES05209525001173802889,TRX_N-00086-45116846,2022-03-23T14:45:12,Donostia,expenses,children,-71.83,-1169.13
buyer_5,Sara,30,ES05209525001173802889,TRX_N-00087-84567829,2022-03-26T18:09:25,Alegr√≠a-Dulantzi,Expense,education,-44.37,-1213.5
buyer_5,Sara,30,ES05209525001173802889,TRX_N-00088-69703995,2022-03-31T15:10:15,Donostia,Expense,transport,-58.29,-1271.79
buyer_5,Sara,30,ES05209525001173802889,TRX_N-00089-28494833,2022-03-31T19:09:28,Donostia,Expense,cash,-100.0,-1371.79
buyer_5,Sara,30,ES05209525001173802889,TRX_N-00090-59459453,2022-04-01T21:18:52,Donostia,incomes,salary,1350.89,-20.9
buyer_5,Sara,30,ES05209525001173802889,TRX_N-00091-25893178,2022-04-01T21:18:52,Donostia,incomes,salary_partner,1138.18,1117.28
buyer_5,Sara,30,ES05209525001173802889,TRX_N-00092-39912804,2022-04-01T10:06:29,Donostia,Expense,cash,-100.0,1017.28
buyer_5,Sara,30,ES05209525001173802889,TRX_N-00093-20181579,2022-04-03T10:20:14,Donostia,Expense,food,-105.89,911.39
buyer_5,Sara,30,ES05209525001173802889,TRX_N-00094-89814449,2022-04-04T15:53:37,Donostia,expenses,mortgage,-726.47,184.92
buyer_5,Sara,30,ES05209525001173802889,TRX_N-00095-37604819,2022-04-04T13:38:18,Donostia,Expense,transport,-70.51,114.41
buyer_5,Sara,30,ES05209525001173802889,TRX_N-00096-30401880,2022-04-06T10:53:10,Donostia,expenses,water,-36.65,77.76
buyer_5,Sara,30,ES05209525001173802889,TRX_N-00097-87823202,2022-04-06T10:45:11,Donostia,expenses,phone,-42.84,34.92
buyer_5,Sara,30,ES05209525001173802889,TRX_N-00098-48456235,2022-04-06T19:17:16,Donostia,Expense,food,-113.72,-78.8
buyer_5,Sara,30,ES05209525001173802889,TRX_N-00099-95053765,2022-04-06T15:13:04,Mungia,Expense,transport,-54.67,-133.47
buyer_5,Sara,30,ES05209525001173802889,TRX_N-00100-34652739,2022-04-07T16:04:44,Donostia,expenses,gas,-94.47,-227.94
buyer_5,Sara,30,ES05209525001173802889,TRX_N-00101-38698316,2022-04-07T23:16:26,Donostia,Expense,clothing,-82.59,-310.53
buyer_5,Sara,30,ES05209525001173802889,TRX_N-00102-92970284,2022-04-08T09:18:35,Donostia,expenses,electricity,-54.24,-364.77
buyer_5,Sara,30,ES05209525001173802889,TRX_N-00103-21095626,2022-04-08T17:56:40,Donostia,expenses,internet,-42.0,-406.77
buyer_5,Sara,30,ES05209525001173802889,TRX_N-00104-77198941,2022-04-11T08:41:19,Basauri,Expense,cash,-100.0,-506.77
buyer_5,Sara,30,ES05209525001173802889,TRX_N-00105-43668950,2022-04-11T15:26:09,Donostia,Expense,repairs,-134.24,-641.01
buyer_5,Sara,30,ES05209525001173802889,TRX_N-00106-93539688,2022-04-12T09:23:26,Donostia,Expense,education,-52.4,-693.41
buyer_5,Sara,30,ES05209525001173802889,TRX_N-00107-59968670,2022-04-12T12:24:50,Portugalete,Expense,cash,-100.0,-793.41
buyer_5,Sara,30,ES05209525001173802889,TRX_N-00108-89162683,2022-04-13T13:52:23,Donostia,Expense,repairs,-84.71,-878.12
buyer_5,Sara,30,ES05209525001173802889,TRX_N-00109-68368949,2022-04-15T04:28:05,Donostia,Expense,food,-106.15,-984.27
buyer_5,Sara,30,ES05209525001173802889,TRX_N-00110-94314858,2022-04-18T10:52:07,Donostia,Expense,education,-72.46,-1056.73
buyer_5,Sara,30,ES05209525001173802889,TRX_N-00111-39500694,2022-04-19T15:54:17,Donostia,Expense,cash,-100.0,-1156.73
buyer_5,Sara,30,ES05209525001173802889,TRX_N-00112-91080929,2022-04-21T19:07:34,Donostia,Expense,food,-93.95,-1250.68
buyer_5,Sara,30,ES05209525001173802889,TRX_N-00113-72426053,2022-04-22T23:28:15,Donostia,Expense,transport,-66.11,-1316.79
buyer_5,Sara,30,ES05209525001173802889,TRX_N-00114-27959735,2022-04-22T17:41:43,Donostia,Expense,leisure,-50.17,-1366.96
buyer_5,Sara,30,ES05209525001173802889,TRX_N-00115-17183819,2022-04-24T20:24:23,Donostia,Expense,cash,-100.0,-1466.96
buyer_5,Sara,30,ES05209525001173802889,TRX_N-00116-70960959,2022-04-25T12:11:45,Donostia,Expense,transport,-74.71,-1541.67
buyer_5,Sara,30,ES05209525001173802889,TRX_N-00117-16416696,2022-04-26T23:19:24,Donostia,Expense,clothing,-61.59,-1603.26
buyer_5,Sara,30,ES05209525001173802889,TRX_N-00118-64973651,2022-04-27T09:24:44,Donostia,Expense,leisure,-28.78,-1632.04
buyer_5,Sara,30,ES05209525001173802889,TRX_N-00119-67229681,2022-04-28T19:34:04,Donostia,Expense,cash,-100.0,-1732.04
buyer_5,Sara,30,ES05209525001173802889,TRX_N-00120-33053804,2022-04-29T18:52:19,Donostia,Expense,food,-83.16,-1815.2
buyer_5,Sara,30,ES05209525001173802889,TRX_N-00121-66580048,2022-04-30T09:56:08,Donostia,Expense,cash,-100.0,-1915.2
buyer_5,Sara,30,ES05209525001173802889,TRX_N-00122-87599065,2022-05-01T20:21:52,Donostia,incomes,salary,1350.89,-564.31
buyer_5,Sara,30,ES05209525001173802889,TRX_N-00123-34055488,2022-05-01T20:21:52,Donostia,incomes,salary_partner,1138.18,573.87
buyer_5,Sara,30,ES05209525001173802889,TRX_N-00124-08151126,2022-05-01T18:16:45,Donostia,Expense,food,-107.54,466.33
buyer_5,Sara,30,ES05209525001173802889,TRX_N-00125-12044667,2022-05-01T18:23:39,Donostia,Expense,cash,-100.0,366.33
buyer_5,Sara,30,ES05209525001173802889,TRX_N-00126-29732176,2022-05-01T08:29:56,Donostia,expenses,children,-118.47,247.86
buyer_5,Sara,30,ES05209525001173802889,TRX_N-00127-10989344,2022-05-03T08:42:29,Donostia,Expense,transport,-57.55,190.31
buyer_5,Sara,30,ES05209525001173802889,TRX_N-00128-21453114,2022-05-03T23:01:21,Donostia,Expense,cash,-100.0,90.31
buyer_5,Sara,30,ES05209525001173802889,TRX_N-00129-24713256,2022-05-04T20:14:58,Donostia,expenses,mortgage,-726.47,-636.16
buyer_5,Sara,30,ES05209525001173802889,TRX_N-00130-71525197,2022-05-06T16:33:32,Donostia,expenses,water,-24.37,-660.53
buyer_5,Sara,30,ES05209525001173802889,TRX_N-00131-93479938,2022-05-07T09:23:52,Donostia,expenses,electricity,-64.78,-725.31
buyer_5,Sara,30,ES05209525001173802889,TRX_N-00132-74655904,2022-05-08T11:08:57,Donostia,expenses,internet,-42.0,-767.31
buyer_5,Sara,30,ES05209525001173802889,TRX_N-00133-16407679,2022-05-08T23:38:40,Donostia,expenses,gas,-94.45,-861.76
buyer_5,Sara,30,ES05209525001173802889,TRX_N-00134-88881745,2022-05-08T15:53:10,Donostia,expenses,phone,-31.93,-893.69
buyer_5,Sara,30,ES05209525001173802889,TRX_N-00135-49808925,2022-05-11T20:12:34,Arrasate,Expense,repairs,-78.41,-972.1
buyer_5,Sara,30,ES05209525001173802889,TRX_N-00136-76228912,2022-05-14T19:42:02,Donostia,Expense,cash,-100.0,-1072.1
buyer_5,Sara,30,ES05209525001173802889,TRX_N-00137-77481757,2022-05-15T15:56:37,Donostia,Expense,food,-116.32,-1188.42
buyer_5,Sara,30,ES05209525001173802889,TRX_N-00138-86443337,2022-05-15T13:02:49,Donostia,Expense,leisure,-50.36,-1238.78
buyer_5,Sara,30,ES05209525001173802889,TRX_N-00139-33566174,2022-05-16T18:57:55,Donostia,Expense,repairs,-149.63,-1388.41
buyer_5,Sara,30,ES05209525001173802889,TRX_N-00140-57228158,2022-05-17T10:53:29,Donostia,Expense,transport,-74.46,-1462.87
buyer_5,Sara,30,ES05209525001173802889,TRX_N-00141-43744936,2022-05-17T18:28:03,Donostia,Expense,education,-46.17,-1509.04
buyer_5,Sara,30,ES05209525001173802889,TRX_N-00142-80831328,2022-05-18T17:29:00,Donostia,Expense,food,-102.31,-1611.35
buyer_5,Sara,30,ES05209525001173802889,TRX_N-00143-69352015,2022-05-19T07:26:24,Donostia,Expense,leisure,-44.3,-1655.65
buyer_5,Sara,30,ES05209525001173802889,TRX_N-00144-61261349,2022-05-19T23:15:03,Donostia,Expense,clothing,-137.69,-1793.34
buyer_5,Sara,30,ES05209525001173802889,TRX_N-00145-54714690,2022-05-22T16:08:34,Donostia,Expense,healthcare,-87.47,-1880.81
buyer_5,Sara,30,ES05209525001173802889,TRX_N-00146-52851077,2022-05-24T10:25:53,Donostia,Expense,cash,-100.0,-1980.81
buyer_5,Sara,30,ES05209525001173802889,TRX_N-00147-60376379,2022-05-25T17:00:17,Donostia,Expense,transport,-71.58,-2052.39
buyer_5,Sara,30,ES05209525001173802889,TRX_N-00148-29641311,2022-05-29T14:48:33,Donostia,Expense,appliances,-303.91,-2356.3
buyer_5,Sara,30,ES05209525001173802889,TRX_N-00149-23717007,2022-05-31T11:33:56,Hernani,Expense,transport,-86.81,-2443.11
buyer_5,Sara,30,ES05209525001173802889,TRX_N-00150-44392960,2022-06-01T22:08:43,Donostia,incomes,salary,1350.89,-1092.22
buyer_5,Sara,30,ES05209525001173802889,TRX_N-00151-08722765,2022-06-01T22:08:43,Donostia,incomes,salary_partner,1138.18,45.96
buyer_5,Sara,30,ES05209525001173802889,TRX_N-00152-79883720,2022-06-01T22:08:43,Donostia,incomes,salary_bonus,1033.8,1079.76
buyer_5,Sara,30,ES05209525001173802889,TRX_N-00153-61899354,2022-06-01T22:08:43,Donostia,incomes,salary_partner_bonus,818.7,1898.46
buyer_5,Sara,30,ES05209525001173802889,TRX_N-00154-57258276,2022-06-02T18:12:11,Donostia,Expense,healthcare,-100.99,1797.47
buyer_5,Sara,30,ES05209525001173802889,TRX_N-00155-17874839,2022-06-03T04:05:21,Donostia,Expense,cash,-100.0,1697.47
buyer_5,Sara,30,ES05209525001173802889,TRX_N-00156-28154855,2022-06-04T23:32:19,Donostia,expenses,mortgage,-726.47,971.0
buyer_5,Sara,30,ES05209525001173802889,TRX_N-00157-06998637,2022-06-05T15:13:54,Donostia,expenses,internet,-42.0,929.0
buyer_5,Sara,30,ES05209525001173802889,TRX_N-00158-32445007,2022-06-05T09:19:20,Donostia,Expense,travel,-1085.58,-156.58
buyer_5,Sara,30,ES05209525001173802889,TRX_N-00159-29938255,2022-06-07T13:58:04,Donostia,Expense,healthcare,-132.46,-289.04
buyer_5,Sara,30,ES05209525001173802889,TRX_N-00160-08918191,2022-06-08T21:51:31,Donostia,expenses,gas,-31.11,-320.15
buyer_5,Sara,30,ES05209525001173802889,TRX_N-00161-97188608,2022-06-08T16:17:53,Donostia,expenses,water,-36.76,-356.91
buyer_5,Sara,30,ES05209525001173802889,TRX_N-00162-21580918,2022-06-08T15:16:58,Donostia,expenses,electricity,-59.26,-416.17
buyer_5,Sara,30,ES05209525001173802889,TRX_N-00163-33823104,2022-06-08T20:48:48,Donostia,expenses,phone,-42.5,-458.67
buyer_5,Sara,30,ES05209525001173802889,TRX_N-00164-72989969,2022-06-09T15:53:08,Donostia,Expense,cash,-100.0,-558.67
buyer_5,Sara,30,ES05209525001173802889,TRX_N-00165-24155052,2022-06-11T10:30:51,Donostia,Expense,leisure,-55.26,-613.93
buyer_5,Sara,30,ES05209525001173802889,TRX_N-00166-43014421,2022-06-12T17:27:41,Donostia,Expense,leisure,-57.7,-671.63
buyer_5,Sara,30,ES05209525001173802889,TRX_N-00167-61237476,2022-06-13T18:09:40,Donostia,Expense,leisure,-69.32,-740.95
buyer_5,Sara,30,ES05209525001173802889,TRX_N-00168-58043818,2022-06-16T14:32:35,Donostia,Expense,gifts,-397.65,-1138.6
buyer_5,Sara,30,ES05209525001173802889,TRX_N-00169-33134347,2022-06-17T17:21:27,Donostia,Expense,clothing,-66.36,-1204.96
buyer_5,Sara,30,ES05209525001173802889,TRX_N-00170-14488193,2022-06-17T14:51:01,Donostia,Expense,cash,-100.0,-1304.96
buyer_5,Sara,30,ES05209525001173802889,TRX_N-00171-34316686,2022-06-18T08:22:05,Donostia,Expense,education,-78.53,-1383.49
buyer_5,Sara,30,ES05209525001173802889,TRX_N-00172-20649201,2022-06-18T09:35:02,Donostia,Expense,repairs,-193.72,-1577.21
buyer_5,Sara,30,ES05209525001173802889,TRX_N-00173-59932715,2022-06-19T01:24:27,Donostia,Expense,gifts,-838.07,-2415.28
buyer_5,Sara,30,ES05209525001173802889,TRX_N-00174-26654947,2022-06-20T23:36:13,Vitoria-Gasteiz,Expense,food,-65.39,-2480.67
buyer_5,Sara,30,ES05209525001173802889,TRX_N-00175-33907012,2022-06-21T18:34:20,Donostia,Expense,education,-55.78,-2536.45
buyer_5,Sara,30,ES05209525001173802889,TRX_N-00176-12085320,2022-06-23T09:56:11,Donostia,Expense,leisure,-32.08,-2568.53
buyer_5,Sara,30,ES05209525001173802889,TRX_N-00177-36775299,2022-06-24T09:31:43,Basauri,Expense,healthcare,-138.83,-2707.36
buyer_5,Sara,30,ES05209525001173802889,TRX_N-00178-64721118,2022-06-25T09:34:59,Donostia,Expense,cash,-100.0,-2807.36
buyer_5,Sara,30,ES05209525001173802889,TRX_N-00179-08098964,2022-06-26T19:38:46,Donostia,Expense,food,-67.09,-2874.45
buyer_5,Sara,30,ES05209525001173802889,TRX_N-00180-06282292,2022-06-26T22:38:21,Zarautz,Expense,gifts,-294.7,-3169.15
buyer_5,Sara,30,ES05209525001173802889,TRX_N-00181-31714722,2022-06-28T12:38:54,Donostia,Expense,transport,-67.67,-3236.82
buyer_5,Sara,30,ES05209525001173802889,TRX_N-00182-30579850,2022-06-29T08:19:18,Donostia,Expense,clothing,-143.4,-3380.22
buyer_5,Sara,30,ES05209525001173802889,TRX_N-00183-96713629,2022-06-29T09:12:26,Donostia,Expense,cash,-100.0,-3480.22
buyer_5,Sara,30,ES05209525001173802889,TRX_N-00184-77112164,2022-07-01T08:15:31,Donostia,incomes,salary,1350.89,-2129.33
buyer_5,Sara,30,ES05209525001173802889,TRX_N-00185-62224396,2022-07-01T08:15:31,Donostia,incomes,salary_partner,1138.18,-991.15
buyer_5,Sara,30,ES05209525001173802889,TRX_N-00186-75290308,2022-07-01T08:15:31,Donostia,incomes,extra_income,151.29,-839.86
buyer_5,Sara,30,ES05209525001173802889,TRX_N-00187-71130872,2022-07-01T09:08:49,Hernani,Expense,cash,-100.0,-939.86
buyer_5,Sara,30,ES05209525001173802889,TRX_N-00188-38504810,2022-07-01T17:25:20,Hernani,Expense,repairs,-62.78,-1002.64
buyer_5,Sara,30,ES05209525001173802889,TRX_N-00189-75911513,2022-07-02T20:16:14,Donostia,Expense,leisure,-56.77,-1059.41
buyer_5,Sara,30,ES05209525001173802889,TRX_N-00190-16071881,2022-07-04T21:09:27,Donostia,expenses,mortgage,-726.47,-1785.88
buyer_5,Sara,30,ES05209525001173802889,TRX_N-00191-29022263,2022-07-04T12:31:48,Donostia,Expense,appliances,-341.33,-2127.21
buyer_5,Sara,30,ES05209525001173802889,TRX_N-00192-60072287,2022-07-04T12:51:00,Donostia,Expense,repairs,-249.59,-2376.8
buyer_5,Sara,30,ES05209525001173802889,TRX_N-00193-94558848,2022-07-05T10:08:51,Donostia,expenses,water,-36.28,-2413.08
buyer_5,Sara,30,ES05209525001173802889,TRX_N-00194-79060743,2022-07-05T15:40:56,Donostia,expenses,electricity,-55.05,-2468.13
buyer_5,Sara,30,ES05209525001173802889,TRX_N-00195-02343747,2022-07-05T19:53:55,Donostia,expenses,internet,-42.0,-2510.13
buyer_5,Sara,30,ES05209525001173802889,TRX_N-00196-88022599,2022-07-05T14:51:36,Donostia,Expense,clothing,-61.87,-2572.0
buyer_5,Sara,30,ES05209525001173802889,TRX_N-00197-37723761,2022-07-06T17:44:04,Elciego,Expense,food,-76.72,-2648.72
buyer_5,Sara,30,ES05209525001173802889,TRX_N-00198-75001013,2022-07-07T16:06:03,Donostia,Expense,clothing,-139.38,-2788.1
buyer_5,Sara,30,ES05209525001173802889,TRX_N-00199-31806443,2022-07-08T08:45:16,Donostia,expenses,gas,-85.88,-2873.98
buyer_5,Sara,30,ES05209525001173802889,TRX_N-00200-43950575,2022-07-08T18:53:33,Donostia,expenses,phone,-39.54,-2913.52
buyer_5,Sara,30,ES05209525001173802889,TRX_N-00201-73075604,2022-07-08T11:42:36,Alegr√≠a-Dulantzi,Expense,education,-42.39,-2955.91
buyer_5,Sara,30,ES05209525001173802889,TRX_N-00202-55594626,2022-07-08T14:35:15,Alegr√≠a-Dulantzi,Expense,cash,-100.0,-3055.91
buyer_5,Sara,30,ES05209525001173802889,TRX_N-00203-59544160,2022-07-09T20:21:19,Donostia,expenses,children,-264.89,-3320.8
buyer_5,Sara,30,ES05209525001173802889,TRX_N-00204-56330738,2022-07-10T16:01:35,Donostia,Expense,transport,-44.38,-3365.18
buyer_5,Sara,30,ES05209525001173802889,TRX_N-00205-98764274,2022-07-11T14:50:32,Donostia,Expense,leisure,-50.47,-3415.65
buyer_5,Sara,30,ES05209525001173802889,TRX_N-00206-23244597,2022-07-13T14:44:59,Donostia,Expense,food,-79.46,-3495.11
buyer_5,Sara,30,ES05209525001173802889,TRX_N-00207-33514051,2022-07-14T12:47:06,Alegr√≠a-Dulantzi,Expense,education,-58.09,-3553.2
buyer_5,Sara,30,ES05209525001173802889,TRX_N-00208-46232065,2022-07-16T04:50:56,Donostia,Expense,cash,-100.0,-3653.2
buyer_5,Sara,30,ES05209525001173802889,TRX_N-00209-79032882,2022-07-16T14:42:46,Donostia,expenses,children,-51.22,-3704.42
buyer_5,Sara,30,ES05209525001173802889,TRX_N-00210-94620119,2022-07-17T11:06:26,Donostia,Expense,food,-61.26,-3765.68
buyer_5,Sara,30,ES05209525001173802889,TRX_N-00211-75952113,2022-07-19T17:09:12,Donostia,Expense,food,-101.59,-3867.27
buyer_5,Sara,30,ES05209525001173802889,TRX_N-00212-20827199,2022-07-19T10:05:47,Donostia,expenses,children,-83.99,-3951.26
buyer_5,Sara,30,ES05209525001173802889,TRX_N-00213-75244124,2022-07-22T19:13:21,Donostia,Expense,gifts,-112.5,-4063.76
buyer_5,Sara,30,ES05209525001173802889,TRX_N-00214-02472195,2022-07-24T15:16:21,Donostia,expenses,children,-112.17,-4175.93
buyer_5,Sara,30,ES05209525001173802889,TRX_N-00215-00218577,2022-07-25T11:38:55,Amurrio,Expense,cash,-100.0,-4275.93
buyer_5,Sara,30,ES05209525001173802889,TRX_N-00216-78462764,2022-07-29T08:01:45,Donostia,expenses,children,-223.6,-4499.53
buyer_5,Sara,30,ES05209525001173802889,TRX_N-00217-06543107,2022-07-30T16:01:35,Portugalete,Expense,food,-122.26,-4621.79
buyer_5,Sara,30,ES05209525001173802889,TRX_N-00218-25248777,2022-07-30T09:51:54,Donostia,expenses,children,-51.79,-4673.58
buyer_5,Sara,30,ES05209525001173802889,TRX_N-00219-57533051,2022-07-31T11:04:20,Donostia,Expense,cash,-100.0,-4773.58
buyer_5,Sara,30,ES05209525001173802889,TRX_N-00220-63943704,2022-07-31T10:57:31,Donostia,expenses,children,-72.88,-4846.46
buyer_5,Sara,30,ES05209525001173802889,TRX_N-00221-81708942,2022-08-01T20:40:30,Donostia,incomes,salary,1350.89,-3495.57
buyer_5,Sara,30,ES05209525001173802889,TRX_N-00222-12361834,2022-08-01T20:40:30,Donostia,incomes,salary_partner,1138.18,-2357.39
buyer_5,Sara,30,ES05209525001173802889,TRX_N-00223-29129327,2022-08-01T02:12:27,Donostia,Expense,education,-58.69,-2416.08
buyer_5,Sara,30,ES05209525001173802889,TRX_N-00224-53389440,2022-08-04T08:32:29,Donostia,expenses,mortgage,-726.47,-3142.55
buyer_5,Sara,30,ES05209525001173802889,TRX_N-00225-16242335,2022-08-04T08:55:43,Donostia,Expense,cash,-100.0,-3242.55
buyer_5,Sara,30,ES05209525001173802889,TRX_N-00226-71430549,2022-08-05T17:28:41,Donostia,expenses,internet,-42.0,-3284.55
buyer_5,Sara,30,ES05209525001173802889,TRX_N-00227-03938846,2022-08-05T05:36:36,Donostia,Expense,cash,-100.0,-3384.55
buyer_5,Sara,30,ES05209525001173802889,TRX_N-00228-26053170,2022-08-06T20:41:13,Donostia,Expense,education,-56.8,-3441.35
buyer_5,Sara,30,ES05209525001173802889,TRX_N-00229-14201525,2022-08-07T22:53:04,Donostia,expenses,gas,-86.02,-3527.37
buyer_5,Sara,30,ES05209525001173802889,TRX_N-00230-63181460,2022-08-07T12:51:37,Vitoria-Gasteiz,Expense,clothing,-128.39,-3655.76
buyer_5,Sara,30,ES05209525001173802889,TRX_N-00231-52667500,2022-08-08T01:31:03,Donostia,expenses,electricity,-40.81,-3696.57
buyer_5,Sara,30,ES05209525001173802889,TRX_N-00232-51077910,2022-08-08T16:53:10,Donostia,expenses,water,-35.96,-3732.53
buyer_5,Sara,30,ES05209525001173802889,TRX_N-00233-91925302,2022-08-08T15:25:05,Donostia,expenses,phone,-30.68,-3763.21
buyer_5,Sara,30,ES05209525001173802889,TRX_N-00234-82812211,2022-08-08T14:22:00,Donostia,Expense,transport,-76.91,-3840.12
buyer_5,Sara,30,ES05209525001173802889,TRX_N-00235-43561958,2022-08-10T06:09:06,Alegr√≠a-Dulantzi,Expense,clothing,-105.62,-3945.74
buyer_5,Sara,30,ES05209525001173802889,TRX_N-00236-08129297,2022-08-11T14:12:53,Donostia,Expense,transport,-79.43,-4025.17
buyer_5,Sara,30,ES05209525001173802889,TRX_N-00237-55329712,2022-08-13T10:18:34,Donostia,Expense,food,-117.63,-4142.8
buyer_5,Sara,30,ES05209525001173802889,TRX_N-00238-03915965,2022-08-13T10:05:35,Donostia,Expense,travel,-1681.61,-5824.41
buyer_5,Sara,30,ES05209525001173802889,TRX_N-00239-80898440,2022-08-13T14:36:04,Donostia,Expense,appliances,-192.76,-6017.17
buyer_5,Sara,30,ES05209525001173802889,TRX_N-00240-02029450,2022-08-13T09:44:45,Oy√≥n-Oion,Expense,repairs,-154.37,-6171.54
buyer_5,Sara,30,ES05209525001173802889,TRX_N-00241-64196393,2022-08-17T22:30:46,Oy√≥n-Oion,Expense,leisure,-64.14,-6235.68
buyer_5,Sara,30,ES05209525001173802889,TRX_N-00242-68789203,2022-08-17T09:35:39,Donostia,Expense,gifts,-335.39,-6571.07
buyer_5,Sara,30,ES05209525001173802889,TRX_N-00243-04380835,2022-08-18T14:54:18,Donostia,Expense,food,-71.26,-6642.33
buyer_5,Sara,30,ES05209525001173802889,TRX_N-00244-06115656,2022-08-19T17:29:02,Donostia,expenses,children,-273.88,-6916.21
buyer_5,Sara,30,ES05209525001173802889,TRX_N-00245-67472672,2022-08-20T11:03:08,Donostia,Expense,food,-110.98,-7027.19
buyer_5,Sara,30,ES05209525001173802889,TRX_N-00246-96420850,2022-08-20T10:13:32,Donostia,Expense,leisure,-23.39,-7050.58
buyer_5,Sara,30,ES05209525001173802889,TRX_N-00247-83289314,2022-08-20T11:58:59,Donostia,Expense,cash,-100.0,-7150.58
buyer_5,Sara,30,ES05209525001173802889,TRX_N-00248-68911323,2022-08-21T13:43:25,Donostia,Expense,repairs,-276.35,-7426.93
buyer_5,Sara,30,ES05209525001173802889,TRX_N-00249-30698796,2022-08-22T15:03:01,Donostia,Expense,transport,-51.18,-7478.11
buyer_5,Sara,30,ES05209525001173802889,TRX_N-00250-10760020,2022-08-22T13:12:19,Donostia,Expense,clothing,-68.03,-7546.14
buyer_5,Sara,30,ES05209525001173802889,TRX_N-00251-53707511,2022-08-24T19:48:30,Donostia,Expense,education,-59.96,-7606.1
buyer_5,Sara,30,ES05209525001173802889,TRX_N-00252-28681160,2022-08-25T15:56:40,Donostia,Expense,leisure,-37.53,-7643.63
buyer_5,Sara,30,ES05209525001173802889,TRX_N-00253-91825576,2022-08-25T19:59:26,Durango,Expense,gifts,-638.42,-8282.05
buyer_5,Sara,30,ES05209525001173802889,TRX_N-00254-74904425,2022-08-25T05:53:32,Donostia,expenses,children,-143.89,-8425.94
buyer_5,Sara,30,ES05209525001173802889,TRX_N-00255-74469365,2022-08-26T11:29:01,Donostia,Expense,food,-73.12,-8499.06
buyer_5,Sara,30,ES05209525001173802889,TRX_N-00256-86603963,2022-08-26T18:35:11,Donostia,Expense,clothing,-125.04,-8624.1
buyer_5,Sara,30,ES05209525001173802889,TRX_N-00257-50333672,2022-08-30T22:57:48,Donostia,Expense,transport,-65.76,-8689.86
buyer_5,Sara,30,ES05209525001173802889,TRX_N-00258-00778432,2022-08-31T16:37:05,Donostia,Expense,clothing,-74.88,-8764.74
buyer_5,Sara,30,ES05209525001173802889,TRX_N-00259-41547755,2022-09-01T15:00:34,Donostia,incomes,salary,1350.89,-7413.85
buyer_5,Sara,30,ES05209525001173802889,TRX_N-00260-19872827,2022-09-01T15:00:34,Donostia,incomes,salary_partner,1138.18,-6275.67
buyer_5,Sara,30,ES05209525001173802889,TRX_N-00261-54712762,2022-09-01T10:29:18,Donostia,Expense,transport,-80.19,-6355.86
buyer_5,Sara,30,ES05209525001173802889,TRX_N-00262-74859127,2022-09-01T05:24:57,Donostia,Expense,leisure,-30.52,-6386.38
buyer_5,Sara,30,ES05209525001173802889,TRX_N-00263-19996771,2022-09-01T19:01:13,Durango,Expense,repairs,-39.88,-6426.26
buyer_5,Sara,30,ES05209525001173802889,TRX_N-00264-77603405,2022-09-03T15:09:31,Galdakao,Expense,leisure,-76.19,-6502.45
buyer_5,Sara,30,ES05209525001173802889,TRX_N-00265-91616818,2022-09-04T10:49:26,Donostia,expenses,mortgage,-726.47,-7228.92
buyer_5,Sara,30,ES05209525001173802889,TRX_N-00266-08308283,2022-09-05T08:49:00,Donostia,expenses,water,-37.32,-7266.24
buyer_5,Sara,30,ES05209525001173802889,TRX_N-00267-47088839,2022-09-05T10:09:11,Santurtzi,Expense,gifts,-418.12,-7684.36
buyer_5,Sara,30,ES05209525001173802889,TRX_N-00268-74441297,2022-09-08T21:27:14,Donostia,expenses,phone,-40.25,-7724.61
buyer_5,Sara,30,ES05209525001173802889,TRX_N-00269-85700101,2022-09-08T14:28:04,Donostia,expenses,electricity,-41.01,-7765.62
buyer_5,Sara,30,ES05209525001173802889,TRX_N-00270-33494941,2022-09-08T12:12:02,Donostia,expenses,gas,-65.02,-7830.64
buyer_5,Sara,30,ES05209525001173802889,TRX_N-00271-68777086,2022-09-08T16:30:31,Donostia,expenses,internet,-42.0,-7872.64
buyer_5,Sara,30,ES05209525001173802889,TRX_N-00272-72645322,2022-09-08T16:48:00,Donostia,Expense,healthcare,-179.99,-8052.63
buyer_5,Sara,30,ES05209525001173802889,TRX_N-00273-27303074,2022-09-08T08:11:41,Donostia,expenses,children,-196.84,-8249.47
buyer_5,Sara,30,ES05209525001173802889,TRX_N-00274-98646922,2022-09-09T14:49:21,Donostia,Expense,gifts,-713.39,-8962.86
buyer_5,Sara,30,ES05209525001173802889,TRX_N-00275-02260500,2022-09-10T08:26:59,Donostia,Expense,clothing,-46.62,-9009.48
buyer_5,Sara,30,ES05209525001173802889,TRX_N-00276-12402072,2022-09-11T09:11:52,Donostia,Expense,food,-72.86,-9082.34
buyer_5,Sara,30,ES05209525001173802889,TRX_N-00277-22087940,2022-09-13T15:31:55,Donostia,Expense,leisure,-68.85,-9151.19
buyer_5,Sara,30,ES05209525001173802889,TRX_N-00278-01664243,2022-09-16T20:36:03,Donostia,Expense,healthcare,-63.3,-9214.49
buyer_5,Sara,30,ES05209525001173802889,TRX_N-00279-75438899,2022-09-17T17:45:04,Donostia,Expense,leisure,-25.95,-9240.44
buyer_5,Sara,30,ES05209525001173802889,TRX_N-00280-90972479,2022-09-17T11:20:19,Donostia,Expense,education,-47.96,-9288.4
buyer_5,Sara,30,ES05209525001173802889,TRX_N-00281-09219818,2022-09-17T09:57:32,Donostia,Expense,cash,-100.0,-9388.4
buyer_5,Sara,30,ES05209525001173802889,TRX_N-00282-32619307,2022-09-18T13:05:53,Donostia,Expense,travel,-500.59,-9888.99
buyer_5,Sara,30,ES05209525001173802889,TRX_N-00283-29862527,2022-09-21T20:26:27,Donostia,Expense,clothing,-60.96,-9949.95
buyer_5,Sara,30,ES05209525001173802889,TRX_N-00284-61105305,2022-09-21T11:57:18,Donostia,Expense,healthcare,-129.23,-10079.18
buyer_5,Sara,30,ES05209525001173802889,TRX_N-00285-24581953,2022-09-21T10:27:23,Donostia,Expense,repairs,-238.97,-10318.15
buyer_5,Sara,30,ES05209525001173802889,TRX_N-00286-74277406,2022-09-22T20:28:38,Donostia,Expense,transport,-77.8,-10395.95
buyer_5,Sara,30,ES05209525001173802889,TRX_N-00287-10792345,2022-09-22T10:00:36,Donostia,Expense,cash,-100.0,-10495.95
buyer_5,Sara,30,ES05209525001173802889,TRX_N-00288-09539623,2022-09-24T19:37:12,Donostia,Expense,gifts,-425.54,-10921.49
buyer_5,Sara,30,ES05209525001173802889,TRX_N-00289-07378786,2022-09-26T19:56:20,Donostia,Expense,transport,-42.76,-10964.25
buyer_5,Sara,30,ES05209525001173802889,TRX_N-00290-58865963,2022-09-26T14:04:24,Donostia,Expense,cash,-100.0,-11064.25
buyer_5,Sara,30,ES05209525001173802889,TRX_N-00291-06569246,2022-09-27T18:54:36,Donostia,Expense,food,-80.42,-11144.67
buyer_5,Sara,30,ES05209525001173802889,TRX_N-00292-11971437,2022-09-28T19:38:38,Donostia,Expense,cash,-100.0,-11244.67
buyer_5,Sara,30,ES05209525001173802889,TRX_N-00293-35883544,2022-09-28T15:22:17,Donostia,Expense,appliances,-272.29,-11516.96
buyer_5,Sara,30,ES05209525001173802889,TRX_N-00294-47263602,2022-09-29T11:40:39,Donostia,Expense,cash,-100.0,-11616.96
buyer_5,Sara,30,ES05209525001173802889,TRX_N-00295-61858853,2022-10-01T12:57:44,Donostia,incomes,salary,1350.89,-10266.07
buyer_5,Sara,30,ES05209525001173802889,TRX_N-00296-37927066,2022-10-01T12:57:44,Donostia,incomes,salary_partner,1138.18,-9127.89
buyer_5,Sara,30,ES05209525001173802889,TRX_N-00297-78921098,2022-10-01T14:17:23,Donostia,Expense,cash,-100.0,-9227.89
buyer_5,Sara,30,ES05209525001173802889,TRX_N-00298-19904992,2022-10-02T21:59:43,Donostia,Expense,leisure,-32.65,-9260.54
buyer_5,Sara,30,ES05209525001173802889,TRX_N-00299-74202522,2022-10-02T18:01:29,Donostia,Expense,cash,-100.0,-9360.54
buyer_5,Sara,30,ES05209525001173802889,TRX_N-00300-26651730,2022-10-03T13:42:40,Donostia,Expense,leisure,-51.12,-9411.66
buyer_5,Sara,30,ES05209525001173802889,TRX_N-00301-94369899,2022-10-03T13:44:33,Andoain,Expense,gifts,-158.16,-9569.82
buyer_5,Sara,30,ES05209525001173802889,TRX_N-00302-84330950,2022-10-04T09:02:52,Donostia,expenses,mortgage,-726.47,-10296.29
buyer_5,Sara,30,ES05209525001173802889,TRX_N-00303-03054970,2022-10-04T10:39:04,Portugalete,Expense,leisure,-72.09,-10368.38
buyer_5,Sara,30,ES05209525001173802889,TRX_N-00304-96352585,2022-10-05T13:36:30,Donostia,expenses,electricity,-49.21,-10417.59
buyer_5,Sara,30,ES05209525001173802889,TRX_N-00305-74153240,2022-10-05T17:30:14,Donostia,expenses,phone,-40.92,-10458.51
buyer_5,Sara,30,ES05209525001173802889,TRX_N-00306-72157991,2022-10-06T08:35:20,Donostia,Expense,leisure,-29.51,-10488.02
buyer_5,Sara,30,ES05209525001173802889,TRX_N-00307-33832833,2022-10-06T10:26:25,Donostia,Expense,cash,-100.0,-10588.02
buyer_5,Sara,30,ES05209525001173802889,TRX_N-00308-08537563,2022-10-07T12:23:25,Donostia,expenses,gas,-34.63,-10622.65
buyer_5,Sara,30,ES05209525001173802889,TRX_N-00309-23541664,2022-10-07T15:15:09,Donostia,Expense,clothing,-58.03,-10680.68
buyer_5,Sara,30,ES05209525001173802889,TRX_N-00310-13787368,2022-10-07T17:25:34,Donostia,Expense,cash,-100.0,-10780.68
buyer_5,Sara,30,ES05209525001173802889,TRX_N-00311-28830166,2022-10-08T09:14:34,Donostia,expenses,water,-40.93,-10821.61
buyer_5,Sara,30,ES05209525001173802889,TRX_N-00312-24234870,2022-10-08T08:24:57,Donostia,expenses,internet,-42.0,-10863.61
buyer_5,Sara,30,ES05209525001173802889,TRX_N-00313-07371664,2022-10-08T09:40:18,Donostia,Expense,food,-82.37,-10945.98
buyer_5,Sara,30,ES05209525001173802889,TRX_N-00314-47546758,2022-10-09T16:58:53,Donostia,Expense,appliances,-147.92,-11093.9
buyer_5,Sara,30,ES05209525001173802889,TRX_N-00315-95704074,2022-10-09T17:39:22,Donostia,expenses,children,-65.25,-11159.15
buyer_5,Sara,30,ES05209525001173802889,TRX_N-00316-03543049,2022-10-12T21:56:02,Donostia,Expense,transport,-88.58,-11247.73
buyer_5,Sara,30,ES05209525001173802889,TRX_N-00317-40542532,2022-10-12T17:15:16,Donostia,Expense,repairs,-50.39,-11298.12
buyer_5,Sara,30,ES05209525001173802889,TRX_N-00318-63667398,2022-10-12T08:54:39,Donostia,expenses,children,-249.15,-11547.27
buyer_5,Sara,30,ES05209525001173802889,TRX_N-00319-46334302,2022-10-13T12:27:56,Donostia,Expense,travel,-679.89,-12227.16
buyer_5,Sara,30,ES05209525001173802889,TRX_N-00320-34470055,2022-10-16T02:58:24,Donostia,Expense,food,-86.14,-12313.3
buyer_5,Sara,30,ES05209525001173802889,TRX_N-00321-54919960,2022-10-16T03:02:57,Elciego,Expense,transport,-42.1,-12355.4
buyer_5,Sara,30,ES05209525001173802889,TRX_N-00322-64258306,2022-10-17T11:43:07,Donostia,Expense,cash,-100.0,-12455.4
buyer_5,Sara,30,ES05209525001173802889,TRX_N-00323-90425058,2022-10-19T19:01:42,Donostia,Expense,cash,-100.0,-12555.4
buyer_5,Sara,30,ES05209525001173802889,TRX_N-00324-89240297,2022-10-20T16:26:59,Donostia,Expense,repairs,-166.88,-12722.28
buyer_5,Sara,30,ES05209525001173802889,TRX_N-00325-68857489,2022-10-21T20:13:03,Donostia,Expense,food,-115.85,-12838.13
buyer_5,Sara,30,ES05209525001173802889,TRX_N-00326-02448470,2022-10-21T14:06:04,Donostia,Expense,transport,-66.48,-12904.61
buyer_5,Sara,30,ES05209525001173802889,TRX_N-00327-19515816,2022-10-21T17:49:22,Donostia,Expense,repairs,-78.55,-12983.16
buyer_5,Sara,30,ES05209525001173802889,TRX_N-00328-82997959,2022-10-22T09:09:15,Pasaia,Expense,cash,-100.0,-13083.16
buyer_5,Sara,30,ES05209525001173802889,TRX_N-00329-08438519,2022-10-23T13:45:08,Leioa,Expense,food,-114.43,-13197.59
buyer_5,Sara,30,ES05209525001173802889,TRX_N-00330-41584535,2022-10-23T15:39:54,Amurrio,Expense,clothing,-92.46,-13290.05
buyer_5,Sara,30,ES05209525001173802889,TRX_N-00331-89778098,2022-10-24T11:41:45,Donostia,Expense,education,-51.13,-13341.18
buyer_5,Sara,30,ES05209525001173802889,TRX_N-00332-99916250,2022-10-24T19:54:33,Donostia,Expense,gifts,-660.79,-14001.97
buyer_5,Sara,30,ES05209525001173802889,TRX_N-00333-26668727,2022-10-25T14:36:58,Erandio,Expense,education,-70.79,-14072.76
buyer_5,Sara,30,ES05209525001173802889,TRX_N-00334-18011496,2022-10-26T08:09:52,Donostia,Expense,transport,-89.09,-14161.85
buyer_5,Sara,30,ES05209525001173802889,TRX_N-00335-14881623,2022-10-27T01:34:12,Donostia,Expense,food,-116.42,-14278.27
buyer_5,Sara,30,ES05209525001173802889,TRX_N-00336-01055908,2022-10-28T16:34:29,Donostia,Expense,food,-72.47,-14350.74
buyer_5,Sara,30,ES05209525001173802889,TRX_N-00337-65935245,2022-10-28T10:06:22,Donostia,Expense,transport,-52.1,-14402.84
buyer_5,Sara,30,ES05209525001173802889,TRX_N-00338-85554746,2022-10-29T10:32:20,Donostia,Expense,leisure,-49.66,-14452.5
buyer_5,Sara,30,ES05209525001173802889,TRX_N-00339-04354417,2022-10-29T12:21:33,Donostia,Expense,gifts,-672.13,-15124.63
buyer_5,Sara,30,ES05209525001173802889,TRX_N-00340-12809861,2022-10-30T20:42:34,Donostia,Expense,cash,-100.0,-15224.63
buyer_5,Sara,30,ES05209525001173802889,TRX_N-00341-20847948,2022-10-31T12:37:29,Alegr√≠a-Dulantzi,Expense,food,-68.11,-15292.74
buyer_5,Sara,30,ES05209525001173802889,TRX_N-00342-37070921,2022-10-31T08:24:30,Donostia,Expense,education,-61.04,-15353.78
buyer_5,Sara,30,ES05209525001173802889,TRX_N-00343-04293172,2022-11-01T12:35:55,Donostia,incomes,salary,1350.89,-14002.89
buyer_5,Sara,30,ES05209525001173802889,TRX_N-00344-53087964,2022-11-01T12:35:55,Donostia,incomes,salary_partner,1138.18,-12864.71
buyer_5,Sara,30,ES05209525001173802889,TRX_N-00345-22702745,2022-11-01T12:35:55,Donostia,incomes,extra_income,151.29,-12713.42
buyer_5,Sara,30,ES05209525001173802889,TRX_N-00346-40865080,2022-11-01T15:24:06,Donostia,Expense,cash,-100.0,-12813.42
buyer_5,Sara,30,ES05209525001173802889,TRX_N-00347-66335132,2022-11-04T16:05:30,Donostia,expenses,mortgage,-726.47,-13539.89
buyer_5,Sara,30,ES05209525001173802889,TRX_N-00348-07133254,2022-11-05T23:02:48,Donostia,expenses,water,-35.23,-13575.12
buyer_5,Sara,30,ES05209525001173802889,TRX_N-00349-61378646,2022-11-06T12:14:08,Donostia,expenses,electricity,-87.82,-13662.94
buyer_5,Sara,30,ES05209525001173802889,TRX_N-00350-96038194,2022-11-06T10:55:48,Donostia,Expense,food,-112.05,-13774.99
buyer_5,Sara,30,ES05209525001173802889,TRX_N-00351-65858990,2022-11-06T14:14:01,Donostia,Expense,leisure,-44.42,-13819.41
buyer_5,Sara,30,ES05209525001173802889,TRX_N-00352-85411530,2022-11-07T10:20:59,Donostia,expenses,gas,-110.74,-13930.15
buyer_5,Sara,30,ES05209525001173802889,TRX_N-00353-35102872,2022-11-08T15:08:51,Donostia,expenses,internet,-42.0,-13972.15
buyer_5,Sara,30,ES05209525001173802889,TRX_N-00354-10646616,2022-11-08T11:16:44,Donostia,expenses,phone,-44.32,-14016.47
buyer_5,Sara,30,ES05209525001173802889,TRX_N-00355-10329143,2022-11-10T20:11:48,Galdakao,Expense,food,-123.14,-14139.61
buyer_5,Sara,30,ES05209525001173802889,TRX_N-00356-61169446,2022-11-10T11:54:15,Andoain,Expense,cash,-100.0,-14239.61
buyer_5,Sara,30,ES05209525001173802889,TRX_N-00357-95611630,2022-11-11T18:41:41,Donostia,Expense,food,-76.09,-14315.7
buyer_5,Sara,30,ES05209525001173802889,TRX_N-00358-22058133,2022-11-14T16:04:19,Donostia,Expense,cash,-100.0,-14415.7
buyer_5,Sara,30,ES05209525001173802889,TRX_N-00359-02090143,2022-11-15T20:01:05,Donostia,Expense,transport,-87.75,-14503.45
buyer_5,Sara,30,ES05209525001173802889,TRX_N-00360-04045770,2022-11-15T10:01:16,Donostia,Expense,leisure,-49.66,-14553.11
buyer_5,Sara,30,ES05209525001173802889,TRX_N-00361-28844940,2022-11-15T17:20:37,Donostia,Expense,cash,-100.0,-14653.11
buyer_5,Sara,30,ES05209525001173802889,TRX_N-00362-49423548,2022-11-15T17:49:39,Donostia,expenses,children,-126.55,-14779.66
buyer_5,Sara,30,ES05209525001173802889,TRX_N-00363-34690744,2022-11-16T16:19:49,Donostia,Expense,clothing,-142.47,-14922.13
buyer_5,Sara,30,ES05209525001173802889,TRX_N-00364-95319457,2022-11-16T17:54:20,Donostia,Expense,appliances,-206.13,-15128.26
buyer_5,Sara,30,ES05209525001173802889,TRX_N-00365-77818343,2022-11-17T22:10:23,Donostia,Expense,food,-73.3,-15201.56
buyer_5,Sara,30,ES05209525001173802889,TRX_N-00366-01001502,2022-11-18T09:12:37,Donostia,Expense,food,-75.34,-15276.9
buyer_5,Sara,30,ES05209525001173802889,TRX_N-00367-01389348,2022-11-19T17:22:10,Lasarte-Oria,Expense,healthcare,-94.84,-15371.74
buyer_5,Sara,30,ES05209525001173802889,TRX_N-00368-77255703,2022-11-20T12:09:05,Donostia,Expense,transport,-76.47,-15448.21
buyer_5,Sara,30,ES05209525001173802889,TRX_N-00369-85173295,2022-11-20T16:37:12,Donostia,Expense,cash,-100.0,-15548.21
buyer_5,Sara,30,ES05209525001173802889,TRX_N-00370-38762496,2022-11-22T13:42:55,Donostia,Expense,gifts,-565.91,-16114.12
buyer_5,Sara,30,ES05209525001173802889,TRX_N-00371-63709424,2022-11-23T09:41:52,Donostia,Expense,cash,-100.0,-16214.12
buyer_5,Sara,30,ES05209525001173802889,TRX_N-00372-86392805,2022-11-25T17:33:31,Donostia,Expense,appliances,-201.36,-16415.48
buyer_5,Sara,30,ES05209525001173802889,TRX_N-00373-54391801,2022-11-26T14:58:12,Donostia,Expense,food,-118.04,-16533.52
buyer_5,Sara,30,ES05209525001173802889,TRX_N-00374-07191725,2022-11-26T14:16:49,Portugalete,Expense,transport,-61.32,-16594.84
buyer_5,Sara,30,ES05209525001173802889,TRX_N-00375-73152625,2022-11-26T20:31:45,Donostia,Expense,cash,-100.0,-16694.84
buyer_5,Sara,30,ES05209525001173802889,TRX_N-00376-57905790,2022-11-27T19:22:20,Donostia,Expense,leisure,-77.64,-16772.48
buyer_5,Sara,30,ES05209525001173802889,TRX_N-00377-08764102,2022-12-01T09:50:40,Donostia,incomes,salary,1350.89,-15421.59
buyer_5,Sara,30,ES05209525001173802889,TRX_N-00378-53659664,2022-12-01T09:50:40,Donostia,incomes,salary_partner,1138.18,-14283.41
buyer_5,Sara,30,ES05209525001173802889,TRX_N-00379-83738513,2022-12-01T09:50:40,Donostia,incomes,salary_bonus,1055.17,-13228.24
buyer_5,Sara,30,ES05209525001173802889,TRX_N-00380-68553928,2022-12-01T09:50:40,Donostia,incomes,salary_partner_bonus,910.0,-12318.24
buyer_5,Sara,30,ES05209525001173802889,TRX_N-00381-63881130,2022-12-01T17:40:22,Donostia,Expense,cash,-100.0,-12418.24
buyer_5,Sara,30,ES05209525001173802889,TRX_N-00382-23236352,2022-12-04T09:03:24,Donostia,expenses,mortgage,-726.47,-13144.71
buyer_5,Sara,30,ES05209525001173802889,TRX_N-00383-39018004,2022-12-04T10:14:11,Donostia,Expense,transport,-49.85,-13194.56
buyer_5,Sara,30,ES05209525001173802889,TRX_N-00384-24330412,2022-12-05T18:35:55,Donostia,expenses,gas,-44.7,-13239.26
buyer_5,Sara,30,ES05209525001173802889,TRX_N-00385-12523897,2022-12-06T19:50:03,Donostia,expenses,internet,-42.0,-13281.26
buyer_5,Sara,30,ES05209525001173802889,TRX_N-00386-05573928,2022-12-06T09:47:54,Donostia,Expense,food,-98.0,-13379.26
buyer_5,Sara,30,ES05209525001173802889,TRX_N-00387-25383616,2022-12-07T12:34:13,Donostia,expenses,phone,-37.13,-13416.39
buyer_5,Sara,30,ES05209525001173802889,TRX_N-00388-30930904,2022-12-08T17:56:25,Donostia,expenses,water,-36.62,-13453.01
buyer_5,Sara,30,ES05209525001173802889,TRX_N-00389-40463119,2022-12-08T14:14:08,Donostia,expenses,electricity,-26.18,-13479.19
buyer_5,Sara,30,ES05209525001173802889,TRX_N-00390-31305001,2022-12-09T16:40:42,Bilbao,Expense,cash,-100.0,-13579.19
buyer_5,Sara,30,ES05209525001173802889,TRX_N-00391-02235502,2022-12-10T21:58:17,Donostia,Expense,gifts,-30.62,-13609.81
buyer_5,Sara,30,ES05209525001173802889,TRX_N-00392-24591475,2022-12-11T14:28:07,Donostia,Expense,education,-54.46,-13664.27
buyer_5,Sara,30,ES05209525001173802889,TRX_N-00393-60857359,2022-12-12T05:51:09,Donostia,Expense,repairs,-150.7,-13814.97
buyer_5,Sara,30,ES05209525001173802889,TRX_N-00394-93394901,2022-12-14T04:33:04,Donostia,Expense,cash,-100.0,-13914.97
buyer_5,Sara,30,ES05209525001173802889,TRX_N-00395-26577399,2022-12-14T16:45:30,Donostia,Expense,gifts,-584.2,-14499.17
buyer_5,Sara,30,ES05209525001173802889,TRX_N-00396-22836370,2022-12-16T08:43:18,Donostia,expenses,children,-187.34,-14686.51
buyer_5,Sara,30,ES05209525001173802889,TRX_N-00397-62561306,2022-12-17T16:16:43,Donostia,Expense,appliances,-319.81,-15006.32
buyer_5,Sara,30,ES05209525001173802889,TRX_N-00398-56526894,2022-12-18T16:01:11,Donostia,Expense,healthcare,-95.63,-15101.95
buyer_5,Sara,30,ES05209525001173802889,TRX_N-00399-11422335,2022-12-18T12:29:46,Donostia,Expense,travel,-517.21,-15619.16
buyer_5,Sara,30,ES05209525001173802889,TRX_N-00400-79997517,2022-12-19T16:51:31,Donostia,Expense,healthcare,-168.67,-15787.83
buyer_5,Sara,30,ES05209525001173802889,TRX_N-00401-26321450,2022-12-19T20:00:27,Elciego,Expense,repairs,-132.11,-15919.94
buyer_5,Sara,30,ES05209525001173802889,TRX_N-00402-51676501,2022-12-21T09:14:35,Donostia,Expense,education,-52.53,-15972.47
buyer_5,Sara,30,ES05209525001173802889,TRX_N-00403-18837790,2022-12-22T14:32:12,Donostia,Expense,clothing,-114.03,-16086.5
buyer_5,Sara,30,ES05209525001173802889,TRX_N-00404-57783405,2022-12-23T11:26:04,Donostia,Expense,transport,-60.41,-16146.91
buyer_5,Sara,30,ES05209525001173802889,TRX_N-00405-07114439,2022-12-25T09:25:09,Donostia,Expense,transport,-56.4,-16203.31
buyer_5,Sara,30,ES05209525001173802889,TRX_N-00406-20695751,2022-12-26T10:58:10,Donostia,Expense,repairs,-243.59,-16446.9
buyer_5,Sara,30,ES05209525001173802889,TRX_N-00407-76506203,2022-12-28T12:08:35,Donostia,Expense,gifts,-79.84,-16526.74
buyer_5,Sara,30,ES05209525001173802889,TRX_N-00408-97197242,2022-12-31T13:43:11,Donostia,Expense,clothing,-151.22,-16677.96
buyer_5,Sara,30,ES05209525001173802889,TRX_N-00409-74918303,2023-01-01T12:08:37,Donostia,incomes,salary,1380.51,-15297.45
buyer_5,Sara,30,ES05209525001173802889,TRX_N-00410-42685360,2023-01-01T12:08:37,Donostia,incomes,salary_partner,1163.13,-14134.32
buyer_5,Sara,30,ES05209525001173802889,TRX_N-00411-79117077,2023-01-02T07:33:28,Pasaia,Expense,food,-97.45,-14231.77
buyer_5,Sara,30,ES05209525001173802889,TRX_N-00412-09733287,2023-01-04T18:55:12,Donostia,expenses,mortgage,-726.47,-14958.24
buyer_5,Sara,30,ES05209525001173802889,TRX_N-00413-39484405,2023-01-04T08:02:25,Donostia,Expense,clothing,-127.86,-15086.1
buyer_5,Sara,30,ES05209525001173802889,TRX_N-00414-43134945,2023-01-05T09:27:01,Donostia,expenses,water,-40.54,-15126.64
buyer_5,Sara,30,ES05209525001173802889,TRX_N-00415-81817965,2023-01-05T13:09:04,Donostia,expenses,phone,-37.93,-15164.57
buyer_5,Sara,30,ES05209525001173802889,TRX_N-00416-86069612,2023-01-05T16:01:22,Donostia,Expense,food,-84.26,-15248.83
buyer_5,Sara,30,ES05209525001173802889,TRX_N-00417-44385298,2023-01-05T17:52:22,Durango,Expense,cash,-100.0,-15348.83
buyer_5,Sara,30,ES05209525001173802889,TRX_N-00418-03887724,2023-01-06T22:48:27,Donostia,expenses,internet,-42.0,-15390.83
buyer_5,Sara,30,ES05209525001173802889,TRX_N-00419-92885098,2023-01-06T18:53:10,Donostia,Expense,appliances,-193.16,-15583.99
buyer_5,Sara,30,ES05209525001173802889,TRX_N-00420-90959616,2023-01-07T15:13:04,Donostia,Expense,cash,-100.0,-15683.99
buyer_5,Sara,30,ES05209525001173802889,TRX_N-00421-14111776,2023-01-08T09:49:10,Donostia,expenses,electricity,-30.44,-15714.43
buyer_5,Sara,30,ES05209525001173802889,TRX_N-00422-23652479,2023-01-08T15:50:55,Donostia,expenses,gas,-106.45,-15820.88
buyer_5,Sara,30,ES05209525001173802889,TRX_N-00423-61396195,2023-01-09T15:00:10,Donostia,Expense,repairs,-301.65,-16122.53
buyer_5,Sara,30,ES05209525001173802889,TRX_N-00424-41903819,2023-01-10T19:56:42,Donostia,Expense,food,-102.97,-16225.5
buyer_5,Sara,30,ES05209525001173802889,TRX_N-00425-00625845,2023-01-11T18:09:21,Donostia,Expense,leisure,-35.95,-16261.45
buyer_5,Sara,30,ES05209525001173802889,TRX_N-00426-00465996,2023-01-11T14:36:29,Iru√±a de Oca,Expense,appliances,-98.92,-16360.37
buyer_5,Sara,30,ES05209525001173802889,TRX_N-00427-04284549,2023-01-13T10:04:48,Donostia,Expense,education,-69.31,-16429.68
buyer_5,Sara,30,ES05209525001173802889,TRX_N-00428-22539614,2023-01-14T14:33:26,Donostia,Expense,cash,-100.0,-16529.68
buyer_5,Sara,30,ES05209525001173802889,TRX_N-00429-56225599,2023-01-16T11:34:42,Donostia,Expense,repairs,-260.83,-16790.51
buyer_5,Sara,30,ES05209525001173802889,TRX_N-00430-63727235,2023-01-17T02:32:03,Donostia,Expense,food,-91.96,-16882.47
buyer_5,Sara,30,ES05209525001173802889,TRX_N-00431-71053361,2023-01-18T09:42:13,Donostia,Expense,clothing,-51.46,-16933.93
buyer_5,Sara,30,ES05209525001173802889,TRX_N-00432-98134496,2023-01-18T09:48:47,Donostia,expenses,children,-74.45,-17008.38
buyer_5,Sara,30,ES05209525001173802889,TRX_N-00433-09729034,2023-01-19T19:50:18,Iru√±a de Oca,Expense,clothing,-114.63,-17123.01
buyer_5,Sara,30,ES05209525001173802889,TRX_N-00434-47565807,2023-01-19T07:39:53,Donostia,Expense,repairs,-180.86,-17303.87
buyer_5,Sara,30,ES05209525001173802889,TRX_N-00435-41093996,2023-01-20T22:02:02,Durango,Expense,transport,-71.96,-17375.83
buyer_5,Sara,30,ES05209525001173802889,TRX_N-00436-95245077,2023-01-20T09:43:17,Donostia,Expense,travel,-350.9,-17726.73
buyer_5,Sara,30,ES05209525001173802889,TRX_N-00437-04069097,2023-01-22T14:02:16,Donostia,Expense,food,-99.6,-17826.33
buyer_5,Sara,30,ES05209525001173802889,TRX_N-00438-95728096,2023-01-24T14:39:34,Sopela,Expense,leisure,-75.25,-17901.58
buyer_5,Sara,30,ES05209525001173802889,TRX_N-00439-06419667,2023-01-25T06:29:35,Donostia,Expense,food,-124.13,-18025.71
buyer_5,Sara,30,ES05209525001173802889,TRX_N-00440-94254597,2023-01-25T14:25:36,Donostia,Expense,gifts,-302.49,-18328.2
buyer_5,Sara,30,ES05209525001173802889,TRX_N-00441-35010553,2023-01-26T12:42:58,Donostia,Expense,food,-64.83,-18393.03
buyer_5,Sara,30,ES05209525001173802889,TRX_N-00442-92821667,2023-01-26T09:40:34,Vitoria-Gasteiz,Expense,repairs,-196.01,-18589.04
buyer_5,Sara,30,ES05209525001173802889,TRX_N-00443-73309121,2023-01-27T00:26:01,Donostia,Expense,transport,-86.22,-18675.26
buyer_5,Sara,30,ES05209525001173802889,TRX_N-00444-49402964,2023-01-29T09:09:23,Donostia,Expense,cash,-100.0,-18775.26
buyer_5,Sara,30,ES05209525001173802889,TRX_N-00445-68414338,2023-01-31T08:23:47,Donostia,Expense,leisure,-36.58,-18811.84
buyer_5,Sara,30,ES05209525001173802889,TRX_N-00446-51797799,2023-02-01T17:39:36,Donostia,incomes,salary,1380.51,-17431.33
buyer_5,Sara,30,ES05209525001173802889,TRX_N-00447-64564454,2023-02-01T17:39:36,Donostia,incomes,salary_partner,1163.13,-16268.2
buyer_5,Sara,30,ES05209525001173802889,TRX_N-00448-63580645,2023-02-01T15:29:25,Donostia,Expense,transport,-60.93,-16329.13
buyer_5,Sara,30,ES05209525001173802889,TRX_N-00449-53373919,2023-02-01T12:24:42,Donostia,Expense,leisure,-79.59,-16408.72
buyer_5,Sara,30,ES05209525001173802889,TRX_N-00450-88290226,2023-02-02T09:52:08,Donostia,Expense,leisure,-25.31,-16434.03
buyer_5,Sara,30,ES05209525001173802889,TRX_N-00451-76781419,2023-02-03T22:15:56,Donostia,Expense,cash,-100.0,-16534.03
buyer_5,Sara,30,ES05209525001173802889,TRX_N-00452-51422524,2023-02-04T09:42:08,Donostia,expenses,mortgage,-726.47,-17260.5
buyer_5,Sara,30,ES05209525001173802889,TRX_N-00453-12862242,2023-02-05T18:33:52,Donostia,expenses,water,-38.64,-17299.14
buyer_5,Sara,30,ES05209525001173802889,TRX_N-00454-07772104,2023-02-05T13:02:51,Donostia,expenses,internet,-42.0,-17341.14
buyer_5,Sara,30,ES05209525001173802889,TRX_N-00455-44570741,2023-02-05T10:43:24,Errenteria,Expense,cash,-100.0,-17441.14
buyer_5,Sara,30,ES05209525001173802889,TRX_N-00456-02359981,2023-02-06T23:36:29,Donostia,expenses,electricity,-82.83,-17523.97
buyer_5,Sara,30,ES05209525001173802889,TRX_N-00457-57489362,2023-02-06T06:04:40,Donostia,expenses,phone,-38.15,-17562.12
buyer_5,Sara,30,ES05209525001173802889,TRX_N-00458-11199596,2023-02-06T22:23:42,Arrasate,Expense,food,-113.23,-17675.35
buyer_5,Sara,30,ES05209525001173802889,TRX_N-00459-71962669,2023-02-06T13:51:04,Leioa,Expense,repairs,-135.86,-17811.21
buyer_5,Sara,30,ES05209525001173802889,TRX_N-00460-97663059,2023-02-07T15:35:19,Mungia,Expense,repairs,-232.86,-18044.07
buyer_5,Sara,30,ES05209525001173802889,TRX_N-00461-04322637,2023-02-08T10:52:59,Donostia,expenses,gas,-76.91,-18120.98
buyer_5,Sara,30,ES05209525001173802889,TRX_N-00462-16012642,2023-02-08T09:19:59,Donostia,Expense,food,-124.75,-18245.73
buyer_5,Sara,30,ES05209525001173802889,TRX_N-00463-73915551,2023-02-08T09:17:29,Donostia,Expense,leisure,-57.24,-18302.97
buyer_5,Sara,30,ES05209525001173802889,TRX_N-00464-71780229,2023-02-09T14:31:15,Donostia,Expense,appliances,-248.84,-18551.81
buyer_5,Sara,30,ES05209525001173802889,TRX_N-00465-17432895,2023-02-09T23:11:17,Donostia,Expense,gifts,-448.96,-19000.77
buyer_5,Sara,30,ES05209525001173802889,TRX_N-00466-23383085,2023-02-10T19:11:57,Portugalete,Expense,leisure,-81.52,-19082.29
buyer_5,Sara,30,ES05209525001173802889,TRX_N-00467-23125852,2023-02-11T11:51:30,Berango,Expense,food,-101.67,-19183.96
buyer_5,Sara,30,ES05209525001173802889,TRX_N-00468-00388614,2023-02-12T08:26:03,Donostia,Expense,food,-120.78,-19304.74
buyer_5,Sara,30,ES05209525001173802889,TRX_N-00469-02648374,2023-02-13T13:00:40,Hondarribia,Expense,food,-74.26,-19379.0
buyer_5,Sara,30,ES05209525001173802889,TRX_N-00470-12399151,2023-02-13T17:00:16,Donostia,Expense,cash,-100.0,-19479.0
buyer_5,Sara,30,ES05209525001173802889,TRX_N-00471-20597628,2023-02-14T11:11:13,Donostia,Expense,clothing,-52.45,-19531.45
buyer_5,Sara,30,ES05209525001173802889,TRX_N-00472-66287650,2023-02-14T16:08:27,Donostia,expenses,children,-219.22,-19750.67
buyer_5,Sara,30,ES05209525001173802889,TRX_N-00473-11000813,2023-02-15T00:46:46,Donostia,Expense,transport,-41.32,-19791.99
buyer_5,Sara,30,ES05209525001173802889,TRX_N-00474-21932078,2023-02-16T20:31:47,Donostia,Expense,repairs,-135.22,-19927.21
buyer_5,Sara,30,ES05209525001173802889,TRX_N-00475-66857263,2023-02-18T15:06:53,Donostia,Expense,cash,-100.0,-20027.21
buyer_5,Sara,30,ES05209525001173802889,TRX_N-00476-74961979,2023-02-20T07:23:23,Donostia,Expense,food,-72.57,-20099.78
buyer_5,Sara,30,ES05209525001173802889,TRX_N-00477-91215081,2023-02-23T14:41:11,Donostia,Expense,leisure,-33.45,-20133.23
buyer_5,Sara,30,ES05209525001173802889,TRX_N-00478-47686185,2023-02-23T13:20:35,Donostia,Expense,clothing,-71.23,-20204.46
buyer_5,Sara,30,ES05209525001173802889,TRX_N-00479-09307147,2023-02-23T20:12:00,Donostia,expenses,children,-153.61,-20358.07
buyer_5,Sara,30,ES05209525001173802889,TRX_N-00480-80911900,2023-02-25T09:04:16,Leioa,Expense,food,-121.06,-20479.13
buyer_5,Sara,30,ES05209525001173802889,TRX_N-00481-00557334,2023-02-25T21:20:25,Salvatierra/Agurain,Expense,clothing,-94.55,-20573.68
buyer_5,Sara,30,ES05209525001173802889,TRX_N-00482-30763124,2023-02-26T10:54:39,Donostia,Expense,gifts,-476.87,-21050.55
buyer_5,Sara,30,ES05209525001173802889,TRX_N-00483-27963133,2023-02-27T01:35:23,Donostia,Expense,clothing,-82.23,-21132.78
buyer_5,Sara,30,ES05209525001173802889,TRX_N-00484-67260870,2023-03-01T16:58:33,Donostia,incomes,salary,1380.51,-19752.27
buyer_5,Sara,30,ES05209525001173802889,TRX_N-00485-40008978,2023-03-01T16:58:33,Donostia,incomes,salary_partner,1163.13,-18589.14
buyer_5,Sara,30,ES05209525001173802889,TRX_N-00486-40264567,2023-03-01T16:58:33,Donostia,incomes,extra_income,151.29,-18437.85
buyer_5,Sara,30,ES05209525001173802889,TRX_N-00487-66847188,2023-03-01T19:00:32,Donostia,Expense,transport,-46.8,-18484.65
buyer_5,Sara,30,ES05209525001173802889,TRX_N-00488-28708825,2023-03-01T09:57:12,Donostia,Expense,repairs,-267.56,-18752.21
buyer_5,Sara,30,ES05209525001173802889,TRX_N-00489-29942684,2023-03-03T20:40:43,Donostia,Expense,leisure,-45.98,-18798.19
buyer_5,Sara,30,ES05209525001173802889,TRX_N-00490-34384575,2023-03-03T14:56:37,Pasaia,Expense,cash,-100.0,-18898.19
buyer_5,Sara,30,ES05209525001173802889,TRX_N-00491-98407743,2023-03-04T23:47:42,Donostia,expenses,mortgage,-726.47,-19624.66
buyer_5,Sara,30,ES05209525001173802889,TRX_N-00492-33306890,2023-03-04T10:26:31,Santurtzi,Expense,education,-68.25,-19692.91
buyer_5,Sara,30,ES05209525001173802889,TRX_N-00493-19286087,2023-03-05T17:39:44,Donostia,Expense,transport,-63.1,-19756.01
buyer_5,Sara,30,ES05209525001173802889,TRX_N-00494-05603306,2023-03-05T17:57:04,Pasaia,Expense,leisure,-40.42,-19796.43
buyer_5,Sara,30,ES05209525001173802889,TRX_N-00495-05311983,2023-03-05T12:21:44,Donostia,Expense,cash,-100.0,-19896.43
buyer_5,Sara,30,ES05209525001173802889,TRX_N-00496-33817643,2023-03-06T19:29:57,Donostia,expenses,water,-39.91,-19936.34
buyer_5,Sara,30,ES05209525001173802889,TRX_N-00497-94451560,2023-03-06T13:56:55,Donostia,expenses,phone,-39.8,-19976.14
buyer_5,Sara,30,ES05209525001173802889,TRX_N-00498-32804819,2023-03-08T22:21:11,Donostia,expenses,gas,-44.44,-20020.58
buyer_5,Sara,30,ES05209525001173802889,TRX_N-00499-93106925,2023-03-08T23:45:31,Donostia,expenses,electricity,-51.94,-20072.52
buyer_5,Sara,30,ES05209525001173802889,TRX_N-00500-33959267,2023-03-08T09:23:14,Donostia,expenses,internet,-42.0,-20114.52
buyer_5,Sara,30,ES05209525001173802889,TRX_N-00501-71760389,2023-03-08T09:33:17,Donostia,Expense,leisure,-30.84,-20145.36
buyer_5,Sara,30,ES05209525001173802889,TRX_N-00502-26874437,2023-03-09T12:22:29,Donostia,Expense,cash,-100.0,-20245.36
buyer_5,Sara,30,ES05209525001173802889,TRX_N-00503-86776564,2023-03-10T10:38:37,Donostia,Expense,transport,-42.78,-20288.14
buyer_5,Sara,30,ES05209525001173802889,TRX_N-00504-84034261,2023-03-12T09:35:20,Durango,Expense,cash,-100.0,-20388.14
buyer_5,Sara,30,ES05209525001173802889,TRX_N-00505-79452550,2023-03-13T08:44:22,Donostia,Expense,food,-68.73,-20456.87
buyer_5,Sara,30,ES05209525001173802889,TRX_N-00506-66710001,2023-03-13T18:14:49,Donostia,Expense,cash,-100.0,-20556.87
buyer_5,Sara,30,ES05209525001173802889,TRX_N-00507-14691995,2023-03-14T02:48:46,Donostia,Expense,healthcare,-76.7,-20633.57
buyer_5,Sara,30,ES05209525001173802889,TRX_N-00508-13898357,2023-03-14T16:49:48,Amurrio,Expense,cash,-100.0,-20733.57
buyer_5,Sara,30,ES05209525001173802889,TRX_N-00509-33066466,2023-03-15T10:05:17,Donostia,Expense,food,-69.96,-20803.53
buyer_5,Sara,30,ES05209525001173802889,TRX_N-00510-11405196,2023-03-18T08:40:42,Alegr√≠a-Dulantzi,Expense,transport,-80.75,-20884.28
buyer_5,Sara,30,ES05209525001173802889,TRX_N-00511-00567497,2023-03-20T12:30:51,Donostia,Expense,travel,-1708.73,-22593.01
buyer_5,Sara,30,ES05209525001173802889,TRX_N-00512-63699547,2023-03-20T18:29:16,Donostia,Expense,repairs,-267.78,-22860.79
buyer_5,Sara,30,ES05209525001173802889,TRX_N-00513-53996338,2023-03-20T17:42:45,Donostia,Expense,gifts,-183.97,-23044.76
buyer_5,Sara,30,ES05209525001173802889,TRX_N-00514-44660558,2023-03-23T16:40:28,Berango,Expense,leisure,-21.9,-23066.66
buyer_5,Sara,30,ES05209525001173802889,TRX_N-00515-51904625,2023-03-23T18:44:48,Donostia,Expense,cash,-100.0,-23166.66
buyer_5,Sara,30,ES05209525001173802889,TRX_N-00516-91322463,2023-03-23T13:20:52,Donostia,Expense,gifts,-833.77,-24000.43
buyer_5,Sara,30,ES05209525001173802889,TRX_N-00517-78443841,2023-03-27T19:56:29,Donostia,Expense,food,-77.16,-24077.59
buyer_5,Sara,30,ES05209525001173802889,TRX_N-00518-88108946,2023-03-27T22:38:06,Donostia,Expense,travel,-557.34,-24634.93
buyer_5,Sara,30,ES05209525001173802889,TRX_N-00519-29609711,2023-04-01T08:57:56,Donostia,incomes,salary,1380.51,-23254.42
buyer_5,Sara,30,ES05209525001173802889,TRX_N-00520-29059045,2023-04-01T08:57:56,Donostia,incomes,salary_partner,1163.13,-22091.29
buyer_5,Sara,30,ES05209525001173802889,TRX_N-00521-38163833,2023-04-02T16:33:56,Donostia,Expense,transport,-74.29,-22165.58
buyer_5,Sara,30,ES05209525001173802889,TRX_N-00522-80178388,2023-04-02T10:28:55,Donostia,Expense,leisure,-52.12,-22217.7
buyer_5,Sara,30,ES05209525001173802889,TRX_N-00523-31746818,2023-04-02T17:53:40,Donostia,Expense,education,-55.4,-22273.1
buyer_5,Sara,30,ES05209525001173802889,TRX_N-00524-42222800,2023-04-02T11:46:45,Donostia,Expense,cash,-100.0,-22373.1
buyer_5,Sara,30,ES05209525001173802889,TRX_N-00525-01422700,2023-04-02T21:50:38,Donostia,expenses,children,-101.96,-22475.06
buyer_5,Sara,30,ES05209525001173802889,TRX_N-00526-80366730,2023-04-03T14:16:40,Donostia,Expense,transport,-68.79,-22543.85
buyer_5,Sara,30,ES05209525001173802889,TRX_N-00527-92142264,2023-04-03T08:09:14,Donostia,Expense,leisure,-68.99,-22612.84
buyer_5,Sara,30,ES05209525001173802889,TRX_N-00528-75641340,2023-04-04T10:33:18,Donostia,expenses,mortgage,-726.47,-23339.31
buyer_5,Sara,30,ES05209525001173802889,TRX_N-00529-90064853,2023-04-05T11:46:06,Donostia,expenses,internet,-42.0,-23381.31
buyer_5,Sara,30,ES05209525001173802889,TRX_N-00530-24519377,2023-04-05T08:18:37,Andoain,Expense,food,-92.54,-23473.85
buyer_5,Sara,30,ES05209525001173802889,TRX_N-00531-45597062,2023-04-05T08:06:39,Donostia,Expense,leisure,-33.02,-23506.87
buyer_5,Sara,30,ES05209525001173802889,TRX_N-00532-46745070,2023-04-05T10:18:23,Donostia,Expense,appliances,-348.37,-23855.24
buyer_5,Sara,30,ES05209525001173802889,TRX_N-00533-03158708,2023-04-06T19:28:47,Donostia,expenses,water,-26.22,-23881.46
buyer_5,Sara,30,ES05209525001173802889,TRX_N-00534-48671722,2023-04-06T20:02:23,Donostia,Expense,repairs,-245.42,-24126.88
buyer_5,Sara,30,ES05209525001173802889,TRX_N-00535-58274037,2023-04-08T22:02:38,Donostia,expenses,electricity,-79.72,-24206.6
buyer_5,Sara,30,ES05209525001173802889,TRX_N-00536-42088454,2023-04-08T18:55:27,Donostia,expenses,gas,-86.49,-24293.09
buyer_5,Sara,30,ES05209525001173802889,TRX_N-00537-90366203,2023-04-08T10:09:11,Donostia,expenses,phone,-41.73,-24334.82
buyer_5,Sara,30,ES05209525001173802889,TRX_N-00538-45632610,2023-04-08T15:32:08,Donostia,Expense,cash,-100.0,-24434.82
buyer_5,Sara,30,ES05209525001173802889,TRX_N-00539-70623992,2023-04-09T16:14:30,Donostia,expenses,children,-152.46,-24587.28
buyer_5,Sara,30,ES05209525001173802889,TRX_N-00540-68523710,2023-04-10T18:37:53,Donostia,Expense,clothing,-134.89,-24722.17
buyer_5,Sara,30,ES05209525001173802889,TRX_N-00541-81603063,2023-04-10T13:25:09,Erandio,Expense,gifts,-210.51,-24932.68
buyer_5,Sara,30,ES05209525001173802889,TRX_N-00542-84510585,2023-04-11T09:38:43,Donostia,Expense,leisure,-83.13,-25015.81
buyer_5,Sara,30,ES05209525001173802889,TRX_N-00543-40628461,2023-04-11T12:03:20,Donostia,Expense,repairs,-62.84,-25078.65
buyer_5,Sara,30,ES05209525001173802889,TRX_N-00544-23281929,2023-04-11T12:02:02,Donostia,Expense,gifts,-60.55,-25139.2
buyer_5,Sara,30,ES05209525001173802889,TRX_N-00545-87752801,2023-04-12T21:33:30,Donostia,Expense,food,-114.33,-25253.53
buyer_5,Sara,30,ES05209525001173802889,TRX_N-00546-63804895,2023-04-15T10:30:39,Donostia,Expense,leisure,-64.07,-25317.6
buyer_5,Sara,30,ES05209525001173802889,TRX_N-00547-99172824,2023-04-15T20:08:10,Portugalete,Expense,cash,-100.0,-25417.6
buyer_5,Sara,30,ES05209525001173802889,TRX_N-00548-18803247,2023-04-15T18:59:49,Donostia,Expense,gifts,-717.21,-26134.81
buyer_5,Sara,30,ES05209525001173802889,TRX_N-00549-58749802,2023-04-16T09:00:42,Donostia,Expense,food,-119.17,-26253.98
buyer_5,Sara,30,ES05209525001173802889,TRX_N-00550-40396734,2023-04-16T11:10:30,Donostia,Expense,clothing,-58.26,-26312.24
buyer_5,Sara,30,ES05209525001173802889,TRX_N-00551-11895780,2023-04-16T20:50:29,Donostia,Expense,cash,-100.0,-26412.24
buyer_5,Sara,30,ES05209525001173802889,TRX_N-00552-58608446,2023-04-19T18:27:27,Donostia,Expense,food,-123.08,-26535.32
buyer_5,Sara,30,ES05209525001173802889,TRX_N-00553-66367154,2023-04-22T21:42:24,Donostia,Expense,leisure,-83.19,-26618.51
buyer_5,Sara,30,ES05209525001173802889,TRX_N-00554-04532703,2023-04-24T04:25:41,Donostia,Expense,food,-104.08,-26722.59
buyer_5,Sara,30,ES05209525001173802889,TRX_N-00555-00398800,2023-04-24T14:55:03,Donostia,Expense,transport,-85.91,-26808.5
buyer_5,Sara,30,ES05209525001173802889,TRX_N-00556-62205621,2023-04-24T15:57:58,Donostia,Expense,appliances,-413.52,-27222.02
buyer_5,Sara,30,ES05209525001173802889,TRX_N-00557-12277585,2023-04-24T12:02:08,Donostia,expenses,children,-231.83,-27453.85
buyer_5,Sara,30,ES05209525001173802889,TRX_N-00558-82410254,2023-04-25T11:39:14,Berango,Expense,transport,-55.13,-27508.98
buyer_5,Sara,30,ES05209525001173802889,TRX_N-00559-62283303,2023-04-25T10:34:31,Donostia,Expense,leisure,-53.86,-27562.84
buyer_5,Sara,30,ES05209525001173802889,TRX_N-00560-03255725,2023-04-26T14:29:51,Lasarte-Oria,Expense,clothing,-69.75,-27632.59
buyer_5,Sara,30,ES05209525001173802889,TRX_N-00561-98903720,2023-04-26T20:14:42,Galdakao,Expense,cash,-100.0,-27732.59
buyer_5,Sara,30,ES05209525001173802889,TRX_N-00562-23167708,2023-04-27T10:31:06,Donostia,Expense,leisure,-77.5,-27810.09
buyer_5,Sara,30,ES05209525001173802889,TRX_N-00563-47465661,2023-04-27T09:54:09,Donostia,Expense,cash,-100.0,-27910.09
buyer_5,Sara,30,ES05209525001173802889,TRX_N-00564-66807832,2023-04-29T12:25:44,Donostia,Expense,education,-58.19,-27968.28
buyer_5,Sara,30,ES05209525001173802889,TRX_N-00565-56106255,2023-04-29T14:25:43,Donostia,Expense,cash,-100.0,-28068.28
buyer_5,Sara,30,ES05209525001173802889,TRX_N-00566-36710784,2023-04-29T09:55:42,Donostia,Expense,gifts,-720.37,-28788.65
buyer_5,Sara,30,ES05209525001173802889,TRX_N-00567-70653599,2023-05-01T10:34:30,Donostia,incomes,salary,1380.51,-27408.14
buyer_5,Sara,30,ES05209525001173802889,TRX_N-00568-95244847,2023-05-01T10:34:30,Donostia,incomes,salary_partner,1163.13,-26245.01
buyer_5,Sara,30,ES05209525001173802889,TRX_N-00569-66171619,2023-05-01T23:47:06,Donostia,Expense,transport,-80.03,-26325.04
buyer_5,Sara,30,ES05209525001173802889,TRX_N-00570-72229887,2023-05-02T14:15:19,Lasarte-Oria,Expense,leisure,-18.78,-26343.82
buyer_5,Sara,30,ES05209525001173802889,TRX_N-00571-42966510,2023-05-04T06:49:30,Donostia,expenses,mortgage,-726.47,-27070.29
buyer_5,Sara,30,ES05209525001173802889,TRX_N-00572-69711189,2023-05-04T14:26:24,Donostia,Expense,education,-47.29,-27117.58
buyer_5,Sara,30,ES05209525001173802889,TRX_N-00573-04759861,2023-05-05T20:44:48,Donostia,Expense,food,-66.38,-27183.96
buyer_5,Sara,30,ES05209525001173802889,TRX_N-00574-81594333,2023-05-05T17:42:08,Donostia,Expense,transport,-79.13,-27263.09
buyer_5,Sara,30,ES05209525001173802889,TRX_N-00575-57602553,2023-05-06T14:05:13,Donostia,expenses,phone,-32.85,-27295.94
buyer_5,Sara,30,ES05209525001173802889,TRX_N-00576-03886336,2023-05-06T20:29:59,Donostia,Expense,repairs,-293.59,-27589.53
buyer_5,Sara,30,ES05209525001173802889,TRX_N-00577-12964127,2023-05-07T15:09:48,Amurrio,Expense,food,-84.57,-27674.1
buyer_5,Sara,30,ES05209525001173802889,TRX_N-00578-31985825,2023-05-08T12:16:22,Donostia,expenses,internet,-42.0,-27716.1
buyer_5,Sara,30,ES05209525001173802889,TRX_N-00579-11059444,2023-05-08T15:10:35,Donostia,expenses,water,-25.32,-27741.42
buyer_5,Sara,30,ES05209525001173802889,TRX_N-00580-13207068,2023-05-08T08:27:54,Donostia,expenses,electricity,-62.97,-27804.39
buyer_5,Sara,30,ES05209525001173802889,TRX_N-00581-03788632,2023-05-08T08:07:16,Donostia,expenses,gas,-45.8,-27850.19
buyer_5,Sara,30,ES05209525001173802889,TRX_N-00582-63131038,2023-05-10T19:34:12,Berango,Expense,food,-92.18,-27942.37
buyer_5,Sara,30,ES05209525001173802889,TRX_N-00583-22242868,2023-05-10T10:41:02,Sopela,Expense,cash,-100.0,-28042.37
buyer_5,Sara,30,ES05209525001173802889,TRX_N-00584-22237293,2023-05-14T11:49:04,Donostia,Expense,education,-65.4,-28107.77
buyer_5,Sara,30,ES05209525001173802889,TRX_N-00585-90016150,2023-05-15T19:02:20,Donostia,Expense,food,-94.88,-28202.65
buyer_5,Sara,30,ES05209525001173802889,TRX_N-00586-50513251,2023-05-15T09:20:26,Donostia,Expense,repairs,-139.13,-28341.78
buyer_5,Sara,30,ES05209525001173802889,TRX_N-00587-81408205,2023-05-16T11:53:09,Salvatierra/Agurain,Expense,transport,-75.43,-28417.21
buyer_5,Sara,30,ES05209525001173802889,TRX_N-00588-87455745,2023-05-16T10:26:59,Donostia,Expense,cash,-100.0,-28517.21
buyer_5,Sara,30,ES05209525001173802889,TRX_N-00589-00972599,2023-05-16T20:22:08,Donostia,Expense,gifts,-376.22,-28893.43
buyer_5,Sara,30,ES05209525001173802889,TRX_N-00590-71817697,2023-05-17T20:10:01,Donostia,Expense,education,-59.64,-28953.07
buyer_5,Sara,30,ES05209525001173802889,TRX_N-00591-56069138,2023-05-17T16:57:16,Donostia,Expense,cash,-100.0,-29053.07
buyer_5,Sara,30,ES05209525001173802889,TRX_N-00592-00221616,2023-05-18T15:03:18,Donostia,Expense,transport,-79.05,-29132.12
buyer_5,Sara,30,ES05209525001173802889,TRX_N-00593-27789542,2023-05-19T12:35:49,Llodio,Expense,transport,-68.14,-29200.26
buyer_5,Sara,30,ES05209525001173802889,TRX_N-00594-01367464,2023-05-20T06:50:04,Donostia,Expense,food,-68.76,-29269.02
buyer_5,Sara,30,ES05209525001173802889,TRX_N-00595-54899141,2023-05-21T09:43:15,Donostia,Expense,food,-113.12,-29382.14
buyer_5,Sara,30,ES05209525001173802889,TRX_N-00596-06283581,2023-05-21T23:58:00,Donostia,Expense,cash,-100.0,-29482.14
buyer_5,Sara,30,ES05209525001173802889,TRX_N-00597-16529019,2023-05-21T14:37:23,Donostia,Expense,repairs,-252.49,-29734.63
buyer_5,Sara,30,ES05209525001173802889,TRX_N-00598-67277756,2023-05-24T11:05:39,Donostia,Expense,transport,-66.61,-29801.24
buyer_5,Sara,30,ES05209525001173802889,TRX_N-00599-19193152,2023-05-26T13:24:56,Donostia,Expense,repairs,-122.28,-29923.52
buyer_5,Sara,30,ES05209525001173802889,TRX_N-00600-70682454,2023-05-27T11:20:20,Donostia,expenses,children,-162.42,-30085.94
buyer_5,Sara,30,ES05209525001173802889,TRX_N-00601-02296429,2023-05-29T17:06:18,Donostia,Expense,clothing,-108.4,-30194.34
buyer_5,Sara,30,ES05209525001173802889,TRX_N-00602-59175443,2023-05-29T14:43:32,Donostia,Expense,cash,-100.0,-30294.34
buyer_5,Sara,30,ES05209525001173802889,TRX_N-00603-72487017,2023-05-30T09:58:57,Galdakao,Expense,leisure,-53.94,-30348.28
buyer_5,Sara,30,ES05209525001173802889,TRX_N-00604-33110860,2023-05-31T15:49:33,Donostia,Expense,repairs,-207.97,-30556.25
buyer_5,Sara,30,ES05209525001173802889,TRX_N-00605-03236073,2023-06-01T12:48:23,Donostia,incomes,salary,1380.51,-29175.74
buyer_5,Sara,30,ES05209525001173802889,TRX_N-00606-53122876,2023-06-01T12:48:23,Donostia,incomes,salary_partner,1163.13,-28012.61
buyer_5,Sara,30,ES05209525001173802889,TRX_N-00607-86830430,2023-06-01T12:48:23,Donostia,incomes,extra_income,151.29,-27861.32
buyer_5,Sara,30,ES05209525001173802889,TRX_N-00608-84705143,2023-06-01T12:48:23,Donostia,incomes,salary_bonus,1065.84,-26795.48
buyer_5,Sara,30,ES05209525001173802889,TRX_N-00609-59599602,2023-06-01T12:48:23,Donostia,incomes,salary_partner_bonus,839.32,-25956.16
buyer_5,Sara,30,ES05209525001173802889,TRX_N-00610-02845855,2023-06-01T04:12:14,Donostia,Expense,food,-99.41,-26055.57
buyer_5,Sara,30,ES05209525001173802889,TRX_N-00611-44375618,2023-06-01T13:49:06,Portugalete,Expense,healthcare,-47.86,-26103.43
buyer_5,Sara,30,ES05209525001173802889,TRX_N-00612-55554099,2023-06-01T20:25:04,Donostia,Expense,cash,-100.0,-26203.43
buyer_5,Sara,30,ES05209525001173802889,TRX_N-00613-80516979,2023-06-02T11:41:17,Donostia,Expense,appliances,-138.66,-26342.09
buyer_5,Sara,30,ES05209525001173802889,TRX_N-00614-05655918,2023-06-03T02:27:32,Donostia,Expense,food,-76.11,-26418.2
buyer_5,Sara,30,ES05209525001173802889,TRX_N-00615-32822186,2023-06-03T22:05:05,Donostia,Expense,transport,-53.96,-26472.16
buyer_5,Sara,30,ES05209525001173802889,TRX_N-00616-67789467,2023-06-03T05:54:21,Donostia,Expense,appliances,-371.38,-26843.54
buyer_5,Sara,30,ES05209525001173802889,TRX_N-00617-33322413,2023-06-03T14:19:45,Donostia,expenses,children,-137.51,-26981.05
buyer_5,Sara,30,ES05209525001173802889,TRX_N-00618-44455418,2023-06-04T18:40:38,Donostia,expenses,mortgage,-726.47,-27707.52
buyer_5,Sara,30,ES05209525001173802889,TRX_N-00619-34201744,2023-06-04T09:05:00,Donostia,Expense,cash,-100.0,-27807.52
buyer_5,Sara,30,ES05209525001173802889,TRX_N-00620-29031642,2023-06-05T06:18:02,Donostia,expenses,electricity,-43.88,-27851.4
buyer_5,Sara,30,ES05209525001173802889,TRX_N-00621-22516937,2023-06-05T19:06:16,Donostia,expenses,gas,-76.61,-27928.01
buyer_5,Sara,30,ES05209525001173802889,TRX_N-00622-19233497,2023-06-05T18:54:51,Donostia,expenses,internet,-42.0,-27970.01
buyer_5,Sara,30,ES05209525001173802889,TRX_N-00623-77406062,2023-06-05T15:52:25,Donostia,Expense,appliances,-177.98,-28147.99
buyer_5,Sara,30,ES05209525001173802889,TRX_N-00624-87678515,2023-06-06T16:36:00,Donostia,expenses,children,-170.68,-28318.67
buyer_5,Sara,30,ES05209525001173802889,TRX_N-00625-44919276,2023-06-07T09:54:44,Eibar,Expense,leisure,-56.73,-28375.4
buyer_5,Sara,30,ES05209525001173802889,TRX_N-00626-68483357,2023-06-08T21:42:10,Donostia,expenses,water,-30.04,-28405.44
buyer_5,Sara,30,ES05209525001173802889,TRX_N-00627-36425029,2023-06-08T08:34:49,Donostia,expenses,phone,-44.93,-28450.37
buyer_5,Sara,30,ES05209525001173802889,TRX_N-00628-43091496,2023-06-08T02:55:38,Donostia,Expense,gifts,-177.07,-28627.44
buyer_5,Sara,30,ES05209525001173802889,TRX_N-00629-32773884,2023-06-10T15:40:09,Eibar,Expense,cash,-100.0,-28727.44
buyer_5,Sara,30,ES05209525001173802889,TRX_N-00630-82990199,2023-06-13T21:40:05,Alegr√≠a-Dulantzi,Expense,leisure,-57.44,-28784.88
buyer_5,Sara,30,ES05209525001173802889,TRX_N-00631-16215717,2023-06-15T14:27:05,Donostia,Expense,food,-105.9,-28890.78
buyer_5,Sara,30,ES05209525001173802889,TRX_N-00632-76093975,2023-06-17T04:04:03,Donostia,Expense,repairs,-103.24,-28994.02
buyer_5,Sara,30,ES05209525001173802889,TRX_N-00633-32764712,2023-06-18T09:41:38,Donostia,Expense,transport,-75.02,-29069.04
buyer_5,Sara,30,ES05209525001173802889,TRX_N-00634-63101176,2023-06-19T17:53:12,Donostia,Expense,clothing,-145.96,-29215.0
buyer_5,Sara,30,ES05209525001173802889,TRX_N-00635-76782441,2023-06-22T11:35:58,Donostia,Expense,transport,-46.43,-29261.43
buyer_5,Sara,30,ES05209525001173802889,TRX_N-00636-51368199,2023-06-23T12:03:47,Donostia,Expense,cash,-100.0,-29361.43
buyer_5,Sara,30,ES05209525001173802889,TRX_N-00637-52579914,2023-06-24T20:13:30,Donostia,Expense,transport,-42.24,-29403.67
buyer_5,Sara,30,ES05209525001173802889,TRX_N-00638-79887866,2023-06-25T08:48:03,Donostia,Expense,cash,-100.0,-29503.67
buyer_5,Sara,30,ES05209525001173802889,TRX_N-00639-04978769,2023-06-28T16:31:19,Donostia,Expense,food,-98.62,-29602.29
buyer_5,Sara,30,ES05209525001173802889,TRX_N-00640-22690690,2023-06-29T10:38:07,Donostia,Expense,healthcare,-129.73,-29732.02
buyer_5,Sara,30,ES05209525001173802889,TRX_N-00641-74140159,2023-06-30T22:41:28,Donostia,Expense,cash,-100.0,-29832.02
buyer_5,Sara,30,ES05209525001173802889,TRX_N-00642-81667389,2023-07-01T19:04:38,Donostia,incomes,salary,1380.51,-28451.51
buyer_5,Sara,30,ES05209525001173802889,TRX_N-00643-82951665,2023-07-01T19:04:38,Donostia,incomes,salary_partner,1163.13,-27288.38
buyer_5,Sara,30,ES05209525001173802889,TRX_N-00644-75882975,2023-07-04T14:03:59,Donostia,expenses,mortgage,-726.47,-28014.85
buyer_5,Sara,30,ES05209525001173802889,TRX_N-00645-82553629,2023-07-04T14:31:39,Donostia,Expense,food,-83.51,-28098.36
buyer_5,Sara,30,ES05209525001173802889,TRX_N-00646-25420741,2023-07-07T16:45:37,Donostia,expenses,water,-33.93,-28132.29
buyer_5,Sara,30,ES05209525001173802889,TRX_N-00647-90499894,2023-07-07T11:24:15,Donostia,expenses,internet,-42.0,-28174.29
buyer_5,Sara,30,ES05209525001173802889,TRX_N-00648-96718158,2023-07-07T04:44:01,Donostia,Expense,cash,-100.0,-28274.29
buyer_5,Sara,30,ES05209525001173802889,TRX_N-00649-20453154,2023-07-08T10:36:15,Donostia,expenses,electricity,-73.01,-28347.3
buyer_5,Sara,30,ES05209525001173802889,TRX_N-00650-50299639,2023-07-08T17:42:17,Donostia,expenses,gas,-40.66,-28387.96
buyer_5,Sara,30,ES05209525001173802889,TRX_N-00651-76822777,2023-07-08T20:51:29,Donostia,expenses,phone,-33.39,-28421.35
buyer_5,Sara,30,ES05209525001173802889,TRX_N-00652-08165781,2023-07-10T08:15:31,Donostia,Expense,food,-75.72,-28497.07
buyer_5,Sara,30,ES05209525001173802889,TRX_N-00653-99960132,2023-07-10T16:21:32,Donostia,Expense,healthcare,-141.17,-28638.24
buyer_5,Sara,30,ES05209525001173802889,TRX_N-00654-39401535,2023-07-13T08:59:11,Basauri,Expense,education,-78.96,-28717.2
buyer_5,Sara,30,ES05209525001173802889,TRX_N-00655-61572249,2023-07-15T13:35:21,Basauri,Expense,cash,-100.0,-28817.2
buyer_5,Sara,30,ES05209525001173802889,TRX_N-00656-03015189,2023-07-17T20:32:52,Donostia,Expense,appliances,-125.9,-28943.1
buyer_5,Sara,30,ES05209525001173802889,TRX_N-00657-65756435,2023-07-17T16:51:39,Donostia,expenses,children,-181.05,-29124.15
buyer_5,Sara,30,ES05209525001173802889,TRX_N-00658-47265572,2023-07-20T14:44:22,Donostia,Expense,food,-100.48,-29224.63
buyer_5,Sara,30,ES05209525001173802889,TRX_N-00659-90559139,2023-07-21T11:46:58,Donostia,Expense,food,-71.48,-29296.11
buyer_5,Sara,30,ES05209525001173802889,TRX_N-00660-41706609,2023-07-21T13:27:07,Donostia,Expense,leisure,-46.74,-29342.85
buyer_5,Sara,30,ES05209525001173802889,TRX_N-00661-73420390,2023-07-22T11:45:11,Hondarribia,Expense,gifts,-581.62,-29924.47
buyer_5,Sara,30,ES05209525001173802889,TRX_N-00662-59143122,2023-07-23T18:06:58,Donostia,Expense,education,-50.14,-29974.61
buyer_5,Sara,30,ES05209525001173802889,TRX_N-00663-00244262,2023-07-23T11:41:20,Donostia,Expense,cash,-100.0,-30074.61
buyer_5,Sara,30,ES05209525001173802889,TRX_N-00664-04942026,2023-07-23T12:20:16,Donostia,Expense,gifts,-785.19,-30859.8
buyer_5,Sara,30,ES05209525001173802889,TRX_N-00665-02493969,2023-07-24T16:44:03,Donostia,Expense,food,-96.04,-30955.84
buyer_5,Sara,30,ES05209525001173802889,TRX_N-00666-66024473,2023-07-24T08:31:32,Donostia,Expense,clothing,-64.41,-31020.25
buyer_5,Sara,30,ES05209525001173802889,TRX_N-00667-62913402,2023-07-24T20:21:45,Donostia,Expense,gifts,-835.41,-31855.66
buyer_5,Sara,30,ES05209525001173802889,TRX_N-00668-52859778,2023-07-27T17:58:19,Donostia,Expense,transport,-41.4,-31897.06
buyer_5,Sara,30,ES05209525001173802889,TRX_N-00669-43329451,2023-07-27T10:36:15,Irun,Expense,leisure,-71.57,-31968.63
buyer_5,Sara,30,ES05209525001173802889,TRX_N-00670-01715994,2023-07-28T19:38:45,Donostia,Expense,cash,-100.0,-32068.63
buyer_5,Sara,30,ES05209525001173802889,TRX_N-00671-85384153,2023-07-29T18:59:16,Donostia,Expense,cash,-100.0,-32168.63
buyer_5,Sara,30,ES05209525001173802889,TRX_N-00672-77958101,2023-07-29T19:09:50,Donostia,expenses,children,-92.21,-32260.84
buyer_5,Sara,30,ES05209525001173802889,TRX_N-00673-56134449,2023-07-31T15:32:00,Donostia,Expense,healthcare,-77.8,-32338.64
buyer_5,Sara,30,ES05209525001173802889,TRX_N-00674-66549981,2023-08-01T08:02:26,Donostia,incomes,salary,1380.51,-30958.13
buyer_5,Sara,30,ES05209525001173802889,TRX_N-00675-20149629,2023-08-01T08:02:26,Donostia,incomes,salary_partner,1163.13,-29795.0
buyer_5,Sara,30,ES05209525001173802889,TRX_N-00676-99897297,2023-08-02T10:07:38,Donostia,Expense,food,-88.82,-29883.82
buyer_5,Sara,30,ES05209525001173802889,TRX_N-00677-79728140,2023-08-04T14:45:47,Donostia,expenses,mortgage,-726.47,-30610.29
buyer_5,Sara,30,ES05209525001173802889,TRX_N-00678-15789226,2023-08-04T10:22:32,Donostia,Expense,clothing,-103.89,-30714.18
buyer_5,Sara,30,ES05209525001173802889,TRX_N-00679-72522176,2023-08-05T10:05:08,Bilbao,Expense,leisure,-43.26,-30757.44
buyer_5,Sara,30,ES05209525001173802889,TRX_N-00680-77719774,2023-08-05T14:22:13,Donostia,Expense,gifts,-110.08,-30867.52
buyer_5,Sara,30,ES05209525001173802889,TRX_N-00681-49097224,2023-08-07T17:38:24,Donostia,Expense,cash,-100.0,-30967.52
buyer_5,Sara,30,ES05209525001173802889,TRX_N-00682-79914127,2023-08-08T19:41:43,Donostia,expenses,water,-39.98,-31007.5
buyer_5,Sara,30,ES05209525001173802889,TRX_N-00683-69613278,2023-08-08T12:15:14,Donostia,expenses,electricity,-72.24,-31079.74
buyer_5,Sara,30,ES05209525001173802889,TRX_N-00684-26139895,2023-08-08T23:04:11,Donostia,expenses,gas,-49.56,-31129.3
buyer_5,Sara,30,ES05209525001173802889,TRX_N-00685-84397636,2023-08-08T18:27:00,Donostia,expenses,internet,-42.0,-31171.3
buyer_5,Sara,30,ES05209525001173802889,TRX_N-00686-00407394,2023-08-08T19:24:38,Donostia,expenses,phone,-42.97,-31214.27
buyer_5,Sara,30,ES05209525001173802889,TRX_N-00687-52009675,2023-08-09T22:33:13,Donostia,Expense,food,-80.69,-31294.96
buyer_5,Sara,30,ES05209525001173802889,TRX_N-00688-49797424,2023-08-10T14:26:51,Getxo,Expense,healthcare,-184.9,-31479.86
buyer_5,Sara,30,ES05209525001173802889,TRX_N-00689-43561833,2023-08-10T18:15:07,Donostia,Expense,repairs,-233.24,-31713.1
buyer_5,Sara,30,ES05209525001173802889,TRX_N-00690-74677129,2023-08-11T16:54:20,Donostia,Expense,transport,-86.73,-31799.83
buyer_5,Sara,30,ES05209525001173802889,TRX_N-00691-71579271,2023-08-11T18:00:27,Donostia,Expense,appliances,-185.61,-31985.44
buyer_5,Sara,30,ES05209525001173802889,TRX_N-00692-23919923,2023-08-11T03:01:15,Arrasate,Expense,gifts,-94.81,-32080.25
buyer_5,Sara,30,ES05209525001173802889,TRX_N-00693-62324697,2023-08-13T19:24:45,Vitoria-Gasteiz,Expense,cash,-100.0,-32180.25
buyer_5,Sara,30,ES05209525001173802889,TRX_N-00694-48768443,2023-08-13T13:02:03,Donostia,Expense,repairs,-31.34,-32211.59
buyer_5,Sara,30,ES05209525001173802889,TRX_N-00695-83105592,2023-08-14T11:43:24,Donostia,Expense,cash,-100.0,-32311.59
buyer_5,Sara,30,ES05209525001173802889,TRX_N-00696-47951732,2023-08-15T23:24:20,Donostia,Expense,food,-90.22,-32401.81
buyer_5,Sara,30,ES05209525001173802889,TRX_N-00697-08116789,2023-08-15T08:59:49,Donostia,Expense,transport,-50.04,-32451.85
buyer_5,Sara,30,ES05209525001173802889,TRX_N-00698-47623737,2023-08-16T15:11:08,Donostia,Expense,appliances,-380.25,-32832.1
buyer_5,Sara,30,ES05209525001173802889,TRX_N-00699-79193208,2023-08-17T10:30:03,Donostia,Expense,food,-93.96,-32926.06
buyer_5,Sara,30,ES05209525001173802889,TRX_N-00700-03235863,2023-08-17T17:35:31,Donostia,expenses,children,-180.47,-33106.53
buyer_5,Sara,30,ES05209525001173802889,TRX_N-00701-34578591,2023-08-18T14:42:02,Donostia,Expense,food,-120.69,-33227.22
buyer_5,Sara,30,ES05209525001173802889,TRX_N-00702-50735207,2023-08-18T15:02:23,Zuia,Expense,transport,-58.04,-33285.26
buyer_5,Sara,30,ES05209525001173802889,TRX_N-00703-52838802,2023-08-18T14:24:30,Donostia,Expense,cash,-100.0,-33385.26
buyer_5,Sara,30,ES05209525001173802889,TRX_N-00704-84578521,2023-08-19T17:30:14,Sestao,Expense,food,-118.74,-33504.0
buyer_5,Sara,30,ES05209525001173802889,TRX_N-00705-40212698,2023-08-20T01:14:10,Donostia,Expense,cash,-100.0,-33604.0
buyer_5,Sara,30,ES05209525001173802889,TRX_N-00706-97932708,2023-08-20T15:50:33,Donostia,expenses,children,-118.67,-33722.67
buyer_5,Sara,30,ES05209525001173802889,TRX_N-00707-22208065,2023-08-21T16:52:32,Donostia,Expense,food,-97.0,-33819.67
buyer_5,Sara,30,ES05209525001173802889,TRX_N-00708-74072412,2023-08-21T18:23:01,Getxo,Expense,gifts,-44.47,-33864.14
buyer_5,Sara,30,ES05209525001173802889,TRX_N-00709-55617379,2023-08-22T10:41:39,Hondarribia,Expense,repairs,-107.17,-33971.31
buyer_5,Sara,30,ES05209525001173802889,TRX_N-00710-06002774,2023-08-23T23:42:49,Donostia,Expense,food,-102.86,-34074.17
buyer_5,Sara,30,ES05209525001173802889,TRX_N-00711-94269182,2023-08-23T10:04:24,Bilbao,Expense,cash,-100.0,-34174.17
buyer_5,Sara,30,ES05209525001173802889,TRX_N-00712-43938881,2023-08-24T02:42:21,Donostia,Expense,leisure,-20.67,-34194.84
buyer_5,Sara,30,ES05209525001173802889,TRX_N-00713-00709510,2023-08-24T14:20:16,Donostia,Expense,healthcare,-85.85,-34280.69
buyer_5,Sara,30,ES05209525001173802889,TRX_N-00714-83912881,2023-08-25T12:15:05,Donostia,Expense,education,-72.75,-34353.44
buyer_5,Sara,30,ES05209525001173802889,TRX_N-00715-57983356,2023-08-27T11:18:33,Donostia,Expense,food,-79.23,-34432.67
buyer_5,Sara,30,ES05209525001173802889,TRX_N-00716-55199176,2023-08-29T17:36:20,Donostia,Expense,food,-109.66,-34542.33
buyer_5,Sara,30,ES05209525001173802889,TRX_N-00717-23267191,2023-08-29T09:14:40,Donostia,Expense,cash,-100.0,-34642.33
buyer_5,Sara,30,ES05209525001173802889,TRX_N-00718-39178273,2023-08-30T08:21:18,Donostia,Expense,food,-122.83,-34765.16
buyer_5,Sara,30,ES05209525001173802889,TRX_N-00719-64003092,2023-08-30T13:30:56,Bilbao,Expense,leisure,-24.42,-34789.58
buyer_5,Sara,30,ES05209525001173802889,TRX_N-00720-23734363,2023-08-31T11:02:11,Donostia,Expense,clothing,-129.57,-34919.15
buyer_5,Sara,30,ES05209525001173802889,TRX_N-00721-12599272,2023-09-01T10:46:23,Donostia,incomes,salary,1380.51,-33538.64
buyer_5,Sara,30,ES05209525001173802889,TRX_N-00722-14494793,2023-09-01T10:46:23,Donostia,incomes,salary_partner,1163.13,-32375.51
buyer_5,Sara,30,ES05209525001173802889,TRX_N-00723-37288761,2023-09-01T16:03:28,Donostia,Expense,food,-63.06,-32438.57
buyer_5,Sara,30,ES05209525001173802889,TRX_N-00724-56749304,2023-09-02T13:44:11,Donostia,Expense,cash,-100.0,-32538.57
buyer_5,Sara,30,ES05209525001173802889,TRX_N-00725-42062325,2023-09-03T13:35:28,Donostia,Expense,food,-64.09,-32602.66
buyer_5,Sara,30,ES05209525001173802889,TRX_N-00726-98774119,2023-09-03T14:58:59,Donostia,Expense,clothing,-136.45,-32739.11
buyer_5,Sara,30,ES05209525001173802889,TRX_N-00727-96374980,2023-09-03T09:36:21,Irun,Expense,cash,-100.0,-32839.11
buyer_5,Sara,30,ES05209525001173802889,TRX_N-00728-97642371,2023-09-04T09:12:28,Donostia,expenses,mortgage,-726.47,-33565.58
buyer_5,Sara,30,ES05209525001173802889,TRX_N-00729-96886963,2023-09-04T13:17:13,Donostia,Expense,gifts,-769.57,-34335.15
buyer_5,Sara,30,ES05209525001173802889,TRX_N-00730-80402967,2023-09-05T12:18:59,Donostia,expenses,electricity,-33.31,-34368.46
buyer_5,Sara,30,ES05209525001173802889,TRX_N-00731-71487761,2023-09-05T15:08:17,Donostia,expenses,gas,-86.52,-34454.98
buyer_5,Sara,30,ES05209525001173802889,TRX_N-00732-75153992,2023-09-05T09:10:57,Donostia,expenses,phone,-38.08,-34493.06
buyer_5,Sara,30,ES05209525001173802889,TRX_N-00733-70163802,2023-09-05T05:04:00,Sestao,Expense,repairs,-304.27,-34797.33
buyer_5,Sara,30,ES05209525001173802889,TRX_N-00734-68921890,2023-09-07T19:08:19,Donostia,expenses,water,-28.44,-34825.77
buyer_5,Sara,30,ES05209525001173802889,TRX_N-00735-12327578,2023-09-08T05:48:21,Donostia,expenses,internet,-42.0,-34867.77
buyer_5,Sara,30,ES05209525001173802889,TRX_N-00736-42763070,2023-09-08T22:54:27,Donostia,Expense,cash,-100.0,-34967.77
buyer_5,Sara,30,ES05209525001173802889,TRX_N-00737-32858988,2023-09-09T13:10:59,Donostia,Expense,food,-103.56,-35071.33
buyer_5,Sara,30,ES05209525001173802889,TRX_N-00738-45498410,2023-09-09T23:39:27,Donostia,Expense,healthcare,-93.26,-35164.59
buyer_5,Sara,30,ES05209525001173802889,TRX_N-00739-63528487,2023-09-11T12:59:14,Donostia,Expense,food,-97.4,-35261.99
buyer_5,Sara,30,ES05209525001173802889,TRX_N-00740-63884065,2023-09-13T18:32:36,Donostia,Expense,education,-63.94,-35325.93
buyer_5,Sara,30,ES05209525001173802889,TRX_N-00741-22425048,2023-09-14T21:00:35,Donostia,Expense,clothing,-122.97,-35448.9
buyer_5,Sara,30,ES05209525001173802889,TRX_N-00742-92662855,2023-09-15T11:04:39,Donostia,Expense,leisure,-48.46,-35497.36
buyer_5,Sara,30,ES05209525001173802889,TRX_N-00743-29412184,2023-09-17T18:24:02,Donostia,Expense,gifts,-808.3,-36305.66
buyer_5,Sara,30,ES05209525001173802889,TRX_N-00744-03684771,2023-09-18T23:55:23,Pasaia,Expense,clothing,-136.13,-36441.79
buyer_5,Sara,30,ES05209525001173802889,TRX_N-00745-33871378,2023-09-19T20:14:59,Donostia,Expense,clothing,-154.8,-36596.59
buyer_5,Sara,30,ES05209525001173802889,TRX_N-00746-70016231,2023-09-22T19:20:18,Donostia,Expense,healthcare,-157.29,-36753.88
buyer_5,Sara,30,ES05209525001173802889,TRX_N-00747-72509435,2023-09-22T14:40:01,Donostia,Expense,cash,-100.0,-36853.88
buyer_5,Sara,30,ES05209525001173802889,TRX_N-00748-85992374,2023-09-24T19:02:13,Donostia,Expense,leisure,-33.0,-36886.88
buyer_5,Sara,30,ES05209525001173802889,TRX_N-00749-41193993,2023-09-24T21:00:56,Donostia,Expense,cash,-100.0,-36986.88
buyer_5,Sara,30,ES05209525001173802889,TRX_N-00750-97819009,2023-09-25T17:16:46,Sestao,Expense,food,-84.3,-37071.18
buyer_5,Sara,30,ES05209525001173802889,TRX_N-00751-90323489,2023-09-25T11:33:34,Donostia,Expense,transport,-54.25,-37125.43
buyer_5,Sara,30,ES05209525001173802889,TRX_N-00752-43184673,2023-09-26T23:10:39,Donostia,Expense,cash,-100.0,-37225.43
buyer_5,Sara,30,ES05209525001173802889,TRX_N-00753-33312384,2023-09-28T09:00:41,Donostia,Expense,leisure,-44.08,-37269.51
buyer_5,Sara,30,ES05209525001173802889,TRX_N-00754-62412836,2023-09-28T10:54:16,Donostia,Expense,gifts,-49.63,-37319.14
buyer_5,Sara,30,ES05209525001173802889,TRX_N-00755-09815299,2023-09-29T10:56:17,Zarautz,Expense,cash,-100.0,-37419.14
buyer_5,Sara,30,ES05209525001173802889,TRX_N-00756-67594078,2023-09-30T19:17:56,Zuia,Expense,food,-112.92,-37532.06
buyer_5,Sara,30,ES05209525001173802889,TRX_N-00757-46736427,2023-09-30T18:24:49,Donostia,Expense,cash,-100.0,-37632.06
buyer_5,Sara,30,ES05209525001173802889,TRX_N-00758-56032686,2023-10-01T19:55:16,Donostia,incomes,salary,1380.51,-36251.55
buyer_5,Sara,30,ES05209525001173802889,TRX_N-00759-09755138,2023-10-01T19:55:16,Donostia,incomes,salary_partner,1163.13,-35088.42
buyer_5,Sara,30,ES05209525001173802889,TRX_N-00760-88927467,2023-10-01T19:55:16,Donostia,incomes,extra_income,151.29,-34937.13
buyer_5,Sara,30,ES05209525001173802889,TRX_N-00761-63866900,2023-10-01T08:56:13,Donostia,Expense,clothing,-56.54,-34993.67
buyer_5,Sara,30,ES05209525001173802889,TRX_N-00762-67239134,2023-10-01T12:37:08,Donostia,Expense,education,-71.38,-35065.05
buyer_5,Sara,30,ES05209525001173802889,TRX_N-00763-29276482,2023-10-01T01:29:27,Galdakao,Expense,cash,-100.0,-35165.05
buyer_5,Sara,30,ES05209525001173802889,TRX_N-00764-04302223,2023-10-02T15:15:01,Donostia,Expense,food,-106.68,-35271.73
buyer_5,Sara,30,ES05209525001173802889,TRX_N-00765-78355757,2023-10-04T14:46:21,Donostia,expenses,mortgage,-726.47,-35998.2
buyer_5,Sara,30,ES05209525001173802889,TRX_N-00766-84882134,2023-10-04T18:49:44,Donostia,Expense,food,-80.27,-36078.47
buyer_5,Sara,30,ES05209525001173802889,TRX_N-00767-98345725,2023-10-04T09:48:43,Donostia,expenses,children,-90.31,-36168.78
buyer_5,Sara,30,ES05209525001173802889,TRX_N-00768-46665776,2023-10-05T19:57:47,Donostia,expenses,gas,-86.98,-36255.76
buyer_5,Sara,30,ES05209525001173802889,TRX_N-00769-70966074,2023-10-06T18:51:17,Donostia,Expense,repairs,-184.3,-36440.06
buyer_5,Sara,30,ES05209525001173802889,TRX_N-00770-85877929,2023-10-08T09:17:44,Donostia,expenses,water,-33.27,-36473.33
buyer_5,Sara,30,ES05209525001173802889,TRX_N-00771-67100224,2023-10-08T09:03:12,Donostia,expenses,electricity,-51.06,-36524.39
buyer_5,Sara,30,ES05209525001173802889,TRX_N-00772-64046656,2023-10-08T17:33:42,Donostia,expenses,internet,-42.0,-36566.39
buyer_5,Sara,30,ES05209525001173802889,TRX_N-00773-77349954,2023-10-08T06:40:37,Donostia,expenses,phone,-42.68,-36609.07
buyer_5,Sara,30,ES05209525001173802889,TRX_N-00774-89663272,2023-10-08T20:36:52,Donostia,Expense,food,-71.59,-36680.66
buyer_5,Sara,30,ES05209525001173802889,TRX_N-00775-63528830,2023-10-09T16:52:29,Donostia,Expense,gifts,-644.26,-37324.92
buyer_5,Sara,30,ES05209525001173802889,TRX_N-00776-34459677,2023-10-10T08:44:29,Donostia,Expense,appliances,-138.7,-37463.62
buyer_5,Sara,30,ES05209525001173802889,TRX_N-00777-34718384,2023-10-10T12:18:56,Donostia,Expense,gifts,-212.42,-37676.04
buyer_5,Sara,30,ES05209525001173802889,TRX_N-00778-42256091,2023-10-12T20:48:34,Hondarribia,Expense,leisure,-73.05,-37749.09
buyer_5,Sara,30,ES05209525001173802889,TRX_N-00779-88359260,2023-10-12T19:54:47,Donostia,Expense,cash,-100.0,-37849.09
buyer_5,Sara,30,ES05209525001173802889,TRX_N-00780-85313892,2023-10-13T19:27:55,Donostia,Expense,gifts,-764.25,-38613.34
buyer_5,Sara,30,ES05209525001173802889,TRX_N-00781-77420716,2023-10-14T12:14:08,Donostia,Expense,transport,-70.73,-38684.07
buyer_5,Sara,30,ES05209525001173802889,TRX_N-00782-49111153,2023-10-14T23:26:18,Donostia,Expense,leisure,-74.65,-38758.72
buyer_5,Sara,30,ES05209525001173802889,TRX_N-00783-53135310,2023-10-14T15:59:41,Irun,Expense,healthcare,-65.02,-38823.74
buyer_5,Sara,30,ES05209525001173802889,TRX_N-00784-79339245,2023-10-23T17:15:45,Donostia,Expense,leisure,-51.78,-38875.52
buyer_5,Sara,30,ES05209525001173802889,TRX_N-00785-60135188,2023-10-24T10:14:23,Donostia,Expense,food,-77.76,-38953.28
buyer_5,Sara,30,ES05209525001173802889,TRX_N-00786-00550291,2023-10-24T17:03:17,Donostia,Expense,clothing,-149.87,-39103.15
buyer_5,Sara,30,ES05209525001173802889,TRX_N-00787-70179252,2023-10-28T18:50:17,Donostia,Expense,food,-83.4,-39186.55
buyer_5,Sara,30,ES05209525001173802889,TRX_N-00788-56147601,2023-10-28T10:11:35,Donostia,Expense,cash,-100.0,-39286.55
buyer_5,Sara,30,ES05209525001173802889,TRX_N-00789-03491554,2023-10-29T18:39:54,Donostia,Expense,cash,-100.0,-39386.55
buyer_5,Sara,30,ES05209525001173802889,TRX_N-00790-24044825,2023-10-30T17:28:31,Bilbao,Expense,food,-85.91,-39472.46
buyer_5,Sara,30,ES05209525001173802889,TRX_N-00791-57834986,2023-11-01T09:44:04,Donostia,incomes,salary,1380.51,-38091.95
buyer_5,Sara,30,ES05209525001173802889,TRX_N-00792-43901934,2023-11-01T09:44:04,Donostia,incomes,salary_partner,1163.13,-36928.82
buyer_5,Sara,30,ES05209525001173802889,TRX_N-00793-52550894,2023-11-01T15:22:48,Donostia,Expense,food,-118.41,-37047.23
buyer_5,Sara,30,ES05209525001173802889,TRX_N-00794-45514354,2023-11-01T06:24:22,Donostia,Expense,appliances,-246.05,-37293.28
buyer_5,Sara,30,ES05209525001173802889,TRX_N-00795-43241293,2023-11-02T08:25:21,Donostia,Expense,cash,-100.0,-37393.28
buyer_5,Sara,30,ES05209525001173802889,TRX_N-00796-98074239,2023-11-03T10:53:23,Durango,Expense,transport,-84.47,-37477.75
buyer_5,Sara,30,ES05209525001173802889,TRX_N-00797-57542470,2023-11-03T09:18:14,Basauri,Expense,cash,-100.0,-37577.75
buyer_5,Sara,30,ES05209525001173802889,TRX_N-00798-99015957,2023-11-04T17:43:10,Donostia,expenses,mortgage,-726.47,-38304.22
buyer_5,Sara,30,ES05209525001173802889,TRX_N-00799-28056483,2023-11-04T13:26:42,Donostia,Expense,gifts,-247.22,-38551.44
buyer_5,Sara,30,ES05209525001173802889,TRX_N-00800-45866715,2023-11-05T12:45:14,Donostia,expenses,gas,-77.18,-38628.62
buyer_5,Sara,30,ES05209525001173802889,TRX_N-00801-77432011,2023-11-05T12:50:37,Hondarribia,Expense,food,-64.81,-38693.43
buyer_5,Sara,30,ES05209525001173802889,TRX_N-00802-98050473,2023-11-05T08:58:38,Donostia,Expense,gifts,-126.34,-38819.77
buyer_5,Sara,30,ES05209525001173802889,TRX_N-00803-28483821,2023-11-06T18:35:35,Donostia,expenses,water,-21.04,-38840.81
buyer_5,Sara,30,ES05209525001173802889,TRX_N-00804-21301211,2023-11-07T19:47:10,Donostia,expenses,phone,-42.78,-38883.59
buyer_5,Sara,30,ES05209525001173802889,TRX_N-00805-62706213,2023-11-08T09:48:57,Donostia,expenses,electricity,-53.96,-38937.55
buyer_5,Sara,30,ES05209525001173802889,TRX_N-00806-21586359,2023-11-08T08:52:27,Donostia,expenses,internet,-42.0,-38979.55
buyer_5,Sara,30,ES05209525001173802889,TRX_N-00807-58692207,2023-11-08T18:30:48,Donostia,Expense,food,-107.09,-39086.64
buyer_5,Sara,30,ES05209525001173802889,TRX_N-00808-84794248,2023-11-10T09:00:32,Donostia,Expense,leisure,-74.89,-39161.53
buyer_5,Sara,30,ES05209525001173802889,TRX_N-00809-72871145,2023-11-11T09:05:27,Donostia,Expense,food,-96.73,-39258.26
buyer_5,Sara,30,ES05209525001173802889,TRX_N-00810-51805342,2023-11-11T18:53:57,Donostia,Expense,leisure,-30.26,-39288.52
buyer_5,Sara,30,ES05209525001173802889,TRX_N-00811-48622871,2023-11-13T13:06:55,Donostia,Expense,transport,-60.79,-39349.31
buyer_5,Sara,30,ES05209525001173802889,TRX_N-00812-72996312,2023-11-13T21:11:55,Donostia,Expense,leisure,-28.65,-39377.96
buyer_5,Sara,30,ES05209525001173802889,TRX_N-00813-70574189,2023-11-13T10:48:38,Donostia,Expense,cash,-100.0,-39477.96
buyer_5,Sara,30,ES05209525001173802889,TRX_N-00814-34548714,2023-11-14T08:46:51,Alegr√≠a-Dulantzi,Expense,clothing,-148.97,-39626.93
buyer_5,Sara,30,ES05209525001173802889,TRX_N-00815-72477209,2023-11-15T10:30:11,Donostia,Expense,food,-75.03,-39701.96
buyer_5,Sara,30,ES05209525001173802889,TRX_N-00816-39854156,2023-11-16T15:07:49,Donostia,Expense,cash,-100.0,-39801.96
buyer_5,Sara,30,ES05209525001173802889,TRX_N-00817-65329564,2023-11-17T16:00:36,Donostia,Expense,clothing,-109.85,-39911.81
buyer_5,Sara,30,ES05209525001173802889,TRX_N-00818-32288758,2023-11-20T22:39:34,Donostia,Expense,cash,-100.0,-40011.81
buyer_5,Sara,30,ES05209525001173802889,TRX_N-00819-00144336,2023-11-23T12:30:24,Zarautz,Expense,food,-111.91,-40123.72
buyer_5,Sara,30,ES05209525001173802889,TRX_N-00820-32680787,2023-11-23T01:56:21,Donostia,Expense,cash,-100.0,-40223.72
buyer_5,Sara,30,ES05209525001173802889,TRX_N-00821-01084510,2023-11-23T12:59:43,Donostia,Expense,repairs,-82.96,-40306.68
buyer_5,Sara,30,ES05209525001173802889,TRX_N-00822-91500632,2023-11-25T12:31:35,Donostia,Expense,transport,-67.68,-40374.36
buyer_5,Sara,30,ES05209525001173802889,TRX_N-00823-42857323,2023-11-25T17:56:10,Donostia,Expense,cash,-100.0,-40474.36
buyer_5,Sara,30,ES05209525001173802889,TRX_N-00824-75067837,2023-11-27T13:07:15,Donostia,Expense,food,-90.68,-40565.04
buyer_5,Sara,30,ES05209525001173802889,TRX_N-00825-86850644,2023-11-27T07:17:31,Donostia,Expense,transport,-74.71,-40639.75
buyer_5,Sara,30,ES05209525001173802889,TRX_N-00826-00266247,2023-11-29T22:01:58,Donostia,Expense,food,-101.69,-40741.44
buyer_5,Sara,30,ES05209525001173802889,TRX_N-00827-73951514,2023-11-30T03:06:50,Donostia,Expense,food,-108.82,-40850.26
buyer_5,Sara,30,ES05209525001173802889,TRX_N-00828-16340846,2023-11-30T20:41:31,Donostia,Expense,cash,-100.0,-40950.26
buyer_5,Sara,30,ES05209525001173802889,TRX_N-00829-92014299,2023-11-30T14:03:26,Donostia,Expense,repairs,-125.92,-41076.18
buyer_5,Sara,30,ES05209525001173802889,TRX_N-00830-18996108,2023-12-01T13:58:42,Donostia,incomes,salary,1380.51,-39695.67
buyer_5,Sara,30,ES05209525001173802889,TRX_N-00831-04610747,2023-12-01T13:58:42,Donostia,incomes,salary_partner,1163.13,-38532.54
buyer_5,Sara,30,ES05209525001173802889,TRX_N-00832-55289239,2023-12-01T13:58:42,Donostia,incomes,salary_bonus,1074.97,-37457.57
buyer_5,Sara,30,ES05209525001173802889,TRX_N-00833-78549250,2023-12-01T13:58:42,Donostia,incomes,salary_partner_bonus,836.2,-36621.37
buyer_5,Sara,30,ES05209525001173802889,TRX_N-00834-74665407,2023-12-01T19:37:55,Donostia,Expense,transport,-54.78,-36676.15
buyer_5,Sara,30,ES05209525001173802889,TRX_N-00835-71981959,2023-12-03T14:46:30,Donostia,Expense,cash,-100.0,-36776.15
buyer_5,Sara,30,ES05209525001173802889,TRX_N-00836-32700481,2023-12-04T16:32:10,Donostia,expenses,mortgage,-726.47,-37502.62
buyer_5,Sara,30,ES05209525001173802889,TRX_N-00837-75389505,2023-12-04T16:24:23,Errenteria,Expense,cash,-100.0,-37602.62
buyer_5,Sara,30,ES05209525001173802889,TRX_N-00838-98549657,2023-12-05T09:24:40,Donostia,expenses,electricity,-27.2,-37629.82
buyer_5,Sara,30,ES05209525001173802889,TRX_N-00839-14265796,2023-12-06T22:17:53,Donostia,expenses,internet,-42.0,-37671.82
buyer_5,Sara,30,ES05209525001173802889,TRX_N-00840-04675175,2023-12-06T14:21:48,Donostia,Expense,repairs,-266.22,-37938.04
buyer_5,Sara,30,ES05209525001173802889,TRX_N-00841-04444217,2023-12-08T15:11:25,Donostia,expenses,water,-30.03,-37968.07
buyer_5,Sara,30,ES05209525001173802889,TRX_N-00842-86191997,2023-12-08T11:09:41,Donostia,expenses,gas,-110.35,-38078.42
buyer_5,Sara,30,ES05209525001173802889,TRX_N-00843-69236957,2023-12-08T08:35:37,Donostia,expenses,phone,-32.11,-38110.53
buyer_5,Sara,30,ES05209525001173802889,TRX_N-00844-21356858,2023-12-10T11:48:57,Llodio,Expense,food,-95.0,-38205.53
buyer_5,Sara,30,ES05209525001173802889,TRX_N-00845-84240465,2023-12-10T18:11:47,Barakaldo,Expense,cash,-100.0,-38305.53
buyer_5,Sara,30,ES05209525001173802889,TRX_N-00846-46140661,2023-12-10T09:04:29,Donostia,Expense,repairs,-186.87,-38492.4
buyer_5,Sara,30,ES05209525001173802889,TRX_N-00847-09470581,2023-12-14T17:12:56,Donostia,Expense,food,-67.92,-38560.32
buyer_5,Sara,30,ES05209525001173802889,TRX_N-00848-80802491,2023-12-16T19:29:08,Donostia,Expense,repairs,-321.48,-38881.8
buyer_5,Sara,30,ES05209525001173802889,TRX_N-00849-81047044,2023-12-17T17:10:02,Donostia,Expense,food,-84.77,-38966.57
buyer_5,Sara,30,ES05209525001173802889,TRX_N-00850-23035132,2023-12-18T17:45:17,Donostia,Expense,food,-109.03,-39075.6
buyer_5,Sara,30,ES05209525001173802889,TRX_N-00851-51401127,2023-12-19T15:34:53,Donostia,Expense,food,-63.55,-39139.15
buyer_5,Sara,30,ES05209525001173802889,TRX_N-00852-06135515,2023-12-20T11:40:36,Donostia,Expense,leisure,-36.75,-39175.9
buyer_5,Sara,30,ES05209525001173802889,TRX_N-00853-57366067,2023-12-20T22:37:17,Donostia,Expense,cash,-100.0,-39275.9
buyer_5,Sara,30,ES05209525001173802889,TRX_N-00854-19882663,2023-12-24T18:40:08,Donostia,Expense,leisure,-77.77,-39353.67
buyer_5,Sara,30,ES05209525001173802889,TRX_N-00855-02155726,2023-12-24T10:59:30,Donostia,expenses,children,-269.25,-39622.92
buyer_5,Sara,30,ES05209525001173802889,TRX_N-00856-88944471,2023-12-25T08:12:35,Donostia,Expense,cash,-100.0,-39722.92
buyer_5,Sara,30,ES05209525001173802889,TRX_N-00857-65006607,2023-12-27T08:58:26,Donostia,Expense,food,-75.1,-39798.02
buyer_5,Sara,30,ES05209525001173802889,TRX_N-00858-10362099,2023-12-27T19:05:49,Donostia,Expense,appliances,-96.22,-39894.24
buyer_5,Sara,30,ES05209525001173802889,TRX_N-00859-48809988,2023-12-28T19:55:30,Donostia,Expense,appliances,-128.13,-40022.37
buyer_5,Sara,30,ES05209525001173802889,TRX_N-00860-94404221,2023-12-29T03:42:28,Donostia,Expense,repairs,-107.5,-40129.87
buyer_5,Sara,30,ES05209525001173802889,TRX_N-00861-78127749,2023-12-29T11:23:13,Donostia,Expense,gifts,-529.56,-40659.43
buyer_5,Sara,30,ES05209525001173802889,TRX_N-00862-44955918,2024-01-01T14:40:14,Donostia,incomes,salary,1426.69,-39232.74
buyer_5,Sara,30,ES05209525001173802889,TRX_N-00863-47287833,2024-01-01T14:40:14,Donostia,incomes,salary_partner,1202.04,-38030.7
buyer_5,Sara,30,ES05209525001173802889,TRX_N-00864-77869882,2024-01-01T15:18:35,Donostia,Expense,cash,-100.0,-38130.7
buyer_5,Sara,30,ES05209525001173802889,TRX_N-00865-25837482,2024-01-02T12:49:52,Donostia,Expense,gifts,-85.25,-38215.95
buyer_5,Sara,30,ES05209525001173802889,TRX_N-00866-91471143,2024-01-03T15:39:00,Donostia,Expense,transport,-81.89,-38297.84
buyer_5,Sara,30,ES05209525001173802889,TRX_N-00867-70094805,2024-01-04T14:31:27,Donostia,expenses,mortgage,-726.47,-39024.31
buyer_5,Sara,30,ES05209525001173802889,TRX_N-00868-30353884,2024-01-04T10:28:43,Donostia,Expense,leisure,-65.05,-39089.36
buyer_5,Sara,30,ES05209525001173802889,TRX_N-00869-85637211,2024-01-05T22:43:21,Donostia,expenses,gas,-85.32,-39174.68
buyer_5,Sara,30,ES05209525001173802889,TRX_N-00870-51984387,2024-01-05T13:35:29,Donostia,Expense,healthcare,-155.96,-39330.64
buyer_5,Sara,30,ES05209525001173802889,TRX_N-00871-16338507,2024-01-06T08:54:23,Donostia,expenses,water,-31.1,-39361.74
buyer_5,Sara,30,ES05209525001173802889,TRX_N-00872-47899743,2024-01-06T16:10:12,Donostia,expenses,internet,-42.0,-39403.74
buyer_5,Sara,30,ES05209525001173802889,TRX_N-00873-35991054,2024-01-06T14:59:47,Donostia,expenses,phone,-30.78,-39434.52
buyer_5,Sara,30,ES05209525001173802889,TRX_N-00874-36370311,2024-01-06T13:19:56,Donostia,expenses,children,-149.44,-39583.96
buyer_5,Sara,30,ES05209525001173802889,TRX_N-00875-22154116,2024-01-08T16:24:12,Donostia,expenses,electricity,-31.09,-39615.05
buyer_5,Sara,30,ES05209525001173802889,TRX_N-00876-89663285,2024-01-09T16:06:26,Donostia,Expense,food,-118.72,-39733.77
buyer_5,Sara,30,ES05209525001173802889,TRX_N-00877-24031264,2024-01-09T16:08:08,Donostia,Expense,education,-62.7,-39796.47
buyer_5,Sara,30,ES05209525001173802889,TRX_N-00878-09807782,2024-01-10T11:33:21,Donostia,Expense,transport,-78.61,-39875.08
buyer_5,Sara,30,ES05209525001173802889,TRX_N-00879-14615904,2024-01-12T10:19:40,Donostia,Expense,food,-119.04,-39994.12
buyer_5,Sara,30,ES05209525001173802889,TRX_N-00880-69704290,2024-01-12T08:05:33,Donostia,Expense,repairs,-202.56,-40196.68
buyer_5,Sara,30,ES05209525001173802889,TRX_N-00881-99320875,2024-01-14T12:33:28,Donostia,Expense,food,-66.37,-40263.05
buyer_5,Sara,30,ES05209525001173802889,TRX_N-00882-53732872,2024-01-16T04:51:46,Donostia,Expense,cash,-100.0,-40363.05
buyer_5,Sara,30,ES05209525001173802889,TRX_N-00883-30643190,2024-01-17T16:01:17,Donostia,Expense,cash,-100.0,-40463.05
buyer_5,Sara,30,ES05209525001173802889,TRX_N-00884-57483524,2024-01-20T15:28:04,Donostia,Expense,cash,-100.0,-40563.05
buyer_5,Sara,30,ES05209525001173802889,TRX_N-00885-23875290,2024-01-22T09:08:51,Lasarte-Oria,Expense,clothing,-108.77,-40671.82
buyer_5,Sara,30,ES05209525001173802889,TRX_N-00886-45023631,2024-01-22T18:24:44,Donostia,Expense,cash,-100.0,-40771.82
buyer_5,Sara,30,ES05209525001173802889,TRX_N-00887-60302142,2024-01-24T22:23:07,Donostia,Expense,clothing,-49.58,-40821.4
buyer_5,Sara,30,ES05209525001173802889,TRX_N-00888-39722608,2024-01-25T15:35:36,Donostia,Expense,cash,-100.0,-40921.4
buyer_5,Sara,30,ES05209525001173802889,TRX_N-00889-17044218,2024-01-26T11:13:58,Donostia,Expense,cash,-100.0,-41021.4
buyer_5,Sara,30,ES05209525001173802889,TRX_N-00890-38923005,2024-01-28T11:13:32,Donostia,Expense,appliances,-213.53,-41234.93
buyer_5,Sara,30,ES05209525001173802889,TRX_N-00891-00867192,2024-01-28T18:26:53,Donostia,Expense,repairs,-93.6,-41328.53
buyer_5,Sara,30,ES05209525001173802889,TRX_N-00892-58146755,2024-01-29T13:06:11,Donostia,Expense,clothing,-68.11,-41396.64
buyer_5,Sara,30,ES05209525001173802889,TRX_N-00893-14414846,2024-01-29T15:41:44,Donostia,Expense,cash,-100.0,-41496.64
buyer_5,Sara,30,ES05209525001173802889,TRX_N-00894-21060877,2024-01-30T21:47:21,Donostia,Expense,cash,-100.0,-41596.64
buyer_5,Sara,30,ES05209525001173802889,TRX_N-00895-13256875,2024-02-01T18:58:11,Donostia,incomes,salary,1426.69,-40169.95
buyer_5,Sara,30,ES05209525001173802889,TRX_N-00896-73541439,2024-02-01T18:58:11,Donostia,incomes,salary_partner,1202.04,-38967.91
buyer_5,Sara,30,ES05209525001173802889,TRX_N-00897-68347516,2024-02-01T18:58:11,Donostia,incomes,extra_income,151.29,-38816.62
buyer_5,Sara,30,ES05209525001173802889,TRX_N-00898-65050619,2024-02-01T07:30:15,Donostia,Expense,food,-81.67,-38898.29
buyer_5,Sara,30,ES05209525001173802889,TRX_N-00899-23278017,2024-02-01T08:55:43,Donostia,Expense,leisure,-59.05,-38957.34
buyer_5,Sara,30,ES05209525001173802889,TRX_N-00900-92120232,2024-02-02T08:58:03,Donostia,Expense,cash,-100.0,-39057.34
buyer_5,Sara,30,ES05209525001173802889,TRX_N-00901-07933928,2024-02-03T16:36:30,Donostia,Expense,transport,-56.06,-39113.4
buyer_5,Sara,30,ES05209525001173802889,TRX_N-00902-35062450,2024-02-04T08:39:44,Donostia,expenses,mortgage,-726.47,-39839.87
buyer_5,Sara,30,ES05209525001173802889,TRX_N-00903-09910888,2024-02-04T14:29:18,Arrasate,Expense,cash,-100.0,-39939.87
buyer_5,Sara,30,ES05209525001173802889,TRX_N-00904-05186996,2024-02-05T07:03:22,Donostia,expenses,water,-26.44,-39966.31
buyer_5,Sara,30,ES05209525001173802889,TRX_N-00905-97578481,2024-02-05T15:11:24,Donostia,expenses,electricity,-88.77,-40055.08
buyer_5,Sara,30,ES05209525001173802889,TRX_N-00906-64566378,2024-02-05T13:29:18,Donostia,expenses,gas,-62.84,-40117.92
buyer_5,Sara,30,ES05209525001173802889,TRX_N-00907-31353410,2024-02-05T15:14:19,Donostia,Expense,transport,-62.49,-40180.41
buyer_5,Sara,30,ES05209525001173802889,TRX_N-00908-61427995,2024-02-06T09:05:37,Donostia,expenses,phone,-43.91,-40224.32
buyer_5,Sara,30,ES05209525001173802889,TRX_N-00909-89820643,2024-02-07T17:18:52,Donostia,expenses,internet,-42.0,-40266.32
buyer_5,Sara,30,ES05209525001173802889,TRX_N-00910-02166275,2024-02-07T17:36:58,Donostia,Expense,transport,-48.9,-40315.22
buyer_5,Sara,30,ES05209525001173802889,TRX_N-00911-86761784,2024-02-11T17:57:22,Donostia,Expense,food,-121.74,-40436.96
buyer_5,Sara,30,ES05209525001173802889,TRX_N-00912-57161723,2024-02-11T14:23:28,Oy√≥n-Oion,Expense,education,-78.9,-40515.86
buyer_5,Sara,30,ES05209525001173802889,TRX_N-00913-22307138,2024-02-12T12:59:02,Zuia,Expense,cash,-100.0,-40615.86
buyer_5,Sara,30,ES05209525001173802889,TRX_N-00914-96336836,2024-02-13T13:39:05,Donostia,Expense,leisure,-21.7,-40637.56
buyer_5,Sara,30,ES05209525001173802889,TRX_N-00915-15286265,2024-02-15T20:29:33,Sopela,Expense,cash,-100.0,-40737.56
buyer_5,Sara,30,ES05209525001173802889,TRX_N-00916-55214501,2024-02-16T16:55:54,Donostia,Expense,clothing,-59.01,-40796.57
buyer_5,Sara,30,ES05209525001173802889,TRX_N-00917-46580873,2024-02-18T23:06:22,Donostia,Expense,repairs,-208.07,-41004.64
buyer_5,Sara,30,ES05209525001173802889,TRX_N-00918-00645613,2024-02-19T12:44:26,Andoain,Expense,cash,-100.0,-41104.64
buyer_5,Sara,30,ES05209525001173802889,TRX_N-00919-42694425,2024-02-20T11:11:02,Donostia,Expense,food,-81.59,-41186.23
buyer_5,Sara,30,ES05209525001173802889,TRX_N-00920-71883464,2024-02-22T18:38:02,Donostia,Expense,repairs,-71.61,-41257.84
buyer_5,Sara,30,ES05209525001173802889,TRX_N-00921-07940428,2024-02-23T17:35:00,Donostia,Expense,education,-65.4,-41323.24
buyer_5,Sara,30,ES05209525001173802889,TRX_N-00922-41158573,2024-02-23T10:14:40,Donostia,Expense,repairs,-241.19,-41564.43
buyer_5,Sara,30,ES05209525001173802889,TRX_N-00923-78853587,2024-02-28T14:19:37,Donostia,Expense,repairs,-125.61,-41690.04
buyer_5,Sara,30,ES05209525001173802889,TRX_N-00924-14740158,2024-03-01T11:40:41,Donostia,incomes,salary,1426.69,-40263.35
buyer_5,Sara,30,ES05209525001173802889,TRX_N-00925-06020037,2024-03-01T11:40:41,Donostia,incomes,salary_partner,1202.04,-39061.31
buyer_5,Sara,30,ES05209525001173802889,TRX_N-00926-90656054,2024-03-03T19:21:30,Donostia,Expense,cash,-100.0,-39161.31
buyer_5,Sara,30,ES05209525001173802889,TRX_N-00927-15427354,2024-03-04T11:08:31,Donostia,expenses,mortgage,-726.47,-39887.78
buyer_5,Sara,30,ES05209525001173802889,TRX_N-00928-52298467,2024-03-05T18:40:19,Donostia,expenses,gas,-97.74,-39985.52
buyer_5,Sara,30,ES05209525001173802889,TRX_N-00929-89219048,2024-03-05T19:06:03,Donostia,expenses,internet,-42.0,-40027.52
buyer_5,Sara,30,ES05209525001173802889,TRX_N-00930-71334450,2024-03-05T10:34:18,Donostia,expenses,phone,-33.06,-40060.58
buyer_5,Sara,30,ES05209525001173802889,TRX_N-00931-39281821,2024-03-05T19:28:38,Donostia,Expense,transport,-69.3,-40129.88
buyer_5,Sara,30,ES05209525001173802889,TRX_N-00932-58948358,2024-03-05T17:17:38,Donostia,Expense,cash,-100.0,-40229.88
buyer_5,Sara,30,ES05209525001173802889,TRX_N-00933-21644089,2024-03-06T11:52:59,Donostia,expenses,water,-25.57,-40255.45
buyer_5,Sara,30,ES05209525001173802889,TRX_N-00934-70969515,2024-03-07T19:17:47,Donostia,Expense,food,-67.56,-40323.01
buyer_5,Sara,30,ES05209525001173802889,TRX_N-00935-76558019,2024-03-07T23:57:27,Donostia,Expense,cash,-100.0,-40423.01
buyer_5,Sara,30,ES05209525001173802889,TRX_N-00936-59291983,2024-03-08T20:15:24,Donostia,expenses,electricity,-35.78,-40458.79
buyer_5,Sara,30,ES05209525001173802889,TRX_N-00937-94098077,2024-03-08T10:11:41,Donostia,Expense,cash,-100.0,-40558.79
buyer_5,Sara,30,ES05209525001173802889,TRX_N-00938-56722070,2024-03-09T19:53:17,Donostia,Expense,leisure,-68.39,-40627.18
buyer_5,Sara,30,ES05209525001173802889,TRX_N-00939-74738443,2024-03-09T22:23:32,Donostia,Expense,clothing,-143.7,-40770.88
buyer_5,Sara,30,ES05209525001173802889,TRX_N-00940-22752706,2024-03-09T15:43:50,Durango,Expense,cash,-100.0,-40870.88
buyer_5,Sara,30,ES05209525001173802889,TRX_N-00941-85980976,2024-03-11T09:01:49,Donostia,Expense,cash,-100.0,-40970.88
buyer_5,Sara,30,ES05209525001173802889,TRX_N-00942-95007333,2024-03-13T13:24:44,Donostia,Expense,clothing,-49.91,-41020.79
buyer_5,Sara,30,ES05209525001173802889,TRX_N-00943-47226254,2024-03-13T08:33:53,Donostia,Expense,repairs,-237.81,-41258.6
buyer_5,Sara,30,ES05209525001173802889,TRX_N-00944-22147493,2024-03-14T08:58:16,Donostia,Expense,leisure,-34.39,-41292.99
buyer_5,Sara,30,ES05209525001173802889,TRX_N-00945-45874094,2024-03-14T14:19:09,Donostia,Expense,cash,-100.0,-41392.99
buyer_5,Sara,30,ES05209525001173802889,TRX_N-00946-19329418,2024-03-15T16:52:20,Donostia,Expense,cash,-100.0,-41492.99
buyer_5,Sara,30,ES05209525001173802889,TRX_N-00947-00235143,2024-03-16T16:19:39,Zarautz,Expense,transport,-44.77,-41537.76
buyer_5,Sara,30,ES05209525001173802889,TRX_N-00948-42625384,2024-03-17T19:26:27,Donostia,Expense,food,-113.0,-41650.76
buyer_5,Sara,30,ES05209525001173802889,TRX_N-00949-26745747,2024-03-17T18:39:15,Donostia,Expense,transport,-79.56,-41730.32
buyer_5,Sara,30,ES05209525001173802889,TRX_N-00950-06309468,2024-03-17T10:38:19,Donostia,Expense,leisure,-67.18,-41797.5
buyer_5,Sara,30,ES05209525001173802889,TRX_N-00951-81091200,2024-03-19T08:03:13,Iru√±a de Oca,Expense,food,-84.94,-41882.44
buyer_5,Sara,30,ES05209525001173802889,TRX_N-00952-03709257,2024-03-19T14:41:40,Zarautz,Expense,cash,-100.0,-41982.44
buyer_5,Sara,30,ES05209525001173802889,TRX_N-00953-03325960,2024-03-20T15:01:37,Donostia,Expense,cash,-100.0,-42082.44
buyer_5,Sara,30,ES05209525001173802889,TRX_N-00954-95968024,2024-03-21T10:22:18,Donostia,Expense,food,-69.31,-42151.75
buyer_5,Sara,30,ES05209525001173802889,TRX_N-00955-01980598,2024-03-23T18:22:58,Alegr√≠a-Dulantzi,Expense,food,-86.91,-42238.66
buyer_5,Sara,30,ES05209525001173802889,TRX_N-00956-38003217,2024-03-24T15:56:10,Donostia,Expense,clothing,-150.35,-42389.01
buyer_5,Sara,30,ES05209525001173802889,TRX_N-00957-33002876,2024-03-24T12:47:35,Donostia,Expense,cash,-100.0,-42489.01
buyer_5,Sara,30,ES05209525001173802889,TRX_N-00958-53721648,2024-03-25T02:35:48,Donostia,Expense,transport,-60.54,-42549.55
buyer_5,Sara,30,ES05209525001173802889,TRX_N-00959-24023511,2024-03-26T16:10:45,Donostia,expenses,children,-250.29,-42799.84
buyer_5,Sara,30,ES05209525001173802889,TRX_N-00960-00761123,2024-03-27T10:36:11,Donostia,Expense,cash,-100.0,-42899.84
buyer_5,Sara,30,ES05209525001173802889,TRX_N-00961-85411590,2024-03-27T20:11:25,Llodio,Expense,appliances,-90.42,-42990.26
buyer_5,Sara,30,ES05209525001173802889,TRX_N-00962-50289933,2024-03-28T15:04:11,Donostia,Expense,clothing,-86.15,-43076.41
buyer_5,Sara,30,ES05209525001173802889,TRX_N-00963-95146386,2024-03-30T09:25:49,Donostia,Expense,gifts,-528.98,-43605.39
buyer_5,Sara,30,ES05209525001173802889,TRX_N-00964-14647382,2024-03-31T13:28:51,Errenteria,Expense,transport,-71.58,-43676.97
buyer_5,Sara,30,ES05209525001173802889,TRX_N-00965-23828346,2024-03-31T14:17:13,Donostia,Expense,leisure,-55.49,-43732.46
buyer_5,Sara,30,ES05209525001173802889,TRX_N-00966-24065445,2024-04-01T11:34:30,Donostia,incomes,salary,1426.69,-42305.77
buyer_5,Sara,30,ES05209525001173802889,TRX_N-00967-13779540,2024-04-01T11:34:30,Donostia,incomes,salary_partner,1202.04,-41103.73
buyer_5,Sara,30,ES05209525001173802889,TRX_N-00968-99108808,2024-04-01T14:45:47,Donostia,Expense,leisure,-30.57,-41134.3
buyer_5,Sara,30,ES05209525001173802889,TRX_N-00969-11840955,2024-04-02T16:33:00,Donostia,Expense,cash,-100.0,-41234.3
buyer_5,Sara,30,ES05209525001173802889,TRX_N-00970-14401072,2024-04-04T18:07:55,Donostia,expenses,mortgage,-726.47,-41960.77
buyer_5,Sara,30,ES05209525001173802889,TRX_N-00971-55534926,2024-04-05T18:09:35,Donostia,Expense,food,-113.89,-42074.66
buyer_5,Sara,30,ES05209525001173802889,TRX_N-00972-95497878,2024-04-05T18:12:26,Donostia,Expense,appliances,-353.61,-42428.27
buyer_5,Sara,30,ES05209525001173802889,TRX_N-00973-93305401,2024-04-06T13:53:47,Donostia,expenses,electricity,-34.91,-42463.18
buyer_5,Sara,30,ES05209525001173802889,TRX_N-00974-49038235,2024-04-07T18:13:46,Donostia,Expense,food,-124.91,-42588.09
buyer_5,Sara,30,ES05209525001173802889,TRX_N-00975-59612219,2024-04-08T13:56:21,Donostia,expenses,water,-25.89,-42613.98
buyer_5,Sara,30,ES05209525001173802889,TRX_N-00976-48207461,2024-04-08T14:37:12,Donostia,expenses,gas,-111.89,-42725.87
buyer_5,Sara,30,ES05209525001173802889,TRX_N-00977-86436666,2024-04-08T22:12:59,Donostia,expenses,internet,-42.0,-42767.87
buyer_5,Sara,30,ES05209525001173802889,TRX_N-00978-80433225,2024-04-08T14:55:39,Donostia,expenses,phone,-33.16,-42801.03
buyer_5,Sara,30,ES05209525001173802889,TRX_N-00979-71300112,2024-04-08T09:18:28,Donostia,Expense,cash,-100.0,-42901.03
buyer_5,Sara,30,ES05209525001173802889,TRX_N-00980-84461964,2024-04-09T11:10:30,Donostia,Expense,clothing,-65.99,-42967.02
buyer_5,Sara,30,ES05209525001173802889,TRX_N-00981-13331589,2024-04-16T08:51:24,Lasarte-Oria,Expense,food,-95.23,-43062.25
buyer_5,Sara,30,ES05209525001173802889,TRX_N-00982-85604354,2024-04-16T23:13:56,Donostia,Expense,clothing,-158.97,-43221.22
buyer_5,Sara,30,ES05209525001173802889,TRX_N-00983-52156940,2024-04-17T13:59:54,Donostia,Expense,clothing,-63.61,-43284.83
buyer_5,Sara,30,ES05209525001173802889,TRX_N-00984-81943690,2024-04-18T19:50:32,Donostia,Expense,food,-77.86,-43362.69
buyer_5,Sara,30,ES05209525001173802889,TRX_N-00985-08416975,2024-04-20T09:39:16,Donostia,Expense,healthcare,-144.12,-43506.81
buyer_5,Sara,30,ES05209525001173802889,TRX_N-00986-46020232,2024-04-20T14:33:28,Donostia,Expense,repairs,-264.0,-43770.81
buyer_5,Sara,30,ES05209525001173802889,TRX_N-00987-61700392,2024-04-21T23:03:43,Donostia,Expense,healthcare,-128.36,-43899.17
buyer_5,Sara,30,ES05209525001173802889,TRX_N-00988-16247114,2024-04-22T16:27:13,Donostia,Expense,food,-124.07,-44023.24
buyer_5,Sara,30,ES05209525001173802889,TRX_N-00989-60660155,2024-04-22T08:34:47,Donostia,Expense,education,-63.55,-44086.79
buyer_5,Sara,30,ES05209525001173802889,TRX_N-00990-30111286,2024-04-23T12:59:57,Donostia,Expense,leisure,-43.7,-44130.49
buyer_5,Sara,30,ES05209525001173802889,TRX_N-00991-25897583,2024-04-23T15:45:06,Donostia,Expense,cash,-100.0,-44230.49
buyer_5,Sara,30,ES05209525001173802889,TRX_N-00992-22435105,2024-04-25T18:14:17,Donostia,Expense,gifts,-762.95,-44993.44
buyer_5,Sara,30,ES05209525001173802889,TRX_N-00993-20808144,2024-04-26T09:16:40,Donostia,Expense,leisure,-69.93,-45063.37
buyer_5,Sara,30,ES05209525001173802889,TRX_N-00994-36690976,2024-04-27T15:17:33,Berango,Expense,healthcare,-57.76,-45121.13
buyer_5,Sara,30,ES05209525001173802889,TRX_N-00995-30719814,2024-04-29T14:25:43,Basauri,Expense,food,-61.85,-45182.98
buyer_5,Sara,30,ES05209525001173802889,TRX_N-00996-19252936,2024-04-30T17:03:18,Portugalete,Expense,food,-107.96,-45290.94
buyer_5,Sara,30,ES05209525001173802889,TRX_N-00997-24257303,2024-05-01T15:39:56,Donostia,incomes,salary,1426.69,-43864.25
buyer_5,Sara,30,ES05209525001173802889,TRX_N-00998-50195832,2024-05-01T15:39:56,Donostia,incomes,salary_partner,1202.04,-42662.21
buyer_5,Sara,30,ES05209525001173802889,TRX_N-00999-73773945,2024-05-01T16:19:24,Donostia,Expense,transport,-58.44,-42720.65
buyer_5,Sara,30,ES05209525001173802889,TRX_N-01000-14491458,2024-05-01T15:42:24,Donostia,Expense,clothing,-76.31,-42796.96
buyer_5,Sara,30,ES05209525001173802889,TRX_N-01001-28099068,2024-05-01T08:19:08,Basauri,Expense,cash,-100.0,-42896.96
buyer_5,Sara,30,ES05209525001173802889,TRX_N-01002-51403534,2024-05-04T15:03:52,Donostia,expenses,mortgage,-726.47,-43623.43
buyer_5,Sara,30,ES05209525001173802889,TRX_N-01003-71310805,2024-05-04T19:48:09,Donostia,Expense,leisure,-77.17,-43700.6
buyer_5,Sara,30,ES05209525001173802889,TRX_N-01004-66993647,2024-05-04T11:46:23,Santurtzi,Expense,cash,-100.0,-43800.6
buyer_5,Sara,30,ES05209525001173802889,TRX_N-01005-19371002,2024-05-05T14:03:24,Donostia,Expense,healthcare,-63.56,-43864.16
buyer_5,Sara,30,ES05209525001173802889,TRX_N-01006-61404804,2024-05-05T17:04:06,Donostia,Expense,cash,-100.0,-43964.16
buyer_5,Sara,30,ES05209525001173802889,TRX_N-01007-37367106,2024-05-06T09:10:09,Donostia,expenses,gas,-63.99,-44028.15
buyer_5,Sara,30,ES05209525001173802889,TRX_N-01008-63435262,2024-05-07T12:33:10,Donostia,expenses,internet,-42.0,-44070.15
buyer_5,Sara,30,ES05209525001173802889,TRX_N-01009-58089501,2024-05-07T17:55:46,Donostia,expenses,phone,-33.81,-44103.96
buyer_5,Sara,30,ES05209525001173802889,TRX_N-01010-19785000,2024-05-08T16:03:18,Donostia,expenses,water,-36.25,-44140.21
buyer_5,Sara,30,ES05209525001173802889,TRX_N-01011-07330633,2024-05-08T19:05:32,Donostia,expenses,electricity,-23.22,-44163.43
buyer_5,Sara,30,ES05209525001173802889,TRX_N-01012-99920024,2024-05-08T23:35:32,Donostia,Expense,leisure,-22.45,-44185.88
buyer_5,Sara,30,ES05209525001173802889,TRX_N-01013-08985942,2024-05-08T20:11:08,Donostia,Expense,repairs,-123.46,-44309.34
buyer_5,Sara,30,ES05209525001173802889,TRX_N-01014-57194229,2024-05-12T13:39:53,Donostia,Expense,clothing,-72.71,-44382.05
buyer_5,Sara,30,ES05209525001173802889,TRX_N-01015-49828951,2024-05-13T23:30:54,Donostia,Expense,transport,-42.84,-44424.89
buyer_5,Sara,30,ES05209525001173802889,TRX_N-01016-44665750,2024-05-13T20:09:52,Donostia,Expense,leisure,-53.11,-44478.0
buyer_5,Sara,30,ES05209525001173802889,TRX_N-01017-34738195,2024-05-15T13:50:47,Donostia,Expense,gifts,-177.6,-44655.6
buyer_5,Sara,30,ES05209525001173802889,TRX_N-01018-70777105,2024-05-16T10:26:43,Pasaia,Expense,leisure,-36.25,-44691.85
buyer_5,Sara,30,ES05209525001173802889,TRX_N-01019-93463131,2024-05-17T18:13:32,Bermeo,Expense,food,-90.28,-44782.13
buyer_5,Sara,30,ES05209525001173802889,TRX_N-01020-33736730,2024-05-18T20:03:01,Donostia,Expense,food,-60.12,-44842.25
buyer_5,Sara,30,ES05209525001173802889,TRX_N-01021-60415623,2024-05-19T19:33:08,Donostia,Expense,food,-110.26,-44952.51
buyer_5,Sara,30,ES05209525001173802889,TRX_N-01022-55544794,2024-05-19T17:09:38,Donostia,Expense,leisure,-35.06,-44987.57
buyer_5,Sara,30,ES05209525001173802889,TRX_N-01023-19194223,2024-05-22T21:28:38,Donostia,Expense,food,-112.73,-45100.3
buyer_5,Sara,30,ES05209525001173802889,TRX_N-01024-73281607,2024-05-23T21:55:49,Donostia,Expense,food,-106.32,-45206.62
buyer_5,Sara,30,ES05209525001173802889,TRX_N-01025-50337993,2024-05-24T17:51:22,Donostia,Expense,cash,-100.0,-45306.62
buyer_5,Sara,30,ES05209525001173802889,TRX_N-01026-29987844,2024-05-26T12:58:07,Donostia,Expense,food,-71.56,-45378.18
buyer_5,Sara,30,ES05209525001173802889,TRX_N-01027-45471454,2024-05-27T10:29:49,Donostia,Expense,leisure,-54.21,-45432.39
buyer_5,Sara,30,ES05209525001173802889,TRX_N-01028-64436976,2024-05-28T11:17:54,Donostia,Expense,gifts,-329.48,-45761.87
buyer_5,Sara,30,ES05209525001173802889,TRX_N-01029-68650076,2024-05-30T16:56:41,Errenteria,Expense,healthcare,-55.16,-45817.03
buyer_5,Sara,30,ES05209525001173802889,TRX_N-01030-90425014,2024-05-30T09:49:05,Donostia,Expense,repairs,-130.53,-45947.56
buyer_5,Sara,30,ES05209525001173802889,TRX_N-01031-35333712,2024-05-31T17:15:18,Donostia,Expense,food,-88.02,-46035.58
buyer_5,Sara,30,ES05209525001173802889,TRX_N-01032-30239380,2024-06-01T16:52:10,Donostia,incomes,salary,1426.69,-44608.89
buyer_5,Sara,30,ES05209525001173802889,TRX_N-01033-28367955,2024-06-01T16:52:10,Donostia,incomes,salary_partner,1202.04,-43406.85
buyer_5,Sara,30,ES05209525001173802889,TRX_N-01034-45302836,2024-06-01T16:52:10,Donostia,incomes,extra_income,151.29,-43255.56
buyer_5,Sara,30,ES05209525001173802889,TRX_N-01035-38995704,2024-06-01T16:52:10,Donostia,incomes,salary_bonus,1081.05,-42174.51
buyer_5,Sara,30,ES05209525001173802889,TRX_N-01036-79765383,2024-06-01T16:52:10,Donostia,incomes,salary_partner_bonus,928.19,-41246.32
buyer_5,Sara,30,ES05209525001173802889,TRX_N-01037-30372755,2024-06-01T14:33:52,Portugalete,Expense,transport,-88.59,-41334.91
buyer_5,Sara,30,ES05209525001173802889,TRX_N-01038-24408000,2024-06-02T18:05:00,Basauri,Expense,leisure,-33.46,-41368.37
buyer_5,Sara,30,ES05209525001173802889,TRX_N-01039-12937533,2024-06-03T14:33:58,Bermeo,Expense,travel,-1166.44,-42534.81
buyer_5,Sara,30,ES05209525001173802889,TRX_N-01040-83606073,2024-06-04T09:38:18,Donostia,expenses,mortgage,-726.47,-43261.28
buyer_5,Sara,30,ES05209525001173802889,TRX_N-01041-66076343,2024-06-04T14:21:30,Donostia,Expense,cash,-100.0,-43361.28
buyer_5,Sara,30,ES05209525001173802889,TRX_N-01042-27433234,2024-06-05T16:31:57,Donostia,expenses,phone,-31.73,-43393.01
buyer_5,Sara,30,ES05209525001173802889,TRX_N-01043-51912309,2024-06-05T18:02:12,Donostia,Expense,leisure,-74.41,-43467.42
buyer_5,Sara,30,ES05209525001173802889,TRX_N-01044-52106104,2024-06-06T11:05:23,Donostia,expenses,electricity,-27.68,-43495.1
buyer_5,Sara,30,ES05209525001173802889,TRX_N-01045-77704057,2024-06-06T01:14:07,Donostia,Expense,education,-51.99,-43547.09
buyer_5,Sara,30,ES05209525001173802889,TRX_N-01046-71515519,2024-06-07T10:51:18,Donostia,Expense,cash,-100.0,-43647.09
buyer_5,Sara,30,ES05209525001173802889,TRX_N-01047-54813211,2024-06-08T17:20:36,Donostia,expenses,water,-26.33,-43673.42
buyer_5,Sara,30,ES05209525001173802889,TRX_N-01048-27163666,2024-06-08T09:29:27,Donostia,expenses,gas,-98.82,-43772.24
buyer_5,Sara,30,ES05209525001173802889,TRX_N-01049-90281580,2024-06-08T18:37:30,Donostia,expenses,internet,-42.0,-43814.24
buyer_5,Sara,30,ES05209525001173802889,TRX_N-01050-95154349,2024-06-08T10:35:30,Donostia,Expense,food,-79.94,-43894.18
buyer_5,Sara,30,ES05209525001173802889,TRX_N-01051-64566766,2024-06-10T20:00:39,Donostia,Expense,cash,-100.0,-43994.18
buyer_5,Sara,30,ES05209525001173802889,TRX_N-01052-80788439,2024-06-11T11:42:07,Donostia,Expense,food,-118.11,-44112.29
buyer_5,Sara,30,ES05209525001173802889,TRX_N-01053-32816185,2024-06-11T09:32:33,Donostia,Expense,appliances,-321.64,-44433.93
buyer_5,Sara,30,ES05209525001173802889,TRX_N-01054-64687292,2024-06-12T22:39:13,Donostia,Expense,transport,-86.18,-44520.11
buyer_5,Sara,30,ES05209525001173802889,TRX_N-01055-00264045,2024-06-14T19:17:56,Donostia,Expense,education,-72.06,-44592.17
buyer_5,Sara,30,ES05209525001173802889,TRX_N-01056-24142547,2024-06-14T06:43:29,Donostia,Expense,cash,-100.0,-44692.17
buyer_5,Sara,30,ES05209525001173802889,TRX_N-01057-98915619,2024-06-15T13:25:53,Donostia,Expense,food,-111.42,-44803.59
buyer_5,Sara,30,ES05209525001173802889,TRX_N-01058-70333217,2024-06-15T22:15:34,Donostia,Expense,repairs,-125.73,-44929.32
buyer_5,Sara,30,ES05209525001173802889,TRX_N-01059-95720583,2024-06-15T19:52:35,Donostia,expenses,children,-175.37,-45104.69
buyer_5,Sara,30,ES05209525001173802889,TRX_N-01060-11490303,2024-06-17T17:49:54,Zarautz,Expense,transport,-82.98,-45187.67
buyer_5,Sara,30,ES05209525001173802889,TRX_N-01061-42844382,2024-06-17T10:06:40,Donostia,Expense,leisure,-42.2,-45229.87
buyer_5,Sara,30,ES05209525001173802889,TRX_N-01062-06165957,2024-06-17T05:22:36,Hondarribia,Expense,appliances,-356.98,-45586.85
buyer_5,Sara,30,ES05209525001173802889,TRX_N-01063-46664164,2024-06-18T21:03:11,Leioa,Expense,transport,-44.75,-45631.6
buyer_5,Sara,30,ES05209525001173802889,TRX_N-01064-98215770,2024-06-19T07:55:18,Donostia,Expense,repairs,-236.88,-45868.48
buyer_5,Sara,30,ES05209525001173802889,TRX_N-01065-09982317,2024-06-21T15:15:07,Oy√≥n-Oion,Expense,cash,-100.0,-45968.48
buyer_5,Sara,30,ES05209525001173802889,TRX_N-01066-80662344,2024-06-22T11:12:16,Berango,Expense,leisure,-38.03,-46006.51
buyer_5,Sara,30,ES05209525001173802889,TRX_N-01067-53345671,2024-06-22T15:55:54,Donostia,Expense,clothing,-71.37,-46077.88
buyer_5,Sara,30,ES05209525001173802889,TRX_N-01068-75262292,2024-06-22T08:40:24,Eibar,Expense,appliances,-194.53,-46272.41
buyer_5,Sara,30,ES05209525001173802889,TRX_N-01069-47739754,2024-06-22T12:51:45,Donostia,expenses,children,-224.82,-46497.23
buyer_5,Sara,30,ES05209525001173802889,TRX_N-01070-76464715,2024-06-23T19:01:39,Donostia,Expense,leisure,-81.04,-46578.27
buyer_5,Sara,30,ES05209525001173802889,TRX_N-01071-03215579,2024-06-27T13:34:19,Donostia,Expense,cash,-100.0,-46678.27
buyer_5,Sara,30,ES05209525001173802889,TRX_N-01072-48577061,2024-06-28T09:13:42,Leioa,Expense,cash,-100.0,-46778.27
buyer_5,Sara,30,ES05209525001173802889,TRX_N-01073-77272565,2024-07-01T15:01:14,Donostia,incomes,salary,1426.69,-45351.58
buyer_5,Sara,30,ES05209525001173802889,TRX_N-01074-51391899,2024-07-01T15:01:14,Donostia,incomes,salary_partner,1202.04,-44149.54
buyer_5,Sara,30,ES05209525001173802889,TRX_N-01075-16661466,2024-07-01T19:08:56,Donostia,Expense,gifts,-360.37,-44509.91
buyer_5,Sara,30,ES05209525001173802889,TRX_N-01076-62232086,2024-07-02T00:34:06,Donostia,Expense,clothing,-55.29,-44565.2
buyer_5,Sara,30,ES05209525001173802889,TRX_N-01077-80681960,2024-07-03T17:06:49,Donostia,Expense,leisure,-57.13,-44622.33
buyer_5,Sara,30,ES05209525001173802889,TRX_N-01078-51526934,2024-07-03T23:25:04,Donostia,Expense,cash,-100.0,-44722.33
buyer_5,Sara,30,ES05209525001173802889,TRX_N-01079-06748386,2024-07-03T10:02:03,Donostia,expenses,children,-111.01,-44833.34
buyer_5,Sara,30,ES05209525001173802889,TRX_N-01080-88982606,2024-07-04T09:48:48,Donostia,expenses,mortgage,-726.47,-45559.81
buyer_5,Sara,30,ES05209525001173802889,TRX_N-01081-31987121,2024-07-04T00:35:39,Donostia,Expense,transport,-86.71,-45646.52
buyer_5,Sara,30,ES05209525001173802889,TRX_N-01082-87599097,2024-07-05T20:45:08,Lasarte-Oria,Expense,cash,-100.0,-45746.52
buyer_5,Sara,30,ES05209525001173802889,TRX_N-01083-27198518,2024-07-06T16:48:27,Donostia,expenses,electricity,-47.3,-45793.82
buyer_5,Sara,30,ES05209525001173802889,TRX_N-01084-18022178,2024-07-06T13:30:59,Donostia,expenses,phone,-33.96,-45827.78
buyer_5,Sara,30,ES05209525001173802889,TRX_N-01085-49381579,2024-07-06T17:00:28,Donostia,Expense,transport,-84.81,-45912.59
buyer_5,Sara,30,ES05209525001173802889,TRX_N-01086-08473298,2024-07-08T15:32:51,Donostia,expenses,water,-42.66,-45955.25
buyer_5,Sara,30,ES05209525001173802889,TRX_N-01087-26113954,2024-07-08T15:28:06,Donostia,expenses,gas,-103.49,-46058.74
buyer_5,Sara,30,ES05209525001173802889,TRX_N-01088-35818061,2024-07-08T05:39:19,Donostia,expenses,internet,-42.0,-46100.74
buyer_5,Sara,30,ES05209525001173802889,TRX_N-01089-92928996,2024-07-09T23:13:53,Donostia,Expense,gifts,-517.85,-46618.59
buyer_5,Sara,30,ES05209525001173802889,TRX_N-01090-48518575,2024-07-10T09:07:42,Donostia,Expense,leisure,-80.57,-46699.16
buyer_5,Sara,30,ES05209525001173802889,TRX_N-01091-01654554,2024-07-10T16:02:34,Donostia,Expense,cash,-100.0,-46799.16
buyer_5,Sara,30,ES05209525001173802889,TRX_N-01092-72561831,2024-07-11T09:11:28,Donostia,Expense,leisure,-74.0,-46873.16
buyer_5,Sara,30,ES05209525001173802889,TRX_N-01093-27092957,2024-07-12T17:00:46,Donostia,Expense,leisure,-74.04,-46947.2
buyer_5,Sara,30,ES05209525001173802889,TRX_N-01094-33200026,2024-07-13T10:13:44,Donostia,Expense,food,-91.38,-47038.58
buyer_5,Sara,30,ES05209525001173802889,TRX_N-01095-35616241,2024-07-16T08:08:09,Donostia,Expense,appliances,-120.35,-47158.93
buyer_5,Sara,30,ES05209525001173802889,TRX_N-01096-92198698,2024-07-17T13:13:50,Erandio,Expense,leisure,-53.0,-47211.93
buyer_5,Sara,30,ES05209525001173802889,TRX_N-01097-86601432,2024-07-17T21:45:46,Donostia,Expense,cash,-100.0,-47311.93
buyer_5,Sara,30,ES05209525001173802889,TRX_N-01098-33955726,2024-07-24T14:11:21,Salvatierra/Agurain,Expense,leisure,-78.38,-47390.31
buyer_5,Sara,30,ES05209525001173802889,TRX_N-01099-38998046,2024-07-24T09:45:30,Donostia,Expense,repairs,-69.86,-47460.17
buyer_5,Sara,30,ES05209525001173802889,TRX_N-01100-75416424,2024-07-28T21:16:59,Donostia,Expense,transport,-53.77,-47513.94
buyer_5,Sara,30,ES05209525001173802889,TRX_N-01101-66858298,2024-07-29T19:27:20,Donostia,Expense,cash,-100.0,-47613.94
buyer_5,Sara,30,ES05209525001173802889,TRX_N-01102-38627636,2024-07-29T18:24:20,Donostia,Expense,repairs,-122.15,-47736.09
buyer_5,Sara,30,ES05209525001173802889,TRX_N-01103-37679981,2024-07-30T16:51:22,Donostia,Expense,cash,-100.0,-47836.09
buyer_5,Sara,30,ES05209525001173802889,TRX_N-01104-48830017,2024-08-01T11:08:47,Donostia,incomes,salary,1426.69,-46409.4
buyer_5,Sara,30,ES05209525001173802889,TRX_N-01105-18681538,2024-08-01T11:08:47,Donostia,incomes,salary_partner,1202.04,-45207.36
buyer_5,Sara,30,ES05209525001173802889,TRX_N-01106-30069672,2024-08-02T12:05:49,Donostia,Expense,appliances,-259.19,-45466.55
buyer_5,Sara,30,ES05209525001173802889,TRX_N-01107-07546327,2024-08-03T10:08:56,Bermeo,Expense,transport,-47.21,-45513.76
buyer_5,Sara,30,ES05209525001173802889,TRX_N-01108-10021328,2024-08-03T16:16:33,Getxo,Expense,healthcare,-161.29,-45675.05
buyer_5,Sara,30,ES05209525001173802889,TRX_N-01109-11779422,2024-08-04T09:51:24,Donostia,expenses,mortgage,-726.47,-46401.52
buyer_5,Sara,30,ES05209525001173802889,TRX_N-01110-81496382,2024-08-04T02:46:05,Donostia,Expense,education,-45.5,-46447.02
buyer_5,Sara,30,ES05209525001173802889,TRX_N-01111-08009880,2024-08-05T16:39:13,Donostia,Expense,transport,-72.83,-46519.85
buyer_5,Sara,30,ES05209525001173802889,TRX_N-01112-24036265,2024-08-06T14:59:30,Donostia,expenses,electricity,-55.7,-46575.55
buyer_5,Sara,30,ES05209525001173802889,TRX_N-01113-84308920,2024-08-06T16:55:14,Donostia,Expense,food,-76.42,-46651.97
buyer_5,Sara,30,ES05209525001173802889,TRX_N-01114-10736845,2024-08-06T14:24:05,Donostia,Expense,transport,-69.63,-46721.6
buyer_5,Sara,30,ES05209525001173802889,TRX_N-01115-88706272,2024-08-07T20:25:26,Donostia,expenses,phone,-34.97,-46756.57
buyer_5,Sara,30,ES05209525001173802889,TRX_N-01116-10435938,2024-08-07T23:06:24,Donostia,Expense,food,-85.28,-46841.85
buyer_5,Sara,30,ES05209525001173802889,TRX_N-01117-83378426,2024-08-08T20:50:35,Donostia,expenses,water,-33.13,-46874.98
buyer_5,Sara,30,ES05209525001173802889,TRX_N-01118-50171519,2024-08-08T16:53:53,Donostia,expenses,gas,-108.48,-46983.46
buyer_5,Sara,30,ES05209525001173802889,TRX_N-01119-12613271,2024-08-08T14:03:24,Donostia,expenses,internet,-42.0,-47025.46
buyer_5,Sara,30,ES05209525001173802889,TRX_N-01120-59244613,2024-08-13T15:41:12,Donostia,Expense,leisure,-78.82,-47104.28
buyer_5,Sara,30,ES05209525001173802889,TRX_N-01121-22428643,2024-08-13T20:38:32,Donostia,Expense,education,-45.64,-47149.92
buyer_5,Sara,30,ES05209525001173802889,TRX_N-01122-65068910,2024-08-13T22:30:17,Donostia,Expense,repairs,-59.04,-47208.96
buyer_5,Sara,30,ES05209525001173802889,TRX_N-01123-34183329,2024-08-15T16:56:23,Donostia,Expense,food,-92.15,-47301.11
buyer_5,Sara,30,ES05209525001173802889,TRX_N-01124-29223090,2024-08-17T01:07:11,Labastida,Expense,education,-60.46,-47361.57
buyer_5,Sara,30,ES05209525001173802889,TRX_N-01125-43485661,2024-08-18T18:02:14,Donostia,Expense,cash,-100.0,-47461.57
buyer_5,Sara,30,ES05209525001173802889,TRX_N-01126-03554042,2024-08-19T08:39:28,Donostia,Expense,leisure,-59.58,-47521.15
buyer_5,Sara,30,ES05209525001173802889,TRX_N-01127-63578952,2024-08-22T00:16:07,Donostia,Expense,food,-105.33,-47626.48
buyer_5,Sara,30,ES05209525001173802889,TRX_N-01128-00214427,2024-08-22T17:31:44,Donostia,Expense,transport,-41.76,-47668.24
buyer_5,Sara,30,ES05209525001173802889,TRX_N-01129-54902304,2024-08-22T08:41:47,Donostia,Expense,leisure,-74.83,-47743.07
buyer_5,Sara,30,ES05209525001173802889,TRX_N-01130-18764590,2024-08-22T16:57:27,Donostia,Expense,clothing,-138.87,-47881.94
buyer_5,Sara,30,ES05209525001173802889,TRX_N-01131-14264141,2024-08-25T09:00:23,Arrasate,Expense,food,-88.56,-47970.5
buyer_5,Sara,30,ES05209525001173802889,TRX_N-01132-46840602,2024-08-25T09:37:35,Donostia,Expense,transport,-67.64,-48038.14
buyer_5,Sara,30,ES05209525001173802889,TRX_N-01133-12622336,2024-08-25T11:01:41,Donostia,Expense,repairs,-234.78,-48272.92
buyer_5,Sara,30,ES05209525001173802889,TRX_N-01134-44739825,2024-08-27T12:14:23,Donostia,Expense,transport,-49.07,-48321.99
buyer_5,Sara,30,ES05209525001173802889,TRX_N-01135-96122342,2024-08-28T20:48:08,Donostia,Expense,food,-85.9,-48407.89
buyer_5,Sara,30,ES05209525001173802889,TRX_N-01136-96890795,2024-08-29T11:02:03,Donostia,Expense,food,-112.56,-48520.45
buyer_5,Sara,30,ES05209525001173802889,TRX_N-01137-02823005,2024-08-30T12:26:35,Donostia,Expense,cash,-100.0,-48620.45
buyer_5,Sara,30,ES05209525001173802889,TRX_N-01138-29053619,2024-09-01T03:09:00,Donostia,incomes,salary,1426.69,-47193.76
buyer_5,Sara,30,ES05209525001173802889,TRX_N-01139-74543446,2024-09-01T03:09:00,Donostia,incomes,salary_partner,1202.04,-45991.72
buyer_5,Sara,30,ES05209525001173802889,TRX_N-01140-54736924,2024-09-01T13:36:52,Iru√±a de Oca,Expense,repairs,-303.16,-46294.88
buyer_5,Sara,30,ES05209525001173802889,TRX_N-01141-43214339,2024-09-02T19:26:14,Iru√±a de Oca,Expense,cash,-100.0,-46394.88
buyer_5,Sara,30,ES05209525001173802889,TRX_N-01142-02832171,2024-09-03T08:42:19,Donostia,expenses,children,-202.23,-46597.11
buyer_5,Sara,30,ES05209525001173802889,TRX_N-01143-29717562,2024-09-04T15:22:20,Donostia,expenses,mortgage,-726.47,-47323.58
buyer_5,Sara,30,ES05209525001173802889,TRX_N-01144-94243651,2024-09-05T16:47:14,Donostia,expenses,gas,-51.08,-47374.66
buyer_5,Sara,30,ES05209525001173802889,TRX_N-01145-43038025,2024-09-05T15:15:18,Donostia,expenses,internet,-42.0,-47416.66
buyer_5,Sara,30,ES05209525001173802889,TRX_N-01146-48565859,2024-09-05T08:47:17,Donostia,expenses,phone,-43.19,-47459.85
buyer_5,Sara,30,ES05209525001173802889,TRX_N-01147-12439483,2024-09-05T15:16:52,Donostia,Expense,transport,-75.53,-47535.38
buyer_5,Sara,30,ES05209525001173802889,TRX_N-01148-00582894,2024-09-06T21:22:03,Hernani,Expense,leisure,-48.9,-47584.28
buyer_5,Sara,30,ES05209525001173802889,TRX_N-01149-71276741,2024-09-06T18:56:24,Donostia,Expense,healthcare,-124.97,-47709.25
buyer_5,Sara,30,ES05209525001173802889,TRX_N-01150-96161155,2024-09-06T12:59:46,Donostia,Expense,gifts,-502.42,-48211.67
buyer_5,Sara,30,ES05209525001173802889,TRX_N-01151-66685656,2024-09-07T06:09:39,Donostia,expenses,water,-42.22,-48253.89
buyer_5,Sara,30,ES05209525001173802889,TRX_N-01152-37966037,2024-09-07T08:20:23,Donostia,Expense,food,-75.18,-48329.07
buyer_5,Sara,30,ES05209525001173802889,TRX_N-01153-79115268,2024-09-07T19:01:22,Donostia,Expense,education,-48.66,-48377.73
buyer_5,Sara,30,ES05209525001173802889,TRX_N-01154-82759156,2024-09-07T14:47:29,Hernani,Expense,cash,-100.0,-48477.73
buyer_5,Sara,30,ES05209525001173802889,TRX_N-01155-25774648,2024-09-08T13:05:38,Donostia,expenses,electricity,-43.86,-48521.59
buyer_5,Sara,30,ES05209525001173802889,TRX_N-01156-14985096,2024-09-08T20:44:58,Donostia,Expense,food,-89.79,-48611.38
buyer_5,Sara,30,ES05209525001173802889,TRX_N-01157-76997609,2024-09-08T09:15:23,Donostia,expenses,children,-229.72,-48841.1
buyer_5,Sara,30,ES05209525001173802889,TRX_N-01158-83010930,2024-09-09T17:41:21,Donostia,Expense,cash,-100.0,-48941.1
buyer_5,Sara,30,ES05209525001173802889,TRX_N-01159-49524222,2024-09-14T09:04:05,Donostia,Expense,repairs,-116.34,-49057.44
buyer_5,Sara,30,ES05209525001173802889,TRX_N-01160-32351435,2024-09-15T11:58:47,Donostia,Expense,food,-89.34,-49146.78
buyer_5,Sara,30,ES05209525001173802889,TRX_N-01161-78876317,2024-09-15T00:21:37,Donostia,Expense,leisure,-32.91,-49179.69
buyer_5,Sara,30,ES05209525001173802889,TRX_N-01162-36338879,2024-09-18T16:32:02,Alegr√≠a-Dulantzi,Expense,food,-88.66,-49268.35
buyer_5,Sara,30,ES05209525001173802889,TRX_N-01163-32957920,2024-09-18T08:45:31,Donostia,Expense,transport,-45.7,-49314.05
buyer_5,Sara,30,ES05209525001173802889,TRX_N-01164-55182118,2024-09-18T14:25:15,Galdakao,Expense,cash,-100.0,-49414.05
buyer_5,Sara,30,ES05209525001173802889,TRX_N-01165-15520199,2024-09-19T12:59:10,Donostia,Expense,food,-74.46,-49488.51
buyer_5,Sara,30,ES05209525001173802889,TRX_N-01166-49569162,2024-09-19T20:37:16,Donostia,Expense,education,-45.48,-49533.99
buyer_5,Sara,30,ES05209525001173802889,TRX_N-01167-08310965,2024-09-19T17:35:33,Donostia,Expense,gifts,-804.02,-50338.01
buyer_5,Sara,30,ES05209525001173802889,TRX_N-01168-90822902,2024-09-22T11:58:25,Donostia,Expense,healthcare,-149.53,-50487.54
buyer_5,Sara,30,ES05209525001173802889,TRX_N-01169-71596829,2024-09-24T18:34:21,Donostia,Expense,clothing,-71.44,-50558.98
buyer_5,Sara,30,ES05209525001173802889,TRX_N-01170-05239742,2024-09-24T00:00:20,Donostia,Expense,cash,-100.0,-50658.98
buyer_5,Sara,30,ES05209525001173802889,TRX_N-01171-08809220,2024-09-26T22:01:49,Donostia,Expense,transport,-89.19,-50748.17
buyer_5,Sara,30,ES05209525001173802889,TRX_N-01172-33339793,2024-09-26T10:48:14,Donostia,Expense,cash,-100.0,-50848.17
buyer_5,Sara,30,ES05209525001173802889,TRX_N-01173-51364679,2024-09-26T18:36:29,Donostia,Expense,repairs,-38.18,-50886.35
buyer_5,Sara,30,ES05209525001173802889,TRX_N-01174-63805749,2024-09-28T19:57:15,Donostia,Expense,leisure,-61.19,-50947.54
buyer_5,Sara,30,ES05209525001173802889,TRX_N-01175-34184370,2024-09-28T22:50:39,Donostia,expenses,children,-264.48,-51212.02
buyer_5,Sara,30,ES05209525001173802889,TRX_N-01176-61114121,2024-09-30T15:27:02,Donostia,Expense,transport,-65.65,-51277.67
buyer_5,Sara,30,ES05209525001173802889,TRX_N-01177-54102611,2024-09-30T15:59:31,Donostia,Expense,repairs,-130.56,-51408.23
buyer_5,Sara,30,ES05209525001173802889,TRX_N-01178-55303184,2024-10-01T22:09:16,Donostia,incomes,salary,1426.69,-49981.54
buyer_5,Sara,30,ES05209525001173802889,TRX_N-01179-87503125,2024-10-01T22:09:16,Donostia,incomes,salary_partner,1202.04,-48779.5
buyer_5,Sara,30,ES05209525001173802889,TRX_N-01180-10432368,2024-10-01T22:09:16,Donostia,incomes,extra_income,151.29,-48628.21
buyer_5,Sara,30,ES05209525001173802889,TRX_N-01181-87091139,2024-10-01T13:47:15,Donostia,Expense,food,-95.37,-48723.58
buyer_5,Sara,30,ES05209525001173802889,TRX_N-01182-95431256,2024-10-03T21:30:51,Donostia,Expense,leisure,-23.74,-48747.32
buyer_5,Sara,30,ES05209525001173802889,TRX_N-01183-61176935,2024-10-03T12:21:45,Donostia,Expense,education,-61.2,-48808.52
buyer_5,Sara,30,ES05209525001173802889,TRX_N-01184-33107486,2024-10-04T13:16:10,Donostia,expenses,mortgage,-726.47,-49534.99
buyer_5,Sara,30,ES05209525001173802889,TRX_N-01185-47396515,2024-10-05T04:09:39,Donostia,Expense,food,-101.21,-49636.2
buyer_5,Sara,30,ES05209525001173802889,TRX_N-01186-83819111,2024-10-05T15:11:00,Amurrio,Expense,cash,-100.0,-49736.2
buyer_5,Sara,30,ES05209525001173802889,TRX_N-01187-17641928,2024-10-06T14:31:49,Donostia,expenses,internet,-42.0,-49778.2
buyer_5,Sara,30,ES05209525001173802889,TRX_N-01188-09580349,2024-10-08T18:50:10,Donostia,expenses,gas,-101.19,-49879.39
buyer_5,Sara,30,ES05209525001173802889,TRX_N-01189-26050237,2024-10-08T08:50:33,Donostia,expenses,water,-20.16,-49899.55
buyer_5,Sara,30,ES05209525001173802889,TRX_N-01190-11947724,2024-10-08T08:28:23,Donostia,expenses,electricity,-41.61,-49941.16
buyer_5,Sara,30,ES05209525001173802889,TRX_N-01191-45401595,2024-10-08T16:29:44,Donostia,expenses,phone,-38.91,-49980.07
buyer_6,Manuel,45,ES45209554403228000157,TRX_N-00001-54667067,2022-01-01T03:21:58,Vitoria-Gasteiz,incomes,salary,1492.25,2563.26
buyer_6,Manuel,45,ES45209554403228000157,TRX_N-00002-26580820,2022-01-01T03:21:58,Vitoria-Gasteiz,incomes,salary_partner,1020.15,3583.41
buyer_6,Manuel,45,ES45209554403228000157,TRX_N-00003-47038464,2022-01-03T19:48:33,Vitoria-Gasteiz,Expense,transport,-44.2,3539.21
buyer_6,Manuel,45,ES45209554403228000157,TRX_N-00004-62305525,2022-01-04T16:08:18,Vitoria-Gasteiz,expenses,mortgage,-842.56,2696.65
buyer_6,Manuel,45,ES45209554403228000157,TRX_N-00005-55880649,2022-01-04T08:20:41,Vitoria-Gasteiz,Expense,clothing,-99.54,2597.11
buyer_6,Manuel,45,ES45209554403228000157,TRX_N-00006-06929501,2022-01-05T07:32:17,Vitoria-Gasteiz,expenses,electricity,-88.46,2508.65
buyer_6,Manuel,45,ES45209554403228000157,TRX_N-00007-64359525,2022-01-06T16:18:57,Vitoria-Gasteiz,Expense,clothing,-111.95,2396.7
buyer_6,Manuel,45,ES45209554403228000157,TRX_N-00008-41029328,2022-01-06T12:27:11,Vitoria-Gasteiz,Expense,gifts,-687.97,1708.73
buyer_6,Manuel,45,ES45209554403228000157,TRX_N-00009-33387782,2022-01-07T20:36:59,Vitoria-Gasteiz,expenses,phone,-43.14,1665.59
buyer_6,Manuel,45,ES45209554403228000157,TRX_N-00010-35069422,2022-01-07T00:19:39,Vitoria-Gasteiz,Expense,appliances,-356.84,1308.75
buyer_6,Manuel,45,ES45209554403228000157,TRX_N-00011-03704326,2022-01-08T08:23:32,Vitoria-Gasteiz,expenses,water,-44.7,1264.05
buyer_6,Manuel,45,ES45209554403228000157,TRX_N-00012-71090434,2022-01-08T12:18:31,Vitoria-Gasteiz,expenses,gas,-107.29,1156.76
buyer_6,Manuel,45,ES45209554403228000157,TRX_N-00013-30535437,2022-01-08T16:50:00,Vitoria-Gasteiz,expenses,internet,-42.0,1114.76
buyer_6,Manuel,45,ES45209554403228000157,TRX_N-00014-37248193,2022-01-10T03:09:31,Vitoria-Gasteiz,Expense,transport,-62.96,1051.8
buyer_6,Manuel,45,ES45209554403228000157,TRX_N-00015-28357089,2022-01-13T16:04:34,Vitoria-Gasteiz,Expense,food,-111.42,940.38
buyer_6,Manuel,45,ES45209554403228000157,TRX_N-00016-69633749,2022-01-13T19:42:24,Vitoria-Gasteiz,Expense,travel,-297.75,642.63
buyer_6,Manuel,45,ES45209554403228000157,TRX_N-00017-89026050,2022-01-14T18:21:59,Leioa,Expense,transport,-69.85,572.78
buyer_6,Manuel,45,ES45209554403228000157,TRX_N-00018-64508413,2022-01-14T14:33:29,Andoain,Expense,clothing,-119.7,453.08
buyer_6,Manuel,45,ES45209554403228000157,TRX_N-00019-35091854,2022-01-19T12:43:10,Basauri,Expense,food,-88.08,365.0
buyer_6,Manuel,45,ES45209554403228000157,TRX_N-00020-64952170,2022-01-19T13:16:39,Vitoria-Gasteiz,Expense,transport,-68.86,296.14
buyer_6,Manuel,45,ES45209554403228000157,TRX_N-00021-24998941,2022-01-22T15:22:23,Vitoria-Gasteiz,Expense,cash,-100.0,196.14
buyer_6,Manuel,45,ES45209554403228000157,TRX_N-00022-90756514,2022-01-22T09:20:35,Vitoria-Gasteiz,Expense,repairs,-143.11,53.03
buyer_6,Manuel,45,ES45209554403228000157,TRX_N-00023-79633718,2022-01-24T19:29:12,Vitoria-Gasteiz,Expense,leisure,-24.95,28.08
buyer_6,Manuel,45,ES45209554403228000157,TRX_N-00024-40797583,2022-01-24T16:26:25,Barakaldo,Expense,cash,-100.0,-71.92
buyer_6,Manuel,45,ES45209554403228000157,TRX_N-00025-90021057,2022-01-25T09:38:33,Vitoria-Gasteiz,Expense,food,-71.07,-142.99
buyer_6,Manuel,45,ES45209554403228000157,TRX_N-00026-10774404,2022-01-25T12:46:45,Vitoria-Gasteiz,Expense,transport,-60.8,-203.79
buyer_6,Manuel,45,ES45209554403228000157,TRX_N-00027-63416317,2022-01-26T09:23:58,Eibar,Expense,clothing,-159.76,-363.55
buyer_6,Manuel,45,ES45209554403228000157,TRX_N-00028-52938547,2022-01-29T10:12:55,Amurrio,Expense,clothing,-148.83,-512.38
buyer_6,Manuel,45,ES45209554403228000157,TRX_N-00029-69509792,2022-01-29T19:44:29,Berango,Expense,cash,-100.0,-612.38
buyer_6,Manuel,45,ES45209554403228000157,TRX_N-00030-23878895,2022-01-30T10:41:15,Vitoria-Gasteiz,Expense,education,-54.07,-666.45
buyer_6,Manuel,45,ES45209554403228000157,TRX_N-00031-72667364,2022-01-31T19:28:18,Vitoria-Gasteiz,Expense,food,-75.5,-741.95
buyer_6,Manuel,45,ES45209554403228000157,TRX_N-00032-32127802,2022-01-31T11:36:48,Vitoria-Gasteiz,Expense,cash,-100.0,-841.95
buyer_6,Manuel,45,ES45209554403228000157,TRX_N-00033-17741493,2022-02-01T20:04:04,Vitoria-Gasteiz,incomes,salary,1492.25,650.3
buyer_6,Manuel,45,ES45209554403228000157,TRX_N-00034-05111017,2022-02-01T20:04:04,Vitoria-Gasteiz,incomes,salary_partner,1020.15,1670.45
buyer_6,Manuel,45,ES45209554403228000157,TRX_N-00035-98340667,2022-02-03T14:35:58,Vitoria-Gasteiz,Expense,food,-92.39,1578.06
buyer_6,Manuel,45,ES45209554403228000157,TRX_N-00036-11861462,2022-02-03T16:53:10,Vitoria-Gasteiz,Expense,leisure,-23.08,1554.98
buyer_6,Manuel,45,ES45209554403228000157,TRX_N-00037-52725785,2022-02-04T03:26:13,Vitoria-Gasteiz,expenses,mortgage,-842.56,712.42
buyer_6,Manuel,45,ES45209554403228000157,TRX_N-00038-44016009,2022-02-04T16:35:54,Vitoria-Gasteiz,Expense,transport,-86.94,625.48
buyer_6,Manuel,45,ES45209554403228000157,TRX_N-00039-02457993,2022-02-05T13:24:40,Leioa,Expense,clothing,-59.77,565.71
buyer_6,Manuel,45,ES45209554403228000157,TRX_N-00040-01354805,2022-02-06T20:21:59,Vitoria-Gasteiz,expenses,electricity,-54.59,511.12
buyer_6,Manuel,45,ES45209554403228000157,TRX_N-00041-85232499,2022-02-06T10:56:54,Vitoria-Gasteiz,expenses,gas,-32.25,478.87
buyer_6,Manuel,45,ES45209554403228000157,TRX_N-00042-76171145,2022-02-06T17:50:38,Vitoria-Gasteiz,Expense,cash,-100.0,378.87
buyer_6,Manuel,45,ES45209554403228000157,TRX_N-00043-38673958,2022-02-07T17:18:49,Vitoria-Gasteiz,expenses,phone,-33.47,345.4
buyer_6,Manuel,45,ES45209554403228000157,TRX_N-00044-67865006,2022-02-08T18:41:41,Vitoria-Gasteiz,expenses,water,-33.52,311.88
buyer_6,Manuel,45,ES45209554403228000157,TRX_N-00045-46761352,2022-02-08T09:03:45,Vitoria-Gasteiz,expenses,internet,-42.0,269.88
buyer_6,Manuel,45,ES45209554403228000157,TRX_N-00046-29409746,2022-02-08T16:18:05,Salvatierra/Agurain,Expense,food,-66.09,203.79
buyer_6,Manuel,45,ES45209554403228000157,TRX_N-00047-87436465,2022-02-08T07:30:15,Vitoria-Gasteiz,Expense,transport,-65.32,138.47
buyer_6,Manuel,45,ES45209554403228000157,TRX_N-00048-53668813,2022-02-09T16:08:43,Vitoria-Gasteiz,Expense,food,-88.52,49.95
buyer_6,Manuel,45,ES45209554403228000157,TRX_N-00049-98561716,2022-02-09T12:55:13,Vitoria-Gasteiz,Expense,repairs,-264.57,-214.62
buyer_6,Manuel,45,ES45209554403228000157,TRX_N-00050-66874616,2022-02-11T09:06:42,Vitoria-Gasteiz,Expense,appliances,-290.07,-504.69
buyer_6,Manuel,45,ES45209554403228000157,TRX_N-00051-77420718,2022-02-14T07:34:14,Vitoria-Gasteiz,Expense,cash,-100.0,-604.69
buyer_6,Manuel,45,ES45209554403228000157,TRX_N-00052-49360516,2022-02-15T14:12:48,Vitoria-Gasteiz,Expense,leisure,-46.74,-651.43
buyer_6,Manuel,45,ES45209554403228000157,TRX_N-00053-12680720,2022-02-15T20:10:51,Vitoria-Gasteiz,Expense,travel,-1571.67,-2223.1
buyer_6,Manuel,45,ES45209554403228000157,TRX_N-00054-88469699,2022-02-16T14:32:15,Vitoria-Gasteiz,Expense,leisure,-78.4,-2301.5
buyer_6,Manuel,45,ES45209554403228000157,TRX_N-00055-65873574,2022-02-16T17:44:57,Vitoria-Gasteiz,Expense,repairs,-274.46,-2575.96
buyer_6,Manuel,45,ES45209554403228000157,TRX_N-00056-60541308,2022-02-17T19:09:58,Amurrio,Expense,transport,-79.95,-2655.91
buyer_6,Manuel,45,ES45209554403228000157,TRX_N-00057-80505242,2022-02-18T14:18:02,Vitoria-Gasteiz,Expense,clothing,-130.58,-2786.49
buyer_6,Manuel,45,ES45209554403228000157,TRX_N-00058-21541845,2022-02-18T02:40:38,Vitoria-Gasteiz,expenses,children,-263.5,-3049.99
buyer_6,Manuel,45,ES45209554403228000157,TRX_N-00059-57371353,2022-02-20T19:05:56,Vitoria-Gasteiz,Expense,cash,-100.0,-3149.99
buyer_6,Manuel,45,ES45209554403228000157,TRX_N-00060-72177015,2022-02-21T17:23:19,Hondarribia,Expense,food,-117.32,-3267.31
buyer_6,Manuel,45,ES45209554403228000157,TRX_N-00061-03145974,2022-02-21T23:26:35,Vitoria-Gasteiz,Expense,cash,-100.0,-3367.31
buyer_6,Manuel,45,ES45209554403228000157,TRX_N-00062-19184142,2022-02-23T15:02:12,Vitoria-Gasteiz,Expense,repairs,-171.31,-3538.62
buyer_6,Manuel,45,ES45209554403228000157,TRX_N-00063-83208470,2022-02-24T20:14:53,Vitoria-Gasteiz,Expense,transport,-73.68,-3612.3
buyer_6,Manuel,45,ES45209554403228000157,TRX_N-00064-49584948,2022-02-24T04:30:21,Vitoria-Gasteiz,Expense,clothing,-103.99,-3716.29
buyer_6,Manuel,45,ES45209554403228000157,TRX_N-00065-63621524,2022-02-25T17:30:06,Vitoria-Gasteiz,Expense,education,-54.12,-3770.41
buyer_6,Manuel,45,ES45209554403228000157,TRX_N-00066-90326721,2022-02-25T16:40:48,Vitoria-Gasteiz,Expense,cash,-100.0,-3870.41
buyer_6,Manuel,45,ES45209554403228000157,TRX_N-00067-83084684,2022-02-26T16:28:07,Vitoria-Gasteiz,Expense,repairs,-135.05,-4005.46
buyer_6,Manuel,45,ES45209554403228000157,TRX_N-00068-16749536,2022-02-27T11:09:07,Vitoria-Gasteiz,Expense,food,-109.5,-4114.96
buyer_6,Manuel,45,ES45209554403228000157,TRX_N-00069-18992049,2022-02-27T19:33:37,Leioa,Expense,education,-55.36,-4170.32
buyer_6,Manuel,45,ES45209554403228000157,TRX_N-00070-52071167,2022-02-27T11:58:35,Vitoria-Gasteiz,Expense,repairs,-287.55,-4457.87
buyer_6,Manuel,45,ES45209554403228000157,TRX_N-00071-09026378,2022-02-28T17:21:03,Basauri,Expense,education,-53.09,-4510.96
buyer_6,Manuel,45,ES45209554403228000157,TRX_N-00072-82808073,2022-03-01T10:35:26,Vitoria-Gasteiz,incomes,salary,1492.25,-3018.71
buyer_6,Manuel,45,ES45209554403228000157,TRX_N-00073-05887593,2022-03-01T10:35:26,Vitoria-Gasteiz,incomes,salary_partner,1020.15,-1998.56
buyer_6,Manuel,45,ES45209554403228000157,TRX_N-00074-91387118,2022-03-01T10:35:26,Vitoria-Gasteiz,incomes,extra_income,251.7,-1746.86
buyer_6,Manuel,45,ES45209554403228000157,TRX_N-00075-88312734,2022-03-02T17:57:39,Donostia,Expense,transport,-44.01,-1790.87
buyer_6,Manuel,45,ES45209554403228000157,TRX_N-00076-38251206,2022-03-02T17:03:52,Vitoria-Gasteiz,Expense,gifts,-763.49,-2554.36
buyer_6,Manuel,45,ES45209554403228000157,TRX_N-00077-60627880,2022-03-04T15:54:07,Vitoria-Gasteiz,expenses,mortgage,-842.56,-3396.92
buyer_6,Manuel,45,ES45209554403228000157,TRX_N-00078-55973315,2022-03-04T13:29:45,Vitoria-Gasteiz,Expense,gifts,-553.97,-3950.89
buyer_6,Manuel,45,ES45209554403228000157,TRX_N-00079-40323440,2022-03-05T06:20:45,Vitoria-Gasteiz,Expense,food,-61.29,-4012.18
buyer_6,Manuel,45,ES45209554403228000157,TRX_N-00080-19143329,2022-03-06T09:25:39,Vitoria-Gasteiz,expenses,water,-23.04,-4035.22
buyer_6,Manuel,45,ES45209554403228000157,TRX_N-00081-94975880,2022-03-06T11:13:02,Vitoria-Gasteiz,expenses,internet,-42.0,-4077.22
buyer_6,Manuel,45,ES45209554403228000157,TRX_N-00082-89674793,2022-03-07T15:21:15,Vitoria-Gasteiz,Expense,leisure,-64.59,-4141.81
buyer_6,Manuel,45,ES45209554403228000157,TRX_N-00083-26791060,2022-03-08T17:26:33,Vitoria-Gasteiz,expenses,electricity,-36.82,-4178.63
buyer_6,Manuel,45,ES45209554403228000157,TRX_N-00084-51346422,2022-03-08T10:08:42,Vitoria-Gasteiz,expenses,phone,-44.45,-4223.08
buyer_6,Manuel,45,ES45209554403228000157,TRX_N-00085-80807686,2022-03-08T17:45:24,Vitoria-Gasteiz,expenses,gas,-30.56,-4253.64
buyer_6,Manuel,45,ES45209554403228000157,TRX_N-00086-31085207,2022-03-10T12:45:10,Vitoria-Gasteiz,Expense,transport,-59.59,-4313.23
buyer_6,Manuel,45,ES45209554403228000157,TRX_N-00087-49339130,2022-03-11T16:54:50,Vitoria-Gasteiz,Expense,cash,-100.0,-4413.23
buyer_6,Manuel,45,ES45209554403228000157,TRX_N-00088-05183461,2022-03-13T12:37:52,Vitoria-Gasteiz,Expense,food,-62.35,-4475.58
buyer_6,Manuel,45,ES45209554403228000157,TRX_N-00089-45476235,2022-03-15T18:12:49,Bilbao,Expense,transport,-64.32,-4539.9
buyer_6,Manuel,45,ES45209554403228000157,TRX_N-00090-19377353,2022-03-15T19:23:58,Vitoria-Gasteiz,Expense,repairs,-246.4,-4786.3
buyer_6,Manuel,45,ES45209554403228000157,TRX_N-00091-53898045,2022-03-16T08:39:54,Vitoria-Gasteiz,Expense,cash,-100.0,-4886.3
buyer_6,Manuel,45,ES45209554403228000157,TRX_N-00092-91017811,2022-03-17T16:58:39,Vitoria-Gasteiz,Expense,leisure,-27.2,-4913.5
buyer_6,Manuel,45,ES45209554403228000157,TRX_N-00093-21338611,2022-03-18T10:37:31,Vitoria-Gasteiz,Expense,cash,-100.0,-5013.5
buyer_6,Manuel,45,ES45209554403228000157,TRX_N-00094-48269839,2022-03-18T16:20:16,Vitoria-Gasteiz,expenses,children,-200.02,-5213.52
buyer_6,Manuel,45,ES45209554403228000157,TRX_N-00095-36550269,2022-03-19T07:00:21,Vitoria-Gasteiz,Expense,repairs,-108.99,-5322.51
buyer_6,Manuel,45,ES45209554403228000157,TRX_N-00096-04742538,2022-03-20T15:20:33,Vitoria-Gasteiz,Expense,food,-73.41,-5395.92
buyer_6,Manuel,45,ES45209554403228000157,TRX_N-00097-43399887,2022-03-23T19:59:56,Vitoria-Gasteiz,Expense,transport,-80.34,-5476.26
buyer_6,Manuel,45,ES45209554403228000157,TRX_N-00098-85621219,2022-03-24T19:56:59,Vitoria-Gasteiz,Expense,clothing,-77.0,-5553.26
buyer_6,Manuel,45,ES45209554403228000157,TRX_N-00099-65593835,2022-03-25T17:00:27,Vitoria-Gasteiz,Expense,food,-65.18,-5618.44
buyer_6,Manuel,45,ES45209554403228000157,TRX_N-00100-87822799,2022-03-27T16:07:03,Vitoria-Gasteiz,Expense,food,-83.55,-5701.99
buyer_6,Manuel,45,ES45209554403228000157,TRX_N-00101-08132093,2022-03-27T14:15:12,Vitoria-Gasteiz,Expense,cash,-100.0,-5801.99
buyer_6,Manuel,45,ES45209554403228000157,TRX_N-00102-26814361,2022-03-28T13:04:58,Vitoria-Gasteiz,Expense,transport,-77.22,-5879.21
buyer_6,Manuel,45,ES45209554403228000157,TRX_N-00103-93712483,2022-03-31T20:04:19,Vitoria-Gasteiz,Expense,cash,-100.0,-5979.21
buyer_6,Manuel,45,ES45209554403228000157,TRX_N-00104-52529634,2022-03-31T12:28:08,Vitoria-Gasteiz,Expense,repairs,-142.44,-6121.65
buyer_6,Manuel,45,ES45209554403228000157,TRX_N-00105-35677171,2022-04-01T16:28:06,Vitoria-Gasteiz,incomes,salary,1492.25,-4629.4
buyer_6,Manuel,45,ES45209554403228000157,TRX_N-00106-11974365,2022-04-01T16:28:06,Vitoria-Gasteiz,incomes,salary_partner,1020.15,-3609.25
buyer_6,Manuel,45,ES45209554403228000157,TRX_N-00107-59220579,2022-04-03T16:36:33,Vitoria-Gasteiz,Expense,food,-109.91,-3719.16
buyer_6,Manuel,45,ES45209554403228000157,TRX_N-00108-30586809,2022-04-03T09:05:24,Vitoria-Gasteiz,Expense,leisure,-53.33,-3772.49
buyer_6,Manuel,45,ES45209554403228000157,TRX_N-00109-48415578,2022-04-03T18:50:07,Vitoria-Gasteiz,Expense,clothing,-60.4,-3832.89
buyer_6,Manuel,45,ES45209554403228000157,TRX_N-00110-54188378,2022-04-04T20:28:03,Vitoria-Gasteiz,expenses,mortgage,-842.56,-4675.45
buyer_6,Manuel,45,ES45209554403228000157,TRX_N-00111-33513774,2022-04-04T19:44:44,Vitoria-Gasteiz,Expense,food,-63.11,-4738.56
buyer_6,Manuel,45,ES45209554403228000157,TRX_N-00112-19533254,2022-04-04T06:25:26,Vitoria-Gasteiz,Expense,cash,-100.0,-4838.56
buyer_6,Manuel,45,ES45209554403228000157,TRX_N-00113-07942315,2022-04-04T19:31:26,Vitoria-Gasteiz,expenses,children,-160.14,-4998.7
buyer_6,Manuel,45,ES45209554403228000157,TRX_N-00114-31839215,2022-04-05T21:31:04,Vitoria-Gasteiz,expenses,internet,-42.0,-5040.7
buyer_6,Manuel,45,ES45209554403228000157,TRX_N-00115-01486752,2022-04-05T01:21:43,Zarautz,Expense,leisure,-57.54,-5098.24
buyer_6,Manuel,45,ES45209554403228000157,TRX_N-00116-46770144,2022-04-07T11:17:10,Vitoria-Gasteiz,expenses,gas,-69.49,-5167.73
buyer_6,Manuel,45,ES45209554403228000157,TRX_N-00117-91323422,2022-04-07T12:02:57,Vitoria-Gasteiz,Expense,food,-88.4,-5256.13
buyer_6,Manuel,45,ES45209554403228000157,TRX_N-00118-15826012,2022-04-08T19:20:45,Vitoria-Gasteiz,expenses,electricity,-20.14,-5276.27
buyer_6,Manuel,45,ES45209554403228000157,TRX_N-00119-23853152,2022-04-08T18:48:52,Vitoria-Gasteiz,expenses,water,-39.36,-5315.63
buyer_6,Manuel,45,ES45209554403228000157,TRX_N-00120-81233715,2022-04-08T01:08:47,Vitoria-Gasteiz,expenses,phone,-37.7,-5353.33
buyer_6,Manuel,45,ES45209554403228000157,TRX_N-00121-47457769,2022-04-09T11:09:06,Vitoria-Gasteiz,Expense,cash,-100.0,-5453.33
buyer_6,Manuel,45,ES45209554403228000157,TRX_N-00122-95477385,2022-04-10T15:17:00,Zarautz,Expense,cash,-100.0,-5553.33
buyer_6,Manuel,45,ES45209554403228000157,TRX_N-00123-26333412,2022-04-15T20:03:02,Galdakao,Expense,education,-51.47,-5604.8
buyer_6,Manuel,45,ES45209554403228000157,TRX_N-00124-92239212,2022-04-16T10:35:20,Vitoria-Gasteiz,Expense,clothing,-75.22,-5680.02
buyer_6,Manuel,45,ES45209554403228000157,TRX_N-00125-97557214,2022-04-16T09:41:44,Vitoria-Gasteiz,Expense,cash,-100.0,-5780.02
buyer_6,Manuel,45,ES45209554403228000157,TRX_N-00126-90131674,2022-04-20T23:54:14,Vitoria-Gasteiz,Expense,clothing,-109.5,-5889.52
buyer_6,Manuel,45,ES45209554403228000157,TRX_N-00127-26414296,2022-04-21T11:21:35,Vitoria-Gasteiz,Expense,education,-72.34,-5961.86
buyer_6,Manuel,45,ES45209554403228000157,TRX_N-00128-16230845,2022-04-22T10:23:51,Vitoria-Gasteiz,expenses,children,-191.15,-6153.01
buyer_6,Manuel,45,ES45209554403228000157,TRX_N-00129-25209979,2022-04-24T20:10:04,Vitoria-Gasteiz,Expense,leisure,-50.96,-6203.97
buyer_6,Manuel,45,ES45209554403228000157,TRX_N-00130-18826905,2022-04-24T23:35:23,Vitoria-Gasteiz,Expense,gifts,-324.59,-6528.56
buyer_6,Manuel,45,ES45209554403228000157,TRX_N-00131-39680970,2022-04-25T18:56:58,Vitoria-Gasteiz,Expense,appliances,-211.21,-6739.77
buyer_6,Manuel,45,ES45209554403228000157,TRX_N-00132-42842912,2022-04-27T07:22:15,Vitoria-Gasteiz,Expense,food,-121.6,-6861.37
buyer_6,Manuel,45,ES45209554403228000157,TRX_N-00133-01917974,2022-04-28T08:38:46,Vitoria-Gasteiz,Expense,clothing,-119.29,-6980.66
buyer_6,Manuel,45,ES45209554403228000157,TRX_N-00134-02398226,2022-04-29T08:29:04,Vitoria-Gasteiz,Expense,leisure,-32.02,-7012.68
buyer_6,Manuel,45,ES45209554403228000157,TRX_N-00135-22653423,2022-04-29T11:21:39,Sestao,Expense,cash,-100.0,-7112.68
buyer_6,Manuel,45,ES45209554403228000157,TRX_N-00136-48608277,2022-05-01T20:59:00,Vitoria-Gasteiz,incomes,salary,1492.25,-5620.43
buyer_6,Manuel,45,ES45209554403228000157,TRX_N-00137-75344800,2022-05-01T20:59:00,Vitoria-Gasteiz,incomes,salary_partner,1020.15,-4600.28
buyer_6,Manuel,45,ES45209554403228000157,TRX_N-00138-07682747,2022-05-01T16:33:08,Vitoria-Gasteiz,Expense,education,-77.25,-4677.53
buyer_6,Manuel,45,ES45209554403228000157,TRX_N-00139-43155213,2022-05-01T17:43:39,Vitoria-Gasteiz,Expense,cash,-100.0,-4777.53
buyer_6,Manuel,45,ES45209554403228000157,TRX_N-00140-84546119,2022-05-03T18:10:03,Vitoria-Gasteiz,Expense,food,-101.08,-4878.61
buyer_6,Manuel,45,ES45209554403228000157,TRX_N-00141-92678088,2022-05-03T15:41:50,Vitoria-Gasteiz,Expense,clothing,-83.45,-4962.06
buyer_6,Manuel,45,ES45209554403228000157,TRX_N-00142-10765269,2022-05-03T13:26:12,Vitoria-Gasteiz,Expense,cash,-100.0,-5062.06
buyer_6,Manuel,45,ES45209554403228000157,TRX_N-00143-49841826,2022-05-04T20:39:13,Vitoria-Gasteiz,expenses,mortgage,-842.56,-5904.62
buyer_6,Manuel,45,ES45209554403228000157,TRX_N-00144-14697184,2022-05-05T08:22:13,Vitoria-Gasteiz,expenses,gas,-41.96,-5946.58
buyer_6,Manuel,45,ES45209554403228000157,TRX_N-00145-07655007,2022-05-05T15:46:09,Vitoria-Gasteiz,expenses,internet,-42.0,-5988.58
buyer_6,Manuel,45,ES45209554403228000157,TRX_N-00146-16143356,2022-05-06T20:47:57,Vitoria-Gasteiz,expenses,water,-44.83,-6033.41
buyer_6,Manuel,45,ES45209554403228000157,TRX_N-00147-46147708,2022-05-06T16:41:52,Vitoria-Gasteiz,expenses,phone,-38.28,-6071.69
buyer_6,Manuel,45,ES45209554403228000157,TRX_N-00148-59256317,2022-05-06T18:10:12,Vitoria-Gasteiz,Expense,transport,-56.22,-6127.91
buyer_6,Manuel,45,ES45209554403228000157,TRX_N-00149-08569707,2022-05-06T22:45:38,Vitoria-Gasteiz,Expense,leisure,-39.16,-6167.07
buyer_6,Manuel,45,ES45209554403228000157,TRX_N-00150-23270790,2022-05-08T14:33:41,Vitoria-Gasteiz,expenses,electricity,-56.43,-6223.5
buyer_6,Manuel,45,ES45209554403228000157,TRX_N-00151-76269984,2022-05-08T18:31:06,Vitoria-Gasteiz,Expense,food,-117.35,-6340.85
buyer_6,Manuel,45,ES45209554403228000157,TRX_N-00152-70543832,2022-05-08T20:04:08,Vitoria-Gasteiz,Expense,cash,-100.0,-6440.85
buyer_6,Manuel,45,ES45209554403228000157,TRX_N-00153-68199680,2022-05-08T09:40:50,Vitoria-Gasteiz,Expense,repairs,-196.02,-6636.87
buyer_6,Manuel,45,ES45209554403228000157,TRX_N-00154-62006725,2022-05-13T17:53:35,Vitoria-Gasteiz,Expense,cash,-100.0,-6736.87
buyer_6,Manuel,45,ES45209554403228000157,TRX_N-00155-28861360,2022-05-13T23:13:56,Vitoria-Gasteiz,Expense,gifts,-78.3,-6815.17
buyer_6,Manuel,45,ES45209554403228000157,TRX_N-00156-24974493,2022-05-14T20:48:08,Vitoria-Gasteiz,Expense,food,-108.47,-6923.64
buyer_6,Manuel,45,ES45209554403228000157,TRX_N-00157-69508376,2022-05-16T14:10:03,Berango,Expense,repairs,-134.1,-7057.74
buyer_6,Manuel,45,ES45209554403228000157,TRX_N-00158-58086534,2022-05-17T09:49:41,Vitoria-Gasteiz,Expense,leisure,-61.26,-7119.0
buyer_6,Manuel,45,ES45209554403228000157,TRX_N-00159-35367818,2022-05-17T04:00:13,Vitoria-Gasteiz,Expense,clothing,-159.81,-7278.81
buyer_6,Manuel,45,ES45209554403228000157,TRX_N-00160-45500265,2022-05-18T05:52:36,Vitoria-Gasteiz,Expense,healthcare,-156.31,-7435.12
buyer_6,Manuel,45,ES45209554403228000157,TRX_N-00161-00102332,2022-05-19T02:55:00,Labastida,Expense,education,-52.07,-7487.19
buyer_6,Manuel,45,ES45209554403228000157,TRX_N-00162-05070277,2022-05-19T23:22:03,Vitoria-Gasteiz,Expense,cash,-100.0,-7587.19
buyer_6,Manuel,45,ES45209554403228000157,TRX_N-00163-75294573,2022-05-20T12:12:18,Vitoria-Gasteiz,Expense,appliances,-261.89,-7849.08
buyer_6,Manuel,45,ES45209554403228000157,TRX_N-00164-64151573,2022-05-20T15:32:30,Vitoria-Gasteiz,Expense,gifts,-606.01,-8455.09
buyer_6,Manuel,45,ES45209554403228000157,TRX_N-00165-25873582,2022-05-21T15:47:33,Elciego,Expense,repairs,-229.6,-8684.69
buyer_6,Manuel,45,ES45209554403228000157,TRX_N-00166-76157831,2022-05-22T15:03:06,Vitoria-Gasteiz,Expense,food,-87.56,-8772.25
buyer_6,Manuel,45,ES45209554403228000157,TRX_N-00167-72616337,2022-05-22T19:44:11,Iru√±a de Oca,Expense,transport,-70.71,-8842.96
buyer_6,Manuel,45,ES45209554403228000157,TRX_N-00168-71333552,2022-05-22T11:49:27,Vitoria-Gasteiz,Expense,cash,-100.0,-8942.96
buyer_6,Manuel,45,ES45209554403228000157,TRX_N-00169-72167390,2022-05-24T07:08:03,Vitoria-Gasteiz,Expense,cash,-100.0,-9042.96
buyer_6,Manuel,45,ES45209554403228000157,TRX_N-00170-76867886,2022-05-28T15:03:12,Vitoria-Gasteiz,Expense,gifts,-813.65,-9856.61
buyer_6,Manuel,45,ES45209554403228000157,TRX_N-00171-55447045,2022-05-29T22:34:03,Vitoria-Gasteiz,Expense,gifts,-592.77,-10449.38
buyer_6,Manuel,45,ES45209554403228000157,TRX_N-00172-81056982,2022-06-01T15:05:29,Vitoria-Gasteiz,incomes,salary,1492.25,-8957.13
buyer_6,Manuel,45,ES45209554403228000157,TRX_N-00173-43922793,2022-06-01T15:05:29,Vitoria-Gasteiz,incomes,salary_partner,1020.15,-7936.98
buyer_6,Manuel,45,ES45209554403228000157,TRX_N-00174-09685843,2022-06-01T15:05:29,Vitoria-Gasteiz,incomes,salary_bonus,1124.35,-6812.63
buyer_6,Manuel,45,ES45209554403228000157,TRX_N-00175-39790084,2022-06-01T15:05:29,Vitoria-Gasteiz,incomes,salary_partner_bonus,755.35,-6057.28
buyer_6,Manuel,45,ES45209554403228000157,TRX_N-00176-79371967,2022-06-01T19:49:27,Vitoria-Gasteiz,Expense,leisure,-35.41,-6092.69
buyer_6,Manuel,45,ES45209554403228000157,TRX_N-00177-68695668,2022-06-02T23:30:40,Vitoria-Gasteiz,Expense,education,-70.98,-6163.67
buyer_6,Manuel,45,ES45209554403228000157,TRX_N-00178-36692118,2022-06-04T23:50:47,Vitoria-Gasteiz,expenses,mortgage,-842.56,-7006.23
buyer_6,Manuel,45,ES45209554403228000157,TRX_N-00179-38875114,2022-06-05T20:33:22,Vitoria-Gasteiz,expenses,water,-41.72,-7047.95
buyer_6,Manuel,45,ES45209554403228000157,TRX_N-00180-36295749,2022-06-05T10:38:57,Vitoria-Gasteiz,expenses,internet,-42.0,-7089.95
buyer_6,Manuel,45,ES45209554403228000157,TRX_N-00181-48377417,2022-06-05T12:44:49,Vitoria-Gasteiz,Expense,cash,-100.0,-7189.95
buyer_6,Manuel,45,ES45209554403228000157,TRX_N-00182-95256466,2022-06-05T18:17:00,Iru√±a de Oca,Expense,appliances,-305.78,-7495.73
buyer_6,Manuel,45,ES45209554403228000157,TRX_N-00183-52560282,2022-06-06T08:51:58,Vitoria-Gasteiz,expenses,children,-65.17,-7560.9
buyer_6,Manuel,45,ES45209554403228000157,TRX_N-00184-52509328,2022-06-07T14:21:30,Vitoria-Gasteiz,Expense,food,-61.67,-7622.57
buyer_6,Manuel,45,ES45209554403228000157,TRX_N-00185-01256522,2022-06-07T17:02:13,Vitoria-Gasteiz,Expense,clothing,-142.33,-7764.9
buyer_6,Manuel,45,ES45209554403228000157,TRX_N-00186-09070166,2022-06-08T00:31:36,Vitoria-Gasteiz,expenses,electricity,-39.3,-7804.2
buyer_6,Manuel,45,ES45209554403228000157,TRX_N-00187-48816509,2022-06-08T12:57:20,Vitoria-Gasteiz,expenses,gas,-45.67,-7849.87
buyer_6,Manuel,45,ES45209554403228000157,TRX_N-00188-78173017,2022-06-08T23:52:57,Vitoria-Gasteiz,expenses,phone,-36.74,-7886.61
buyer_6,Manuel,45,ES45209554403228000157,TRX_N-00189-95312211,2022-06-08T04:14:10,Vitoria-Gasteiz,Expense,cash,-100.0,-7986.61
buyer_6,Manuel,45,ES45209554403228000157,TRX_N-00190-86378566,2022-06-09T21:26:10,Vitoria-Gasteiz,Expense,leisure,-24.37,-8010.98
buyer_6,Manuel,45,ES45209554403228000157,TRX_N-00191-49852259,2022-06-11T16:33:54,Zarautz,Expense,food,-60.61,-8071.59
buyer_6,Manuel,45,ES45209554403228000157,TRX_N-00192-63901243,2022-06-11T21:41:44,Vitoria-Gasteiz,Expense,leisure,-53.25,-8124.84
buyer_6,Manuel,45,ES45209554403228000157,TRX_N-00193-60789877,2022-06-13T16:17:49,Vitoria-Gasteiz,Expense,food,-114.65,-8239.49
buyer_6,Manuel,45,ES45209554403228000157,TRX_N-00194-20328311,2022-06-16T18:00:18,Vitoria-Gasteiz,Expense,transport,-89.74,-8329.23
buyer_6,Manuel,45,ES45209554403228000157,TRX_N-00195-69011135,2022-06-16T18:54:51,Bermeo,Expense,appliances,-349.41,-8678.64
buyer_6,Manuel,45,ES45209554403228000157,TRX_N-00196-64401263,2022-06-20T05:43:51,Vitoria-Gasteiz,Expense,repairs,-134.96,-8813.6
buyer_6,Manuel,45,ES45209554403228000157,TRX_N-00197-32380472,2022-06-22T08:50:41,Vitoria-Gasteiz,Expense,food,-122.06,-8935.66
buyer_6,Manuel,45,ES45209554403228000157,TRX_N-00198-82795641,2022-06-23T10:02:49,Vitoria-Gasteiz,Expense,food,-86.06,-9021.72
buyer_6,Manuel,45,ES45209554403228000157,TRX_N-00199-24149011,2022-06-24T20:22:15,Vitoria-Gasteiz,Expense,transport,-47.04,-9068.76
buyer_6,Manuel,45,ES45209554403228000157,TRX_N-00200-14289038,2022-06-24T09:08:26,Vitoria-Gasteiz,Expense,cash,-100.0,-9168.76
buyer_6,Manuel,45,ES45209554403228000157,TRX_N-00201-66575284,2022-06-25T11:06:18,Eibar,Expense,cash,-100.0,-9268.76
buyer_6,Manuel,45,ES45209554403228000157,TRX_N-00202-89467007,2022-06-27T13:03:38,Vitoria-Gasteiz,Expense,food,-95.84,-9364.6
buyer_6,Manuel,45,ES45209554403228000157,TRX_N-00203-51724866,2022-06-28T23:13:30,Vitoria-Gasteiz,Expense,food,-72.87,-9437.47
buyer_6,Manuel,45,ES45209554403228000157,TRX_N-00204-64158141,2022-06-28T16:20:52,Vitoria-Gasteiz,Expense,transport,-69.11,-9506.58
buyer_6,Manuel,45,ES45209554403228000157,TRX_N-00205-90277498,2022-06-28T17:19:58,Barakaldo,Expense,cash,-100.0,-9606.58
buyer_6,Manuel,45,ES45209554403228000157,TRX_N-00206-24150301,2022-06-29T16:33:04,Vitoria-Gasteiz,Expense,cash,-100.0,-9706.58
buyer_6,Manuel,45,ES45209554403228000157,TRX_N-00207-76640367,2022-06-29T12:59:38,Vitoria-Gasteiz,Expense,travel,-370.51,-10077.09
buyer_6,Manuel,45,ES45209554403228000157,TRX_N-00208-20708547,2022-07-01T12:34:10,Vitoria-Gasteiz,incomes,salary,1492.25,-8584.84
buyer_6,Manuel,45,ES45209554403228000157,TRX_N-00209-14066110,2022-07-01T12:34:10,Vitoria-Gasteiz,incomes,salary_partner,1020.15,-7564.69
buyer_6,Manuel,45,ES45209554403228000157,TRX_N-00210-19084137,2022-07-01T12:34:10,Vitoria-Gasteiz,incomes,extra_income,251.7,-7312.99
buyer_6,Manuel,45,ES45209554403228000157,TRX_N-00211-94850463,2022-07-01T22:59:45,Vitoria-Gasteiz,expenses,children,-81.33,-7394.32
buyer_6,Manuel,45,ES45209554403228000157,TRX_N-00212-49359888,2022-07-03T16:37:05,Vitoria-Gasteiz,Expense,transport,-61.61,-7455.93
buyer_6,Manuel,45,ES45209554403228000157,TRX_N-00213-46234384,2022-07-03T18:54:48,Berango,Expense,healthcare,-79.57,-7535.5
buyer_6,Manuel,45,ES45209554403228000157,TRX_N-00214-24970343,2022-07-03T14:44:12,Vitoria-Gasteiz,Expense,education,-65.47,-7600.97
buyer_6,Manuel,45,ES45209554403228000157,TRX_N-00215-61954151,2022-07-03T08:02:58,Pasaia,Expense,cash,-100.0,-7700.97
buyer_6,Manuel,45,ES45209554403228000157,TRX_N-00216-14127284,2022-07-03T16:08:04,Vitoria-Gasteiz,expenses,children,-174.46,-7875.43
buyer_6,Manuel,45,ES45209554403228000157,TRX_N-00217-88362837,2022-07-04T12:18:48,Vitoria-Gasteiz,expenses,mortgage,-842.56,-8717.99
buyer_6,Manuel,45,ES45209554403228000157,TRX_N-00218-67945880,2022-07-05T10:56:31,Vitoria-Gasteiz,expenses,electricity,-35.09,-8753.08
buyer_6,Manuel,45,ES45209554403228000157,TRX_N-00219-50532439,2022-07-05T10:34:20,Vitoria-Gasteiz,expenses,internet,-42.0,-8795.08
buyer_6,Manuel,45,ES45209554403228000157,TRX_N-00220-37951811,2022-07-05T15:39:11,Vitoria-Gasteiz,Expense,food,-74.29,-8869.37
buyer_6,Manuel,45,ES45209554403228000157,TRX_N-00221-31247743,2022-07-06T05:01:14,Vitoria-Gasteiz,expenses,gas,-47.44,-8916.81
buyer_6,Manuel,45,ES45209554403228000157,TRX_N-00222-86981586,2022-07-06T13:06:19,Vitoria-Gasteiz,Expense,food,-118.78,-9035.59
buyer_6,Manuel,45,ES45209554403228000157,TRX_N-00223-63663634,2022-07-07T14:26:39,Vitoria-Gasteiz,expenses,phone,-42.41,-9078.0
buyer_6,Manuel,45,ES45209554403228000157,TRX_N-00224-88853075,2022-07-07T16:19:55,Vitoria-Gasteiz,Expense,food,-84.24,-9162.24
buyer_6,Manuel,45,ES45209554403228000157,TRX_N-00225-83899927,2022-07-07T16:31:54,Vitoria-Gasteiz,Expense,leisure,-52.44,-9214.68
buyer_6,Manuel,45,ES45209554403228000157,TRX_N-00226-92255211,2022-07-07T17:04:18,Vitoria-Gasteiz,Expense,gifts,-719.33,-9934.01
buyer_6,Manuel,45,ES45209554403228000157,TRX_N-00227-23603063,2022-07-08T17:01:59,Vitoria-Gasteiz,expenses,water,-24.07,-9958.08
buyer_6,Manuel,45,ES45209554403228000157,TRX_N-00228-47114756,2022-07-08T12:44:20,Vitoria-Gasteiz,Expense,appliances,-335.97,-10294.05
buyer_6,Manuel,45,ES45209554403228000157,TRX_N-00229-02381471,2022-07-09T09:26:42,Vitoria-Gasteiz,Expense,leisure,-35.5,-10329.55
buyer_6,Manuel,45,ES45209554403228000157,TRX_N-00230-34613772,2022-07-10T16:33:42,Vitoria-Gasteiz,Expense,cash,-100.0,-10429.55
buyer_6,Manuel,45,ES45209554403228000157,TRX_N-00231-65917973,2022-07-10T19:18:06,Vitoria-Gasteiz,Expense,repairs,-128.55,-10558.1
buyer_6,Manuel,45,ES45209554403228000157,TRX_N-00232-33144776,2022-07-12T11:56:13,Vitoria-Gasteiz,Expense,education,-45.11,-10603.21
buyer_6,Manuel,45,ES45209554403228000157,TRX_N-00233-62967428,2022-07-14T20:18:53,Vitoria-Gasteiz,Expense,food,-124.66,-10727.87
buyer_6,Manuel,45,ES45209554403228000157,TRX_N-00234-71743026,2022-07-15T17:01:09,Amurrio,Expense,clothing,-102.2,-10830.07
buyer_6,Manuel,45,ES45209554403228000157,TRX_N-00235-14690880,2022-07-18T08:45:02,Vitoria-Gasteiz,Expense,education,-74.03,-10904.1
buyer_6,Manuel,45,ES45209554403228000157,TRX_N-00236-42690930,2022-07-21T12:18:15,Vitoria-Gasteiz,Expense,food,-64.8,-10968.9
buyer_6,Manuel,45,ES45209554403228000157,TRX_N-00237-25324106,2022-07-21T14:45:05,Vitoria-Gasteiz,Expense,transport,-89.7,-11058.6
buyer_6,Manuel,45,ES45209554403228000157,TRX_N-00238-80688751,2022-07-22T20:30:31,Leioa,Expense,leisure,-40.64,-11099.24
buyer_6,Manuel,45,ES45209554403228000157,TRX_N-00239-76214999,2022-07-22T11:30:42,Elciego,Expense,education,-48.55,-11147.79
buyer_6,Manuel,45,ES45209554403228000157,TRX_N-00240-17860852,2022-07-22T19:22:50,Llodio,Expense,cash,-100.0,-11247.79
buyer_6,Manuel,45,ES45209554403228000157,TRX_N-00241-09253424,2022-07-23T20:34:03,Vitoria-Gasteiz,Expense,food,-95.51,-11343.3
buyer_6,Manuel,45,ES45209554403228000157,TRX_N-00242-86771663,2022-07-23T22:57:07,Portugalete,Expense,travel,-1519.8,-12863.1
buyer_6,Manuel,45,ES45209554403228000157,TRX_N-00243-88744561,2022-07-24T18:51:13,Vitoria-Gasteiz,Expense,food,-82.28,-12945.38
buyer_6,Manuel,45,ES45209554403228000157,TRX_N-00244-75935122,2022-07-26T12:39:45,Vitoria-Gasteiz,Expense,clothing,-106.79,-13052.17
buyer_6,Manuel,45,ES45209554403228000157,TRX_N-00245-56070736,2022-07-28T16:49:56,Vitoria-Gasteiz,Expense,food,-120.39,-13172.56
buyer_6,Manuel,45,ES45209554403228000157,TRX_N-00246-52459130,2022-07-29T22:36:55,Vitoria-Gasteiz,Expense,food,-80.55,-13253.11
buyer_6,Manuel,45,ES45209554403228000157,TRX_N-00247-35496262,2022-08-01T17:06:46,Vitoria-Gasteiz,incomes,salary,1492.25,-11760.86
buyer_6,Manuel,45,ES45209554403228000157,TRX_N-00248-39008945,2022-08-01T17:06:46,Vitoria-Gasteiz,incomes,salary_partner,1020.15,-10740.71
buyer_6,Manuel,45,ES45209554403228000157,TRX_N-00249-96351874,2022-08-01T11:34:56,Vitoria-Gasteiz,Expense,transport,-55.52,-10796.23
buyer_6,Manuel,45,ES45209554403228000157,TRX_N-00250-07308729,2022-08-02T21:21:59,Vitoria-Gasteiz,Expense,travel,-1401.21,-12197.44
buyer_6,Manuel,45,ES45209554403228000157,TRX_N-00251-64795574,2022-08-04T19:40:05,Vitoria-Gasteiz,expenses,mortgage,-842.56,-13040.0
buyer_6,Manuel,45,ES45209554403228000157,TRX_N-00252-00334913,2022-08-05T13:07:05,Vitoria-Gasteiz,expenses,electricity,-87.67,-13127.67
buyer_6,Manuel,45,ES45209554403228000157,TRX_N-00253-63574077,2022-08-05T12:43:34,Vitoria-Gasteiz,Expense,repairs,-188.82,-13316.49
buyer_6,Manuel,45,ES45209554403228000157,TRX_N-00254-91802498,2022-08-07T11:34:31,Vitoria-Gasteiz,expenses,phone,-34.17,-13350.66
buyer_6,Manuel,45,ES45209554403228000157,TRX_N-00255-50962077,2022-08-08T23:44:42,Vitoria-Gasteiz,expenses,water,-43.85,-13394.51
buyer_6,Manuel,45,ES45209554403228000157,TRX_N-00256-56716142,2022-08-08T15:41:16,Vitoria-Gasteiz,expenses,gas,-68.49,-13463.0
buyer_6,Manuel,45,ES45209554403228000157,TRX_N-00257-30017949,2022-08-08T14:53:42,Vitoria-Gasteiz,expenses,internet,-42.0,-13505.0
buyer_6,Manuel,45,ES45209554403228000157,TRX_N-00258-79930903,2022-08-08T10:20:51,Vitoria-Gasteiz,Expense,clothing,-61.57,-13566.57
buyer_6,Manuel,45,ES45209554403228000157,TRX_N-00259-26805613,2022-08-08T18:50:45,Vitoria-Gasteiz,Expense,cash,-100.0,-13666.57
buyer_6,Manuel,45,ES45209554403228000157,TRX_N-00260-88081451,2022-08-10T17:00:22,Elciego,Expense,healthcare,-86.7,-13753.27
buyer_6,Manuel,45,ES45209554403228000157,TRX_N-00261-33032966,2022-08-11T21:37:57,Vitoria-Gasteiz,Expense,transport,-84.5,-13837.77
buyer_6,Manuel,45,ES45209554403228000157,TRX_N-00262-15538557,2022-08-12T13:53:50,Salvatierra/Agurain,Expense,cash,-100.0,-13937.77
buyer_6,Manuel,45,ES45209554403228000157,TRX_N-00263-97471330,2022-08-13T10:32:03,Vitoria-Gasteiz,Expense,food,-87.06,-14024.83
buyer_6,Manuel,45,ES45209554403228000157,TRX_N-00264-85451206,2022-08-13T15:50:16,Vitoria-Gasteiz,Expense,cash,-100.0,-14124.83
buyer_6,Manuel,45,ES45209554403228000157,TRX_N-00265-62823137,2022-08-14T20:37:19,Vitoria-Gasteiz,Expense,cash,-100.0,-14224.83
buyer_6,Manuel,45,ES45209554403228000157,TRX_N-00266-25982642,2022-08-18T20:18:15,Vitoria-Gasteiz,Expense,food,-61.41,-14286.24
buyer_6,Manuel,45,ES45209554403228000157,TRX_N-00267-98478966,2022-08-18T18:37:59,Pasaia,Expense,cash,-100.0,-14386.24
buyer_6,Manuel,45,ES45209554403228000157,TRX_N-00268-89012025,2022-08-20T07:17:57,Vitoria-Gasteiz,Expense,food,-72.12,-14458.36
buyer_6,Manuel,45,ES45209554403228000157,TRX_N-00269-65176183,2022-08-20T11:57:39,Vitoria-Gasteiz,Expense,education,-73.85,-14532.21
buyer_6,Manuel,45,ES45209554403228000157,TRX_N-00270-70833960,2022-08-22T09:59:33,Vitoria-Gasteiz,Expense,cash,-100.0,-14632.21
buyer_6,Manuel,45,ES45209554403228000157,TRX_N-00271-71942604,2022-08-23T15:10:11,Vitoria-Gasteiz,Expense,transport,-55.85,-14688.06
buyer_6,Manuel,45,ES45209554403228000157,TRX_N-00272-76484415,2022-08-23T22:10:30,Hernani,Expense,leisure,-68.77,-14756.83
buyer_6,Manuel,45,ES45209554403228000157,TRX_N-00273-34884461,2022-08-24T18:56:42,Vitoria-Gasteiz,Expense,leisure,-75.18,-14832.01
buyer_6,Manuel,45,ES45209554403228000157,TRX_N-00274-40453781,2022-08-25T18:40:53,Vitoria-Gasteiz,Expense,leisure,-37.89,-14869.9
buyer_6,Manuel,45,ES45209554403228000157,TRX_N-00275-08470114,2022-08-25T16:10:57,Vitoria-Gasteiz,Expense,repairs,-79.82,-14949.72
buyer_6,Manuel,45,ES45209554403228000157,TRX_N-00276-46484661,2022-08-29T23:15:31,Vitoria-Gasteiz,Expense,cash,-100.0,-15049.72
buyer_6,Manuel,45,ES45209554403228000157,TRX_N-00277-32259768,2022-08-30T10:31:45,Vitoria-Gasteiz,Expense,food,-83.57,-15133.29
buyer_6,Manuel,45,ES45209554403228000157,TRX_N-00278-23746695,2022-08-31T11:13:33,Vitoria-Gasteiz,Expense,leisure,-46.85,-15180.14
buyer_6,Manuel,45,ES45209554403228000157,TRX_N-00279-12382022,2022-08-31T16:12:22,Vitoria-Gasteiz,Expense,clothing,-147.56,-15327.7
buyer_6,Manuel,45,ES45209554403228000157,TRX_N-00280-66702842,2022-09-01T14:56:41,Vitoria-Gasteiz,incomes,salary,1492.25,-13835.45
buyer_6,Manuel,45,ES45209554403228000157,TRX_N-00281-43263893,2022-09-01T14:56:41,Vitoria-Gasteiz,incomes,salary_partner,1020.15,-12815.3
buyer_6,Manuel,45,ES45209554403228000157,TRX_N-00282-50654871,2022-09-02T07:14:48,Vitoria-Gasteiz,Expense,appliances,-151.05,-12966.35
buyer_6,Manuel,45,ES45209554403228000157,TRX_N-00283-34058369,2022-09-03T16:31:05,Vitoria-Gasteiz,Expense,leisure,-22.95,-12989.3
buyer_6,Manuel,45,ES45209554403228000157,TRX_N-00284-29564939,2022-09-04T09:52:22,Vitoria-Gasteiz,expenses,mortgage,-842.56,-13831.86
buyer_6,Manuel,45,ES45209554403228000157,TRX_N-00285-80838398,2022-09-04T15:37:49,Vitoria-Gasteiz,Expense,food,-100.25,-13932.11
buyer_6,Manuel,45,ES45209554403228000157,TRX_N-00286-17002223,2022-09-05T17:02:23,Vitoria-Gasteiz,expenses,electricity,-58.68,-13990.79
buyer_6,Manuel,45,ES45209554403228000157,TRX_N-00287-85975814,2022-09-05T17:41:40,Durango,Expense,transport,-55.36,-14046.15
buyer_6,Manuel,45,ES45209554403228000157,TRX_N-00288-13910676,2022-09-06T22:09:44,Vitoria-Gasteiz,expenses,water,-30.98,-14077.13
buyer_6,Manuel,45,ES45209554403228000157,TRX_N-00289-56030860,2022-09-06T05:42:27,Vitoria-Gasteiz,Expense,transport,-53.29,-14130.42
buyer_6,Manuel,45,ES45209554403228000157,TRX_N-00290-06854132,2022-09-06T18:11:57,Vitoria-Gasteiz,Expense,healthcare,-164.23,-14294.65
buyer_6,Manuel,45,ES45209554403228000157,TRX_N-00291-20360459,2022-09-07T14:27:52,Vitoria-Gasteiz,Expense,food,-117.26,-14411.91
buyer_6,Manuel,45,ES45209554403228000157,TRX_N-00292-82439166,2022-09-08T09:54:09,Vitoria-Gasteiz,expenses,gas,-43.88,-14455.79
buyer_6,Manuel,45,ES45209554403228000157,TRX_N-00293-50106662,2022-09-08T09:50:56,Vitoria-Gasteiz,expenses,internet,-42.0,-14497.79
buyer_6,Manuel,45,ES45209554403228000157,TRX_N-00294-79141430,2022-09-08T20:08:11,Vitoria-Gasteiz,expenses,phone,-34.48,-14532.27
buyer_6,Manuel,45,ES45209554403228000157,TRX_N-00295-64004260,2022-09-11T05:10:45,Vitoria-Gasteiz,Expense,food,-78.92,-14611.19
buyer_6,Manuel,45,ES45209554403228000157,TRX_N-00296-14904061,2022-09-11T09:28:14,Vitoria-Gasteiz,Expense,appliances,-126.64,-14737.83
buyer_6,Manuel,45,ES45209554403228000157,TRX_N-00297-01490443,2022-09-13T21:11:39,Alegr√≠a-Dulantzi,Expense,transport,-62.59,-14800.42
buyer_6,Manuel,45,ES45209554403228000157,TRX_N-00298-34033888,2022-09-13T19:54:08,Vitoria-Gasteiz,Expense,cash,-100.0,-14900.42
buyer_6,Manuel,45,ES45209554403228000157,TRX_N-00299-65395720,2022-09-13T19:16:24,Errenteria,Expense,travel,-787.42,-15687.84
buyer_6,Manuel,45,ES45209554403228000157,TRX_N-00300-16496348,2022-09-15T10:10:48,Vitoria-Gasteiz,Expense,travel,-1328.01,-17015.85
buyer_6,Manuel,45,ES45209554403228000157,TRX_N-00301-43942619,2022-09-15T17:43:23,Vitoria-Gasteiz,Expense,repairs,-322.52,-17338.37
buyer_6,Manuel,45,ES45209554403228000157,TRX_N-00302-49118353,2022-09-17T09:09:58,Arrasate,Expense,food,-124.58,-17462.95
buyer_6,Manuel,45,ES45209554403228000157,TRX_N-00303-79536886,2022-09-17T14:13:09,Vitoria-Gasteiz,Expense,transport,-40.01,-17502.96
buyer_6,Manuel,45,ES45209554403228000157,TRX_N-00304-51010804,2022-09-17T19:22:13,Sopela,Expense,travel,-660.41,-18163.37
buyer_6,Manuel,45,ES45209554403228000157,TRX_N-00305-38720434,2022-09-18T19:45:42,Getxo,Expense,clothing,-127.94,-18291.31
buyer_6,Manuel,45,ES45209554403228000157,TRX_N-00306-75135762,2022-09-18T09:04:33,Vitoria-Gasteiz,Expense,repairs,-263.84,-18555.15
buyer_6,Manuel,45,ES45209554403228000157,TRX_N-00307-01097407,2022-09-20T18:15:13,Sestao,Expense,leisure,-24.83,-18579.98
buyer_6,Manuel,45,ES45209554403228000157,TRX_N-00308-92666988,2022-09-21T12:49:57,Vitoria-Gasteiz,Expense,food,-69.63,-18649.61
buyer_6,Manuel,45,ES45209554403228000157,TRX_N-00309-25947963,2022-09-22T21:50:31,Vitoria-Gasteiz,Expense,healthcare,-39.7,-18689.31
buyer_6,Manuel,45,ES45209554403228000157,TRX_N-00310-77094364,2022-09-23T12:01:17,Vitoria-Gasteiz,Expense,leisure,-80.31,-18769.62
buyer_6,Manuel,45,ES45209554403228000157,TRX_N-00311-51186167,2022-09-24T19:32:24,Vitoria-Gasteiz,Expense,cash,-100.0,-18869.62
buyer_6,Manuel,45,ES45209554403228000157,TRX_N-00312-25350288,2022-09-25T15:45:00,Vitoria-Gasteiz,Expense,transport,-41.63,-18911.25
buyer_6,Manuel,45,ES45209554403228000157,TRX_N-00313-79005992,2022-09-27T08:31:28,Vitoria-Gasteiz,Expense,transport,-63.91,-18975.16
buyer_6,Manuel,45,ES45209554403228000157,TRX_N-00314-49168016,2022-09-27T08:44:55,Vitoria-Gasteiz,Expense,healthcare,-113.66,-19088.82
buyer_6,Manuel,45,ES45209554403228000157,TRX_N-00315-60084671,2022-09-28T14:11:09,Vitoria-Gasteiz,Expense,gifts,-821.23,-19910.05
buyer_6,Manuel,45,ES45209554403228000157,TRX_N-00316-85332716,2022-10-01T17:02:26,Vitoria-Gasteiz,incomes,salary,1492.25,-18417.8
buyer_6,Manuel,45,ES45209554403228000157,TRX_N-00317-49324106,2022-10-01T17:02:26,Vitoria-Gasteiz,incomes,salary_partner,1020.15,-17397.65
buyer_6,Manuel,45,ES45209554403228000157,TRX_N-00318-81927938,2022-10-01T20:45:10,Vitoria-Gasteiz,Expense,education,-55.88,-17453.53
buyer_6,Manuel,45,ES45209554403228000157,TRX_N-00319-66493541,2022-10-04T14:11:12,Vitoria-Gasteiz,expenses,mortgage,-842.56,-18296.09
buyer_6,Manuel,45,ES45209554403228000157,TRX_N-00320-61999824,2022-10-05T14:58:59,Vitoria-Gasteiz,expenses,electricity,-51.1,-18347.19
buyer_6,Manuel,45,ES45209554403228000157,TRX_N-00321-34613264,2022-10-05T14:37:36,Vitoria-Gasteiz,expenses,phone,-43.94,-18391.13
buyer_6,Manuel,45,ES45209554403228000157,TRX_N-00322-43361431,2022-10-06T12:01:54,Vitoria-Gasteiz,expenses,water,-32.79,-18423.92
buyer_6,Manuel,45,ES45209554403228000157,TRX_N-00323-00811954,2022-10-06T16:54:59,Vitoria-Gasteiz,expenses,gas,-49.37,-18473.29
buyer_6,Manuel,45,ES45209554403228000157,TRX_N-00324-65858111,2022-10-07T16:41:58,Vitoria-Gasteiz,Expense,food,-117.63,-18590.92
buyer_6,Manuel,45,ES45209554403228000157,TRX_N-00325-04451260,2022-10-08T16:12:28,Vitoria-Gasteiz,expenses,internet,-42.0,-18632.92
buyer_6,Manuel,45,ES45209554403228000157,TRX_N-00326-90766672,2022-10-08T10:53:16,Basauri,Expense,food,-121.43,-18754.35
buyer_6,Manuel,45,ES45209554403228000157,TRX_N-00327-84275966,2022-10-08T14:14:31,Vitoria-Gasteiz,Expense,leisure,-74.3,-18828.65
buyer_6,Manuel,45,ES45209554403228000157,TRX_N-00328-23048177,2022-10-09T14:01:00,Vitoria-Gasteiz,Expense,food,-98.15,-18926.8
buyer_6,Manuel,45,ES45209554403228000157,TRX_N-00329-78633578,2022-10-10T19:25:07,Amurrio,Expense,education,-62.01,-18988.81
buyer_6,Manuel,45,ES45209554403228000157,TRX_N-00330-53423985,2022-10-11T12:44:26,Vitoria-Gasteiz,Expense,food,-89.55,-19078.36
buyer_6,Manuel,45,ES45209554403228000157,TRX_N-00331-54394189,2022-10-14T10:13:07,Vitoria-Gasteiz,Expense,gifts,-487.96,-19566.32
buyer_6,Manuel,45,ES45209554403228000157,TRX_N-00332-12516925,2022-10-18T14:08:41,Durango,Expense,cash,-100.0,-19666.32
buyer_6,Manuel,45,ES45209554403228000157,TRX_N-00333-58957186,2022-10-23T12:18:12,Erandio,Expense,food,-69.92,-19736.24
buyer_6,Manuel,45,ES45209554403228000157,TRX_N-00334-19591751,2022-10-23T09:36:25,Vitoria-Gasteiz,Expense,transport,-69.83,-19806.07
buyer_6,Manuel,45,ES45209554403228000157,TRX_N-00335-01089853,2022-10-23T22:44:12,Vitoria-Gasteiz,Expense,cash,-100.0,-19906.07
buyer_6,Manuel,45,ES45209554403228000157,TRX_N-00336-71343408,2022-10-25T21:38:37,Vitoria-Gasteiz,Expense,food,-73.2,-19979.27
buyer_6,Manuel,45,ES45209554403228000157,TRX_N-00337-82113826,2022-10-26T16:27:20,Vitoria-Gasteiz,Expense,food,-61.42,-20040.69
buyer_6,Manuel,45,ES45209554403228000157,TRX_N-00338-83866893,2022-10-29T08:47:27,Vitoria-Gasteiz,Expense,transport,-63.29,-20103.98
buyer_6,Manuel,45,ES45209554403228000157,TRX_N-00339-76141520,2022-10-29T21:57:14,Vitoria-Gasteiz,Expense,cash,-100.0,-20203.98
buyer_6,Manuel,45,ES45209554403228000157,TRX_N-00340-21362295,2022-10-30T08:46:30,Andoain,Expense,food,-74.47,-20278.45
buyer_6,Manuel,45,ES45209554403228000157,TRX_N-00341-69206666,2022-10-30T23:32:06,Vitoria-Gasteiz,Expense,cash,-100.0,-20378.45
buyer_6,Manuel,45,ES45209554403228000157,TRX_N-00342-78296032,2022-10-30T18:23:30,Vitoria-Gasteiz,Expense,gifts,-847.77,-21226.22
buyer_6,Manuel,45,ES45209554403228000157,TRX_N-00343-84592632,2022-10-31T17:44:37,Santurtzi,Expense,repairs,-75.02,-21301.24
buyer_6,Manuel,45,ES45209554403228000157,TRX_N-00344-26265609,2022-11-01T12:19:07,Vitoria-Gasteiz,incomes,salary,1492.25,-19808.99
buyer_6,Manuel,45,ES45209554403228000157,TRX_N-00345-54687693,2022-11-01T12:19:07,Vitoria-Gasteiz,incomes,salary_partner,1020.15,-18788.84
buyer_6,Manuel,45,ES45209554403228000157,TRX_N-00346-35558662,2022-11-01T12:19:07,Vitoria-Gasteiz,incomes,extra_income,251.7,-18537.14
buyer_6,Manuel,45,ES45209554403228000157,TRX_N-00347-90800329,2022-11-02T05:13:19,Vitoria-Gasteiz,Expense,leisure,-78.1,-18615.24
buyer_6,Manuel,45,ES45209554403228000157,TRX_N-00348-87927006,2022-11-02T06:25:50,Vitoria-Gasteiz,Expense,healthcare,-131.81,-18747.05
buyer_6,Manuel,45,ES45209554403228000157,TRX_N-00349-40377120,2022-11-03T13:50:29,Vitoria-Gasteiz,Expense,transport,-85.82,-18832.87
buyer_6,Manuel,45,ES45209554403228000157,TRX_N-00350-15256429,2022-11-03T16:54:26,Vitoria-Gasteiz,Expense,cash,-100.0,-18932.87
buyer_6,Manuel,45,ES45209554403228000157,TRX_N-00351-14466083,2022-11-04T19:13:03,Vitoria-Gasteiz,expenses,mortgage,-842.56,-19775.43
buyer_6,Manuel,45,ES45209554403228000157,TRX_N-00352-07586792,2022-11-05T08:42:31,Bilbao,Expense,appliances,-377.92,-20153.35
buyer_6,Manuel,45,ES45209554403228000157,TRX_N-00353-01210608,2022-11-05T11:07:55,Vitoria-Gasteiz,Expense,gifts,-336.07,-20489.42
buyer_6,Manuel,45,ES45209554403228000157,TRX_N-00354-62327235,2022-11-08T17:37:37,Vitoria-Gasteiz,expenses,electricity,-69.33,-20558.75
buyer_6,Manuel,45,ES45209554403228000157,TRX_N-00355-06565155,2022-11-08T18:16:42,Vitoria-Gasteiz,expenses,gas,-60.81,-20619.56
buyer_6,Manuel,45,ES45209554403228000157,TRX_N-00356-35610988,2022-11-08T17:01:49,Vitoria-Gasteiz,expenses,water,-36.84,-20656.4
buyer_6,Manuel,45,ES45209554403228000157,TRX_N-00357-23057782,2022-11-08T18:16:31,Vitoria-Gasteiz,expenses,internet,-42.0,-20698.4
buyer_6,Manuel,45,ES45209554403228000157,TRX_N-00358-55344086,2022-11-08T10:08:09,Vitoria-Gasteiz,expenses,phone,-38.81,-20737.21
buyer_6,Manuel,45,ES45209554403228000157,TRX_N-00359-07992973,2022-11-08T11:43:13,Vitoria-Gasteiz,Expense,food,-86.23,-20823.44
buyer_6,Manuel,45,ES45209554403228000157,TRX_N-00360-76764555,2022-11-09T15:44:06,Vitoria-Gasteiz,Expense,food,-82.45,-20905.89
buyer_6,Manuel,45,ES45209554403228000157,TRX_N-00361-95210404,2022-11-10T16:39:02,Vitoria-Gasteiz,Expense,transport,-81.55,-20987.44
buyer_6,Manuel,45,ES45209554403228000157,TRX_N-00362-72620714,2022-11-10T19:10:27,Vitoria-Gasteiz,Expense,leisure,-77.62,-21065.06
buyer_6,Manuel,45,ES45209554403228000157,TRX_N-00363-55168837,2022-11-11T10:38:25,Vitoria-Gasteiz,Expense,transport,-68.15,-21133.21
buyer_6,Manuel,45,ES45209554403228000157,TRX_N-00364-03144966,2022-11-12T13:12:47,Berango,Expense,food,-90.63,-21223.84
buyer_6,Manuel,45,ES45209554403228000157,TRX_N-00365-36208435,2022-11-13T15:51:24,Errenteria,Expense,food,-91.54,-21315.38
buyer_6,Manuel,45,ES45209554403228000157,TRX_N-00366-56628915,2022-11-15T10:57:07,Vitoria-Gasteiz,Expense,leisure,-66.45,-21381.83
buyer_6,Manuel,45,ES45209554403228000157,TRX_N-00367-32000314,2022-11-17T11:49:22,Vitoria-Gasteiz,Expense,repairs,-89.86,-21471.69
buyer_6,Manuel,45,ES45209554403228000157,TRX_N-00368-37421737,2022-11-18T08:08:16,Vitoria-Gasteiz,Expense,transport,-72.87,-21544.56
buyer_6,Manuel,45,ES45209554403228000157,TRX_N-00369-52567180,2022-11-18T14:09:00,Barakaldo,Expense,healthcare,-162.26,-21706.82
buyer_6,Manuel,45,ES45209554403228000157,TRX_N-00370-27473736,2022-11-18T14:30:56,Vitoria-Gasteiz,Expense,education,-58.09,-21764.91
buyer_6,Manuel,45,ES45209554403228000157,TRX_N-00371-81073217,2022-11-19T18:58:12,Amurrio,Expense,cash,-100.0,-21864.91
buyer_6,Manuel,45,ES45209554403228000157,TRX_N-00372-25352282,2022-11-22T15:10:19,Vitoria-Gasteiz,Expense,food,-108.1,-21973.01
buyer_6,Manuel,45,ES45209554403228000157,TRX_N-00373-20207649,2022-11-22T20:59:51,Vitoria-Gasteiz,Expense,transport,-59.93,-22032.94
buyer_6,Manuel,45,ES45209554403228000157,TRX_N-00374-27603603,2022-11-25T16:46:58,Portugalete,Expense,food,-67.29,-22100.23
buyer_6,Manuel,45,ES45209554403228000157,TRX_N-00375-22708723,2022-11-26T08:09:54,Vitoria-Gasteiz,Expense,education,-75.05,-22175.28
buyer_6,Manuel,45,ES45209554403228000157,TRX_N-00376-03123858,2022-11-27T15:13:34,Vitoria-Gasteiz,Expense,food,-124.53,-22299.81
buyer_6,Manuel,45,ES45209554403228000157,TRX_N-00377-49955764,2022-11-29T20:38:12,Vitoria-Gasteiz,Expense,leisure,-19.18,-22318.99
buyer_6,Manuel,45,ES45209554403228000157,TRX_N-00378-83441795,2022-11-30T23:00:18,Vitoria-Gasteiz,Expense,food,-96.4,-22415.39
buyer_6,Manuel,45,ES45209554403228000157,TRX_N-00379-26885795,2022-11-30T17:00:57,Vitoria-Gasteiz,Expense,leisure,-79.34,-22494.73
buyer_6,Manuel,45,ES45209554403228000157,TRX_N-00380-64652513,2022-12-01T13:35:46,Vitoria-Gasteiz,incomes,salary,1492.25,-21002.48
buyer_6,Manuel,45,ES45209554403228000157,TRX_N-00381-55999972,2022-12-01T13:35:46,Vitoria-Gasteiz,incomes,salary_partner,1020.15,-19982.33
buyer_6,Manuel,45,ES45209554403228000157,TRX_N-00382-66832551,2022-12-01T13:35:46,Vitoria-Gasteiz,incomes,salary_bonus,1180.33,-18802.0
buyer_6,Manuel,45,ES45209554403228000157,TRX_N-00383-98245773,2022-12-01T13:35:46,Vitoria-Gasteiz,incomes,salary_partner_bonus,730.77,-18071.23
buyer_6,Manuel,45,ES45209554403228000157,TRX_N-00384-50054420,2022-12-01T17:27:31,Vitoria-Gasteiz,Expense,food,-64.48,-18135.71
buyer_6,Manuel,45,ES45209554403228000157,TRX_N-00385-56292422,2022-12-01T10:57:36,Vitoria-Gasteiz,Expense,leisure,-49.06,-18184.77
buyer_6,Manuel,45,ES45209554403228000157,TRX_N-00386-50130530,2022-12-03T23:07:43,Vitoria-Gasteiz,Expense,appliances,-208.08,-18392.85
buyer_6,Manuel,45,ES45209554403228000157,TRX_N-00387-74836819,2022-12-04T10:41:57,Vitoria-Gasteiz,expenses,mortgage,-842.56,-19235.41
buyer_6,Manuel,45,ES45209554403228000157,TRX_N-00388-69489773,2022-12-04T15:33:00,Vitoria-Gasteiz,Expense,clothing,-55.36,-19290.77
buyer_6,Manuel,45,ES45209554403228000157,TRX_N-00389-79366085,2022-12-05T18:00:49,Vitoria-Gasteiz,expenses,electricity,-24.35,-19315.12
buyer_6,Manuel,45,ES45209554403228000157,TRX_N-00390-55930162,2022-12-05T18:39:35,Vitoria-Gasteiz,Expense,transport,-57.95,-19373.07
buyer_6,Manuel,45,ES45209554403228000157,TRX_N-00391-69736019,2022-12-05T11:09:24,Vitoria-Gasteiz,Expense,repairs,-236.17,-19609.24
buyer_6,Manuel,45,ES45209554403228000157,TRX_N-00392-47118473,2022-12-06T17:08:45,Vitoria-Gasteiz,Expense,food,-112.91,-19722.15
buyer_6,Manuel,45,ES45209554403228000157,TRX_N-00393-50733081,2022-12-07T20:43:55,Vitoria-Gasteiz,expenses,gas,-42.17,-19764.32
buyer_6,Manuel,45,ES45209554403228000157,TRX_N-00394-17987351,2022-12-07T15:36:53,Vitoria-Gasteiz,expenses,phone,-43.14,-19807.46
buyer_6,Manuel,45,ES45209554403228000157,TRX_N-00395-96769317,2022-12-08T15:58:59,Vitoria-Gasteiz,expenses,water,-27.71,-19835.17
buyer_6,Manuel,45,ES45209554403228000157,TRX_N-00396-05329578,2022-12-08T20:59:08,Vitoria-Gasteiz,expenses,internet,-42.0,-19877.17
buyer_6,Manuel,45,ES45209554403228000157,TRX_N-00397-54737248,2022-12-10T08:57:52,Vitoria-Gasteiz,Expense,leisure,-77.77,-19954.94
buyer_6,Manuel,45,ES45209554403228000157,TRX_N-00398-30487749,2022-12-10T10:01:22,Vitoria-Gasteiz,Expense,cash,-100.0,-20054.94
buyer_6,Manuel,45,ES45209554403228000157,TRX_N-00399-47116170,2022-12-11T12:33:03,Vitoria-Gasteiz,Expense,cash,-100.0,-20154.94
buyer_6,Manuel,45,ES45209554403228000157,TRX_N-00400-52430560,2022-12-12T09:26:07,Vitoria-Gasteiz,Expense,cash,-100.0,-20254.94
buyer_6,Manuel,45,ES45209554403228000157,TRX_N-00401-03594480,2022-12-15T17:13:30,Vitoria-Gasteiz,Expense,cash,-100.0,-20354.94
buyer_6,Manuel,45,ES45209554403228000157,TRX_N-00402-98018603,2022-12-16T23:33:42,Vitoria-Gasteiz,Expense,leisure,-60.31,-20415.25
buyer_6,Manuel,45,ES45209554403228000157,TRX_N-00403-64691851,2022-12-18T19:04:23,Vitoria-Gasteiz,Expense,transport,-70.69,-20485.94
buyer_6,Manuel,45,ES45209554403228000157,TRX_N-00404-09572919,2022-12-18T13:36:33,Vitoria-Gasteiz,Expense,leisure,-71.3,-20557.24
buyer_6,Manuel,45,ES45209554403228000157,TRX_N-00405-27425145,2022-12-18T14:54:40,Vitoria-Gasteiz,expenses,children,-125.6,-20682.84
buyer_6,Manuel,45,ES45209554403228000157,TRX_N-00406-24144201,2022-12-19T09:57:35,Oy√≥n-Oion,Expense,gifts,-661.48,-21344.32
buyer_6,Manuel,45,ES45209554403228000157,TRX_N-00407-03633090,2022-12-20T11:43:07,Vitoria-Gasteiz,Expense,gifts,-525.76,-21870.08
buyer_6,Manuel,45,ES45209554403228000157,TRX_N-00408-03311130,2022-12-20T18:59:38,Vitoria-Gasteiz,expenses,children,-148.54,-22018.62
buyer_6,Manuel,45,ES45209554403228000157,TRX_N-00409-89269336,2022-12-22T11:05:58,Vitoria-Gasteiz,Expense,food,-103.02,-22121.64
buyer_6,Manuel,45,ES45209554403228000157,TRX_N-00410-10273788,2022-12-23T17:44:39,Vitoria-Gasteiz,Expense,healthcare,-129.68,-22251.32
buyer_6,Manuel,45,ES45209554403228000157,TRX_N-00411-40407846,2022-12-24T16:04:01,Vitoria-Gasteiz,Expense,cash,-100.0,-22351.32
buyer_6,Manuel,45,ES45209554403228000157,TRX_N-00412-01519125,2022-12-26T06:44:11,Vitoria-Gasteiz,Expense,appliances,-185.62,-22536.94
buyer_6,Manuel,45,ES45209554403228000157,TRX_N-00413-40288221,2022-12-27T14:59:33,Vitoria-Gasteiz,Expense,cash,-100.0,-22636.94
buyer_6,Manuel,45,ES45209554403228000157,TRX_N-00414-49912066,2022-12-29T09:36:00,Vitoria-Gasteiz,Expense,food,-116.75,-22753.69
buyer_6,Manuel,45,ES45209554403228000157,TRX_N-00415-75403972,2022-12-29T14:05:12,Zuia,Expense,clothing,-100.16,-22853.85
buyer_6,Manuel,45,ES45209554403228000157,TRX_N-00416-92652749,2023-01-01T11:07:21,Vitoria-Gasteiz,incomes,salary,1546.23,-21307.62
buyer_6,Manuel,45,ES45209554403228000157,TRX_N-00417-16897276,2023-01-01T11:07:21,Vitoria-Gasteiz,incomes,salary_partner,1057.05,-20250.57
buyer_6,Manuel,45,ES45209554403228000157,TRX_N-00418-04557460,2023-01-02T11:51:41,Vitoria-Gasteiz,Expense,repairs,-263.97,-20514.54
buyer_6,Manuel,45,ES45209554403228000157,TRX_N-00419-26329629,2023-01-04T21:14:28,Vitoria-Gasteiz,expenses,mortgage,-842.56,-21357.1
buyer_6,Manuel,45,ES45209554403228000157,TRX_N-00420-69453569,2023-01-04T14:55:54,Vitoria-Gasteiz,Expense,cash,-100.0,-21457.1
buyer_6,Manuel,45,ES45209554403228000157,TRX_N-00421-31961858,2023-01-05T16:44:18,Vitoria-Gasteiz,expenses,water,-30.47,-21487.57
buyer_6,Manuel,45,ES45209554403228000157,TRX_N-00422-99745652,2023-01-05T13:22:23,Vitoria-Gasteiz,expenses,gas,-43.79,-21531.36
buyer_6,Manuel,45,ES45209554403228000157,TRX_N-00423-07820611,2023-01-05T13:34:04,Vitoria-Gasteiz,Expense,cash,-100.0,-21631.36
buyer_6,Manuel,45,ES45209554403228000157,TRX_N-00424-04592265,2023-01-06T09:10:58,Vitoria-Gasteiz,Expense,cash,-100.0,-21731.36
buyer_6,Manuel,45,ES45209554403228000157,TRX_N-00425-57383131,2023-01-08T12:40:55,Vitoria-Gasteiz,expenses,electricity,-32.64,-21764.0
buyer_6,Manuel,45,ES45209554403228000157,TRX_N-00426-60303441,2023-01-08T14:35:54,Vitoria-Gasteiz,expenses,internet,-42.0,-21806.0
buyer_6,Manuel,45,ES45209554403228000157,TRX_N-00427-85632173,2023-01-08T14:32:49,Vitoria-Gasteiz,expenses,phone,-35.25,-21841.25
buyer_6,Manuel,45,ES45209554403228000157,TRX_N-00428-05893749,2023-01-08T21:26:58,Vitoria-Gasteiz,Expense,leisure,-59.68,-21900.93
buyer_6,Manuel,45,ES45209554403228000157,TRX_N-00429-04924904,2023-01-08T12:58:20,Vitoria-Gasteiz,expenses,children,-192.76,-22093.69
buyer_6,Manuel,45,ES45209554403228000157,TRX_N-00430-65442348,2023-01-10T15:33:32,Vitoria-Gasteiz,Expense,clothing,-145.89,-22239.58
buyer_6,Manuel,45,ES45209554403228000157,TRX_N-00431-17793996,2023-01-12T09:06:25,Vitoria-Gasteiz,Expense,cash,-100.0,-22339.58
buyer_6,Manuel,45,ES45209554403228000157,TRX_N-00432-48877152,2023-01-13T08:39:58,Vitoria-Gasteiz,Expense,transport,-70.54,-22410.12
buyer_6,Manuel,45,ES45209554403228000157,TRX_N-00433-35217500,2023-01-14T20:14:56,Vitoria-Gasteiz,Expense,clothing,-140.27,-22550.39
buyer_6,Manuel,45,ES45209554403228000157,TRX_N-00434-74360180,2023-01-14T19:25:31,Vitoria-Gasteiz,Expense,gifts,-588.61,-23139.0
buyer_6,Manuel,45,ES45209554403228000157,TRX_N-00435-08352929,2023-01-15T12:08:29,Vitoria-Gasteiz,Expense,transport,-53.55,-23192.55
buyer_6,Manuel,45,ES45209554403228000157,TRX_N-00436-15132282,2023-01-15T09:19:00,Amurrio,Expense,leisure,-41.35,-23233.9
buyer_6,Manuel,45,ES45209554403228000157,TRX_N-00437-45236835,2023-01-17T11:55:32,Vitoria-Gasteiz,Expense,food,-91.77,-23325.67
buyer_6,Manuel,45,ES45209554403228000157,TRX_N-00438-68532622,2023-01-17T19:47:57,Vitoria-Gasteiz,Expense,cash,-100.0,-23425.67
buyer_6,Manuel,45,ES45209554403228000157,TRX_N-00439-80946571,2023-01-18T14:59:27,Vitoria-Gasteiz,Expense,food,-61.33,-23487.0
buyer_6,Manuel,45,ES45209554403228000157,TRX_N-00440-82164289,2023-01-18T22:58:57,Vitoria-Gasteiz,Expense,repairs,-115.34,-23602.34
buyer_6,Manuel,45,ES45209554403228000157,TRX_N-00441-48154465,2023-01-19T13:38:04,Vitoria-Gasteiz,Expense,cash,-100.0,-23702.34
buyer_6,Manuel,45,ES45209554403228000157,TRX_N-00442-48215763,2023-01-19T03:15:09,Vitoria-Gasteiz,Expense,repairs,-317.77,-24020.11
buyer_6,Manuel,45,ES45209554403228000157,TRX_N-00443-09034969,2023-01-20T13:22:27,Vitoria-Gasteiz,Expense,travel,-1262.14,-25282.25
buyer_6,Manuel,45,ES45209554403228000157,TRX_N-00444-78287510,2023-01-21T08:30:21,Vitoria-Gasteiz,Expense,leisure,-46.08,-25328.33
buyer_6,Manuel,45,ES45209554403228000157,TRX_N-00445-52788754,2023-01-23T18:25:56,Errenteria,Expense,transport,-86.21,-25414.54
buyer_6,Manuel,45,ES45209554403228000157,TRX_N-00446-74211036,2023-01-23T21:50:40,Vitoria-Gasteiz,Expense,cash,-100.0,-25514.54
buyer_6,Manuel,45,ES45209554403228000157,TRX_N-00447-38713701,2023-01-24T12:56:46,Vitoria-Gasteiz,Expense,food,-78.7,-25593.24
buyer_6,Manuel,45,ES45209554403228000157,TRX_N-00448-09642093,2023-01-24T10:36:04,Vitoria-Gasteiz,Expense,leisure,-32.6,-25625.84
buyer_6,Manuel,45,ES45209554403228000157,TRX_N-00449-53996555,2023-01-24T13:29:55,Vitoria-Gasteiz,Expense,healthcare,-167.47,-25793.31
buyer_6,Manuel,45,ES45209554403228000157,TRX_N-00450-10193971,2023-01-24T11:59:36,Vitoria-Gasteiz,Expense,gifts,-592.88,-26386.19
buyer_6,Manuel,45,ES45209554403228000157,TRX_N-00451-67058044,2023-01-25T11:39:35,Hondarribia,Expense,appliances,-80.12,-26466.31
buyer_6,Manuel,45,ES45209554403228000157,TRX_N-00452-39814900,2023-01-26T17:33:12,Vitoria-Gasteiz,Expense,cash,-100.0,-26566.31
buyer_6,Manuel,45,ES45209554403228000157,TRX_N-00453-52022307,2023-02-01T11:01:23,Vitoria-Gasteiz,incomes,salary,1546.23,-25020.08
buyer_6,Manuel,45,ES45209554403228000157,TRX_N-00454-74430721,2023-02-01T11:01:23,Vitoria-Gasteiz,incomes,salary_partner,1057.05,-23963.03
buyer_6,Manuel,45,ES45209554403228000157,TRX_N-00455-83138316,2023-02-01T11:01:23,Vitoria-Gasteiz,incomes,extra_income,251.7,-23711.33
buyer_6,Manuel,45,ES45209554403228000157,TRX_N-00456-94265347,2023-02-01T04:48:50,Irun,Expense,cash,-100.0,-23811.33
buyer_6,Manuel,45,ES45209554403228000157,TRX_N-00457-34483267,2023-02-03T12:09:15,Vitoria-Gasteiz,Expense,transport,-65.4,-23876.73
buyer_6,Manuel,45,ES45209554403228000157,TRX_N-00458-03220814,2023-02-03T08:05:52,Zarautz,Expense,clothing,-133.06,-24009.79
buyer_6,Manuel,45,ES45209554403228000157,TRX_N-00459-01977880,2023-02-04T00:38:45,Vitoria-Gasteiz,expenses,mortgage,-842.56,-24852.35
buyer_6,Manuel,45,ES45209554403228000157,TRX_N-00460-50996930,2023-02-04T16:29:55,Vitoria-Gasteiz,Expense,leisure,-43.82,-24896.17
buyer_6,Manuel,45,ES45209554403228000157,TRX_N-00461-24644461,2023-02-05T13:01:58,Vitoria-Gasteiz,expenses,water,-24.63,-24920.8
buyer_6,Manuel,45,ES45209554403228000157,TRX_N-00462-21921188,2023-02-05T18:05:43,Vitoria-Gasteiz,expenses,internet,-42.0,-24962.8
buyer_6,Manuel,45,ES45209554403228000157,TRX_N-00463-50133735,2023-02-05T08:43:23,Vitoria-Gasteiz,expenses,phone,-36.95,-24999.75
buyer_6,Manuel,45,ES45209554403228000157,TRX_N-00464-93546264,2023-02-05T17:37:42,Vitoria-Gasteiz,Expense,food,-123.34,-25123.09
buyer_6,Manuel,45,ES45209554403228000157,TRX_N-00465-56653466,2023-02-06T22:12:10,Vitoria-Gasteiz,expenses,gas,-79.97,-25203.06
buyer_6,Manuel,45,ES45209554403228000157,TRX_N-00466-46255466,2023-02-06T18:57:59,Vitoria-Gasteiz,Expense,food,-69.5,-25272.56
buyer_6,Manuel,45,ES45209554403228000157,TRX_N-00467-06485988,2023-02-06T19:10:47,Vitoria-Gasteiz,Expense,cash,-100.0,-25372.56
buyer_6,Manuel,45,ES45209554403228000157,TRX_N-00468-22771914,2023-02-07T20:35:05,Vitoria-Gasteiz,Expense,repairs,-185.97,-25558.53
buyer_6,Manuel,45,ES45209554403228000157,TRX_N-00469-54748782,2023-02-08T22:00:42,Vitoria-Gasteiz,expenses,electricity,-33.74,-25592.27
buyer_6,Manuel,45,ES45209554403228000157,TRX_N-00470-85087627,2023-02-08T21:09:49,Zarautz,Expense,education,-43.73,-25636.0
buyer_6,Manuel,45,ES45209554403228000157,TRX_N-00471-43962133,2023-02-09T18:16:37,Vitoria-Gasteiz,Expense,gifts,-369.44,-26005.44
buyer_6,Manuel,45,ES45209554403228000157,TRX_N-00472-14791940,2023-02-13T12:50:36,Zuia,Expense,clothing,-96.16,-26101.6
buyer_6,Manuel,45,ES45209554403228000157,TRX_N-00473-64101131,2023-02-13T17:04:52,Vitoria-Gasteiz,Expense,gifts,-72.58,-26174.18
buyer_6,Manuel,45,ES45209554403228000157,TRX_N-00474-60635125,2023-02-14T04:42:56,Bermeo,Expense,cash,-100.0,-26274.18
buyer_6,Manuel,45,ES45209554403228000157,TRX_N-00475-92549217,2023-02-15T16:41:56,Vitoria-Gasteiz,Expense,repairs,-64.89,-26339.07
buyer_6,Manuel,45,ES45209554403228000157,TRX_N-00476-41814434,2023-02-16T04:43:03,Vitoria-Gasteiz,Expense,food,-107.31,-26446.38
buyer_6,Manuel,45,ES45209554403228000157,TRX_N-00477-10037726,2023-02-16T13:36:00,Vitoria-Gasteiz,Expense,repairs,-291.41,-26737.79
buyer_6,Manuel,45,ES45209554403228000157,TRX_N-00478-22562649,2023-02-16T11:58:38,Vitoria-Gasteiz,Expense,gifts,-448.16,-27185.95
buyer_6,Manuel,45,ES45209554403228000157,TRX_N-00479-98669343,2023-02-18T03:28:45,Vitoria-Gasteiz,Expense,repairs,-162.69,-27348.64
buyer_6,Manuel,45,ES45209554403228000157,TRX_N-00480-40339258,2023-02-18T14:23:07,Vitoria-Gasteiz,expenses,children,-199.46,-27548.1
buyer_6,Manuel,45,ES45209554403228000157,TRX_N-00481-77863009,2023-02-19T10:43:39,Vitoria-Gasteiz,Expense,food,-100.41,-27648.51
buyer_6,Manuel,45,ES45209554403228000157,TRX_N-00482-73644714,2023-02-20T11:39:13,Vitoria-Gasteiz,Expense,cash,-100.0,-27748.51
buyer_6,Manuel,45,ES45209554403228000157,TRX_N-00483-75049431,2023-02-22T08:23:51,Vitoria-Gasteiz,Expense,leisure,-37.14,-27785.65
buyer_6,Manuel,45,ES45209554403228000157,TRX_N-00484-71368455,2023-02-23T01:47:27,Vitoria-Gasteiz,expenses,children,-94.63,-27880.28
buyer_6,Manuel,45,ES45209554403228000157,TRX_N-00485-00192724,2023-02-24T08:22:19,Andoain,Expense,transport,-61.64,-27941.92
buyer_6,Manuel,45,ES45209554403228000157,TRX_N-00486-35652502,2023-02-25T11:31:01,Vitoria-Gasteiz,Expense,clothing,-142.65,-28084.57
buyer_6,Manuel,45,ES45209554403228000157,TRX_N-00487-71484939,2023-03-01T15:39:34,Vitoria-Gasteiz,incomes,salary,1546.23,-26538.34
buyer_6,Manuel,45,ES45209554403228000157,TRX_N-00488-52761013,2023-03-01T15:39:34,Vitoria-Gasteiz,incomes,salary_partner,1057.05,-25481.29
buyer_6,Manuel,45,ES45209554403228000157,TRX_N-00489-78467809,2023-03-03T14:04:48,Vitoria-Gasteiz,Expense,leisure,-38.63,-25519.92
buyer_6,Manuel,45,ES45209554403228000157,TRX_N-00490-71858616,2023-03-03T22:02:45,Vitoria-Gasteiz,Expense,travel,-1138.69,-26658.61
buyer_6,Manuel,45,ES45209554403228000157,TRX_N-00491-16588571,2023-03-04T20:33:53,Vitoria-Gasteiz,expenses,mortgage,-842.56,-27501.17
buyer_6,Manuel,45,ES45209554403228000157,TRX_N-00492-69411432,2023-03-04T20:53:48,Vitoria-Gasteiz,Expense,food,-60.89,-27562.06
buyer_6,Manuel,45,ES45209554403228000157,TRX_N-00493-88730436,2023-03-05T23:38:30,Vitoria-Gasteiz,expenses,water,-44.99,-27607.05
buyer_6,Manuel,45,ES45209554403228000157,TRX_N-00494-33865760,2023-03-05T11:47:56,Vitoria-Gasteiz,Expense,leisure,-45.63,-27652.68
buyer_6,Manuel,45,ES45209554403228000157,TRX_N-00495-88648563,2023-03-06T20:06:54,Vitoria-Gasteiz,expenses,phone,-40.35,-27693.03
buyer_6,Manuel,45,ES45209554403228000157,TRX_N-00496-66629285,2023-03-06T16:30:20,Vitoria-Gasteiz,Expense,transport,-45.12,-27738.15
buyer_6,Manuel,45,ES45209554403228000157,TRX_N-00497-17007073,2023-03-06T02:27:18,Galdakao,Expense,education,-70.16,-27808.31
buyer_6,Manuel,45,ES45209554403228000157,TRX_N-00498-20737207,2023-03-06T12:08:08,Vitoria-Gasteiz,Expense,cash,-100.0,-27908.31
buyer_6,Manuel,45,ES45209554403228000157,TRX_N-00499-99970738,2023-03-08T21:22:57,Vitoria-Gasteiz,expenses,electricity,-28.32,-27936.63
buyer_6,Manuel,45,ES45209554403228000157,TRX_N-00500-13957455,2023-03-08T15:12:02,Vitoria-Gasteiz,expenses,gas,-100.58,-28037.21
buyer_6,Manuel,45,ES45209554403228000157,TRX_N-00501-41410345,2023-03-08T02:20:34,Vitoria-Gasteiz,expenses,internet,-42.0,-28079.21
buyer_6,Manuel,45,ES45209554403228000157,TRX_N-00502-37293333,2023-03-08T15:49:39,Vitoria-Gasteiz,Expense,cash,-100.0,-28179.21
buyer_6,Manuel,45,ES45209554403228000157,TRX_N-00503-54385036,2023-03-09T21:44:42,Vitoria-Gasteiz,Expense,leisure,-62.58,-28241.79
buyer_6,Manuel,45,ES45209554403228000157,TRX_N-00504-52992350,2023-03-09T16:59:15,Vitoria-Gasteiz,expenses,children,-208.19,-28449.98
buyer_6,Manuel,45,ES45209554403228000157,TRX_N-00505-23761608,2023-03-12T23:03:07,Iru√±a de Oca,Expense,leisure,-49.25,-28499.23
buyer_6,Manuel,45,ES45209554403228000157,TRX_N-00506-02977718,2023-03-15T20:31:33,Vitoria-Gasteiz,Expense,transport,-82.94,-28582.17
buyer_6,Manuel,45,ES45209554403228000157,TRX_N-00507-34104753,2023-03-18T15:53:50,Vitoria-Gasteiz,Expense,cash,-100.0,-28682.17
buyer_6,Manuel,45,ES45209554403228000157,TRX_N-00508-66457469,2023-03-19T03:59:33,Vitoria-Gasteiz,Expense,leisure,-32.39,-28714.56
buyer_6,Manuel,45,ES45209554403228000157,TRX_N-00509-06733451,2023-03-19T12:19:07,Vitoria-Gasteiz,Expense,cash,-100.0,-28814.56
buyer_6,Manuel,45,ES45209554403228000157,TRX_N-00510-37906919,2023-03-19T14:30:23,Vitoria-Gasteiz,Expense,repairs,-130.24,-28944.8
buyer_6,Manuel,45,ES45209554403228000157,TRX_N-00511-43441308,2023-03-20T20:15:09,Vitoria-Gasteiz,expenses,children,-277.37,-29222.17
buyer_6,Manuel,45,ES45209554403228000157,TRX_N-00512-22686346,2023-03-22T02:34:25,Vitoria-Gasteiz,Expense,cash,-100.0,-29322.17
buyer_6,Manuel,45,ES45209554403228000157,TRX_N-00513-18925256,2023-03-22T12:03:18,Santurtzi,Expense,repairs,-199.34,-29521.51
buyer_6,Manuel,45,ES45209554403228000157,TRX_N-00514-51439777,2023-03-27T20:18:35,Vitoria-Gasteiz,Expense,gifts,-27.33,-29548.84
buyer_6,Manuel,45,ES45209554403228000157,TRX_N-00515-82189491,2023-03-29T17:37:55,Amurrio,Expense,repairs,-261.4,-29810.24
buyer_6,Manuel,45,ES45209554403228000157,TRX_N-00516-32924816,2023-03-31T22:31:37,Vitoria-Gasteiz,Expense,food,-96.05,-29906.29
buyer_6,Manuel,45,ES45209554403228000157,TRX_N-00517-74932405,2023-03-31T20:01:49,Vitoria-Gasteiz,Expense,cash,-100.0,-30006.29
buyer_6,Manuel,45,ES45209554403228000157,TRX_N-00518-88223900,2023-04-01T16:53:37,Vitoria-Gasteiz,incomes,salary,1546.23,-28460.06
buyer_6,Manuel,45,ES45209554403228000157,TRX_N-00519-62848894,2023-04-01T16:53:37,Vitoria-Gasteiz,incomes,salary_partner,1057.05,-27403.01
buyer_6,Manuel,45,ES45209554403228000157,TRX_N-00520-99919420,2023-04-01T12:53:33,Vitoria-Gasteiz,Expense,clothing,-96.7,-27499.71
buyer_6,Manuel,45,ES45209554403228000157,TRX_N-00521-04025244,2023-04-01T19:01:28,Vitoria-Gasteiz,Expense,education,-59.9,-27559.61
buyer_6,Manuel,45,ES45209554403228000157,TRX_N-00522-66796961,2023-04-04T14:10:28,Vitoria-Gasteiz,expenses,mortgage,-842.56,-28402.17
buyer_6,Manuel,45,ES45209554403228000157,TRX_N-00523-03845006,2023-04-04T11:13:39,Vitoria-Gasteiz,Expense,food,-94.58,-28496.75
buyer_6,Manuel,45,ES45209554403228000157,TRX_N-00524-18900472,2023-04-05T18:09:42,Vitoria-Gasteiz,expenses,electricity,-66.66,-28563.41
buyer_6,Manuel,45,ES45209554403228000157,TRX_N-00525-09277999,2023-04-05T06:58:49,Vitoria-Gasteiz,expenses,internet,-42.0,-28605.41
buyer_6,Manuel,45,ES45209554403228000157,TRX_N-00526-99993223,2023-04-05T11:33:24,Vitoria-Gasteiz,Expense,food,-123.0,-28728.41
buyer_6,Manuel,45,ES45209554403228000157,TRX_N-00527-02346824,2023-04-05T17:11:51,Vitoria-Gasteiz,Expense,gifts,-176.6,-28905.01
buyer_6,Manuel,45,ES45209554403228000157,TRX_N-00528-86351675,2023-04-06T16:04:10,Vitoria-Gasteiz,expenses,water,-29.77,-28934.78
buyer_6,Manuel,45,ES45209554403228000157,TRX_N-00529-52546092,2023-04-06T13:40:17,Vitoria-Gasteiz,Expense,clothing,-126.48,-29061.26
buyer_6,Manuel,45,ES45209554403228000157,TRX_N-00530-53809340,2023-04-06T20:43:08,Vitoria-Gasteiz,Expense,cash,-100.0,-29161.26
buyer_6,Manuel,45,ES45209554403228000157,TRX_N-00531-17946524,2023-04-06T08:29:32,Vitoria-Gasteiz,Expense,gifts,-843.94,-30005.2
buyer_6,Manuel,45,ES45209554403228000157,TRX_N-00532-50023275,2023-04-08T18:56:40,Vitoria-Gasteiz,expenses,gas,-84.01,-30089.21
buyer_6,Manuel,45,ES45209554403228000157,TRX_N-00533-84533241,2023-04-08T16:09:33,Vitoria-Gasteiz,expenses,phone,-41.2,-30130.41
buyer_6,Manuel,45,ES45209554403228000157,TRX_N-00534-35568360,2023-04-08T18:46:36,Getxo,Expense,transport,-84.49,-30214.9
buyer_6,Manuel,45,ES45209554403228000157,TRX_N-00535-31705900,2023-04-09T12:58:25,Vitoria-Gasteiz,Expense,clothing,-141.7,-30356.6
buyer_6,Manuel,45,ES45209554403228000157,TRX_N-00536-22830782,2023-04-10T08:02:40,Vitoria-Gasteiz,Expense,clothing,-130.55,-30487.15
buyer_6,Manuel,45,ES45209554403228000157,TRX_N-00537-15250539,2023-04-10T12:03:32,Vitoria-Gasteiz,Expense,cash,-100.0,-30587.15
buyer_6,Manuel,45,ES45209554403228000157,TRX_N-00538-30591744,2023-04-12T15:13:49,Vitoria-Gasteiz,Expense,healthcare,-117.95,-30705.1
buyer_6,Manuel,45,ES45209554403228000157,TRX_N-00539-57582397,2023-04-13T10:00:34,Vitoria-Gasteiz,Expense,cash,-100.0,-30805.1
buyer_6,Manuel,45,ES45209554403228000157,TRX_N-00540-51898436,2023-04-15T12:55:56,Vitoria-Gasteiz,Expense,transport,-64.64,-30869.74
buyer_6,Manuel,45,ES45209554403228000157,TRX_N-00541-94278175,2023-04-16T18:06:24,Vitoria-Gasteiz,Expense,transport,-43.54,-30913.28
buyer_6,Manuel,45,ES45209554403228000157,TRX_N-00542-09516432,2023-04-17T13:12:24,Vitoria-Gasteiz,Expense,leisure,-51.91,-30965.19
buyer_6,Manuel,45,ES45209554403228000157,TRX_N-00543-67613910,2023-04-18T18:44:11,Vitoria-Gasteiz,Expense,cash,-100.0,-31065.19
buyer_6,Manuel,45,ES45209554403228000157,TRX_N-00544-20970976,2023-04-19T14:03:23,Vitoria-Gasteiz,Expense,clothing,-76.62,-31141.81
buyer_6,Manuel,45,ES45209554403228000157,TRX_N-00545-85638435,2023-04-20T09:20:29,Vitoria-Gasteiz,Expense,leisure,-23.11,-31164.92
buyer_6,Manuel,45,ES45209554403228000157,TRX_N-00546-56371634,2023-04-21T02:00:04,Vitoria-Gasteiz,Expense,cash,-100.0,-31264.92
buyer_6,Manuel,45,ES45209554403228000157,TRX_N-00547-29140338,2023-04-21T16:37:23,Vitoria-Gasteiz,Expense,gifts,-98.87,-31363.79
buyer_6,Manuel,45,ES45209554403228000157,TRX_N-00548-00452325,2023-04-23T18:40:50,Vitoria-Gasteiz,Expense,cash,-100.0,-31463.79
buyer_6,Manuel,45,ES45209554403228000157,TRX_N-00549-89454888,2023-04-24T19:34:43,Vitoria-Gasteiz,Expense,food,-78.41,-31542.2
buyer_6,Manuel,45,ES45209554403228000157,TRX_N-00550-28512057,2023-04-26T16:56:26,Elciego,Expense,leisure,-58.39,-31600.59
buyer_6,Manuel,45,ES45209554403228000157,TRX_N-00551-41526244,2023-04-26T12:15:55,Vitoria-Gasteiz,Expense,repairs,-286.42,-31887.01
buyer_6,Manuel,45,ES45209554403228000157,TRX_N-00552-06020491,2023-04-26T15:10:25,Vitoria-Gasteiz,expenses,children,-273.76,-32160.77
buyer_6,Manuel,45,ES45209554403228000157,TRX_N-00553-94141200,2023-05-01T15:37:52,Vitoria-Gasteiz,incomes,salary,1546.23,-30614.54
buyer_6,Manuel,45,ES45209554403228000157,TRX_N-00554-90414992,2023-05-01T15:37:52,Vitoria-Gasteiz,incomes,salary_partner,1057.05,-29557.49
buyer_6,Manuel,45,ES45209554403228000157,TRX_N-00555-67875571,2023-05-02T23:44:29,Vitoria-Gasteiz,expenses,children,-102.31,-29659.8
buyer_6,Manuel,45,ES45209554403228000157,TRX_N-00556-83164536,2023-05-04T01:44:33,Vitoria-Gasteiz,expenses,mortgage,-842.56,-30502.36
buyer_6,Manuel,45,ES45209554403228000157,TRX_N-00557-03895849,2023-05-04T13:58:20,Vitoria-Gasteiz,Expense,cash,-100.0,-30602.36
buyer_6,Manuel,45,ES45209554403228000157,TRX_N-00558-00773160,2023-05-05T12:49:39,Vitoria-Gasteiz,expenses,gas,-99.02,-30701.38
buyer_6,Manuel,45,ES45209554403228000157,TRX_N-00559-43543884,2023-05-05T04:10:38,Mungia,Expense,food,-81.86,-30783.24
buyer_6,Manuel,45,ES45209554403228000157,TRX_N-00560-87167329,2023-05-05T08:37:38,Vitoria-Gasteiz,Expense,repairs,-174.45,-30957.69
buyer_6,Manuel,45,ES45209554403228000157,TRX_N-00561-43628628,2023-05-06T19:25:33,Vitoria-Gasteiz,expenses,internet,-42.0,-30999.69
buyer_6,Manuel,45,ES45209554403228000157,TRX_N-00562-37254686,2023-05-06T10:29:26,Iru√±a de Oca,Expense,clothing,-147.67,-31147.36
buyer_6,Manuel,45,ES45209554403228000157,TRX_N-00563-09321056,2023-05-06T20:10:27,Vitoria-Gasteiz,Expense,appliances,-220.28,-31367.64
buyer_6,Manuel,45,ES45209554403228000157,TRX_N-00564-34988204,2023-05-07T16:45:40,Vitoria-Gasteiz,expenses,electricity,-82.61,-31450.25
buyer_6,Manuel,45,ES45209554403228000157,TRX_N-00565-78577761,2023-05-07T22:31:02,Vitoria-Gasteiz,expenses,phone,-39.73,-31489.98
buyer_6,Manuel,45,ES45209554403228000157,TRX_N-00566-08976940,2023-05-08T12:46:01,Vitoria-Gasteiz,expenses,water,-39.62,-31529.6
buyer_6,Manuel,45,ES45209554403228000157,TRX_N-00567-99209598,2023-05-08T23:08:10,Vitoria-Gasteiz,Expense,food,-113.92,-31643.52
buyer_6,Manuel,45,ES45209554403228000157,TRX_N-00568-78515695,2023-05-09T08:20:29,Vitoria-Gasteiz,Expense,gifts,-549.37,-32192.89
buyer_6,Manuel,45,ES45209554403228000157,TRX_N-00569-35544262,2023-05-11T16:35:42,Vitoria-Gasteiz,Expense,food,-65.71,-32258.6
buyer_6,Manuel,45,ES45209554403228000157,TRX_N-00570-57471067,2023-05-11T16:53:57,Vitoria-Gasteiz,Expense,transport,-73.94,-32332.54
buyer_6,Manuel,45,ES45209554403228000157,TRX_N-00571-61190456,2023-05-11T09:47:17,Vitoria-Gasteiz,Expense,cash,-100.0,-32432.54
buyer_6,Manuel,45,ES45209554403228000157,TRX_N-00572-90383116,2023-05-11T11:29:00,Vitoria-Gasteiz,Expense,repairs,-322.73,-32755.27
buyer_6,Manuel,45,ES45209554403228000157,TRX_N-00573-10349812,2023-05-11T09:04:51,Vitoria-Gasteiz,Expense,gifts,-261.76,-33017.03
buyer_6,Manuel,45,ES45209554403228000157,TRX_N-00574-77502160,2023-05-12T13:57:25,Vitoria-Gasteiz,Expense,transport,-49.85,-33066.88
buyer_6,Manuel,45,ES45209554403228000157,TRX_N-00575-06769707,2023-05-17T14:58:01,Vitoria-Gasteiz,Expense,clothing,-102.99,-33169.87
buyer_6,Manuel,45,ES45209554403228000157,TRX_N-00576-10311255,2023-05-17T04:17:05,Vitoria-Gasteiz,Expense,education,-66.7,-33236.57
buyer_6,Manuel,45,ES45209554403228000157,TRX_N-00577-87802493,2023-05-17T08:25:33,Vitoria-Gasteiz,Expense,cash,-100.0,-33336.57
buyer_6,Manuel,45,ES45209554403228000157,TRX_N-00578-54370352,2023-05-18T17:54:51,Vitoria-Gasteiz,Expense,clothing,-133.79,-33470.36
buyer_6,Manuel,45,ES45209554403228000157,TRX_N-00579-38818727,2023-05-20T18:51:23,Vitoria-Gasteiz,Expense,cash,-100.0,-33570.36
buyer_6,Manuel,45,ES45209554403228000157,TRX_N-00580-15479406,2023-05-22T21:14:52,Zuia,Expense,leisure,-64.24,-33634.6
buyer_6,Manuel,45,ES45209554403228000157,TRX_N-00581-31273731,2023-05-22T15:35:24,Vitoria-Gasteiz,Expense,repairs,-159.96,-33794.56
buyer_6,Manuel,45,ES45209554403228000157,TRX_N-00582-18203524,2023-05-24T21:13:24,Vitoria-Gasteiz,Expense,food,-107.23,-33901.79
buyer_6,Manuel,45,ES45209554403228000157,TRX_N-00583-43471589,2023-05-25T02:10:24,Galdakao,Expense,transport,-77.4,-33979.19
buyer_6,Manuel,45,ES45209554403228000157,TRX_N-00584-41553181,2023-05-25T11:55:08,Vitoria-Gasteiz,Expense,gifts,-322.79,-34301.98
buyer_6,Manuel,45,ES45209554403228000157,TRX_N-00585-34978263,2023-05-30T14:25:53,Vitoria-Gasteiz,Expense,leisure,-56.84,-34358.82
buyer_6,Manuel,45,ES45209554403228000157,TRX_N-00586-95981877,2023-06-01T11:32:52,Vitoria-Gasteiz,incomes,salary,1546.23,-32812.59
buyer_6,Manuel,45,ES45209554403228000157,TRX_N-00587-57846550,2023-06-01T11:32:52,Vitoria-Gasteiz,incomes,salary_partner,1057.05,-31755.54
buyer_6,Manuel,45,ES45209554403228000157,TRX_N-00588-11157354,2023-06-01T11:32:52,Vitoria-Gasteiz,incomes,extra_income,251.7,-31503.84
buyer_6,Manuel,45,ES45209554403228000157,TRX_N-00589-79542418,2023-06-01T11:32:52,Vitoria-Gasteiz,incomes,salary_bonus,1230.17,-30273.67
buyer_6,Manuel,45,ES45209554403228000157,TRX_N-00590-62138204,2023-06-01T11:32:52,Vitoria-Gasteiz,incomes,salary_partner_bonus,844.64,-29429.03
buyer_6,Manuel,45,ES45209554403228000157,TRX_N-00591-11666889,2023-06-01T19:02:55,Vitoria-Gasteiz,Expense,clothing,-76.78,-29505.81
buyer_6,Manuel,45,ES45209554403228000157,TRX_N-00592-52566298,2023-06-01T08:11:20,Vitoria-Gasteiz,Expense,cash,-100.0,-29605.81
buyer_6,Manuel,45,ES45209554403228000157,TRX_N-00593-80107333,2023-06-04T09:00:37,Vitoria-Gasteiz,expenses,mortgage,-842.56,-30448.37
buyer_6,Manuel,45,ES45209554403228000157,TRX_N-00594-81941891,2023-06-04T19:51:29,Vitoria-Gasteiz,Expense,cash,-100.0,-30548.37
buyer_6,Manuel,45,ES45209554403228000157,TRX_N-00595-32330940,2023-06-05T14:23:53,Vitoria-Gasteiz,expenses,water,-34.85,-30583.22
buyer_6,Manuel,45,ES45209554403228000157,TRX_N-00596-13641171,2023-06-05T10:57:57,Bermeo,Expense,cash,-100.0,-30683.22
buyer_6,Manuel,45,ES45209554403228000157,TRX_N-00597-75348411,2023-06-06T14:19:38,Vitoria-Gasteiz,expenses,internet,-42.0,-30725.22
buyer_6,Manuel,45,ES45209554403228000157,TRX_N-00598-35952421,2023-06-06T19:44:03,Vitoria-Gasteiz,Expense,cash,-100.0,-30825.22
buyer_6,Manuel,45,ES45209554403228000157,TRX_N-00599-04636491,2023-06-07T20:35:56,Vitoria-Gasteiz,expenses,phone,-44.45,-30869.67
buyer_6,Manuel,45,ES45209554403228000157,TRX_N-00600-53249462,2023-06-08T17:06:53,Vitoria-Gasteiz,expenses,gas,-69.44,-30939.11
buyer_6,Manuel,45,ES45209554403228000157,TRX_N-00601-54256279,2023-06-08T09:30:35,Vitoria-Gasteiz,expenses,electricity,-25.19,-30964.3
buyer_6,Manuel,45,ES45209554403228000157,TRX_N-00602-85569323,2023-06-12T22:21:50,Vitoria-Gasteiz,Expense,clothing,-83.75,-31048.05
buyer_6,Manuel,45,ES45209554403228000157,TRX_N-00603-97447562,2023-06-15T12:44:56,Vitoria-Gasteiz,Expense,leisure,-78.26,-31126.31
buyer_6,Manuel,45,ES45209554403228000157,TRX_N-00604-48424704,2023-06-15T16:43:51,Vitoria-Gasteiz,Expense,education,-68.11,-31194.42
buyer_6,Manuel,45,ES45209554403228000157,TRX_N-00605-54078977,2023-06-16T12:10:58,Vitoria-Gasteiz,Expense,transport,-71.56,-31265.98
buyer_6,Manuel,45,ES45209554403228000157,TRX_N-00606-61057649,2023-06-16T18:23:51,Vitoria-Gasteiz,Expense,repairs,-259.92,-31525.9
buyer_6,Manuel,45,ES45209554403228000157,TRX_N-00607-87854744,2023-06-18T18:53:47,Vitoria-Gasteiz,Expense,clothing,-121.64,-31647.54
buyer_6,Manuel,45,ES45209554403228000157,TRX_N-00608-18397559,2023-06-18T16:08:27,Vitoria-Gasteiz,Expense,gifts,-77.57,-31725.11
buyer_6,Manuel,45,ES45209554403228000157,TRX_N-00609-47826328,2023-06-19T13:17:16,Vitoria-Gasteiz,expenses,children,-160.55,-31885.66
buyer_6,Manuel,45,ES45209554403228000157,TRX_N-00610-39135615,2023-06-20T16:19:21,Vitoria-Gasteiz,Expense,healthcare,-146.56,-32032.22
buyer_6,Manuel,45,ES45209554403228000157,TRX_N-00611-02641701,2023-06-20T04:57:45,Vitoria-Gasteiz,Expense,cash,-100.0,-32132.22
buyer_6,Manuel,45,ES45209554403228000157,TRX_N-00612-59556304,2023-06-24T20:07:32,Arrasate,Expense,food,-80.75,-32212.97
buyer_6,Manuel,45,ES45209554403228000157,TRX_N-00613-39135841,2023-06-24T12:00:23,Vitoria-Gasteiz,Expense,cash,-100.0,-32312.97
buyer_6,Manuel,45,ES45209554403228000157,TRX_N-00614-94677348,2023-06-25T13:20:10,Vitoria-Gasteiz,Expense,appliances,-213.93,-32526.9
buyer_6,Manuel,45,ES45209554403228000157,TRX_N-00615-82792097,2023-06-25T15:40:48,Vitoria-Gasteiz,Expense,repairs,-236.42,-32763.32
buyer_6,Manuel,45,ES45209554403228000157,TRX_N-00616-56312831,2023-06-26T14:10:03,Portugalete,Expense,food,-74.41,-32837.73
buyer_6,Manuel,45,ES45209554403228000157,TRX_N-00617-72254135,2023-06-26T17:40:31,Vitoria-Gasteiz,Expense,appliances,-156.91,-32994.64
buyer_6,Manuel,45,ES45209554403228000157,TRX_N-00618-49714370,2023-06-27T13:41:58,Vitoria-Gasteiz,Expense,leisure,-52.05,-33046.69
buyer_6,Manuel,45,ES45209554403228000157,TRX_N-00619-20509847,2023-06-27T17:20:52,Vitoria-Gasteiz,Expense,cash,-100.0,-33146.69
buyer_6,Manuel,45,ES45209554403228000157,TRX_N-00620-98822433,2023-06-28T11:56:44,Vitoria-Gasteiz,Expense,leisure,-41.28,-33187.97
buyer_6,Manuel,45,ES45209554403228000157,TRX_N-00621-33401948,2023-06-30T15:57:27,Sopela,Expense,cash,-100.0,-33287.97
buyer_6,Manuel,45,ES45209554403228000157,TRX_N-00622-71498978,2023-07-01T07:24:32,Vitoria-Gasteiz,incomes,salary,1546.23,-31741.74
buyer_6,Manuel,45,ES45209554403228000157,TRX_N-00623-28279279,2023-07-01T07:24:32,Vitoria-Gasteiz,incomes,salary_partner,1057.05,-30684.69
buyer_6,Manuel,45,ES45209554403228000157,TRX_N-00624-07467520,2023-07-02T10:15:10,Vitoria-Gasteiz,Expense,food,-73.38,-30758.07
buyer_6,Manuel,45,ES45209554403228000157,TRX_N-00625-49336651,2023-07-03T11:30:43,Vitoria-Gasteiz,Expense,cash,-100.0,-30858.07
buyer_6,Manuel,45,ES45209554403228000157,TRX_N-00626-19435371,2023-07-04T12:18:24,Vitoria-Gasteiz,expenses,mortgage,-842.56,-31700.63
buyer_6,Manuel,45,ES45209554403228000157,TRX_N-00627-45996171,2023-07-04T09:14:28,Andoain,Expense,food,-92.8,-31793.43
buyer_6,Manuel,45,ES45209554403228000157,TRX_N-00628-95128723,2023-07-05T10:59:06,Mungia,Expense,cash,-100.0,-31893.43
buyer_6,Manuel,45,ES45209554403228000157,TRX_N-00629-22330015,2023-07-06T20:49:16,Vitoria-Gasteiz,expenses,phone,-33.1,-31926.53
buyer_6,Manuel,45,ES45209554403228000157,TRX_N-00630-56800391,2023-07-06T22:14:38,Vitoria-Gasteiz,Expense,repairs,-321.91,-32248.44
buyer_6,Manuel,45,ES45209554403228000157,TRX_N-00631-16247927,2023-07-07T16:32:34,Vitoria-Gasteiz,Expense,transport,-47.11,-32295.55
buyer_6,Manuel,45,ES45209554403228000157,TRX_N-00632-51748471,2023-07-07T12:48:24,Vitoria-Gasteiz,Expense,leisure,-21.04,-32316.59
buyer_6,Manuel,45,ES45209554403228000157,TRX_N-00633-74142782,2023-07-08T13:27:33,Vitoria-Gasteiz,expenses,water,-34.9,-32351.49
buyer_6,Manuel,45,ES45209554403228000157,TRX_N-00634-22000972,2023-07-08T16:10:50,Vitoria-Gasteiz,expenses,internet,-42.0,-32393.49
buyer_6,Manuel,45,ES45209554403228000157,TRX_N-00635-14120131,2023-07-08T18:56:26,Vitoria-Gasteiz,expenses,electricity,-44.43,-32437.92
buyer_6,Manuel,45,ES45209554403228000157,TRX_N-00636-38428572,2023-07-08T13:48:51,Vitoria-Gasteiz,expenses,gas,-51.83,-32489.75
buyer_6,Manuel,45,ES45209554403228000157,TRX_N-00637-40114150,2023-07-12T16:06:00,Vitoria-Gasteiz,Expense,healthcare,-96.59,-32586.34
buyer_6,Manuel,45,ES45209554403228000157,TRX_N-00638-00824110,2023-07-12T17:37:56,Vitoria-Gasteiz,Expense,travel,-444.66,-33031.0
buyer_6,Manuel,45,ES45209554403228000157,TRX_N-00639-23232279,2023-07-13T16:05:18,Vitoria-Gasteiz,Expense,leisure,-63.17,-33094.17
buyer_6,Manuel,45,ES45209554403228000157,TRX_N-00640-96566537,2023-07-14T11:59:14,Zuia,Expense,food,-114.83,-33209.0
buyer_6,Manuel,45,ES45209554403228000157,TRX_N-00641-13618615,2023-07-16T17:48:33,Vitoria-Gasteiz,Expense,food,-98.39,-33307.39
buyer_6,Manuel,45,ES45209554403228000157,TRX_N-00642-03186568,2023-07-16T16:42:54,Vitoria-Gasteiz,Expense,healthcare,-182.56,-33489.95
buyer_6,Manuel,45,ES45209554403228000157,TRX_N-00643-57932209,2023-07-16T14:09:35,Vitoria-Gasteiz,Expense,cash,-100.0,-33589.95
buyer_6,Manuel,45,ES45209554403228000157,TRX_N-00644-65923854,2023-07-16T11:07:51,Vitoria-Gasteiz,expenses,children,-63.77,-33653.72
buyer_6,Manuel,45,ES45209554403228000157,TRX_N-00645-13389659,2023-07-18T08:51:48,Donostia,Expense,food,-64.46,-33718.18
buyer_6,Manuel,45,ES45209554403228000157,TRX_N-00646-00846704,2023-07-18T13:28:57,Vitoria-Gasteiz,Expense,education,-77.83,-33796.01
buyer_6,Manuel,45,ES45209554403228000157,TRX_N-00647-64711921,2023-07-19T12:29:01,Vitoria-Gasteiz,Expense,transport,-68.28,-33864.29
buyer_6,Manuel,45,ES45209554403228000157,TRX_N-00648-74709481,2023-07-20T13:51:40,Vitoria-Gasteiz,Expense,transport,-49.11,-33913.4
buyer_6,Manuel,45,ES45209554403228000157,TRX_N-00649-94885626,2023-07-22T20:21:59,Irun,Expense,cash,-100.0,-34013.4
buyer_6,Manuel,45,ES45209554403228000157,TRX_N-00650-18957554,2023-07-24T11:22:28,Vitoria-Gasteiz,Expense,cash,-100.0,-34113.4
buyer_6,Manuel,45,ES45209554403228000157,TRX_N-00651-23961773,2023-07-24T05:55:10,Bilbao,Expense,gifts,-480.69,-34594.09
buyer_6,Manuel,45,ES45209554403228000157,TRX_N-00652-90232178,2023-07-27T13:59:41,Vitoria-Gasteiz,Expense,cash,-100.0,-34694.09
buyer_6,Manuel,45,ES45209554403228000157,TRX_N-00653-45901628,2023-07-27T06:17:22,Vitoria-Gasteiz,Expense,travel,-536.45,-35230.54
buyer_6,Manuel,45,ES45209554403228000157,TRX_N-00654-07477346,2023-07-28T17:36:27,Zarautz,Expense,travel,-1820.73,-37051.27
buyer_6,Manuel,45,ES45209554403228000157,TRX_N-00655-73360379,2023-07-28T09:39:24,Alegr√≠a-Dulantzi,Expense,repairs,-40.56,-37091.83
buyer_6,Manuel,45,ES45209554403228000157,TRX_N-00656-54019756,2023-08-01T10:32:51,Vitoria-Gasteiz,incomes,salary,1546.23,-35545.6
buyer_6,Manuel,45,ES45209554403228000157,TRX_N-00657-42173859,2023-08-01T10:32:51,Vitoria-Gasteiz,incomes,salary_partner,1057.05,-34488.55
buyer_6,Manuel,45,ES45209554403228000157,TRX_N-00658-80318793,2023-08-01T11:08:40,Vitoria-Gasteiz,Expense,cash,-100.0,-34588.55
buyer_6,Manuel,45,ES45209554403228000157,TRX_N-00659-23962940,2023-08-02T14:56:42,Vitoria-Gasteiz,Expense,food,-121.29,-34709.84
buyer_6,Manuel,45,ES45209554403228000157,TRX_N-00660-25197251,2023-08-04T17:26:02,Vitoria-Gasteiz,expenses,mortgage,-842.56,-35552.4
buyer_6,Manuel,45,ES45209554403228000157,TRX_N-00661-47399107,2023-08-04T21:19:16,Oy√≥n-Oion,Expense,cash,-100.0,-35652.4
buyer_6,Manuel,45,ES45209554403228000157,TRX_N-00662-21340445,2023-08-04T08:34:08,Vitoria-Gasteiz,expenses,children,-251.25,-35903.65
buyer_6,Manuel,45,ES45209554403228000157,TRX_N-00663-18111421,2023-08-05T11:20:29,Vitoria-Gasteiz,Expense,transport,-78.88,-35982.53
buyer_6,Manuel,45,ES45209554403228000157,TRX_N-00664-35717286,2023-08-06T11:18:51,Vitoria-Gasteiz,expenses,internet,-42.0,-36024.53
buyer_6,Manuel,45,ES45209554403228000157,TRX_N-00665-76502513,2023-08-06T13:13:33,Vitoria-Gasteiz,Expense,clothing,-99.05,-36123.58
buyer_6,Manuel,45,ES45209554403228000157,TRX_N-00666-96455222,2023-08-07T08:22:43,Vitoria-Gasteiz,expenses,phone,-38.74,-36162.32
buyer_6,Manuel,45,ES45209554403228000157,TRX_N-00667-90970940,2023-08-07T19:26:18,Vitoria-Gasteiz,Expense,transport,-88.14,-36250.46
buyer_6,Manuel,45,ES45209554403228000157,TRX_N-00668-46821391,2023-08-07T16:36:33,Vitoria-Gasteiz,Expense,leisure,-31.43,-36281.89
buyer_6,Manuel,45,ES45209554403228000157,TRX_N-00669-19678763,2023-08-08T15:09:26,Vitoria-Gasteiz,expenses,electricity,-46.62,-36328.51
buyer_6,Manuel,45,ES45209554403228000157,TRX_N-00670-00403879,2023-08-08T19:35:49,Vitoria-Gasteiz,expenses,water,-27.89,-36356.4
buyer_6,Manuel,45,ES45209554403228000157,TRX_N-00671-33946330,2023-08-08T11:22:24,Vitoria-Gasteiz,expenses,gas,-79.8,-36436.2
buyer_6,Manuel,45,ES45209554403228000157,TRX_N-00672-46298870,2023-08-08T13:22:31,Vitoria-Gasteiz,Expense,transport,-84.55,-36520.75
buyer_6,Manuel,45,ES45209554403228000157,TRX_N-00673-38007785,2023-08-08T18:45:14,Vitoria-Gasteiz,Expense,education,-71.79,-36592.54
buyer_6,Manuel,45,ES45209554403228000157,TRX_N-00674-55184344,2023-08-09T22:55:55,Pasaia,Expense,leisure,-84.91,-36677.45
buyer_6,Manuel,45,ES45209554403228000157,TRX_N-00675-82697952,2023-08-10T09:12:36,Vitoria-Gasteiz,Expense,education,-44.61,-36722.06
buyer_6,Manuel,45,ES45209554403228000157,TRX_N-00676-17473395,2023-08-11T12:26:56,Hondarribia,Expense,leisure,-31.17,-36753.23
buyer_6,Manuel,45,ES45209554403228000157,TRX_N-00677-25759853,2023-08-14T13:53:48,Vitoria-Gasteiz,Expense,education,-46.64,-36799.87
buyer_6,Manuel,45,ES45209554403228000157,TRX_N-00678-90928402,2023-08-15T09:53:15,Vitoria-Gasteiz,Expense,repairs,-188.06,-36987.93
buyer_6,Manuel,45,ES45209554403228000157,TRX_N-00679-61149314,2023-08-16T20:48:53,Vitoria-Gasteiz,Expense,cash,-100.0,-37087.93
buyer_6,Manuel,45,ES45209554403228000157,TRX_N-00680-73397382,2023-08-17T13:01:38,Vitoria-Gasteiz,Expense,cash,-100.0,-37187.93
buyer_6,Manuel,45,ES45209554403228000157,TRX_N-00681-75655173,2023-08-17T08:50:12,Vitoria-Gasteiz,Expense,repairs,-85.55,-37273.48
buyer_6,Manuel,45,ES45209554403228000157,TRX_N-00682-51594702,2023-08-19T02:19:28,Vitoria-Gasteiz,Expense,gifts,-370.3,-37643.78
buyer_6,Manuel,45,ES45209554403228000157,TRX_N-00683-75745300,2023-08-22T09:25:26,Erandio,Expense,transport,-86.36,-37730.14
buyer_6,Manuel,45,ES45209554403228000157,TRX_N-00684-40250519,2023-08-22T12:27:13,Vitoria-Gasteiz,Expense,cash,-100.0,-37830.14
buyer_6,Manuel,45,ES45209554403228000157,TRX_N-00685-21080539,2023-08-23T15:59:01,Vitoria-Gasteiz,Expense,healthcare,-75.14,-37905.28
buyer_6,Manuel,45,ES45209554403228000157,TRX_N-00686-80021732,2023-08-23T19:33:00,Vitoria-Gasteiz,Expense,cash,-100.0,-38005.28
buyer_6,Manuel,45,ES45209554403228000157,TRX_N-00687-26747172,2023-08-29T19:50:25,Vitoria-Gasteiz,Expense,clothing,-94.33,-38099.61
buyer_6,Manuel,45,ES45209554403228000157,TRX_N-00688-33586648,2023-08-29T12:23:19,Vitoria-Gasteiz,Expense,repairs,-91.69,-38191.3
buyer_6,Manuel,45,ES45209554403228000157,TRX_N-00689-33780447,2023-09-01T12:01:34,Vitoria-Gasteiz,incomes,salary,1546.23,-36645.07
buyer_6,Manuel,45,ES45209554403228000157,TRX_N-00690-01137321,2023-09-01T12:01:34,Vitoria-Gasteiz,incomes,salary_partner,1057.05,-35588.02
buyer_6,Manuel,45,ES45209554403228000157,TRX_N-00691-09558646,2023-09-01T12:01:34,Vitoria-Gasteiz,incomes,extra_income,251.7,-35336.32
buyer_6,Manuel,45,ES45209554403228000157,TRX_N-00692-81990795,2023-09-02T12:25:50,Vitoria-Gasteiz,Expense,cash,-100.0,-35436.32
buyer_6,Manuel,45,ES45209554403228000157,TRX_N-00693-07444870,2023-09-04T23:55:20,Vitoria-Gasteiz,expenses,mortgage,-842.56,-36278.88
buyer_6,Manuel,45,ES45209554403228000157,TRX_N-00694-27542383,2023-09-06T15:15:44,Vitoria-Gasteiz,expenses,phone,-44.19,-36323.07
buyer_6,Manuel,45,ES45209554403228000157,TRX_N-00695-42698615,2023-09-06T00:10:56,Hondarribia,Expense,clothing,-127.83,-36450.9
buyer_6,Manuel,45,ES45209554403228000157,TRX_N-00696-87090494,2023-09-08T13:35:37,Vitoria-Gasteiz,expenses,water,-29.13,-36480.03
buyer_6,Manuel,45,ES45209554403228000157,TRX_N-00697-95719118,2023-09-08T13:16:05,Vitoria-Gasteiz,expenses,electricity,-87.05,-36567.08
buyer_6,Manuel,45,ES45209554403228000157,TRX_N-00698-66953687,2023-09-08T20:14:09,Vitoria-Gasteiz,expenses,gas,-37.57,-36604.65
buyer_6,Manuel,45,ES45209554403228000157,TRX_N-00699-10529805,2023-09-08T07:34:29,Vitoria-Gasteiz,expenses,internet,-42.0,-36646.65
buyer_6,Manuel,45,ES45209554403228000157,TRX_N-00700-74884488,2023-09-08T19:02:39,Vitoria-Gasteiz,Expense,appliances,-352.3,-36998.95
buyer_6,Manuel,45,ES45209554403228000157,TRX_N-00701-56778959,2023-09-09T10:32:13,Vitoria-Gasteiz,Expense,leisure,-50.63,-37049.58
buyer_6,Manuel,45,ES45209554403228000157,TRX_N-00702-13204005,2023-09-09T19:19:17,Getxo,Expense,repairs,-225.07,-37274.65
buyer_6,Manuel,45,ES45209554403228000157,TRX_N-00703-26277475,2023-09-10T17:45:50,Vitoria-Gasteiz,Expense,cash,-100.0,-37374.65
buyer_6,Manuel,45,ES45209554403228000157,TRX_N-00704-66403240,2023-09-11T17:44:12,Vitoria-Gasteiz,Expense,travel,-1525.32,-38899.97
buyer_6,Manuel,45,ES45209554403228000157,TRX_N-00705-80726817,2023-09-11T11:05:51,Vitoria-Gasteiz,Expense,repairs,-211.97,-39111.94
buyer_6,Manuel,45,ES45209554403228000157,TRX_N-00706-77644299,2023-09-12T09:43:54,Vitoria-Gasteiz,Expense,gifts,-466.56,-39578.5
buyer_6,Manuel,45,ES45209554403228000157,TRX_N-00707-95477400,2023-09-14T09:46:42,Vitoria-Gasteiz,Expense,food,-68.53,-39647.03
buyer_6,Manuel,45,ES45209554403228000157,TRX_N-00708-77689391,2023-09-14T11:09:53,Zuia,Expense,cash,-100.0,-39747.03
buyer_6,Manuel,45,ES45209554403228000157,TRX_N-00709-77795320,2023-09-15T10:56:11,Vitoria-Gasteiz,expenses,children,-230.31,-39977.34
buyer_6,Manuel,45,ES45209554403228000157,TRX_N-00710-93690703,2023-09-17T12:32:51,Vitoria-Gasteiz,Expense,transport,-82.14,-40059.48
buyer_6,Manuel,45,ES45209554403228000157,TRX_N-00711-06261938,2023-09-18T19:30:17,Vitoria-Gasteiz,Expense,food,-81.94,-40141.42
buyer_6,Manuel,45,ES45209554403228000157,TRX_N-00712-32539639,2023-09-18T04:31:17,Vitoria-Gasteiz,Expense,clothing,-121.3,-40262.72
buyer_6,Manuel,45,ES45209554403228000157,TRX_N-00713-99098914,2023-09-20T11:04:12,Vitoria-Gasteiz,Expense,repairs,-118.46,-40381.18
buyer_6,Manuel,45,ES45209554403228000157,TRX_N-00714-50144201,2023-09-21T08:25:08,Vitoria-Gasteiz,Expense,cash,-100.0,-40481.18
buyer_6,Manuel,45,ES45209554403228000157,TRX_N-00715-11178546,2023-09-22T12:26:43,Vitoria-Gasteiz,Expense,food,-77.08,-40558.26
buyer_6,Manuel,45,ES45209554403228000157,TRX_N-00716-53698084,2023-09-22T15:43:41,Vitoria-Gasteiz,Expense,education,-66.43,-40624.69
buyer_6,Manuel,45,ES45209554403228000157,TRX_N-00717-96776454,2023-09-22T12:30:09,Vitoria-Gasteiz,Expense,gifts,-195.74,-40820.43
buyer_6,Manuel,45,ES45209554403228000157,TRX_N-00718-13295642,2023-09-23T01:33:30,Vitoria-Gasteiz,Expense,repairs,-195.04,-41015.47
buyer_6,Manuel,45,ES45209554403228000157,TRX_N-00719-65846583,2023-09-24T13:48:10,Vitoria-Gasteiz,Expense,education,-43.67,-41059.14
buyer_6,Manuel,45,ES45209554403228000157,TRX_N-00720-54742424,2023-09-25T23:31:14,Vitoria-Gasteiz,Expense,education,-62.76,-41121.9
buyer_6,Manuel,45,ES45209554403228000157,TRX_N-00721-65227191,2023-09-26T19:13:10,Vitoria-Gasteiz,Expense,food,-91.94,-41213.84
buyer_6,Manuel,45,ES45209554403228000157,TRX_N-00722-12829353,2023-09-28T10:52:37,Oy√≥n-Oion,Expense,leisure,-62.97,-41276.81
buyer_6,Manuel,45,ES45209554403228000157,TRX_N-00723-96137126,2023-09-28T20:05:20,Vitoria-Gasteiz,Expense,cash,-100.0,-41376.81
buyer_6,Manuel,45,ES45209554403228000157,TRX_N-00724-55121335,2023-09-28T20:24:23,Vitoria-Gasteiz,Expense,repairs,-287.5,-41664.31
buyer_6,Manuel,45,ES45209554403228000157,TRX_N-00725-94696675,2023-09-29T20:39:08,Vitoria-Gasteiz,Expense,cash,-100.0,-41764.31
buyer_6,Manuel,45,ES45209554403228000157,TRX_N-00726-65075237,2023-09-29T02:32:52,Vitoria-Gasteiz,expenses,children,-147.46,-41911.77
buyer_6,Manuel,45,ES45209554403228000157,TRX_N-00727-21300947,2023-09-30T11:09:41,Galdakao,Expense,repairs,-195.13,-42106.9
buyer_6,Manuel,45,ES45209554403228000157,TRX_N-00728-05695277,2023-10-01T05:59:58,Vitoria-Gasteiz,incomes,salary,1546.23,-40560.67
buyer_6,Manuel,45,ES45209554403228000157,TRX_N-00729-55962578,2023-10-01T05:59:58,Vitoria-Gasteiz,incomes,salary_partner,1057.05,-39503.62
buyer_6,Manuel,45,ES45209554403228000157,TRX_N-00730-89607721,2023-10-01T17:36:59,Durango,Expense,leisure,-76.31,-39579.93
buyer_6,Manuel,45,ES45209554403228000157,TRX_N-00731-80617156,2023-10-02T19:44:15,Vitoria-Gasteiz,Expense,cash,-100.0,-39679.93
buyer_6,Manuel,45,ES45209554403228000157,TRX_N-00732-13508484,2023-10-04T08:14:21,Vitoria-Gasteiz,expenses,mortgage,-842.56,-40522.49
buyer_6,Manuel,45,ES45209554403228000157,TRX_N-00733-48829663,2023-10-06T08:59:47,Vitoria-Gasteiz,expenses,gas,-56.24,-40578.73
buyer_6,Manuel,45,ES45209554403228000157,TRX_N-00734-43769806,2023-10-06T22:29:59,Vitoria-Gasteiz,expenses,phone,-38.05,-40616.78
buyer_6,Manuel,45,ES45209554403228000157,TRX_N-00735-43636471,2023-10-06T09:38:54,Vitoria-Gasteiz,Expense,food,-96.09,-40712.87
buyer_6,Manuel,45,ES45209554403228000157,TRX_N-00736-07419018,2023-10-06T08:29:59,Vitoria-Gasteiz,Expense,transport,-60.14,-40773.01
buyer_6,Manuel,45,ES45209554403228000157,TRX_N-00737-07361812,2023-10-06T03:46:04,Vitoria-Gasteiz,Expense,leisure,-19.13,-40792.14
buyer_6,Manuel,45,ES45209554403228000157,TRX_N-00738-00406992,2023-10-06T14:49:54,Vitoria-Gasteiz,expenses,children,-79.13,-40871.27
buyer_6,Manuel,45,ES45209554403228000157,TRX_N-00739-38087812,2023-10-07T08:40:43,Vitoria-Gasteiz,expenses,water,-23.52,-40894.79
buyer_6,Manuel,45,ES45209554403228000157,TRX_N-00740-90390131,2023-10-07T15:10:10,Vitoria-Gasteiz,Expense,clothing,-81.48,-40976.27
buyer_6,Manuel,45,ES45209554403228000157,TRX_N-00741-63377725,2023-10-08T12:55:43,Vitoria-Gasteiz,expenses,internet,-42.0,-41018.27
buyer_6,Manuel,45,ES45209554403228000157,TRX_N-00742-68003556,2023-10-08T10:34:42,Vitoria-Gasteiz,expenses,electricity,-24.45,-41042.72
buyer_6,Manuel,45,ES45209554403228000157,TRX_N-00743-17612411,2023-10-08T11:54:13,Santurtzi,Expense,food,-100.02,-41142.74
buyer_6,Manuel,45,ES45209554403228000157,TRX_N-00744-46538831,2023-10-10T19:16:21,Vitoria-Gasteiz,Expense,leisure,-26.12,-41168.86
buyer_6,Manuel,45,ES45209554403228000157,TRX_N-00745-21363629,2023-10-10T20:54:19,Lasarte-Oria,Expense,cash,-100.0,-41268.86
buyer_6,Manuel,45,ES45209554403228000157,TRX_N-00746-55239507,2023-10-13T09:27:38,Vitoria-Gasteiz,Expense,food,-105.2,-41374.06
buyer_6,Manuel,45,ES45209554403228000157,TRX_N-00747-43881913,2023-10-15T13:15:07,Vitoria-Gasteiz,Expense,transport,-51.47,-41425.53
buyer_6,Manuel,45,ES45209554403228000157,TRX_N-00748-68869757,2023-10-16T16:25:00,Vitoria-Gasteiz,Expense,food,-122.24,-41547.77
buyer_6,Manuel,45,ES45209554403228000157,TRX_N-00749-11024553,2023-10-17T17:02:47,Vitoria-Gasteiz,Expense,leisure,-76.17,-41623.94
buyer_6,Manuel,45,ES45209554403228000157,TRX_N-00750-72249630,2023-10-22T15:26:27,Vitoria-Gasteiz,Expense,food,-118.95,-41742.89
buyer_6,Manuel,45,ES45209554403228000157,TRX_N-00751-24553000,2023-10-23T23:06:37,Vitoria-Gasteiz,Expense,food,-94.43,-41837.32
buyer_6,Manuel,45,ES45209554403228000157,TRX_N-00752-45076201,2023-10-24T09:10:52,Vitoria-Gasteiz,Expense,repairs,-217.17,-42054.49
buyer_6,Manuel,45,ES45209554403228000157,TRX_N-00753-31994933,2023-10-24T12:33:25,Vitoria-Gasteiz,Expense,gifts,-320.48,-42374.97
buyer_6,Manuel,45,ES45209554403228000157,TRX_N-00754-46288690,2023-10-26T16:41:19,Vitoria-Gasteiz,Expense,cash,-100.0,-42474.97
buyer_6,Manuel,45,ES45209554403228000157,TRX_N-00755-69906525,2023-10-29T08:02:48,Vitoria-Gasteiz,Expense,transport,-69.69,-42544.66
buyer_6,Manuel,45,ES45209554403228000157,TRX_N-00756-18444192,2023-10-30T09:47:38,Vitoria-Gasteiz,expenses,children,-73.89,-42618.55
buyer_6,Manuel,45,ES45209554403228000157,TRX_N-00757-02598848,2023-10-31T10:04:51,Getxo,Expense,leisure,-32.62,-42651.17
buyer_6,Manuel,45,ES45209554403228000157,TRX_N-00758-99500019,2023-11-01T11:48:36,Vitoria-Gasteiz,incomes,salary,1546.23,-41104.94
buyer_6,Manuel,45,ES45209554403228000157,TRX_N-00759-57795978,2023-11-01T11:48:36,Vitoria-Gasteiz,incomes,salary_partner,1057.05,-40047.89
buyer_6,Manuel,45,ES45209554403228000157,TRX_N-00760-36800035,2023-11-02T15:26:26,Vitoria-Gasteiz,Expense,leisure,-45.17,-40093.06
buyer_6,Manuel,45,ES45209554403228000157,TRX_N-00761-65209901,2023-11-04T23:41:42,Vitoria-Gasteiz,expenses,mortgage,-842.56,-40935.62
buyer_6,Manuel,45,ES45209554403228000157,TRX_N-00762-94079615,2023-11-04T12:40:08,Vitoria-Gasteiz,Expense,food,-87.38,-41023.0
buyer_6,Manuel,45,ES45209554403228000157,TRX_N-00763-01568946,2023-11-04T05:10:22,Vitoria-Gasteiz,Expense,cash,-100.0,-41123.0
buyer_6,Manuel,45,ES45209554403228000157,TRX_N-00764-45690353,2023-11-05T06:43:01,Vitoria-Gasteiz,expenses,electricity,-73.42,-41196.42
buyer_6,Manuel,45,ES45209554403228000157,TRX_N-00765-16149942,2023-11-05T19:16:36,Vitoria-Gasteiz,expenses,gas,-75.01,-41271.43
buyer_6,Manuel,45,ES45209554403228000157,TRX_N-00766-66370077,2023-11-06T13:10:50,Vitoria-Gasteiz,Expense,cash,-100.0,-41371.43
buyer_6,Manuel,45,ES45209554403228000157,TRX_N-00767-47300786,2023-11-07T15:33:04,Vitoria-Gasteiz,expenses,phone,-43.03,-41414.46
buyer_6,Manuel,45,ES45209554403228000157,TRX_N-00768-86711673,2023-11-08T08:29:18,Vitoria-Gasteiz,expenses,water,-20.22,-41434.68
buyer_6,Manuel,45,ES45209554403228000157,TRX_N-00769-33981680,2023-11-08T16:08:46,Vitoria-Gasteiz,expenses,internet,-42.0,-41476.68
buyer_6,Manuel,45,ES45209554403228000157,TRX_N-00770-08960231,2023-11-08T19:42:42,Vitoria-Gasteiz,Expense,food,-109.68,-41586.36
buyer_6,Manuel,45,ES45209554403228000157,TRX_N-00771-93214296,2023-11-10T13:08:14,Vitoria-Gasteiz,Expense,gifts,-184.02,-41770.38
buyer_6,Manuel,45,ES45209554403228000157,TRX_N-00772-50829017,2023-11-12T08:16:21,Vitoria-Gasteiz,Expense,food,-110.3,-41880.68
buyer_6,Manuel,45,ES45209554403228000157,TRX_N-00773-73342415,2023-11-12T16:53:20,Vitoria-Gasteiz,Expense,clothing,-157.9,-42038.58
buyer_6,Manuel,45,ES45209554403228000157,TRX_N-00774-28957285,2023-11-13T16:19:05,Labastida,Expense,transport,-87.03,-42125.61
buyer_6,Manuel,45,ES45209554403228000157,TRX_N-00775-39863923,2023-11-15T17:57:26,Vitoria-Gasteiz,Expense,clothing,-145.71,-42271.32
buyer_6,Manuel,45,ES45209554403228000157,TRX_N-00776-48116547,2023-11-17T16:03:28,Pasaia,Expense,clothing,-151.54,-42422.86
buyer_6,Manuel,45,ES45209554403228000157,TRX_N-00777-15225607,2023-11-17T22:36:14,Vitoria-Gasteiz,Expense,cash,-100.0,-42522.86
buyer_6,Manuel,45,ES45209554403228000157,TRX_N-00778-63920980,2023-11-18T20:34:54,Vitoria-Gasteiz,Expense,cash,-100.0,-42622.86
buyer_6,Manuel,45,ES45209554403228000157,TRX_N-00779-78306550,2023-11-19T17:12:46,Vitoria-Gasteiz,Expense,gifts,-317.87,-42940.73
buyer_6,Manuel,45,ES45209554403228000157,TRX_N-00780-99411435,2023-11-20T20:02:56,Vitoria-Gasteiz,Expense,clothing,-158.31,-43099.04
buyer_6,Manuel,45,ES45209554403228000157,TRX_N-00781-16008724,2023-11-20T22:13:18,Galdakao,Expense,repairs,-206.67,-43305.71
buyer_6,Manuel,45,ES45209554403228000157,TRX_N-00782-21209043,2023-11-22T09:32:47,Vitoria-Gasteiz,Expense,appliances,-261.29,-43567.0
buyer_6,Manuel,45,ES45209554403228000157,TRX_N-00783-78834320,2023-11-23T14:44:31,Vitoria-Gasteiz,Expense,leisure,-51.88,-43618.88
buyer_6,Manuel,45,ES45209554403228000157,TRX_N-00784-02856835,2023-11-24T03:49:25,Vitoria-Gasteiz,Expense,clothing,-148.78,-43767.66
buyer_6,Manuel,45,ES45209554403228000157,TRX_N-00785-67514315,2023-11-25T17:17:59,Vitoria-Gasteiz,Expense,transport,-86.45,-43854.11
buyer_6,Manuel,45,ES45209554403228000157,TRX_N-00786-56130254,2023-11-25T11:49:53,Vitoria-Gasteiz,Expense,cash,-100.0,-43954.11
buyer_6,Manuel,45,ES45209554403228000157,TRX_N-00787-39344276,2023-11-26T09:09:39,Vitoria-Gasteiz,Expense,food,-70.95,-44025.06
buyer_6,Manuel,45,ES45209554403228000157,TRX_N-00788-83480011,2023-11-26T11:12:05,Vitoria-Gasteiz,Expense,leisure,-37.08,-44062.14
buyer_6,Manuel,45,ES45209554403228000157,TRX_N-00789-02456736,2023-11-27T11:31:45,Vitoria-Gasteiz,Expense,transport,-82.14,-44144.28
buyer_6,Manuel,45,ES45209554403228000157,TRX_N-00790-17165830,2023-11-27T13:35:50,Vitoria-Gasteiz,Expense,leisure,-62.51,-44206.79
buyer_6,Manuel,45,ES45209554403228000157,TRX_N-00791-21284163,2023-11-28T13:48:33,Vitoria-Gasteiz,Expense,food,-99.69,-44306.48
buyer_6,Manuel,45,ES45209554403228000157,TRX_N-00792-74846876,2023-11-28T21:36:39,Vitoria-Gasteiz,Expense,transport,-59.94,-44366.42
buyer_6,Manuel,45,ES45209554403228000157,TRX_N-00793-18220329,2023-11-28T10:58:37,Vitoria-Gasteiz,expenses,children,-100.73,-44467.15
buyer_6,Manuel,45,ES45209554403228000157,TRX_N-00794-58733651,2023-11-29T14:01:40,Vitoria-Gasteiz,Expense,food,-98.24,-44565.39
buyer_6,Manuel,45,ES45209554403228000157,TRX_N-00795-75222794,2023-12-01T22:52:52,Vitoria-Gasteiz,incomes,salary,1546.23,-43019.16
buyer_6,Manuel,45,ES45209554403228000157,TRX_N-00796-72169029,2023-12-01T22:52:52,Vitoria-Gasteiz,incomes,salary_partner,1057.05,-41962.11
buyer_6,Manuel,45,ES45209554403228000157,TRX_N-00797-67285502,2023-12-01T22:52:52,Vitoria-Gasteiz,incomes,extra_income,251.7,-41710.41
buyer_6,Manuel,45,ES45209554403228000157,TRX_N-00798-88259832,2023-12-01T22:52:52,Vitoria-Gasteiz,incomes,salary_bonus,1177.32,-40533.09
buyer_6,Manuel,45,ES45209554403228000157,TRX_N-00799-61447657,2023-12-01T22:52:52,Vitoria-Gasteiz,incomes,salary_partner_bonus,813.17,-39719.92
buyer_6,Manuel,45,ES45209554403228000157,TRX_N-00800-58034707,2023-12-01T12:34:53,Vitoria-Gasteiz,Expense,food,-91.6,-39811.52
buyer_6,Manuel,45,ES45209554403228000157,TRX_N-00801-94363802,2023-12-03T09:50:45,Vitoria-Gasteiz,Expense,leisure,-74.05,-39885.57
buyer_6,Manuel,45,ES45209554403228000157,TRX_N-00802-09596531,2023-12-04T14:25:02,Vitoria-Gasteiz,expenses,mortgage,-842.56,-40728.13
buyer_6,Manuel,45,ES45209554403228000157,TRX_N-00803-59281627,2023-12-04T14:24:13,Iru√±a de Oca,Expense,cash,-100.0,-40828.13
buyer_6,Manuel,45,ES45209554403228000157,TRX_N-00804-68583745,2023-12-05T23:05:00,Vitoria-Gasteiz,expenses,water,-39.2,-40867.33
buyer_6,Manuel,45,ES45209554403228000157,TRX_N-00805-85031523,2023-12-05T10:28:45,Vitoria-Gasteiz,expenses,internet,-42.0,-40909.33
buyer_6,Manuel,45,ES45209554403228000157,TRX_N-00806-62786877,2023-12-06T10:38:44,Vitoria-Gasteiz,expenses,phone,-38.19,-40947.52
buyer_6,Manuel,45,ES45209554403228000157,TRX_N-00807-25795468,2023-12-07T10:57:14,Vitoria-Gasteiz,expenses,gas,-41.03,-40988.55
buyer_6,Manuel,45,ES45209554403228000157,TRX_N-00808-95563256,2023-12-07T13:04:19,Pasaia,Expense,leisure,-39.73,-41028.28
buyer_6,Manuel,45,ES45209554403228000157,TRX_N-00809-58188497,2023-12-08T13:37:26,Vitoria-Gasteiz,expenses,electricity,-51.31,-41079.59
buyer_6,Manuel,45,ES45209554403228000157,TRX_N-00810-88934064,2023-12-08T10:45:54,Vitoria-Gasteiz,Expense,repairs,-263.79,-41343.38
buyer_6,Manuel,45,ES45209554403228000157,TRX_N-00811-52040618,2023-12-09T13:37:27,Vitoria-Gasteiz,Expense,gifts,-745.01,-42088.39
buyer_6,Manuel,45,ES45209554403228000157,TRX_N-00812-80037560,2023-12-10T20:24:50,Vitoria-Gasteiz,Expense,food,-106.45,-42194.84
buyer_6,Manuel,45,ES45209554403228000157,TRX_N-00813-84203089,2023-12-12T12:32:32,Vitoria-Gasteiz,Expense,food,-117.67,-42312.51
buyer_6,Manuel,45,ES45209554403228000157,TRX_N-00814-65060594,2023-12-15T04:54:41,Vitoria-Gasteiz,Expense,repairs,-325.66,-42638.17
buyer_6,Manuel,45,ES45209554403228000157,TRX_N-00815-17752155,2023-12-17T18:47:19,Zuia,Expense,transport,-65.25,-42703.42
buyer_6,Manuel,45,ES45209554403228000157,TRX_N-00816-47182432,2023-12-17T14:02:35,Vitoria-Gasteiz,Expense,cash,-100.0,-42803.42
buyer_6,Manuel,45,ES45209554403228000157,TRX_N-00817-90243458,2023-12-17T19:35:19,Durango,Expense,travel,-1561.82,-44365.24
buyer_6,Manuel,45,ES45209554403228000157,TRX_N-00818-13803039,2023-12-19T19:49:21,Vitoria-Gasteiz,expenses,children,-160.47,-44525.71
buyer_6,Manuel,45,ES45209554403228000157,TRX_N-00819-97194406,2023-12-21T18:13:42,Zuia,Expense,food,-78.5,-44604.21
buyer_6,Manuel,45,ES45209554403228000157,TRX_N-00820-66346183,2023-12-21T11:52:06,Vitoria-Gasteiz,Expense,clothing,-119.56,-44723.77
buyer_6,Manuel,45,ES45209554403228000157,TRX_N-00821-54358061,2023-12-21T08:51:48,Vitoria-Gasteiz,Expense,healthcare,-51.22,-44774.99
buyer_6,Manuel,45,ES45209554403228000157,TRX_N-00822-23482540,2023-12-22T15:23:18,Vitoria-Gasteiz,Expense,transport,-67.51,-44842.5
buyer_6,Manuel,45,ES45209554403228000157,TRX_N-00823-62783518,2023-12-23T11:42:52,Vitoria-Gasteiz,Expense,leisure,-76.43,-44918.93
buyer_6,Manuel,45,ES45209554403228000157,TRX_N-00824-96004968,2023-12-24T20:54:25,Vitoria-Gasteiz,Expense,food,-65.63,-44984.56
buyer_6,Manuel,45,ES45209554403228000157,TRX_N-00825-41827473,2023-12-24T11:42:22,Vitoria-Gasteiz,Expense,cash,-100.0,-45084.56
buyer_6,Manuel,45,ES45209554403228000157,TRX_N-00826-91951873,2023-12-26T14:08:19,Vitoria-Gasteiz,Expense,food,-102.02,-45186.58
buyer_6,Manuel,45,ES45209554403228000157,TRX_N-00827-66399534,2023-12-26T20:09:28,Vitoria-Gasteiz,Expense,leisure,-61.16,-45247.74
buyer_6,Manuel,45,ES45209554403228000157,TRX_N-00828-43487020,2023-12-27T16:52:04,Vitoria-Gasteiz,Expense,food,-106.68,-45354.42
buyer_6,Manuel,45,ES45209554403228000157,TRX_N-00829-89638228,2023-12-29T19:47:01,Vitoria-Gasteiz,Expense,food,-101.5,-45455.92
buyer_6,Manuel,45,ES45209554403228000157,TRX_N-00830-24127319,2023-12-29T09:20:01,Vitoria-Gasteiz,Expense,cash,-100.0,-45555.92
buyer_6,Manuel,45,ES45209554403228000157,TRX_N-00831-26688229,2023-12-30T00:23:25,Vitoria-Gasteiz,Expense,food,-64.16,-45620.08
buyer_6,Manuel,45,ES45209554403228000157,TRX_N-00832-28013889,2023-12-30T11:18:00,Vitoria-Gasteiz,Expense,cash,-100.0,-45720.08
buyer_6,Manuel,45,ES45209554403228000157,TRX_N-00833-49018805,2023-12-31T15:42:08,Vitoria-Gasteiz,expenses,children,-260.79,-45980.87
buyer_6,Manuel,45,ES45209554403228000157,TRX_N-00834-91078319,2024-01-01T00:49:59,Vitoria-Gasteiz,incomes,salary,1595.28,-44385.59
buyer_6,Manuel,45,ES45209554403228000157,TRX_N-00835-28725652,2024-01-01T00:49:59,Vitoria-Gasteiz,incomes,salary_partner,1090.58,-43295.01
buyer_6,Manuel,45,ES45209554403228000157,TRX_N-00836-89522696,2024-01-02T22:40:40,Vitoria-Gasteiz,Expense,leisure,-82.42,-43377.43
buyer_6,Manuel,45,ES45209554403228000157,TRX_N-00837-62576136,2024-01-04T21:00:01,Vitoria-Gasteiz,expenses,mortgage,-842.56,-44219.99
buyer_6,Manuel,45,ES45209554403228000157,TRX_N-00838-34084901,2024-01-04T19:24:09,Vitoria-Gasteiz,Expense,leisure,-72.27,-44292.26
buyer_6,Manuel,45,ES45209554403228000157,TRX_N-00839-66750231,2024-01-05T02:33:55,Vitoria-Gasteiz,expenses,water,-25.17,-44317.43
buyer_6,Manuel,45,ES45209554403228000157,TRX_N-00840-20762629,2024-01-05T12:29:11,Vitoria-Gasteiz,Expense,transport,-40.82,-44358.25
buyer_6,Manuel,45,ES45209554403228000157,TRX_N-00841-75577664,2024-01-05T09:34:59,Vitoria-Gasteiz,Expense,repairs,-285.36,-44643.61
buyer_6,Manuel,45,ES45209554403228000157,TRX_N-00842-51857571,2024-01-05T07:12:07,Vitoria-Gasteiz,expenses,children,-211.22,-44854.83
buyer_6,Manuel,45,ES45209554403228000157,TRX_N-00843-16241028,2024-01-06T13:14:07,Vitoria-Gasteiz,expenses,gas,-31.84,-44886.67
buyer_6,Manuel,45,ES45209554403228000157,TRX_N-00844-38351142,2024-01-06T15:51:09,Vitoria-Gasteiz,Expense,cash,-100.0,-44986.67
buyer_6,Manuel,45,ES45209554403228000157,TRX_N-00845-38291227,2024-01-07T08:30:43,Vitoria-Gasteiz,Expense,gifts,-805.85,-45792.52
buyer_6,Manuel,45,ES45209554403228000157,TRX_N-00846-95067923,2024-01-08T01:38:47,Vitoria-Gasteiz,expenses,electricity,-25.46,-45817.98
buyer_6,Manuel,45,ES45209554403228000157,TRX_N-00847-31266219,2024-01-08T08:44:06,Vitoria-Gasteiz,expenses,internet,-42.0,-45859.98
buyer_6,Manuel,45,ES45209554403228000157,TRX_N-00848-56471914,2024-01-08T20:40:56,Vitoria-Gasteiz,expenses,phone,-34.65,-45894.63
buyer_6,Manuel,45,ES45209554403228000157,TRX_N-00849-73311061,2024-01-09T08:53:28,Arrasate,Expense,cash,-100.0,-45994.63
buyer_6,Manuel,45,ES45209554403228000157,TRX_N-00850-35941741,2024-01-12T22:37:26,Zarautz,Expense,leisure,-74.47,-46069.1
buyer_6,Manuel,45,ES45209554403228000157,TRX_N-00851-99893852,2024-01-13T06:55:45,Vitoria-Gasteiz,Expense,cash,-100.0,-46169.1
buyer_6,Manuel,45,ES45209554403228000157,TRX_N-00852-85971170,2024-01-14T08:10:29,Vitoria-Gasteiz,Expense,repairs,-55.55,-46224.65
buyer_6,Manuel,45,ES45209554403228000157,TRX_N-00853-96484304,2024-01-15T11:07:13,Vitoria-Gasteiz,Expense,gifts,-763.24,-46987.89
buyer_6,Manuel,45,ES45209554403228000157,TRX_N-00854-19987376,2024-01-17T12:12:10,Vitoria-Gasteiz,Expense,transport,-79.81,-47067.7
buyer_6,Manuel,45,ES45209554403228000157,TRX_N-00855-13597796,2024-01-17T14:53:03,Vitoria-Gasteiz,Expense,leisure,-75.58,-47143.28
buyer_6,Manuel,45,ES45209554403228000157,TRX_N-00856-66931425,2024-01-19T19:28:23,Vitoria-Gasteiz,Expense,food,-82.69,-47225.97
buyer_6,Manuel,45,ES45209554403228000157,TRX_N-00857-13210985,2024-01-20T16:36:08,Vitoria-Gasteiz,Expense,education,-61.42,-47287.39
buyer_6,Manuel,45,ES45209554403228000157,TRX_N-00858-31849198,2024-01-20T09:41:26,Eibar,Expense,cash,-100.0,-47387.39
buyer_6,Manuel,45,ES45209554403228000157,TRX_N-00859-63729075,2024-01-21T13:06:36,Vitoria-Gasteiz,Expense,food,-93.9,-47481.29
buyer_6,Manuel,45,ES45209554403228000157,TRX_N-00860-91339399,2024-01-21T09:39:43,Vitoria-Gasteiz,Expense,education,-53.79,-47535.08
buyer_6,Manuel,45,ES45209554403228000157,TRX_N-00861-82384298,2024-01-21T10:58:45,Vitoria-Gasteiz,Expense,cash,-100.0,-47635.08
buyer_6,Manuel,45,ES45209554403228000157,TRX_N-00862-45572093,2024-01-21T12:20:14,Vitoria-Gasteiz,expenses,children,-90.0,-47725.08
buyer_6,Manuel,45,ES45209554403228000157,TRX_N-00863-29563612,2024-01-22T18:31:51,Vitoria-Gasteiz,Expense,repairs,-112.19,-47837.27
buyer_6,Manuel,45,ES45209554403228000157,TRX_N-00864-52966028,2024-01-23T11:07:35,Vitoria-Gasteiz,Expense,cash,-100.0,-47937.27
buyer_6,Manuel,45,ES45209554403228000157,TRX_N-00865-78256403,2024-01-25T12:20:34,Vitoria-Gasteiz,expenses,children,-118.7,-48055.97
buyer_6,Manuel,45,ES45209554403228000157,TRX_N-00866-81887757,2024-01-26T22:20:43,Vitoria-Gasteiz,Expense,repairs,-138.08,-48194.05
buyer_6,Manuel,45,ES45209554403228000157,TRX_N-00867-86605276,2024-01-27T20:23:50,Vitoria-Gasteiz,Expense,food,-101.82,-48295.87
buyer_6,Manuel,45,ES45209554403228000157,TRX_N-00868-36138037,2024-01-27T08:34:36,Vitoria-Gasteiz,Expense,healthcare,-80.54,-48376.41
buyer_6,Manuel,45,ES45209554403228000157,TRX_N-00869-24936195,2024-01-28T08:18:38,Durango,Expense,transport,-54.61,-48431.02
buyer_6,Manuel,45,ES45209554403228000157,TRX_N-00870-49701889,2024-01-29T10:48:35,Vitoria-Gasteiz,Expense,leisure,-69.67,-48500.69
buyer_6,Manuel,45,ES45209554403228000157,TRX_N-00871-80271889,2024-01-29T09:25:31,Vitoria-Gasteiz,Expense,education,-56.43,-48557.12
buyer_6,Manuel,45,ES45209554403228000157,TRX_N-00872-72256754,2024-01-29T14:32:56,Vitoria-Gasteiz,Expense,gifts,-844.07,-49401.19
buyer_6,Manuel,45,ES45209554403228000157,TRX_N-00873-81994865,2024-01-30T17:12:33,Vitoria-Gasteiz,Expense,gifts,-536.15,-49937.34
buyer_6,Manuel,45,ES45209554403228000157,TRX_N-00874-91348276,2024-02-01T13:31:15,Vitoria-Gasteiz,incomes,salary,1595.28,-48342.06
buyer_6,Manuel,45,ES45209554403228000157,TRX_N-00875-29700129,2024-02-01T13:31:15,Vitoria-Gasteiz,incomes,salary_partner,1090.58,-47251.48
buyer_6,Manuel,45,ES45209554403228000157,TRX_N-00876-84314486,2024-02-01T15:10:57,Llodio,Expense,transport,-71.41,-47322.89
buyer_6,Manuel,45,ES45209554403228000157,TRX_N-00877-82456281,2024-02-01T18:05:39,Vitoria-Gasteiz,Expense,cash,-100.0,-47422.89
buyer_6,Manuel,45,ES45209554403228000157,TRX_N-00878-24742267,2024-02-02T23:07:39,Vitoria-Gasteiz,Expense,education,-45.24,-47468.13
buyer_6,Manuel,45,ES45209554403228000157,TRX_N-00879-66890861,2024-02-04T13:44:11,Vitoria-Gasteiz,expenses,mortgage,-842.56,-48310.69
buyer_6,Manuel,45,ES45209554403228000157,TRX_N-00880-84367581,2024-02-04T19:12:12,Vitoria-Gasteiz,Expense,appliances,-107.71,-48418.4
buyer_6,Manuel,45,ES45209554403228000157,TRX_N-00881-91583914,2024-02-05T17:01:20,Vitoria-Gasteiz,expenses,electricity,-72.49,-48490.89
buyer_6,Manuel,45,ES45209554403228000157,TRX_N-00882-70272890,2024-02-05T00:15:58,Vitoria-Gasteiz,expenses,gas,-34.83,-48525.72
buyer_6,Manuel,45,ES45209554403228000157,TRX_N-00883-38671374,2024-02-05T09:30:09,Vitoria-Gasteiz,expenses,phone,-40.9,-48566.62
buyer_6,Manuel,45,ES45209554403228000157,TRX_N-00884-56525552,2024-02-06T10:33:17,Vitoria-Gasteiz,Expense,transport,-45.8,-48612.42
buyer_6,Manuel,45,ES45209554403228000157,TRX_N-00885-01210306,2024-02-07T08:19:57,Vitoria-Gasteiz,Expense,leisure,-18.55,-48630.97
buyer_6,Manuel,45,ES45209554403228000157,TRX_N-00886-94114575,2024-02-07T02:50:29,Vitoria-Gasteiz,Expense,gifts,-469.5,-49100.47
buyer_6,Manuel,45,ES45209554403228000157,TRX_N-00887-54139682,2024-02-08T17:03:18,Vitoria-Gasteiz,expenses,water,-35.53,-49136.0
buyer_6,Manuel,45,ES45209554403228000157,TRX_N-00888-95733588,2024-02-08T21:48:29,Vitoria-Gasteiz,expenses,internet,-42.0,-49178.0
buyer_6,Manuel,45,ES45209554403228000157,TRX_N-00889-25186866,2024-02-09T22:28:41,Hondarribia,Expense,leisure,-41.76,-49219.76
buyer_6,Manuel,45,ES45209554403228000157,TRX_N-00890-89030393,2024-02-09T20:25:33,Vitoria-Gasteiz,Expense,repairs,-292.05,-49511.81
buyer_6,Manuel,45,ES45209554403228000157,TRX_N-00891-76548913,2024-02-11T10:20:11,Vitoria-Gasteiz,Expense,transport,-43.66,-49555.47
buyer_6,Manuel,45,ES45209554403228000157,TRX_N-00892-75835632,2024-02-12T14:15:02,Vitoria-Gasteiz,Expense,travel,-285.66,-49841.13
buyer_6,Manuel,45,ES45209554403228000157,TRX_N-00893-24363209,2024-02-12T15:07:46,Vitoria-Gasteiz,Expense,gifts,-189.32,-50030.45
buyer_6,Manuel,45,ES45209554403228000157,TRX_N-00894-11886272,2024-02-14T17:49:51,Vitoria-Gasteiz,Expense,cash,-100.0,-50130.45
buyer_6,Manuel,45,ES45209554403228000157,TRX_N-00895-72252952,2024-02-15T17:56:34,Vitoria-Gasteiz,Expense,clothing,-105.13,-50235.58
buyer_6,Manuel,45,ES45209554403228000157,TRX_N-00896-43374669,2024-02-16T08:05:54,Vitoria-Gasteiz,Expense,cash,-100.0,-50335.58
buyer_6,Manuel,45,ES45209554403228000157,TRX_N-00897-29552651,2024-02-18T19:21:15,Andoain,Expense,transport,-72.16,-50407.74
buyer_6,Manuel,45,ES45209554403228000157,TRX_N-00898-15414678,2024-02-18T17:46:30,Vitoria-Gasteiz,Expense,gifts,-461.14,-50868.88
buyer_6,Manuel,45,ES45209554403228000157,TRX_N-00899-42017103,2024-02-20T19:48:48,Vitoria-Gasteiz,Expense,leisure,-36.04,-50904.92
buyer_6,Manuel,45,ES45209554403228000157,TRX_N-00900-39629551,2024-02-23T19:39:08,Vitoria-Gasteiz,Expense,food,-100.33,-51005.25
buyer_6,Manuel,45,ES45209554403228000157,TRX_N-00901-64446894,2024-02-24T13:10:56,Bermeo,Expense,repairs,-120.64,-51125.89
buyer_6,Manuel,45,ES45209554403228000157,TRX_N-00902-69394420,2024-02-25T11:09:56,Durango,Expense,cash,-100.0,-51225.89
buyer_6,Manuel,45,ES45209554403228000157,TRX_N-00903-96890601,2024-02-25T14:56:54,Vitoria-Gasteiz,expenses,children,-108.27,-51334.16
buyer_6,Manuel,45,ES45209554403228000157,TRX_N-00904-87808311,2024-02-26T18:52:10,Elciego,Expense,cash,-100.0,-51434.16
buyer_6,Manuel,45,ES45209554403228000157,TRX_N-00905-21326860,2024-02-29T10:48:20,Vitoria-Gasteiz,Expense,repairs,-90.71,-51524.87
buyer_6,Manuel,45,ES45209554403228000157,TRX_N-00906-71748023,2024-03-01T20:15:30,Vitoria-Gasteiz,incomes,salary,1595.28,-49929.59
buyer_6,Manuel,45,ES45209554403228000157,TRX_N-00907-59582089,2024-03-01T20:15:30,Vitoria-Gasteiz,incomes,salary_partner,1090.58,-48839.01
buyer_6,Manuel,45,ES45209554403228000157,TRX_N-00908-83869112,2024-03-01T20:15:30,Vitoria-Gasteiz,incomes,extra_income,251.7,-48587.31
buyer_6,Manuel,45,ES45209554403228000157,TRX_N-00909-87455022,2024-03-02T12:08:51,Zuia,Expense,food,-72.31,-48659.62
buyer_6,Manuel,45,ES45209554403228000157,TRX_N-00910-53743239,2024-03-02T08:03:08,Vitoria-Gasteiz,Expense,repairs,-141.31,-48800.93
buyer_6,Manuel,45,ES45209554403228000157,TRX_N-00911-86954050,2024-03-04T21:28:42,Vitoria-Gasteiz,expenses,mortgage,-842.56,-49643.49
buyer_6,Manuel,45,ES45209554403228000157,TRX_N-00912-37746084,2024-03-04T08:23:44,Vitoria-Gasteiz,Expense,cash,-100.0,-49743.49
buyer_6,Manuel,45,ES45209554403228000157,TRX_N-00913-59372808,2024-03-04T22:49:27,Vitoria-Gasteiz,Expense,repairs,-40.96,-49784.45
buyer_6,Manuel,45,ES45209554403228000157,TRX_N-00914-03995568,2024-03-05T10:38:04,Vitoria-Gasteiz,Expense,cash,-100.0,-49884.45
buyer_6,Manuel,45,ES45209554403228000157,TRX_N-00915-29094532,2024-03-06T08:31:16,Vitoria-Gasteiz,Expense,leisure,-24.17,-49908.62
buyer_6,Manuel,45,ES45209554403228000157,TRX_N-00916-73389544,2024-03-08T21:22:35,Vitoria-Gasteiz,expenses,water,-42.31,-49950.93
buyer_6,Manuel,45,ES45209554403228000157,TRX_N-00917-76643209,2024-03-08T02:50:17,Vitoria-Gasteiz,expenses,electricity,-68.44,-50019.37
buyer_6,Manuel,45,ES45209554403228000157,TRX_N-00918-23758537,2024-03-08T19:06:44,Vitoria-Gasteiz,expenses,gas,-104.75,-50124.12
buyer_6,Manuel,45,ES45209554403228000157,TRX_N-00919-40493305,2024-03-08T17:45:12,Vitoria-Gasteiz,expenses,internet,-42.0,-50166.12
buyer_6,Manuel,45,ES45209554403228000157,TRX_N-00920-57185403,2024-03-08T16:09:38,Vitoria-Gasteiz,expenses,phone,-41.52,-50207.64
buyer_6,Manuel,45,ES45209554403228000157,TRX_N-00921-76007996,2024-03-10T11:10:53,Vitoria-Gasteiz,Expense,cash,-100.0,-50307.64
buyer_6,Manuel,45,ES45209554403228000157,TRX_N-00922-14085275,2024-03-12T05:08:56,Vitoria-Gasteiz,Expense,healthcare,-55.85,-50363.49
buyer_6,Manuel,45,ES45209554403228000157,TRX_N-00923-78590160,2024-03-14T09:06:52,Vitoria-Gasteiz,Expense,food,-87.4,-50450.89
buyer_6,Manuel,45,ES45209554403228000157,TRX_N-00924-40469847,2024-03-14T20:11:15,Durango,Expense,leisure,-59.95,-50510.84
buyer_6,Manuel,45,ES45209554403228000157,TRX_N-00925-56328174,2024-03-16T02:42:04,Vitoria-Gasteiz,Expense,food,-122.11,-50632.95
buyer_6,Manuel,45,ES45209554403228000157,TRX_N-00926-12151142,2024-03-16T19:33:08,Lasarte-Oria,Expense,leisure,-52.47,-50685.42
buyer_6,Manuel,45,ES45209554403228000157,TRX_N-00927-88478713,2024-03-16T15:14:45,Oy√≥n-Oion,Expense,education,-43.35,-50728.77
buyer_6,Manuel,45,ES45209554403228000157,TRX_N-00928-90683788,2024-03-17T08:34:44,Vitoria-Gasteiz,Expense,food,-78.46,-50807.23
buyer_6,Manuel,45,ES45209554403228000157,TRX_N-00929-95309351,2024-03-18T15:59:06,Vitoria-Gasteiz,Expense,transport,-63.82,-50871.05
buyer_6,Manuel,45,ES45209554403228000157,TRX_N-00930-44497232,2024-03-19T08:30:38,Vitoria-Gasteiz,Expense,clothing,-71.55,-50942.6
buyer_6,Manuel,45,ES45209554403228000157,TRX_N-00931-51638355,2024-03-19T08:39:07,Vitoria-Gasteiz,Expense,cash,-100.0,-51042.6
buyer_6,Manuel,45,ES45209554403228000157,TRX_N-00932-46338201,2024-03-21T08:03:46,Vitoria-Gasteiz,Expense,repairs,-180.27,-51222.87
buyer_6,Manuel,45,ES45209554403228000157,TRX_N-00933-99537691,2024-03-23T15:00:37,Vitoria-Gasteiz,Expense,healthcare,-136.41,-51359.28
buyer_6,Manuel,45,ES45209554403228000157,TRX_N-00934-71785934,2024-03-26T16:40:27,Vitoria-Gasteiz,Expense,leisure,-23.93,-51383.21
buyer_6,Manuel,45,ES45209554403228000157,TRX_N-00935-60245677,2024-03-26T12:07:27,Vitoria-Gasteiz,Expense,healthcare,-104.3,-51487.51
buyer_6,Manuel,45,ES45209554403228000157,TRX_N-00936-90865752,2024-03-28T19:24:10,Vitoria-Gasteiz,Expense,cash,-100.0,-51587.51
buyer_6,Manuel,45,ES45209554403228000157,TRX_N-00937-49541463,2024-03-29T12:11:04,Vitoria-Gasteiz,Expense,leisure,-77.58,-51665.09
buyer_6,Manuel,45,ES45209554403228000157,TRX_N-00938-03570634,2024-03-30T12:35:45,Vitoria-Gasteiz,Expense,food,-91.57,-51756.66
buyer_6,Manuel,45,ES45209554403228000157,TRX_N-00939-89639343,2024-03-31T17:41:10,Vitoria-Gasteiz,Expense,healthcare,-52.54,-51809.2
buyer_6,Manuel,45,ES45209554403228000157,TRX_N-00940-17343448,2024-03-31T13:48:04,Labastida,Expense,cash,-100.0,-51909.2
buyer_6,Manuel,45,ES45209554403228000157,TRX_N-00941-26649292,2024-04-01T17:18:55,Vitoria-Gasteiz,incomes,salary,1595.28,-50313.92
buyer_6,Manuel,45,ES45209554403228000157,TRX_N-00942-60974504,2024-04-01T17:18:55,Vitoria-Gasteiz,incomes,salary_partner,1090.58,-49223.34
buyer_6,Manuel,45,ES45209554403228000157,TRX_N-00943-01138172,2024-04-01T13:36:33,Vitoria-Gasteiz,Expense,clothing,-149.28,-49372.62
buyer_6,Manuel,45,ES45209554403228000157,TRX_N-00944-85729583,2024-04-02T09:32:49,Vitoria-Gasteiz,Expense,food,-82.38,-49455.0
buyer_6,Manuel,45,ES45209554403228000157,TRX_N-00945-73613562,2024-04-03T09:12:25,Vitoria-Gasteiz,Expense,transport,-51.01,-49506.01
buyer_6,Manuel,45,ES45209554403228000157,TRX_N-00946-08700969,2024-04-03T18:13:31,Vitoria-Gasteiz,Expense,cash,-100.0,-49606.01
buyer_6,Manuel,45,ES45209554403228000157,TRX_N-00947-24262486,2024-04-03T16:28:53,Vitoria-Gasteiz,Expense,repairs,-203.51,-49809.52
buyer_6,Manuel,45,ES45209554403228000157,TRX_N-00948-22898265,2024-04-04T11:16:11,Vitoria-Gasteiz,expenses,mortgage,-842.56,-50652.08
buyer_6,Manuel,45,ES45209554403228000157,TRX_N-00949-55114950,2024-04-05T09:26:30,Vitoria-Gasteiz,Expense,food,-100.63,-50752.71
buyer_6,Manuel,45,ES45209554403228000157,TRX_N-00950-50158258,2024-04-07T13:47:00,Vitoria-Gasteiz,expenses,water,-29.75,-50782.46
buyer_6,Manuel,45,ES45209554403228000157,TRX_N-00951-62841028,2024-04-07T18:56:11,Vitoria-Gasteiz,expenses,electricity,-87.2,-50869.66
buyer_6,Manuel,45,ES45209554403228000157,TRX_N-00952-43266043,2024-04-07T07:19:37,Vitoria-Gasteiz,expenses,phone,-44.24,-50913.9
buyer_6,Manuel,45,ES45209554403228000157,TRX_N-00953-18132124,2024-04-08T14:59:55,Vitoria-Gasteiz,expenses,internet,-42.0,-50955.9
buyer_6,Manuel,45,ES45209554403228000157,TRX_N-00954-05074358,2024-04-08T16:36:10,Vitoria-Gasteiz,expenses,gas,-79.72,-51035.62
buyer_6,Manuel,45,ES45209554403228000157,TRX_N-00955-20723348,2024-04-10T10:09:40,Vitoria-Gasteiz,Expense,food,-117.42,-51153.04
buyer_6,Manuel,45,ES45209554403228000157,TRX_N-00956-36389977,2024-04-10T20:16:02,Vitoria-Gasteiz,Expense,leisure,-55.4,-51208.44
buyer_6,Manuel,45,ES45209554403228000157,TRX_N-00957-24028634,2024-04-11T11:51:09,Vitoria-Gasteiz,Expense,food,-108.59,-51317.03
buyer_6,Manuel,45,ES45209554403228000157,TRX_N-00958-15872618,2024-04-12T15:45:37,Vitoria-Gasteiz,Expense,leisure,-55.19,-51372.22
buyer_6,Manuel,45,ES45209554403228000157,TRX_N-00959-91501207,2024-04-13T12:03:17,Vitoria-Gasteiz,Expense,cash,-100.0,-51472.22
buyer_6,Manuel,45,ES45209554403228000157,TRX_N-00960-90380166,2024-04-14T11:31:23,Vitoria-Gasteiz,Expense,food,-105.77,-51577.99
buyer_6,Manuel,45,ES45209554403228000157,TRX_N-00961-61796759,2024-04-14T10:39:31,Vitoria-Gasteiz,Expense,transport,-46.26,-51624.25
buyer_6,Manuel,45,ES45209554403228000157,TRX_N-00962-41541946,2024-04-14T18:09:36,Berango,Expense,cash,-100.0,-51724.25
buyer_6,Manuel,45,ES45209554403228000157,TRX_N-00963-98584630,2024-04-15T09:56:26,Vitoria-Gasteiz,Expense,appliances,-223.55,-51947.8
buyer_6,Manuel,45,ES45209554403228000157,TRX_N-00964-15723876,2024-04-17T18:42:58,Vitoria-Gasteiz,Expense,transport,-49.89,-51997.69
buyer_6,Manuel,45,ES45209554403228000157,TRX_N-00965-35452523,2024-04-19T15:04:45,Vitoria-Gasteiz,Expense,leisure,-73.23,-52070.92
buyer_6,Manuel,45,ES45209554403228000157,TRX_N-00966-79412285,2024-04-19T15:12:00,Vitoria-Gasteiz,Expense,appliances,-184.58,-52255.5
buyer_6,Manuel,45,ES45209554403228000157,TRX_N-00967-50811052,2024-04-20T10:05:53,Vitoria-Gasteiz,Expense,cash,-100.0,-52355.5
buyer_6,Manuel,45,ES45209554403228000157,TRX_N-00968-32908314,2024-04-22T18:38:10,Vitoria-Gasteiz,Expense,transport,-84.59,-52440.09
buyer_6,Manuel,45,ES45209554403228000157,TRX_N-00969-96053978,2024-04-22T13:05:29,Vitoria-Gasteiz,Expense,leisure,-74.51,-52514.6
buyer_6,Manuel,45,ES45209554403228000157,TRX_N-00970-93189611,2024-04-22T21:55:20,Vitoria-Gasteiz,Expense,cash,-100.0,-52614.6
buyer_6,Manuel,45,ES45209554403228000157,TRX_N-00971-68415335,2024-04-24T12:50:01,Vitoria-Gasteiz,Expense,food,-100.28,-52714.88
buyer_6,Manuel,45,ES45209554403228000157,TRX_N-00972-60404737,2024-04-24T09:55:24,Vitoria-Gasteiz,Expense,cash,-100.0,-52814.88
buyer_6,Manuel,45,ES45209554403228000157,TRX_N-00973-12623646,2024-04-25T16:13:55,Vitoria-Gasteiz,Expense,cash,-100.0,-52914.88
buyer_6,Manuel,45,ES45209554403228000157,TRX_N-00974-70506136,2024-04-26T06:08:43,Leioa,Expense,leisure,-32.46,-52947.34
buyer_6,Manuel,45,ES45209554403228000157,TRX_N-00975-37762346,2024-04-26T18:41:48,Vitoria-Gasteiz,Expense,repairs,-236.67,-53184.01
buyer_6,Manuel,45,ES45209554403228000157,TRX_N-00976-16260815,2024-04-28T18:34:09,Vitoria-Gasteiz,Expense,food,-121.62,-53305.63
buyer_6,Manuel,45,ES45209554403228000157,TRX_N-00977-08460015,2024-04-28T04:38:18,Vitoria-Gasteiz,Expense,leisure,-54.09,-53359.72
buyer_6,Manuel,45,ES45209554403228000157,TRX_N-00978-09879134,2024-04-29T18:11:36,Vitoria-Gasteiz,Expense,transport,-55.09,-53414.81
buyer_6,Manuel,45,ES45209554403228000157,TRX_N-00979-00641316,2024-04-30T11:47:33,Oy√≥n-Oion,Expense,appliances,-386.12,-53800.93
buyer_6,Manuel,45,ES45209554403228000157,TRX_N-00980-86583703,2024-05-01T17:31:31,Vitoria-Gasteiz,incomes,salary,1595.28,-52205.65
buyer_6,Manuel,45,ES45209554403228000157,TRX_N-00981-03881442,2024-05-01T17:31:31,Vitoria-Gasteiz,incomes,salary_partner,1090.58,-51115.07
buyer_6,Manuel,45,ES45209554403228000157,TRX_N-00982-21166281,2024-05-04T16:43:56,Vitoria-Gasteiz,expenses,mortgage,-842.56,-51957.63
buyer_6,Manuel,45,ES45209554403228000157,TRX_N-00983-33994037,2024-05-04T13:09:29,Vitoria-Gasteiz,Expense,cash,-100.0,-52057.63
buyer_6,Manuel,45,ES45209554403228000157,TRX_N-00984-18992773,2024-05-05T18:21:50,Vitoria-Gasteiz,expenses,water,-42.3,-52099.93
buyer_6,Manuel,45,ES45209554403228000157,TRX_N-00985-68761191,2024-05-05T13:19:27,Vitoria-Gasteiz,expenses,electricity,-81.72,-52181.65
buyer_6,Manuel,45,ES45209554403228000157,TRX_N-00986-62856401,2024-05-05T17:41:26,Galdakao,Expense,food,-116.09,-52297.74
buyer_6,Manuel,45,ES45209554403228000157,TRX_N-00987-09456005,2024-05-07T10:39:32,Vitoria-Gasteiz,expenses,internet,-42.0,-52339.74
buyer_6,Manuel,45,ES45209554403228000157,TRX_N-00988-36384689,2024-05-07T22:45:35,Vitoria-Gasteiz,expenses,phone,-31.18,-52370.92
buyer_6,Manuel,45,ES45209554403228000157,TRX_N-00989-65673172,2024-05-07T06:39:58,Vitoria-Gasteiz,Expense,cash,-100.0,-52470.92
buyer_6,Manuel,45,ES45209554403228000157,TRX_N-00990-22074039,2024-05-08T07:01:15,Vitoria-Gasteiz,expenses,gas,-82.68,-52553.6
buyer_6,Manuel,45,ES45209554403228000157,TRX_N-00991-37217793,2024-05-08T18:05:34,Vitoria-Gasteiz,Expense,healthcare,-114.17,-52667.77
buyer_6,Manuel,45,ES45209554403228000157,TRX_N-00992-64453519,2024-05-08T09:49:29,Vitoria-Gasteiz,Expense,cash,-100.0,-52767.77
buyer_6,Manuel,45,ES45209554403228000157,TRX_N-00993-97394842,2024-05-09T00:24:18,Vitoria-Gasteiz,Expense,leisure,-26.35,-52794.12
buyer_6,Manuel,45,ES45209554403228000157,TRX_N-00994-55492596,2024-05-12T15:34:48,Vitoria-Gasteiz,Expense,leisure,-25.7,-52819.82
buyer_6,Manuel,45,ES45209554403228000157,TRX_N-00995-87042068,2024-05-12T10:17:48,Santurtzi,Expense,education,-55.89,-52875.71
buyer_6,Manuel,45,ES45209554403228000157,TRX_N-00996-30982946,2024-05-12T12:25:14,Vitoria-Gasteiz,Expense,repairs,-329.85,-53205.56
buyer_6,Manuel,45,ES45209554403228000157,TRX_N-00997-86295836,2024-05-13T18:04:19,Vitoria-Gasteiz,Expense,cash,-100.0,-53305.56
buyer_6,Manuel,45,ES45209554403228000157,TRX_N-00998-17310246,2024-05-14T20:41:50,Vitoria-Gasteiz,Expense,food,-102.77,-53408.33
buyer_6,Manuel,45,ES45209554403228000157,TRX_N-00999-97870080,2024-05-20T18:31:33,Vitoria-Gasteiz,Expense,food,-118.38,-53526.71
buyer_6,Manuel,45,ES45209554403228000157,TRX_N-01000-04128128,2024-05-22T15:44:02,Vitoria-Gasteiz,Expense,transport,-89.57,-53616.28
buyer_6,Manuel,45,ES45209554403228000157,TRX_N-01001-23808253,2024-05-22T09:10:16,Arrasate,Expense,education,-48.15,-53664.43
buyer_6,Manuel,45,ES45209554403228000157,TRX_N-01002-65174825,2024-05-23T16:51:41,Vitoria-Gasteiz,Expense,cash,-100.0,-53764.43
buyer_6,Manuel,45,ES45209554403228000157,TRX_N-01003-58853978,2024-05-23T00:10:16,Galdakao,Expense,repairs,-153.26,-53917.69
buyer_6,Manuel,45,ES45209554403228000157,TRX_N-01004-20282759,2024-05-24T16:49:29,Vitoria-Gasteiz,Expense,leisure,-49.5,-53967.19
buyer_6,Manuel,45,ES45209554403228000157,TRX_N-01005-03707433,2024-05-27T17:54:48,Vitoria-Gasteiz,Expense,cash,-100.0,-54067.19
buyer_6,Manuel,45,ES45209554403228000157,TRX_N-01006-72923951,2024-05-28T13:40:15,Vitoria-Gasteiz,Expense,cash,-100.0,-54167.19
buyer_6,Manuel,45,ES45209554403228000157,TRX_N-01007-99729281,2024-05-29T02:07:21,Vitoria-Gasteiz,Expense,cash,-100.0,-54267.19
buyer_6,Manuel,45,ES45209554403228000157,TRX_N-01008-75765281,2024-06-01T16:16:05,Vitoria-Gasteiz,incomes,salary,1595.28,-52671.91
buyer_6,Manuel,45,ES45209554403228000157,TRX_N-01009-84440600,2024-06-01T16:16:05,Vitoria-Gasteiz,incomes,salary_partner,1090.58,-51581.33
buyer_6,Manuel,45,ES45209554403228000157,TRX_N-01010-92608162,2024-06-01T16:16:05,Vitoria-Gasteiz,incomes,salary_bonus,1123.89,-50457.44
buyer_6,Manuel,45,ES45209554403228000157,TRX_N-01011-07434051,2024-06-01T16:16:05,Vitoria-Gasteiz,incomes,salary_partner_bonus,862.92,-49594.52
buyer_6,Manuel,45,ES45209554403228000157,TRX_N-01012-25128234,2024-06-01T00:06:29,Vitoria-Gasteiz,Expense,food,-124.63,-49719.15
buyer_6,Manuel,45,ES45209554403228000157,TRX_N-01013-37434826,2024-06-01T19:57:23,Vitoria-Gasteiz,Expense,healthcare,-72.36,-49791.51
buyer_6,Manuel,45,ES45209554403228000157,TRX_N-01014-70785853,2024-06-01T15:48:50,Basauri,Expense,gifts,-143.68,-49935.19
buyer_6,Manuel,45,ES45209554403228000157,TRX_N-01015-25260224,2024-06-02T17:20:59,Vitoria-Gasteiz,Expense,cash,-100.0,-50035.19
buyer_6,Manuel,45,ES45209554403228000157,TRX_N-01016-30587761,2024-06-03T08:41:24,Elciego,Expense,education,-78.72,-50113.91
buyer_6,Manuel,45,ES45209554403228000157,TRX_N-01017-53788118,2024-06-04T09:26:35,Vitoria-Gasteiz,expenses,mortgage,-842.56,-50956.47
buyer_6,Manuel,45,ES45209554403228000157,TRX_N-01018-21584090,2024-06-04T08:49:33,Vitoria-Gasteiz,Expense,appliances,-181.28,-51137.75
buyer_6,Manuel,45,ES45209554403228000157,TRX_N-01019-78588361,2024-06-06T11:50:05,Vitoria-Gasteiz,expenses,gas,-36.37,-51174.12
buyer_6,Manuel,45,ES45209554403228000157,TRX_N-01020-29407092,2024-06-06T11:43:29,Vitoria-Gasteiz,expenses,phone,-39.92,-51214.04
buyer_6,Manuel,45,ES45209554403228000157,TRX_N-01021-79143424,2024-06-06T18:23:20,Santurtzi,Expense,food,-96.85,-51310.89
buyer_6,Manuel,45,ES45209554403228000157,TRX_N-01022-22438609,2024-06-07T19:16:49,Vitoria-Gasteiz,Expense,clothing,-128.47,-51439.36
buyer_6,Manuel,45,ES45209554403228000157,TRX_N-01023-06017024,2024-06-07T11:37:39,Vitoria-Gasteiz,Expense,cash,-100.0,-51539.36
buyer_6,Manuel,45,ES45209554403228000157,TRX_N-01024-81769672,2024-06-07T15:41:46,Vitoria-Gasteiz,expenses,children,-226.08,-51765.44
buyer_6,Manuel,45,ES45209554403228000157,TRX_N-01025-17556100,2024-06-08T13:20:59,Vitoria-Gasteiz,expenses,water,-37.44,-51802.88
buyer_6,Manuel,45,ES45209554403228000157,TRX_N-01026-22882324,2024-06-08T15:38:52,Vitoria-Gasteiz,expenses,electricity,-41.31,-51844.19
buyer_6,Manuel,45,ES45209554403228000157,TRX_N-01027-88910872,2024-06-08T12:53:10,Vitoria-Gasteiz,expenses,internet,-42.0,-51886.19
buyer_6,Manuel,45,ES45209554403228000157,TRX_N-01028-53815686,2024-06-09T16:24:18,Vitoria-Gasteiz,expenses,children,-197.78,-52083.97
buyer_6,Manuel,45,ES45209554403228000157,TRX_N-01029-85588730,2024-06-13T14:06:17,Lasarte-Oria,Expense,healthcare,-41.18,-52125.15
buyer_6,Manuel,45,ES45209554403228000157,TRX_N-01030-19822172,2024-06-16T03:47:58,Bilbao,Expense,food,-94.35,-52219.5
buyer_6,Manuel,45,ES45209554403228000157,TRX_N-01031-14640825,2024-06-16T12:57:33,Vitoria-Gasteiz,Expense,appliances,-345.4,-52564.9
buyer_6,Manuel,45,ES45209554403228000157,TRX_N-01032-16105732,2024-06-18T18:34:25,Vitoria-Gasteiz,Expense,transport,-58.49,-52623.39
buyer_6,Manuel,45,ES45209554403228000157,TRX_N-01033-59574201,2024-06-18T09:27:06,Vitoria-Gasteiz,Expense,repairs,-291.89,-52915.28
buyer_6,Manuel,45,ES45209554403228000157,TRX_N-01034-24889592,2024-06-18T15:45:00,Vitoria-Gasteiz,expenses,children,-93.93,-53009.21
buyer_6,Manuel,45,ES45209554403228000157,TRX_N-01035-09007873,2024-06-19T08:08:44,Vitoria-Gasteiz,Expense,leisure,-61.27,-53070.48
buyer_6,Manuel,45,ES45209554403228000157,TRX_N-01036-03273637,2024-06-19T08:27:46,Vitoria-Gasteiz,expenses,children,-121.73,-53192.21
buyer_6,Manuel,45,ES45209554403228000157,TRX_N-01037-26249034,2024-06-20T18:44:40,Vitoria-Gasteiz,Expense,appliances,-168.38,-53360.59
buyer_6,Manuel,45,ES45209554403228000157,TRX_N-01038-40440140,2024-06-21T20:50:26,Vitoria-Gasteiz,Expense,repairs,-93.19,-53453.78
buyer_6,Manuel,45,ES45209554403228000157,TRX_N-01039-49227991,2024-06-23T11:35:30,Vitoria-Gasteiz,Expense,cash,-100.0,-53553.78
buyer_6,Manuel,45,ES45209554403228000157,TRX_N-01040-05524869,2024-06-24T11:31:46,Hernani,Expense,gifts,-103.62,-53657.4
buyer_6,Manuel,45,ES45209554403228000157,TRX_N-01041-41221830,2024-06-25T18:09:41,Vitoria-Gasteiz,Expense,food,-67.73,-53725.13
buyer_6,Manuel,45,ES45209554403228000157,TRX_N-01042-33777923,2024-06-28T12:03:52,Llodio,Expense,leisure,-68.26,-53793.39
buyer_6,Manuel,45,ES45209554403228000157,TRX_N-01043-07387509,2024-06-29T17:48:22,Vitoria-Gasteiz,Expense,leisure,-24.88,-53818.27
buyer_6,Manuel,45,ES45209554403228000157,TRX_N-01044-54638965,2024-06-29T10:57:28,Vitoria-Gasteiz,Expense,clothing,-103.58,-53921.85
buyer_6,Manuel,45,ES45209554403228000157,TRX_N-01045-96573442,2024-06-29T13:51:14,Vitoria-Gasteiz,expenses,children,-204.03,-54125.88
buyer_6,Manuel,45,ES45209554403228000157,TRX_N-01046-63922293,2024-07-01T04:12:21,Vitoria-Gasteiz,incomes,salary,1595.28,-52530.6
buyer_6,Manuel,45,ES45209554403228000157,TRX_N-01047-90683091,2024-07-01T04:12:21,Vitoria-Gasteiz,incomes,salary_partner,1090.58,-51440.02
buyer_6,Manuel,45,ES45209554403228000157,TRX_N-01048-11016430,2024-07-01T04:12:21,Vitoria-Gasteiz,incomes,extra_income,251.7,-51188.32
buyer_6,Manuel,45,ES45209554403228000157,TRX_N-01049-73582200,2024-07-01T20:08:30,Lasarte-Oria,Expense,food,-93.44,-51281.76
buyer_6,Manuel,45,ES45209554403228000157,TRX_N-01050-67406228,2024-07-02T08:53:14,Vitoria-Gasteiz,Expense,clothing,-59.13,-51340.89
buyer_6,Manuel,45,ES45209554403228000157,TRX_N-01051-03189137,2024-07-03T17:00:49,Vitoria-Gasteiz,Expense,cash,-100.0,-51440.89
buyer_6,Manuel,45,ES45209554403228000157,TRX_N-01052-35962015,2024-07-04T19:09:08,Vitoria-Gasteiz,expenses,mortgage,-842.56,-52283.45
buyer_6,Manuel,45,ES45209554403228000157,TRX_N-01053-37300924,2024-07-04T19:35:00,Llodio,Expense,appliances,-211.99,-52495.44
buyer_6,Manuel,45,ES45209554403228000157,TRX_N-01054-87976162,2024-07-05T14:19:46,Vitoria-Gasteiz,expenses,phone,-36.72,-52532.16
buyer_6,Manuel,45,ES45209554403228000157,TRX_N-01055-62699676,2024-07-05T21:50:07,Vitoria-Gasteiz,Expense,cash,-100.0,-52632.16
buyer_6,Manuel,45,ES45209554403228000157,TRX_N-01056-44862195,2024-07-06T19:26:40,Vitoria-Gasteiz,expenses,internet,-42.0,-52674.16
buyer_6,Manuel,45,ES45209554403228000157,TRX_N-01057-70226355,2024-07-06T01:47:49,Andoain,Expense,leisure,-76.8,-52750.96
buyer_6,Manuel,45,ES45209554403228000157,TRX_N-01058-47930481,2024-07-07T15:18:58,Vitoria-Gasteiz,expenses,water,-25.13,-52776.09
buyer_6,Manuel,45,ES45209554403228000157,TRX_N-01059-47412402,2024-07-08T19:10:21,Vitoria-Gasteiz,expenses,electricity,-22.62,-52798.71
buyer_6,Manuel,45,ES45209554403228000157,TRX_N-01060-51319104,2024-07-08T16:37:28,Vitoria-Gasteiz,expenses,gas,-38.74,-52837.45
buyer_6,Manuel,45,ES45209554403228000157,TRX_N-01061-22029983,2024-07-09T19:36:18,Galdakao,Expense,repairs,-65.77,-52903.22
buyer_6,Manuel,45,ES45209554403228000157,TRX_N-01062-22469006,2024-07-11T13:01:07,Vitoria-Gasteiz,Expense,repairs,-232.36,-53135.58
buyer_6,Manuel,45,ES45209554403228000157,TRX_N-01063-96051689,2024-07-12T18:57:11,Vitoria-Gasteiz,Expense,clothing,-148.62,-53284.2
buyer_6,Manuel,45,ES45209554403228000157,TRX_N-01064-28473546,2024-07-15T11:30:00,Vitoria-Gasteiz,Expense,repairs,-45.59,-53329.79
buyer_6,Manuel,45,ES45209554403228000157,TRX_N-01065-46778553,2024-07-16T22:36:30,Vitoria-Gasteiz,Expense,leisure,-29.57,-53359.36
buyer_6,Manuel,45,ES45209554403228000157,TRX_N-01066-96486466,2024-07-19T20:48:43,Vitoria-Gasteiz,Expense,food,-123.18,-53482.54
buyer_6,Manuel,45,ES45209554403228000157,TRX_N-01067-05668180,2024-07-20T14:41:59,Vitoria-Gasteiz,Expense,cash,-100.0,-53582.54
buyer_6,Manuel,45,ES45209554403228000157,TRX_N-01068-18611135,2024-07-21T18:53:31,Zuia,Expense,food,-87.61,-53670.15
buyer_6,Manuel,45,ES45209554403228000157,TRX_N-01069-67761387,2024-07-23T19:22:54,Vitoria-Gasteiz,Expense,food,-92.1,-53762.25
buyer_6,Manuel,45,ES45209554403228000157,TRX_N-01070-93834244,2024-07-25T15:29:16,Vitoria-Gasteiz,Expense,gifts,-35.19,-53797.44
buyer_6,Manuel,45,ES45209554403228000157,TRX_N-01071-33323717,2024-07-26T11:33:53,Vitoria-Gasteiz,Expense,food,-67.18,-53864.62
buyer_6,Manuel,45,ES45209554403228000157,TRX_N-01072-67897275,2024-07-26T08:08:06,Vitoria-Gasteiz,Expense,repairs,-182.65,-54047.27
buyer_6,Manuel,45,ES45209554403228000157,TRX_N-01073-52420225,2024-07-27T18:06:45,Vitoria-Gasteiz,Expense,transport,-51.96,-54099.23
buyer_6,Manuel,45,ES45209554403228000157,TRX_N-01074-37071950,2024-07-27T08:59:41,Vitoria-Gasteiz,Expense,education,-69.75,-54168.98
buyer_6,Manuel,45,ES45209554403228000157,TRX_N-01075-03525367,2024-08-01T13:14:24,Vitoria-Gasteiz,incomes,salary,1595.28,-52573.7
buyer_6,Manuel,45,ES45209554403228000157,TRX_N-01076-18125903,2024-08-01T13:14:24,Vitoria-Gasteiz,incomes,salary_partner,1090.58,-51483.12
buyer_6,Manuel,45,ES45209554403228000157,TRX_N-01077-01910889,2024-08-01T12:54:45,Vitoria-Gasteiz,Expense,leisure,-27.34,-51510.46
buyer_6,Manuel,45,ES45209554403228000157,TRX_N-01078-46470676,2024-08-02T12:20:00,Vitoria-Gasteiz,Expense,healthcare,-185.65,-51696.11
buyer_6,Manuel,45,ES45209554403228000157,TRX_N-01079-08527393,2024-08-02T09:32:31,Vitoria-Gasteiz,Expense,travel,-1395.91,-53092.02
buyer_6,Manuel,45,ES45209554403228000157,TRX_N-01080-62065971,2024-08-04T12:01:48,Vitoria-Gasteiz,expenses,mortgage,-842.56,-53934.58
buyer_6,Manuel,45,ES45209554403228000157,TRX_N-01081-75614414,2024-08-04T13:25:11,Vitoria-Gasteiz,Expense,food,-113.21,-54047.79
buyer_6,Manuel,45,ES45209554403228000157,TRX_N-01082-85263202,2024-08-04T18:41:34,Vitoria-Gasteiz,Expense,leisure,-28.17,-54075.96
buyer_6,Manuel,45,ES45209554403228000157,TRX_N-01083-73197653,2024-08-04T18:28:12,Vitoria-Gasteiz,Expense,cash,-100.0,-54175.96
buyer_6,Manuel,45,ES45209554403228000157,TRX_N-01084-31719997,2024-08-05T19:51:18,Vitoria-Gasteiz,expenses,electricity,-24.99,-54200.95
buyer_6,Manuel,45,ES45209554403228000157,TRX_N-01085-23280659,2024-08-06T00:17:41,Vitoria-Gasteiz,expenses,internet,-42.0,-54242.95
buyer_6,Manuel,45,ES45209554403228000157,TRX_N-01086-00202634,2024-08-06T17:05:14,Vitoria-Gasteiz,expenses,children,-274.79,-54517.74
buyer_6,Manuel,45,ES45209554403228000157,TRX_N-01087-16229394,2024-08-07T08:23:46,Vitoria-Gasteiz,expenses,water,-31.81,-54549.55
buyer_6,Manuel,45,ES45209554403228000157,TRX_N-01088-23975302,2024-08-07T02:08:19,Vitoria-Gasteiz,expenses,phone,-37.75,-54587.3
buyer_6,Manuel,45,ES45209554403228000157,TRX_N-01089-63281881,2024-08-07T22:48:48,Vitoria-Gasteiz,Expense,repairs,-318.19,-54905.49
buyer_6,Manuel,45,ES45209554403228000157,TRX_N-01090-09153457,2024-08-08T19:57:09,Vitoria-Gasteiz,expenses,gas,-58.47,-54963.96
buyer_6,Manuel,45,ES45209554403228000157,TRX_N-01091-30694705,2024-08-08T20:55:08,Vitoria-Gasteiz,Expense,food,-97.64,-55061.6
buyer_6,Manuel,45,ES45209554403228000157,TRX_N-01092-48262195,2024-08-14T02:28:22,Vitoria-Gasteiz,Expense,cash,-100.0,-55161.6
buyer_6,Manuel,45,ES45209554403228000157,TRX_N-01093-41925691,2024-08-15T09:13:22,Portugalete,Expense,repairs,-36.23,-55197.83
buyer_6,Manuel,45,ES45209554403228000157,TRX_N-01094-00253470,2024-08-16T11:36:17,Vitoria-Gasteiz,Expense,cash,-100.0,-55297.83
buyer_6,Manuel,45,ES45209554403228000157,TRX_N-01095-38533518,2024-08-17T13:35:49,Vitoria-Gasteiz,Expense,transport,-80.38,-55378.21
buyer_6,Manuel,45,ES45209554403228000157,TRX_N-01096-91570927,2024-08-18T09:55:02,Vitoria-Gasteiz,Expense,food,-85.5,-55463.71
buyer_6,Manuel,45,ES45209554403228000157,TRX_N-01097-27154331,2024-08-18T10:18:55,Vitoria-Gasteiz,Expense,appliances,-117.0,-55580.71
buyer_6,Manuel,45,ES45209554403228000157,TRX_N-01098-38913738,2024-08-24T08:56:15,Vitoria-Gasteiz,Expense,food,-84.15,-55664.86
buyer_6,Manuel,45,ES45209554403228000157,TRX_N-01099-59941977,2024-08-24T18:57:10,Vitoria-Gasteiz,expenses,children,-143.62,-55808.48
buyer_6,Manuel,45,ES45209554403228000157,TRX_N-01100-82149509,2024-08-25T14:39:10,Vitoria-Gasteiz,Expense,transport,-80.69,-55889.17
buyer_6,Manuel,45,ES45209554403228000157,TRX_N-01101-27276920,2024-08-25T18:18:45,Vitoria-Gasteiz,Expense,leisure,-78.36,-55967.53
buyer_6,Manuel,45,ES45209554403228000157,TRX_N-01102-97146328,2024-08-28T13:30:15,Vitoria-Gasteiz,Expense,leisure,-18.63,-55986.16
buyer_6,Manuel,45,ES45209554403228000157,TRX_N-01103-64688517,2024-08-28T09:32:26,Vitoria-Gasteiz,Expense,cash,-100.0,-56086.16
buyer_6,Manuel,45,ES45209554403228000157,TRX_N-01104-38899527,2024-08-28T15:32:13,Vitoria-Gasteiz,Expense,travel,-775.71,-56861.87
buyer_6,Manuel,45,ES45209554403228000157,TRX_N-01105-21425153,2024-08-28T18:21:46,Santurtzi,Expense,repairs,-194.1,-57055.97
buyer_6,Manuel,45,ES45209554403228000157,TRX_N-01106-69252100,2024-08-29T10:10:58,Salvatierra/Agurain,Expense,food,-93.68,-57149.65
buyer_6,Manuel,45,ES45209554403228000157,TRX_N-01107-04508432,2024-08-29T09:07:04,Vitoria-Gasteiz,Expense,cash,-100.0,-57249.65
buyer_6,Manuel,45,ES45209554403228000157,TRX_N-01108-05285594,2024-08-30T09:06:46,Vitoria-Gasteiz,Expense,transport,-42.27,-57291.92
buyer_6,Manuel,45,ES45209554403228000157,TRX_N-01109-55927727,2024-08-31T08:42:37,Vitoria-Gasteiz,Expense,cash,-100.0,-57391.92
buyer_6,Manuel,45,ES45209554403228000157,TRX_N-01110-56297279,2024-09-01T02:40:49,Vitoria-Gasteiz,incomes,salary,1595.28,-55796.64
buyer_6,Manuel,45,ES45209554403228000157,TRX_N-01111-06147561,2024-09-01T02:40:49,Vitoria-Gasteiz,incomes,salary_partner,1090.58,-54706.06
buyer_6,Manuel,45,ES45209554403228000157,TRX_N-01112-28958965,2024-09-04T19:53:07,Vitoria-Gasteiz,expenses,mortgage,-842.56,-55548.62
buyer_6,Manuel,45,ES45209554403228000157,TRX_N-01113-88678753,2024-09-04T08:35:12,Vitoria-Gasteiz,Expense,cash,-100.0,-55648.62
buyer_6,Manuel,45,ES45209554403228000157,TRX_N-01114-09624875,2024-09-04T14:49:07,Andoain,Expense,appliances,-373.17,-56021.79
buyer_6,Manuel,45,ES45209554403228000157,TRX_N-01115-33851904,2024-09-05T15:27:06,Vitoria-Gasteiz,expenses,water,-40.26,-56062.05
buyer_6,Manuel,45,ES45209554403228000157,TRX_N-01116-12060076,2024-09-05T15:22:30,Vitoria-Gasteiz,Expense,transport,-88.95,-56151.0
buyer_6,Manuel,45,ES45209554403228000157,TRX_N-01117-25574667,2024-09-05T08:12:50,Vitoria-Gasteiz,Expense,leisure,-33.14,-56184.14
buyer_6,Manuel,45,ES45209554403228000157,TRX_N-01118-20036314,2024-09-06T15:16:45,Vitoria-Gasteiz,expenses,electricity,-44.35,-56228.49
buyer_6,Manuel,45,ES45209554403228000157,TRX_N-01119-04230857,2024-09-06T09:57:44,Vitoria-Gasteiz,expenses,internet,-42.0,-56270.49
buyer_6,Manuel,45,ES45209554403228000157,TRX_N-01120-55644233,2024-09-06T13:48:26,Vitoria-Gasteiz,Expense,transport,-67.88,-56338.37
buyer_6,Manuel,45,ES45209554403228000157,TRX_N-01121-46720841,2024-09-06T14:05:05,Eibar,Expense,education,-43.17,-56381.54
buyer_6,Manuel,45,ES45209554403228000157,TRX_N-01122-98077293,2024-09-07T15:27:59,Vitoria-Gasteiz,Expense,cash,-100.0,-56481.54
buyer_6,Manuel,45,ES45209554403228000157,TRX_N-01123-69570663,2024-09-08T19:23:49,Vitoria-Gasteiz,expenses,gas,-86.63,-56568.17
buyer_6,Manuel,45,ES45209554403228000157,TRX_N-01124-46401338,2024-09-08T19:10:54,Vitoria-Gasteiz,expenses,phone,-31.66,-56599.83
buyer_6,Manuel,45,ES45209554403228000157,TRX_N-01125-10786114,2024-09-08T09:02:13,Vitoria-Gasteiz,Expense,leisure,-66.23,-56666.06
buyer_6,Manuel,45,ES45209554403228000157,TRX_N-01126-38475822,2024-09-08T14:13:09,Hernani,Expense,gifts,-127.99,-56794.05
buyer_6,Manuel,45,ES45209554403228000157,TRX_N-01127-60200918,2024-09-08T12:41:32,Vitoria-Gasteiz,expenses,children,-152.86,-56946.91
buyer_6,Manuel,45,ES45209554403228000157,TRX_N-01128-16539917,2024-09-12T16:10:42,Vitoria-Gasteiz,Expense,leisure,-61.18,-57008.09
buyer_6,Manuel,45,ES45209554403228000157,TRX_N-01129-44808865,2024-09-13T12:37:18,Vitoria-Gasteiz,Expense,healthcare,-52.31,-57060.4
buyer_6,Manuel,45,ES45209554403228000157,TRX_N-01130-82354539,2024-09-15T12:36:59,Vitoria-Gasteiz,Expense,leisure,-31.47,-57091.87
buyer_6,Manuel,45,ES45209554403228000157,TRX_N-01131-75700662,2024-09-15T23:46:56,Vitoria-Gasteiz,Expense,gifts,-380.8,-57472.67
buyer_6,Manuel,45,ES45209554403228000157,TRX_N-01132-93662134,2024-09-16T08:11:35,Galdakao,Expense,repairs,-30.28,-57502.95
buyer_6,Manuel,45,ES45209554403228000157,TRX_N-01133-01444754,2024-09-17T14:59:12,Iru√±a de Oca,Expense,clothing,-50.57,-57553.52
buyer_6,Manuel,45,ES45209554403228000157,TRX_N-01134-83279118,2024-09-20T07:17:28,Vitoria-Gasteiz,Expense,transport,-63.95,-57617.47
buyer_6,Manuel,45,ES45209554403228000157,TRX_N-01135-99608509,2024-09-21T09:14:01,Irun,Expense,clothing,-116.87,-57734.34
buyer_6,Manuel,45,ES45209554403228000157,TRX_N-01136-28456486,2024-09-21T05:46:49,Vitoria-Gasteiz,expenses,children,-160.17,-57894.51
buyer_6,Manuel,45,ES45209554403228000157,TRX_N-01137-03184364,2024-09-23T14:12:13,Basauri,Expense,food,-75.52,-57970.03
buyer_6,Manuel,45,ES45209554403228000157,TRX_N-01138-20335312,2024-09-23T16:11:49,Vitoria-Gasteiz,Expense,leisure,-49.69,-58019.72
buyer_6,Manuel,45,ES45209554403228000157,TRX_N-01139-10304683,2024-09-25T22:42:21,Galdakao,Expense,cash,-100.0,-58119.72
buyer_6,Manuel,45,ES45209554403228000157,TRX_N-01140-90276716,2024-09-25T14:19:59,Vitoria-Gasteiz,Expense,gifts,-293.98,-58413.7
buyer_6,Manuel,45,ES45209554403228000157,TRX_N-01141-78483914,2024-09-26T08:04:23,Vitoria-Gasteiz,Expense,cash,-100.0,-58513.7
buyer_6,Manuel,45,ES45209554403228000157,TRX_N-01142-18765079,2024-09-27T16:50:01,Vitoria-Gasteiz,Expense,food,-92.32,-58606.02
buyer_6,Manuel,45,ES45209554403228000157,TRX_N-01143-03920416,2024-09-28T14:40:59,Vitoria-Gasteiz,expenses,children,-59.34,-58665.36
buyer_6,Manuel,45,ES45209554403228000157,TRX_N-01144-84468761,2024-09-29T22:35:40,Vitoria-Gasteiz,Expense,transport,-85.29,-58750.65
buyer_6,Manuel,45,ES45209554403228000157,TRX_N-01145-74697575,2024-09-30T01:54:41,Vitoria-Gasteiz,Expense,cash,-100.0,-58850.65
buyer_6,Manuel,45,ES45209554403228000157,TRX_N-01146-50448427,2024-10-01T12:40:31,Vitoria-Gasteiz,incomes,salary,1595.28,-57255.37
buyer_6,Manuel,45,ES45209554403228000157,TRX_N-01147-37595998,2024-10-01T12:40:31,Vitoria-Gasteiz,incomes,salary_partner,1090.58,-56164.79
buyer_6,Manuel,45,ES45209554403228000157,TRX_N-01148-51030269,2024-10-01T21:24:53,Andoain,Expense,gifts,-432.92,-56597.71
buyer_6,Manuel,45,ES45209554403228000157,TRX_N-01149-83919192,2024-10-02T17:54:09,Vitoria-Gasteiz,Expense,healthcare,-168.98,-56766.69
buyer_6,Manuel,45,ES45209554403228000157,TRX_N-01150-68947654,2024-10-04T18:34:05,Vitoria-Gasteiz,expenses,mortgage,-842.56,-57609.25
buyer_6,Manuel,45,ES45209554403228000157,TRX_N-01151-52318510,2024-10-04T16:18:42,Vitoria-Gasteiz,Expense,food,-71.28,-57680.53
buyer_6,Manuel,45,ES45209554403228000157,TRX_N-01152-13862790,2024-10-04T12:15:12,Vitoria-Gasteiz,Expense,leisure,-37.98,-57718.51
buyer_6,Manuel,45,ES45209554403228000157,TRX_N-01153-55975202,2024-10-04T17:35:04,Vitoria-Gasteiz,Expense,education,-65.44,-57783.95
buyer_6,Manuel,45,ES45209554403228000157,TRX_N-01154-09383856,2024-10-05T10:22:24,Vitoria-Gasteiz,expenses,electricity,-76.74,-57860.69
buyer_6,Manuel,45,ES45209554403228000157,TRX_N-01155-72974394,2024-10-05T18:49:02,Alegr√≠a-Dulantzi,Expense,leisure,-59.36,-57920.05
buyer_6,Manuel,45,ES45209554403228000157,TRX_N-01156-07336327,2024-10-06T20:33:14,Vitoria-Gasteiz,expenses,phone,-39.91,-57959.96
buyer_6,Manuel,45,ES45209554403228000157,TRX_N-01157-94857444,2024-10-06T03:04:22,Vitoria-Gasteiz,Expense,repairs,-161.25,-58121.21
buyer_6,Manuel,45,ES45209554403228000157,TRX_N-01158-10362491,2024-10-07T09:11:34,Vitoria-Gasteiz,Expense,food,-79.82,-58201.03
buyer_6,Manuel,45,ES45209554403228000157,TRX_N-01159-91869967,2024-10-08T15:47:50,Vitoria-Gasteiz,expenses,gas,-36.22,-58237.25
buyer_6,Manuel,45,ES45209554403228000157,TRX_N-01160-92080949,2024-10-08T10:49:48,Vitoria-Gasteiz,expenses,water,-26.85,-58264.1
buyer_6,Manuel,45,ES45209554403228000157,TRX_N-01161-21349750,2024-10-08T13:43:12,Vitoria-Gasteiz,expenses,internet,-42.0,-58306.1
buyer_6,Manuel,45,ES45209554403228000157,TRX_N-01162-64216580,2024-10-08T01:26:26,Vitoria-Gasteiz,Expense,food,-74.47,-58380.57
buyer_7,Mar√≠a,56,ES69209598874776399917,TRX_N-00001-82802458,2022-01-01T12:13:10,Portugalete,incomes,salary,1380.62,3226.77
buyer_7,Mar√≠a,56,ES69209598874776399917,TRX_N-00002-37422378,2022-01-01T12:13:10,Portugalete,incomes,salary_partner,1282.12,4508.89
buyer_7,Mar√≠a,56,ES69209598874776399917,TRX_N-00003-98074799,2022-01-03T21:05:39,Portugalete,Expense,appliances,-264.17,4244.72
buyer_7,Mar√≠a,56,ES69209598874776399917,TRX_N-00004-92223850,2022-01-04T08:21:16,Portugalete,expenses,mortgage,-866.4,3378.32
buyer_7,Mar√≠a,56,ES69209598874776399917,TRX_N-00005-00872067,2022-01-04T15:38:21,Portugalete,Expense,leisure,-30.37,3347.95
buyer_7,Mar√≠a,56,ES69209598874776399917,TRX_N-00006-86208883,2022-01-05T08:12:17,Portugalete,expenses,electricity,-63.98,3283.97
buyer_7,Mar√≠a,56,ES69209598874776399917,TRX_N-00007-07785534,2022-01-06T08:52:08,Portugalete,expenses,gas,-65.18,3218.79
buyer_7,Mar√≠a,56,ES69209598874776399917,TRX_N-00008-90864730,2022-01-06T12:50:54,Portugalete,expenses,internet,-42.0,3176.79
buyer_7,Mar√≠a,56,ES69209598874776399917,TRX_N-00009-85946671,2022-01-06T13:52:27,Portugalete,expenses,phone,-40.9,3135.89
buyer_7,Mar√≠a,56,ES69209598874776399917,TRX_N-00010-69833663,2022-01-06T15:27:59,Portugalete,Expense,repairs,-38.05,3097.84
buyer_7,Mar√≠a,56,ES69209598874776399917,TRX_N-00011-81543748,2022-01-07T12:16:27,Portugalete,expenses,water,-34.25,3063.59
buyer_7,Mar√≠a,56,ES69209598874776399917,TRX_N-00012-15302100,2022-01-11T19:50:29,Portugalete,Expense,food,-112.14,2951.45
buyer_7,Mar√≠a,56,ES69209598874776399917,TRX_N-00013-32507579,2022-01-11T08:05:47,Portugalete,Expense,gifts,-96.24,2855.21
buyer_7,Mar√≠a,56,ES69209598874776399917,TRX_N-00014-35799977,2022-01-13T12:52:42,Portugalete,Expense,clothing,-57.66,2797.55
buyer_7,Mar√≠a,56,ES69209598874776399917,TRX_N-00015-08161679,2022-01-13T18:34:08,Llodio,Expense,cash,-100.0,2697.55
buyer_7,Mar√≠a,56,ES69209598874776399917,TRX_N-00016-93119262,2022-01-15T12:28:23,Portugalete,Expense,transport,-45.06,2652.49
buyer_7,Mar√≠a,56,ES69209598874776399917,TRX_N-00017-45983534,2022-01-15T19:03:12,Portugalete,Expense,gifts,-303.71,2348.78
buyer_7,Mar√≠a,56,ES69209598874776399917,TRX_N-00018-57725174,2022-01-16T19:48:18,Mungia,Expense,food,-61.14,2287.64
buyer_7,Mar√≠a,56,ES69209598874776399917,TRX_N-00019-04684763,2022-01-19T16:46:43,Portugalete,Expense,clothing,-106.14,2181.5
buyer_7,Mar√≠a,56,ES69209598874776399917,TRX_N-00020-68576450,2022-01-21T15:00:33,Barakaldo,Expense,food,-117.77,2063.73
buyer_7,Mar√≠a,56,ES69209598874776399917,TRX_N-00021-43973217,2022-01-21T17:06:44,Portugalete,Expense,cash,-100.0,1963.73
buyer_7,Mar√≠a,56,ES69209598874776399917,TRX_N-00022-23206685,2022-01-21T09:59:09,Portugalete,Expense,gifts,-99.93,1863.8
buyer_7,Mar√≠a,56,ES69209598874776399917,TRX_N-00023-21699635,2022-01-22T15:04:45,Portugalete,Expense,cash,-100.0,1763.8
buyer_7,Mar√≠a,56,ES69209598874776399917,TRX_N-00024-15573651,2022-01-25T13:33:52,Durango,Expense,gifts,-209.73,1554.07
buyer_7,Mar√≠a,56,ES69209598874776399917,TRX_N-00025-51278374,2022-01-27T20:40:51,Portugalete,Expense,repairs,-137.22,1416.85
buyer_7,Mar√≠a,56,ES69209598874776399917,TRX_N-00026-76894271,2022-01-28T16:06:36,Portugalete,Expense,healthcare,-111.01,1305.84
buyer_7,Mar√≠a,56,ES69209598874776399917,TRX_N-00027-55633891,2022-01-30T08:57:54,Portugalete,Expense,gifts,-143.65,1162.19
buyer_7,Mar√≠a,56,ES69209598874776399917,TRX_N-00028-38266130,2022-01-31T21:35:17,Portugalete,Expense,cash,-100.0,1062.19
buyer_7,Mar√≠a,56,ES69209598874776399917,TRX_N-00029-59504674,2022-02-01T06:00:41,Portugalete,incomes,salary,1380.62,2442.81
buyer_7,Mar√≠a,56,ES69209598874776399917,TRX_N-00030-27775756,2022-02-01T06:00:41,Portugalete,incomes,salary_partner,1282.12,3724.93
buyer_7,Mar√≠a,56,ES69209598874776399917,TRX_N-00031-58776289,2022-02-02T10:10:24,Portugalete,Expense,cash,-100.0,3624.93
buyer_7,Mar√≠a,56,ES69209598874776399917,TRX_N-00032-52329792,2022-02-04T04:52:02,Portugalete,expenses,mortgage,-866.4,2758.53
buyer_7,Mar√≠a,56,ES69209598874776399917,TRX_N-00033-59794296,2022-02-04T17:28:47,Basauri,Expense,leisure,-67.61,2690.92
buyer_7,Mar√≠a,56,ES69209598874776399917,TRX_N-00034-28134612,2022-02-05T17:18:00,Portugalete,expenses,gas,-95.33,2595.59
buyer_7,Mar√≠a,56,ES69209598874776399917,TRX_N-00035-15911852,2022-02-05T17:03:32,Portugalete,expenses,internet,-42.0,2553.59
buyer_7,Mar√≠a,56,ES69209598874776399917,TRX_N-00036-58070515,2022-02-06T14:23:14,Portugalete,expenses,electricity,-63.9,2489.69
buyer_7,Mar√≠a,56,ES69209598874776399917,TRX_N-00037-22843560,2022-02-06T20:40:33,Portugalete,Expense,food,-61.34,2428.35
buyer_7,Mar√≠a,56,ES69209598874776399917,TRX_N-00038-68384757,2022-02-06T08:23:05,Portugalete,Expense,leisure,-24.3,2404.05
buyer_7,Mar√≠a,56,ES69209598874776399917,TRX_N-00039-90526254,2022-02-07T09:52:10,Portugalete,Expense,transport,-63.54,2340.51
buyer_7,Mar√≠a,56,ES69209598874776399917,TRX_N-00040-44372695,2022-02-08T08:55:22,Portugalete,expenses,water,-41.15,2299.36
buyer_7,Mar√≠a,56,ES69209598874776399917,TRX_N-00041-86750691,2022-02-08T19:07:21,Portugalete,expenses,phone,-33.92,2265.44
buyer_7,Mar√≠a,56,ES69209598874776399917,TRX_N-00042-82172926,2022-02-09T00:48:46,Portugalete,Expense,food,-123.26,2142.18
buyer_7,Mar√≠a,56,ES69209598874776399917,TRX_N-00043-71841314,2022-02-09T17:31:39,Portugalete,Expense,transport,-79.48,2062.7
buyer_7,Mar√≠a,56,ES69209598874776399917,TRX_N-00044-93082241,2022-02-10T20:00:52,Irun,Expense,cash,-100.0,1962.7
buyer_7,Mar√≠a,56,ES69209598874776399917,TRX_N-00045-06388511,2022-02-11T17:40:41,Portugalete,Expense,cash,-100.0,1862.7
buyer_7,Mar√≠a,56,ES69209598874776399917,TRX_N-00046-81340119,2022-02-12T17:36:32,Andoain,Expense,transport,-55.51,1807.19
buyer_7,Mar√≠a,56,ES69209598874776399917,TRX_N-00047-38261927,2022-02-13T12:58:46,Portugalete,Expense,food,-98.4,1708.79
buyer_7,Mar√≠a,56,ES69209598874776399917,TRX_N-00048-74289226,2022-02-13T13:23:34,Portugalete,Expense,cash,-100.0,1608.79
buyer_7,Mar√≠a,56,ES69209598874776399917,TRX_N-00049-50837195,2022-02-14T16:32:50,Portugalete,Expense,gifts,-528.6,1080.19
buyer_7,Mar√≠a,56,ES69209598874776399917,TRX_N-00050-09206687,2022-02-17T19:56:43,Portugalete,Expense,transport,-59.01,1021.18
buyer_7,Mar√≠a,56,ES69209598874776399917,TRX_N-00051-86457589,2022-02-19T17:48:09,Portugalete,Expense,food,-122.37,898.81
buyer_7,Mar√≠a,56,ES69209598874776399917,TRX_N-00052-35312860,2022-02-19T09:29:12,Portugalete,Expense,travel,-565.65,333.16
buyer_7,Mar√≠a,56,ES69209598874776399917,TRX_N-00053-94408779,2022-02-20T05:42:44,Mungia,Expense,food,-96.76,236.4
buyer_7,Mar√≠a,56,ES69209598874776399917,TRX_N-00054-58492308,2022-02-20T18:56:19,Portugalete,expenses,children,-93.58,142.82
buyer_7,Mar√≠a,56,ES69209598874776399917,TRX_N-00055-81214839,2022-02-21T23:37:25,Pasaia,Expense,leisure,-51.15,91.67
buyer_7,Mar√≠a,56,ES69209598874776399917,TRX_N-00056-91663973,2022-02-22T16:25:53,Portugalete,Expense,transport,-71.41,20.26
buyer_7,Mar√≠a,56,ES69209598874776399917,TRX_N-00057-91007054,2022-02-22T17:56:20,Portugalete,Expense,education,-60.62,-40.36
buyer_7,Mar√≠a,56,ES69209598874776399917,TRX_N-00058-65068303,2022-02-22T19:25:18,Portugalete,Expense,gifts,-477.78,-518.14
buyer_7,Mar√≠a,56,ES69209598874776399917,TRX_N-00059-23075090,2022-02-25T21:42:49,Portugalete,Expense,food,-98.72,-616.86
buyer_7,Mar√≠a,56,ES69209598874776399917,TRX_N-00060-47788823,2022-02-25T13:26:00,Portugalete,Expense,leisure,-42.49,-659.35
buyer_7,Mar√≠a,56,ES69209598874776399917,TRX_N-00061-14853180,2022-02-26T17:51:55,Portugalete,Expense,travel,-1478.77,-2138.12
buyer_7,Mar√≠a,56,ES69209598874776399917,TRX_N-00062-55081416,2022-03-01T15:43:36,Portugalete,incomes,salary,1380.62,-757.5
buyer_7,Mar√≠a,56,ES69209598874776399917,TRX_N-00063-57669688,2022-03-01T15:43:36,Portugalete,incomes,salary_partner,1282.12,524.62
buyer_7,Mar√≠a,56,ES69209598874776399917,TRX_N-00064-99655856,2022-03-01T08:03:52,Portugalete,Expense,food,-106.77,417.85
buyer_7,Mar√≠a,56,ES69209598874776399917,TRX_N-00065-16945029,2022-03-01T17:31:22,Portugalete,Expense,gifts,-672.17,-254.32
buyer_7,Mar√≠a,56,ES69209598874776399917,TRX_N-00066-33375712,2022-03-02T13:08:17,Irun,Expense,cash,-100.0,-354.32
buyer_7,Mar√≠a,56,ES69209598874776399917,TRX_N-00067-61814898,2022-03-04T17:21:08,Portugalete,expenses,mortgage,-866.4,-1220.72
buyer_7,Mar√≠a,56,ES69209598874776399917,TRX_N-00068-88659409,2022-03-04T17:55:13,Portugalete,Expense,clothing,-128.81,-1349.53
buyer_7,Mar√≠a,56,ES69209598874776399917,TRX_N-00069-92223279,2022-03-05T12:14:30,Portugalete,expenses,electricity,-71.83,-1421.36
buyer_7,Mar√≠a,56,ES69209598874776399917,TRX_N-00070-95585832,2022-03-05T20:05:49,Portugalete,expenses,gas,-75.38,-1496.74
buyer_7,Mar√≠a,56,ES69209598874776399917,TRX_N-00071-75815053,2022-03-05T12:52:49,Portugalete,expenses,internet,-42.0,-1538.74
buyer_7,Mar√≠a,56,ES69209598874776399917,TRX_N-00072-13328155,2022-03-06T09:56:20,Labastida,Expense,transport,-47.6,-1586.34
buyer_7,Mar√≠a,56,ES69209598874776399917,TRX_N-00073-36947212,2022-03-06T17:18:53,Portugalete,Expense,travel,-1578.94,-3165.28
buyer_7,Mar√≠a,56,ES69209598874776399917,TRX_N-00074-23986360,2022-03-07T18:55:12,Portugalete,expenses,phone,-44.5,-3209.78
buyer_7,Mar√≠a,56,ES69209598874776399917,TRX_N-00075-92575936,2022-03-07T04:28:20,Portugalete,Expense,food,-100.14,-3309.92
buyer_7,Mar√≠a,56,ES69209598874776399917,TRX_N-00076-19239183,2022-03-07T11:16:31,Durango,Expense,transport,-58.68,-3368.6
buyer_7,Mar√≠a,56,ES69209598874776399917,TRX_N-00077-87357495,2022-03-07T20:45:57,Berango,Expense,gifts,-301.96,-3670.56
buyer_7,Mar√≠a,56,ES69209598874776399917,TRX_N-00078-85107889,2022-03-08T13:55:41,Portugalete,expenses,water,-37.46,-3708.02
buyer_7,Mar√≠a,56,ES69209598874776399917,TRX_N-00079-63601767,2022-03-08T15:31:14,Alegr√≠a-Dulantzi,Expense,cash,-100.0,-3808.02
buyer_7,Mar√≠a,56,ES69209598874776399917,TRX_N-00080-18510137,2022-03-09T14:04:47,Portugalete,expenses,children,-133.48,-3941.5
buyer_7,Mar√≠a,56,ES69209598874776399917,TRX_N-00081-67360357,2022-03-11T19:24:47,Portugalete,Expense,food,-112.42,-4053.92
buyer_7,Mar√≠a,56,ES69209598874776399917,TRX_N-00082-14405074,2022-03-11T19:58:02,Leioa,Expense,leisure,-63.3,-4117.22
buyer_7,Mar√≠a,56,ES69209598874776399917,TRX_N-00083-72824821,2022-03-12T23:44:06,Portugalete,Expense,transport,-50.63,-4167.85
buyer_7,Mar√≠a,56,ES69209598874776399917,TRX_N-00084-35476817,2022-03-12T20:11:26,Portugalete,Expense,healthcare,-77.53,-4245.38
buyer_7,Mar√≠a,56,ES69209598874776399917,TRX_N-00085-46605320,2022-03-13T14:22:42,Portugalete,expenses,children,-170.45,-4415.83
buyer_7,Mar√≠a,56,ES69209598874776399917,TRX_N-00086-02006294,2022-03-14T21:29:51,Portugalete,Expense,repairs,-109.76,-4525.59
buyer_7,Mar√≠a,56,ES69209598874776399917,TRX_N-00087-61648777,2022-03-14T22:04:37,Portugalete,Expense,gifts,-517.91,-5043.5
buyer_7,Mar√≠a,56,ES69209598874776399917,TRX_N-00088-19454030,2022-03-15T09:21:02,Portugalete,Expense,healthcare,-107.08,-5150.58
buyer_7,Mar√≠a,56,ES69209598874776399917,TRX_N-00089-56543282,2022-03-15T12:53:27,Eibar,Expense,repairs,-226.47,-5377.05
buyer_7,Mar√≠a,56,ES69209598874776399917,TRX_N-00090-46036386,2022-03-17T15:09:41,Portugalete,Expense,cash,-100.0,-5477.05
buyer_7,Mar√≠a,56,ES69209598874776399917,TRX_N-00091-28299701,2022-03-17T20:23:25,Portugalete,expenses,children,-141.72,-5618.77
buyer_7,Mar√≠a,56,ES69209598874776399917,TRX_N-00092-32368891,2022-03-22T09:44:01,Portugalete,Expense,leisure,-63.1,-5681.87
buyer_7,Mar√≠a,56,ES69209598874776399917,TRX_N-00093-93088663,2022-03-23T16:24:47,Portugalete,Expense,appliances,-83.02,-5764.89
buyer_7,Mar√≠a,56,ES69209598874776399917,TRX_N-00094-64037504,2022-03-24T21:43:27,Portugalete,Expense,transport,-86.78,-5851.67
buyer_7,Mar√≠a,56,ES69209598874776399917,TRX_N-00095-55415382,2022-03-24T17:32:57,Portugalete,Expense,education,-66.39,-5918.06
buyer_7,Mar√≠a,56,ES69209598874776399917,TRX_N-00096-69357555,2022-03-25T01:28:23,Portugalete,Expense,leisure,-43.47,-5961.53
buyer_7,Mar√≠a,56,ES69209598874776399917,TRX_N-00097-28554084,2022-03-25T12:58:45,Portugalete,Expense,cash,-100.0,-6061.53
buyer_7,Mar√≠a,56,ES69209598874776399917,TRX_N-00098-09751366,2022-03-28T22:33:27,Portugalete,Expense,transport,-40.56,-6102.09
buyer_7,Mar√≠a,56,ES69209598874776399917,TRX_N-00099-66106421,2022-03-29T00:50:26,Portugalete,Expense,repairs,-99.82,-6201.91
buyer_7,Mar√≠a,56,ES69209598874776399917,TRX_N-00100-62337100,2022-03-30T13:38:45,Portugalete,Expense,food,-67.01,-6268.92
buyer_7,Mar√≠a,56,ES69209598874776399917,TRX_N-00101-54159992,2022-04-01T19:46:47,Portugalete,incomes,salary,1380.62,-4888.3
buyer_7,Mar√≠a,56,ES69209598874776399917,TRX_N-00102-92510051,2022-04-01T19:46:47,Portugalete,incomes,salary_partner,1282.12,-3606.18
buyer_7,Mar√≠a,56,ES69209598874776399917,TRX_N-00103-45095344,2022-04-01T19:46:47,Portugalete,incomes,extra_income,160.8,-3445.38
buyer_7,Mar√≠a,56,ES69209598874776399917,TRX_N-00104-70312222,2022-04-01T13:14:56,Portugalete,Expense,appliances,-84.65,-3530.03
buyer_7,Mar√≠a,56,ES69209598874776399917,TRX_N-00105-33623316,2022-04-02T17:12:12,Pasaia,Expense,food,-70.97,-3601.0
buyer_7,Mar√≠a,56,ES69209598874776399917,TRX_N-00106-43858575,2022-04-03T21:10:59,Portugalete,Expense,cash,-100.0,-3701.0
buyer_7,Mar√≠a,56,ES69209598874776399917,TRX_N-00107-69435060,2022-04-04T09:38:52,Portugalete,expenses,mortgage,-866.4,-4567.4
buyer_7,Mar√≠a,56,ES69209598874776399917,TRX_N-00108-93312621,2022-04-05T17:04:33,Portugalete,expenses,phone,-35.36,-4602.76
buyer_7,Mar√≠a,56,ES69209598874776399917,TRX_N-00109-33608698,2022-04-05T02:55:01,Durango,Expense,food,-94.39,-4697.15
buyer_7,Mar√≠a,56,ES69209598874776399917,TRX_N-00110-93967135,2022-04-05T22:48:56,Portugalete,Expense,transport,-74.99,-4772.14
buyer_7,Mar√≠a,56,ES69209598874776399917,TRX_N-00111-37525956,2022-04-05T17:51:31,Portugalete,Expense,education,-64.92,-4837.06
buyer_7,Mar√≠a,56,ES69209598874776399917,TRX_N-00112-76992887,2022-04-05T17:11:47,Portugalete,Expense,appliances,-103.47,-4940.53
buyer_7,Mar√≠a,56,ES69209598874776399917,TRX_N-00113-04077604,2022-04-06T14:09:41,Portugalete,expenses,water,-31.14,-4971.67
buyer_7,Mar√≠a,56,ES69209598874776399917,TRX_N-00114-94214741,2022-04-06T04:00:58,Portugalete,expenses,gas,-109.16,-5080.83
buyer_7,Mar√≠a,56,ES69209598874776399917,TRX_N-00115-52195009,2022-04-06T19:18:57,Portugalete,Expense,transport,-66.47,-5147.3
buyer_7,Mar√≠a,56,ES69209598874776399917,TRX_N-00116-93238412,2022-04-06T17:36:32,Salvatierra/Agurain,Expense,leisure,-53.84,-5201.14
buyer_7,Mar√≠a,56,ES69209598874776399917,TRX_N-00117-35299984,2022-04-06T09:01:30,Portugalete,Expense,cash,-100.0,-5301.14
buyer_7,Mar√≠a,56,ES69209598874776399917,TRX_N-00118-08885369,2022-04-07T16:18:05,Portugalete,expenses,electricity,-58.55,-5359.69
buyer_7,Mar√≠a,56,ES69209598874776399917,TRX_N-00119-28917996,2022-04-07T18:34:51,Portugalete,Expense,leisure,-24.38,-5384.07
buyer_7,Mar√≠a,56,ES69209598874776399917,TRX_N-00120-37636452,2022-04-07T21:08:40,Getxo,Expense,gifts,-318.11,-5702.18
buyer_7,Mar√≠a,56,ES69209598874776399917,TRX_N-00121-59442447,2022-04-08T16:22:31,Portugalete,expenses,internet,-42.0,-5744.18
buyer_7,Mar√≠a,56,ES69209598874776399917,TRX_N-00122-71295856,2022-04-08T09:06:13,Lasarte-Oria,Expense,clothing,-149.12,-5893.3
buyer_7,Mar√≠a,56,ES69209598874776399917,TRX_N-00123-82171059,2022-04-08T12:44:14,Portugalete,expenses,children,-213.42,-6106.72
buyer_7,Mar√≠a,56,ES69209598874776399917,TRX_N-00124-24222795,2022-04-11T13:55:44,Barakaldo,Expense,food,-83.11,-6189.83
buyer_7,Mar√≠a,56,ES69209598874776399917,TRX_N-00125-04868217,2022-04-11T11:24:57,Barakaldo,Expense,cash,-100.0,-6289.83
buyer_7,Mar√≠a,56,ES69209598874776399917,TRX_N-00126-34299469,2022-04-13T12:24:52,Portugalete,Expense,cash,-100.0,-6389.83
buyer_7,Mar√≠a,56,ES69209598874776399917,TRX_N-00127-78312290,2022-04-14T10:55:06,Portugalete,Expense,food,-68.56,-6458.39
buyer_7,Mar√≠a,56,ES69209598874776399917,TRX_N-00128-82572392,2022-04-16T10:05:44,Zuia,Expense,transport,-89.85,-6548.24
buyer_7,Mar√≠a,56,ES69209598874776399917,TRX_N-00129-68604269,2022-04-16T18:23:57,Portugalete,Expense,cash,-100.0,-6648.24
buyer_7,Mar√≠a,56,ES69209598874776399917,TRX_N-00130-97163147,2022-04-17T20:19:58,Portugalete,Expense,transport,-62.89,-6711.13
buyer_7,Mar√≠a,56,ES69209598874776399917,TRX_N-00131-06131820,2022-04-18T20:57:39,Portugalete,Expense,leisure,-44.4,-6755.53
buyer_7,Mar√≠a,56,ES69209598874776399917,TRX_N-00132-99845046,2022-04-18T18:34:59,Portugalete,Expense,repairs,-159.1,-6914.63
buyer_7,Mar√≠a,56,ES69209598874776399917,TRX_N-00133-89201202,2022-04-22T10:30:47,Portugalete,Expense,transport,-70.61,-6985.24
buyer_7,Mar√≠a,56,ES69209598874776399917,TRX_N-00134-17649088,2022-04-22T10:34:59,Portugalete,expenses,children,-189.85,-7175.09
buyer_7,Mar√≠a,56,ES69209598874776399917,TRX_N-00135-03083156,2022-04-24T13:53:23,Portugalete,Expense,clothing,-84.27,-7259.36
buyer_7,Mar√≠a,56,ES69209598874776399917,TRX_N-00136-52581174,2022-04-25T16:39:21,Portugalete,Expense,repairs,-39.77,-7299.13
buyer_7,Mar√≠a,56,ES69209598874776399917,TRX_N-00137-70967210,2022-04-26T22:07:40,Portugalete,Expense,repairs,-138.65,-7437.78
buyer_7,Mar√≠a,56,ES69209598874776399917,TRX_N-00138-09841176,2022-04-28T09:07:29,Portugalete,Expense,appliances,-185.71,-7623.49
buyer_7,Mar√≠a,56,ES69209598874776399917,TRX_N-00139-72195957,2022-04-30T10:29:40,Basauri,Expense,clothing,-123.89,-7747.38
buyer_7,Mar√≠a,56,ES69209598874776399917,TRX_N-00140-59443399,2022-04-30T11:24:54,Andoain,Expense,cash,-100.0,-7847.38
buyer_7,Mar√≠a,56,ES69209598874776399917,TRX_N-00141-95191623,2022-05-01T09:34:06,Portugalete,incomes,salary,1380.62,-6466.76
buyer_7,Mar√≠a,56,ES69209598874776399917,TRX_N-00142-33625403,2022-05-01T09:34:06,Portugalete,incomes,salary_partner,1282.12,-5184.64
buyer_7,Mar√≠a,56,ES69209598874776399917,TRX_N-00143-71693474,2022-05-02T05:15:57,Portugalete,Expense,transport,-74.33,-5258.97
buyer_7,Mar√≠a,56,ES69209598874776399917,TRX_N-00144-94287321,2022-05-03T19:39:24,Portugalete,Expense,food,-112.6,-5371.57
buyer_7,Mar√≠a,56,ES69209598874776399917,TRX_N-00145-13865969,2022-05-04T17:24:29,Portugalete,expenses,mortgage,-866.4,-6237.97
buyer_7,Mar√≠a,56,ES69209598874776399917,TRX_N-00146-90900427,2022-05-04T00:44:31,Portugalete,Expense,education,-50.17,-6288.14
buyer_7,Mar√≠a,56,ES69209598874776399917,TRX_N-00147-98311573,2022-05-05T12:48:15,Portugalete,expenses,gas,-63.74,-6351.88
buyer_7,Mar√≠a,56,ES69209598874776399917,TRX_N-00148-51892421,2022-05-06T10:32:30,Portugalete,expenses,internet,-42.0,-6393.88
buyer_7,Mar√≠a,56,ES69209598874776399917,TRX_N-00149-24543234,2022-05-06T17:57:59,Portugalete,Expense,appliances,-269.44,-6663.32
buyer_7,Mar√≠a,56,ES69209598874776399917,TRX_N-00150-19135561,2022-05-07T20:16:25,Portugalete,expenses,water,-40.75,-6704.07
buyer_7,Mar√≠a,56,ES69209598874776399917,TRX_N-00151-93747835,2022-05-07T23:29:01,Portugalete,Expense,travel,-749.44,-7453.51
buyer_7,Mar√≠a,56,ES69209598874776399917,TRX_N-00152-31967016,2022-05-08T16:44:21,Portugalete,expenses,electricity,-56.17,-7509.68
buyer_7,Mar√≠a,56,ES69209598874776399917,TRX_N-00153-06863286,2022-05-08T14:38:33,Portugalete,expenses,phone,-42.48,-7552.16
buyer_7,Mar√≠a,56,ES69209598874776399917,TRX_N-00154-56928557,2022-05-08T15:54:15,Portugalete,expenses,children,-64.16,-7616.32
buyer_7,Mar√≠a,56,ES69209598874776399917,TRX_N-00155-43978558,2022-05-14T09:07:29,Portugalete,Expense,food,-119.46,-7735.78
buyer_7,Mar√≠a,56,ES69209598874776399917,TRX_N-00156-31470055,2022-05-14T19:22:04,Portugalete,expenses,children,-88.64,-7824.42
buyer_7,Mar√≠a,56,ES69209598874776399917,TRX_N-00157-38135096,2022-05-17T10:54:33,Portugalete,Expense,gifts,-407.79,-8232.21
buyer_7,Mar√≠a,56,ES69209598874776399917,TRX_N-00158-68298569,2022-05-18T09:07:06,Portugalete,Expense,food,-75.03,-8307.24
buyer_7,Mar√≠a,56,ES69209598874776399917,TRX_N-00159-21708858,2022-05-18T12:36:10,Portugalete,Expense,transport,-82.28,-8389.52
buyer_7,Mar√≠a,56,ES69209598874776399917,TRX_N-00160-82221480,2022-05-19T15:17:36,Portugalete,Expense,travel,-1098.81,-9488.33
buyer_7,Mar√≠a,56,ES69209598874776399917,TRX_N-00161-44937766,2022-05-22T14:56:01,Portugalete,Expense,education,-57.81,-9546.14
buyer_7,Mar√≠a,56,ES69209598874776399917,TRX_N-00162-90192023,2022-05-23T19:10:02,Portugalete,Expense,food,-77.67,-9623.81
buyer_7,Mar√≠a,56,ES69209598874776399917,TRX_N-00163-07654615,2022-05-23T15:49:40,Portugalete,Expense,leisure,-65.76,-9689.57
buyer_7,Mar√≠a,56,ES69209598874776399917,TRX_N-00164-74802206,2022-05-23T17:15:51,Portugalete,Expense,cash,-100.0,-9789.57
buyer_7,Mar√≠a,56,ES69209598874776399917,TRX_N-00165-16602812,2022-05-24T11:46:16,Portugalete,Expense,food,-116.57,-9906.14
buyer_7,Mar√≠a,56,ES69209598874776399917,TRX_N-00166-15498424,2022-05-24T23:21:58,Portugalete,expenses,children,-270.28,-10176.42
buyer_7,Mar√≠a,56,ES69209598874776399917,TRX_N-00167-36203473,2022-05-29T06:31:44,Portugalete,Expense,healthcare,-57.73,-10234.15
buyer_7,Mar√≠a,56,ES69209598874776399917,TRX_N-00168-14661673,2022-05-30T16:54:21,Portugalete,Expense,food,-67.87,-10302.02
buyer_7,Mar√≠a,56,ES69209598874776399917,TRX_N-00169-25526804,2022-05-30T13:57:07,Erandio,Expense,transport,-41.77,-10343.79
buyer_7,Mar√≠a,56,ES69209598874776399917,TRX_N-00170-55049756,2022-05-31T14:51:05,Portugalete,Expense,travel,-849.27,-11193.06
buyer_7,Mar√≠a,56,ES69209598874776399917,TRX_N-00171-14465403,2022-06-01T13:21:05,Portugalete,incomes,salary,1380.62,-9812.44
buyer_7,Mar√≠a,56,ES69209598874776399917,TRX_N-00172-61681309,2022-06-01T13:21:05,Portugalete,incomes,salary_partner,1282.12,-8530.32
buyer_7,Mar√≠a,56,ES69209598874776399917,TRX_N-00173-78695965,2022-06-01T13:21:05,Portugalete,incomes,salary_bonus,1093.08,-7437.24
buyer_7,Mar√≠a,56,ES69209598874776399917,TRX_N-00174-51467202,2022-06-01T13:21:05,Portugalete,incomes,salary_partner_bonus,995.61,-6441.63
buyer_7,Mar√≠a,56,ES69209598874776399917,TRX_N-00175-14578581,2022-06-01T22:26:17,Portugalete,Expense,cash,-100.0,-6541.63
buyer_7,Mar√≠a,56,ES69209598874776399917,TRX_N-00176-50577348,2022-06-02T20:09:05,Eibar,Expense,leisure,-33.1,-6574.73
buyer_7,Mar√≠a,56,ES69209598874776399917,TRX_N-00177-07907950,2022-06-04T09:44:47,Portugalete,expenses,mortgage,-866.4,-7441.13
buyer_7,Mar√≠a,56,ES69209598874776399917,TRX_N-00178-23605544,2022-06-05T17:55:50,Portugalete,expenses,internet,-42.0,-7483.13
buyer_7,Mar√≠a,56,ES69209598874776399917,TRX_N-00179-74773872,2022-06-05T08:15:30,Portugalete,Expense,travel,-420.36,-7903.49
buyer_7,Mar√≠a,56,ES69209598874776399917,TRX_N-00180-88957860,2022-06-06T08:40:55,Portugalete,expenses,water,-44.56,-7948.05
buyer_7,Mar√≠a,56,ES69209598874776399917,TRX_N-00181-39218311,2022-06-06T11:15:18,Portugalete,expenses,phone,-38.35,-7986.4
buyer_7,Mar√≠a,56,ES69209598874776399917,TRX_N-00182-16084054,2022-06-07T10:27:36,Portugalete,Expense,gifts,-459.32,-8445.72
buyer_7,Mar√≠a,56,ES69209598874776399917,TRX_N-00183-24380335,2022-06-08T03:52:30,Portugalete,expenses,electricity,-20.89,-8466.61
buyer_7,Mar√≠a,56,ES69209598874776399917,TRX_N-00184-84761626,2022-06-08T18:50:11,Portugalete,expenses,gas,-93.28,-8559.89
buyer_7,Mar√≠a,56,ES69209598874776399917,TRX_N-00185-39069785,2022-06-12T03:10:46,Portugalete,Expense,food,-81.92,-8641.81
buyer_7,Mar√≠a,56,ES69209598874776399917,TRX_N-00186-99990734,2022-06-12T17:05:45,Portugalete,Expense,transport,-73.66,-8715.47
buyer_7,Mar√≠a,56,ES69209598874776399917,TRX_N-00187-51922704,2022-06-13T03:54:52,Zarautz,Expense,transport,-65.65,-8781.12
buyer_7,Mar√≠a,56,ES69209598874776399917,TRX_N-00188-85906397,2022-06-13T05:31:43,Mungia,Expense,leisure,-48.6,-8829.72
buyer_7,Mar√≠a,56,ES69209598874776399917,TRX_N-00189-97788853,2022-06-14T05:07:13,Portugalete,Expense,leisure,-35.12,-8864.84
buyer_7,Mar√≠a,56,ES69209598874776399917,TRX_N-00190-69889517,2022-06-15T11:54:47,Portugalete,Expense,food,-99.94,-8964.78
buyer_7,Mar√≠a,56,ES69209598874776399917,TRX_N-00191-47859584,2022-06-15T12:19:39,Mungia,Expense,cash,-100.0,-9064.78
buyer_7,Mar√≠a,56,ES69209598874776399917,TRX_N-00192-11956161,2022-06-16T13:33:47,Lasarte-Oria,Expense,food,-82.37,-9147.15
buyer_7,Mar√≠a,56,ES69209598874776399917,TRX_N-00193-17870767,2022-06-17T12:30:23,Irun,Expense,repairs,-133.46,-9280.61
buyer_7,Mar√≠a,56,ES69209598874776399917,TRX_N-00194-96943450,2022-06-18T16:05:58,Portugalete,Expense,transport,-55.02,-9335.63
buyer_7,Mar√≠a,56,ES69209598874776399917,TRX_N-00195-60108220,2022-06-18T11:44:48,Hernani,Expense,leisure,-51.71,-9387.34
buyer_7,Mar√≠a,56,ES69209598874776399917,TRX_N-00196-49448821,2022-06-18T15:55:17,Portugalete,Expense,gifts,-148.75,-9536.09
buyer_7,Mar√≠a,56,ES69209598874776399917,TRX_N-00197-27243128,2022-06-19T14:43:29,Portugalete,Expense,leisure,-41.03,-9577.12
buyer_7,Mar√≠a,56,ES69209598874776399917,TRX_N-00198-46267851,2022-06-19T12:46:51,Portugalete,Expense,cash,-100.0,-9677.12
buyer_7,Mar√≠a,56,ES69209598874776399917,TRX_N-00199-80476756,2022-06-20T21:30:29,Portugalete,Expense,food,-109.34,-9786.46
buyer_7,Mar√≠a,56,ES69209598874776399917,TRX_N-00200-46066236,2022-06-24T11:01:01,Portugalete,Expense,food,-94.14,-9880.6
buyer_7,Mar√≠a,56,ES69209598874776399917,TRX_N-00201-10462909,2022-06-24T16:24:16,Portugalete,expenses,children,-72.63,-9953.23
buyer_7,Mar√≠a,56,ES69209598874776399917,TRX_N-00202-17178424,2022-06-25T10:55:03,Portugalete,Expense,food,-98.13,-10051.36
buyer_7,Mar√≠a,56,ES69209598874776399917,TRX_N-00203-36876619,2022-06-28T18:57:18,Portugalete,Expense,cash,-100.0,-10151.36
buyer_7,Mar√≠a,56,ES69209598874776399917,TRX_N-00204-69542753,2022-06-29T18:08:09,Portugalete,Expense,transport,-61.89,-10213.25
buyer_7,Mar√≠a,56,ES69209598874776399917,TRX_N-00205-78004239,2022-06-29T20:24:26,Portugalete,Expense,repairs,-101.38,-10314.63
buyer_7,Mar√≠a,56,ES69209598874776399917,TRX_N-00206-23012252,2022-07-01T17:01:54,Portugalete,incomes,salary,1380.62,-8934.01
buyer_7,Mar√≠a,56,ES69209598874776399917,TRX_N-00207-89114151,2022-07-01T17:01:54,Portugalete,incomes,salary_partner,1282.12,-7651.89
buyer_7,Mar√≠a,56,ES69209598874776399917,TRX_N-00208-38312216,2022-07-03T15:29:01,Portugalete,Expense,food,-115.85,-7767.74
buyer_7,Mar√≠a,56,ES69209598874776399917,TRX_N-00209-68417053,2022-07-04T22:25:06,Portugalete,expenses,mortgage,-866.4,-8634.14
buyer_7,Mar√≠a,56,ES69209598874776399917,TRX_N-00210-99405010,2022-07-04T09:14:53,Portugalete,Expense,leisure,-34.76,-8668.9
buyer_7,Mar√≠a,56,ES69209598874776399917,TRX_N-00211-40561435,2022-07-05T21:19:56,Portugalete,expenses,water,-43.25,-8712.15
buyer_7,Mar√≠a,56,ES69209598874776399917,TRX_N-00212-74951301,2022-07-05T17:40:24,Portugalete,expenses,internet,-42.0,-8754.15
buyer_7,Mar√≠a,56,ES69209598874776399917,TRX_N-00213-27045418,2022-07-05T17:21:06,Portugalete,expenses,phone,-43.02,-8797.17
buyer_7,Mar√≠a,56,ES69209598874776399917,TRX_N-00214-58663220,2022-07-05T21:58:53,Portugalete,Expense,transport,-46.78,-8843.95
buyer_7,Mar√≠a,56,ES69209598874776399917,TRX_N-00215-42900615,2022-07-05T11:42:49,Portugalete,Expense,education,-75.1,-8919.05
buyer_7,Mar√≠a,56,ES69209598874776399917,TRX_N-00216-56462801,2022-07-08T17:04:41,Portugalete,expenses,electricity,-51.59,-8970.64
buyer_7,Mar√≠a,56,ES69209598874776399917,TRX_N-00217-19111095,2022-07-08T20:50:59,Portugalete,expenses,gas,-72.95,-9043.59
buyer_7,Mar√≠a,56,ES69209598874776399917,TRX_N-00218-48265987,2022-07-10T20:31:01,Portugalete,Expense,repairs,-233.67,-9277.26
buyer_7,Mar√≠a,56,ES69209598874776399917,TRX_N-00219-29571734,2022-07-12T12:45:55,Portugalete,Expense,repairs,-127.76,-9405.02
buyer_7,Mar√≠a,56,ES69209598874776399917,TRX_N-00220-50437417,2022-07-13T00:37:31,Portugalete,Expense,leisure,-57.33,-9462.35
buyer_7,Mar√≠a,56,ES69209598874776399917,TRX_N-00221-54446556,2022-07-15T15:36:37,Portugalete,Expense,clothing,-113.45,-9575.8
buyer_7,Mar√≠a,56,ES69209598874776399917,TRX_N-00222-15366066,2022-07-15T11:50:54,Leioa,Expense,cash,-100.0,-9675.8
buyer_7,Mar√≠a,56,ES69209598874776399917,TRX_N-00223-78060001,2022-07-16T16:29:30,Portugalete,Expense,transport,-45.45,-9721.25
buyer_7,Mar√≠a,56,ES69209598874776399917,TRX_N-00224-06011357,2022-07-17T18:16:02,Portugalete,Expense,transport,-79.73,-9800.98
buyer_7,Mar√≠a,56,ES69209598874776399917,TRX_N-00225-23359692,2022-07-19T11:54:39,Hondarribia,Expense,healthcare,-168.88,-9969.86
buyer_7,Mar√≠a,56,ES69209598874776399917,TRX_N-00226-84674934,2022-07-21T14:51:51,Portugalete,Expense,repairs,-27.96,-9997.82
buyer_7,Mar√≠a,56,ES69209598874776399917,TRX_N-00227-45405704,2022-07-21T15:25:28,Portugalete,expenses,children,-252.16,-10249.98
buyer_7,Mar√≠a,56,ES69209598874776399917,TRX_N-00228-68176671,2022-07-22T17:43:44,Portugalete,expenses,children,-211.53,-10461.51
buyer_7,Mar√≠a,56,ES69209598874776399917,TRX_N-00229-09419976,2022-07-23T11:43:43,Getxo,Expense,leisure,-26.83,-10488.34
buyer_7,Mar√≠a,56,ES69209598874776399917,TRX_N-00230-34766199,2022-07-24T12:09:27,Portugalete,Expense,leisure,-72.12,-10560.46
buyer_7,Mar√≠a,56,ES69209598874776399917,TRX_N-00231-97708257,2022-07-25T20:40:19,Portugalete,Expense,healthcare,-188.19,-10748.65
buyer_7,Mar√≠a,56,ES69209598874776399917,TRX_N-00232-03945142,2022-07-25T19:07:41,Mungia,Expense,appliances,-414.12,-11162.77
buyer_7,Mar√≠a,56,ES69209598874776399917,TRX_N-00233-15809974,2022-07-26T14:02:33,Portugalete,Expense,cash,-100.0,-11262.77
buyer_7,Mar√≠a,56,ES69209598874776399917,TRX_N-00234-38814014,2022-07-27T13:43:11,Portugalete,Expense,food,-72.86,-11335.63
buyer_7,Mar√≠a,56,ES69209598874776399917,TRX_N-00235-04033972,2022-07-27T16:18:30,Portugalete,Expense,transport,-53.77,-11389.4
buyer_7,Mar√≠a,56,ES69209598874776399917,TRX_N-00236-28819878,2022-07-28T03:07:52,Portugalete,Expense,cash,-100.0,-11489.4
buyer_7,Mar√≠a,56,ES69209598874776399917,TRX_N-00237-70981221,2022-07-30T15:09:17,Portugalete,Expense,food,-102.23,-11591.63
buyer_7,Mar√≠a,56,ES69209598874776399917,TRX_N-00238-66407713,2022-07-30T02:00:06,Portugalete,Expense,repairs,-32.03,-11623.66
buyer_7,Mar√≠a,56,ES69209598874776399917,TRX_N-00239-51387774,2022-07-30T13:28:33,Portugalete,expenses,children,-243.71,-11867.37
buyer_7,Mar√≠a,56,ES69209598874776399917,TRX_N-00240-23233690,2022-07-31T15:44:56,Portugalete,Expense,transport,-51.93,-11919.3
buyer_7,Mar√≠a,56,ES69209598874776399917,TRX_N-00241-25164130,2022-08-01T20:34:26,Portugalete,incomes,salary,1380.62,-10538.68
buyer_7,Mar√≠a,56,ES69209598874776399917,TRX_N-00242-91440209,2022-08-01T20:34:26,Portugalete,incomes,salary_partner,1282.12,-9256.56
buyer_7,Mar√≠a,56,ES69209598874776399917,TRX_N-00243-89051927,2022-08-01T20:34:26,Portugalete,incomes,extra_income,160.8,-9095.76
buyer_7,Mar√≠a,56,ES69209598874776399917,TRX_N-00244-35365371,2022-08-01T18:17:04,Portugalete,Expense,appliances,-177.97,-9273.73
buyer_7,Mar√≠a,56,ES69209598874776399917,TRX_N-00245-11516766,2022-08-02T14:08:43,Portugalete,Expense,transport,-57.13,-9330.86
buyer_7,Mar√≠a,56,ES69209598874776399917,TRX_N-00246-23996804,2022-08-04T09:03:44,Portugalete,expenses,mortgage,-866.4,-10197.26
buyer_7,Mar√≠a,56,ES69209598874776399917,TRX_N-00247-53430591,2022-08-05T10:36:40,Portugalete,expenses,electricity,-47.62,-10244.88
buyer_7,Mar√≠a,56,ES69209598874776399917,TRX_N-00248-77883492,2022-08-06T17:28:57,Portugalete,expenses,phone,-43.74,-10288.62
buyer_7,Mar√≠a,56,ES69209598874776399917,TRX_N-00249-24034986,2022-08-08T15:49:12,Portugalete,expenses,water,-33.32,-10321.94
buyer_7,Mar√≠a,56,ES69209598874776399917,TRX_N-00250-99942373,2022-08-08T15:59:22,Portugalete,expenses,gas,-41.88,-10363.82
buyer_7,Mar√≠a,56,ES69209598874776399917,TRX_N-00251-75392055,2022-08-08T16:57:53,Portugalete,expenses,internet,-42.0,-10405.82
buyer_7,Mar√≠a,56,ES69209598874776399917,TRX_N-00252-66467177,2022-08-10T12:20:02,Portugalete,Expense,food,-72.82,-10478.64
buyer_7,Mar√≠a,56,ES69209598874776399917,TRX_N-00253-57753287,2022-08-10T02:19:38,Portugalete,Expense,healthcare,-109.36,-10588.0
buyer_7,Mar√≠a,56,ES69209598874776399917,TRX_N-00254-99242604,2022-08-11T18:50:31,Portugalete,Expense,leisure,-52.79,-10640.79
buyer_7,Mar√≠a,56,ES69209598874776399917,TRX_N-00255-35484232,2022-08-11T19:56:40,Llodio,Expense,gifts,-716.41,-11357.2
buyer_7,Mar√≠a,56,ES69209598874776399917,TRX_N-00256-19461066,2022-08-12T11:56:48,Portugalete,Expense,leisure,-19.52,-11376.72
buyer_7,Mar√≠a,56,ES69209598874776399917,TRX_N-00257-16501584,2022-08-13T20:11:34,Portugalete,Expense,leisure,-22.82,-11399.54
buyer_7,Mar√≠a,56,ES69209598874776399917,TRX_N-00258-01389845,2022-08-14T20:33:13,Bilbao,Expense,food,-99.38,-11498.92
buyer_7,Mar√≠a,56,ES69209598874776399917,TRX_N-00259-53836345,2022-08-14T17:48:08,Portugalete,Expense,gifts,-662.15,-12161.07
buyer_7,Mar√≠a,56,ES69209598874776399917,TRX_N-00260-46389993,2022-08-16T09:53:08,Portugalete,Expense,food,-73.36,-12234.43
buyer_7,Mar√≠a,56,ES69209598874776399917,TRX_N-00261-08492734,2022-08-16T02:58:32,Portugalete,Expense,transport,-49.05,-12283.48
buyer_7,Mar√≠a,56,ES69209598874776399917,TRX_N-00262-37568115,2022-08-17T15:47:28,Portugalete,Expense,transport,-66.5,-12349.98
buyer_7,Mar√≠a,56,ES69209598874776399917,TRX_N-00263-91120373,2022-08-20T15:22:43,Portugalete,Expense,food,-67.3,-12417.28
buyer_7,Mar√≠a,56,ES69209598874776399917,TRX_N-00264-68976615,2022-08-21T11:28:14,Portugalete,Expense,repairs,-188.8,-12606.08
buyer_7,Mar√≠a,56,ES69209598874776399917,TRX_N-00265-58728362,2022-08-23T02:35:17,Portugalete,Expense,leisure,-59.62,-12665.7
buyer_7,Mar√≠a,56,ES69209598874776399917,TRX_N-00266-50632574,2022-08-24T23:42:51,Portugalete,Expense,clothing,-124.02,-12789.72
buyer_7,Mar√≠a,56,ES69209598874776399917,TRX_N-00267-14905945,2022-08-25T10:31:02,Portugalete,Expense,food,-109.0,-12898.72
buyer_7,Mar√≠a,56,ES69209598874776399917,TRX_N-00268-31410702,2022-08-25T20:22:39,Portugalete,Expense,leisure,-47.55,-12946.27
buyer_7,Mar√≠a,56,ES69209598874776399917,TRX_N-00269-78084057,2022-08-25T12:31:21,Portugalete,Expense,gifts,-819.53,-13765.8
buyer_7,Mar√≠a,56,ES69209598874776399917,TRX_N-00270-73461659,2022-08-26T12:14:25,Portugalete,Expense,cash,-100.0,-13865.8
buyer_7,Mar√≠a,56,ES69209598874776399917,TRX_N-00271-21265176,2022-08-27T11:52:57,Portugalete,Expense,food,-90.96,-13956.76
buyer_7,Mar√≠a,56,ES69209598874776399917,TRX_N-00272-76091022,2022-08-28T16:26:51,Portugalete,Expense,education,-48.15,-14004.91
buyer_7,Mar√≠a,56,ES69209598874776399917,TRX_N-00273-12690421,2022-08-29T15:18:57,Portugalete,Expense,food,-69.64,-14074.55
buyer_7,Mar√≠a,56,ES69209598874776399917,TRX_N-00274-60940219,2022-08-29T13:00:51,Portugalete,Expense,travel,-402.51,-14477.06
buyer_7,Mar√≠a,56,ES69209598874776399917,TRX_N-00275-02039638,2022-08-30T19:12:52,Portugalete,Expense,leisure,-34.46,-14511.52
buyer_7,Mar√≠a,56,ES69209598874776399917,TRX_N-00276-33341351,2022-09-01T09:30:50,Portugalete,incomes,salary,1380.62,-13130.9
buyer_7,Mar√≠a,56,ES69209598874776399917,TRX_N-00277-67893141,2022-09-01T09:30:50,Portugalete,incomes,salary_partner,1282.12,-11848.78
buyer_7,Mar√≠a,56,ES69209598874776399917,TRX_N-00278-69430693,2022-09-01T10:35:53,Portugalete,Expense,leisure,-62.58,-11911.36
buyer_7,Mar√≠a,56,ES69209598874776399917,TRX_N-00279-03358940,2022-09-02T15:58:20,Portugalete,Expense,food,-66.83,-11978.19
buyer_7,Mar√≠a,56,ES69209598874776399917,TRX_N-00280-00657711,2022-09-04T14:53:20,Portugalete,expenses,mortgage,-866.4,-12844.59
buyer_7,Mar√≠a,56,ES69209598874776399917,TRX_N-00281-16069383,2022-09-04T21:38:15,Portugalete,Expense,gifts,-110.23,-12954.82
buyer_7,Mar√≠a,56,ES69209598874776399917,TRX_N-00282-78117224,2022-09-05T15:03:18,Portugalete,expenses,water,-39.86,-12994.68
buyer_7,Mar√≠a,56,ES69209598874776399917,TRX_N-00283-16081613,2022-09-05T10:53:53,Portugalete,expenses,electricity,-69.55,-13064.23
buyer_7,Mar√≠a,56,ES69209598874776399917,TRX_N-00284-42230965,2022-09-05T05:18:05,Portugalete,expenses,gas,-50.43,-13114.66
buyer_7,Mar√≠a,56,ES69209598874776399917,TRX_N-00285-99698231,2022-09-05T12:06:33,Portugalete,expenses,internet,-42.0,-13156.66
buyer_7,Mar√≠a,56,ES69209598874776399917,TRX_N-00286-94384890,2022-09-06T19:49:19,Sestao,Expense,cash,-100.0,-13256.66
buyer_7,Mar√≠a,56,ES69209598874776399917,TRX_N-00287-52283384,2022-09-08T23:08:15,Portugalete,expenses,phone,-43.31,-13299.97
buyer_7,Mar√≠a,56,ES69209598874776399917,TRX_N-00288-92055031,2022-09-08T17:39:42,Portugalete,Expense,education,-45.66,-13345.63
buyer_7,Mar√≠a,56,ES69209598874776399917,TRX_N-00289-54132363,2022-09-09T13:33:04,Portugalete,Expense,food,-104.69,-13450.32
buyer_7,Mar√≠a,56,ES69209598874776399917,TRX_N-00290-51527209,2022-09-10T23:45:51,Portugalete,Expense,cash,-100.0,-13550.32
buyer_7,Mar√≠a,56,ES69209598874776399917,TRX_N-00291-82132183,2022-09-11T16:41:58,Galdakao,Expense,transport,-68.9,-13619.22
buyer_7,Mar√≠a,56,ES69209598874776399917,TRX_N-00292-67014138,2022-09-13T11:18:15,Portugalete,Expense,cash,-100.0,-13719.22
buyer_7,Mar√≠a,56,ES69209598874776399917,TRX_N-00293-42726116,2022-09-17T21:52:09,Portugalete,Expense,clothing,-84.59,-13803.81
buyer_7,Mar√≠a,56,ES69209598874776399917,TRX_N-00294-86275035,2022-09-19T22:42:24,Portugalete,Expense,food,-71.57,-13875.38
buyer_7,Mar√≠a,56,ES69209598874776399917,TRX_N-00295-73277373,2022-09-20T16:58:32,Portugalete,Expense,transport,-83.51,-13958.89
buyer_7,Mar√≠a,56,ES69209598874776399917,TRX_N-00296-84413531,2022-09-20T08:18:35,Erandio,Expense,gifts,-455.2,-14414.09
buyer_7,Mar√≠a,56,ES69209598874776399917,TRX_N-00297-04083028,2022-09-21T13:23:55,Portugalete,Expense,leisure,-46.29,-14460.38
buyer_7,Mar√≠a,56,ES69209598874776399917,TRX_N-00298-59218267,2022-09-22T08:28:42,Salvatierra/Agurain,Expense,leisure,-80.91,-14541.29
buyer_7,Mar√≠a,56,ES69209598874776399917,TRX_N-00299-07783005,2022-09-22T11:53:06,Portugalete,Expense,cash,-100.0,-14641.29
buyer_7,Mar√≠a,56,ES69209598874776399917,TRX_N-00300-99893841,2022-09-23T16:04:44,Portugalete,Expense,food,-109.71,-14751.0
buyer_7,Mar√≠a,56,ES69209598874776399917,TRX_N-00301-49003410,2022-09-23T16:20:24,Portugalete,Expense,leisure,-35.06,-14786.06
buyer_7,Mar√≠a,56,ES69209598874776399917,TRX_N-00302-47296657,2022-09-23T20:08:48,Portugalete,Expense,education,-52.69,-14838.75
buyer_7,Mar√≠a,56,ES69209598874776399917,TRX_N-00303-74698316,2022-09-24T17:12:51,Portugalete,Expense,appliances,-407.97,-15246.72
buyer_7,Mar√≠a,56,ES69209598874776399917,TRX_N-00304-02528420,2022-09-25T04:34:44,Portugalete,Expense,leisure,-35.33,-15282.05
buyer_7,Mar√≠a,56,ES69209598874776399917,TRX_N-00305-35283168,2022-09-26T18:30:07,Mungia,Expense,food,-96.11,-15378.16
buyer_7,Mar√≠a,56,ES69209598874776399917,TRX_N-00306-45107034,2022-09-27T10:59:03,Portugalete,Expense,leisure,-79.33,-15457.49
buyer_7,Mar√≠a,56,ES69209598874776399917,TRX_N-00307-12113234,2022-09-29T10:42:44,Portugalete,Expense,leisure,-28.16,-15485.65
buyer_7,Mar√≠a,56,ES69209598874776399917,TRX_N-00308-20083288,2022-09-30T17:08:38,Lasarte-Oria,Expense,appliances,-135.92,-15621.57
buyer_7,Mar√≠a,56,ES69209598874776399917,TRX_N-00309-57543939,2022-10-01T13:12:51,Portugalete,incomes,salary,1380.62,-14240.95
buyer_7,Mar√≠a,56,ES69209598874776399917,TRX_N-00310-26435403,2022-10-01T13:12:51,Portugalete,incomes,salary_partner,1282.12,-12958.83
buyer_7,Mar√≠a,56,ES69209598874776399917,TRX_N-00311-52785481,2022-10-01T09:07:31,Errenteria,Expense,food,-75.96,-13034.79
buyer_7,Mar√≠a,56,ES69209598874776399917,TRX_N-00312-27403433,2022-10-01T14:29:25,Portugalete,Expense,clothing,-107.83,-13142.62
buyer_7,Mar√≠a,56,ES69209598874776399917,TRX_N-00313-14329786,2022-10-01T02:41:22,Barakaldo,Expense,healthcare,-128.12,-13270.74
buyer_7,Mar√≠a,56,ES69209598874776399917,TRX_N-00314-67929510,2022-10-01T18:15:08,Portugalete,Expense,gifts,-754.99,-14025.73
buyer_7,Mar√≠a,56,ES69209598874776399917,TRX_N-00315-37535447,2022-10-03T16:23:08,Portugalete,Expense,appliances,-103.16,-14128.89
buyer_7,Mar√≠a,56,ES69209598874776399917,TRX_N-00316-26329739,2022-10-04T20:17:38,Portugalete,expenses,mortgage,-866.4,-14995.29
buyer_7,Mar√≠a,56,ES69209598874776399917,TRX_N-00317-73860920,2022-10-05T10:36:55,Portugalete,expenses,internet,-42.0,-15037.29
buyer_7,Mar√≠a,56,ES69209598874776399917,TRX_N-00318-48179213,2022-10-05T20:52:02,Portugalete,Expense,clothing,-56.54,-15093.83
buyer_7,Mar√≠a,56,ES69209598874776399917,TRX_N-00319-64354392,2022-10-06T15:52:27,Portugalete,expenses,electricity,-72.84,-15166.67
buyer_7,Mar√≠a,56,ES69209598874776399917,TRX_N-00320-16254159,2022-10-06T00:11:25,Portugalete,expenses,phone,-42.89,-15209.56
buyer_7,Mar√≠a,56,ES69209598874776399917,TRX_N-00321-79290961,2022-10-06T17:11:41,Portugalete,Expense,transport,-70.55,-15280.11
buyer_7,Mar√≠a,56,ES69209598874776399917,TRX_N-00322-72414973,2022-10-07T04:56:52,Portugalete,Expense,repairs,-314.57,-15594.68
buyer_7,Mar√≠a,56,ES69209598874776399917,TRX_N-00323-57927986,2022-10-08T11:33:57,Portugalete,expenses,water,-35.83,-15630.51
buyer_7,Mar√≠a,56,ES69209598874776399917,TRX_N-00324-05492489,2022-10-08T17:57:16,Portugalete,expenses,gas,-41.23,-15671.74
buyer_7,Mar√≠a,56,ES69209598874776399917,TRX_N-00325-08280171,2022-10-09T14:07:06,Portugalete,Expense,food,-94.08,-15765.82
buyer_7,Mar√≠a,56,ES69209598874776399917,TRX_N-00326-99391485,2022-10-09T16:52:27,Portugalete,Expense,appliances,-92.16,-15857.98
buyer_7,Mar√≠a,56,ES69209598874776399917,TRX_N-00327-48751960,2022-10-10T20:16:25,Portugalete,Expense,cash,-100.0,-15957.98
buyer_7,Mar√≠a,56,ES69209598874776399917,TRX_N-00328-35709896,2022-10-11T08:46:12,Portugalete,Expense,food,-81.78,-16039.76
buyer_7,Mar√≠a,56,ES69209598874776399917,TRX_N-00329-22839904,2022-10-11T18:47:20,Portugalete,Expense,leisure,-38.67,-16078.43
buyer_7,Mar√≠a,56,ES69209598874776399917,TRX_N-00330-53364464,2022-10-14T09:04:47,Portugalete,Expense,cash,-100.0,-16178.43
buyer_7,Mar√≠a,56,ES69209598874776399917,TRX_N-00331-38247794,2022-10-14T15:27:26,Portugalete,expenses,children,-232.92,-16411.35
buyer_7,Mar√≠a,56,ES69209598874776399917,TRX_N-00332-95164713,2022-10-15T16:05:36,Portugalete,Expense,food,-117.5,-16528.85
buyer_7,Mar√≠a,56,ES69209598874776399917,TRX_N-00333-68872567,2022-10-18T20:33:10,Portugalete,Expense,gifts,-98.55,-16627.4
buyer_7,Mar√≠a,56,ES69209598874776399917,TRX_N-00334-52921377,2022-10-19T05:40:39,Bermeo,Expense,gifts,-358.9,-16986.3
buyer_7,Mar√≠a,56,ES69209598874776399917,TRX_N-00335-06835090,2022-10-21T17:14:50,Portugalete,Expense,transport,-62.91,-17049.21
buyer_7,Mar√≠a,56,ES69209598874776399917,TRX_N-00336-25467591,2022-10-21T10:13:27,Santurtzi,Expense,repairs,-286.52,-17335.73
buyer_7,Mar√≠a,56,ES69209598874776399917,TRX_N-00337-81562270,2022-10-23T09:04:27,Portugalete,Expense,leisure,-56.53,-17392.26
buyer_7,Mar√≠a,56,ES69209598874776399917,TRX_N-00338-27556502,2022-10-23T14:00:49,Portugalete,Expense,healthcare,-124.22,-17516.48
buyer_7,Mar√≠a,56,ES69209598874776399917,TRX_N-00339-89379662,2022-10-23T12:56:52,Portugalete,Expense,cash,-100.0,-17616.48
buyer_7,Mar√≠a,56,ES69209598874776399917,TRX_N-00340-99546892,2022-10-24T19:25:37,Portugalete,Expense,travel,-1289.22,-18905.7
buyer_7,Mar√≠a,56,ES69209598874776399917,TRX_N-00341-27389080,2022-10-26T04:57:56,Portugalete,Expense,food,-71.89,-18977.59
buyer_7,Mar√≠a,56,ES69209598874776399917,TRX_N-00342-82089139,2022-10-29T17:33:20,Portugalete,Expense,food,-84.78,-19062.37
buyer_7,Mar√≠a,56,ES69209598874776399917,TRX_N-00343-38510699,2022-10-30T15:25:21,Portugalete,Expense,cash,-100.0,-19162.37
buyer_7,Mar√≠a,56,ES69209598874776399917,TRX_N-00344-99852219,2022-11-01T08:25:06,Portugalete,incomes,salary,1380.62,-17781.75
buyer_7,Mar√≠a,56,ES69209598874776399917,TRX_N-00345-72997079,2022-11-01T08:25:06,Portugalete,incomes,salary_partner,1282.12,-16499.63
buyer_7,Mar√≠a,56,ES69209598874776399917,TRX_N-00346-89472184,2022-11-02T12:25:10,Portugalete,Expense,food,-118.61,-16618.24
buyer_7,Mar√≠a,56,ES69209598874776399917,TRX_N-00347-53369014,2022-11-02T10:43:14,Portugalete,Expense,leisure,-47.85,-16666.09
buyer_7,Mar√≠a,56,ES69209598874776399917,TRX_N-00348-84560349,2022-11-03T08:53:15,Portugalete,Expense,repairs,-273.67,-16939.76
buyer_7,Mar√≠a,56,ES69209598874776399917,TRX_N-00349-33062602,2022-11-04T13:55:55,Portugalete,expenses,mortgage,-866.4,-17806.16
buyer_7,Mar√≠a,56,ES69209598874776399917,TRX_N-00350-89013402,2022-11-04T19:41:10,Portugalete,Expense,cash,-100.0,-17906.16
buyer_7,Mar√≠a,56,ES69209598874776399917,TRX_N-00351-41180538,2022-11-05T13:35:41,Portugalete,expenses,water,-40.67,-17946.83
buyer_7,Mar√≠a,56,ES69209598874776399917,TRX_N-00352-21320009,2022-11-05T15:36:39,Portugalete,expenses,internet,-42.0,-17988.83
buyer_7,Mar√≠a,56,ES69209598874776399917,TRX_N-00353-28663284,2022-11-05T13:34:56,Hernani,Expense,education,-60.12,-18048.95
buyer_7,Mar√≠a,56,ES69209598874776399917,TRX_N-00354-33548605,2022-11-06T21:02:48,Portugalete,Expense,travel,-378.8,-18427.75
buyer_7,Mar√≠a,56,ES69209598874776399917,TRX_N-00355-60220932,2022-11-07T22:31:59,Portugalete,expenses,phone,-43.53,-18471.28
buyer_7,Mar√≠a,56,ES69209598874776399917,TRX_N-00356-00194155,2022-11-07T16:58:41,Portugalete,Expense,cash,-100.0,-18571.28
buyer_7,Mar√≠a,56,ES69209598874776399917,TRX_N-00357-88838848,2022-11-08T23:16:18,Portugalete,expenses,gas,-54.81,-18626.09
buyer_7,Mar√≠a,56,ES69209598874776399917,TRX_N-00358-09276323,2022-11-08T22:02:39,Portugalete,expenses,electricity,-29.68,-18655.77
buyer_7,Mar√≠a,56,ES69209598874776399917,TRX_N-00359-38414618,2022-11-09T08:23:15,Portugalete,Expense,leisure,-62.1,-18717.87
buyer_7,Mar√≠a,56,ES69209598874776399917,TRX_N-00360-13441029,2022-11-10T12:26:41,Irun,Expense,food,-105.98,-18823.85
buyer_7,Mar√≠a,56,ES69209598874776399917,TRX_N-00361-90567144,2022-11-10T18:28:31,Portugalete,Expense,leisure,-47.79,-18871.64
buyer_7,Mar√≠a,56,ES69209598874776399917,TRX_N-00362-25689823,2022-11-11T17:44:21,Portugalete,Expense,gifts,-429.69,-19301.33
buyer_7,Mar√≠a,56,ES69209598874776399917,TRX_N-00363-96676528,2022-11-13T20:42:22,Portugalete,Expense,appliances,-89.83,-19391.16
buyer_7,Mar√≠a,56,ES69209598874776399917,TRX_N-00364-93592986,2022-11-15T06:19:03,Portugalete,Expense,leisure,-80.31,-19471.47
buyer_7,Mar√≠a,56,ES69209598874776399917,TRX_N-00365-99876448,2022-11-15T12:54:08,Portugalete,Expense,cash,-100.0,-19571.47
buyer_7,Mar√≠a,56,ES69209598874776399917,TRX_N-00366-83153767,2022-11-15T11:44:05,Portugalete,expenses,children,-87.83,-19659.3
buyer_7,Mar√≠a,56,ES69209598874776399917,TRX_N-00367-05934147,2022-11-16T16:04:58,Portugalete,Expense,leisure,-66.64,-19725.94
buyer_7,Mar√≠a,56,ES69209598874776399917,TRX_N-00368-28935710,2022-11-16T11:27:21,Portugalete,Expense,gifts,-32.85,-19758.79
buyer_7,Mar√≠a,56,ES69209598874776399917,TRX_N-00369-25540323,2022-11-17T14:12:13,Portugalete,Expense,leisure,-63.38,-19822.17
buyer_7,Mar√≠a,56,ES69209598874776399917,TRX_N-00370-33072697,2022-11-19T18:32:42,Portugalete,Expense,food,-101.78,-19923.95
buyer_7,Mar√≠a,56,ES69209598874776399917,TRX_N-00371-01505600,2022-11-19T10:32:21,Barakaldo,Expense,leisure,-35.81,-19959.76
buyer_7,Mar√≠a,56,ES69209598874776399917,TRX_N-00372-36074743,2022-11-19T09:21:41,Portugalete,Expense,cash,-100.0,-20059.76
buyer_7,Mar√≠a,56,ES69209598874776399917,TRX_N-00373-35831749,2022-11-21T18:48:44,Portugalete,Expense,healthcare,-139.56,-20199.32
buyer_7,Mar√≠a,56,ES69209598874776399917,TRX_N-00374-56689319,2022-11-22T16:37:26,Portugalete,Expense,food,-121.08,-20320.4
buyer_7,Mar√≠a,56,ES69209598874776399917,TRX_N-00375-84113027,2022-11-22T12:54:49,Portugalete,Expense,healthcare,-161.16,-20481.56
buyer_7,Mar√≠a,56,ES69209598874776399917,TRX_N-00376-88742598,2022-11-22T18:48:16,Portugalete,Expense,cash,-100.0,-20581.56
buyer_7,Mar√≠a,56,ES69209598874776399917,TRX_N-00377-52869150,2022-11-29T11:26:13,Portugalete,Expense,food,-60.9,-20642.46
buyer_7,Mar√≠a,56,ES69209598874776399917,TRX_N-00378-68330102,2022-11-30T14:12:36,Portugalete,Expense,repairs,-94.15,-20736.61
buyer_7,Mar√≠a,56,ES69209598874776399917,TRX_N-00379-77252325,2022-11-30T08:16:37,Portugalete,Expense,gifts,-68.21,-20804.82
buyer_7,Mar√≠a,56,ES69209598874776399917,TRX_N-00380-95707291,2022-12-01T20:17:24,Portugalete,incomes,salary,1380.62,-19424.2
buyer_7,Mar√≠a,56,ES69209598874776399917,TRX_N-00381-41657455,2022-12-01T20:17:24,Portugalete,incomes,salary_partner,1282.12,-18142.08
buyer_7,Mar√≠a,56,ES69209598874776399917,TRX_N-00382-88659510,2022-12-01T20:17:24,Portugalete,incomes,extra_income,160.8,-17981.28
buyer_7,Mar√≠a,56,ES69209598874776399917,TRX_N-00383-24372502,2022-12-01T20:17:24,Portugalete,incomes,salary_bonus,1056.65,-16924.63
buyer_7,Mar√≠a,56,ES69209598874776399917,TRX_N-00384-83520260,2022-12-01T20:17:24,Portugalete,incomes,salary_partner_bonus,926.78,-15997.85
buyer_7,Mar√≠a,56,ES69209598874776399917,TRX_N-00385-91138640,2022-12-01T16:47:26,Portugalete,expenses,children,-216.04,-16213.89
buyer_7,Mar√≠a,56,ES69209598874776399917,TRX_N-00386-81263251,2022-12-02T21:49:40,Portugalete,Expense,leisure,-52.48,-16266.37
buyer_7,Mar√≠a,56,ES69209598874776399917,TRX_N-00387-04276991,2022-12-04T10:06:53,Portugalete,expenses,mortgage,-866.4,-17132.77
buyer_7,Mar√≠a,56,ES69209598874776399917,TRX_N-00388-13938056,2022-12-05T11:23:18,Portugalete,expenses,internet,-42.0,-17174.77
buyer_7,Mar√≠a,56,ES69209598874776399917,TRX_N-00389-11028836,2022-12-06T13:03:09,Portugalete,Expense,food,-66.34,-17241.11
buyer_7,Mar√≠a,56,ES69209598874776399917,TRX_N-00390-01672724,2022-12-06T14:36:51,Portugalete,Expense,cash,-100.0,-17341.11
buyer_7,Mar√≠a,56,ES69209598874776399917,TRX_N-00391-97942340,2022-12-07T11:40:48,Portugalete,expenses,electricity,-80.1,-17421.21
buyer_7,Mar√≠a,56,ES69209598874776399917,TRX_N-00392-17861991,2022-12-07T16:02:49,Portugalete,Expense,transport,-86.83,-17508.04
buyer_7,Mar√≠a,56,ES69209598874776399917,TRX_N-00393-96083456,2022-12-08T10:18:09,Portugalete,expenses,water,-44.34,-17552.38
buyer_7,Mar√≠a,56,ES69209598874776399917,TRX_N-00394-18169191,2022-12-08T13:26:47,Portugalete,expenses,gas,-103.17,-17655.55
buyer_7,Mar√≠a,56,ES69209598874776399917,TRX_N-00395-39514184,2022-12-08T08:14:52,Portugalete,expenses,phone,-34.9,-17690.45
buyer_7,Mar√≠a,56,ES69209598874776399917,TRX_N-00396-15758841,2022-12-09T08:57:39,Sestao,Expense,cash,-100.0,-17790.45
buyer_7,Mar√≠a,56,ES69209598874776399917,TRX_N-00397-95565866,2022-12-10T16:24:20,Portugalete,Expense,cash,-100.0,-17890.45
buyer_7,Mar√≠a,56,ES69209598874776399917,TRX_N-00398-45889570,2022-12-12T17:20:45,Portugalete,Expense,education,-75.77,-17966.22
buyer_7,Mar√≠a,56,ES69209598874776399917,TRX_N-00399-99159007,2022-12-12T09:27:20,Portugalete,Expense,cash,-100.0,-18066.22
buyer_7,Mar√≠a,56,ES69209598874776399917,TRX_N-00400-28410356,2022-12-13T12:16:54,Portugalete,expenses,children,-59.79,-18126.01
buyer_7,Mar√≠a,56,ES69209598874776399917,TRX_N-00401-18934209,2022-12-19T04:00:29,Portugalete,Expense,food,-74.96,-18200.97
buyer_7,Mar√≠a,56,ES69209598874776399917,TRX_N-00402-30979463,2022-12-21T18:22:24,Portugalete,Expense,transport,-82.99,-18283.96
buyer_7,Mar√≠a,56,ES69209598874776399917,TRX_N-00403-97123398,2022-12-22T15:26:50,Portugalete,Expense,food,-75.07,-18359.03
buyer_7,Mar√≠a,56,ES69209598874776399917,TRX_N-00404-89173927,2022-12-22T17:52:14,Portugalete,Expense,leisure,-35.28,-18394.31
buyer_7,Mar√≠a,56,ES69209598874776399917,TRX_N-00405-33931583,2022-12-24T21:06:12,Portugalete,Expense,clothing,-62.76,-18457.07
buyer_7,Mar√≠a,56,ES69209598874776399917,TRX_N-00406-59596983,2022-12-25T15:27:11,Leioa,Expense,repairs,-40.17,-18497.24
buyer_7,Mar√≠a,56,ES69209598874776399917,TRX_N-00407-12672231,2022-12-27T16:06:53,Portugalete,Expense,leisure,-77.87,-18575.11
buyer_7,Mar√≠a,56,ES69209598874776399917,TRX_N-00408-05367175,2022-12-27T20:19:03,Barakaldo,Expense,repairs,-324.38,-18899.49
buyer_7,Mar√≠a,56,ES69209598874776399917,TRX_N-00409-08548461,2022-12-28T19:02:10,Portugalete,Expense,repairs,-134.77,-19034.26
buyer_7,Mar√≠a,56,ES69209598874776399917,TRX_N-00410-78261847,2022-12-29T07:04:42,Portugalete,Expense,leisure,-31.67,-19065.93
buyer_7,Mar√≠a,56,ES69209598874776399917,TRX_N-00411-21725827,2022-12-29T10:48:57,Portugalete,Expense,clothing,-149.04,-19214.97
buyer_7,Mar√≠a,56,ES69209598874776399917,TRX_N-00412-27455680,2022-12-29T05:14:50,Arrasate,Expense,cash,-100.0,-19314.97
buyer_7,Mar√≠a,56,ES69209598874776399917,TRX_N-00413-10721558,2022-12-30T17:17:38,Portugalete,Expense,transport,-83.26,-19398.23
buyer_7,Mar√≠a,56,ES69209598874776399917,TRX_N-00414-07884079,2023-01-01T23:35:31,Portugalete,incomes,salary,1423.73,-17974.5
buyer_7,Mar√≠a,56,ES69209598874776399917,TRX_N-00415-99767025,2023-01-01T23:35:31,Portugalete,incomes,salary_partner,1322.16,-16652.34
buyer_7,Mar√≠a,56,ES69209598874776399917,TRX_N-00416-57887701,2023-01-02T10:18:18,Portugalete,Expense,transport,-59.55,-16711.89
buyer_7,Mar√≠a,56,ES69209598874776399917,TRX_N-00417-45779566,2023-01-02T09:40:21,Portugalete,Expense,cash,-100.0,-16811.89
buyer_7,Mar√≠a,56,ES69209598874776399917,TRX_N-00418-81464711,2023-01-04T18:43:45,Portugalete,expenses,mortgage,-866.4,-17678.29
buyer_7,Mar√≠a,56,ES69209598874776399917,TRX_N-00419-25017186,2023-01-04T12:10:49,Portugalete,Expense,food,-124.23,-17802.52
buyer_7,Mar√≠a,56,ES69209598874776399917,TRX_N-00420-58015481,2023-01-04T16:59:01,Portugalete,Expense,cash,-100.0,-17902.52
buyer_7,Mar√≠a,56,ES69209598874776399917,TRX_N-00421-28163374,2023-01-05T14:19:13,Portugalete,Expense,cash,-100.0,-18002.52
buyer_7,Mar√≠a,56,ES69209598874776399917,TRX_N-00422-91701882,2023-01-06T18:30:56,Portugalete,expenses,internet,-42.0,-18044.52
buyer_7,Mar√≠a,56,ES69209598874776399917,TRX_N-00423-80542532,2023-01-06T13:33:35,Portugalete,Expense,education,-53.5,-18098.02
buyer_7,Mar√≠a,56,ES69209598874776399917,TRX_N-00424-27264620,2023-01-07T14:18:03,Sopela,Expense,food,-68.15,-18166.17
buyer_7,Mar√≠a,56,ES69209598874776399917,TRX_N-00425-23555114,2023-01-08T08:48:47,Portugalete,expenses,water,-37.56,-18203.73
buyer_7,Mar√≠a,56,ES69209598874776399917,TRX_N-00426-41298372,2023-01-08T10:12:12,Portugalete,expenses,electricity,-27.11,-18230.84
buyer_7,Mar√≠a,56,ES69209598874776399917,TRX_N-00427-98515350,2023-01-08T20:05:40,Portugalete,expenses,gas,-89.05,-18319.89
buyer_7,Mar√≠a,56,ES69209598874776399917,TRX_N-00428-27080947,2023-01-08T11:47:18,Portugalete,expenses,phone,-44.97,-18364.86
buyer_7,Mar√≠a,56,ES69209598874776399917,TRX_N-00429-75018199,2023-01-08T18:02:49,Iru√±a de Oca,Expense,appliances,-401.76,-18766.62
buyer_7,Mar√≠a,56,ES69209598874776399917,TRX_N-00430-86028573,2023-01-10T23:41:07,Portugalete,Expense,cash,-100.0,-18866.62
buyer_7,Mar√≠a,56,ES69209598874776399917,TRX_N-00431-05402949,2023-01-11T11:57:09,Portugalete,Expense,gifts,-77.43,-18944.05
buyer_7,Mar√≠a,56,ES69209598874776399917,TRX_N-00432-69659224,2023-01-13T23:08:34,Portugalete,Expense,repairs,-138.24,-19082.29
buyer_7,Mar√≠a,56,ES69209598874776399917,TRX_N-00433-57408139,2023-01-15T21:38:51,Portugalete,Expense,leisure,-65.53,-19147.82
buyer_7,Mar√≠a,56,ES69209598874776399917,TRX_N-00434-92236189,2023-01-16T19:18:34,Basauri,Expense,cash,-100.0,-19247.82
buyer_7,Mar√≠a,56,ES69209598874776399917,TRX_N-00435-23372055,2023-01-18T00:53:16,Barakaldo,Expense,food,-72.64,-19320.46
buyer_7,Mar√≠a,56,ES69209598874776399917,TRX_N-00436-05273515,2023-01-20T11:43:35,Portugalete,Expense,leisure,-54.3,-19374.76
buyer_7,Mar√≠a,56,ES69209598874776399917,TRX_N-00437-57861975,2023-01-23T20:24:29,Eibar,Expense,food,-120.83,-19495.59
buyer_7,Mar√≠a,56,ES69209598874776399917,TRX_N-00438-09671595,2023-01-25T10:48:06,Salvatierra/Agurain,Expense,food,-100.79,-19596.38
buyer_7,Mar√≠a,56,ES69209598874776399917,TRX_N-00439-57541635,2023-01-29T16:31:17,Portugalete,Expense,education,-48.69,-19645.07
buyer_7,Mar√≠a,56,ES69209598874776399917,TRX_N-00440-01852184,2023-01-29T15:43:40,Portugalete,Expense,cash,-100.0,-19745.07
buyer_7,Mar√≠a,56,ES69209598874776399917,TRX_N-00441-30514701,2023-01-31T08:09:47,Portugalete,Expense,gifts,-83.2,-19828.27
buyer_7,Mar√≠a,56,ES69209598874776399917,TRX_N-00442-90238706,2023-02-01T11:33:21,Portugalete,incomes,salary,1423.73,-18404.54
buyer_7,Mar√≠a,56,ES69209598874776399917,TRX_N-00443-79867286,2023-02-01T11:33:21,Portugalete,incomes,salary_partner,1322.16,-17082.38
buyer_7,Mar√≠a,56,ES69209598874776399917,TRX_N-00444-05242016,2023-02-03T18:30:32,Portugalete,Expense,repairs,-280.56,-17362.94
buyer_7,Mar√≠a,56,ES69209598874776399917,TRX_N-00445-85355812,2023-02-04T12:49:20,Portugalete,expenses,mortgage,-866.4,-18229.34
buyer_7,Mar√≠a,56,ES69209598874776399917,TRX_N-00446-75426395,2023-02-04T14:07:38,Donostia,Expense,leisure,-18.86,-18248.2
buyer_7,Mar√≠a,56,ES69209598874776399917,TRX_N-00447-91160249,2023-02-05T13:35:59,Portugalete,expenses,gas,-82.57,-18330.77
buyer_7,Mar√≠a,56,ES69209598874776399917,TRX_N-00448-04464993,2023-02-07T14:47:28,Portugalete,expenses,electricity,-62.22,-18392.99
buyer_7,Mar√≠a,56,ES69209598874776399917,TRX_N-00449-28394462,2023-02-08T19:46:22,Portugalete,expenses,water,-21.08,-18414.07
buyer_7,Mar√≠a,56,ES69209598874776399917,TRX_N-00450-60734549,2023-02-08T20:26:07,Portugalete,expenses,internet,-42.0,-18456.07
buyer_7,Mar√≠a,56,ES69209598874776399917,TRX_N-00451-92512156,2023-02-08T22:16:23,Portugalete,expenses,phone,-37.27,-18493.34
buyer_7,Mar√≠a,56,ES69209598874776399917,TRX_N-00452-89892088,2023-02-10T18:27:25,Portugalete,Expense,food,-109.31,-18602.65
buyer_7,Mar√≠a,56,ES69209598874776399917,TRX_N-00453-33458176,2023-02-11T17:06:59,Bermeo,Expense,leisure,-79.84,-18682.49
buyer_7,Mar√≠a,56,ES69209598874776399917,TRX_N-00454-03810233,2023-02-12T09:01:49,Portugalete,Expense,food,-114.22,-18796.71
buyer_7,Mar√≠a,56,ES69209598874776399917,TRX_N-00455-03518316,2023-02-13T14:54:44,Portugalete,Expense,food,-96.87,-18893.58
buyer_7,Mar√≠a,56,ES69209598874776399917,TRX_N-00456-22314545,2023-02-14T17:10:52,Portugalete,Expense,leisure,-48.76,-18942.34
buyer_7,Mar√≠a,56,ES69209598874776399917,TRX_N-00457-59533148,2023-02-15T06:30:28,Portugalete,Expense,food,-63.28,-19005.62
buyer_7,Mar√≠a,56,ES69209598874776399917,TRX_N-00458-56196832,2023-02-16T17:29:51,Portugalete,Expense,transport,-89.19,-19094.81
buyer_7,Mar√≠a,56,ES69209598874776399917,TRX_N-00459-86878476,2023-02-17T11:54:30,Iru√±a de Oca,Expense,transport,-44.39,-19139.2
buyer_7,Mar√≠a,56,ES69209598874776399917,TRX_N-00460-82680776,2023-02-18T16:02:38,Portugalete,Expense,food,-80.44,-19219.64
buyer_7,Mar√≠a,56,ES69209598874776399917,TRX_N-00461-78778814,2023-02-18T20:25:25,Portugalete,Expense,cash,-100.0,-19319.64
buyer_7,Mar√≠a,56,ES69209598874776399917,TRX_N-00462-75454293,2023-02-19T17:02:41,Portugalete,Expense,food,-124.73,-19444.37
buyer_7,Mar√≠a,56,ES69209598874776399917,TRX_N-00463-44794235,2023-02-19T20:48:22,Portugalete,Expense,transport,-80.48,-19524.85
buyer_7,Mar√≠a,56,ES69209598874776399917,TRX_N-00464-28536611,2023-02-19T21:15:59,Portugalete,Expense,clothing,-123.13,-19647.98
buyer_7,Mar√≠a,56,ES69209598874776399917,TRX_N-00465-52099566,2023-02-20T08:41:07,Portugalete,Expense,cash,-100.0,-19747.98
buyer_7,Mar√≠a,56,ES69209598874776399917,TRX_N-00466-60528327,2023-02-21T08:06:25,Portugalete,Expense,cash,-100.0,-19847.98
buyer_7,Mar√≠a,56,ES69209598874776399917,TRX_N-00467-56306851,2023-02-27T15:16:15,Portugalete,Expense,leisure,-75.66,-19923.64
buyer_7,Mar√≠a,56,ES69209598874776399917,TRX_N-00468-01602042,2023-02-27T08:35:07,Portugalete,Expense,cash,-100.0,-20023.64
buyer_7,Mar√≠a,56,ES69209598874776399917,TRX_N-00469-45078322,2023-02-27T19:11:53,Portugalete,Expense,travel,-1638.26,-21661.9
buyer_7,Mar√≠a,56,ES69209598874776399917,TRX_N-00470-99994215,2023-02-28T21:47:02,Portugalete,Expense,education,-50.36,-21712.26
buyer_7,Mar√≠a,56,ES69209598874776399917,TRX_N-00471-40266803,2023-03-01T13:31:08,Portugalete,incomes,salary,1423.73,-20288.53
buyer_7,Mar√≠a,56,ES69209598874776399917,TRX_N-00472-77221468,2023-03-01T13:31:08,Portugalete,incomes,salary_partner,1322.16,-18966.37
buyer_7,Mar√≠a,56,ES69209598874776399917,TRX_N-00473-83827091,2023-03-01T14:33:33,Portugalete,Expense,food,-70.34,-19036.71
buyer_7,Mar√≠a,56,ES69209598874776399917,TRX_N-00474-98024884,2023-03-01T08:08:16,Durango,Expense,transport,-65.88,-19102.59
buyer_7,Mar√≠a,56,ES69209598874776399917,TRX_N-00475-71624661,2023-03-04T23:44:11,Portugalete,expenses,mortgage,-866.4,-19968.99
buyer_7,Mar√≠a,56,ES69209598874776399917,TRX_N-00476-40153883,2023-03-05T19:54:50,Portugalete,expenses,electricity,-57.39,-20026.38
buyer_7,Mar√≠a,56,ES69209598874776399917,TRX_N-00477-62967890,2023-03-05T01:51:34,Portugalete,Expense,clothing,-57.78,-20084.16
buyer_7,Mar√≠a,56,ES69209598874776399917,TRX_N-00478-11962468,2023-03-05T20:51:16,Portugalete,Expense,repairs,-250.89,-20335.05
buyer_7,Mar√≠a,56,ES69209598874776399917,TRX_N-00479-90537867,2023-03-06T08:20:33,Portugalete,expenses,water,-28.04,-20363.09
buyer_7,Mar√≠a,56,ES69209598874776399917,TRX_N-00480-42736750,2023-03-07T08:53:44,Portugalete,expenses,gas,-84.08,-20447.17
buyer_7,Mar√≠a,56,ES69209598874776399917,TRX_N-00481-29676781,2023-03-07T14:27:30,Portugalete,expenses,internet,-42.0,-20489.17
buyer_7,Mar√≠a,56,ES69209598874776399917,TRX_N-00482-36347951,2023-03-07T14:55:17,Erandio,Expense,clothing,-97.31,-20586.48
buyer_7,Mar√≠a,56,ES69209598874776399917,TRX_N-00483-41187378,2023-03-07T15:06:03,Portugalete,Expense,gifts,-176.9,-20763.38
buyer_7,Mar√≠a,56,ES69209598874776399917,TRX_N-00484-89533421,2023-03-08T11:50:20,Portugalete,expenses,phone,-41.41,-20804.79
buyer_7,Mar√≠a,56,ES69209598874776399917,TRX_N-00485-67944376,2023-03-11T14:53:14,Portugalete,Expense,clothing,-158.32,-20963.11
buyer_7,Mar√≠a,56,ES69209598874776399917,TRX_N-00486-49696755,2023-03-12T19:14:14,Portugalete,Expense,transport,-53.28,-21016.39
buyer_7,Mar√≠a,56,ES69209598874776399917,TRX_N-00487-59160388,2023-03-12T20:06:21,Portugalete,Expense,appliances,-402.32,-21418.71
buyer_7,Mar√≠a,56,ES69209598874776399917,TRX_N-00488-20723001,2023-03-12T01:46:58,Portugalete,Expense,repairs,-267.62,-21686.33
buyer_7,Mar√≠a,56,ES69209598874776399917,TRX_N-00489-77822528,2023-03-13T18:56:07,Portugalete,Expense,repairs,-70.49,-21756.82
buyer_7,Mar√≠a,56,ES69209598874776399917,TRX_N-00490-45824126,2023-03-14T18:22:06,Portugalete,Expense,food,-102.27,-21859.09
buyer_7,Mar√≠a,56,ES69209598874776399917,TRX_N-00491-80085235,2023-03-15T15:01:07,Portugalete,Expense,clothing,-103.01,-21962.1
buyer_7,Mar√≠a,56,ES69209598874776399917,TRX_N-00492-61992862,2023-03-15T21:23:44,Portugalete,expenses,children,-246.86,-22208.96
buyer_7,Mar√≠a,56,ES69209598874776399917,TRX_N-00493-98693039,2023-03-16T17:25:55,Portugalete,Expense,leisure,-77.08,-22286.04
buyer_7,Mar√≠a,56,ES69209598874776399917,TRX_N-00494-06148707,2023-03-18T12:23:09,Portugalete,Expense,cash,-100.0,-22386.04
buyer_7,Mar√≠a,56,ES69209598874776399917,TRX_N-00495-84817357,2023-03-19T17:18:49,Portugalete,Expense,transport,-59.51,-22445.55
buyer_7,Mar√≠a,56,ES69209598874776399917,TRX_N-00496-61363018,2023-03-20T20:48:08,Portugalete,Expense,leisure,-68.91,-22514.46
buyer_7,Mar√≠a,56,ES69209598874776399917,TRX_N-00497-24093988,2023-03-21T13:13:32,Portugalete,Expense,repairs,-51.33,-22565.79
buyer_7,Mar√≠a,56,ES69209598874776399917,TRX_N-00498-05069558,2023-03-22T14:57:05,Portugalete,expenses,children,-179.41,-22745.2
buyer_7,Mar√≠a,56,ES69209598874776399917,TRX_N-00499-18263392,2023-03-23T14:19:18,Portugalete,Expense,food,-100.51,-22845.71
buyer_7,Mar√≠a,56,ES69209598874776399917,TRX_N-00500-08978579,2023-03-23T14:05:03,Mungia,Expense,cash,-100.0,-22945.71
buyer_7,Mar√≠a,56,ES69209598874776399917,TRX_N-00501-93085756,2023-03-24T08:19:57,Portugalete,Expense,food,-62.43,-23008.14
buyer_7,Mar√≠a,56,ES69209598874776399917,TRX_N-00502-03613642,2023-03-25T22:25:56,Portugalete,Expense,transport,-52.05,-23060.19
buyer_7,Mar√≠a,56,ES69209598874776399917,TRX_N-00503-01911751,2023-03-25T09:01:01,Portugalete,Expense,repairs,-52.41,-23112.6
buyer_7,Mar√≠a,56,ES69209598874776399917,TRX_N-00504-48084523,2023-03-25T13:16:50,Portugalete,Expense,gifts,-349.01,-23461.61
buyer_7,Mar√≠a,56,ES69209598874776399917,TRX_N-00505-53984465,2023-03-26T16:27:07,Zuia,Expense,clothing,-132.56,-23594.17
buyer_7,Mar√≠a,56,ES69209598874776399917,TRX_N-00506-31106824,2023-03-27T16:21:00,Labastida,Expense,cash,-100.0,-23694.17
buyer_7,Mar√≠a,56,ES69209598874776399917,TRX_N-00507-92867015,2023-03-28T18:27:46,Portugalete,Expense,clothing,-94.95,-23789.12
buyer_7,Mar√≠a,56,ES69209598874776399917,TRX_N-00508-40315770,2023-03-28T19:28:48,Portugalete,expenses,children,-244.63,-24033.75
buyer_7,Mar√≠a,56,ES69209598874776399917,TRX_N-00509-99023700,2023-03-30T14:09:14,Portugalete,Expense,leisure,-24.92,-24058.67
buyer_7,Mar√≠a,56,ES69209598874776399917,TRX_N-00510-95401116,2023-03-30T18:11:21,Portugalete,Expense,cash,-100.0,-24158.67
buyer_7,Mar√≠a,56,ES69209598874776399917,TRX_N-00511-09250517,2023-03-31T08:12:56,Portugalete,Expense,transport,-65.5,-24224.17
buyer_7,Mar√≠a,56,ES69209598874776399917,TRX_N-00512-00756921,2023-04-01T08:56:54,Portugalete,incomes,salary,1423.73,-22800.44
buyer_7,Mar√≠a,56,ES69209598874776399917,TRX_N-00513-86697130,2023-04-01T08:56:54,Portugalete,incomes,salary_partner,1322.16,-21478.28
buyer_7,Mar√≠a,56,ES69209598874776399917,TRX_N-00514-62595533,2023-04-01T08:56:54,Portugalete,incomes,extra_income,160.8,-21317.48
buyer_7,Mar√≠a,56,ES69209598874776399917,TRX_N-00515-33584489,2023-04-02T18:25:41,Sopela,Expense,leisure,-30.81,-21348.29
buyer_7,Mar√≠a,56,ES69209598874776399917,TRX_N-00516-57317176,2023-04-02T12:59:59,Leioa,Expense,travel,-1648.73,-22997.02
buyer_7,Mar√≠a,56,ES69209598874776399917,TRX_N-00517-13659451,2023-04-04T14:50:58,Portugalete,expenses,mortgage,-866.4,-23863.42
buyer_7,Mar√≠a,56,ES69209598874776399917,TRX_N-00518-60569260,2023-04-04T09:49:57,Portugalete,Expense,gifts,-821.31,-24684.73
buyer_7,Mar√≠a,56,ES69209598874776399917,TRX_N-00519-35296150,2023-04-06T14:05:28,Portugalete,expenses,water,-28.31,-24713.04
buyer_7,Mar√≠a,56,ES69209598874776399917,TRX_N-00520-27849133,2023-04-06T15:58:25,Portugalete,expenses,phone,-32.49,-24745.53
buyer_7,Mar√≠a,56,ES69209598874776399917,TRX_N-00521-69213380,2023-04-07T08:03:10,Portugalete,expenses,internet,-42.0,-24787.53
buyer_7,Mar√≠a,56,ES69209598874776399917,TRX_N-00522-08095233,2023-04-08T20:30:40,Portugalete,expenses,electricity,-76.03,-24863.56
buyer_7,Mar√≠a,56,ES69209598874776399917,TRX_N-00523-76419573,2023-04-08T10:10:41,Portugalete,expenses,gas,-53.07,-24916.63
buyer_7,Mar√≠a,56,ES69209598874776399917,TRX_N-00524-62391853,2023-04-09T15:15:05,Pasaia,Expense,transport,-68.49,-24985.12
buyer_7,Mar√≠a,56,ES69209598874776399917,TRX_N-00525-49913835,2023-04-09T17:08:26,Portugalete,Expense,healthcare,-170.52,-25155.64
buyer_7,Mar√≠a,56,ES69209598874776399917,TRX_N-00526-02628269,2023-04-10T14:45:41,Donostia,Expense,repairs,-192.7,-25348.34
buyer_7,Mar√≠a,56,ES69209598874776399917,TRX_N-00527-35216249,2023-04-11T13:39:11,Portugalete,Expense,clothing,-135.76,-25484.1
buyer_7,Mar√≠a,56,ES69209598874776399917,TRX_N-00528-83972261,2023-04-11T21:05:57,Donostia,Expense,cash,-100.0,-25584.1
buyer_7,Mar√≠a,56,ES69209598874776399917,TRX_N-00529-45570452,2023-04-12T16:27:49,Portugalete,Expense,leisure,-53.76,-25637.86
buyer_7,Mar√≠a,56,ES69209598874776399917,TRX_N-00530-45654723,2023-04-12T11:41:12,Portugalete,Expense,education,-51.47,-25689.33
buyer_7,Mar√≠a,56,ES69209598874776399917,TRX_N-00531-26862421,2023-04-13T14:35:04,Portugalete,Expense,cash,-100.0,-25789.33
buyer_7,Mar√≠a,56,ES69209598874776399917,TRX_N-00532-14119292,2023-04-13T10:27:42,Arrasate,Expense,appliances,-292.52,-26081.85
buyer_7,Mar√≠a,56,ES69209598874776399917,TRX_N-00533-69463695,2023-04-14T19:03:52,Alegr√≠a-Dulantzi,Expense,cash,-100.0,-26181.85
buyer_7,Mar√≠a,56,ES69209598874776399917,TRX_N-00534-60912164,2023-04-16T08:20:00,Portugalete,Expense,cash,-100.0,-26281.85
buyer_7,Mar√≠a,56,ES69209598874776399917,TRX_N-00535-79489301,2023-04-16T14:59:31,Portugalete,expenses,children,-257.86,-26539.71
buyer_7,Mar√≠a,56,ES69209598874776399917,TRX_N-00536-71950217,2023-04-18T01:26:40,Portugalete,Expense,cash,-100.0,-26639.71
buyer_7,Mar√≠a,56,ES69209598874776399917,TRX_N-00537-90407459,2023-04-19T08:55:38,Portugalete,Expense,leisure,-23.65,-26663.36
buyer_7,Mar√≠a,56,ES69209598874776399917,TRX_N-00538-00962465,2023-04-20T09:21:21,Portugalete,Expense,gifts,-639.71,-27303.07
buyer_7,Mar√≠a,56,ES69209598874776399917,TRX_N-00539-17586350,2023-04-21T06:27:38,Hondarribia,Expense,leisure,-40.6,-27343.67
buyer_7,Mar√≠a,56,ES69209598874776399917,TRX_N-00540-38579396,2023-04-21T19:06:01,Portugalete,Expense,clothing,-84.55,-27428.22
buyer_7,Mar√≠a,56,ES69209598874776399917,TRX_N-00541-80682619,2023-04-23T15:23:18,Salvatierra/Agurain,Expense,transport,-73.45,-27501.67
buyer_7,Mar√≠a,56,ES69209598874776399917,TRX_N-00542-24910401,2023-04-26T09:36:21,Lasarte-Oria,Expense,repairs,-289.73,-27791.4
buyer_7,Mar√≠a,56,ES69209598874776399917,TRX_N-00543-97413213,2023-04-27T15:21:29,Portugalete,Expense,transport,-45.16,-27836.56
buyer_7,Mar√≠a,56,ES69209598874776399917,TRX_N-00544-88750142,2023-04-28T15:35:53,Portugalete,Expense,food,-108.82,-27945.38
buyer_7,Mar√≠a,56,ES69209598874776399917,TRX_N-00545-72706661,2023-04-30T18:39:42,Portugalete,Expense,gifts,-186.17,-28131.55
buyer_7,Mar√≠a,56,ES69209598874776399917,TRX_N-00546-80328214,2023-05-01T00:20:51,Portugalete,incomes,salary,1423.73,-26707.82
buyer_7,Mar√≠a,56,ES69209598874776399917,TRX_N-00547-55120274,2023-05-01T00:20:51,Portugalete,incomes,salary_partner,1322.16,-25385.66
buyer_7,Mar√≠a,56,ES69209598874776399917,TRX_N-00548-23484232,2023-05-01T17:12:24,Portugalete,Expense,cash,-100.0,-25485.66
buyer_7,Mar√≠a,56,ES69209598874776399917,TRX_N-00549-43413918,2023-05-02T14:23:33,Portugalete,Expense,food,-114.72,-25600.38
buyer_7,Mar√≠a,56,ES69209598874776399917,TRX_N-00550-32333049,2023-05-02T11:37:24,Portugalete,Expense,cash,-100.0,-25700.38
buyer_7,Mar√≠a,56,ES69209598874776399917,TRX_N-00551-24032921,2023-05-02T13:00:46,Bermeo,Expense,gifts,-503.51,-26203.89
buyer_7,Mar√≠a,56,ES69209598874776399917,TRX_N-00552-29021197,2023-05-03T06:11:34,Portugalete,Expense,food,-124.18,-26328.07
buyer_7,Mar√≠a,56,ES69209598874776399917,TRX_N-00553-41860017,2023-05-03T10:12:25,Donostia,Expense,repairs,-80.6,-26408.67
buyer_7,Mar√≠a,56,ES69209598874776399917,TRX_N-00554-93525694,2023-05-04T15:04:23,Portugalete,expenses,mortgage,-866.4,-27275.07
buyer_7,Mar√≠a,56,ES69209598874776399917,TRX_N-00555-52549116,2023-05-05T20:44:18,Portugalete,expenses,electricity,-84.08,-27359.15
buyer_7,Mar√≠a,56,ES69209598874776399917,TRX_N-00556-17890387,2023-05-05T08:54:14,Portugalete,expenses,phone,-36.88,-27396.03
buyer_7,Mar√≠a,56,ES69209598874776399917,TRX_N-00557-82598425,2023-05-06T07:13:59,Salvatierra/Agurain,Expense,food,-99.23,-27495.26
buyer_7,Mar√≠a,56,ES69209598874776399917,TRX_N-00558-27383967,2023-05-07T15:07:45,Portugalete,expenses,internet,-42.0,-27537.26
buyer_7,Mar√≠a,56,ES69209598874776399917,TRX_N-00559-75254917,2023-05-07T19:22:47,Portugalete,Expense,clothing,-62.43,-27599.69
buyer_7,Mar√≠a,56,ES69209598874776399917,TRX_N-00560-55438891,2023-05-08T18:16:56,Portugalete,expenses,water,-42.32,-27642.01
buyer_7,Mar√≠a,56,ES69209598874776399917,TRX_N-00561-00955528,2023-05-08T12:58:22,Portugalete,expenses,gas,-38.24,-27680.25
buyer_7,Mar√≠a,56,ES69209598874776399917,TRX_N-00562-54731721,2023-05-08T17:47:08,Portugalete,Expense,repairs,-224.56,-27904.81
buyer_7,Mar√≠a,56,ES69209598874776399917,TRX_N-00563-31884147,2023-05-10T08:49:18,Arrasate,Expense,gifts,-257.35,-28162.16
buyer_7,Mar√≠a,56,ES69209598874776399917,TRX_N-00564-18005851,2023-05-12T09:43:08,Portugalete,Expense,appliances,-269.27,-28431.43
buyer_7,Mar√≠a,56,ES69209598874776399917,TRX_N-00565-63853015,2023-05-13T15:35:53,Galdakao,Expense,healthcare,-78.5,-28509.93
buyer_7,Mar√≠a,56,ES69209598874776399917,TRX_N-00566-19146891,2023-05-16T19:59:44,Portugalete,Expense,cash,-100.0,-28609.93
buyer_7,Mar√≠a,56,ES69209598874776399917,TRX_N-00567-09347742,2023-05-17T19:13:16,Lasarte-Oria,Expense,leisure,-58.67,-28668.6
buyer_7,Mar√≠a,56,ES69209598874776399917,TRX_N-00568-35370804,2023-05-18T20:06:21,Portugalete,Expense,food,-99.63,-28768.23
buyer_7,Mar√≠a,56,ES69209598874776399917,TRX_N-00569-08249018,2023-05-19T19:58:39,Portugalete,Expense,transport,-60.94,-28829.17
buyer_7,Mar√≠a,56,ES69209598874776399917,TRX_N-00570-91663487,2023-05-20T18:47:58,Portugalete,Expense,leisure,-71.51,-28900.68
buyer_7,Mar√≠a,56,ES69209598874776399917,TRX_N-00571-99963999,2023-05-21T13:56:21,Portugalete,Expense,gifts,-336.95,-29237.63
buyer_7,Mar√≠a,56,ES69209598874776399917,TRX_N-00572-37712328,2023-05-24T09:37:53,Portugalete,Expense,cash,-100.0,-29337.63
buyer_7,Mar√≠a,56,ES69209598874776399917,TRX_N-00573-10009160,2023-05-24T07:49:39,Donostia,Expense,travel,-559.61,-29897.24
buyer_7,Mar√≠a,56,ES69209598874776399917,TRX_N-00574-38392911,2023-05-29T17:30:55,Iru√±a de Oca,Expense,cash,-100.0,-29997.24
buyer_7,Mar√≠a,56,ES69209598874776399917,TRX_N-00575-49249474,2023-05-30T16:55:02,Portugalete,Expense,cash,-100.0,-30097.24
buyer_7,Mar√≠a,56,ES69209598874776399917,TRX_N-00576-49967600,2023-06-01T18:04:45,Portugalete,incomes,salary,1423.73,-28673.51
buyer_7,Mar√≠a,56,ES69209598874776399917,TRX_N-00577-70454321,2023-06-01T18:04:45,Portugalete,incomes,salary_partner,1322.16,-27351.35
buyer_7,Mar√≠a,56,ES69209598874776399917,TRX_N-00578-83949015,2023-06-01T18:04:45,Portugalete,incomes,salary_bonus,1031.32,-26320.03
buyer_7,Mar√≠a,56,ES69209598874776399917,TRX_N-00579-17719055,2023-06-01T18:04:45,Portugalete,incomes,salary_partner_bonus,963.89,-25356.14
buyer_7,Mar√≠a,56,ES69209598874776399917,TRX_N-00580-56140143,2023-06-01T11:33:02,Portugalete,Expense,cash,-100.0,-25456.14
buyer_7,Mar√≠a,56,ES69209598874776399917,TRX_N-00581-11982341,2023-06-01T17:34:32,Portugalete,Expense,gifts,-144.98,-25601.12
buyer_7,Mar√≠a,56,ES69209598874776399917,TRX_N-00582-57206638,2023-06-02T19:40:20,Portugalete,Expense,healthcare,-104.65,-25705.77
buyer_7,Mar√≠a,56,ES69209598874776399917,TRX_N-00583-76176234,2023-06-03T19:27:14,Portugalete,Expense,leisure,-50.19,-25755.96
buyer_7,Mar√≠a,56,ES69209598874776399917,TRX_N-00584-85689424,2023-06-04T13:55:34,Portugalete,expenses,mortgage,-866.4,-26622.36
buyer_7,Mar√≠a,56,ES69209598874776399917,TRX_N-00585-76570418,2023-06-05T16:38:21,Portugalete,expenses,water,-42.19,-26664.55
buyer_7,Mar√≠a,56,ES69209598874776399917,TRX_N-00586-21964137,2023-06-05T14:22:49,Portugalete,expenses,internet,-42.0,-26706.55
buyer_7,Mar√≠a,56,ES69209598874776399917,TRX_N-00587-75761135,2023-06-06T10:11:44,Portugalete,expenses,gas,-83.46,-26790.01
buyer_7,Mar√≠a,56,ES69209598874776399917,TRX_N-00588-30476670,2023-06-07T19:16:14,Portugalete,expenses,electricity,-56.71,-26846.72
buyer_7,Mar√≠a,56,ES69209598874776399917,TRX_N-00589-99455760,2023-06-07T15:46:56,Portugalete,expenses,phone,-43.81,-26890.53
buyer_7,Mar√≠a,56,ES69209598874776399917,TRX_N-00590-23672825,2023-06-08T10:36:44,Portugalete,Expense,leisure,-44.11,-26934.64
buyer_7,Mar√≠a,56,ES69209598874776399917,TRX_N-00591-20745554,2023-06-08T17:06:58,Sopela,Expense,travel,-384.83,-27319.47
buyer_7,Mar√≠a,56,ES69209598874776399917,TRX_N-00592-57888693,2023-06-09T19:31:50,Portugalete,Expense,repairs,-289.71,-27609.18
buyer_7,Mar√≠a,56,ES69209598874776399917,TRX_N-00593-96398937,2023-06-11T05:55:21,Portugalete,Expense,gifts,-198.88,-27808.06
buyer_7,Mar√≠a,56,ES69209598874776399917,TRX_N-00594-41713208,2023-06-12T14:19:57,Portugalete,Expense,leisure,-54.12,-27862.18
buyer_7,Mar√≠a,56,ES69209598874776399917,TRX_N-00595-88973964,2023-06-12T11:30:25,Labastida,Expense,gifts,-814.52,-28676.7
buyer_7,Mar√≠a,56,ES69209598874776399917,TRX_N-00596-08810841,2023-06-15T08:53:47,Portugalete,Expense,food,-68.87,-28745.57
buyer_7,Mar√≠a,56,ES69209598874776399917,TRX_N-00597-32618209,2023-06-16T13:16:47,Getxo,Expense,appliances,-348.51,-29094.08
buyer_7,Mar√≠a,56,ES69209598874776399917,TRX_N-00598-20246320,2023-06-18T12:16:45,Barakaldo,Expense,food,-114.23,-29208.31
buyer_7,Mar√≠a,56,ES69209598874776399917,TRX_N-00599-52015558,2023-06-18T08:20:59,Iru√±a de Oca,Expense,education,-70.17,-29278.48
buyer_7,Mar√≠a,56,ES69209598874776399917,TRX_N-00600-08979674,2023-06-18T08:16:24,Portugalete,Expense,cash,-100.0,-29378.48
buyer_7,Mar√≠a,56,ES69209598874776399917,TRX_N-00601-44480282,2023-06-18T09:11:33,Portugalete,Expense,repairs,-153.01,-29531.49
buyer_7,Mar√≠a,56,ES69209598874776399917,TRX_N-00602-63704586,2023-06-19T19:46:25,Portugalete,Expense,food,-99.19,-29630.68
buyer_7,Mar√≠a,56,ES69209598874776399917,TRX_N-00603-71547987,2023-06-20T16:37:27,Portugalete,Expense,cash,-100.0,-29730.68
buyer_7,Mar√≠a,56,ES69209598874776399917,TRX_N-00604-82573920,2023-06-21T20:09:13,Lasarte-Oria,Expense,transport,-57.92,-29788.6
buyer_7,Mar√≠a,56,ES69209598874776399917,TRX_N-00605-39778704,2023-06-22T20:16:41,Portugalete,Expense,healthcare,-96.88,-29885.48
buyer_7,Mar√≠a,56,ES69209598874776399917,TRX_N-00606-01627226,2023-06-23T16:38:23,Zuia,Expense,cash,-100.0,-29985.48
buyer_7,Mar√≠a,56,ES69209598874776399917,TRX_N-00607-16124434,2023-06-24T13:29:40,Portugalete,Expense,repairs,-28.37,-30013.85
buyer_7,Mar√≠a,56,ES69209598874776399917,TRX_N-00608-86589939,2023-06-25T11:55:56,Portugalete,Expense,transport,-68.55,-30082.4
buyer_7,Mar√≠a,56,ES69209598874776399917,TRX_N-00609-45717386,2023-06-25T19:15:10,Portugalete,Expense,education,-72.31,-30154.71
buyer_7,Mar√≠a,56,ES69209598874776399917,TRX_N-00610-30220788,2023-06-25T00:09:08,Portugalete,Expense,cash,-100.0,-30254.71
buyer_7,Mar√≠a,56,ES69209598874776399917,TRX_N-00611-43021701,2023-06-28T16:57:31,Portugalete,Expense,food,-91.53,-30346.24
buyer_7,Mar√≠a,56,ES69209598874776399917,TRX_N-00612-92633347,2023-06-30T14:32:09,Portugalete,Expense,food,-116.5,-30462.74
buyer_7,Mar√≠a,56,ES69209598874776399917,TRX_N-00613-59572948,2023-06-30T15:08:37,Portugalete,Expense,transport,-69.16,-30531.9
buyer_7,Mar√≠a,56,ES69209598874776399917,TRX_N-00614-71347082,2023-06-30T11:24:52,Portugalete,Expense,cash,-100.0,-30631.9
buyer_7,Mar√≠a,56,ES69209598874776399917,TRX_N-00615-17049880,2023-07-01T17:13:12,Portugalete,incomes,salary,1423.73,-29208.17
buyer_7,Mar√≠a,56,ES69209598874776399917,TRX_N-00616-37310967,2023-07-01T17:13:12,Portugalete,incomes,salary_partner,1322.16,-27886.01
buyer_7,Mar√≠a,56,ES69209598874776399917,TRX_N-00617-36543939,2023-07-01T17:13:12,Portugalete,incomes,extra_income,160.8,-27725.21
buyer_7,Mar√≠a,56,ES69209598874776399917,TRX_N-00618-62613089,2023-07-01T10:11:10,Leioa,Expense,cash,-100.0,-27825.21
buyer_7,Mar√≠a,56,ES69209598874776399917,TRX_N-00619-32788702,2023-07-02T16:15:56,Portugalete,Expense,food,-86.38,-27911.59
buyer_7,Mar√≠a,56,ES69209598874776399917,TRX_N-00620-96112995,2023-07-03T19:52:05,Portugalete,Expense,food,-117.41,-28029.0
buyer_7,Mar√≠a,56,ES69209598874776399917,TRX_N-00621-20493747,2023-07-04T18:52:31,Portugalete,expenses,mortgage,-866.4,-28895.4
buyer_7,Mar√≠a,56,ES69209598874776399917,TRX_N-00622-09329172,2023-07-04T20:59:04,Portugalete,Expense,food,-98.12,-28993.52
buyer_7,Mar√≠a,56,ES69209598874776399917,TRX_N-00623-17483219,2023-07-04T14:29:30,Portugalete,Expense,travel,-1237.99,-30231.51
buyer_7,Mar√≠a,56,ES69209598874776399917,TRX_N-00624-97960348,2023-07-05T16:42:10,Portugalete,expenses,electricity,-62.53,-30294.04
buyer_7,Mar√≠a,56,ES69209598874776399917,TRX_N-00625-52022728,2023-07-05T19:43:08,Portugalete,expenses,gas,-41.24,-30335.28
buyer_7,Mar√≠a,56,ES69209598874776399917,TRX_N-00626-87554928,2023-07-05T20:11:27,Portugalete,expenses,internet,-42.0,-30377.28
buyer_7,Mar√≠a,56,ES69209598874776399917,TRX_N-00627-80159895,2023-07-06T09:04:06,Portugalete,Expense,food,-110.58,-30487.86
buyer_7,Mar√≠a,56,ES69209598874776399917,TRX_N-00628-00809888,2023-07-06T00:12:37,Portugalete,Expense,leisure,-32.31,-30520.17
buyer_7,Mar√≠a,56,ES69209598874776399917,TRX_N-00629-73637245,2023-07-08T12:53:03,Portugalete,expenses,water,-40.22,-30560.39
buyer_7,Mar√≠a,56,ES69209598874776399917,TRX_N-00630-93967847,2023-07-08T16:12:40,Portugalete,expenses,phone,-38.87,-30599.26
buyer_7,Mar√≠a,56,ES69209598874776399917,TRX_N-00631-95750086,2023-07-10T19:01:10,Portugalete,Expense,food,-64.31,-30663.57
buyer_7,Mar√≠a,56,ES69209598874776399917,TRX_N-00632-41496397,2023-07-10T21:16:24,Portugalete,Expense,leisure,-36.84,-30700.41
buyer_7,Mar√≠a,56,ES69209598874776399917,TRX_N-00633-94112884,2023-07-11T10:50:27,Portugalete,Expense,leisure,-35.14,-30735.55
buyer_7,Mar√≠a,56,ES69209598874776399917,TRX_N-00634-71487110,2023-07-12T14:54:04,Portugalete,Expense,clothing,-94.86,-30830.41
buyer_7,Mar√≠a,56,ES69209598874776399917,TRX_N-00635-88326909,2023-07-13T09:07:14,Portugalete,Expense,food,-120.0,-30950.41
buyer_7,Mar√≠a,56,ES69209598874776399917,TRX_N-00636-47304122,2023-07-15T14:50:36,Portugalete,Expense,food,-77.33,-31027.74
buyer_7,Mar√≠a,56,ES69209598874776399917,TRX_N-00637-50054057,2023-07-15T08:21:01,Portugalete,Expense,leisure,-57.91,-31085.65
buyer_7,Mar√≠a,56,ES69209598874776399917,TRX_N-00638-84472871,2023-07-16T23:56:06,Portugalete,Expense,clothing,-77.1,-31162.75
buyer_7,Mar√≠a,56,ES69209598874776399917,TRX_N-00639-42795964,2023-07-17T18:28:38,Leioa,Expense,leisure,-40.61,-31203.36
buyer_7,Mar√≠a,56,ES69209598874776399917,TRX_N-00640-93431437,2023-07-20T16:18:07,Portugalete,Expense,leisure,-47.68,-31251.04
buyer_7,Mar√≠a,56,ES69209598874776399917,TRX_N-00641-47895903,2023-07-21T18:46:17,Portugalete,Expense,food,-111.63,-31362.67
buyer_7,Mar√≠a,56,ES69209598874776399917,TRX_N-00642-38653658,2023-07-21T09:07:37,Iru√±a de Oca,Expense,education,-68.79,-31431.46
buyer_7,Mar√≠a,56,ES69209598874776399917,TRX_N-00643-11813983,2023-07-22T22:11:05,Portugalete,Expense,gifts,-271.97,-31703.43
buyer_7,Mar√≠a,56,ES69209598874776399917,TRX_N-00644-54506372,2023-07-22T08:30:26,Portugalete,expenses,children,-189.49,-31892.92
buyer_7,Mar√≠a,56,ES69209598874776399917,TRX_N-00645-61631840,2023-07-23T06:24:43,Portugalete,Expense,repairs,-104.55,-31997.47
buyer_7,Mar√≠a,56,ES69209598874776399917,TRX_N-00646-42674175,2023-07-27T17:59:50,Portugalete,Expense,leisure,-72.97,-32070.44
buyer_7,Mar√≠a,56,ES69209598874776399917,TRX_N-00647-44297507,2023-07-27T15:00:55,Portugalete,Expense,cash,-100.0,-32170.44
buyer_7,Mar√≠a,56,ES69209598874776399917,TRX_N-00648-70214103,2023-07-28T15:08:46,Portugalete,Expense,leisure,-24.64,-32195.08
buyer_7,Mar√≠a,56,ES69209598874776399917,TRX_N-00649-98929391,2023-07-31T16:20:58,Portugalete,Expense,repairs,-303.24,-32498.32
buyer_7,Mar√≠a,56,ES69209598874776399917,TRX_N-00650-89050230,2023-08-01T09:41:21,Portugalete,incomes,salary,1423.73,-31074.59
buyer_7,Mar√≠a,56,ES69209598874776399917,TRX_N-00651-92330137,2023-08-01T09:41:21,Portugalete,incomes,salary_partner,1322.16,-29752.43
buyer_7,Mar√≠a,56,ES69209598874776399917,TRX_N-00652-75359212,2023-08-01T23:43:57,Portugalete,Expense,cash,-100.0,-29852.43
buyer_7,Mar√≠a,56,ES69209598874776399917,TRX_N-00653-79024710,2023-08-01T09:13:46,Portugalete,Expense,gifts,-784.72,-30637.15
buyer_7,Mar√≠a,56,ES69209598874776399917,TRX_N-00654-69216132,2023-08-02T12:22:15,Portugalete,Expense,clothing,-102.01,-30739.16
buyer_7,Mar√≠a,56,ES69209598874776399917,TRX_N-00655-26760258,2023-08-02T22:49:07,Berango,Expense,cash,-100.0,-30839.16
buyer_7,Mar√≠a,56,ES69209598874776399917,TRX_N-00656-62521315,2023-08-03T09:29:55,Bilbao,Expense,leisure,-30.36,-30869.52
buyer_7,Mar√≠a,56,ES69209598874776399917,TRX_N-00657-62536962,2023-08-03T09:18:50,Portugalete,Expense,cash,-100.0,-30969.52
buyer_7,Mar√≠a,56,ES69209598874776399917,TRX_N-00658-91758819,2023-08-04T10:42:36,Portugalete,expenses,mortgage,-866.4,-31835.92
buyer_7,Mar√≠a,56,ES69209598874776399917,TRX_N-00659-44565707,2023-08-04T12:49:30,Portugalete,Expense,food,-68.95,-31904.87
buyer_7,Mar√≠a,56,ES69209598874776399917,TRX_N-00660-44697167,2023-08-04T20:42:25,Portugalete,Expense,leisure,-21.89,-31926.76
buyer_7,Mar√≠a,56,ES69209598874776399917,TRX_N-00661-00928873,2023-08-05T09:06:51,Portugalete,expenses,gas,-30.69,-31957.45
buyer_7,Mar√≠a,56,ES69209598874776399917,TRX_N-00662-22263799,2023-08-06T16:27:51,Portugalete,expenses,water,-41.36,-31998.81
buyer_7,Mar√≠a,56,ES69209598874776399917,TRX_N-00663-48133452,2023-08-06T10:52:02,Portugalete,expenses,phone,-37.3,-32036.11
buyer_7,Mar√≠a,56,ES69209598874776399917,TRX_N-00664-17254674,2023-08-08T11:12:20,Portugalete,expenses,internet,-42.0,-32078.11
buyer_7,Mar√≠a,56,ES69209598874776399917,TRX_N-00665-84894797,2023-08-08T15:04:51,Portugalete,expenses,electricity,-72.36,-32150.47
buyer_7,Mar√≠a,56,ES69209598874776399917,TRX_N-00666-11547816,2023-08-08T18:57:03,Portugalete,Expense,transport,-62.17,-32212.64
buyer_7,Mar√≠a,56,ES69209598874776399917,TRX_N-00667-44445324,2023-08-08T04:15:06,Portugalete,Expense,leisure,-70.25,-32282.89
buyer_7,Mar√≠a,56,ES69209598874776399917,TRX_N-00668-98806936,2023-08-10T19:47:35,Portugalete,Expense,education,-60.45,-32343.34
buyer_7,Mar√≠a,56,ES69209598874776399917,TRX_N-00669-85239051,2023-08-13T09:53:25,Portugalete,Expense,food,-80.66,-32424.0
buyer_7,Mar√≠a,56,ES69209598874776399917,TRX_N-00670-21425174,2023-08-13T12:09:38,Portugalete,Expense,cash,-100.0,-32524.0
buyer_7,Mar√≠a,56,ES69209598874776399917,TRX_N-00671-30781820,2023-08-14T17:49:43,Portugalete,Expense,food,-97.19,-32621.19
buyer_7,Mar√≠a,56,ES69209598874776399917,TRX_N-00672-50191170,2023-08-16T07:10:47,Portugalete,Expense,clothing,-91.41,-32712.6
buyer_7,Mar√≠a,56,ES69209598874776399917,TRX_N-00673-56201016,2023-08-16T14:48:03,Portugalete,expenses,children,-189.67,-32902.27
buyer_7,Mar√≠a,56,ES69209598874776399917,TRX_N-00674-06842161,2023-08-17T10:36:46,Portugalete,Expense,cash,-100.0,-33002.27
buyer_7,Mar√≠a,56,ES69209598874776399917,TRX_N-00675-81069653,2023-08-18T17:04:05,Zarautz,Expense,repairs,-175.05,-33177.32
buyer_7,Mar√≠a,56,ES69209598874776399917,TRX_N-00676-29644808,2023-08-19T18:01:38,Portugalete,Expense,cash,-100.0,-33277.32
buyer_7,Mar√≠a,56,ES69209598874776399917,TRX_N-00677-76251919,2023-08-21T10:07:22,Portugalete,Expense,transport,-86.3,-33363.62
buyer_7,Mar√≠a,56,ES69209598874776399917,TRX_N-00678-25775765,2023-08-21T11:29:11,Hernani,Expense,clothing,-67.5,-33431.12
buyer_7,Mar√≠a,56,ES69209598874776399917,TRX_N-00679-63702330,2023-08-21T13:11:16,Portugalete,Expense,cash,-100.0,-33531.12
buyer_7,Mar√≠a,56,ES69209598874776399917,TRX_N-00680-94597057,2023-08-22T07:50:40,Portugalete,Expense,repairs,-258.55,-33789.67
buyer_7,Mar√≠a,56,ES69209598874776399917,TRX_N-00681-44541544,2023-08-23T10:24:49,Portugalete,Expense,clothing,-154.59,-33944.26
buyer_7,Mar√≠a,56,ES69209598874776399917,TRX_N-00682-00926232,2023-08-23T14:33:25,Berango,Expense,cash,-100.0,-34044.26
buyer_7,Mar√≠a,56,ES69209598874776399917,TRX_N-00683-93614915,2023-08-23T12:22:53,Eibar,Expense,gifts,-41.92,-34086.18
buyer_7,Mar√≠a,56,ES69209598874776399917,TRX_N-00684-39415763,2023-08-24T11:35:23,Portugalete,Expense,education,-50.25,-34136.43
buyer_7,Mar√≠a,56,ES69209598874776399917,TRX_N-00685-67771018,2023-08-24T09:27:01,Mungia,Expense,cash,-100.0,-34236.43
buyer_7,Mar√≠a,56,ES69209598874776399917,TRX_N-00686-99992882,2023-08-27T23:31:16,Portugalete,Expense,cash,-100.0,-34336.43
buyer_7,Mar√≠a,56,ES69209598874776399917,TRX_N-00687-13915137,2023-08-29T02:48:22,Amurrio,Expense,cash,-100.0,-34436.43
buyer_7,Mar√≠a,56,ES69209598874776399917,TRX_N-00688-06916150,2023-08-30T20:26:35,Portugalete,expenses,children,-50.23,-34486.66
buyer_7,Mar√≠a,56,ES69209598874776399917,TRX_N-00689-52163111,2023-08-31T10:49:50,Portugalete,Expense,transport,-84.02,-34570.68
buyer_7,Mar√≠a,56,ES69209598874776399917,TRX_N-00690-22653808,2023-09-01T18:37:26,Portugalete,incomes,salary,1423.73,-33146.95
buyer_7,Mar√≠a,56,ES69209598874776399917,TRX_N-00691-26703885,2023-09-01T18:37:26,Portugalete,incomes,salary_partner,1322.16,-31824.79
buyer_7,Mar√≠a,56,ES69209598874776399917,TRX_N-00692-93021474,2023-09-01T13:56:42,Portugalete,Expense,cash,-100.0,-31924.79
buyer_7,Mar√≠a,56,ES69209598874776399917,TRX_N-00693-84549731,2023-09-04T08:58:49,Portugalete,expenses,mortgage,-866.4,-32791.19
buyer_7,Mar√≠a,56,ES69209598874776399917,TRX_N-00694-62567965,2023-09-04T12:31:06,Salvatierra/Agurain,Expense,food,-84.88,-32876.07
buyer_7,Mar√≠a,56,ES69209598874776399917,TRX_N-00695-60935446,2023-09-06T06:56:21,Portugalete,expenses,electricity,-81.33,-32957.4
buyer_7,Mar√≠a,56,ES69209598874776399917,TRX_N-00696-59219796,2023-09-06T12:36:29,Basauri,Expense,gifts,-274.29,-33231.69
buyer_7,Mar√≠a,56,ES69209598874776399917,TRX_N-00697-15025960,2023-09-07T11:49:56,Portugalete,expenses,gas,-101.41,-33333.1
buyer_7,Mar√≠a,56,ES69209598874776399917,TRX_N-00698-44423321,2023-09-07T18:53:57,Portugalete,Expense,clothing,-89.52,-33422.62
buyer_7,Mar√≠a,56,ES69209598874776399917,TRX_N-00699-49057598,2023-09-08T08:04:30,Portugalete,expenses,internet,-42.0,-33464.62
buyer_7,Mar√≠a,56,ES69209598874776399917,TRX_N-00700-54450131,2023-09-08T13:34:07,Portugalete,expenses,water,-28.51,-33493.13
buyer_7,Mar√≠a,56,ES69209598874776399917,TRX_N-00701-76929860,2023-09-08T15:49:01,Portugalete,expenses,phone,-39.6,-33532.73
buyer_7,Mar√≠a,56,ES69209598874776399917,TRX_N-00702-43144366,2023-09-08T08:54:07,Portugalete,Expense,leisure,-18.52,-33551.25
buyer_7,Mar√≠a,56,ES69209598874776399917,TRX_N-00703-14843173,2023-09-08T16:09:11,Portugalete,Expense,cash,-100.0,-33651.25
buyer_7,Mar√≠a,56,ES69209598874776399917,TRX_N-00704-56566884,2023-09-08T23:10:51,Portugalete,expenses,children,-71.54,-33722.79
buyer_7,Mar√≠a,56,ES69209598874776399917,TRX_N-00705-89231017,2023-09-10T13:05:52,Getxo,Expense,leisure,-19.71,-33742.5
buyer_7,Mar√≠a,56,ES69209598874776399917,TRX_N-00706-30271886,2023-09-10T17:29:35,Portugalete,Expense,cash,-100.0,-33842.5
buyer_7,Mar√≠a,56,ES69209598874776399917,TRX_N-00707-53003977,2023-09-12T16:28:37,Portugalete,Expense,leisure,-61.53,-33904.03
buyer_7,Mar√≠a,56,ES69209598874776399917,TRX_N-00708-51723348,2023-09-12T12:04:30,Irun,Expense,appliances,-383.06,-34287.09
buyer_7,Mar√≠a,56,ES69209598874776399917,TRX_N-00709-04450647,2023-09-12T14:16:30,Portugalete,Expense,repairs,-281.15,-34568.24
buyer_7,Mar√≠a,56,ES69209598874776399917,TRX_N-00710-60583425,2023-09-13T11:18:29,Portugalete,Expense,cash,-100.0,-34668.24
buyer_7,Mar√≠a,56,ES69209598874776399917,TRX_N-00711-69363466,2023-09-14T00:02:35,Portugalete,Expense,clothing,-148.8,-34817.04
buyer_7,Mar√≠a,56,ES69209598874776399917,TRX_N-00712-41546321,2023-09-14T12:55:17,Portugalete,Expense,cash,-100.0,-34917.04
buyer_7,Mar√≠a,56,ES69209598874776399917,TRX_N-00713-63167646,2023-09-15T14:49:02,Llodio,Expense,repairs,-161.61,-35078.65
buyer_7,Mar√≠a,56,ES69209598874776399917,TRX_N-00714-20191957,2023-09-17T15:01:31,Portugalete,Expense,transport,-86.84,-35165.49
buyer_7,Mar√≠a,56,ES69209598874776399917,TRX_N-00715-43335531,2023-09-17T10:08:50,Portugalete,Expense,education,-64.32,-35229.81
buyer_7,Mar√≠a,56,ES69209598874776399917,TRX_N-00716-93119494,2023-09-18T11:44:12,Pasaia,Expense,food,-123.77,-35353.58
buyer_7,Mar√≠a,56,ES69209598874776399917,TRX_N-00717-93984137,2023-09-18T15:13:00,Erandio,Expense,cash,-100.0,-35453.58
buyer_7,Mar√≠a,56,ES69209598874776399917,TRX_N-00718-65289241,2023-09-19T20:06:30,Portugalete,Expense,transport,-86.29,-35539.87
buyer_7,Mar√≠a,56,ES69209598874776399917,TRX_N-00719-05356645,2023-09-20T14:30:10,Portugalete,Expense,gifts,-529.93,-36069.8
buyer_7,Mar√≠a,56,ES69209598874776399917,TRX_N-00720-54149995,2023-09-21T20:06:27,Portugalete,Expense,food,-97.87,-36167.67
buyer_7,Mar√≠a,56,ES69209598874776399917,TRX_N-00721-17804905,2023-09-22T16:21:36,Portugalete,expenses,children,-255.5,-36423.17
buyer_7,Mar√≠a,56,ES69209598874776399917,TRX_N-00722-19052174,2023-09-23T23:54:43,Portugalete,Expense,leisure,-18.25,-36441.42
buyer_7,Mar√≠a,56,ES69209598874776399917,TRX_N-00723-91351352,2023-09-23T08:05:29,Portugalete,Expense,healthcare,-123.28,-36564.7
buyer_7,Mar√≠a,56,ES69209598874776399917,TRX_N-00724-34292774,2023-09-24T12:28:23,Portugalete,Expense,cash,-100.0,-36664.7
buyer_7,Mar√≠a,56,ES69209598874776399917,TRX_N-00725-54672079,2023-09-25T13:42:05,Portugalete,Expense,education,-61.59,-36726.29
buyer_7,Mar√≠a,56,ES69209598874776399917,TRX_N-00726-58030705,2023-09-27T14:56:00,Portugalete,Expense,food,-68.49,-36794.78
buyer_7,Mar√≠a,56,ES69209598874776399917,TRX_N-00727-74842530,2023-09-27T15:06:22,Labastida,Expense,clothing,-77.76,-36872.54
buyer_7,Mar√≠a,56,ES69209598874776399917,TRX_N-00728-56319720,2023-09-28T21:43:36,Portugalete,Expense,food,-97.59,-36970.13
buyer_7,Mar√≠a,56,ES69209598874776399917,TRX_N-00729-30339011,2023-09-29T20:43:02,Portugalete,Expense,food,-105.62,-37075.75
buyer_7,Mar√≠a,56,ES69209598874776399917,TRX_N-00730-83556720,2023-09-30T21:01:40,Portugalete,Expense,food,-103.45,-37179.2
buyer_7,Mar√≠a,56,ES69209598874776399917,TRX_N-00731-78885498,2023-10-01T19:50:21,Portugalete,incomes,salary,1423.73,-35755.47
buyer_7,Mar√≠a,56,ES69209598874776399917,TRX_N-00732-32534658,2023-10-01T19:50:21,Portugalete,incomes,salary_partner,1322.16,-34433.31
buyer_7,Mar√≠a,56,ES69209598874776399917,TRX_N-00733-07372370,2023-10-01T19:50:21,Portugalete,incomes,extra_income,160.8,-34272.51
buyer_7,Mar√≠a,56,ES69209598874776399917,TRX_N-00734-22622223,2023-10-03T12:23:06,Llodio,Expense,food,-121.18,-34393.69
buyer_7,Mar√≠a,56,ES69209598874776399917,TRX_N-00735-36548607,2023-10-03T14:21:16,Portugalete,Expense,cash,-100.0,-34493.69
buyer_7,Mar√≠a,56,ES69209598874776399917,TRX_N-00736-99992613,2023-10-04T11:34:27,Portugalete,expenses,mortgage,-866.4,-35360.09
buyer_7,Mar√≠a,56,ES69209598874776399917,TRX_N-00737-47207279,2023-10-04T17:45:44,Leioa,Expense,food,-105.9,-35465.99
buyer_7,Mar√≠a,56,ES69209598874776399917,TRX_N-00738-66211023,2023-10-05T16:35:59,Portugalete,Expense,transport,-78.48,-35544.47
buyer_7,Mar√≠a,56,ES69209598874776399917,TRX_N-00739-29956423,2023-10-05T16:42:26,Leioa,Expense,gifts,-521.47,-36065.94
buyer_7,Mar√≠a,56,ES69209598874776399917,TRX_N-00740-74524471,2023-10-07T08:01:29,Portugalete,expenses,phone,-31.35,-36097.29
buyer_7,Mar√≠a,56,ES69209598874776399917,TRX_N-00741-38218406,2023-10-07T11:42:27,Portugalete,Expense,healthcare,-53.41,-36150.7
buyer_7,Mar√≠a,56,ES69209598874776399917,TRX_N-00742-54408338,2023-10-08T07:54:28,Portugalete,expenses,electricity,-26.13,-36176.83
buyer_7,Mar√≠a,56,ES69209598874776399917,TRX_N-00743-05356832,2023-10-08T16:47:24,Portugalete,expenses,water,-36.46,-36213.29
buyer_7,Mar√≠a,56,ES69209598874776399917,TRX_N-00744-84374179,2023-10-08T18:05:24,Portugalete,expenses,gas,-52.14,-36265.43
buyer_7,Mar√≠a,56,ES69209598874776399917,TRX_N-00745-72154944,2023-10-08T13:04:02,Portugalete,expenses,internet,-42.0,-36307.43
buyer_7,Mar√≠a,56,ES69209598874776399917,TRX_N-00746-28887532,2023-10-09T20:08:14,Portugalete,Expense,cash,-100.0,-36407.43
buyer_7,Mar√≠a,56,ES69209598874776399917,TRX_N-00747-22132149,2023-10-09T18:50:49,Elciego,Expense,gifts,-544.21,-36951.64
buyer_7,Mar√≠a,56,ES69209598874776399917,TRX_N-00748-05086425,2023-10-10T12:01:27,Portugalete,Expense,leisure,-39.81,-36991.45
buyer_7,Mar√≠a,56,ES69209598874776399917,TRX_N-00749-78913537,2023-10-11T22:08:03,Portugalete,Expense,repairs,-69.55,-37061.0
buyer_7,Mar√≠a,56,ES69209598874776399917,TRX_N-00750-63239317,2023-10-13T10:12:20,Portugalete,Expense,food,-121.2,-37182.2
buyer_7,Mar√≠a,56,ES69209598874776399917,TRX_N-00751-54486941,2023-10-16T16:47:53,Andoain,Expense,food,-94.22,-37276.42
buyer_7,Mar√≠a,56,ES69209598874776399917,TRX_N-00752-01422635,2023-10-17T16:25:39,Portugalete,Expense,cash,-100.0,-37376.42
buyer_7,Mar√≠a,56,ES69209598874776399917,TRX_N-00753-25111831,2023-10-18T09:38:28,Portugalete,Expense,transport,-70.44,-37446.86
buyer_7,Mar√≠a,56,ES69209598874776399917,TRX_N-00754-40544494,2023-10-19T14:03:30,Donostia,Expense,food,-93.34,-37540.2
buyer_7,Mar√≠a,56,ES69209598874776399917,TRX_N-00755-34851761,2023-10-19T21:28:34,Irun,Expense,leisure,-34.13,-37574.33
buyer_7,Mar√≠a,56,ES69209598874776399917,TRX_N-00756-74210032,2023-10-19T09:33:27,Portugalete,Expense,cash,-100.0,-37674.33
buyer_7,Mar√≠a,56,ES69209598874776399917,TRX_N-00757-50294774,2023-10-22T14:00:54,Zarautz,Expense,cash,-100.0,-37774.33
buyer_7,Mar√≠a,56,ES69209598874776399917,TRX_N-00758-01312591,2023-10-23T17:17:06,Portugalete,Expense,cash,-100.0,-37874.33
buyer_7,Mar√≠a,56,ES69209598874776399917,TRX_N-00759-38899267,2023-10-25T20:52:13,Portugalete,Expense,food,-114.28,-37988.61
buyer_7,Mar√≠a,56,ES69209598874776399917,TRX_N-00760-47957824,2023-10-25T18:55:26,Portugalete,Expense,transport,-52.22,-38040.83
buyer_7,Mar√≠a,56,ES69209598874776399917,TRX_N-00761-99014243,2023-10-26T08:46:42,Portugalete,Expense,leisure,-65.99,-38106.82
buyer_7,Mar√≠a,56,ES69209598874776399917,TRX_N-00762-90107214,2023-10-27T11:08:22,Portugalete,Expense,leisure,-63.41,-38170.23
buyer_7,Mar√≠a,56,ES69209598874776399917,TRX_N-00763-00080323,2023-10-27T20:23:10,Portugalete,Expense,appliances,-179.48,-38349.71
buyer_7,Mar√≠a,56,ES69209598874776399917,TRX_N-00764-46801347,2023-10-28T10:55:06,Portugalete,Expense,cash,-100.0,-38449.71
buyer_7,Mar√≠a,56,ES69209598874776399917,TRX_N-00765-31991015,2023-10-29T18:28:08,Portugalete,expenses,children,-54.16,-38503.87
buyer_7,Mar√≠a,56,ES69209598874776399917,TRX_N-00766-26008578,2023-10-30T13:08:23,Portugalete,Expense,cash,-100.0,-38603.87
buyer_7,Mar√≠a,56,ES69209598874776399917,TRX_N-00767-05637687,2023-11-01T22:01:07,Portugalete,incomes,salary,1423.73,-37180.14
buyer_7,Mar√≠a,56,ES69209598874776399917,TRX_N-00768-86387627,2023-11-01T22:01:07,Portugalete,incomes,salary_partner,1322.16,-35857.98
buyer_7,Mar√≠a,56,ES69209598874776399917,TRX_N-00769-17217288,2023-11-01T14:41:05,Portugalete,Expense,leisure,-68.82,-35926.8
buyer_7,Mar√≠a,56,ES69209598874776399917,TRX_N-00770-80536958,2023-11-02T09:04:14,Portugalete,Expense,clothing,-81.7,-36008.5
buyer_7,Mar√≠a,56,ES69209598874776399917,TRX_N-00771-37861820,2023-11-02T18:56:05,Portugalete,Expense,cash,-100.0,-36108.5
buyer_7,Mar√≠a,56,ES69209598874776399917,TRX_N-00772-83050354,2023-11-04T11:58:29,Portugalete,expenses,mortgage,-866.4,-36974.9
buyer_7,Mar√≠a,56,ES69209598874776399917,TRX_N-00773-45194105,2023-11-04T21:49:08,Portugalete,Expense,leisure,-18.77,-36993.67
buyer_7,Mar√≠a,56,ES69209598874776399917,TRX_N-00774-73407677,2023-11-04T10:40:06,Portugalete,Expense,clothing,-67.01,-37060.68
buyer_7,Mar√≠a,56,ES69209598874776399917,TRX_N-00775-84240611,2023-11-05T19:11:36,Portugalete,expenses,gas,-56.61,-37117.29
buyer_7,Mar√≠a,56,ES69209598874776399917,TRX_N-00776-77881977,2023-11-06T13:20:23,Portugalete,expenses,water,-38.74,-37156.03
buyer_7,Mar√≠a,56,ES69209598874776399917,TRX_N-00777-42987159,2023-11-06T15:54:38,Portugalete,expenses,phone,-30.49,-37186.52
buyer_7,Mar√≠a,56,ES69209598874776399917,TRX_N-00778-23746088,2023-11-07T12:32:14,Portugalete,expenses,internet,-42.0,-37228.52
buyer_7,Mar√≠a,56,ES69209598874776399917,TRX_N-00779-55207550,2023-11-08T10:46:52,Portugalete,expenses,electricity,-71.75,-37300.27
buyer_7,Mar√≠a,56,ES69209598874776399917,TRX_N-00780-70755853,2023-11-08T20:49:43,Portugalete,Expense,transport,-47.21,-37347.48
buyer_7,Mar√≠a,56,ES69209598874776399917,TRX_N-00781-81138596,2023-11-08T18:32:01,Portugalete,Expense,cash,-100.0,-37447.48
buyer_7,Mar√≠a,56,ES69209598874776399917,TRX_N-00782-04894288,2023-11-08T13:15:03,Portugalete,Expense,travel,-830.99,-38278.47
buyer_7,Mar√≠a,56,ES69209598874776399917,TRX_N-00783-28290792,2023-11-09T13:38:34,Portugalete,expenses,children,-101.32,-38379.79
buyer_7,Mar√≠a,56,ES69209598874776399917,TRX_N-00784-21592863,2023-11-11T17:39:49,Portugalete,Expense,education,-75.73,-38455.52
buyer_7,Mar√≠a,56,ES69209598874776399917,TRX_N-00785-04036273,2023-11-11T13:51:12,Portugalete,Expense,gifts,-192.73,-38648.25
buyer_7,Mar√≠a,56,ES69209598874776399917,TRX_N-00786-55217551,2023-11-15T11:39:32,Leioa,Expense,cash,-100.0,-38748.25
buyer_7,Mar√≠a,56,ES69209598874776399917,TRX_N-00787-43934718,2023-11-17T12:28:42,Eibar,Expense,healthcare,-112.35,-38860.6
buyer_7,Mar√≠a,56,ES69209598874776399917,TRX_N-00788-45099889,2023-11-18T11:03:50,Portugalete,Expense,clothing,-132.76,-38993.36
buyer_7,Mar√≠a,56,ES69209598874776399917,TRX_N-00789-24224240,2023-11-21T10:49:30,Portugalete,Expense,transport,-79.73,-39073.09
buyer_7,Mar√≠a,56,ES69209598874776399917,TRX_N-00790-28608135,2023-11-22T16:43:07,Portugalete,Expense,transport,-71.91,-39145.0
buyer_7,Mar√≠a,56,ES69209598874776399917,TRX_N-00791-07999466,2023-11-22T09:59:35,Mungia,Expense,repairs,-73.45,-39218.45
buyer_7,Mar√≠a,56,ES69209598874776399917,TRX_N-00792-09424681,2023-11-23T14:34:54,Portugalete,Expense,food,-64.43,-39282.88
buyer_7,Mar√≠a,56,ES69209598874776399917,TRX_N-00793-59910468,2023-11-23T18:24:59,Portugalete,Expense,transport,-81.78,-39364.66
buyer_7,Mar√≠a,56,ES69209598874776399917,TRX_N-00794-11191798,2023-11-23T17:16:41,Portugalete,Expense,education,-49.16,-39413.82
buyer_7,Mar√≠a,56,ES69209598874776399917,TRX_N-00795-30880315,2023-11-23T14:15:33,Hernani,Expense,cash,-100.0,-39513.82
buyer_7,Mar√≠a,56,ES69209598874776399917,TRX_N-00796-64753038,2023-11-24T10:42:20,Portugalete,Expense,clothing,-159.96,-39673.78
buyer_7,Mar√≠a,56,ES69209598874776399917,TRX_N-00797-41298790,2023-11-24T08:14:52,Portugalete,Expense,cash,-100.0,-39773.78
buyer_7,Mar√≠a,56,ES69209598874776399917,TRX_N-00798-08131834,2023-11-25T23:08:49,Portugalete,Expense,transport,-74.44,-39848.22
buyer_7,Mar√≠a,56,ES69209598874776399917,TRX_N-00799-56904202,2023-11-26T16:25:59,Mungia,Expense,appliances,-120.63,-39968.85
buyer_7,Mar√≠a,56,ES69209598874776399917,TRX_N-00800-26435305,2023-11-27T11:56:58,Portugalete,Expense,transport,-85.63,-40054.48
buyer_7,Mar√≠a,56,ES69209598874776399917,TRX_N-00801-03627313,2023-11-28T11:38:18,Erandio,Expense,clothing,-133.16,-40187.64
buyer_7,Mar√≠a,56,ES69209598874776399917,TRX_N-00802-72340074,2023-11-28T16:22:33,Oy√≥n-Oion,Expense,cash,-100.0,-40287.64
buyer_7,Mar√≠a,56,ES69209598874776399917,TRX_N-00803-66023142,2023-12-01T16:57:15,Portugalete,incomes,salary,1423.73,-38863.91
buyer_7,Mar√≠a,56,ES69209598874776399917,TRX_N-00804-24446650,2023-12-01T16:57:15,Portugalete,incomes,salary_partner,1322.16,-37541.75
buyer_7,Mar√≠a,56,ES69209598874776399917,TRX_N-00805-99873084,2023-12-01T16:57:15,Portugalete,incomes,salary_bonus,1084.13,-36457.62
buyer_7,Mar√≠a,56,ES69209598874776399917,TRX_N-00806-55936651,2023-12-01T16:57:15,Portugalete,incomes,salary_partner_bonus,1018.18,-35439.44
buyer_7,Mar√≠a,56,ES69209598874776399917,TRX_N-00807-50023777,2023-12-01T20:07:48,Portugalete,Expense,transport,-79.93,-35519.37
buyer_7,Mar√≠a,56,ES69209598874776399917,TRX_N-00808-52679239,2023-12-01T17:27:50,Portugalete,Expense,cash,-100.0,-35619.37
buyer_7,Mar√≠a,56,ES69209598874776399917,TRX_N-00809-89802470,2023-12-03T08:52:44,Portugalete,Expense,repairs,-310.7,-35930.07
buyer_7,Mar√≠a,56,ES69209598874776399917,TRX_N-00810-81271631,2023-12-04T04:38:21,Portugalete,expenses,mortgage,-866.4,-36796.47
buyer_7,Mar√≠a,56,ES69209598874776399917,TRX_N-00811-58541734,2023-12-04T11:43:51,Portugalete,Expense,transport,-67.38,-36863.85
buyer_7,Mar√≠a,56,ES69209598874776399917,TRX_N-00812-27507083,2023-12-05T11:58:32,Portugalete,expenses,gas,-70.26,-36934.11
buyer_7,Mar√≠a,56,ES69209598874776399917,TRX_N-00813-05274460,2023-12-06T12:06:51,Portugalete,expenses,internet,-42.0,-36976.11
buyer_7,Mar√≠a,56,ES69209598874776399917,TRX_N-00814-59470259,2023-12-06T17:09:33,Portugalete,Expense,leisure,-56.47,-37032.58
buyer_7,Mar√≠a,56,ES69209598874776399917,TRX_N-00815-39289850,2023-12-06T20:49:39,Portugalete,Expense,cash,-100.0,-37132.58
buyer_7,Mar√≠a,56,ES69209598874776399917,TRX_N-00816-58279566,2023-12-07T11:14:49,Portugalete,expenses,phone,-30.62,-37163.2
buyer_7,Mar√≠a,56,ES69209598874776399917,TRX_N-00817-33534365,2023-12-07T18:58:08,Portugalete,Expense,food,-72.44,-37235.64
buyer_7,Mar√≠a,56,ES69209598874776399917,TRX_N-00818-05927072,2023-12-08T09:46:26,Portugalete,expenses,water,-44.11,-37279.75
buyer_7,Mar√≠a,56,ES69209598874776399917,TRX_N-00819-71300004,2023-12-08T08:38:45,Portugalete,expenses,electricity,-65.55,-37345.3
buyer_7,Mar√≠a,56,ES69209598874776399917,TRX_N-00820-74610386,2023-12-08T09:21:46,Portugalete,Expense,education,-54.46,-37399.76
buyer_7,Mar√≠a,56,ES69209598874776399917,TRX_N-00821-77423946,2023-12-10T00:54:11,Portugalete,Expense,transport,-66.61,-37466.37
buyer_7,Mar√≠a,56,ES69209598874776399917,TRX_N-00822-05644522,2023-12-10T16:33:18,Barakaldo,Expense,cash,-100.0,-37566.37
buyer_7,Mar√≠a,56,ES69209598874776399917,TRX_N-00823-22349014,2023-12-10T06:02:00,Portugalete,Expense,repairs,-212.94,-37779.31
buyer_7,Mar√≠a,56,ES69209598874776399917,TRX_N-00824-54772866,2023-12-11T17:29:45,Portugalete,Expense,food,-111.09,-37890.4
buyer_7,Mar√≠a,56,ES69209598874776399917,TRX_N-00825-77378659,2023-12-11T11:59:20,Llodio,Expense,leisure,-71.75,-37962.15
buyer_7,Mar√≠a,56,ES69209598874776399917,TRX_N-00826-41237734,2023-12-13T20:42:16,Portugalete,Expense,gifts,-185.81,-38147.96
buyer_7,Mar√≠a,56,ES69209598874776399917,TRX_N-00827-59925724,2023-12-14T20:57:09,Portugalete,Expense,food,-97.46,-38245.42
buyer_7,Mar√≠a,56,ES69209598874776399917,TRX_N-00828-53391089,2023-12-14T13:40:45,Portugalete,Expense,clothing,-106.75,-38352.17
buyer_7,Mar√≠a,56,ES69209598874776399917,TRX_N-00829-85359252,2023-12-16T08:10:55,Portugalete,Expense,education,-51.07,-38403.24
buyer_7,Mar√≠a,56,ES69209598874776399917,TRX_N-00830-28436523,2023-12-17T04:46:46,Portugalete,expenses,children,-215.39,-38618.63
buyer_7,Mar√≠a,56,ES69209598874776399917,TRX_N-00831-20503044,2023-12-18T14:43:46,Basauri,Expense,food,-114.73,-38733.36
buyer_7,Mar√≠a,56,ES69209598874776399917,TRX_N-00832-04085315,2023-12-20T19:39:31,Portugalete,Expense,appliances,-106.26,-38839.62
buyer_7,Mar√≠a,56,ES69209598874776399917,TRX_N-00833-98672727,2023-12-20T17:52:24,Portugalete,expenses,children,-225.45,-39065.07
buyer_7,Mar√≠a,56,ES69209598874776399917,TRX_N-00834-72851798,2023-12-22T09:36:27,Getxo,Expense,food,-118.37,-39183.44
buyer_7,Mar√≠a,56,ES69209598874776399917,TRX_N-00835-63255386,2023-12-23T18:44:15,Lasarte-Oria,Expense,leisure,-79.43,-39262.87
buyer_7,Mar√≠a,56,ES69209598874776399917,TRX_N-00836-64555567,2023-12-25T12:05:59,Portugalete,Expense,food,-67.63,-39330.5
buyer_7,Mar√≠a,56,ES69209598874776399917,TRX_N-00837-60238094,2023-12-25T08:10:48,Portugalete,Expense,cash,-100.0,-39430.5
buyer_7,Mar√≠a,56,ES69209598874776399917,TRX_N-00838-63203352,2023-12-27T13:25:14,Portugalete,Expense,food,-68.27,-39498.77
buyer_7,Mar√≠a,56,ES69209598874776399917,TRX_N-00839-22690962,2023-12-27T12:46:45,Portugalete,Expense,healthcare,-135.17,-39633.94
buyer_7,Mar√≠a,56,ES69209598874776399917,TRX_N-00840-07361947,2023-12-28T11:38:17,Portugalete,Expense,healthcare,-124.6,-39758.54
buyer_7,Mar√≠a,56,ES69209598874776399917,TRX_N-00841-57952310,2023-12-29T12:54:18,Portugalete,Expense,leisure,-41.35,-39799.89
buyer_7,Mar√≠a,56,ES69209598874776399917,TRX_N-00842-24519619,2023-12-29T11:29:06,Portugalete,expenses,children,-215.42,-40015.31
buyer_7,Mar√≠a,56,ES69209598874776399917,TRX_N-00843-70377944,2023-12-30T01:13:14,Portugalete,Expense,transport,-79.19,-40094.5
buyer_7,Mar√≠a,56,ES69209598874776399917,TRX_N-00844-68458448,2023-12-31T10:31:32,Portugalete,Expense,transport,-88.11,-40182.61
buyer_7,Mar√≠a,56,ES69209598874776399917,TRX_N-00845-08008588,2024-01-01T09:06:07,Portugalete,incomes,salary,1476.39,-38706.22
buyer_7,Mar√≠a,56,ES69209598874776399917,TRX_N-00846-44517635,2024-01-01T09:06:07,Portugalete,incomes,salary_partner,1371.06,-37335.16
buyer_7,Mar√≠a,56,ES69209598874776399917,TRX_N-00847-80923338,2024-01-02T19:55:06,Portugalete,Expense,transport,-81.94,-37417.1
buyer_7,Mar√≠a,56,ES69209598874776399917,TRX_N-00848-60224970,2024-01-02T17:34:05,Portugalete,Expense,leisure,-23.19,-37440.29
buyer_7,Mar√≠a,56,ES69209598874776399917,TRX_N-00849-07275051,2024-01-04T06:51:47,Portugalete,expenses,mortgage,-866.4,-38306.69
buyer_7,Mar√≠a,56,ES69209598874776399917,TRX_N-00850-64194945,2024-01-04T13:48:43,Portugalete,Expense,cash,-100.0,-38406.69
buyer_7,Mar√≠a,56,ES69209598874776399917,TRX_N-00851-17428860,2024-01-05T17:20:40,Portugalete,expenses,water,-39.1,-38445.79
buyer_7,Mar√≠a,56,ES69209598874776399917,TRX_N-00852-08461804,2024-01-05T19:32:03,Portugalete,expenses,electricity,-60.84,-38506.63
buyer_7,Mar√≠a,56,ES69209598874776399917,TRX_N-00853-92259956,2024-01-05T09:28:20,Portugalete,expenses,gas,-104.15,-38610.78
buyer_7,Mar√≠a,56,ES69209598874776399917,TRX_N-00854-56279152,2024-01-05T18:21:34,Portugalete,expenses,phone,-34.45,-38645.23
buyer_7,Mar√≠a,56,ES69209598874776399917,TRX_N-00855-15061827,2024-01-06T19:28:18,Portugalete,Expense,repairs,-140.47,-38785.7
buyer_7,Mar√≠a,56,ES69209598874776399917,TRX_N-00856-97925308,2024-01-08T13:20:13,Portugalete,expenses,internet,-42.0,-38827.7
buyer_7,Mar√≠a,56,ES69209598874776399917,TRX_N-00857-75384179,2024-01-08T14:26:51,Portugalete,Expense,repairs,-27.51,-38855.21
buyer_7,Mar√≠a,56,ES69209598874776399917,TRX_N-00858-58034849,2024-01-09T17:00:11,Llodio,Expense,appliances,-290.31,-39145.52
buyer_7,Mar√≠a,56,ES69209598874776399917,TRX_N-00859-27089798,2024-01-10T01:25:03,Portugalete,Expense,food,-72.33,-39217.85
buyer_7,Mar√≠a,56,ES69209598874776399917,TRX_N-00860-17690154,2024-01-10T00:40:29,Oy√≥n-Oion,Expense,gifts,-342.93,-39560.78
buyer_7,Mar√≠a,56,ES69209598874776399917,TRX_N-00861-16777993,2024-01-10T13:52:44,Portugalete,expenses,children,-106.42,-39667.2
buyer_7,Mar√≠a,56,ES69209598874776399917,TRX_N-00862-29583969,2024-01-11T15:43:57,Portugalete,Expense,cash,-100.0,-39767.2
buyer_7,Mar√≠a,56,ES69209598874776399917,TRX_N-00863-65812023,2024-01-14T08:49:39,Portugalete,Expense,transport,-70.94,-39838.14
buyer_7,Mar√≠a,56,ES69209598874776399917,TRX_N-00864-60876660,2024-01-14T08:19:18,Portugalete,Expense,repairs,-326.83,-40164.97
buyer_7,Mar√≠a,56,ES69209598874776399917,TRX_N-00865-41201464,2024-01-15T12:27:18,Portugalete,Expense,food,-83.0,-40247.97
buyer_7,Mar√≠a,56,ES69209598874776399917,TRX_N-00866-50491614,2024-01-17T08:08:09,Portugalete,Expense,food,-63.45,-40311.42
buyer_7,Mar√≠a,56,ES69209598874776399917,TRX_N-00867-72261272,2024-01-17T14:02:03,Portugalete,Expense,transport,-40.28,-40351.7
buyer_7,Mar√≠a,56,ES69209598874776399917,TRX_N-00868-61628280,2024-01-19T19:54:14,Portugalete,Expense,transport,-42.55,-40394.25
buyer_7,Mar√≠a,56,ES69209598874776399917,TRX_N-00869-76847918,2024-01-19T11:47:35,Portugalete,Expense,leisure,-83.06,-40477.31
buyer_7,Mar√≠a,56,ES69209598874776399917,TRX_N-00870-53992114,2024-01-19T19:09:28,Portugalete,Expense,appliances,-360.48,-40837.79
buyer_7,Mar√≠a,56,ES69209598874776399917,TRX_N-00871-46954883,2024-01-21T23:07:00,Portugalete,Expense,food,-111.8,-40949.59
buyer_7,Mar√≠a,56,ES69209598874776399917,TRX_N-00872-91818785,2024-01-23T23:52:42,Portugalete,Expense,leisure,-74.09,-41023.68
buyer_7,Mar√≠a,56,ES69209598874776399917,TRX_N-00873-96015538,2024-01-23T08:24:41,Portugalete,Expense,cash,-100.0,-41123.68
buyer_7,Mar√≠a,56,ES69209598874776399917,TRX_N-00874-30065914,2024-01-24T09:58:45,Portugalete,Expense,food,-122.37,-41246.05
buyer_7,Mar√≠a,56,ES69209598874776399917,TRX_N-00875-63252075,2024-01-24T16:31:35,Portugalete,Expense,clothing,-99.36,-41345.41
buyer_7,Mar√≠a,56,ES69209598874776399917,TRX_N-00876-68827315,2024-01-25T10:42:06,Portugalete,Expense,clothing,-127.28,-41472.69
buyer_7,Mar√≠a,56,ES69209598874776399917,TRX_N-00877-05020536,2024-01-25T19:26:00,Portugalete,Expense,repairs,-212.73,-41685.42
buyer_7,Mar√≠a,56,ES69209598874776399917,TRX_N-00878-80143751,2024-01-26T22:28:10,Portugalete,Expense,cash,-100.0,-41785.42
buyer_7,Mar√≠a,56,ES69209598874776399917,TRX_N-00879-90644231,2024-01-26T23:35:50,Portugalete,Expense,repairs,-71.65,-41857.07
buyer_7,Mar√≠a,56,ES69209598874776399917,TRX_N-00880-97835055,2024-01-28T17:21:57,Portugalete,expenses,children,-120.37,-41977.44
buyer_7,Mar√≠a,56,ES69209598874776399917,TRX_N-00881-95970310,2024-01-29T12:46:43,Portugalete,Expense,leisure,-67.87,-42045.31
buyer_7,Mar√≠a,56,ES69209598874776399917,TRX_N-00882-06892802,2024-01-29T14:36:33,Portugalete,Expense,cash,-100.0,-42145.31
buyer_7,Mar√≠a,56,ES69209598874776399917,TRX_N-00883-86623846,2024-01-30T08:59:23,Vitoria-Gasteiz,Expense,food,-100.83,-42246.14
buyer_7,Mar√≠a,56,ES69209598874776399917,TRX_N-00884-31641168,2024-01-31T12:13:59,Portugalete,expenses,children,-107.38,-42353.52
buyer_7,Mar√≠a,56,ES69209598874776399917,TRX_N-00885-26741225,2024-02-01T08:16:29,Portugalete,incomes,salary,1476.39,-40877.13
buyer_7,Mar√≠a,56,ES69209598874776399917,TRX_N-00886-81462283,2024-02-01T08:16:29,Portugalete,incomes,salary_partner,1371.06,-39506.07
buyer_7,Mar√≠a,56,ES69209598874776399917,TRX_N-00887-30132367,2024-02-01T08:16:29,Portugalete,incomes,extra_income,160.8,-39345.27
buyer_7,Mar√≠a,56,ES69209598874776399917,TRX_N-00888-61031773,2024-02-01T16:31:52,Portugalete,Expense,leisure,-62.32,-39407.59
buyer_7,Mar√≠a,56,ES69209598874776399917,TRX_N-00889-47822111,2024-02-03T17:51:57,Portugalete,Expense,repairs,-210.26,-39617.85
buyer_7,Mar√≠a,56,ES69209598874776399917,TRX_N-00890-37277526,2024-02-04T16:39:58,Portugalete,expenses,mortgage,-866.4,-40484.25
buyer_7,Mar√≠a,56,ES69209598874776399917,TRX_N-00891-19899608,2024-02-05T14:14:25,Portugalete,expenses,electricity,-56.75,-40541.0
buyer_7,Mar√≠a,56,ES69209598874776399917,TRX_N-00892-40387199,2024-02-05T13:41:10,Portugalete,expenses,gas,-41.74,-40582.74
buyer_7,Mar√≠a,56,ES69209598874776399917,TRX_N-00893-17732518,2024-02-05T05:21:17,Portugalete,expenses,phone,-30.32,-40613.06
buyer_7,Mar√≠a,56,ES69209598874776399917,TRX_N-00894-23063450,2024-02-05T19:42:16,Portugalete,Expense,leisure,-41.51,-40654.57
buyer_7,Mar√≠a,56,ES69209598874776399917,TRX_N-00895-46155699,2024-02-07T19:57:59,Portugalete,expenses,water,-40.28,-40694.85
buyer_7,Mar√≠a,56,ES69209598874776399917,TRX_N-00896-65617272,2024-02-07T11:28:25,Portugalete,Expense,leisure,-25.23,-40720.08
buyer_7,Mar√≠a,56,ES69209598874776399917,TRX_N-00897-36765749,2024-02-08T18:34:51,Portugalete,expenses,internet,-42.0,-40762.08
buyer_7,Mar√≠a,56,ES69209598874776399917,TRX_N-00898-11134908,2024-02-09T17:40:04,Portugalete,Expense,cash,-100.0,-40862.08
buyer_7,Mar√≠a,56,ES69209598874776399917,TRX_N-00899-86899245,2024-02-10T17:26:00,Portugalete,Expense,food,-79.05,-40941.13
buyer_7,Mar√≠a,56,ES69209598874776399917,TRX_N-00900-96967253,2024-02-11T17:19:47,Leioa,Expense,cash,-100.0,-41041.13
buyer_7,Mar√≠a,56,ES69209598874776399917,TRX_N-00901-63048272,2024-02-12T17:28:36,Portugalete,Expense,cash,-100.0,-41141.13
buyer_7,Mar√≠a,56,ES69209598874776399917,TRX_N-00902-70306935,2024-02-15T19:40:29,Eibar,Expense,transport,-42.06,-41183.19
buyer_7,Mar√≠a,56,ES69209598874776399917,TRX_N-00903-70143479,2024-02-15T03:14:00,Portugalete,Expense,gifts,-113.49,-41296.68
buyer_7,Mar√≠a,56,ES69209598874776399917,TRX_N-00904-20085455,2024-02-16T18:03:58,Irun,Expense,transport,-41.98,-41338.66
buyer_7,Mar√≠a,56,ES69209598874776399917,TRX_N-00905-00568150,2024-02-16T12:31:49,Berango,Expense,cash,-100.0,-41438.66
buyer_7,Mar√≠a,56,ES69209598874776399917,TRX_N-00906-20957974,2024-02-19T23:13:54,Portugalete,Expense,healthcare,-57.52,-41496.18
buyer_7,Mar√≠a,56,ES69209598874776399917,TRX_N-00907-22428473,2024-02-19T17:15:25,Portugalete,Expense,cash,-100.0,-41596.18
buyer_7,Mar√≠a,56,ES69209598874776399917,TRX_N-00908-30245688,2024-02-21T11:25:17,Portugalete,Expense,leisure,-52.36,-41648.54
buyer_7,Mar√≠a,56,ES69209598874776399917,TRX_N-00909-12000676,2024-02-21T18:48:07,Portugalete,expenses,children,-106.67,-41755.21
buyer_7,Mar√≠a,56,ES69209598874776399917,TRX_N-00910-11743366,2024-02-24T08:45:05,Portugalete,Expense,transport,-41.19,-41796.4
buyer_7,Mar√≠a,56,ES69209598874776399917,TRX_N-00911-42770489,2024-02-26T10:36:36,Portugalete,Expense,leisure,-20.57,-41816.97
buyer_7,Mar√≠a,56,ES69209598874776399917,TRX_N-00912-21869476,2024-02-27T16:36:43,Portugalete,Expense,education,-65.98,-41882.95
buyer_7,Mar√≠a,56,ES69209598874776399917,TRX_N-00913-50931702,2024-03-01T15:17:12,Portugalete,incomes,salary,1476.39,-40406.56
buyer_7,Mar√≠a,56,ES69209598874776399917,TRX_N-00914-73300515,2024-03-01T15:17:12,Portugalete,incomes,salary_partner,1371.06,-39035.5
buyer_7,Mar√≠a,56,ES69209598874776399917,TRX_N-00915-72009824,2024-03-01T11:37:52,Portugalete,Expense,transport,-75.26,-39110.76
buyer_7,Mar√≠a,56,ES69209598874776399917,TRX_N-00916-84126805,2024-03-04T08:34:10,Portugalete,expenses,mortgage,-866.4,-39977.16
buyer_7,Mar√≠a,56,ES69209598874776399917,TRX_N-00917-80419393,2024-03-04T20:54:47,Portugalete,expenses,children,-259.85,-40237.01
buyer_7,Mar√≠a,56,ES69209598874776399917,TRX_N-00918-04078824,2024-03-06T20:52:44,Portugalete,expenses,water,-29.49,-40266.5
buyer_7,Mar√≠a,56,ES69209598874776399917,TRX_N-00919-03528535,2024-03-06T10:49:43,Portugalete,expenses,electricity,-59.39,-40325.89
buyer_7,Mar√≠a,56,ES69209598874776399917,TRX_N-00920-12843320,2024-03-06T12:09:15,Portugalete,expenses,internet,-42.0,-40367.89
buyer_7,Mar√≠a,56,ES69209598874776399917,TRX_N-00921-76030425,2024-03-06T20:56:11,Zuia,Expense,repairs,-312.52,-40680.41
buyer_7,Mar√≠a,56,ES69209598874776399917,TRX_N-00922-62732252,2024-03-07T03:24:44,Portugalete,Expense,food,-90.91,-40771.32
buyer_7,Mar√≠a,56,ES69209598874776399917,TRX_N-00923-16063515,2024-03-08T13:28:37,Portugalete,expenses,gas,-101.5,-40872.82
buyer_7,Mar√≠a,56,ES69209598874776399917,TRX_N-00924-51938879,2024-03-08T15:39:23,Portugalete,expenses,phone,-34.97,-40907.79
buyer_7,Mar√≠a,56,ES69209598874776399917,TRX_N-00925-71780548,2024-03-08T18:31:59,Portugalete,Expense,travel,-1481.66,-42389.45
buyer_7,Mar√≠a,56,ES69209598874776399917,TRX_N-00926-27888148,2024-03-09T09:05:05,Portugalete,expenses,children,-139.21,-42528.66
buyer_7,Mar√≠a,56,ES69209598874776399917,TRX_N-00927-05801118,2024-03-11T10:09:47,Portugalete,Expense,cash,-100.0,-42628.66
buyer_7,Mar√≠a,56,ES69209598874776399917,TRX_N-00928-39221652,2024-03-13T17:49:27,Leioa,Expense,clothing,-102.82,-42731.48
buyer_7,Mar√≠a,56,ES69209598874776399917,TRX_N-00929-26831742,2024-03-13T16:48:48,Portugalete,expenses,children,-174.59,-42906.07
buyer_7,Mar√≠a,56,ES69209598874776399917,TRX_N-00930-16333707,2024-03-14T20:21:51,Portugalete,Expense,cash,-100.0,-43006.07
buyer_7,Mar√≠a,56,ES69209598874776399917,TRX_N-00931-20979671,2024-03-16T19:31:00,Portugalete,Expense,food,-60.68,-43066.75
buyer_7,Mar√≠a,56,ES69209598874776399917,TRX_N-00932-76605633,2024-03-19T14:06:45,Portugalete,Expense,transport,-70.22,-43136.97
buyer_7,Mar√≠a,56,ES69209598874776399917,TRX_N-00933-96693224,2024-03-22T07:27:18,Portugalete,Expense,food,-93.62,-43230.59
buyer_7,Mar√≠a,56,ES69209598874776399917,TRX_N-00934-45222025,2024-03-22T15:36:18,Portugalete,Expense,transport,-66.06,-43296.65
buyer_7,Mar√≠a,56,ES69209598874776399917,TRX_N-00935-48099235,2024-03-22T15:19:16,Portugalete,Expense,gifts,-97.47,-43394.12
buyer_7,Mar√≠a,56,ES69209598874776399917,TRX_N-00936-34569828,2024-03-23T09:26:12,Portugalete,Expense,cash,-100.0,-43494.12
buyer_7,Mar√≠a,56,ES69209598874776399917,TRX_N-00937-60704241,2024-03-24T20:14:19,Portugalete,Expense,cash,-100.0,-43594.12
buyer_7,Mar√≠a,56,ES69209598874776399917,TRX_N-00938-64755837,2024-03-24T06:17:41,Portugalete,Expense,repairs,-235.66,-43829.78
buyer_7,Mar√≠a,56,ES69209598874776399917,TRX_N-00939-10940453,2024-03-25T12:43:32,Portugalete,Expense,food,-95.57,-43925.35
buyer_7,Mar√≠a,56,ES69209598874776399917,TRX_N-00940-40652751,2024-03-28T04:22:16,Bermeo,Expense,food,-92.84,-44018.19
buyer_7,Mar√≠a,56,ES69209598874776399917,TRX_N-00941-80442869,2024-03-29T17:43:26,Portugalete,Expense,leisure,-49.17,-44067.36
buyer_7,Mar√≠a,56,ES69209598874776399917,TRX_N-00942-55440771,2024-03-29T14:56:27,Portugalete,Expense,healthcare,-63.78,-44131.14
buyer_7,Mar√≠a,56,ES69209598874776399917,TRX_N-00943-19931867,2024-03-31T11:11:55,Portugalete,Expense,transport,-42.85,-44173.99
buyer_7,Mar√≠a,56,ES69209598874776399917,TRX_N-00944-76792998,2024-04-01T14:55:11,Portugalete,incomes,salary,1476.39,-42697.6
buyer_7,Mar√≠a,56,ES69209598874776399917,TRX_N-00945-35784824,2024-04-01T14:55:11,Portugalete,incomes,salary_partner,1371.06,-41326.54
buyer_7,Mar√≠a,56,ES69209598874776399917,TRX_N-00946-15980280,2024-04-03T19:10:47,Portugalete,Expense,transport,-80.98,-41407.52
buyer_7,Mar√≠a,56,ES69209598874776399917,TRX_N-00947-56033063,2024-04-04T04:20:43,Portugalete,expenses,mortgage,-866.4,-42273.92
buyer_7,Mar√≠a,56,ES69209598874776399917,TRX_N-00948-27632478,2024-04-05T18:01:24,Portugalete,expenses,gas,-87.15,-42361.07
buyer_7,Mar√≠a,56,ES69209598874776399917,TRX_N-00949-29823335,2024-04-06T16:47:14,Portugalete,expenses,internet,-42.0,-42403.07
buyer_7,Mar√≠a,56,ES69209598874776399917,TRX_N-00950-66054549,2024-04-06T12:32:49,Portugalete,Expense,repairs,-126.25,-42529.32
buyer_7,Mar√≠a,56,ES69209598874776399917,TRX_N-00951-20363323,2024-04-07T17:46:28,Portugalete,expenses,phone,-42.33,-42571.65
buyer_7,Mar√≠a,56,ES69209598874776399917,TRX_N-00952-00488590,2024-04-07T08:22:18,Portugalete,Expense,food,-120.58,-42692.23
buyer_7,Mar√≠a,56,ES69209598874776399917,TRX_N-00953-69575755,2024-04-08T17:31:54,Portugalete,expenses,electricity,-73.65,-42765.88
buyer_7,Mar√≠a,56,ES69209598874776399917,TRX_N-00954-43193525,2024-04-08T12:10:14,Portugalete,expenses,water,-20.87,-42786.75
buyer_7,Mar√≠a,56,ES69209598874776399917,TRX_N-00955-89668370,2024-04-08T08:02:47,Portugalete,Expense,cash,-100.0,-42886.75
buyer_7,Mar√≠a,56,ES69209598874776399917,TRX_N-00956-83038427,2024-04-08T19:08:01,Portugalete,Expense,repairs,-202.49,-43089.24
buyer_7,Mar√≠a,56,ES69209598874776399917,TRX_N-00957-07639250,2024-04-10T15:41:17,Portugalete,Expense,leisure,-78.14,-43167.38
buyer_7,Mar√≠a,56,ES69209598874776399917,TRX_N-00958-11428549,2024-04-11T08:20:25,Portugalete,Expense,food,-91.29,-43258.67
buyer_7,Mar√≠a,56,ES69209598874776399917,TRX_N-00959-94129814,2024-04-11T14:44:53,Portugalete,Expense,gifts,-288.3,-43546.97
buyer_7,Mar√≠a,56,ES69209598874776399917,TRX_N-00960-35558609,2024-04-12T09:45:24,Portugalete,Expense,transport,-61.04,-43608.01
buyer_7,Mar√≠a,56,ES69209598874776399917,TRX_N-00961-65714791,2024-04-13T06:22:54,Portugalete,Expense,food,-117.15,-43725.16
buyer_7,Mar√≠a,56,ES69209598874776399917,TRX_N-00962-62036623,2024-04-13T18:57:34,Portugalete,expenses,children,-237.1,-43962.26
buyer_7,Mar√≠a,56,ES69209598874776399917,TRX_N-00963-85971619,2024-04-16T11:12:56,Portugalete,Expense,transport,-83.02,-44045.28
buyer_7,Mar√≠a,56,ES69209598874776399917,TRX_N-00964-01500572,2024-04-16T18:07:52,Portugalete,Expense,healthcare,-135.99,-44181.27
buyer_7,Mar√≠a,56,ES69209598874776399917,TRX_N-00965-10038373,2024-04-17T20:05:50,Portugalete,Expense,transport,-63.82,-44245.09
buyer_7,Mar√≠a,56,ES69209598874776399917,TRX_N-00966-55522705,2024-04-18T18:36:49,Mungia,Expense,gifts,-574.33,-44819.42
buyer_7,Mar√≠a,56,ES69209598874776399917,TRX_N-00967-88540365,2024-04-20T15:32:02,Portugalete,Expense,leisure,-73.75,-44893.17
buyer_7,Mar√≠a,56,ES69209598874776399917,TRX_N-00968-73444946,2024-04-21T16:42:37,Sopela,Expense,cash,-100.0,-44993.17
buyer_7,Mar√≠a,56,ES69209598874776399917,TRX_N-00969-58419530,2024-04-22T12:31:55,Portugalete,Expense,food,-67.57,-45060.74
buyer_7,Mar√≠a,56,ES69209598874776399917,TRX_N-00970-31713020,2024-04-22T12:38:03,Portugalete,Expense,cash,-100.0,-45160.74
buyer_7,Mar√≠a,56,ES69209598874776399917,TRX_N-00971-14693783,2024-04-23T08:10:38,Portugalete,Expense,food,-106.7,-45267.44
buyer_7,Mar√≠a,56,ES69209598874776399917,TRX_N-00972-55303220,2024-04-24T12:12:52,Portugalete,Expense,cash,-100.0,-45367.44
buyer_7,Mar√≠a,56,ES69209598874776399917,TRX_N-00973-53519618,2024-04-25T21:01:14,Portugalete,Expense,repairs,-136.46,-45503.9
buyer_7,Mar√≠a,56,ES69209598874776399917,TRX_N-00974-56474162,2024-04-26T10:56:01,Portugalete,Expense,cash,-100.0,-45603.9
buyer_7,Mar√≠a,56,ES69209598874776399917,TRX_N-00975-04247378,2024-04-26T17:35:46,Portugalete,Expense,appliances,-361.16,-45965.06
buyer_7,Mar√≠a,56,ES69209598874776399917,TRX_N-00976-17523335,2024-04-29T04:51:34,Portugalete,Expense,cash,-100.0,-46065.06
buyer_7,Mar√≠a,56,ES69209598874776399917,TRX_N-00977-30323320,2024-04-30T18:34:51,Portugalete,Expense,repairs,-110.6,-46175.66
buyer_7,Mar√≠a,56,ES69209598874776399917,TRX_N-00978-27928078,2024-05-01T16:18:25,Portugalete,incomes,salary,1476.39,-44699.27
buyer_7,Mar√≠a,56,ES69209598874776399917,TRX_N-00979-36065692,2024-05-01T16:18:25,Portugalete,incomes,salary_partner,1371.06,-43328.21
buyer_7,Mar√≠a,56,ES69209598874776399917,TRX_N-00980-97807618,2024-05-01T16:18:25,Portugalete,incomes,extra_income,160.8,-43167.41
buyer_7,Mar√≠a,56,ES69209598874776399917,TRX_N-00981-54362078,2024-05-01T15:39:21,Labastida,Expense,leisure,-42.44,-43209.85
buyer_7,Mar√≠a,56,ES69209598874776399917,TRX_N-00982-42301610,2024-05-02T10:17:06,Amurrio,Expense,cash,-100.0,-43309.85
buyer_7,Mar√≠a,56,ES69209598874776399917,TRX_N-00983-85607984,2024-05-03T00:42:06,Portugalete,Expense,leisure,-54.67,-43364.52
buyer_7,Mar√≠a,56,ES69209598874776399917,TRX_N-00984-31555720,2024-05-03T09:12:22,Portugalete,Expense,cash,-100.0,-43464.52
buyer_7,Mar√≠a,56,ES69209598874776399917,TRX_N-00985-41842423,2024-05-03T11:49:04,Portugalete,expenses,children,-278.64,-43743.16
buyer_7,Mar√≠a,56,ES69209598874776399917,TRX_N-00986-42637680,2024-05-04T11:01:51,Portugalete,expenses,mortgage,-866.4,-44609.56
buyer_7,Mar√≠a,56,ES69209598874776399917,TRX_N-00987-68839948,2024-05-04T21:02:23,Portugalete,Expense,cash,-100.0,-44709.56
buyer_7,Mar√≠a,56,ES69209598874776399917,TRX_N-00988-59829417,2024-05-05T12:26:52,Portugalete,expenses,electricity,-85.05,-44794.61
buyer_7,Mar√≠a,56,ES69209598874776399917,TRX_N-00989-26346596,2024-05-05T13:14:02,Sestao,Expense,cash,-100.0,-44894.61
buyer_7,Mar√≠a,56,ES69209598874776399917,TRX_N-00990-26793449,2024-05-07T21:15:31,Portugalete,expenses,phone,-38.54,-44933.15
buyer_7,Mar√≠a,56,ES69209598874776399917,TRX_N-00991-65536576,2024-05-08T18:25:41,Portugalete,expenses,water,-29.78,-44962.93
buyer_7,Mar√≠a,56,ES69209598874776399917,TRX_N-00992-13976324,2024-05-08T19:17:13,Portugalete,expenses,internet,-42.0,-45004.93
buyer_7,Mar√≠a,56,ES69209598874776399917,TRX_N-00993-64242341,2024-05-08T15:02:21,Portugalete,expenses,gas,-32.73,-45037.66
buyer_7,Mar√≠a,56,ES69209598874776399917,TRX_N-00994-32196709,2024-05-09T08:25:08,Portugalete,Expense,food,-118.51,-45156.17
buyer_7,Mar√≠a,56,ES69209598874776399917,TRX_N-00995-69310890,2024-05-09T05:38:24,Portugalete,Expense,transport,-84.09,-45240.26
buyer_7,Mar√≠a,56,ES69209598874776399917,TRX_N-00996-75125091,2024-05-09T10:25:22,Portugalete,Expense,cash,-100.0,-45340.26
buyer_7,Mar√≠a,56,ES69209598874776399917,TRX_N-00997-63210797,2024-05-09T13:00:55,Portugalete,Expense,appliances,-246.93,-45587.19
buyer_7,Mar√≠a,56,ES69209598874776399917,TRX_N-00998-94632016,2024-05-11T17:57:12,Portugalete,Expense,food,-105.97,-45693.16
buyer_7,Mar√≠a,56,ES69209598874776399917,TRX_N-00999-65117667,2024-05-11T06:02:24,Portugalete,Expense,clothing,-61.81,-45754.97
buyer_7,Mar√≠a,56,ES69209598874776399917,TRX_N-01000-99941473,2024-05-11T08:12:59,Pasaia,Expense,cash,-100.0,-45854.97
buyer_7,Mar√≠a,56,ES69209598874776399917,TRX_N-01001-26119430,2024-05-11T22:54:36,Portugalete,Expense,gifts,-832.03,-46687.0
buyer_7,Mar√≠a,56,ES69209598874776399917,TRX_N-01002-45792680,2024-05-12T20:15:52,Portugalete,Expense,clothing,-91.55,-46778.55
buyer_7,Mar√≠a,56,ES69209598874776399917,TRX_N-01003-47388449,2024-05-14T08:46:06,Portugalete,Expense,cash,-100.0,-46878.55
buyer_7,Mar√≠a,56,ES69209598874776399917,TRX_N-01004-43606403,2024-05-15T12:12:58,Portugalete,Expense,food,-106.15,-46984.7
buyer_7,Mar√≠a,56,ES69209598874776399917,TRX_N-01005-34532329,2024-05-17T03:26:21,Portugalete,Expense,food,-86.72,-47071.42
buyer_7,Mar√≠a,56,ES69209598874776399917,TRX_N-01006-63755319,2024-05-17T17:08:28,Portugalete,Expense,healthcare,-154.64,-47226.06
buyer_7,Mar√≠a,56,ES69209598874776399917,TRX_N-01007-36283446,2024-05-19T11:22:37,Portugalete,Expense,travel,-723.29,-47949.35
buyer_7,Mar√≠a,56,ES69209598874776399917,TRX_N-01008-91932498,2024-05-22T19:00:59,Portugalete,Expense,cash,-100.0,-48049.35
buyer_7,Mar√≠a,56,ES69209598874776399917,TRX_N-01009-60971356,2024-05-25T11:32:13,Portugalete,Expense,cash,-100.0,-48149.35
buyer_7,Mar√≠a,56,ES69209598874776399917,TRX_N-01010-81780507,2024-05-26T13:51:40,Amurrio,Expense,cash,-100.0,-48249.35
buyer_7,Mar√≠a,56,ES69209598874776399917,TRX_N-01011-87555397,2024-05-28T13:13:12,Portugalete,Expense,food,-104.73,-48354.08
buyer_7,Mar√≠a,56,ES69209598874776399917,TRX_N-01012-52812016,2024-05-28T05:39:28,Portugalete,Expense,clothing,-94.48,-48448.56
buyer_7,Mar√≠a,56,ES69209598874776399917,TRX_N-01013-74841921,2024-06-01T20:34:00,Portugalete,incomes,salary,1476.39,-46972.17
buyer_7,Mar√≠a,56,ES69209598874776399917,TRX_N-01014-33074439,2024-06-01T20:34:00,Portugalete,incomes,salary_partner,1371.06,-45601.11
buyer_7,Mar√≠a,56,ES69209598874776399917,TRX_N-01015-80372417,2024-06-01T20:34:00,Portugalete,incomes,salary_bonus,1096.74,-44504.37
buyer_7,Mar√≠a,56,ES69209598874776399917,TRX_N-01016-02280196,2024-06-01T20:34:00,Portugalete,incomes,salary_partner_bonus,1034.96,-43469.41
buyer_7,Mar√≠a,56,ES69209598874776399917,TRX_N-01017-43182630,2024-06-04T12:33:04,Portugalete,expenses,mortgage,-866.4,-44335.81
buyer_7,Mar√≠a,56,ES69209598874776399917,TRX_N-01018-44997347,2024-06-04T20:49:50,Portugalete,Expense,cash,-100.0,-44435.81
buyer_7,Mar√≠a,56,ES69209598874776399917,TRX_N-01019-75745951,2024-06-05T13:03:22,Portugalete,Expense,cash,-100.0,-44535.81
buyer_7,Mar√≠a,56,ES69209598874776399917,TRX_N-01020-66859445,2024-06-06T09:27:20,Portugalete,expenses,electricity,-21.97,-44557.78
buyer_7,Mar√≠a,56,ES69209598874776399917,TRX_N-01021-48913961,2024-06-07T08:42:15,Portugalete,expenses,water,-31.51,-44589.29
buyer_7,Mar√≠a,56,ES69209598874776399917,TRX_N-01022-75619423,2024-06-08T15:44:41,Portugalete,expenses,gas,-68.07,-44657.36
buyer_7,Mar√≠a,56,ES69209598874776399917,TRX_N-01023-41722376,2024-06-08T15:30:59,Portugalete,expenses,internet,-42.0,-44699.36
buyer_7,Mar√≠a,56,ES69209598874776399917,TRX_N-01024-58120527,2024-06-08T11:37:32,Portugalete,expenses,phone,-35.36,-44734.72
buyer_7,Mar√≠a,56,ES69209598874776399917,TRX_N-01025-51481829,2024-06-08T18:22:51,Portugalete,Expense,leisure,-41.13,-44775.85
buyer_7,Mar√≠a,56,ES69209598874776399917,TRX_N-01026-07866964,2024-06-08T11:49:02,Portugalete,expenses,children,-132.4,-44908.25
buyer_7,Mar√≠a,56,ES69209598874776399917,TRX_N-01027-28428534,2024-06-10T13:08:26,Portugalete,Expense,leisure,-33.58,-44941.83
buyer_7,Mar√≠a,56,ES69209598874776399917,TRX_N-01028-76322361,2024-06-10T18:38:57,Portugalete,Expense,cash,-100.0,-45041.83
buyer_7,Mar√≠a,56,ES69209598874776399917,TRX_N-01029-34002849,2024-06-11T15:42:15,Portugalete,Expense,leisure,-54.66,-45096.49
buyer_7,Mar√≠a,56,ES69209598874776399917,TRX_N-01030-20220042,2024-06-12T11:48:53,Portugalete,Expense,food,-64.39,-45160.88
buyer_7,Mar√≠a,56,ES69209598874776399917,TRX_N-01031-68295357,2024-06-13T09:39:07,Portugalete,Expense,cash,-100.0,-45260.88
buyer_7,Mar√≠a,56,ES69209598874776399917,TRX_N-01032-54178125,2024-06-14T13:43:30,Portugalete,Expense,repairs,-135.09,-45395.97
buyer_7,Mar√≠a,56,ES69209598874776399917,TRX_N-01033-75270271,2024-06-17T23:23:42,Portugalete,Expense,food,-117.18,-45513.15
buyer_7,Mar√≠a,56,ES69209598874776399917,TRX_N-01034-99084693,2024-06-18T16:58:53,Portugalete,Expense,transport,-83.27,-45596.42
buyer_7,Mar√≠a,56,ES69209598874776399917,TRX_N-01035-44427335,2024-06-20T11:13:19,Portugalete,Expense,leisure,-48.92,-45645.34
buyer_7,Mar√≠a,56,ES69209598874776399917,TRX_N-01036-10089146,2024-06-20T16:28:09,Portugalete,Expense,cash,-100.0,-45745.34
buyer_7,Mar√≠a,56,ES69209598874776399917,TRX_N-01037-71769229,2024-06-21T16:15:15,Portugalete,Expense,appliances,-197.76,-45943.1
buyer_7,Mar√≠a,56,ES69209598874776399917,TRX_N-01038-69139726,2024-06-23T13:36:13,Portugalete,Expense,clothing,-126.84,-46069.94
buyer_7,Mar√≠a,56,ES69209598874776399917,TRX_N-01039-23338933,2024-06-23T16:28:37,Portugalete,Expense,appliances,-90.15,-46160.09
buyer_7,Mar√≠a,56,ES69209598874776399917,TRX_N-01040-90206021,2024-06-24T16:09:13,Portugalete,Expense,leisure,-62.02,-46222.11
buyer_7,Mar√≠a,56,ES69209598874776399917,TRX_N-01041-68884052,2024-06-26T13:55:26,Portugalete,Expense,food,-107.62,-46329.73
buyer_7,Mar√≠a,56,ES69209598874776399917,TRX_N-01042-90587304,2024-06-26T13:14:21,Portugalete,Expense,cash,-100.0,-46429.73
buyer_7,Mar√≠a,56,ES69209598874776399917,TRX_N-01043-78805863,2024-06-27T21:28:51,Portugalete,Expense,leisure,-59.58,-46489.31
buyer_7,Mar√≠a,56,ES69209598874776399917,TRX_N-01044-24135115,2024-06-28T05:53:46,Portugalete,Expense,repairs,-164.81,-46654.12
buyer_7,Mar√≠a,56,ES69209598874776399917,TRX_N-01045-36003549,2024-06-30T04:49:44,Portugalete,expenses,children,-55.33,-46709.45
buyer_7,Mar√≠a,56,ES69209598874776399917,TRX_N-01046-20552092,2024-07-01T12:36:33,Portugalete,incomes,salary,1476.39,-45233.06
buyer_7,Mar√≠a,56,ES69209598874776399917,TRX_N-01047-46797350,2024-07-01T12:36:33,Portugalete,incomes,salary_partner,1371.06,-43862.0
buyer_7,Mar√≠a,56,ES69209598874776399917,TRX_N-01048-89775309,2024-07-01T16:01:37,Salvatierra/Agurain,Expense,food,-95.11,-43957.11
buyer_7,Mar√≠a,56,ES69209598874776399917,TRX_N-01049-90139790,2024-07-02T09:26:06,Portugalete,Expense,cash,-100.0,-44057.11
buyer_7,Mar√≠a,56,ES69209598874776399917,TRX_N-01050-77526572,2024-07-03T18:48:20,Portugalete,Expense,transport,-67.14,-44124.25
buyer_7,Mar√≠a,56,ES69209598874776399917,TRX_N-01051-18753526,2024-07-04T15:03:10,Portugalete,expenses,mortgage,-866.4,-44990.65
buyer_7,Mar√≠a,56,ES69209598874776399917,TRX_N-01052-96822190,2024-07-05T16:10:22,Portugalete,expenses,water,-23.14,-45013.79
buyer_7,Mar√≠a,56,ES69209598874776399917,TRX_N-01053-35575859,2024-07-05T14:37:29,Portugalete,expenses,internet,-42.0,-45055.79
buyer_7,Mar√≠a,56,ES69209598874776399917,TRX_N-01054-50233791,2024-07-06T12:20:29,Portugalete,Expense,food,-88.37,-45144.16
buyer_7,Mar√≠a,56,ES69209598874776399917,TRX_N-01055-10674630,2024-07-07T10:24:18,Portugalete,expenses,electricity,-22.77,-45166.93
buyer_7,Mar√≠a,56,ES69209598874776399917,TRX_N-01056-66063218,2024-07-08T19:16:55,Portugalete,expenses,phone,-40.28,-45207.21
buyer_7,Mar√≠a,56,ES69209598874776399917,TRX_N-01057-06178737,2024-07-08T22:05:31,Portugalete,expenses,gas,-98.92,-45306.13
buyer_7,Mar√≠a,56,ES69209598874776399917,TRX_N-01058-16995571,2024-07-08T17:10:37,Zuia,Expense,cash,-100.0,-45406.13
buyer_7,Mar√≠a,56,ES69209598874776399917,TRX_N-01059-05673444,2024-07-09T14:53:49,Portugalete,Expense,food,-92.66,-45498.79
buyer_7,Mar√≠a,56,ES69209598874776399917,TRX_N-01060-67598824,2024-07-09T12:46:54,Portugalete,Expense,healthcare,-126.63,-45625.42
buyer_7,Mar√≠a,56,ES69209598874776399917,TRX_N-01061-14686687,2024-07-10T21:43:34,Portugalete,Expense,food,-66.32,-45691.74
buyer_7,Mar√≠a,56,ES69209598874776399917,TRX_N-01062-67820489,2024-07-10T20:17:31,Portugalete,Expense,repairs,-324.67,-46016.41
buyer_7,Mar√≠a,56,ES69209598874776399917,TRX_N-01063-18740571,2024-07-11T12:13:51,Portugalete,Expense,education,-56.39,-46072.8
buyer_7,Mar√≠a,56,ES69209598874776399917,TRX_N-01064-22994937,2024-07-12T12:02:16,Portugalete,Expense,food,-108.34,-46181.14
buyer_7,Mar√≠a,56,ES69209598874776399917,TRX_N-01065-13595186,2024-07-13T03:04:13,Portugalete,Expense,food,-90.49,-46271.63
buyer_7,Mar√≠a,56,ES69209598874776399917,TRX_N-01066-61151896,2024-07-15T12:45:18,Portugalete,Expense,food,-79.46,-46351.09
buyer_7,Mar√≠a,56,ES69209598874776399917,TRX_N-01067-55016627,2024-07-15T09:02:02,Portugalete,Expense,leisure,-30.46,-46381.55
buyer_7,Mar√≠a,56,ES69209598874776399917,TRX_N-01068-58749698,2024-07-15T18:01:40,Portugalete,Expense,repairs,-240.56,-46622.11
buyer_7,Mar√≠a,56,ES69209598874776399917,TRX_N-01069-29433073,2024-07-17T11:42:52,Basauri,Expense,transport,-63.9,-46686.01
buyer_7,Mar√≠a,56,ES69209598874776399917,TRX_N-01070-47708396,2024-07-17T15:22:03,Errenteria,Expense,education,-53.23,-46739.24
buyer_7,Mar√≠a,56,ES69209598874776399917,TRX_N-01071-12839633,2024-07-17T13:30:47,Basauri,Expense,cash,-100.0,-46839.24
buyer_7,Mar√≠a,56,ES69209598874776399917,TRX_N-01072-69839969,2024-07-19T19:45:45,Portugalete,Expense,food,-107.42,-46946.66
buyer_7,Mar√≠a,56,ES69209598874776399917,TRX_N-01073-04907685,2024-07-19T16:02:46,Llodio,Expense,leisure,-60.71,-47007.37
buyer_7,Mar√≠a,56,ES69209598874776399917,TRX_N-01074-09862902,2024-07-21T10:02:19,Portugalete,Expense,food,-113.66,-47121.03
buyer_7,Mar√≠a,56,ES69209598874776399917,TRX_N-01075-08238058,2024-07-21T11:46:28,Llodio,Expense,transport,-42.95,-47163.98
buyer_7,Mar√≠a,56,ES69209598874776399917,TRX_N-01076-97257843,2024-07-22T15:34:18,Portugalete,Expense,transport,-83.31,-47247.29
buyer_7,Mar√≠a,56,ES69209598874776399917,TRX_N-01077-16376065,2024-07-23T23:22:26,Portugalete,Expense,gifts,-143.66,-47390.95
buyer_7,Mar√≠a,56,ES69209598874776399917,TRX_N-01078-49949480,2024-07-24T22:19:13,Portugalete,Expense,food,-73.94,-47464.89
buyer_7,Mar√≠a,56,ES69209598874776399917,TRX_N-01079-32713720,2024-07-25T17:40:54,Portugalete,Expense,leisure,-36.51,-47501.4
buyer_7,Mar√≠a,56,ES69209598874776399917,TRX_N-01080-88577030,2024-07-25T13:24:18,Bermeo,Expense,clothing,-158.82,-47660.22
buyer_7,Mar√≠a,56,ES69209598874776399917,TRX_N-01081-04660168,2024-07-26T13:55:23,Portugalete,Expense,education,-50.52,-47710.74
buyer_7,Mar√≠a,56,ES69209598874776399917,TRX_N-01082-05791860,2024-07-26T11:01:48,Portugalete,expenses,children,-279.08,-47989.82
buyer_7,Mar√≠a,56,ES69209598874776399917,TRX_N-01083-22968323,2024-07-27T19:24:38,Portugalete,Expense,transport,-55.97,-48045.79
buyer_7,Mar√≠a,56,ES69209598874776399917,TRX_N-01084-16473475,2024-07-28T15:19:35,Hondarribia,Expense,transport,-85.73,-48131.52
buyer_7,Mar√≠a,56,ES69209598874776399917,TRX_N-01085-72373397,2024-07-30T11:24:35,Portugalete,Expense,appliances,-256.93,-48388.45
buyer_7,Mar√≠a,56,ES69209598874776399917,TRX_N-01086-50120281,2024-07-31T17:10:17,Alegr√≠a-Dulantzi,Expense,leisure,-80.47,-48468.92
buyer_7,Mar√≠a,56,ES69209598874776399917,TRX_N-01087-05988547,2024-08-01T03:43:39,Portugalete,incomes,salary,1476.39,-46992.53
buyer_7,Mar√≠a,56,ES69209598874776399917,TRX_N-01088-55588803,2024-08-01T03:43:39,Portugalete,incomes,salary_partner,1371.06,-45621.47
buyer_7,Mar√≠a,56,ES69209598874776399917,TRX_N-01089-54841486,2024-08-01T20:27:35,Portugalete,Expense,cash,-100.0,-45721.47
buyer_7,Mar√≠a,56,ES69209598874776399917,TRX_N-01090-48137966,2024-08-01T18:27:15,Portugalete,Expense,repairs,-198.39,-45919.86
buyer_7,Mar√≠a,56,ES69209598874776399917,TRX_N-01091-97726232,2024-08-02T14:22:31,Durango,Expense,leisure,-64.86,-45984.72
buyer_7,Mar√≠a,56,ES69209598874776399917,TRX_N-01092-11502013,2024-08-04T23:56:54,Portugalete,expenses,mortgage,-866.4,-46851.12
buyer_7,Mar√≠a,56,ES69209598874776399917,TRX_N-01093-94116083,2024-08-04T09:10:48,Portugalete,Expense,food,-114.9,-46966.02
buyer_7,Mar√≠a,56,ES69209598874776399917,TRX_N-01094-68388763,2024-08-06T15:24:49,Portugalete,expenses,electricity,-37.6,-47003.62
buyer_7,Mar√≠a,56,ES69209598874776399917,TRX_N-01095-90192465,2024-08-06T15:27:31,Portugalete,expenses,phone,-37.65,-47041.27
buyer_7,Mar√≠a,56,ES69209598874776399917,TRX_N-01096-51767052,2024-08-06T07:39:20,Portugalete,Expense,leisure,-41.44,-47082.71
buyer_7,Mar√≠a,56,ES69209598874776399917,TRX_N-01097-99678751,2024-08-06T11:58:49,Bermeo,Expense,gifts,-79.34,-47162.05
buyer_7,Mar√≠a,56,ES69209598874776399917,TRX_N-01098-93338121,2024-08-07T20:27:32,Portugalete,Expense,food,-84.86,-47246.91
buyer_7,Mar√≠a,56,ES69209598874776399917,TRX_N-01099-64503205,2024-08-08T23:04:10,Portugalete,expenses,water,-31.87,-47278.78
buyer_7,Mar√≠a,56,ES69209598874776399917,TRX_N-01100-98762660,2024-08-08T17:08:08,Portugalete,expenses,gas,-69.74,-47348.52
buyer_7,Mar√≠a,56,ES69209598874776399917,TRX_N-01101-30391845,2024-08-08T00:43:42,Portugalete,expenses,internet,-42.0,-47390.52
buyer_7,Mar√≠a,56,ES69209598874776399917,TRX_N-01102-35231908,2024-08-08T19:11:40,Portugalete,Expense,repairs,-31.05,-47421.57
buyer_7,Mar√≠a,56,ES69209598874776399917,TRX_N-01103-03808164,2024-08-12T00:21:11,Portugalete,Expense,clothing,-124.97,-47546.54
buyer_7,Mar√≠a,56,ES69209598874776399917,TRX_N-01104-76261784,2024-08-12T21:21:27,Portugalete,Expense,repairs,-142.24,-47688.78
buyer_7,Mar√≠a,56,ES69209598874776399917,TRX_N-01105-56242156,2024-08-14T12:34:05,Portugalete,Expense,food,-76.31,-47765.09
buyer_7,Mar√≠a,56,ES69209598874776399917,TRX_N-01106-29198982,2024-08-17T16:19:49,Portugalete,Expense,transport,-41.16,-47806.25
buyer_7,Mar√≠a,56,ES69209598874776399917,TRX_N-01107-52117568,2024-08-17T18:11:07,Portugalete,Expense,cash,-100.0,-47906.25
buyer_7,Mar√≠a,56,ES69209598874776399917,TRX_N-01108-74655852,2024-08-18T05:02:56,Portugalete,Expense,leisure,-77.75,-47984.0
buyer_7,Mar√≠a,56,ES69209598874776399917,TRX_N-01109-85381169,2024-08-20T15:57:31,Portugalete,Expense,transport,-83.89,-48067.89
buyer_7,Mar√≠a,56,ES69209598874776399917,TRX_N-01110-03625986,2024-08-20T08:05:16,Portugalete,Expense,repairs,-61.36,-48129.25
buyer_7,Mar√≠a,56,ES69209598874776399917,TRX_N-01111-89644837,2024-08-21T13:14:33,Portugalete,expenses,children,-94.26,-48223.51
buyer_7,Mar√≠a,56,ES69209598874776399917,TRX_N-01112-54040021,2024-08-22T10:37:24,Mungia,Expense,repairs,-286.0,-48509.51
buyer_7,Mar√≠a,56,ES69209598874776399917,TRX_N-01113-39872616,2024-08-23T19:18:16,Portugalete,Expense,education,-45.93,-48555.44
buyer_7,Mar√≠a,56,ES69209598874776399917,TRX_N-01114-87845578,2024-08-24T18:04:23,Portugalete,Expense,transport,-45.2,-48600.64
buyer_7,Mar√≠a,56,ES69209598874776399917,TRX_N-01115-79160620,2024-08-24T19:40:08,Portugalete,Expense,leisure,-24.89,-48625.53
buyer_7,Mar√≠a,56,ES69209598874776399917,TRX_N-01116-33969645,2024-08-24T11:34:02,Portugalete,Expense,healthcare,-179.87,-48805.4
buyer_7,Mar√≠a,56,ES69209598874776399917,TRX_N-01117-55390153,2024-08-25T11:31:19,Portugalete,Expense,leisure,-82.58,-48887.98
buyer_7,Mar√≠a,56,ES69209598874776399917,TRX_N-01118-37819784,2024-08-25T11:29:39,Portugalete,Expense,repairs,-69.93,-48957.91
buyer_7,Mar√≠a,56,ES69209598874776399917,TRX_N-01119-82420701,2024-08-25T03:30:34,Portugalete,Expense,gifts,-507.95,-49465.86
buyer_7,Mar√≠a,56,ES69209598874776399917,TRX_N-01120-80761696,2024-08-26T09:52:03,Portugalete,Expense,leisure,-49.34,-49515.2
buyer_7,Mar√≠a,56,ES69209598874776399917,TRX_N-01121-06606256,2024-08-26T03:49:25,Portugalete,Expense,repairs,-187.79,-49702.99
buyer_7,Mar√≠a,56,ES69209598874776399917,TRX_N-01122-67104276,2024-08-29T19:30:18,Portugalete,Expense,food,-68.29,-49771.28
buyer_7,Mar√≠a,56,ES69209598874776399917,TRX_N-01123-55181310,2024-08-29T05:17:30,Portugalete,Expense,education,-60.92,-49832.2
buyer_7,Mar√≠a,56,ES69209598874776399917,TRX_N-01124-48078951,2024-09-01T13:36:14,Portugalete,incomes,salary,1476.39,-48355.81
buyer_7,Mar√≠a,56,ES69209598874776399917,TRX_N-01125-39310202,2024-09-01T13:36:14,Portugalete,incomes,salary_partner,1371.06,-46984.75
buyer_7,Mar√≠a,56,ES69209598874776399917,TRX_N-01126-25947465,2024-09-01T13:36:14,Portugalete,incomes,extra_income,160.8,-46823.95
buyer_7,Mar√≠a,56,ES69209598874776399917,TRX_N-01127-99255399,2024-09-02T08:19:19,Portugalete,Expense,leisure,-80.89,-46904.84
buyer_7,Mar√≠a,56,ES69209598874776399917,TRX_N-01128-88194355,2024-09-02T14:58:55,Portugalete,Expense,clothing,-73.15,-46977.99
buyer_7,Mar√≠a,56,ES69209598874776399917,TRX_N-01129-77844577,2024-09-02T23:50:14,Portugalete,Expense,education,-58.18,-47036.17
buyer_7,Mar√≠a,56,ES69209598874776399917,TRX_N-01130-14358486,2024-09-04T22:01:37,Portugalete,expenses,mortgage,-866.4,-47902.57
buyer_7,Mar√≠a,56,ES69209598874776399917,TRX_N-01131-89917800,2024-09-04T15:53:14,Portugalete,Expense,cash,-100.0,-48002.57
buyer_7,Mar√≠a,56,ES69209598874776399917,TRX_N-01132-66183642,2024-09-05T14:39:50,Portugalete,expenses,phone,-38.47,-48041.04
buyer_7,Mar√≠a,56,ES69209598874776399917,TRX_N-01133-40878213,2024-09-05T21:46:05,Portugalete,Expense,food,-74.39,-48115.43
buyer_7,Mar√≠a,56,ES69209598874776399917,TRX_N-01134-61579324,2024-09-06T12:24:28,Portugalete,Expense,leisure,-19.14,-48134.57
buyer_7,Mar√≠a,56,ES69209598874776399917,TRX_N-01135-36176181,2024-09-06T13:13:08,Portugalete,Expense,gifts,-277.72,-48412.29
buyer_7,Mar√≠a,56,ES69209598874776399917,TRX_N-01136-81215492,2024-09-07T17:16:02,Portugalete,expenses,water,-41.87,-48454.16
buyer_7,Mar√≠a,56,ES69209598874776399917,TRX_N-01137-21318125,2024-09-07T04:42:34,Portugalete,expenses,internet,-42.0,-48496.16
buyer_7,Mar√≠a,56,ES69209598874776399917,TRX_N-01138-51087558,2024-09-07T13:32:23,Portugalete,Expense,gifts,-736.03,-49232.19
buyer_7,Mar√≠a,56,ES69209598874776399917,TRX_N-01139-19314669,2024-09-08T12:10:28,Portugalete,expenses,electricity,-82.58,-49314.77
buyer_7,Mar√≠a,56,ES69209598874776399917,TRX_N-01140-46552095,2024-09-08T09:18:53,Portugalete,expenses,gas,-101.27,-49416.04
buyer_7,Mar√≠a,56,ES69209598874776399917,TRX_N-01141-41549794,2024-09-08T11:33:21,Portugalete,Expense,appliances,-242.62,-49658.66
buyer_7,Mar√≠a,56,ES69209598874776399917,TRX_N-01142-11684776,2024-09-08T14:41:27,Portugalete,Expense,repairs,-124.19,-49782.85
buyer_7,Mar√≠a,56,ES69209598874776399917,TRX_N-01143-35207273,2024-09-09T10:57:28,Portugalete,Expense,cash,-100.0,-49882.85
buyer_7,Mar√≠a,56,ES69209598874776399917,TRX_N-01144-83431203,2024-09-10T11:37:46,Portugalete,Expense,repairs,-192.56,-50075.41
buyer_7,Mar√≠a,56,ES69209598874776399917,TRX_N-01145-58243722,2024-09-11T11:32:55,Portugalete,Expense,food,-120.11,-50195.52
buyer_7,Mar√≠a,56,ES69209598874776399917,TRX_N-01146-52658727,2024-09-13T04:34:37,Portugalete,Expense,gifts,-801.51,-50997.03
buyer_7,Mar√≠a,56,ES69209598874776399917,TRX_N-01147-19634598,2024-09-15T12:13:49,Portugalete,Expense,gifts,-526.75,-51523.78
buyer_7,Mar√≠a,56,ES69209598874776399917,TRX_N-01148-56038486,2024-09-16T22:21:16,Portugalete,Expense,leisure,-79.72,-51603.5
buyer_7,Mar√≠a,56,ES69209598874776399917,TRX_N-01149-67604924,2024-09-18T15:31:46,Portugalete,Expense,transport,-68.95,-51672.45
buyer_7,Mar√≠a,56,ES69209598874776399917,TRX_N-01150-99554711,2024-09-20T23:56:06,Portugalete,Expense,cash,-100.0,-51772.45
buyer_7,Mar√≠a,56,ES69209598874776399917,TRX_N-01151-37407606,2024-09-21T13:03:58,Erandio,Expense,education,-44.5,-51816.95
buyer_7,Mar√≠a,56,ES69209598874776399917,TRX_N-01152-60977535,2024-09-22T13:46:04,Portugalete,Expense,leisure,-68.5,-51885.45
buyer_7,Mar√≠a,56,ES69209598874776399917,TRX_N-01153-51377473,2024-09-22T15:55:01,Portugalete,Expense,appliances,-158.49,-52043.94
buyer_7,Mar√≠a,56,ES69209598874776399917,TRX_N-01154-76564658,2024-09-26T08:35:50,Sestao,Expense,transport,-60.64,-52104.58
buyer_7,Mar√≠a,56,ES69209598874776399917,TRX_N-01155-42119961,2024-09-26T19:23:00,Portugalete,Expense,cash,-100.0,-52204.58
buyer_7,Mar√≠a,56,ES69209598874776399917,TRX_N-01156-96913470,2024-09-27T16:08:11,Zuia,Expense,cash,-100.0,-52304.58
buyer_7,Mar√≠a,56,ES69209598874776399917,TRX_N-01157-42837230,2024-09-28T16:02:17,Portugalete,Expense,food,-114.19,-52418.77
buyer_7,Mar√≠a,56,ES69209598874776399917,TRX_N-01158-22647047,2024-09-28T17:27:54,Portugalete,Expense,education,-65.69,-52484.46
buyer_7,Mar√≠a,56,ES69209598874776399917,TRX_N-01159-04466053,2024-09-30T03:56:46,Portugalete,Expense,food,-61.78,-52546.24
buyer_7,Mar√≠a,56,ES69209598874776399917,TRX_N-01160-23621055,2024-10-01T12:06:52,Portugalete,incomes,salary,1476.39,-51069.85
buyer_7,Mar√≠a,56,ES69209598874776399917,TRX_N-01161-39262479,2024-10-01T12:06:52,Portugalete,incomes,salary_partner,1371.06,-49698.79
buyer_7,Mar√≠a,56,ES69209598874776399917,TRX_N-01162-04095779,2024-10-02T14:31:57,Portugalete,Expense,food,-118.96,-49817.75
buyer_7,Mar√≠a,56,ES69209598874776399917,TRX_N-01163-47485787,2024-10-02T00:38:38,Portugalete,Expense,cash,-100.0,-49917.75
buyer_7,Mar√≠a,56,ES69209598874776399917,TRX_N-01164-49309700,2024-10-02T02:17:08,Portugalete,Expense,appliances,-116.64,-50034.39
buyer_7,Mar√≠a,56,ES69209598874776399917,TRX_N-01165-08805158,2024-10-03T13:59:59,Portugalete,Expense,leisure,-80.75,-50115.14
buyer_7,Mar√≠a,56,ES69209598874776399917,TRX_N-01166-72640905,2024-10-04T00:24:57,Portugalete,expenses,mortgage,-866.4,-50981.54
buyer_7,Mar√≠a,56,ES69209598874776399917,TRX_N-01167-66197928,2024-10-05T10:56:37,Portugalete,Expense,healthcare,-145.33,-51126.87
buyer_7,Mar√≠a,56,ES69209598874776399917,TRX_N-01168-85245592,2024-10-05T13:12:26,Portugalete,Expense,gifts,-573.59,-51700.46
buyer_7,Mar√≠a,56,ES69209598874776399917,TRX_N-01169-16391807,2024-10-07T08:27:22,Portugalete,expenses,gas,-87.3,-51787.76
buyer_7,Mar√≠a,56,ES69209598874776399917,TRX_N-01170-48345051,2024-10-08T20:24:08,Portugalete,expenses,water,-37.55,-51825.31
buyer_7,Mar√≠a,56,ES69209598874776399917,TRX_N-01171-84031186,2024-10-08T12:37:47,Portugalete,expenses,electricity,-51.5,-51876.81
buyer_7,Mar√≠a,56,ES69209598874776399917,TRX_N-01172-61405120,2024-10-08T01:43:45,Portugalete,expenses,internet,-42.0,-51918.81
buyer_7,Mar√≠a,56,ES69209598874776399917,TRX_N-01173-82975344,2024-10-08T09:52:15,Portugalete,expenses,phone,-37.49,-51956.3
buyer_7,Mar√≠a,56,ES69209598874776399917,TRX_N-01174-42430866,2024-10-08T16:00:06,Mungia,Expense,cash,-100.0,-52056.3
buyer_8,Antonio,45,ES47209569543860298423,TRX_N-00001-20670248,2022-01-01T14:10:36,Labastida,incomes,salary,1498.15,3327.67
buyer_8,Antonio,45,ES47209569543860298423,TRX_N-00002-33621358,2022-01-01T14:10:36,Labastida,incomes,salary_partner,1629.2,4956.87
buyer_8,Antonio,45,ES47209569543860298423,TRX_N-00003-34501857,2022-01-01T08:37:44,Labastida,Expense,healthcare,-103.7,4853.17
buyer_8,Antonio,45,ES47209569543860298423,TRX_N-00004-59232478,2022-01-01T12:10:39,Oy√≥n-Oion,Expense,cash,-100.0,4753.17
buyer_8,Antonio,45,ES47209569543860298423,TRX_N-00005-83322262,2022-01-02T11:48:07,Labastida,Expense,travel,-1808.28,2944.89
buyer_8,Antonio,45,ES47209569543860298423,TRX_N-00006-78022467,2022-01-04T13:31:36,Labastida,expenses,mortgage,-842.18,2102.71
buyer_8,Antonio,45,ES47209569543860298423,TRX_N-00007-60616894,2022-01-04T08:24:20,Labastida,Expense,food,-64.02,2038.69
buyer_8,Antonio,45,ES47209569543860298423,TRX_N-00008-58803253,2022-01-05T09:50:51,Labastida,expenses,gas,-69.89,1968.8
buyer_8,Antonio,45,ES47209569543860298423,TRX_N-00009-00592717,2022-01-05T12:29:21,Labastida,expenses,internet,-42.0,1926.8
buyer_8,Antonio,45,ES47209569543860298423,TRX_N-00010-58600947,2022-01-06T20:21:53,Labastida,Expense,leisure,-29.72,1897.08
buyer_8,Antonio,45,ES47209569543860298423,TRX_N-00011-10500080,2022-01-06T17:01:54,Labastida,expenses,children,-99.46,1797.62
buyer_8,Antonio,45,ES47209569543860298423,TRX_N-00012-91433325,2022-01-08T08:38:52,Labastida,expenses,water,-35.62,1762.0
buyer_8,Antonio,45,ES47209569543860298423,TRX_N-00013-41054934,2022-01-08T10:17:00,Labastida,expenses,electricity,-75.21,1686.79
buyer_8,Antonio,45,ES47209569543860298423,TRX_N-00014-88347480,2022-01-08T13:09:20,Labastida,expenses,phone,-31.81,1654.98
buyer_8,Antonio,45,ES47209569543860298423,TRX_N-00015-36231598,2022-01-11T19:08:09,Arrasate,Expense,food,-112.88,1542.1
buyer_8,Antonio,45,ES47209569543860298423,TRX_N-00016-09702341,2022-01-12T05:49:23,Labastida,Expense,clothing,-46.47,1495.63
buyer_8,Antonio,45,ES47209569543860298423,TRX_N-00017-74954541,2022-01-15T11:07:22,Labastida,Expense,cash,-100.0,1395.63
buyer_8,Antonio,45,ES47209569543860298423,TRX_N-00018-62879763,2022-01-17T16:08:07,Bermeo,Expense,food,-94.26,1301.37
buyer_8,Antonio,45,ES47209569543860298423,TRX_N-00019-72148777,2022-01-19T18:26:32,Hondarribia,Expense,food,-100.7,1200.67
buyer_8,Antonio,45,ES47209569543860298423,TRX_N-00020-58963116,2022-01-20T12:12:34,Labastida,Expense,transport,-60.79,1139.88
buyer_8,Antonio,45,ES47209569543860298423,TRX_N-00021-97531711,2022-01-22T14:36:57,Labastida,Expense,food,-98.49,1041.39
buyer_8,Antonio,45,ES47209569543860298423,TRX_N-00022-56275164,2022-01-24T12:05:05,Labastida,Expense,transport,-75.63,965.76
buyer_8,Antonio,45,ES47209569543860298423,TRX_N-00023-55252422,2022-01-25T08:44:49,Labastida,Expense,cash,-100.0,865.76
buyer_8,Antonio,45,ES47209569543860298423,TRX_N-00024-82499240,2022-01-27T19:44:56,Labastida,Expense,healthcare,-92.73,773.03
buyer_8,Antonio,45,ES47209569543860298423,TRX_N-00025-96452388,2022-01-27T16:48:25,Labastida,Expense,cash,-100.0,673.03
buyer_8,Antonio,45,ES47209569543860298423,TRX_N-00026-06817521,2022-01-30T10:05:17,Labastida,Expense,cash,-100.0,573.03
buyer_8,Antonio,45,ES47209569543860298423,TRX_N-00027-83314598,2022-02-01T11:42:31,Labastida,incomes,salary,1498.15,2071.18
buyer_8,Antonio,45,ES47209569543860298423,TRX_N-00028-45264401,2022-02-01T11:42:31,Labastida,incomes,salary_partner,1629.2,3700.38
buyer_8,Antonio,45,ES47209569543860298423,TRX_N-00029-82437870,2022-02-01T19:59:09,Labastida,Expense,leisure,-66.18,3634.2
buyer_8,Antonio,45,ES47209569543860298423,TRX_N-00030-97239480,2022-02-01T11:01:34,Labastida,Expense,cash,-100.0,3534.2
buyer_8,Antonio,45,ES47209569543860298423,TRX_N-00031-32949923,2022-02-02T06:54:55,Labastida,Expense,food,-87.16,3447.04
buyer_8,Antonio,45,ES47209569543860298423,TRX_N-00032-48832269,2022-02-02T02:34:10,Labastida,Expense,gifts,-513.07,2933.97
buyer_8,Antonio,45,ES47209569543860298423,TRX_N-00033-06606367,2022-02-03T06:16:37,Labastida,Expense,food,-113.38,2820.59
buyer_8,Antonio,45,ES47209569543860298423,TRX_N-00034-63605756,2022-02-04T17:15:09,Labastida,expenses,mortgage,-842.18,1978.41
buyer_8,Antonio,45,ES47209569543860298423,TRX_N-00035-12253514,2022-02-04T04:45:51,Labastida,Expense,transport,-40.39,1938.02
buyer_8,Antonio,45,ES47209569543860298423,TRX_N-00036-78520091,2022-02-04T09:15:32,Labastida,Expense,gifts,-214.17,1723.85
buyer_8,Antonio,45,ES47209569543860298423,TRX_N-00037-82873182,2022-02-05T17:56:30,Labastida,expenses,gas,-95.49,1628.36
buyer_8,Antonio,45,ES47209569543860298423,TRX_N-00038-31904294,2022-02-05T17:13:02,Labastida,expenses,internet,-42.0,1586.36
buyer_8,Antonio,45,ES47209569543860298423,TRX_N-00039-16571080,2022-02-05T13:04:33,Labastida,Expense,repairs,-122.44,1463.92
buyer_8,Antonio,45,ES47209569543860298423,TRX_N-00040-72700632,2022-02-06T14:38:57,Labastida,expenses,water,-32.45,1431.47
buyer_8,Antonio,45,ES47209569543860298423,TRX_N-00041-57865861,2022-02-06T14:07:41,Labastida,Expense,repairs,-128.13,1303.34
buyer_8,Antonio,45,ES47209569543860298423,TRX_N-00042-68081733,2022-02-07T08:44:13,Labastida,Expense,clothing,-139.62,1163.72
buyer_8,Antonio,45,ES47209569543860298423,TRX_N-00043-29887374,2022-02-07T03:01:09,Labastida,Expense,cash,-100.0,1063.72
buyer_8,Antonio,45,ES47209569543860298423,TRX_N-00044-27109991,2022-02-08T13:14:42,Labastida,expenses,electricity,-74.18,989.54
buyer_8,Antonio,45,ES47209569543860298423,TRX_N-00045-43831946,2022-02-08T20:29:46,Labastida,expenses,phone,-31.99,957.55
buyer_8,Antonio,45,ES47209569543860298423,TRX_N-00046-24177277,2022-02-09T14:44:47,Labastida,Expense,food,-104.12,853.43
buyer_8,Antonio,45,ES47209569543860298423,TRX_N-00047-83365733,2022-02-10T06:32:08,Labastida,Expense,gifts,-85.74,767.69
buyer_8,Antonio,45,ES47209569543860298423,TRX_N-00048-77524525,2022-02-11T15:06:42,Labastida,Expense,transport,-43.36,724.33
buyer_8,Antonio,45,ES47209569543860298423,TRX_N-00049-12824665,2022-02-12T08:51:38,Labastida,Expense,food,-120.93,603.4
buyer_8,Antonio,45,ES47209569543860298423,TRX_N-00050-01620032,2022-02-13T00:04:15,Errenteria,Expense,clothing,-95.2,508.2
buyer_8,Antonio,45,ES47209569543860298423,TRX_N-00051-87052428,2022-02-15T14:28:06,Labastida,Expense,food,-86.66,421.54
buyer_8,Antonio,45,ES47209569543860298423,TRX_N-00052-71985363,2022-02-17T22:50:38,Labastida,Expense,cash,-100.0,321.54
buyer_8,Antonio,45,ES47209569543860298423,TRX_N-00053-99993835,2022-02-19T15:13:42,Labastida,Expense,food,-82.58,238.96
buyer_8,Antonio,45,ES47209569543860298423,TRX_N-00054-69833379,2022-02-19T18:02:59,Labastida,Expense,repairs,-218.27,20.69
buyer_8,Antonio,45,ES47209569543860298423,TRX_N-00055-39162266,2022-02-22T19:25:24,Labastida,Expense,cash,-100.0,-79.31
buyer_8,Antonio,45,ES47209569543860298423,TRX_N-00056-31174421,2022-02-24T18:05:25,Labastida,Expense,repairs,-236.08,-315.39
buyer_8,Antonio,45,ES47209569543860298423,TRX_N-00057-20194139,2022-02-26T23:47:26,Labastida,Expense,food,-121.83,-437.22
buyer_8,Antonio,45,ES47209569543860298423,TRX_N-00058-87588136,2022-03-01T11:23:32,Labastida,incomes,salary,1498.15,1060.93
buyer_8,Antonio,45,ES47209569543860298423,TRX_N-00059-84138048,2022-03-01T11:23:32,Labastida,incomes,salary_partner,1629.2,2690.13
buyer_8,Antonio,45,ES47209569543860298423,TRX_N-00060-60391120,2022-03-04T11:20:07,Labastida,expenses,mortgage,-842.18,1847.95
buyer_8,Antonio,45,ES47209569543860298423,TRX_N-00061-82775644,2022-03-04T21:27:49,Labastida,expenses,children,-167.1,1680.85
buyer_8,Antonio,45,ES47209569543860298423,TRX_N-00062-86733043,2022-03-05T21:17:08,Labastida,expenses,water,-34.75,1646.1
buyer_8,Antonio,45,ES47209569543860298423,TRX_N-00063-52906826,2022-03-05T15:55:42,Labastida,expenses,internet,-42.0,1604.1
buyer_8,Antonio,45,ES47209569543860298423,TRX_N-00064-84567353,2022-03-06T10:06:22,Labastida,expenses,electricity,-26.7,1577.4
buyer_8,Antonio,45,ES47209569543860298423,TRX_N-00065-07222324,2022-03-06T14:01:15,Labastida,Expense,repairs,-66.58,1510.82
buyer_8,Antonio,45,ES47209569543860298423,TRX_N-00066-85531164,2022-03-07T15:56:49,Labastida,expenses,gas,-95.89,1414.93
buyer_8,Antonio,45,ES47209569543860298423,TRX_N-00067-47132479,2022-03-08T21:42:17,Labastida,expenses,phone,-34.98,1379.95
buyer_8,Antonio,45,ES47209569543860298423,TRX_N-00068-79191584,2022-03-11T12:02:05,Labastida,Expense,food,-108.21,1271.74
buyer_8,Antonio,45,ES47209569543860298423,TRX_N-00069-87438920,2022-03-11T17:58:22,Labastida,Expense,clothing,-109.81,1161.93
buyer_8,Antonio,45,ES47209569543860298423,TRX_N-00070-69269771,2022-03-12T13:46:41,Labastida,Expense,healthcare,-124.63,1037.3
buyer_8,Antonio,45,ES47209569543860298423,TRX_N-00071-53409622,2022-03-20T13:36:58,Labastida,Expense,food,-92.47,944.83
buyer_8,Antonio,45,ES47209569543860298423,TRX_N-00072-73789343,2022-03-20T16:53:41,Berango,Expense,leisure,-84.22,860.61
buyer_8,Antonio,45,ES47209569543860298423,TRX_N-00073-30738833,2022-03-20T15:23:29,Labastida,Expense,clothing,-66.81,793.8
buyer_8,Antonio,45,ES47209569543860298423,TRX_N-00074-76717188,2022-03-21T12:47:27,Labastida,Expense,gifts,-346.27,447.53
buyer_8,Antonio,45,ES47209569543860298423,TRX_N-00075-83829865,2022-03-22T18:27:00,Labastida,Expense,leisure,-25.34,422.19
buyer_8,Antonio,45,ES47209569543860298423,TRX_N-00076-82437192,2022-03-24T17:29:42,Mungia,Expense,leisure,-68.26,353.93
buyer_8,Antonio,45,ES47209569543860298423,TRX_N-00077-40874419,2022-03-24T10:09:18,Labastida,Expense,clothing,-108.31,245.62
buyer_8,Antonio,45,ES47209569543860298423,TRX_N-00078-36460842,2022-03-25T04:19:43,Labastida,Expense,transport,-41.81,203.81
buyer_8,Antonio,45,ES47209569543860298423,TRX_N-00079-12527982,2022-03-27T19:46:25,Zuia,Expense,leisure,-59.19,144.62
buyer_8,Antonio,45,ES47209569543860298423,TRX_N-00080-66762515,2022-03-28T13:34:49,Labastida,Expense,cash,-100.0,44.62
buyer_8,Antonio,45,ES47209569543860298423,TRX_N-00081-57760077,2022-03-29T20:51:01,Labastida,Expense,transport,-52.93,-8.31
buyer_8,Antonio,45,ES47209569543860298423,TRX_N-00082-74393827,2022-03-29T17:58:59,Labastida,Expense,repairs,-167.25,-175.56
buyer_8,Antonio,45,ES47209569543860298423,TRX_N-00083-90605642,2022-03-29T09:53:59,Labastida,Expense,gifts,-329.83,-505.39
buyer_8,Antonio,45,ES47209569543860298423,TRX_N-00084-81325862,2022-03-30T17:04:52,Labastida,Expense,cash,-100.0,-605.39
buyer_8,Antonio,45,ES47209569543860298423,TRX_N-00085-85904244,2022-04-01T16:50:32,Labastida,incomes,salary,1498.15,892.76
buyer_8,Antonio,45,ES47209569543860298423,TRX_N-00086-18881289,2022-04-01T16:50:32,Labastida,incomes,salary_partner,1629.2,2521.96
buyer_8,Antonio,45,ES47209569543860298423,TRX_N-00087-97886396,2022-04-01T16:50:32,Labastida,incomes,extra_income,237.8,2759.76
buyer_8,Antonio,45,ES47209569543860298423,TRX_N-00088-72198855,2022-04-01T11:27:17,Labastida,Expense,food,-98.67,2661.09
buyer_8,Antonio,45,ES47209569543860298423,TRX_N-00089-32127003,2022-04-02T10:53:35,Labastida,Expense,food,-106.66,2554.43
buyer_8,Antonio,45,ES47209569543860298423,TRX_N-00090-42840631,2022-04-03T19:50:02,Donostia,Expense,cash,-100.0,2454.43
buyer_8,Antonio,45,ES47209569543860298423,TRX_N-00091-95895583,2022-04-04T19:36:58,Labastida,expenses,mortgage,-842.18,1612.25
buyer_8,Antonio,45,ES47209569543860298423,TRX_N-00092-88958601,2022-04-04T10:02:04,Bermeo,Expense,clothing,-138.03,1474.22
buyer_8,Antonio,45,ES47209569543860298423,TRX_N-00093-26217084,2022-04-05T17:14:43,Labastida,expenses,water,-36.23,1437.99
buyer_8,Antonio,45,ES47209569543860298423,TRX_N-00094-73898683,2022-04-05T18:58:29,Labastida,expenses,gas,-97.15,1340.84
buyer_8,Antonio,45,ES47209569543860298423,TRX_N-00095-93284090,2022-04-05T09:37:53,Labastida,expenses,internet,-42.0,1298.84
buyer_8,Antonio,45,ES47209569543860298423,TRX_N-00096-67573451,2022-04-06T14:47:17,Labastida,Expense,food,-79.53,1219.31
buyer_8,Antonio,45,ES47209569543860298423,TRX_N-00097-11604003,2022-04-07T18:37:34,Labastida,expenses,electricity,-26.41,1192.9
buyer_8,Antonio,45,ES47209569543860298423,TRX_N-00098-51595746,2022-04-07T01:52:10,Labastida,Expense,healthcare,-160.9,1032.0
buyer_8,Antonio,45,ES47209569543860298423,TRX_N-00099-87348037,2022-04-08T20:34:53,Labastida,expenses,phone,-39.25,992.75
buyer_8,Antonio,45,ES47209569543860298423,TRX_N-00100-71356706,2022-04-08T17:21:37,Labastida,Expense,clothing,-91.29,901.46
buyer_8,Antonio,45,ES47209569543860298423,TRX_N-00101-85639827,2022-04-08T14:14:51,Labastida,Expense,cash,-100.0,801.46
buyer_8,Antonio,45,ES47209569543860298423,TRX_N-00102-40637991,2022-04-11T14:21:17,Labastida,Expense,repairs,-137.74,663.72
buyer_8,Antonio,45,ES47209569543860298423,TRX_N-00103-25740808,2022-04-12T13:18:33,Berango,Expense,clothing,-138.19,525.53
buyer_8,Antonio,45,ES47209569543860298423,TRX_N-00104-51837381,2022-04-13T17:41:11,Labastida,Expense,gifts,-190.91,334.62
buyer_8,Antonio,45,ES47209569543860298423,TRX_N-00105-75603320,2022-04-14T11:38:23,Labastida,Expense,leisure,-66.89,267.73
buyer_8,Antonio,45,ES47209569543860298423,TRX_N-00106-29761160,2022-04-16T09:01:04,Labastida,Expense,gifts,-689.15,-421.42
buyer_8,Antonio,45,ES47209569543860298423,TRX_N-00107-38126336,2022-04-20T12:44:38,Labastida,Expense,transport,-78.39,-499.81
buyer_8,Antonio,45,ES47209569543860298423,TRX_N-00108-48708423,2022-04-23T17:20:21,Labastida,Expense,food,-96.71,-596.52
buyer_8,Antonio,45,ES47209569543860298423,TRX_N-00109-68962997,2022-04-23T10:13:46,Labastida,Expense,transport,-61.35,-657.87
buyer_8,Antonio,45,ES47209569543860298423,TRX_N-00110-12587980,2022-04-23T10:45:18,Llodio,Expense,cash,-100.0,-757.87
buyer_8,Antonio,45,ES47209569543860298423,TRX_N-00111-20178937,2022-04-24T10:06:52,Labastida,expenses,children,-83.63,-841.5
buyer_8,Antonio,45,ES47209569543860298423,TRX_N-00112-27072142,2022-04-25T17:43:52,Labastida,Expense,food,-97.69,-939.19
buyer_8,Antonio,45,ES47209569543860298423,TRX_N-00113-10150824,2022-04-25T05:56:01,Santurtzi,Expense,cash,-100.0,-1039.19
buyer_8,Antonio,45,ES47209569543860298423,TRX_N-00114-02527621,2022-04-26T09:09:51,Labastida,Expense,healthcare,-64.51,-1103.7
buyer_8,Antonio,45,ES47209569543860298423,TRX_N-00115-88095827,2022-04-26T14:20:18,Getxo,Expense,travel,-525.53,-1629.23
buyer_8,Antonio,45,ES47209569543860298423,TRX_N-00116-44327136,2022-04-27T14:31:47,Labastida,Expense,leisure,-53.62,-1682.85
buyer_8,Antonio,45,ES47209569543860298423,TRX_N-00117-33053336,2022-04-27T18:15:46,Leioa,Expense,education,-46.7,-1729.55
buyer_8,Antonio,45,ES47209569543860298423,TRX_N-00118-50942000,2022-04-27T17:56:52,Labastida,Expense,gifts,-257.56,-1987.11
buyer_8,Antonio,45,ES47209569543860298423,TRX_N-00119-48116391,2022-04-28T10:51:39,Bermeo,Expense,food,-93.97,-2081.08
buyer_8,Antonio,45,ES47209569543860298423,TRX_N-00120-44979261,2022-04-30T15:10:27,Labastida,Expense,leisure,-42.94,-2124.02
buyer_8,Antonio,45,ES47209569543860298423,TRX_N-00121-06185042,2022-05-01T08:46:47,Labastida,incomes,salary,1498.15,-625.87
buyer_8,Antonio,45,ES47209569543860298423,TRX_N-00122-79655052,2022-05-01T08:46:47,Labastida,incomes,salary_partner,1629.2,1003.33
buyer_8,Antonio,45,ES47209569543860298423,TRX_N-00123-36300880,2022-05-01T13:24:50,Labastida,Expense,cash,-100.0,903.33
buyer_8,Antonio,45,ES47209569543860298423,TRX_N-00124-89744549,2022-05-03T13:30:27,Labastida,Expense,healthcare,-177.33,726.0
buyer_8,Antonio,45,ES47209569543860298423,TRX_N-00125-18292733,2022-05-03T23:05:33,Labastida,Expense,gifts,-734.1,-8.1
buyer_8,Antonio,45,ES47209569543860298423,TRX_N-00126-00801949,2022-05-04T06:22:23,Labastida,expenses,mortgage,-842.18,-850.28
buyer_8,Antonio,45,ES47209569543860298423,TRX_N-00127-72537936,2022-05-05T10:41:21,Labastida,expenses,water,-23.02,-873.3
buyer_8,Antonio,45,ES47209569543860298423,TRX_N-00128-61800752,2022-05-05T09:29:59,Labastida,Expense,gifts,-56.55,-929.85
buyer_8,Antonio,45,ES47209569543860298423,TRX_N-00129-25562721,2022-05-06T20:49:49,Labastida,expenses,internet,-42.0,-971.85
buyer_8,Antonio,45,ES47209569543860298423,TRX_N-00130-35011895,2022-05-06T18:46:27,Labastida,expenses,phone,-42.1,-1013.95
buyer_8,Antonio,45,ES47209569543860298423,TRX_N-00131-53565017,2022-05-07T20:57:35,Labastida,expenses,gas,-83.11,-1097.06
buyer_8,Antonio,45,ES47209569543860298423,TRX_N-00132-25033254,2022-05-08T12:46:35,Labastida,expenses,electricity,-32.51,-1129.57
buyer_8,Antonio,45,ES47209569543860298423,TRX_N-00133-75694545,2022-05-08T16:39:41,Zarautz,Expense,cash,-100.0,-1229.57
buyer_8,Antonio,45,ES47209569543860298423,TRX_N-00134-41228617,2022-05-09T09:13:09,Labastida,Expense,transport,-57.05,-1286.62
buyer_8,Antonio,45,ES47209569543860298423,TRX_N-00135-16126287,2022-05-12T06:52:06,Labastida,Expense,leisure,-21.57,-1308.19
buyer_8,Antonio,45,ES47209569543860298423,TRX_N-00136-75118709,2022-05-13T15:39:27,Labastida,Expense,leisure,-45.21,-1353.4
buyer_8,Antonio,45,ES47209569543860298423,TRX_N-00137-51193918,2022-05-13T15:58:51,Labastida,Expense,cash,-100.0,-1453.4
buyer_8,Antonio,45,ES47209569543860298423,TRX_N-00138-35484124,2022-05-15T08:11:20,Oy√≥n-Oion,Expense,transport,-73.29,-1526.69
buyer_8,Antonio,45,ES47209569543860298423,TRX_N-00139-62991220,2022-05-16T20:44:30,Amurrio,Expense,cash,-100.0,-1626.69
buyer_8,Antonio,45,ES47209569543860298423,TRX_N-00140-64385026,2022-05-17T13:47:05,Zarautz,Expense,cash,-100.0,-1726.69
buyer_8,Antonio,45,ES47209569543860298423,TRX_N-00141-13317789,2022-05-18T11:27:41,Labastida,Expense,gifts,-670.05,-2396.74
buyer_8,Antonio,45,ES47209569543860298423,TRX_N-00142-25276925,2022-05-19T13:31:36,Labastida,Expense,cash,-100.0,-2496.74
buyer_8,Antonio,45,ES47209569543860298423,TRX_N-00143-75191219,2022-05-19T10:00:45,Labastida,Expense,repairs,-175.66,-2672.4
buyer_8,Antonio,45,ES47209569543860298423,TRX_N-00144-23096447,2022-05-20T14:11:43,Labastida,Expense,transport,-88.96,-2761.36
buyer_8,Antonio,45,ES47209569543860298423,TRX_N-00145-29933754,2022-05-23T01:06:56,Labastida,Expense,cash,-100.0,-2861.36
buyer_8,Antonio,45,ES47209569543860298423,TRX_N-00146-93198968,2022-05-24T10:54:26,Labastida,Expense,cash,-100.0,-2961.36
buyer_8,Antonio,45,ES47209569543860298423,TRX_N-00147-43781676,2022-05-26T09:42:54,Labastida,Expense,clothing,-157.96,-3119.32
buyer_8,Antonio,45,ES47209569543860298423,TRX_N-00148-99983659,2022-05-26T17:40:03,Donostia,Expense,repairs,-174.64,-3293.96
buyer_8,Antonio,45,ES47209569543860298423,TRX_N-00149-19744749,2022-05-27T05:56:40,Labastida,Expense,food,-113.39,-3407.35
buyer_8,Antonio,45,ES47209569543860298423,TRX_N-00150-36930244,2022-05-30T17:43:32,Labastida,Expense,leisure,-69.54,-3476.89
buyer_8,Antonio,45,ES47209569543860298423,TRX_N-00151-48179507,2022-05-30T16:10:20,Labastida,Expense,repairs,-298.57,-3775.46
buyer_8,Antonio,45,ES47209569543860298423,TRX_N-00152-05042698,2022-06-01T13:45:19,Labastida,incomes,salary,1498.15,-2277.31
buyer_8,Antonio,45,ES47209569543860298423,TRX_N-00153-27326430,2022-06-01T13:45:19,Labastida,incomes,salary_partner,1629.2,-648.11
buyer_8,Antonio,45,ES47209569543860298423,TRX_N-00154-78065507,2022-06-01T13:45:19,Labastida,incomes,salary_bonus,1181.84,533.73
buyer_8,Antonio,45,ES47209569543860298423,TRX_N-00155-96890040,2022-06-01T13:45:19,Labastida,incomes,salary_partner_bonus,1152.24,1685.97
buyer_8,Antonio,45,ES47209569543860298423,TRX_N-00156-32342566,2022-06-01T11:42:34,Labastida,Expense,leisure,-43.43,1642.54
buyer_8,Antonio,45,ES47209569543860298423,TRX_N-00157-55823466,2022-06-02T20:28:42,Labastida,Expense,transport,-77.72,1564.82
buyer_8,Antonio,45,ES47209569543860298423,TRX_N-00158-88566029,2022-06-02T20:09:17,Labastida,Expense,leisure,-55.45,1509.37
buyer_8,Antonio,45,ES47209569543860298423,TRX_N-00159-78422253,2022-06-02T12:07:09,Labastida,Expense,gifts,-213.59,1295.78
buyer_8,Antonio,45,ES47209569543860298423,TRX_N-00160-81128250,2022-06-03T01:00:57,Labastida,Expense,food,-105.27,1190.51
buyer_8,Antonio,45,ES47209569543860298423,TRX_N-00161-64138283,2022-06-04T11:28:50,Labastida,expenses,mortgage,-842.18,348.33
buyer_8,Antonio,45,ES47209569543860298423,TRX_N-00162-37243337,2022-06-05T07:08:34,Erandio,Expense,clothing,-100.03,248.3
buyer_8,Antonio,45,ES47209569543860298423,TRX_N-00163-65163425,2022-06-05T18:42:28,Labastida,Expense,cash,-100.0,148.3
buyer_8,Antonio,45,ES47209569543860298423,TRX_N-00164-29890609,2022-06-06T04:24:22,Labastida,expenses,water,-38.38,109.92
buyer_8,Antonio,45,ES47209569543860298423,TRX_N-00165-84715557,2022-06-06T12:50:16,Labastida,expenses,gas,-71.76,38.16
buyer_8,Antonio,45,ES47209569543860298423,TRX_N-00166-81080544,2022-06-06T19:34:50,Labastida,expenses,internet,-42.0,-3.84
buyer_8,Antonio,45,ES47209569543860298423,TRX_N-00167-36115985,2022-06-06T17:00:21,Labastida,Expense,food,-109.7,-113.54
buyer_8,Antonio,45,ES47209569543860298423,TRX_N-00168-59754283,2022-06-07T09:45:01,Labastida,expenses,phone,-31.7,-145.24
buyer_8,Antonio,45,ES47209569543860298423,TRX_N-00169-09428242,2022-06-07T14:59:20,Labastida,Expense,food,-60.84,-206.08
buyer_8,Antonio,45,ES47209569543860298423,TRX_N-00170-83183563,2022-06-08T13:29:27,Labastida,expenses,electricity,-46.72,-252.8
buyer_8,Antonio,45,ES47209569543860298423,TRX_N-00171-83015462,2022-06-08T18:18:03,Labastida,Expense,food,-111.01,-363.81
buyer_8,Antonio,45,ES47209569543860298423,TRX_N-00172-25220137,2022-06-09T10:07:01,Hondarribia,Expense,education,-52.0,-415.81
buyer_8,Antonio,45,ES47209569543860298423,TRX_N-00173-12855574,2022-06-10T15:08:48,Oy√≥n-Oion,Expense,leisure,-47.79,-463.6
buyer_8,Antonio,45,ES47209569543860298423,TRX_N-00174-05453906,2022-06-11T14:16:38,Labastida,Expense,food,-83.43,-547.03
buyer_8,Antonio,45,ES47209569543860298423,TRX_N-00175-49262081,2022-06-11T11:50:53,Labastida,Expense,transport,-45.12,-592.15
buyer_8,Antonio,45,ES47209569543860298423,TRX_N-00176-97726797,2022-06-11T09:56:37,Portugalete,Expense,gifts,-183.11,-775.26
buyer_8,Antonio,45,ES47209569543860298423,TRX_N-00177-72716178,2022-06-13T19:44:29,Labastida,Expense,food,-75.42,-850.68
buyer_8,Antonio,45,ES47209569543860298423,TRX_N-00178-67436085,2022-06-13T20:46:28,Sestao,Expense,transport,-69.62,-920.3
buyer_8,Antonio,45,ES47209569543860298423,TRX_N-00179-86962430,2022-06-13T20:19:58,Labastida,Expense,cash,-100.0,-1020.3
buyer_8,Antonio,45,ES47209569543860298423,TRX_N-00180-66730098,2022-06-15T23:01:42,Labastida,Expense,food,-64.01,-1084.31
buyer_8,Antonio,45,ES47209569543860298423,TRX_N-00181-48342593,2022-06-15T10:32:47,Labastida,Expense,cash,-100.0,-1184.31
buyer_8,Antonio,45,ES47209569543860298423,TRX_N-00182-85073920,2022-06-15T18:51:43,Labastida,Expense,repairs,-183.43,-1367.74
buyer_8,Antonio,45,ES47209569543860298423,TRX_N-00183-85227327,2022-06-16T18:28:47,Labastida,Expense,transport,-54.11,-1421.85
buyer_8,Antonio,45,ES47209569543860298423,TRX_N-00184-30340203,2022-06-16T12:21:24,Labastida,Expense,cash,-100.0,-1521.85
buyer_8,Antonio,45,ES47209569543860298423,TRX_N-00185-01273929,2022-06-17T23:49:14,Labastida,expenses,children,-155.44,-1677.29
buyer_8,Antonio,45,ES47209569543860298423,TRX_N-00186-60877274,2022-06-18T09:54:25,Labastida,Expense,food,-80.11,-1757.4
buyer_8,Antonio,45,ES47209569543860298423,TRX_N-00187-83802525,2022-06-19T08:23:21,Labastida,Expense,leisure,-73.09,-1830.49
buyer_8,Antonio,45,ES47209569543860298423,TRX_N-00188-41817113,2022-06-23T09:16:52,Labastida,Expense,food,-81.83,-1912.32
buyer_8,Antonio,45,ES47209569543860298423,TRX_N-00189-57637810,2022-06-23T07:51:29,Durango,Expense,cash,-100.0,-2012.32
buyer_8,Antonio,45,ES47209569543860298423,TRX_N-00190-57712484,2022-06-24T20:14:53,Eibar,Expense,cash,-100.0,-2112.32
buyer_8,Antonio,45,ES47209569543860298423,TRX_N-00191-54151351,2022-06-24T19:33:24,Labastida,Expense,appliances,-130.97,-2243.29
buyer_8,Antonio,45,ES47209569543860298423,TRX_N-00192-63838541,2022-06-25T07:38:22,Labastida,Expense,food,-81.53,-2324.82
buyer_8,Antonio,45,ES47209569543860298423,TRX_N-00193-02077323,2022-06-25T18:23:33,Portugalete,Expense,cash,-100.0,-2424.82
buyer_8,Antonio,45,ES47209569543860298423,TRX_N-00194-60558618,2022-06-26T18:08:50,Labastida,Expense,cash,-100.0,-2524.82
buyer_8,Antonio,45,ES47209569543860298423,TRX_N-00195-21210035,2022-06-28T20:19:40,Labastida,Expense,food,-88.35,-2613.17
buyer_8,Antonio,45,ES47209569543860298423,TRX_N-00196-47756732,2022-06-30T18:14:58,Hondarribia,Expense,cash,-100.0,-2713.17
buyer_8,Antonio,45,ES47209569543860298423,TRX_N-00197-22079416,2022-07-01T15:16:15,Labastida,incomes,salary,1498.15,-1215.02
buyer_8,Antonio,45,ES47209569543860298423,TRX_N-00198-57179570,2022-07-01T15:16:15,Labastida,incomes,salary_partner,1629.2,414.18
buyer_8,Antonio,45,ES47209569543860298423,TRX_N-00199-79484279,2022-07-01T15:16:15,Labastida,incomes,extra_income,237.8,651.98
buyer_8,Antonio,45,ES47209569543860298423,TRX_N-00200-25980928,2022-07-03T13:24:26,Labastida,Expense,healthcare,-138.61,513.37
buyer_8,Antonio,45,ES47209569543860298423,TRX_N-00201-98168200,2022-07-03T00:34:50,Labastida,Expense,gifts,-182.39,330.98
buyer_8,Antonio,45,ES47209569543860298423,TRX_N-00202-12772856,2022-07-04T15:02:21,Labastida,expenses,mortgage,-842.18,-511.2
buyer_8,Antonio,45,ES47209569543860298423,TRX_N-00203-33039685,2022-07-06T12:47:31,Labastida,expenses,internet,-42.0,-553.2
buyer_8,Antonio,45,ES47209569543860298423,TRX_N-00204-43266688,2022-07-06T08:24:52,Labastida,Expense,travel,-312.98,-866.18
buyer_8,Antonio,45,ES47209569543860298423,TRX_N-00205-60411217,2022-07-07T12:31:20,Labastida,expenses,water,-32.83,-899.01
buyer_8,Antonio,45,ES47209569543860298423,TRX_N-00206-63883092,2022-07-07T19:29:16,Labastida,Expense,repairs,-313.88,-1212.89
buyer_8,Antonio,45,ES47209569543860298423,TRX_N-00207-78875492,2022-07-07T19:57:03,Labastida,expenses,children,-99.03,-1311.92
buyer_8,Antonio,45,ES47209569543860298423,TRX_N-00208-13662712,2022-07-08T20:18:56,Labastida,expenses,electricity,-37.4,-1349.32
buyer_8,Antonio,45,ES47209569543860298423,TRX_N-00209-37879442,2022-07-08T20:57:20,Labastida,expenses,gas,-50.76,-1400.08
buyer_8,Antonio,45,ES47209569543860298423,TRX_N-00210-14400842,2022-07-08T09:43:46,Labastida,expenses,phone,-38.85,-1438.93
buyer_8,Antonio,45,ES47209569543860298423,TRX_N-00211-18428179,2022-07-08T12:20:48,Labastida,Expense,cash,-100.0,-1538.93
buyer_8,Antonio,45,ES47209569543860298423,TRX_N-00212-96837517,2022-07-09T18:12:16,Labastida,Expense,leisure,-29.32,-1568.25
buyer_8,Antonio,45,ES47209569543860298423,TRX_N-00213-16869061,2022-07-09T15:56:30,Labastida,Expense,repairs,-278.76,-1847.01
buyer_8,Antonio,45,ES47209569543860298423,TRX_N-00214-07260399,2022-07-11T20:23:50,Labastida,Expense,education,-48.99,-1896.0
buyer_8,Antonio,45,ES47209569543860298423,TRX_N-00215-70735968,2022-07-13T13:58:21,Labastida,Expense,transport,-46.97,-1942.97
buyer_8,Antonio,45,ES47209569543860298423,TRX_N-00216-63191334,2022-07-13T08:34:06,Labastida,Expense,cash,-100.0,-2042.97
buyer_8,Antonio,45,ES47209569543860298423,TRX_N-00217-56731086,2022-07-14T10:20:15,Labastida,Expense,food,-107.84,-2150.81
buyer_8,Antonio,45,ES47209569543860298423,TRX_N-00218-75111629,2022-07-14T10:30:37,Labastida,Expense,travel,-1349.09,-3499.9
buyer_8,Antonio,45,ES47209569543860298423,TRX_N-00219-32058962,2022-07-15T12:36:54,Lasarte-Oria,Expense,repairs,-295.44,-3795.34
buyer_8,Antonio,45,ES47209569543860298423,TRX_N-00220-57334076,2022-07-15T09:39:07,Labastida,expenses,children,-127.07,-3922.41
buyer_8,Antonio,45,ES47209569543860298423,TRX_N-00221-14180864,2022-07-17T12:51:16,Santurtzi,Expense,leisure,-61.02,-3983.43
buyer_8,Antonio,45,ES47209569543860298423,TRX_N-00222-10111467,2022-07-17T18:50:29,Labastida,expenses,children,-151.87,-4135.3
buyer_8,Antonio,45,ES47209569543860298423,TRX_N-00223-27133988,2022-07-18T17:12:50,Oy√≥n-Oion,Expense,cash,-100.0,-4235.3
buyer_8,Antonio,45,ES47209569543860298423,TRX_N-00224-62003904,2022-07-21T10:23:40,Pasaia,Expense,cash,-100.0,-4335.3
buyer_8,Antonio,45,ES47209569543860298423,TRX_N-00225-80031296,2022-07-21T08:20:08,Labastida,Expense,repairs,-283.23,-4618.53
buyer_8,Antonio,45,ES47209569543860298423,TRX_N-00226-79552289,2022-07-26T11:47:15,Labastida,Expense,leisure,-18.24,-4636.77
buyer_8,Antonio,45,ES47209569543860298423,TRX_N-00227-80717167,2022-07-26T15:22:01,Labastida,Expense,cash,-100.0,-4736.77
buyer_8,Antonio,45,ES47209569543860298423,TRX_N-00228-40514822,2022-07-26T15:53:19,Labastida,Expense,appliances,-399.23,-5136.0
buyer_8,Antonio,45,ES47209569543860298423,TRX_N-00229-30113308,2022-07-30T16:35:41,Amurrio,Expense,food,-67.81,-5203.81
buyer_8,Antonio,45,ES47209569543860298423,TRX_N-00230-06073128,2022-07-31T19:52:42,Labastida,Expense,food,-63.66,-5267.47
buyer_8,Antonio,45,ES47209569543860298423,TRX_N-00231-50594860,2022-08-01T10:05:53,Labastida,incomes,salary,1498.15,-3769.32
buyer_8,Antonio,45,ES47209569543860298423,TRX_N-00232-01357745,2022-08-01T10:05:53,Labastida,incomes,salary_partner,1629.2,-2140.12
buyer_8,Antonio,45,ES47209569543860298423,TRX_N-00233-02176836,2022-08-02T20:42:24,Labastida,Expense,transport,-41.81,-2181.93
buyer_8,Antonio,45,ES47209569543860298423,TRX_N-00234-10694699,2022-08-03T06:20:32,Errenteria,Expense,cash,-100.0,-2281.93
buyer_8,Antonio,45,ES47209569543860298423,TRX_N-00235-92124469,2022-08-04T18:55:23,Labastida,expenses,mortgage,-842.18,-3124.11
buyer_8,Antonio,45,ES47209569543860298423,TRX_N-00236-70915728,2022-08-05T14:53:32,Labastida,expenses,electricity,-58.06,-3182.17
buyer_8,Antonio,45,ES47209569543860298423,TRX_N-00237-92260974,2022-08-05T21:10:18,Labastida,expenses,phone,-34.86,-3217.03
buyer_8,Antonio,45,ES47209569543860298423,TRX_N-00238-01332984,2022-08-07T08:23:28,Labastida,expenses,water,-26.99,-3244.02
buyer_8,Antonio,45,ES47209569543860298423,TRX_N-00239-58876229,2022-08-07T20:16:51,Labastida,expenses,internet,-42.0,-3286.02
buyer_8,Antonio,45,ES47209569543860298423,TRX_N-00240-96647276,2022-08-07T20:29:52,Labastida,Expense,cash,-100.0,-3386.02
buyer_8,Antonio,45,ES47209569543860298423,TRX_N-00241-81067395,2022-08-07T01:14:55,Zarautz,Expense,gifts,-601.24,-3987.26
buyer_8,Antonio,45,ES47209569543860298423,TRX_N-00242-96123723,2022-08-08T15:39:59,Labastida,expenses,gas,-95.04,-4082.3
buyer_8,Antonio,45,ES47209569543860298423,TRX_N-00243-68250498,2022-08-08T02:06:48,Labastida,Expense,cash,-100.0,-4182.3
buyer_8,Antonio,45,ES47209569543860298423,TRX_N-00244-65400535,2022-08-10T10:46:55,Labastida,Expense,food,-70.47,-4252.77
buyer_8,Antonio,45,ES47209569543860298423,TRX_N-00245-10616139,2022-08-11T19:06:32,Labastida,Expense,education,-75.5,-4328.27
buyer_8,Antonio,45,ES47209569543860298423,TRX_N-00246-48251329,2022-08-11T17:56:02,Vitoria-Gasteiz,Expense,appliances,-182.3,-4510.57
buyer_8,Antonio,45,ES47209569543860298423,TRX_N-00247-99685281,2022-08-12T20:25:16,Labastida,Expense,cash,-100.0,-4610.57
buyer_8,Antonio,45,ES47209569543860298423,TRX_N-00248-54662380,2022-08-13T09:12:25,Labastida,Expense,clothing,-140.98,-4751.55
buyer_8,Antonio,45,ES47209569543860298423,TRX_N-00249-55351308,2022-08-15T11:44:01,Labastida,Expense,food,-118.8,-4870.35
buyer_8,Antonio,45,ES47209569543860298423,TRX_N-00250-25928023,2022-08-15T19:33:39,Oy√≥n-Oion,Expense,leisure,-62.85,-4933.2
buyer_8,Antonio,45,ES47209569543860298423,TRX_N-00251-28492051,2022-08-15T08:11:10,Donostia,Expense,gifts,-299.05,-5232.25
buyer_8,Antonio,45,ES47209569543860298423,TRX_N-00252-29399349,2022-08-16T08:42:08,Labastida,Expense,transport,-75.55,-5307.8
buyer_8,Antonio,45,ES47209569543860298423,TRX_N-00253-70015638,2022-08-17T18:21:24,Salvatierra/Agurain,Expense,cash,-100.0,-5407.8
buyer_8,Antonio,45,ES47209569543860298423,TRX_N-00254-68135404,2022-08-17T13:50:16,Labastida,Expense,gifts,-348.91,-5756.71
buyer_8,Antonio,45,ES47209569543860298423,TRX_N-00255-37077280,2022-08-18T08:35:09,Santurtzi,Expense,leisure,-77.67,-5834.38
buyer_8,Antonio,45,ES47209569543860298423,TRX_N-00256-96236228,2022-08-18T15:01:17,Labastida,Expense,cash,-100.0,-5934.38
buyer_8,Antonio,45,ES47209569543860298423,TRX_N-00257-34702169,2022-08-21T09:17:40,Labastida,Expense,transport,-81.09,-6015.47
buyer_8,Antonio,45,ES47209569543860298423,TRX_N-00258-42260673,2022-08-24T20:03:07,Labastida,Expense,cash,-100.0,-6115.47
buyer_8,Antonio,45,ES47209569543860298423,TRX_N-00259-20680072,2022-08-25T14:48:54,Elciego,Expense,transport,-52.46,-6167.93
buyer_8,Antonio,45,ES47209569543860298423,TRX_N-00260-70684086,2022-08-25T11:20:40,Pasaia,Expense,appliances,-385.09,-6553.02
buyer_8,Antonio,45,ES47209569543860298423,TRX_N-00261-39657321,2022-08-26T13:02:43,Pasaia,Expense,cash,-100.0,-6653.02
buyer_8,Antonio,45,ES47209569543860298423,TRX_N-00262-42789253,2022-08-27T10:11:27,Hondarribia,Expense,travel,-538.5,-7191.52
buyer_8,Antonio,45,ES47209569543860298423,TRX_N-00263-03356923,2022-08-28T14:41:49,Labastida,Expense,repairs,-231.34,-7422.86
buyer_8,Antonio,45,ES47209569543860298423,TRX_N-00264-73580197,2022-08-29T14:59:03,Labastida,Expense,food,-80.57,-7503.43
buyer_8,Antonio,45,ES47209569543860298423,TRX_N-00265-11928595,2022-08-29T18:57:45,Labastida,Expense,cash,-100.0,-7603.43
buyer_8,Antonio,45,ES47209569543860298423,TRX_N-00266-64997425,2022-08-30T17:55:00,Labastida,Expense,leisure,-73.07,-7676.5
buyer_8,Antonio,45,ES47209569543860298423,TRX_N-00267-73139209,2022-08-31T08:43:57,Labastida,Expense,clothing,-61.48,-7737.98
buyer_8,Antonio,45,ES47209569543860298423,TRX_N-00268-38450248,2022-08-31T23:42:09,Labastida,Expense,education,-53.04,-7791.02
buyer_8,Antonio,45,ES47209569543860298423,TRX_N-00269-29077695,2022-09-01T09:05:10,Labastida,incomes,salary,1498.15,-6292.87
buyer_8,Antonio,45,ES47209569543860298423,TRX_N-00270-20589699,2022-09-01T09:05:10,Labastida,incomes,salary_partner,1629.2,-4663.67
buyer_8,Antonio,45,ES47209569543860298423,TRX_N-00271-06236944,2022-09-02T17:55:23,Labastida,Expense,leisure,-72.36,-4736.03
buyer_8,Antonio,45,ES47209569543860298423,TRX_N-00272-40302361,2022-09-03T20:18:35,Labastida,Expense,transport,-55.45,-4791.48
buyer_8,Antonio,45,ES47209569543860298423,TRX_N-00273-13804083,2022-09-03T18:17:16,Labastida,expenses,children,-144.07,-4935.55
buyer_8,Antonio,45,ES47209569543860298423,TRX_N-00274-44589920,2022-09-04T17:05:56,Labastida,expenses,mortgage,-842.18,-5777.73
buyer_8,Antonio,45,ES47209569543860298423,TRX_N-00275-44705014,2022-09-04T18:24:44,Labastida,Expense,cash,-100.0,-5877.73
buyer_8,Antonio,45,ES47209569543860298423,TRX_N-00276-05956165,2022-09-05T09:25:38,Labastida,expenses,gas,-102.81,-5980.54
buyer_8,Antonio,45,ES47209569543860298423,TRX_N-00277-88476903,2022-09-05T02:39:13,Labastida,expenses,internet,-42.0,-6022.54
buyer_8,Antonio,45,ES47209569543860298423,TRX_N-00278-49402035,2022-09-05T14:16:09,Labastida,Expense,cash,-100.0,-6122.54
buyer_8,Antonio,45,ES47209569543860298423,TRX_N-00279-07522165,2022-09-05T10:59:50,Labastida,expenses,children,-173.65,-6296.19
buyer_8,Antonio,45,ES47209569543860298423,TRX_N-00280-90788525,2022-09-06T12:33:41,Labastida,expenses,phone,-37.34,-6333.53
buyer_8,Antonio,45,ES47209569543860298423,TRX_N-00281-43473741,2022-09-06T15:03:27,Labastida,Expense,food,-85.96,-6419.49
buyer_8,Antonio,45,ES47209569543860298423,TRX_N-00282-74708976,2022-09-08T09:00:35,Labastida,expenses,water,-40.26,-6459.75
buyer_8,Antonio,45,ES47209569543860298423,TRX_N-00283-95324177,2022-09-08T00:57:09,Labastida,expenses,electricity,-46.73,-6506.48
buyer_8,Antonio,45,ES47209569543860298423,TRX_N-00284-65434374,2022-09-08T16:53:14,Labastida,Expense,leisure,-44.69,-6551.17
buyer_8,Antonio,45,ES47209569543860298423,TRX_N-00285-25687017,2022-09-09T21:42:41,Labastida,Expense,transport,-43.66,-6594.83
buyer_8,Antonio,45,ES47209569543860298423,TRX_N-00286-79974263,2022-09-12T09:49:22,Labastida,Expense,education,-65.36,-6660.19
buyer_8,Antonio,45,ES47209569543860298423,TRX_N-00287-58142257,2022-09-12T18:32:09,Labastida,Expense,gifts,-136.21,-6796.4
buyer_8,Antonio,45,ES47209569543860298423,TRX_N-00288-74130942,2022-09-13T04:31:34,Labastida,Expense,cash,-100.0,-6896.4
buyer_8,Antonio,45,ES47209569543860298423,TRX_N-00289-56908067,2022-09-14T18:05:14,Labastida,Expense,repairs,-273.71,-7170.11
buyer_8,Antonio,45,ES47209569543860298423,TRX_N-00290-99850721,2022-09-15T20:22:37,Labastida,Expense,repairs,-194.37,-7364.48
buyer_8,Antonio,45,ES47209569543860298423,TRX_N-00291-21621342,2022-09-15T15:54:32,Labastida,expenses,children,-181.63,-7546.11
buyer_8,Antonio,45,ES47209569543860298423,TRX_N-00292-56418869,2022-09-17T11:22:39,Arrasate,Expense,healthcare,-165.25,-7711.36
buyer_8,Antonio,45,ES47209569543860298423,TRX_N-00293-73778659,2022-09-17T16:31:37,Labastida,Expense,gifts,-595.22,-8306.58
buyer_8,Antonio,45,ES47209569543860298423,TRX_N-00294-28870576,2022-09-18T19:09:51,Labastida,Expense,food,-73.68,-8380.26
buyer_8,Antonio,45,ES47209569543860298423,TRX_N-00295-23504819,2022-09-19T11:48:37,Labastida,Expense,cash,-100.0,-8480.26
buyer_8,Antonio,45,ES47209569543860298423,TRX_N-00296-09011652,2022-09-20T14:22:00,Donostia,Expense,cash,-100.0,-8580.26
buyer_8,Antonio,45,ES47209569543860298423,TRX_N-00297-32881656,2022-09-20T13:31:12,Erandio,Expense,repairs,-279.81,-8860.07
buyer_8,Antonio,45,ES47209569543860298423,TRX_N-00298-25943512,2022-09-21T09:53:33,Labastida,Expense,food,-90.13,-8950.2
buyer_8,Antonio,45,ES47209569543860298423,TRX_N-00299-48658345,2022-09-22T18:35:14,Labastida,Expense,cash,-100.0,-9050.2
buyer_8,Antonio,45,ES47209569543860298423,TRX_N-00300-27785376,2022-09-24T08:19:50,Labastida,Expense,cash,-100.0,-9150.2
buyer_8,Antonio,45,ES47209569543860298423,TRX_N-00301-71909225,2022-09-24T16:37:07,Labastida,Expense,repairs,-236.08,-9386.28
buyer_8,Antonio,45,ES47209569543860298423,TRX_N-00302-82883479,2022-09-26T04:59:25,Andoain,Expense,healthcare,-122.85,-9509.13
buyer_8,Antonio,45,ES47209569543860298423,TRX_N-00303-75742531,2022-09-26T12:49:02,Labastida,Expense,gifts,-605.76,-10114.89
buyer_8,Antonio,45,ES47209569543860298423,TRX_N-00304-10614895,2022-09-28T16:05:49,Pasaia,Expense,leisure,-54.78,-10169.67
buyer_8,Antonio,45,ES47209569543860298423,TRX_N-00305-15049093,2022-10-01T09:21:25,Labastida,incomes,salary,1498.15,-8671.52
buyer_8,Antonio,45,ES47209569543860298423,TRX_N-00306-10670521,2022-10-01T09:21:25,Labastida,incomes,salary_partner,1629.2,-7042.32
buyer_8,Antonio,45,ES47209569543860298423,TRX_N-00307-70863195,2022-10-01T19:52:13,Labastida,Expense,food,-100.82,-7143.14
buyer_8,Antonio,45,ES47209569543860298423,TRX_N-00308-29540387,2022-10-01T05:14:09,Galdakao,Expense,cash,-100.0,-7243.14
buyer_8,Antonio,45,ES47209569543860298423,TRX_N-00309-95991242,2022-10-02T19:18:01,Bilbao,Expense,cash,-100.0,-7343.14
buyer_8,Antonio,45,ES47209569543860298423,TRX_N-00310-35438147,2022-10-04T18:14:15,Labastida,expenses,mortgage,-842.18,-8185.32
buyer_8,Antonio,45,ES47209569543860298423,TRX_N-00311-44292018,2022-10-04T20:06:03,Sestao,Expense,food,-100.05,-8285.37
buyer_8,Antonio,45,ES47209569543860298423,TRX_N-00312-37949674,2022-10-05T15:38:19,Labastida,expenses,electricity,-69.57,-8354.94
buyer_8,Antonio,45,ES47209569543860298423,TRX_N-00313-30165008,2022-10-05T15:20:03,Labastida,expenses,gas,-36.74,-8391.68
buyer_8,Antonio,45,ES47209569543860298423,TRX_N-00314-07159272,2022-10-05T03:38:36,Labastida,Expense,clothing,-73.65,-8465.33
buyer_8,Antonio,45,ES47209569543860298423,TRX_N-00315-76384864,2022-10-05T13:47:54,Labastida,Expense,appliances,-328.86,-8794.19
buyer_8,Antonio,45,ES47209569543860298423,TRX_N-00316-79889668,2022-10-06T08:11:29,Labastida,expenses,internet,-42.0,-8836.19
buyer_8,Antonio,45,ES47209569543860298423,TRX_N-00317-27687541,2022-10-06T14:55:36,Labastida,expenses,phone,-43.29,-8879.48
buyer_8,Antonio,45,ES47209569543860298423,TRX_N-00318-81985274,2022-10-06T01:35:42,Labastida,Expense,transport,-53.73,-8933.21
buyer_8,Antonio,45,ES47209569543860298423,TRX_N-00319-30424747,2022-10-06T12:52:24,Labastida,Expense,leisure,-19.46,-8952.67
buyer_8,Antonio,45,ES47209569543860298423,TRX_N-00320-77285762,2022-10-08T09:44:07,Labastida,expenses,water,-43.52,-8996.19
buyer_8,Antonio,45,ES47209569543860298423,TRX_N-00321-36936559,2022-10-08T20:58:15,Errenteria,Expense,food,-80.98,-9077.17
buyer_8,Antonio,45,ES47209569543860298423,TRX_N-00322-54977583,2022-10-08T15:55:19,Labastida,Expense,gifts,-462.15,-9539.32
buyer_8,Antonio,45,ES47209569543860298423,TRX_N-00323-02037469,2022-10-09T16:14:35,Labastida,Expense,appliances,-85.87,-9625.19
buyer_8,Antonio,45,ES47209569543860298423,TRX_N-00324-88449775,2022-10-12T08:57:51,Erandio,Expense,education,-55.89,-9681.08
buyer_8,Antonio,45,ES47209569543860298423,TRX_N-00325-93091114,2022-10-14T21:43:41,Portugalete,Expense,food,-117.08,-9798.16
buyer_8,Antonio,45,ES47209569543860298423,TRX_N-00326-15200208,2022-10-17T16:27:48,Labastida,Expense,food,-109.87,-9908.03
buyer_8,Antonio,45,ES47209569543860298423,TRX_N-00327-63315455,2022-10-17T19:40:07,Labastida,Expense,cash,-100.0,-10008.03
buyer_8,Antonio,45,ES47209569543860298423,TRX_N-00328-07237201,2022-10-18T10:09:37,Labastida,Expense,cash,-100.0,-10108.03
buyer_8,Antonio,45,ES47209569543860298423,TRX_N-00329-49661477,2022-10-19T11:16:25,Labastida,expenses,children,-273.73,-10381.76
buyer_8,Antonio,45,ES47209569543860298423,TRX_N-00330-25241855,2022-10-20T16:06:25,Labastida,Expense,food,-121.35,-10503.11
buyer_8,Antonio,45,ES47209569543860298423,TRX_N-00331-22644638,2022-10-20T22:44:37,Labastida,Expense,leisure,-30.56,-10533.67
buyer_8,Antonio,45,ES47209569543860298423,TRX_N-00332-77921222,2022-10-21T09:20:53,Labastida,expenses,children,-136.67,-10670.34
buyer_8,Antonio,45,ES47209569543860298423,TRX_N-00333-54717895,2022-10-22T09:24:21,Labastida,Expense,travel,-911.69,-11582.03
buyer_8,Antonio,45,ES47209569543860298423,TRX_N-00334-92756898,2022-10-27T17:43:34,Labastida,Expense,clothing,-129.21,-11711.24
buyer_8,Antonio,45,ES47209569543860298423,TRX_N-00335-89710954,2022-10-28T07:00:51,Labastida,Expense,gifts,-467.47,-12178.71
buyer_8,Antonio,45,ES47209569543860298423,TRX_N-00336-00148322,2022-10-31T11:50:41,Labastida,Expense,transport,-48.16,-12226.87
buyer_8,Antonio,45,ES47209569543860298423,TRX_N-00337-79998786,2022-11-01T06:35:44,Labastida,incomes,salary,1498.15,-10728.72
buyer_8,Antonio,45,ES47209569543860298423,TRX_N-00338-39578873,2022-11-01T06:35:44,Labastida,incomes,salary_partner,1629.2,-9099.52
buyer_8,Antonio,45,ES47209569543860298423,TRX_N-00339-82741307,2022-11-01T06:35:44,Labastida,incomes,extra_income,237.8,-8861.72
buyer_8,Antonio,45,ES47209569543860298423,TRX_N-00340-88825164,2022-11-01T19:27:18,Labastida,Expense,food,-97.14,-8958.86
buyer_8,Antonio,45,ES47209569543860298423,TRX_N-00341-27497745,2022-11-02T08:39:20,Labastida,Expense,transport,-85.2,-9044.06
buyer_8,Antonio,45,ES47209569543860298423,TRX_N-00342-76632147,2022-11-02T09:54:02,Labastida,Expense,leisure,-33.48,-9077.54
buyer_8,Antonio,45,ES47209569543860298423,TRX_N-00343-44016209,2022-11-04T14:45:02,Labastida,expenses,mortgage,-842.18,-9919.72
buyer_8,Antonio,45,ES47209569543860298423,TRX_N-00344-21277700,2022-11-04T10:01:40,Labastida,Expense,food,-101.41,-10021.13
buyer_8,Antonio,45,ES47209569543860298423,TRX_N-00345-69903211,2022-11-05T17:40:26,Labastida,expenses,electricity,-88.95,-10110.08
buyer_8,Antonio,45,ES47209569543860298423,TRX_N-00346-27956229,2022-11-05T11:50:54,Labastida,Expense,cash,-100.0,-10210.08
buyer_8,Antonio,45,ES47209569543860298423,TRX_N-00347-50586352,2022-11-05T12:42:44,Labastida,Expense,appliances,-374.72,-10584.8
buyer_8,Antonio,45,ES47209569543860298423,TRX_N-00348-01262981,2022-11-06T17:39:54,Labastida,expenses,gas,-47.13,-10631.93
buyer_8,Antonio,45,ES47209569543860298423,TRX_N-00349-08622937,2022-11-07T13:08:46,Labastida,expenses,internet,-42.0,-10673.93
buyer_8,Antonio,45,ES47209569543860298423,TRX_N-00350-95291264,2022-11-07T21:05:49,Galdakao,Expense,leisure,-73.44,-10747.37
buyer_8,Antonio,45,ES47209569543860298423,TRX_N-00351-55691203,2022-11-08T10:35:59,Labastida,expenses,water,-35.01,-10782.38
buyer_8,Antonio,45,ES47209569543860298423,TRX_N-00352-12486010,2022-11-08T17:19:19,Labastida,expenses,phone,-32.72,-10815.1
buyer_8,Antonio,45,ES47209569543860298423,TRX_N-00353-44011067,2022-11-08T13:14:25,Labastida,Expense,repairs,-253.87,-11068.97
buyer_8,Antonio,45,ES47209569543860298423,TRX_N-00354-58462059,2022-11-09T21:24:21,Labastida,Expense,cash,-100.0,-11168.97
buyer_8,Antonio,45,ES47209569543860298423,TRX_N-00355-97223452,2022-11-12T13:16:06,Erandio,Expense,leisure,-32.71,-11201.68
buyer_8,Antonio,45,ES47209569543860298423,TRX_N-00356-93962664,2022-11-12T12:50:21,Labastida,Expense,clothing,-55.24,-11256.92
buyer_8,Antonio,45,ES47209569543860298423,TRX_N-00357-40578457,2022-11-13T15:53:24,Irun,Expense,food,-112.98,-11369.9
buyer_8,Antonio,45,ES47209569543860298423,TRX_N-00358-74473237,2022-11-13T17:35:17,Labastida,Expense,repairs,-319.11,-11689.01
buyer_8,Antonio,45,ES47209569543860298423,TRX_N-00359-84500807,2022-11-14T10:06:37,Labastida,Expense,leisure,-33.08,-11722.09
buyer_8,Antonio,45,ES47209569543860298423,TRX_N-00360-13030996,2022-11-14T04:27:10,Labastida,Expense,gifts,-643.2,-12365.29
buyer_8,Antonio,45,ES47209569543860298423,TRX_N-00361-97874870,2022-11-15T13:55:40,Labastida,Expense,leisure,-52.9,-12418.19
buyer_8,Antonio,45,ES47209569543860298423,TRX_N-00362-31018604,2022-11-15T08:24:38,Labastida,Expense,clothing,-142.95,-12561.14
buyer_8,Antonio,45,ES47209569543860298423,TRX_N-00363-93202685,2022-11-18T12:46:58,Labastida,Expense,clothing,-152.53,-12713.67
buyer_8,Antonio,45,ES47209569543860298423,TRX_N-00364-60590060,2022-11-19T19:41:55,Labastida,Expense,transport,-68.17,-12781.84
buyer_8,Antonio,45,ES47209569543860298423,TRX_N-00365-15710930,2022-11-19T19:26:22,Labastida,Expense,cash,-100.0,-12881.84
buyer_8,Antonio,45,ES47209569543860298423,TRX_N-00366-89067594,2022-11-19T14:27:31,Bermeo,Expense,appliances,-272.1,-13153.94
buyer_8,Antonio,45,ES47209569543860298423,TRX_N-00367-32601166,2022-11-20T23:20:04,Labastida,Expense,transport,-68.86,-13222.8
buyer_8,Antonio,45,ES47209569543860298423,TRX_N-00368-81395634,2022-11-21T10:02:29,Oy√≥n-Oion,Expense,leisure,-46.91,-13269.71
buyer_8,Antonio,45,ES47209569543860298423,TRX_N-00369-25684037,2022-11-21T14:26:44,Labastida,Expense,cash,-100.0,-13369.71
buyer_8,Antonio,45,ES47209569543860298423,TRX_N-00370-79156901,2022-11-22T14:13:34,Labastida,Expense,food,-97.12,-13466.83
buyer_8,Antonio,45,ES47209569543860298423,TRX_N-00371-59806571,2022-11-22T11:26:29,Labastida,Expense,healthcare,-98.71,-13565.54
buyer_8,Antonio,45,ES47209569543860298423,TRX_N-00372-43265027,2022-11-26T20:16:39,Labastida,Expense,repairs,-287.01,-13852.55
buyer_8,Antonio,45,ES47209569543860298423,TRX_N-00373-85738745,2022-11-27T12:13:08,Labastida,Expense,food,-72.57,-13925.12
buyer_8,Antonio,45,ES47209569543860298423,TRX_N-00374-54108872,2022-11-28T11:42:34,Labastida,Expense,food,-73.56,-13998.68
buyer_8,Antonio,45,ES47209569543860298423,TRX_N-00375-24290446,2022-11-29T10:08:45,Andoain,Expense,gifts,-467.35,-14466.03
buyer_8,Antonio,45,ES47209569543860298423,TRX_N-00376-54555407,2022-11-30T09:17:43,Labastida,Expense,clothing,-98.61,-14564.64
buyer_8,Antonio,45,ES47209569543860298423,TRX_N-00377-80103063,2022-12-01T16:27:42,Labastida,incomes,salary,1498.15,-13066.49
buyer_8,Antonio,45,ES47209569543860298423,TRX_N-00378-37796207,2022-12-01T16:27:42,Labastida,incomes,salary_partner,1629.2,-11437.29
buyer_8,Antonio,45,ES47209569543860298423,TRX_N-00379-28467354,2022-12-01T16:27:42,Labastida,incomes,salary_bonus,1113.73,-10323.56
buyer_8,Antonio,45,ES47209569543860298423,TRX_N-00380-38482561,2022-12-01T16:27:42,Labastida,incomes,salary_partner_bonus,1205.37,-9118.19
buyer_8,Antonio,45,ES47209569543860298423,TRX_N-00381-38804606,2022-12-01T14:28:45,Labastida,Expense,clothing,-158.19,-9276.38
buyer_8,Antonio,45,ES47209569543860298423,TRX_N-00382-79176562,2022-12-01T08:38:57,Labastida,Expense,cash,-100.0,-9376.38
buyer_8,Antonio,45,ES47209569543860298423,TRX_N-00383-81443597,2022-12-01T15:06:33,Labastida,Expense,gifts,-809.52,-10185.9
buyer_8,Antonio,45,ES47209569543860298423,TRX_N-00384-82224515,2022-12-03T10:27:17,Labastida,Expense,cash,-100.0,-10285.9
buyer_8,Antonio,45,ES47209569543860298423,TRX_N-00385-54643527,2022-12-04T08:15:56,Labastida,expenses,mortgage,-842.18,-11128.08
buyer_8,Antonio,45,ES47209569543860298423,TRX_N-00386-17333723,2022-12-05T16:57:45,Labastida,expenses,phone,-32.67,-11160.75
buyer_8,Antonio,45,ES47209569543860298423,TRX_N-00387-29510023,2022-12-06T21:58:28,Labastida,expenses,gas,-78.67,-11239.42
buyer_8,Antonio,45,ES47209569543860298423,TRX_N-00388-12839524,2022-12-07T08:27:53,Labastida,expenses,electricity,-67.35,-11306.77
buyer_8,Antonio,45,ES47209569543860298423,TRX_N-00389-24522473,2022-12-07T18:26:28,Labastida,Expense,cash,-100.0,-11406.77
buyer_8,Antonio,45,ES47209569543860298423,TRX_N-00390-51881075,2022-12-07T21:28:08,Labastida,Expense,appliances,-83.83,-11490.6
buyer_8,Antonio,45,ES47209569543860298423,TRX_N-00391-00808469,2022-12-07T20:45:34,Llodio,Expense,gifts,-796.87,-12287.47
buyer_8,Antonio,45,ES47209569543860298423,TRX_N-00392-98839223,2022-12-08T15:40:44,Labastida,expenses,water,-36.15,-12323.62
buyer_8,Antonio,45,ES47209569543860298423,TRX_N-00393-33924839,2022-12-08T19:28:01,Labastida,expenses,internet,-42.0,-12365.62
buyer_8,Antonio,45,ES47209569543860298423,TRX_N-00394-20418770,2022-12-09T01:25:55,Eibar,Expense,education,-72.0,-12437.62
buyer_8,Antonio,45,ES47209569543860298423,TRX_N-00395-03563044,2022-12-09T20:42:06,Labastida,Expense,cash,-100.0,-12537.62
buyer_8,Antonio,45,ES47209569543860298423,TRX_N-00396-34917344,2022-12-11T03:10:30,Labastida,Expense,food,-72.54,-12610.16
buyer_8,Antonio,45,ES47209569543860298423,TRX_N-00397-11217487,2022-12-11T20:10:54,Labastida,Expense,repairs,-225.38,-12835.54
buyer_8,Antonio,45,ES47209569543860298423,TRX_N-00398-35544405,2022-12-12T11:43:03,Labastida,Expense,food,-119.76,-12955.3
buyer_8,Antonio,45,ES47209569543860298423,TRX_N-00399-06058996,2022-12-13T20:49:34,Labastida,Expense,leisure,-57.19,-13012.49
buyer_8,Antonio,45,ES47209569543860298423,TRX_N-00400-97180959,2022-12-13T18:52:20,Labastida,Expense,clothing,-88.48,-13100.97
buyer_8,Antonio,45,ES47209569543860298423,TRX_N-00401-59634129,2022-12-13T14:50:03,Hondarribia,Expense,travel,-1749.81,-14850.78
buyer_8,Antonio,45,ES47209569543860298423,TRX_N-00402-44161703,2022-12-15T12:56:48,Labastida,Expense,transport,-50.92,-14901.7
buyer_8,Antonio,45,ES47209569543860298423,TRX_N-00403-17251390,2022-12-15T20:27:50,Berango,Expense,cash,-100.0,-15001.7
buyer_8,Antonio,45,ES47209569543860298423,TRX_N-00404-82676321,2022-12-17T16:34:42,Arrasate,Expense,leisure,-39.97,-15041.67
buyer_8,Antonio,45,ES47209569543860298423,TRX_N-00405-63086283,2022-12-17T10:46:12,Labastida,Expense,gifts,-535.84,-15577.51
buyer_8,Antonio,45,ES47209569543860298423,TRX_N-00406-99118527,2022-12-18T10:52:55,Labastida,Expense,gifts,-349.54,-15927.05
buyer_8,Antonio,45,ES47209569543860298423,TRX_N-00407-80135165,2022-12-19T11:39:29,Labastida,Expense,clothing,-77.52,-16004.57
buyer_8,Antonio,45,ES47209569543860298423,TRX_N-00408-79591029,2022-12-19T09:57:20,Labastida,Expense,cash,-100.0,-16104.57
buyer_8,Antonio,45,ES47209569543860298423,TRX_N-00409-04952250,2022-12-21T20:58:23,Labastida,Expense,cash,-100.0,-16204.57
buyer_8,Antonio,45,ES47209569543860298423,TRX_N-00410-58153683,2022-12-22T03:18:47,Labastida,Expense,cash,-100.0,-16304.57
buyer_8,Antonio,45,ES47209569543860298423,TRX_N-00411-21306283,2022-12-26T03:24:08,Labastida,Expense,food,-97.1,-16401.67
buyer_8,Antonio,45,ES47209569543860298423,TRX_N-00412-84969911,2022-12-27T04:52:47,Labastida,Expense,food,-93.38,-16495.05
buyer_8,Antonio,45,ES47209569543860298423,TRX_N-00413-66409609,2022-12-27T20:51:25,Labastida,Expense,gifts,-791.55,-17286.6
buyer_8,Antonio,45,ES47209569543860298423,TRX_N-00414-50686788,2022-12-28T08:32:37,Labastida,Expense,repairs,-297.93,-17584.53
buyer_8,Antonio,45,ES47209569543860298423,TRX_N-00415-20635071,2022-12-28T20:58:42,Labastida,Expense,gifts,-630.11,-18214.64
buyer_8,Antonio,45,ES47209569543860298423,TRX_N-00416-03784109,2022-12-29T08:26:57,Labastida,Expense,education,-52.03,-18266.67
buyer_8,Antonio,45,ES47209569543860298423,TRX_N-00417-87614912,2023-01-01T09:35:07,Labastida,incomes,salary,1545.65,-16721.02
buyer_8,Antonio,45,ES47209569543860298423,TRX_N-00418-78302569,2023-01-01T09:35:07,Labastida,incomes,salary_partner,1680.85,-15040.17
buyer_8,Antonio,45,ES47209569543860298423,TRX_N-00419-95177924,2023-01-01T14:50:56,Errenteria,Expense,food,-104.38,-15144.55
buyer_8,Antonio,45,ES47209569543860298423,TRX_N-00420-59528623,2023-01-02T08:11:59,Labastida,Expense,cash,-100.0,-15244.55
buyer_8,Antonio,45,ES47209569543860298423,TRX_N-00421-69470579,2023-01-03T10:01:50,Labastida,Expense,transport,-50.87,-15295.42
buyer_8,Antonio,45,ES47209569543860298423,TRX_N-00422-07590851,2023-01-04T13:25:20,Labastida,expenses,mortgage,-842.18,-16137.6
buyer_8,Antonio,45,ES47209569543860298423,TRX_N-00423-68064146,2023-01-04T11:24:22,Labastida,Expense,food,-114.21,-16251.81
buyer_8,Antonio,45,ES47209569543860298423,TRX_N-00424-61733959,2023-01-05T16:59:29,Labastida,expenses,internet,-42.0,-16293.81
buyer_8,Antonio,45,ES47209569543860298423,TRX_N-00425-82885904,2023-01-06T20:16:33,Labastida,Expense,gifts,-712.01,-17005.82
buyer_8,Antonio,45,ES47209569543860298423,TRX_N-00426-14930220,2023-01-07T01:24:42,Labastida,expenses,gas,-70.39,-17076.21
buyer_8,Antonio,45,ES47209569543860298423,TRX_N-00427-84720393,2023-01-07T16:56:38,Labastida,Expense,cash,-100.0,-17176.21
buyer_8,Antonio,45,ES47209569543860298423,TRX_N-00428-69602832,2023-01-08T16:54:19,Labastida,expenses,electricity,-73.87,-17250.08
buyer_8,Antonio,45,ES47209569543860298423,TRX_N-00429-72944422,2023-01-08T22:54:58,Labastida,expenses,water,-42.3,-17292.38
buyer_8,Antonio,45,ES47209569543860298423,TRX_N-00430-52624330,2023-01-08T10:55:46,Labastida,expenses,phone,-39.31,-17331.69
buyer_8,Antonio,45,ES47209569543860298423,TRX_N-00431-54028088,2023-01-08T20:16:51,Labastida,Expense,gifts,-45.54,-17377.23
buyer_8,Antonio,45,ES47209569543860298423,TRX_N-00432-46714754,2023-01-09T09:39:30,Labastida,Expense,transport,-73.14,-17450.37
buyer_8,Antonio,45,ES47209569543860298423,TRX_N-00433-26478622,2023-01-10T18:09:24,Labastida,Expense,food,-92.45,-17542.82
buyer_8,Antonio,45,ES47209569543860298423,TRX_N-00434-42127904,2023-01-11T17:54:55,Labastida,Expense,cash,-100.0,-17642.82
buyer_8,Antonio,45,ES47209569543860298423,TRX_N-00435-91562841,2023-01-14T12:25:47,Labastida,Expense,cash,-100.0,-17742.82
buyer_8,Antonio,45,ES47209569543860298423,TRX_N-00436-94301852,2023-01-20T16:55:42,Labastida,Expense,repairs,-305.18,-18048.0
buyer_8,Antonio,45,ES47209569543860298423,TRX_N-00437-05912398,2023-01-21T17:50:54,Erandio,Expense,food,-80.63,-18128.63
buyer_8,Antonio,45,ES47209569543860298423,TRX_N-00438-80500539,2023-01-21T19:20:35,Pasaia,Expense,healthcare,-100.36,-18228.99
buyer_8,Antonio,45,ES47209569543860298423,TRX_N-00439-67053357,2023-01-22T16:52:43,Labastida,Expense,cash,-100.0,-18328.99
buyer_8,Antonio,45,ES47209569543860298423,TRX_N-00440-59913541,2023-01-22T17:31:24,Labastida,Expense,repairs,-128.76,-18457.75
buyer_8,Antonio,45,ES47209569543860298423,TRX_N-00441-74405749,2023-01-25T11:07:32,Labastida,Expense,leisure,-41.35,-18499.1
buyer_8,Antonio,45,ES47209569543860298423,TRX_N-00442-13533339,2023-01-28T14:51:23,Labastida,Expense,food,-97.87,-18596.97
buyer_8,Antonio,45,ES47209569543860298423,TRX_N-00443-33740187,2023-01-28T12:18:57,Labastida,Expense,transport,-63.03,-18660.0
buyer_8,Antonio,45,ES47209569543860298423,TRX_N-00444-35806908,2023-01-29T08:54:43,Labastida,Expense,food,-90.78,-18750.78
buyer_8,Antonio,45,ES47209569543860298423,TRX_N-00445-12646404,2023-01-29T15:56:53,Labastida,Expense,transport,-60.57,-18811.35
buyer_8,Antonio,45,ES47209569543860298423,TRX_N-00446-17572707,2023-01-30T17:55:59,Sopela,Expense,leisure,-53.25,-18864.6
buyer_8,Antonio,45,ES47209569543860298423,TRX_N-00447-65473018,2023-01-31T18:12:09,Labastida,Expense,food,-91.13,-18955.73
buyer_8,Antonio,45,ES47209569543860298423,TRX_N-00448-99541512,2023-02-01T10:30:30,Labastida,incomes,salary,1545.65,-17410.08
buyer_8,Antonio,45,ES47209569543860298423,TRX_N-00449-58000611,2023-02-01T10:30:30,Labastida,incomes,salary_partner,1680.85,-15729.23
buyer_8,Antonio,45,ES47209569543860298423,TRX_N-00450-09314515,2023-02-01T10:30:30,Labastida,incomes,extra_income,237.8,-15491.43
buyer_8,Antonio,45,ES47209569543860298423,TRX_N-00451-07447147,2023-02-01T18:35:23,Labastida,Expense,transport,-53.33,-15544.76
buyer_8,Antonio,45,ES47209569543860298423,TRX_N-00452-10922803,2023-02-03T19:56:49,Labastida,Expense,transport,-89.32,-15634.08
buyer_8,Antonio,45,ES47209569543860298423,TRX_N-00453-45577590,2023-02-04T19:49:01,Labastida,expenses,mortgage,-842.18,-16476.26
buyer_8,Antonio,45,ES47209569543860298423,TRX_N-00454-42124781,2023-02-04T11:35:02,Labastida,expenses,children,-263.27,-16739.53
buyer_8,Antonio,45,ES47209569543860298423,TRX_N-00455-66692967,2023-02-05T19:13:22,Labastida,Expense,leisure,-55.32,-16794.85
buyer_8,Antonio,45,ES47209569543860298423,TRX_N-00456-88668258,2023-02-05T08:45:18,Sopela,Expense,cash,-100.0,-16894.85
buyer_8,Antonio,45,ES47209569543860298423,TRX_N-00457-57160230,2023-02-06T08:18:58,Labastida,expenses,internet,-42.0,-16936.85
buyer_8,Antonio,45,ES47209569543860298423,TRX_N-00458-37761978,2023-02-06T08:00:19,Portugalete,Expense,repairs,-136.99,-17073.84
buyer_8,Antonio,45,ES47209569543860298423,TRX_N-00459-78664764,2023-02-07T13:07:42,Labastida,expenses,phone,-32.87,-17106.71
buyer_8,Antonio,45,ES47209569543860298423,TRX_N-00460-60542710,2023-02-08T14:17:35,Labastida,expenses,water,-30.33,-17137.04
buyer_8,Antonio,45,ES47209569543860298423,TRX_N-00461-61431370,2023-02-08T11:44:47,Labastida,expenses,electricity,-87.31,-17224.35
buyer_8,Antonio,45,ES47209569543860298423,TRX_N-00462-79597267,2023-02-08T10:38:53,Labastida,expenses,gas,-51.04,-17275.39
buyer_8,Antonio,45,ES47209569543860298423,TRX_N-00463-36708736,2023-02-08T11:55:06,Labastida,Expense,education,-69.12,-17344.51
buyer_8,Antonio,45,ES47209569543860298423,TRX_N-00464-67965952,2023-02-09T19:37:35,Labastida,Expense,cash,-100.0,-17444.51
buyer_8,Antonio,45,ES47209569543860298423,TRX_N-00465-87860331,2023-02-10T03:50:39,Zarautz,Expense,gifts,-424.33,-17868.84
buyer_8,Antonio,45,ES47209569543860298423,TRX_N-00466-97622641,2023-02-16T12:02:09,Bilbao,Expense,healthcare,-184.58,-18053.42
buyer_8,Antonio,45,ES47209569543860298423,TRX_N-00467-26494402,2023-02-16T13:39:13,Labastida,Expense,education,-77.55,-18130.97
buyer_8,Antonio,45,ES47209569543860298423,TRX_N-00468-78498144,2023-02-16T17:12:50,Labastida,Expense,gifts,-651.06,-18782.03
buyer_8,Antonio,45,ES47209569543860298423,TRX_N-00469-44248866,2023-02-17T17:56:26,Labastida,expenses,children,-104.83,-18886.86
buyer_8,Antonio,45,ES47209569543860298423,TRX_N-00470-32508603,2023-02-19T17:43:20,Labastida,Expense,cash,-100.0,-18986.86
buyer_8,Antonio,45,ES47209569543860298423,TRX_N-00471-36792140,2023-02-20T15:58:34,Zarautz,Expense,food,-71.79,-19058.65
buyer_8,Antonio,45,ES47209569543860298423,TRX_N-00472-88476557,2023-02-20T21:23:36,Labastida,Expense,cash,-100.0,-19158.65
buyer_8,Antonio,45,ES47209569543860298423,TRX_N-00473-61792562,2023-02-23T13:13:21,Labastida,Expense,food,-124.8,-19283.45
buyer_8,Antonio,45,ES47209569543860298423,TRX_N-00474-71774540,2023-02-24T10:01:16,Labastida,Expense,cash,-100.0,-19383.45
buyer_8,Antonio,45,ES47209569543860298423,TRX_N-00475-65211020,2023-02-26T20:41:32,Labastida,Expense,leisure,-82.4,-19465.85
buyer_8,Antonio,45,ES47209569543860298423,TRX_N-00476-59476423,2023-02-26T16:58:18,Labastida,Expense,cash,-100.0,-19565.85
buyer_8,Antonio,45,ES47209569543860298423,TRX_N-00477-93919801,2023-02-27T13:58:27,Labastida,Expense,food,-77.08,-19642.93
buyer_8,Antonio,45,ES47209569543860298423,TRX_N-00478-11638134,2023-02-27T16:24:18,Iru√±a de Oca,Expense,transport,-84.91,-19727.84
buyer_8,Antonio,45,ES47209569543860298423,TRX_N-00479-74030649,2023-03-01T19:44:18,Labastida,incomes,salary,1545.65,-18182.19
buyer_8,Antonio,45,ES47209569543860298423,TRX_N-00480-73020917,2023-03-01T19:44:18,Labastida,incomes,salary_partner,1680.85,-16501.34
buyer_8,Antonio,45,ES47209569543860298423,TRX_N-00481-37743093,2023-03-02T10:08:27,Labastida,Expense,leisure,-71.33,-16572.67
buyer_8,Antonio,45,ES47209569543860298423,TRX_N-00482-09279561,2023-03-02T11:44:14,Labastida,Expense,repairs,-115.23,-16687.9
buyer_8,Antonio,45,ES47209569543860298423,TRX_N-00483-41039120,2023-03-03T20:44:40,Labastida,Expense,clothing,-56.69,-16744.59
buyer_8,Antonio,45,ES47209569543860298423,TRX_N-00484-95032083,2023-03-04T09:55:01,Labastida,expenses,mortgage,-842.18,-17586.77
buyer_8,Antonio,45,ES47209569543860298423,TRX_N-00485-45367881,2023-03-04T13:30:08,Elciego,Expense,transport,-87.31,-17674.08
buyer_8,Antonio,45,ES47209569543860298423,TRX_N-00486-26676147,2023-03-04T09:01:43,Labastida,Expense,cash,-100.0,-17774.08
buyer_8,Antonio,45,ES47209569543860298423,TRX_N-00487-14458825,2023-03-05T18:13:28,Labastida,expenses,water,-42.3,-17816.38
buyer_8,Antonio,45,ES47209569543860298423,TRX_N-00488-91609699,2023-03-05T12:38:57,Labastida,Expense,leisure,-39.98,-17856.36
buyer_8,Antonio,45,ES47209569543860298423,TRX_N-00489-81365151,2023-03-06T00:51:39,Labastida,expenses,electricity,-43.72,-17900.08
buyer_8,Antonio,45,ES47209569543860298423,TRX_N-00490-72528736,2023-03-06T10:49:14,Labastida,expenses,gas,-59.78,-17959.86
buyer_8,Antonio,45,ES47209569543860298423,TRX_N-00491-22938465,2023-03-06T07:24:59,Labastida,Expense,cash,-100.0,-18059.86
buyer_8,Antonio,45,ES47209569543860298423,TRX_N-00492-44215140,2023-03-07T20:56:31,Labastida,Expense,leisure,-60.89,-18120.75
buyer_8,Antonio,45,ES47209569543860298423,TRX_N-00493-15984971,2023-03-08T17:14:50,Labastida,expenses,internet,-42.0,-18162.75
buyer_8,Antonio,45,ES47209569543860298423,TRX_N-00494-75003641,2023-03-08T09:19:38,Labastida,expenses,phone,-31.99,-18194.74
buyer_8,Antonio,45,ES47209569543860298423,TRX_N-00495-69798924,2023-03-13T10:01:37,Labastida,Expense,repairs,-98.75,-18293.49
buyer_8,Antonio,45,ES47209569543860298423,TRX_N-00496-65071856,2023-03-14T19:29:09,Labastida,Expense,food,-88.2,-18381.69
buyer_8,Antonio,45,ES47209569543860298423,TRX_N-00497-15812833,2023-03-15T14:37:46,Labastida,Expense,cash,-100.0,-18481.69
buyer_8,Antonio,45,ES47209569543860298423,TRX_N-00498-01589978,2023-03-17T17:01:06,Labastida,Expense,repairs,-33.7,-18515.39
buyer_8,Antonio,45,ES47209569543860298423,TRX_N-00499-13868613,2023-03-18T09:58:36,Labastida,Expense,leisure,-46.32,-18561.71
buyer_8,Antonio,45,ES47209569543860298423,TRX_N-00500-79273098,2023-03-19T22:59:28,Labastida,Expense,leisure,-63.42,-18625.13
buyer_8,Antonio,45,ES47209569543860298423,TRX_N-00501-30372450,2023-03-21T09:30:23,Labastida,Expense,gifts,-716.6,-19341.73
buyer_8,Antonio,45,ES47209569543860298423,TRX_N-00502-58517042,2023-03-22T20:57:49,Labastida,Expense,cash,-100.0,-19441.73
buyer_8,Antonio,45,ES47209569543860298423,TRX_N-00503-04937583,2023-03-24T21:36:33,Labastida,Expense,transport,-79.38,-19521.11
buyer_8,Antonio,45,ES47209569543860298423,TRX_N-00504-20403099,2023-03-25T13:39:21,Labastida,Expense,transport,-87.22,-19608.33
buyer_8,Antonio,45,ES47209569543860298423,TRX_N-00505-11328081,2023-03-26T09:03:07,Labastida,expenses,children,-55.74,-19664.07
buyer_8,Antonio,45,ES47209569543860298423,TRX_N-00506-73131199,2023-03-28T22:34:35,Vitoria-Gasteiz,Expense,leisure,-73.24,-19737.31
buyer_8,Antonio,45,ES47209569543860298423,TRX_N-00507-80090155,2023-03-28T10:40:54,Labastida,Expense,appliances,-408.24,-20145.55
buyer_8,Antonio,45,ES47209569543860298423,TRX_N-00508-24925279,2023-03-30T15:08:06,Labastida,Expense,transport,-56.79,-20202.34
buyer_8,Antonio,45,ES47209569543860298423,TRX_N-00509-48797993,2023-03-30T12:30:43,Leioa,Expense,travel,-1886.6,-22088.94
buyer_8,Antonio,45,ES47209569543860298423,TRX_N-00510-33711962,2023-03-31T08:49:24,Labastida,Expense,food,-123.81,-22212.75
buyer_8,Antonio,45,ES47209569543860298423,TRX_N-00511-22609843,2023-04-01T14:03:59,Labastida,incomes,salary,1545.65,-20667.1
buyer_8,Antonio,45,ES47209569543860298423,TRX_N-00512-31617479,2023-04-01T14:03:59,Labastida,incomes,salary_partner,1680.85,-18986.25
buyer_8,Antonio,45,ES47209569543860298423,TRX_N-00513-27184959,2023-04-03T20:46:19,Labastida,Expense,transport,-76.8,-19063.05
buyer_8,Antonio,45,ES47209569543860298423,TRX_N-00514-94458606,2023-04-04T13:11:50,Labastida,expenses,mortgage,-842.18,-19905.23
buyer_8,Antonio,45,ES47209569543860298423,TRX_N-00515-92522524,2023-04-04T18:12:08,Labastida,Expense,clothing,-67.81,-19973.04
buyer_8,Antonio,45,ES47209569543860298423,TRX_N-00516-81571910,2023-04-04T23:42:54,Labastida,expenses,children,-159.6,-20132.64
buyer_8,Antonio,45,ES47209569543860298423,TRX_N-00517-49711901,2023-04-05T18:20:53,Labastida,expenses,water,-38.97,-20171.61
buyer_8,Antonio,45,ES47209569543860298423,TRX_N-00518-43389593,2023-04-05T18:48:42,Labastida,expenses,gas,-80.96,-20252.57
buyer_8,Antonio,45,ES47209569543860298423,TRX_N-00519-39808396,2023-04-05T19:13:56,Labastida,expenses,phone,-40.41,-20292.98
buyer_8,Antonio,45,ES47209569543860298423,TRX_N-00520-99017814,2023-04-05T09:02:21,Labastida,Expense,cash,-100.0,-20392.98
buyer_8,Antonio,45,ES47209569543860298423,TRX_N-00521-29327102,2023-04-05T20:54:45,Pasaia,Expense,appliances,-229.31,-20622.29
buyer_8,Antonio,45,ES47209569543860298423,TRX_N-00522-96062140,2023-04-07T19:22:36,Labastida,expenses,electricity,-47.68,-20669.97
buyer_8,Antonio,45,ES47209569543860298423,TRX_N-00523-93946065,2023-04-08T13:51:32,Labastida,expenses,internet,-42.0,-20711.97
buyer_8,Antonio,45,ES47209569543860298423,TRX_N-00524-00509677,2023-04-08T17:11:00,Basauri,Expense,cash,-100.0,-20811.97
buyer_8,Antonio,45,ES47209569543860298423,TRX_N-00525-71959706,2023-04-08T15:44:13,Labastida,Expense,repairs,-268.14,-21080.11
buyer_8,Antonio,45,ES47209569543860298423,TRX_N-00526-04742860,2023-04-08T15:13:23,Labastida,Expense,gifts,-511.12,-21591.23
buyer_8,Antonio,45,ES47209569543860298423,TRX_N-00527-57333755,2023-04-10T18:16:34,Basauri,Expense,education,-67.03,-21658.26
buyer_8,Antonio,45,ES47209569543860298423,TRX_N-00528-71781667,2023-04-10T16:19:09,Labastida,Expense,travel,-282.62,-21940.88
buyer_8,Antonio,45,ES47209569543860298423,TRX_N-00529-37658988,2023-04-11T14:23:31,Portugalete,Expense,food,-118.47,-22059.35
buyer_8,Antonio,45,ES47209569543860298423,TRX_N-00530-72016678,2023-04-11T20:29:20,Labastida,Expense,transport,-50.18,-22109.53
buyer_8,Antonio,45,ES47209569543860298423,TRX_N-00531-49881955,2023-04-11T08:59:37,Bermeo,Expense,cash,-100.0,-22209.53
buyer_8,Antonio,45,ES47209569543860298423,TRX_N-00532-32613801,2023-04-12T09:48:06,Labastida,Expense,cash,-100.0,-22309.53
buyer_8,Antonio,45,ES47209569543860298423,TRX_N-00533-41453654,2023-04-13T21:42:15,Labastida,Expense,gifts,-819.04,-23128.57
buyer_8,Antonio,45,ES47209569543860298423,TRX_N-00534-91727558,2023-04-17T09:49:14,Labastida,Expense,education,-60.85,-23189.42
buyer_8,Antonio,45,ES47209569543860298423,TRX_N-00535-54423293,2023-04-17T17:28:48,Labastida,Expense,gifts,-245.32,-23434.74
buyer_8,Antonio,45,ES47209569543860298423,TRX_N-00536-87228472,2023-04-18T16:20:40,Labastida,Expense,cash,-100.0,-23534.74
buyer_8,Antonio,45,ES47209569543860298423,TRX_N-00537-00561560,2023-04-19T17:45:26,Labastida,expenses,children,-258.77,-23793.51
buyer_8,Antonio,45,ES47209569543860298423,TRX_N-00538-57552248,2023-04-22T10:05:43,Labastida,Expense,travel,-1070.43,-24863.94
buyer_8,Antonio,45,ES47209569543860298423,TRX_N-00539-21938567,2023-04-23T11:38:17,Labastida,Expense,transport,-60.79,-24924.73
buyer_8,Antonio,45,ES47209569543860298423,TRX_N-00540-86133970,2023-04-24T19:42:05,Labastida,Expense,transport,-56.66,-24981.39
buyer_8,Antonio,45,ES47209569543860298423,TRX_N-00541-55051690,2023-04-24T11:05:10,Labastida,Expense,leisure,-39.51,-25020.9
buyer_8,Antonio,45,ES47209569543860298423,TRX_N-00542-49818105,2023-04-24T10:51:26,Labastida,Expense,cash,-100.0,-25120.9
buyer_8,Antonio,45,ES47209569543860298423,TRX_N-00543-70457954,2023-04-24T20:42:12,Labastida,Expense,appliances,-112.77,-25233.67
buyer_8,Antonio,45,ES47209569543860298423,TRX_N-00544-14724722,2023-04-25T13:46:05,Labastida,Expense,leisure,-20.24,-25253.91
buyer_8,Antonio,45,ES47209569543860298423,TRX_N-00545-50334990,2023-04-25T16:27:17,Labastida,Expense,cash,-100.0,-25353.91
buyer_8,Antonio,45,ES47209569543860298423,TRX_N-00546-34575402,2023-04-26T10:17:38,Labastida,Expense,gifts,-308.72,-25662.63
buyer_8,Antonio,45,ES47209569543860298423,TRX_N-00547-86508961,2023-04-28T09:04:54,Labastida,Expense,repairs,-172.0,-25834.63
buyer_8,Antonio,45,ES47209569543860298423,TRX_N-00548-15421438,2023-04-30T13:22:44,Labastida,Expense,food,-76.54,-25911.17
buyer_8,Antonio,45,ES47209569543860298423,TRX_N-00549-28761828,2023-04-30T15:49:32,Labastida,Expense,gifts,-158.86,-26070.03
buyer_8,Antonio,45,ES47209569543860298423,TRX_N-00550-09576355,2023-05-01T20:51:48,Labastida,incomes,salary,1545.65,-24524.38
buyer_8,Antonio,45,ES47209569543860298423,TRX_N-00551-54382378,2023-05-01T20:51:48,Labastida,incomes,salary_partner,1680.85,-22843.53
buyer_8,Antonio,45,ES47209569543860298423,TRX_N-00552-08208338,2023-05-01T20:51:48,Labastida,incomes,extra_income,237.8,-22605.73
buyer_8,Antonio,45,ES47209569543860298423,TRX_N-00553-17864073,2023-05-02T10:04:23,Labastida,Expense,education,-59.08,-22664.81
buyer_8,Antonio,45,ES47209569543860298423,TRX_N-00554-59557096,2023-05-03T16:40:49,Labastida,Expense,food,-87.97,-22752.78
buyer_8,Antonio,45,ES47209569543860298423,TRX_N-00555-41478012,2023-05-03T20:59:29,Labastida,Expense,cash,-100.0,-22852.78
buyer_8,Antonio,45,ES47209569543860298423,TRX_N-00556-53944369,2023-05-03T08:44:54,Elciego,Expense,repairs,-32.62,-22885.4
buyer_8,Antonio,45,ES47209569543860298423,TRX_N-00557-16392254,2023-05-04T14:16:22,Labastida,expenses,mortgage,-842.18,-23727.58
buyer_8,Antonio,45,ES47209569543860298423,TRX_N-00558-68364270,2023-05-05T08:11:16,Labastida,expenses,electricity,-63.76,-23791.34
buyer_8,Antonio,45,ES47209569543860298423,TRX_N-00559-73548685,2023-05-05T11:18:45,Labastida,expenses,internet,-42.0,-23833.34
buyer_8,Antonio,45,ES47209569543860298423,TRX_N-00560-68320487,2023-05-06T19:23:18,Labastida,expenses,water,-24.61,-23857.95
buyer_8,Antonio,45,ES47209569543860298423,TRX_N-00561-28935200,2023-05-08T08:17:00,Labastida,expenses,gas,-100.62,-23958.57
buyer_8,Antonio,45,ES47209569543860298423,TRX_N-00562-23601158,2023-05-08T15:27:18,Labastida,expenses,phone,-36.49,-23995.06
buyer_8,Antonio,45,ES47209569543860298423,TRX_N-00563-86140236,2023-05-12T19:17:04,Labastida,Expense,appliances,-88.95,-24084.01
buyer_8,Antonio,45,ES47209569543860298423,TRX_N-00564-09245313,2023-05-13T11:28:01,Labastida,Expense,transport,-46.62,-24130.63
buyer_8,Antonio,45,ES47209569543860298423,TRX_N-00565-11039359,2023-05-14T19:48:28,Labastida,Expense,leisure,-70.37,-24201.0
buyer_8,Antonio,45,ES47209569543860298423,TRX_N-00566-33574992,2023-05-14T18:03:03,Labastida,Expense,cash,-100.0,-24301.0
buyer_8,Antonio,45,ES47209569543860298423,TRX_N-00567-88520788,2023-05-14T03:14:53,Labastida,Expense,appliances,-79.27,-24380.27
buyer_8,Antonio,45,ES47209569543860298423,TRX_N-00568-59292361,2023-05-17T21:41:21,Galdakao,Expense,clothing,-96.68,-24476.95
buyer_8,Antonio,45,ES47209569543860298423,TRX_N-00569-32968907,2023-05-18T22:16:17,Portugalete,Expense,transport,-47.51,-24524.46
buyer_8,Antonio,45,ES47209569543860298423,TRX_N-00570-06031687,2023-05-18T10:29:06,Labastida,Expense,cash,-100.0,-24624.46
buyer_8,Antonio,45,ES47209569543860298423,TRX_N-00571-33610558,2023-05-18T08:41:01,Eibar,Expense,gifts,-150.56,-24775.02
buyer_8,Antonio,45,ES47209569543860298423,TRX_N-00572-68675503,2023-05-19T15:13:40,Labastida,Expense,food,-98.2,-24873.22
buyer_8,Antonio,45,ES47209569543860298423,TRX_N-00573-78575793,2023-05-19T23:28:53,Labastida,Expense,appliances,-266.25,-25139.47
buyer_8,Antonio,45,ES47209569543860298423,TRX_N-00574-30008307,2023-05-23T20:12:15,Labastida,Expense,cash,-100.0,-25239.47
buyer_8,Antonio,45,ES47209569543860298423,TRX_N-00575-72036241,2023-05-23T14:27:20,Labastida,Expense,gifts,-85.5,-25324.97
buyer_8,Antonio,45,ES47209569543860298423,TRX_N-00576-23584891,2023-05-24T21:05:23,Labastida,Expense,food,-70.0,-25394.97
buyer_8,Antonio,45,ES47209569543860298423,TRX_N-00577-21753533,2023-05-24T11:51:52,Basauri,Expense,transport,-57.32,-25452.29
buyer_8,Antonio,45,ES47209569543860298423,TRX_N-00578-58957570,2023-05-24T19:14:48,Labastida,Expense,appliances,-235.73,-25688.02
buyer_8,Antonio,45,ES47209569543860298423,TRX_N-00579-56803986,2023-05-24T09:02:57,Salvatierra/Agurain,Expense,repairs,-284.47,-25972.49
buyer_8,Antonio,45,ES47209569543860298423,TRX_N-00580-55418680,2023-05-27T11:31:26,Elciego,Expense,food,-77.86,-26050.35
buyer_8,Antonio,45,ES47209569543860298423,TRX_N-00581-93535691,2023-05-27T09:29:42,Labastida,Expense,cash,-100.0,-26150.35
buyer_8,Antonio,45,ES47209569543860298423,TRX_N-00582-03025616,2023-05-28T08:23:26,Hondarribia,Expense,cash,-100.0,-26250.35
buyer_8,Antonio,45,ES47209569543860298423,TRX_N-00583-86674875,2023-05-29T16:00:32,Labastida,Expense,repairs,-51.91,-26302.26
buyer_8,Antonio,45,ES47209569543860298423,TRX_N-00584-01225902,2023-05-31T14:55:36,Labastida,Expense,transport,-59.28,-26361.54
buyer_8,Antonio,45,ES47209569543860298423,TRX_N-00585-05152018,2023-06-01T14:54:20,Labastida,incomes,salary,1545.65,-24815.89
buyer_8,Antonio,45,ES47209569543860298423,TRX_N-00586-82771934,2023-06-01T14:54:20,Labastida,incomes,salary_partner,1680.85,-23135.04
buyer_8,Antonio,45,ES47209569543860298423,TRX_N-00587-31336406,2023-06-01T14:54:20,Labastida,incomes,salary_bonus,1207.52,-21927.52
buyer_8,Antonio,45,ES47209569543860298423,TRX_N-00588-50129748,2023-06-01T14:54:20,Labastida,incomes,salary_partner_bonus,1182.92,-20744.6
buyer_8,Antonio,45,ES47209569543860298423,TRX_N-00589-84638336,2023-06-02T17:25:55,Labastida,Expense,cash,-100.0,-20844.6
buyer_8,Antonio,45,ES47209569543860298423,TRX_N-00590-78077324,2023-06-03T17:09:28,Labastida,Expense,food,-104.88,-20949.48
buyer_8,Antonio,45,ES47209569543860298423,TRX_N-00591-39845171,2023-06-03T22:49:33,Galdakao,Expense,cash,-100.0,-21049.48
buyer_8,Antonio,45,ES47209569543860298423,TRX_N-00592-24085196,2023-06-03T10:19:17,Labastida,Expense,repairs,-331.99,-21381.47
buyer_8,Antonio,45,ES47209569543860298423,TRX_N-00593-01640570,2023-06-04T18:13:20,Labastida,expenses,mortgage,-842.18,-22223.65
buyer_8,Antonio,45,ES47209569543860298423,TRX_N-00594-69151048,2023-06-05T13:00:37,Labastida,expenses,water,-21.34,-22244.99
buyer_8,Antonio,45,ES47209569543860298423,TRX_N-00595-79293039,2023-06-05T17:00:22,Labastida,expenses,internet,-42.0,-22286.99
buyer_8,Antonio,45,ES47209569543860298423,TRX_N-00596-63371130,2023-06-06T16:16:16,Labastida,expenses,phone,-33.68,-22320.67
buyer_8,Antonio,45,ES47209569543860298423,TRX_N-00597-88669399,2023-06-06T11:49:45,Labastida,Expense,food,-90.36,-22411.03
buyer_8,Antonio,45,ES47209569543860298423,TRX_N-00598-21844957,2023-06-07T18:08:36,Labastida,expenses,electricity,-51.63,-22462.66
buyer_8,Antonio,45,ES47209569543860298423,TRX_N-00599-27125421,2023-06-07T20:20:34,Labastida,expenses,gas,-81.03,-22543.69
buyer_8,Antonio,45,ES47209569543860298423,TRX_N-00600-84726060,2023-06-08T20:06:28,Labastida,Expense,education,-52.47,-22596.16
buyer_8,Antonio,45,ES47209569543860298423,TRX_N-00601-72910671,2023-06-10T13:14:51,Zarautz,Expense,healthcare,-118.55,-22714.71
buyer_8,Antonio,45,ES47209569543860298423,TRX_N-00602-92474076,2023-06-10T14:06:38,Labastida,Expense,education,-67.17,-22781.88
buyer_8,Antonio,45,ES47209569543860298423,TRX_N-00603-63816123,2023-06-11T17:22:37,Labastida,Expense,clothing,-143.37,-22925.25
buyer_8,Antonio,45,ES47209569543860298423,TRX_N-00604-21769742,2023-06-14T08:33:19,Labastida,Expense,leisure,-24.28,-22949.53
buyer_8,Antonio,45,ES47209569543860298423,TRX_N-00605-80247625,2023-06-14T13:03:12,Oy√≥n-Oion,Expense,cash,-100.0,-23049.53
buyer_8,Antonio,45,ES47209569543860298423,TRX_N-00606-42090257,2023-06-15T21:10:22,Labastida,Expense,food,-124.25,-23173.78
buyer_8,Antonio,45,ES47209569543860298423,TRX_N-00607-55516976,2023-06-15T20:10:09,Labastida,Expense,clothing,-125.79,-23299.57
buyer_8,Antonio,45,ES47209569543860298423,TRX_N-00608-74126340,2023-06-17T13:25:00,Mungia,Expense,food,-81.0,-23380.57
buyer_8,Antonio,45,ES47209569543860298423,TRX_N-00609-30874052,2023-06-18T22:52:31,Labastida,Expense,cash,-100.0,-23480.57
buyer_8,Antonio,45,ES47209569543860298423,TRX_N-00610-25040257,2023-06-19T10:23:58,Labastida,Expense,food,-124.08,-23604.65
buyer_8,Antonio,45,ES47209569543860298423,TRX_N-00611-59780874,2023-06-19T05:30:11,Labastida,Expense,clothing,-156.65,-23761.3
buyer_8,Antonio,45,ES47209569543860298423,TRX_N-00612-77835240,2023-06-20T13:11:21,Labastida,Expense,gifts,-239.98,-24001.28
buyer_8,Antonio,45,ES47209569543860298423,TRX_N-00613-96386249,2023-06-20T15:10:51,Labastida,expenses,children,-169.86,-24171.14
buyer_8,Antonio,45,ES47209569543860298423,TRX_N-00614-61990507,2023-06-21T12:04:03,Labastida,Expense,clothing,-50.37,-24221.51
buyer_8,Antonio,45,ES47209569543860298423,TRX_N-00615-09871679,2023-06-22T13:04:36,Labastida,Expense,cash,-100.0,-24321.51
buyer_8,Antonio,45,ES47209569543860298423,TRX_N-00616-74484530,2023-06-23T15:39:55,Labastida,Expense,food,-79.64,-24401.15
buyer_8,Antonio,45,ES47209569543860298423,TRX_N-00617-13621284,2023-06-23T16:53:49,Labastida,Expense,clothing,-85.53,-24486.68
buyer_8,Antonio,45,ES47209569543860298423,TRX_N-00618-29167998,2023-06-25T10:06:10,Elciego,Expense,transport,-84.35,-24571.03
buyer_8,Antonio,45,ES47209569543860298423,TRX_N-00619-88987188,2023-06-26T18:49:38,Labastida,Expense,gifts,-670.72,-25241.75
buyer_8,Antonio,45,ES47209569543860298423,TRX_N-00620-63795684,2023-06-27T10:54:30,Labastida,expenses,children,-89.34,-25331.09
buyer_8,Antonio,45,ES47209569543860298423,TRX_N-00621-25232316,2023-06-29T23:24:35,Labastida,Expense,leisure,-21.68,-25352.77
buyer_8,Antonio,45,ES47209569543860298423,TRX_N-00622-33515865,2023-06-29T18:09:16,Eibar,Expense,repairs,-310.85,-25663.62
buyer_8,Antonio,45,ES47209569543860298423,TRX_N-00623-88759941,2023-06-30T13:21:07,Labastida,Expense,repairs,-33.37,-25696.99
buyer_8,Antonio,45,ES47209569543860298423,TRX_N-00624-38142012,2023-07-01T06:47:00,Labastida,incomes,salary,1545.65,-24151.34
buyer_8,Antonio,45,ES47209569543860298423,TRX_N-00625-12434875,2023-07-01T06:47:00,Labastida,incomes,salary_partner,1680.85,-22470.49
buyer_8,Antonio,45,ES47209569543860298423,TRX_N-00626-56157718,2023-07-01T08:22:24,Labastida,Expense,clothing,-67.5,-22537.99
buyer_8,Antonio,45,ES47209569543860298423,TRX_N-00627-22294193,2023-07-03T13:14:52,Labastida,Expense,cash,-100.0,-22637.99
buyer_8,Antonio,45,ES47209569543860298423,TRX_N-00628-09520814,2023-07-04T20:40:43,Labastida,expenses,mortgage,-842.18,-23480.17
buyer_8,Antonio,45,ES47209569543860298423,TRX_N-00629-94585211,2023-07-04T19:39:08,Labastida,Expense,repairs,-325.48,-23805.65
buyer_8,Antonio,45,ES47209569543860298423,TRX_N-00630-09675330,2023-07-06T14:58:21,Labastida,expenses,electricity,-54.15,-23859.8
buyer_8,Antonio,45,ES47209569543860298423,TRX_N-00631-70741339,2023-07-06T13:14:26,Labastida,expenses,internet,-42.0,-23901.8
buyer_8,Antonio,45,ES47209569543860298423,TRX_N-00632-56970617,2023-07-06T19:44:48,Labastida,Expense,cash,-100.0,-24001.8
buyer_8,Antonio,45,ES47209569543860298423,TRX_N-00633-12386869,2023-07-07T18:59:24,Labastida,expenses,gas,-98.5,-24100.3
buyer_8,Antonio,45,ES47209569543860298423,TRX_N-00634-72983997,2023-07-07T13:27:43,Labastida,Expense,cash,-100.0,-24200.3
buyer_8,Antonio,45,ES47209569543860298423,TRX_N-00635-30633019,2023-07-07T08:08:12,Labastida,Expense,repairs,-270.66,-24470.96
buyer_8,Antonio,45,ES47209569543860298423,TRX_N-00636-15772920,2023-07-07T14:28:34,Labastida,Expense,gifts,-415.17,-24886.13
buyer_8,Antonio,45,ES47209569543860298423,TRX_N-00637-54448937,2023-07-08T10:36:49,Labastida,expenses,water,-36.29,-24922.42
buyer_8,Antonio,45,ES47209569543860298423,TRX_N-00638-01502407,2023-07-08T23:00:46,Labastida,expenses,phone,-37.23,-24959.65
buyer_8,Antonio,45,ES47209569543860298423,TRX_N-00639-20877998,2023-07-08T16:09:29,Zarautz,Expense,repairs,-241.69,-25201.34
buyer_8,Antonio,45,ES47209569543860298423,TRX_N-00640-07556891,2023-07-10T22:00:29,Labastida,Expense,education,-69.37,-25270.71
buyer_8,Antonio,45,ES47209569543860298423,TRX_N-00641-57517424,2023-07-10T00:30:06,Zarautz,Expense,repairs,-120.1,-25390.81
buyer_8,Antonio,45,ES47209569543860298423,TRX_N-00642-38916255,2023-07-15T11:12:17,Labastida,Expense,cash,-100.0,-25490.81
buyer_8,Antonio,45,ES47209569543860298423,TRX_N-00643-97007070,2023-07-16T08:26:46,Labastida,Expense,cash,-100.0,-25590.81
buyer_8,Antonio,45,ES47209569543860298423,TRX_N-00644-28738215,2023-07-18T20:47:18,Andoain,Expense,food,-109.91,-25700.72
buyer_8,Antonio,45,ES47209569543860298423,TRX_N-00645-77733242,2023-07-19T14:02:59,Labastida,Expense,cash,-100.0,-25800.72
buyer_8,Antonio,45,ES47209569543860298423,TRX_N-00646-87266037,2023-07-23T17:08:43,Labastida,Expense,cash,-100.0,-25900.72
buyer_8,Antonio,45,ES47209569543860298423,TRX_N-00647-11081020,2023-07-24T16:38:08,Galdakao,Expense,cash,-100.0,-26000.72
buyer_8,Antonio,45,ES47209569543860298423,TRX_N-00648-85053331,2023-07-25T18:54:28,Labastida,Expense,leisure,-61.73,-26062.45
buyer_8,Antonio,45,ES47209569543860298423,TRX_N-00649-89751422,2023-07-25T17:31:10,Amurrio,Expense,cash,-100.0,-26162.45
buyer_8,Antonio,45,ES47209569543860298423,TRX_N-00650-91763545,2023-07-26T11:43:17,Labastida,Expense,food,-106.32,-26268.77
buyer_8,Antonio,45,ES47209569543860298423,TRX_N-00651-31262841,2023-07-27T22:10:14,Labastida,Expense,leisure,-31.54,-26300.31
buyer_8,Antonio,45,ES47209569543860298423,TRX_N-00652-02669949,2023-07-27T23:30:22,Salvatierra/Agurain,Expense,gifts,-221.99,-26522.3
buyer_8,Antonio,45,ES47209569543860298423,TRX_N-00653-09982950,2023-07-28T19:21:37,Labastida,Expense,food,-66.4,-26588.7
buyer_8,Antonio,45,ES47209569543860298423,TRX_N-00654-25763879,2023-07-28T19:35:21,Labastida,Expense,clothing,-80.64,-26669.34
buyer_8,Antonio,45,ES47209569543860298423,TRX_N-00655-32608543,2023-07-29T14:13:40,Labastida,Expense,cash,-100.0,-26769.34
buyer_8,Antonio,45,ES47209569543860298423,TRX_N-00656-70819420,2023-07-30T19:55:50,Labastida,Expense,food,-88.06,-26857.4
buyer_8,Antonio,45,ES47209569543860298423,TRX_N-00657-18107806,2023-07-30T22:25:55,Labastida,Expense,clothing,-76.44,-26933.84
buyer_8,Antonio,45,ES47209569543860298423,TRX_N-00658-91582244,2023-07-30T15:18:56,Labastida,Expense,cash,-100.0,-27033.84
buyer_8,Antonio,45,ES47209569543860298423,TRX_N-00659-33633151,2023-07-30T10:49:48,Labastida,Expense,gifts,-268.75,-27302.59
buyer_8,Antonio,45,ES47209569543860298423,TRX_N-00660-04961248,2023-08-01T16:00:06,Labastida,incomes,salary,1545.65,-25756.94
buyer_8,Antonio,45,ES47209569543860298423,TRX_N-00661-38526766,2023-08-01T16:00:06,Labastida,incomes,salary_partner,1680.85,-24076.09
buyer_8,Antonio,45,ES47209569543860298423,TRX_N-00662-82643458,2023-08-01T16:00:06,Labastida,incomes,extra_income,237.8,-23838.29
buyer_8,Antonio,45,ES47209569543860298423,TRX_N-00663-40932910,2023-08-03T12:52:14,Labastida,Expense,cash,-100.0,-23938.29
buyer_8,Antonio,45,ES47209569543860298423,TRX_N-00664-70382888,2023-08-03T12:15:16,Labastida,Expense,appliances,-286.36,-24224.65
buyer_8,Antonio,45,ES47209569543860298423,TRX_N-00665-60832953,2023-08-04T14:34:52,Labastida,expenses,mortgage,-842.18,-25066.83
buyer_8,Antonio,45,ES47209569543860298423,TRX_N-00666-63512829,2023-08-04T09:34:31,Labastida,Expense,leisure,-82.18,-25149.01
buyer_8,Antonio,45,ES47209569543860298423,TRX_N-00667-69238575,2023-08-05T13:21:31,Labastida,Expense,food,-78.69,-25227.7
buyer_8,Antonio,45,ES47209569543860298423,TRX_N-00668-66593804,2023-08-05T15:44:14,Labastida,Expense,leisure,-73.08,-25300.78
buyer_8,Antonio,45,ES47209569543860298423,TRX_N-00669-16075762,2023-08-05T11:42:39,Labastida,Expense,cash,-100.0,-25400.78
buyer_8,Antonio,45,ES47209569543860298423,TRX_N-00670-21595496,2023-08-06T04:13:49,Labastida,expenses,water,-33.21,-25433.99
buyer_8,Antonio,45,ES47209569543860298423,TRX_N-00671-52869828,2023-08-06T08:19:13,Labastida,Expense,cash,-100.0,-25533.99
buyer_8,Antonio,45,ES47209569543860298423,TRX_N-00672-65209759,2023-08-07T09:47:10,Labastida,expenses,electricity,-88.96,-25622.95
buyer_8,Antonio,45,ES47209569543860298423,TRX_N-00673-75044301,2023-08-08T13:43:29,Labastida,expenses,gas,-35.33,-25658.28
buyer_8,Antonio,45,ES47209569543860298423,TRX_N-00674-52620959,2023-08-08T18:05:58,Labastida,expenses,internet,-42.0,-25700.28
buyer_8,Antonio,45,ES47209569543860298423,TRX_N-00675-94868320,2023-08-08T13:28:41,Labastida,expenses,phone,-32.45,-25732.73
buyer_8,Antonio,45,ES47209569543860298423,TRX_N-00676-92845807,2023-08-08T13:28:02,Labastida,Expense,gifts,-666.12,-26398.85
buyer_8,Antonio,45,ES47209569543860298423,TRX_N-00677-04090214,2023-08-09T05:22:46,Labastida,Expense,leisure,-26.07,-26424.92
buyer_8,Antonio,45,ES47209569543860298423,TRX_N-00678-72641473,2023-08-09T11:00:06,Labastida,Expense,cash,-100.0,-26524.92
buyer_8,Antonio,45,ES47209569543860298423,TRX_N-00679-55807350,2023-08-10T14:35:50,Labastida,Expense,food,-63.13,-26588.05
buyer_8,Antonio,45,ES47209569543860298423,TRX_N-00680-77820741,2023-08-10T16:29:04,Hernani,Expense,education,-49.19,-26637.24
buyer_8,Antonio,45,ES47209569543860298423,TRX_N-00681-41867571,2023-08-11T16:24:05,Labastida,Expense,repairs,-55.73,-26692.97
buyer_8,Antonio,45,ES47209569543860298423,TRX_N-00682-11742911,2023-08-12T18:04:16,Labastida,Expense,cash,-100.0,-26792.97
buyer_8,Antonio,45,ES47209569543860298423,TRX_N-00683-62394633,2023-08-12T21:17:33,Labastida,Expense,repairs,-80.99,-26873.96
buyer_8,Antonio,45,ES47209569543860298423,TRX_N-00684-28112127,2023-08-13T11:12:24,Labastida,Expense,cash,-100.0,-26973.96
buyer_8,Antonio,45,ES47209569543860298423,TRX_N-00685-33980764,2023-08-14T14:42:12,Sestao,Expense,cash,-100.0,-27073.96
buyer_8,Antonio,45,ES47209569543860298423,TRX_N-00686-44038546,2023-08-17T12:05:30,Labastida,Expense,clothing,-63.0,-27136.96
buyer_8,Antonio,45,ES47209569543860298423,TRX_N-00687-14659663,2023-08-18T09:04:10,Labastida,Expense,leisure,-54.2,-27191.16
buyer_8,Antonio,45,ES47209569543860298423,TRX_N-00688-69511852,2023-08-19T16:42:13,Labastida,Expense,food,-74.74,-27265.9
buyer_8,Antonio,45,ES47209569543860298423,TRX_N-00689-12335652,2023-08-19T08:42:18,Labastida,Expense,cash,-100.0,-27365.9
buyer_8,Antonio,45,ES47209569543860298423,TRX_N-00690-23014469,2023-08-20T12:59:25,Irun,Expense,food,-72.42,-27438.32
buyer_8,Antonio,45,ES47209569543860298423,TRX_N-00691-80763537,2023-08-20T16:41:08,Labastida,Expense,transport,-84.76,-27523.08
buyer_8,Antonio,45,ES47209569543860298423,TRX_N-00692-20923273,2023-08-21T15:22:30,Labastida,Expense,cash,-100.0,-27623.08
buyer_8,Antonio,45,ES47209569543860298423,TRX_N-00693-46713798,2023-08-22T20:38:37,Labastida,expenses,children,-97.62,-27720.7
buyer_8,Antonio,45,ES47209569543860298423,TRX_N-00694-98897551,2023-08-25T18:00:10,Labastida,Expense,transport,-66.45,-27787.15
buyer_8,Antonio,45,ES47209569543860298423,TRX_N-00695-11068190,2023-08-25T16:23:29,Labastida,Expense,cash,-100.0,-27887.15
buyer_8,Antonio,45,ES47209569543860298423,TRX_N-00696-41719487,2023-08-26T13:54:50,Oy√≥n-Oion,Expense,leisure,-25.64,-27912.79
buyer_8,Antonio,45,ES47209569543860298423,TRX_N-00697-73530715,2023-08-26T08:21:37,Labastida,Expense,gifts,-757.68,-28670.47
buyer_8,Antonio,45,ES47209569543860298423,TRX_N-00698-18837981,2023-08-27T17:36:16,Iru√±a de Oca,Expense,education,-44.53,-28715.0
buyer_8,Antonio,45,ES47209569543860298423,TRX_N-00699-06808107,2023-08-28T13:20:20,Donostia,Expense,repairs,-32.85,-28747.85
buyer_8,Antonio,45,ES47209569543860298423,TRX_N-00700-59758937,2023-08-28T10:00:37,Barakaldo,Expense,gifts,-815.96,-29563.81
buyer_8,Antonio,45,ES47209569543860298423,TRX_N-00701-23247042,2023-08-29T11:20:05,Labastida,Expense,clothing,-47.54,-29611.35
buyer_8,Antonio,45,ES47209569543860298423,TRX_N-00702-28139842,2023-08-29T09:17:26,Labastida,Expense,cash,-100.0,-29711.35
buyer_8,Antonio,45,ES47209569543860298423,TRX_N-00703-26439532,2023-08-29T09:22:25,Labastida,Expense,travel,-1310.33,-31021.68
buyer_8,Antonio,45,ES47209569543860298423,TRX_N-00704-53772174,2023-08-30T18:37:21,Donostia,Expense,appliances,-230.76,-31252.44
buyer_8,Antonio,45,ES47209569543860298423,TRX_N-00705-95965771,2023-09-01T11:34:32,Labastida,incomes,salary,1545.65,-29706.79
buyer_8,Antonio,45,ES47209569543860298423,TRX_N-00706-37030425,2023-09-01T11:34:32,Labastida,incomes,salary_partner,1680.85,-28025.94
buyer_8,Antonio,45,ES47209569543860298423,TRX_N-00707-35028349,2023-09-01T11:00:14,Labastida,Expense,repairs,-83.09,-28109.03
buyer_8,Antonio,45,ES47209569543860298423,TRX_N-00708-59920928,2023-09-02T20:51:06,Labastida,Expense,clothing,-93.23,-28202.26
buyer_8,Antonio,45,ES47209569543860298423,TRX_N-00709-07331207,2023-09-02T10:04:49,Labastida,Expense,appliances,-314.89,-28517.15
buyer_8,Antonio,45,ES47209569543860298423,TRX_N-00710-44846994,2023-09-04T08:07:53,Labastida,expenses,mortgage,-842.18,-29359.33
buyer_8,Antonio,45,ES47209569543860298423,TRX_N-00711-10514977,2023-09-04T14:46:33,Labastida,Expense,transport,-45.83,-29405.16
buyer_8,Antonio,45,ES47209569543860298423,TRX_N-00712-48272396,2023-09-05T19:34:46,Labastida,expenses,gas,-36.85,-29442.01
buyer_8,Antonio,45,ES47209569543860298423,TRX_N-00713-83302881,2023-09-06T15:48:57,Labastida,expenses,water,-41.4,-29483.41
buyer_8,Antonio,45,ES47209569543860298423,TRX_N-00714-87498098,2023-09-06T16:21:23,Labastida,Expense,repairs,-56.42,-29539.83
buyer_8,Antonio,45,ES47209569543860298423,TRX_N-00715-62555433,2023-09-06T19:06:22,Labastida,Expense,gifts,-590.79,-30130.62
buyer_8,Antonio,45,ES47209569543860298423,TRX_N-00716-42617065,2023-09-07T15:44:27,Labastida,Expense,cash,-100.0,-30230.62
buyer_8,Antonio,45,ES47209569543860298423,TRX_N-00717-40070127,2023-09-08T17:33:46,Labastida,expenses,electricity,-35.18,-30265.8
buyer_8,Antonio,45,ES47209569543860298423,TRX_N-00718-33112394,2023-09-08T13:34:01,Labastida,expenses,internet,-42.0,-30307.8
buyer_8,Antonio,45,ES47209569543860298423,TRX_N-00719-47528041,2023-09-08T02:03:19,Labastida,expenses,phone,-42.04,-30349.84
buyer_8,Antonio,45,ES47209569543860298423,TRX_N-00720-12476100,2023-09-08T16:21:36,Labastida,Expense,healthcare,-151.71,-30501.55
buyer_8,Antonio,45,ES47209569543860298423,TRX_N-00721-18934264,2023-09-10T10:19:04,Zarautz,Expense,food,-74.59,-30576.14
buyer_8,Antonio,45,ES47209569543860298423,TRX_N-00722-79042724,2023-09-10T21:19:03,Labastida,Expense,leisure,-31.75,-30607.89
buyer_8,Antonio,45,ES47209569543860298423,TRX_N-00723-18489351,2023-09-10T18:36:43,Labastida,Expense,education,-75.01,-30682.9
buyer_8,Antonio,45,ES47209569543860298423,TRX_N-00724-09208757,2023-09-13T11:10:19,Labastida,Expense,leisure,-24.12,-30707.02
buyer_8,Antonio,45,ES47209569543860298423,TRX_N-00725-56968835,2023-09-16T10:50:15,Labastida,Expense,leisure,-45.3,-30752.32
buyer_8,Antonio,45,ES47209569543860298423,TRX_N-00726-02129474,2023-09-16T19:38:51,Labastida,Expense,appliances,-104.6,-30856.92
buyer_8,Antonio,45,ES47209569543860298423,TRX_N-00727-52281400,2023-09-16T20:13:22,Labastida,expenses,children,-135.05,-30991.97
buyer_8,Antonio,45,ES47209569543860298423,TRX_N-00728-64538457,2023-09-18T09:22:44,Labastida,Expense,repairs,-245.55,-31237.52
buyer_8,Antonio,45,ES47209569543860298423,TRX_N-00729-69450958,2023-09-19T23:19:05,Alegr√≠a-Dulantzi,Expense,clothing,-156.96,-31394.48
buyer_8,Antonio,45,ES47209569543860298423,TRX_N-00730-06560536,2023-09-22T20:29:23,Labastida,Expense,transport,-48.94,-31443.42
buyer_8,Antonio,45,ES47209569543860298423,TRX_N-00731-95419142,2023-09-22T19:53:52,Labastida,Expense,cash,-100.0,-31543.42
buyer_8,Antonio,45,ES47209569543860298423,TRX_N-00732-05038619,2023-09-23T23:43:20,Labastida,Expense,cash,-100.0,-31643.42
buyer_8,Antonio,45,ES47209569543860298423,TRX_N-00733-35460234,2023-09-24T23:16:42,Labastida,Expense,appliances,-283.05,-31926.47
buyer_8,Antonio,45,ES47209569543860298423,TRX_N-00734-49037987,2023-09-24T10:03:18,Iru√±a de Oca,Expense,gifts,-369.23,-32295.7
buyer_8,Antonio,45,ES47209569543860298423,TRX_N-00735-12898584,2023-09-24T18:21:57,Labastida,expenses,children,-231.44,-32527.14
buyer_8,Antonio,45,ES47209569543860298423,TRX_N-00736-78851878,2023-09-25T21:55:17,Portugalete,Expense,transport,-50.95,-32578.09
buyer_8,Antonio,45,ES47209569543860298423,TRX_N-00737-44324883,2023-09-25T09:32:53,Labastida,Expense,leisure,-82.61,-32660.7
buyer_8,Antonio,45,ES47209569543860298423,TRX_N-00738-42207508,2023-09-25T09:21:35,Labastida,Expense,cash,-100.0,-32760.7
buyer_8,Antonio,45,ES47209569543860298423,TRX_N-00739-18775392,2023-09-26T20:19:08,Labastida,Expense,leisure,-53.3,-32814.0
buyer_8,Antonio,45,ES47209569543860298423,TRX_N-00740-14498185,2023-09-26T09:48:56,Labastida,Expense,cash,-100.0,-32914.0
buyer_8,Antonio,45,ES47209569543860298423,TRX_N-00741-45833450,2023-09-27T10:43:12,Labastida,Expense,transport,-83.93,-32997.93
buyer_8,Antonio,45,ES47209569543860298423,TRX_N-00742-66464346,2023-09-28T09:51:05,Labastida,Expense,leisure,-73.73,-33071.66
buyer_8,Antonio,45,ES47209569543860298423,TRX_N-00743-68400645,2023-09-28T18:13:19,Labastida,Expense,cash,-100.0,-33171.66
buyer_8,Antonio,45,ES47209569543860298423,TRX_N-00744-33162703,2023-09-28T16:30:36,Labastida,Expense,repairs,-135.18,-33306.84
buyer_8,Antonio,45,ES47209569543860298423,TRX_N-00745-35762752,2023-09-30T17:23:20,Labastida,Expense,transport,-55.78,-33362.62
buyer_8,Antonio,45,ES47209569543860298423,TRX_N-00746-30253873,2023-09-30T09:21:48,Labastida,Expense,gifts,-417.52,-33780.14
buyer_8,Antonio,45,ES47209569543860298423,TRX_N-00747-67723052,2023-10-01T15:37:46,Labastida,incomes,salary,1545.65,-32234.49
buyer_8,Antonio,45,ES47209569543860298423,TRX_N-00748-74682908,2023-10-01T15:37:46,Labastida,incomes,salary_partner,1680.85,-30553.64
buyer_8,Antonio,45,ES47209569543860298423,TRX_N-00749-32309137,2023-10-01T16:14:13,Labastida,Expense,education,-50.54,-30604.18
buyer_8,Antonio,45,ES47209569543860298423,TRX_N-00750-81884447,2023-10-01T09:56:10,Iru√±a de Oca,Expense,cash,-100.0,-30704.18
buyer_8,Antonio,45,ES47209569543860298423,TRX_N-00751-08977730,2023-10-01T19:02:28,Labastida,Expense,gifts,-276.88,-30981.06
buyer_8,Antonio,45,ES47209569543860298423,TRX_N-00752-00157464,2023-10-02T15:20:27,Labastida,Expense,cash,-100.0,-31081.06
buyer_8,Antonio,45,ES47209569543860298423,TRX_N-00753-79724766,2023-10-04T20:34:21,Labastida,expenses,mortgage,-842.18,-31923.24
buyer_8,Antonio,45,ES47209569543860298423,TRX_N-00754-20112314,2023-10-04T10:06:31,Labastida,Expense,cash,-100.0,-32023.24
buyer_8,Antonio,45,ES47209569543860298423,TRX_N-00755-77446123,2023-10-05T17:01:33,Labastida,expenses,electricity,-53.92,-32077.16
buyer_8,Antonio,45,ES47209569543860298423,TRX_N-00756-26737041,2023-10-05T09:23:12,Labastida,expenses,gas,-56.41,-32133.57
buyer_8,Antonio,45,ES47209569543860298423,TRX_N-00757-74958744,2023-10-05T15:23:35,Labastida,expenses,phone,-41.73,-32175.3
buyer_8,Antonio,45,ES47209569543860298423,TRX_N-00758-11251521,2023-10-06T10:27:12,Labastida,expenses,internet,-42.0,-32217.3
buyer_8,Antonio,45,ES47209569543860298423,TRX_N-00759-79406709,2023-10-07T14:30:50,Lasarte-Oria,Expense,food,-95.1,-32312.4
buyer_8,Antonio,45,ES47209569543860298423,TRX_N-00760-73493972,2023-10-07T08:48:31,Oy√≥n-Oion,Expense,transport,-75.44,-32387.84
buyer_8,Antonio,45,ES47209569543860298423,TRX_N-00761-24212946,2023-10-08T20:12:26,Labastida,expenses,water,-20.74,-32408.58
buyer_8,Antonio,45,ES47209569543860298423,TRX_N-00762-60354486,2023-10-08T13:56:27,Portugalete,Expense,transport,-54.75,-32463.33
buyer_8,Antonio,45,ES47209569543860298423,TRX_N-00763-44834752,2023-10-11T10:15:32,Labastida,Expense,gifts,-190.92,-32654.25
buyer_8,Antonio,45,ES47209569543860298423,TRX_N-00764-46241727,2023-10-12T22:06:20,Labastida,Expense,food,-91.83,-32746.08
buyer_8,Antonio,45,ES47209569543860298423,TRX_N-00765-10066881,2023-10-13T23:07:30,Labastida,Expense,food,-88.52,-32834.6
buyer_8,Antonio,45,ES47209569543860298423,TRX_N-00766-72599955,2023-10-13T15:04:06,Labastida,Expense,cash,-100.0,-32934.6
buyer_8,Antonio,45,ES47209569543860298423,TRX_N-00767-05321238,2023-10-14T03:11:19,Labastida,Expense,education,-71.11,-33005.71
buyer_8,Antonio,45,ES47209569543860298423,TRX_N-00768-36254707,2023-10-14T20:27:22,Labastida,Expense,cash,-100.0,-33105.71
buyer_8,Antonio,45,ES47209569543860298423,TRX_N-00769-49594276,2023-10-15T16:57:32,Labastida,Expense,food,-118.92,-33224.63
buyer_8,Antonio,45,ES47209569543860298423,TRX_N-00770-01970347,2023-10-15T01:38:47,Labastida,Expense,cash,-100.0,-33324.63
buyer_8,Antonio,45,ES47209569543860298423,TRX_N-00771-56498712,2023-10-17T16:05:37,Labastida,Expense,leisure,-57.21,-33381.84
buyer_8,Antonio,45,ES47209569543860298423,TRX_N-00772-76325447,2023-10-18T10:00:10,Labastida,Expense,food,-90.37,-33472.21
buyer_8,Antonio,45,ES47209569543860298423,TRX_N-00773-35529633,2023-10-18T11:56:25,Donostia,Expense,clothing,-95.86,-33568.07
buyer_8,Antonio,45,ES47209569543860298423,TRX_N-00774-36730841,2023-10-23T15:44:01,Portugalete,Expense,food,-67.55,-33635.62
buyer_8,Antonio,45,ES47209569543860298423,TRX_N-00775-37779377,2023-10-24T08:04:12,Labastida,Expense,leisure,-71.4,-33707.02
buyer_8,Antonio,45,ES47209569543860298423,TRX_N-00776-93517993,2023-10-24T12:05:44,Labastida,Expense,cash,-100.0,-33807.02
buyer_8,Antonio,45,ES47209569543860298423,TRX_N-00777-14273612,2023-10-25T21:33:26,Bilbao,Expense,healthcare,-40.11,-33847.13
buyer_8,Antonio,45,ES47209569543860298423,TRX_N-00778-55065740,2023-10-27T09:03:50,Labastida,Expense,gifts,-490.35,-34337.48
buyer_8,Antonio,45,ES47209569543860298423,TRX_N-00779-64074924,2023-10-30T09:21:54,Labastida,Expense,food,-96.37,-34433.85
buyer_8,Antonio,45,ES47209569543860298423,TRX_N-00780-86846191,2023-11-01T04:52:55,Labastida,incomes,salary,1545.65,-32888.2
buyer_8,Antonio,45,ES47209569543860298423,TRX_N-00781-72294840,2023-11-01T04:52:55,Labastida,incomes,salary_partner,1680.85,-31207.35
buyer_8,Antonio,45,ES47209569543860298423,TRX_N-00782-48492584,2023-11-01T04:52:55,Labastida,incomes,extra_income,237.8,-30969.55
buyer_8,Antonio,45,ES47209569543860298423,TRX_N-00783-10263499,2023-11-02T09:17:20,Labastida,Expense,leisure,-72.97,-31042.52
buyer_8,Antonio,45,ES47209569543860298423,TRX_N-00784-84005203,2023-11-02T14:45:22,Labastida,Expense,travel,-1787.25,-32829.77
buyer_8,Antonio,45,ES47209569543860298423,TRX_N-00785-74421280,2023-11-04T21:15:24,Labastida,expenses,mortgage,-842.18,-33671.95
buyer_8,Antonio,45,ES47209569543860298423,TRX_N-00786-61164778,2023-11-04T10:34:36,Labastida,Expense,transport,-73.48,-33745.43
buyer_8,Antonio,45,ES47209569543860298423,TRX_N-00787-25813259,2023-11-05T19:45:07,Labastida,expenses,electricity,-82.27,-33827.7
buyer_8,Antonio,45,ES47209569543860298423,TRX_N-00788-67050255,2023-11-05T13:29:25,Labastida,expenses,internet,-42.0,-33869.7
buyer_8,Antonio,45,ES47209569543860298423,TRX_N-00789-97399644,2023-11-06T14:34:04,Labastida,expenses,phone,-43.47,-33913.17
buyer_8,Antonio,45,ES47209569543860298423,TRX_N-00790-33545910,2023-11-08T13:23:45,Labastida,expenses,water,-33.76,-33946.93
buyer_8,Antonio,45,ES47209569543860298423,TRX_N-00791-41910629,2023-11-08T19:03:14,Labastida,expenses,gas,-61.0,-34007.93
buyer_8,Antonio,45,ES47209569543860298423,TRX_N-00792-94045466,2023-11-09T19:34:39,Labastida,Expense,leisure,-54.48,-34062.41
buyer_8,Antonio,45,ES47209569543860298423,TRX_N-00793-39659531,2023-11-09T11:53:43,Labastida,Expense,cash,-100.0,-34162.41
buyer_8,Antonio,45,ES47209569543860298423,TRX_N-00794-57226602,2023-11-11T23:11:22,Labastida,Expense,food,-60.05,-34222.46
buyer_8,Antonio,45,ES47209569543860298423,TRX_N-00795-64915578,2023-11-12T16:17:48,Labastida,Expense,transport,-55.8,-34278.26
buyer_8,Antonio,45,ES47209569543860298423,TRX_N-00796-82656390,2023-11-12T14:43:49,Labastida,Expense,leisure,-22.96,-34301.22
buyer_8,Antonio,45,ES47209569543860298423,TRX_N-00797-75081586,2023-11-12T08:59:47,Llodio,Expense,cash,-100.0,-34401.22
buyer_8,Antonio,45,ES47209569543860298423,TRX_N-00798-27986812,2023-11-12T11:17:52,Labastida,Expense,repairs,-198.52,-34599.74
buyer_8,Antonio,45,ES47209569543860298423,TRX_N-00799-09501328,2023-11-16T17:07:01,Labastida,Expense,gifts,-427.7,-35027.44
buyer_8,Antonio,45,ES47209569543860298423,TRX_N-00800-34287845,2023-11-17T18:39:13,Labastida,Expense,clothing,-67.82,-35095.26
buyer_8,Antonio,45,ES47209569543860298423,TRX_N-00801-59471797,2023-11-17T12:56:44,Labastida,Expense,education,-48.9,-35144.16
buyer_8,Antonio,45,ES47209569543860298423,TRX_N-00802-96758168,2023-11-18T05:59:31,Labastida,Expense,clothing,-106.01,-35250.17
buyer_8,Antonio,45,ES47209569543860298423,TRX_N-00803-16515783,2023-11-21T15:17:47,Labastida,Expense,food,-107.21,-35357.38
buyer_8,Antonio,45,ES47209569543860298423,TRX_N-00804-90256127,2023-11-22T08:17:53,Labastida,Expense,food,-79.11,-35436.49
buyer_8,Antonio,45,ES47209569543860298423,TRX_N-00805-72849654,2023-11-24T16:13:33,Labastida,Expense,repairs,-142.27,-35578.76
buyer_8,Antonio,45,ES47209569543860298423,TRX_N-00806-79787364,2023-11-26T17:40:43,Labastida,Expense,food,-109.34,-35688.1
buyer_8,Antonio,45,ES47209569543860298423,TRX_N-00807-13255106,2023-11-26T19:50:14,Labastida,Expense,cash,-100.0,-35788.1
buyer_8,Antonio,45,ES47209569543860298423,TRX_N-00808-12560886,2023-11-27T12:00:15,Labastida,Expense,leisure,-84.98,-35873.08
buyer_8,Antonio,45,ES47209569543860298423,TRX_N-00809-91522832,2023-11-28T10:02:44,Labastida,Expense,leisure,-65.67,-35938.75
buyer_8,Antonio,45,ES47209569543860298423,TRX_N-00810-16593111,2023-11-29T23:59:10,Labastida,expenses,children,-138.61,-36077.36
buyer_8,Antonio,45,ES47209569543860298423,TRX_N-00811-79716401,2023-12-01T05:11:29,Labastida,incomes,salary,1545.65,-34531.71
buyer_8,Antonio,45,ES47209569543860298423,TRX_N-00812-49349591,2023-12-01T05:11:29,Labastida,incomes,salary_partner,1680.85,-32850.86
buyer_8,Antonio,45,ES47209569543860298423,TRX_N-00813-43894345,2023-12-01T05:11:29,Labastida,incomes,salary_bonus,1159.57,-31691.29
buyer_8,Antonio,45,ES47209569543860298423,TRX_N-00814-25370890,2023-12-01T05:11:29,Labastida,incomes,salary_partner_bonus,1266.57,-30424.72
buyer_8,Antonio,45,ES47209569543860298423,TRX_N-00815-03446523,2023-12-01T17:11:56,Labastida,Expense,repairs,-313.58,-30738.3
buyer_8,Antonio,45,ES47209569543860298423,TRX_N-00816-13057184,2023-12-02T18:21:01,Sestao,Expense,leisure,-36.59,-30774.89
buyer_8,Antonio,45,ES47209569543860298423,TRX_N-00817-30601088,2023-12-04T05:01:28,Labastida,expenses,mortgage,-842.18,-31617.07
buyer_8,Antonio,45,ES47209569543860298423,TRX_N-00818-57240373,2023-12-05T10:49:47,Labastida,expenses,internet,-42.0,-31659.07
buyer_8,Antonio,45,ES47209569543860298423,TRX_N-00819-97050065,2023-12-05T23:39:01,Labastida,Expense,leisure,-84.4,-31743.47
buyer_8,Antonio,45,ES47209569543860298423,TRX_N-00820-22569805,2023-12-05T13:16:01,Berango,Expense,cash,-100.0,-31843.47
buyer_8,Antonio,45,ES47209569543860298423,TRX_N-00821-38427125,2023-12-05T15:25:36,Labastida,Expense,gifts,-578.41,-32421.88
buyer_8,Antonio,45,ES47209569543860298423,TRX_N-00822-18709166,2023-12-07T16:45:44,Labastida,expenses,phone,-34.72,-32456.6
buyer_8,Antonio,45,ES47209569543860298423,TRX_N-00823-15671456,2023-12-07T09:14:56,Labastida,Expense,gifts,-480.71,-32937.31
buyer_8,Antonio,45,ES47209569543860298423,TRX_N-00824-95513777,2023-12-08T09:44:02,Labastida,expenses,water,-26.44,-32963.75
buyer_8,Antonio,45,ES47209569543860298423,TRX_N-00825-80945021,2023-12-08T11:57:15,Labastida,expenses,electricity,-41.46,-33005.21
buyer_8,Antonio,45,ES47209569543860298423,TRX_N-00826-29040199,2023-12-08T09:47:11,Labastida,expenses,gas,-86.4,-33091.61
buyer_8,Antonio,45,ES47209569543860298423,TRX_N-00827-74132156,2023-12-09T03:11:21,Sestao,Expense,repairs,-53.41,-33145.02
buyer_8,Antonio,45,ES47209569543860298423,TRX_N-00828-24618108,2023-12-12T00:04:17,Labastida,Expense,gifts,-430.88,-33575.9
buyer_8,Antonio,45,ES47209569543860298423,TRX_N-00829-17374005,2023-12-13T13:56:56,Labastida,Expense,leisure,-32.9,-33608.8
buyer_8,Antonio,45,ES47209569543860298423,TRX_N-00830-53736000,2023-12-13T17:55:04,Labastida,Expense,clothing,-89.58,-33698.38
buyer_8,Antonio,45,ES47209569543860298423,TRX_N-00831-99562113,2023-12-15T18:09:58,Labastida,Expense,food,-91.54,-33789.92
buyer_8,Antonio,45,ES47209569543860298423,TRX_N-00832-19905397,2023-12-15T19:22:56,Labastida,Expense,transport,-79.46,-33869.38
buyer_8,Antonio,45,ES47209569543860298423,TRX_N-00833-42414759,2023-12-16T05:59:35,Labastida,Expense,transport,-47.41,-33916.79
buyer_8,Antonio,45,ES47209569543860298423,TRX_N-00834-01914028,2023-12-16T04:52:50,Labastida,Expense,gifts,-278.28,-34195.07
buyer_8,Antonio,45,ES47209569543860298423,TRX_N-00835-80503953,2023-12-17T09:55:59,Labastida,Expense,leisure,-34.14,-34229.21
buyer_8,Antonio,45,ES47209569543860298423,TRX_N-00836-35706444,2023-12-17T02:14:33,Labastida,expenses,children,-188.31,-34417.52
buyer_8,Antonio,45,ES47209569543860298423,TRX_N-00837-14386684,2023-12-19T08:37:26,Labastida,Expense,cash,-100.0,-34517.52
buyer_8,Antonio,45,ES47209569543860298423,TRX_N-00838-23023811,2023-12-20T13:37:31,Labastida,Expense,transport,-89.01,-34606.53
buyer_8,Antonio,45,ES47209569543860298423,TRX_N-00839-23054411,2023-12-20T14:49:42,Labastida,Expense,leisure,-45.65,-34652.18
buyer_8,Antonio,45,ES47209569543860298423,TRX_N-00840-68999537,2023-12-21T19:33:02,Labastida,Expense,cash,-100.0,-34752.18
buyer_8,Antonio,45,ES47209569543860298423,TRX_N-00841-01922806,2023-12-22T10:49:31,Labastida,Expense,food,-101.18,-34853.36
buyer_8,Antonio,45,ES47209569543860298423,TRX_N-00842-68120451,2023-12-22T13:06:44,Labastida,Expense,transport,-51.44,-34904.8
buyer_8,Antonio,45,ES47209569543860298423,TRX_N-00843-28656731,2023-12-23T16:25:12,Labastida,Expense,transport,-74.03,-34978.83
buyer_8,Antonio,45,ES47209569543860298423,TRX_N-00844-03056363,2023-12-24T12:06:30,Labastida,Expense,gifts,-144.38,-35123.21
buyer_8,Antonio,45,ES47209569543860298423,TRX_N-00845-78717518,2023-12-25T19:09:10,Labastida,Expense,leisure,-54.85,-35178.06
buyer_8,Antonio,45,ES47209569543860298423,TRX_N-00846-55779283,2023-12-25T19:03:17,Labastida,Expense,gifts,-311.76,-35489.82
buyer_8,Antonio,45,ES47209569543860298423,TRX_N-00847-56000231,2023-12-26T09:07:08,Labastida,Expense,leisure,-34.11,-35523.93
buyer_8,Antonio,45,ES47209569543860298423,TRX_N-00848-77327503,2023-12-29T23:58:20,Labastida,Expense,leisure,-79.68,-35603.61
buyer_8,Antonio,45,ES47209569543860298423,TRX_N-00849-16633686,2023-12-30T20:07:46,Labastida,Expense,travel,-1261.0,-36864.61
buyer_8,Antonio,45,ES47209569543860298423,TRX_N-00850-52548422,2023-12-31T09:18:54,Labastida,Expense,cash,-100.0,-36964.61
buyer_8,Antonio,45,ES47209569543860298423,TRX_N-00851-61888652,2024-01-01T14:53:03,Labastida,incomes,salary,1580.69,-35383.92
buyer_8,Antonio,45,ES47209569543860298423,TRX_N-00852-61520153,2024-01-01T14:53:03,Labastida,incomes,salary_partner,1718.95,-33664.97
buyer_8,Antonio,45,ES47209569543860298423,TRX_N-00853-37574185,2024-01-01T18:03:17,Labastida,Expense,repairs,-81.88,-33746.85
buyer_8,Antonio,45,ES47209569543860298423,TRX_N-00854-15191470,2024-01-02T13:52:56,Labastida,Expense,travel,-1759.43,-35506.28
buyer_8,Antonio,45,ES47209569543860298423,TRX_N-00855-05603333,2024-01-04T15:09:45,Labastida,expenses,mortgage,-842.18,-36348.46
buyer_8,Antonio,45,ES47209569543860298423,TRX_N-00856-56833639,2024-01-04T08:50:23,Labastida,Expense,travel,-1029.91,-37378.37
buyer_8,Antonio,45,ES47209569543860298423,TRX_N-00857-08834900,2024-01-05T11:57:50,Labastida,expenses,water,-30.64,-37409.01
buyer_8,Antonio,45,ES47209569543860298423,TRX_N-00858-03874578,2024-01-05T08:17:33,Labastida,expenses,internet,-42.0,-37451.01
buyer_8,Antonio,45,ES47209569543860298423,TRX_N-00859-89353473,2024-01-05T16:58:59,Labastida,Expense,clothing,-130.63,-37581.64
buyer_8,Antonio,45,ES47209569543860298423,TRX_N-00860-17912503,2024-01-05T08:40:16,Labastida,Expense,gifts,-206.7,-37788.34
buyer_8,Antonio,45,ES47209569543860298423,TRX_N-00861-08981482,2024-01-06T10:56:05,Labastida,expenses,phone,-33.49,-37821.83
buyer_8,Antonio,45,ES47209569543860298423,TRX_N-00862-35120680,2024-01-06T03:52:28,Labastida,Expense,leisure,-71.89,-37893.72
buyer_8,Antonio,45,ES47209569543860298423,TRX_N-00863-15642585,2024-01-07T10:34:29,Labastida,expenses,gas,-67.08,-37960.8
buyer_8,Antonio,45,ES47209569543860298423,TRX_N-00864-17586277,2024-01-07T19:28:09,Labastida,Expense,cash,-100.0,-38060.8
buyer_8,Antonio,45,ES47209569543860298423,TRX_N-00865-69414556,2024-01-08T22:31:48,Labastida,expenses,electricity,-69.33,-38130.13
buyer_8,Antonio,45,ES47209569543860298423,TRX_N-00866-64414466,2024-01-09T12:38:22,Labastida,Expense,healthcare,-116.58,-38246.71
buyer_8,Antonio,45,ES47209569543860298423,TRX_N-00867-76200245,2024-01-09T08:36:10,Labastida,Expense,cash,-100.0,-38346.71
buyer_8,Antonio,45,ES47209569543860298423,TRX_N-00868-49225145,2024-01-09T13:57:05,Labastida,expenses,children,-160.42,-38507.13
buyer_8,Antonio,45,ES47209569543860298423,TRX_N-00869-86545435,2024-01-10T20:46:37,Labastida,Expense,cash,-100.0,-38607.13
buyer_8,Antonio,45,ES47209569543860298423,TRX_N-00870-63985271,2024-01-13T08:31:06,Hernani,Expense,transport,-77.74,-38684.87
buyer_8,Antonio,45,ES47209569543860298423,TRX_N-00871-18187185,2024-01-13T20:00:42,Hondarribia,Expense,education,-77.14,-38762.01
buyer_8,Antonio,45,ES47209569543860298423,TRX_N-00872-38882623,2024-01-13T14:01:51,Labastida,Expense,repairs,-205.79,-38967.8
buyer_8,Antonio,45,ES47209569543860298423,TRX_N-00873-95991573,2024-01-14T11:47:56,Labastida,Expense,transport,-75.88,-39043.68
buyer_8,Antonio,45,ES47209569543860298423,TRX_N-00874-45446346,2024-01-14T14:59:53,Labastida,Expense,cash,-100.0,-39143.68
buyer_8,Antonio,45,ES47209569543860298423,TRX_N-00875-90755429,2024-01-14T08:21:37,Labastida,Expense,gifts,-688.58,-39832.26
buyer_8,Antonio,45,ES47209569543860298423,TRX_N-00876-96332261,2024-01-16T15:48:13,Lasarte-Oria,Expense,gifts,-214.24,-40046.5
buyer_8,Antonio,45,ES47209569543860298423,TRX_N-00877-71364299,2024-01-17T18:15:29,Labastida,Expense,food,-66.29,-40112.79
buyer_8,Antonio,45,ES47209569543860298423,TRX_N-00878-10749447,2024-01-17T19:31:05,Labastida,Expense,leisure,-21.43,-40134.22
buyer_8,Antonio,45,ES47209569543860298423,TRX_N-00879-29808123,2024-01-17T14:48:02,Labastida,Expense,healthcare,-43.88,-40178.1
buyer_8,Antonio,45,ES47209569543860298423,TRX_N-00880-82299482,2024-01-17T21:00:53,Labastida,expenses,children,-158.21,-40336.31
buyer_8,Antonio,45,ES47209569543860298423,TRX_N-00881-92991727,2024-01-18T13:12:16,Labastida,Expense,leisure,-54.51,-40390.82
buyer_8,Antonio,45,ES47209569543860298423,TRX_N-00882-38724041,2024-01-18T20:40:54,Erandio,Expense,repairs,-224.66,-40615.48
buyer_8,Antonio,45,ES47209569543860298423,TRX_N-00883-30173847,2024-01-22T20:35:29,Labastida,Expense,transport,-62.2,-40677.68
buyer_8,Antonio,45,ES47209569543860298423,TRX_N-00884-96009395,2024-01-22T12:52:19,Labastida,Expense,repairs,-108.45,-40786.13
buyer_8,Antonio,45,ES47209569543860298423,TRX_N-00885-46839859,2024-01-24T13:25:52,Labastida,Expense,transport,-40.78,-40826.91
buyer_8,Antonio,45,ES47209569543860298423,TRX_N-00886-29192133,2024-01-24T16:58:19,Labastida,Expense,repairs,-45.57,-40872.48
buyer_8,Antonio,45,ES47209569543860298423,TRX_N-00887-05006330,2024-01-27T23:06:19,Labastida,Expense,transport,-54.64,-40927.12
buyer_8,Antonio,45,ES47209569543860298423,TRX_N-00888-66941057,2024-01-27T12:37:35,Labastida,Expense,cash,-100.0,-41027.12
buyer_8,Antonio,45,ES47209569543860298423,TRX_N-00889-97519694,2024-01-28T20:14:47,Labastida,Expense,food,-74.52,-41101.64
buyer_8,Antonio,45,ES47209569543860298423,TRX_N-00890-58323954,2024-01-28T09:59:52,Arrasate,Expense,gifts,-611.19,-41712.83
buyer_8,Antonio,45,ES47209569543860298423,TRX_N-00891-08805718,2024-01-29T11:19:55,Leioa,Expense,clothing,-157.69,-41870.52
buyer_8,Antonio,45,ES47209569543860298423,TRX_N-00892-26571883,2024-01-31T22:13:08,Erandio,Expense,cash,-100.0,-41970.52
buyer_8,Antonio,45,ES47209569543860298423,TRX_N-00893-00706184,2024-01-31T16:47:41,Zuia,Expense,gifts,-334.54,-42305.06
buyer_8,Antonio,45,ES47209569543860298423,TRX_N-00894-51660084,2024-02-01T15:43:59,Labastida,incomes,salary,1580.69,-40724.37
buyer_8,Antonio,45,ES47209569543860298423,TRX_N-00895-78316214,2024-02-01T15:43:59,Labastida,incomes,salary_partner,1718.95,-39005.42
buyer_8,Antonio,45,ES47209569543860298423,TRX_N-00896-20002639,2024-02-01T18:25:10,Labastida,Expense,food,-120.3,-39125.72
buyer_8,Antonio,45,ES47209569543860298423,TRX_N-00897-62793503,2024-02-01T16:06:58,Labastida,expenses,children,-55.16,-39180.88
buyer_8,Antonio,45,ES47209569543860298423,TRX_N-00898-58127737,2024-02-02T09:46:24,Labastida,Expense,food,-106.24,-39287.12
buyer_8,Antonio,45,ES47209569543860298423,TRX_N-00899-18547288,2024-02-03T12:02:09,Vitoria-Gasteiz,Expense,food,-116.79,-39403.91
buyer_8,Antonio,45,ES47209569543860298423,TRX_N-00900-32137777,2024-02-04T20:44:17,Labastida,expenses,mortgage,-842.18,-40246.09
buyer_8,Antonio,45,ES47209569543860298423,TRX_N-00901-93784681,2024-02-04T08:48:09,Labastida,Expense,transport,-71.81,-40317.9
buyer_8,Antonio,45,ES47209569543860298423,TRX_N-00902-90651608,2024-02-05T10:49:45,Labastida,expenses,gas,-93.24,-40411.14
buyer_8,Antonio,45,ES47209569543860298423,TRX_N-00903-87014688,2024-02-06T18:30:33,Labastida,expenses,internet,-42.0,-40453.14
buyer_8,Antonio,45,ES47209569543860298423,TRX_N-00904-37529261,2024-02-06T09:50:17,Labastida,Expense,education,-54.89,-40508.03
buyer_8,Antonio,45,ES47209569543860298423,TRX_N-00905-48590186,2024-02-07T09:09:15,Labastida,Expense,transport,-47.05,-40555.08
buyer_8,Antonio,45,ES47209569543860298423,TRX_N-00906-75201727,2024-02-08T09:43:11,Labastida,expenses,electricity,-53.05,-40608.13
buyer_8,Antonio,45,ES47209569543860298423,TRX_N-00907-23408493,2024-02-08T13:22:47,Labastida,expenses,water,-24.94,-40633.07
buyer_8,Antonio,45,ES47209569543860298423,TRX_N-00908-64284574,2024-02-08T14:03:11,Labastida,expenses,phone,-33.75,-40666.82
buyer_8,Antonio,45,ES47209569543860298423,TRX_N-00909-50826140,2024-02-12T14:35:29,Labastida,Expense,education,-55.08,-40721.9
buyer_8,Antonio,45,ES47209569543860298423,TRX_N-00910-51462707,2024-02-14T17:50:12,Labastida,Expense,transport,-77.68,-40799.58
buyer_8,Antonio,45,ES47209569543860298423,TRX_N-00911-41566060,2024-02-14T18:32:19,Labastida,Expense,clothing,-157.3,-40956.88
buyer_8,Antonio,45,ES47209569543860298423,TRX_N-00912-05035750,2024-02-15T20:03:31,Labastida,Expense,leisure,-66.85,-41023.73
buyer_8,Antonio,45,ES47209569543860298423,TRX_N-00913-89189791,2024-02-16T14:24:43,Labastida,Expense,food,-121.06,-41144.79
buyer_8,Antonio,45,ES47209569543860298423,TRX_N-00914-49135284,2024-02-16T20:35:41,Labastida,Expense,transport,-82.96,-41227.75
buyer_8,Antonio,45,ES47209569543860298423,TRX_N-00915-25615405,2024-02-17T09:00:13,Labastida,Expense,gifts,-358.15,-41585.9
buyer_8,Antonio,45,ES47209569543860298423,TRX_N-00916-29460030,2024-02-23T13:47:21,Labastida,Expense,travel,-974.7,-42560.6
buyer_8,Antonio,45,ES47209569543860298423,TRX_N-00917-67065804,2024-02-24T20:07:52,Labastida,Expense,food,-81.36,-42641.96
buyer_8,Antonio,45,ES47209569543860298423,TRX_N-00918-36820914,2024-02-24T18:08:56,Labastida,Expense,transport,-70.42,-42712.38
buyer_8,Antonio,45,ES47209569543860298423,TRX_N-00919-16933409,2024-02-24T18:59:59,Labastida,expenses,children,-231.62,-42944.0
buyer_8,Antonio,45,ES47209569543860298423,TRX_N-00920-46515696,2024-02-25T20:56:33,Labastida,Expense,clothing,-56.12,-43000.12
buyer_8,Antonio,45,ES47209569543860298423,TRX_N-00921-90835733,2024-02-27T11:31:05,Labastida,Expense,leisure,-61.6,-43061.72
buyer_8,Antonio,45,ES47209569543860298423,TRX_N-00922-92322352,2024-02-27T19:28:38,Labastida,Expense,travel,-1472.92,-44534.64
buyer_8,Antonio,45,ES47209569543860298423,TRX_N-00923-59334761,2024-02-29T14:47:15,Hernani,Expense,cash,-100.0,-44634.64
buyer_8,Antonio,45,ES47209569543860298423,TRX_N-00924-62406383,2024-03-01T17:13:10,Labastida,incomes,salary,1580.69,-43053.95
buyer_8,Antonio,45,ES47209569543860298423,TRX_N-00925-28082728,2024-03-01T17:13:10,Labastida,incomes,salary_partner,1718.95,-41335.0
buyer_8,Antonio,45,ES47209569543860298423,TRX_N-00926-03696706,2024-03-01T17:13:10,Labastida,incomes,extra_income,237.8,-41097.2
buyer_8,Antonio,45,ES47209569543860298423,TRX_N-00927-80266880,2024-03-01T13:53:06,Labastida,Expense,clothing,-82.78,-41179.98
buyer_8,Antonio,45,ES47209569543860298423,TRX_N-00928-46386678,2024-03-01T20:44:40,Durango,Expense,education,-60.42,-41240.4
buyer_8,Antonio,45,ES47209569543860298423,TRX_N-00929-44639277,2024-03-02T22:08:42,Labastida,Expense,cash,-100.0,-41340.4
buyer_8,Antonio,45,ES47209569543860298423,TRX_N-00930-15590464,2024-03-04T15:02:21,Labastida,expenses,mortgage,-842.18,-42182.58
buyer_8,Antonio,45,ES47209569543860298423,TRX_N-00931-07960561,2024-03-04T16:02:42,Labastida,Expense,transport,-59.14,-42241.72
buyer_8,Antonio,45,ES47209569543860298423,TRX_N-00932-38358677,2024-03-05T08:22:24,Labastida,expenses,electricity,-53.72,-42295.44
buyer_8,Antonio,45,ES47209569543860298423,TRX_N-00933-52124222,2024-03-06T18:44:06,Labastida,expenses,gas,-81.04,-42376.48
buyer_8,Antonio,45,ES47209569543860298423,TRX_N-00934-48723983,2024-03-06T14:19:27,Labastida,Expense,leisure,-40.05,-42416.53
buyer_8,Antonio,45,ES47209569543860298423,TRX_N-00935-33440787,2024-03-07T15:01:47,Labastida,expenses,phone,-39.3,-42455.83
buyer_8,Antonio,45,ES47209569543860298423,TRX_N-00936-10256822,2024-03-08T16:21:31,Labastida,expenses,water,-33.25,-42489.08
buyer_8,Antonio,45,ES47209569543860298423,TRX_N-00937-32764475,2024-03-08T10:36:11,Labastida,expenses,internet,-42.0,-42531.08
buyer_8,Antonio,45,ES47209569543860298423,TRX_N-00938-89354923,2024-03-09T20:27:07,Labastida,Expense,transport,-87.61,-42618.69
buyer_8,Antonio,45,ES47209569543860298423,TRX_N-00939-20193825,2024-03-09T12:15:33,Labastida,Expense,appliances,-400.46,-43019.15
buyer_8,Antonio,45,ES47209569543860298423,TRX_N-00940-25772810,2024-03-09T11:04:49,Labastida,Expense,gifts,-241.68,-43260.83
buyer_8,Antonio,45,ES47209569543860298423,TRX_N-00941-55576678,2024-03-10T08:50:26,Labastida,Expense,leisure,-50.09,-43310.92
buyer_8,Antonio,45,ES47209569543860298423,TRX_N-00942-78577215,2024-03-11T10:54:28,Labastida,Expense,leisure,-66.56,-43377.48
buyer_8,Antonio,45,ES47209569543860298423,TRX_N-00943-92165366,2024-03-12T10:10:56,Salvatierra/Agurain,Expense,food,-70.03,-43447.51
buyer_8,Antonio,45,ES47209569543860298423,TRX_N-00944-93516644,2024-03-12T18:48:23,Labastida,Expense,education,-52.06,-43499.57
buyer_8,Antonio,45,ES47209569543860298423,TRX_N-00945-91667167,2024-03-13T14:04:50,Berango,Expense,food,-101.23,-43600.8
buyer_8,Antonio,45,ES47209569543860298423,TRX_N-00946-74904244,2024-03-14T21:55:25,Labastida,Expense,food,-101.73,-43702.53
buyer_8,Antonio,45,ES47209569543860298423,TRX_N-00947-68648139,2024-03-14T19:22:56,Labastida,Expense,clothing,-50.49,-43753.02
buyer_8,Antonio,45,ES47209569543860298423,TRX_N-00948-92085098,2024-03-15T16:55:03,Labastida,Expense,cash,-100.0,-43853.02
buyer_8,Antonio,45,ES47209569543860298423,TRX_N-00949-04435036,2024-03-15T04:45:05,Labastida,Expense,repairs,-230.45,-44083.47
buyer_8,Antonio,45,ES47209569543860298423,TRX_N-00950-75222192,2024-03-15T14:55:32,Labastida,Expense,gifts,-688.51,-44771.98
buyer_8,Antonio,45,ES47209569543860298423,TRX_N-00951-03148606,2024-03-16T18:23:59,Labastida,Expense,transport,-88.12,-44860.1
buyer_8,Antonio,45,ES47209569543860298423,TRX_N-00952-78589658,2024-03-16T19:07:21,Labastida,Expense,appliances,-377.7,-45237.8
buyer_8,Antonio,45,ES47209569543860298423,TRX_N-00953-47291110,2024-03-18T16:21:29,Iru√±a de Oca,Expense,transport,-71.37,-45309.17
buyer_8,Antonio,45,ES47209569543860298423,TRX_N-00954-25123186,2024-03-19T15:36:39,Leioa,Expense,food,-61.69,-45370.86
buyer_8,Antonio,45,ES47209569543860298423,TRX_N-00955-94475722,2024-03-20T11:51:59,Labastida,Expense,leisure,-36.88,-45407.74
buyer_8,Antonio,45,ES47209569543860298423,TRX_N-00956-27332099,2024-03-21T20:43:29,Pasaia,Expense,food,-111.99,-45519.73
buyer_8,Antonio,45,ES47209569543860298423,TRX_N-00957-87027802,2024-03-21T10:07:29,Labastida,Expense,appliances,-353.07,-45872.8
buyer_8,Antonio,45,ES47209569543860298423,TRX_N-00958-50578032,2024-03-24T11:47:07,Durango,Expense,food,-86.29,-45959.09
buyer_8,Antonio,45,ES47209569543860298423,TRX_N-00959-71406843,2024-03-24T01:49:52,Labastida,Expense,clothing,-159.41,-46118.5
buyer_8,Antonio,45,ES47209569543860298423,TRX_N-00960-84921344,2024-03-26T09:33:33,Labastida,Expense,healthcare,-80.3,-46198.8
buyer_8,Antonio,45,ES47209569543860298423,TRX_N-00961-17619298,2024-03-28T10:33:54,Labastida,Expense,appliances,-214.68,-46413.48
buyer_8,Antonio,45,ES47209569543860298423,TRX_N-00962-19107206,2024-03-28T10:15:56,Labastida,Expense,repairs,-183.57,-46597.05
buyer_8,Antonio,45,ES47209569543860298423,TRX_N-00963-93787163,2024-03-30T11:06:04,Labastida,Expense,cash,-100.0,-46697.05
buyer_8,Antonio,45,ES47209569543860298423,TRX_N-00964-88149641,2024-03-31T04:48:42,Amurrio,Expense,education,-46.4,-46743.45
buyer_8,Antonio,45,ES47209569543860298423,TRX_N-00965-59005390,2024-04-01T12:51:40,Labastida,incomes,salary,1580.69,-45162.76
buyer_8,Antonio,45,ES47209569543860298423,TRX_N-00966-41314996,2024-04-01T12:51:40,Labastida,incomes,salary_partner,1718.95,-43443.81
buyer_8,Antonio,45,ES47209569543860298423,TRX_N-00967-37661351,2024-04-01T08:56:25,Errenteria,Expense,leisure,-63.85,-43507.66
buyer_8,Antonio,45,ES47209569543860298423,TRX_N-00968-02634077,2024-04-01T06:55:04,Labastida,Expense,clothing,-91.52,-43599.18
buyer_8,Antonio,45,ES47209569543860298423,TRX_N-00969-60764174,2024-04-02T12:14:02,Labastida,Expense,cash,-100.0,-43699.18
buyer_8,Antonio,45,ES47209569543860298423,TRX_N-00970-21736826,2024-04-02T19:01:26,Labastida,Expense,gifts,-87.17,-43786.35
buyer_8,Antonio,45,ES47209569543860298423,TRX_N-00971-13556732,2024-04-04T11:48:44,Labastida,expenses,mortgage,-842.18,-44628.53
buyer_8,Antonio,45,ES47209569543860298423,TRX_N-00972-75207625,2024-04-04T23:17:52,Labastida,Expense,leisure,-64.82,-44693.35
buyer_8,Antonio,45,ES47209569543860298423,TRX_N-00973-50711152,2024-04-04T14:15:13,Labastida,Expense,cash,-100.0,-44793.35
buyer_8,Antonio,45,ES47209569543860298423,TRX_N-00974-65818645,2024-04-05T09:49:26,Labastida,expenses,electricity,-60.99,-44854.34
buyer_8,Antonio,45,ES47209569543860298423,TRX_N-00975-10437985,2024-04-05T16:21:33,Labastida,expenses,internet,-42.0,-44896.34
buyer_8,Antonio,45,ES47209569543860298423,TRX_N-00976-68266377,2024-04-05T18:15:00,Labastida,Expense,leisure,-52.67,-44949.01
buyer_8,Antonio,45,ES47209569543860298423,TRX_N-00977-32245338,2024-04-05T01:06:23,Labastida,Expense,cash,-100.0,-45049.01
buyer_8,Antonio,45,ES47209569543860298423,TRX_N-00978-27515278,2024-04-06T15:20:22,Labastida,expenses,water,-20.87,-45069.88
buyer_8,Antonio,45,ES47209569543860298423,TRX_N-00979-71203605,2024-04-06T20:56:34,Labastida,expenses,phone,-39.26,-45109.14
buyer_8,Antonio,45,ES47209569543860298423,TRX_N-00980-96480997,2024-04-07T09:37:32,Labastida,Expense,cash,-100.0,-45209.14
buyer_8,Antonio,45,ES47209569543860298423,TRX_N-00981-36609544,2024-04-07T15:02:00,Labastida,Expense,travel,-300.98,-45510.12
buyer_8,Antonio,45,ES47209569543860298423,TRX_N-00982-74502433,2024-04-08T18:24:27,Labastida,expenses,gas,-36.87,-45546.99
buyer_8,Antonio,45,ES47209569543860298423,TRX_N-00983-81011141,2024-04-08T14:58:10,Bermeo,Expense,travel,-473.11,-46020.1
buyer_8,Antonio,45,ES47209569543860298423,TRX_N-00984-55363058,2024-04-09T05:05:02,Labastida,Expense,gifts,-715.43,-46735.53
buyer_8,Antonio,45,ES47209569543860298423,TRX_N-00985-37968093,2024-04-11T19:04:01,Labastida,expenses,children,-71.91,-46807.44
buyer_8,Antonio,45,ES47209569543860298423,TRX_N-00986-47346183,2024-04-12T23:11:49,Labastida,Expense,transport,-41.23,-46848.67
buyer_8,Antonio,45,ES47209569543860298423,TRX_N-00987-34693722,2024-04-13T17:51:19,Labastida,Expense,transport,-56.18,-46904.85
buyer_8,Antonio,45,ES47209569543860298423,TRX_N-00988-84743308,2024-04-15T08:44:26,Labastida,Expense,cash,-100.0,-47004.85
buyer_8,Antonio,45,ES47209569543860298423,TRX_N-00989-83146230,2024-04-15T20:43:42,Labastida,Expense,appliances,-286.67,-47291.52
buyer_8,Antonio,45,ES47209569543860298423,TRX_N-00990-90734829,2024-04-15T13:58:26,Labastida,Expense,gifts,-380.27,-47671.79
buyer_8,Antonio,45,ES47209569543860298423,TRX_N-00991-10838724,2024-04-16T13:45:27,Lasarte-Oria,Expense,healthcare,-63.21,-47735.0
buyer_8,Antonio,45,ES47209569543860298423,TRX_N-00992-03626393,2024-04-16T14:18:23,Labastida,expenses,children,-170.56,-47905.56
buyer_8,Antonio,45,ES47209569543860298423,TRX_N-00993-41099862,2024-04-17T08:58:32,Labastida,Expense,food,-120.2,-48025.76
buyer_8,Antonio,45,ES47209569543860298423,TRX_N-00994-52793645,2024-04-18T15:53:16,Labastida,Expense,cash,-100.0,-48125.76
buyer_8,Antonio,45,ES47209569543860298423,TRX_N-00995-16214713,2024-04-19T11:40:03,Labastida,Expense,leisure,-22.4,-48148.16
buyer_8,Antonio,45,ES47209569543860298423,TRX_N-00996-34750470,2024-04-21T21:09:26,Labastida,Expense,education,-66.36,-48214.52
buyer_8,Antonio,45,ES47209569543860298423,TRX_N-00997-20679702,2024-04-22T16:30:10,Labastida,Expense,food,-95.63,-48310.15
buyer_8,Antonio,45,ES47209569543860298423,TRX_N-00998-75956631,2024-04-22T15:07:07,Pasaia,Expense,healthcare,-49.29,-48359.44
buyer_8,Antonio,45,ES47209569543860298423,TRX_N-00999-00703948,2024-04-22T17:36:32,Labastida,Expense,cash,-100.0,-48459.44
buyer_8,Antonio,45,ES47209569543860298423,TRX_N-01000-52226738,2024-04-23T09:45:03,Labastida,Expense,repairs,-92.5,-48551.94
buyer_8,Antonio,45,ES47209569543860298423,TRX_N-01001-52669388,2024-04-24T08:14:21,Amurrio,Expense,food,-74.06,-48626.0
buyer_8,Antonio,45,ES47209569543860298423,TRX_N-01002-21282533,2024-04-25T02:10:20,Labastida,Expense,food,-65.79,-48691.79
buyer_8,Antonio,45,ES47209569543860298423,TRX_N-01003-37633097,2024-04-26T00:48:40,Labastida,Expense,food,-64.47,-48756.26
buyer_8,Antonio,45,ES47209569543860298423,TRX_N-01004-47711070,2024-04-26T11:26:51,Labastida,Expense,education,-68.94,-48825.2
buyer_8,Antonio,45,ES47209569543860298423,TRX_N-01005-09932206,2024-04-27T08:45:50,Basauri,Expense,repairs,-134.96,-48960.16
buyer_8,Antonio,45,ES47209569543860298423,TRX_N-01006-63976582,2024-04-29T15:14:22,Leioa,Expense,cash,-100.0,-49060.16
buyer_8,Antonio,45,ES47209569543860298423,TRX_N-01007-44671090,2024-05-01T20:08:57,Labastida,incomes,salary,1580.69,-47479.47
buyer_8,Antonio,45,ES47209569543860298423,TRX_N-01008-68202140,2024-05-01T20:08:57,Labastida,incomes,salary_partner,1718.95,-45760.52
buyer_8,Antonio,45,ES47209569543860298423,TRX_N-01009-26540109,2024-05-01T12:32:06,Labastida,Expense,education,-69.82,-45830.34
buyer_8,Antonio,45,ES47209569543860298423,TRX_N-01010-14410078,2024-05-02T10:57:21,Labastida,Expense,clothing,-139.92,-45970.26
buyer_8,Antonio,45,ES47209569543860298423,TRX_N-01011-51944158,2024-05-03T11:41:25,Arrasate,Expense,food,-81.94,-46052.2
buyer_8,Antonio,45,ES47209569543860298423,TRX_N-01012-03440876,2024-05-03T11:58:43,Labastida,Expense,clothing,-75.95,-46128.15
buyer_8,Antonio,45,ES47209569543860298423,TRX_N-01013-48338653,2024-05-04T08:15:24,Labastida,expenses,mortgage,-842.18,-46970.33
buyer_8,Antonio,45,ES47209569543860298423,TRX_N-01014-28928573,2024-05-04T12:57:01,Labastida,Expense,cash,-100.0,-47070.33
buyer_8,Antonio,45,ES47209569543860298423,TRX_N-01015-57523686,2024-05-05T13:42:05,Labastida,expenses,water,-24.79,-47095.12
buyer_8,Antonio,45,ES47209569543860298423,TRX_N-01016-82051417,2024-05-05T17:02:40,Bermeo,Expense,repairs,-55.31,-47150.43
buyer_8,Antonio,45,ES47209569543860298423,TRX_N-01017-70081841,2024-05-07T13:02:51,Labastida,Expense,food,-102.33,-47252.76
buyer_8,Antonio,45,ES47209569543860298423,TRX_N-01018-79152805,2024-05-08T20:29:30,Labastida,expenses,electricity,-76.84,-47329.6
buyer_8,Antonio,45,ES47209569543860298423,TRX_N-01019-52675898,2024-05-08T11:18:54,Labastida,expenses,gas,-76.76,-47406.36
buyer_8,Antonio,45,ES47209569543860298423,TRX_N-01020-98973011,2024-05-08T21:44:28,Labastida,expenses,internet,-42.0,-47448.36
buyer_8,Antonio,45,ES47209569543860298423,TRX_N-01021-71610830,2024-05-08T16:35:50,Labastida,expenses,phone,-36.22,-47484.58
buyer_8,Antonio,45,ES47209569543860298423,TRX_N-01022-49598813,2024-05-09T15:16:03,Labastida,Expense,food,-99.35,-47583.93
buyer_8,Antonio,45,ES47209569543860298423,TRX_N-01023-36957910,2024-05-09T19:30:06,Labastida,Expense,clothing,-104.77,-47688.7
buyer_8,Antonio,45,ES47209569543860298423,TRX_N-01024-61424749,2024-05-10T22:42:12,Labastida,Expense,gifts,-679.61,-48368.31
buyer_8,Antonio,45,ES47209569543860298423,TRX_N-01025-80856117,2024-05-14T14:33:31,Labastida,Expense,food,-123.08,-48491.39
buyer_8,Antonio,45,ES47209569543860298423,TRX_N-01026-41884816,2024-05-15T16:53:47,Labastida,Expense,leisure,-26.13,-48517.52
buyer_8,Antonio,45,ES47209569543860298423,TRX_N-01027-33693652,2024-05-17T11:23:19,Santurtzi,Expense,clothing,-139.87,-48657.39
buyer_8,Antonio,45,ES47209569543860298423,TRX_N-01028-96161156,2024-05-17T16:06:13,Labastida,Expense,travel,-421.95,-49079.34
buyer_8,Antonio,45,ES47209569543860298423,TRX_N-01029-17539566,2024-05-18T11:00:36,Labastida,Expense,leisure,-25.86,-49105.2
buyer_8,Antonio,45,ES47209569543860298423,TRX_N-01030-86829403,2024-05-18T20:19:38,Labastida,Expense,cash,-100.0,-49205.2
buyer_8,Antonio,45,ES47209569543860298423,TRX_N-01031-35986618,2024-05-20T17:27:40,Sopela,Expense,education,-64.67,-49269.87
buyer_8,Antonio,45,ES47209569543860298423,TRX_N-01032-87609316,2024-05-21T10:10:52,Labastida,Expense,transport,-70.54,-49340.41
buyer_8,Antonio,45,ES47209569543860298423,TRX_N-01033-01188197,2024-05-21T20:13:55,Labastida,Expense,cash,-100.0,-49440.41
buyer_8,Antonio,45,ES47209569543860298423,TRX_N-01034-02186805,2024-05-22T11:57:59,Errenteria,Expense,transport,-59.39,-49499.8
buyer_8,Antonio,45,ES47209569543860298423,TRX_N-01035-57718284,2024-05-25T18:08:38,Labastida,expenses,children,-143.43,-49643.23
buyer_8,Antonio,45,ES47209569543860298423,TRX_N-01036-63675925,2024-05-28T09:14:29,Labastida,Expense,cash,-100.0,-49743.23
buyer_8,Antonio,45,ES47209569543860298423,TRX_N-01037-17420510,2024-05-31T10:21:07,Labastida,Expense,leisure,-62.83,-49806.06
buyer_8,Antonio,45,ES47209569543860298423,TRX_N-01038-26779282,2024-06-01T21:50:21,Labastida,incomes,salary,1580.69,-48225.37
buyer_8,Antonio,45,ES47209569543860298423,TRX_N-01039-70432173,2024-06-01T21:50:21,Labastida,incomes,salary_partner,1718.95,-46506.42
buyer_8,Antonio,45,ES47209569543860298423,TRX_N-01040-13226594,2024-06-01T21:50:21,Labastida,incomes,salary_bonus,1161.51,-45344.91
buyer_8,Antonio,45,ES47209569543860298423,TRX_N-01041-13807859,2024-06-01T21:50:21,Labastida,incomes,salary_partner_bonus,1318.87,-44026.04
buyer_8,Antonio,45,ES47209569543860298423,TRX_N-01042-96518222,2024-06-03T19:46:23,Errenteria,Expense,leisure,-50.35,-44076.39
buyer_8,Antonio,45,ES47209569543860298423,TRX_N-01043-13253973,2024-06-03T17:10:07,Labastida,expenses,children,-252.9,-44329.29
buyer_8,Antonio,45,ES47209569543860298423,TRX_N-01044-77999781,2024-06-04T17:01:10,Labastida,expenses,mortgage,-842.18,-45171.47
buyer_8,Antonio,45,ES47209569543860298423,TRX_N-01045-82103555,2024-06-04T22:36:45,Labastida,Expense,appliances,-164.07,-45335.54
buyer_8,Antonio,45,ES47209569543860298423,TRX_N-01046-65598272,2024-06-05T13:42:34,Labastida,expenses,gas,-93.42,-45428.96
buyer_8,Antonio,45,ES47209569543860298423,TRX_N-01047-59266926,2024-06-05T13:26:43,Labastida,expenses,phone,-44.53,-45473.49
buyer_8,Antonio,45,ES47209569543860298423,TRX_N-01048-67312650,2024-06-05T14:25:45,Labastida,Expense,healthcare,-100.75,-45574.24
buyer_8,Antonio,45,ES47209569543860298423,TRX_N-01049-17247776,2024-06-06T20:27:16,Labastida,expenses,electricity,-77.27,-45651.51
buyer_8,Antonio,45,ES47209569543860298423,TRX_N-01050-95011008,2024-06-06T15:04:21,Labastida,Expense,transport,-74.18,-45725.69
buyer_8,Antonio,45,ES47209569543860298423,TRX_N-01051-33621207,2024-06-06T12:40:03,Labastida,Expense,clothing,-114.99,-45840.68
buyer_8,Antonio,45,ES47209569543860298423,TRX_N-01052-60523940,2024-06-07T21:36:27,Labastida,Expense,food,-90.71,-45931.39
buyer_8,Antonio,45,ES47209569543860298423,TRX_N-01053-20483217,2024-06-08T11:02:09,Labastida,expenses,water,-24.18,-45955.57
buyer_8,Antonio,45,ES47209569543860298423,TRX_N-01054-17705667,2024-06-08T08:21:56,Labastida,expenses,internet,-42.0,-45997.57
buyer_8,Antonio,45,ES47209569543860298423,TRX_N-01055-63171904,2024-06-08T13:14:06,Labastida,Expense,food,-112.55,-46110.12
buyer_8,Antonio,45,ES47209569543860298423,TRX_N-01056-65235121,2024-06-09T06:45:29,Labastida,Expense,education,-48.15,-46158.27
buyer_8,Antonio,45,ES47209569543860298423,TRX_N-01057-48367790,2024-06-11T19:02:55,Oy√≥n-Oion,Expense,leisure,-67.15,-46225.42
buyer_8,Antonio,45,ES47209569543860298423,TRX_N-01058-95555574,2024-06-12T09:04:42,Labastida,Expense,food,-115.35,-46340.77
buyer_8,Antonio,45,ES47209569543860298423,TRX_N-01059-96012366,2024-06-12T05:20:43,Labastida,Expense,clothing,-127.37,-46468.14
buyer_8,Antonio,45,ES47209569543860298423,TRX_N-01060-95659871,2024-06-13T11:26:12,Labastida,Expense,appliances,-378.89,-46847.03
buyer_8,Antonio,45,ES47209569543860298423,TRX_N-01061-21404454,2024-06-15T09:15:10,Labastida,Expense,transport,-47.33,-46894.36
buyer_8,Antonio,45,ES47209569543860298423,TRX_N-01062-82082063,2024-06-18T08:07:18,Labastida,Expense,transport,-71.13,-46965.49
buyer_8,Antonio,45,ES47209569543860298423,TRX_N-01063-10038575,2024-06-18T19:01:05,Labastida,Expense,cash,-100.0,-47065.49
buyer_8,Antonio,45,ES47209569543860298423,TRX_N-01064-85980804,2024-06-20T10:42:11,Labastida,Expense,healthcare,-171.93,-47237.42
buyer_8,Antonio,45,ES47209569543860298423,TRX_N-01065-08986558,2024-06-21T15:57:23,Labastida,Expense,leisure,-83.48,-47320.9
buyer_8,Antonio,45,ES47209569543860298423,TRX_N-01066-46144265,2024-06-22T13:39:39,Labastida,Expense,leisure,-25.71,-47346.61
buyer_8,Antonio,45,ES47209569543860298423,TRX_N-01067-43466879,2024-06-23T18:24:59,Labastida,Expense,transport,-83.45,-47430.06
buyer_8,Antonio,45,ES47209569543860298423,TRX_N-01068-85667450,2024-06-23T16:58:58,Labastida,Expense,clothing,-153.45,-47583.51
buyer_8,Antonio,45,ES47209569543860298423,TRX_N-01069-30753651,2024-06-25T22:17:46,Labastida,expenses,children,-200.38,-47783.89
buyer_8,Antonio,45,ES47209569543860298423,TRX_N-01070-72293522,2024-06-26T18:33:05,Labastida,Expense,gifts,-612.29,-48396.18
buyer_8,Antonio,45,ES47209569543860298423,TRX_N-01071-00641818,2024-06-28T20:54:09,Eibar,Expense,transport,-42.84,-48439.02
buyer_8,Antonio,45,ES47209569543860298423,TRX_N-01072-05864703,2024-06-29T10:55:15,Labastida,Expense,food,-84.74,-48523.76
buyer_8,Antonio,45,ES47209569543860298423,TRX_N-01073-70194131,2024-06-29T14:19:49,Labastida,Expense,transport,-83.15,-48606.91
buyer_8,Antonio,45,ES47209569543860298423,TRX_N-01074-79271773,2024-06-29T14:29:38,Labastida,Expense,cash,-100.0,-48706.91
buyer_8,Antonio,45,ES47209569543860298423,TRX_N-01075-81953728,2024-06-29T13:39:28,Labastida,Expense,repairs,-83.84,-48790.75
buyer_8,Antonio,45,ES47209569543860298423,TRX_N-01076-80712333,2024-07-01T06:33:57,Labastida,incomes,salary,1580.69,-47210.06
buyer_8,Antonio,45,ES47209569543860298423,TRX_N-01077-91653629,2024-07-01T06:33:57,Labastida,incomes,salary_partner,1718.95,-45491.11
buyer_8,Antonio,45,ES47209569543860298423,TRX_N-01078-24732630,2024-07-01T06:33:57,Labastida,incomes,extra_income,237.8,-45253.31
buyer_8,Antonio,45,ES47209569543860298423,TRX_N-01079-82635866,2024-07-03T15:24:53,Labastida,Expense,cash,-100.0,-45353.31
buyer_8,Antonio,45,ES47209569543860298423,TRX_N-01080-03471747,2024-07-04T16:33:08,Labastida,expenses,mortgage,-842.18,-46195.49
buyer_8,Antonio,45,ES47209569543860298423,TRX_N-01081-05016217,2024-07-05T09:58:48,Labastida,expenses,phone,-42.0,-46237.49
buyer_8,Antonio,45,ES47209569543860298423,TRX_N-01082-09678713,2024-07-06T17:29:31,Labastida,expenses,internet,-42.0,-46279.49
buyer_8,Antonio,45,ES47209569543860298423,TRX_N-01083-34627700,2024-07-06T18:17:43,Labastida,Expense,transport,-55.99,-46335.48
buyer_8,Antonio,45,ES47209569543860298423,TRX_N-01084-33884958,2024-07-07T05:19:54,Labastida,expenses,gas,-99.18,-46434.66
buyer_8,Antonio,45,ES47209569543860298423,TRX_N-01085-61676801,2024-07-07T18:45:19,Andoain,Expense,leisure,-76.1,-46510.76
buyer_8,Antonio,45,ES47209569543860298423,TRX_N-01086-74215014,2024-07-08T14:01:16,Labastida,expenses,water,-44.45,-46555.21
buyer_8,Antonio,45,ES47209569543860298423,TRX_N-01087-33181122,2024-07-08T21:20:36,Labastida,expenses,electricity,-54.37,-46609.58
buyer_8,Antonio,45,ES47209569543860298423,TRX_N-01088-71357259,2024-07-09T14:47:46,Errenteria,Expense,repairs,-260.27,-46869.85
buyer_8,Antonio,45,ES47209569543860298423,TRX_N-01089-99810494,2024-07-10T15:12:59,Labastida,Expense,food,-100.5,-46970.35
buyer_8,Antonio,45,ES47209569543860298423,TRX_N-01090-40988303,2024-07-14T09:25:46,Labastida,Expense,cash,-100.0,-47070.35
buyer_8,Antonio,45,ES47209569543860298423,TRX_N-01091-21078670,2024-07-14T06:18:15,Labastida,expenses,children,-212.38,-47282.73
buyer_8,Antonio,45,ES47209569543860298423,TRX_N-01092-51701388,2024-07-15T14:03:10,Donostia,Expense,travel,-1749.07,-49031.8
buyer_8,Antonio,45,ES47209569543860298423,TRX_N-01093-58995608,2024-07-16T09:15:54,Labastida,Expense,food,-68.54,-49100.34
buyer_8,Antonio,45,ES47209569543860298423,TRX_N-01094-74181147,2024-07-17T11:30:04,Labastida,Expense,food,-108.41,-49208.75
buyer_8,Antonio,45,ES47209569543860298423,TRX_N-01095-72627288,2024-07-18T23:14:32,Labastida,Expense,food,-92.91,-49301.66
buyer_8,Antonio,45,ES47209569543860298423,TRX_N-01096-50989996,2024-07-18T15:53:53,Labastida,Expense,leisure,-38.78,-49340.44
buyer_8,Antonio,45,ES47209569543860298423,TRX_N-01097-02089739,2024-07-20T13:33:43,Labastida,Expense,cash,-100.0,-49440.44
buyer_8,Antonio,45,ES47209569543860298423,TRX_N-01098-27556551,2024-07-21T18:08:44,Labastida,Expense,cash,-100.0,-49540.44
buyer_8,Antonio,45,ES47209569543860298423,TRX_N-01099-14190761,2024-07-26T09:29:56,Labastida,Expense,cash,-100.0,-49640.44
buyer_8,Antonio,45,ES47209569543860298423,TRX_N-01100-59568384,2024-07-27T09:54:51,Lasarte-Oria,Expense,clothing,-83.34,-49723.78
buyer_8,Antonio,45,ES47209569543860298423,TRX_N-01101-68386086,2024-07-27T15:36:48,Andoain,Expense,education,-72.81,-49796.59
buyer_8,Antonio,45,ES47209569543860298423,TRX_N-01102-62644790,2024-07-27T10:08:01,Lasarte-Oria,Expense,cash,-100.0,-49896.59
buyer_8,Antonio,45,ES47209569543860298423,TRX_N-01103-64303226,2024-07-28T19:08:57,Labastida,Expense,cash,-100.0,-49996.59
buyer_8,Antonio,45,ES47209569543860298423,TRX_N-01104-21307278,2024-07-29T18:34:05,Labastida,Expense,food,-67.61,-50064.2
buyer_8,Antonio,45,ES47209569543860298423,TRX_N-01105-69244637,2024-08-01T15:01:11,Labastida,incomes,salary,1580.69,-48483.51
buyer_8,Antonio,45,ES47209569543860298423,TRX_N-01106-38514044,2024-08-01T15:01:11,Labastida,incomes,salary_partner,1718.95,-46764.56
buyer_8,Antonio,45,ES47209569543860298423,TRX_N-01107-06457695,2024-08-02T17:04:32,Labastida,Expense,transport,-56.76,-46821.32
buyer_8,Antonio,45,ES47209569543860298423,TRX_N-01108-78329776,2024-08-03T20:42:31,Labastida,Expense,gifts,-597.12,-47418.44
buyer_8,Antonio,45,ES47209569543860298423,TRX_N-01109-90501440,2024-08-04T19:34:07,Labastida,expenses,mortgage,-842.18,-48260.62
buyer_8,Antonio,45,ES47209569543860298423,TRX_N-01110-46382680,2024-08-04T15:21:15,Basauri,Expense,food,-60.04,-48320.66
buyer_8,Antonio,45,ES47209569543860298423,TRX_N-01111-02637230,2024-08-04T11:58:33,Labastida,expenses,children,-134.31,-48454.97
buyer_8,Antonio,45,ES47209569543860298423,TRX_N-01112-14289538,2024-08-06T10:09:55,Labastida,expenses,internet,-42.0,-48496.97
buyer_8,Antonio,45,ES47209569543860298423,TRX_N-01113-56806192,2024-08-07T11:32:19,Labastida,expenses,gas,-59.53,-48556.5
buyer_8,Antonio,45,ES47209569543860298423,TRX_N-01114-37667101,2024-08-07T19:50:54,Salvatierra/Agurain,Expense,cash,-100.0,-48656.5
buyer_8,Antonio,45,ES47209569543860298423,TRX_N-01115-17829811,2024-08-08T08:46:49,Labastida,expenses,water,-24.95,-48681.45
buyer_8,Antonio,45,ES47209569543860298423,TRX_N-01116-24649864,2024-08-08T10:08:57,Labastida,expenses,electricity,-44.25,-48725.7
buyer_8,Antonio,45,ES47209569543860298423,TRX_N-01117-27680391,2024-08-08T15:37:32,Labastida,expenses,phone,-39.64,-48765.34
buyer_8,Antonio,45,ES47209569543860298423,TRX_N-01118-59232227,2024-08-08T19:44:10,Labastida,Expense,food,-100.97,-48866.31
buyer_8,Antonio,45,ES47209569543860298423,TRX_N-01119-03167376,2024-08-10T19:44:45,Labastida,Expense,appliances,-410.14,-49276.45
buyer_8,Antonio,45,ES47209569543860298423,TRX_N-01120-99268024,2024-08-14T10:03:53,Labastida,Expense,education,-52.52,-49328.97
buyer_8,Antonio,45,ES47209569543860298423,TRX_N-01121-90009547,2024-08-18T19:37:10,Labastida,Expense,leisure,-44.1,-49373.07
buyer_8,Antonio,45,ES47209569543860298423,TRX_N-01122-47295636,2024-08-19T18:54:17,Sestao,Expense,transport,-69.35,-49442.42
buyer_8,Antonio,45,ES47209569543860298423,TRX_N-01123-73707066,2024-08-22T22:58:01,Labastida,Expense,food,-65.08,-49507.5
buyer_8,Antonio,45,ES47209569543860298423,TRX_N-01124-13913039,2024-08-22T19:27:15,Donostia,Expense,cash,-100.0,-49607.5
buyer_8,Antonio,45,ES47209569543860298423,TRX_N-01125-15179483,2024-08-23T12:38:36,Labastida,Expense,cash,-100.0,-49707.5
buyer_8,Antonio,45,ES47209569543860298423,TRX_N-01126-73398012,2024-08-26T11:45:06,Labastida,Expense,leisure,-48.48,-49755.98
buyer_8,Antonio,45,ES47209569543860298423,TRX_N-01127-94253771,2024-08-30T15:18:43,Labastida,Expense,transport,-61.84,-49817.82
buyer_8,Antonio,45,ES47209569543860298423,TRX_N-01128-31802154,2024-09-01T12:36:45,Labastida,incomes,salary,1580.69,-48237.13
buyer_8,Antonio,45,ES47209569543860298423,TRX_N-01129-29706944,2024-09-01T12:36:45,Labastida,incomes,salary_partner,1718.95,-46518.18
buyer_8,Antonio,45,ES47209569543860298423,TRX_N-01130-44381975,2024-09-01T17:54:52,Durango,Expense,transport,-84.96,-46603.14
buyer_8,Antonio,45,ES47209569543860298423,TRX_N-01131-48552824,2024-09-01T00:53:28,Labastida,Expense,cash,-100.0,-46703.14
buyer_8,Antonio,45,ES47209569543860298423,TRX_N-01132-50061695,2024-09-02T11:41:12,Labastida,Expense,food,-99.03,-46802.17
buyer_8,Antonio,45,ES47209569543860298423,TRX_N-01133-43367236,2024-09-02T07:19:24,Labastida,Expense,appliances,-165.63,-46967.8
buyer_8,Antonio,45,ES47209569543860298423,TRX_N-01134-77868831,2024-09-03T17:00:50,Labastida,Expense,leisure,-84.23,-47052.03
buyer_8,Antonio,45,ES47209569543860298423,TRX_N-01135-77044738,2024-09-04T19:47:39,Labastida,expenses,mortgage,-842.18,-47894.21
buyer_8,Antonio,45,ES47209569543860298423,TRX_N-01136-64887175,2024-09-04T00:14:16,Labastida,Expense,cash,-100.0,-47994.21
buyer_8,Antonio,45,ES47209569543860298423,TRX_N-01137-63687536,2024-09-05T14:03:43,Labastida,expenses,gas,-73.7,-48067.91
buyer_8,Antonio,45,ES47209569543860298423,TRX_N-01138-47865053,2024-09-05T18:42:01,Labastida,Expense,cash,-100.0,-48167.91
buyer_8,Antonio,45,ES47209569543860298423,TRX_N-01139-05680158,2024-09-06T10:41:42,Labastida,expenses,water,-27.54,-48195.45
buyer_8,Antonio,45,ES47209569543860298423,TRX_N-01140-90926482,2024-09-06T16:09:17,Labastida,expenses,electricity,-89.46,-48284.91
buyer_8,Antonio,45,ES47209569543860298423,TRX_N-01141-89187519,2024-09-06T09:31:00,Labastida,expenses,internet,-42.0,-48326.91
buyer_8,Antonio,45,ES47209569543860298423,TRX_N-01142-16498034,2024-09-06T18:13:55,Hernani,Expense,transport,-66.24,-48393.15
buyer_8,Antonio,45,ES47209569543860298423,TRX_N-01143-66138258,2024-09-06T12:41:17,Zuia,Expense,repairs,-60.0,-48453.15
buyer_8,Antonio,45,ES47209569543860298423,TRX_N-01144-44707425,2024-09-07T15:13:21,Labastida,expenses,phone,-40.84,-48493.99
buyer_8,Antonio,45,ES47209569543860298423,TRX_N-01145-29746948,2024-09-07T09:05:44,Labastida,Expense,gifts,-70.74,-48564.73
buyer_8,Antonio,45,ES47209569543860298423,TRX_N-01146-11489068,2024-09-08T17:35:54,Labastida,Expense,repairs,-148.07,-48712.8
buyer_8,Antonio,45,ES47209569543860298423,TRX_N-01147-60472895,2024-09-10T16:33:36,Labastida,Expense,education,-50.02,-48762.82
buyer_8,Antonio,45,ES47209569543860298423,TRX_N-01148-15643624,2024-09-10T03:31:29,Labastida,Expense,repairs,-174.84,-48937.66
buyer_8,Antonio,45,ES47209569543860298423,TRX_N-01149-04771934,2024-09-11T16:12:01,Labastida,Expense,leisure,-49.83,-48987.49
buyer_8,Antonio,45,ES47209569543860298423,TRX_N-01150-12675763,2024-09-11T21:18:49,Labastida,Expense,repairs,-29.45,-49016.94
buyer_8,Antonio,45,ES47209569543860298423,TRX_N-01151-33820514,2024-09-15T13:33:11,Labastida,Expense,leisure,-22.7,-49039.64
buyer_8,Antonio,45,ES47209569543860298423,TRX_N-01152-62658415,2024-09-15T15:06:07,Labastida,Expense,healthcare,-148.0,-49187.64
buyer_8,Antonio,45,ES47209569543860298423,TRX_N-01153-19794956,2024-09-18T13:51:59,Labastida,Expense,food,-73.89,-49261.53
buyer_8,Antonio,45,ES47209569543860298423,TRX_N-01154-44479834,2024-09-18T12:18:13,Labastida,Expense,cash,-100.0,-49361.53
buyer_8,Antonio,45,ES47209569543860298423,TRX_N-01155-82072569,2024-09-19T08:18:22,Erandio,Expense,transport,-42.3,-49403.83
buyer_8,Antonio,45,ES47209569543860298423,TRX_N-01156-41781819,2024-09-21T19:41:59,Labastida,Expense,food,-92.7,-49496.53
buyer_8,Antonio,45,ES47209569543860298423,TRX_N-01157-63860495,2024-09-25T04:29:08,Labastida,Expense,leisure,-32.93,-49529.46
buyer_8,Antonio,45,ES47209569543860298423,TRX_N-01158-09026174,2024-09-26T04:16:52,Labastida,Expense,cash,-100.0,-49629.46
buyer_8,Antonio,45,ES47209569543860298423,TRX_N-01159-95262474,2024-09-27T10:21:14,Labastida,Expense,leisure,-37.65,-49667.11
buyer_8,Antonio,45,ES47209569543860298423,TRX_N-01160-96057799,2024-09-28T13:48:04,Alegr√≠a-Dulantzi,Expense,transport,-42.67,-49709.78
buyer_8,Antonio,45,ES47209569543860298423,TRX_N-01161-03572242,2024-09-28T18:00:17,Labastida,Expense,leisure,-54.57,-49764.35
buyer_8,Antonio,45,ES47209569543860298423,TRX_N-01162-01878373,2024-09-29T12:33:27,Labastida,Expense,repairs,-105.09,-49869.44
buyer_8,Antonio,45,ES47209569543860298423,TRX_N-01163-65021007,2024-09-29T13:07:06,Portugalete,Expense,gifts,-672.4,-50541.84
buyer_8,Antonio,45,ES47209569543860298423,TRX_N-01164-33880484,2024-09-30T16:17:33,Labastida,Expense,food,-119.4,-50661.24
buyer_8,Antonio,45,ES47209569543860298423,TRX_N-01165-69682026,2024-09-30T11:01:10,Labastida,Expense,leisure,-53.62,-50714.86
buyer_8,Antonio,45,ES47209569543860298423,TRX_N-01166-68174360,2024-10-01T08:59:02,Labastida,incomes,salary,1580.69,-49134.17
buyer_8,Antonio,45,ES47209569543860298423,TRX_N-01167-73392298,2024-10-01T08:59:02,Labastida,incomes,salary_partner,1718.95,-47415.22
buyer_8,Antonio,45,ES47209569543860298423,TRX_N-01168-47009994,2024-10-01T09:42:35,Labastida,Expense,cash,-100.0,-47515.22
buyer_8,Antonio,45,ES47209569543860298423,TRX_N-01169-65221435,2024-10-04T12:34:34,Labastida,expenses,mortgage,-842.18,-48357.4
buyer_8,Antonio,45,ES47209569543860298423,TRX_N-01170-63637239,2024-10-05T15:45:51,Labastida,expenses,water,-31.71,-48389.11
buyer_8,Antonio,45,ES47209569543860298423,TRX_N-01171-34004292,2024-10-05T20:32:26,Labastida,expenses,electricity,-85.76,-48474.87
buyer_8,Antonio,45,ES47209569543860298423,TRX_N-01172-37549714,2024-10-05T18:17:55,Labastida,Expense,food,-110.48,-48585.35
buyer_8,Antonio,45,ES47209569543860298423,TRX_N-01173-06077782,2024-10-05T08:38:11,Labastida,Expense,education,-56.99,-48642.34
buyer_8,Antonio,45,ES47209569543860298423,TRX_N-01174-48334419,2024-10-06T12:57:00,Labastida,Expense,transport,-89.52,-48731.86
buyer_8,Antonio,45,ES47209569543860298423,TRX_N-01175-15728065,2024-10-06T08:42:52,Mungia,Expense,education,-43.99,-48775.85
buyer_8,Antonio,45,ES47209569543860298423,TRX_N-01176-23083625,2024-10-07T13:26:05,Labastida,expenses,gas,-50.05,-48825.9
buyer_8,Antonio,45,ES47209569543860298423,TRX_N-01177-40207876,2024-10-07T16:41:18,Labastida,expenses,phone,-41.08,-48866.98
buyer_8,Antonio,45,ES47209569543860298423,TRX_N-01178-78663786,2024-10-08T18:40:00,Labastida,expenses,internet,-42.0,-48908.98
buyer_8,Antonio,45,ES47209569543860298423,TRX_N-01179-54668856,2024-10-08T18:17:53,Labastida,Expense,repairs,-207.27,-49116.25
