profile,name,age,iban,trx_id,timestamp,city,trx_type,trx_cat,amount_eur,balance
buyer_1,Luis,28,ES28209599118326557478,TRX_N-00001-71592386,2022-01-01T22:10:26,Bilbao,incomes,salary,1265.98,1384.69
buyer_1,Luis,28,ES28209599118326557478,TRX_N-00002-85251273,2022-01-01T14:02:54,Bilbao,Expense,transport,-245.05,1139.64
buyer_1,Luis,28,ES28209599118326557478,TRX_N-00003-22208311,2022-01-01T19:53:37,Salvatierra/Agurain,Expense,leisure,-255.22,884.42
buyer_1,Luis,28,ES28209599118326557478,TRX_N-00004-77207221,2022-01-01T20:43:22,Bilbao,Expense,clothing,-354.15,530.27
buyer_1,Luis,28,ES28209599118326557478,TRX_N-00005-58902267,2022-01-02T20:25:52,Bilbao,Expense,transport,-459.47,70.8
buyer_1,Luis,28,ES28209599118326557478,TRX_N-00006-72688694,2022-01-02T13:32:55,Bilbao,Expense,transport,-77.34,-6.54
buyer_1,Luis,28,ES28209599118326557478,TRX_N-00007-41405965,2022-01-02T13:00:59,Labastida,Expense,personal_care,-70.49,-77.03
buyer_1,Luis,28,ES28209599118326557478,TRX_N-00008-77407856,2022-01-03T13:53:50,Bilbao,Expense,healthcare,-37.58,-114.61
buyer_1,Luis,28,ES28209599118326557478,TRX_N-00009-71852852,2022-01-03T21:07:23,Bilbao,Expense,car,-276.75,-391.36
buyer_1,Luis,28,ES28209599118326557478,TRX_N-00010-36823624,2022-01-03T19:03:49,Bilbao,Expense,transport,-223.23,-614.59
buyer_1,Luis,28,ES28209599118326557478,TRX_N-00011-03838704,2022-01-04T04:26:23,Bilbao,Housing,Rent,-1369.49,-1984.08
buyer_1,Luis,28,ES28209599118326557478,TRX_N-00012-05521676,2022-01-04T03:27:13,Bilbao,Expense,car,-361.85,-2345.93
buyer_1,Luis,28,ES28209599118326557478,TRX_N-00013-78374548,2022-01-04T12:05:13,Bilbao,Expense,technology,-162.41,-2508.34
buyer_1,Luis,28,ES28209599118326557478,TRX_N-00014-92087017,2022-01-04T17:59:45,Vitoria-Gasteiz,Expense,food,-199.82,-2708.16
buyer_1,Luis,28,ES28209599118326557478,TRX_N-00015-60471662,2022-01-05T11:35:04,Bilbao,basic_services,water,-40.14,-2748.3
buyer_1,Luis,28,ES28209599118326557478,TRX_N-00016-10280781,2022-01-05T19:28:33,Bilbao,basic_services,electricity,-118.61,-2866.91
buyer_1,Luis,28,ES28209599118326557478,TRX_N-00017-84727949,2022-01-05T18:27:05,Bilbao,basic_services,phone,-47.02,-2913.93
buyer_1,Luis,28,ES28209599118326557478,TRX_N-00018-89248331,2022-01-05T20:36:29,Bilbao,Expense,savings,-280.33,-3194.26
buyer_1,Luis,28,ES28209599118326557478,TRX_N-00019-20127034,2022-01-05T18:18:04,Bilbao,Expense,personal_care,-463.33,-3657.59
buyer_1,Luis,28,ES28209599118326557478,TRX_N-00020-88630978,2022-01-05T12:16:59,Bilbao,Expense,technology,-175.99,-3833.58
buyer_1,Luis,28,ES28209599118326557478,TRX_N-00021-57469189,2022-01-06T17:06:12,Bilbao,basic_services,internet,-72.55,-3906.13
buyer_1,Luis,28,ES28209599118326557478,TRX_N-00022-90074654,2022-01-06T16:23:36,Bilbao,Expense,basic-services,-430.3,-4336.43
buyer_1,Luis,28,ES28209599118326557478,TRX_N-00023-31044444,2022-01-06T08:10:19,Bilbao,Expense,basic-services,-231.46,-4567.89
buyer_1,Luis,28,ES28209599118326557478,TRX_N-00024-99326255,2022-01-06T05:08:30,Sestao,Expense,transport,-98.92,-4666.81
buyer_1,Luis,28,ES28209599118326557478,TRX_N-00025-67564378,2022-01-07T19:06:04,Bilbao,Expense,clothing,-446.01,-5112.82
buyer_1,Luis,28,ES28209599118326557478,TRX_N-00026-29431301,2022-01-07T19:30:32,Bilbao,Expense,healthcare,-263.17,-5375.99
buyer_1,Luis,28,ES28209599118326557478,TRX_N-00027-24442174,2022-01-07T19:24:16,Bilbao,Expense,clothing,-498.96,-5874.95
buyer_1,Luis,28,ES28209599118326557478,TRX_N-00028-47633299,2022-01-08T05:24:50,Bilbao,basic_services,gas,-87.12,-5962.07
buyer_1,Luis,28,ES28209599118326557478,TRX_N-00029-80096937,2022-01-08T18:53:45,Bilbao,Expense,transport,-133.85,-6095.92
buyer_1,Luis,28,ES28209599118326557478,TRX_N-00030-69552594,2022-01-08T18:12:21,Bilbao,Expense,basic-services,-294.32,-6390.24
buyer_1,Luis,28,ES28209599118326557478,TRX_N-00031-97091321,2022-01-08T17:55:38,Bilbao,Expense,technology,-224.4,-6614.64
buyer_1,Luis,28,ES28209599118326557478,TRX_N-00032-07879675,2022-01-09T17:57:00,Bilbao,Expense,loans,-390.71,-7005.35
buyer_1,Luis,28,ES28209599118326557478,TRX_N-00033-79024159,2022-01-09T15:27:47,Bilbao,Expense,healthcare,-447.23,-7452.58
buyer_1,Luis,28,ES28209599118326557478,TRX_N-00034-36924604,2022-01-09T13:18:34,Bilbao,Expense,clothing,-315.84,-7768.42
buyer_1,Luis,28,ES28209599118326557478,TRX_N-00035-75819201,2022-01-10T08:06:12,Bilbao,Expense,leisure,-295.0,-8063.42
buyer_1,Luis,28,ES28209599118326557478,TRX_N-00036-50924717,2022-01-10T10:41:19,Bilbao,Expense,food,-302.91,-8366.33
buyer_1,Luis,28,ES28209599118326557478,TRX_N-00037-63524853,2022-01-10T10:22:01,Bilbao,Expense,transport,-55.22,-8421.55
buyer_1,Luis,28,ES28209599118326557478,TRX_N-00038-04660360,2022-01-11T10:10:05,Bilbao,Expense,children,-388.26,-8809.81
buyer_1,Luis,28,ES28209599118326557478,TRX_N-00039-87572443,2022-01-11T15:17:22,Bilbao,Expense,technology,-24.34,-8834.15
buyer_1,Luis,28,ES28209599118326557478,TRX_N-00040-60654143,2022-01-11T10:12:44,Bilbao,Expense,transport,-286.49,-9120.64
buyer_1,Luis,28,ES28209599118326557478,TRX_N-00041-03062819,2022-01-12T18:20:23,Eibar,Expense,leisure,-162.53,-9283.17
buyer_1,Luis,28,ES28209599118326557478,TRX_N-00042-90496754,2022-01-12T16:51:10,Bilbao,Expense,personal_care,-126.42,-9409.59
buyer_1,Luis,28,ES28209599118326557478,TRX_N-00043-27660205,2022-01-12T14:51:06,Bilbao,Expense,children,-463.66,-9873.25
buyer_1,Luis,28,ES28209599118326557478,TRX_N-00044-56025928,2022-01-13T09:16:00,Bilbao,Expense,healthcare,-472.88,-10346.13
buyer_1,Luis,28,ES28209599118326557478,TRX_N-00045-56044079,2022-01-13T08:29:04,Bilbao,Expense,food,-204.51,-10550.64
buyer_1,Luis,28,ES28209599118326557478,TRX_N-00046-98368902,2022-01-13T14:43:23,Bilbao,Expense,transport,-425.96,-10976.6
buyer_1,Luis,28,ES28209599118326557478,TRX_N-00047-39334299,2022-01-14T12:17:23,Bilbao,Expense,loans,-469.02,-11445.62
buyer_1,Luis,28,ES28209599118326557478,TRX_N-00048-30383842,2022-01-14T16:43:51,Donostia,Expense,housing,-403.88,-11849.5
buyer_1,Luis,28,ES28209599118326557478,TRX_N-00049-60279827,2022-01-14T21:39:17,Berango,Expense,savings,-385.4,-12234.9
buyer_1,Luis,28,ES28209599118326557478,TRX_N-00050-75056346,2022-01-15T15:40:03,Bilbao,Expense,children,-222.4,-12457.3
buyer_1,Luis,28,ES28209599118326557478,TRX_N-00051-55262750,2022-01-15T17:21:35,Bilbao,Expense,food,-347.55,-12804.85
buyer_1,Luis,28,ES28209599118326557478,TRX_N-00052-94916420,2022-01-15T13:14:25,Zarautz,Expense,transport,-209.82,-13014.67
buyer_1,Luis,28,ES28209599118326557478,TRX_N-00053-98693254,2022-01-16T16:00:37,Bilbao,Expense,housing,-116.48,-13131.15
buyer_1,Luis,28,ES28209599118326557478,TRX_N-00054-34968006,2022-01-16T09:33:10,Irun,Expense,subscriptions,-240.88,-13372.03
buyer_1,Luis,28,ES28209599118326557478,TRX_N-00055-08793028,2022-01-16T16:04:07,Bilbao,Expense,personal_care,-192.02,-13564.05
buyer_1,Luis,28,ES28209599118326557478,TRX_N-00056-42435839,2022-01-17T17:42:43,Bilbao,Expense,savings,-94.96,-13659.01
buyer_1,Luis,28,ES28209599118326557478,TRX_N-00057-47077135,2022-01-17T20:44:51,Amurrio,Expense,personal_care,-292.53,-13951.54
buyer_1,Luis,28,ES28209599118326557478,TRX_N-00058-99060526,2022-01-17T22:50:11,Bilbao,Expense,education,-81.2,-14032.74
buyer_1,Luis,28,ES28209599118326557478,TRX_N-00059-31067335,2022-01-18T19:29:07,Bilbao,Expense,savings,-139.56,-14172.3
buyer_1,Luis,28,ES28209599118326557478,TRX_N-00060-13659865,2022-01-18T10:45:46,Bilbao,Expense,healthcare,-44.99,-14217.29
buyer_1,Luis,28,ES28209599118326557478,TRX_N-00061-65041412,2022-01-18T11:00:55,Bilbao,Expense,subscriptions,-347.34,-14564.63
buyer_1,Luis,28,ES28209599118326557478,TRX_N-00062-77689383,2022-01-19T20:54:43,Mungia,Expense,personal_care,-124.95,-14689.58
buyer_1,Luis,28,ES28209599118326557478,TRX_N-00063-53062723,2022-01-19T19:35:40,Bilbao,Expense,food,-303.44,-14993.02
buyer_1,Luis,28,ES28209599118326557478,TRX_N-00064-45272449,2022-01-19T04:30:31,Bilbao,Expense,subscriptions,-415.95,-15408.97
buyer_1,Luis,28,ES28209599118326557478,TRX_N-00065-44466052,2022-01-20T15:58:20,Bilbao,Expense,food,-50.95,-15459.92
buyer_1,Luis,28,ES28209599118326557478,TRX_N-00066-30168185,2022-01-20T14:56:21,Bilbao,Expense,technology,-264.22,-15724.14
buyer_1,Luis,28,ES28209599118326557478,TRX_N-00067-05348502,2022-01-20T19:41:35,Bilbao,Expense,basic-services,-149.53,-15873.67
buyer_1,Luis,28,ES28209599118326557478,TRX_N-00068-80435135,2022-01-21T12:24:37,Bilbao,Expense,healthcare,-270.59,-16144.26
buyer_1,Luis,28,ES28209599118326557478,TRX_N-00069-58973217,2022-01-21T18:56:56,Llodio,Expense,personal_care,-273.59,-16417.85
buyer_1,Luis,28,ES28209599118326557478,TRX_N-00070-35769427,2022-01-21T10:45:35,Bilbao,Expense,savings,-275.97,-16693.82
buyer_1,Luis,28,ES28209599118326557478,TRX_N-00071-68081986,2022-01-22T13:55:47,Alegría-Dulantzi,Expense,basic-services,-387.31,-17081.13
buyer_1,Luis,28,ES28209599118326557478,TRX_N-00072-59577941,2022-01-22T09:57:14,Bilbao,Expense,children,-354.77,-17435.9
buyer_1,Luis,28,ES28209599118326557478,TRX_N-00073-77728801,2022-01-22T08:26:30,Bilbao,Expense,savings,-298.96,-17734.86
buyer_1,Luis,28,ES28209599118326557478,TRX_N-00074-60958638,2022-01-23T15:09:54,Erandio,Expense,leisure,-261.7,-17996.56
buyer_1,Luis,28,ES28209599118326557478,TRX_N-00075-40354311,2022-01-23T05:39:17,Bilbao,Expense,technology,-201.55,-18198.11
buyer_1,Luis,28,ES28209599118326557478,TRX_N-00076-17464956,2022-01-23T08:20:06,Bilbao,Expense,healthcare,-80.71,-18278.82
buyer_1,Luis,28,ES28209599118326557478,TRX_N-00077-90196406,2022-01-24T12:59:25,Bilbao,Expense,healthcare,-254.39,-18533.21
buyer_1,Luis,28,ES28209599118326557478,TRX_N-00078-21996665,2022-01-24T08:23:44,Bilbao,Expense,car,-271.47,-18804.68
buyer_1,Luis,28,ES28209599118326557478,TRX_N-00079-63187798,2022-01-24T03:32:54,Alegría-Dulantzi,Expense,children,-428.61,-19233.29
buyer_1,Luis,28,ES28209599118326557478,TRX_N-00080-46730428,2022-01-25T04:40:03,Pasaia,Expense,leisure,-457.5,-19690.79
buyer_1,Luis,28,ES28209599118326557478,TRX_N-00081-47217632,2022-01-25T10:03:46,Bilbao,Expense,technology,-378.11,-20068.9
buyer_1,Luis,28,ES28209599118326557478,TRX_N-00082-06559570,2022-01-25T10:47:10,Bilbao,Expense,clothing,-481.64,-20550.54
buyer_1,Luis,28,ES28209599118326557478,TRX_N-00083-99567836,2022-01-26T16:40:40,Getxo,Expense,transport,-333.14,-20883.68
buyer_1,Luis,28,ES28209599118326557478,TRX_N-00084-24157295,2022-01-26T10:33:25,Bilbao,Expense,subscriptions,-442.52,-21326.2
buyer_1,Luis,28,ES28209599118326557478,TRX_N-00085-81620386,2022-01-26T18:02:49,Bilbao,Expense,basic-services,-349.69,-21675.89
buyer_1,Luis,28,ES28209599118326557478,TRX_N-00086-24816131,2022-01-27T15:26:57,Bilbao,Expense,clothing,-303.0,-21978.89
buyer_1,Luis,28,ES28209599118326557478,TRX_N-00087-54678842,2022-01-27T09:54:02,Zarautz,Expense,technology,-199.48,-22178.37
buyer_1,Luis,28,ES28209599118326557478,TRX_N-00088-27601274,2022-01-27T11:59:40,Bilbao,Expense,car,-215.85,-22394.22
buyer_1,Luis,28,ES28209599118326557478,TRX_N-00089-62903946,2022-01-28T08:06:33,Bilbao,Expense,personal_care,-219.15,-22613.37
buyer_1,Luis,28,ES28209599118326557478,TRX_N-00090-07117341,2022-01-28T15:57:27,Bilbao,Expense,clothing,-139.87,-22753.24
buyer_1,Luis,28,ES28209599118326557478,TRX_N-00091-17550447,2022-01-28T11:08:44,Bilbao,Expense,car,-319.05,-23072.29
buyer_1,Luis,28,ES28209599118326557478,TRX_N-00092-69118054,2022-01-29T13:33:40,Berango,Expense,healthcare,-159.22,-23231.51
buyer_1,Luis,28,ES28209599118326557478,TRX_N-00093-31974482,2022-01-29T15:37:45,Bilbao,Expense,savings,-464.92,-23696.43
buyer_1,Luis,28,ES28209599118326557478,TRX_N-00094-36519995,2022-01-29T07:02:11,Bilbao,Expense,savings,-412.48,-24108.91
buyer_1,Luis,28,ES28209599118326557478,TRX_N-00095-30514987,2022-01-30T14:25:01,Bilbao,Expense,healthcare,-160.23,-24269.14
buyer_1,Luis,28,ES28209599118326557478,TRX_N-00096-60111332,2022-01-30T17:29:15,Bilbao,Expense,basic-services,-46.09,-24315.23
buyer_1,Luis,28,ES28209599118326557478,TRX_N-00097-10688801,2022-01-30T12:14:51,Salvatierra/Agurain,Expense,food,-453.34,-24768.57
buyer_1,Luis,28,ES28209599118326557478,TRX_N-00098-30801282,2022-01-31T19:01:48,Bilbao,Expense,loans,-374.73,-25143.3
buyer_1,Luis,28,ES28209599118326557478,TRX_N-00099-92005793,2022-01-31T12:20:27,Bilbao,Expense,basic-services,-123.08,-25266.38
buyer_1,Luis,28,ES28209599118326557478,TRX_N-00100-75907473,2022-01-31T19:28:48,Galdakao,Expense,savings,-119.25,-25385.63
buyer_1,Luis,28,ES28209599118326557478,TRX_N-00101-57000889,2022-02-01T13:52:02,Bilbao,incomes,salary,1265.98,-24119.65
buyer_1,Luis,28,ES28209599118326557478,TRX_N-00102-12086819,2022-02-01T00:02:26,Barakaldo,Expense,savings,-255.55,-24375.2
buyer_1,Luis,28,ES28209599118326557478,TRX_N-00103-70234201,2022-02-01T17:18:42,Bilbao,Expense,technology,-465.94,-24841.14
buyer_1,Luis,28,ES28209599118326557478,TRX_N-00104-71737003,2022-02-01T14:54:21,Bilbao,Expense,subscriptions,-202.38,-25043.52
buyer_1,Luis,28,ES28209599118326557478,TRX_N-00105-13275037,2022-02-02T11:20:46,Andoain,Expense,housing,-229.37,-25272.89
buyer_1,Luis,28,ES28209599118326557478,TRX_N-00106-00204359,2022-02-02T00:43:45,Bilbao,Expense,children,-247.13,-25520.02
buyer_1,Luis,28,ES28209599118326557478,TRX_N-00107-40410380,2022-02-02T22:25:06,Bilbao,Expense,technology,-99.55,-25619.57
buyer_1,Luis,28,ES28209599118326557478,TRX_N-00108-10680015,2022-02-03T13:54:23,Alegría-Dulantzi,Expense,clothing,-87.3,-25706.87
buyer_1,Luis,28,ES28209599118326557478,TRX_N-00109-07164695,2022-02-03T11:52:59,Bilbao,Expense,personal_care,-424.88,-26131.75
buyer_1,Luis,28,ES28209599118326557478,TRX_N-00110-20661628,2022-02-03T16:42:31,Bilbao,Expense,leisure,-177.01,-26308.76
buyer_1,Luis,28,ES28209599118326557478,TRX_N-00111-93640948,2022-02-04T12:02:25,Bilbao,Housing,Rent,-1369.49,-27678.25
buyer_1,Luis,28,ES28209599118326557478,TRX_N-00112-39185678,2022-02-04T19:51:56,Bilbao,Expense,personal_care,-50.54,-27728.79
buyer_1,Luis,28,ES28209599118326557478,TRX_N-00113-72681225,2022-02-04T15:20:05,Bilbao,Expense,education,-401.57,-28130.36
buyer_1,Luis,28,ES28209599118326557478,TRX_N-00114-55314136,2022-02-04T15:07:59,Getxo,Expense,car,-166.63,-28296.99
buyer_1,Luis,28,ES28209599118326557478,TRX_N-00115-97921715,2022-02-05T11:29:00,Bilbao,Expense,savings,-439.87,-28736.86
buyer_1,Luis,28,ES28209599118326557478,TRX_N-00116-58174787,2022-02-05T14:19:33,Bilbao,Expense,children,-366.65,-29103.51
buyer_1,Luis,28,ES28209599118326557478,TRX_N-00117-04981083,2022-02-05T23:56:48,Bilbao,Expense,transport,-303.95,-29407.46
buyer_1,Luis,28,ES28209599118326557478,TRX_N-00118-61879039,2022-02-06T15:27:01,Bilbao,basic_services,phone,-91.48,-29498.94
buyer_1,Luis,28,ES28209599118326557478,TRX_N-00119-50865150,2022-02-06T23:43:57,Oyón-Oion,Expense,subscriptions,-128.65,-29627.59
buyer_1,Luis,28,ES28209599118326557478,TRX_N-00120-62948702,2022-02-06T15:02:34,Bilbao,Expense,clothing,-383.57,-30011.16
buyer_1,Luis,28,ES28209599118326557478,TRX_N-00121-35774530,2022-02-06T21:34:51,Bilbao,Expense,children,-62.04,-30073.2
buyer_1,Luis,28,ES28209599118326557478,TRX_N-00122-04623823,2022-02-07T22:20:22,Bilbao,basic_services,gas,-49.46,-30122.66
buyer_1,Luis,28,ES28209599118326557478,TRX_N-00123-56830012,2022-02-07T01:31:34,Bilbao,basic_services,internet,-74.92,-30197.58
buyer_1,Luis,28,ES28209599118326557478,TRX_N-00124-03803183,2022-02-07T19:24:47,Bilbao,Expense,housing,-415.39,-30612.97
buyer_1,Luis,28,ES28209599118326557478,TRX_N-00125-86110896,2022-02-07T17:44:11,Bilbao,Expense,savings,-343.9,-30956.87
buyer_1,Luis,28,ES28209599118326557478,TRX_N-00126-77615775,2022-02-07T19:10:06,Bilbao,Expense,savings,-191.41,-31148.28
buyer_1,Luis,28,ES28209599118326557478,TRX_N-00127-45844131,2022-02-08T17:03:50,Bilbao,basic_services,water,-68.83,-31217.11
buyer_1,Luis,28,ES28209599118326557478,TRX_N-00128-38343096,2022-02-08T17:28:40,Bilbao,basic_services,electricity,-57.38,-31274.49
buyer_1,Luis,28,ES28209599118326557478,TRX_N-00129-05662583,2022-02-08T10:47:23,Bilbao,Expense,loans,-10.33,-31284.82
buyer_1,Luis,28,ES28209599118326557478,TRX_N-00130-03959386,2022-02-08T19:05:19,Bilbao,Expense,savings,-206.17,-31490.99
buyer_1,Luis,28,ES28209599118326557478,TRX_N-00131-25054375,2022-02-08T10:25:56,Bilbao,Expense,housing,-463.56,-31954.55
buyer_1,Luis,28,ES28209599118326557478,TRX_N-00132-35629414,2022-02-09T13:14:26,Bilbao,Expense,loans,-15.61,-31970.16
buyer_1,Luis,28,ES28209599118326557478,TRX_N-00133-50130118,2022-02-09T12:26:29,Bilbao,Expense,leisure,-28.52,-31998.68
buyer_1,Luis,28,ES28209599118326557478,TRX_N-00134-55944266,2022-02-09T17:21:02,Bilbao,Expense,food,-318.86,-32317.54
buyer_1,Luis,28,ES28209599118326557478,TRX_N-00135-57657095,2022-02-10T11:43:32,Bilbao,Expense,car,-350.24,-32667.78
buyer_1,Luis,28,ES28209599118326557478,TRX_N-00136-39883917,2022-02-10T10:48:10,Bilbao,Expense,savings,-351.39,-33019.17
buyer_1,Luis,28,ES28209599118326557478,TRX_N-00137-59667922,2022-02-10T14:50:08,Bilbao,Expense,loans,-386.12,-33405.29
buyer_1,Luis,28,ES28209599118326557478,TRX_N-00138-57964959,2022-02-11T11:22:52,Bilbao,Expense,savings,-402.12,-33807.41
buyer_1,Luis,28,ES28209599118326557478,TRX_N-00139-12028759,2022-02-11T04:47:16,Basauri,Expense,food,-185.37,-33992.78
buyer_1,Luis,28,ES28209599118326557478,TRX_N-00140-45527274,2022-02-11T16:16:32,Bilbao,Expense,loans,-173.47,-34166.25
buyer_1,Luis,28,ES28209599118326557478,TRX_N-00141-83126816,2022-02-12T16:38:42,Bilbao,Expense,car,-178.12,-34344.37
buyer_1,Luis,28,ES28209599118326557478,TRX_N-00142-76343679,2022-02-12T14:08:47,Bilbao,Expense,subscriptions,-446.1,-34790.47
buyer_1,Luis,28,ES28209599118326557478,TRX_N-00143-57833136,2022-02-12T12:01:52,Bilbao,Expense,subscriptions,-421.51,-35211.98
buyer_1,Luis,28,ES28209599118326557478,TRX_N-00144-40476971,2022-02-13T16:26:10,Bilbao,Expense,basic-services,-136.17,-35348.15
buyer_1,Luis,28,ES28209599118326557478,TRX_N-00145-45968462,2022-02-13T23:49:51,Bilbao,Expense,healthcare,-47.28,-35395.43
buyer_1,Luis,28,ES28209599118326557478,TRX_N-00146-47473276,2022-02-13T16:03:39,Bilbao,Expense,housing,-473.27,-35868.7
buyer_1,Luis,28,ES28209599118326557478,TRX_N-00147-11147584,2022-02-14T16:25:02,Bilbao,Expense,loans,-90.79,-35959.49
buyer_1,Luis,28,ES28209599118326557478,TRX_N-00148-50392058,2022-02-14T11:28:58,Bilbao,Expense,healthcare,-97.87,-36057.36
buyer_1,Luis,28,ES28209599118326557478,TRX_N-00149-35040200,2022-02-14T03:45:46,Bilbao,Expense,basic-services,-344.36,-36401.72
buyer_1,Luis,28,ES28209599118326557478,TRX_N-00150-73430786,2022-02-15T19:34:18,Bilbao,Expense,housing,-296.83,-36698.55
buyer_1,Luis,28,ES28209599118326557478,TRX_N-00151-65064983,2022-02-15T20:56:35,Bilbao,Expense,car,-462.12,-37160.67
buyer_1,Luis,28,ES28209599118326557478,TRX_N-00152-59159993,2022-02-15T10:05:03,Bilbao,Expense,basic-services,-91.02,-37251.69
buyer_1,Luis,28,ES28209599118326557478,TRX_N-00153-89194358,2022-02-16T15:51:23,Bilbao,Expense,education,-124.42,-37376.11
buyer_1,Luis,28,ES28209599118326557478,TRX_N-00154-52952277,2022-02-16T22:56:12,Bilbao,Expense,food,-122.19,-37498.3
buyer_1,Luis,28,ES28209599118326557478,TRX_N-00155-07782781,2022-02-16T11:03:30,Bilbao,Expense,leisure,-128.29,-37626.59
buyer_1,Luis,28,ES28209599118326557478,TRX_N-00156-05234994,2022-02-17T17:48:17,Bilbao,Expense,healthcare,-45.27,-37671.86
buyer_1,Luis,28,ES28209599118326557478,TRX_N-00157-51067853,2022-02-17T15:59:07,Bilbao,Expense,leisure,-416.25,-38088.11
buyer_1,Luis,28,ES28209599118326557478,TRX_N-00158-28360144,2022-02-17T17:11:09,Bilbao,Expense,housing,-384.29,-38472.4
buyer_1,Luis,28,ES28209599118326557478,TRX_N-00159-54082558,2022-02-18T09:18:06,Bilbao,Expense,food,-462.97,-38935.37
buyer_1,Luis,28,ES28209599118326557478,TRX_N-00160-66255994,2022-02-18T08:10:54,Bilbao,Expense,personal_care,-136.47,-39071.84
buyer_1,Luis,28,ES28209599118326557478,TRX_N-00161-24886177,2022-02-18T11:57:07,Bilbao,Expense,loans,-80.58,-39152.42
buyer_1,Luis,28,ES28209599118326557478,TRX_N-00162-39679165,2022-02-19T10:19:03,Bilbao,Expense,loans,-87.85,-39240.27
buyer_1,Luis,28,ES28209599118326557478,TRX_N-00163-70263697,2022-02-19T13:36:51,Sestao,Expense,subscriptions,-205.29,-39445.56
buyer_1,Luis,28,ES28209599118326557478,TRX_N-00164-67623769,2022-02-19T15:16:32,Bilbao,Expense,technology,-183.34,-39628.9
buyer_1,Luis,28,ES28209599118326557478,TRX_N-00165-79581428,2022-02-20T19:09:50,Labastida,Expense,children,-202.82,-39831.72
buyer_1,Luis,28,ES28209599118326557478,TRX_N-00166-24476340,2022-02-20T08:25:14,Bilbao,Expense,housing,-423.58,-40255.3
buyer_1,Luis,28,ES28209599118326557478,TRX_N-00167-12871390,2022-02-20T16:32:27,Bilbao,Expense,healthcare,-479.4,-40734.7
buyer_1,Luis,28,ES28209599118326557478,TRX_N-00168-09555419,2022-02-21T23:14:18,Andoain,Expense,healthcare,-92.66,-40827.36
buyer_1,Luis,28,ES28209599118326557478,TRX_N-00169-11561184,2022-02-21T14:44:53,Bilbao,Expense,children,-211.85,-41039.21
buyer_1,Luis,28,ES28209599118326557478,TRX_N-00170-77064199,2022-02-21T08:24:02,Bilbao,Expense,housing,-442.97,-41482.18
buyer_1,Luis,28,ES28209599118326557478,TRX_N-00171-69352935,2022-02-22T06:10:59,Bilbao,Expense,savings,-169.03,-41651.21
buyer_1,Luis,28,ES28209599118326557478,TRX_N-00172-79184251,2022-02-22T15:35:47,Bilbao,Expense,housing,-207.0,-41858.21
buyer_1,Luis,28,ES28209599118326557478,TRX_N-00173-40653603,2022-02-22T08:44:12,Bilbao,Expense,technology,-358.72,-42216.93
buyer_1,Luis,28,ES28209599118326557478,TRX_N-00174-83949334,2022-02-23T14:31:17,Elciego,Expense,personal_care,-87.37,-42304.3
buyer_1,Luis,28,ES28209599118326557478,TRX_N-00175-66067927,2022-02-23T20:25:15,Bilbao,Expense,clothing,-179.0,-42483.3
buyer_1,Luis,28,ES28209599118326557478,TRX_N-00176-65080755,2022-02-23T14:48:09,Bilbao,Expense,car,-279.9,-42763.2
buyer_1,Luis,28,ES28209599118326557478,TRX_N-00177-16254591,2022-02-24T18:29:41,Lasarte-Oria,Expense,children,-331.71,-43094.91
buyer_1,Luis,28,ES28209599118326557478,TRX_N-00178-76800840,2022-02-24T12:56:51,Bilbao,Expense,car,-345.77,-43440.68
buyer_1,Luis,28,ES28209599118326557478,TRX_N-00179-69768529,2022-02-24T18:58:37,Bilbao,Expense,education,-113.64,-43554.32
buyer_1,Luis,28,ES28209599118326557478,TRX_N-00180-04107345,2022-02-25T23:03:55,Alegría-Dulantzi,Expense,education,-271.02,-43825.34
buyer_1,Luis,28,ES28209599118326557478,TRX_N-00181-24477421,2022-02-25T20:59:34,Bilbao,Expense,leisure,-183.34,-44008.68
buyer_1,Luis,28,ES28209599118326557478,TRX_N-00182-58447629,2022-02-25T19:43:22,Leioa,Expense,subscriptions,-147.32,-44156.0
buyer_1,Luis,28,ES28209599118326557478,TRX_N-00183-03055994,2022-02-26T09:29:42,Bilbao,Expense,clothing,-47.79,-44203.79
buyer_1,Luis,28,ES28209599118326557478,TRX_N-00184-15359584,2022-02-26T11:55:49,Bilbao,Expense,children,-386.1,-44589.89
buyer_1,Luis,28,ES28209599118326557478,TRX_N-00185-89683899,2022-02-26T08:25:42,Bilbao,Expense,leisure,-291.06,-44880.95
buyer_1,Luis,28,ES28209599118326557478,TRX_N-00186-15673845,2022-02-27T17:36:12,Bilbao,Expense,leisure,-347.9,-45228.85
buyer_1,Luis,28,ES28209599118326557478,TRX_N-00187-59408509,2022-02-27T03:36:33,Santurtzi,Expense,technology,-271.34,-45500.19
buyer_1,Luis,28,ES28209599118326557478,TRX_N-00188-16885197,2022-02-27T12:23:02,Bilbao,Expense,savings,-133.26,-45633.45
buyer_1,Luis,28,ES28209599118326557478,TRX_N-00189-31898213,2022-02-28T17:42:17,Bilbao,Expense,transport,-72.29,-45705.74
buyer_1,Luis,28,ES28209599118326557478,TRX_N-00190-79150898,2022-02-28T17:00:07,Bilbao,Expense,food,-321.75,-46027.49
buyer_1,Luis,28,ES28209599118326557478,TRX_N-00191-52451733,2022-02-28T16:35:31,Basauri,Expense,food,-48.76,-46076.25
buyer_1,Luis,28,ES28209599118326557478,TRX_N-00192-73571005,2022-03-01T10:59:48,Bilbao,incomes,salary,1265.98,-44810.27
buyer_1,Luis,28,ES28209599118326557478,TRX_N-00193-96549807,2022-03-01T10:59:48,Bilbao,incomes,extra_income,126.6,-44683.67
buyer_1,Luis,28,ES28209599118326557478,TRX_N-00194-25781368,2022-03-01T15:00:19,Iruña de Oca,Expense,clothing,-223.5,-44907.17
buyer_1,Luis,28,ES28209599118326557478,TRX_N-00195-59255460,2022-03-01T06:02:09,Bilbao,Expense,car,-188.81,-45095.98
buyer_1,Luis,28,ES28209599118326557478,TRX_N-00196-97304057,2022-03-01T09:57:03,Errenteria,Expense,savings,-164.54,-45260.52
buyer_1,Luis,28,ES28209599118326557478,TRX_N-00197-11649014,2022-03-02T19:30:17,Zarautz,Expense,transport,-12.21,-45272.73
buyer_1,Luis,28,ES28209599118326557478,TRX_N-00198-73559844,2022-03-02T20:53:32,Arrasate,Expense,education,-51.91,-45324.64
buyer_1,Luis,28,ES28209599118326557478,TRX_N-00199-66866408,2022-03-02T11:12:52,Bilbao,Expense,education,-285.91,-45610.55
buyer_1,Luis,28,ES28209599118326557478,TRX_N-00200-36598517,2022-03-03T15:42:18,Bilbao,Expense,basic-services,-265.52,-45876.07
buyer_1,Luis,28,ES28209599118326557478,TRX_N-00201-03644881,2022-03-03T19:24:02,Bilbao,Expense,children,-483.3,-46359.37
buyer_1,Luis,28,ES28209599118326557478,TRX_N-00202-09718066,2022-03-03T13:44:01,Bilbao,Expense,children,-110.01,-46469.38
buyer_1,Luis,28,ES28209599118326557478,TRX_N-00203-82406522,2022-03-04T19:43:06,Bilbao,Housing,Rent,-1369.49,-47838.87
buyer_1,Luis,28,ES28209599118326557478,TRX_N-00204-20870152,2022-03-04T15:52:06,Bilbao,Expense,healthcare,-262.42,-48101.29
buyer_1,Luis,28,ES28209599118326557478,TRX_N-00205-15214590,2022-03-04T19:30:32,Bilbao,Expense,personal_care,-245.59,-48346.88
buyer_1,Luis,28,ES28209599118326557478,TRX_N-00206-17102650,2022-03-04T20:41:23,Portugalete,Expense,car,-124.77,-48471.65
buyer_1,Luis,28,ES28209599118326557478,TRX_N-00207-51678884,2022-03-05T12:44:38,Bilbao,basic_services,electricity,-106.26,-48577.91
buyer_1,Luis,28,ES28209599118326557478,TRX_N-00208-16291300,2022-03-05T13:36:33,Bilbao,basic_services,gas,-17.42,-48595.33
buyer_1,Luis,28,ES28209599118326557478,TRX_N-00209-66090135,2022-03-05T13:04:33,Leioa,Expense,transport,-371.41,-48966.74
buyer_1,Luis,28,ES28209599118326557478,TRX_N-00210-90525151,2022-03-05T10:56:30,Llodio,Expense,loans,-52.28,-49019.02
buyer_1,Luis,28,ES28209599118326557478,TRX_N-00211-64030492,2022-03-05T15:38:02,Lasarte-Oria,Expense,car,-139.14,-49158.16
buyer_1,Luis,28,ES28209599118326557478,TRX_N-00212-77694155,2022-03-06T09:59:50,Bilbao,Expense,healthcare,-387.91,-49546.07
buyer_1,Luis,28,ES28209599118326557478,TRX_N-00213-37955438,2022-03-06T11:54:14,Arrasate,Expense,car,-161.21,-49707.28
buyer_1,Luis,28,ES28209599118326557478,TRX_N-00214-21344797,2022-03-06T12:34:08,Bilbao,Expense,personal_care,-63.35,-49770.63
buyer_1,Luis,28,ES28209599118326557478,TRX_N-00215-32136800,2022-03-07T22:16:33,Bilbao,basic_services,water,-34.26,-49804.89
buyer_1,Luis,28,ES28209599118326557478,TRX_N-00216-85397304,2022-03-07T14:48:24,Bilbao,Expense,clothing,-403.68,-50208.57
buyer_1,Luis,28,ES28209599118326557478,TRX_N-00217-94672721,2022-03-07T15:32:41,Bilbao,Expense,car,-347.58,-50556.15
buyer_1,Luis,28,ES28209599118326557478,TRX_N-00218-43783006,2022-03-07T04:12:47,Hernani,Expense,personal_care,-390.23,-50946.38
buyer_1,Luis,28,ES28209599118326557478,TRX_N-00219-25147929,2022-03-08T14:17:21,Bilbao,basic_services,internet,-63.88,-51010.26
buyer_1,Luis,28,ES28209599118326557478,TRX_N-00220-96121880,2022-03-08T17:02:43,Bilbao,basic_services,phone,-75.8,-51086.06
buyer_1,Luis,28,ES28209599118326557478,TRX_N-00221-49840369,2022-03-08T16:31:40,Oyón-Oion,Expense,basic-services,-350.79,-51436.85
buyer_1,Luis,28,ES28209599118326557478,TRX_N-00222-28835565,2022-03-08T08:37:59,Bilbao,Expense,leisure,-263.41,-51700.26
buyer_1,Luis,28,ES28209599118326557478,TRX_N-00223-01632087,2022-03-08T17:39:13,Elciego,Expense,subscriptions,-392.49,-52092.75
buyer_1,Luis,28,ES28209599118326557478,TRX_N-00224-00646289,2022-03-09T09:10:18,Bilbao,Expense,children,-340.1,-52432.85
buyer_1,Luis,28,ES28209599118326557478,TRX_N-00225-02197491,2022-03-09T13:06:35,Bilbao,Expense,healthcare,-28.46,-52461.31
buyer_1,Luis,28,ES28209599118326557478,TRX_N-00226-82717078,2022-03-09T14:38:48,Bilbao,Expense,savings,-389.28,-52850.59
buyer_1,Luis,28,ES28209599118326557478,TRX_N-00227-25333495,2022-03-10T08:05:35,Bilbao,Expense,transport,-50.52,-52901.11
buyer_1,Luis,28,ES28209599118326557478,TRX_N-00228-88558254,2022-03-10T00:49:34,Bilbao,Expense,leisure,-38.9,-52940.01
buyer_1,Luis,28,ES28209599118326557478,TRX_N-00229-58029401,2022-03-10T15:10:30,Bilbao,Expense,savings,-200.91,-53140.92
buyer_1,Luis,28,ES28209599118326557478,TRX_N-00230-11536660,2022-03-11T10:48:48,Bilbao,Expense,leisure,-452.97,-53593.89
buyer_1,Luis,28,ES28209599118326557478,TRX_N-00231-10022295,2022-03-11T17:36:06,Bilbao,Expense,loans,-236.57,-53830.46
buyer_1,Luis,28,ES28209599118326557478,TRX_N-00232-86035920,2022-03-11T12:49:54,Bilbao,Expense,loans,-171.55,-54002.01
buyer_1,Luis,28,ES28209599118326557478,TRX_N-00233-00385733,2022-03-12T14:06:53,Bilbao,Expense,transport,-159.91,-54161.92
buyer_1,Luis,28,ES28209599118326557478,TRX_N-00234-39936843,2022-03-12T15:38:02,Bilbao,Expense,children,-491.42,-54653.34
buyer_1,Luis,28,ES28209599118326557478,TRX_N-00235-51756922,2022-03-12T16:29:12,Bilbao,Expense,children,-23.16,-54676.5
buyer_1,Luis,28,ES28209599118326557478,TRX_N-00236-97263592,2022-03-13T10:43:21,Bilbao,Expense,healthcare,-456.16,-55132.66
buyer_1,Luis,28,ES28209599118326557478,TRX_N-00237-08380406,2022-03-13T11:43:56,Bilbao,Expense,food,-116.14,-55248.8
buyer_1,Luis,28,ES28209599118326557478,TRX_N-00238-31817210,2022-03-13T17:11:42,Bilbao,Expense,personal_care,-160.11,-55408.91
buyer_1,Luis,28,ES28209599118326557478,TRX_N-00239-73712302,2022-03-14T17:14:11,Bilbao,Expense,healthcare,-65.18,-55474.09
buyer_1,Luis,28,ES28209599118326557478,TRX_N-00240-92085456,2022-03-14T14:42:42,Hernani,Expense,leisure,-390.12,-55864.21
buyer_1,Luis,28,ES28209599118326557478,TRX_N-00241-60101677,2022-03-14T16:00:38,Lasarte-Oria,Expense,personal_care,-110.47,-55974.68
buyer_1,Luis,28,ES28209599118326557478,TRX_N-00242-17404373,2022-03-15T09:12:22,Bilbao,Expense,basic-services,-428.7,-56403.38
buyer_1,Luis,28,ES28209599118326557478,TRX_N-00243-14551243,2022-03-15T16:24:56,Bilbao,Expense,personal_care,-347.78,-56751.16
buyer_1,Luis,28,ES28209599118326557478,TRX_N-00244-70272155,2022-03-15T12:50:59,Irun,Expense,personal_care,-212.37,-56963.53
buyer_1,Luis,28,ES28209599118326557478,TRX_N-00245-51777160,2022-03-16T18:36:03,Bilbao,Expense,food,-236.11,-57199.64
buyer_1,Luis,28,ES28209599118326557478,TRX_N-00246-81916216,2022-03-16T14:24:47,Bilbao,Expense,technology,-440.46,-57640.1
buyer_1,Luis,28,ES28209599118326557478,TRX_N-00247-24672457,2022-03-16T05:27:57,Bilbao,Expense,technology,-276.62,-57916.72
buyer_1,Luis,28,ES28209599118326557478,TRX_N-00248-14614345,2022-03-17T15:19:13,Bilbao,Expense,subscriptions,-140.47,-58057.19
buyer_1,Luis,28,ES28209599118326557478,TRX_N-00249-43339977,2022-03-17T20:14:25,Getxo,Expense,clothing,-317.86,-58375.05
buyer_1,Luis,28,ES28209599118326557478,TRX_N-00250-29104460,2022-03-17T18:26:50,Zuia,Expense,subscriptions,-438.56,-58813.61
buyer_1,Luis,28,ES28209599118326557478,TRX_N-00251-75570674,2022-03-18T08:43:13,Bilbao,Expense,savings,-109.46,-58923.07
buyer_1,Luis,28,ES28209599118326557478,TRX_N-00252-76792656,2022-03-18T23:58:50,Bilbao,Expense,personal_care,-230.48,-59153.55
buyer_1,Luis,28,ES28209599118326557478,TRX_N-00253-12891701,2022-03-18T23:28:32,Bilbao,Expense,personal_care,-466.66,-59620.21
buyer_1,Luis,28,ES28209599118326557478,TRX_N-00254-59798050,2022-03-19T17:51:39,Bilbao,Expense,education,-188.51,-59808.72
buyer_1,Luis,28,ES28209599118326557478,TRX_N-00255-67230134,2022-03-19T11:59:51,Bilbao,Expense,housing,-458.03,-60266.75
buyer_1,Luis,28,ES28209599118326557478,TRX_N-00256-76434535,2022-03-19T18:07:07,Bilbao,Expense,savings,-364.39,-60631.14
buyer_1,Luis,28,ES28209599118326557478,TRX_N-00257-84481342,2022-03-20T11:02:46,Bilbao,Expense,basic-services,-303.41,-60934.55
buyer_1,Luis,28,ES28209599118326557478,TRX_N-00258-67226439,2022-03-20T11:35:59,Bilbao,Expense,leisure,-199.23,-61133.78
buyer_1,Luis,28,ES28209599118326557478,TRX_N-00259-26640569,2022-03-20T13:11:55,Bilbao,Expense,clothing,-274.99,-61408.77
buyer_1,Luis,28,ES28209599118326557478,TRX_N-00260-51825874,2022-03-21T10:08:01,Bilbao,Expense,basic-services,-147.16,-61555.93
buyer_1,Luis,28,ES28209599118326557478,TRX_N-00261-87562326,2022-03-21T10:29:58,Santurtzi,Expense,transport,-152.57,-61708.5
buyer_1,Luis,28,ES28209599118326557478,TRX_N-00262-65355116,2022-03-21T20:21:49,Bilbao,Expense,housing,-441.85,-62150.35
buyer_1,Luis,28,ES28209599118326557478,TRX_N-00263-90097456,2022-03-22T10:29:49,Bilbao,Expense,loans,-411.37,-62561.72
buyer_1,Luis,28,ES28209599118326557478,TRX_N-00264-08931764,2022-03-22T19:22:49,Bilbao,Expense,leisure,-364.45,-62926.17
buyer_1,Luis,28,ES28209599118326557478,TRX_N-00265-32264934,2022-03-22T16:37:23,Donostia,Expense,transport,-32.92,-62959.09
buyer_1,Luis,28,ES28209599118326557478,TRX_N-00266-23052834,2022-03-23T15:25:59,Bilbao,Expense,savings,-218.32,-63177.41
buyer_1,Luis,28,ES28209599118326557478,TRX_N-00267-26414637,2022-03-23T08:28:14,Bilbao,Expense,car,-220.42,-63397.83
buyer_1,Luis,28,ES28209599118326557478,TRX_N-00268-16434278,2022-03-23T10:22:56,Bilbao,Expense,basic-services,-156.45,-63554.28
buyer_1,Luis,28,ES28209599118326557478,TRX_N-00269-45102164,2022-03-24T12:18:58,Bilbao,Expense,personal_care,-233.14,-63787.42
buyer_1,Luis,28,ES28209599118326557478,TRX_N-00270-30076108,2022-03-24T19:26:50,Bilbao,Expense,healthcare,-329.32,-64116.74
buyer_1,Luis,28,ES28209599118326557478,TRX_N-00271-85093586,2022-03-24T14:02:40,Bilbao,Expense,clothing,-153.28,-64270.02
buyer_1,Luis,28,ES28209599118326557478,TRX_N-00272-19585444,2022-03-25T13:54:14,Bilbao,Expense,subscriptions,-420.42,-64690.44
buyer_1,Luis,28,ES28209599118326557478,TRX_N-00273-50581006,2022-03-25T16:02:41,Bilbao,Expense,car,-298.94,-64989.38
buyer_1,Luis,28,ES28209599118326557478,TRX_N-00274-18837508,2022-03-25T18:51:54,Lasarte-Oria,Expense,subscriptions,-438.68,-65428.06
buyer_1,Luis,28,ES28209599118326557478,TRX_N-00275-35505325,2022-03-26T12:40:43,Bilbao,Expense,technology,-324.2,-65752.26
buyer_1,Luis,28,ES28209599118326557478,TRX_N-00276-82945675,2022-03-26T09:37:25,Portugalete,Expense,personal_care,-186.76,-65939.02
buyer_1,Luis,28,ES28209599118326557478,TRX_N-00277-11405175,2022-03-26T23:26:43,Bilbao,Expense,savings,-472.95,-66411.97
buyer_1,Luis,28,ES28209599118326557478,TRX_N-00278-30790773,2022-03-27T10:21:18,Bilbao,Expense,basic-services,-338.02,-66749.99
buyer_1,Luis,28,ES28209599118326557478,TRX_N-00279-77139116,2022-03-27T09:34:07,Bilbao,Expense,children,-95.91,-66845.9
buyer_1,Luis,28,ES28209599118326557478,TRX_N-00280-10554260,2022-03-27T01:34:18,Bilbao,Expense,technology,-482.01,-67327.91
buyer_1,Luis,28,ES28209599118326557478,TRX_N-00281-81679731,2022-03-28T14:55:29,Bilbao,Expense,education,-275.25,-67603.16
buyer_1,Luis,28,ES28209599118326557478,TRX_N-00282-99233677,2022-03-28T08:21:07,Oyón-Oion,Expense,basic-services,-461.65,-68064.81
buyer_1,Luis,28,ES28209599118326557478,TRX_N-00283-09817631,2022-03-28T09:58:04,Santurtzi,Expense,education,-271.65,-68336.46
buyer_1,Luis,28,ES28209599118326557478,TRX_N-00284-57675848,2022-03-29T17:59:58,Labastida,Expense,education,-122.56,-68459.02
buyer_1,Luis,28,ES28209599118326557478,TRX_N-00285-97996123,2022-03-29T13:39:42,Bilbao,Expense,personal_care,-154.63,-68613.65
buyer_1,Luis,28,ES28209599118326557478,TRX_N-00286-12995158,2022-03-29T15:16:36,Bilbao,Expense,car,-246.53,-68860.18
buyer_1,Luis,28,ES28209599118326557478,TRX_N-00287-83200506,2022-03-30T13:02:06,Bilbao,Expense,children,-204.42,-69064.6
buyer_1,Luis,28,ES28209599118326557478,TRX_N-00288-70703771,2022-03-30T11:50:43,Elciego,Expense,savings,-30.42,-69095.02
buyer_1,Luis,28,ES28209599118326557478,TRX_N-00289-06269020,2022-03-30T16:53:22,Bilbao,Expense,savings,-28.28,-69123.3
buyer_1,Luis,28,ES28209599118326557478,TRX_N-00290-00711020,2022-03-31T11:34:15,Bilbao,Expense,education,-87.8,-69211.1
buyer_1,Luis,28,ES28209599118326557478,TRX_N-00291-67836141,2022-03-31T15:49:22,Bilbao,Expense,loans,-21.11,-69232.21
buyer_1,Luis,28,ES28209599118326557478,TRX_N-00292-00666514,2022-03-31T15:36:33,Bilbao,Expense,education,-265.12,-69497.33
buyer_1,Luis,28,ES28209599118326557478,TRX_N-00293-04507118,2022-04-01T19:24:16,Bilbao,incomes,salary,1265.98,-68231.35
buyer_1,Luis,28,ES28209599118326557478,TRX_N-00294-88632755,2022-04-01T12:13:42,Galdakao,Expense,education,-368.84,-68600.19
buyer_1,Luis,28,ES28209599118326557478,TRX_N-00295-48898826,2022-04-01T10:36:51,Bilbao,Expense,transport,-408.28,-69008.47
buyer_1,Luis,28,ES28209599118326557478,TRX_N-00296-39580885,2022-04-01T14:18:45,Bilbao,Expense,clothing,-350.49,-69358.96
buyer_1,Luis,28,ES28209599118326557478,TRX_N-00297-50221719,2022-04-02T20:54:32,Mungia,Expense,food,-383.33,-69742.29
buyer_1,Luis,28,ES28209599118326557478,TRX_N-00298-01750220,2022-04-02T16:04:31,Bilbao,Expense,transport,-187.67,-69929.96
buyer_1,Luis,28,ES28209599118326557478,TRX_N-00299-82212777,2022-04-02T13:33:58,Bilbao,Expense,savings,-435.13,-70365.09
buyer_1,Luis,28,ES28209599118326557478,TRX_N-00300-63334111,2022-04-03T14:15:47,Bilbao,Expense,clothing,-129.23,-70494.32
buyer_1,Luis,28,ES28209599118326557478,TRX_N-00301-55009781,2022-04-03T12:55:17,Bilbao,Expense,housing,-281.06,-70775.38
buyer_1,Luis,28,ES28209599118326557478,TRX_N-00302-06048203,2022-04-03T12:39:21,Bilbao,Expense,housing,-153.55,-70928.93
buyer_1,Luis,28,ES28209599118326557478,TRX_N-00303-17222487,2022-04-04T13:56:25,Bilbao,Housing,Rent,-1369.49,-72298.42
buyer_1,Luis,28,ES28209599118326557478,TRX_N-00304-12460115,2022-04-04T12:03:08,Bilbao,Expense,healthcare,-405.99,-72704.41
buyer_1,Luis,28,ES28209599118326557478,TRX_N-00305-05909621,2022-04-04T09:31:03,Bilbao,Expense,food,-108.93,-72813.34
buyer_1,Luis,28,ES28209599118326557478,TRX_N-00306-37776715,2022-04-04T12:53:39,Bilbao,Expense,education,-198.65,-73011.99
buyer_1,Luis,28,ES28209599118326557478,TRX_N-00307-30690161,2022-04-05T19:31:42,Bilbao,basic_services,water,-65.64,-73077.63
buyer_1,Luis,28,ES28209599118326557478,TRX_N-00308-16331669,2022-04-05T16:09:21,Bilbao,basic_services,gas,-71.15,-73148.78
buyer_1,Luis,28,ES28209599118326557478,TRX_N-00309-61413868,2022-04-05T09:04:05,Bilbao,Expense,car,-353.25,-73502.03
buyer_1,Luis,28,ES28209599118326557478,TRX_N-00310-19167959,2022-04-05T11:39:31,Bilbao,Expense,education,-352.36,-73854.39
buyer_1,Luis,28,ES28209599118326557478,TRX_N-00311-08502531,2022-04-05T15:29:35,Bilbao,Expense,basic-services,-400.88,-74255.27
buyer_1,Luis,28,ES28209599118326557478,TRX_N-00312-71782880,2022-04-06T15:12:07,Hernani,Expense,leisure,-332.17,-74587.44
buyer_1,Luis,28,ES28209599118326557478,TRX_N-00313-05354258,2022-04-06T21:36:50,Bilbao,Expense,leisure,-296.75,-74884.19
buyer_1,Luis,28,ES28209599118326557478,TRX_N-00314-97731043,2022-04-06T08:26:38,Bilbao,Expense,healthcare,-148.0,-75032.19
buyer_1,Luis,28,ES28209599118326557478,TRX_N-00315-58903648,2022-04-07T16:40:43,Bilbao,basic_services,electricity,-28.41,-75060.6
buyer_1,Luis,28,ES28209599118326557478,TRX_N-00316-18512368,2022-04-07T08:40:43,Bilbao,basic_services,internet,-52.1,-75112.7
buyer_1,Luis,28,ES28209599118326557478,TRX_N-00317-46288422,2022-04-07T15:18:51,Bilbao,Expense,children,-78.72,-75191.42
buyer_1,Luis,28,ES28209599118326557478,TRX_N-00318-60064110,2022-04-07T04:28:22,Bilbao,Expense,transport,-293.77,-75485.19
buyer_1,Luis,28,ES28209599118326557478,TRX_N-00319-16141270,2022-04-07T09:25:53,Salvatierra/Agurain,Expense,food,-383.62,-75868.81
buyer_1,Luis,28,ES28209599118326557478,TRX_N-00320-49122302,2022-04-08T17:24:58,Bilbao,basic_services,phone,-51.51,-75920.32
buyer_1,Luis,28,ES28209599118326557478,TRX_N-00321-43979517,2022-04-08T11:15:26,Bilbao,Expense,personal_care,-371.61,-76291.93
buyer_1,Luis,28,ES28209599118326557478,TRX_N-00322-14717051,2022-04-08T19:37:57,Lasarte-Oria,Expense,loans,-253.46,-76545.39
buyer_1,Luis,28,ES28209599118326557478,TRX_N-00323-58035640,2022-04-08T13:07:06,Bilbao,Expense,car,-400.08,-76945.47
buyer_1,Luis,28,ES28209599118326557478,TRX_N-00324-82633319,2022-04-09T15:54:32,Bilbao,Expense,leisure,-43.96,-76989.43
buyer_1,Luis,28,ES28209599118326557478,TRX_N-00325-05038947,2022-04-09T05:18:00,Vitoria-Gasteiz,Expense,car,-48.2,-77037.63
buyer_1,Luis,28,ES28209599118326557478,TRX_N-00326-73147428,2022-04-09T05:43:40,Bilbao,Expense,loans,-431.94,-77469.57
buyer_1,Luis,28,ES28209599118326557478,TRX_N-00327-58725859,2022-04-10T08:08:32,Bilbao,Expense,loans,-243.15,-77712.72
buyer_1,Luis,28,ES28209599118326557478,TRX_N-00328-67862158,2022-04-10T22:03:50,Bilbao,Expense,food,-301.98,-78014.7
buyer_1,Luis,28,ES28209599118326557478,TRX_N-00329-28548737,2022-04-10T22:23:22,Mungia,Expense,leisure,-93.52,-78108.22
buyer_1,Luis,28,ES28209599118326557478,TRX_N-00330-39024296,2022-04-11T15:52:01,Bilbao,Expense,clothing,-133.3,-78241.52
buyer_1,Luis,28,ES28209599118326557478,TRX_N-00331-17488793,2022-04-11T13:53:43,Bilbao,Expense,savings,-419.3,-78660.82
buyer_1,Luis,28,ES28209599118326557478,TRX_N-00332-10327664,2022-04-11T11:49:53,Bilbao,Expense,education,-239.53,-78900.35
buyer_1,Luis,28,ES28209599118326557478,TRX_N-00333-45515969,2022-04-12T04:26:44,Bilbao,Expense,clothing,-29.62,-78929.97
buyer_1,Luis,28,ES28209599118326557478,TRX_N-00334-50255367,2022-04-12T15:50:34,Bilbao,Expense,technology,-47.0,-78976.97
buyer_1,Luis,28,ES28209599118326557478,TRX_N-00335-11064128,2022-04-12T19:24:52,Sestao,Expense,clothing,-82.78,-79059.75
buyer_1,Luis,28,ES28209599118326557478,TRX_N-00336-81504975,2022-04-13T17:39:23,Galdakao,Expense,leisure,-39.5,-79099.25
buyer_1,Luis,28,ES28209599118326557478,TRX_N-00337-38449295,2022-04-13T11:27:47,Bilbao,Expense,transport,-202.61,-79301.86
buyer_1,Luis,28,ES28209599118326557478,TRX_N-00338-74402362,2022-04-13T18:31:36,Bilbao,Expense,education,-437.14,-79739.0
buyer_1,Luis,28,ES28209599118326557478,TRX_N-00339-71275530,2022-04-14T04:45:43,Bilbao,Expense,housing,-151.95,-79890.95
buyer_1,Luis,28,ES28209599118326557478,TRX_N-00340-81941417,2022-04-14T09:03:31,Bilbao,Expense,subscriptions,-388.72,-80279.67
buyer_1,Luis,28,ES28209599118326557478,TRX_N-00341-38424717,2022-04-14T11:18:16,Bilbao,Expense,leisure,-16.47,-80296.14
buyer_1,Luis,28,ES28209599118326557478,TRX_N-00342-91449319,2022-04-15T05:20:01,Elciego,Expense,savings,-35.45,-80331.59
buyer_1,Luis,28,ES28209599118326557478,TRX_N-00343-04857866,2022-04-15T15:07:29,Bilbao,Expense,children,-214.58,-80546.17
buyer_1,Luis,28,ES28209599118326557478,TRX_N-00344-37688996,2022-04-15T12:41:43,Bilbao,Expense,housing,-474.02,-81020.19
buyer_1,Luis,28,ES28209599118326557478,TRX_N-00345-37500618,2022-04-16T11:01:09,Bilbao,Expense,subscriptions,-148.8,-81168.99
buyer_1,Luis,28,ES28209599118326557478,TRX_N-00346-42183338,2022-04-16T12:34:31,Bilbao,Expense,technology,-395.91,-81564.9
buyer_1,Luis,28,ES28209599118326557478,TRX_N-00347-01089085,2022-04-16T16:27:41,Vitoria-Gasteiz,Expense,clothing,-479.93,-82044.83
buyer_1,Luis,28,ES28209599118326557478,TRX_N-00348-22792587,2022-04-17T16:49:40,Basauri,Expense,leisure,-419.84,-82464.67
buyer_1,Luis,28,ES28209599118326557478,TRX_N-00349-29891326,2022-04-17T13:33:17,Bilbao,Expense,food,-187.89,-82652.56
buyer_1,Luis,28,ES28209599118326557478,TRX_N-00350-76871781,2022-04-17T08:35:56,Barakaldo,Expense,basic-services,-255.74,-82908.3
buyer_1,Luis,28,ES28209599118326557478,TRX_N-00351-17603437,2022-04-18T20:24:25,Getxo,Expense,car,-129.64,-83037.94
buyer_1,Luis,28,ES28209599118326557478,TRX_N-00352-19662791,2022-04-18T08:18:43,Bilbao,Expense,healthcare,-262.67,-83300.61
buyer_1,Luis,28,ES28209599118326557478,TRX_N-00353-95087361,2022-04-18T10:24:17,Bilbao,Expense,leisure,-426.54,-83727.15
buyer_1,Luis,28,ES28209599118326557478,TRX_N-00354-99463987,2022-04-19T22:19:53,Bilbao,Expense,leisure,-389.23,-84116.38
buyer_1,Luis,28,ES28209599118326557478,TRX_N-00355-19213173,2022-04-19T18:15:18,Bilbao,Expense,leisure,-439.74,-84556.12
buyer_1,Luis,28,ES28209599118326557478,TRX_N-00356-93063554,2022-04-19T22:09:50,Bilbao,Expense,clothing,-27.66,-84583.78
buyer_1,Luis,28,ES28209599118326557478,TRX_N-00357-45820790,2022-04-20T02:26:38,Bilbao,Expense,technology,-105.13,-84688.91
buyer_1,Luis,28,ES28209599118326557478,TRX_N-00358-18294619,2022-04-20T12:39:15,Bilbao,Expense,subscriptions,-437.19,-85126.1
buyer_1,Luis,28,ES28209599118326557478,TRX_N-00359-74351535,2022-04-20T22:39:18,Oyón-Oion,Expense,food,-239.52,-85365.62
buyer_1,Luis,28,ES28209599118326557478,TRX_N-00360-27774007,2022-04-21T01:59:20,Bilbao,Expense,personal_care,-187.56,-85553.18
buyer_1,Luis,28,ES28209599118326557478,TRX_N-00361-95889710,2022-04-21T18:18:53,Bilbao,Expense,basic-services,-489.63,-86042.81
buyer_1,Luis,28,ES28209599118326557478,TRX_N-00362-18344058,2022-04-21T17:49:36,Bilbao,Expense,subscriptions,-447.1,-86489.91
buyer_1,Luis,28,ES28209599118326557478,TRX_N-00363-71562793,2022-04-22T17:57:36,Bilbao,Expense,children,-405.17,-86895.08
buyer_1,Luis,28,ES28209599118326557478,TRX_N-00364-41702771,2022-04-22T20:42:06,Bilbao,Expense,children,-84.09,-86979.17
buyer_1,Luis,28,ES28209599118326557478,TRX_N-00365-74347553,2022-04-22T22:33:37,Bilbao,Expense,loans,-235.03,-87214.2
buyer_1,Luis,28,ES28209599118326557478,TRX_N-00366-35817871,2022-04-23T21:31:44,Durango,Expense,transport,-197.73,-87411.93
buyer_1,Luis,28,ES28209599118326557478,TRX_N-00367-34369825,2022-04-23T17:29:05,Elciego,Expense,loans,-429.69,-87841.62
buyer_1,Luis,28,ES28209599118326557478,TRX_N-00368-23718783,2022-04-23T21:32:13,Bilbao,Expense,loans,-67.45,-87909.07
buyer_1,Luis,28,ES28209599118326557478,TRX_N-00369-72325492,2022-04-24T18:43:32,Bilbao,Expense,transport,-221.78,-88130.85
buyer_1,Luis,28,ES28209599118326557478,TRX_N-00370-20263811,2022-04-24T19:01:18,Bilbao,Expense,children,-178.58,-88309.43
buyer_1,Luis,28,ES28209599118326557478,TRX_N-00371-21298612,2022-04-24T20:41:59,Amurrio,Expense,savings,-356.93,-88666.36
buyer_1,Luis,28,ES28209599118326557478,TRX_N-00372-84796456,2022-04-25T18:03:27,Santurtzi,Expense,food,-471.99,-89138.35
buyer_1,Luis,28,ES28209599118326557478,TRX_N-00373-39027269,2022-04-25T10:10:23,Bilbao,Expense,savings,-275.18,-89413.53
buyer_1,Luis,28,ES28209599118326557478,TRX_N-00374-66975785,2022-04-25T20:00:56,Bilbao,Expense,technology,-373.46,-89786.99
buyer_1,Luis,28,ES28209599118326557478,TRX_N-00375-96549119,2022-04-26T13:23:31,Bilbao,Expense,car,-381.54,-90168.53
buyer_1,Luis,28,ES28209599118326557478,TRX_N-00376-06594132,2022-04-26T08:08:36,Bilbao,Expense,housing,-256.78,-90425.31
buyer_1,Luis,28,ES28209599118326557478,TRX_N-00377-35982854,2022-04-26T08:12:28,Bilbao,Expense,housing,-162.68,-90587.99
buyer_1,Luis,28,ES28209599118326557478,TRX_N-00378-01012487,2022-04-27T13:59:45,Bilbao,Expense,technology,-69.58,-90657.57
buyer_1,Luis,28,ES28209599118326557478,TRX_N-00379-70990480,2022-04-27T05:26:21,Berango,Expense,subscriptions,-51.95,-90709.52
buyer_1,Luis,28,ES28209599118326557478,TRX_N-00380-99968171,2022-04-27T12:05:47,Bilbao,Expense,food,-52.41,-90761.93
buyer_1,Luis,28,ES28209599118326557478,TRX_N-00381-96175918,2022-04-28T08:22:43,Bilbao,Expense,children,-164.76,-90926.69
buyer_1,Luis,28,ES28209599118326557478,TRX_N-00382-50669073,2022-04-28T12:29:40,Bilbao,Expense,children,-174.48,-91101.17
buyer_1,Luis,28,ES28209599118326557478,TRX_N-00383-06686809,2022-04-28T14:37:53,Bilbao,Expense,loans,-487.09,-91588.26
buyer_1,Luis,28,ES28209599118326557478,TRX_N-00384-84114421,2022-04-29T13:01:34,Bilbao,Expense,healthcare,-294.77,-91883.03
buyer_1,Luis,28,ES28209599118326557478,TRX_N-00385-00811746,2022-04-29T08:28:59,Bilbao,Expense,subscriptions,-10.78,-91893.81
buyer_1,Luis,28,ES28209599118326557478,TRX_N-00386-45858402,2022-04-29T12:35:30,Erandio,Expense,education,-447.69,-92341.5
buyer_1,Luis,28,ES28209599118326557478,TRX_N-00387-00917116,2022-04-30T16:46:40,Bilbao,Expense,savings,-459.93,-92801.43
buyer_1,Luis,28,ES28209599118326557478,TRX_N-00388-79658046,2022-04-30T17:37:15,Bilbao,Expense,car,-416.71,-93218.14
buyer_1,Luis,28,ES28209599118326557478,TRX_N-00389-65060865,2022-04-30T20:08:46,Getxo,Expense,food,-97.24,-93315.38
buyer_1,Luis,28,ES28209599118326557478,TRX_N-00390-93835092,2022-05-01T19:12:07,Bilbao,incomes,salary,1265.98,-92049.4
buyer_1,Luis,28,ES28209599118326557478,TRX_N-00391-86117085,2022-05-01T12:18:49,Bilbao,Expense,car,-433.97,-92483.37
buyer_1,Luis,28,ES28209599118326557478,TRX_N-00392-00696084,2022-05-01T00:35:04,Bilbao,Expense,basic-services,-470.17,-92953.54
buyer_1,Luis,28,ES28209599118326557478,TRX_N-00393-02020338,2022-05-01T20:05:09,Bilbao,Expense,healthcare,-172.91,-93126.45
buyer_1,Luis,28,ES28209599118326557478,TRX_N-00394-77802803,2022-05-02T14:14:00,Bilbao,Expense,housing,-256.65,-93383.1
buyer_1,Luis,28,ES28209599118326557478,TRX_N-00395-13939056,2022-05-02T13:26:40,Bilbao,Expense,personal_care,-45.5,-93428.6
buyer_1,Luis,28,ES28209599118326557478,TRX_N-00396-73903193,2022-05-02T10:42:36,Vitoria-Gasteiz,Expense,technology,-479.09,-93907.69
buyer_1,Luis,28,ES28209599118326557478,TRX_N-00397-00457450,2022-05-03T18:28:27,Salvatierra/Agurain,Expense,children,-172.36,-94080.05
buyer_1,Luis,28,ES28209599118326557478,TRX_N-00398-46169236,2022-05-03T17:53:20,Bilbao,Expense,children,-499.08,-94579.13
buyer_1,Luis,28,ES28209599118326557478,TRX_N-00399-20335750,2022-05-03T15:16:19,Bilbao,Expense,subscriptions,-59.02,-94638.15
buyer_1,Luis,28,ES28209599118326557478,TRX_N-00400-63698240,2022-05-04T20:58:54,Bilbao,Housing,Rent,-1369.49,-96007.64
buyer_1,Luis,28,ES28209599118326557478,TRX_N-00401-39170813,2022-05-04T16:21:01,Zuia,Expense,children,-233.53,-96241.17
buyer_1,Luis,28,ES28209599118326557478,TRX_N-00402-41928701,2022-05-04T14:36:38,Bilbao,Expense,savings,-204.53,-96445.7
buyer_1,Luis,28,ES28209599118326557478,TRX_N-00403-26165309,2022-05-04T14:10:02,Bilbao,Expense,savings,-375.09,-96820.79
buyer_1,Luis,28,ES28209599118326557478,TRX_N-00404-74153394,2022-05-05T11:15:56,Bilbao,basic_services,water,-76.29,-96897.08
buyer_1,Luis,28,ES28209599118326557478,TRX_N-00405-43160096,2022-05-05T12:09:43,Bilbao,basic_services,gas,-50.33,-96947.41
buyer_1,Luis,28,ES28209599118326557478,TRX_N-00406-91409828,2022-05-05T17:14:47,Bilbao,Expense,savings,-181.65,-97129.06
buyer_1,Luis,28,ES28209599118326557478,TRX_N-00407-29334098,2022-05-05T10:30:11,Bilbao,Expense,savings,-242.21,-97371.27
buyer_1,Luis,28,ES28209599118326557478,TRX_N-00408-37532540,2022-05-05T18:09:53,Bilbao,Expense,education,-42.42,-97413.69
buyer_1,Luis,28,ES28209599118326557478,TRX_N-00409-01125556,2022-05-06T23:07:56,Galdakao,Expense,housing,-61.43,-97475.12
buyer_1,Luis,28,ES28209599118326557478,TRX_N-00410-77208360,2022-05-06T15:05:18,Bilbao,Expense,food,-199.11,-97674.23
buyer_1,Luis,28,ES28209599118326557478,TRX_N-00411-44247189,2022-05-06T14:37:58,Bilbao,Expense,food,-249.71,-97923.94
buyer_1,Luis,28,ES28209599118326557478,TRX_N-00412-98705335,2022-05-07T18:24:41,Bilbao,Expense,children,-438.07,-98362.01
buyer_1,Luis,28,ES28209599118326557478,TRX_N-00413-15520227,2022-05-07T07:49:53,Bilbao,Expense,technology,-496.63,-98858.64
buyer_1,Luis,28,ES28209599118326557478,TRX_N-00414-47755034,2022-05-07T08:36:25,Bilbao,Expense,personal_care,-328.14,-99186.78
buyer_1,Luis,28,ES28209599118326557478,TRX_N-00415-26347534,2022-05-08T10:32:37,Bilbao,basic_services,electricity,-98.97,-99285.75
buyer_1,Luis,28,ES28209599118326557478,TRX_N-00416-21699843,2022-05-08T10:36:53,Bilbao,basic_services,internet,-71.01,-99356.76
buyer_1,Luis,28,ES28209599118326557478,TRX_N-00417-93036982,2022-05-08T16:45:24,Bilbao,basic_services,phone,-51.04,-99407.8
buyer_1,Luis,28,ES28209599118326557478,TRX_N-00418-51481609,2022-05-08T15:45:12,Bilbao,Expense,savings,-478.3,-99886.1
buyer_1,Luis,28,ES28209599118326557478,TRX_N-00419-15169973,2022-05-08T11:13:27,Bilbao,Expense,basic-services,-410.34,-100296.44
buyer_1,Luis,28,ES28209599118326557478,TRX_N-00420-19595508,2022-05-08T05:26:25,Bilbao,Expense,subscriptions,-39.12,-100335.56
buyer_1,Luis,28,ES28209599118326557478,TRX_N-00421-10221346,2022-05-09T08:13:55,Bilbao,Expense,savings,-475.75,-100811.31
buyer_1,Luis,28,ES28209599118326557478,TRX_N-00422-66743080,2022-05-09T03:34:21,Bilbao,Expense,healthcare,-81.34,-100892.65
buyer_1,Luis,28,ES28209599118326557478,TRX_N-00423-03186027,2022-05-09T12:07:16,Leioa,Expense,loans,-246.73,-101139.38
buyer_1,Luis,28,ES28209599118326557478,TRX_N-00424-05878490,2022-05-10T19:01:38,Berango,Expense,education,-496.18,-101635.56
buyer_1,Luis,28,ES28209599118326557478,TRX_N-00425-89698784,2022-05-10T08:39:27,Eibar,Expense,transport,-164.67,-101800.23
buyer_1,Luis,28,ES28209599118326557478,TRX_N-00426-82146475,2022-05-10T11:18:35,Bilbao,Expense,housing,-211.76,-102011.99
buyer_1,Luis,28,ES28209599118326557478,TRX_N-00427-10542354,2022-05-11T09:26:25,Bilbao,Expense,savings,-151.96,-102163.95
buyer_1,Luis,28,ES28209599118326557478,TRX_N-00428-90310785,2022-05-11T08:42:19,Bilbao,Expense,healthcare,-57.92,-102221.87
buyer_1,Luis,28,ES28209599118326557478,TRX_N-00429-81472501,2022-05-11T13:21:37,Bilbao,Expense,children,-303.89,-102525.76
buyer_1,Luis,28,ES28209599118326557478,TRX_N-00430-87882789,2022-05-12T17:18:33,Bilbao,Expense,car,-99.26,-102625.02
buyer_1,Luis,28,ES28209599118326557478,TRX_N-00431-51176074,2022-05-12T12:22:15,Bilbao,Expense,leisure,-425.47,-103050.49
buyer_1,Luis,28,ES28209599118326557478,TRX_N-00432-24165977,2022-05-12T14:10:41,Bilbao,Expense,clothing,-265.1,-103315.59
buyer_1,Luis,28,ES28209599118326557478,TRX_N-00433-20505565,2022-05-13T07:59:01,Zuia,Expense,savings,-116.27,-103431.86
buyer_1,Luis,28,ES28209599118326557478,TRX_N-00434-61689394,2022-05-13T13:04:35,Pasaia,Expense,food,-444.13,-103875.99
buyer_1,Luis,28,ES28209599118326557478,TRX_N-00435-13976792,2022-05-13T22:57:15,Bilbao,Expense,subscriptions,-286.6,-104162.59
buyer_1,Luis,28,ES28209599118326557478,TRX_N-00436-22267813,2022-05-14T08:58:30,Bilbao,Expense,healthcare,-445.11,-104607.7
buyer_1,Luis,28,ES28209599118326557478,TRX_N-00437-87874289,2022-05-14T20:37:11,Bilbao,Expense,food,-499.33,-105107.03
buyer_1,Luis,28,ES28209599118326557478,TRX_N-00438-45067473,2022-05-14T08:40:04,Bilbao,Expense,loans,-119.97,-105227.0
buyer_1,Luis,28,ES28209599118326557478,TRX_N-00439-82665570,2022-05-15T15:11:45,Bilbao,Expense,healthcare,-134.85,-105361.85
buyer_1,Luis,28,ES28209599118326557478,TRX_N-00440-31318110,2022-05-15T12:23:46,Bilbao,Expense,education,-259.07,-105620.92
buyer_1,Luis,28,ES28209599118326557478,TRX_N-00441-42076421,2022-05-15T10:19:26,Bilbao,Expense,personal_care,-485.6,-106106.52
buyer_1,Luis,28,ES28209599118326557478,TRX_N-00442-61579080,2022-05-16T19:47:39,Bilbao,Expense,personal_care,-242.31,-106348.83
buyer_1,Luis,28,ES28209599118326557478,TRX_N-00443-47492268,2022-05-16T20:13:38,Arrasate,Expense,healthcare,-175.92,-106524.75
buyer_1,Luis,28,ES28209599118326557478,TRX_N-00444-57974258,2022-05-16T20:03:46,Mungia,Expense,education,-89.57,-106614.32
buyer_1,Luis,28,ES28209599118326557478,TRX_N-00445-94415087,2022-05-17T15:17:37,Bilbao,Expense,subscriptions,-401.41,-107015.73
buyer_1,Luis,28,ES28209599118326557478,TRX_N-00446-53302431,2022-05-17T06:58:25,Bilbao,Expense,clothing,-420.96,-107436.69
buyer_1,Luis,28,ES28209599118326557478,TRX_N-00447-22372468,2022-05-17T22:00:26,Bilbao,Expense,clothing,-39.44,-107476.13
buyer_1,Luis,28,ES28209599118326557478,TRX_N-00448-38223315,2022-05-18T14:14:00,Sopela,Expense,personal_care,-379.89,-107856.02
buyer_1,Luis,28,ES28209599118326557478,TRX_N-00449-48370489,2022-05-18T14:40:37,Bilbao,Expense,food,-11.05,-107867.07
buyer_1,Luis,28,ES28209599118326557478,TRX_N-00450-59613897,2022-05-18T14:50:43,Bilbao,Expense,basic-services,-335.28,-108202.35
buyer_1,Luis,28,ES28209599118326557478,TRX_N-00451-52213154,2022-05-19T11:03:29,Bilbao,Expense,healthcare,-42.89,-108245.24
buyer_1,Luis,28,ES28209599118326557478,TRX_N-00452-92360132,2022-05-19T16:46:17,Bilbao,Expense,food,-248.93,-108494.17
buyer_1,Luis,28,ES28209599118326557478,TRX_N-00453-23265491,2022-05-19T14:28:12,Bilbao,Expense,housing,-187.18,-108681.35
buyer_1,Luis,28,ES28209599118326557478,TRX_N-00454-47088091,2022-05-20T22:47:17,Errenteria,Expense,car,-215.25,-108896.6
buyer_1,Luis,28,ES28209599118326557478,TRX_N-00455-27952364,2022-05-20T18:17:59,Bilbao,Expense,personal_care,-24.31,-108920.91
buyer_1,Luis,28,ES28209599118326557478,TRX_N-00456-00885853,2022-05-20T12:35:40,Bilbao,Expense,housing,-305.1,-109226.01
buyer_1,Luis,28,ES28209599118326557478,TRX_N-00457-53429331,2022-05-21T20:23:18,Basauri,Expense,loans,-110.47,-109336.48
buyer_1,Luis,28,ES28209599118326557478,TRX_N-00458-47761028,2022-05-21T19:30:19,Bilbao,Expense,car,-365.0,-109701.48
buyer_1,Luis,28,ES28209599118326557478,TRX_N-00459-39243231,2022-05-21T13:30:28,Bilbao,Expense,basic-services,-164.59,-109866.07
buyer_1,Luis,28,ES28209599118326557478,TRX_N-00460-07093517,2022-05-22T18:16:22,Llodio,Expense,savings,-90.87,-109956.94
buyer_1,Luis,28,ES28209599118326557478,TRX_N-00461-47731415,2022-05-22T16:02:23,Bilbao,Expense,clothing,-184.97,-110141.91
buyer_1,Luis,28,ES28209599118326557478,TRX_N-00462-51082822,2022-05-22T17:48:15,Bilbao,Expense,savings,-336.68,-110478.59
buyer_1,Luis,28,ES28209599118326557478,TRX_N-00463-32538336,2022-05-23T19:09:47,Bilbao,Expense,savings,-113.67,-110592.26
buyer_1,Luis,28,ES28209599118326557478,TRX_N-00464-48111817,2022-05-23T06:29:18,Alegría-Dulantzi,Expense,technology,-493.85,-111086.11
buyer_1,Luis,28,ES28209599118326557478,TRX_N-00465-18680823,2022-05-23T19:13:02,Bilbao,Expense,personal_care,-105.59,-111191.7
buyer_1,Luis,28,ES28209599118326557478,TRX_N-00466-92360909,2022-05-24T09:59:52,Bilbao,Expense,leisure,-175.44,-111367.14
buyer_1,Luis,28,ES28209599118326557478,TRX_N-00467-05279279,2022-05-24T12:11:47,Bilbao,Expense,clothing,-168.94,-111536.08
buyer_1,Luis,28,ES28209599118326557478,TRX_N-00468-03419140,2022-05-24T08:13:33,Sestao,Expense,loans,-394.48,-111930.56
buyer_1,Luis,28,ES28209599118326557478,TRX_N-00469-17089969,2022-05-25T20:11:04,Bilbao,Expense,personal_care,-79.41,-112009.97
buyer_1,Luis,28,ES28209599118326557478,TRX_N-00470-52651686,2022-05-25T18:55:13,Bilbao,Expense,car,-187.63,-112197.6
buyer_1,Luis,28,ES28209599118326557478,TRX_N-00471-15454719,2022-05-25T09:52:40,Bilbao,Expense,housing,-459.57,-112657.17
buyer_1,Luis,28,ES28209599118326557478,TRX_N-00472-12021128,2022-05-26T20:44:54,Bilbao,Expense,personal_care,-16.28,-112673.45
buyer_1,Luis,28,ES28209599118326557478,TRX_N-00473-82325018,2022-05-26T10:03:43,Bilbao,Expense,car,-414.56,-113088.01
buyer_1,Luis,28,ES28209599118326557478,TRX_N-00474-75741381,2022-05-26T08:27:24,Bilbao,Expense,technology,-249.33,-113337.34
buyer_1,Luis,28,ES28209599118326557478,TRX_N-00475-69859655,2022-05-27T11:53:00,Bilbao,Expense,technology,-168.43,-113505.77
buyer_1,Luis,28,ES28209599118326557478,TRX_N-00476-02966355,2022-05-27T11:13:12,Bilbao,Expense,food,-349.26,-113855.03
buyer_1,Luis,28,ES28209599118326557478,TRX_N-00477-08963087,2022-05-27T14:48:06,Bilbao,Expense,subscriptions,-431.31,-114286.34
buyer_1,Luis,28,ES28209599118326557478,TRX_N-00478-15495484,2022-05-28T23:26:51,Bilbao,Expense,transport,-458.84,-114745.18
buyer_1,Luis,28,ES28209599118326557478,TRX_N-00479-27845946,2022-05-28T09:55:27,Bilbao,Expense,subscriptions,-204.62,-114949.8
buyer_1,Luis,28,ES28209599118326557478,TRX_N-00480-97011125,2022-05-28T13:50:57,Bilbao,Expense,healthcare,-290.83,-115240.63
buyer_1,Luis,28,ES28209599118326557478,TRX_N-00481-56632601,2022-05-29T11:27:06,Bilbao,Expense,personal_care,-273.01,-115513.64
buyer_1,Luis,28,ES28209599118326557478,TRX_N-00482-38158915,2022-05-29T06:59:32,Andoain,Expense,leisure,-314.7,-115828.34
buyer_1,Luis,28,ES28209599118326557478,TRX_N-00483-29005987,2022-05-29T17:42:11,Bilbao,Expense,leisure,-96.27,-115924.61
buyer_1,Luis,28,ES28209599118326557478,TRX_N-00484-82025420,2022-05-30T12:19:22,Bilbao,Expense,education,-483.93,-116408.54
buyer_1,Luis,28,ES28209599118326557478,TRX_N-00485-55093738,2022-05-30T10:42:39,Bilbao,Expense,children,-373.02,-116781.56
buyer_1,Luis,28,ES28209599118326557478,TRX_N-00486-64788668,2022-05-30T12:31:26,Bilbao,Expense,technology,-397.05,-117178.61
buyer_1,Luis,28,ES28209599118326557478,TRX_N-00487-76505454,2022-05-31T21:55:26,Bilbao,Expense,technology,-269.53,-117448.14
buyer_1,Luis,28,ES28209599118326557478,TRX_N-00488-27783150,2022-05-31T22:26:45,Arrasate,Expense,car,-114.75,-117562.89
buyer_1,Luis,28,ES28209599118326557478,TRX_N-00489-91472810,2022-05-31T14:58:10,Bilbao,Expense,personal_care,-86.89,-117649.78
buyer_1,Luis,28,ES28209599118326557478,TRX_N-00490-72300671,2022-06-01T16:31:21,Bilbao,incomes,salary,1265.98,-116383.8
buyer_1,Luis,28,ES28209599118326557478,TRX_N-00491-53887158,2022-06-01T16:31:21,Bilbao,incomes,extra_income,126.6,-116257.2
buyer_1,Luis,28,ES28209599118326557478,TRX_N-00492-27684226,2022-06-01T16:31:21,Bilbao,incomes,salary_extra,969.01,-115288.19
buyer_1,Luis,28,ES28209599118326557478,TRX_N-00493-32097664,2022-06-01T09:24:33,Bilbao,annual_bills,taxes,-4513.52,-119801.71
buyer_1,Luis,28,ES28209599118326557478,TRX_N-00494-92745800,2022-06-01T14:57:36,Bilbao,annual_bills,insurance,-818.87,-120620.58
buyer_1,Luis,28,ES28209599118326557478,TRX_N-00495-06127362,2022-06-01T12:36:37,Mungia,Expense,children,-347.28,-120967.86
buyer_1,Luis,28,ES28209599118326557478,TRX_N-00496-90036591,2022-06-01T16:41:47,Bilbao,Expense,loans,-414.65,-121382.51
buyer_1,Luis,28,ES28209599118326557478,TRX_N-00497-91138454,2022-06-01T08:59:17,Bilbao,Expense,children,-182.07,-121564.58
buyer_1,Luis,28,ES28209599118326557478,TRX_N-00498-93008118,2022-06-02T17:36:24,Bilbao,Expense,car,-173.3,-121737.88
buyer_1,Luis,28,ES28209599118326557478,TRX_N-00499-65500994,2022-06-02T09:21:21,Pasaia,Expense,basic-services,-12.47,-121750.35
buyer_1,Luis,28,ES28209599118326557478,TRX_N-00500-16717352,2022-06-02T14:10:24,Pasaia,Expense,education,-104.38,-121854.73
buyer_1,Luis,28,ES28209599118326557478,TRX_N-00501-93311005,2022-06-03T10:48:33,Bilbao,Expense,transport,-335.99,-122190.72
buyer_1,Luis,28,ES28209599118326557478,TRX_N-00502-49292481,2022-06-03T08:39:33,Bilbao,Expense,transport,-126.14,-122316.86
buyer_1,Luis,28,ES28209599118326557478,TRX_N-00503-23904733,2022-06-03T18:46:27,Bilbao,Expense,children,-426.81,-122743.67
buyer_1,Luis,28,ES28209599118326557478,TRX_N-00504-81646874,2022-06-04T08:27:53,Bilbao,Housing,Rent,-1369.49,-124113.16
buyer_1,Luis,28,ES28209599118326557478,TRX_N-00505-32811906,2022-06-04T20:21:12,Bilbao,Expense,children,-59.02,-124172.18
buyer_1,Luis,28,ES28209599118326557478,TRX_N-00506-76859858,2022-06-04T15:21:41,Bilbao,Expense,housing,-60.98,-124233.16
buyer_1,Luis,28,ES28209599118326557478,TRX_N-00507-56316939,2022-06-04T10:39:46,Santurtzi,Expense,leisure,-387.23,-124620.39
buyer_1,Luis,28,ES28209599118326557478,TRX_N-00508-30604670,2022-06-05T10:04:56,Bilbao,basic_services,phone,-64.75,-124685.14
buyer_1,Luis,28,ES28209599118326557478,TRX_N-00509-32015601,2022-06-05T11:13:58,Bilbao,Expense,food,-396.03,-125081.17
buyer_1,Luis,28,ES28209599118326557478,TRX_N-00510-80811455,2022-06-05T18:48:18,Bilbao,Expense,basic-services,-129.46,-125210.63
buyer_1,Luis,28,ES28209599118326557478,TRX_N-00511-64747219,2022-06-05T19:09:24,Bilbao,Expense,education,-275.28,-125485.91
buyer_1,Luis,28,ES28209599118326557478,TRX_N-00512-59387401,2022-06-06T20:08:06,Bilbao,basic_services,water,-25.06,-125510.97
buyer_1,Luis,28,ES28209599118326557478,TRX_N-00513-44681218,2022-06-06T13:40:55,Bilbao,Expense,basic-services,-37.98,-125548.95
buyer_1,Luis,28,ES28209599118326557478,TRX_N-00514-47491999,2022-06-06T13:26:36,Bilbao,Expense,healthcare,-148.41,-125697.36
buyer_1,Luis,28,ES28209599118326557478,TRX_N-00515-15282223,2022-06-06T16:26:59,Bilbao,Expense,car,-451.99,-126149.35
buyer_1,Luis,28,ES28209599118326557478,TRX_N-00516-34002913,2022-06-07T20:53:10,Bilbao,Expense,personal_care,-88.58,-126237.93
buyer_1,Luis,28,ES28209599118326557478,TRX_N-00517-50668033,2022-06-07T13:22:09,Bilbao,Expense,food,-487.55,-126725.48
buyer_1,Luis,28,ES28209599118326557478,TRX_N-00518-30439470,2022-06-07T16:48:15,Bilbao,Expense,healthcare,-144.3,-126869.78
buyer_1,Luis,28,ES28209599118326557478,TRX_N-00519-77789243,2022-06-08T17:19:24,Bilbao,basic_services,electricity,-78.35,-126948.13
buyer_1,Luis,28,ES28209599118326557478,TRX_N-00520-24549235,2022-06-08T22:12:58,Bilbao,basic_services,gas,-67.25,-127015.38
buyer_1,Luis,28,ES28209599118326557478,TRX_N-00521-87178952,2022-06-08T09:41:36,Bilbao,basic_services,internet,-55.73,-127071.11
buyer_1,Luis,28,ES28209599118326557478,TRX_N-00522-82495781,2022-06-08T11:44:44,Bilbao,Expense,car,-159.68,-127230.79
buyer_1,Luis,28,ES28209599118326557478,TRX_N-00523-93712634,2022-06-08T08:57:56,Bilbao,Expense,subscriptions,-83.11,-127313.9
buyer_1,Luis,28,ES28209599118326557478,TRX_N-00524-02272315,2022-06-08T14:47:24,Zuia,Expense,housing,-331.33,-127645.23
buyer_1,Luis,28,ES28209599118326557478,TRX_N-00525-93879308,2022-06-09T07:15:54,Bilbao,Expense,savings,-155.89,-127801.12
buyer_1,Luis,28,ES28209599118326557478,TRX_N-00526-84089525,2022-06-09T00:45:05,Bilbao,Expense,technology,-354.82,-128155.94
buyer_1,Luis,28,ES28209599118326557478,TRX_N-00527-85378353,2022-06-09T08:55:23,Elciego,Expense,personal_care,-434.52,-128590.46
buyer_1,Luis,28,ES28209599118326557478,TRX_N-00528-00407123,2022-06-10T08:04:51,Berango,Expense,healthcare,-51.76,-128642.22
buyer_1,Luis,28,ES28209599118326557478,TRX_N-00529-95020578,2022-06-10T17:09:01,Bilbao,Expense,housing,-366.27,-129008.49
buyer_1,Luis,28,ES28209599118326557478,TRX_N-00530-08902100,2022-06-10T08:31:55,Bilbao,Expense,education,-331.71,-129340.2
buyer_1,Luis,28,ES28209599118326557478,TRX_N-00531-54263396,2022-06-11T13:37:55,Donostia,Expense,children,-106.23,-129446.43
buyer_1,Luis,28,ES28209599118326557478,TRX_N-00532-43322377,2022-06-11T11:24:18,Leioa,Expense,education,-135.12,-129581.55
buyer_1,Luis,28,ES28209599118326557478,TRX_N-00533-27511210,2022-06-11T09:31:52,Bilbao,Expense,basic-services,-77.4,-129658.95
buyer_1,Luis,28,ES28209599118326557478,TRX_N-00534-48066932,2022-06-12T10:50:30,Getxo,Expense,children,-358.9,-130017.85
buyer_1,Luis,28,ES28209599118326557478,TRX_N-00535-75217180,2022-06-12T12:53:39,Bilbao,Expense,loans,-443.39,-130461.24
buyer_1,Luis,28,ES28209599118326557478,TRX_N-00536-18391550,2022-06-12T19:54:42,Getxo,Expense,housing,-328.5,-130789.74
buyer_1,Luis,28,ES28209599118326557478,TRX_N-00537-91969111,2022-06-13T16:45:55,Bilbao,Expense,personal_care,-55.01,-130844.75
buyer_1,Luis,28,ES28209599118326557478,TRX_N-00538-40415433,2022-06-13T15:07:53,Bilbao,Expense,clothing,-53.01,-130897.76
buyer_1,Luis,28,ES28209599118326557478,TRX_N-00539-45285886,2022-06-13T16:47:01,Bilbao,Expense,loans,-212.25,-131110.01
buyer_1,Luis,28,ES28209599118326557478,TRX_N-00540-15857006,2022-06-14T13:59:44,Bilbao,Expense,education,-111.46,-131221.47
buyer_1,Luis,28,ES28209599118326557478,TRX_N-00541-61600443,2022-06-14T11:07:59,Llodio,Expense,education,-169.43,-131390.9
buyer_1,Luis,28,ES28209599118326557478,TRX_N-00542-26288664,2022-06-14T06:47:53,Bilbao,Expense,healthcare,-178.57,-131569.47
buyer_1,Luis,28,ES28209599118326557478,TRX_N-00543-23645239,2022-06-15T18:44:22,Bilbao,Expense,children,-358.38,-131927.85
buyer_1,Luis,28,ES28209599118326557478,TRX_N-00544-01182330,2022-06-15T00:30:44,Bilbao,Expense,leisure,-415.18,-132343.03
buyer_1,Luis,28,ES28209599118326557478,TRX_N-00545-01929096,2022-06-15T18:26:19,Bilbao,Expense,education,-392.63,-132735.66
buyer_1,Luis,28,ES28209599118326557478,TRX_N-00546-30650797,2022-06-16T17:02:41,Bilbao,Expense,personal_care,-419.11,-133154.77
buyer_1,Luis,28,ES28209599118326557478,TRX_N-00547-39237768,2022-06-16T13:24:31,Bilbao,Expense,housing,-287.55,-133442.32
buyer_1,Luis,28,ES28209599118326557478,TRX_N-00548-49479875,2022-06-16T21:28:21,Bilbao,Expense,loans,-68.38,-133510.7
buyer_1,Luis,28,ES28209599118326557478,TRX_N-00549-30193919,2022-06-17T11:56:19,Amurrio,Expense,subscriptions,-289.73,-133800.43
buyer_1,Luis,28,ES28209599118326557478,TRX_N-00550-89094927,2022-06-17T13:08:24,Barakaldo,Expense,clothing,-362.25,-134162.68
buyer_1,Luis,28,ES28209599118326557478,TRX_N-00551-60106624,2022-06-17T15:22:11,Bilbao,Expense,technology,-122.77,-134285.45
buyer_1,Luis,28,ES28209599118326557478,TRX_N-00552-74019757,2022-06-18T13:41:53,Bilbao,Expense,personal_care,-325.15,-134610.6
buyer_1,Luis,28,ES28209599118326557478,TRX_N-00553-41937332,2022-06-18T08:20:42,Bilbao,Expense,housing,-291.47,-134902.07
buyer_1,Luis,28,ES28209599118326557478,TRX_N-00554-94903841,2022-06-18T15:04:05,Bilbao,Expense,transport,-364.48,-135266.55
buyer_1,Luis,28,ES28209599118326557478,TRX_N-00555-92168291,2022-06-19T17:59:13,Bilbao,Expense,leisure,-448.9,-135715.45
buyer_1,Luis,28,ES28209599118326557478,TRX_N-00556-34120530,2022-06-19T11:23:02,Bilbao,Expense,education,-58.27,-135773.72
buyer_1,Luis,28,ES28209599118326557478,TRX_N-00557-99146996,2022-06-19T05:49:59,Bilbao,Expense,education,-293.59,-136067.31
buyer_1,Luis,28,ES28209599118326557478,TRX_N-00558-37711974,2022-06-20T13:49:51,Bilbao,Expense,technology,-212.34,-136279.65
buyer_1,Luis,28,ES28209599118326557478,TRX_N-00559-74107535,2022-06-20T17:42:22,Bilbao,Expense,healthcare,-440.09,-136719.74
buyer_1,Luis,28,ES28209599118326557478,TRX_N-00560-28650555,2022-06-20T08:22:24,Bilbao,Expense,healthcare,-426.6,-137146.34
buyer_1,Luis,28,ES28209599118326557478,TRX_N-00561-91029883,2022-06-21T23:38:26,Bilbao,Expense,children,-340.72,-137487.06
buyer_1,Luis,28,ES28209599118326557478,TRX_N-00562-98003077,2022-06-21T18:58:57,Bilbao,Expense,food,-141.53,-137628.59
buyer_1,Luis,28,ES28209599118326557478,TRX_N-00563-80814551,2022-06-21T12:40:51,Vitoria-Gasteiz,Expense,subscriptions,-90.5,-137719.09
buyer_1,Luis,28,ES28209599118326557478,TRX_N-00564-93006566,2022-06-22T17:12:11,Bilbao,Expense,car,-376.11,-138095.2
buyer_1,Luis,28,ES28209599118326557478,TRX_N-00565-30960508,2022-06-22T06:15:39,Bilbao,Expense,clothing,-388.76,-138483.96
buyer_1,Luis,28,ES28209599118326557478,TRX_N-00566-94069659,2022-06-22T14:08:44,Bilbao,Expense,leisure,-434.36,-138918.32
buyer_1,Luis,28,ES28209599118326557478,TRX_N-00567-94964655,2022-06-23T15:52:32,Lasarte-Oria,Expense,car,-300.19,-139218.51
buyer_1,Luis,28,ES28209599118326557478,TRX_N-00568-00443277,2022-06-23T18:32:00,Bilbao,Expense,subscriptions,-149.12,-139367.63
buyer_1,Luis,28,ES28209599118326557478,TRX_N-00569-23945872,2022-06-23T16:43:36,Zarautz,Expense,basic-services,-29.34,-139396.97
buyer_1,Luis,28,ES28209599118326557478,TRX_N-00570-17736964,2022-06-24T18:07:49,Bilbao,Expense,basic-services,-202.72,-139599.69
buyer_1,Luis,28,ES28209599118326557478,TRX_N-00571-25203904,2022-06-24T04:29:28,Bilbao,Expense,personal_care,-287.91,-139887.6
buyer_1,Luis,28,ES28209599118326557478,TRX_N-00572-91017471,2022-06-24T13:36:04,Bilbao,Expense,housing,-494.09,-140381.69
buyer_1,Luis,28,ES28209599118326557478,TRX_N-00573-26842153,2022-06-25T18:23:13,Bilbao,Expense,subscriptions,-81.19,-140462.88
buyer_1,Luis,28,ES28209599118326557478,TRX_N-00574-92605116,2022-06-25T20:10:08,Bilbao,Expense,loans,-82.41,-140545.29
buyer_1,Luis,28,ES28209599118326557478,TRX_N-00575-37447759,2022-06-25T04:49:29,Bilbao,Expense,basic-services,-472.36,-141017.65
buyer_1,Luis,28,ES28209599118326557478,TRX_N-00576-74814623,2022-06-26T14:50:34,Durango,Expense,housing,-375.17,-141392.82
buyer_1,Luis,28,ES28209599118326557478,TRX_N-00577-64735902,2022-06-26T15:37:22,Bilbao,Expense,leisure,-74.07,-141466.89
buyer_1,Luis,28,ES28209599118326557478,TRX_N-00578-31374205,2022-06-26T11:03:01,Bilbao,Expense,healthcare,-58.75,-141525.64
buyer_1,Luis,28,ES28209599118326557478,TRX_N-00579-48496609,2022-06-27T18:06:07,Bilbao,Expense,personal_care,-161.6,-141687.24
buyer_1,Luis,28,ES28209599118326557478,TRX_N-00580-32932614,2022-06-27T17:01:27,Bilbao,Expense,children,-207.93,-141895.17
buyer_1,Luis,28,ES28209599118326557478,TRX_N-00581-12504852,2022-06-27T14:59:30,Bilbao,Expense,children,-222.73,-142117.9
buyer_1,Luis,28,ES28209599118326557478,TRX_N-00582-06047368,2022-06-28T12:31:58,Bilbao,Expense,education,-130.65,-142248.55
buyer_1,Luis,28,ES28209599118326557478,TRX_N-00583-13391757,2022-06-28T12:17:29,Salvatierra/Agurain,Expense,basic-services,-185.87,-142434.42
buyer_1,Luis,28,ES28209599118326557478,TRX_N-00584-67661383,2022-06-28T14:15:53,Bilbao,Expense,subscriptions,-425.49,-142859.91
buyer_1,Luis,28,ES28209599118326557478,TRX_N-00585-88490226,2022-06-29T16:55:53,Bilbao,Expense,basic-services,-489.14,-143349.05
buyer_1,Luis,28,ES28209599118326557478,TRX_N-00586-25433962,2022-06-29T16:52:50,Oyón-Oion,Expense,leisure,-20.82,-143369.87
buyer_1,Luis,28,ES28209599118326557478,TRX_N-00587-44474980,2022-06-29T17:44:06,Bilbao,Expense,basic-services,-247.35,-143617.22
buyer_1,Luis,28,ES28209599118326557478,TRX_N-00588-67700797,2022-06-30T14:34:23,Bilbao,Expense,clothing,-489.61,-144106.83
buyer_1,Luis,28,ES28209599118326557478,TRX_N-00589-74325108,2022-06-30T21:24:48,Bilbao,Expense,healthcare,-448.79,-144555.62
buyer_1,Luis,28,ES28209599118326557478,TRX_N-00590-20801049,2022-06-30T14:23:40,Bilbao,Expense,basic-services,-383.09,-144938.71
buyer_1,Luis,28,ES28209599118326557478,TRX_N-00591-94807399,2022-07-01T16:56:57,Bilbao,incomes,salary,1265.98,-143672.73
buyer_1,Luis,28,ES28209599118326557478,TRX_N-00592-14249193,2022-07-01T18:33:47,Bilbao,Expense,car,-161.1,-143833.83
buyer_1,Luis,28,ES28209599118326557478,TRX_N-00593-23206766,2022-07-01T13:04:26,Bilbao,Expense,personal_care,-27.85,-143861.68
buyer_1,Luis,28,ES28209599118326557478,TRX_N-00594-69484944,2022-07-01T15:46:29,Bilbao,Expense,basic-services,-66.62,-143928.3
buyer_1,Luis,28,ES28209599118326557478,TRX_N-00595-93322198,2022-07-02T14:46:02,Bilbao,Expense,basic-services,-157.97,-144086.27
buyer_1,Luis,28,ES28209599118326557478,TRX_N-00596-51592594,2022-07-02T11:45:43,Bilbao,Expense,basic-services,-268.8,-144355.07
buyer_1,Luis,28,ES28209599118326557478,TRX_N-00597-52225936,2022-07-02T18:16:16,Bilbao,Expense,car,-315.36,-144670.43
buyer_1,Luis,28,ES28209599118326557478,TRX_N-00598-36756447,2022-07-03T11:06:53,Bilbao,Expense,car,-440.89,-145111.32
buyer_1,Luis,28,ES28209599118326557478,TRX_N-00599-02216506,2022-07-03T15:31:19,Berango,Expense,housing,-375.31,-145486.63
buyer_1,Luis,28,ES28209599118326557478,TRX_N-00600-91501495,2022-07-03T18:46:14,Basauri,Expense,personal_care,-194.8,-145681.43
buyer_1,Luis,28,ES28209599118326557478,TRX_N-00601-10109327,2022-07-04T20:36:07,Bilbao,Housing,Rent,-1369.49,-147050.92
buyer_1,Luis,28,ES28209599118326557478,TRX_N-00602-32452328,2022-07-04T17:28:08,Bilbao,Expense,personal_care,-159.73,-147210.65
buyer_1,Luis,28,ES28209599118326557478,TRX_N-00603-56227162,2022-07-04T18:24:29,Bilbao,Expense,clothing,-489.2,-147699.85
buyer_1,Luis,28,ES28209599118326557478,TRX_N-00604-79763192,2022-07-04T20:52:53,Bilbao,Expense,basic-services,-480.51,-148180.36
buyer_1,Luis,28,ES28209599118326557478,TRX_N-00605-78629437,2022-07-05T17:16:08,Bilbao,basic_services,gas,-49.6,-148229.96
buyer_1,Luis,28,ES28209599118326557478,TRX_N-00606-46031573,2022-07-05T08:45:42,Bilbao,basic_services,phone,-85.8,-148315.76
buyer_1,Luis,28,ES28209599118326557478,TRX_N-00607-42883424,2022-07-05T19:11:28,Bilbao,Expense,leisure,-43.66,-148359.42
buyer_1,Luis,28,ES28209599118326557478,TRX_N-00608-80605671,2022-07-05T08:55:22,Bilbao,Expense,clothing,-41.8,-148401.22
buyer_1,Luis,28,ES28209599118326557478,TRX_N-00609-32140981,2022-07-05T13:39:29,Bilbao,Expense,car,-56.04,-148457.26
buyer_1,Luis,28,ES28209599118326557478,TRX_N-00610-43684102,2022-07-06T10:47:45,Bilbao,Expense,basic-services,-55.16,-148512.42
buyer_1,Luis,28,ES28209599118326557478,TRX_N-00611-94287930,2022-07-06T15:00:37,Bermeo,Expense,basic-services,-201.12,-148713.54
buyer_1,Luis,28,ES28209599118326557478,TRX_N-00612-01327670,2022-07-06T22:45:21,Bilbao,Expense,loans,-419.58,-149133.12
buyer_1,Luis,28,ES28209599118326557478,TRX_N-00613-76827285,2022-07-07T15:10:50,Bilbao,Expense,personal_care,-28.83,-149161.95
buyer_1,Luis,28,ES28209599118326557478,TRX_N-00614-85629927,2022-07-07T12:29:10,Bilbao,Expense,leisure,-323.47,-149485.42
buyer_1,Luis,28,ES28209599118326557478,TRX_N-00615-95599875,2022-07-07T17:15:52,Bilbao,Expense,children,-128.78,-149614.2
buyer_1,Luis,28,ES28209599118326557478,TRX_N-00616-25838087,2022-07-08T16:54:10,Bilbao,basic_services,internet,-53.62,-149667.82
buyer_1,Luis,28,ES28209599118326557478,TRX_N-00617-79387206,2022-07-08T16:21:34,Bilbao,basic_services,water,-21.52,-149689.34
buyer_1,Luis,28,ES28209599118326557478,TRX_N-00618-31176550,2022-07-08T13:45:27,Bilbao,basic_services,electricity,-126.0,-149815.34
buyer_1,Luis,28,ES28209599118326557478,TRX_N-00619-90759504,2022-07-08T08:02:04,Bilbao,Expense,healthcare,-426.67,-150242.01
buyer_1,Luis,28,ES28209599118326557478,TRX_N-00620-38214930,2022-07-08T18:43:31,Erandio,Expense,healthcare,-65.89,-150307.9
buyer_1,Luis,28,ES28209599118326557478,TRX_N-00621-19716245,2022-07-08T16:42:57,Bilbao,Expense,subscriptions,-140.58,-150448.48
buyer_1,Luis,28,ES28209599118326557478,TRX_N-00622-32604841,2022-07-09T10:30:20,Bilbao,Expense,housing,-96.18,-150544.66
buyer_1,Luis,28,ES28209599118326557478,TRX_N-00623-37642879,2022-07-09T11:27:06,Bilbao,Expense,food,-204.49,-150749.15
buyer_1,Luis,28,ES28209599118326557478,TRX_N-00624-59694789,2022-07-09T11:25:26,Bermeo,Expense,transport,-222.01,-150971.16
buyer_1,Luis,28,ES28209599118326557478,TRX_N-00625-59363047,2022-07-10T14:12:01,Bilbao,Expense,loans,-412.43,-151383.59
buyer_1,Luis,28,ES28209599118326557478,TRX_N-00626-60882148,2022-07-10T09:47:13,Bilbao,Expense,housing,-145.49,-151529.08
buyer_1,Luis,28,ES28209599118326557478,TRX_N-00627-58210779,2022-07-10T14:43:04,Bilbao,Expense,education,-421.61,-151950.69
buyer_1,Luis,28,ES28209599118326557478,TRX_N-00628-85739262,2022-07-11T10:52:26,Bilbao,Expense,leisure,-78.4,-152029.09
buyer_1,Luis,28,ES28209599118326557478,TRX_N-00629-47854496,2022-07-11T23:37:40,Bilbao,Expense,transport,-447.98,-152477.07
buyer_1,Luis,28,ES28209599118326557478,TRX_N-00630-19965699,2022-07-11T14:21:03,Bilbao,Expense,personal_care,-160.29,-152637.36
buyer_1,Luis,28,ES28209599118326557478,TRX_N-00631-20283767,2022-07-12T19:25:25,Bilbao,Expense,savings,-354.22,-152991.58
buyer_1,Luis,28,ES28209599118326557478,TRX_N-00632-14739740,2022-07-12T16:07:54,Bilbao,Expense,personal_care,-221.46,-153213.04
buyer_1,Luis,28,ES28209599118326557478,TRX_N-00633-29516128,2022-07-12T13:06:59,Bilbao,Expense,savings,-318.48,-153531.52
buyer_1,Luis,28,ES28209599118326557478,TRX_N-00634-13025577,2022-07-13T10:42:12,Bilbao,Expense,basic-services,-100.66,-153632.18
buyer_1,Luis,28,ES28209599118326557478,TRX_N-00635-92812865,2022-07-13T10:20:20,Bilbao,Expense,technology,-162.77,-153794.95
buyer_1,Luis,28,ES28209599118326557478,TRX_N-00636-63787131,2022-07-13T04:18:56,Durango,Expense,transport,-303.88,-154098.83
buyer_1,Luis,28,ES28209599118326557478,TRX_N-00637-20780785,2022-07-14T15:50:12,Bilbao,Expense,car,-61.72,-154160.55
buyer_1,Luis,28,ES28209599118326557478,TRX_N-00638-16777727,2022-07-14T03:47:18,Bilbao,Expense,clothing,-289.09,-154449.64
buyer_1,Luis,28,ES28209599118326557478,TRX_N-00639-27932081,2022-07-14T10:41:17,Bilbao,Expense,loans,-103.0,-154552.64
buyer_1,Luis,28,ES28209599118326557478,TRX_N-00640-72209303,2022-07-15T12:19:17,Bilbao,Expense,leisure,-347.06,-154899.7
buyer_1,Luis,28,ES28209599118326557478,TRX_N-00641-83301352,2022-07-15T19:31:00,Andoain,Expense,technology,-497.13,-155396.83
buyer_1,Luis,28,ES28209599118326557478,TRX_N-00642-04238672,2022-07-15T09:47:46,Bilbao,Expense,loans,-273.8,-155670.63
buyer_1,Luis,28,ES28209599118326557478,TRX_N-00643-52461493,2022-07-16T09:52:45,Bilbao,Expense,housing,-267.79,-155938.42
buyer_1,Luis,28,ES28209599118326557478,TRX_N-00644-73191590,2022-07-16T06:20:48,Zarautz,Expense,car,-201.18,-156139.6
buyer_1,Luis,28,ES28209599118326557478,TRX_N-00645-43612218,2022-07-16T09:58:46,Eibar,Expense,personal_care,-283.75,-156423.35
buyer_1,Luis,28,ES28209599118326557478,TRX_N-00646-60214460,2022-07-17T18:35:32,Bilbao,Expense,housing,-81.15,-156504.5
buyer_1,Luis,28,ES28209599118326557478,TRX_N-00647-38671368,2022-07-17T08:32:24,Bilbao,Expense,personal_care,-43.17,-156547.67
buyer_1,Luis,28,ES28209599118326557478,TRX_N-00648-23070371,2022-07-17T22:36:01,Bilbao,Expense,leisure,-206.07,-156753.74
buyer_1,Luis,28,ES28209599118326557478,TRX_N-00649-23445013,2022-07-18T16:03:22,Bilbao,Expense,housing,-338.35,-157092.09
buyer_1,Luis,28,ES28209599118326557478,TRX_N-00650-85502545,2022-07-18T11:40:31,Irun,Expense,subscriptions,-449.45,-157541.54
buyer_1,Luis,28,ES28209599118326557478,TRX_N-00651-14436008,2022-07-18T13:12:28,Bilbao,Expense,personal_care,-193.73,-157735.27
buyer_1,Luis,28,ES28209599118326557478,TRX_N-00652-29489261,2022-07-19T08:14:14,Bilbao,Expense,food,-155.28,-157890.55
buyer_1,Luis,28,ES28209599118326557478,TRX_N-00653-69690814,2022-07-19T20:39:08,Bilbao,Expense,housing,-135.91,-158026.46
buyer_1,Luis,28,ES28209599118326557478,TRX_N-00654-52282760,2022-07-19T09:11:57,Bilbao,Expense,subscriptions,-439.0,-158465.46
buyer_1,Luis,28,ES28209599118326557478,TRX_N-00655-39112814,2022-07-20T12:53:16,Salvatierra/Agurain,Expense,technology,-76.47,-158541.93
buyer_1,Luis,28,ES28209599118326557478,TRX_N-00656-93267634,2022-07-20T09:26:26,Bilbao,Expense,children,-55.18,-158597.11
buyer_1,Luis,28,ES28209599118326557478,TRX_N-00657-04736430,2022-07-20T17:08:29,Bilbao,Expense,healthcare,-44.66,-158641.77
buyer_1,Luis,28,ES28209599118326557478,TRX_N-00658-68196014,2022-07-21T11:29:31,Bilbao,Expense,food,-376.31,-159018.08
buyer_1,Luis,28,ES28209599118326557478,TRX_N-00659-81414567,2022-07-21T11:32:41,Bilbao,Expense,subscriptions,-55.19,-159073.27
buyer_1,Luis,28,ES28209599118326557478,TRX_N-00660-93926289,2022-07-21T23:26:17,Bilbao,Expense,education,-435.83,-159509.1
buyer_1,Luis,28,ES28209599118326557478,TRX_N-00661-01155901,2022-07-22T10:33:22,Bilbao,Expense,subscriptions,-326.96,-159836.06
buyer_1,Luis,28,ES28209599118326557478,TRX_N-00662-71744746,2022-07-22T16:21:18,Bilbao,Expense,loans,-376.52,-160212.58
buyer_1,Luis,28,ES28209599118326557478,TRX_N-00663-40241972,2022-07-22T15:04:06,Bilbao,Expense,food,-358.89,-160571.47
buyer_1,Luis,28,ES28209599118326557478,TRX_N-00664-60154883,2022-07-23T10:13:13,Bilbao,Expense,basic-services,-10.33,-160581.8
buyer_1,Luis,28,ES28209599118326557478,TRX_N-00665-64072414,2022-07-23T12:08:02,Bilbao,Expense,clothing,-389.22,-160971.02
buyer_1,Luis,28,ES28209599118326557478,TRX_N-00666-25545506,2022-07-23T09:24:17,Bilbao,Expense,transport,-270.31,-161241.33
buyer_1,Luis,28,ES28209599118326557478,TRX_N-00667-21523364,2022-07-24T11:44:30,Errenteria,Expense,loans,-367.65,-161608.98
buyer_1,Luis,28,ES28209599118326557478,TRX_N-00668-26510469,2022-07-24T12:07:43,Bilbao,Expense,housing,-382.33,-161991.31
buyer_1,Luis,28,ES28209599118326557478,TRX_N-00669-38444398,2022-07-24T09:31:24,Bilbao,Expense,leisure,-164.39,-162155.7
buyer_1,Luis,28,ES28209599118326557478,TRX_N-00670-19674661,2022-07-25T08:12:52,Bilbao,Expense,children,-247.14,-162402.84
buyer_1,Luis,28,ES28209599118326557478,TRX_N-00671-65309354,2022-07-25T21:17:00,Bilbao,Expense,housing,-241.78,-162644.62
buyer_1,Luis,28,ES28209599118326557478,TRX_N-00672-31810408,2022-07-25T20:38:29,Bilbao,Expense,transport,-130.06,-162774.68
buyer_1,Luis,28,ES28209599118326557478,TRX_N-00673-64297317,2022-07-26T15:16:51,Bilbao,Expense,education,-287.17,-163061.85
buyer_1,Luis,28,ES28209599118326557478,TRX_N-00674-58810064,2022-07-26T18:19:20,Bilbao,Expense,basic-services,-217.21,-163279.06
buyer_1,Luis,28,ES28209599118326557478,TRX_N-00675-71127903,2022-07-26T16:02:32,Bilbao,Expense,savings,-184.32,-163463.38
buyer_1,Luis,28,ES28209599118326557478,TRX_N-00676-93154378,2022-07-27T11:29:23,Bilbao,Expense,car,-413.38,-163876.76
buyer_1,Luis,28,ES28209599118326557478,TRX_N-00677-44042000,2022-07-27T09:58:58,Bilbao,Expense,loans,-443.15,-164319.91
buyer_1,Luis,28,ES28209599118326557478,TRX_N-00678-43288657,2022-07-27T15:13:27,Bilbao,Expense,technology,-199.36,-164519.27
buyer_1,Luis,28,ES28209599118326557478,TRX_N-00679-98743049,2022-07-28T09:57:40,Bilbao,Expense,car,-294.81,-164814.08
buyer_1,Luis,28,ES28209599118326557478,TRX_N-00680-01265969,2022-07-28T11:19:16,Bilbao,Expense,car,-52.2,-164866.28
buyer_1,Luis,28,ES28209599118326557478,TRX_N-00681-09260377,2022-07-28T21:51:41,Bilbao,Expense,technology,-119.08,-164985.36
buyer_1,Luis,28,ES28209599118326557478,TRX_N-00682-09132945,2022-07-29T07:18:43,Bilbao,Expense,children,-43.56,-165028.92
buyer_1,Luis,28,ES28209599118326557478,TRX_N-00683-33423819,2022-07-29T14:59:00,Bilbao,Expense,personal_care,-43.46,-165072.38
buyer_1,Luis,28,ES28209599118326557478,TRX_N-00684-60485370,2022-07-29T19:48:34,Bilbao,Expense,car,-489.29,-165561.67
buyer_1,Luis,28,ES28209599118326557478,TRX_N-00685-51094067,2022-07-30T08:21:02,Donostia,Expense,education,-118.53,-165680.2
buyer_1,Luis,28,ES28209599118326557478,TRX_N-00686-74246076,2022-07-30T12:59:42,Bilbao,Expense,food,-223.64,-165903.84
buyer_1,Luis,28,ES28209599118326557478,TRX_N-00687-12767656,2022-07-30T17:57:22,Bilbao,Expense,leisure,-471.67,-166375.51
buyer_1,Luis,28,ES28209599118326557478,TRX_N-00688-16336437,2022-07-31T14:53:34,Bilbao,Expense,subscriptions,-432.11,-166807.62
buyer_1,Luis,28,ES28209599118326557478,TRX_N-00689-58562752,2022-07-31T15:13:32,Bilbao,Expense,savings,-299.21,-167106.83
buyer_1,Luis,28,ES28209599118326557478,TRX_N-00690-45698676,2022-07-31T20:38:05,Bilbao,Expense,savings,-364.81,-167471.64
buyer_1,Luis,28,ES28209599118326557478,TRX_N-00691-46875621,2022-08-01T00:33:35,Bilbao,incomes,salary,1265.98,-166205.66
buyer_1,Luis,28,ES28209599118326557478,TRX_N-00692-81589268,2022-08-01T04:56:44,Bilbao,Expense,clothing,-121.84,-166327.5
buyer_1,Luis,28,ES28209599118326557478,TRX_N-00693-06362210,2022-08-01T12:32:30,Bilbao,Expense,technology,-250.72,-166578.22
buyer_1,Luis,28,ES28209599118326557478,TRX_N-00694-47573111,2022-08-01T19:37:12,Bilbao,Expense,car,-175.38,-166753.6
buyer_1,Luis,28,ES28209599118326557478,TRX_N-00695-86793194,2022-08-02T15:39:09,Bilbao,Expense,education,-312.01,-167065.61
buyer_1,Luis,28,ES28209599118326557478,TRX_N-00696-93650736,2022-08-02T11:49:41,Bilbao,Expense,housing,-70.86,-167136.47
buyer_1,Luis,28,ES28209599118326557478,TRX_N-00697-50248913,2022-08-02T19:51:41,Barakaldo,Expense,clothing,-53.39,-167189.86
buyer_1,Luis,28,ES28209599118326557478,TRX_N-00698-78698731,2022-08-03T16:21:21,Bilbao,Expense,leisure,-129.18,-167319.04
buyer_1,Luis,28,ES28209599118326557478,TRX_N-00699-33535803,2022-08-03T10:22:28,Bilbao,Expense,car,-353.07,-167672.11
buyer_1,Luis,28,ES28209599118326557478,TRX_N-00700-24806256,2022-08-03T16:50:13,Bilbao,Expense,clothing,-227.77,-167899.88
buyer_1,Luis,28,ES28209599118326557478,TRX_N-00701-96310769,2022-08-04T10:25:47,Bilbao,Housing,Rent,-1369.49,-169269.37
buyer_1,Luis,28,ES28209599118326557478,TRX_N-00702-62320072,2022-08-04T18:12:07,Bilbao,Expense,subscriptions,-105.39,-169374.76
buyer_1,Luis,28,ES28209599118326557478,TRX_N-00703-97269338,2022-08-04T12:58:02,Bilbao,Expense,subscriptions,-372.38,-169747.14
buyer_1,Luis,28,ES28209599118326557478,TRX_N-00704-10727916,2022-08-04T14:52:03,Bilbao,Expense,car,-292.77,-170039.91
buyer_1,Luis,28,ES28209599118326557478,TRX_N-00705-52183446,2022-08-05T12:02:13,Bilbao,basic_services,internet,-49.53,-170089.44
buyer_1,Luis,28,ES28209599118326557478,TRX_N-00706-72154843,2022-08-05T12:28:32,Bilbao,Expense,leisure,-328.01,-170417.45
buyer_1,Luis,28,ES28209599118326557478,TRX_N-00707-29955414,2022-08-05T14:43:07,Bilbao,Expense,children,-30.26,-170447.71
buyer_1,Luis,28,ES28209599118326557478,TRX_N-00708-63051567,2022-08-05T15:59:48,Bilbao,Expense,loans,-79.93,-170527.64
buyer_1,Luis,28,ES28209599118326557478,TRX_N-00709-53319189,2022-08-06T15:52:34,Bilbao,basic_services,water,-72.09,-170599.73
buyer_1,Luis,28,ES28209599118326557478,TRX_N-00710-16148474,2022-08-06T13:02:04,Bilbao,Expense,subscriptions,-370.26,-170969.99
buyer_1,Luis,28,ES28209599118326557478,TRX_N-00711-76087269,2022-08-06T20:16:08,Bilbao,Expense,subscriptions,-331.91,-171301.9
buyer_1,Luis,28,ES28209599118326557478,TRX_N-00712-57763581,2022-08-06T20:35:22,Bilbao,Expense,housing,-188.01,-171489.91
buyer_1,Luis,28,ES28209599118326557478,TRX_N-00713-77702414,2022-08-07T16:51:06,Bilbao,basic_services,gas,-92.74,-171582.65
buyer_1,Luis,28,ES28209599118326557478,TRX_N-00714-26686140,2022-08-07T12:46:44,Bilbao,Expense,technology,-82.54,-171665.19
buyer_1,Luis,28,ES28209599118326557478,TRX_N-00715-57947511,2022-08-07T16:00:42,Leioa,Expense,car,-31.28,-171696.47
buyer_1,Luis,28,ES28209599118326557478,TRX_N-00716-67377067,2022-08-07T18:30:07,Bilbao,Expense,savings,-394.63,-172091.1
buyer_1,Luis,28,ES28209599118326557478,TRX_N-00717-12814583,2022-08-08T14:43:56,Bilbao,basic_services,phone,-99.44,-172190.54
buyer_1,Luis,28,ES28209599118326557478,TRX_N-00718-27229835,2022-08-08T09:23:11,Bilbao,basic_services,electricity,-131.47,-172322.01
buyer_1,Luis,28,ES28209599118326557478,TRX_N-00719-67575366,2022-08-08T10:58:34,Bilbao,Expense,transport,-394.03,-172716.04
buyer_1,Luis,28,ES28209599118326557478,TRX_N-00720-96141424,2022-08-08T09:22:11,Bilbao,Expense,personal_care,-427.81,-173143.85
buyer_1,Luis,28,ES28209599118326557478,TRX_N-00721-94969201,2022-08-08T12:35:41,Bilbao,Expense,savings,-479.89,-173623.74
buyer_1,Luis,28,ES28209599118326557478,TRX_N-00722-79511852,2022-08-09T14:05:44,Bilbao,Expense,personal_care,-23.25,-173646.99
buyer_1,Luis,28,ES28209599118326557478,TRX_N-00723-25791558,2022-08-09T16:16:32,Bilbao,Expense,food,-429.58,-174076.57
buyer_1,Luis,28,ES28209599118326557478,TRX_N-00724-80342933,2022-08-09T14:15:16,Bilbao,Expense,subscriptions,-165.43,-174242.0
buyer_1,Luis,28,ES28209599118326557478,TRX_N-00725-52404314,2022-08-10T11:10:13,Bilbao,Expense,leisure,-69.74,-174311.74
buyer_1,Luis,28,ES28209599118326557478,TRX_N-00726-54639142,2022-08-10T10:15:10,Bilbao,Expense,transport,-207.79,-174519.53
buyer_1,Luis,28,ES28209599118326557478,TRX_N-00727-07428114,2022-08-10T15:04:19,Bilbao,Expense,car,-22.5,-174542.03
buyer_1,Luis,28,ES28209599118326557478,TRX_N-00728-32440117,2022-08-11T13:04:56,Bilbao,Expense,food,-279.98,-174822.01
buyer_1,Luis,28,ES28209599118326557478,TRX_N-00729-14107527,2022-08-11T16:04:10,Vitoria-Gasteiz,Expense,healthcare,-65.31,-174887.32
buyer_1,Luis,28,ES28209599118326557478,TRX_N-00730-31399453,2022-08-11T17:27:38,Bilbao,Expense,healthcare,-140.55,-175027.87
buyer_1,Luis,28,ES28209599118326557478,TRX_N-00731-18125648,2022-08-12T19:44:06,Bilbao,Expense,transport,-63.97,-175091.84
buyer_1,Luis,28,ES28209599118326557478,TRX_N-00732-08166464,2022-08-12T19:52:20,Bilbao,Expense,technology,-311.2,-175403.04
buyer_1,Luis,28,ES28209599118326557478,TRX_N-00733-85241133,2022-08-12T12:05:02,Leioa,Expense,children,-404.38,-175807.42
buyer_1,Luis,28,ES28209599118326557478,TRX_N-00734-12605544,2022-08-13T08:36:21,Barakaldo,Expense,education,-99.06,-175906.48
buyer_1,Luis,28,ES28209599118326557478,TRX_N-00735-20859244,2022-08-13T12:33:36,Bilbao,Expense,car,-128.13,-176034.61
buyer_1,Luis,28,ES28209599118326557478,TRX_N-00736-16229943,2022-08-13T11:10:24,Pasaia,Expense,loans,-437.65,-176472.26
buyer_1,Luis,28,ES28209599118326557478,TRX_N-00737-44619743,2022-08-14T10:46:44,Pasaia,Expense,clothing,-270.65,-176742.91
buyer_1,Luis,28,ES28209599118326557478,TRX_N-00738-52476392,2022-08-14T11:44:25,Bilbao,Expense,loans,-89.65,-176832.56
buyer_1,Luis,28,ES28209599118326557478,TRX_N-00739-81392322,2022-08-14T14:34:17,Bilbao,Expense,housing,-395.22,-177227.78
buyer_1,Luis,28,ES28209599118326557478,TRX_N-00740-99997344,2022-08-15T09:31:41,Bilbao,Expense,subscriptions,-410.97,-177638.75
buyer_1,Luis,28,ES28209599118326557478,TRX_N-00741-46685337,2022-08-15T06:54:56,Bilbao,Expense,children,-489.16,-178127.91
buyer_1,Luis,28,ES28209599118326557478,TRX_N-00742-31360517,2022-08-15T17:42:00,Bilbao,Expense,transport,-425.37,-178553.28
buyer_1,Luis,28,ES28209599118326557478,TRX_N-00743-88347972,2022-08-16T16:04:50,Bilbao,Expense,personal_care,-192.71,-178745.99
buyer_1,Luis,28,ES28209599118326557478,TRX_N-00744-41888817,2022-08-16T08:31:17,Bilbao,Expense,technology,-221.38,-178967.37
buyer_1,Luis,28,ES28209599118326557478,TRX_N-00745-94495925,2022-08-16T18:41:00,Bilbao,Expense,transport,-288.91,-179256.28
buyer_1,Luis,28,ES28209599118326557478,TRX_N-00746-83159344,2022-08-17T19:56:13,Bilbao,Expense,food,-454.35,-179710.63
buyer_1,Luis,28,ES28209599118326557478,TRX_N-00747-01136067,2022-08-17T10:36:34,Bilbao,Expense,technology,-127.72,-179838.35
buyer_1,Luis,28,ES28209599118326557478,TRX_N-00748-13972492,2022-08-17T11:42:10,Bilbao,Expense,leisure,-101.49,-179939.84
buyer_1,Luis,28,ES28209599118326557478,TRX_N-00749-89335666,2022-08-18T09:19:08,Bilbao,Expense,car,-226.64,-180166.48
buyer_1,Luis,28,ES28209599118326557478,TRX_N-00750-68708959,2022-08-18T16:27:17,Bilbao,Expense,clothing,-278.21,-180444.69
buyer_1,Luis,28,ES28209599118326557478,TRX_N-00751-91515143,2022-08-18T15:35:50,Bilbao,Expense,children,-400.24,-180844.93
buyer_1,Luis,28,ES28209599118326557478,TRX_N-00752-92049917,2022-08-19T09:24:15,Bilbao,Expense,food,-268.88,-181113.81
buyer_1,Luis,28,ES28209599118326557478,TRX_N-00753-08594288,2022-08-19T12:20:43,Bilbao,Expense,car,-208.95,-181322.76
buyer_1,Luis,28,ES28209599118326557478,TRX_N-00754-10128217,2022-08-19T19:12:15,Eibar,Expense,basic-services,-247.39,-181570.15
buyer_1,Luis,28,ES28209599118326557478,TRX_N-00755-18234744,2022-08-20T10:31:05,Bilbao,Expense,housing,-34.76,-181604.91
buyer_1,Luis,28,ES28209599118326557478,TRX_N-00756-61691526,2022-08-20T08:16:15,Bilbao,Expense,healthcare,-186.83,-181791.74
buyer_1,Luis,28,ES28209599118326557478,TRX_N-00757-24459300,2022-08-20T01:52:32,Bilbao,Expense,loans,-167.44,-181959.18
buyer_1,Luis,28,ES28209599118326557478,TRX_N-00758-07866904,2022-08-21T23:10:37,Bilbao,Expense,subscriptions,-454.76,-182413.94
buyer_1,Luis,28,ES28209599118326557478,TRX_N-00759-42402613,2022-08-21T05:29:22,Bilbao,Expense,personal_care,-121.63,-182535.57
buyer_1,Luis,28,ES28209599118326557478,TRX_N-00760-07570177,2022-08-21T10:02:46,Bilbao,Expense,clothing,-285.76,-182821.33
buyer_1,Luis,28,ES28209599118326557478,TRX_N-00761-15155964,2022-08-22T09:38:50,Bilbao,Expense,clothing,-163.87,-182985.2
buyer_1,Luis,28,ES28209599118326557478,TRX_N-00762-43893847,2022-08-22T20:00:43,Bilbao,Expense,car,-154.52,-183139.72
buyer_1,Luis,28,ES28209599118326557478,TRX_N-00763-29514570,2022-08-22T04:35:50,Amurrio,Expense,savings,-386.15,-183525.87
buyer_1,Luis,28,ES28209599118326557478,TRX_N-00764-76917477,2022-08-23T09:43:55,Bilbao,Expense,basic-services,-242.81,-183768.68
buyer_1,Luis,28,ES28209599118326557478,TRX_N-00765-53655701,2022-08-23T10:08:21,Bilbao,Expense,personal_care,-169.09,-183937.77
buyer_1,Luis,28,ES28209599118326557478,TRX_N-00766-43388317,2022-08-23T13:20:32,Bilbao,Expense,technology,-83.81,-184021.58
buyer_1,Luis,28,ES28209599118326557478,TRX_N-00767-45831765,2022-08-24T14:54:09,Bilbao,Expense,clothing,-370.14,-184391.72
buyer_1,Luis,28,ES28209599118326557478,TRX_N-00768-54599443,2022-08-24T20:02:22,Bilbao,Expense,savings,-360.09,-184751.81
buyer_1,Luis,28,ES28209599118326557478,TRX_N-00769-22735169,2022-08-24T07:53:00,Pasaia,Expense,clothing,-440.96,-185192.77
buyer_1,Luis,28,ES28209599118326557478,TRX_N-00770-34455144,2022-08-25T17:25:53,Bilbao,Expense,subscriptions,-167.17,-185359.94
buyer_1,Luis,28,ES28209599118326557478,TRX_N-00771-90038035,2022-08-25T12:04:59,Bilbao,Expense,subscriptions,-145.0,-185504.94
buyer_1,Luis,28,ES28209599118326557478,TRX_N-00772-42153663,2022-08-25T20:04:06,Bilbao,Expense,basic-services,-182.57,-185687.51
buyer_1,Luis,28,ES28209599118326557478,TRX_N-00773-92838284,2022-08-26T18:04:52,Bilbao,Expense,food,-314.55,-186002.06
buyer_1,Luis,28,ES28209599118326557478,TRX_N-00774-79974392,2022-08-26T05:55:15,Bilbao,Expense,children,-196.54,-186198.6
buyer_1,Luis,28,ES28209599118326557478,TRX_N-00775-35629594,2022-08-26T15:50:33,Bilbao,Expense,basic-services,-480.36,-186678.96
buyer_1,Luis,28,ES28209599118326557478,TRX_N-00776-34124318,2022-08-27T20:42:57,Bilbao,Expense,subscriptions,-437.72,-187116.68
buyer_1,Luis,28,ES28209599118326557478,TRX_N-00777-68068763,2022-08-27T08:18:50,Basauri,Expense,children,-361.3,-187477.98
buyer_1,Luis,28,ES28209599118326557478,TRX_N-00778-84954542,2022-08-27T19:22:53,Portugalete,Expense,education,-128.67,-187606.65
buyer_1,Luis,28,ES28209599118326557478,TRX_N-00779-98267119,2022-08-28T10:46:19,Bilbao,Expense,car,-222.49,-187829.14
buyer_1,Luis,28,ES28209599118326557478,TRX_N-00780-24457834,2022-08-28T16:51:51,Bilbao,Expense,leisure,-292.73,-188121.87
buyer_1,Luis,28,ES28209599118326557478,TRX_N-00781-37537427,2022-08-28T17:13:59,Bilbao,Expense,savings,-249.26,-188371.13
buyer_1,Luis,28,ES28209599118326557478,TRX_N-00782-42513105,2022-08-29T10:51:59,Bilbao,Expense,basic-services,-275.58,-188646.71
buyer_1,Luis,28,ES28209599118326557478,TRX_N-00783-90588066,2022-08-29T20:40:09,Bilbao,Expense,car,-168.05,-188814.76
buyer_1,Luis,28,ES28209599118326557478,TRX_N-00784-99781517,2022-08-29T12:03:54,Bilbao,Expense,food,-341.23,-189155.99
buyer_1,Luis,28,ES28209599118326557478,TRX_N-00785-37805943,2022-08-30T15:35:15,Bilbao,Expense,loans,-441.96,-189597.95
buyer_1,Luis,28,ES28209599118326557478,TRX_N-00786-87179771,2022-08-30T22:41:06,Bilbao,Expense,education,-167.97,-189765.92
buyer_1,Luis,28,ES28209599118326557478,TRX_N-00787-23550197,2022-08-30T11:30:38,Erandio,Expense,healthcare,-297.13,-190063.05
buyer_1,Luis,28,ES28209599118326557478,TRX_N-00788-05070514,2022-08-31T21:17:50,Bilbao,Expense,education,-67.62,-190130.67
buyer_1,Luis,28,ES28209599118326557478,TRX_N-00789-81804449,2022-08-31T15:00:15,Sopela,Expense,loans,-173.87,-190304.54
buyer_1,Luis,28,ES28209599118326557478,TRX_N-00790-71699387,2022-08-31T23:44:34,Bilbao,Expense,savings,-190.23,-190494.77
buyer_1,Luis,28,ES28209599118326557478,TRX_N-00791-62051165,2022-09-01T08:27:15,Bilbao,incomes,salary,1265.98,-189228.79
buyer_1,Luis,28,ES28209599118326557478,TRX_N-00792-88726381,2022-09-01T08:27:15,Bilbao,incomes,extra_income,126.6,-189102.19
buyer_1,Luis,28,ES28209599118326557478,TRX_N-00793-67241536,2022-09-01T19:26:18,Bilbao,Expense,subscriptions,-225.39,-189327.58
buyer_1,Luis,28,ES28209599118326557478,TRX_N-00794-09524179,2022-09-01T16:26:15,Bilbao,Expense,food,-89.75,-189417.33
buyer_1,Luis,28,ES28209599118326557478,TRX_N-00795-11367195,2022-09-01T16:53:49,Bilbao,Expense,transport,-256.57,-189673.9
buyer_1,Luis,28,ES28209599118326557478,TRX_N-00796-15536574,2022-09-02T10:13:00,Bilbao,Expense,savings,-475.68,-190149.58
buyer_1,Luis,28,ES28209599118326557478,TRX_N-00797-93067974,2022-09-02T12:08:16,Erandio,Expense,education,-291.12,-190440.7
buyer_1,Luis,28,ES28209599118326557478,TRX_N-00798-70301150,2022-09-02T00:42:55,Bilbao,Expense,subscriptions,-78.79,-190519.49
buyer_1,Luis,28,ES28209599118326557478,TRX_N-00799-05226043,2022-09-03T18:00:07,Bilbao,Expense,leisure,-230.28,-190749.77
buyer_1,Luis,28,ES28209599118326557478,TRX_N-00800-07252619,2022-09-03T15:06:49,Bilbao,Expense,healthcare,-112.56,-190862.33
buyer_1,Luis,28,ES28209599118326557478,TRX_N-00801-84915925,2022-09-03T11:43:55,Bilbao,Expense,children,-357.65,-191219.98
buyer_1,Luis,28,ES28209599118326557478,TRX_N-00802-67973019,2022-09-04T11:21:42,Bilbao,Housing,Rent,-1369.49,-192589.47
buyer_1,Luis,28,ES28209599118326557478,TRX_N-00803-20304190,2022-09-04T13:16:03,Bilbao,Expense,personal_care,-409.09,-192998.56
buyer_1,Luis,28,ES28209599118326557478,TRX_N-00804-28096562,2022-09-04T14:30:37,Bilbao,Expense,personal_care,-136.84,-193135.4
buyer_1,Luis,28,ES28209599118326557478,TRX_N-00805-97942724,2022-09-04T09:29:04,Hondarribia,Expense,subscriptions,-10.12,-193145.52
buyer_1,Luis,28,ES28209599118326557478,TRX_N-00806-14011564,2022-09-05T10:53:35,Leioa,Expense,basic-services,-30.79,-193176.31
buyer_1,Luis,28,ES28209599118326557478,TRX_N-00807-39370177,2022-09-05T15:19:25,Durango,Expense,savings,-485.96,-193662.27
buyer_1,Luis,28,ES28209599118326557478,TRX_N-00808-59737806,2022-09-05T15:07:19,Bilbao,Expense,housing,-292.24,-193954.51
buyer_1,Luis,28,ES28209599118326557478,TRX_N-00809-62632648,2022-09-06T10:58:57,Bilbao,basic_services,gas,-19.34,-193973.85
buyer_1,Luis,28,ES28209599118326557478,TRX_N-00810-05356615,2022-09-06T17:23:34,Bilbao,Expense,housing,-101.64,-194075.49
buyer_1,Luis,28,ES28209599118326557478,TRX_N-00811-59575320,2022-09-06T16:03:37,Bilbao,Expense,transport,-334.67,-194410.16
buyer_1,Luis,28,ES28209599118326557478,TRX_N-00812-38510190,2022-09-06T17:46:22,Bilbao,Expense,basic-services,-208.24,-194618.4
buyer_1,Luis,28,ES28209599118326557478,TRX_N-00813-09009076,2022-09-07T00:00:13,Bilbao,basic_services,water,-69.63,-194688.03
buyer_1,Luis,28,ES28209599118326557478,TRX_N-00814-05808287,2022-09-07T04:21:56,Bilbao,Expense,children,-341.17,-195029.2
buyer_1,Luis,28,ES28209599118326557478,TRX_N-00815-71018212,2022-09-07T10:02:04,Getxo,Expense,savings,-296.73,-195325.93
buyer_1,Luis,28,ES28209599118326557478,TRX_N-00816-55686289,2022-09-07T07:17:07,Bilbao,Expense,subscriptions,-27.39,-195353.32
buyer_1,Luis,28,ES28209599118326557478,TRX_N-00817-70863379,2022-09-08T09:45:08,Bilbao,basic_services,phone,-72.02,-195425.34
buyer_1,Luis,28,ES28209599118326557478,TRX_N-00818-16683626,2022-09-08T21:10:34,Bilbao,basic_services,electricity,-137.51,-195562.85
buyer_1,Luis,28,ES28209599118326557478,TRX_N-00819-34122135,2022-09-08T19:48:26,Bilbao,basic_services,internet,-40.66,-195603.51
buyer_1,Luis,28,ES28209599118326557478,TRX_N-00820-46998356,2022-09-08T11:58:27,Bilbao,Expense,clothing,-44.12,-195647.63
buyer_1,Luis,28,ES28209599118326557478,TRX_N-00821-10819489,2022-09-08T19:23:45,Irun,Expense,healthcare,-458.68,-196106.31
buyer_1,Luis,28,ES28209599118326557478,TRX_N-00822-33057498,2022-09-08T13:39:48,Bilbao,Expense,healthcare,-225.08,-196331.39
buyer_1,Luis,28,ES28209599118326557478,TRX_N-00823-60951438,2022-09-09T11:51:54,Bilbao,Expense,car,-148.06,-196479.45
buyer_1,Luis,28,ES28209599118326557478,TRX_N-00824-54587862,2022-09-09T19:13:40,Bilbao,Expense,savings,-60.51,-196539.96
buyer_1,Luis,28,ES28209599118326557478,TRX_N-00825-72570327,2022-09-09T11:20:51,Alegría-Dulantzi,Expense,food,-154.3,-196694.26
buyer_1,Luis,28,ES28209599118326557478,TRX_N-00826-82166029,2022-09-10T09:44:14,Bilbao,Expense,savings,-174.8,-196869.06
buyer_1,Luis,28,ES28209599118326557478,TRX_N-00827-41057858,2022-09-10T10:57:43,Oyón-Oion,Expense,education,-480.68,-197349.74
buyer_1,Luis,28,ES28209599118326557478,TRX_N-00828-33118610,2022-09-10T13:43:46,Bilbao,Expense,transport,-197.22,-197546.96
buyer_1,Luis,28,ES28209599118326557478,TRX_N-00829-69759843,2022-09-11T17:18:37,Eibar,Expense,leisure,-123.43,-197670.39
buyer_1,Luis,28,ES28209599118326557478,TRX_N-00830-02438491,2022-09-11T18:11:13,Bilbao,Expense,subscriptions,-111.8,-197782.19
buyer_1,Luis,28,ES28209599118326557478,TRX_N-00831-42900801,2022-09-11T23:26:04,Bilbao,Expense,children,-296.11,-198078.3
buyer_1,Luis,28,ES28209599118326557478,TRX_N-00832-15919069,2022-09-12T12:16:10,Andoain,Expense,basic-services,-172.4,-198250.7
buyer_1,Luis,28,ES28209599118326557478,TRX_N-00833-91005523,2022-09-12T09:33:40,Bilbao,Expense,housing,-449.68,-198700.38
buyer_1,Luis,28,ES28209599118326557478,TRX_N-00834-31684585,2022-09-12T12:27:34,Bilbao,Expense,loans,-263.26,-198963.64
buyer_1,Luis,28,ES28209599118326557478,TRX_N-00835-64458291,2022-09-13T22:07:21,Bilbao,Expense,car,-430.52,-199394.16
buyer_1,Luis,28,ES28209599118326557478,TRX_N-00836-73835981,2022-09-13T09:55:54,Durango,Expense,transport,-435.72,-199829.88
buyer_1,Luis,28,ES28209599118326557478,TRX_N-00837-86479706,2022-09-13T17:50:32,Bilbao,Expense,healthcare,-418.69,-200248.57
buyer_1,Luis,28,ES28209599118326557478,TRX_N-00838-34364005,2022-09-14T13:10:10,Bilbao,Expense,leisure,-367.78,-200616.35
buyer_1,Luis,28,ES28209599118326557478,TRX_N-00839-87119609,2022-09-14T17:05:56,Bilbao,Expense,subscriptions,-415.79,-201032.14
buyer_1,Luis,28,ES28209599118326557478,TRX_N-00840-22968166,2022-09-14T20:03:00,Bilbao,Expense,leisure,-17.69,-201049.83
buyer_1,Luis,28,ES28209599118326557478,TRX_N-00841-86990697,2022-09-15T16:08:00,Bilbao,Expense,loans,-359.08,-201408.91
buyer_1,Luis,28,ES28209599118326557478,TRX_N-00842-21862096,2022-09-15T15:45:28,Bilbao,Expense,food,-228.2,-201637.11
buyer_1,Luis,28,ES28209599118326557478,TRX_N-00843-93766215,2022-09-15T20:31:49,Bilbao,Expense,basic-services,-112.1,-201749.21
buyer_1,Luis,28,ES28209599118326557478,TRX_N-00844-60455368,2022-09-16T02:02:20,Bilbao,Expense,technology,-479.75,-202228.96
buyer_1,Luis,28,ES28209599118326557478,TRX_N-00845-05015876,2022-09-16T08:06:25,Zarautz,Expense,transport,-348.75,-202577.71
buyer_1,Luis,28,ES28209599118326557478,TRX_N-00846-78134832,2022-09-16T20:32:19,Bilbao,Expense,basic-services,-436.1,-203013.81
buyer_1,Luis,28,ES28209599118326557478,TRX_N-00847-08256721,2022-09-17T12:24:42,Andoain,Expense,car,-312.56,-203326.37
buyer_1,Luis,28,ES28209599118326557478,TRX_N-00848-12933577,2022-09-17T13:34:55,Bilbao,Expense,loans,-453.14,-203779.51
buyer_1,Luis,28,ES28209599118326557478,TRX_N-00849-16751838,2022-09-17T10:33:43,Santurtzi,Expense,healthcare,-316.51,-204096.02
buyer_1,Luis,28,ES28209599118326557478,TRX_N-00850-15787418,2022-09-18T14:56:50,Errenteria,Expense,technology,-358.57,-204454.59
buyer_1,Luis,28,ES28209599118326557478,TRX_N-00851-25733797,2022-09-18T11:47:46,Bilbao,Expense,personal_care,-242.38,-204696.97
buyer_1,Luis,28,ES28209599118326557478,TRX_N-00852-11573798,2022-09-18T21:07:29,Bilbao,Expense,subscriptions,-136.22,-204833.19
buyer_1,Luis,28,ES28209599118326557478,TRX_N-00853-97526512,2022-09-19T10:37:38,Bilbao,Expense,clothing,-239.02,-205072.21
buyer_1,Luis,28,ES28209599118326557478,TRX_N-00854-56595537,2022-09-19T08:37:01,Bermeo,Expense,basic-services,-366.44,-205438.65
buyer_1,Luis,28,ES28209599118326557478,TRX_N-00855-74406707,2022-09-19T10:36:02,Bilbao,Expense,transport,-340.28,-205778.93
buyer_1,Luis,28,ES28209599118326557478,TRX_N-00856-75446753,2022-09-20T12:15:53,Eibar,Expense,technology,-280.27,-206059.2
buyer_1,Luis,28,ES28209599118326557478,TRX_N-00857-30973173,2022-09-20T23:03:32,Bilbao,Expense,healthcare,-320.47,-206379.67
buyer_1,Luis,28,ES28209599118326557478,TRX_N-00858-02285275,2022-09-20T12:24:03,Portugalete,Expense,healthcare,-310.27,-206689.94
buyer_1,Luis,28,ES28209599118326557478,TRX_N-00859-96282615,2022-09-21T16:25:33,Pasaia,Expense,food,-232.5,-206922.44
buyer_1,Luis,28,ES28209599118326557478,TRX_N-00860-09882106,2022-09-21T19:21:24,Bilbao,Expense,loans,-457.51,-207379.95
buyer_1,Luis,28,ES28209599118326557478,TRX_N-00861-11926605,2022-09-21T12:36:58,Durango,Expense,subscriptions,-73.1,-207453.05
buyer_1,Luis,28,ES28209599118326557478,TRX_N-00862-70704971,2022-09-22T23:16:15,Bilbao,Expense,loans,-310.64,-207763.69
buyer_1,Luis,28,ES28209599118326557478,TRX_N-00863-62384383,2022-09-22T14:16:42,Bilbao,Expense,housing,-382.6,-208146.29
buyer_1,Luis,28,ES28209599118326557478,TRX_N-00864-74391440,2022-09-22T06:44:26,Bilbao,Expense,housing,-412.82,-208559.11
buyer_1,Luis,28,ES28209599118326557478,TRX_N-00865-26290438,2022-09-23T15:35:39,Bilbao,Expense,transport,-130.02,-208689.13
buyer_1,Luis,28,ES28209599118326557478,TRX_N-00866-32306794,2022-09-23T10:01:51,Bilbao,Expense,basic-services,-332.24,-209021.37
buyer_1,Luis,28,ES28209599118326557478,TRX_N-00867-47089758,2022-09-23T12:12:41,Bilbao,Expense,clothing,-33.89,-209055.26
buyer_1,Luis,28,ES28209599118326557478,TRX_N-00868-76146116,2022-09-24T13:54:29,Bilbao,Expense,housing,-140.47,-209195.73
buyer_1,Luis,28,ES28209599118326557478,TRX_N-00869-67887222,2022-09-24T04:46:34,Bilbao,Expense,clothing,-55.78,-209251.51
buyer_1,Luis,28,ES28209599118326557478,TRX_N-00870-21553272,2022-09-24T15:25:58,Bilbao,Expense,education,-401.73,-209653.24
buyer_1,Luis,28,ES28209599118326557478,TRX_N-00871-01681110,2022-09-25T19:08:29,Bilbao,Expense,car,-75.11,-209728.35
buyer_1,Luis,28,ES28209599118326557478,TRX_N-00872-61358810,2022-09-25T14:34:02,Bilbao,Expense,subscriptions,-260.67,-209989.02
buyer_1,Luis,28,ES28209599118326557478,TRX_N-00873-15988948,2022-09-25T10:18:43,Bilbao,Expense,food,-161.01,-210150.03
buyer_1,Luis,28,ES28209599118326557478,TRX_N-00874-70666389,2022-09-26T16:48:31,Bilbao,Expense,leisure,-380.52,-210530.55
buyer_1,Luis,28,ES28209599118326557478,TRX_N-00875-08047741,2022-09-26T21:53:29,Bilbao,Expense,education,-253.21,-210783.76
buyer_1,Luis,28,ES28209599118326557478,TRX_N-00876-50196720,2022-09-26T19:46:17,Bilbao,Expense,technology,-230.32,-211014.08
buyer_1,Luis,28,ES28209599118326557478,TRX_N-00877-40172935,2022-09-27T11:52:35,Bilbao,Expense,loans,-206.49,-211220.57
buyer_1,Luis,28,ES28209599118326557478,TRX_N-00878-96503232,2022-09-27T10:02:46,Bilbao,Expense,food,-374.2,-211594.77
buyer_1,Luis,28,ES28209599118326557478,TRX_N-00879-89088369,2022-09-27T21:45:08,Sestao,Expense,leisure,-490.9,-212085.67
buyer_1,Luis,28,ES28209599118326557478,TRX_N-00880-88358287,2022-09-28T10:42:40,Bilbao,Expense,clothing,-238.09,-212323.76
buyer_1,Luis,28,ES28209599118326557478,TRX_N-00881-97166605,2022-09-28T15:34:18,Bilbao,Expense,education,-319.43,-212643.19
buyer_1,Luis,28,ES28209599118326557478,TRX_N-00882-44664993,2022-09-28T17:15:29,Eibar,Expense,leisure,-474.63,-213117.82
buyer_1,Luis,28,ES28209599118326557478,TRX_N-00883-72478351,2022-09-29T16:58:07,Andoain,Expense,food,-303.16,-213420.98
buyer_1,Luis,28,ES28209599118326557478,TRX_N-00884-04932887,2022-09-29T11:33:00,Bilbao,Expense,housing,-60.2,-213481.18
buyer_1,Luis,28,ES28209599118326557478,TRX_N-00885-41440238,2022-09-29T17:05:33,Bilbao,Expense,leisure,-488.29,-213969.47
buyer_1,Luis,28,ES28209599118326557478,TRX_N-00886-88839906,2022-09-30T17:38:34,Bilbao,Expense,personal_care,-135.12,-214104.59
buyer_1,Luis,28,ES28209599118326557478,TRX_N-00887-50769959,2022-09-30T17:19:53,Bilbao,Expense,loans,-438.36,-214542.95
buyer_1,Luis,28,ES28209599118326557478,TRX_N-00888-59568183,2022-09-30T01:42:21,Bilbao,Expense,transport,-341.47,-214884.42
buyer_1,Luis,28,ES28209599118326557478,TRX_N-00889-81995002,2022-10-01T04:45:11,Bilbao,incomes,salary,1265.98,-213618.44
buyer_1,Luis,28,ES28209599118326557478,TRX_N-00890-71401897,2022-10-01T20:20:30,Bilbao,Expense,housing,-221.61,-213840.05
buyer_1,Luis,28,ES28209599118326557478,TRX_N-00891-57097017,2022-10-01T15:04:59,Galdakao,Expense,children,-458.64,-214298.69
buyer_1,Luis,28,ES28209599118326557478,TRX_N-00892-67874946,2022-10-01T14:05:40,Bilbao,Expense,children,-464.21,-214762.9
buyer_1,Luis,28,ES28209599118326557478,TRX_N-00893-74719581,2022-10-02T22:32:19,Bilbao,Expense,leisure,-38.01,-214800.91
buyer_1,Luis,28,ES28209599118326557478,TRX_N-00894-94636879,2022-10-02T20:04:10,Llodio,Expense,loans,-270.05,-215070.96
buyer_1,Luis,28,ES28209599118326557478,TRX_N-00895-80538071,2022-10-02T20:24:55,Bilbao,Expense,subscriptions,-225.24,-215296.2
buyer_1,Luis,28,ES28209599118326557478,TRX_N-00896-79416889,2022-10-03T23:04:43,Bilbao,Expense,transport,-426.4,-215722.6
buyer_1,Luis,28,ES28209599118326557478,TRX_N-00897-98609558,2022-10-03T16:52:13,Bilbao,Expense,food,-444.08,-216166.68
buyer_1,Luis,28,ES28209599118326557478,TRX_N-00898-67883234,2022-10-03T14:53:28,Bilbao,Expense,savings,-121.88,-216288.56
buyer_1,Luis,28,ES28209599118326557478,TRX_N-00899-55507069,2022-10-04T04:34:34,Bilbao,Housing,Rent,-1369.49,-217658.05
buyer_1,Luis,28,ES28209599118326557478,TRX_N-00900-92198338,2022-10-04T01:22:05,Bilbao,Expense,leisure,-168.02,-217826.07
buyer_1,Luis,28,ES28209599118326557478,TRX_N-00901-20781447,2022-10-04T12:46:05,Bilbao,Expense,housing,-301.29,-218127.36
buyer_1,Luis,28,ES28209599118326557478,TRX_N-00902-04944486,2022-10-04T01:04:10,Sestao,Expense,subscriptions,-200.65,-218328.01
buyer_1,Luis,28,ES28209599118326557478,TRX_N-00903-14162235,2022-10-05T20:00:03,Bilbao,basic_services,internet,-32.56,-218360.57
buyer_1,Luis,28,ES28209599118326557478,TRX_N-00904-42740824,2022-10-05T11:57:22,Bilbao,Expense,basic-services,-70.81,-218431.38
buyer_1,Luis,28,ES28209599118326557478,TRX_N-00905-61881030,2022-10-05T23:18:24,Bilbao,Expense,transport,-94.84,-218526.22
buyer_1,Luis,28,ES28209599118326557478,TRX_N-00906-32171393,2022-10-05T09:29:54,Bilbao,Expense,children,-247.43,-218773.65
buyer_1,Luis,28,ES28209599118326557478,TRX_N-00907-85512604,2022-10-06T11:43:42,Bilbao,basic_services,gas,-93.29,-218866.94
buyer_1,Luis,28,ES28209599118326557478,TRX_N-00908-19156425,2022-10-06T15:19:48,Bilbao,Expense,basic-services,-186.78,-219053.72
buyer_1,Luis,28,ES28209599118326557478,TRX_N-00909-40010134,2022-10-06T17:39:40,Bilbao,Expense,personal_care,-327.55,-219381.27
buyer_1,Luis,28,ES28209599118326557478,TRX_N-00910-00533535,2022-10-06T15:55:23,Barakaldo,Expense,basic-services,-450.74,-219832.01
buyer_1,Luis,28,ES28209599118326557478,TRX_N-00911-64185677,2022-10-07T02:55:26,Bilbao,basic_services,water,-55.76,-219887.77
buyer_1,Luis,28,ES28209599118326557478,TRX_N-00912-88182206,2022-10-07T08:42:35,Bilbao,Expense,education,-479.15,-220366.92
buyer_1,Luis,28,ES28209599118326557478,TRX_N-00913-01974763,2022-10-07T09:36:56,Portugalete,Expense,loans,-302.57,-220669.49
buyer_1,Luis,28,ES28209599118326557478,TRX_N-00914-72055584,2022-10-07T20:42:58,Bilbao,Expense,personal_care,-108.07,-220777.56
buyer_1,Luis,28,ES28209599118326557478,TRX_N-00915-09212170,2022-10-08T09:20:16,Bilbao,basic_services,electricity,-41.35,-220818.91
buyer_1,Luis,28,ES28209599118326557478,TRX_N-00916-27592516,2022-10-08T13:29:13,Bilbao,basic_services,phone,-24.83,-220843.74
buyer_1,Luis,28,ES28209599118326557478,TRX_N-00917-17478624,2022-10-08T03:46:21,Bilbao,Expense,savings,-105.12,-220948.86
buyer_1,Luis,28,ES28209599118326557478,TRX_N-00918-36186330,2022-10-08T22:39:08,Bilbao,Expense,basic-services,-219.67,-221168.53
buyer_1,Luis,28,ES28209599118326557478,TRX_N-00919-91070882,2022-10-08T15:41:12,Bilbao,Expense,technology,-314.31,-221482.84
buyer_1,Luis,28,ES28209599118326557478,TRX_N-00920-23429095,2022-10-09T17:08:40,Bilbao,Expense,healthcare,-265.41,-221748.25
buyer_1,Luis,28,ES28209599118326557478,TRX_N-00921-80074156,2022-10-09T06:43:00,Bilbao,Expense,children,-366.75,-222115.0
buyer_1,Luis,28,ES28209599118326557478,TRX_N-00922-37108676,2022-10-09T19:53:06,Galdakao,Expense,housing,-174.94,-222289.94
buyer_1,Luis,28,ES28209599118326557478,TRX_N-00923-59446597,2022-10-10T12:50:31,Bilbao,Expense,technology,-406.24,-222696.18
buyer_1,Luis,28,ES28209599118326557478,TRX_N-00924-34569166,2022-10-10T08:59:32,Bilbao,Expense,loans,-211.28,-222907.46
buyer_1,Luis,28,ES28209599118326557478,TRX_N-00925-93367625,2022-10-10T08:05:18,Pasaia,Expense,car,-226.67,-223134.13
buyer_1,Luis,28,ES28209599118326557478,TRX_N-00926-10682035,2022-10-11T13:15:02,Errenteria,Expense,basic-services,-274.51,-223408.64
buyer_1,Luis,28,ES28209599118326557478,TRX_N-00927-57316739,2022-10-11T11:32:44,Erandio,Expense,savings,-366.42,-223775.06
buyer_1,Luis,28,ES28209599118326557478,TRX_N-00928-36801935,2022-10-11T17:35:18,Bilbao,Expense,basic-services,-451.02,-224226.08
buyer_1,Luis,28,ES28209599118326557478,TRX_N-00929-70996476,2022-10-12T09:54:42,Bilbao,Expense,transport,-457.7,-224683.78
buyer_1,Luis,28,ES28209599118326557478,TRX_N-00930-92398204,2022-10-12T12:28:17,Bilbao,Expense,children,-313.42,-224997.2
buyer_1,Luis,28,ES28209599118326557478,TRX_N-00931-54836403,2022-10-12T22:21:34,Bilbao,Expense,food,-213.13,-225210.33
buyer_1,Luis,28,ES28209599118326557478,TRX_N-00932-10152827,2022-10-13T17:50:15,Bilbao,Expense,loans,-378.82,-225589.15
buyer_1,Luis,28,ES28209599118326557478,TRX_N-00933-12535847,2022-10-13T08:57:14,Bilbao,Expense,food,-334.33,-225923.48
buyer_1,Luis,28,ES28209599118326557478,TRX_N-00934-04676230,2022-10-13T16:28:01,Bilbao,Expense,savings,-492.49,-226415.97
buyer_1,Luis,28,ES28209599118326557478,TRX_N-00935-53800739,2022-10-14T20:10:30,Bilbao,Expense,education,-344.06,-226760.03
buyer_1,Luis,28,ES28209599118326557478,TRX_N-00936-06466158,2022-10-14T10:45:17,Bilbao,Expense,technology,-190.22,-226950.25
buyer_1,Luis,28,ES28209599118326557478,TRX_N-00937-70010820,2022-10-14T22:13:49,Bilbao,Expense,education,-373.78,-227324.03
buyer_1,Luis,28,ES28209599118326557478,TRX_N-00938-77264015,2022-10-15T12:41:09,Bilbao,Expense,transport,-254.03,-227578.06
buyer_1,Luis,28,ES28209599118326557478,TRX_N-00939-49693314,2022-10-15T19:25:59,Bilbao,Expense,car,-54.1,-227632.16
buyer_1,Luis,28,ES28209599118326557478,TRX_N-00940-23052026,2022-10-15T10:51:38,Bilbao,Expense,food,-40.59,-227672.75
buyer_1,Luis,28,ES28209599118326557478,TRX_N-00941-18464451,2022-10-16T07:59:45,Bilbao,Expense,food,-463.46,-228136.21
buyer_1,Luis,28,ES28209599118326557478,TRX_N-00942-88989883,2022-10-16T18:14:04,Bilbao,Expense,clothing,-302.35,-228438.56
buyer_1,Luis,28,ES28209599118326557478,TRX_N-00943-95723638,2022-10-16T12:54:58,Bilbao,Expense,housing,-204.61,-228643.17
buyer_1,Luis,28,ES28209599118326557478,TRX_N-00944-60897483,2022-10-17T14:21:42,Bilbao,Expense,education,-69.65,-228712.82
buyer_1,Luis,28,ES28209599118326557478,TRX_N-00945-27111645,2022-10-17T08:43:00,Galdakao,Expense,healthcare,-221.46,-228934.28
buyer_1,Luis,28,ES28209599118326557478,TRX_N-00946-02262507,2022-10-17T12:57:25,Bilbao,Expense,car,-186.56,-229120.84
buyer_1,Luis,28,ES28209599118326557478,TRX_N-00947-74724860,2022-10-18T08:01:48,Sestao,Expense,personal_care,-113.75,-229234.59
buyer_1,Luis,28,ES28209599118326557478,TRX_N-00948-12330004,2022-10-18T01:43:18,Basauri,Expense,children,-337.03,-229571.62
buyer_1,Luis,28,ES28209599118326557478,TRX_N-00949-26154276,2022-10-18T08:45:15,Bilbao,Expense,clothing,-234.6,-229806.22
buyer_1,Luis,28,ES28209599118326557478,TRX_N-00950-19741578,2022-10-19T10:56:51,Mungia,Expense,children,-327.64,-230133.86
buyer_1,Luis,28,ES28209599118326557478,TRX_N-00951-37548083,2022-10-19T18:28:30,Bilbao,Expense,leisure,-180.51,-230314.37
buyer_1,Luis,28,ES28209599118326557478,TRX_N-00952-42175634,2022-10-19T08:54:00,Bilbao,Expense,healthcare,-279.31,-230593.68
buyer_1,Luis,28,ES28209599118326557478,TRX_N-00953-63500262,2022-10-20T22:36:05,Bilbao,Expense,loans,-322.93,-230916.61
buyer_1,Luis,28,ES28209599118326557478,TRX_N-00954-33198453,2022-10-20T04:08:03,Bilbao,Expense,transport,-344.61,-231261.22
buyer_1,Luis,28,ES28209599118326557478,TRX_N-00955-97384950,2022-10-20T06:23:43,Bilbao,Expense,healthcare,-156.48,-231417.7
buyer_1,Luis,28,ES28209599118326557478,TRX_N-00956-69417484,2022-10-21T11:31:25,Bilbao,Expense,education,-189.93,-231607.63
buyer_1,Luis,28,ES28209599118326557478,TRX_N-00957-66617960,2022-10-21T10:59:08,Bilbao,Expense,loans,-386.85,-231994.48
buyer_1,Luis,28,ES28209599118326557478,TRX_N-00958-89851866,2022-10-21T08:12:32,Bilbao,Expense,housing,-51.47,-232045.95
buyer_1,Luis,28,ES28209599118326557478,TRX_N-00959-16972451,2022-10-22T12:22:57,Galdakao,Expense,basic-services,-440.91,-232486.86
buyer_1,Luis,28,ES28209599118326557478,TRX_N-00960-81484685,2022-10-22T13:32:11,Bilbao,Expense,housing,-317.93,-232804.79
buyer_1,Luis,28,ES28209599118326557478,TRX_N-00961-27793150,2022-10-22T19:20:31,Bilbao,Expense,loans,-98.64,-232903.43
buyer_1,Luis,28,ES28209599118326557478,TRX_N-00962-73338012,2022-10-23T14:03:09,Bilbao,Expense,technology,-231.4,-233134.83
buyer_1,Luis,28,ES28209599118326557478,TRX_N-00963-95802921,2022-10-23T18:04:37,Bilbao,Expense,children,-161.0,-233295.83
buyer_1,Luis,28,ES28209599118326557478,TRX_N-00964-24447076,2022-10-23T14:04:11,Bilbao,Expense,loans,-366.75,-233662.58
buyer_1,Luis,28,ES28209599118326557478,TRX_N-00965-34151421,2022-10-24T12:43:33,Bilbao,Expense,education,-32.84,-233695.42
buyer_1,Luis,28,ES28209599118326557478,TRX_N-00966-24346604,2022-10-24T09:06:37,Bilbao,Expense,children,-456.3,-234151.72
buyer_1,Luis,28,ES28209599118326557478,TRX_N-00967-43523882,2022-10-24T16:20:28,Bilbao,Expense,car,-57.18,-234208.9
buyer_1,Luis,28,ES28209599118326557478,TRX_N-00968-11850292,2022-10-25T07:49:10,Bilbao,Expense,leisure,-68.46,-234277.36
buyer_1,Luis,28,ES28209599118326557478,TRX_N-00969-20101269,2022-10-25T10:19:25,Bilbao,Expense,savings,-66.78,-234344.14
buyer_1,Luis,28,ES28209599118326557478,TRX_N-00970-44924858,2022-10-25T08:14:41,Bilbao,Expense,education,-349.28,-234693.42
buyer_1,Luis,28,ES28209599118326557478,TRX_N-00971-67030372,2022-10-26T12:22:50,Berango,Expense,children,-459.55,-235152.97
buyer_1,Luis,28,ES28209599118326557478,TRX_N-00972-12091252,2022-10-26T17:52:19,Bilbao,Expense,leisure,-190.35,-235343.32
buyer_1,Luis,28,ES28209599118326557478,TRX_N-00973-73849981,2022-10-26T14:50:56,Bilbao,Expense,personal_care,-372.87,-235716.19
buyer_1,Luis,28,ES28209599118326557478,TRX_N-00974-76574183,2022-10-27T14:09:23,Bilbao,Expense,clothing,-420.09,-236136.28
buyer_1,Luis,28,ES28209599118326557478,TRX_N-00975-38873960,2022-10-27T15:34:38,Llodio,Expense,healthcare,-420.1,-236556.38
buyer_1,Luis,28,ES28209599118326557478,TRX_N-00976-63620751,2022-10-27T15:37:48,Bilbao,Expense,subscriptions,-274.25,-236830.63
buyer_1,Luis,28,ES28209599118326557478,TRX_N-00977-50792822,2022-10-28T09:31:10,Iruña de Oca,Expense,loans,-441.85,-237272.48
buyer_1,Luis,28,ES28209599118326557478,TRX_N-00978-49846757,2022-10-28T08:28:40,Bilbao,Expense,leisure,-14.71,-237287.19
buyer_1,Luis,28,ES28209599118326557478,TRX_N-00979-76254555,2022-10-28T05:32:17,Bilbao,Expense,transport,-402.41,-237689.6
buyer_1,Luis,28,ES28209599118326557478,TRX_N-00980-36491376,2022-10-29T19:00:44,Bilbao,Expense,healthcare,-231.25,-237920.85
buyer_1,Luis,28,ES28209599118326557478,TRX_N-00981-88118981,2022-10-29T23:55:30,Bilbao,Expense,subscriptions,-272.54,-238193.39
buyer_1,Luis,28,ES28209599118326557478,TRX_N-00982-04981477,2022-10-29T18:20:58,Bilbao,Expense,children,-148.52,-238341.91
buyer_1,Luis,28,ES28209599118326557478,TRX_N-00983-44822435,2022-10-30T17:15:39,Bilbao,Expense,savings,-91.92,-238433.83
buyer_1,Luis,28,ES28209599118326557478,TRX_N-00984-94799793,2022-10-30T19:29:38,Bilbao,Expense,technology,-60.04,-238493.87
buyer_1,Luis,28,ES28209599118326557478,TRX_N-00985-49558386,2022-10-30T14:48:19,Portugalete,Expense,subscriptions,-240.24,-238734.11
buyer_1,Luis,28,ES28209599118326557478,TRX_N-00986-65423456,2022-10-31T13:06:09,Bilbao,Expense,savings,-493.53,-239227.64
buyer_1,Luis,28,ES28209599118326557478,TRX_N-00987-67363640,2022-10-31T08:40:29,Bilbao,Expense,subscriptions,-160.04,-239387.68
buyer_1,Luis,28,ES28209599118326557478,TRX_N-00988-90376179,2022-10-31T12:18:35,Bilbao,Expense,savings,-460.87,-239848.55
buyer_1,Luis,28,ES28209599118326557478,TRX_N-00989-40653117,2022-11-01T17:45:54,Bilbao,incomes,salary,1265.98,-238582.57
buyer_1,Luis,28,ES28209599118326557478,TRX_N-00990-95696379,2022-11-01T17:45:54,Bilbao,incomes,extra_income,126.6,-238455.97
buyer_1,Luis,28,ES28209599118326557478,TRX_N-00991-70051489,2022-11-01T20:01:47,Bilbao,Expense,food,-105.34,-238561.31
buyer_1,Luis,28,ES28209599118326557478,TRX_N-00992-05839184,2022-11-01T15:55:03,Bilbao,Expense,education,-150.92,-238712.23
buyer_1,Luis,28,ES28209599118326557478,TRX_N-00993-25761954,2022-11-01T19:12:37,Bilbao,Expense,clothing,-148.7,-238860.93
buyer_1,Luis,28,ES28209599118326557478,TRX_N-00994-09228189,2022-11-02T15:55:16,Bilbao,Expense,leisure,-175.05,-239035.98
buyer_1,Luis,28,ES28209599118326557478,TRX_N-00995-46377108,2022-11-02T20:40:10,Bilbao,Expense,basic-services,-75.92,-239111.9
buyer_1,Luis,28,ES28209599118326557478,TRX_N-00996-72377088,2022-11-02T14:21:23,Bilbao,Expense,children,-355.19,-239467.09
buyer_1,Luis,28,ES28209599118326557478,TRX_N-00997-30772030,2022-11-03T08:29:13,Bilbao,Expense,housing,-168.94,-239636.03
buyer_1,Luis,28,ES28209599118326557478,TRX_N-00998-36895786,2022-11-03T08:12:39,Bilbao,Expense,food,-323.0,-239959.03
buyer_1,Luis,28,ES28209599118326557478,TRX_N-00999-00546704,2022-11-03T16:00:03,Bilbao,Expense,loans,-327.02,-240286.05
buyer_1,Luis,28,ES28209599118326557478,TRX_N-01000-79248120,2022-11-04T15:57:01,Bilbao,Housing,Rent,-1369.49,-241655.54
buyer_1,Luis,28,ES28209599118326557478,TRX_N-01001-53733902,2022-11-04T19:05:10,Bilbao,Expense,basic-services,-129.66,-241785.2
buyer_1,Luis,28,ES28209599118326557478,TRX_N-01002-10509858,2022-11-04T08:11:44,Bilbao,Expense,clothing,-39.13,-241824.33
buyer_1,Luis,28,ES28209599118326557478,TRX_N-01003-32402430,2022-11-04T18:58:17,Bilbao,Expense,car,-439.11,-242263.44
buyer_1,Luis,28,ES28209599118326557478,TRX_N-01004-50797006,2022-11-05T08:31:30,Bilbao,basic_services,electricity,-129.46,-242392.9
buyer_1,Luis,28,ES28209599118326557478,TRX_N-01005-19700822,2022-11-05T09:51:20,Bilbao,basic_services,gas,-84.88,-242477.78
buyer_1,Luis,28,ES28209599118326557478,TRX_N-01006-27528702,2022-11-05T18:47:12,Bilbao,Expense,subscriptions,-374.05,-242851.83
buyer_1,Luis,28,ES28209599118326557478,TRX_N-01007-45554501,2022-11-05T09:36:35,Bilbao,Expense,leisure,-489.14,-243340.97
buyer_1,Luis,28,ES28209599118326557478,TRX_N-01008-79921353,2022-11-05T18:20:31,Oyón-Oion,Expense,clothing,-453.68,-243794.65
buyer_1,Luis,28,ES28209599118326557478,TRX_N-01009-84661569,2022-11-06T20:44:56,Bilbao,basic_services,water,-10.51,-243805.16
buyer_1,Luis,28,ES28209599118326557478,TRX_N-01010-78967527,2022-11-06T13:56:02,Bilbao,Expense,food,-459.68,-244264.84
buyer_1,Luis,28,ES28209599118326557478,TRX_N-01011-93033068,2022-11-06T09:44:42,Bilbao,Expense,leisure,-23.45,-244288.29
buyer_1,Luis,28,ES28209599118326557478,TRX_N-01012-66117275,2022-11-06T12:46:30,Bilbao,Expense,leisure,-486.1,-244774.39
buyer_1,Luis,28,ES28209599118326557478,TRX_N-01013-69748760,2022-11-07T16:15:22,Bilbao,basic_services,phone,-93.58,-244867.97
buyer_1,Luis,28,ES28209599118326557478,TRX_N-01014-68397291,2022-11-07T16:12:04,Llodio,Expense,loans,-216.5,-245084.47
buyer_1,Luis,28,ES28209599118326557478,TRX_N-01015-09125561,2022-11-07T14:42:41,Bilbao,Expense,subscriptions,-232.55,-245317.02
buyer_1,Luis,28,ES28209599118326557478,TRX_N-01016-85820663,2022-11-07T17:46:42,Portugalete,Expense,leisure,-421.41,-245738.43
buyer_1,Luis,28,ES28209599118326557478,TRX_N-01017-38597821,2022-11-08T10:02:47,Bilbao,basic_services,internet,-33.84,-245772.27
buyer_1,Luis,28,ES28209599118326557478,TRX_N-01018-28311214,2022-11-08T15:53:14,Vitoria-Gasteiz,Expense,transport,-458.06,-246230.33
buyer_1,Luis,28,ES28209599118326557478,TRX_N-01019-01228612,2022-11-08T13:24:21,Bilbao,Expense,personal_care,-409.74,-246640.07
buyer_1,Luis,28,ES28209599118326557478,TRX_N-01020-40526358,2022-11-08T17:29:09,Bilbao,Expense,basic-services,-310.0,-246950.07
buyer_1,Luis,28,ES28209599118326557478,TRX_N-01021-45944823,2022-11-09T08:27:16,Bilbao,Expense,basic-services,-312.38,-247262.45
buyer_1,Luis,28,ES28209599118326557478,TRX_N-01022-55279239,2022-11-09T22:53:58,Galdakao,Expense,education,-179.84,-247442.29
buyer_1,Luis,28,ES28209599118326557478,TRX_N-01023-73786341,2022-11-09T19:44:08,Bilbao,Expense,subscriptions,-85.67,-247527.96
buyer_1,Luis,28,ES28209599118326557478,TRX_N-01024-83348149,2022-11-10T18:12:29,Bilbao,Expense,loans,-461.14,-247989.1
buyer_1,Luis,28,ES28209599118326557478,TRX_N-01025-98757902,2022-11-10T05:54:48,Bilbao,Expense,housing,-442.99,-248432.09
buyer_1,Luis,28,ES28209599118326557478,TRX_N-01026-45765688,2022-11-10T06:07:36,Eibar,Expense,subscriptions,-21.87,-248453.96
buyer_1,Luis,28,ES28209599118326557478,TRX_N-01027-27639436,2022-11-11T00:39:16,Bermeo,Expense,education,-53.13,-248507.09
buyer_1,Luis,28,ES28209599118326557478,TRX_N-01028-57457207,2022-11-11T01:55:05,Bilbao,Expense,personal_care,-484.36,-248991.45
buyer_1,Luis,28,ES28209599118326557478,TRX_N-01029-88083669,2022-11-11T08:13:01,Bilbao,Expense,housing,-484.64,-249476.09
buyer_1,Luis,28,ES28209599118326557478,TRX_N-01030-21950554,2022-11-12T16:47:26,Bilbao,Expense,food,-81.2,-249557.29
buyer_1,Luis,28,ES28209599118326557478,TRX_N-01031-74689056,2022-11-12T07:35:04,Hondarribia,Expense,basic-services,-405.97,-249963.26
buyer_1,Luis,28,ES28209599118326557478,TRX_N-01032-44121415,2022-11-12T11:50:11,Zarautz,Expense,leisure,-208.31,-250171.57
buyer_1,Luis,28,ES28209599118326557478,TRX_N-01033-83163377,2022-11-13T19:28:43,Bilbao,Expense,car,-16.3,-250187.87
buyer_1,Luis,28,ES28209599118326557478,TRX_N-01034-11226353,2022-11-13T17:54:43,Bilbao,Expense,healthcare,-373.58,-250561.45
buyer_1,Luis,28,ES28209599118326557478,TRX_N-01035-21334252,2022-11-13T20:53:49,Berango,Expense,basic-services,-381.09,-250942.54
buyer_1,Luis,28,ES28209599118326557478,TRX_N-01036-46548734,2022-11-14T11:05:13,Bilbao,Expense,personal_care,-110.24,-251052.78
buyer_1,Luis,28,ES28209599118326557478,TRX_N-01037-89612260,2022-11-14T18:26:26,Bilbao,Expense,food,-404.69,-251457.47
buyer_1,Luis,28,ES28209599118326557478,TRX_N-01038-55740645,2022-11-14T04:24:06,Bilbao,Expense,food,-453.2,-251910.67
buyer_1,Luis,28,ES28209599118326557478,TRX_N-01039-48632355,2022-11-15T08:32:17,Mungia,Expense,healthcare,-349.11,-252259.78
buyer_1,Luis,28,ES28209599118326557478,TRX_N-01040-27741892,2022-11-15T10:07:33,Bilbao,Expense,education,-329.74,-252589.52
buyer_1,Luis,28,ES28209599118326557478,TRX_N-01041-32831126,2022-11-15T09:02:20,Bilbao,Expense,car,-324.67,-252914.19
buyer_1,Luis,28,ES28209599118326557478,TRX_N-01042-63920798,2022-11-16T10:56:23,Bilbao,Expense,subscriptions,-43.81,-252958.0
buyer_1,Luis,28,ES28209599118326557478,TRX_N-01043-89215789,2022-11-16T20:35:00,Barakaldo,Expense,transport,-78.56,-253036.56
buyer_1,Luis,28,ES28209599118326557478,TRX_N-01044-62237667,2022-11-16T09:51:11,Bilbao,Expense,leisure,-25.29,-253061.85
buyer_1,Luis,28,ES28209599118326557478,TRX_N-01045-22612841,2022-11-17T05:11:17,Bilbao,Expense,leisure,-199.25,-253261.1
buyer_1,Luis,28,ES28209599118326557478,TRX_N-01046-05073076,2022-11-17T11:21:18,Bilbao,Expense,personal_care,-158.67,-253419.77
buyer_1,Luis,28,ES28209599118326557478,TRX_N-01047-54421055,2022-11-17T18:42:26,Bilbao,Expense,education,-76.61,-253496.38
buyer_1,Luis,28,ES28209599118326557478,TRX_N-01048-35259642,2022-11-18T19:36:36,Bilbao,Expense,transport,-334.63,-253831.01
buyer_1,Luis,28,ES28209599118326557478,TRX_N-01049-93427012,2022-11-18T03:49:40,Bilbao,Expense,basic-services,-159.14,-253990.15
buyer_1,Luis,28,ES28209599118326557478,TRX_N-01050-50835420,2022-11-18T20:36:12,Bilbao,Expense,education,-399.13,-254389.28
buyer_1,Luis,28,ES28209599118326557478,TRX_N-01051-96659617,2022-11-19T09:43:13,Bilbao,Expense,children,-326.08,-254715.36
buyer_1,Luis,28,ES28209599118326557478,TRX_N-01052-68716096,2022-11-19T20:45:08,Bilbao,Expense,technology,-44.47,-254759.83
buyer_1,Luis,28,ES28209599118326557478,TRX_N-01053-16909905,2022-11-19T14:38:17,Bilbao,Expense,car,-74.37,-254834.2
buyer_1,Luis,28,ES28209599118326557478,TRX_N-01054-77132683,2022-11-20T15:57:37,Bilbao,Expense,education,-397.4,-255231.6
buyer_1,Luis,28,ES28209599118326557478,TRX_N-01055-79603662,2022-11-20T16:16:18,Bilbao,Expense,healthcare,-83.59,-255315.19
buyer_1,Luis,28,ES28209599118326557478,TRX_N-01056-29531187,2022-11-20T19:51:04,Alegría-Dulantzi,Expense,education,-423.57,-255738.76
buyer_1,Luis,28,ES28209599118326557478,TRX_N-01057-52292269,2022-11-21T16:01:26,Bilbao,Expense,transport,-152.25,-255891.01
buyer_1,Luis,28,ES28209599118326557478,TRX_N-01058-20238271,2022-11-21T09:25:47,Bilbao,Expense,savings,-283.48,-256174.49
buyer_1,Luis,28,ES28209599118326557478,TRX_N-01059-10245047,2022-11-21T22:36:18,Bilbao,Expense,healthcare,-409.59,-256584.08
buyer_1,Luis,28,ES28209599118326557478,TRX_N-01060-91828693,2022-11-22T12:08:48,Sopela,Expense,healthcare,-399.01,-256983.09
buyer_1,Luis,28,ES28209599118326557478,TRX_N-01061-02945191,2022-11-22T10:53:56,Bilbao,Expense,food,-143.87,-257126.96
buyer_1,Luis,28,ES28209599118326557478,TRX_N-01062-37458506,2022-11-22T22:19:19,Bilbao,Expense,education,-84.88,-257211.84
buyer_1,Luis,28,ES28209599118326557478,TRX_N-01063-98449976,2022-11-23T20:29:57,Bilbao,Expense,savings,-81.49,-257293.33
buyer_1,Luis,28,ES28209599118326557478,TRX_N-01064-88758876,2022-11-23T08:24:46,Irun,Expense,housing,-260.21,-257553.54
buyer_1,Luis,28,ES28209599118326557478,TRX_N-01065-85649544,2022-11-23T13:25:14,Bilbao,Expense,personal_care,-278.6,-257832.14
buyer_1,Luis,28,ES28209599118326557478,TRX_N-01066-25071830,2022-11-24T16:07:11,Bilbao,Expense,clothing,-280.47,-258112.61
buyer_1,Luis,28,ES28209599118326557478,TRX_N-01067-36409147,2022-11-24T22:01:51,Eibar,Expense,basic-services,-244.14,-258356.75
buyer_1,Luis,28,ES28209599118326557478,TRX_N-01068-29158206,2022-11-24T15:45:15,Bilbao,Expense,subscriptions,-413.98,-258770.73
buyer_1,Luis,28,ES28209599118326557478,TRX_N-01069-36511356,2022-11-25T10:25:47,Bilbao,Expense,leisure,-397.99,-259168.72
buyer_1,Luis,28,ES28209599118326557478,TRX_N-01070-80243728,2022-11-25T20:10:22,Irun,Expense,leisure,-395.3,-259564.02
buyer_1,Luis,28,ES28209599118326557478,TRX_N-01071-96176983,2022-11-25T17:04:51,Bilbao,Expense,healthcare,-444.38,-260008.4
buyer_1,Luis,28,ES28209599118326557478,TRX_N-01072-27694951,2022-11-26T11:05:15,Bilbao,Expense,technology,-322.47,-260330.87
buyer_1,Luis,28,ES28209599118326557478,TRX_N-01073-60277788,2022-11-26T10:01:06,Bilbao,Expense,technology,-323.9,-260654.77
buyer_1,Luis,28,ES28209599118326557478,TRX_N-01074-30312050,2022-11-26T18:10:45,Bilbao,Expense,car,-370.91,-261025.68
buyer_1,Luis,28,ES28209599118326557478,TRX_N-01075-37002234,2022-11-27T12:20:25,Bilbao,Expense,loans,-241.31,-261266.99
buyer_1,Luis,28,ES28209599118326557478,TRX_N-01076-35958176,2022-11-27T00:00:40,Bilbao,Expense,transport,-371.77,-261638.76
buyer_1,Luis,28,ES28209599118326557478,TRX_N-01077-80434513,2022-11-27T18:10:10,Bilbao,Expense,children,-464.94,-262103.7
buyer_1,Luis,28,ES28209599118326557478,TRX_N-01078-52690856,2022-11-28T15:10:04,Bilbao,Expense,healthcare,-202.7,-262306.4
buyer_1,Luis,28,ES28209599118326557478,TRX_N-01079-76909227,2022-11-28T10:04:00,Elciego,Expense,children,-329.82,-262636.22
buyer_1,Luis,28,ES28209599118326557478,TRX_N-01080-73402264,2022-11-28T17:15:30,Bilbao,Expense,technology,-83.07,-262719.29
buyer_1,Luis,28,ES28209599118326557478,TRX_N-01081-84551600,2022-11-29T13:43:18,Bilbao,Expense,leisure,-460.43,-263179.72
buyer_1,Luis,28,ES28209599118326557478,TRX_N-01082-68764810,2022-11-29T18:07:04,Bilbao,Expense,technology,-92.92,-263272.64
buyer_1,Luis,28,ES28209599118326557478,TRX_N-01083-66512090,2022-11-29T12:01:53,Bilbao,Expense,clothing,-211.03,-263483.67
buyer_1,Luis,28,ES28209599118326557478,TRX_N-01084-11005299,2022-11-30T19:36:25,Bilbao,Expense,basic-services,-496.16,-263979.83
buyer_1,Luis,28,ES28209599118326557478,TRX_N-01085-65738812,2022-11-30T15:39:35,Bilbao,Expense,children,-365.66,-264345.49
buyer_1,Luis,28,ES28209599118326557478,TRX_N-01086-45839426,2022-11-30T15:10:05,Bilbao,Expense,loans,-465.47,-264810.96
buyer_1,Luis,28,ES28209599118326557478,TRX_N-01087-61064408,2022-12-01T12:44:16,Bilbao,incomes,salary,1265.98,-263544.98
buyer_1,Luis,28,ES28209599118326557478,TRX_N-01088-44742970,2022-12-01T12:44:16,Bilbao,incomes,salary_extra,908.9,-262636.08
buyer_1,Luis,28,ES28209599118326557478,TRX_N-01089-88348262,2022-12-01T17:13:02,Bilbao,Expense,food,-259.1,-262895.18
buyer_1,Luis,28,ES28209599118326557478,TRX_N-01090-63523477,2022-12-01T09:43:31,Bilbao,Expense,housing,-207.44,-263102.62
buyer_1,Luis,28,ES28209599118326557478,TRX_N-01091-61632232,2022-12-01T10:32:29,Bilbao,Expense,loans,-292.03,-263394.65
buyer_1,Luis,28,ES28209599118326557478,TRX_N-01092-48560540,2022-12-02T18:19:58,Bilbao,Expense,transport,-182.82,-263577.47
buyer_1,Luis,28,ES28209599118326557478,TRX_N-01093-61145883,2022-12-02T20:32:21,Bilbao,Expense,clothing,-245.39,-263822.86
buyer_1,Luis,28,ES28209599118326557478,TRX_N-01094-38332406,2022-12-02T11:38:34,Bilbao,Expense,leisure,-347.65,-264170.51
buyer_1,Luis,28,ES28209599118326557478,TRX_N-01095-13366327,2022-12-03T14:42:18,Bilbao,Expense,transport,-287.0,-264457.51
buyer_1,Luis,28,ES28209599118326557478,TRX_N-01096-21977883,2022-12-03T17:56:20,Bilbao,Expense,healthcare,-132.04,-264589.55
buyer_1,Luis,28,ES28209599118326557478,TRX_N-01097-95153199,2022-12-03T12:00:07,Bilbao,Expense,basic-services,-176.34,-264765.89
buyer_1,Luis,28,ES28209599118326557478,TRX_N-01098-79658072,2022-12-04T18:40:01,Bilbao,Housing,Rent,-1369.49,-266135.38
buyer_1,Luis,28,ES28209599118326557478,TRX_N-01099-49355169,2022-12-04T18:41:01,Bilbao,Expense,savings,-248.86,-266384.24
buyer_1,Luis,28,ES28209599118326557478,TRX_N-01100-04886037,2022-12-04T15:12:31,Bilbao,Expense,leisure,-399.1,-266783.34
buyer_1,Luis,28,ES28209599118326557478,TRX_N-01101-94892914,2022-12-04T18:01:30,Bilbao,Expense,technology,-237.4,-267020.74
buyer_1,Luis,28,ES28209599118326557478,TRX_N-01102-80383916,2022-12-05T20:03:36,Getxo,Expense,healthcare,-459.41,-267480.15
buyer_1,Luis,28,ES28209599118326557478,TRX_N-01103-84686003,2022-12-05T03:16:55,Bilbao,Expense,healthcare,-176.51,-267656.66
buyer_1,Luis,28,ES28209599118326557478,TRX_N-01104-02979347,2022-12-05T13:40:16,Bilbao,Expense,personal_care,-162.83,-267819.49
buyer_1,Luis,28,ES28209599118326557478,TRX_N-01105-48544750,2022-12-06T08:27:43,Bilbao,basic_services,gas,-45.39,-267864.88
buyer_1,Luis,28,ES28209599118326557478,TRX_N-01106-22533160,2022-12-06T09:58:41,Bilbao,basic_services,internet,-51.86,-267916.74
buyer_1,Luis,28,ES28209599118326557478,TRX_N-01107-93908439,2022-12-06T18:08:31,Bilbao,Expense,clothing,-123.76,-268040.5
buyer_1,Luis,28,ES28209599118326557478,TRX_N-01108-49122407,2022-12-06T08:32:40,Pasaia,Expense,leisure,-265.04,-268305.54
buyer_1,Luis,28,ES28209599118326557478,TRX_N-01109-39604600,2022-12-06T16:09:23,Bilbao,Expense,clothing,-59.37,-268364.91
buyer_1,Luis,28,ES28209599118326557478,TRX_N-01110-74467459,2022-12-07T22:59:41,Bilbao,basic_services,electricity,-106.43,-268471.34
buyer_1,Luis,28,ES28209599118326557478,TRX_N-01111-91976566,2022-12-07T11:51:13,Bilbao,Expense,housing,-264.93,-268736.27
buyer_1,Luis,28,ES28209599118326557478,TRX_N-01112-53872797,2022-12-07T19:00:10,Bilbao,Expense,food,-466.01,-269202.28
buyer_1,Luis,28,ES28209599118326557478,TRX_N-01113-36258159,2022-12-07T19:33:44,Bilbao,Expense,savings,-450.05,-269652.33
buyer_1,Luis,28,ES28209599118326557478,TRX_N-01114-01597173,2022-12-08T14:15:18,Bilbao,basic_services,water,-28.0,-269680.33
buyer_1,Luis,28,ES28209599118326557478,TRX_N-01115-11344057,2022-12-08T15:44:50,Bilbao,basic_services,phone,-56.28,-269736.61
buyer_1,Luis,28,ES28209599118326557478,TRX_N-01116-01944524,2022-12-08T23:06:36,Bilbao,Expense,leisure,-213.23,-269949.84
buyer_1,Luis,28,ES28209599118326557478,TRX_N-01117-90082119,2022-12-08T11:03:35,Bilbao,Expense,technology,-446.63,-270396.47
buyer_1,Luis,28,ES28209599118326557478,TRX_N-01118-54728269,2022-12-08T17:09:11,Salvatierra/Agurain,Expense,personal_care,-278.02,-270674.49
buyer_1,Luis,28,ES28209599118326557478,TRX_N-01119-08778572,2022-12-09T11:13:06,Bilbao,Expense,clothing,-352.74,-271027.23
buyer_1,Luis,28,ES28209599118326557478,TRX_N-01120-37401304,2022-12-09T09:17:06,Bilbao,Expense,housing,-456.31,-271483.54
buyer_1,Luis,28,ES28209599118326557478,TRX_N-01121-81160938,2022-12-09T23:42:54,Bilbao,Expense,healthcare,-242.04,-271725.58
buyer_1,Luis,28,ES28209599118326557478,TRX_N-01122-97913866,2022-12-10T10:36:46,Bilbao,Expense,car,-309.78,-272035.36
buyer_1,Luis,28,ES28209599118326557478,TRX_N-01123-03903414,2022-12-10T17:43:29,Barakaldo,Expense,personal_care,-303.66,-272339.02
buyer_1,Luis,28,ES28209599118326557478,TRX_N-01124-32997757,2022-12-10T14:49:58,Bilbao,Expense,personal_care,-24.8,-272363.82
buyer_1,Luis,28,ES28209599118326557478,TRX_N-01125-74371454,2022-12-11T22:45:01,Bilbao,Expense,subscriptions,-143.28,-272507.1
buyer_1,Luis,28,ES28209599118326557478,TRX_N-01126-69768725,2022-12-11T23:01:26,Bilbao,Expense,education,-355.9,-272863.0
buyer_1,Luis,28,ES28209599118326557478,TRX_N-01127-60398342,2022-12-11T14:44:03,Bilbao,Expense,personal_care,-184.44,-273047.44
buyer_1,Luis,28,ES28209599118326557478,TRX_N-01128-44938126,2022-12-12T23:49:57,Bilbao,Expense,food,-78.67,-273126.11
buyer_1,Luis,28,ES28209599118326557478,TRX_N-01129-19180594,2022-12-12T10:31:56,Bilbao,Expense,personal_care,-16.66,-273142.77
buyer_1,Luis,28,ES28209599118326557478,TRX_N-01130-57296126,2022-12-12T15:57:34,Bilbao,Expense,basic-services,-499.56,-273642.33
buyer_1,Luis,28,ES28209599118326557478,TRX_N-01131-58854055,2022-12-13T19:46:50,Bilbao,Expense,healthcare,-408.82,-274051.15
buyer_1,Luis,28,ES28209599118326557478,TRX_N-01132-60792918,2022-12-13T08:51:28,Bilbao,Expense,subscriptions,-62.31,-274113.46
buyer_1,Luis,28,ES28209599118326557478,TRX_N-01133-66833475,2022-12-13T05:26:20,Bilbao,Expense,car,-318.48,-274431.94
buyer_1,Luis,28,ES28209599118326557478,TRX_N-01134-24455390,2022-12-14T12:27:18,Bilbao,Expense,housing,-436.43,-274868.37
buyer_1,Luis,28,ES28209599118326557478,TRX_N-01135-38312130,2022-12-14T12:28:51,Erandio,Expense,car,-51.87,-274920.24
buyer_1,Luis,28,ES28209599118326557478,TRX_N-01136-76510669,2022-12-14T08:01:34,Bilbao,Expense,basic-services,-414.49,-275334.73
buyer_1,Luis,28,ES28209599118326557478,TRX_N-01137-21562519,2022-12-15T13:29:09,Labastida,Expense,personal_care,-85.23,-275419.96
buyer_1,Luis,28,ES28209599118326557478,TRX_N-01138-14625684,2022-12-15T15:40:50,Bilbao,Expense,housing,-43.24,-275463.2
buyer_1,Luis,28,ES28209599118326557478,TRX_N-01139-29556328,2022-12-15T19:57:56,Bilbao,Expense,loans,-115.67,-275578.87
buyer_1,Luis,28,ES28209599118326557478,TRX_N-01140-49744299,2022-12-16T13:10:30,Bilbao,Expense,subscriptions,-273.91,-275852.78
buyer_1,Luis,28,ES28209599118326557478,TRX_N-01141-79639954,2022-12-16T17:04:06,Bilbao,Expense,subscriptions,-296.16,-276148.94
buyer_1,Luis,28,ES28209599118326557478,TRX_N-01142-80853413,2022-12-16T18:16:03,Bilbao,Expense,technology,-274.01,-276422.95
buyer_1,Luis,28,ES28209599118326557478,TRX_N-01143-74426869,2022-12-17T08:15:40,Bilbao,Expense,clothing,-300.35,-276723.3
buyer_1,Luis,28,ES28209599118326557478,TRX_N-01144-97257391,2022-12-17T18:16:24,Bilbao,Expense,loans,-491.48,-277214.78
buyer_1,Luis,28,ES28209599118326557478,TRX_N-01145-89634271,2022-12-17T08:06:43,Bilbao,Expense,subscriptions,-345.38,-277560.16
buyer_1,Luis,28,ES28209599118326557478,TRX_N-01146-83997340,2022-12-18T10:19:44,Bilbao,Expense,personal_care,-466.39,-278026.55
buyer_1,Luis,28,ES28209599118326557478,TRX_N-01147-95498940,2022-12-18T12:57:18,Bilbao,Expense,food,-356.86,-278383.41
buyer_1,Luis,28,ES28209599118326557478,TRX_N-01148-26698875,2022-12-18T13:19:06,Bilbao,Expense,children,-398.13,-278781.54
buyer_1,Luis,28,ES28209599118326557478,TRX_N-01149-75455927,2022-12-19T08:12:56,Bilbao,Expense,loans,-449.61,-279231.15
buyer_1,Luis,28,ES28209599118326557478,TRX_N-01150-86455266,2022-12-19T13:04:07,Bilbao,Expense,clothing,-278.47,-279509.62
buyer_1,Luis,28,ES28209599118326557478,TRX_N-01151-19115195,2022-12-19T03:20:12,Bilbao,Expense,education,-421.52,-279931.14
buyer_1,Luis,28,ES28209599118326557478,TRX_N-01152-41705019,2022-12-20T13:40:37,Leioa,Expense,clothing,-361.76,-280292.9
buyer_1,Luis,28,ES28209599118326557478,TRX_N-01153-06530772,2022-12-20T08:14:57,Bilbao,Expense,car,-374.82,-280667.72
buyer_1,Luis,28,ES28209599118326557478,TRX_N-01154-92254221,2022-12-20T13:29:25,Bilbao,Expense,subscriptions,-68.22,-280735.94
buyer_1,Luis,28,ES28209599118326557478,TRX_N-01155-65713262,2022-12-21T19:49:11,Bilbao,Expense,technology,-396.41,-281132.35
buyer_1,Luis,28,ES28209599118326557478,TRX_N-01156-80853987,2022-12-21T21:18:58,Bilbao,Expense,clothing,-355.37,-281487.72
buyer_1,Luis,28,ES28209599118326557478,TRX_N-01157-59106979,2022-12-21T10:27:39,Pasaia,Expense,loans,-250.5,-281738.22
buyer_1,Luis,28,ES28209599118326557478,TRX_N-01158-33601605,2022-12-22T20:33:26,Bilbao,Expense,technology,-311.35,-282049.57
buyer_1,Luis,28,ES28209599118326557478,TRX_N-01159-62808095,2022-12-22T16:27:03,Bilbao,Expense,food,-27.47,-282077.04
buyer_1,Luis,28,ES28209599118326557478,TRX_N-01160-70904742,2022-12-22T15:19:41,Bilbao,Expense,children,-278.13,-282355.17
buyer_1,Luis,28,ES28209599118326557478,TRX_N-01161-41705922,2022-12-23T19:41:56,Bilbao,Expense,education,-342.13,-282697.3
buyer_1,Luis,28,ES28209599118326557478,TRX_N-01162-26373756,2022-12-23T15:48:18,Bilbao,Expense,food,-256.32,-282953.62
buyer_1,Luis,28,ES28209599118326557478,TRX_N-01163-47619352,2022-12-23T10:04:33,Bilbao,Expense,personal_care,-397.98,-283351.6
buyer_1,Luis,28,ES28209599118326557478,TRX_N-01164-04000856,2022-12-24T16:35:52,Alegría-Dulantzi,Expense,healthcare,-479.15,-283830.75
buyer_1,Luis,28,ES28209599118326557478,TRX_N-01165-36765704,2022-12-24T08:20:34,Bilbao,Expense,clothing,-62.44,-283893.19
buyer_1,Luis,28,ES28209599118326557478,TRX_N-01166-67106776,2022-12-24T22:14:21,Bilbao,Expense,subscriptions,-260.04,-284153.23
buyer_1,Luis,28,ES28209599118326557478,TRX_N-01167-56447522,2022-12-25T13:56:12,Bilbao,Expense,leisure,-460.68,-284613.91
buyer_1,Luis,28,ES28209599118326557478,TRX_N-01168-28038156,2022-12-25T08:47:56,Bilbao,Expense,children,-111.55,-284725.46
buyer_1,Luis,28,ES28209599118326557478,TRX_N-01169-99137499,2022-12-25T21:25:39,Bilbao,Expense,technology,-403.81,-285129.27
buyer_1,Luis,28,ES28209599118326557478,TRX_N-01170-91767648,2022-12-26T08:51:10,Bilbao,Expense,children,-118.08,-285247.35
buyer_1,Luis,28,ES28209599118326557478,TRX_N-01171-80592066,2022-12-26T09:51:16,Lasarte-Oria,Expense,savings,-128.57,-285375.92
buyer_1,Luis,28,ES28209599118326557478,TRX_N-01172-86910194,2022-12-26T15:07:53,Bilbao,Expense,healthcare,-106.7,-285482.62
buyer_1,Luis,28,ES28209599118326557478,TRX_N-01173-62889216,2022-12-27T11:05:25,Bilbao,Expense,basic-services,-414.69,-285897.31
buyer_1,Luis,28,ES28209599118326557478,TRX_N-01174-38653916,2022-12-27T20:21:46,Bilbao,Expense,subscriptions,-326.89,-286224.2
buyer_1,Luis,28,ES28209599118326557478,TRX_N-01175-67244104,2022-12-27T16:16:01,Santurtzi,Expense,loans,-321.96,-286546.16
buyer_1,Luis,28,ES28209599118326557478,TRX_N-01176-01712824,2022-12-28T21:51:34,Bilbao,Expense,housing,-62.97,-286609.13
buyer_1,Luis,28,ES28209599118326557478,TRX_N-01177-79194133,2022-12-28T12:31:10,Bilbao,Expense,housing,-337.75,-286946.88
buyer_1,Luis,28,ES28209599118326557478,TRX_N-01178-70666279,2022-12-28T14:33:41,Bilbao,Expense,technology,-137.25,-287084.13
buyer_1,Luis,28,ES28209599118326557478,TRX_N-01179-09718670,2022-12-29T16:27:33,Bilbao,Expense,basic-services,-283.73,-287367.86
buyer_1,Luis,28,ES28209599118326557478,TRX_N-01180-23999858,2022-12-29T16:44:34,Bilbao,Expense,transport,-88.34,-287456.2
buyer_1,Luis,28,ES28209599118326557478,TRX_N-01181-53696078,2022-12-29T02:20:13,Bilbao,Expense,basic-services,-416.24,-287872.44
buyer_1,Luis,28,ES28209599118326557478,TRX_N-01182-12369345,2022-12-30T09:00:37,Bilbao,Expense,healthcare,-466.26,-288338.7
buyer_1,Luis,28,ES28209599118326557478,TRX_N-01183-49152975,2022-12-30T12:38:49,Bilbao,Expense,education,-299.5,-288638.2
buyer_1,Luis,28,ES28209599118326557478,TRX_N-01184-37617763,2022-12-30T18:41:09,Bilbao,Expense,clothing,-317.24,-288955.44
buyer_1,Luis,28,ES28209599118326557478,TRX_N-01185-18328883,2022-12-31T22:53:39,Bilbao,Expense,technology,-236.77,-289192.21
buyer_1,Luis,28,ES28209599118326557478,TRX_N-01186-50204751,2022-12-31T13:08:14,Bilbao,Expense,subscriptions,-321.23,-289513.44
buyer_1,Luis,28,ES28209599118326557478,TRX_N-01187-95439683,2022-12-31T18:43:03,Bilbao,Expense,housing,-77.77,-289591.21
buyer_1,Luis,28,ES28209599118326557478,TRX_N-01188-45693920,2023-01-01T04:04:14,Bilbao,incomes,salary,1265.98,-288325.23
buyer_1,Luis,28,ES28209599118326557478,TRX_N-01189-19234708,2023-01-01T18:05:05,Bilbao,Expense,food,-385.06,-288710.29
buyer_1,Luis,28,ES28209599118326557478,TRX_N-01190-74304233,2023-01-01T12:54:38,Bilbao,Expense,savings,-98.11,-288808.4
buyer_1,Luis,28,ES28209599118326557478,TRX_N-01191-14168792,2023-01-01T23:51:50,Bilbao,Expense,education,-17.77,-288826.17
buyer_1,Luis,28,ES28209599118326557478,TRX_N-01192-33759629,2023-01-02T11:35:33,Leioa,Expense,subscriptions,-386.11,-289212.28
buyer_1,Luis,28,ES28209599118326557478,TRX_N-01193-87858409,2023-01-02T19:36:18,Bilbao,Expense,housing,-249.21,-289461.49
buyer_1,Luis,28,ES28209599118326557478,TRX_N-01194-51549276,2023-01-02T15:40:33,Bilbao,Expense,loans,-49.87,-289511.36
buyer_1,Luis,28,ES28209599118326557478,TRX_N-01195-91896121,2023-01-03T12:47:48,Bilbao,Expense,transport,-190.84,-289702.2
buyer_1,Luis,28,ES28209599118326557478,TRX_N-01196-91557577,2023-01-03T05:35:35,Bilbao,Expense,healthcare,-59.92,-289762.12
buyer_1,Luis,28,ES28209599118326557478,TRX_N-01197-62910897,2023-01-03T08:47:35,Bilbao,Expense,personal_care,-45.59,-289807.71
buyer_1,Luis,28,ES28209599118326557478,TRX_N-01198-22479877,2023-01-04T18:28:07,Bilbao,Housing,Rent,-1369.49,-291177.2
buyer_1,Luis,28,ES28209599118326557478,TRX_N-01199-67059841,2023-01-04T09:33:52,Sopela,Expense,healthcare,-230.78,-291407.98
buyer_1,Luis,28,ES28209599118326557478,TRX_N-01200-05663287,2023-01-04T04:50:15,Bilbao,Expense,children,-95.41,-291503.39
buyer_1,Luis,28,ES28209599118326557478,TRX_N-01201-89862772,2023-01-04T08:34:58,Bilbao,Expense,loans,-430.34,-291933.73
buyer_1,Luis,28,ES28209599118326557478,TRX_N-01202-12493448,2023-01-05T09:06:03,Bilbao,Expense,basic-services,-226.19,-292159.92
buyer_1,Luis,28,ES28209599118326557478,TRX_N-01203-90575263,2023-01-05T11:40:05,Bilbao,Expense,housing,-283.79,-292443.71
buyer_1,Luis,28,ES28209599118326557478,TRX_N-01204-59036369,2023-01-05T00:50:38,Bilbao,Expense,personal_care,-190.08,-292633.79
buyer_1,Luis,28,ES28209599118326557478,TRX_N-01205-97533965,2023-01-06T11:45:31,Bilbao,basic_services,internet,-50.85,-292684.64
buyer_1,Luis,28,ES28209599118326557478,TRX_N-01206-90208814,2023-01-06T18:27:49,Bilbao,Expense,leisure,-367.31,-293051.95
buyer_1,Luis,28,ES28209599118326557478,TRX_N-01207-34019161,2023-01-06T21:26:24,Bilbao,Expense,savings,-379.41,-293431.36
buyer_1,Luis,28,ES28209599118326557478,TRX_N-01208-34224203,2023-01-06T11:58:15,Bilbao,Expense,food,-92.99,-293524.35
buyer_1,Luis,28,ES28209599118326557478,TRX_N-01209-03105451,2023-01-07T10:53:28,Bilbao,basic_services,gas,-75.2,-293599.55
buyer_1,Luis,28,ES28209599118326557478,TRX_N-01210-47587260,2023-01-07T12:06:55,Bilbao,Expense,car,-89.48,-293689.03
buyer_1,Luis,28,ES28209599118326557478,TRX_N-01211-90408938,2023-01-07T10:03:21,Bilbao,Expense,housing,-424.99,-294114.02
buyer_1,Luis,28,ES28209599118326557478,TRX_N-01212-17917138,2023-01-07T18:41:51,Bilbao,Expense,transport,-155.89,-294269.91
buyer_1,Luis,28,ES28209599118326557478,TRX_N-01213-71140367,2023-01-08T16:11:07,Bilbao,basic_services,water,-49.89,-294319.8
buyer_1,Luis,28,ES28209599118326557478,TRX_N-01214-67374274,2023-01-08T14:02:44,Bilbao,basic_services,electricity,-86.09,-294405.89
buyer_1,Luis,28,ES28209599118326557478,TRX_N-01215-65002087,2023-01-08T03:35:28,Bilbao,basic_services,phone,-32.7,-294438.59
buyer_1,Luis,28,ES28209599118326557478,TRX_N-01216-61413156,2023-01-08T17:55:17,Bilbao,Expense,housing,-145.96,-294584.55
buyer_1,Luis,28,ES28209599118326557478,TRX_N-01217-90944165,2023-01-08T21:42:02,Bilbao,Expense,savings,-415.84,-295000.39
buyer_1,Luis,28,ES28209599118326557478,TRX_N-01218-51448391,2023-01-08T08:12:08,Bilbao,Expense,savings,-139.69,-295140.08
buyer_1,Luis,28,ES28209599118326557478,TRX_N-01219-01099507,2023-01-09T19:39:51,Bilbao,Expense,subscriptions,-304.23,-295444.31
buyer_1,Luis,28,ES28209599118326557478,TRX_N-01220-68332582,2023-01-09T04:38:59,Bilbao,Expense,children,-490.54,-295934.85
buyer_1,Luis,28,ES28209599118326557478,TRX_N-01221-90372334,2023-01-09T08:12:54,Portugalete,Expense,healthcare,-469.76,-296404.61
buyer_1,Luis,28,ES28209599118326557478,TRX_N-01222-98076608,2023-01-10T19:12:10,Alegría-Dulantzi,Expense,loans,-302.89,-296707.5
buyer_1,Luis,28,ES28209599118326557478,TRX_N-01223-82503696,2023-01-10T23:11:50,Bilbao,Expense,transport,-437.3,-297144.8
buyer_1,Luis,28,ES28209599118326557478,TRX_N-01224-12427654,2023-01-10T02:30:32,Bilbao,Expense,healthcare,-55.99,-297200.79
buyer_1,Luis,28,ES28209599118326557478,TRX_N-01225-22967379,2023-01-11T03:58:36,Bilbao,Expense,leisure,-182.0,-297382.79
buyer_1,Luis,28,ES28209599118326557478,TRX_N-01226-19351604,2023-01-11T17:29:27,Bilbao,Expense,technology,-467.98,-297850.77
buyer_1,Luis,28,ES28209599118326557478,TRX_N-01227-00532253,2023-01-11T10:36:10,Bilbao,Expense,healthcare,-499.77,-298350.54
buyer_1,Luis,28,ES28209599118326557478,TRX_N-01228-85471950,2023-01-12T19:37:55,Bilbao,Expense,savings,-277.95,-298628.49
buyer_1,Luis,28,ES28209599118326557478,TRX_N-01229-90048639,2023-01-12T18:10:50,Bilbao,Expense,leisure,-413.15,-299041.64
buyer_1,Luis,28,ES28209599118326557478,TRX_N-01230-60035345,2023-01-12T15:04:23,Hondarribia,Expense,children,-213.67,-299255.31
buyer_1,Luis,28,ES28209599118326557478,TRX_N-01231-69978705,2023-01-13T14:53:11,Hondarribia,Expense,housing,-204.84,-299460.15
buyer_1,Luis,28,ES28209599118326557478,TRX_N-01232-26661045,2023-01-13T20:12:34,Bilbao,Expense,clothing,-157.95,-299618.1
buyer_1,Luis,28,ES28209599118326557478,TRX_N-01233-95019278,2023-01-13T10:56:15,Irun,Expense,personal_care,-10.96,-299629.06
buyer_1,Luis,28,ES28209599118326557478,TRX_N-01234-63104534,2023-01-14T15:15:14,Bilbao,Expense,leisure,-51.72,-299680.78
buyer_1,Luis,28,ES28209599118326557478,TRX_N-01235-79475686,2023-01-14T09:47:23,Bilbao,Expense,transport,-484.03,-300164.81
buyer_1,Luis,28,ES28209599118326557478,TRX_N-01236-93590516,2023-01-14T11:07:46,Bilbao,Expense,savings,-254.84,-300419.65
buyer_1,Luis,28,ES28209599118326557478,TRX_N-01237-81256615,2023-01-15T05:00:08,Bilbao,Expense,basic-services,-455.43,-300875.08
buyer_1,Luis,28,ES28209599118326557478,TRX_N-01238-66183820,2023-01-15T14:00:14,Bilbao,Expense,car,-183.63,-301058.71
buyer_1,Luis,28,ES28209599118326557478,TRX_N-01239-66564334,2023-01-15T18:04:22,Bilbao,Expense,loans,-495.34,-301554.05
buyer_1,Luis,28,ES28209599118326557478,TRX_N-01240-21633531,2023-01-16T19:51:56,Bilbao,Expense,personal_care,-168.38,-301722.43
buyer_1,Luis,28,ES28209599118326557478,TRX_N-01241-68410749,2023-01-16T19:43:10,Bilbao,Expense,clothing,-167.37,-301889.8
buyer_1,Luis,28,ES28209599118326557478,TRX_N-01242-05716549,2023-01-16T09:08:46,Bilbao,Expense,technology,-144.48,-302034.28
buyer_1,Luis,28,ES28209599118326557478,TRX_N-01243-68070053,2023-01-17T20:06:15,Bilbao,Expense,children,-145.48,-302179.76
buyer_1,Luis,28,ES28209599118326557478,TRX_N-01244-98298693,2023-01-17T05:32:05,Bilbao,Expense,children,-452.34,-302632.1
buyer_1,Luis,28,ES28209599118326557478,TRX_N-01245-16771328,2023-01-17T09:37:45,Bilbao,Expense,leisure,-21.56,-302653.66
buyer_1,Luis,28,ES28209599118326557478,TRX_N-01246-80856987,2023-01-18T13:09:02,Bilbao,Expense,transport,-69.09,-302722.75
buyer_1,Luis,28,ES28209599118326557478,TRX_N-01247-88408867,2023-01-18T07:09:41,Salvatierra/Agurain,Expense,subscriptions,-283.44,-303006.19
buyer_1,Luis,28,ES28209599118326557478,TRX_N-01248-87614156,2023-01-18T00:01:02,Bilbao,Expense,savings,-102.55,-303108.74
buyer_1,Luis,28,ES28209599118326557478,TRX_N-01249-04098862,2023-01-19T15:55:16,Bilbao,Expense,healthcare,-154.19,-303262.93
buyer_1,Luis,28,ES28209599118326557478,TRX_N-01250-13119532,2023-01-19T20:17:18,Bilbao,Expense,technology,-293.58,-303556.51
buyer_1,Luis,28,ES28209599118326557478,TRX_N-01251-72149694,2023-01-19T11:30:28,Bilbao,Expense,subscriptions,-322.05,-303878.56
buyer_1,Luis,28,ES28209599118326557478,TRX_N-01252-09814552,2023-01-20T15:26:17,Bilbao,Expense,basic-services,-287.76,-304166.32
buyer_1,Luis,28,ES28209599118326557478,TRX_N-01253-33441936,2023-01-20T19:45:04,Bilbao,Expense,leisure,-291.07,-304457.39
buyer_1,Luis,28,ES28209599118326557478,TRX_N-01254-65263564,2023-01-20T21:27:46,Bilbao,Expense,savings,-202.24,-304659.63
buyer_1,Luis,28,ES28209599118326557478,TRX_N-01255-96453497,2023-01-21T09:07:20,Bilbao,Expense,transport,-492.14,-305151.77
buyer_1,Luis,28,ES28209599118326557478,TRX_N-01256-24176650,2023-01-21T12:08:50,Oyón-Oion,Expense,clothing,-313.97,-305465.74
buyer_1,Luis,28,ES28209599118326557478,TRX_N-01257-83499432,2023-01-21T08:45:10,Bilbao,Expense,basic-services,-232.67,-305698.41
buyer_1,Luis,28,ES28209599118326557478,TRX_N-01258-50801575,2023-01-22T12:19:07,Bilbao,Expense,leisure,-417.04,-306115.45
buyer_1,Luis,28,ES28209599118326557478,TRX_N-01259-95504401,2023-01-22T08:42:01,Eibar,Expense,subscriptions,-396.87,-306512.32
buyer_1,Luis,28,ES28209599118326557478,TRX_N-01260-92659949,2023-01-22T10:36:03,Bilbao,Expense,leisure,-142.37,-306654.69
buyer_1,Luis,28,ES28209599118326557478,TRX_N-01261-07807913,2023-01-23T12:13:12,Eibar,Expense,clothing,-261.67,-306916.36
buyer_1,Luis,28,ES28209599118326557478,TRX_N-01262-64725904,2023-01-23T11:51:11,Bilbao,Expense,basic-services,-170.66,-307087.02
buyer_1,Luis,28,ES28209599118326557478,TRX_N-01263-04560215,2023-01-23T15:02:19,Barakaldo,Expense,food,-292.07,-307379.09
buyer_1,Luis,28,ES28209599118326557478,TRX_N-01264-97497036,2023-01-24T12:48:31,Bilbao,Expense,housing,-468.38,-307847.47
buyer_1,Luis,28,ES28209599118326557478,TRX_N-01265-69573018,2023-01-24T10:29:46,Bilbao,Expense,children,-292.42,-308139.89
buyer_1,Luis,28,ES28209599118326557478,TRX_N-01266-83083109,2023-01-24T13:25:26,Arrasate,Expense,children,-128.1,-308267.99
buyer_1,Luis,28,ES28209599118326557478,TRX_N-01267-29055495,2023-01-25T11:48:53,Bilbao,Expense,housing,-240.32,-308508.31
buyer_1,Luis,28,ES28209599118326557478,TRX_N-01268-70056905,2023-01-25T18:01:14,Bilbao,Expense,car,-311.95,-308820.26
buyer_1,Luis,28,ES28209599118326557478,TRX_N-01269-94165210,2023-01-25T10:58:17,Bilbao,Expense,savings,-111.7,-308931.96
buyer_1,Luis,28,ES28209599118326557478,TRX_N-01270-33654028,2023-01-26T18:02:12,Irun,Expense,transport,-138.76,-309070.72
buyer_1,Luis,28,ES28209599118326557478,TRX_N-01271-28414618,2023-01-26T22:58:58,Bilbao,Expense,food,-58.78,-309129.5
buyer_1,Luis,28,ES28209599118326557478,TRX_N-01272-21072894,2023-01-26T20:55:47,Bilbao,Expense,leisure,-411.47,-309540.97
buyer_1,Luis,28,ES28209599118326557478,TRX_N-01273-61682196,2023-01-27T14:54:36,Bilbao,Expense,subscriptions,-362.72,-309903.69
buyer_1,Luis,28,ES28209599118326557478,TRX_N-01274-02805493,2023-01-27T20:21:24,Bilbao,Expense,children,-383.37,-310287.06
buyer_1,Luis,28,ES28209599118326557478,TRX_N-01275-63963548,2023-01-27T22:15:00,Bilbao,Expense,car,-262.67,-310549.73
buyer_1,Luis,28,ES28209599118326557478,TRX_N-01276-32274271,2023-01-28T19:01:17,Bilbao,Expense,leisure,-267.59,-310817.32
buyer_1,Luis,28,ES28209599118326557478,TRX_N-01277-42383628,2023-01-28T17:37:53,Bilbao,Expense,loans,-133.85,-310951.17
buyer_1,Luis,28,ES28209599118326557478,TRX_N-01278-83043545,2023-01-28T12:51:23,Bilbao,Expense,car,-199.51,-311150.68
buyer_1,Luis,28,ES28209599118326557478,TRX_N-01279-26817183,2023-01-29T19:41:15,Mungia,Expense,education,-40.22,-311190.9
buyer_1,Luis,28,ES28209599118326557478,TRX_N-01280-63017421,2023-01-29T21:48:21,Andoain,Expense,education,-32.82,-311223.72
buyer_1,Luis,28,ES28209599118326557478,TRX_N-01281-18901562,2023-01-29T18:27:11,Bilbao,Expense,healthcare,-328.22,-311551.94
buyer_1,Luis,28,ES28209599118326557478,TRX_N-01282-99136336,2023-01-30T12:43:34,Andoain,Expense,car,-66.62,-311618.56
buyer_1,Luis,28,ES28209599118326557478,TRX_N-01283-95257080,2023-01-30T12:08:10,Bilbao,Expense,personal_care,-46.18,-311664.74
buyer_1,Luis,28,ES28209599118326557478,TRX_N-01284-82281032,2023-01-30T16:52:13,Bilbao,Expense,transport,-384.89,-312049.63
buyer_1,Luis,28,ES28209599118326557478,TRX_N-01285-84285406,2023-01-31T14:04:56,Errenteria,Expense,basic-services,-121.82,-312171.45
buyer_1,Luis,28,ES28209599118326557478,TRX_N-01286-14602151,2023-01-31T09:11:32,Bilbao,Expense,education,-312.04,-312483.49
buyer_1,Luis,28,ES28209599118326557478,TRX_N-01287-78266811,2023-01-31T14:45:03,Bilbao,Expense,food,-266.21,-312749.7
buyer_1,Luis,28,ES28209599118326557478,TRX_N-01288-34334619,2023-02-01T14:41:14,Bilbao,incomes,salary,1265.98,-311483.72
buyer_1,Luis,28,ES28209599118326557478,TRX_N-01289-80072472,2023-02-01T14:41:14,Bilbao,incomes,extra_income,126.6,-311357.12
buyer_1,Luis,28,ES28209599118326557478,TRX_N-01290-13281735,2023-02-01T19:34:12,Bilbao,Expense,car,-387.58,-311744.7
buyer_1,Luis,28,ES28209599118326557478,TRX_N-01291-20777245,2023-02-01T16:33:29,Bilbao,Expense,clothing,-391.82,-312136.52
buyer_1,Luis,28,ES28209599118326557478,TRX_N-01292-04363595,2023-02-01T12:41:00,Bilbao,Expense,children,-415.71,-312552.23
buyer_1,Luis,28,ES28209599118326557478,TRX_N-01293-87487828,2023-02-02T12:09:07,Bilbao,Expense,leisure,-194.25,-312746.48
buyer_1,Luis,28,ES28209599118326557478,TRX_N-01294-22304235,2023-02-02T18:43:18,Bilbao,Expense,transport,-183.96,-312930.44
buyer_1,Luis,28,ES28209599118326557478,TRX_N-01295-42179100,2023-02-02T09:09:42,Bilbao,Expense,food,-29.06,-312959.5
buyer_1,Luis,28,ES28209599118326557478,TRX_N-01296-68988433,2023-02-03T12:54:55,Bilbao,Expense,basic-services,-86.53,-313046.03
buyer_1,Luis,28,ES28209599118326557478,TRX_N-01297-45659773,2023-02-03T16:19:18,Berango,Expense,leisure,-237.03,-313283.06
buyer_1,Luis,28,ES28209599118326557478,TRX_N-01298-45047217,2023-02-03T16:35:32,Barakaldo,Expense,car,-289.46,-313572.52
buyer_1,Luis,28,ES28209599118326557478,TRX_N-01299-80140244,2023-02-04T19:08:58,Bilbao,Housing,Rent,-1369.49,-314942.01
buyer_1,Luis,28,ES28209599118326557478,TRX_N-01300-12233334,2023-02-04T13:11:44,Bilbao,Expense,subscriptions,-254.84,-315196.85
buyer_1,Luis,28,ES28209599118326557478,TRX_N-01301-93394342,2023-02-04T20:35:47,Bilbao,Expense,technology,-409.79,-315606.64
buyer_1,Luis,28,ES28209599118326557478,TRX_N-01302-29092808,2023-02-04T23:09:43,Bilbao,Expense,personal_care,-314.06,-315920.7
buyer_1,Luis,28,ES28209599118326557478,TRX_N-01303-92096373,2023-02-05T09:38:48,Bilbao,basic_services,electricity,-72.01,-315992.71
buyer_1,Luis,28,ES28209599118326557478,TRX_N-01304-50991175,2023-02-05T09:36:24,Bilbao,Expense,savings,-196.34,-316189.05
buyer_1,Luis,28,ES28209599118326557478,TRX_N-01305-18230095,2023-02-05T11:03:59,Bilbao,Expense,technology,-232.21,-316421.26
buyer_1,Luis,28,ES28209599118326557478,TRX_N-01306-93746008,2023-02-05T21:47:00,Bilbao,Expense,savings,-390.57,-316811.83
buyer_1,Luis,28,ES28209599118326557478,TRX_N-01307-96350722,2023-02-06T06:17:07,Bilbao,Expense,education,-347.74,-317159.57
buyer_1,Luis,28,ES28209599118326557478,TRX_N-01308-88117128,2023-02-06T18:51:47,Bilbao,Expense,personal_care,-426.17,-317585.74
buyer_1,Luis,28,ES28209599118326557478,TRX_N-01309-85929775,2023-02-06T19:36:44,Santurtzi,Expense,technology,-178.46,-317764.2
buyer_1,Luis,28,ES28209599118326557478,TRX_N-01310-87228166,2023-02-07T10:08:53,Bilbao,basic_services,gas,-57.87,-317822.07
buyer_1,Luis,28,ES28209599118326557478,TRX_N-01311-10860888,2023-02-07T19:44:58,Bilbao,Expense,clothing,-55.69,-317877.76
buyer_1,Luis,28,ES28209599118326557478,TRX_N-01312-81400079,2023-02-07T12:42:33,Bilbao,Expense,car,-116.44,-317994.2
buyer_1,Luis,28,ES28209599118326557478,TRX_N-01313-01787527,2023-02-07T22:59:13,Bilbao,Expense,food,-24.49,-318018.69
buyer_1,Luis,28,ES28209599118326557478,TRX_N-01314-42840624,2023-02-08T14:25:42,Bilbao,basic_services,internet,-55.72,-318074.41
buyer_1,Luis,28,ES28209599118326557478,TRX_N-01315-45563262,2023-02-08T12:35:34,Bilbao,basic_services,water,-12.06,-318086.47
buyer_1,Luis,28,ES28209599118326557478,TRX_N-01316-49353631,2023-02-08T15:31:05,Bilbao,basic_services,phone,-60.86,-318147.33
buyer_1,Luis,28,ES28209599118326557478,TRX_N-01317-76245452,2023-02-08T09:15:08,Bilbao,Expense,transport,-452.7,-318600.03
buyer_1,Luis,28,ES28209599118326557478,TRX_N-01318-14331937,2023-02-08T20:56:26,Bilbao,Expense,savings,-180.54,-318780.57
buyer_1,Luis,28,ES28209599118326557478,TRX_N-01319-55642500,2023-02-08T17:42:39,Vitoria-Gasteiz,Expense,children,-447.04,-319227.61
buyer_1,Luis,28,ES28209599118326557478,TRX_N-01320-62513331,2023-02-09T14:48:41,Bilbao,Expense,food,-347.86,-319575.47
buyer_1,Luis,28,ES28209599118326557478,TRX_N-01321-15459787,2023-02-09T07:59:25,Hernani,Expense,basic-services,-442.63,-320018.1
buyer_1,Luis,28,ES28209599118326557478,TRX_N-01322-77716343,2023-02-09T10:03:12,Bilbao,Expense,personal_care,-237.58,-320255.68
buyer_1,Luis,28,ES28209599118326557478,TRX_N-01323-83626597,2023-02-10T12:08:58,Bilbao,Expense,healthcare,-320.34,-320576.02
buyer_1,Luis,28,ES28209599118326557478,TRX_N-01324-80574847,2023-02-10T12:32:09,Bilbao,Expense,transport,-346.81,-320922.83
buyer_1,Luis,28,ES28209599118326557478,TRX_N-01325-54253603,2023-02-10T08:12:38,Andoain,Expense,children,-195.5,-321118.33
buyer_1,Luis,28,ES28209599118326557478,TRX_N-01326-19467272,2023-02-11T10:15:51,Bilbao,Expense,housing,-326.49,-321444.82
buyer_1,Luis,28,ES28209599118326557478,TRX_N-01327-98310630,2023-02-11T17:30:18,Bilbao,Expense,loans,-244.78,-321689.6
buyer_1,Luis,28,ES28209599118326557478,TRX_N-01328-24898008,2023-02-11T15:10:40,Bilbao,Expense,healthcare,-190.53,-321880.13
buyer_1,Luis,28,ES28209599118326557478,TRX_N-01329-97699360,2023-02-12T13:50:58,Bilbao,Expense,basic-services,-102.97,-321983.1
buyer_1,Luis,28,ES28209599118326557478,TRX_N-01330-16848169,2023-02-12T01:16:35,Bilbao,Expense,personal_care,-386.83,-322369.93
buyer_1,Luis,28,ES28209599118326557478,TRX_N-01331-31159438,2023-02-12T12:57:26,Bilbao,Expense,housing,-16.16,-322386.09
buyer_1,Luis,28,ES28209599118326557478,TRX_N-01332-11031117,2023-02-13T02:49:41,Bilbao,Expense,personal_care,-392.93,-322779.02
buyer_1,Luis,28,ES28209599118326557478,TRX_N-01333-60171941,2023-02-13T18:22:07,Bilbao,Expense,savings,-273.1,-323052.12
buyer_1,Luis,28,ES28209599118326557478,TRX_N-01334-52787021,2023-02-13T14:52:34,Bilbao,Expense,personal_care,-84.54,-323136.66
buyer_1,Luis,28,ES28209599118326557478,TRX_N-01335-34606189,2023-02-14T08:02:35,Mungia,Expense,housing,-320.17,-323456.83
buyer_1,Luis,28,ES28209599118326557478,TRX_N-01336-00155457,2023-02-14T18:35:04,Bilbao,Expense,healthcare,-292.91,-323749.74
buyer_1,Luis,28,ES28209599118326557478,TRX_N-01337-51774758,2023-02-14T18:39:11,Bilbao,Expense,technology,-369.44,-324119.18
buyer_1,Luis,28,ES28209599118326557478,TRX_N-01338-77077527,2023-02-15T14:16:08,Bilbao,Expense,transport,-208.67,-324327.85
buyer_1,Luis,28,ES28209599118326557478,TRX_N-01339-57720218,2023-02-15T21:43:40,Bilbao,Expense,basic-services,-46.6,-324374.45
buyer_1,Luis,28,ES28209599118326557478,TRX_N-01340-26098415,2023-02-15T23:01:10,Pasaia,Expense,technology,-359.05,-324733.5
buyer_1,Luis,28,ES28209599118326557478,TRX_N-01341-67602194,2023-02-16T12:17:20,Bilbao,Expense,children,-330.68,-325064.18
buyer_1,Luis,28,ES28209599118326557478,TRX_N-01342-91621665,2023-02-16T08:52:53,Bilbao,Expense,loans,-178.99,-325243.17
buyer_1,Luis,28,ES28209599118326557478,TRX_N-01343-85017502,2023-02-16T20:00:19,Bilbao,Expense,education,-453.71,-325696.88
buyer_1,Luis,28,ES28209599118326557478,TRX_N-01344-66913812,2023-02-17T08:07:32,Bilbao,Expense,savings,-232.11,-325928.99
buyer_1,Luis,28,ES28209599118326557478,TRX_N-01345-73425495,2023-02-17T15:17:06,Bilbao,Expense,leisure,-54.27,-325983.26
buyer_1,Luis,28,ES28209599118326557478,TRX_N-01346-11612836,2023-02-17T12:04:11,Bilbao,Expense,clothing,-326.05,-326309.31
buyer_1,Luis,28,ES28209599118326557478,TRX_N-01347-53845964,2023-02-18T18:17:36,Bilbao,Expense,car,-261.32,-326570.63
buyer_1,Luis,28,ES28209599118326557478,TRX_N-01348-18245665,2023-02-18T03:10:45,Bilbao,Expense,personal_care,-195.09,-326765.72
buyer_1,Luis,28,ES28209599118326557478,TRX_N-01349-16505684,2023-02-18T08:34:33,Bilbao,Expense,personal_care,-263.13,-327028.85
buyer_1,Luis,28,ES28209599118326557478,TRX_N-01350-53421179,2023-02-19T11:49:35,Bilbao,Expense,housing,-130.7,-327159.55
buyer_1,Luis,28,ES28209599118326557478,TRX_N-01351-12096076,2023-02-19T20:58:03,Amurrio,Expense,loans,-291.87,-327451.42
buyer_1,Luis,28,ES28209599118326557478,TRX_N-01352-69270096,2023-02-19T18:37:20,Bilbao,Expense,food,-133.8,-327585.22
buyer_1,Luis,28,ES28209599118326557478,TRX_N-01353-38608576,2023-02-20T13:05:53,Bilbao,Expense,car,-111.95,-327697.17
buyer_1,Luis,28,ES28209599118326557478,TRX_N-01354-79366674,2023-02-20T04:24:06,Bilbao,Expense,children,-247.96,-327945.13
buyer_1,Luis,28,ES28209599118326557478,TRX_N-01355-26876716,2023-02-20T12:26:43,Bilbao,Expense,food,-269.08,-328214.21
buyer_1,Luis,28,ES28209599118326557478,TRX_N-01356-89190146,2023-02-21T09:53:38,Bilbao,Expense,savings,-151.68,-328365.89
buyer_1,Luis,28,ES28209599118326557478,TRX_N-01357-81948022,2023-02-21T14:15:40,Bilbao,Expense,transport,-424.34,-328790.23
buyer_1,Luis,28,ES28209599118326557478,TRX_N-01358-16670446,2023-02-21T13:36:33,Bilbao,Expense,leisure,-69.16,-328859.39
buyer_1,Luis,28,ES28209599118326557478,TRX_N-01359-00286620,2023-02-22T17:03:09,Berango,Expense,education,-15.23,-328874.62
buyer_1,Luis,28,ES28209599118326557478,TRX_N-01360-96513101,2023-02-22T15:46:47,Bilbao,Expense,housing,-280.73,-329155.35
buyer_1,Luis,28,ES28209599118326557478,TRX_N-01361-35186742,2023-02-22T22:29:15,Sestao,Expense,personal_care,-425.73,-329581.08
buyer_1,Luis,28,ES28209599118326557478,TRX_N-01362-04534242,2023-02-23T19:12:08,Bilbao,Expense,children,-111.61,-329692.69
buyer_1,Luis,28,ES28209599118326557478,TRX_N-01363-26261505,2023-02-23T16:35:17,Mungia,Expense,car,-130.38,-329823.07
buyer_1,Luis,28,ES28209599118326557478,TRX_N-01364-11133984,2023-02-23T18:54:50,Bilbao,Expense,leisure,-27.02,-329850.09
buyer_1,Luis,28,ES28209599118326557478,TRX_N-01365-18216630,2023-02-24T20:21:47,Erandio,Expense,food,-72.84,-329922.93
buyer_1,Luis,28,ES28209599118326557478,TRX_N-01366-22875642,2023-02-24T19:37:51,Bilbao,Expense,leisure,-119.37,-330042.3
buyer_1,Luis,28,ES28209599118326557478,TRX_N-01367-99869309,2023-02-24T20:46:40,Zuia,Expense,housing,-204.9,-330247.2
buyer_1,Luis,28,ES28209599118326557478,TRX_N-01368-05732443,2023-02-25T16:44:11,Bilbao,Expense,personal_care,-413.88,-330661.08
buyer_1,Luis,28,ES28209599118326557478,TRX_N-01369-43078712,2023-02-25T20:49:07,Bilbao,Expense,housing,-24.47,-330685.55
buyer_1,Luis,28,ES28209599118326557478,TRX_N-01370-03947712,2023-02-25T21:33:13,Bilbao,Expense,personal_care,-490.03,-331175.58
buyer_1,Luis,28,ES28209599118326557478,TRX_N-01371-83087441,2023-02-26T18:42:52,Erandio,Expense,basic-services,-72.2,-331247.78
buyer_1,Luis,28,ES28209599118326557478,TRX_N-01372-23801728,2023-02-26T18:16:39,Vitoria-Gasteiz,Expense,transport,-24.74,-331272.52
buyer_1,Luis,28,ES28209599118326557478,TRX_N-01373-13388451,2023-02-26T20:37:05,Bilbao,Expense,transport,-442.4,-331714.92
buyer_1,Luis,28,ES28209599118326557478,TRX_N-01374-59026138,2023-02-27T15:08:44,Bilbao,Expense,education,-385.67,-332100.59
buyer_1,Luis,28,ES28209599118326557478,TRX_N-01375-90378277,2023-02-27T08:17:39,Bilbao,Expense,clothing,-90.12,-332190.71
buyer_1,Luis,28,ES28209599118326557478,TRX_N-01376-79481378,2023-02-27T14:30:58,Bilbao,Expense,personal_care,-29.53,-332220.24
buyer_1,Luis,28,ES28209599118326557478,TRX_N-01377-06386965,2023-02-28T02:16:00,Iruña de Oca,Expense,basic-services,-370.94,-332591.18
buyer_1,Luis,28,ES28209599118326557478,TRX_N-01378-12053064,2023-02-28T03:53:12,Bilbao,Expense,transport,-426.83,-333018.01
buyer_1,Luis,28,ES28209599118326557478,TRX_N-01379-49238470,2023-02-28T15:17:17,Bilbao,Expense,education,-374.43,-333392.44
buyer_1,Luis,28,ES28209599118326557478,TRX_N-01380-67927957,2023-03-01T15:22:51,Bilbao,incomes,salary,1265.98,-332126.46
buyer_1,Luis,28,ES28209599118326557478,TRX_N-01381-17437908,2023-03-01T16:38:52,Barakaldo,Expense,personal_care,-223.25,-332349.71
buyer_1,Luis,28,ES28209599118326557478,TRX_N-01382-12823115,2023-03-01T19:51:58,Bilbao,Expense,transport,-268.01,-332617.72
buyer_1,Luis,28,ES28209599118326557478,TRX_N-01383-89568623,2023-03-01T14:45:01,Bilbao,Expense,savings,-328.08,-332945.8
buyer_1,Luis,28,ES28209599118326557478,TRX_N-01384-01926725,2023-03-02T19:16:20,Bilbao,Expense,housing,-105.29,-333051.09
buyer_1,Luis,28,ES28209599118326557478,TRX_N-01385-22363918,2023-03-02T12:16:56,Bilbao,Expense,education,-172.83,-333223.92
buyer_1,Luis,28,ES28209599118326557478,TRX_N-01386-39201484,2023-03-02T06:01:26,Bilbao,Expense,basic-services,-343.13,-333567.05
buyer_1,Luis,28,ES28209599118326557478,TRX_N-01387-28843245,2023-03-03T20:28:25,Bilbao,Expense,savings,-34.56,-333601.61
buyer_1,Luis,28,ES28209599118326557478,TRX_N-01388-66009401,2023-03-03T18:52:21,Lasarte-Oria,Expense,savings,-77.99,-333679.6
buyer_1,Luis,28,ES28209599118326557478,TRX_N-01389-43751415,2023-03-03T08:56:52,Bilbao,Expense,loans,-316.21,-333995.81
buyer_1,Luis,28,ES28209599118326557478,TRX_N-01390-05681450,2023-03-04T08:32:50,Bilbao,Housing,Rent,-1369.49,-335365.3
buyer_1,Luis,28,ES28209599118326557478,TRX_N-01391-06665077,2023-03-04T19:07:38,Bilbao,Expense,education,-135.9,-335501.2
buyer_1,Luis,28,ES28209599118326557478,TRX_N-01392-86648571,2023-03-04T10:52:40,Bilbao,Expense,leisure,-284.05,-335785.25
buyer_1,Luis,28,ES28209599118326557478,TRX_N-01393-91324229,2023-03-04T15:53:36,Bilbao,Expense,subscriptions,-96.99,-335882.24
buyer_1,Luis,28,ES28209599118326557478,TRX_N-01394-95676187,2023-03-05T12:44:37,Bilbao,Expense,housing,-109.66,-335991.9
buyer_1,Luis,28,ES28209599118326557478,TRX_N-01395-05767361,2023-03-05T14:36:42,Andoain,Expense,transport,-144.22,-336136.12
buyer_1,Luis,28,ES28209599118326557478,TRX_N-01396-00805144,2023-03-05T19:32:27,Bilbao,Expense,transport,-453.3,-336589.42
buyer_1,Luis,28,ES28209599118326557478,TRX_N-01397-60228031,2023-03-06T22:50:50,Bilbao,basic_services,water,-45.47,-336634.89
buyer_1,Luis,28,ES28209599118326557478,TRX_N-01398-01367966,2023-03-06T12:34:35,Bilbao,basic_services,gas,-78.94,-336713.83
buyer_1,Luis,28,ES28209599118326557478,TRX_N-01399-54881018,2023-03-06T19:36:59,Bilbao,basic_services,phone,-44.8,-336758.63
buyer_1,Luis,28,ES28209599118326557478,TRX_N-01400-02539805,2023-03-06T10:37:18,Bilbao,Expense,children,-82.5,-336841.13
buyer_1,Luis,28,ES28209599118326557478,TRX_N-01401-07186042,2023-03-06T12:57:51,Vitoria-Gasteiz,Expense,food,-159.97,-337001.1
buyer_1,Luis,28,ES28209599118326557478,TRX_N-01402-97140394,2023-03-06T16:42:53,Bilbao,Expense,leisure,-265.63,-337266.73
buyer_1,Luis,28,ES28209599118326557478,TRX_N-01403-99770920,2023-03-07T17:36:11,Bilbao,basic_services,electricity,-120.46,-337387.19
buyer_1,Luis,28,ES28209599118326557478,TRX_N-01404-86926047,2023-03-07T06:59:27,Bilbao,basic_services,internet,-35.92,-337423.11
buyer_1,Luis,28,ES28209599118326557478,TRX_N-01405-54952442,2023-03-07T18:03:08,Amurrio,Expense,clothing,-209.47,-337632.58
buyer_1,Luis,28,ES28209599118326557478,TRX_N-01406-37873349,2023-03-07T19:34:01,Bilbao,Expense,healthcare,-348.27,-337980.85
buyer_1,Luis,28,ES28209599118326557478,TRX_N-01407-18251385,2023-03-07T12:39:54,Bilbao,Expense,children,-327.63,-338308.48
buyer_1,Luis,28,ES28209599118326557478,TRX_N-01408-69668493,2023-03-08T14:44:42,Bilbao,Expense,children,-31.93,-338340.41
buyer_1,Luis,28,ES28209599118326557478,TRX_N-01409-00148077,2023-03-08T08:18:58,Bilbao,Expense,clothing,-433.87,-338774.28
buyer_1,Luis,28,ES28209599118326557478,TRX_N-01410-56866103,2023-03-08T09:53:12,Bilbao,Expense,personal_care,-343.52,-339117.8
buyer_1,Luis,28,ES28209599118326557478,TRX_N-01411-62061378,2023-03-09T08:30:17,Bilbao,Expense,housing,-439.3,-339557.1
buyer_1,Luis,28,ES28209599118326557478,TRX_N-01412-12487061,2023-03-09T11:54:44,Bilbao,Expense,education,-266.3,-339823.4
buyer_1,Luis,28,ES28209599118326557478,TRX_N-01413-37160070,2023-03-09T18:07:52,Bilbao,Expense,savings,-314.76,-340138.16
buyer_1,Luis,28,ES28209599118326557478,TRX_N-01414-63239245,2023-03-10T14:36:46,Bilbao,Expense,subscriptions,-321.75,-340459.91
buyer_1,Luis,28,ES28209599118326557478,TRX_N-01415-79400447,2023-03-10T12:31:58,Bilbao,Expense,housing,-497.9,-340957.81
buyer_1,Luis,28,ES28209599118326557478,TRX_N-01416-01331523,2023-03-10T19:08:39,Bilbao,Expense,food,-120.93,-341078.74
buyer_1,Luis,28,ES28209599118326557478,TRX_N-01417-91993197,2023-03-11T12:39:19,Bilbao,Expense,personal_care,-194.42,-341273.16
buyer_1,Luis,28,ES28209599118326557478,TRX_N-01418-25562515,2023-03-11T15:12:06,Bilbao,Expense,education,-420.96,-341694.12
buyer_1,Luis,28,ES28209599118326557478,TRX_N-01419-53777704,2023-03-11T17:42:57,Bilbao,Expense,subscriptions,-488.62,-342182.74
buyer_1,Luis,28,ES28209599118326557478,TRX_N-01420-23837020,2023-03-12T12:07:03,Errenteria,Expense,savings,-470.59,-342653.33
buyer_1,Luis,28,ES28209599118326557478,TRX_N-01421-27948986,2023-03-12T09:16:35,Bilbao,Expense,personal_care,-307.28,-342960.61
buyer_1,Luis,28,ES28209599118326557478,TRX_N-01422-42374602,2023-03-12T16:07:14,Bilbao,Expense,children,-262.53,-343223.14
buyer_1,Luis,28,ES28209599118326557478,TRX_N-01423-17354366,2023-03-13T10:55:31,Bilbao,Expense,subscriptions,-359.04,-343582.18
buyer_1,Luis,28,ES28209599118326557478,TRX_N-01424-89634540,2023-03-13T14:16:34,Bilbao,Expense,leisure,-229.37,-343811.55
buyer_1,Luis,28,ES28209599118326557478,TRX_N-01425-31042435,2023-03-13T09:19:41,Bilbao,Expense,savings,-99.58,-343911.13
buyer_1,Luis,28,ES28209599118326557478,TRX_N-01426-42094419,2023-03-14T09:36:41,Bilbao,Expense,children,-88.96,-344000.09
buyer_1,Luis,28,ES28209599118326557478,TRX_N-01427-18060543,2023-03-14T09:20:02,Bilbao,Expense,clothing,-27.14,-344027.23
buyer_1,Luis,28,ES28209599118326557478,TRX_N-01428-41578925,2023-03-14T13:39:24,Bilbao,Expense,children,-442.96,-344470.19
buyer_1,Luis,28,ES28209599118326557478,TRX_N-01429-55545659,2023-03-15T13:58:58,Bilbao,Expense,subscriptions,-138.66,-344608.85
buyer_1,Luis,28,ES28209599118326557478,TRX_N-01430-85998181,2023-03-15T17:48:29,Bilbao,Expense,food,-190.92,-344799.77
buyer_1,Luis,28,ES28209599118326557478,TRX_N-01431-81939102,2023-03-15T13:23:56,Getxo,Expense,technology,-149.06,-344948.83
buyer_1,Luis,28,ES28209599118326557478,TRX_N-01432-00605742,2023-03-16T20:35:33,Bilbao,Expense,transport,-425.17,-345374.0
buyer_1,Luis,28,ES28209599118326557478,TRX_N-01433-83650849,2023-03-16T00:37:05,Bilbao,Expense,healthcare,-100.55,-345474.55
buyer_1,Luis,28,ES28209599118326557478,TRX_N-01434-58081148,2023-03-16T15:06:56,Bilbao,Expense,subscriptions,-218.2,-345692.75
buyer_1,Luis,28,ES28209599118326557478,TRX_N-01435-08809397,2023-03-17T08:12:16,Bilbao,Expense,subscriptions,-499.98,-346192.73
buyer_1,Luis,28,ES28209599118326557478,TRX_N-01436-43190165,2023-03-17T17:58:16,Bilbao,Expense,loans,-368.35,-346561.08
buyer_1,Luis,28,ES28209599118326557478,TRX_N-01437-28703698,2023-03-17T07:57:18,Bilbao,Expense,basic-services,-472.65,-347033.73
buyer_1,Luis,28,ES28209599118326557478,TRX_N-01438-63241723,2023-03-18T16:57:53,Bilbao,Expense,transport,-484.86,-347518.59
buyer_1,Luis,28,ES28209599118326557478,TRX_N-01439-07229125,2023-03-18T10:51:13,Bilbao,Expense,subscriptions,-378.41,-347897.0
buyer_1,Luis,28,ES28209599118326557478,TRX_N-01440-32132122,2023-03-18T18:09:19,Bilbao,Expense,education,-336.87,-348233.87
buyer_1,Luis,28,ES28209599118326557478,TRX_N-01441-89440775,2023-03-19T14:03:51,Errenteria,Expense,food,-13.31,-348247.18
buyer_1,Luis,28,ES28209599118326557478,TRX_N-01442-82213055,2023-03-19T20:43:32,Hondarribia,Expense,education,-229.41,-348476.59
buyer_1,Luis,28,ES28209599118326557478,TRX_N-01443-36240404,2023-03-19T14:15:39,Bilbao,Expense,children,-54.8,-348531.39
buyer_1,Luis,28,ES28209599118326557478,TRX_N-01444-10845955,2023-03-20T17:29:31,Bilbao,Expense,car,-468.39,-348999.78
buyer_1,Luis,28,ES28209599118326557478,TRX_N-01445-06861021,2023-03-20T09:41:09,Bilbao,Expense,technology,-52.67,-349052.45
buyer_1,Luis,28,ES28209599118326557478,TRX_N-01446-46730564,2023-03-20T14:44:35,Bilbao,Expense,children,-227.65,-349280.1
buyer_1,Luis,28,ES28209599118326557478,TRX_N-01447-14154653,2023-03-21T17:06:22,Bilbao,Expense,personal_care,-349.91,-349630.01
buyer_1,Luis,28,ES28209599118326557478,TRX_N-01448-48930948,2023-03-21T13:15:19,Bilbao,Expense,clothing,-153.77,-349783.78
buyer_1,Luis,28,ES28209599118326557478,TRX_N-01449-98096855,2023-03-21T19:51:02,Bilbao,Expense,personal_care,-380.8,-350164.58
buyer_1,Luis,28,ES28209599118326557478,TRX_N-01450-34536902,2023-03-22T15:36:58,Bilbao,Expense,basic-services,-71.7,-350236.28
buyer_1,Luis,28,ES28209599118326557478,TRX_N-01451-50810477,2023-03-22T19:59:05,Eibar,Expense,transport,-67.73,-350304.01
buyer_1,Luis,28,ES28209599118326557478,TRX_N-01452-23715104,2023-03-22T10:06:28,Elciego,Expense,healthcare,-329.14,-350633.15
buyer_1,Luis,28,ES28209599118326557478,TRX_N-01453-78398606,2023-03-23T19:05:09,Bilbao,Expense,transport,-280.55,-350913.7
buyer_1,Luis,28,ES28209599118326557478,TRX_N-01454-01820792,2023-03-23T12:33:10,Bilbao,Expense,healthcare,-258.05,-351171.75
buyer_1,Luis,28,ES28209599118326557478,TRX_N-01455-36740542,2023-03-23T11:40:52,Bilbao,Expense,housing,-315.46,-351487.21
buyer_1,Luis,28,ES28209599118326557478,TRX_N-01456-52667701,2023-03-24T18:10:09,Bilbao,Expense,basic-services,-402.62,-351889.83
buyer_1,Luis,28,ES28209599118326557478,TRX_N-01457-25779358,2023-03-24T09:45:03,Zuia,Expense,education,-417.74,-352307.57
buyer_1,Luis,28,ES28209599118326557478,TRX_N-01458-01592524,2023-03-24T08:51:47,Bilbao,Expense,basic-services,-297.36,-352604.93
buyer_1,Luis,28,ES28209599118326557478,TRX_N-01459-09606435,2023-03-25T08:59:14,Vitoria-Gasteiz,Expense,loans,-367.41,-352972.34
buyer_1,Luis,28,ES28209599118326557478,TRX_N-01460-21702345,2023-03-25T15:14:03,Bilbao,Expense,healthcare,-142.59,-353114.93
buyer_1,Luis,28,ES28209599118326557478,TRX_N-01461-29723610,2023-03-25T19:46:39,Bilbao,Expense,leisure,-361.19,-353476.12
buyer_1,Luis,28,ES28209599118326557478,TRX_N-01462-19178735,2023-03-26T22:45:36,Bilbao,Expense,clothing,-231.91,-353708.03
buyer_1,Luis,28,ES28209599118326557478,TRX_N-01463-54219767,2023-03-26T14:41:38,Bilbao,Expense,children,-467.54,-354175.57
buyer_1,Luis,28,ES28209599118326557478,TRX_N-01464-95051372,2023-03-26T18:50:39,Bilbao,Expense,technology,-71.34,-354246.91
buyer_1,Luis,28,ES28209599118326557478,TRX_N-01465-19620532,2023-03-27T01:00:33,Portugalete,Expense,education,-257.49,-354504.4
buyer_1,Luis,28,ES28209599118326557478,TRX_N-01466-48584520,2023-03-27T15:17:35,Eibar,Expense,personal_care,-101.39,-354605.79
buyer_1,Luis,28,ES28209599118326557478,TRX_N-01467-14141957,2023-03-27T09:23:58,Labastida,Expense,loans,-86.13,-354691.92
buyer_1,Luis,28,ES28209599118326557478,TRX_N-01468-60818655,2023-03-28T07:25:06,Andoain,Expense,clothing,-362.3,-355054.22
buyer_1,Luis,28,ES28209599118326557478,TRX_N-01469-40726188,2023-03-28T10:09:50,Bilbao,Expense,technology,-357.21,-355411.43
buyer_1,Luis,28,ES28209599118326557478,TRX_N-01470-07353818,2023-03-28T01:11:02,Portugalete,Expense,transport,-190.77,-355602.2
buyer_1,Luis,28,ES28209599118326557478,TRX_N-01471-35176877,2023-03-29T09:06:11,Bilbao,Expense,healthcare,-354.53,-355956.73
buyer_1,Luis,28,ES28209599118326557478,TRX_N-01472-63799340,2023-03-29T05:04:57,Bilbao,Expense,basic-services,-124.65,-356081.38
buyer_1,Luis,28,ES28209599118326557478,TRX_N-01473-38518228,2023-03-29T16:24:15,Erandio,Expense,education,-63.01,-356144.39
buyer_1,Luis,28,ES28209599118326557478,TRX_N-01474-65831213,2023-03-30T17:04:37,Bilbao,Expense,basic-services,-239.43,-356383.82
buyer_1,Luis,28,ES28209599118326557478,TRX_N-01475-44733023,2023-03-30T15:29:46,Bilbao,Expense,children,-357.62,-356741.44
buyer_1,Luis,28,ES28209599118326557478,TRX_N-01476-82410747,2023-03-30T10:31:37,Bilbao,Expense,housing,-266.88,-357008.32
buyer_1,Luis,28,ES28209599118326557478,TRX_N-01477-63352460,2023-03-31T09:05:20,Bilbao,Expense,car,-125.07,-357133.39
buyer_1,Luis,28,ES28209599118326557478,TRX_N-01478-41403641,2023-03-31T17:41:11,Alegría-Dulantzi,Expense,clothing,-52.67,-357186.06
buyer_1,Luis,28,ES28209599118326557478,TRX_N-01479-43233349,2023-03-31T01:47:17,Elciego,Expense,personal_care,-303.36,-357489.42
buyer_1,Luis,28,ES28209599118326557478,TRX_N-01480-29929881,2023-04-01T13:23:37,Bilbao,incomes,salary,1265.98,-356223.44
buyer_1,Luis,28,ES28209599118326557478,TRX_N-01481-41092644,2023-04-01T16:02:27,Bilbao,Expense,food,-461.1,-356684.54
buyer_1,Luis,28,ES28209599118326557478,TRX_N-01482-33409299,2023-04-01T15:09:32,Alegría-Dulantzi,Expense,savings,-329.51,-357014.05
buyer_1,Luis,28,ES28209599118326557478,TRX_N-01483-43550032,2023-04-01T09:59:18,Irun,Expense,leisure,-325.03,-357339.08
buyer_1,Luis,28,ES28209599118326557478,TRX_N-01484-01504938,2023-04-02T18:52:45,Bilbao,Expense,healthcare,-12.64,-357351.72
buyer_1,Luis,28,ES28209599118326557478,TRX_N-01485-31528444,2023-04-02T22:32:44,Bilbao,Expense,children,-183.37,-357535.09
buyer_1,Luis,28,ES28209599118326557478,TRX_N-01486-58104304,2023-04-02T18:47:46,Bilbao,Expense,savings,-36.63,-357571.72
buyer_1,Luis,28,ES28209599118326557478,TRX_N-01487-37550966,2023-04-03T21:14:29,Bilbao,Expense,children,-221.2,-357792.92
buyer_1,Luis,28,ES28209599118326557478,TRX_N-01488-42333568,2023-04-03T08:01:42,Bilbao,Expense,children,-450.14,-358243.06
buyer_1,Luis,28,ES28209599118326557478,TRX_N-01489-26555051,2023-04-03T18:38:55,Bilbao,Expense,leisure,-427.2,-358670.26
buyer_1,Luis,28,ES28209599118326557478,TRX_N-01490-88846734,2023-04-04T12:02:24,Bilbao,Housing,Rent,-1369.49,-360039.75
buyer_1,Luis,28,ES28209599118326557478,TRX_N-01491-30801837,2023-04-04T13:46:04,Portugalete,Expense,car,-35.49,-360075.24
buyer_1,Luis,28,ES28209599118326557478,TRX_N-01492-22349229,2023-04-04T12:18:39,Bilbao,Expense,clothing,-135.34,-360210.58
buyer_1,Luis,28,ES28209599118326557478,TRX_N-01493-48118324,2023-04-04T15:14:59,Hernani,Expense,transport,-401.04,-360611.62
buyer_1,Luis,28,ES28209599118326557478,TRX_N-01494-87083742,2023-04-05T18:40:56,Bilbao,Expense,clothing,-80.65,-360692.27
buyer_1,Luis,28,ES28209599118326557478,TRX_N-01495-71558745,2023-04-05T18:51:15,Bilbao,Expense,loans,-394.38,-361086.65
buyer_1,Luis,28,ES28209599118326557478,TRX_N-01496-06967677,2023-04-05T02:51:08,Bilbao,Expense,transport,-354.24,-361440.89
buyer_1,Luis,28,ES28209599118326557478,TRX_N-01497-96854973,2023-04-06T20:49:36,Bilbao,basic_services,phone,-34.9,-361475.79
buyer_1,Luis,28,ES28209599118326557478,TRX_N-01498-85773204,2023-04-06T17:14:16,Hernani,Expense,personal_care,-30.68,-361506.47
buyer_1,Luis,28,ES28209599118326557478,TRX_N-01499-85945293,2023-04-06T12:02:41,Irun,Expense,personal_care,-346.32,-361852.79
buyer_1,Luis,28,ES28209599118326557478,TRX_N-01500-93736925,2023-04-06T21:56:13,Bilbao,Expense,personal_care,-17.61,-361870.4
buyer_1,Luis,28,ES28209599118326557478,TRX_N-01501-10433272,2023-04-07T22:03:55,Bilbao,basic_services,internet,-57.6,-361928.0
buyer_1,Luis,28,ES28209599118326557478,TRX_N-01502-95459236,2023-04-07T14:08:55,Eibar,Expense,healthcare,-129.75,-362057.75
buyer_1,Luis,28,ES28209599118326557478,TRX_N-01503-61665323,2023-04-07T18:18:35,Bilbao,Expense,savings,-29.57,-362087.32
buyer_1,Luis,28,ES28209599118326557478,TRX_N-01504-45834545,2023-04-07T16:58:46,Bilbao,Expense,food,-159.47,-362246.79
buyer_1,Luis,28,ES28209599118326557478,TRX_N-01505-91973440,2023-04-08T15:45:02,Bilbao,basic_services,water,-44.07,-362290.86
buyer_1,Luis,28,ES28209599118326557478,TRX_N-01506-51740746,2023-04-08T17:27:14,Bilbao,basic_services,electricity,-91.04,-362381.9
buyer_1,Luis,28,ES28209599118326557478,TRX_N-01507-18813641,2023-04-08T15:38:25,Bilbao,basic_services,gas,-81.46,-362463.36
buyer_1,Luis,28,ES28209599118326557478,TRX_N-01508-26327496,2023-04-08T09:15:25,Bilbao,Expense,transport,-222.44,-362685.8
buyer_1,Luis,28,ES28209599118326557478,TRX_N-01509-55093408,2023-04-08T10:25:54,Bilbao,Expense,subscriptions,-162.99,-362848.79
buyer_1,Luis,28,ES28209599118326557478,TRX_N-01510-28211609,2023-04-08T01:17:07,Bilbao,Expense,children,-429.59,-363278.38
buyer_1,Luis,28,ES28209599118326557478,TRX_N-01511-93205670,2023-04-09T02:39:44,Bilbao,Expense,subscriptions,-258.49,-363536.87
buyer_1,Luis,28,ES28209599118326557478,TRX_N-01512-84979093,2023-04-09T20:00:14,Bilbao,Expense,education,-283.21,-363820.08
buyer_1,Luis,28,ES28209599118326557478,TRX_N-01513-01463118,2023-04-09T19:37:38,Bilbao,Expense,car,-32.58,-363852.66
buyer_1,Luis,28,ES28209599118326557478,TRX_N-01514-87503548,2023-04-10T13:24:22,Bilbao,Expense,personal_care,-383.96,-364236.62
buyer_1,Luis,28,ES28209599118326557478,TRX_N-01515-80550815,2023-04-10T08:10:32,Bilbao,Expense,housing,-178.7,-364415.32
buyer_1,Luis,28,ES28209599118326557478,TRX_N-01516-52191464,2023-04-10T11:56:55,Bilbao,Expense,healthcare,-257.86,-364673.18
buyer_1,Luis,28,ES28209599118326557478,TRX_N-01517-07440439,2023-04-11T16:12:32,Bilbao,Expense,car,-256.77,-364929.95
buyer_1,Luis,28,ES28209599118326557478,TRX_N-01518-59300849,2023-04-11T10:38:27,Bilbao,Expense,food,-234.38,-365164.33
buyer_1,Luis,28,ES28209599118326557478,TRX_N-01519-70704856,2023-04-11T14:50:22,Bilbao,Expense,subscriptions,-176.61,-365340.94
buyer_1,Luis,28,ES28209599118326557478,TRX_N-01520-15123340,2023-04-12T12:44:01,Getxo,Expense,food,-240.22,-365581.16
buyer_1,Luis,28,ES28209599118326557478,TRX_N-01521-05589425,2023-04-12T08:36:22,Bilbao,Expense,transport,-426.93,-366008.09
buyer_1,Luis,28,ES28209599118326557478,TRX_N-01522-64809165,2023-04-12T10:21:21,Bilbao,Expense,children,-42.8,-366050.89
buyer_1,Luis,28,ES28209599118326557478,TRX_N-01523-18211679,2023-04-13T08:09:54,Bilbao,Expense,basic-services,-334.01,-366384.9
buyer_1,Luis,28,ES28209599118326557478,TRX_N-01524-70528909,2023-04-13T22:36:45,Bilbao,Expense,food,-176.76,-366561.66
buyer_1,Luis,28,ES28209599118326557478,TRX_N-01525-49837968,2023-04-13T11:07:26,Elciego,Expense,education,-68.16,-366629.82
buyer_1,Luis,28,ES28209599118326557478,TRX_N-01526-36943466,2023-04-14T02:27:36,Galdakao,Expense,car,-148.2,-366778.02
buyer_1,Luis,28,ES28209599118326557478,TRX_N-01527-75787557,2023-04-14T17:30:20,Bilbao,Expense,personal_care,-211.66,-366989.68
buyer_1,Luis,28,ES28209599118326557478,TRX_N-01528-52278744,2023-04-14T13:47:35,Bilbao,Expense,transport,-69.3,-367058.98
buyer_1,Luis,28,ES28209599118326557478,TRX_N-01529-70624170,2023-04-15T10:13:12,Bilbao,Expense,food,-133.46,-367192.44
buyer_1,Luis,28,ES28209599118326557478,TRX_N-01530-51468562,2023-04-15T17:37:29,Bilbao,Expense,healthcare,-137.71,-367330.15
buyer_1,Luis,28,ES28209599118326557478,TRX_N-01531-51450480,2023-04-15T09:31:28,Bilbao,Expense,loans,-391.19,-367721.34
buyer_1,Luis,28,ES28209599118326557478,TRX_N-01532-84730959,2023-04-16T18:31:29,Bilbao,Expense,loans,-53.91,-367775.25
buyer_1,Luis,28,ES28209599118326557478,TRX_N-01533-08141984,2023-04-16T18:37:39,Bilbao,Expense,savings,-418.32,-368193.57
buyer_1,Luis,28,ES28209599118326557478,TRX_N-01534-77713921,2023-04-16T10:00:11,Bilbao,Expense,technology,-452.41,-368645.98
buyer_1,Luis,28,ES28209599118326557478,TRX_N-01535-89732249,2023-04-17T10:20:46,Bilbao,Expense,car,-318.35,-368964.33
buyer_1,Luis,28,ES28209599118326557478,TRX_N-01536-10798892,2023-04-17T09:44:55,Labastida,Expense,loans,-474.41,-369438.74
buyer_1,Luis,28,ES28209599118326557478,TRX_N-01537-35833072,2023-04-17T17:39:49,Sopela,Expense,clothing,-444.4,-369883.14
buyer_1,Luis,28,ES28209599118326557478,TRX_N-01538-28850637,2023-04-18T09:37:45,Bilbao,Expense,loans,-449.55,-370332.69
buyer_1,Luis,28,ES28209599118326557478,TRX_N-01539-20058593,2023-04-18T14:54:32,Bilbao,Expense,personal_care,-89.12,-370421.81
buyer_1,Luis,28,ES28209599118326557478,TRX_N-01540-76365828,2023-04-18T06:13:10,Bilbao,Expense,technology,-252.46,-370674.27
buyer_1,Luis,28,ES28209599118326557478,TRX_N-01541-45009932,2023-04-19T14:14:21,Berango,Expense,car,-482.03,-371156.3
buyer_1,Luis,28,ES28209599118326557478,TRX_N-01542-76163465,2023-04-19T14:21:57,Bilbao,Expense,housing,-95.12,-371251.42
buyer_1,Luis,28,ES28209599118326557478,TRX_N-01543-66319764,2023-04-19T11:05:13,Bilbao,Expense,personal_care,-181.71,-371433.13
buyer_1,Luis,28,ES28209599118326557478,TRX_N-01544-83026105,2023-04-20T10:11:29,Bilbao,Expense,savings,-138.06,-371571.19
buyer_1,Luis,28,ES28209599118326557478,TRX_N-01545-34776612,2023-04-20T14:50:03,Bilbao,Expense,clothing,-31.17,-371602.36
buyer_1,Luis,28,ES28209599118326557478,TRX_N-01546-89740265,2023-04-20T11:11:27,Eibar,Expense,savings,-320.44,-371922.8
buyer_1,Luis,28,ES28209599118326557478,TRX_N-01547-82196206,2023-04-21T22:49:14,Bilbao,Expense,leisure,-418.58,-372341.38
buyer_1,Luis,28,ES28209599118326557478,TRX_N-01548-95427526,2023-04-21T11:36:31,Bilbao,Expense,technology,-165.19,-372506.57
buyer_1,Luis,28,ES28209599118326557478,TRX_N-01549-03032556,2023-04-21T20:35:25,Bilbao,Expense,technology,-467.38,-372973.95
buyer_1,Luis,28,ES28209599118326557478,TRX_N-01550-34439663,2023-04-22T21:36:30,Bilbao,Expense,basic-services,-22.11,-372996.06
buyer_1,Luis,28,ES28209599118326557478,TRX_N-01551-72864490,2023-04-22T15:01:31,Berango,Expense,subscriptions,-474.92,-373470.98
buyer_1,Luis,28,ES28209599118326557478,TRX_N-01552-13772358,2023-04-22T13:20:28,Bilbao,Expense,food,-87.1,-373558.08
buyer_1,Luis,28,ES28209599118326557478,TRX_N-01553-03871413,2023-04-23T09:53:18,Zarautz,Expense,technology,-443.31,-374001.39
buyer_1,Luis,28,ES28209599118326557478,TRX_N-01554-53880737,2023-04-23T08:18:58,Bilbao,Expense,transport,-311.36,-374312.75
buyer_1,Luis,28,ES28209599118326557478,TRX_N-01555-00486637,2023-04-23T09:13:00,Hernani,Expense,children,-456.55,-374769.3
buyer_1,Luis,28,ES28209599118326557478,TRX_N-01556-59085355,2023-04-24T04:06:23,Bilbao,Expense,food,-385.68,-375154.98
buyer_1,Luis,28,ES28209599118326557478,TRX_N-01557-30720810,2023-04-24T12:54:14,Hondarribia,Expense,basic-services,-435.71,-375590.69
buyer_1,Luis,28,ES28209599118326557478,TRX_N-01558-48942509,2023-04-24T04:11:41,Bilbao,Expense,subscriptions,-367.46,-375958.15
buyer_1,Luis,28,ES28209599118326557478,TRX_N-01559-47659720,2023-04-25T13:06:45,Bilbao,Expense,basic-services,-14.46,-375972.61
buyer_1,Luis,28,ES28209599118326557478,TRX_N-01560-65365094,2023-04-25T16:57:32,Bilbao,Expense,subscriptions,-477.51,-376450.12
buyer_1,Luis,28,ES28209599118326557478,TRX_N-01561-13071708,2023-04-25T16:21:44,Bilbao,Expense,savings,-281.35,-376731.47
buyer_1,Luis,28,ES28209599118326557478,TRX_N-01562-57346196,2023-04-26T01:14:01,Bilbao,Expense,healthcare,-240.65,-376972.12
buyer_1,Luis,28,ES28209599118326557478,TRX_N-01563-71899540,2023-04-26T17:13:04,Bilbao,Expense,housing,-496.47,-377468.59
buyer_1,Luis,28,ES28209599118326557478,TRX_N-01564-40628528,2023-04-26T15:09:29,Bilbao,Expense,housing,-367.5,-377836.09
buyer_1,Luis,28,ES28209599118326557478,TRX_N-01565-30766051,2023-04-27T14:38:06,Bilbao,Expense,basic-services,-90.01,-377926.1
buyer_1,Luis,28,ES28209599118326557478,TRX_N-01566-96497386,2023-04-27T10:29:58,Bilbao,Expense,education,-496.77,-378422.87
buyer_1,Luis,28,ES28209599118326557478,TRX_N-01567-91005264,2023-04-27T20:31:40,Bilbao,Expense,personal_care,-451.58,-378874.45
buyer_1,Luis,28,ES28209599118326557478,TRX_N-01568-85169803,2023-04-28T19:41:39,Bermeo,Expense,subscriptions,-298.83,-379173.28
buyer_1,Luis,28,ES28209599118326557478,TRX_N-01569-34714030,2023-04-28T18:22:04,Bilbao,Expense,car,-398.09,-379571.37
buyer_1,Luis,28,ES28209599118326557478,TRX_N-01570-19408072,2023-04-28T17:34:31,Sopela,Expense,personal_care,-404.89,-379976.26
buyer_1,Luis,28,ES28209599118326557478,TRX_N-01571-31811580,2023-04-29T19:44:53,Bilbao,Expense,basic-services,-238.89,-380215.15
buyer_1,Luis,28,ES28209599118326557478,TRX_N-01572-17473462,2023-04-29T15:59:16,Bilbao,Expense,leisure,-261.3,-380476.45
buyer_1,Luis,28,ES28209599118326557478,TRX_N-01573-66644475,2023-04-29T17:38:10,Bilbao,Expense,transport,-285.74,-380762.19
buyer_1,Luis,28,ES28209599118326557478,TRX_N-01574-70980609,2023-04-30T17:30:25,Bilbao,Expense,housing,-188.99,-380951.18
buyer_1,Luis,28,ES28209599118326557478,TRX_N-01575-37255991,2023-04-30T12:46:34,Bilbao,Expense,leisure,-493.75,-381444.93
buyer_1,Luis,28,ES28209599118326557478,TRX_N-01576-09214505,2023-04-30T20:57:35,Bilbao,Expense,basic-services,-173.41,-381618.34
buyer_1,Luis,28,ES28209599118326557478,TRX_N-01577-30784601,2023-05-01T14:49:45,Bilbao,incomes,salary,1265.98,-380352.36
buyer_1,Luis,28,ES28209599118326557478,TRX_N-01578-47172041,2023-05-01T14:49:45,Bilbao,incomes,extra_income,126.6,-380225.76
buyer_1,Luis,28,ES28209599118326557478,TRX_N-01579-32901715,2023-05-01T13:55:06,Bilbao,Expense,subscriptions,-94.26,-380320.02
buyer_1,Luis,28,ES28209599118326557478,TRX_N-01580-57952049,2023-05-01T16:06:38,Bilbao,Expense,basic-services,-76.52,-380396.54
buyer_1,Luis,28,ES28209599118326557478,TRX_N-01581-97869420,2023-05-01T14:06:12,Bilbao,Expense,basic-services,-310.85,-380707.39
buyer_1,Luis,28,ES28209599118326557478,TRX_N-01582-76648344,2023-05-02T10:58:14,Bilbao,Expense,housing,-40.42,-380747.81
buyer_1,Luis,28,ES28209599118326557478,TRX_N-01583-07183030,2023-05-02T09:05:34,Bilbao,Expense,savings,-141.73,-380889.54
buyer_1,Luis,28,ES28209599118326557478,TRX_N-01584-07721705,2023-05-02T09:25:26,Bilbao,Expense,leisure,-490.38,-381379.92
buyer_1,Luis,28,ES28209599118326557478,TRX_N-01585-72037177,2023-05-03T16:17:54,Bilbao,Expense,personal_care,-432.39,-381812.31
buyer_1,Luis,28,ES28209599118326557478,TRX_N-01586-51332235,2023-05-03T21:18:24,Bilbao,Expense,healthcare,-336.26,-382148.57
buyer_1,Luis,28,ES28209599118326557478,TRX_N-01587-01226010,2023-05-03T11:24:48,Bilbao,Expense,food,-338.4,-382486.97
buyer_1,Luis,28,ES28209599118326557478,TRX_N-01588-33475422,2023-05-04T11:04:15,Bilbao,Housing,Rent,-1369.49,-383856.46
buyer_1,Luis,28,ES28209599118326557478,TRX_N-01589-82561855,2023-05-04T11:53:08,Bilbao,Expense,savings,-315.44,-384171.9
buyer_1,Luis,28,ES28209599118326557478,TRX_N-01590-56333036,2023-05-04T08:04:00,Bilbao,Expense,personal_care,-301.19,-384473.09
buyer_1,Luis,28,ES28209599118326557478,TRX_N-01591-13105088,2023-05-04T17:20:40,Bilbao,Expense,food,-352.83,-384825.92
buyer_1,Luis,28,ES28209599118326557478,TRX_N-01592-54561178,2023-05-05T16:44:03,Bilbao,basic_services,water,-74.52,-384900.44
buyer_1,Luis,28,ES28209599118326557478,TRX_N-01593-34970332,2023-05-05T01:09:17,Bilbao,basic_services,electricity,-87.98,-384988.42
buyer_1,Luis,28,ES28209599118326557478,TRX_N-01594-16421976,2023-05-05T12:46:08,Bilbao,basic_services,phone,-37.2,-385025.62
buyer_1,Luis,28,ES28209599118326557478,TRX_N-01595-82328357,2023-05-05T21:34:58,Bilbao,Expense,car,-289.61,-385315.23
buyer_1,Luis,28,ES28209599118326557478,TRX_N-01596-29174983,2023-05-05T14:58:19,Leioa,Expense,clothing,-383.75,-385698.98
buyer_1,Luis,28,ES28209599118326557478,TRX_N-01597-82216478,2023-05-05T23:14:03,Bilbao,Expense,car,-301.79,-386000.77
buyer_1,Luis,28,ES28209599118326557478,TRX_N-01598-82708564,2023-05-06T17:55:43,Bilbao,basic_services,internet,-60.1,-386060.87
buyer_1,Luis,28,ES28209599118326557478,TRX_N-01599-46209618,2023-05-06T19:54:36,Bilbao,Expense,loans,-98.03,-386158.9
buyer_1,Luis,28,ES28209599118326557478,TRX_N-01600-25519021,2023-05-06T02:56:33,Bilbao,Expense,clothing,-258.9,-386417.8
buyer_1,Luis,28,ES28209599118326557478,TRX_N-01601-81399706,2023-05-06T20:13:48,Bilbao,Expense,healthcare,-406.69,-386824.49
buyer_1,Luis,28,ES28209599118326557478,TRX_N-01602-47178063,2023-05-07T18:14:01,Bilbao,basic_services,gas,-18.23,-386842.72
buyer_1,Luis,28,ES28209599118326557478,TRX_N-01603-02286216,2023-05-07T15:34:35,Zuia,Expense,technology,-337.33,-387180.05
buyer_1,Luis,28,ES28209599118326557478,TRX_N-01604-95289009,2023-05-07T12:45:19,Bilbao,Expense,loans,-290.41,-387470.46
buyer_1,Luis,28,ES28209599118326557478,TRX_N-01605-58818429,2023-05-07T17:55:24,Bilbao,Expense,food,-85.92,-387556.38
buyer_1,Luis,28,ES28209599118326557478,TRX_N-01606-47187745,2023-05-08T11:42:45,Bilbao,Expense,technology,-176.71,-387733.09
buyer_1,Luis,28,ES28209599118326557478,TRX_N-01607-28320635,2023-05-08T18:41:01,Bilbao,Expense,healthcare,-457.1,-388190.19
buyer_1,Luis,28,ES28209599118326557478,TRX_N-01608-11748945,2023-05-08T20:10:24,Bilbao,Expense,food,-349.14,-388539.33
buyer_1,Luis,28,ES28209599118326557478,TRX_N-01609-11915308,2023-05-09T13:07:10,Bilbao,Expense,car,-151.7,-388691.03
buyer_1,Luis,28,ES28209599118326557478,TRX_N-01610-71450719,2023-05-09T17:31:18,Bilbao,Expense,clothing,-282.12,-388973.15
buyer_1,Luis,28,ES28209599118326557478,TRX_N-01611-39677470,2023-05-09T17:27:23,Bilbao,Expense,car,-262.7,-389235.85
buyer_1,Luis,28,ES28209599118326557478,TRX_N-01612-02043357,2023-05-10T10:26:26,Bilbao,Expense,car,-357.19,-389593.04
buyer_1,Luis,28,ES28209599118326557478,TRX_N-01613-63484717,2023-05-10T18:03:24,Bilbao,Expense,technology,-110.17,-389703.21
buyer_1,Luis,28,ES28209599118326557478,TRX_N-01614-61390126,2023-05-10T11:26:45,Bilbao,Expense,subscriptions,-321.58,-390024.79
buyer_1,Luis,28,ES28209599118326557478,TRX_N-01615-32578258,2023-05-11T11:43:03,Amurrio,Expense,children,-296.36,-390321.15
buyer_1,Luis,28,ES28209599118326557478,TRX_N-01616-08135220,2023-05-11T19:48:11,Bilbao,Expense,food,-490.75,-390811.9
buyer_1,Luis,28,ES28209599118326557478,TRX_N-01617-42692628,2023-05-11T10:20:09,Bilbao,Expense,leisure,-293.57,-391105.47
buyer_1,Luis,28,ES28209599118326557478,TRX_N-01618-42070283,2023-05-12T17:11:02,Lasarte-Oria,Expense,education,-284.36,-391389.83
buyer_1,Luis,28,ES28209599118326557478,TRX_N-01619-35826225,2023-05-12T09:31:34,Bilbao,Expense,housing,-45.76,-391435.59
buyer_1,Luis,28,ES28209599118326557478,TRX_N-01620-76147895,2023-05-12T10:03:49,Bilbao,Expense,personal_care,-415.03,-391850.62
buyer_1,Luis,28,ES28209599118326557478,TRX_N-01621-67718279,2023-05-13T11:33:16,Bilbao,Expense,personal_care,-63.28,-391913.9
buyer_1,Luis,28,ES28209599118326557478,TRX_N-01622-23384038,2023-05-13T14:25:50,Bilbao,Expense,transport,-34.49,-391948.39
buyer_1,Luis,28,ES28209599118326557478,TRX_N-01623-34713311,2023-05-13T08:50:43,Donostia,Expense,children,-435.98,-392384.37
buyer_1,Luis,28,ES28209599118326557478,TRX_N-01624-93245622,2023-05-14T11:37:50,Bilbao,Expense,car,-181.44,-392565.81
buyer_1,Luis,28,ES28209599118326557478,TRX_N-01625-19560828,2023-05-14T16:22:28,Bilbao,Expense,children,-26.97,-392592.78
buyer_1,Luis,28,ES28209599118326557478,TRX_N-01626-96556799,2023-05-14T15:50:51,Bilbao,Expense,housing,-293.4,-392886.18
buyer_1,Luis,28,ES28209599118326557478,TRX_N-01627-24278500,2023-05-15T12:59:04,Bilbao,Expense,subscriptions,-176.69,-393062.87
buyer_1,Luis,28,ES28209599118326557478,TRX_N-01628-90720729,2023-05-15T01:17:09,Bilbao,Expense,technology,-205.76,-393268.63
buyer_1,Luis,28,ES28209599118326557478,TRX_N-01629-60875303,2023-05-15T06:18:45,Bilbao,Expense,personal_care,-202.3,-393470.93
buyer_1,Luis,28,ES28209599118326557478,TRX_N-01630-50945775,2023-05-16T18:35:44,Iruña de Oca,Expense,car,-410.54,-393881.47
buyer_1,Luis,28,ES28209599118326557478,TRX_N-01631-37302415,2023-05-16T13:40:36,Getxo,Expense,loans,-11.92,-393893.39
buyer_1,Luis,28,ES28209599118326557478,TRX_N-01632-60566618,2023-05-16T14:19:42,Bilbao,Expense,children,-382.13,-394275.52
buyer_1,Luis,28,ES28209599118326557478,TRX_N-01633-00074373,2023-05-17T09:03:40,Bilbao,Expense,housing,-216.96,-394492.48
buyer_1,Luis,28,ES28209599118326557478,TRX_N-01634-66874055,2023-05-17T16:22:04,Durango,Expense,healthcare,-157.49,-394649.97
buyer_1,Luis,28,ES28209599118326557478,TRX_N-01635-64024001,2023-05-17T16:34:01,Bilbao,Expense,technology,-289.41,-394939.38
buyer_1,Luis,28,ES28209599118326557478,TRX_N-01636-47253072,2023-05-18T16:59:57,Bilbao,Expense,car,-176.2,-395115.58
buyer_1,Luis,28,ES28209599118326557478,TRX_N-01637-64273156,2023-05-18T14:46:01,Bilbao,Expense,subscriptions,-13.84,-395129.42
buyer_1,Luis,28,ES28209599118326557478,TRX_N-01638-77936832,2023-05-18T14:35:48,Bilbao,Expense,children,-237.18,-395366.6
buyer_1,Luis,28,ES28209599118326557478,TRX_N-01639-19955392,2023-05-19T16:24:38,Bilbao,Expense,technology,-413.47,-395780.07
buyer_1,Luis,28,ES28209599118326557478,TRX_N-01640-77801640,2023-05-19T16:24:03,Bilbao,Expense,personal_care,-66.65,-395846.72
buyer_1,Luis,28,ES28209599118326557478,TRX_N-01641-93867407,2023-05-19T11:30:17,Bilbao,Expense,transport,-211.54,-396058.26
buyer_1,Luis,28,ES28209599118326557478,TRX_N-01642-37101783,2023-05-20T14:58:58,Bilbao,Expense,leisure,-83.58,-396141.84
buyer_1,Luis,28,ES28209599118326557478,TRX_N-01643-28439450,2023-05-20T13:05:27,Salvatierra/Agurain,Expense,clothing,-50.82,-396192.66
buyer_1,Luis,28,ES28209599118326557478,TRX_N-01644-38883322,2023-05-20T18:43:08,Bilbao,Expense,education,-491.15,-396683.81
buyer_1,Luis,28,ES28209599118326557478,TRX_N-01645-65812141,2023-05-21T13:48:46,Bilbao,Expense,car,-43.59,-396727.4
buyer_1,Luis,28,ES28209599118326557478,TRX_N-01646-58986352,2023-05-21T03:00:45,Bilbao,Expense,subscriptions,-309.87,-397037.27
buyer_1,Luis,28,ES28209599118326557478,TRX_N-01647-77753608,2023-05-21T16:01:20,Bilbao,Expense,leisure,-226.29,-397263.56
buyer_1,Luis,28,ES28209599118326557478,TRX_N-01648-59590628,2023-05-22T17:29:57,Bilbao,Expense,children,-19.14,-397282.7
buyer_1,Luis,28,ES28209599118326557478,TRX_N-01649-70194348,2023-05-22T14:10:05,Bilbao,Expense,subscriptions,-161.9,-397444.6
buyer_1,Luis,28,ES28209599118326557478,TRX_N-01650-19856391,2023-05-22T15:23:58,Bilbao,Expense,clothing,-259.55,-397704.15
buyer_1,Luis,28,ES28209599118326557478,TRX_N-01651-11099024,2023-05-23T16:10:18,Bilbao,Expense,children,-339.46,-398043.61
buyer_1,Luis,28,ES28209599118326557478,TRX_N-01652-90292190,2023-05-23T15:33:43,Bilbao,Expense,subscriptions,-246.32,-398289.93
buyer_1,Luis,28,ES28209599118326557478,TRX_N-01653-82616851,2023-05-23T15:32:08,Bilbao,Expense,subscriptions,-254.84,-398544.77
buyer_1,Luis,28,ES28209599118326557478,TRX_N-01654-43282715,2023-05-24T10:42:41,Bermeo,Expense,savings,-470.88,-399015.65
buyer_1,Luis,28,ES28209599118326557478,TRX_N-01655-88042899,2023-05-24T14:32:33,Bilbao,Expense,clothing,-341.51,-399357.16
buyer_1,Luis,28,ES28209599118326557478,TRX_N-01656-81480533,2023-05-24T14:26:49,Bilbao,Expense,leisure,-177.01,-399534.17
buyer_1,Luis,28,ES28209599118326557478,TRX_N-01657-42362423,2023-05-25T09:26:41,Bilbao,Expense,transport,-194.6,-399728.77
buyer_1,Luis,28,ES28209599118326557478,TRX_N-01658-25340574,2023-05-25T09:38:50,Bilbao,Expense,leisure,-51.02,-399779.79
buyer_1,Luis,28,ES28209599118326557478,TRX_N-01659-79780238,2023-05-25T17:39:00,Bilbao,Expense,education,-149.31,-399929.1
buyer_1,Luis,28,ES28209599118326557478,TRX_N-01660-28022292,2023-05-26T09:01:32,Arrasate,Expense,car,-174.84,-400103.94
buyer_1,Luis,28,ES28209599118326557478,TRX_N-01661-17412735,2023-05-26T08:14:58,Bilbao,Expense,loans,-55.15,-400159.09
buyer_1,Luis,28,ES28209599118326557478,TRX_N-01662-47448259,2023-05-26T18:23:04,Galdakao,Expense,healthcare,-292.71,-400451.8
buyer_1,Luis,28,ES28209599118326557478,TRX_N-01663-03823344,2023-05-27T12:47:23,Zarautz,Expense,loans,-39.38,-400491.18
buyer_1,Luis,28,ES28209599118326557478,TRX_N-01664-38758736,2023-05-27T12:06:05,Bilbao,Expense,car,-341.12,-400832.3
buyer_1,Luis,28,ES28209599118326557478,TRX_N-01665-22742892,2023-05-27T22:50:59,Bilbao,Expense,basic-services,-426.92,-401259.22
buyer_1,Luis,28,ES28209599118326557478,TRX_N-01666-22417220,2023-05-28T16:52:36,Bilbao,Expense,clothing,-209.93,-401469.15
buyer_1,Luis,28,ES28209599118326557478,TRX_N-01667-72344847,2023-05-28T17:05:25,Bilbao,Expense,food,-44.88,-401514.03
buyer_1,Luis,28,ES28209599118326557478,TRX_N-01668-44389859,2023-05-28T19:46:03,Bilbao,Expense,leisure,-397.18,-401911.21
buyer_1,Luis,28,ES28209599118326557478,TRX_N-01669-88662563,2023-05-29T13:38:58,Bilbao,Expense,clothing,-491.86,-402403.07
buyer_1,Luis,28,ES28209599118326557478,TRX_N-01670-58403486,2023-05-29T21:57:06,Mungia,Expense,leisure,-471.19,-402874.26
buyer_1,Luis,28,ES28209599118326557478,TRX_N-01671-47691991,2023-05-29T16:55:05,Bilbao,Expense,leisure,-419.51,-403293.77
buyer_1,Luis,28,ES28209599118326557478,TRX_N-01672-72240005,2023-05-30T08:42:50,Bilbao,Expense,healthcare,-412.77,-403706.54
buyer_1,Luis,28,ES28209599118326557478,TRX_N-01673-34957919,2023-05-30T20:54:32,Bilbao,Expense,education,-426.1,-404132.64
buyer_1,Luis,28,ES28209599118326557478,TRX_N-01674-59797321,2023-05-30T23:04:00,Bilbao,Expense,food,-306.71,-404439.35
buyer_1,Luis,28,ES28209599118326557478,TRX_N-01675-22717021,2023-05-31T00:48:11,Bilbao,Expense,education,-439.24,-404878.59
buyer_1,Luis,28,ES28209599118326557478,TRX_N-01676-85675512,2023-05-31T08:07:04,Bilbao,Expense,clothing,-430.78,-405309.37
buyer_1,Luis,28,ES28209599118326557478,TRX_N-01677-20134640,2023-05-31T20:40:07,Hernani,Expense,leisure,-180.48,-405489.85
buyer_1,Luis,28,ES28209599118326557478,TRX_N-01678-25892792,2023-06-01T22:50:18,Bilbao,incomes,salary,1265.98,-404223.87
buyer_1,Luis,28,ES28209599118326557478,TRX_N-01679-34352757,2023-06-01T22:50:18,Bilbao,incomes,salary_extra,1006.15,-403217.72
buyer_1,Luis,28,ES28209599118326557478,TRX_N-01680-26180443,2023-06-01T09:57:18,Bilbao,Expense,leisure,-239.85,-403457.57
buyer_1,Luis,28,ES28209599118326557478,TRX_N-01681-42149476,2023-06-01T15:11:01,Bilbao,Expense,savings,-40.44,-403498.01
buyer_1,Luis,28,ES28209599118326557478,TRX_N-01682-74088031,2023-06-01T19:30:42,Bilbao,Expense,technology,-370.59,-403868.6
buyer_1,Luis,28,ES28209599118326557478,TRX_N-01683-57195203,2023-06-02T15:29:52,Bilbao,annual_bills,taxes,-3177.76,-407046.36
buyer_1,Luis,28,ES28209599118326557478,TRX_N-01684-43698182,2023-06-02T01:10:22,Bilbao,annual_bills,insurance,-649.07,-407695.43
buyer_1,Luis,28,ES28209599118326557478,TRX_N-01685-62758109,2023-06-02T16:56:41,Bilbao,Expense,housing,-189.37,-407884.8
buyer_1,Luis,28,ES28209599118326557478,TRX_N-01686-45073209,2023-06-02T20:42:48,Bilbao,Expense,children,-221.7,-408106.5
buyer_1,Luis,28,ES28209599118326557478,TRX_N-01687-73346221,2023-06-02T20:36:36,Bilbao,Expense,technology,-283.56,-408390.06
buyer_1,Luis,28,ES28209599118326557478,TRX_N-01688-79321247,2023-06-03T19:37:01,Bilbao,Expense,personal_care,-328.84,-408718.9
buyer_1,Luis,28,ES28209599118326557478,TRX_N-01689-25132131,2023-06-03T12:22:09,Bilbao,Expense,food,-439.63,-409158.53
buyer_1,Luis,28,ES28209599118326557478,TRX_N-01690-67245142,2023-06-03T18:37:32,Bilbao,Expense,leisure,-483.1,-409641.63
buyer_1,Luis,28,ES28209599118326557478,TRX_N-01691-12320491,2023-06-04T19:46:46,Bilbao,Housing,Rent,-1369.49,-411011.12
buyer_1,Luis,28,ES28209599118326557478,TRX_N-01692-33972683,2023-06-04T03:48:51,Erandio,Expense,clothing,-377.05,-411388.17
buyer_1,Luis,28,ES28209599118326557478,TRX_N-01693-67945219,2023-06-04T15:23:59,Bilbao,Expense,leisure,-450.01,-411838.18
buyer_1,Luis,28,ES28209599118326557478,TRX_N-01694-16593768,2023-06-04T11:38:36,Bilbao,Expense,savings,-349.4,-412187.58
buyer_1,Luis,28,ES28209599118326557478,TRX_N-01695-99059105,2023-06-05T05:25:40,Bilbao,basic_services,phone,-81.35,-412268.93
buyer_1,Luis,28,ES28209599118326557478,TRX_N-01696-29647413,2023-06-05T18:19:25,Bilbao,Expense,savings,-314.05,-412582.98
buyer_1,Luis,28,ES28209599118326557478,TRX_N-01697-14945424,2023-06-05T15:15:54,Bilbao,Expense,technology,-39.9,-412622.88
buyer_1,Luis,28,ES28209599118326557478,TRX_N-01698-04505588,2023-06-05T18:45:52,Bilbao,Expense,car,-29.52,-412652.4
buyer_1,Luis,28,ES28209599118326557478,TRX_N-01699-60843805,2023-06-06T13:00:49,Bilbao,basic_services,internet,-40.96,-412693.36
buyer_1,Luis,28,ES28209599118326557478,TRX_N-01700-71887211,2023-06-06T09:01:31,Bilbao,Expense,basic-services,-437.91,-413131.27
buyer_1,Luis,28,ES28209599118326557478,TRX_N-01701-50883176,2023-06-06T13:14:49,Bilbao,Expense,children,-83.08,-413214.35
buyer_1,Luis,28,ES28209599118326557478,TRX_N-01702-82706316,2023-06-06T17:06:32,Bilbao,Expense,leisure,-459.19,-413673.54
buyer_1,Luis,28,ES28209599118326557478,TRX_N-01703-39412520,2023-06-07T17:44:19,Bilbao,Expense,basic-services,-189.63,-413863.17
buyer_1,Luis,28,ES28209599118326557478,TRX_N-01704-00592063,2023-06-07T19:37:07,Bilbao,Expense,car,-159.94,-414023.11
buyer_1,Luis,28,ES28209599118326557478,TRX_N-01705-14045029,2023-06-07T20:19:39,Bilbao,Expense,subscriptions,-246.85,-414269.96
buyer_1,Luis,28,ES28209599118326557478,TRX_N-01706-52461967,2023-06-08T13:06:41,Bilbao,basic_services,gas,-60.41,-414330.37
buyer_1,Luis,28,ES28209599118326557478,TRX_N-01707-99767619,2023-06-08T16:17:53,Bilbao,basic_services,water,-63.28,-414393.65
buyer_1,Luis,28,ES28209599118326557478,TRX_N-01708-10849506,2023-06-08T11:54:30,Bilbao,basic_services,electricity,-92.35,-414486.0
buyer_1,Luis,28,ES28209599118326557478,TRX_N-01709-03681075,2023-06-08T08:05:48,Bilbao,Expense,car,-58.18,-414544.18
buyer_1,Luis,28,ES28209599118326557478,TRX_N-01710-78887204,2023-06-08T13:46:52,Bilbao,Expense,personal_care,-356.01,-414900.19
buyer_1,Luis,28,ES28209599118326557478,TRX_N-01711-89082155,2023-06-08T08:46:27,Bilbao,Expense,transport,-158.63,-415058.82
buyer_1,Luis,28,ES28209599118326557478,TRX_N-01712-96898600,2023-06-09T10:01:35,Bilbao,Expense,technology,-75.49,-415134.31
buyer_1,Luis,28,ES28209599118326557478,TRX_N-01713-86403189,2023-06-09T16:00:44,Bilbao,Expense,car,-369.46,-415503.77
buyer_1,Luis,28,ES28209599118326557478,TRX_N-01714-54065893,2023-06-09T14:01:40,Sestao,Expense,leisure,-135.47,-415639.24
buyer_1,Luis,28,ES28209599118326557478,TRX_N-01715-29640773,2023-06-10T12:21:04,Bilbao,Expense,car,-457.0,-416096.24
buyer_1,Luis,28,ES28209599118326557478,TRX_N-01716-28045985,2023-06-10T16:02:36,Bilbao,Expense,food,-184.98,-416281.22
buyer_1,Luis,28,ES28209599118326557478,TRX_N-01717-29655742,2023-06-10T11:27:37,Bilbao,Expense,housing,-422.29,-416703.51
buyer_1,Luis,28,ES28209599118326557478,TRX_N-01718-29056526,2023-06-11T18:03:28,Bilbao,Expense,children,-159.98,-416863.49
buyer_1,Luis,28,ES28209599118326557478,TRX_N-01719-70356775,2023-06-11T12:07:40,Bilbao,Expense,technology,-310.3,-417173.79
buyer_1,Luis,28,ES28209599118326557478,TRX_N-01720-44531069,2023-06-11T11:03:25,Bilbao,Expense,food,-168.36,-417342.15
buyer_1,Luis,28,ES28209599118326557478,TRX_N-01721-56566557,2023-06-12T14:09:45,Bilbao,Expense,healthcare,-449.56,-417791.71
buyer_1,Luis,28,ES28209599118326557478,TRX_N-01722-16197516,2023-06-12T15:38:36,Bilbao,Expense,transport,-75.77,-417867.48
buyer_1,Luis,28,ES28209599118326557478,TRX_N-01723-29585712,2023-06-12T10:47:13,Bilbao,Expense,food,-286.2,-418153.68
buyer_1,Luis,28,ES28209599118326557478,TRX_N-01724-18237090,2023-06-13T19:17:55,Bilbao,Expense,housing,-63.21,-418216.89
buyer_1,Luis,28,ES28209599118326557478,TRX_N-01725-92504626,2023-06-13T13:47:35,Bilbao,Expense,personal_care,-104.56,-418321.45
buyer_1,Luis,28,ES28209599118326557478,TRX_N-01726-70899304,2023-06-13T20:31:51,Bilbao,Expense,clothing,-493.52,-418814.97
buyer_1,Luis,28,ES28209599118326557478,TRX_N-01727-83710725,2023-06-14T13:18:10,Bilbao,Expense,education,-497.55,-419312.52
buyer_1,Luis,28,ES28209599118326557478,TRX_N-01728-93858462,2023-06-14T15:02:15,Bilbao,Expense,food,-293.96,-419606.48
buyer_1,Luis,28,ES28209599118326557478,TRX_N-01729-61775630,2023-06-14T20:30:44,Bilbao,Expense,personal_care,-402.25,-420008.73
buyer_1,Luis,28,ES28209599118326557478,TRX_N-01730-89645836,2023-06-15T11:24:46,Bilbao,Expense,savings,-319.01,-420327.74
buyer_1,Luis,28,ES28209599118326557478,TRX_N-01731-96164954,2023-06-15T08:11:33,Bilbao,Expense,car,-374.16,-420701.9
buyer_1,Luis,28,ES28209599118326557478,TRX_N-01732-93636658,2023-06-15T15:12:42,Bilbao,Expense,car,-190.38,-420892.28
buyer_1,Luis,28,ES28209599118326557478,TRX_N-01733-39721626,2023-06-16T13:38:54,Bilbao,Expense,personal_care,-151.16,-421043.44
buyer_1,Luis,28,ES28209599118326557478,TRX_N-01734-55008764,2023-06-16T19:01:51,Bilbao,Expense,food,-339.27,-421382.71
buyer_1,Luis,28,ES28209599118326557478,TRX_N-01735-04431979,2023-06-16T16:39:20,Bilbao,Expense,loans,-409.71,-421792.42
buyer_1,Luis,28,ES28209599118326557478,TRX_N-01736-59115350,2023-06-17T13:39:06,Bilbao,Expense,transport,-28.02,-421820.44
buyer_1,Luis,28,ES28209599118326557478,TRX_N-01737-49486405,2023-06-17T08:35:35,Eibar,Expense,technology,-102.03,-421922.47
buyer_1,Luis,28,ES28209599118326557478,TRX_N-01738-01261021,2023-06-17T12:36:02,Bilbao,Expense,basic-services,-144.65,-422067.12
buyer_1,Luis,28,ES28209599118326557478,TRX_N-01739-16151651,2023-06-18T17:32:50,Bilbao,Expense,technology,-46.12,-422113.24
buyer_1,Luis,28,ES28209599118326557478,TRX_N-01740-22948220,2023-06-18T11:04:18,Bilbao,Expense,education,-421.26,-422534.5
buyer_1,Luis,28,ES28209599118326557478,TRX_N-01741-60973430,2023-06-18T06:36:32,Bilbao,Expense,basic-services,-194.63,-422729.13
buyer_1,Luis,28,ES28209599118326557478,TRX_N-01742-92332985,2023-06-19T23:40:52,Bilbao,Expense,subscriptions,-495.13,-423224.26
buyer_1,Luis,28,ES28209599118326557478,TRX_N-01743-70910512,2023-06-19T12:50:30,Bermeo,Expense,children,-483.23,-423707.49
buyer_1,Luis,28,ES28209599118326557478,TRX_N-01744-02699701,2023-06-19T16:57:54,Bilbao,Expense,clothing,-308.37,-424015.86
buyer_1,Luis,28,ES28209599118326557478,TRX_N-01745-60534786,2023-06-20T15:22:48,Bilbao,Expense,children,-390.65,-424406.51
buyer_1,Luis,28,ES28209599118326557478,TRX_N-01746-60501611,2023-06-20T09:57:44,Bilbao,Expense,savings,-71.56,-424478.07
buyer_1,Luis,28,ES28209599118326557478,TRX_N-01747-33881432,2023-06-20T16:47:09,Bilbao,Expense,loans,-144.11,-424622.18
buyer_1,Luis,28,ES28209599118326557478,TRX_N-01748-06743331,2023-06-21T23:07:46,Bilbao,Expense,healthcare,-415.91,-425038.09
buyer_1,Luis,28,ES28209599118326557478,TRX_N-01749-01083417,2023-06-21T04:28:03,Portugalete,Expense,personal_care,-400.24,-425438.33
buyer_1,Luis,28,ES28209599118326557478,TRX_N-01750-16127059,2023-06-21T11:28:16,Bilbao,Expense,personal_care,-183.64,-425621.97
buyer_1,Luis,28,ES28209599118326557478,TRX_N-01751-05026891,2023-06-22T10:53:42,Bilbao,Expense,technology,-269.68,-425891.65
buyer_1,Luis,28,ES28209599118326557478,TRX_N-01752-47691340,2023-06-22T23:02:21,Zuia,Expense,children,-279.57,-426171.22
buyer_1,Luis,28,ES28209599118326557478,TRX_N-01753-73307655,2023-06-22T22:55:05,Bilbao,Expense,clothing,-275.33,-426446.55
buyer_1,Luis,28,ES28209599118326557478,TRX_N-01754-13289876,2023-06-23T04:53:09,Bilbao,Expense,healthcare,-456.16,-426902.71
buyer_1,Luis,28,ES28209599118326557478,TRX_N-01755-93396912,2023-06-23T14:51:59,Zarautz,Expense,housing,-29.5,-426932.21
buyer_1,Luis,28,ES28209599118326557478,TRX_N-01756-20953022,2023-06-23T18:41:13,Bilbao,Expense,food,-267.98,-427200.19
buyer_1,Luis,28,ES28209599118326557478,TRX_N-01757-17724782,2023-06-24T05:13:06,Bilbao,Expense,housing,-337.52,-427537.71
buyer_1,Luis,28,ES28209599118326557478,TRX_N-01758-33574031,2023-06-24T10:29:54,Bilbao,Expense,children,-320.54,-427858.25
buyer_1,Luis,28,ES28209599118326557478,TRX_N-01759-05640361,2023-06-24T11:53:01,Bilbao,Expense,savings,-474.27,-428332.52
buyer_1,Luis,28,ES28209599118326557478,TRX_N-01760-60123286,2023-06-25T19:31:02,Portugalete,Expense,education,-223.3,-428555.82
buyer_1,Luis,28,ES28209599118326557478,TRX_N-01761-85841790,2023-06-25T22:23:39,Bilbao,Expense,healthcare,-368.01,-428923.83
buyer_1,Luis,28,ES28209599118326557478,TRX_N-01762-87553315,2023-06-25T01:02:12,Bilbao,Expense,savings,-494.71,-429418.54
buyer_1,Luis,28,ES28209599118326557478,TRX_N-01763-10472699,2023-06-26T17:53:48,Bilbao,Expense,subscriptions,-236.94,-429655.48
buyer_1,Luis,28,ES28209599118326557478,TRX_N-01764-61681398,2023-06-26T10:34:32,Bilbao,Expense,personal_care,-362.93,-430018.41
buyer_1,Luis,28,ES28209599118326557478,TRX_N-01765-23932375,2023-06-26T10:08:56,Bilbao,Expense,leisure,-490.02,-430508.43
buyer_1,Luis,28,ES28209599118326557478,TRX_N-01766-81149052,2023-06-27T11:29:56,Erandio,Expense,healthcare,-322.29,-430830.72
buyer_1,Luis,28,ES28209599118326557478,TRX_N-01767-46969869,2023-06-27T20:06:22,Lasarte-Oria,Expense,clothing,-437.02,-431267.74
buyer_1,Luis,28,ES28209599118326557478,TRX_N-01768-22578797,2023-06-27T23:29:36,Bilbao,Expense,clothing,-290.67,-431558.41
buyer_1,Luis,28,ES28209599118326557478,TRX_N-01769-04767343,2023-06-28T21:13:24,Bilbao,Expense,savings,-59.9,-431618.31
buyer_1,Luis,28,ES28209599118326557478,TRX_N-01770-50898235,2023-06-28T11:44:59,Bilbao,Expense,clothing,-384.89,-432003.2
buyer_1,Luis,28,ES28209599118326557478,TRX_N-01771-94521867,2023-06-28T10:50:10,Bilbao,Expense,healthcare,-409.57,-432412.77
buyer_1,Luis,28,ES28209599118326557478,TRX_N-01772-17775652,2023-06-29T11:17:12,Bilbao,Expense,technology,-225.45,-432638.22
buyer_1,Luis,28,ES28209599118326557478,TRX_N-01773-04971310,2023-06-29T12:57:52,Bilbao,Expense,housing,-19.16,-432657.38
buyer_1,Luis,28,ES28209599118326557478,TRX_N-01774-24979241,2023-06-29T16:03:56,Getxo,Expense,housing,-272.11,-432929.49
buyer_1,Luis,28,ES28209599118326557478,TRX_N-01775-91656028,2023-06-30T08:54:30,Barakaldo,Expense,personal_care,-23.56,-432953.05
buyer_1,Luis,28,ES28209599118326557478,TRX_N-01776-58498224,2023-06-30T11:38:10,Bilbao,Expense,clothing,-486.72,-433439.77
buyer_1,Luis,28,ES28209599118326557478,TRX_N-01777-45521376,2023-06-30T12:09:45,Bilbao,Expense,transport,-439.65,-433879.42
buyer_1,Luis,28,ES28209599118326557478,TRX_N-01778-36663197,2023-07-01T08:44:47,Bilbao,incomes,salary,1265.98,-432613.44
buyer_1,Luis,28,ES28209599118326557478,TRX_N-01779-44795597,2023-07-01T15:24:58,Bilbao,Expense,education,-172.14,-432785.58
buyer_1,Luis,28,ES28209599118326557478,TRX_N-01780-82708719,2023-07-01T10:02:08,Bilbao,Expense,savings,-22.24,-432807.82
buyer_1,Luis,28,ES28209599118326557478,TRX_N-01781-62502345,2023-07-01T14:17:46,Bilbao,Expense,leisure,-201.09,-433008.91
buyer_1,Luis,28,ES28209599118326557478,TRX_N-01782-26380941,2023-07-02T11:54:26,Bilbao,Expense,clothing,-65.05,-433073.96
buyer_1,Luis,28,ES28209599118326557478,TRX_N-01783-99096151,2023-07-02T17:36:47,Bilbao,Expense,children,-156.95,-433230.91
buyer_1,Luis,28,ES28209599118326557478,TRX_N-01784-17507654,2023-07-02T20:46:52,Bilbao,Expense,leisure,-497.63,-433728.54
buyer_1,Luis,28,ES28209599118326557478,TRX_N-01785-28948686,2023-07-03T12:18:14,Bilbao,Expense,transport,-67.43,-433795.97
buyer_1,Luis,28,ES28209599118326557478,TRX_N-01786-45602077,2023-07-03T11:01:18,Leioa,Expense,transport,-112.9,-433908.87
buyer_1,Luis,28,ES28209599118326557478,TRX_N-01787-94429815,2023-07-03T14:56:20,Barakaldo,Expense,healthcare,-60.27,-433969.14
buyer_1,Luis,28,ES28209599118326557478,TRX_N-01788-99454624,2023-07-04T23:46:57,Bilbao,Housing,Rent,-1369.49,-435338.63
buyer_1,Luis,28,ES28209599118326557478,TRX_N-01789-36724379,2023-07-04T14:14:07,Bilbao,Expense,technology,-86.41,-435425.04
buyer_1,Luis,28,ES28209599118326557478,TRX_N-01790-89679329,2023-07-04T07:16:24,Bilbao,Expense,leisure,-34.94,-435459.98
buyer_1,Luis,28,ES28209599118326557478,TRX_N-01791-36213771,2023-07-04T19:52:33,Bilbao,Expense,children,-289.99,-435749.97
buyer_1,Luis,28,ES28209599118326557478,TRX_N-01792-86140925,2023-07-05T10:46:13,Bilbao,basic_services,internet,-62.18,-435812.15
buyer_1,Luis,28,ES28209599118326557478,TRX_N-01793-93860660,2023-07-05T15:25:02,Bilbao,Expense,subscriptions,-399.26,-436211.41
buyer_1,Luis,28,ES28209599118326557478,TRX_N-01794-38078122,2023-07-05T16:01:35,Bilbao,Expense,savings,-371.4,-436582.81
buyer_1,Luis,28,ES28209599118326557478,TRX_N-01795-92049355,2023-07-05T09:51:59,Bilbao,Expense,healthcare,-137.37,-436720.18
buyer_1,Luis,28,ES28209599118326557478,TRX_N-01796-19243236,2023-07-06T18:46:55,Bilbao,Expense,car,-132.93,-436853.11
buyer_1,Luis,28,ES28209599118326557478,TRX_N-01797-96738276,2023-07-06T08:38:55,Bilbao,Expense,housing,-376.57,-437229.68
buyer_1,Luis,28,ES28209599118326557478,TRX_N-01798-70205812,2023-07-06T10:34:37,Bilbao,Expense,education,-307.18,-437536.86
buyer_1,Luis,28,ES28209599118326557478,TRX_N-01799-84246991,2023-07-07T05:03:10,Bilbao,basic_services,gas,-37.72,-437574.58
buyer_1,Luis,28,ES28209599118326557478,TRX_N-01800-63509283,2023-07-07T15:32:23,Bilbao,Expense,transport,-238.06,-437812.64
buyer_1,Luis,28,ES28209599118326557478,TRX_N-01801-85578038,2023-07-07T14:21:32,Bilbao,Expense,transport,-424.95,-438237.59
buyer_1,Luis,28,ES28209599118326557478,TRX_N-01802-08059066,2023-07-07T15:47:09,Bilbao,Expense,transport,-357.55,-438595.14
buyer_1,Luis,28,ES28209599118326557478,TRX_N-01803-71237356,2023-07-08T20:53:08,Bilbao,basic_services,water,-35.15,-438630.29
buyer_1,Luis,28,ES28209599118326557478,TRX_N-01804-84014835,2023-07-08T10:05:18,Bilbao,basic_services,electricity,-53.57,-438683.86
buyer_1,Luis,28,ES28209599118326557478,TRX_N-01805-97695282,2023-07-08T09:10:34,Bilbao,basic_services,phone,-38.42,-438722.28
buyer_1,Luis,28,ES28209599118326557478,TRX_N-01806-68463607,2023-07-08T19:49:54,Bilbao,Expense,leisure,-144.45,-438866.73
buyer_1,Luis,28,ES28209599118326557478,TRX_N-01807-59532797,2023-07-08T20:42:07,Bermeo,Expense,loans,-14.1,-438880.83
buyer_1,Luis,28,ES28209599118326557478,TRX_N-01808-70540074,2023-07-08T09:17:31,Bilbao,Expense,housing,-470.86,-439351.69
buyer_1,Luis,28,ES28209599118326557478,TRX_N-01809-54368889,2023-07-09T08:32:40,Bilbao,Expense,technology,-471.8,-439823.49
buyer_1,Luis,28,ES28209599118326557478,TRX_N-01810-31929036,2023-07-09T10:23:14,Bilbao,Expense,education,-306.99,-440130.48
buyer_1,Luis,28,ES28209599118326557478,TRX_N-01811-44115612,2023-07-09T19:15:56,Bilbao,Expense,savings,-87.08,-440217.56
buyer_1,Luis,28,ES28209599118326557478,TRX_N-01812-18043034,2023-07-10T20:56:59,Bilbao,Expense,leisure,-416.51,-440634.07
buyer_1,Luis,28,ES28209599118326557478,TRX_N-01813-36017905,2023-07-10T14:06:04,Bilbao,Expense,savings,-348.3,-440982.37
buyer_1,Luis,28,ES28209599118326557478,TRX_N-01814-25794520,2023-07-10T17:11:41,Bilbao,Expense,children,-315.78,-441298.15
buyer_1,Luis,28,ES28209599118326557478,TRX_N-01815-92726421,2023-07-11T17:50:02,Bilbao,Expense,healthcare,-43.08,-441341.23
buyer_1,Luis,28,ES28209599118326557478,TRX_N-01816-06206989,2023-07-11T09:51:17,Salvatierra/Agurain,Expense,technology,-466.83,-441808.06
buyer_1,Luis,28,ES28209599118326557478,TRX_N-01817-44326157,2023-07-11T19:41:00,Vitoria-Gasteiz,Expense,food,-252.35,-442060.41
buyer_1,Luis,28,ES28209599118326557478,TRX_N-01818-88562689,2023-07-12T05:14:23,Amurrio,Expense,technology,-12.8,-442073.21
buyer_1,Luis,28,ES28209599118326557478,TRX_N-01819-21816879,2023-07-12T10:05:51,Bilbao,Expense,leisure,-215.97,-442289.18
buyer_1,Luis,28,ES28209599118326557478,TRX_N-01820-82346449,2023-07-12T11:18:10,Bilbao,Expense,leisure,-303.93,-442593.11
buyer_1,Luis,28,ES28209599118326557478,TRX_N-01821-24579000,2023-07-13T19:40:50,Arrasate,Expense,technology,-66.4,-442659.51
buyer_1,Luis,28,ES28209599118326557478,TRX_N-01822-41538390,2023-07-13T12:42:15,Bilbao,Expense,personal_care,-231.22,-442890.73
buyer_1,Luis,28,ES28209599118326557478,TRX_N-01823-31162639,2023-07-13T17:38:20,Basauri,Expense,clothing,-391.71,-443282.44
buyer_1,Luis,28,ES28209599118326557478,TRX_N-01824-80966315,2023-07-14T14:47:51,Bilbao,Expense,transport,-20.43,-443302.87
buyer_1,Luis,28,ES28209599118326557478,TRX_N-01825-86206529,2023-07-14T13:30:09,Iruña de Oca,Expense,transport,-201.37,-443504.24
buyer_1,Luis,28,ES28209599118326557478,TRX_N-01826-43924953,2023-07-14T17:30:17,Bilbao,Expense,personal_care,-151.09,-443655.33
buyer_1,Luis,28,ES28209599118326557478,TRX_N-01827-18600574,2023-07-15T20:41:59,Bilbao,Expense,transport,-282.5,-443937.83
buyer_1,Luis,28,ES28209599118326557478,TRX_N-01828-32461264,2023-07-15T15:34:23,Hondarribia,Expense,loans,-476.87,-444414.7
buyer_1,Luis,28,ES28209599118326557478,TRX_N-01829-57190134,2023-07-15T08:39:10,Bilbao,Expense,subscriptions,-180.34,-444595.04
buyer_1,Luis,28,ES28209599118326557478,TRX_N-01830-11434825,2023-07-16T13:30:10,Bilbao,Expense,education,-143.7,-444738.74
buyer_1,Luis,28,ES28209599118326557478,TRX_N-01831-85191283,2023-07-16T13:42:38,Errenteria,Expense,food,-120.19,-444858.93
buyer_1,Luis,28,ES28209599118326557478,TRX_N-01832-13754629,2023-07-16T09:47:28,Bilbao,Expense,housing,-284.13,-445143.06
buyer_1,Luis,28,ES28209599118326557478,TRX_N-01833-62304429,2023-07-17T09:26:07,Bilbao,Expense,children,-206.11,-445349.17
buyer_1,Luis,28,ES28209599118326557478,TRX_N-01834-93757355,2023-07-17T16:33:40,Bilbao,Expense,housing,-75.32,-445424.49
buyer_1,Luis,28,ES28209599118326557478,TRX_N-01835-66703476,2023-07-17T17:17:09,Bilbao,Expense,leisure,-315.07,-445739.56
buyer_1,Luis,28,ES28209599118326557478,TRX_N-01836-39474820,2023-07-18T13:23:16,Bilbao,Expense,personal_care,-73.84,-445813.4
buyer_1,Luis,28,ES28209599118326557478,TRX_N-01837-89271824,2023-07-18T12:11:02,Bilbao,Expense,loans,-465.84,-446279.24
buyer_1,Luis,28,ES28209599118326557478,TRX_N-01838-78157335,2023-07-18T13:52:12,Bilbao,Expense,clothing,-157.71,-446436.95
buyer_1,Luis,28,ES28209599118326557478,TRX_N-01839-48204533,2023-07-19T09:07:37,Bilbao,Expense,education,-195.68,-446632.63
buyer_1,Luis,28,ES28209599118326557478,TRX_N-01840-99635213,2023-07-19T13:55:07,Bilbao,Expense,savings,-217.54,-446850.17
buyer_1,Luis,28,ES28209599118326557478,TRX_N-01841-72858154,2023-07-19T21:09:55,Bilbao,Expense,personal_care,-19.03,-446869.2
buyer_1,Luis,28,ES28209599118326557478,TRX_N-01842-45243824,2023-07-20T16:19:46,Bilbao,Expense,loans,-395.88,-447265.08
buyer_1,Luis,28,ES28209599118326557478,TRX_N-01843-11684326,2023-07-20T08:48:27,Elciego,Expense,transport,-42.4,-447307.48
buyer_1,Luis,28,ES28209599118326557478,TRX_N-01844-85137354,2023-07-20T09:57:32,Bilbao,Expense,basic-services,-384.32,-447691.8
buyer_1,Luis,28,ES28209599118326557478,TRX_N-01845-20046294,2023-07-21T15:22:13,Bilbao,Expense,technology,-135.92,-447827.72
buyer_1,Luis,28,ES28209599118326557478,TRX_N-01846-24710907,2023-07-21T17:31:44,Bilbao,Expense,clothing,-391.71,-448219.43
buyer_1,Luis,28,ES28209599118326557478,TRX_N-01847-39801369,2023-07-21T09:43:40,Bilbao,Expense,loans,-125.65,-448345.08
buyer_1,Luis,28,ES28209599118326557478,TRX_N-01848-09143721,2023-07-22T09:36:02,Bilbao,Expense,subscriptions,-139.97,-448485.05
buyer_1,Luis,28,ES28209599118326557478,TRX_N-01849-17950007,2023-07-22T16:16:55,Bilbao,Expense,clothing,-181.87,-448666.92
buyer_1,Luis,28,ES28209599118326557478,TRX_N-01850-92389600,2023-07-22T12:38:07,Bilbao,Expense,education,-113.28,-448780.2
buyer_1,Luis,28,ES28209599118326557478,TRX_N-01851-48035875,2023-07-23T10:39:18,Berango,Expense,healthcare,-498.22,-449278.42
buyer_1,Luis,28,ES28209599118326557478,TRX_N-01852-55238817,2023-07-23T01:59:02,Bilbao,Expense,transport,-176.4,-449454.82
buyer_1,Luis,28,ES28209599118326557478,TRX_N-01853-60300400,2023-07-23T13:46:54,Bilbao,Expense,leisure,-436.78,-449891.6
buyer_1,Luis,28,ES28209599118326557478,TRX_N-01854-24815871,2023-07-24T22:32:37,Arrasate,Expense,transport,-208.75,-450100.35
buyer_1,Luis,28,ES28209599118326557478,TRX_N-01855-56309476,2023-07-24T12:08:32,Bilbao,Expense,children,-292.05,-450392.4
buyer_1,Luis,28,ES28209599118326557478,TRX_N-01856-61374383,2023-07-24T18:17:56,Bilbao,Expense,children,-369.16,-450761.56
buyer_1,Luis,28,ES28209599118326557478,TRX_N-01857-46840543,2023-07-25T08:49:43,Bilbao,Expense,car,-328.09,-451089.65
buyer_1,Luis,28,ES28209599118326557478,TRX_N-01858-75786996,2023-07-25T07:58:06,Bilbao,Expense,technology,-472.8,-451562.45
buyer_1,Luis,28,ES28209599118326557478,TRX_N-01859-30019448,2023-07-25T11:25:57,Errenteria,Expense,housing,-288.99,-451851.44
buyer_1,Luis,28,ES28209599118326557478,TRX_N-01860-42110664,2023-07-26T22:20:45,Bilbao,Expense,technology,-64.08,-451915.52
buyer_1,Luis,28,ES28209599118326557478,TRX_N-01861-09692900,2023-07-26T14:22:35,Bilbao,Expense,leisure,-30.36,-451945.88
buyer_1,Luis,28,ES28209599118326557478,TRX_N-01862-61199990,2023-07-26T11:48:11,Bilbao,Expense,basic-services,-183.83,-452129.71
buyer_1,Luis,28,ES28209599118326557478,TRX_N-01863-29110598,2023-07-27T18:46:17,Bilbao,Expense,food,-243.54,-452373.25
buyer_1,Luis,28,ES28209599118326557478,TRX_N-01864-69993575,2023-07-27T14:23:49,Bilbao,Expense,healthcare,-135.76,-452509.01
buyer_1,Luis,28,ES28209599118326557478,TRX_N-01865-69798030,2023-07-27T12:11:03,Bilbao,Expense,children,-415.65,-452924.66
buyer_1,Luis,28,ES28209599118326557478,TRX_N-01866-60093764,2023-07-28T11:28:45,Bilbao,Expense,savings,-247.06,-453171.72
buyer_1,Luis,28,ES28209599118326557478,TRX_N-01867-75142533,2023-07-28T14:52:14,Bilbao,Expense,savings,-236.94,-453408.66
buyer_1,Luis,28,ES28209599118326557478,TRX_N-01868-42393958,2023-07-28T17:13:32,Bilbao,Expense,leisure,-194.38,-453603.04
buyer_1,Luis,28,ES28209599118326557478,TRX_N-01869-38701613,2023-07-29T09:30:48,Bilbao,Expense,clothing,-290.08,-453893.12
buyer_1,Luis,28,ES28209599118326557478,TRX_N-01870-44266950,2023-07-29T19:25:15,Bilbao,Expense,healthcare,-437.69,-454330.81
buyer_1,Luis,28,ES28209599118326557478,TRX_N-01871-74607714,2023-07-29T11:51:05,Bilbao,Expense,savings,-276.14,-454606.95
buyer_1,Luis,28,ES28209599118326557478,TRX_N-01872-44534547,2023-07-30T23:44:37,Bilbao,Expense,car,-224.95,-454831.9
buyer_1,Luis,28,ES28209599118326557478,TRX_N-01873-72574473,2023-07-30T17:39:02,Bilbao,Expense,clothing,-285.29,-455117.19
buyer_1,Luis,28,ES28209599118326557478,TRX_N-01874-06624146,2023-07-30T09:33:44,Barakaldo,Expense,education,-103.24,-455220.43
buyer_1,Luis,28,ES28209599118326557478,TRX_N-01875-90447481,2023-07-31T20:03:16,Llodio,Expense,education,-421.89,-455642.32
buyer_1,Luis,28,ES28209599118326557478,TRX_N-01876-19266439,2023-07-31T12:55:37,Bilbao,Expense,food,-50.01,-455692.33
buyer_1,Luis,28,ES28209599118326557478,TRX_N-01877-06787707,2023-07-31T15:32:56,Bilbao,Expense,basic-services,-172.55,-455864.88
buyer_1,Luis,28,ES28209599118326557478,TRX_N-01878-00699507,2023-08-01T22:28:51,Bilbao,incomes,salary,1265.98,-454598.9
buyer_1,Luis,28,ES28209599118326557478,TRX_N-01879-92727870,2023-08-01T22:28:51,Bilbao,incomes,extra_income,126.6,-454472.3
buyer_1,Luis,28,ES28209599118326557478,TRX_N-01880-72658714,2023-08-01T17:16:42,Bilbao,Expense,car,-189.39,-454661.69
buyer_1,Luis,28,ES28209599118326557478,TRX_N-01881-34331665,2023-08-01T00:22:25,Bilbao,Expense,basic-services,-23.5,-454685.19
buyer_1,Luis,28,ES28209599118326557478,TRX_N-01882-40052385,2023-08-01T10:19:29,Hernani,Expense,leisure,-484.64,-455169.83
buyer_1,Luis,28,ES28209599118326557478,TRX_N-01883-10726453,2023-08-02T14:43:56,Bilbao,Expense,leisure,-222.48,-455392.31
buyer_1,Luis,28,ES28209599118326557478,TRX_N-01884-34012495,2023-08-02T16:02:15,Bilbao,Expense,basic-services,-36.86,-455429.17
buyer_1,Luis,28,ES28209599118326557478,TRX_N-01885-54672209,2023-08-02T08:54:20,Bilbao,Expense,clothing,-157.37,-455586.54
buyer_1,Luis,28,ES28209599118326557478,TRX_N-01886-10982887,2023-08-03T19:17:29,Bilbao,Expense,food,-58.44,-455644.98
buyer_1,Luis,28,ES28209599118326557478,TRX_N-01887-16164012,2023-08-03T11:06:52,Barakaldo,Expense,technology,-87.58,-455732.56
buyer_1,Luis,28,ES28209599118326557478,TRX_N-01888-77381540,2023-08-03T19:58:06,Bilbao,Expense,transport,-72.53,-455805.09
buyer_1,Luis,28,ES28209599118326557478,TRX_N-01889-29087310,2023-08-04T16:02:11,Bilbao,Housing,Rent,-1369.49,-457174.58
buyer_1,Luis,28,ES28209599118326557478,TRX_N-01890-68955400,2023-08-04T14:27:57,Bilbao,Expense,housing,-301.52,-457476.1
buyer_1,Luis,28,ES28209599118326557478,TRX_N-01891-12871347,2023-08-04T14:15:46,Bilbao,Expense,basic-services,-52.81,-457528.91
buyer_1,Luis,28,ES28209599118326557478,TRX_N-01892-13926025,2023-08-04T14:33:11,Bilbao,Expense,clothing,-390.86,-457919.77
buyer_1,Luis,28,ES28209599118326557478,TRX_N-01893-93414122,2023-08-05T23:25:23,Bilbao,basic_services,gas,-20.39,-457940.16
buyer_1,Luis,28,ES28209599118326557478,TRX_N-01894-32388256,2023-08-05T13:11:17,Bilbao,basic_services,internet,-57.79,-457997.95
buyer_1,Luis,28,ES28209599118326557478,TRX_N-01895-02306094,2023-08-05T19:07:48,Bilbao,basic_services,phone,-50.84,-458048.79
buyer_1,Luis,28,ES28209599118326557478,TRX_N-01896-11827030,2023-08-05T11:53:59,Bilbao,Expense,children,-420.91,-458469.7
buyer_1,Luis,28,ES28209599118326557478,TRX_N-01897-51016342,2023-08-05T11:58:41,Bilbao,Expense,subscriptions,-55.81,-458525.51
buyer_1,Luis,28,ES28209599118326557478,TRX_N-01898-21612460,2023-08-05T13:21:24,Bilbao,Expense,savings,-294.1,-458819.61
buyer_1,Luis,28,ES28209599118326557478,TRX_N-01899-00944022,2023-08-06T09:06:07,Bilbao,Expense,basic-services,-465.84,-459285.45
buyer_1,Luis,28,ES28209599118326557478,TRX_N-01900-37368357,2023-08-06T21:37:04,Bilbao,Expense,clothing,-484.61,-459770.06
buyer_1,Luis,28,ES28209599118326557478,TRX_N-01901-22194694,2023-08-06T20:38:49,Bilbao,Expense,car,-453.07,-460223.13
buyer_1,Luis,28,ES28209599118326557478,TRX_N-01902-76603401,2023-08-07T20:14:32,Bilbao,Expense,savings,-210.81,-460433.94
buyer_1,Luis,28,ES28209599118326557478,TRX_N-01903-03067560,2023-08-07T03:10:54,Bilbao,Expense,leisure,-263.89,-460697.83
buyer_1,Luis,28,ES28209599118326557478,TRX_N-01904-10134571,2023-08-07T08:36:05,Bilbao,Expense,education,-175.94,-460873.77
buyer_1,Luis,28,ES28209599118326557478,TRX_N-01905-26723565,2023-08-08T15:39:11,Bilbao,basic_services,water,-33.64,-460907.41
buyer_1,Luis,28,ES28209599118326557478,TRX_N-01906-32905663,2023-08-08T17:39:59,Bilbao,basic_services,electricity,-121.72,-461029.13
buyer_1,Luis,28,ES28209599118326557478,TRX_N-01907-62051871,2023-08-08T14:09:15,Bilbao,Expense,personal_care,-45.05,-461074.18
buyer_1,Luis,28,ES28209599118326557478,TRX_N-01908-43658953,2023-08-08T19:34:19,Bilbao,Expense,children,-435.27,-461509.45
buyer_1,Luis,28,ES28209599118326557478,TRX_N-01909-31600665,2023-08-08T14:03:20,Bilbao,Expense,food,-321.34,-461830.79
buyer_1,Luis,28,ES28209599118326557478,TRX_N-01910-34639012,2023-08-09T16:24:31,Donostia,Expense,basic-services,-361.86,-462192.65
buyer_1,Luis,28,ES28209599118326557478,TRX_N-01911-64211920,2023-08-09T18:02:00,Bilbao,Expense,healthcare,-180.63,-462373.28
buyer_1,Luis,28,ES28209599118326557478,TRX_N-01912-51365631,2023-08-09T02:14:13,Sestao,Expense,loans,-50.52,-462423.8
buyer_1,Luis,28,ES28209599118326557478,TRX_N-01913-93652455,2023-08-10T14:17:36,Bilbao,Expense,education,-475.7,-462899.5
buyer_1,Luis,28,ES28209599118326557478,TRX_N-01914-09099456,2023-08-10T13:31:33,Bilbao,Expense,technology,-296.66,-463196.16
buyer_1,Luis,28,ES28209599118326557478,TRX_N-01915-97336978,2023-08-10T13:06:36,Bilbao,Expense,basic-services,-287.91,-463484.07
buyer_1,Luis,28,ES28209599118326557478,TRX_N-01916-05920953,2023-08-11T12:08:59,Barakaldo,Expense,technology,-242.74,-463726.81
buyer_1,Luis,28,ES28209599118326557478,TRX_N-01917-01580792,2023-08-11T05:35:04,Pasaia,Expense,technology,-370.05,-464096.86
buyer_1,Luis,28,ES28209599118326557478,TRX_N-01918-81927177,2023-08-11T09:42:38,Bilbao,Expense,housing,-343.72,-464440.58
buyer_1,Luis,28,ES28209599118326557478,TRX_N-01919-36116329,2023-08-12T11:20:09,Bilbao,Expense,technology,-217.69,-464658.27
buyer_1,Luis,28,ES28209599118326557478,TRX_N-01920-17818078,2023-08-12T21:05:12,Bilbao,Expense,leisure,-186.51,-464844.78
buyer_1,Luis,28,ES28209599118326557478,TRX_N-01921-61440931,2023-08-12T11:08:06,Bilbao,Expense,savings,-297.89,-465142.67
buyer_1,Luis,28,ES28209599118326557478,TRX_N-01922-63739271,2023-08-13T15:31:16,Bilbao,Expense,children,-231.94,-465374.61
buyer_1,Luis,28,ES28209599118326557478,TRX_N-01923-06782312,2023-08-13T16:24:36,Zarautz,Expense,personal_care,-480.25,-465854.86
buyer_1,Luis,28,ES28209599118326557478,TRX_N-01924-34345294,2023-08-13T13:01:40,Bilbao,Expense,car,-34.96,-465889.82
buyer_1,Luis,28,ES28209599118326557478,TRX_N-01925-85053876,2023-08-14T20:11:25,Bilbao,Expense,healthcare,-24.93,-465914.75
buyer_1,Luis,28,ES28209599118326557478,TRX_N-01926-81975441,2023-08-14T16:03:43,Bilbao,Expense,personal_care,-93.36,-466008.11
buyer_1,Luis,28,ES28209599118326557478,TRX_N-01927-24838755,2023-08-14T08:30:37,Bilbao,Expense,transport,-126.16,-466134.27
buyer_1,Luis,28,ES28209599118326557478,TRX_N-01928-63280211,2023-08-15T17:07:18,Bilbao,Expense,transport,-86.19,-466220.46
buyer_1,Luis,28,ES28209599118326557478,TRX_N-01929-70754150,2023-08-15T01:24:42,Bilbao,Expense,car,-149.42,-466369.88
buyer_1,Luis,28,ES28209599118326557478,TRX_N-01930-49994920,2023-08-15T18:37:08,Bilbao,Expense,transport,-364.96,-466734.84
buyer_1,Luis,28,ES28209599118326557478,TRX_N-01931-78313391,2023-08-16T21:24:52,Portugalete,Expense,food,-206.65,-466941.49
buyer_1,Luis,28,ES28209599118326557478,TRX_N-01932-19072490,2023-08-16T11:21:04,Iruña de Oca,Expense,car,-463.26,-467404.75
buyer_1,Luis,28,ES28209599118326557478,TRX_N-01933-18235291,2023-08-16T14:45:25,Vitoria-Gasteiz,Expense,housing,-116.39,-467521.14
buyer_1,Luis,28,ES28209599118326557478,TRX_N-01934-34266386,2023-08-17T19:33:02,Errenteria,Expense,leisure,-298.85,-467819.99
buyer_1,Luis,28,ES28209599118326557478,TRX_N-01935-93113132,2023-08-17T16:24:56,Bilbao,Expense,housing,-471.68,-468291.67
buyer_1,Luis,28,ES28209599118326557478,TRX_N-01936-80484744,2023-08-17T11:32:19,Bilbao,Expense,clothing,-388.18,-468679.85
buyer_1,Luis,28,ES28209599118326557478,TRX_N-01937-27019326,2023-08-18T12:18:48,Bilbao,Expense,housing,-373.39,-469053.24
buyer_1,Luis,28,ES28209599118326557478,TRX_N-01938-04470194,2023-08-18T18:39:28,Bilbao,Expense,clothing,-93.75,-469146.99
buyer_1,Luis,28,ES28209599118326557478,TRX_N-01939-25941964,2023-08-18T17:39:22,Bilbao,Expense,education,-47.73,-469194.72
buyer_1,Luis,28,ES28209599118326557478,TRX_N-01940-40447091,2023-08-19T19:28:41,Bilbao,Expense,personal_care,-168.62,-469363.34
buyer_1,Luis,28,ES28209599118326557478,TRX_N-01941-04160198,2023-08-19T09:26:28,Basauri,Expense,basic-services,-176.34,-469539.68
buyer_1,Luis,28,ES28209599118326557478,TRX_N-01942-74413477,2023-08-19T13:28:36,Bilbao,Expense,transport,-315.02,-469854.7
buyer_1,Luis,28,ES28209599118326557478,TRX_N-01943-82261627,2023-08-20T20:20:43,Bilbao,Expense,basic-services,-20.82,-469875.52
buyer_1,Luis,28,ES28209599118326557478,TRX_N-01944-46525724,2023-08-20T17:40:02,Bilbao,Expense,healthcare,-83.37,-469958.89
buyer_1,Luis,28,ES28209599118326557478,TRX_N-01945-45607184,2023-08-20T10:56:00,Bilbao,Expense,children,-75.55,-470034.44
buyer_1,Luis,28,ES28209599118326557478,TRX_N-01946-37114098,2023-08-21T15:41:30,Bilbao,Expense,children,-485.03,-470519.47
buyer_1,Luis,28,ES28209599118326557478,TRX_N-01947-90687756,2023-08-21T07:01:15,Bilbao,Expense,housing,-103.31,-470622.78
buyer_1,Luis,28,ES28209599118326557478,TRX_N-01948-93801874,2023-08-21T23:30:34,Bilbao,Expense,car,-337.41,-470960.19
buyer_1,Luis,28,ES28209599118326557478,TRX_N-01949-54320776,2023-08-22T20:27:18,Bilbao,Expense,children,-374.09,-471334.28
buyer_1,Luis,28,ES28209599118326557478,TRX_N-01950-02144146,2023-08-22T23:03:52,Bilbao,Expense,technology,-40.74,-471375.02
buyer_1,Luis,28,ES28209599118326557478,TRX_N-01951-68599019,2023-08-22T18:18:43,Bilbao,Expense,leisure,-292.12,-471667.14
buyer_1,Luis,28,ES28209599118326557478,TRX_N-01952-14638404,2023-08-23T18:13:32,Bilbao,Expense,leisure,-280.04,-471947.18
buyer_1,Luis,28,ES28209599118326557478,TRX_N-01953-95576788,2023-08-23T13:17:26,Bilbao,Expense,leisure,-53.31,-472000.49
buyer_1,Luis,28,ES28209599118326557478,TRX_N-01954-48288219,2023-08-23T12:44:32,Arrasate,Expense,children,-390.34,-472390.83
buyer_1,Luis,28,ES28209599118326557478,TRX_N-01955-77906638,2023-08-24T14:28:30,Bilbao,Expense,technology,-315.05,-472705.88
buyer_1,Luis,28,ES28209599118326557478,TRX_N-01956-06557845,2023-08-24T14:36:02,Bilbao,Expense,education,-287.69,-472993.57
buyer_1,Luis,28,ES28209599118326557478,TRX_N-01957-05646748,2023-08-24T20:27:15,Bilbao,Expense,clothing,-34.27,-473027.84
buyer_1,Luis,28,ES28209599118326557478,TRX_N-01958-64697248,2023-08-25T08:05:27,Bilbao,Expense,technology,-446.71,-473474.55
buyer_1,Luis,28,ES28209599118326557478,TRX_N-01959-72083916,2023-08-25T14:02:47,Bilbao,Expense,technology,-202.99,-473677.54
buyer_1,Luis,28,ES28209599118326557478,TRX_N-01960-26783891,2023-08-25T05:47:50,Bilbao,Expense,subscriptions,-81.45,-473758.99
buyer_1,Luis,28,ES28209599118326557478,TRX_N-01961-02300303,2023-08-26T11:25:59,Bilbao,Expense,personal_care,-360.05,-474119.04
buyer_1,Luis,28,ES28209599118326557478,TRX_N-01962-42475019,2023-08-26T09:01:25,Bilbao,Expense,housing,-485.04,-474604.08
buyer_1,Luis,28,ES28209599118326557478,TRX_N-01963-71195224,2023-08-26T20:54:54,Bilbao,Expense,technology,-202.68,-474806.76
buyer_1,Luis,28,ES28209599118326557478,TRX_N-01964-47402332,2023-08-27T23:20:07,Bilbao,Expense,savings,-74.21,-474880.97
buyer_1,Luis,28,ES28209599118326557478,TRX_N-01965-45884701,2023-08-27T20:02:13,Bilbao,Expense,education,-161.53,-475042.5
buyer_1,Luis,28,ES28209599118326557478,TRX_N-01966-01669563,2023-08-27T16:46:03,Bilbao,Expense,technology,-461.76,-475504.26
buyer_1,Luis,28,ES28209599118326557478,TRX_N-01967-85690533,2023-08-28T20:16:14,Bilbao,Expense,children,-360.2,-475864.46
buyer_1,Luis,28,ES28209599118326557478,TRX_N-01968-49762732,2023-08-28T14:14:50,Bilbao,Expense,food,-346.49,-476210.95
buyer_1,Luis,28,ES28209599118326557478,TRX_N-01969-61113892,2023-08-28T18:01:14,Santurtzi,Expense,healthcare,-100.11,-476311.06
buyer_1,Luis,28,ES28209599118326557478,TRX_N-01970-32352012,2023-08-29T20:38:08,Bilbao,Expense,loans,-250.3,-476561.36
buyer_1,Luis,28,ES28209599118326557478,TRX_N-01971-78409514,2023-08-29T13:36:21,Salvatierra/Agurain,Expense,leisure,-46.99,-476608.35
buyer_1,Luis,28,ES28209599118326557478,TRX_N-01972-86209388,2023-08-29T00:40:07,Bilbao,Expense,transport,-37.26,-476645.61
buyer_1,Luis,28,ES28209599118326557478,TRX_N-01973-42727073,2023-08-30T08:23:41,Basauri,Expense,car,-364.78,-477010.39
buyer_1,Luis,28,ES28209599118326557478,TRX_N-01974-00226462,2023-08-30T23:43:22,Bilbao,Expense,personal_care,-303.33,-477313.72
buyer_1,Luis,28,ES28209599118326557478,TRX_N-01975-48877331,2023-08-30T13:59:32,Bilbao,Expense,healthcare,-254.61,-477568.33
buyer_1,Luis,28,ES28209599118326557478,TRX_N-01976-18328361,2023-08-31T22:50:13,Bilbao,Expense,savings,-445.08,-478013.41
buyer_1,Luis,28,ES28209599118326557478,TRX_N-01977-97067639,2023-08-31T10:11:25,Bilbao,Expense,housing,-383.74,-478397.15
buyer_1,Luis,28,ES28209599118326557478,TRX_N-01978-32008608,2023-08-31T14:30:26,Bilbao,Expense,transport,-47.53,-478444.68
buyer_1,Luis,28,ES28209599118326557478,TRX_N-01979-50964264,2023-09-01T06:16:41,Bilbao,incomes,salary,1265.98,-477178.7
buyer_1,Luis,28,ES28209599118326557478,TRX_N-01980-00547797,2023-09-01T11:20:57,Sopela,Expense,car,-437.02,-477615.72
buyer_1,Luis,28,ES28209599118326557478,TRX_N-01981-61784834,2023-09-01T13:12:54,Bilbao,Expense,food,-398.49,-478014.21
buyer_1,Luis,28,ES28209599118326557478,TRX_N-01982-69157562,2023-09-01T18:10:31,Bilbao,Expense,healthcare,-445.45,-478459.66
buyer_1,Luis,28,ES28209599118326557478,TRX_N-01983-95051682,2023-09-02T16:43:06,Bilbao,Expense,savings,-16.09,-478475.75
buyer_1,Luis,28,ES28209599118326557478,TRX_N-01984-71444282,2023-09-02T23:50:04,Bilbao,Expense,loans,-339.07,-478814.82
buyer_1,Luis,28,ES28209599118326557478,TRX_N-01985-37455080,2023-09-02T09:07:36,Bilbao,Expense,children,-210.11,-479024.93
buyer_1,Luis,28,ES28209599118326557478,TRX_N-01986-52505744,2023-09-03T04:44:10,Bilbao,Expense,personal_care,-460.72,-479485.65
buyer_1,Luis,28,ES28209599118326557478,TRX_N-01987-92356830,2023-09-03T15:58:16,Bilbao,Expense,leisure,-342.0,-479827.65
buyer_1,Luis,28,ES28209599118326557478,TRX_N-01988-41619424,2023-09-03T17:46:48,Bermeo,Expense,personal_care,-336.28,-480163.93
buyer_1,Luis,28,ES28209599118326557478,TRX_N-01989-61124970,2023-09-04T11:30:55,Bilbao,Housing,Rent,-1369.49,-481533.42
buyer_1,Luis,28,ES28209599118326557478,TRX_N-01990-31190149,2023-09-04T20:22:09,Santurtzi,Expense,children,-32.02,-481565.44
buyer_1,Luis,28,ES28209599118326557478,TRX_N-01991-26467460,2023-09-04T13:12:12,Bilbao,Expense,leisure,-429.54,-481994.98
buyer_1,Luis,28,ES28209599118326557478,TRX_N-01992-66875838,2023-09-04T14:08:41,Bilbao,Expense,leisure,-159.77,-482154.75
buyer_1,Luis,28,ES28209599118326557478,TRX_N-01993-97047197,2023-09-05T06:33:23,Bilbao,basic_services,phone,-67.62,-482222.37
buyer_1,Luis,28,ES28209599118326557478,TRX_N-01994-15464682,2023-09-05T17:13:27,Bilbao,Expense,education,-185.89,-482408.26
buyer_1,Luis,28,ES28209599118326557478,TRX_N-01995-20018797,2023-09-05T19:01:08,Bilbao,Expense,car,-331.15,-482739.41
buyer_1,Luis,28,ES28209599118326557478,TRX_N-01996-32744798,2023-09-05T19:23:34,Andoain,Expense,personal_care,-41.21,-482780.62
buyer_1,Luis,28,ES28209599118326557478,TRX_N-01997-05214335,2023-09-06T12:57:54,Bilbao,basic_services,electricity,-25.51,-482806.13
buyer_1,Luis,28,ES28209599118326557478,TRX_N-01998-12272645,2023-09-06T11:10:53,Bilbao,basic_services,gas,-29.53,-482835.66
buyer_1,Luis,28,ES28209599118326557478,TRX_N-01999-86189362,2023-09-06T11:18:29,Zuia,Expense,food,-386.15,-483221.81
buyer_1,Luis,28,ES28209599118326557478,TRX_N-02000-54072787,2023-09-06T21:59:55,Bilbao,Expense,clothing,-364.89,-483586.7
buyer_1,Luis,28,ES28209599118326557478,TRX_N-02001-11740180,2023-09-06T08:32:26,Bilbao,Expense,basic-services,-488.22,-484074.92
buyer_1,Luis,28,ES28209599118326557478,TRX_N-02002-59558324,2023-09-07T20:48:27,Bilbao,Expense,food,-57.39,-484132.31
buyer_1,Luis,28,ES28209599118326557478,TRX_N-02003-38368183,2023-09-07T22:06:23,Bilbao,Expense,loans,-344.62,-484476.93
buyer_1,Luis,28,ES28209599118326557478,TRX_N-02004-97160367,2023-09-07T14:11:36,Bilbao,Expense,transport,-364.67,-484841.6
buyer_1,Luis,28,ES28209599118326557478,TRX_N-02005-76127645,2023-09-08T10:17:36,Bilbao,basic_services,water,-47.17,-484888.77
buyer_1,Luis,28,ES28209599118326557478,TRX_N-02006-81163412,2023-09-08T12:41:51,Bilbao,basic_services,internet,-61.49,-484950.26
buyer_1,Luis,28,ES28209599118326557478,TRX_N-02007-33414882,2023-09-08T13:29:35,Bilbao,Expense,savings,-351.44,-485301.7
buyer_1,Luis,28,ES28209599118326557478,TRX_N-02008-75766847,2023-09-08T18:49:04,Bilbao,Expense,food,-397.83,-485699.53
buyer_1,Luis,28,ES28209599118326557478,TRX_N-02009-40089518,2023-09-08T17:16:36,Bilbao,Expense,transport,-142.02,-485841.55
buyer_1,Luis,28,ES28209599118326557478,TRX_N-02010-89905967,2023-09-09T11:27:38,Bilbao,Expense,personal_care,-386.82,-486228.37
buyer_1,Luis,28,ES28209599118326557478,TRX_N-02011-27409070,2023-09-09T14:30:57,Arrasate,Expense,housing,-301.67,-486530.04
buyer_1,Luis,28,ES28209599118326557478,TRX_N-02012-17923820,2023-09-09T14:15:44,Bilbao,Expense,housing,-322.48,-486852.52
buyer_1,Luis,28,ES28209599118326557478,TRX_N-02013-63994943,2023-09-10T23:20:04,Bilbao,Expense,personal_care,-91.82,-486944.34
buyer_1,Luis,28,ES28209599118326557478,TRX_N-02014-76268199,2023-09-10T16:02:33,Salvatierra/Agurain,Expense,loans,-435.76,-487380.1
buyer_1,Luis,28,ES28209599118326557478,TRX_N-02015-91400474,2023-09-10T20:17:12,Bilbao,Expense,housing,-96.21,-487476.31
buyer_1,Luis,28,ES28209599118326557478,TRX_N-02016-67701196,2023-09-11T19:31:19,Durango,Expense,car,-320.93,-487797.24
buyer_1,Luis,28,ES28209599118326557478,TRX_N-02017-99625244,2023-09-11T08:55:22,Bilbao,Expense,transport,-333.04,-488130.28
buyer_1,Luis,28,ES28209599118326557478,TRX_N-02018-09843006,2023-09-11T13:42:44,Bilbao,Expense,clothing,-267.97,-488398.25
buyer_1,Luis,28,ES28209599118326557478,TRX_N-02019-84776860,2023-09-12T10:43:10,Irun,Expense,car,-442.15,-488840.4
buyer_1,Luis,28,ES28209599118326557478,TRX_N-02020-61883873,2023-09-12T21:27:26,Bilbao,Expense,education,-321.32,-489161.72
buyer_1,Luis,28,ES28209599118326557478,TRX_N-02021-22542917,2023-09-12T23:08:29,Bilbao,Expense,subscriptions,-212.39,-489374.11
buyer_1,Luis,28,ES28209599118326557478,TRX_N-02022-92192815,2023-09-13T08:06:00,Bilbao,Expense,transport,-66.8,-489440.91
buyer_1,Luis,28,ES28209599118326557478,TRX_N-02023-68188406,2023-09-13T18:05:48,Bilbao,Expense,children,-128.69,-489569.6
buyer_1,Luis,28,ES28209599118326557478,TRX_N-02024-32197349,2023-09-13T16:51:31,Basauri,Expense,subscriptions,-50.33,-489619.93
buyer_1,Luis,28,ES28209599118326557478,TRX_N-02025-87532897,2023-09-14T20:14:33,Bilbao,Expense,clothing,-71.74,-489691.67
buyer_1,Luis,28,ES28209599118326557478,TRX_N-02026-55286381,2023-09-14T21:22:31,Bilbao,Expense,healthcare,-189.42,-489881.09
buyer_1,Luis,28,ES28209599118326557478,TRX_N-02027-76075997,2023-09-14T10:06:52,Bilbao,Expense,children,-206.37,-490087.46
buyer_1,Luis,28,ES28209599118326557478,TRX_N-02028-05266852,2023-09-15T12:29:27,Bilbao,Expense,basic-services,-263.42,-490350.88
buyer_1,Luis,28,ES28209599118326557478,TRX_N-02029-72054698,2023-09-15T10:35:10,Bilbao,Expense,technology,-484.68,-490835.56
buyer_1,Luis,28,ES28209599118326557478,TRX_N-02030-55204139,2023-09-15T10:58:35,Bilbao,Expense,leisure,-456.27,-491291.83
buyer_1,Luis,28,ES28209599118326557478,TRX_N-02031-28142571,2023-09-16T21:26:27,Bilbao,Expense,savings,-299.11,-491590.94
buyer_1,Luis,28,ES28209599118326557478,TRX_N-02032-60548745,2023-09-16T12:31:33,Erandio,Expense,savings,-336.51,-491927.45
buyer_1,Luis,28,ES28209599118326557478,TRX_N-02033-40047204,2023-09-16T08:31:02,Bilbao,Expense,children,-245.8,-492173.25
buyer_1,Luis,28,ES28209599118326557478,TRX_N-02034-04178424,2023-09-17T19:46:23,Pasaia,Expense,loans,-25.86,-492199.11
buyer_1,Luis,28,ES28209599118326557478,TRX_N-02035-07587163,2023-09-17T22:41:03,Sopela,Expense,subscriptions,-261.06,-492460.17
buyer_1,Luis,28,ES28209599118326557478,TRX_N-02036-58710722,2023-09-17T00:22:16,Bilbao,Expense,clothing,-355.57,-492815.74
buyer_1,Luis,28,ES28209599118326557478,TRX_N-02037-39444548,2023-09-18T19:10:53,Erandio,Expense,children,-367.38,-493183.12
buyer_1,Luis,28,ES28209599118326557478,TRX_N-02038-21130547,2023-09-18T12:53:01,Leioa,Expense,leisure,-478.73,-493661.85
buyer_1,Luis,28,ES28209599118326557478,TRX_N-02039-73842007,2023-09-18T09:26:19,Bilbao,Expense,basic-services,-253.89,-493915.74
buyer_1,Luis,28,ES28209599118326557478,TRX_N-02040-98330110,2023-09-19T20:12:04,Bilbao,Expense,housing,-11.48,-493927.22
buyer_1,Luis,28,ES28209599118326557478,TRX_N-02041-18155158,2023-09-19T13:52:21,Bilbao,Expense,leisure,-207.05,-494134.27
buyer_1,Luis,28,ES28209599118326557478,TRX_N-02042-63441869,2023-09-19T08:32:36,Bilbao,Expense,clothing,-104.52,-494238.79
buyer_1,Luis,28,ES28209599118326557478,TRX_N-02043-98857196,2023-09-20T21:45:07,Bilbao,Expense,transport,-482.92,-494721.71
buyer_1,Luis,28,ES28209599118326557478,TRX_N-02044-75969842,2023-09-20T09:28:20,Bilbao,Expense,clothing,-150.16,-494871.87
buyer_1,Luis,28,ES28209599118326557478,TRX_N-02045-35678715,2023-09-20T13:22:16,Bilbao,Expense,leisure,-225.86,-495097.73
buyer_1,Luis,28,ES28209599118326557478,TRX_N-02046-93795513,2023-09-21T13:00:58,Bilbao,Expense,food,-369.32,-495467.05
buyer_1,Luis,28,ES28209599118326557478,TRX_N-02047-94231758,2023-09-21T23:29:12,Bilbao,Expense,clothing,-46.4,-495513.45
buyer_1,Luis,28,ES28209599118326557478,TRX_N-02048-43299376,2023-09-21T16:50:29,Bilbao,Expense,subscriptions,-186.9,-495700.35
buyer_1,Luis,28,ES28209599118326557478,TRX_N-02049-62147162,2023-09-22T12:57:52,Bilbao,Expense,food,-129.3,-495829.65
buyer_1,Luis,28,ES28209599118326557478,TRX_N-02050-69355585,2023-09-22T17:54:34,Bilbao,Expense,savings,-16.41,-495846.06
buyer_1,Luis,28,ES28209599118326557478,TRX_N-02051-48071029,2023-09-22T11:41:59,Bilbao,Expense,technology,-84.6,-495930.66
buyer_1,Luis,28,ES28209599118326557478,TRX_N-02052-95759720,2023-09-23T18:08:34,Bilbao,Expense,car,-319.34,-496250.0
buyer_1,Luis,28,ES28209599118326557478,TRX_N-02053-42204959,2023-09-23T15:44:42,Iruña de Oca,Expense,basic-services,-253.11,-496503.11
buyer_1,Luis,28,ES28209599118326557478,TRX_N-02054-24104767,2023-09-23T13:53:55,Galdakao,Expense,leisure,-190.89,-496694.0
buyer_1,Luis,28,ES28209599118326557478,TRX_N-02055-25893752,2023-09-24T08:10:33,Bilbao,Expense,leisure,-362.24,-497056.24
buyer_1,Luis,28,ES28209599118326557478,TRX_N-02056-32437562,2023-09-24T09:08:30,Bilbao,Expense,children,-289.11,-497345.35
buyer_1,Luis,28,ES28209599118326557478,TRX_N-02057-56151898,2023-09-24T20:24:43,Oyón-Oion,Expense,food,-328.14,-497673.49
buyer_1,Luis,28,ES28209599118326557478,TRX_N-02058-77951718,2023-09-25T19:58:58,Bilbao,Expense,education,-151.55,-497825.04
buyer_1,Luis,28,ES28209599118326557478,TRX_N-02059-86628672,2023-09-25T14:05:27,Bilbao,Expense,subscriptions,-264.4,-498089.44
buyer_1,Luis,28,ES28209599118326557478,TRX_N-02060-52984408,2023-09-25T10:40:02,Iruña de Oca,Expense,loans,-226.12,-498315.56
buyer_1,Luis,28,ES28209599118326557478,TRX_N-02061-77950166,2023-09-26T20:10:23,Eibar,Expense,food,-178.28,-498493.84
buyer_1,Luis,28,ES28209599118326557478,TRX_N-02062-51983161,2023-09-26T13:35:21,Pasaia,Expense,basic-services,-441.8,-498935.64
buyer_1,Luis,28,ES28209599118326557478,TRX_N-02063-06515166,2023-09-26T00:30:03,Bilbao,Expense,housing,-477.89,-499413.53
buyer_1,Luis,28,ES28209599118326557478,TRX_N-02064-54940158,2023-09-27T18:45:57,Bilbao,Expense,housing,-410.08,-499823.61
buyer_1,Luis,28,ES28209599118326557478,TRX_N-02065-22567165,2023-09-27T15:07:22,Bilbao,Expense,housing,-413.64,-500237.25
buyer_1,Luis,28,ES28209599118326557478,TRX_N-02066-10166483,2023-09-27T18:04:40,Bilbao,Expense,children,-339.85,-500577.1
buyer_1,Luis,28,ES28209599118326557478,TRX_N-02067-64279989,2023-09-28T08:55:20,Bilbao,Expense,savings,-496.59,-501073.69
buyer_1,Luis,28,ES28209599118326557478,TRX_N-02068-65784693,2023-09-28T19:24:56,Bilbao,Expense,subscriptions,-143.9,-501217.59
buyer_1,Luis,28,ES28209599118326557478,TRX_N-02069-74546830,2023-09-28T19:24:15,Bilbao,Expense,food,-59.16,-501276.75
buyer_1,Luis,28,ES28209599118326557478,TRX_N-02070-57263321,2023-09-29T12:26:02,Bilbao,Expense,subscriptions,-381.05,-501657.8
buyer_1,Luis,28,ES28209599118326557478,TRX_N-02071-06150332,2023-09-29T17:10:49,Oyón-Oion,Expense,clothing,-186.86,-501844.66
buyer_1,Luis,28,ES28209599118326557478,TRX_N-02072-41148391,2023-09-29T14:26:58,Bilbao,Expense,technology,-40.32,-501884.98
buyer_1,Luis,28,ES28209599118326557478,TRX_N-02073-61916603,2023-09-30T16:33:04,Bilbao,Expense,basic-services,-27.36,-501912.34
buyer_1,Luis,28,ES28209599118326557478,TRX_N-02074-97349839,2023-09-30T20:01:09,Iruña de Oca,Expense,education,-481.07,-502393.41
buyer_1,Luis,28,ES28209599118326557478,TRX_N-02075-02061611,2023-09-30T10:54:23,Bilbao,Expense,children,-312.26,-502705.67
buyer_1,Luis,28,ES28209599118326557478,TRX_N-02076-94216977,2023-10-01T12:02:55,Bilbao,incomes,salary,1265.98,-501439.69
buyer_1,Luis,28,ES28209599118326557478,TRX_N-02077-86909266,2023-10-01T19:46:27,Bilbao,Expense,children,-428.59,-501868.28
buyer_1,Luis,28,ES28209599118326557478,TRX_N-02078-37864394,2023-10-01T12:12:37,Bilbao,Expense,transport,-320.84,-502189.12
buyer_1,Luis,28,ES28209599118326557478,TRX_N-02079-63756963,2023-10-01T14:46:58,Bilbao,Expense,education,-15.51,-502204.63
buyer_1,Luis,28,ES28209599118326557478,TRX_N-02080-93849139,2023-10-02T14:25:29,Bilbao,Expense,personal_care,-214.09,-502418.72
buyer_1,Luis,28,ES28209599118326557478,TRX_N-02081-38771603,2023-10-02T21:33:35,Bilbao,Expense,clothing,-112.58,-502531.3
buyer_1,Luis,28,ES28209599118326557478,TRX_N-02082-72638545,2023-10-02T11:00:19,Bilbao,Expense,food,-176.67,-502707.97
buyer_1,Luis,28,ES28209599118326557478,TRX_N-02083-89052362,2023-10-03T16:00:16,Bilbao,Expense,technology,-426.87,-503134.84
buyer_1,Luis,28,ES28209599118326557478,TRX_N-02084-40347956,2023-10-03T11:13:25,Bilbao,Expense,food,-459.84,-503594.68
buyer_1,Luis,28,ES28209599118326557478,TRX_N-02085-25388759,2023-10-03T17:39:25,Bilbao,Expense,basic-services,-227.08,-503821.76
buyer_1,Luis,28,ES28209599118326557478,TRX_N-02086-11341479,2023-10-04T05:09:13,Bilbao,Housing,Rent,-1369.49,-505191.25
buyer_1,Luis,28,ES28209599118326557478,TRX_N-02087-33823598,2023-10-04T23:45:04,Bilbao,Expense,leisure,-43.03,-505234.28
buyer_1,Luis,28,ES28209599118326557478,TRX_N-02088-81047681,2023-10-04T16:41:58,Bilbao,Expense,subscriptions,-50.97,-505285.25
buyer_1,Luis,28,ES28209599118326557478,TRX_N-02089-36426255,2023-10-04T20:54:21,Bilbao,Expense,food,-181.24,-505466.49
buyer_1,Luis,28,ES28209599118326557478,TRX_N-02090-46540148,2023-10-05T20:23:28,Bilbao,basic_services,water,-14.89,-505481.38
buyer_1,Luis,28,ES28209599118326557478,TRX_N-02091-53518344,2023-10-05T16:40:20,Bilbao,Expense,children,-128.41,-505609.79
buyer_1,Luis,28,ES28209599118326557478,TRX_N-02092-75792079,2023-10-05T09:45:38,Bilbao,Expense,education,-63.98,-505673.77
buyer_1,Luis,28,ES28209599118326557478,TRX_N-02093-56306109,2023-10-05T12:03:01,Bilbao,Expense,car,-340.74,-506014.51
buyer_1,Luis,28,ES28209599118326557478,TRX_N-02094-80659209,2023-10-06T13:32:05,Bilbao,basic_services,internet,-42.22,-506056.73
buyer_1,Luis,28,ES28209599118326557478,TRX_N-02095-97426869,2023-10-06T14:11:04,Alegría-Dulantzi,Expense,basic-services,-163.53,-506220.26
buyer_1,Luis,28,ES28209599118326557478,TRX_N-02096-84763186,2023-10-06T20:19:41,Bilbao,Expense,savings,-404.09,-506624.35
buyer_1,Luis,28,ES28209599118326557478,TRX_N-02097-05936327,2023-10-06T16:09:24,Bilbao,Expense,healthcare,-155.17,-506779.52
buyer_1,Luis,28,ES28209599118326557478,TRX_N-02098-01484150,2023-10-07T17:50:15,Bilbao,basic_services,gas,-62.35,-506841.87
buyer_1,Luis,28,ES28209599118326557478,TRX_N-02099-43244050,2023-10-07T20:10:09,Bilbao,basic_services,phone,-63.44,-506905.31
buyer_1,Luis,28,ES28209599118326557478,TRX_N-02100-58128945,2023-10-07T09:16:49,Bilbao,Expense,education,-171.91,-507077.22
buyer_1,Luis,28,ES28209599118326557478,TRX_N-02101-67096603,2023-10-07T19:37:07,Bilbao,Expense,children,-232.36,-507309.58
buyer_1,Luis,28,ES28209599118326557478,TRX_N-02102-78634203,2023-10-07T13:56:58,Bilbao,Expense,children,-477.29,-507786.87
buyer_1,Luis,28,ES28209599118326557478,TRX_N-02103-16959146,2023-10-08T11:23:24,Bilbao,basic_services,electricity,-53.32,-507840.19
buyer_1,Luis,28,ES28209599118326557478,TRX_N-02104-89405914,2023-10-08T21:25:34,Bermeo,Expense,food,-494.55,-508334.74
buyer_1,Luis,28,ES28209599118326557478,TRX_N-02105-32771423,2023-10-08T19:53:42,Alegría-Dulantzi,Expense,clothing,-480.05,-508814.79
buyer_1,Luis,28,ES28209599118326557478,TRX_N-02106-21892980,2023-10-08T19:19:45,Bilbao,Expense,clothing,-476.2,-509290.99
buyer_1,Luis,28,ES28209599118326557478,TRX_N-02107-61419225,2023-10-09T17:13:28,Bilbao,Expense,car,-105.21,-509396.2
buyer_1,Luis,28,ES28209599118326557478,TRX_N-02108-62309292,2023-10-09T15:19:21,Bilbao,Expense,clothing,-470.72,-509866.92
buyer_1,Luis,28,ES28209599118326557478,TRX_N-02109-00085539,2023-10-09T05:15:59,Bilbao,Expense,housing,-364.14,-510231.06
buyer_1,Luis,28,ES28209599118326557478,TRX_N-02110-78639887,2023-10-10T11:20:58,Bilbao,Expense,leisure,-126.51,-510357.57
buyer_1,Luis,28,ES28209599118326557478,TRX_N-02111-02674456,2023-10-10T21:01:02,Irun,Expense,technology,-202.5,-510560.07
buyer_1,Luis,28,ES28209599118326557478,TRX_N-02112-59040256,2023-10-10T19:29:31,Bilbao,Expense,technology,-206.57,-510766.64
buyer_1,Luis,28,ES28209599118326557478,TRX_N-02113-66387044,2023-10-11T14:58:41,Bilbao,Expense,housing,-310.0,-511076.64
buyer_1,Luis,28,ES28209599118326557478,TRX_N-02114-78960707,2023-10-11T00:56:34,Bilbao,Expense,personal_care,-63.1,-511139.74
buyer_1,Luis,28,ES28209599118326557478,TRX_N-02115-58942832,2023-10-11T15:40:41,Bilbao,Expense,leisure,-202.47,-511342.21
buyer_1,Luis,28,ES28209599118326557478,TRX_N-02116-87057939,2023-10-12T07:04:25,Bilbao,Expense,healthcare,-81.31,-511423.52
buyer_1,Luis,28,ES28209599118326557478,TRX_N-02117-92221721,2023-10-12T09:57:59,Bilbao,Expense,education,-391.93,-511815.45
buyer_1,Luis,28,ES28209599118326557478,TRX_N-02118-66654127,2023-10-12T14:23:36,Bilbao,Expense,housing,-132.81,-511948.26
buyer_1,Luis,28,ES28209599118326557478,TRX_N-02119-64634047,2023-10-13T12:13:29,Bilbao,Expense,leisure,-61.21,-512009.47
buyer_1,Luis,28,ES28209599118326557478,TRX_N-02120-03386242,2023-10-13T06:32:43,Bilbao,Expense,basic-services,-201.08,-512210.55
buyer_1,Luis,28,ES28209599118326557478,TRX_N-02121-01261110,2023-10-13T16:40:25,Bilbao,Expense,savings,-247.01,-512457.56
buyer_1,Luis,28,ES28209599118326557478,TRX_N-02122-07415875,2023-10-14T11:29:47,Bilbao,Expense,education,-261.54,-512719.1
buyer_1,Luis,28,ES28209599118326557478,TRX_N-02123-73765822,2023-10-14T19:58:39,Bilbao,Expense,loans,-125.02,-512844.12
buyer_1,Luis,28,ES28209599118326557478,TRX_N-02124-50211026,2023-10-14T12:09:35,Bilbao,Expense,personal_care,-164.26,-513008.38
buyer_1,Luis,28,ES28209599118326557478,TRX_N-02125-37522756,2023-10-15T12:53:48,Galdakao,Expense,personal_care,-135.56,-513143.94
buyer_1,Luis,28,ES28209599118326557478,TRX_N-02126-82673154,2023-10-15T13:46:52,Bilbao,Expense,education,-276.73,-513420.67
buyer_1,Luis,28,ES28209599118326557478,TRX_N-02127-99631083,2023-10-15T11:49:21,Bilbao,Expense,education,-477.9,-513898.57
buyer_1,Luis,28,ES28209599118326557478,TRX_N-02128-27698720,2023-10-16T18:45:23,Bilbao,Expense,transport,-58.08,-513956.65
buyer_1,Luis,28,ES28209599118326557478,TRX_N-02129-34325472,2023-10-16T11:20:04,Oyón-Oion,Expense,food,-134.2,-514090.85
buyer_1,Luis,28,ES28209599118326557478,TRX_N-02130-48707444,2023-10-16T19:09:42,Bilbao,Expense,loans,-31.87,-514122.72
buyer_1,Luis,28,ES28209599118326557478,TRX_N-02131-64124549,2023-10-17T16:59:37,Bilbao,Expense,loans,-259.15,-514381.87
buyer_1,Luis,28,ES28209599118326557478,TRX_N-02132-56490863,2023-10-17T16:50:54,Bilbao,Expense,personal_care,-106.67,-514488.54
buyer_1,Luis,28,ES28209599118326557478,TRX_N-02133-00667263,2023-10-17T10:10:08,Irun,Expense,savings,-339.07,-514827.61
buyer_1,Luis,28,ES28209599118326557478,TRX_N-02134-61629539,2023-10-18T03:09:25,Bilbao,Expense,subscriptions,-151.88,-514979.49
buyer_1,Luis,28,ES28209599118326557478,TRX_N-02135-38763308,2023-10-18T19:47:13,Bilbao,Expense,loans,-499.91,-515479.4
buyer_1,Luis,28,ES28209599118326557478,TRX_N-02136-72216884,2023-10-18T17:04:09,Berango,Expense,savings,-42.45,-515521.85
buyer_1,Luis,28,ES28209599118326557478,TRX_N-02137-21268301,2023-10-19T18:38:01,Alegría-Dulantzi,Expense,subscriptions,-377.62,-515899.47
buyer_1,Luis,28,ES28209599118326557478,TRX_N-02138-41129219,2023-10-19T23:07:37,Bilbao,Expense,basic-services,-480.16,-516379.63
buyer_1,Luis,28,ES28209599118326557478,TRX_N-02139-49597104,2023-10-19T17:08:07,Bilbao,Expense,basic-services,-58.42,-516438.05
buyer_1,Luis,28,ES28209599118326557478,TRX_N-02140-12830045,2023-10-20T12:54:44,Bilbao,Expense,car,-342.58,-516780.63
buyer_1,Luis,28,ES28209599118326557478,TRX_N-02141-99174155,2023-10-20T12:16:14,Mungia,Expense,education,-133.08,-516913.71
buyer_1,Luis,28,ES28209599118326557478,TRX_N-02142-81881581,2023-10-20T09:09:16,Bilbao,Expense,technology,-125.34,-517039.05
buyer_1,Luis,28,ES28209599118326557478,TRX_N-02143-33275795,2023-10-21T18:29:16,Bilbao,Expense,savings,-370.87,-517409.92
buyer_1,Luis,28,ES28209599118326557478,TRX_N-02144-64401155,2023-10-21T18:25:06,Bilbao,Expense,car,-164.91,-517574.83
buyer_1,Luis,28,ES28209599118326557478,TRX_N-02145-22424120,2023-10-21T19:42:52,Bilbao,Expense,food,-63.1,-517637.93
buyer_1,Luis,28,ES28209599118326557478,TRX_N-02146-45762612,2023-10-22T12:20:24,Bilbao,Expense,personal_care,-285.88,-517923.81
buyer_1,Luis,28,ES28209599118326557478,TRX_N-02147-92568987,2023-10-22T16:45:36,Bilbao,Expense,savings,-208.44,-518132.25
buyer_1,Luis,28,ES28209599118326557478,TRX_N-02148-34538441,2023-10-22T13:19:18,Arrasate,Expense,car,-182.22,-518314.47
buyer_1,Luis,28,ES28209599118326557478,TRX_N-02149-44575643,2023-10-23T17:35:57,Mungia,Expense,basic-services,-190.01,-518504.48
buyer_1,Luis,28,ES28209599118326557478,TRX_N-02150-31614131,2023-10-23T08:45:41,Bilbao,Expense,food,-142.11,-518646.59
buyer_1,Luis,28,ES28209599118326557478,TRX_N-02151-28848767,2023-10-23T13:26:13,Iruña de Oca,Expense,technology,-320.83,-518967.42
buyer_1,Luis,28,ES28209599118326557478,TRX_N-02152-07398144,2023-10-24T05:18:57,Bilbao,Expense,personal_care,-27.04,-518994.46
buyer_1,Luis,28,ES28209599118326557478,TRX_N-02153-15327713,2023-10-24T12:55:01,Bilbao,Expense,children,-286.07,-519280.53
buyer_1,Luis,28,ES28209599118326557478,TRX_N-02154-79213787,2023-10-24T09:09:08,Bilbao,Expense,clothing,-89.21,-519369.74
buyer_1,Luis,28,ES28209599118326557478,TRX_N-02155-95799866,2023-10-25T14:43:12,Bilbao,Expense,personal_care,-265.25,-519634.99
buyer_1,Luis,28,ES28209599118326557478,TRX_N-02156-31845474,2023-10-25T08:58:15,Bilbao,Expense,subscriptions,-149.44,-519784.43
buyer_1,Luis,28,ES28209599118326557478,TRX_N-02157-81836183,2023-10-25T19:34:36,Bilbao,Expense,clothing,-356.16,-520140.59
buyer_1,Luis,28,ES28209599118326557478,TRX_N-02158-61901789,2023-10-26T20:12:58,Bilbao,Expense,food,-491.1,-520631.69
buyer_1,Luis,28,ES28209599118326557478,TRX_N-02159-98267871,2023-10-26T16:44:43,Bilbao,Expense,transport,-318.58,-520950.27
buyer_1,Luis,28,ES28209599118326557478,TRX_N-02160-35544497,2023-10-26T23:10:01,Bilbao,Expense,children,-85.48,-521035.75
buyer_1,Luis,28,ES28209599118326557478,TRX_N-02161-82407520,2023-10-27T17:51:46,Bilbao,Expense,children,-382.28,-521418.03
buyer_1,Luis,28,ES28209599118326557478,TRX_N-02162-96879020,2023-10-27T10:24:12,Bilbao,Expense,car,-61.41,-521479.44
buyer_1,Luis,28,ES28209599118326557478,TRX_N-02163-77574023,2023-10-27T16:04:28,Bilbao,Expense,basic-services,-416.17,-521895.61
buyer_1,Luis,28,ES28209599118326557478,TRX_N-02164-58763566,2023-10-28T16:57:59,Bilbao,Expense,food,-93.2,-521988.81
buyer_1,Luis,28,ES28209599118326557478,TRX_N-02165-97480185,2023-10-28T15:42:38,Bilbao,Expense,transport,-391.32,-522380.13
buyer_1,Luis,28,ES28209599118326557478,TRX_N-02166-65976444,2023-10-28T14:01:29,Bilbao,Expense,technology,-29.46,-522409.59
buyer_1,Luis,28,ES28209599118326557478,TRX_N-02167-01631454,2023-10-29T20:33:48,Sopela,Expense,healthcare,-157.65,-522567.24
buyer_1,Luis,28,ES28209599118326557478,TRX_N-02168-11435754,2023-10-29T18:47:54,Bilbao,Expense,basic-services,-340.8,-522908.04
buyer_1,Luis,28,ES28209599118326557478,TRX_N-02169-00259103,2023-10-29T22:14:29,Irun,Expense,education,-461.79,-523369.83
buyer_1,Luis,28,ES28209599118326557478,TRX_N-02170-73370869,2023-10-30T15:33:47,Bilbao,Expense,subscriptions,-282.69,-523652.52
buyer_1,Luis,28,ES28209599118326557478,TRX_N-02171-11625708,2023-10-30T08:08:08,Bilbao,Expense,clothing,-361.03,-524013.55
buyer_1,Luis,28,ES28209599118326557478,TRX_N-02172-78251109,2023-10-30T22:31:34,Bilbao,Expense,basic-services,-60.5,-524074.05
buyer_1,Luis,28,ES28209599118326557478,TRX_N-02173-60813610,2023-10-31T14:20:34,Bilbao,Expense,basic-services,-483.72,-524557.77
buyer_1,Luis,28,ES28209599118326557478,TRX_N-02174-08375644,2023-10-31T23:24:23,Bilbao,Expense,housing,-221.67,-524779.44
buyer_1,Luis,28,ES28209599118326557478,TRX_N-02175-83331296,2023-10-31T22:43:41,Salvatierra/Agurain,Expense,subscriptions,-373.55,-525152.99
buyer_1,Luis,28,ES28209599118326557478,TRX_N-02176-48706684,2023-11-01T09:43:59,Bilbao,incomes,salary,1265.98,-523887.01
buyer_1,Luis,28,ES28209599118326557478,TRX_N-02177-43089675,2023-11-01T09:43:59,Bilbao,incomes,extra_income,126.6,-523760.41
buyer_1,Luis,28,ES28209599118326557478,TRX_N-02178-05496026,2023-11-01T13:28:44,Bilbao,Expense,food,-333.16,-524093.57
buyer_1,Luis,28,ES28209599118326557478,TRX_N-02179-36594053,2023-11-01T16:03:33,Bilbao,Expense,savings,-145.72,-524239.29
buyer_1,Luis,28,ES28209599118326557478,TRX_N-02180-72426884,2023-11-01T20:47:03,Bilbao,Expense,children,-95.06,-524334.35
buyer_1,Luis,28,ES28209599118326557478,TRX_N-02181-08340608,2023-11-02T17:34:57,Bilbao,Expense,technology,-22.66,-524357.01
buyer_1,Luis,28,ES28209599118326557478,TRX_N-02182-89708820,2023-11-02T15:37:17,Bilbao,Expense,subscriptions,-126.48,-524483.49
buyer_1,Luis,28,ES28209599118326557478,TRX_N-02183-45057206,2023-11-02T15:07:06,Leioa,Expense,children,-325.93,-524809.42
buyer_1,Luis,28,ES28209599118326557478,TRX_N-02184-68902803,2023-11-03T20:09:41,Bilbao,Expense,car,-196.22,-525005.64
buyer_1,Luis,28,ES28209599118326557478,TRX_N-02185-61703326,2023-11-03T14:50:56,Bilbao,Expense,personal_care,-23.55,-525029.19
buyer_1,Luis,28,ES28209599118326557478,TRX_N-02186-27709499,2023-11-03T17:40:31,Bilbao,Expense,housing,-307.42,-525336.61
buyer_1,Luis,28,ES28209599118326557478,TRX_N-02187-13626665,2023-11-04T12:09:26,Bilbao,Housing,Rent,-1369.49,-526706.1
buyer_1,Luis,28,ES28209599118326557478,TRX_N-02188-13377949,2023-11-04T23:05:24,Bilbao,Expense,leisure,-130.8,-526836.9
buyer_1,Luis,28,ES28209599118326557478,TRX_N-02189-04946210,2023-11-04T17:11:11,Bilbao,Expense,healthcare,-430.51,-527267.41
buyer_1,Luis,28,ES28209599118326557478,TRX_N-02190-46984677,2023-11-04T11:59:27,Errenteria,Expense,savings,-25.7,-527293.11
buyer_1,Luis,28,ES28209599118326557478,TRX_N-02191-42296122,2023-11-05T11:57:19,Bilbao,basic_services,internet,-77.41,-527370.52
buyer_1,Luis,28,ES28209599118326557478,TRX_N-02192-26730746,2023-11-05T11:15:50,Bilbao,basic_services,phone,-62.18,-527432.7
buyer_1,Luis,28,ES28209599118326557478,TRX_N-02193-73863913,2023-11-05T13:58:21,Andoain,Expense,technology,-78.0,-527510.7
buyer_1,Luis,28,ES28209599118326557478,TRX_N-02194-86997973,2023-11-05T20:09:18,Bilbao,Expense,loans,-395.99,-527906.69
buyer_1,Luis,28,ES28209599118326557478,TRX_N-02195-76866937,2023-11-05T10:52:03,Amurrio,Expense,loans,-86.92,-527993.61
buyer_1,Luis,28,ES28209599118326557478,TRX_N-02196-23089741,2023-11-06T14:41:38,Bilbao,basic_services,electricity,-124.53,-528118.14
buyer_1,Luis,28,ES28209599118326557478,TRX_N-02197-46055274,2023-11-06T17:55:57,Bilbao,basic_services,gas,-23.35,-528141.49
buyer_1,Luis,28,ES28209599118326557478,TRX_N-02198-69174926,2023-11-06T04:37:36,Bilbao,Expense,loans,-92.24,-528233.73
buyer_1,Luis,28,ES28209599118326557478,TRX_N-02199-46781729,2023-11-06T20:59:32,Bilbao,Expense,education,-327.45,-528561.18
buyer_1,Luis,28,ES28209599118326557478,TRX_N-02200-22428226,2023-11-06T17:49:28,Bilbao,Expense,clothing,-52.85,-528614.03
buyer_1,Luis,28,ES28209599118326557478,TRX_N-02201-92493065,2023-11-07T20:03:13,Bilbao,Expense,food,-329.97,-528944.0
buyer_1,Luis,28,ES28209599118326557478,TRX_N-02202-95941198,2023-11-07T15:21:02,Bilbao,Expense,children,-453.03,-529397.03
buyer_1,Luis,28,ES28209599118326557478,TRX_N-02203-59540730,2023-11-07T17:09:12,Bilbao,Expense,savings,-251.33,-529648.36
buyer_1,Luis,28,ES28209599118326557478,TRX_N-02204-03305223,2023-11-08T10:15:38,Bilbao,basic_services,water,-58.97,-529707.33
buyer_1,Luis,28,ES28209599118326557478,TRX_N-02205-44781299,2023-11-08T13:51:27,Bilbao,Expense,healthcare,-12.01,-529719.34
buyer_1,Luis,28,ES28209599118326557478,TRX_N-02206-63060332,2023-11-08T19:27:22,Bilbao,Expense,housing,-192.16,-529911.5
buyer_1,Luis,28,ES28209599118326557478,TRX_N-02207-55815515,2023-11-08T10:52:58,Bilbao,Expense,housing,-331.41,-530242.91
buyer_1,Luis,28,ES28209599118326557478,TRX_N-02208-18349280,2023-11-09T20:32:23,Bilbao,Expense,education,-129.27,-530372.18
buyer_1,Luis,28,ES28209599118326557478,TRX_N-02209-41869520,2023-11-09T10:57:40,Bilbao,Expense,loans,-334.38,-530706.56
buyer_1,Luis,28,ES28209599118326557478,TRX_N-02210-27421259,2023-11-09T12:51:00,Alegría-Dulantzi,Expense,subscriptions,-134.24,-530840.8
buyer_1,Luis,28,ES28209599118326557478,TRX_N-02211-05077744,2023-11-10T05:52:37,Durango,Expense,children,-464.02,-531304.82
buyer_1,Luis,28,ES28209599118326557478,TRX_N-02212-81872067,2023-11-10T13:04:57,Bilbao,Expense,technology,-378.84,-531683.66
buyer_1,Luis,28,ES28209599118326557478,TRX_N-02213-04599675,2023-11-10T22:34:06,Bilbao,Expense,technology,-446.75,-532130.41
buyer_1,Luis,28,ES28209599118326557478,TRX_N-02214-31101229,2023-11-11T17:34:48,Bilbao,Expense,subscriptions,-419.85,-532550.26
buyer_1,Luis,28,ES28209599118326557478,TRX_N-02215-94420038,2023-11-11T17:04:55,Bilbao,Expense,loans,-149.49,-532699.75
buyer_1,Luis,28,ES28209599118326557478,TRX_N-02216-35320098,2023-11-11T18:55:02,Bilbao,Expense,education,-65.89,-532765.64
buyer_1,Luis,28,ES28209599118326557478,TRX_N-02217-84901029,2023-11-12T08:34:02,Bilbao,Expense,children,-284.83,-533050.47
buyer_1,Luis,28,ES28209599118326557478,TRX_N-02218-98244133,2023-11-12T18:55:02,Bilbao,Expense,housing,-126.82,-533177.29
buyer_1,Luis,28,ES28209599118326557478,TRX_N-02219-50358477,2023-11-12T19:14:09,Bilbao,Expense,personal_care,-451.4,-533628.69
buyer_1,Luis,28,ES28209599118326557478,TRX_N-02220-69902945,2023-11-13T23:30:12,Bilbao,Expense,healthcare,-26.19,-533654.88
buyer_1,Luis,28,ES28209599118326557478,TRX_N-02221-27670910,2023-11-13T08:50:49,Bilbao,Expense,subscriptions,-76.77,-533731.65
buyer_1,Luis,28,ES28209599118326557478,TRX_N-02222-28957503,2023-11-13T11:39:59,Bilbao,Expense,personal_care,-373.52,-534105.17
buyer_1,Luis,28,ES28209599118326557478,TRX_N-02223-31716127,2023-11-14T18:08:30,Bilbao,Expense,car,-415.59,-534520.76
buyer_1,Luis,28,ES28209599118326557478,TRX_N-02224-18305835,2023-11-14T10:20:56,Bilbao,Expense,healthcare,-466.3,-534987.06
buyer_1,Luis,28,ES28209599118326557478,TRX_N-02225-63858712,2023-11-14T12:56:25,Bilbao,Expense,savings,-53.27,-535040.33
buyer_1,Luis,28,ES28209599118326557478,TRX_N-02226-07722385,2023-11-15T10:16:44,Pasaia,Expense,children,-225.23,-535265.56
buyer_1,Luis,28,ES28209599118326557478,TRX_N-02227-85062071,2023-11-15T11:25:18,Bilbao,Expense,children,-309.39,-535574.95
buyer_1,Luis,28,ES28209599118326557478,TRX_N-02228-70942308,2023-11-15T09:11:08,Bilbao,Expense,leisure,-22.85,-535597.8
buyer_1,Luis,28,ES28209599118326557478,TRX_N-02229-19729830,2023-11-16T15:27:58,Leioa,Expense,subscriptions,-454.18,-536051.98
buyer_1,Luis,28,ES28209599118326557478,TRX_N-02230-47033701,2023-11-16T16:44:21,Bilbao,Expense,food,-208.03,-536260.01
buyer_1,Luis,28,ES28209599118326557478,TRX_N-02231-07751968,2023-11-16T13:06:43,Bilbao,Expense,subscriptions,-307.63,-536567.64
buyer_1,Luis,28,ES28209599118326557478,TRX_N-02232-96734012,2023-11-17T23:03:41,Bilbao,Expense,healthcare,-343.38,-536911.02
buyer_1,Luis,28,ES28209599118326557478,TRX_N-02233-00281664,2023-11-17T11:31:54,Bilbao,Expense,education,-337.01,-537248.03
buyer_1,Luis,28,ES28209599118326557478,TRX_N-02234-87321490,2023-11-17T05:13:42,Bilbao,Expense,basic-services,-35.2,-537283.23
buyer_1,Luis,28,ES28209599118326557478,TRX_N-02235-65429062,2023-11-18T12:33:19,Bilbao,Expense,car,-331.35,-537614.58
buyer_1,Luis,28,ES28209599118326557478,TRX_N-02236-77556618,2023-11-18T17:51:26,Bilbao,Expense,education,-443.19,-538057.77
buyer_1,Luis,28,ES28209599118326557478,TRX_N-02237-70118677,2023-11-18T23:03:00,Bilbao,Expense,clothing,-135.96,-538193.73
buyer_1,Luis,28,ES28209599118326557478,TRX_N-02238-42222383,2023-11-19T17:33:49,Bilbao,Expense,basic-services,-471.51,-538665.24
buyer_1,Luis,28,ES28209599118326557478,TRX_N-02239-15785340,2023-11-19T08:17:36,Bilbao,Expense,clothing,-497.25,-539162.49
buyer_1,Luis,28,ES28209599118326557478,TRX_N-02240-61429336,2023-11-19T13:58:59,Basauri,Expense,clothing,-357.26,-539519.75
buyer_1,Luis,28,ES28209599118326557478,TRX_N-02241-41483197,2023-11-20T11:42:28,Bermeo,Expense,transport,-464.79,-539984.54
buyer_1,Luis,28,ES28209599118326557478,TRX_N-02242-56240224,2023-11-20T22:11:35,Bilbao,Expense,personal_care,-11.1,-539995.64
buyer_1,Luis,28,ES28209599118326557478,TRX_N-02243-78379188,2023-11-20T14:30:13,Bilbao,Expense,basic-services,-68.41,-540064.05
buyer_1,Luis,28,ES28209599118326557478,TRX_N-02244-99326493,2023-11-21T08:00:39,Bilbao,Expense,healthcare,-324.21,-540388.26
buyer_1,Luis,28,ES28209599118326557478,TRX_N-02245-47146514,2023-11-21T09:27:38,Llodio,Expense,leisure,-69.92,-540458.18
buyer_1,Luis,28,ES28209599118326557478,TRX_N-02246-23791765,2023-11-21T13:47:51,Zarautz,Expense,housing,-157.31,-540615.49
buyer_1,Luis,28,ES28209599118326557478,TRX_N-02247-34286716,2023-11-22T14:42:33,Bilbao,Expense,children,-247.66,-540863.15
buyer_1,Luis,28,ES28209599118326557478,TRX_N-02248-99866026,2023-11-22T18:36:52,Bilbao,Expense,subscriptions,-33.61,-540896.76
buyer_1,Luis,28,ES28209599118326557478,TRX_N-02249-48131685,2023-11-22T04:30:47,Bilbao,Expense,food,-161.38,-541058.14
buyer_1,Luis,28,ES28209599118326557478,TRX_N-02250-21326992,2023-11-23T09:07:18,Bilbao,Expense,savings,-373.71,-541431.85
buyer_1,Luis,28,ES28209599118326557478,TRX_N-02251-52616989,2023-11-23T14:03:52,Bilbao,Expense,personal_care,-276.16,-541708.01
buyer_1,Luis,28,ES28209599118326557478,TRX_N-02252-56894546,2023-11-23T13:36:14,Barakaldo,Expense,food,-259.31,-541967.32
buyer_1,Luis,28,ES28209599118326557478,TRX_N-02253-81746173,2023-11-24T12:29:14,Bilbao,Expense,loans,-361.71,-542329.03
buyer_1,Luis,28,ES28209599118326557478,TRX_N-02254-00244797,2023-11-24T09:58:29,Bilbao,Expense,food,-197.26,-542526.29
buyer_1,Luis,28,ES28209599118326557478,TRX_N-02255-60950488,2023-11-24T23:30:15,Bilbao,Expense,healthcare,-132.21,-542658.5
buyer_1,Luis,28,ES28209599118326557478,TRX_N-02256-88622540,2023-11-25T09:45:57,Bilbao,Expense,car,-307.03,-542965.53
buyer_1,Luis,28,ES28209599118326557478,TRX_N-02257-43123765,2023-11-25T20:16:53,Sestao,Expense,children,-164.87,-543130.4
buyer_1,Luis,28,ES28209599118326557478,TRX_N-02258-51832775,2023-11-25T04:04:06,Bilbao,Expense,food,-24.41,-543154.81
buyer_1,Luis,28,ES28209599118326557478,TRX_N-02259-33096152,2023-11-26T17:43:13,Bilbao,Expense,clothing,-305.92,-543460.73
buyer_1,Luis,28,ES28209599118326557478,TRX_N-02260-95160687,2023-11-26T16:07:22,Bilbao,Expense,technology,-394.8,-543855.53
buyer_1,Luis,28,ES28209599118326557478,TRX_N-02261-34475946,2023-11-26T17:17:33,Bilbao,Expense,clothing,-288.84,-544144.37
buyer_1,Luis,28,ES28209599118326557478,TRX_N-02262-06109544,2023-11-27T10:47:27,Durango,Expense,savings,-42.72,-544187.09
buyer_1,Luis,28,ES28209599118326557478,TRX_N-02263-60337592,2023-11-27T20:08:42,Bilbao,Expense,healthcare,-453.82,-544640.91
buyer_1,Luis,28,ES28209599118326557478,TRX_N-02264-90376588,2023-11-27T08:35:08,Bilbao,Expense,clothing,-106.47,-544747.38
buyer_1,Luis,28,ES28209599118326557478,TRX_N-02265-04446735,2023-11-28T17:41:33,Bilbao,Expense,healthcare,-262.38,-545009.76
buyer_1,Luis,28,ES28209599118326557478,TRX_N-02266-15808460,2023-11-28T15:31:36,Bilbao,Expense,education,-141.16,-545150.92
buyer_1,Luis,28,ES28209599118326557478,TRX_N-02267-54320861,2023-11-28T10:48:43,Durango,Expense,technology,-121.36,-545272.28
buyer_1,Luis,28,ES28209599118326557478,TRX_N-02268-07892339,2023-11-29T11:31:37,Bilbao,Expense,basic-services,-135.85,-545408.13
buyer_1,Luis,28,ES28209599118326557478,TRX_N-02269-47657223,2023-11-29T17:25:29,Bilbao,Expense,children,-167.39,-545575.52
buyer_1,Luis,28,ES28209599118326557478,TRX_N-02270-22735282,2023-11-29T20:55:49,Bilbao,Expense,car,-367.57,-545943.09
buyer_1,Luis,28,ES28209599118326557478,TRX_N-02271-70594178,2023-11-30T09:09:10,Bilbao,Expense,food,-418.64,-546361.73
buyer_1,Luis,28,ES28209599118326557478,TRX_N-02272-81993290,2023-11-30T12:19:20,Arrasate,Expense,clothing,-42.95,-546404.68
buyer_1,Luis,28,ES28209599118326557478,TRX_N-02273-79459385,2023-11-30T16:17:33,Bilbao,Expense,housing,-227.15,-546631.83
buyer_1,Luis,28,ES28209599118326557478,TRX_N-02274-01320901,2023-12-01T10:42:28,Bilbao,incomes,salary,1265.98,-545365.85
buyer_1,Luis,28,ES28209599118326557478,TRX_N-02275-54516377,2023-12-01T10:42:28,Bilbao,incomes,salary_extra,1002.86,-544362.99
buyer_1,Luis,28,ES28209599118326557478,TRX_N-02276-78602454,2023-12-01T04:58:15,Bilbao,Expense,savings,-73.95,-544436.94
buyer_1,Luis,28,ES28209599118326557478,TRX_N-02277-66125631,2023-12-01T17:53:33,Bilbao,Expense,clothing,-312.08,-544749.02
buyer_1,Luis,28,ES28209599118326557478,TRX_N-02278-22075073,2023-12-01T16:02:24,Bilbao,Expense,loans,-13.74,-544762.76
buyer_1,Luis,28,ES28209599118326557478,TRX_N-02279-46516656,2023-12-02T17:44:33,Bilbao,Expense,car,-60.0,-544822.76
buyer_1,Luis,28,ES28209599118326557478,TRX_N-02280-99218888,2023-12-02T19:19:52,Bilbao,Expense,clothing,-156.16,-544978.92
buyer_1,Luis,28,ES28209599118326557478,TRX_N-02281-40212289,2023-12-02T20:51:21,Bilbao,Expense,children,-42.43,-545021.35
buyer_1,Luis,28,ES28209599118326557478,TRX_N-02282-96234651,2023-12-03T15:51:06,Bilbao,Expense,savings,-67.3,-545088.65
buyer_1,Luis,28,ES28209599118326557478,TRX_N-02283-64382418,2023-12-03T08:56:00,Bermeo,Expense,loans,-129.04,-545217.69
buyer_1,Luis,28,ES28209599118326557478,TRX_N-02284-73601215,2023-12-03T12:44:23,Portugalete,Expense,education,-443.37,-545661.06
buyer_1,Luis,28,ES28209599118326557478,TRX_N-02285-44149463,2023-12-04T22:30:32,Bilbao,Housing,Rent,-1369.49,-547030.55
buyer_1,Luis,28,ES28209599118326557478,TRX_N-02286-34567317,2023-12-04T11:54:54,Bilbao,Expense,children,-223.38,-547253.93
buyer_1,Luis,28,ES28209599118326557478,TRX_N-02287-77867694,2023-12-04T14:02:13,Leioa,Expense,technology,-322.44,-547576.37
buyer_1,Luis,28,ES28209599118326557478,TRX_N-02288-45871964,2023-12-04T19:44:40,Bilbao,Expense,car,-379.22,-547955.59
buyer_1,Luis,28,ES28209599118326557478,TRX_N-02289-72958475,2023-12-05T16:47:41,Durango,Expense,food,-31.66,-547987.25
buyer_1,Luis,28,ES28209599118326557478,TRX_N-02290-07407844,2023-12-05T08:46:25,Bilbao,Expense,food,-330.67,-548317.92
buyer_1,Luis,28,ES28209599118326557478,TRX_N-02291-74172166,2023-12-05T15:08:57,Bilbao,Expense,healthcare,-404.67,-548722.59
buyer_1,Luis,28,ES28209599118326557478,TRX_N-02292-68909970,2023-12-06T14:36:34,Bilbao,basic_services,gas,-41.56,-548764.15
buyer_1,Luis,28,ES28209599118326557478,TRX_N-02293-02378826,2023-12-06T05:04:25,Bilbao,Expense,technology,-126.24,-548890.39
buyer_1,Luis,28,ES28209599118326557478,TRX_N-02294-66176797,2023-12-06T16:12:03,Bilbao,Expense,food,-116.07,-549006.46
buyer_1,Luis,28,ES28209599118326557478,TRX_N-02295-28921157,2023-12-06T08:12:22,Errenteria,Expense,transport,-117.61,-549124.07
buyer_1,Luis,28,ES28209599118326557478,TRX_N-02296-11190645,2023-12-07T09:12:59,Bilbao,basic_services,electricity,-24.42,-549148.49
buyer_1,Luis,28,ES28209599118326557478,TRX_N-02297-53202194,2023-12-07T08:01:18,Bilbao,Expense,technology,-54.17,-549202.66
buyer_1,Luis,28,ES28209599118326557478,TRX_N-02298-58052184,2023-12-07T22:38:14,Bilbao,Expense,education,-353.91,-549556.57
buyer_1,Luis,28,ES28209599118326557478,TRX_N-02299-52831451,2023-12-07T20:06:55,Bilbao,Expense,clothing,-488.26,-550044.83
buyer_1,Luis,28,ES28209599118326557478,TRX_N-02300-98769327,2023-12-08T17:09:27,Bilbao,basic_services,water,-38.47,-550083.3
buyer_1,Luis,28,ES28209599118326557478,TRX_N-02301-32389989,2023-12-08T19:47:25,Bilbao,basic_services,internet,-48.65,-550131.95
buyer_1,Luis,28,ES28209599118326557478,TRX_N-02302-95029010,2023-12-08T16:53:50,Bilbao,basic_services,phone,-49.62,-550181.57
buyer_1,Luis,28,ES28209599118326557478,TRX_N-02303-02444838,2023-12-08T19:17:20,Bilbao,Expense,children,-213.71,-550395.28
buyer_1,Luis,28,ES28209599118326557478,TRX_N-02304-15811226,2023-12-08T10:26:29,Bilbao,Expense,clothing,-220.89,-550616.17
buyer_1,Luis,28,ES28209599118326557478,TRX_N-02305-25691442,2023-12-08T18:32:16,Bilbao,Expense,basic-services,-134.64,-550750.81
buyer_1,Luis,28,ES28209599118326557478,TRX_N-02306-24128143,2023-12-09T09:42:30,Bilbao,Expense,loans,-476.52,-551227.33
buyer_1,Luis,28,ES28209599118326557478,TRX_N-02307-41490602,2023-12-09T18:27:47,Bilbao,Expense,housing,-78.07,-551305.4
buyer_1,Luis,28,ES28209599118326557478,TRX_N-02308-96744326,2023-12-09T12:11:23,Bilbao,Expense,loans,-270.14,-551575.54
buyer_1,Luis,28,ES28209599118326557478,TRX_N-02309-56334702,2023-12-10T08:36:48,Bilbao,Expense,savings,-136.42,-551711.96
buyer_1,Luis,28,ES28209599118326557478,TRX_N-02310-77764331,2023-12-10T08:41:03,Bilbao,Expense,food,-357.35,-552069.31
buyer_1,Luis,28,ES28209599118326557478,TRX_N-02311-73185795,2023-12-10T11:43:02,Berango,Expense,basic-services,-455.61,-552524.92
buyer_1,Luis,28,ES28209599118326557478,TRX_N-02312-60951330,2023-12-11T16:28:00,Bilbao,Expense,healthcare,-151.53,-552676.45
buyer_1,Luis,28,ES28209599118326557478,TRX_N-02313-58131980,2023-12-11T12:21:20,Bermeo,Expense,savings,-288.33,-552964.78
buyer_1,Luis,28,ES28209599118326557478,TRX_N-02314-03763675,2023-12-11T15:03:50,Sopela,Expense,clothing,-410.79,-553375.57
buyer_1,Luis,28,ES28209599118326557478,TRX_N-02315-45140254,2023-12-12T22:21:51,Bilbao,Expense,children,-259.52,-553635.09
buyer_1,Luis,28,ES28209599118326557478,TRX_N-02316-22867857,2023-12-12T13:48:56,Bilbao,Expense,transport,-170.09,-553805.18
buyer_1,Luis,28,ES28209599118326557478,TRX_N-02317-49678341,2023-12-12T08:59:38,Bilbao,Expense,personal_care,-128.54,-553933.72
buyer_1,Luis,28,ES28209599118326557478,TRX_N-02318-43231667,2023-12-13T10:06:36,Bilbao,Expense,housing,-20.51,-553954.23
buyer_1,Luis,28,ES28209599118326557478,TRX_N-02319-26348723,2023-12-13T18:22:44,Bilbao,Expense,loans,-63.74,-554017.97
buyer_1,Luis,28,ES28209599118326557478,TRX_N-02320-53859316,2023-12-13T23:25:53,Eibar,Expense,basic-services,-353.43,-554371.4
buyer_1,Luis,28,ES28209599118326557478,TRX_N-02321-13683975,2023-12-14T11:21:27,Hondarribia,Expense,housing,-161.92,-554533.32
buyer_1,Luis,28,ES28209599118326557478,TRX_N-02322-44502833,2023-12-14T15:05:52,Bilbao,Expense,children,-343.41,-554876.73
buyer_1,Luis,28,ES28209599118326557478,TRX_N-02323-36315713,2023-12-14T08:14:46,Bilbao,Expense,children,-140.02,-555016.75
buyer_1,Luis,28,ES28209599118326557478,TRX_N-02324-78093621,2023-12-15T08:17:19,Iruña de Oca,Expense,education,-293.26,-555310.01
buyer_1,Luis,28,ES28209599118326557478,TRX_N-02325-48253728,2023-12-15T14:47:34,Bilbao,Expense,subscriptions,-85.83,-555395.84
buyer_1,Luis,28,ES28209599118326557478,TRX_N-02326-18649367,2023-12-15T19:52:19,Portugalete,Expense,savings,-44.15,-555439.99
buyer_1,Luis,28,ES28209599118326557478,TRX_N-02327-43908140,2023-12-16T08:47:59,Bilbao,Expense,clothing,-131.39,-555571.38
buyer_1,Luis,28,ES28209599118326557478,TRX_N-02328-74375937,2023-12-16T12:28:41,Bilbao,Expense,subscriptions,-311.66,-555883.04
buyer_1,Luis,28,ES28209599118326557478,TRX_N-02329-23230626,2023-12-16T12:58:44,Bilbao,Expense,car,-157.95,-556040.99
buyer_1,Luis,28,ES28209599118326557478,TRX_N-02330-64446863,2023-12-17T13:39:27,Bilbao,Expense,basic-services,-427.4,-556468.39
buyer_1,Luis,28,ES28209599118326557478,TRX_N-02331-39995071,2023-12-17T21:31:28,Bilbao,Expense,leisure,-139.77,-556608.16
buyer_1,Luis,28,ES28209599118326557478,TRX_N-02332-44017932,2023-12-17T20:59:31,Bilbao,Expense,leisure,-99.45,-556707.61
buyer_1,Luis,28,ES28209599118326557478,TRX_N-02333-45224758,2023-12-18T01:33:32,Bilbao,Expense,technology,-182.95,-556890.56
buyer_1,Luis,28,ES28209599118326557478,TRX_N-02334-05790571,2023-12-18T10:15:30,Bilbao,Expense,transport,-108.63,-556999.19
buyer_1,Luis,28,ES28209599118326557478,TRX_N-02335-98555222,2023-12-18T12:01:04,Bilbao,Expense,education,-404.28,-557403.47
buyer_1,Luis,28,ES28209599118326557478,TRX_N-02336-85444133,2023-12-19T15:12:45,Bilbao,Expense,children,-328.56,-557732.03
buyer_1,Luis,28,ES28209599118326557478,TRX_N-02337-65437698,2023-12-19T17:03:01,Bilbao,Expense,basic-services,-206.85,-557938.88
buyer_1,Luis,28,ES28209599118326557478,TRX_N-02338-19592247,2023-12-19T17:04:53,Bilbao,Expense,transport,-26.95,-557965.83
buyer_1,Luis,28,ES28209599118326557478,TRX_N-02339-94863766,2023-12-20T19:47:00,Bilbao,Expense,leisure,-467.32,-558433.15
buyer_1,Luis,28,ES28209599118326557478,TRX_N-02340-46979159,2023-12-20T08:17:52,Bilbao,Expense,healthcare,-100.7,-558533.85
buyer_1,Luis,28,ES28209599118326557478,TRX_N-02341-63289319,2023-12-20T20:23:00,Bilbao,Expense,children,-453.55,-558987.4
buyer_1,Luis,28,ES28209599118326557478,TRX_N-02342-28017979,2023-12-21T19:30:03,Bilbao,Expense,housing,-466.02,-559453.42
buyer_1,Luis,28,ES28209599118326557478,TRX_N-02343-23917698,2023-12-21T14:00:19,Bilbao,Expense,education,-477.96,-559931.38
buyer_1,Luis,28,ES28209599118326557478,TRX_N-02344-74512274,2023-12-21T11:11:07,Bilbao,Expense,transport,-433.03,-560364.41
buyer_1,Luis,28,ES28209599118326557478,TRX_N-02345-08667784,2023-12-22T11:41:54,Bilbao,Expense,technology,-110.14,-560474.55
buyer_1,Luis,28,ES28209599118326557478,TRX_N-02346-90818926,2023-12-22T08:09:58,Bilbao,Expense,basic-services,-117.52,-560592.07
buyer_1,Luis,28,ES28209599118326557478,TRX_N-02347-05452664,2023-12-22T12:41:38,Bilbao,Expense,education,-294.89,-560886.96
buyer_1,Luis,28,ES28209599118326557478,TRX_N-02348-75210566,2023-12-23T14:06:16,Bilbao,Expense,leisure,-421.19,-561308.15
buyer_1,Luis,28,ES28209599118326557478,TRX_N-02349-67546197,2023-12-23T12:16:47,Bilbao,Expense,subscriptions,-275.94,-561584.09
buyer_1,Luis,28,ES28209599118326557478,TRX_N-02350-57071057,2023-12-23T03:18:16,Bilbao,Expense,clothing,-140.82,-561724.91
buyer_1,Luis,28,ES28209599118326557478,TRX_N-02351-63721487,2023-12-24T15:55:04,Bilbao,Expense,housing,-110.07,-561834.98
buyer_1,Luis,28,ES28209599118326557478,TRX_N-02352-18261565,2023-12-24T02:14:35,Oyón-Oion,Expense,car,-246.89,-562081.87
buyer_1,Luis,28,ES28209599118326557478,TRX_N-02353-93334880,2023-12-24T22:33:44,Bilbao,Expense,leisure,-284.6,-562366.47
buyer_1,Luis,28,ES28209599118326557478,TRX_N-02354-23591113,2023-12-25T17:34:26,Bilbao,Expense,education,-208.99,-562575.46
buyer_1,Luis,28,ES28209599118326557478,TRX_N-02355-35703687,2023-12-25T11:03:31,Bilbao,Expense,education,-152.03,-562727.49
buyer_1,Luis,28,ES28209599118326557478,TRX_N-02356-14120270,2023-12-25T02:57:36,Bilbao,Expense,subscriptions,-260.44,-562987.93
buyer_1,Luis,28,ES28209599118326557478,TRX_N-02357-16676297,2023-12-26T15:17:10,Eibar,Expense,education,-79.73,-563067.66
buyer_1,Luis,28,ES28209599118326557478,TRX_N-02358-16902757,2023-12-26T11:11:22,Bilbao,Expense,transport,-246.42,-563314.08
buyer_1,Luis,28,ES28209599118326557478,TRX_N-02359-42766607,2023-12-26T08:28:18,Bilbao,Expense,children,-235.9,-563549.98
buyer_1,Luis,28,ES28209599118326557478,TRX_N-02360-81151142,2023-12-27T12:00:17,Bilbao,Expense,technology,-462.5,-564012.48
buyer_1,Luis,28,ES28209599118326557478,TRX_N-02361-83368091,2023-12-27T20:34:59,Lasarte-Oria,Expense,savings,-204.26,-564216.74
buyer_1,Luis,28,ES28209599118326557478,TRX_N-02362-92924746,2023-12-27T18:33:51,Bilbao,Expense,education,-474.17,-564690.91
buyer_1,Luis,28,ES28209599118326557478,TRX_N-02363-41517532,2023-12-28T13:22:42,Bilbao,Expense,children,-240.79,-564931.7
buyer_1,Luis,28,ES28209599118326557478,TRX_N-02364-18608624,2023-12-28T18:24:50,Bilbao,Expense,leisure,-282.02,-565213.72
buyer_1,Luis,28,ES28209599118326557478,TRX_N-02365-31864488,2023-12-28T18:57:43,Bilbao,Expense,savings,-307.79,-565521.51
buyer_1,Luis,28,ES28209599118326557478,TRX_N-02366-39478822,2023-12-29T20:59:18,Sestao,Expense,clothing,-258.38,-565779.89
buyer_1,Luis,28,ES28209599118326557478,TRX_N-02367-73981219,2023-12-29T11:09:16,Bilbao,Expense,car,-365.09,-566144.98
buyer_1,Luis,28,ES28209599118326557478,TRX_N-02368-17353687,2023-12-29T13:58:38,Bilbao,Expense,car,-451.36,-566596.34
buyer_1,Luis,28,ES28209599118326557478,TRX_N-02369-25276218,2023-12-30T15:36:12,Bilbao,Expense,technology,-152.06,-566748.4
buyer_1,Luis,28,ES28209599118326557478,TRX_N-02370-40789080,2023-12-30T17:21:57,Bilbao,Expense,savings,-401.58,-567149.98
buyer_1,Luis,28,ES28209599118326557478,TRX_N-02371-53405522,2023-12-30T17:58:36,Bilbao,Expense,housing,-340.45,-567490.43
buyer_1,Luis,28,ES28209599118326557478,TRX_N-02372-72724916,2023-12-31T09:19:08,Getxo,Expense,technology,-264.62,-567755.05
buyer_1,Luis,28,ES28209599118326557478,TRX_N-02373-28709279,2023-12-31T09:36:07,Bilbao,Expense,car,-405.68,-568160.73
buyer_1,Luis,28,ES28209599118326557478,TRX_N-02374-70813253,2023-12-31T13:41:54,Bilbao,Expense,savings,-243.04,-568403.77
buyer_1,Luis,28,ES28209599118326557478,TRX_N-02375-81136822,2024-01-01T18:24:22,Bilbao,incomes,salary,1265.98,-567137.79
buyer_1,Luis,28,ES28209599118326557478,TRX_N-02376-73352064,2024-01-01T18:24:22,Bilbao,incomes,extra_income,126.6,-567011.19
buyer_1,Luis,28,ES28209599118326557478,TRX_N-02377-02323034,2024-01-01T13:25:56,Bilbao,Expense,loans,-264.95,-567276.14
buyer_1,Luis,28,ES28209599118326557478,TRX_N-02378-84371635,2024-01-01T17:09:45,Bilbao,Expense,transport,-497.83,-567773.97
buyer_1,Luis,28,ES28209599118326557478,TRX_N-02379-30288793,2024-01-01T09:29:38,Sopela,Expense,savings,-395.01,-568168.98
buyer_1,Luis,28,ES28209599118326557478,TRX_N-02380-14630290,2024-01-02T09:18:36,Bilbao,Expense,healthcare,-97.09,-568266.07
buyer_1,Luis,28,ES28209599118326557478,TRX_N-02381-00247808,2024-01-02T21:32:53,Bilbao,Expense,savings,-409.67,-568675.74
buyer_1,Luis,28,ES28209599118326557478,TRX_N-02382-20681025,2024-01-02T14:09:07,Bilbao,Expense,subscriptions,-90.17,-568765.91
buyer_1,Luis,28,ES28209599118326557478,TRX_N-02383-94131398,2024-01-03T19:02:23,Bilbao,Expense,personal_care,-388.38,-569154.29
buyer_1,Luis,28,ES28209599118326557478,TRX_N-02384-14787373,2024-01-03T16:52:31,Bilbao,Expense,technology,-446.03,-569600.32
buyer_1,Luis,28,ES28209599118326557478,TRX_N-02385-94796554,2024-01-03T19:03:12,Bilbao,Expense,personal_care,-325.92,-569926.24
buyer_1,Luis,28,ES28209599118326557478,TRX_N-02386-90424680,2024-01-04T11:04:16,Bilbao,Housing,Rent,-1369.49,-571295.73
buyer_1,Luis,28,ES28209599118326557478,TRX_N-02387-14312319,2024-01-04T14:37:55,Bilbao,Expense,savings,-355.35,-571651.08
buyer_1,Luis,28,ES28209599118326557478,TRX_N-02388-01722020,2024-01-04T21:43:42,Bilbao,Expense,technology,-292.17,-571943.25
buyer_1,Luis,28,ES28209599118326557478,TRX_N-02389-64557505,2024-01-04T13:30:34,Bilbao,Expense,children,-75.0,-572018.25
buyer_1,Luis,28,ES28209599118326557478,TRX_N-02390-66241286,2024-01-05T13:25:08,Bilbao,Expense,loans,-366.98,-572385.23
buyer_1,Luis,28,ES28209599118326557478,TRX_N-02391-60469501,2024-01-05T08:51:08,Bilbao,Expense,education,-304.27,-572689.5
buyer_1,Luis,28,ES28209599118326557478,TRX_N-02392-61110246,2024-01-05T09:11:22,Bilbao,Expense,technology,-496.86,-573186.36
buyer_1,Luis,28,ES28209599118326557478,TRX_N-02393-68224817,2024-01-06T12:01:55,Bilbao,basic_services,electricity,-113.38,-573299.74
buyer_1,Luis,28,ES28209599118326557478,TRX_N-02394-85067453,2024-01-06T09:49:15,Bilbao,basic_services,internet,-62.31,-573362.05
buyer_1,Luis,28,ES28209599118326557478,TRX_N-02395-46069913,2024-01-06T04:15:51,Bilbao,Expense,leisure,-269.96,-573632.01
buyer_1,Luis,28,ES28209599118326557478,TRX_N-02396-51813661,2024-01-06T16:23:10,Bilbao,Expense,loans,-435.61,-574067.62
buyer_1,Luis,28,ES28209599118326557478,TRX_N-02397-09236339,2024-01-06T22:13:13,Bilbao,Expense,housing,-484.61,-574552.23
buyer_1,Luis,28,ES28209599118326557478,TRX_N-02398-01845458,2024-01-07T10:52:27,Bilbao,Expense,transport,-483.81,-575036.04
buyer_1,Luis,28,ES28209599118326557478,TRX_N-02399-06994913,2024-01-07T16:28:50,Eibar,Expense,basic-services,-360.8,-575396.84
buyer_1,Luis,28,ES28209599118326557478,TRX_N-02400-64971453,2024-01-07T14:38:13,Bilbao,Expense,healthcare,-436.9,-575833.74
buyer_1,Luis,28,ES28209599118326557478,TRX_N-02401-27880680,2024-01-08T12:00:41,Bilbao,basic_services,water,-32.3,-575866.04
buyer_1,Luis,28,ES28209599118326557478,TRX_N-02402-13887103,2024-01-08T10:39:04,Bilbao,basic_services,gas,-37.68,-575903.72
buyer_1,Luis,28,ES28209599118326557478,TRX_N-02403-24513226,2024-01-08T17:52:00,Bilbao,basic_services,phone,-98.05,-576001.77
buyer_1,Luis,28,ES28209599118326557478,TRX_N-02404-09538917,2024-01-08T05:10:24,Bilbao,Expense,healthcare,-317.97,-576319.74
buyer_1,Luis,28,ES28209599118326557478,TRX_N-02405-28942481,2024-01-08T15:38:31,Bilbao,Expense,car,-41.41,-576361.15
buyer_1,Luis,28,ES28209599118326557478,TRX_N-02406-39331812,2024-01-08T19:54:39,Bilbao,Expense,children,-45.66,-576406.81
buyer_1,Luis,28,ES28209599118326557478,TRX_N-02407-84140087,2024-01-09T17:12:04,Salvatierra/Agurain,Expense,food,-281.22,-576688.03
buyer_1,Luis,28,ES28209599118326557478,TRX_N-02408-74487341,2024-01-09T09:42:28,Bilbao,Expense,transport,-132.91,-576820.94
buyer_1,Luis,28,ES28209599118326557478,TRX_N-02409-49309754,2024-01-09T19:54:55,Bilbao,Expense,loans,-252.84,-577073.78
buyer_1,Luis,28,ES28209599118326557478,TRX_N-02410-58039924,2024-01-10T10:03:26,Bilbao,Expense,personal_care,-361.17,-577434.95
buyer_1,Luis,28,ES28209599118326557478,TRX_N-02411-21513115,2024-01-10T20:20:39,Bilbao,Expense,subscriptions,-283.89,-577718.84
buyer_1,Luis,28,ES28209599118326557478,TRX_N-02412-26107068,2024-01-10T10:02:12,Labastida,Expense,loans,-383.16,-578102.0
buyer_1,Luis,28,ES28209599118326557478,TRX_N-02413-31941460,2024-01-11T20:42:33,Bilbao,Expense,personal_care,-206.95,-578308.95
buyer_1,Luis,28,ES28209599118326557478,TRX_N-02414-40657749,2024-01-11T19:46:02,Bilbao,Expense,children,-56.74,-578365.69
buyer_1,Luis,28,ES28209599118326557478,TRX_N-02415-11925190,2024-01-11T15:20:32,Bilbao,Expense,car,-213.04,-578578.73
buyer_1,Luis,28,ES28209599118326557478,TRX_N-02416-07415406,2024-01-12T10:41:31,Hernani,Expense,loans,-252.36,-578831.09
buyer_1,Luis,28,ES28209599118326557478,TRX_N-02417-71036218,2024-01-12T17:29:39,Bilbao,Expense,basic-services,-203.91,-579035.0
buyer_1,Luis,28,ES28209599118326557478,TRX_N-02418-97963958,2024-01-12T08:42:31,Bilbao,Expense,technology,-335.91,-579370.91
buyer_1,Luis,28,ES28209599118326557478,TRX_N-02419-26899491,2024-01-13T20:07:34,Bilbao,Expense,education,-485.74,-579856.65
buyer_1,Luis,28,ES28209599118326557478,TRX_N-02420-10529652,2024-01-13T10:26:06,Bilbao,Expense,housing,-457.91,-580314.56
buyer_1,Luis,28,ES28209599118326557478,TRX_N-02421-32421964,2024-01-13T20:44:51,Bilbao,Expense,food,-482.49,-580797.05
buyer_1,Luis,28,ES28209599118326557478,TRX_N-02422-86055100,2024-01-14T04:08:09,Salvatierra/Agurain,Expense,food,-315.09,-581112.14
buyer_1,Luis,28,ES28209599118326557478,TRX_N-02423-73017131,2024-01-14T19:34:26,Bilbao,Expense,subscriptions,-67.83,-581179.97
buyer_1,Luis,28,ES28209599118326557478,TRX_N-02424-55525154,2024-01-14T18:11:53,Bilbao,Expense,loans,-306.58,-581486.55
buyer_1,Luis,28,ES28209599118326557478,TRX_N-02425-52676022,2024-01-15T20:19:37,Bilbao,Expense,food,-210.97,-581697.52
buyer_1,Luis,28,ES28209599118326557478,TRX_N-02426-89116315,2024-01-15T20:03:26,Hernani,Expense,transport,-134.61,-581832.13
buyer_1,Luis,28,ES28209599118326557478,TRX_N-02427-30360308,2024-01-15T15:38:59,Bilbao,Expense,housing,-29.92,-581862.05
buyer_1,Luis,28,ES28209599118326557478,TRX_N-02428-44635849,2024-01-16T20:10:47,Elciego,Expense,housing,-54.06,-581916.11
buyer_1,Luis,28,ES28209599118326557478,TRX_N-02429-12091895,2024-01-16T15:48:29,Bilbao,Expense,food,-173.08,-582089.19
buyer_1,Luis,28,ES28209599118326557478,TRX_N-02430-39930571,2024-01-16T08:54:34,Zarautz,Expense,housing,-364.94,-582454.13
buyer_1,Luis,28,ES28209599118326557478,TRX_N-02431-90871843,2024-01-17T12:57:33,Bilbao,Expense,personal_care,-286.63,-582740.76
buyer_1,Luis,28,ES28209599118326557478,TRX_N-02432-69836779,2024-01-17T14:39:32,Bilbao,Expense,leisure,-402.94,-583143.7
buyer_1,Luis,28,ES28209599118326557478,TRX_N-02433-02498925,2024-01-17T18:58:19,Bilbao,Expense,technology,-221.17,-583364.87
buyer_1,Luis,28,ES28209599118326557478,TRX_N-02434-98589870,2024-01-18T16:59:28,Amurrio,Expense,loans,-305.27,-583670.14
buyer_1,Luis,28,ES28209599118326557478,TRX_N-02435-46344119,2024-01-18T07:19:04,Bilbao,Expense,subscriptions,-145.59,-583815.73
buyer_1,Luis,28,ES28209599118326557478,TRX_N-02436-15787083,2024-01-18T09:53:40,Bilbao,Expense,clothing,-159.25,-583974.98
buyer_1,Luis,28,ES28209599118326557478,TRX_N-02437-01558036,2024-01-19T14:19:51,Bilbao,Expense,children,-367.83,-584342.81
buyer_1,Luis,28,ES28209599118326557478,TRX_N-02438-52102553,2024-01-19T09:06:31,Zuia,Expense,personal_care,-278.5,-584621.31
buyer_1,Luis,28,ES28209599118326557478,TRX_N-02439-81325717,2024-01-19T12:35:07,Bilbao,Expense,transport,-149.17,-584770.48
buyer_1,Luis,28,ES28209599118326557478,TRX_N-02440-63605748,2024-01-20T18:18:34,Bilbao,Expense,savings,-399.86,-585170.34
buyer_1,Luis,28,ES28209599118326557478,TRX_N-02441-63067257,2024-01-20T10:54:30,Bilbao,Expense,housing,-253.09,-585423.43
buyer_1,Luis,28,ES28209599118326557478,TRX_N-02442-76544636,2024-01-20T17:47:26,Bilbao,Expense,savings,-403.06,-585826.49
buyer_1,Luis,28,ES28209599118326557478,TRX_N-02443-85428441,2024-01-21T18:14:45,Bilbao,Expense,clothing,-441.35,-586267.84
buyer_1,Luis,28,ES28209599118326557478,TRX_N-02444-09034792,2024-01-21T17:52:31,Bilbao,Expense,housing,-153.54,-586421.38
buyer_1,Luis,28,ES28209599118326557478,TRX_N-02445-63166021,2024-01-21T10:23:29,Bilbao,Expense,savings,-363.27,-586784.65
buyer_1,Luis,28,ES28209599118326557478,TRX_N-02446-04419734,2024-01-22T21:24:49,Donostia,Expense,food,-27.63,-586812.28
buyer_1,Luis,28,ES28209599118326557478,TRX_N-02447-75719237,2024-01-22T21:33:14,Bilbao,Expense,loans,-240.09,-587052.37
buyer_1,Luis,28,ES28209599118326557478,TRX_N-02448-09015745,2024-01-22T16:58:52,Mungia,Expense,subscriptions,-230.39,-587282.76
buyer_1,Luis,28,ES28209599118326557478,TRX_N-02449-81945628,2024-01-23T19:18:11,Santurtzi,Expense,children,-365.12,-587647.88
buyer_1,Luis,28,ES28209599118326557478,TRX_N-02450-26631829,2024-01-23T20:08:43,Bilbao,Expense,technology,-121.71,-587769.59
buyer_1,Luis,28,ES28209599118326557478,TRX_N-02451-86680870,2024-01-23T14:34:20,Bermeo,Expense,children,-226.81,-587996.4
buyer_1,Luis,28,ES28209599118326557478,TRX_N-02452-98931288,2024-01-24T11:23:23,Bilbao,Expense,food,-216.11,-588212.51
buyer_1,Luis,28,ES28209599118326557478,TRX_N-02453-47719115,2024-01-24T11:46:05,Bilbao,Expense,clothing,-72.43,-588284.94
buyer_1,Luis,28,ES28209599118326557478,TRX_N-02454-82928390,2024-01-24T13:49:32,Bilbao,Expense,transport,-376.01,-588660.95
buyer_1,Luis,28,ES28209599118326557478,TRX_N-02455-43069122,2024-01-25T20:08:20,Bilbao,Expense,personal_care,-168.42,-588829.37
buyer_1,Luis,28,ES28209599118326557478,TRX_N-02456-37385743,2024-01-25T10:41:30,Bilbao,Expense,food,-198.37,-589027.74
buyer_1,Luis,28,ES28209599118326557478,TRX_N-02457-27182190,2024-01-25T16:14:30,Andoain,Expense,education,-396.37,-589424.11
buyer_1,Luis,28,ES28209599118326557478,TRX_N-02458-14033533,2024-01-26T22:49:20,Oyón-Oion,Expense,leisure,-448.78,-589872.89
buyer_1,Luis,28,ES28209599118326557478,TRX_N-02459-29343407,2024-01-26T09:58:02,Zuia,Expense,savings,-466.86,-590339.75
buyer_1,Luis,28,ES28209599118326557478,TRX_N-02460-89275608,2024-01-26T22:12:44,Bilbao,Expense,personal_care,-281.94,-590621.69
buyer_1,Luis,28,ES28209599118326557478,TRX_N-02461-00417812,2024-01-27T16:04:35,Bilbao,Expense,food,-253.02,-590874.71
buyer_1,Luis,28,ES28209599118326557478,TRX_N-02462-64856716,2024-01-27T17:06:23,Bilbao,Expense,housing,-25.69,-590900.4
buyer_1,Luis,28,ES28209599118326557478,TRX_N-02463-41672373,2024-01-27T18:11:42,Oyón-Oion,Expense,subscriptions,-455.07,-591355.47
buyer_1,Luis,28,ES28209599118326557478,TRX_N-02464-41929391,2024-01-28T08:32:45,Bilbao,Expense,technology,-465.2,-591820.67
buyer_1,Luis,28,ES28209599118326557478,TRX_N-02465-19109571,2024-01-28T06:19:24,Bilbao,Expense,subscriptions,-262.16,-592082.83
buyer_1,Luis,28,ES28209599118326557478,TRX_N-02466-57073908,2024-01-28T20:40:37,Bilbao,Expense,children,-368.05,-592450.88
buyer_1,Luis,28,ES28209599118326557478,TRX_N-02467-23674519,2024-01-29T11:13:52,Bilbao,Expense,food,-259.08,-592709.96
buyer_1,Luis,28,ES28209599118326557478,TRX_N-02468-46288674,2024-01-29T10:22:22,Bilbao,Expense,car,-390.04,-593100.0
buyer_1,Luis,28,ES28209599118326557478,TRX_N-02469-40106505,2024-01-29T13:34:09,Bilbao,Expense,transport,-186.53,-593286.53
buyer_1,Luis,28,ES28209599118326557478,TRX_N-02470-11274217,2024-01-30T10:30:49,Bilbao,Expense,leisure,-38.35,-593324.88
buyer_1,Luis,28,ES28209599118326557478,TRX_N-02471-03956186,2024-01-30T21:05:27,Andoain,Expense,savings,-392.7,-593717.58
buyer_1,Luis,28,ES28209599118326557478,TRX_N-02472-93403759,2024-01-30T02:15:08,Bilbao,Expense,children,-456.96,-594174.54
buyer_1,Luis,28,ES28209599118326557478,TRX_N-02473-40300540,2024-01-31T12:15:44,Bilbao,Expense,personal_care,-64.48,-594239.02
buyer_1,Luis,28,ES28209599118326557478,TRX_N-02474-75755379,2024-01-31T18:29:40,Elciego,Expense,housing,-247.47,-594486.49
buyer_1,Luis,28,ES28209599118326557478,TRX_N-02475-45896866,2024-01-31T09:18:39,Bilbao,Expense,healthcare,-209.29,-594695.78
buyer_1,Luis,28,ES28209599118326557478,TRX_N-02476-50902632,2024-02-01T20:04:26,Bilbao,incomes,salary,1265.98,-593429.8
buyer_1,Luis,28,ES28209599118326557478,TRX_N-02477-35159681,2024-02-01T11:11:04,Bilbao,Expense,children,-315.11,-593744.91
buyer_1,Luis,28,ES28209599118326557478,TRX_N-02478-04528201,2024-02-01T09:09:38,Bilbao,Expense,clothing,-176.09,-593921.0
buyer_1,Luis,28,ES28209599118326557478,TRX_N-02479-94618487,2024-02-01T15:12:53,Mungia,Expense,savings,-406.28,-594327.28
buyer_1,Luis,28,ES28209599118326557478,TRX_N-02480-34527899,2024-02-02T12:12:16,Bilbao,Expense,personal_care,-434.58,-594761.86
buyer_1,Luis,28,ES28209599118326557478,TRX_N-02481-16908672,2024-02-02T16:17:42,Bilbao,Expense,clothing,-227.62,-594989.48
buyer_1,Luis,28,ES28209599118326557478,TRX_N-02482-28129720,2024-02-02T17:03:05,Bilbao,Expense,car,-111.05,-595100.53
buyer_1,Luis,28,ES28209599118326557478,TRX_N-02483-82410547,2024-02-03T17:35:14,Bilbao,Expense,loans,-435.56,-595536.09
buyer_1,Luis,28,ES28209599118326557478,TRX_N-02484-30288252,2024-02-03T14:37:01,Bilbao,Expense,leisure,-104.67,-595640.76
buyer_1,Luis,28,ES28209599118326557478,TRX_N-02485-35623254,2024-02-03T10:30:24,Bilbao,Expense,children,-150.54,-595791.3
buyer_1,Luis,28,ES28209599118326557478,TRX_N-02486-54011631,2024-02-04T04:11:18,Bilbao,Housing,Rent,-1369.49,-597160.79
buyer_1,Luis,28,ES28209599118326557478,TRX_N-02487-95963944,2024-02-04T12:55:57,Bilbao,Expense,education,-335.41,-597496.2
buyer_1,Luis,28,ES28209599118326557478,TRX_N-02488-26131426,2024-02-04T16:53:42,Donostia,Expense,housing,-251.95,-597748.15
buyer_1,Luis,28,ES28209599118326557478,TRX_N-02489-98252619,2024-02-04T22:37:58,Bilbao,Expense,technology,-100.23,-597848.38
buyer_1,Luis,28,ES28209599118326557478,TRX_N-02490-58476893,2024-02-05T14:23:21,Bilbao,basic_services,water,-58.74,-597907.12
buyer_1,Luis,28,ES28209599118326557478,TRX_N-02491-21356398,2024-02-05T20:08:31,Bilbao,basic_services,gas,-96.45,-598003.57
buyer_1,Luis,28,ES28209599118326557478,TRX_N-02492-01793607,2024-02-05T08:22:00,Bilbao,basic_services,internet,-34.21,-598037.78
buyer_1,Luis,28,ES28209599118326557478,TRX_N-02493-77060072,2024-02-05T15:55:06,Bilbao,Expense,housing,-334.95,-598372.73
buyer_1,Luis,28,ES28209599118326557478,TRX_N-02494-54879794,2024-02-05T10:10:09,Bilbao,Expense,healthcare,-314.18,-598686.91
buyer_1,Luis,28,ES28209599118326557478,TRX_N-02495-66899400,2024-02-05T20:16:36,Bilbao,Expense,healthcare,-30.27,-598717.18
buyer_1,Luis,28,ES28209599118326557478,TRX_N-02496-14496291,2024-02-06T11:03:26,Bilbao,basic_services,electricity,-37.5,-598754.68
buyer_1,Luis,28,ES28209599118326557478,TRX_N-02497-00101574,2024-02-06T12:05:14,Bilbao,Expense,personal_care,-305.27,-599059.95
buyer_1,Luis,28,ES28209599118326557478,TRX_N-02498-26175813,2024-02-06T19:31:06,Bilbao,Expense,children,-321.55,-599381.5
buyer_1,Luis,28,ES28209599118326557478,TRX_N-02499-18869694,2024-02-06T12:49:20,Bilbao,Expense,personal_care,-213.09,-599594.59
buyer_1,Luis,28,ES28209599118326557478,TRX_N-02500-29822794,2024-02-07T11:36:15,Eibar,Expense,car,-101.4,-599695.99
buyer_1,Luis,28,ES28209599118326557478,TRX_N-02501-39544174,2024-02-07T12:09:00,Bilbao,Expense,transport,-437.66,-600133.65
buyer_1,Luis,28,ES28209599118326557478,TRX_N-02502-27459769,2024-02-07T02:22:01,Bilbao,Expense,basic-services,-226.89,-600360.54
buyer_1,Luis,28,ES28209599118326557478,TRX_N-02503-57807138,2024-02-08T17:30:16,Bilbao,basic_services,phone,-52.97,-600413.51
buyer_1,Luis,28,ES28209599118326557478,TRX_N-02504-93922406,2024-02-08T14:35:35,Bilbao,Expense,technology,-135.7,-600549.21
buyer_1,Luis,28,ES28209599118326557478,TRX_N-02505-12794116,2024-02-08T23:37:10,Berango,Expense,personal_care,-57.01,-600606.22
buyer_1,Luis,28,ES28209599118326557478,TRX_N-02506-97970362,2024-02-08T16:34:58,Bilbao,Expense,technology,-350.67,-600956.89
buyer_1,Luis,28,ES28209599118326557478,TRX_N-02507-54269418,2024-02-09T00:14:33,Bilbao,Expense,housing,-265.45,-601222.34
buyer_1,Luis,28,ES28209599118326557478,TRX_N-02508-97920972,2024-02-09T08:09:07,Bilbao,Expense,food,-475.82,-601698.16
buyer_1,Luis,28,ES28209599118326557478,TRX_N-02509-94405498,2024-02-09T16:30:14,Erandio,Expense,healthcare,-399.51,-602097.67
buyer_1,Luis,28,ES28209599118326557478,TRX_N-02510-40751966,2024-02-10T16:54:20,Bilbao,Expense,healthcare,-118.53,-602216.2
buyer_1,Luis,28,ES28209599118326557478,TRX_N-02511-84985969,2024-02-10T04:56:56,Irun,Expense,subscriptions,-288.38,-602504.58
buyer_1,Luis,28,ES28209599118326557478,TRX_N-02512-76061365,2024-02-10T17:57:24,Bilbao,Expense,transport,-30.39,-602534.97
buyer_1,Luis,28,ES28209599118326557478,TRX_N-02513-93496245,2024-02-11T13:10:11,Bilbao,Expense,children,-42.76,-602577.73
buyer_1,Luis,28,ES28209599118326557478,TRX_N-02514-91552051,2024-02-11T09:49:13,Bilbao,Expense,healthcare,-460.12,-603037.85
buyer_1,Luis,28,ES28209599118326557478,TRX_N-02515-34694309,2024-02-11T15:35:47,Bilbao,Expense,leisure,-250.95,-603288.8
buyer_1,Luis,28,ES28209599118326557478,TRX_N-02516-73379150,2024-02-12T11:55:34,Bilbao,Expense,education,-139.22,-603428.02
buyer_1,Luis,28,ES28209599118326557478,TRX_N-02517-43768878,2024-02-12T11:32:55,Bilbao,Expense,subscriptions,-185.76,-603613.78
buyer_1,Luis,28,ES28209599118326557478,TRX_N-02518-50384215,2024-02-12T05:42:14,Bilbao,Expense,housing,-365.99,-603979.77
buyer_1,Luis,28,ES28209599118326557478,TRX_N-02519-13855293,2024-02-13T18:10:13,Bilbao,Expense,personal_care,-78.75,-604058.52
buyer_1,Luis,28,ES28209599118326557478,TRX_N-02520-11285680,2024-02-13T09:54:45,Mungia,Expense,clothing,-292.34,-604350.86
buyer_1,Luis,28,ES28209599118326557478,TRX_N-02521-37588043,2024-02-13T08:36:43,Bilbao,Expense,clothing,-383.88,-604734.74
buyer_1,Luis,28,ES28209599118326557478,TRX_N-02522-27438824,2024-02-14T11:18:23,Berango,Expense,subscriptions,-291.92,-605026.66
buyer_1,Luis,28,ES28209599118326557478,TRX_N-02523-83895012,2024-02-14T10:45:40,Bilbao,Expense,education,-326.74,-605353.4
buyer_1,Luis,28,ES28209599118326557478,TRX_N-02524-23417434,2024-02-14T20:45:03,Bilbao,Expense,personal_care,-262.71,-605616.11
buyer_1,Luis,28,ES28209599118326557478,TRX_N-02525-11568974,2024-02-15T12:51:14,Bilbao,Expense,basic-services,-137.73,-605753.84
buyer_1,Luis,28,ES28209599118326557478,TRX_N-02526-85273211,2024-02-15T17:09:31,Bilbao,Expense,subscriptions,-49.6,-605803.44
buyer_1,Luis,28,ES28209599118326557478,TRX_N-02527-81676536,2024-02-15T19:51:30,Bilbao,Expense,loans,-277.56,-606081.0
buyer_1,Luis,28,ES28209599118326557478,TRX_N-02528-78588622,2024-02-16T04:12:36,Bilbao,Expense,clothing,-372.26,-606453.26
buyer_1,Luis,28,ES28209599118326557478,TRX_N-02529-41626921,2024-02-16T08:51:32,Bilbao,Expense,subscriptions,-52.05,-606505.31
buyer_1,Luis,28,ES28209599118326557478,TRX_N-02530-51661653,2024-02-16T08:25:30,Leioa,Expense,subscriptions,-80.92,-606586.23
buyer_1,Luis,28,ES28209599118326557478,TRX_N-02531-86769356,2024-02-17T16:06:03,Bilbao,Expense,clothing,-420.69,-607006.92
buyer_1,Luis,28,ES28209599118326557478,TRX_N-02532-07206775,2024-02-17T11:58:28,Bilbao,Expense,food,-196.84,-607203.76
buyer_1,Luis,28,ES28209599118326557478,TRX_N-02533-91959900,2024-02-17T14:29:32,Basauri,Expense,savings,-332.24,-607536.0
buyer_1,Luis,28,ES28209599118326557478,TRX_N-02534-40121120,2024-02-18T19:49:35,Bilbao,Expense,healthcare,-236.19,-607772.19
buyer_1,Luis,28,ES28209599118326557478,TRX_N-02535-59801821,2024-02-18T13:03:43,Bilbao,Expense,leisure,-429.27,-608201.46
buyer_1,Luis,28,ES28209599118326557478,TRX_N-02536-40509162,2024-02-18T17:08:23,Vitoria-Gasteiz,Expense,clothing,-336.89,-608538.35
buyer_1,Luis,28,ES28209599118326557478,TRX_N-02537-44768568,2024-02-19T10:05:06,Bilbao,Expense,savings,-467.04,-609005.39
buyer_1,Luis,28,ES28209599118326557478,TRX_N-02538-31392897,2024-02-19T09:49:20,Bilbao,Expense,car,-141.03,-609146.42
buyer_1,Luis,28,ES28209599118326557478,TRX_N-02539-39396500,2024-02-19T14:23:45,Bilbao,Expense,clothing,-53.32,-609199.74
buyer_1,Luis,28,ES28209599118326557478,TRX_N-02540-28978308,2024-02-20T19:53:09,Bilbao,Expense,personal_care,-447.04,-609646.78
buyer_1,Luis,28,ES28209599118326557478,TRX_N-02541-27246199,2024-02-20T23:20:31,Bilbao,Expense,technology,-18.89,-609665.67
buyer_1,Luis,28,ES28209599118326557478,TRX_N-02542-96434743,2024-02-20T15:55:19,Bermeo,Expense,education,-104.58,-609770.25
buyer_1,Luis,28,ES28209599118326557478,TRX_N-02543-65518893,2024-02-21T10:44:35,Eibar,Expense,transport,-488.6,-610258.85
buyer_1,Luis,28,ES28209599118326557478,TRX_N-02544-25697926,2024-02-21T19:13:43,Bilbao,Expense,technology,-37.97,-610296.82
buyer_1,Luis,28,ES28209599118326557478,TRX_N-02545-95233061,2024-02-21T15:17:14,Bilbao,Expense,leisure,-59.98,-610356.8
buyer_1,Luis,28,ES28209599118326557478,TRX_N-02546-61008054,2024-02-22T16:40:54,Bilbao,Expense,basic-services,-31.66,-610388.46
buyer_1,Luis,28,ES28209599118326557478,TRX_N-02547-12567396,2024-02-22T12:47:19,Bilbao,Expense,healthcare,-252.78,-610641.24
buyer_1,Luis,28,ES28209599118326557478,TRX_N-02548-73921448,2024-02-22T08:19:52,Bilbao,Expense,food,-104.04,-610745.28
buyer_1,Luis,28,ES28209599118326557478,TRX_N-02549-94135668,2024-02-23T16:00:48,Bilbao,Expense,housing,-49.33,-610794.61
buyer_1,Luis,28,ES28209599118326557478,TRX_N-02550-10766482,2024-02-23T18:37:44,Zuia,Expense,children,-210.95,-611005.56
buyer_1,Luis,28,ES28209599118326557478,TRX_N-02551-31086003,2024-02-23T22:49:56,Bilbao,Expense,technology,-179.94,-611185.5
buyer_1,Luis,28,ES28209599118326557478,TRX_N-02552-35320392,2024-02-24T20:23:53,Bilbao,Expense,education,-191.21,-611376.71
buyer_1,Luis,28,ES28209599118326557478,TRX_N-02553-86463983,2024-02-24T20:42:22,Bilbao,Expense,subscriptions,-227.9,-611604.61
buyer_1,Luis,28,ES28209599118326557478,TRX_N-02554-26560223,2024-02-24T10:05:11,Bilbao,Expense,healthcare,-343.79,-611948.4
buyer_1,Luis,28,ES28209599118326557478,TRX_N-02555-26288784,2024-02-25T14:55:48,Bilbao,Expense,food,-134.34,-612082.74
buyer_1,Luis,28,ES28209599118326557478,TRX_N-02556-16139888,2024-02-25T08:48:54,Bilbao,Expense,technology,-267.48,-612350.22
buyer_1,Luis,28,ES28209599118326557478,TRX_N-02557-97369989,2024-02-25T10:40:22,Iruña de Oca,Expense,transport,-67.25,-612417.47
buyer_1,Luis,28,ES28209599118326557478,TRX_N-02558-75696615,2024-02-26T17:21:15,Bilbao,Expense,education,-440.7,-612858.17
buyer_1,Luis,28,ES28209599118326557478,TRX_N-02559-21078616,2024-02-26T19:48:37,Errenteria,Expense,personal_care,-347.6,-613205.77
buyer_1,Luis,28,ES28209599118326557478,TRX_N-02560-41192352,2024-02-26T05:05:26,Amurrio,Expense,education,-246.5,-613452.27
buyer_1,Luis,28,ES28209599118326557478,TRX_N-02561-93292387,2024-02-27T16:37:45,Bilbao,Expense,technology,-496.56,-613948.83
buyer_1,Luis,28,ES28209599118326557478,TRX_N-02562-25333249,2024-02-27T15:38:57,Sestao,Expense,education,-78.98,-614027.81
buyer_1,Luis,28,ES28209599118326557478,TRX_N-02563-23611699,2024-02-27T10:37:53,Arrasate,Expense,technology,-70.86,-614098.67
buyer_1,Luis,28,ES28209599118326557478,TRX_N-02564-47475520,2024-02-28T10:49:45,Erandio,Expense,loans,-109.39,-614208.06
buyer_1,Luis,28,ES28209599118326557478,TRX_N-02565-67724411,2024-02-28T20:03:11,Bilbao,Expense,car,-275.82,-614483.88
buyer_1,Luis,28,ES28209599118326557478,TRX_N-02566-11511012,2024-02-28T10:07:17,Bilbao,Expense,subscriptions,-317.73,-614801.61
buyer_1,Luis,28,ES28209599118326557478,TRX_N-02567-63734144,2024-02-29T15:38:00,Bilbao,Expense,clothing,-74.48,-614876.09
buyer_1,Luis,28,ES28209599118326557478,TRX_N-02568-87015054,2024-02-29T09:38:36,Bilbao,Expense,personal_care,-12.59,-614888.68
buyer_1,Luis,28,ES28209599118326557478,TRX_N-02569-86599163,2024-02-29T12:17:08,Bilbao,Expense,clothing,-249.46,-615138.14
buyer_1,Luis,28,ES28209599118326557478,TRX_N-02570-01808237,2024-03-01T08:54:55,Bilbao,incomes,salary,1265.98,-613872.16
buyer_1,Luis,28,ES28209599118326557478,TRX_N-02571-58280307,2024-03-01T13:51:25,Bilbao,Expense,food,-62.96,-613935.12
buyer_1,Luis,28,ES28209599118326557478,TRX_N-02572-43807322,2024-03-01T17:02:15,Bilbao,Expense,transport,-63.27,-613998.39
buyer_1,Luis,28,ES28209599118326557478,TRX_N-02573-68072398,2024-03-01T07:11:11,Bilbao,Expense,technology,-475.83,-614474.22
buyer_1,Luis,28,ES28209599118326557478,TRX_N-02574-96379134,2024-03-02T12:09:47,Bilbao,Expense,children,-196.32,-614670.54
buyer_1,Luis,28,ES28209599118326557478,TRX_N-02575-49675241,2024-03-02T20:08:02,Bilbao,Expense,personal_care,-37.0,-614707.54
buyer_1,Luis,28,ES28209599118326557478,TRX_N-02576-03134137,2024-03-02T19:14:50,Donostia,Expense,healthcare,-407.64,-615115.18
buyer_1,Luis,28,ES28209599118326557478,TRX_N-02577-62884757,2024-03-03T08:15:14,Bilbao,Expense,education,-481.67,-615596.85
buyer_1,Luis,28,ES28209599118326557478,TRX_N-02578-92735070,2024-03-03T11:51:15,Bilbao,Expense,food,-273.75,-615870.6
buyer_1,Luis,28,ES28209599118326557478,TRX_N-02579-89714096,2024-03-03T17:13:15,Vitoria-Gasteiz,Expense,healthcare,-68.22,-615938.82
buyer_1,Luis,28,ES28209599118326557478,TRX_N-02580-33613024,2024-03-04T13:45:24,Bilbao,Housing,Rent,-1369.49,-617308.31
buyer_1,Luis,28,ES28209599118326557478,TRX_N-02581-04166084,2024-03-04T12:40:57,Salvatierra/Agurain,Expense,housing,-264.96,-617573.27
buyer_1,Luis,28,ES28209599118326557478,TRX_N-02582-05429520,2024-03-04T16:05:49,Bilbao,Expense,leisure,-402.21,-617975.48
buyer_1,Luis,28,ES28209599118326557478,TRX_N-02583-02091797,2024-03-04T11:56:11,Bilbao,Expense,loans,-292.53,-618268.01
buyer_1,Luis,28,ES28209599118326557478,TRX_N-02584-34518573,2024-03-05T17:30:14,Bilbao,basic_services,gas,-78.69,-618346.7
buyer_1,Luis,28,ES28209599118326557478,TRX_N-02585-02437468,2024-03-05T10:42:33,Bilbao,basic_services,internet,-46.33,-618393.03
buyer_1,Luis,28,ES28209599118326557478,TRX_N-02586-85544555,2024-03-05T12:43:52,Bilbao,Expense,education,-257.42,-618650.45
buyer_1,Luis,28,ES28209599118326557478,TRX_N-02587-65857483,2024-03-05T11:59:03,Bilbao,Expense,clothing,-466.66,-619117.11
buyer_1,Luis,28,ES28209599118326557478,TRX_N-02588-20603695,2024-03-05T14:46:00,Bilbao,Expense,leisure,-301.3,-619418.41
buyer_1,Luis,28,ES28209599118326557478,TRX_N-02589-83780018,2024-03-06T21:53:02,Bilbao,Expense,technology,-478.32,-619896.73
buyer_1,Luis,28,ES28209599118326557478,TRX_N-02590-58212622,2024-03-06T12:20:49,Bilbao,Expense,children,-377.85,-620274.58
buyer_1,Luis,28,ES28209599118326557478,TRX_N-02591-42295993,2024-03-06T13:49:13,Bilbao,Expense,loans,-60.49,-620335.07
buyer_1,Luis,28,ES28209599118326557478,TRX_N-02592-84493830,2024-03-07T08:02:34,Bilbao,Expense,transport,-23.27,-620358.34
buyer_1,Luis,28,ES28209599118326557478,TRX_N-02593-94957642,2024-03-07T12:07:00,Bilbao,Expense,technology,-14.26,-620372.6
buyer_1,Luis,28,ES28209599118326557478,TRX_N-02594-24997467,2024-03-07T08:29:14,Bilbao,Expense,healthcare,-241.72,-620614.32
buyer_1,Luis,28,ES28209599118326557478,TRX_N-02595-73492973,2024-03-08T16:42:10,Bilbao,basic_services,water,-11.84,-620626.16
buyer_1,Luis,28,ES28209599118326557478,TRX_N-02596-30431345,2024-03-08T13:24:31,Bilbao,basic_services,electricity,-92.4,-620718.56
buyer_1,Luis,28,ES28209599118326557478,TRX_N-02597-07506224,2024-03-08T17:39:52,Bilbao,basic_services,phone,-87.18,-620805.74
buyer_1,Luis,28,ES28209599118326557478,TRX_N-02598-19425797,2024-03-08T15:07:45,Bilbao,Expense,education,-252.0,-621057.74
buyer_1,Luis,28,ES28209599118326557478,TRX_N-02599-03512313,2024-03-08T13:01:15,Bilbao,Expense,technology,-470.06,-621527.8
buyer_1,Luis,28,ES28209599118326557478,TRX_N-02600-11538373,2024-03-08T18:54:59,Donostia,Expense,personal_care,-290.38,-621818.18
buyer_1,Luis,28,ES28209599118326557478,TRX_N-02601-22602376,2024-03-09T17:20:20,Donostia,Expense,transport,-442.29,-622260.47
buyer_1,Luis,28,ES28209599118326557478,TRX_N-02602-66656435,2024-03-09T16:11:57,Bilbao,Expense,subscriptions,-178.58,-622439.05
buyer_1,Luis,28,ES28209599118326557478,TRX_N-02603-99745079,2024-03-09T17:55:22,Bilbao,Expense,subscriptions,-167.59,-622606.64
buyer_1,Luis,28,ES28209599118326557478,TRX_N-02604-92896641,2024-03-10T12:47:51,Bilbao,Expense,healthcare,-76.46,-622683.1
buyer_1,Luis,28,ES28209599118326557478,TRX_N-02605-69631726,2024-03-10T17:24:47,Bilbao,Expense,clothing,-241.63,-622924.73
buyer_1,Luis,28,ES28209599118326557478,TRX_N-02606-50521707,2024-03-10T12:09:29,Pasaia,Expense,transport,-271.08,-623195.81
buyer_1,Luis,28,ES28209599118326557478,TRX_N-02607-87412444,2024-03-11T08:14:28,Bilbao,Expense,education,-319.73,-623515.54
buyer_1,Luis,28,ES28209599118326557478,TRX_N-02608-30222960,2024-03-11T11:50:24,Bilbao,Expense,personal_care,-334.17,-623849.71
buyer_1,Luis,28,ES28209599118326557478,TRX_N-02609-84108013,2024-03-11T11:24:30,Donostia,Expense,education,-364.78,-624214.49
buyer_1,Luis,28,ES28209599118326557478,TRX_N-02610-91776237,2024-03-12T16:16:23,Bermeo,Expense,technology,-35.2,-624249.69
buyer_1,Luis,28,ES28209599118326557478,TRX_N-02611-24161177,2024-03-12T16:19:16,Bilbao,Expense,housing,-480.79,-624730.48
buyer_1,Luis,28,ES28209599118326557478,TRX_N-02612-80091101,2024-03-12T12:54:00,Bilbao,Expense,subscriptions,-33.98,-624764.46
buyer_1,Luis,28,ES28209599118326557478,TRX_N-02613-01502464,2024-03-13T12:32:16,Bilbao,Expense,education,-73.91,-624838.37
buyer_1,Luis,28,ES28209599118326557478,TRX_N-02614-49822538,2024-03-13T08:17:24,Bilbao,Expense,children,-155.98,-624994.35
buyer_1,Luis,28,ES28209599118326557478,TRX_N-02615-20950608,2024-03-13T20:51:45,Bilbao,Expense,personal_care,-442.26,-625436.61
buyer_1,Luis,28,ES28209599118326557478,TRX_N-02616-87447520,2024-03-14T08:05:22,Bilbao,Expense,car,-66.22,-625502.83
buyer_1,Luis,28,ES28209599118326557478,TRX_N-02617-75854500,2024-03-14T20:51:13,Bilbao,Expense,car,-238.12,-625740.95
buyer_1,Luis,28,ES28209599118326557478,TRX_N-02618-96656080,2024-03-14T15:18:54,Bilbao,Expense,basic-services,-165.63,-625906.58
buyer_1,Luis,28,ES28209599118326557478,TRX_N-02619-56741174,2024-03-15T20:21:16,Bilbao,Expense,loans,-62.34,-625968.92
buyer_1,Luis,28,ES28209599118326557478,TRX_N-02620-76036294,2024-03-15T13:18:18,Bilbao,Expense,savings,-180.14,-626149.06
buyer_1,Luis,28,ES28209599118326557478,TRX_N-02621-78225532,2024-03-15T09:37:23,Bilbao,Expense,personal_care,-212.15,-626361.21
buyer_1,Luis,28,ES28209599118326557478,TRX_N-02622-47636468,2024-03-16T08:15:11,Bilbao,Expense,food,-216.53,-626577.74
buyer_1,Luis,28,ES28209599118326557478,TRX_N-02623-74997551,2024-03-16T12:36:37,Bilbao,Expense,loans,-88.26,-626666.0
buyer_1,Luis,28,ES28209599118326557478,TRX_N-02624-93512502,2024-03-16T16:36:41,Bilbao,Expense,car,-317.73,-626983.73
buyer_1,Luis,28,ES28209599118326557478,TRX_N-02625-94770141,2024-03-17T16:59:46,Bilbao,Expense,savings,-393.37,-627377.1
buyer_1,Luis,28,ES28209599118326557478,TRX_N-02626-99299662,2024-03-17T19:36:40,Elciego,Expense,education,-122.0,-627499.1
buyer_1,Luis,28,ES28209599118326557478,TRX_N-02627-44300360,2024-03-17T12:58:21,Zarautz,Expense,technology,-461.66,-627960.76
buyer_1,Luis,28,ES28209599118326557478,TRX_N-02628-05396162,2024-03-18T10:19:39,Berango,Expense,food,-11.91,-627972.67
buyer_1,Luis,28,ES28209599118326557478,TRX_N-02629-01381498,2024-03-18T14:39:58,Berango,Expense,children,-467.72,-628440.39
buyer_1,Luis,28,ES28209599118326557478,TRX_N-02630-67975631,2024-03-18T20:05:39,Bilbao,Expense,basic-services,-67.97,-628508.36
buyer_1,Luis,28,ES28209599118326557478,TRX_N-02631-47147886,2024-03-19T09:47:14,Bilbao,Expense,subscriptions,-337.22,-628845.58
buyer_1,Luis,28,ES28209599118326557478,TRX_N-02632-62899824,2024-03-19T18:00:27,Vitoria-Gasteiz,Expense,basic-services,-222.0,-629067.58
buyer_1,Luis,28,ES28209599118326557478,TRX_N-02633-68027733,2024-03-19T10:07:19,Bilbao,Expense,loans,-156.03,-629223.61
buyer_1,Luis,28,ES28209599118326557478,TRX_N-02634-86896229,2024-03-20T16:03:47,Bilbao,Expense,housing,-224.78,-629448.39
buyer_1,Luis,28,ES28209599118326557478,TRX_N-02635-21100204,2024-03-20T21:05:21,Bilbao,Expense,children,-403.96,-629852.35
buyer_1,Luis,28,ES28209599118326557478,TRX_N-02636-26831765,2024-03-20T23:49:42,Bilbao,Expense,car,-249.53,-630101.88
buyer_1,Luis,28,ES28209599118326557478,TRX_N-02637-95020389,2024-03-21T17:22:45,Bilbao,Expense,education,-339.57,-630441.45
buyer_1,Luis,28,ES28209599118326557478,TRX_N-02638-97452701,2024-03-21T10:43:45,Bilbao,Expense,leisure,-361.66,-630803.11
buyer_1,Luis,28,ES28209599118326557478,TRX_N-02639-88766614,2024-03-21T10:55:03,Bilbao,Expense,education,-492.52,-631295.63
buyer_1,Luis,28,ES28209599118326557478,TRX_N-02640-33142788,2024-03-22T13:23:51,Bilbao,Expense,personal_care,-77.14,-631372.77
buyer_1,Luis,28,ES28209599118326557478,TRX_N-02641-16824443,2024-03-22T08:19:50,Bilbao,Expense,loans,-215.95,-631588.72
buyer_1,Luis,28,ES28209599118326557478,TRX_N-02642-29746041,2024-03-22T08:05:20,Bilbao,Expense,housing,-17.62,-631606.34
buyer_1,Luis,28,ES28209599118326557478,TRX_N-02643-24916876,2024-03-23T10:00:16,Bilbao,Expense,technology,-239.41,-631845.75
buyer_1,Luis,28,ES28209599118326557478,TRX_N-02644-02849961,2024-03-23T20:11:10,Leioa,Expense,clothing,-106.66,-631952.41
buyer_1,Luis,28,ES28209599118326557478,TRX_N-02645-09849169,2024-03-23T20:16:09,Bilbao,Expense,savings,-288.91,-632241.32
buyer_1,Luis,28,ES28209599118326557478,TRX_N-02646-92366935,2024-03-24T14:04:47,Santurtzi,Expense,transport,-186.0,-632427.32
buyer_1,Luis,28,ES28209599118326557478,TRX_N-02647-85097902,2024-03-24T20:14:21,Mungia,Expense,car,-456.5,-632883.82
buyer_1,Luis,28,ES28209599118326557478,TRX_N-02648-21940596,2024-03-24T19:03:22,Bilbao,Expense,car,-140.04,-633023.86
buyer_1,Luis,28,ES28209599118326557478,TRX_N-02649-69746984,2024-03-25T20:27:51,Bilbao,Expense,healthcare,-219.37,-633243.23
buyer_1,Luis,28,ES28209599118326557478,TRX_N-02650-31569288,2024-03-25T18:16:10,Bilbao,Expense,technology,-40.81,-633284.04
buyer_1,Luis,28,ES28209599118326557478,TRX_N-02651-13510696,2024-03-25T10:59:09,Bilbao,Expense,basic-services,-287.57,-633571.61
buyer_1,Luis,28,ES28209599118326557478,TRX_N-02652-27711692,2024-03-26T11:53:35,Bilbao,Expense,clothing,-97.9,-633669.51
buyer_1,Luis,28,ES28209599118326557478,TRX_N-02653-67213728,2024-03-26T18:49:52,Bilbao,Expense,housing,-255.81,-633925.32
buyer_1,Luis,28,ES28209599118326557478,TRX_N-02654-43698651,2024-03-26T08:34:10,Bilbao,Expense,savings,-201.08,-634126.4
buyer_1,Luis,28,ES28209599118326557478,TRX_N-02655-87790278,2024-03-27T19:25:48,Bermeo,Expense,basic-services,-452.01,-634578.41
buyer_1,Luis,28,ES28209599118326557478,TRX_N-02656-13127778,2024-03-27T21:32:48,Bilbao,Expense,savings,-12.57,-634590.98
buyer_1,Luis,28,ES28209599118326557478,TRX_N-02657-24380800,2024-03-27T15:28:20,Bilbao,Expense,personal_care,-292.82,-634883.8
buyer_1,Luis,28,ES28209599118326557478,TRX_N-02658-13637159,2024-03-28T22:02:51,Getxo,Expense,savings,-278.44,-635162.24
buyer_1,Luis,28,ES28209599118326557478,TRX_N-02659-48832926,2024-03-28T20:14:43,Bilbao,Expense,car,-439.21,-635601.45
buyer_1,Luis,28,ES28209599118326557478,TRX_N-02660-66305519,2024-03-28T16:08:34,Bilbao,Expense,car,-164.16,-635765.61
buyer_1,Luis,28,ES28209599118326557478,TRX_N-02661-57376522,2024-03-29T13:35:43,Bilbao,Expense,food,-455.32,-636220.93
buyer_1,Luis,28,ES28209599118326557478,TRX_N-02662-85994689,2024-03-29T19:23:27,Bilbao,Expense,education,-148.11,-636369.04
buyer_1,Luis,28,ES28209599118326557478,TRX_N-02663-60952347,2024-03-29T11:37:54,Bilbao,Expense,transport,-72.28,-636441.32
buyer_1,Luis,28,ES28209599118326557478,TRX_N-02664-91957455,2024-03-30T19:04:10,Bilbao,Expense,car,-198.04,-636639.36
buyer_1,Luis,28,ES28209599118326557478,TRX_N-02665-53899660,2024-03-30T14:07:20,Bilbao,Expense,basic-services,-460.73,-637100.09
buyer_1,Luis,28,ES28209599118326557478,TRX_N-02666-09623971,2024-03-30T15:42:58,Bilbao,Expense,children,-284.38,-637384.47
buyer_1,Luis,28,ES28209599118326557478,TRX_N-02667-99282920,2024-03-31T09:03:07,Bilbao,Expense,children,-108.29,-637492.76
buyer_1,Luis,28,ES28209599118326557478,TRX_N-02668-24015426,2024-03-31T02:57:37,Mungia,Expense,leisure,-351.13,-637843.89
buyer_1,Luis,28,ES28209599118326557478,TRX_N-02669-00660965,2024-03-31T15:42:28,Bilbao,Expense,clothing,-114.5,-637958.39
buyer_1,Luis,28,ES28209599118326557478,TRX_N-02670-12074900,2024-04-01T09:29:05,Bilbao,incomes,salary,1265.98,-636692.41
buyer_1,Luis,28,ES28209599118326557478,TRX_N-02671-45760933,2024-04-01T09:29:05,Bilbao,incomes,extra_income,126.6,-636565.81
buyer_1,Luis,28,ES28209599118326557478,TRX_N-02672-78081891,2024-04-01T11:51:24,Bilbao,Expense,savings,-397.07,-636962.88
buyer_1,Luis,28,ES28209599118326557478,TRX_N-02673-56818049,2024-04-01T13:45:57,Irun,Expense,basic-services,-157.17,-637120.05
buyer_1,Luis,28,ES28209599118326557478,TRX_N-02674-13107482,2024-04-01T16:28:24,Bermeo,Expense,leisure,-397.62,-637517.67
buyer_1,Luis,28,ES28209599118326557478,TRX_N-02675-56326465,2024-04-02T18:53:11,Bilbao,Expense,transport,-424.6,-637942.27
buyer_1,Luis,28,ES28209599118326557478,TRX_N-02676-67193617,2024-04-02T20:35:10,Bilbao,Expense,healthcare,-243.88,-638186.15
buyer_1,Luis,28,ES28209599118326557478,TRX_N-02677-71859056,2024-04-02T06:37:45,Hondarribia,Expense,subscriptions,-93.88,-638280.03
buyer_1,Luis,28,ES28209599118326557478,TRX_N-02678-95814026,2024-04-03T01:02:52,Bilbao,Expense,leisure,-67.69,-638347.72
buyer_1,Luis,28,ES28209599118326557478,TRX_N-02679-74303429,2024-04-03T23:53:39,Bilbao,Expense,education,-107.49,-638455.21
buyer_1,Luis,28,ES28209599118326557478,TRX_N-02680-16938505,2024-04-03T19:33:16,Bilbao,Expense,children,-490.95,-638946.16
buyer_1,Luis,28,ES28209599118326557478,TRX_N-02681-26644581,2024-04-04T17:26:41,Bilbao,Housing,Rent,-1369.49,-640315.65
buyer_1,Luis,28,ES28209599118326557478,TRX_N-02682-04461517,2024-04-04T13:06:47,Durango,Expense,leisure,-24.26,-640339.91
buyer_1,Luis,28,ES28209599118326557478,TRX_N-02683-54130191,2024-04-04T17:59:36,Bilbao,Expense,children,-407.81,-640747.72
buyer_1,Luis,28,ES28209599118326557478,TRX_N-02684-74174780,2024-04-04T10:02:00,Bilbao,Expense,children,-185.05,-640932.77
buyer_1,Luis,28,ES28209599118326557478,TRX_N-02685-92280782,2024-04-05T10:11:41,Bilbao,Expense,basic-services,-180.08,-641112.85
buyer_1,Luis,28,ES28209599118326557478,TRX_N-02686-83089824,2024-04-05T12:32:24,Bilbao,Expense,food,-45.15,-641158.0
buyer_1,Luis,28,ES28209599118326557478,TRX_N-02687-64936736,2024-04-05T15:39:20,Bilbao,Expense,savings,-403.14,-641561.14
buyer_1,Luis,28,ES28209599118326557478,TRX_N-02688-13396531,2024-04-06T12:15:35,Bilbao,basic_services,electricity,-62.25,-641623.39
buyer_1,Luis,28,ES28209599118326557478,TRX_N-02689-62763178,2024-04-06T13:58:12,Bilbao,basic_services,internet,-64.75,-641688.14
buyer_1,Luis,28,ES28209599118326557478,TRX_N-02690-52689695,2024-04-06T14:27:20,Bilbao,Expense,basic-services,-64.02,-641752.16
buyer_1,Luis,28,ES28209599118326557478,TRX_N-02691-54963789,2024-04-06T17:06:31,Bilbao,Expense,transport,-96.72,-641848.88
buyer_1,Luis,28,ES28209599118326557478,TRX_N-02692-67035531,2024-04-06T13:47:14,Bilbao,Expense,education,-171.04,-642019.92
buyer_1,Luis,28,ES28209599118326557478,TRX_N-02693-92445131,2024-04-07T08:09:50,Bilbao,basic_services,water,-34.52,-642054.44
buyer_1,Luis,28,ES28209599118326557478,TRX_N-02694-95223615,2024-04-07T11:38:34,Bilbao,basic_services,phone,-71.27,-642125.71
buyer_1,Luis,28,ES28209599118326557478,TRX_N-02695-34002752,2024-04-07T12:38:19,Bilbao,Expense,car,-111.58,-642237.29
buyer_1,Luis,28,ES28209599118326557478,TRX_N-02696-38913281,2024-04-07T17:06:50,Bilbao,Expense,education,-341.96,-642579.25
buyer_1,Luis,28,ES28209599118326557478,TRX_N-02697-90219341,2024-04-07T08:16:49,Bilbao,Expense,subscriptions,-135.77,-642715.02
buyer_1,Luis,28,ES28209599118326557478,TRX_N-02698-43121255,2024-04-08T08:23:36,Bilbao,basic_services,gas,-32.68,-642747.7
buyer_1,Luis,28,ES28209599118326557478,TRX_N-02699-92846139,2024-04-08T23:44:19,Bilbao,Expense,savings,-331.05,-643078.75
buyer_1,Luis,28,ES28209599118326557478,TRX_N-02700-29602271,2024-04-08T10:26:40,Bilbao,Expense,clothing,-204.75,-643283.5
buyer_1,Luis,28,ES28209599118326557478,TRX_N-02701-26246205,2024-04-08T17:03:16,Oyón-Oion,Expense,housing,-227.98,-643511.48
buyer_1,Luis,28,ES28209599118326557478,TRX_N-02702-56304724,2024-04-09T19:24:36,Bilbao,Expense,technology,-495.81,-644007.29
buyer_1,Luis,28,ES28209599118326557478,TRX_N-02703-19122725,2024-04-09T22:35:36,Errenteria,Expense,housing,-132.33,-644139.62
buyer_1,Luis,28,ES28209599118326557478,TRX_N-02704-57164869,2024-04-09T17:24:20,Bilbao,Expense,car,-74.34,-644213.96
buyer_1,Luis,28,ES28209599118326557478,TRX_N-02705-82576832,2024-04-10T09:05:16,Bilbao,Expense,education,-172.43,-644386.39
buyer_1,Luis,28,ES28209599118326557478,TRX_N-02706-74320157,2024-04-10T12:25:11,Bilbao,Expense,education,-417.13,-644803.52
buyer_1,Luis,28,ES28209599118326557478,TRX_N-02707-44725539,2024-04-10T12:25:36,Bilbao,Expense,savings,-168.09,-644971.61
buyer_1,Luis,28,ES28209599118326557478,TRX_N-02708-72817171,2024-04-11T18:40:45,Mungia,Expense,leisure,-318.19,-645289.8
buyer_1,Luis,28,ES28209599118326557478,TRX_N-02709-92405566,2024-04-11T22:08:06,Bilbao,Expense,clothing,-234.42,-645524.22
buyer_1,Luis,28,ES28209599118326557478,TRX_N-02710-04456958,2024-04-11T18:07:55,Llodio,Expense,healthcare,-63.26,-645587.48
buyer_1,Luis,28,ES28209599118326557478,TRX_N-02711-37984956,2024-04-12T17:10:47,Bilbao,Expense,technology,-32.65,-645620.13
buyer_1,Luis,28,ES28209599118326557478,TRX_N-02712-30118189,2024-04-12T18:34:41,Bilbao,Expense,leisure,-49.93,-645670.06
buyer_1,Luis,28,ES28209599118326557478,TRX_N-02713-61879729,2024-04-12T18:51:09,Hernani,Expense,transport,-426.34,-646096.4
buyer_1,Luis,28,ES28209599118326557478,TRX_N-02714-50597096,2024-04-13T14:55:53,Bilbao,Expense,car,-298.29,-646394.69
buyer_1,Luis,28,ES28209599118326557478,TRX_N-02715-32490298,2024-04-13T14:14:23,Bilbao,Expense,clothing,-91.96,-646486.65
buyer_1,Luis,28,ES28209599118326557478,TRX_N-02716-13871450,2024-04-13T09:08:33,Bilbao,Expense,food,-187.51,-646674.16
buyer_1,Luis,28,ES28209599118326557478,TRX_N-02717-29000924,2024-04-14T05:30:47,Bilbao,Expense,children,-311.94,-646986.1
buyer_1,Luis,28,ES28209599118326557478,TRX_N-02718-72778072,2024-04-14T11:18:19,Bilbao,Expense,personal_care,-309.5,-647295.6
buyer_1,Luis,28,ES28209599118326557478,TRX_N-02719-36099742,2024-04-14T08:11:02,Bilbao,Expense,subscriptions,-241.25,-647536.85
buyer_1,Luis,28,ES28209599118326557478,TRX_N-02720-15279401,2024-04-15T13:33:28,Bilbao,Expense,housing,-378.01,-647914.86
buyer_1,Luis,28,ES28209599118326557478,TRX_N-02721-74273305,2024-04-15T08:14:58,Bilbao,Expense,transport,-375.15,-648290.01
buyer_1,Luis,28,ES28209599118326557478,TRX_N-02722-03959016,2024-04-15T10:00:05,Bilbao,Expense,children,-64.9,-648354.91
buyer_1,Luis,28,ES28209599118326557478,TRX_N-02723-84599669,2024-04-16T11:32:36,Sestao,Expense,education,-133.38,-648488.29
buyer_1,Luis,28,ES28209599118326557478,TRX_N-02724-29030610,2024-04-16T14:46:58,Bilbao,Expense,savings,-434.53,-648922.82
buyer_1,Luis,28,ES28209599118326557478,TRX_N-02725-15850375,2024-04-16T08:49:33,Bilbao,Expense,subscriptions,-246.85,-649169.67
buyer_1,Luis,28,ES28209599118326557478,TRX_N-02726-26300382,2024-04-17T09:22:30,Bilbao,Expense,children,-143.26,-649312.93
buyer_1,Luis,28,ES28209599118326557478,TRX_N-02727-69960326,2024-04-17T20:52:38,Bilbao,Expense,clothing,-237.95,-649550.88
buyer_1,Luis,28,ES28209599118326557478,TRX_N-02728-66328201,2024-04-17T09:53:00,Bilbao,Expense,healthcare,-163.56,-649714.44
buyer_1,Luis,28,ES28209599118326557478,TRX_N-02729-97211094,2024-04-18T12:40:01,Bilbao,Expense,clothing,-130.39,-649844.83
buyer_1,Luis,28,ES28209599118326557478,TRX_N-02730-27775837,2024-04-18T13:12:41,Bilbao,Expense,education,-24.16,-649868.99
buyer_1,Luis,28,ES28209599118326557478,TRX_N-02731-86725538,2024-04-18T11:40:58,Alegría-Dulantzi,Expense,children,-186.74,-650055.73
buyer_1,Luis,28,ES28209599118326557478,TRX_N-02732-14824933,2024-04-19T05:28:48,Getxo,Expense,transport,-308.18,-650363.91
buyer_1,Luis,28,ES28209599118326557478,TRX_N-02733-63509274,2024-04-19T16:53:10,Bilbao,Expense,food,-462.58,-650826.49
buyer_1,Luis,28,ES28209599118326557478,TRX_N-02734-56411107,2024-04-19T23:38:51,Bermeo,Expense,leisure,-99.28,-650925.77
buyer_1,Luis,28,ES28209599118326557478,TRX_N-02735-05275445,2024-04-20T04:40:51,Vitoria-Gasteiz,Expense,loans,-336.24,-651262.01
buyer_1,Luis,28,ES28209599118326557478,TRX_N-02736-30333354,2024-04-20T16:22:48,Zarautz,Expense,subscriptions,-76.35,-651338.36
buyer_1,Luis,28,ES28209599118326557478,TRX_N-02737-86297871,2024-04-20T20:42:37,Barakaldo,Expense,basic-services,-286.96,-651625.32
buyer_1,Luis,28,ES28209599118326557478,TRX_N-02738-27953235,2024-04-21T20:11:55,Bilbao,Expense,technology,-379.16,-652004.48
buyer_1,Luis,28,ES28209599118326557478,TRX_N-02739-03278353,2024-04-21T09:32:54,Bilbao,Expense,housing,-376.22,-652380.7
buyer_1,Luis,28,ES28209599118326557478,TRX_N-02740-44904021,2024-04-21T12:42:46,Bilbao,Expense,education,-180.22,-652560.92
buyer_1,Luis,28,ES28209599118326557478,TRX_N-02741-46871209,2024-04-22T13:23:19,Bilbao,Expense,transport,-273.79,-652834.71
buyer_1,Luis,28,ES28209599118326557478,TRX_N-02742-85615396,2024-04-22T14:41:51,Bilbao,Expense,personal_care,-64.08,-652898.79
buyer_1,Luis,28,ES28209599118326557478,TRX_N-02743-85568849,2024-04-22T12:27:13,Bilbao,Expense,technology,-123.18,-653021.97
buyer_1,Luis,28,ES28209599118326557478,TRX_N-02744-45929427,2024-04-23T15:57:43,Iruña de Oca,Expense,education,-155.72,-653177.69
buyer_1,Luis,28,ES28209599118326557478,TRX_N-02745-15732184,2024-04-23T22:50:01,Bilbao,Expense,personal_care,-461.47,-653639.16
buyer_1,Luis,28,ES28209599118326557478,TRX_N-02746-52615040,2024-04-23T19:24:53,Bilbao,Expense,education,-237.55,-653876.71
buyer_1,Luis,28,ES28209599118326557478,TRX_N-02747-01886312,2024-04-24T09:59:54,Bilbao,Expense,personal_care,-53.35,-653930.06
buyer_1,Luis,28,ES28209599118326557478,TRX_N-02748-59230833,2024-04-24T14:19:57,Bilbao,Expense,technology,-233.68,-654163.74
buyer_1,Luis,28,ES28209599118326557478,TRX_N-02749-93327717,2024-04-24T14:16:39,Bilbao,Expense,healthcare,-269.75,-654433.49
buyer_1,Luis,28,ES28209599118326557478,TRX_N-02750-31783290,2024-04-25T09:55:50,Bilbao,Expense,education,-234.96,-654668.45
buyer_1,Luis,28,ES28209599118326557478,TRX_N-02751-58734878,2024-04-25T15:19:21,Bilbao,Expense,housing,-238.47,-654906.92
buyer_1,Luis,28,ES28209599118326557478,TRX_N-02752-22006292,2024-04-25T18:10:21,Bilbao,Expense,personal_care,-480.02,-655386.94
buyer_1,Luis,28,ES28209599118326557478,TRX_N-02753-64568776,2024-04-26T10:38:54,Bilbao,Expense,subscriptions,-80.62,-655467.56
buyer_1,Luis,28,ES28209599118326557478,TRX_N-02754-19547871,2024-04-26T01:59:37,Bilbao,Expense,housing,-316.57,-655784.13
buyer_1,Luis,28,ES28209599118326557478,TRX_N-02755-25114597,2024-04-26T16:15:55,Bilbao,Expense,healthcare,-201.39,-655985.52
buyer_1,Luis,28,ES28209599118326557478,TRX_N-02756-03753803,2024-04-27T06:30:22,Bilbao,Expense,loans,-398.24,-656383.76
buyer_1,Luis,28,ES28209599118326557478,TRX_N-02757-26013013,2024-04-27T13:11:41,Bilbao,Expense,subscriptions,-112.97,-656496.73
buyer_1,Luis,28,ES28209599118326557478,TRX_N-02758-03777519,2024-04-27T01:18:33,Bilbao,Expense,housing,-192.21,-656688.94
buyer_1,Luis,28,ES28209599118326557478,TRX_N-02759-09136751,2024-04-28T13:43:04,Bilbao,Expense,personal_care,-107.41,-656796.35
buyer_1,Luis,28,ES28209599118326557478,TRX_N-02760-63800106,2024-04-28T19:59:47,Bilbao,Expense,car,-215.09,-657011.44
buyer_1,Luis,28,ES28209599118326557478,TRX_N-02761-81443329,2024-04-28T11:55:53,Bermeo,Expense,basic-services,-219.92,-657231.36
buyer_1,Luis,28,ES28209599118326557478,TRX_N-02762-46378178,2024-04-29T10:14:13,Bilbao,Expense,basic-services,-14.98,-657246.34
buyer_1,Luis,28,ES28209599118326557478,TRX_N-02763-88188511,2024-04-29T14:15:30,Bilbao,Expense,education,-164.61,-657410.95
buyer_1,Luis,28,ES28209599118326557478,TRX_N-02764-70405919,2024-04-29T19:32:29,Bilbao,Expense,basic-services,-82.59,-657493.54
buyer_1,Luis,28,ES28209599118326557478,TRX_N-02765-78046412,2024-04-30T11:47:20,Sopela,Expense,car,-283.94,-657777.48
buyer_1,Luis,28,ES28209599118326557478,TRX_N-02766-85444240,2024-04-30T16:17:18,Bilbao,Expense,housing,-225.72,-658003.2
buyer_1,Luis,28,ES28209599118326557478,TRX_N-02767-34104674,2024-04-30T19:58:55,Basauri,Expense,children,-31.33,-658034.53
buyer_1,Luis,28,ES28209599118326557478,TRX_N-02768-11493420,2024-05-01T17:50:30,Bilbao,incomes,salary,1265.98,-656768.55
buyer_1,Luis,28,ES28209599118326557478,TRX_N-02769-74821918,2024-05-01T12:56:33,Bilbao,Expense,housing,-401.59,-657170.14
buyer_1,Luis,28,ES28209599118326557478,TRX_N-02770-78894396,2024-05-01T15:19:12,Bilbao,Expense,healthcare,-470.3,-657640.44
buyer_1,Luis,28,ES28209599118326557478,TRX_N-02771-10803102,2024-05-01T04:55:31,Bilbao,Expense,savings,-376.81,-658017.25
buyer_1,Luis,28,ES28209599118326557478,TRX_N-02772-02412730,2024-05-02T08:13:37,Bilbao,Expense,technology,-474.74,-658491.99
buyer_1,Luis,28,ES28209599118326557478,TRX_N-02773-61800462,2024-05-02T19:41:23,Bilbao,Expense,transport,-448.72,-658940.71
buyer_1,Luis,28,ES28209599118326557478,TRX_N-02774-91691325,2024-05-02T16:02:46,Bilbao,Expense,healthcare,-367.21,-659307.92
buyer_1,Luis,28,ES28209599118326557478,TRX_N-02775-84074623,2024-05-03T13:18:20,Bilbao,Expense,education,-150.24,-659458.16
buyer_1,Luis,28,ES28209599118326557478,TRX_N-02776-41158610,2024-05-03T13:18:50,Bilbao,Expense,housing,-95.16,-659553.32
buyer_1,Luis,28,ES28209599118326557478,TRX_N-02777-91503976,2024-05-03T20:46:12,Portugalete,Expense,housing,-100.65,-659653.97
buyer_1,Luis,28,ES28209599118326557478,TRX_N-02778-72388118,2024-05-04T12:18:20,Bilbao,Housing,Rent,-1369.49,-661023.46
buyer_1,Luis,28,ES28209599118326557478,TRX_N-02779-55755775,2024-05-04T15:50:19,Durango,Expense,housing,-37.25,-661060.71
buyer_1,Luis,28,ES28209599118326557478,TRX_N-02780-29676013,2024-05-04T20:43:56,Bilbao,Expense,technology,-341.81,-661402.52
buyer_1,Luis,28,ES28209599118326557478,TRX_N-02781-86838109,2024-05-04T15:52:08,Bilbao,Expense,clothing,-202.18,-661604.7
buyer_1,Luis,28,ES28209599118326557478,TRX_N-02782-81182063,2024-05-05T08:04:02,Bilbao,basic_services,water,-69.44,-661674.14
buyer_1,Luis,28,ES28209599118326557478,TRX_N-02783-11948650,2024-05-05T17:11:02,Llodio,Expense,education,-426.27,-662100.41
buyer_1,Luis,28,ES28209599118326557478,TRX_N-02784-89233048,2024-05-05T18:33:44,Santurtzi,Expense,subscriptions,-201.28,-662301.69
buyer_1,Luis,28,ES28209599118326557478,TRX_N-02785-53377114,2024-05-05T21:46:06,Bilbao,Expense,food,-473.43,-662775.12
buyer_1,Luis,28,ES28209599118326557478,TRX_N-02786-27797528,2024-05-06T18:40:23,Bilbao,basic_services,electricity,-47.24,-662822.36
buyer_1,Luis,28,ES28209599118326557478,TRX_N-02787-06465716,2024-05-06T04:59:12,Bilbao,basic_services,internet,-39.75,-662862.11
buyer_1,Luis,28,ES28209599118326557478,TRX_N-02788-62898823,2024-05-06T20:35:52,Bilbao,Expense,basic-services,-90.59,-662952.7
buyer_1,Luis,28,ES28209599118326557478,TRX_N-02789-63172051,2024-05-06T18:17:51,Bilbao,Expense,savings,-78.32,-663031.02
buyer_1,Luis,28,ES28209599118326557478,TRX_N-02790-93777859,2024-05-06T20:50:24,Arrasate,Expense,education,-442.66,-663473.68
buyer_1,Luis,28,ES28209599118326557478,TRX_N-02791-56460852,2024-05-07T08:03:39,Bilbao,basic_services,gas,-32.4,-663506.08
buyer_1,Luis,28,ES28209599118326557478,TRX_N-02792-84208084,2024-05-07T19:33:03,Bilbao,basic_services,phone,-69.25,-663575.33
buyer_1,Luis,28,ES28209599118326557478,TRX_N-02793-81861289,2024-05-07T14:03:04,Bilbao,Expense,subscriptions,-280.26,-663855.59
buyer_1,Luis,28,ES28209599118326557478,TRX_N-02794-84932487,2024-05-07T10:43:07,Bilbao,Expense,savings,-416.65,-664272.24
buyer_1,Luis,28,ES28209599118326557478,TRX_N-02795-15525043,2024-05-07T13:55:06,Bilbao,Expense,clothing,-422.89,-664695.13
buyer_1,Luis,28,ES28209599118326557478,TRX_N-02796-79089507,2024-05-08T08:22:23,Zarautz,Expense,loans,-491.47,-665186.6
buyer_1,Luis,28,ES28209599118326557478,TRX_N-02797-38285186,2024-05-08T08:15:19,Bilbao,Expense,savings,-457.0,-665643.6
buyer_1,Luis,28,ES28209599118326557478,TRX_N-02798-85075337,2024-05-08T08:10:19,Bilbao,Expense,transport,-252.67,-665896.27
buyer_1,Luis,28,ES28209599118326557478,TRX_N-02799-91248750,2024-05-09T19:21:10,Bilbao,Expense,car,-493.65,-666389.92
buyer_1,Luis,28,ES28209599118326557478,TRX_N-02800-54455369,2024-05-09T17:16:32,Bilbao,Expense,clothing,-357.85,-666747.77
buyer_1,Luis,28,ES28209599118326557478,TRX_N-02801-15742449,2024-05-09T02:26:59,Bilbao,Expense,children,-374.58,-667122.35
buyer_1,Luis,28,ES28209599118326557478,TRX_N-02802-87790355,2024-05-10T13:08:27,Bilbao,Expense,subscriptions,-377.93,-667500.28
buyer_1,Luis,28,ES28209599118326557478,TRX_N-02803-60523121,2024-05-10T07:05:11,Bilbao,Expense,housing,-51.11,-667551.39
buyer_1,Luis,28,ES28209599118326557478,TRX_N-02804-51299191,2024-05-10T19:53:49,Labastida,Expense,technology,-57.41,-667608.8
buyer_1,Luis,28,ES28209599118326557478,TRX_N-02805-11891978,2024-05-11T16:33:55,Donostia,Expense,clothing,-158.52,-667767.32
buyer_1,Luis,28,ES28209599118326557478,TRX_N-02806-84561086,2024-05-11T10:57:27,Bilbao,Expense,basic-services,-95.0,-667862.32
buyer_1,Luis,28,ES28209599118326557478,TRX_N-02807-76700599,2024-05-11T17:34:39,Bilbao,Expense,education,-251.27,-668113.59
buyer_1,Luis,28,ES28209599118326557478,TRX_N-02808-11189289,2024-05-12T09:46:56,Bilbao,Expense,housing,-393.94,-668507.53
buyer_1,Luis,28,ES28209599118326557478,TRX_N-02809-91518389,2024-05-12T18:46:19,Bilbao,Expense,leisure,-74.77,-668582.3
buyer_1,Luis,28,ES28209599118326557478,TRX_N-02810-72768010,2024-05-12T16:01:36,Labastida,Expense,education,-178.58,-668760.88
buyer_1,Luis,28,ES28209599118326557478,TRX_N-02811-75398942,2024-05-13T10:20:57,Bilbao,Expense,subscriptions,-169.08,-668929.96
buyer_1,Luis,28,ES28209599118326557478,TRX_N-02812-03761936,2024-05-13T11:47:24,Bilbao,Expense,children,-44.1,-668974.06
buyer_1,Luis,28,ES28209599118326557478,TRX_N-02813-76664418,2024-05-13T05:56:37,Bilbao,Expense,children,-195.7,-669169.76
buyer_1,Luis,28,ES28209599118326557478,TRX_N-02814-79467804,2024-05-14T18:30:01,Bilbao,Expense,food,-104.89,-669274.65
buyer_1,Luis,28,ES28209599118326557478,TRX_N-02815-19247317,2024-05-14T16:40:54,Bilbao,Expense,housing,-314.8,-669589.45
buyer_1,Luis,28,ES28209599118326557478,TRX_N-02816-56592449,2024-05-14T12:14:58,Zarautz,Expense,children,-493.99,-670083.44
buyer_1,Luis,28,ES28209599118326557478,TRX_N-02817-05763463,2024-05-15T18:47:37,Bilbao,Expense,savings,-325.21,-670408.65
buyer_1,Luis,28,ES28209599118326557478,TRX_N-02818-00162951,2024-05-15T16:03:50,Barakaldo,Expense,car,-13.94,-670422.59
buyer_1,Luis,28,ES28209599118326557478,TRX_N-02819-22157861,2024-05-15T12:11:06,Bilbao,Expense,loans,-293.27,-670715.86
buyer_1,Luis,28,ES28209599118326557478,TRX_N-02820-03443474,2024-05-16T10:49:24,Alegría-Dulantzi,Expense,leisure,-295.79,-671011.65
buyer_1,Luis,28,ES28209599118326557478,TRX_N-02821-23074243,2024-05-16T13:41:58,Bilbao,Expense,education,-360.47,-671372.12
buyer_1,Luis,28,ES28209599118326557478,TRX_N-02822-64784651,2024-05-16T18:03:50,Bilbao,Expense,technology,-394.36,-671766.48
buyer_1,Luis,28,ES28209599118326557478,TRX_N-02823-04498637,2024-05-17T19:16:11,Bilbao,Expense,education,-295.05,-672061.53
buyer_1,Luis,28,ES28209599118326557478,TRX_N-02824-69049961,2024-05-17T17:14:05,Bilbao,Expense,personal_care,-188.71,-672250.24
buyer_1,Luis,28,ES28209599118326557478,TRX_N-02825-46117870,2024-05-17T09:30:13,Bilbao,Expense,transport,-438.16,-672688.4
buyer_1,Luis,28,ES28209599118326557478,TRX_N-02826-97527621,2024-05-18T11:17:54,Bilbao,Expense,food,-74.83,-672763.23
buyer_1,Luis,28,ES28209599118326557478,TRX_N-02827-12482207,2024-05-18T23:50:20,Bilbao,Expense,basic-services,-52.56,-672815.79
buyer_1,Luis,28,ES28209599118326557478,TRX_N-02828-80777310,2024-05-18T21:06:13,Bilbao,Expense,loans,-92.13,-672907.92
buyer_1,Luis,28,ES28209599118326557478,TRX_N-02829-00073587,2024-05-19T14:54:20,Bilbao,Expense,loans,-449.65,-673357.57
buyer_1,Luis,28,ES28209599118326557478,TRX_N-02830-25616025,2024-05-19T19:46:40,Bilbao,Expense,technology,-339.36,-673696.93
buyer_1,Luis,28,ES28209599118326557478,TRX_N-02831-63395920,2024-05-19T09:53:03,Bilbao,Expense,children,-394.05,-674090.98
buyer_1,Luis,28,ES28209599118326557478,TRX_N-02832-31317460,2024-05-20T19:51:40,Bilbao,Expense,leisure,-282.3,-674373.28
buyer_1,Luis,28,ES28209599118326557478,TRX_N-02833-54441673,2024-05-20T17:04:09,Bilbao,Expense,technology,-208.59,-674581.87
buyer_1,Luis,28,ES28209599118326557478,TRX_N-02834-29137196,2024-05-20T19:57:58,Bilbao,Expense,education,-440.01,-675021.88
buyer_1,Luis,28,ES28209599118326557478,TRX_N-02835-62615957,2024-05-21T20:53:13,Bilbao,Expense,personal_care,-279.39,-675301.27
buyer_1,Luis,28,ES28209599118326557478,TRX_N-02836-47738191,2024-05-21T10:11:14,Sopela,Expense,subscriptions,-90.02,-675391.29
buyer_1,Luis,28,ES28209599118326557478,TRX_N-02837-03381652,2024-05-21T19:07:13,Bilbao,Expense,leisure,-151.94,-675543.23
buyer_1,Luis,28,ES28209599118326557478,TRX_N-02838-22703512,2024-05-22T15:10:40,Salvatierra/Agurain,Expense,basic-services,-483.41,-676026.64
buyer_1,Luis,28,ES28209599118326557478,TRX_N-02839-01247709,2024-05-22T20:51:40,Bilbao,Expense,basic-services,-13.16,-676039.8
buyer_1,Luis,28,ES28209599118326557478,TRX_N-02840-44670325,2024-05-22T17:07:13,Amurrio,Expense,education,-216.8,-676256.6
buyer_1,Luis,28,ES28209599118326557478,TRX_N-02841-27711568,2024-05-23T20:45:13,Bilbao,Expense,housing,-381.16,-676637.76
buyer_1,Luis,28,ES28209599118326557478,TRX_N-02842-02435614,2024-05-23T12:30:43,Eibar,Expense,housing,-176.74,-676814.5
buyer_1,Luis,28,ES28209599118326557478,TRX_N-02843-66010069,2024-05-23T20:14:21,Bilbao,Expense,subscriptions,-149.98,-676964.48
buyer_1,Luis,28,ES28209599118326557478,TRX_N-02844-81271518,2024-05-24T01:08:19,Bilbao,Expense,healthcare,-235.3,-677199.78
buyer_1,Luis,28,ES28209599118326557478,TRX_N-02845-08186134,2024-05-24T19:20:13,Bilbao,Expense,children,-317.63,-677517.41
buyer_1,Luis,28,ES28209599118326557478,TRX_N-02846-36331916,2024-05-24T14:48:41,Bilbao,Expense,basic-services,-267.5,-677784.91
buyer_1,Luis,28,ES28209599118326557478,TRX_N-02847-14784191,2024-05-25T17:00:04,Bilbao,Expense,basic-services,-170.32,-677955.23
buyer_1,Luis,28,ES28209599118326557478,TRX_N-02848-08332717,2024-05-25T11:30:30,Bilbao,Expense,food,-401.37,-678356.6
buyer_1,Luis,28,ES28209599118326557478,TRX_N-02849-26003318,2024-05-25T12:39:01,Bilbao,Expense,loans,-159.56,-678516.16
buyer_1,Luis,28,ES28209599118326557478,TRX_N-02850-46139223,2024-05-26T22:10:14,Bilbao,Expense,education,-364.12,-678880.28
buyer_1,Luis,28,ES28209599118326557478,TRX_N-02851-36386915,2024-05-26T22:43:14,Hondarribia,Expense,savings,-300.87,-679181.15
buyer_1,Luis,28,ES28209599118326557478,TRX_N-02852-80856129,2024-05-26T15:48:19,Bilbao,Expense,healthcare,-391.9,-679573.05
buyer_1,Luis,28,ES28209599118326557478,TRX_N-02853-48742579,2024-05-27T21:05:17,Bilbao,Expense,transport,-355.98,-679929.03
buyer_1,Luis,28,ES28209599118326557478,TRX_N-02854-22031961,2024-05-27T18:11:55,Berango,Expense,savings,-70.83,-679999.86
buyer_1,Luis,28,ES28209599118326557478,TRX_N-02855-92027340,2024-05-27T11:54:44,Bilbao,Expense,children,-424.55,-680424.41
buyer_1,Luis,28,ES28209599118326557478,TRX_N-02856-98725977,2024-05-28T14:52:21,Elciego,Expense,personal_care,-211.62,-680636.03
buyer_1,Luis,28,ES28209599118326557478,TRX_N-02857-96975391,2024-05-28T15:45:14,Bilbao,Expense,basic-services,-166.95,-680802.98
buyer_1,Luis,28,ES28209599118326557478,TRX_N-02858-18950093,2024-05-28T11:28:04,Bilbao,Expense,children,-249.05,-681052.03
buyer_1,Luis,28,ES28209599118326557478,TRX_N-02859-43277181,2024-05-29T15:13:09,Bilbao,Expense,clothing,-58.35,-681110.38
buyer_1,Luis,28,ES28209599118326557478,TRX_N-02860-47896828,2024-05-29T23:57:08,Bilbao,Expense,clothing,-112.23,-681222.61
buyer_1,Luis,28,ES28209599118326557478,TRX_N-02861-74863103,2024-05-29T06:10:03,Bilbao,Expense,car,-113.83,-681336.44
buyer_1,Luis,28,ES28209599118326557478,TRX_N-02862-16473499,2024-05-30T05:17:51,Bilbao,Expense,subscriptions,-432.5,-681768.94
buyer_1,Luis,28,ES28209599118326557478,TRX_N-02863-70079308,2024-05-30T18:17:35,Bilbao,Expense,subscriptions,-391.33,-682160.27
buyer_1,Luis,28,ES28209599118326557478,TRX_N-02864-15449833,2024-05-30T09:59:13,Bilbao,Expense,basic-services,-222.72,-682382.99
buyer_1,Luis,28,ES28209599118326557478,TRX_N-02865-00691929,2024-05-31T12:22:45,Llodio,Expense,healthcare,-49.76,-682432.75
buyer_1,Luis,28,ES28209599118326557478,TRX_N-02866-51841103,2024-05-31T11:50:33,Bilbao,Expense,basic-services,-95.12,-682527.87
buyer_1,Luis,28,ES28209599118326557478,TRX_N-02867-50311540,2024-05-31T18:15:10,Bilbao,Expense,transport,-414.98,-682942.85
buyer_1,Luis,28,ES28209599118326557478,TRX_N-02868-45045283,2024-06-01T19:58:04,Bilbao,incomes,salary,1265.98,-681676.87
buyer_1,Luis,28,ES28209599118326557478,TRX_N-02869-85717441,2024-06-01T19:58:04,Bilbao,incomes,salary_extra,1004.48,-680672.39
buyer_1,Luis,28,ES28209599118326557478,TRX_N-02870-53024991,2024-06-01T14:32:23,Bilbao,Expense,healthcare,-339.17,-681011.56
buyer_1,Luis,28,ES28209599118326557478,TRX_N-02871-68565445,2024-06-01T14:18:17,Bilbao,Expense,children,-252.36,-681263.92
buyer_1,Luis,28,ES28209599118326557478,TRX_N-02872-83010673,2024-06-01T16:40:08,Bilbao,Expense,healthcare,-38.63,-681302.55
buyer_1,Luis,28,ES28209599118326557478,TRX_N-02873-72837459,2024-06-02T20:33:13,Bilbao,Expense,transport,-75.7,-681378.25
buyer_1,Luis,28,ES28209599118326557478,TRX_N-02874-58061784,2024-06-02T13:38:52,Bilbao,Expense,children,-378.8,-681757.05
buyer_1,Luis,28,ES28209599118326557478,TRX_N-02875-88152442,2024-06-02T02:04:15,Bilbao,Expense,children,-195.88,-681952.93
buyer_1,Luis,28,ES28209599118326557478,TRX_N-02876-80914509,2024-06-03T17:30:08,Bilbao,Expense,healthcare,-232.62,-682185.55
buyer_1,Luis,28,ES28209599118326557478,TRX_N-02877-93981425,2024-06-03T10:38:27,Bilbao,Expense,savings,-306.05,-682491.6
buyer_1,Luis,28,ES28209599118326557478,TRX_N-02878-49367915,2024-06-03T09:16:45,Galdakao,Expense,leisure,-495.21,-682986.81
buyer_1,Luis,28,ES28209599118326557478,TRX_N-02879-71174622,2024-06-04T14:15:08,Bilbao,Housing,Rent,-1369.49,-684356.3
buyer_1,Luis,28,ES28209599118326557478,TRX_N-02880-51022628,2024-06-04T15:15:41,Bilbao,annual_bills,taxes,-1790.06,-686146.36
buyer_1,Luis,28,ES28209599118326557478,TRX_N-02881-00533878,2024-06-04T19:34:51,Bilbao,annual_bills,insurance,-1478.51,-687624.87
buyer_1,Luis,28,ES28209599118326557478,TRX_N-02882-00202898,2024-06-04T09:14:20,Bilbao,Expense,technology,-493.57,-688118.44
buyer_1,Luis,28,ES28209599118326557478,TRX_N-02883-71422730,2024-06-04T16:36:20,Bilbao,Expense,car,-258.16,-688376.6
buyer_1,Luis,28,ES28209599118326557478,TRX_N-02884-35036932,2024-06-04T22:47:59,Sestao,Expense,leisure,-403.28,-688779.88
buyer_1,Luis,28,ES28209599118326557478,TRX_N-02885-31488853,2024-06-05T13:37:04,Bilbao,basic_services,internet,-49.72,-688829.6
buyer_1,Luis,28,ES28209599118326557478,TRX_N-02886-23551386,2024-06-05T16:27:40,Bilbao,basic_services,phone,-55.81,-688885.41
buyer_1,Luis,28,ES28209599118326557478,TRX_N-02887-59124128,2024-06-05T18:48:29,Bilbao,Expense,basic-services,-418.49,-689303.9
buyer_1,Luis,28,ES28209599118326557478,TRX_N-02888-32585463,2024-06-05T09:12:52,Bilbao,Expense,leisure,-412.27,-689716.17
buyer_1,Luis,28,ES28209599118326557478,TRX_N-02889-52546579,2024-06-05T10:49:01,Bilbao,Expense,savings,-404.18,-690120.35
buyer_1,Luis,28,ES28209599118326557478,TRX_N-02890-54818135,2024-06-06T09:07:41,Bilbao,Expense,healthcare,-197.39,-690317.74
buyer_1,Luis,28,ES28209599118326557478,TRX_N-02891-82500813,2024-06-06T10:12:15,Hondarribia,Expense,healthcare,-79.99,-690397.73
buyer_1,Luis,28,ES28209599118326557478,TRX_N-02892-70047810,2024-06-06T12:16:52,Bilbao,Expense,education,-395.43,-690793.16
buyer_1,Luis,28,ES28209599118326557478,TRX_N-02893-68324043,2024-06-07T11:06:53,Hernani,Expense,children,-459.41,-691252.57
buyer_1,Luis,28,ES28209599118326557478,TRX_N-02894-89335376,2024-06-07T14:41:07,Bilbao,Expense,children,-443.21,-691695.78
buyer_1,Luis,28,ES28209599118326557478,TRX_N-02895-49223936,2024-06-07T20:44:54,Bilbao,Expense,savings,-343.26,-692039.04
buyer_1,Luis,28,ES28209599118326557478,TRX_N-02896-84596167,2024-06-08T15:38:15,Bilbao,basic_services,electricity,-96.64,-692135.68
buyer_1,Luis,28,ES28209599118326557478,TRX_N-02897-97729269,2024-06-08T08:33:15,Bilbao,basic_services,water,-38.21,-692173.89
buyer_1,Luis,28,ES28209599118326557478,TRX_N-02898-76899319,2024-06-08T10:45:11,Bilbao,basic_services,gas,-63.93,-692237.82
buyer_1,Luis,28,ES28209599118326557478,TRX_N-02899-62229971,2024-06-08T01:48:08,Bilbao,Expense,basic-services,-269.87,-692507.69
buyer_1,Luis,28,ES28209599118326557478,TRX_N-02900-31830535,2024-06-08T23:54:40,Bilbao,Expense,car,-226.53,-692734.22
buyer_1,Luis,28,ES28209599118326557478,TRX_N-02901-02182982,2024-06-08T14:08:40,Bilbao,Expense,food,-29.46,-692763.68
buyer_1,Luis,28,ES28209599118326557478,TRX_N-02902-66314371,2024-06-09T11:23:03,Bilbao,Expense,housing,-287.28,-693050.96
buyer_1,Luis,28,ES28209599118326557478,TRX_N-02903-22368094,2024-06-09T11:59:39,Bilbao,Expense,basic-services,-495.14,-693546.1
buyer_1,Luis,28,ES28209599118326557478,TRX_N-02904-29924711,2024-06-09T20:38:30,Barakaldo,Expense,loans,-213.32,-693759.42
buyer_1,Luis,28,ES28209599118326557478,TRX_N-02905-13624818,2024-06-10T10:50:54,Elciego,Expense,car,-441.0,-694200.42
buyer_1,Luis,28,ES28209599118326557478,TRX_N-02906-62562608,2024-06-10T00:46:57,Bilbao,Expense,car,-494.09,-694694.51
buyer_1,Luis,28,ES28209599118326557478,TRX_N-02907-29000358,2024-06-10T09:41:28,Bilbao,Expense,clothing,-403.45,-695097.96
buyer_1,Luis,28,ES28209599118326557478,TRX_N-02908-98707228,2024-06-11T08:05:42,Bilbao,Expense,car,-488.54,-695586.5
buyer_1,Luis,28,ES28209599118326557478,TRX_N-02909-45405328,2024-06-11T20:52:53,Bilbao,Expense,personal_care,-218.0,-695804.5
buyer_1,Luis,28,ES28209599118326557478,TRX_N-02910-14114920,2024-06-11T00:34:07,Bilbao,Expense,housing,-400.45,-696204.95
buyer_1,Luis,28,ES28209599118326557478,TRX_N-02911-95517395,2024-06-12T17:47:28,Bilbao,Expense,transport,-499.91,-696704.86
buyer_1,Luis,28,ES28209599118326557478,TRX_N-02912-41633769,2024-06-12T17:29:17,Bilbao,Expense,children,-296.05,-697000.91
buyer_1,Luis,28,ES28209599118326557478,TRX_N-02913-17244511,2024-06-12T17:12:01,Barakaldo,Expense,basic-services,-267.97,-697268.88
buyer_1,Luis,28,ES28209599118326557478,TRX_N-02914-53731078,2024-06-13T18:11:50,Bilbao,Expense,housing,-176.49,-697445.37
buyer_1,Luis,28,ES28209599118326557478,TRX_N-02915-86852039,2024-06-13T15:46:57,Bilbao,Expense,personal_care,-468.53,-697913.9
buyer_1,Luis,28,ES28209599118326557478,TRX_N-02916-64679834,2024-06-13T18:33:28,Bilbao,Expense,savings,-29.38,-697943.28
buyer_1,Luis,28,ES28209599118326557478,TRX_N-02917-02372924,2024-06-14T20:13:41,Bilbao,Expense,loans,-328.76,-698272.04
buyer_1,Luis,28,ES28209599118326557478,TRX_N-02918-15244338,2024-06-14T19:24:01,Bilbao,Expense,leisure,-382.23,-698654.27
buyer_1,Luis,28,ES28209599118326557478,TRX_N-02919-64707820,2024-06-14T13:56:48,Bilbao,Expense,basic-services,-298.01,-698952.28
buyer_1,Luis,28,ES28209599118326557478,TRX_N-02920-73145540,2024-06-15T08:14:07,Sopela,Expense,subscriptions,-180.98,-699133.26
buyer_1,Luis,28,ES28209599118326557478,TRX_N-02921-37090265,2024-06-15T08:09:20,Bilbao,Expense,personal_care,-75.3,-699208.56
buyer_1,Luis,28,ES28209599118326557478,TRX_N-02922-76535635,2024-06-15T08:38:36,Bilbao,Expense,healthcare,-463.17,-699671.73
buyer_1,Luis,28,ES28209599118326557478,TRX_N-02923-10533391,2024-06-16T14:28:36,Bilbao,Expense,subscriptions,-248.1,-699919.83
buyer_1,Luis,28,ES28209599118326557478,TRX_N-02924-84008221,2024-06-16T16:07:24,Getxo,Expense,basic-services,-317.94,-700237.77
buyer_1,Luis,28,ES28209599118326557478,TRX_N-02925-66012318,2024-06-16T12:41:01,Erandio,Expense,basic-services,-217.61,-700455.38
buyer_1,Luis,28,ES28209599118326557478,TRX_N-02926-10958296,2024-06-17T10:53:47,Bermeo,Expense,loans,-394.1,-700849.48
buyer_1,Luis,28,ES28209599118326557478,TRX_N-02927-06129506,2024-06-17T13:54:40,Bilbao,Expense,children,-31.38,-700880.86
buyer_1,Luis,28,ES28209599118326557478,TRX_N-02928-02993364,2024-06-17T10:57:24,Bilbao,Expense,car,-319.91,-701200.77
buyer_1,Luis,28,ES28209599118326557478,TRX_N-02929-36835659,2024-06-18T21:55:12,Bilbao,Expense,car,-79.89,-701280.66
buyer_1,Luis,28,ES28209599118326557478,TRX_N-02930-57250825,2024-06-18T18:04:30,Bilbao,Expense,car,-86.49,-701367.15
buyer_1,Luis,28,ES28209599118326557478,TRX_N-02931-92076428,2024-06-18T19:34:34,Bilbao,Expense,transport,-308.47,-701675.62
buyer_1,Luis,28,ES28209599118326557478,TRX_N-02932-29384893,2024-06-19T17:34:40,Bilbao,Expense,leisure,-116.82,-701792.44
buyer_1,Luis,28,ES28209599118326557478,TRX_N-02933-24908198,2024-06-19T16:25:48,Bilbao,Expense,healthcare,-281.23,-702073.67
buyer_1,Luis,28,ES28209599118326557478,TRX_N-02934-46267738,2024-06-19T09:56:11,Bilbao,Expense,education,-132.16,-702205.83
buyer_1,Luis,28,ES28209599118326557478,TRX_N-02935-44510752,2024-06-20T15:50:42,Bilbao,Expense,children,-417.38,-702623.21
buyer_1,Luis,28,ES28209599118326557478,TRX_N-02936-03033898,2024-06-20T15:14:19,Bilbao,Expense,basic-services,-179.33,-702802.54
buyer_1,Luis,28,ES28209599118326557478,TRX_N-02937-68530629,2024-06-20T05:05:58,Bilbao,Expense,children,-108.71,-702911.25
buyer_1,Luis,28,ES28209599118326557478,TRX_N-02938-61582356,2024-06-21T20:14:21,Hondarribia,Expense,healthcare,-65.88,-702977.13
buyer_1,Luis,28,ES28209599118326557478,TRX_N-02939-14670280,2024-06-21T23:02:56,Bilbao,Expense,subscriptions,-57.07,-703034.2
buyer_1,Luis,28,ES28209599118326557478,TRX_N-02940-30454192,2024-06-21T10:06:05,Bilbao,Expense,savings,-379.69,-703413.89
buyer_1,Luis,28,ES28209599118326557478,TRX_N-02941-68565498,2024-06-22T23:47:47,Bilbao,Expense,leisure,-95.62,-703509.51
buyer_1,Luis,28,ES28209599118326557478,TRX_N-02942-02878333,2024-06-22T10:47:43,Bilbao,Expense,transport,-339.38,-703848.89
buyer_1,Luis,28,ES28209599118326557478,TRX_N-02943-97421710,2024-06-22T10:07:37,Bilbao,Expense,housing,-427.41,-704276.3
buyer_1,Luis,28,ES28209599118326557478,TRX_N-02944-77596178,2024-06-23T14:15:02,Bilbao,Expense,car,-239.99,-704516.29
buyer_1,Luis,28,ES28209599118326557478,TRX_N-02945-52376523,2024-06-23T09:30:52,Bilbao,Expense,food,-30.53,-704546.82
buyer_1,Luis,28,ES28209599118326557478,TRX_N-02946-59045502,2024-06-23T12:33:23,Bilbao,Expense,children,-83.28,-704630.1
buyer_1,Luis,28,ES28209599118326557478,TRX_N-02947-05574449,2024-06-24T07:49:43,Bilbao,Expense,loans,-86.03,-704716.13
buyer_1,Luis,28,ES28209599118326557478,TRX_N-02948-40554150,2024-06-24T23:32:06,Bilbao,Expense,savings,-265.24,-704981.37
buyer_1,Luis,28,ES28209599118326557478,TRX_N-02949-15276476,2024-06-24T15:51:32,Bilbao,Expense,loans,-120.75,-705102.12
buyer_1,Luis,28,ES28209599118326557478,TRX_N-02950-60110769,2024-06-25T08:37:44,Hondarribia,Expense,subscriptions,-214.16,-705316.28
buyer_1,Luis,28,ES28209599118326557478,TRX_N-02951-31177253,2024-06-25T15:39:06,Andoain,Expense,children,-495.79,-705812.07
buyer_1,Luis,28,ES28209599118326557478,TRX_N-02952-50828689,2024-06-25T14:06:24,Bilbao,Expense,transport,-357.16,-706169.23
buyer_1,Luis,28,ES28209599118326557478,TRX_N-02953-00587576,2024-06-26T10:27:17,Bilbao,Expense,healthcare,-24.25,-706193.48
buyer_1,Luis,28,ES28209599118326557478,TRX_N-02954-88329459,2024-06-26T10:13:30,Bilbao,Expense,personal_care,-135.57,-706329.05
buyer_1,Luis,28,ES28209599118326557478,TRX_N-02955-84195879,2024-06-26T13:26:31,Bilbao,Expense,education,-299.06,-706628.11
buyer_1,Luis,28,ES28209599118326557478,TRX_N-02956-92440762,2024-06-27T05:11:10,Bilbao,Expense,healthcare,-177.8,-706805.91
buyer_1,Luis,28,ES28209599118326557478,TRX_N-02957-95866758,2024-06-27T20:20:11,Bilbao,Expense,education,-478.47,-707284.38
buyer_1,Luis,28,ES28209599118326557478,TRX_N-02958-02980536,2024-06-27T18:04:29,Bilbao,Expense,technology,-310.77,-707595.15
buyer_1,Luis,28,ES28209599118326557478,TRX_N-02959-61896650,2024-06-28T16:23:46,Bilbao,Expense,healthcare,-315.89,-707911.04
buyer_1,Luis,28,ES28209599118326557478,TRX_N-02960-93599024,2024-06-28T18:23:08,Bilbao,Expense,technology,-64.81,-707975.85
buyer_1,Luis,28,ES28209599118326557478,TRX_N-02961-02825937,2024-06-28T23:59:29,Lasarte-Oria,Expense,technology,-243.53,-708219.38
buyer_1,Luis,28,ES28209599118326557478,TRX_N-02962-98460181,2024-06-29T03:06:22,Bilbao,Expense,car,-375.15,-708594.53
buyer_1,Luis,28,ES28209599118326557478,TRX_N-02963-12748426,2024-06-29T15:14:38,Hondarribia,Expense,subscriptions,-154.3,-708748.83
buyer_1,Luis,28,ES28209599118326557478,TRX_N-02964-68544988,2024-06-29T13:22:34,Bilbao,Expense,food,-276.27,-709025.1
buyer_1,Luis,28,ES28209599118326557478,TRX_N-02965-86101140,2024-06-30T17:42:31,Bilbao,Expense,subscriptions,-396.45,-709421.55
buyer_1,Luis,28,ES28209599118326557478,TRX_N-02966-41682712,2024-06-30T10:36:25,Bilbao,Expense,basic-services,-108.67,-709530.22
buyer_1,Luis,28,ES28209599118326557478,TRX_N-02967-53220747,2024-06-30T13:27:47,Bilbao,Expense,car,-71.99,-709602.21
buyer_1,Luis,28,ES28209599118326557478,TRX_N-02968-83936876,2024-07-01T15:32:30,Bilbao,incomes,salary,1265.98,-708336.23
buyer_1,Luis,28,ES28209599118326557478,TRX_N-02969-70616412,2024-07-01T15:32:30,Bilbao,incomes,extra_income,126.6,-708209.63
buyer_1,Luis,28,ES28209599118326557478,TRX_N-02970-42006138,2024-07-01T09:50:08,Bilbao,Expense,basic-services,-488.55,-708698.18
buyer_1,Luis,28,ES28209599118326557478,TRX_N-02971-00613715,2024-07-01T04:44:11,Bilbao,Expense,transport,-385.99,-709084.17
buyer_1,Luis,28,ES28209599118326557478,TRX_N-02972-88421025,2024-07-01T18:05:47,Galdakao,Expense,education,-360.79,-709444.96
buyer_1,Luis,28,ES28209599118326557478,TRX_N-02973-31401805,2024-07-02T10:56:18,Bilbao,Expense,transport,-415.67,-709860.63
buyer_1,Luis,28,ES28209599118326557478,TRX_N-02974-01349369,2024-07-02T20:53:23,Bilbao,Expense,loans,-401.9,-710262.53
buyer_1,Luis,28,ES28209599118326557478,TRX_N-02975-90018098,2024-07-02T17:46:34,Bilbao,Expense,housing,-433.99,-710696.52
buyer_1,Luis,28,ES28209599118326557478,TRX_N-02976-17431139,2024-07-03T17:35:35,Bilbao,Expense,car,-18.16,-710714.68
buyer_1,Luis,28,ES28209599118326557478,TRX_N-02977-70307049,2024-07-03T14:58:53,Bilbao,Expense,technology,-345.83,-711060.51
buyer_1,Luis,28,ES28209599118326557478,TRX_N-02978-75446744,2024-07-03T21:35:35,Bilbao,Expense,subscriptions,-55.62,-711116.13
buyer_1,Luis,28,ES28209599118326557478,TRX_N-02979-20958785,2024-07-04T17:50:20,Bilbao,Housing,Rent,-1369.49,-712485.62
buyer_1,Luis,28,ES28209599118326557478,TRX_N-02980-29902662,2024-07-04T20:03:05,Arrasate,Expense,education,-121.17,-712606.79
buyer_1,Luis,28,ES28209599118326557478,TRX_N-02981-52612087,2024-07-04T08:46:27,Bilbao,Expense,clothing,-486.63,-713093.42
buyer_1,Luis,28,ES28209599118326557478,TRX_N-02982-60172081,2024-07-04T18:56:53,Bilbao,Expense,clothing,-484.06,-713577.48
buyer_1,Luis,28,ES28209599118326557478,TRX_N-02983-32898279,2024-07-05T21:56:44,Bilbao,basic_services,electricity,-80.25,-713657.73
buyer_1,Luis,28,ES28209599118326557478,TRX_N-02984-28951207,2024-07-05T07:15:40,Bilbao,Expense,subscriptions,-128.48,-713786.21
buyer_1,Luis,28,ES28209599118326557478,TRX_N-02985-63662580,2024-07-05T10:20:37,Bilbao,Expense,children,-283.05,-714069.26
buyer_1,Luis,28,ES28209599118326557478,TRX_N-02986-36217721,2024-07-05T18:04:38,Bilbao,Expense,transport,-294.24,-714363.5
buyer_1,Luis,28,ES28209599118326557478,TRX_N-02987-89667850,2024-07-06T13:12:16,Bilbao,basic_services,phone,-89.77,-714453.27
buyer_1,Luis,28,ES28209599118326557478,TRX_N-02988-93492596,2024-07-06T22:32:58,Bilbao,Expense,basic-services,-81.45,-714534.72
buyer_1,Luis,28,ES28209599118326557478,TRX_N-02989-03531542,2024-07-06T05:55:07,Hernani,Expense,housing,-82.52,-714617.24
buyer_1,Luis,28,ES28209599118326557478,TRX_N-02990-79139829,2024-07-06T12:48:28,Bilbao,Expense,savings,-274.67,-714891.91
buyer_1,Luis,28,ES28209599118326557478,TRX_N-02991-21951045,2024-07-07T18:51:02,Bilbao,basic_services,water,-59.22,-714951.13
buyer_1,Luis,28,ES28209599118326557478,TRX_N-02992-14558149,2024-07-07T14:04:13,Bilbao,basic_services,gas,-74.79,-715025.92
buyer_1,Luis,28,ES28209599118326557478,TRX_N-02993-06664793,2024-07-07T14:38:47,Bilbao,Expense,leisure,-323.4,-715349.32
buyer_1,Luis,28,ES28209599118326557478,TRX_N-02994-12015985,2024-07-07T19:09:23,Bilbao,Expense,education,-245.31,-715594.63
buyer_1,Luis,28,ES28209599118326557478,TRX_N-02995-24054084,2024-07-07T11:26:11,Bilbao,Expense,technology,-256.64,-715851.27
buyer_1,Luis,28,ES28209599118326557478,TRX_N-02996-19669331,2024-07-08T19:06:14,Bilbao,basic_services,internet,-43.23,-715894.5
buyer_1,Luis,28,ES28209599118326557478,TRX_N-02997-07034949,2024-07-08T20:06:03,Bilbao,Expense,basic-services,-185.44,-716079.94
buyer_1,Luis,28,ES28209599118326557478,TRX_N-02998-46508133,2024-07-08T04:07:51,Bilbao,Expense,leisure,-483.62,-716563.56
buyer_1,Luis,28,ES28209599118326557478,TRX_N-02999-91640710,2024-07-08T12:04:55,Bilbao,Expense,leisure,-400.69,-716964.25
buyer_1,Luis,28,ES28209599118326557478,TRX_N-03000-86462506,2024-07-09T07:21:32,Bilbao,Expense,housing,-163.18,-717127.43
buyer_1,Luis,28,ES28209599118326557478,TRX_N-03001-80654564,2024-07-09T09:06:39,Getxo,Expense,car,-144.69,-717272.12
buyer_1,Luis,28,ES28209599118326557478,TRX_N-03002-76524448,2024-07-09T03:18:02,Bilbao,Expense,personal_care,-227.75,-717499.87
buyer_1,Luis,28,ES28209599118326557478,TRX_N-03003-47501152,2024-07-10T17:04:00,Bilbao,Expense,clothing,-64.12,-717563.99
buyer_1,Luis,28,ES28209599118326557478,TRX_N-03004-79316037,2024-07-10T19:11:28,Bilbao,Expense,leisure,-457.94,-718021.93
buyer_1,Luis,28,ES28209599118326557478,TRX_N-03005-83043330,2024-07-10T17:15:03,Bilbao,Expense,personal_care,-153.3,-718175.23
buyer_1,Luis,28,ES28209599118326557478,TRX_N-03006-59155233,2024-07-11T11:28:54,Bilbao,Expense,education,-343.73,-718518.96
buyer_1,Luis,28,ES28209599118326557478,TRX_N-03007-14560419,2024-07-11T14:11:15,Bilbao,Expense,food,-86.22,-718605.18
buyer_1,Luis,28,ES28209599118326557478,TRX_N-03008-39215207,2024-07-11T14:46:06,Bilbao,Expense,healthcare,-340.04,-718945.22
buyer_1,Luis,28,ES28209599118326557478,TRX_N-03009-77578195,2024-07-12T03:21:22,Bilbao,Expense,savings,-150.89,-719096.11
buyer_1,Luis,28,ES28209599118326557478,TRX_N-03010-75458244,2024-07-12T19:42:23,Bilbao,Expense,food,-133.56,-719229.67
buyer_1,Luis,28,ES28209599118326557478,TRX_N-03011-47751267,2024-07-12T08:04:35,Bilbao,Expense,healthcare,-42.19,-719271.86
buyer_1,Luis,28,ES28209599118326557478,TRX_N-03012-44917266,2024-07-13T15:00:24,Bilbao,Expense,food,-213.57,-719485.43
buyer_1,Luis,28,ES28209599118326557478,TRX_N-03013-90579629,2024-07-13T16:58:19,Bilbao,Expense,basic-services,-398.31,-719883.74
buyer_1,Luis,28,ES28209599118326557478,TRX_N-03014-08412690,2024-07-13T14:48:43,Arrasate,Expense,loans,-430.95,-720314.69
buyer_1,Luis,28,ES28209599118326557478,TRX_N-03015-27798540,2024-07-14T08:49:28,Bilbao,Expense,technology,-156.6,-720471.29
buyer_1,Luis,28,ES28209599118326557478,TRX_N-03016-27496262,2024-07-14T21:41:23,Bilbao,Expense,housing,-33.1,-720504.39
buyer_1,Luis,28,ES28209599118326557478,TRX_N-03017-15515335,2024-07-14T09:08:00,Santurtzi,Expense,education,-168.75,-720673.14
buyer_1,Luis,28,ES28209599118326557478,TRX_N-03018-98609297,2024-07-15T16:00:43,Bilbao,Expense,technology,-253.91,-720927.05
buyer_1,Luis,28,ES28209599118326557478,TRX_N-03019-42376686,2024-07-15T16:13:56,Bilbao,Expense,housing,-24.64,-720951.69
buyer_1,Luis,28,ES28209599118326557478,TRX_N-03020-62000990,2024-07-15T16:40:20,Bilbao,Expense,technology,-113.05,-721064.74
buyer_1,Luis,28,ES28209599118326557478,TRX_N-03021-25200798,2024-07-16T10:19:39,Bilbao,Expense,car,-352.64,-721417.38
buyer_1,Luis,28,ES28209599118326557478,TRX_N-03022-56553401,2024-07-16T21:12:59,Portugalete,Expense,housing,-220.59,-721637.97
buyer_1,Luis,28,ES28209599118326557478,TRX_N-03023-58103514,2024-07-16T16:19:00,Bilbao,Expense,children,-483.16,-722121.13
buyer_1,Luis,28,ES28209599118326557478,TRX_N-03024-67649269,2024-07-17T15:34:24,Bilbao,Expense,children,-435.89,-722557.02
buyer_1,Luis,28,ES28209599118326557478,TRX_N-03025-21532046,2024-07-17T13:25:24,Bilbao,Expense,children,-181.36,-722738.38
buyer_1,Luis,28,ES28209599118326557478,TRX_N-03026-53921893,2024-07-17T19:07:04,Bilbao,Expense,personal_care,-231.35,-722969.73
buyer_1,Luis,28,ES28209599118326557478,TRX_N-03027-45911584,2024-07-18T14:58:50,Bilbao,Expense,transport,-68.91,-723038.64
buyer_1,Luis,28,ES28209599118326557478,TRX_N-03028-71089621,2024-07-18T16:50:40,Bilbao,Expense,loans,-284.34,-723322.98
buyer_1,Luis,28,ES28209599118326557478,TRX_N-03029-65800221,2024-07-18T12:17:13,Bilbao,Expense,clothing,-201.24,-723524.22
buyer_1,Luis,28,ES28209599118326557478,TRX_N-03030-86168033,2024-07-19T12:59:05,Irun,Expense,children,-397.02,-723921.24
buyer_1,Luis,28,ES28209599118326557478,TRX_N-03031-94705103,2024-07-19T17:34:41,Donostia,Expense,clothing,-200.08,-724121.32
buyer_1,Luis,28,ES28209599118326557478,TRX_N-03032-19530381,2024-07-19T14:57:45,Pasaia,Expense,transport,-168.38,-724289.7
buyer_1,Luis,28,ES28209599118326557478,TRX_N-03033-64443449,2024-07-20T16:20:35,Bilbao,Expense,basic-services,-393.23,-724682.93
buyer_1,Luis,28,ES28209599118326557478,TRX_N-03034-38158015,2024-07-20T17:58:19,Bilbao,Expense,healthcare,-381.31,-725064.24
buyer_1,Luis,28,ES28209599118326557478,TRX_N-03035-83265028,2024-07-20T18:13:05,Errenteria,Expense,personal_care,-214.23,-725278.47
buyer_1,Luis,28,ES28209599118326557478,TRX_N-03036-41401115,2024-07-21T15:34:50,Bilbao,Expense,loans,-249.12,-725527.59
buyer_1,Luis,28,ES28209599118326557478,TRX_N-03037-87754820,2024-07-21T14:27:23,Bilbao,Expense,food,-398.68,-725926.27
buyer_1,Luis,28,ES28209599118326557478,TRX_N-03038-46962338,2024-07-21T11:49:35,Getxo,Expense,food,-165.11,-726091.38
buyer_1,Luis,28,ES28209599118326557478,TRX_N-03039-64151292,2024-07-22T08:47:05,Bilbao,Expense,loans,-82.26,-726173.64
buyer_1,Luis,28,ES28209599118326557478,TRX_N-03040-59801227,2024-07-22T14:55:13,Bilbao,Expense,housing,-352.28,-726525.92
buyer_1,Luis,28,ES28209599118326557478,TRX_N-03041-97787414,2024-07-22T19:45:37,Vitoria-Gasteiz,Expense,subscriptions,-123.56,-726649.48
buyer_1,Luis,28,ES28209599118326557478,TRX_N-03042-61283946,2024-07-23T21:49:13,Bilbao,Expense,leisure,-218.84,-726868.32
buyer_1,Luis,28,ES28209599118326557478,TRX_N-03043-01495151,2024-07-23T08:19:51,Bilbao,Expense,leisure,-370.43,-727238.75
buyer_1,Luis,28,ES28209599118326557478,TRX_N-03044-27825925,2024-07-23T09:12:40,Leioa,Expense,food,-212.13,-727450.88
buyer_1,Luis,28,ES28209599118326557478,TRX_N-03045-64316604,2024-07-24T12:23:08,Bilbao,Expense,healthcare,-217.88,-727668.76
buyer_1,Luis,28,ES28209599118326557478,TRX_N-03046-15025996,2024-07-24T13:53:49,Bilbao,Expense,healthcare,-316.98,-727985.74
buyer_1,Luis,28,ES28209599118326557478,TRX_N-03047-67245447,2024-07-24T18:47:54,Bilbao,Expense,leisure,-418.25,-728403.99
buyer_1,Luis,28,ES28209599118326557478,TRX_N-03048-77023123,2024-07-25T02:28:59,Bilbao,Expense,children,-283.83,-728687.82
buyer_1,Luis,28,ES28209599118326557478,TRX_N-03049-68358984,2024-07-25T10:48:30,Bilbao,Expense,transport,-304.99,-728992.81
buyer_1,Luis,28,ES28209599118326557478,TRX_N-03050-95522937,2024-07-25T17:57:00,Bilbao,Expense,transport,-176.74,-729169.55
buyer_1,Luis,28,ES28209599118326557478,TRX_N-03051-13148955,2024-07-26T22:07:46,Basauri,Expense,children,-435.36,-729604.91
buyer_1,Luis,28,ES28209599118326557478,TRX_N-03052-33733942,2024-07-26T14:20:56,Bilbao,Expense,basic-services,-371.18,-729976.09
buyer_1,Luis,28,ES28209599118326557478,TRX_N-03053-33067094,2024-07-26T10:47:09,Bilbao,Expense,housing,-221.66,-730197.75
buyer_1,Luis,28,ES28209599118326557478,TRX_N-03054-61723764,2024-07-27T02:45:18,Bilbao,Expense,healthcare,-368.17,-730565.92
buyer_1,Luis,28,ES28209599118326557478,TRX_N-03055-76169102,2024-07-27T03:40:17,Bilbao,Expense,subscriptions,-431.0,-730996.92
buyer_1,Luis,28,ES28209599118326557478,TRX_N-03056-97648301,2024-07-27T16:19:18,Bilbao,Expense,basic-services,-314.12,-731311.04
buyer_1,Luis,28,ES28209599118326557478,TRX_N-03057-63516734,2024-07-28T14:39:45,Bilbao,Expense,savings,-18.36,-731329.4
buyer_1,Luis,28,ES28209599118326557478,TRX_N-03058-38562017,2024-07-28T02:04:55,Bilbao,Expense,transport,-252.57,-731581.97
buyer_1,Luis,28,ES28209599118326557478,TRX_N-03059-72415573,2024-07-28T13:48:06,Bilbao,Expense,loans,-286.43,-731868.4
buyer_1,Luis,28,ES28209599118326557478,TRX_N-03060-22190843,2024-07-29T18:18:21,Bilbao,Expense,food,-376.25,-732244.65
buyer_1,Luis,28,ES28209599118326557478,TRX_N-03061-24074121,2024-07-29T21:30:33,Bilbao,Expense,leisure,-395.08,-732639.73
buyer_1,Luis,28,ES28209599118326557478,TRX_N-03062-39513068,2024-07-29T09:37:00,Errenteria,Expense,savings,-117.55,-732757.28
buyer_1,Luis,28,ES28209599118326557478,TRX_N-03063-59810201,2024-07-30T19:41:28,Bilbao,Expense,clothing,-11.17,-732768.45
buyer_1,Luis,28,ES28209599118326557478,TRX_N-03064-96701880,2024-07-30T08:30:09,Bilbao,Expense,loans,-335.52,-733103.97
buyer_1,Luis,28,ES28209599118326557478,TRX_N-03065-33594764,2024-07-30T12:23:17,Bilbao,Expense,personal_care,-445.36,-733549.33
buyer_1,Luis,28,ES28209599118326557478,TRX_N-03066-99138906,2024-07-31T08:44:37,Bilbao,Expense,children,-168.16,-733717.49
buyer_1,Luis,28,ES28209599118326557478,TRX_N-03067-93936942,2024-07-31T21:41:10,Bilbao,Expense,basic-services,-206.17,-733923.66
buyer_1,Luis,28,ES28209599118326557478,TRX_N-03068-51810510,2024-07-31T19:18:43,Bilbao,Expense,education,-440.38,-734364.04
buyer_1,Luis,28,ES28209599118326557478,TRX_N-03069-86188945,2024-08-01T16:25:17,Bilbao,incomes,salary,1265.98,-733098.06
buyer_1,Luis,28,ES28209599118326557478,TRX_N-03070-27709077,2024-08-01T10:48:21,Basauri,Expense,food,-348.76,-733446.82
buyer_1,Luis,28,ES28209599118326557478,TRX_N-03071-26903873,2024-08-01T12:59:20,Andoain,Expense,subscriptions,-28.27,-733475.09
buyer_1,Luis,28,ES28209599118326557478,TRX_N-03072-35105486,2024-08-01T08:46:36,Bilbao,Expense,car,-483.96,-733959.05
buyer_1,Luis,28,ES28209599118326557478,TRX_N-03073-06257121,2024-08-02T02:54:29,Bilbao,Expense,technology,-382.72,-734341.77
buyer_1,Luis,28,ES28209599118326557478,TRX_N-03074-47518494,2024-08-02T17:58:23,Errenteria,Expense,transport,-241.5,-734583.27
buyer_1,Luis,28,ES28209599118326557478,TRX_N-03075-90424358,2024-08-02T23:03:37,Bilbao,Expense,food,-422.54,-735005.81
buyer_1,Luis,28,ES28209599118326557478,TRX_N-03076-88374437,2024-08-03T09:03:26,Bilbao,Expense,basic-services,-310.65,-735316.46
buyer_1,Luis,28,ES28209599118326557478,TRX_N-03077-40024839,2024-08-03T09:41:40,Bilbao,Expense,clothing,-14.71,-735331.17
buyer_1,Luis,28,ES28209599118326557478,TRX_N-03078-67600784,2024-08-03T11:27:35,Bilbao,Expense,food,-373.63,-735704.8
buyer_1,Luis,28,ES28209599118326557478,TRX_N-03079-31575082,2024-08-04T07:29:26,Bilbao,Housing,Rent,-1369.49,-737074.29
buyer_1,Luis,28,ES28209599118326557478,TRX_N-03080-43210675,2024-08-04T20:44:17,Bilbao,Expense,car,-169.28,-737243.57
buyer_1,Luis,28,ES28209599118326557478,TRX_N-03081-34854348,2024-08-04T12:28:30,Bilbao,Expense,healthcare,-462.36,-737705.93
buyer_1,Luis,28,ES28209599118326557478,TRX_N-03082-97065589,2024-08-04T12:05:24,Bilbao,Expense,personal_care,-32.92,-737738.85
buyer_1,Luis,28,ES28209599118326557478,TRX_N-03083-23218371,2024-08-05T15:14:37,Salvatierra/Agurain,Expense,healthcare,-92.55,-737831.4
buyer_1,Luis,28,ES28209599118326557478,TRX_N-03084-20340521,2024-08-05T14:26:43,Bilbao,Expense,personal_care,-74.42,-737905.82
buyer_1,Luis,28,ES28209599118326557478,TRX_N-03085-01920773,2024-08-05T20:48:51,Vitoria-Gasteiz,Expense,clothing,-293.82,-738199.64
buyer_1,Luis,28,ES28209599118326557478,TRX_N-03086-02174509,2024-08-06T08:01:32,Bilbao,basic_services,electricity,-60.17,-738259.81
buyer_1,Luis,28,ES28209599118326557478,TRX_N-03087-90741048,2024-08-06T17:51:42,Bilbao,Expense,transport,-155.24,-738415.05
buyer_1,Luis,28,ES28209599118326557478,TRX_N-03088-09065936,2024-08-06T18:36:02,Irun,Expense,personal_care,-275.48,-738690.53
buyer_1,Luis,28,ES28209599118326557478,TRX_N-03089-60021073,2024-08-06T13:58:02,Bilbao,Expense,housing,-458.55,-739149.08
buyer_1,Luis,28,ES28209599118326557478,TRX_N-03090-51614632,2024-08-07T11:29:46,Bilbao,basic_services,water,-70.7,-739219.78
buyer_1,Luis,28,ES28209599118326557478,TRX_N-03091-83835808,2024-08-07T16:33:19,Bilbao,basic_services,phone,-96.44,-739316.22
buyer_1,Luis,28,ES28209599118326557478,TRX_N-03092-95528431,2024-08-07T10:44:44,Portugalete,Expense,transport,-160.37,-739476.59
buyer_1,Luis,28,ES28209599118326557478,TRX_N-03093-74843531,2024-08-07T11:04:06,Bilbao,Expense,housing,-328.49,-739805.08
buyer_1,Luis,28,ES28209599118326557478,TRX_N-03094-37784990,2024-08-07T23:05:50,Andoain,Expense,transport,-434.64,-740239.72
buyer_1,Luis,28,ES28209599118326557478,TRX_N-03095-79883892,2024-08-08T08:30:26,Bilbao,basic_services,internet,-35.69,-740275.41
buyer_1,Luis,28,ES28209599118326557478,TRX_N-03096-46730600,2024-08-08T13:16:31,Bilbao,basic_services,gas,-42.11,-740317.52
buyer_1,Luis,28,ES28209599118326557478,TRX_N-03097-15227301,2024-08-08T18:57:18,Bilbao,Expense,transport,-376.24,-740693.76
buyer_1,Luis,28,ES28209599118326557478,TRX_N-03098-60755511,2024-08-08T23:38:46,Bilbao,Expense,subscriptions,-485.89,-741179.65
buyer_1,Luis,28,ES28209599118326557478,TRX_N-03099-66927073,2024-08-08T20:23:28,Bilbao,Expense,loans,-499.66,-741679.31
buyer_1,Luis,28,ES28209599118326557478,TRX_N-03100-32681983,2024-08-09T11:37:51,Bilbao,Expense,savings,-268.45,-741947.76
buyer_1,Luis,28,ES28209599118326557478,TRX_N-03101-43689692,2024-08-09T17:12:01,Lasarte-Oria,Expense,basic-services,-26.25,-741974.01
buyer_1,Luis,28,ES28209599118326557478,TRX_N-03102-47121420,2024-08-09T16:31:27,Bilbao,Expense,transport,-199.21,-742173.22
buyer_1,Luis,28,ES28209599118326557478,TRX_N-03103-42202679,2024-08-10T13:06:48,Bilbao,Expense,basic-services,-374.15,-742547.37
buyer_1,Luis,28,ES28209599118326557478,TRX_N-03104-55093230,2024-08-10T03:00:30,Bilbao,Expense,housing,-192.37,-742739.74
buyer_1,Luis,28,ES28209599118326557478,TRX_N-03105-87978870,2024-08-10T17:00:21,Bilbao,Expense,education,-218.13,-742957.87
buyer_1,Luis,28,ES28209599118326557478,TRX_N-03106-35075821,2024-08-11T19:29:34,Bilbao,Expense,loans,-53.38,-743011.25
buyer_1,Luis,28,ES28209599118326557478,TRX_N-03107-43750595,2024-08-11T12:17:18,Durango,Expense,personal_care,-65.16,-743076.41
buyer_1,Luis,28,ES28209599118326557478,TRX_N-03108-66693035,2024-08-11T11:57:41,Sopela,Expense,healthcare,-470.72,-743547.13
buyer_1,Luis,28,ES28209599118326557478,TRX_N-03109-13779729,2024-08-12T21:06:44,Bilbao,Expense,healthcare,-216.7,-743763.83
buyer_1,Luis,28,ES28209599118326557478,TRX_N-03110-04187169,2024-08-12T09:35:51,Bilbao,Expense,transport,-344.33,-744108.16
buyer_1,Luis,28,ES28209599118326557478,TRX_N-03111-18057940,2024-08-12T12:22:24,Bilbao,Expense,car,-152.26,-744260.42
buyer_1,Luis,28,ES28209599118326557478,TRX_N-03112-16236433,2024-08-13T08:03:23,Errenteria,Expense,clothing,-388.22,-744648.64
buyer_1,Luis,28,ES28209599118326557478,TRX_N-03113-51724126,2024-08-13T12:50:52,Donostia,Expense,personal_care,-312.01,-744960.65
buyer_1,Luis,28,ES28209599118326557478,TRX_N-03114-29003284,2024-08-13T17:55:17,Pasaia,Expense,housing,-105.65,-745066.3
buyer_1,Luis,28,ES28209599118326557478,TRX_N-03115-93052300,2024-08-14T15:41:47,Bilbao,Expense,children,-319.17,-745385.47
buyer_1,Luis,28,ES28209599118326557478,TRX_N-03116-20219681,2024-08-14T13:50:19,Bilbao,Expense,healthcare,-24.03,-745409.5
buyer_1,Luis,28,ES28209599118326557478,TRX_N-03117-57931723,2024-08-14T18:58:02,Bilbao,Expense,healthcare,-412.38,-745821.88
buyer_1,Luis,28,ES28209599118326557478,TRX_N-03118-56496393,2024-08-15T17:57:20,Bilbao,Expense,clothing,-304.25,-746126.13
buyer_1,Luis,28,ES28209599118326557478,TRX_N-03119-21716026,2024-08-15T20:44:24,Bilbao,Expense,subscriptions,-31.69,-746157.82
buyer_1,Luis,28,ES28209599118326557478,TRX_N-03120-44713131,2024-08-15T13:49:43,Bilbao,Expense,basic-services,-344.14,-746501.96
buyer_1,Luis,28,ES28209599118326557478,TRX_N-03121-43321620,2024-08-16T15:54:46,Bilbao,Expense,clothing,-53.62,-746555.58
buyer_1,Luis,28,ES28209599118326557478,TRX_N-03122-59080424,2024-08-16T02:07:23,Bilbao,Expense,technology,-372.36,-746927.94
buyer_1,Luis,28,ES28209599118326557478,TRX_N-03123-40705185,2024-08-16T11:13:34,Bilbao,Expense,leisure,-499.83,-747427.77
buyer_1,Luis,28,ES28209599118326557478,TRX_N-03124-79028818,2024-08-17T12:22:27,Bilbao,Expense,personal_care,-12.54,-747440.31
buyer_1,Luis,28,ES28209599118326557478,TRX_N-03125-15788213,2024-08-17T19:49:14,Bilbao,Expense,basic-services,-226.0,-747666.31
buyer_1,Luis,28,ES28209599118326557478,TRX_N-03126-20999035,2024-08-17T12:16:03,Bilbao,Expense,personal_care,-289.62,-747955.93
buyer_1,Luis,28,ES28209599118326557478,TRX_N-03127-87461523,2024-08-18T14:17:23,Bilbao,Expense,housing,-308.04,-748263.97
buyer_1,Luis,28,ES28209599118326557478,TRX_N-03128-28608588,2024-08-18T18:16:44,Bilbao,Expense,clothing,-426.58,-748690.55
buyer_1,Luis,28,ES28209599118326557478,TRX_N-03129-15737658,2024-08-18T09:16:31,Sestao,Expense,housing,-367.14,-749057.69
buyer_1,Luis,28,ES28209599118326557478,TRX_N-03130-23060511,2024-08-19T09:17:38,Bilbao,Expense,basic-services,-490.88,-749548.57
buyer_1,Luis,28,ES28209599118326557478,TRX_N-03131-07712893,2024-08-19T18:36:42,Bilbao,Expense,healthcare,-87.02,-749635.59
buyer_1,Luis,28,ES28209599118326557478,TRX_N-03132-58417230,2024-08-19T10:17:54,Mungia,Expense,technology,-413.23,-750048.82
buyer_1,Luis,28,ES28209599118326557478,TRX_N-03133-60446680,2024-08-20T16:01:07,Vitoria-Gasteiz,Expense,children,-200.89,-750249.71
buyer_1,Luis,28,ES28209599118326557478,TRX_N-03134-68900456,2024-08-20T17:58:32,Bilbao,Expense,clothing,-374.54,-750624.25
buyer_1,Luis,28,ES28209599118326557478,TRX_N-03135-39897935,2024-08-20T11:33:05,Salvatierra/Agurain,Expense,subscriptions,-48.12,-750672.37
buyer_1,Luis,28,ES28209599118326557478,TRX_N-03136-13399055,2024-08-21T13:52:37,Bilbao,Expense,clothing,-136.77,-750809.14
buyer_1,Luis,28,ES28209599118326557478,TRX_N-03137-60750339,2024-08-21T23:04:50,Bilbao,Expense,clothing,-29.13,-750838.27
buyer_1,Luis,28,ES28209599118326557478,TRX_N-03138-00595421,2024-08-21T12:09:54,Bilbao,Expense,leisure,-28.71,-750866.98
buyer_1,Luis,28,ES28209599118326557478,TRX_N-03139-56061732,2024-08-22T17:34:26,Bilbao,Expense,subscriptions,-433.18,-751300.16
buyer_1,Luis,28,ES28209599118326557478,TRX_N-03140-27256248,2024-08-22T05:40:30,Bilbao,Expense,savings,-69.8,-751369.96
buyer_1,Luis,28,ES28209599118326557478,TRX_N-03141-51414011,2024-08-22T12:11:38,Bilbao,Expense,technology,-494.94,-751864.9
buyer_1,Luis,28,ES28209599118326557478,TRX_N-03142-09700173,2024-08-23T01:09:47,Bilbao,Expense,education,-326.36,-752191.26
buyer_1,Luis,28,ES28209599118326557478,TRX_N-03143-72631748,2024-08-23T20:50:13,Bilbao,Expense,basic-services,-153.98,-752345.24
buyer_1,Luis,28,ES28209599118326557478,TRX_N-03144-68831608,2024-08-23T18:07:20,Bilbao,Expense,children,-412.92,-752758.16
buyer_1,Luis,28,ES28209599118326557478,TRX_N-03145-91926387,2024-08-24T09:56:11,Bilbao,Expense,education,-55.87,-752814.03
buyer_1,Luis,28,ES28209599118326557478,TRX_N-03146-29747879,2024-08-24T11:25:35,Bilbao,Expense,housing,-312.06,-753126.09
buyer_1,Luis,28,ES28209599118326557478,TRX_N-03147-76777489,2024-08-24T09:46:40,Bilbao,Expense,education,-326.68,-753452.77
buyer_1,Luis,28,ES28209599118326557478,TRX_N-03148-25581407,2024-08-25T22:24:40,Bilbao,Expense,healthcare,-461.74,-753914.51
buyer_1,Luis,28,ES28209599118326557478,TRX_N-03149-25173317,2024-08-25T10:13:12,Amurrio,Expense,leisure,-480.6,-754395.11
buyer_1,Luis,28,ES28209599118326557478,TRX_N-03150-18835253,2024-08-25T07:12:00,Bilbao,Expense,healthcare,-133.12,-754528.23
buyer_1,Luis,28,ES28209599118326557478,TRX_N-03151-66082590,2024-08-26T15:26:07,Bilbao,Expense,subscriptions,-449.84,-754978.07
buyer_1,Luis,28,ES28209599118326557478,TRX_N-03152-81609091,2024-08-26T08:44:07,Sopela,Expense,subscriptions,-465.28,-755443.35
buyer_1,Luis,28,ES28209599118326557478,TRX_N-03153-29354636,2024-08-26T14:07:21,Irun,Expense,loans,-157.9,-755601.25
buyer_1,Luis,28,ES28209599118326557478,TRX_N-03154-72302740,2024-08-27T08:25:19,Bilbao,Expense,savings,-220.53,-755821.78
buyer_1,Luis,28,ES28209599118326557478,TRX_N-03155-46316559,2024-08-27T17:55:03,Eibar,Expense,subscriptions,-449.89,-756271.67
buyer_1,Luis,28,ES28209599118326557478,TRX_N-03156-02492342,2024-08-27T09:02:34,Bilbao,Expense,basic-services,-413.05,-756684.72
buyer_1,Luis,28,ES28209599118326557478,TRX_N-03157-45582074,2024-08-28T00:15:00,Bilbao,Expense,technology,-379.41,-757064.13
buyer_1,Luis,28,ES28209599118326557478,TRX_N-03158-64765852,2024-08-28T18:32:17,Bilbao,Expense,education,-423.19,-757487.32
buyer_1,Luis,28,ES28209599118326557478,TRX_N-03159-97055705,2024-08-28T14:05:11,Bilbao,Expense,loans,-199.75,-757687.07
buyer_1,Luis,28,ES28209599118326557478,TRX_N-03160-04152724,2024-08-29T11:21:30,Bilbao,Expense,technology,-294.62,-757981.69
buyer_1,Luis,28,ES28209599118326557478,TRX_N-03161-86904249,2024-08-29T00:14:07,Bilbao,Expense,children,-27.85,-758009.54
buyer_1,Luis,28,ES28209599118326557478,TRX_N-03162-90084404,2024-08-29T17:34:52,Erandio,Expense,education,-37.0,-758046.54
buyer_1,Luis,28,ES28209599118326557478,TRX_N-03163-97657570,2024-08-30T18:36:32,Bilbao,Expense,food,-395.46,-758442.0
buyer_1,Luis,28,ES28209599118326557478,TRX_N-03164-37033732,2024-08-30T15:47:12,Bilbao,Expense,subscriptions,-152.77,-758594.77
buyer_1,Luis,28,ES28209599118326557478,TRX_N-03165-34673004,2024-08-30T11:56:38,Bilbao,Expense,food,-53.19,-758647.96
buyer_1,Luis,28,ES28209599118326557478,TRX_N-03166-89204829,2024-08-31T15:17:14,Bilbao,Expense,loans,-298.63,-758946.59
buyer_1,Luis,28,ES28209599118326557478,TRX_N-03167-01709499,2024-08-31T08:10:20,Bilbao,Expense,personal_care,-235.32,-759181.91
buyer_1,Luis,28,ES28209599118326557478,TRX_N-03168-79095379,2024-08-31T15:37:54,Eibar,Expense,transport,-64.99,-759246.9
buyer_1,Luis,28,ES28209599118326557478,TRX_N-03169-55933895,2024-09-01T17:41:15,Bilbao,incomes,salary,1265.98,-757980.92
buyer_1,Luis,28,ES28209599118326557478,TRX_N-03170-34790601,2024-09-01T18:00:51,Bilbao,Expense,car,-171.16,-758152.08
buyer_1,Luis,28,ES28209599118326557478,TRX_N-03171-45709731,2024-09-01T08:12:57,Bilbao,Expense,car,-491.75,-758643.83
buyer_1,Luis,28,ES28209599118326557478,TRX_N-03172-10050088,2024-09-01T02:16:56,Bilbao,Expense,education,-29.91,-758673.74
buyer_1,Luis,28,ES28209599118326557478,TRX_N-03173-80528868,2024-09-02T19:43:02,Bilbao,Expense,subscriptions,-43.59,-758717.33
buyer_1,Luis,28,ES28209599118326557478,TRX_N-03174-05679245,2024-09-02T19:37:38,Bilbao,Expense,car,-79.62,-758796.95
buyer_1,Luis,28,ES28209599118326557478,TRX_N-03175-69038657,2024-09-02T14:30:09,Leioa,Expense,healthcare,-123.91,-758920.86
buyer_1,Luis,28,ES28209599118326557478,TRX_N-03176-86085470,2024-09-03T11:30:10,Bilbao,Expense,transport,-408.09,-759328.95
buyer_1,Luis,28,ES28209599118326557478,TRX_N-03177-62257943,2024-09-03T12:46:36,Getxo,Expense,children,-214.71,-759543.66
buyer_1,Luis,28,ES28209599118326557478,TRX_N-03178-82642152,2024-09-03T13:19:27,Bilbao,Expense,technology,-168.51,-759712.17
buyer_1,Luis,28,ES28209599118326557478,TRX_N-03179-10935563,2024-09-04T10:25:43,Bilbao,Housing,Rent,-1369.49,-761081.66
buyer_1,Luis,28,ES28209599118326557478,TRX_N-03180-92347784,2024-09-04T12:55:56,Bilbao,Expense,basic-services,-471.67,-761553.33
buyer_1,Luis,28,ES28209599118326557478,TRX_N-03181-58729412,2024-09-04T19:46:13,Bilbao,Expense,healthcare,-155.93,-761709.26
buyer_1,Luis,28,ES28209599118326557478,TRX_N-03182-83629992,2024-09-04T19:13:20,Bilbao,Expense,housing,-195.92,-761905.18
buyer_1,Luis,28,ES28209599118326557478,TRX_N-03183-44037494,2024-09-05T20:04:03,Bilbao,Expense,food,-420.77,-762325.95
buyer_1,Luis,28,ES28209599118326557478,TRX_N-03184-08923444,2024-09-05T06:48:46,Bilbao,Expense,car,-485.82,-762811.77
buyer_1,Luis,28,ES28209599118326557478,TRX_N-03185-34823597,2024-09-05T14:42:06,Bilbao,Expense,transport,-491.35,-763303.12
buyer_1,Luis,28,ES28209599118326557478,TRX_N-03186-72238701,2024-09-06T13:07:13,Bilbao,basic_services,water,-73.22,-763376.34
buyer_1,Luis,28,ES28209599118326557478,TRX_N-03187-22136992,2024-09-06T12:39:59,Bilbao,basic_services,internet,-54.19,-763430.53
buyer_1,Luis,28,ES28209599118326557478,TRX_N-03188-65882036,2024-09-06T11:25:02,Bilbao,Expense,education,-237.93,-763668.46
buyer_1,Luis,28,ES28209599118326557478,TRX_N-03189-27711591,2024-09-06T02:57:22,Berango,Expense,savings,-495.53,-764163.99
buyer_1,Luis,28,ES28209599118326557478,TRX_N-03190-66771739,2024-09-06T09:10:27,Santurtzi,Expense,housing,-265.25,-764429.24
buyer_1,Luis,28,ES28209599118326557478,TRX_N-03191-00386625,2024-09-07T19:51:28,Bilbao,basic_services,phone,-63.23,-764492.47
buyer_1,Luis,28,ES28209599118326557478,TRX_N-03192-34829157,2024-09-07T09:29:30,Bilbao,Expense,subscriptions,-79.51,-764571.98
buyer_1,Luis,28,ES28209599118326557478,TRX_N-03193-54530870,2024-09-07T21:26:39,Bilbao,Expense,clothing,-298.2,-764870.18
buyer_1,Luis,28,ES28209599118326557478,TRX_N-03194-32541133,2024-09-07T20:17:47,Bilbao,Expense,car,-394.68,-765264.86
buyer_1,Luis,28,ES28209599118326557478,TRX_N-03195-29088002,2024-09-08T20:10:02,Bilbao,basic_services,electricity,-79.18,-765344.04
buyer_1,Luis,28,ES28209599118326557478,TRX_N-03196-01728312,2024-09-08T16:31:35,Bilbao,basic_services,gas,-43.32,-765387.36
buyer_1,Luis,28,ES28209599118326557478,TRX_N-03197-50488810,2024-09-08T16:26:50,Lasarte-Oria,Expense,housing,-22.43,-765409.79
buyer_1,Luis,28,ES28209599118326557478,TRX_N-03198-17278132,2024-09-08T21:20:20,Bilbao,Expense,food,-340.81,-765750.6
buyer_1,Luis,28,ES28209599118326557478,TRX_N-03199-91562905,2024-09-08T11:04:14,Bilbao,Expense,clothing,-447.04,-766197.64
buyer_1,Luis,28,ES28209599118326557478,TRX_N-03200-48982685,2024-09-09T19:58:44,Galdakao,Expense,housing,-211.98,-766409.62
buyer_1,Luis,28,ES28209599118326557478,TRX_N-03201-58465007,2024-09-09T10:28:51,Bilbao,Expense,food,-376.44,-766786.06
buyer_1,Luis,28,ES28209599118326557478,TRX_N-03202-33508070,2024-09-09T17:50:09,Bilbao,Expense,clothing,-250.97,-767037.03
buyer_1,Luis,28,ES28209599118326557478,TRX_N-03203-00742395,2024-09-10T14:41:43,Bilbao,Expense,technology,-493.26,-767530.29
buyer_1,Luis,28,ES28209599118326557478,TRX_N-03204-86315574,2024-09-10T12:13:09,Bilbao,Expense,personal_care,-311.94,-767842.23
buyer_1,Luis,28,ES28209599118326557478,TRX_N-03205-79706919,2024-09-10T15:01:10,Bilbao,Expense,healthcare,-290.98,-768133.21
buyer_1,Luis,28,ES28209599118326557478,TRX_N-03206-61648075,2024-09-11T18:28:42,Bilbao,Expense,loans,-32.92,-768166.13
buyer_1,Luis,28,ES28209599118326557478,TRX_N-03207-47431336,2024-09-11T08:40:52,Bermeo,Expense,food,-30.33,-768196.46
buyer_1,Luis,28,ES28209599118326557478,TRX_N-03208-15498054,2024-09-11T16:12:05,Bilbao,Expense,car,-277.49,-768473.95
buyer_1,Luis,28,ES28209599118326557478,TRX_N-03209-27652753,2024-09-12T11:04:59,Bilbao,Expense,transport,-281.3,-768755.25
buyer_1,Luis,28,ES28209599118326557478,TRX_N-03210-94940667,2024-09-12T20:28:28,Bilbao,Expense,technology,-260.45,-769015.7
buyer_1,Luis,28,ES28209599118326557478,TRX_N-03211-39241015,2024-09-12T20:29:39,Bilbao,Expense,technology,-75.95,-769091.65
buyer_1,Luis,28,ES28209599118326557478,TRX_N-03212-54370922,2024-09-13T18:37:02,Bilbao,Expense,healthcare,-290.83,-769382.48
buyer_1,Luis,28,ES28209599118326557478,TRX_N-03213-73588957,2024-09-13T20:04:22,Bilbao,Expense,clothing,-406.89,-769789.37
buyer_1,Luis,28,ES28209599118326557478,TRX_N-03214-89755180,2024-09-13T17:03:04,Bilbao,Expense,leisure,-489.18,-770278.55
buyer_1,Luis,28,ES28209599118326557478,TRX_N-03215-09028735,2024-09-14T15:33:05,Bilbao,Expense,technology,-306.27,-770584.82
buyer_1,Luis,28,ES28209599118326557478,TRX_N-03216-62530225,2024-09-14T23:06:01,Durango,Expense,leisure,-198.54,-770783.36
buyer_1,Luis,28,ES28209599118326557478,TRX_N-03217-59733289,2024-09-14T11:41:09,Bilbao,Expense,transport,-209.33,-770992.69
buyer_1,Luis,28,ES28209599118326557478,TRX_N-03218-84233991,2024-09-15T16:04:17,Bilbao,Expense,technology,-119.83,-771112.52
buyer_1,Luis,28,ES28209599118326557478,TRX_N-03219-73176508,2024-09-15T14:57:34,Galdakao,Expense,healthcare,-301.29,-771413.81
buyer_1,Luis,28,ES28209599118326557478,TRX_N-03220-11625502,2024-09-15T18:06:17,Bilbao,Expense,children,-49.99,-771463.8
buyer_1,Luis,28,ES28209599118326557478,TRX_N-03221-69383955,2024-09-16T06:02:18,Bilbao,Expense,car,-304.8,-771768.6
buyer_1,Luis,28,ES28209599118326557478,TRX_N-03222-35537057,2024-09-16T18:16:16,Erandio,Expense,loans,-258.18,-772026.78
buyer_1,Luis,28,ES28209599118326557478,TRX_N-03223-62778611,2024-09-16T09:33:05,Bilbao,Expense,healthcare,-252.58,-772279.36
buyer_1,Luis,28,ES28209599118326557478,TRX_N-03224-37478408,2024-09-17T13:29:04,Bilbao,Expense,car,-463.04,-772742.4
buyer_1,Luis,28,ES28209599118326557478,TRX_N-03225-92474071,2024-09-17T16:41:56,Bilbao,Expense,transport,-449.07,-773191.47
buyer_1,Luis,28,ES28209599118326557478,TRX_N-03226-66884711,2024-09-17T21:05:56,Bilbao,Expense,transport,-281.26,-773472.73
buyer_1,Luis,28,ES28209599118326557478,TRX_N-03227-73363050,2024-09-18T20:58:57,Bilbao,Expense,basic-services,-195.53,-773668.26
buyer_1,Luis,28,ES28209599118326557478,TRX_N-03228-31230800,2024-09-18T15:27:51,Bilbao,Expense,children,-105.18,-773773.44
buyer_1,Luis,28,ES28209599118326557478,TRX_N-03229-61492657,2024-09-18T09:45:44,Mungia,Expense,personal_care,-261.78,-774035.22
buyer_1,Luis,28,ES28209599118326557478,TRX_N-03230-37513106,2024-09-19T09:19:14,Bilbao,Expense,food,-459.96,-774495.18
buyer_1,Luis,28,ES28209599118326557478,TRX_N-03231-20527711,2024-09-19T14:00:26,Bilbao,Expense,education,-167.39,-774662.57
buyer_1,Luis,28,ES28209599118326557478,TRX_N-03232-91733672,2024-09-19T08:39:34,Bilbao,Expense,personal_care,-176.28,-774838.85
buyer_1,Luis,28,ES28209599118326557478,TRX_N-03233-18701109,2024-09-20T15:01:57,Bilbao,Expense,healthcare,-395.42,-775234.27
buyer_1,Luis,28,ES28209599118326557478,TRX_N-03234-91673594,2024-09-20T18:35:26,Bilbao,Expense,healthcare,-162.42,-775396.69
buyer_1,Luis,28,ES28209599118326557478,TRX_N-03235-85772723,2024-09-20T13:22:23,Iruña de Oca,Expense,basic-services,-369.12,-775765.81
buyer_1,Luis,28,ES28209599118326557478,TRX_N-03236-94892655,2024-09-21T13:42:01,Bilbao,Expense,savings,-10.52,-775776.33
buyer_1,Luis,28,ES28209599118326557478,TRX_N-03237-14055718,2024-09-21T17:53:56,Bilbao,Expense,children,-428.47,-776204.8
buyer_1,Luis,28,ES28209599118326557478,TRX_N-03238-45791488,2024-09-21T18:16:03,Bilbao,Expense,housing,-194.65,-776399.45
buyer_1,Luis,28,ES28209599118326557478,TRX_N-03239-71045039,2024-09-22T11:46:57,Bilbao,Expense,basic-services,-304.17,-776703.62
buyer_1,Luis,28,ES28209599118326557478,TRX_N-03240-46011152,2024-09-22T19:53:25,Barakaldo,Expense,basic-services,-190.93,-776894.55
buyer_1,Luis,28,ES28209599118326557478,TRX_N-03241-70150745,2024-09-22T20:33:23,Amurrio,Expense,technology,-224.29,-777118.84
buyer_1,Luis,28,ES28209599118326557478,TRX_N-03242-92026643,2024-09-23T14:16:03,Bilbao,Expense,clothing,-298.33,-777417.17
buyer_1,Luis,28,ES28209599118326557478,TRX_N-03243-39406756,2024-09-23T19:06:34,Bilbao,Expense,basic-services,-139.14,-777556.31
buyer_1,Luis,28,ES28209599118326557478,TRX_N-03244-24168319,2024-09-23T11:47:44,Bilbao,Expense,car,-64.09,-777620.4
buyer_1,Luis,28,ES28209599118326557478,TRX_N-03245-75738635,2024-09-24T18:15:00,Bilbao,Expense,basic-services,-197.24,-777817.64
buyer_1,Luis,28,ES28209599118326557478,TRX_N-03246-17149465,2024-09-24T10:45:55,Lasarte-Oria,Expense,loans,-332.91,-778150.55
buyer_1,Luis,28,ES28209599118326557478,TRX_N-03247-10380193,2024-09-24T16:14:19,Bilbao,Expense,technology,-407.06,-778557.61
buyer_1,Luis,28,ES28209599118326557478,TRX_N-03248-10935207,2024-09-25T20:56:37,Erandio,Expense,children,-420.67,-778978.28
buyer_1,Luis,28,ES28209599118326557478,TRX_N-03249-85652140,2024-09-25T20:24:02,Bilbao,Expense,education,-141.26,-779119.54
buyer_1,Luis,28,ES28209599118326557478,TRX_N-03250-03977639,2024-09-25T18:09:08,Mungia,Expense,basic-services,-216.0,-779335.54
buyer_1,Luis,28,ES28209599118326557478,TRX_N-03251-57884386,2024-09-26T12:46:25,Bilbao,Expense,car,-217.14,-779552.68
buyer_1,Luis,28,ES28209599118326557478,TRX_N-03252-52778407,2024-09-26T07:59:44,Donostia,Expense,basic-services,-474.0,-780026.68
buyer_1,Luis,28,ES28209599118326557478,TRX_N-03253-08012402,2024-09-26T15:44:27,Bilbao,Expense,car,-218.13,-780244.81
buyer_1,Luis,28,ES28209599118326557478,TRX_N-03254-48531015,2024-09-27T16:42:07,Bilbao,Expense,basic-services,-234.78,-780479.59
buyer_1,Luis,28,ES28209599118326557478,TRX_N-03255-82982857,2024-09-27T09:14:21,Bilbao,Expense,technology,-335.75,-780815.34
buyer_1,Luis,28,ES28209599118326557478,TRX_N-03256-59373355,2024-09-27T22:30:43,Bilbao,Expense,clothing,-286.94,-781102.28
buyer_1,Luis,28,ES28209599118326557478,TRX_N-03257-02543571,2024-09-28T15:42:20,Bilbao,Expense,personal_care,-75.89,-781178.17
buyer_1,Luis,28,ES28209599118326557478,TRX_N-03258-22267482,2024-09-28T08:04:38,Bilbao,Expense,technology,-373.57,-781551.74
buyer_1,Luis,28,ES28209599118326557478,TRX_N-03259-50208021,2024-09-28T11:37:25,Bilbao,Expense,personal_care,-460.53,-782012.27
buyer_1,Luis,28,ES28209599118326557478,TRX_N-03260-70012164,2024-09-29T18:31:27,Bilbao,Expense,savings,-264.51,-782276.78
buyer_1,Luis,28,ES28209599118326557478,TRX_N-03261-84552866,2024-09-29T08:57:39,Santurtzi,Expense,basic-services,-479.06,-782755.84
buyer_1,Luis,28,ES28209599118326557478,TRX_N-03262-68704906,2024-09-29T00:54:46,Bilbao,Expense,transport,-356.97,-783112.81
buyer_1,Luis,28,ES28209599118326557478,TRX_N-03263-03088113,2024-09-30T10:55:48,Bilbao,Expense,savings,-392.08,-783504.89
buyer_1,Luis,28,ES28209599118326557478,TRX_N-03264-29269326,2024-09-30T04:35:31,Eibar,Expense,housing,-224.5,-783729.39
buyer_1,Luis,28,ES28209599118326557478,TRX_N-03265-89779502,2024-09-30T17:58:50,Bilbao,Expense,leisure,-44.19,-783773.58
buyer_1,Luis,28,ES28209599118326557478,TRX_N-03266-27729304,2024-10-01T10:21:23,Bilbao,incomes,salary,1265.98,-782507.6
buyer_1,Luis,28,ES28209599118326557478,TRX_N-03267-23379199,2024-10-01T10:21:23,Bilbao,incomes,extra_income,126.6,-782381.0
buyer_1,Luis,28,ES28209599118326557478,TRX_N-03268-85614722,2024-10-01T20:58:32,Bilbao,Expense,subscriptions,-240.96,-782621.96
buyer_1,Luis,28,ES28209599118326557478,TRX_N-03269-72109579,2024-10-01T10:12:28,Bilbao,Expense,car,-109.49,-782731.45
buyer_1,Luis,28,ES28209599118326557478,TRX_N-03270-00265316,2024-10-01T21:41:34,Bilbao,Expense,personal_care,-202.1,-782933.55
buyer_1,Luis,28,ES28209599118326557478,TRX_N-03271-02741102,2024-10-02T20:05:47,Santurtzi,Expense,car,-355.55,-783289.1
buyer_1,Luis,28,ES28209599118326557478,TRX_N-03272-12880921,2024-10-02T13:59:11,Bilbao,Expense,food,-126.43,-783415.53
buyer_1,Luis,28,ES28209599118326557478,TRX_N-03273-22393075,2024-10-02T07:04:11,Leioa,Expense,personal_care,-176.37,-783591.9
buyer_1,Luis,28,ES28209599118326557478,TRX_N-03274-43125539,2024-10-03T10:48:22,Barakaldo,Expense,food,-325.1,-783917.0
buyer_1,Luis,28,ES28209599118326557478,TRX_N-03275-61390716,2024-10-03T19:25:19,Bilbao,Expense,leisure,-421.38,-784338.38
buyer_1,Luis,28,ES28209599118326557478,TRX_N-03276-93040557,2024-10-03T16:57:02,Bilbao,Expense,transport,-494.84,-784833.22
buyer_1,Luis,28,ES28209599118326557478,TRX_N-03277-93739470,2024-10-04T09:26:03,Bilbao,Housing,Rent,-1369.49,-786202.71
buyer_1,Luis,28,ES28209599118326557478,TRX_N-03278-47481271,2024-10-04T09:30:59,Bilbao,Expense,loans,-448.66,-786651.37
buyer_1,Luis,28,ES28209599118326557478,TRX_N-03279-12622398,2024-10-04T09:19:36,Bilbao,Expense,basic-services,-425.54,-787076.91
buyer_1,Luis,28,ES28209599118326557478,TRX_N-03280-75899497,2024-10-04T17:47:54,Bilbao,Expense,transport,-44.12,-787121.03
buyer_1,Luis,28,ES28209599118326557478,TRX_N-03281-79554980,2024-10-05T20:10:15,Bilbao,basic_services,electricity,-52.23,-787173.26
buyer_1,Luis,28,ES28209599118326557478,TRX_N-03282-20402424,2024-10-05T19:53:43,Bilbao,Expense,technology,-137.39,-787310.65
buyer_1,Luis,28,ES28209599118326557478,TRX_N-03283-05755351,2024-10-05T11:15:11,Bilbao,Expense,clothing,-303.15,-787613.8
buyer_1,Luis,28,ES28209599118326557478,TRX_N-03284-83460630,2024-10-05T07:53:47,Bilbao,Expense,housing,-25.15,-787638.95
buyer_1,Luis,28,ES28209599118326557478,TRX_N-03285-92363722,2024-10-06T11:24:59,Bilbao,basic_services,water,-23.09,-787662.04
buyer_1,Luis,28,ES28209599118326557478,TRX_N-03286-56754152,2024-10-06T08:23:51,Alegría-Dulantzi,Expense,leisure,-228.52,-787890.56
buyer_1,Luis,28,ES28209599118326557478,TRX_N-03287-72201016,2024-10-06T10:29:57,Zarautz,Expense,healthcare,-20.52,-787911.08
buyer_1,Luis,28,ES28209599118326557478,TRX_N-03288-03120104,2024-10-06T09:07:27,Donostia,Expense,housing,-22.29,-787933.37
buyer_1,Luis,28,ES28209599118326557478,TRX_N-03289-15908945,2024-10-07T09:45:27,Bilbao,Expense,technology,-37.11,-787970.48
buyer_1,Luis,28,ES28209599118326557478,TRX_N-03290-59822864,2024-10-07T16:38:51,Bilbao,Expense,subscriptions,-402.87,-788373.35
buyer_1,Luis,28,ES28209599118326557478,TRX_N-03291-17506525,2024-10-07T09:56:36,Bilbao,Expense,personal_care,-108.07,-788481.42
buyer_1,Luis,28,ES28209599118326557478,TRX_N-03292-20944405,2024-10-08T02:21:32,Bilbao,basic_services,phone,-95.16,-788576.58
buyer_1,Luis,28,ES28209599118326557478,TRX_N-03293-08994524,2024-10-08T18:24:13,Bilbao,basic_services,gas,-16.83,-788593.41
buyer_1,Luis,28,ES28209599118326557478,TRX_N-03294-72008996,2024-10-08T21:06:32,Bilbao,basic_services,internet,-32.87,-788626.28
buyer_1,Luis,28,ES28209599118326557478,TRX_N-03295-53050745,2024-10-08T23:24:30,Eibar,Expense,savings,-133.27,-788759.55
buyer_1,Luis,28,ES28209599118326557478,TRX_N-03296-80689700,2024-10-08T13:00:59,Bilbao,Expense,education,-267.2,-789026.75
buyer_1,Luis,28,ES28209599118326557478,TRX_N-03297-08915457,2024-10-08T20:34:46,Bilbao,Expense,car,-295.81,-789322.56
