profile,name,age,iban,trx_id,timestamp,city,trx_type,trx_cat,amount_eur,balance
buyer_1,Luis,28,ES56209552778483068985,TRX_N-00001-69937029,2022-01-01T20:37:33,Bilbao,incomes,salary,1403.02,2943.01
buyer_1,Luis,28,ES56209552778483068985,TRX_N-00002-62936149,2022-01-01T20:37:33,Bilbao,incomes,salary_partner,1319.6,4262.61
buyer_1,Luis,28,ES56209552778483068985,TRX_N-00003-61617379,2022-01-01T19:44:33,Oy√≥n-Oion,Expense,education,-47.34,4215.27
buyer_1,Luis,28,ES56209552778483068985,TRX_N-00004-26749769,2022-01-02T20:37:54,Bilbao,Expense,leisure,-65.84,4149.43
buyer_1,Luis,28,ES56209552778483068985,TRX_N-00005-41404127,2022-01-03T14:30:05,Bilbao,Expense,food,-62.24,4087.19
buyer_1,Luis,28,ES56209552778483068985,TRX_N-00006-82058332,2022-01-03T17:43:04,Bilbao,Expense,gifts,-81.52,4005.67
buyer_1,Luis,28,ES56209552778483068985,TRX_N-00007-85110675,2022-01-04T19:15:20,Bilbao,expenses,mortgage,-731.08,3274.59
buyer_1,Luis,28,ES56209552778483068985,TRX_N-00008-30953383,2022-01-04T20:45:12,Santurtzi,Expense,cash,-100.0,3174.59
buyer_1,Luis,28,ES56209552778483068985,TRX_N-00009-65591847,2022-01-04T13:52:19,Getxo,Expense,repairs,-322.87,2851.72
buyer_1,Luis,28,ES56209552778483068985,TRX_N-00010-47532625,2022-01-04T21:26:15,Bilbao,Expense,gifts,-649.02,2202.7
buyer_1,Luis,28,ES56209552778483068985,TRX_N-00011-27795550,2022-01-05T12:19:21,Bilbao,expenses,electricity,-63.86,2138.84
buyer_1,Luis,28,ES56209552778483068985,TRX_N-00012-09037079,2022-01-05T10:59:59,Bilbao,expenses,phone,-32.41,2106.43
buyer_1,Luis,28,ES56209552778483068985,TRX_N-00013-82267486,2022-01-05T12:59:49,Bilbao,Expense,food,-65.95,2040.48
buyer_1,Luis,28,ES56209552778483068985,TRX_N-00014-69559126,2022-01-06T18:59:14,Bilbao,expenses,gas,-108.56,1931.92
buyer_1,Luis,28,ES56209552778483068985,TRX_N-00015-06022910,2022-01-06T19:17:02,Bilbao,Expense,food,-86.13,1845.79
buyer_1,Luis,28,ES56209552778483068985,TRX_N-00016-72936959,2022-01-08T14:24:32,Bilbao,expenses,water,-35.12,1810.67
buyer_1,Luis,28,ES56209552778483068985,TRX_N-00017-29908825,2022-01-08T08:13:13,Bilbao,expenses,internet,-42.0,1768.67
buyer_1,Luis,28,ES56209552778483068985,TRX_N-00018-70609196,2022-01-08T22:59:08,Bilbao,Expense,repairs,-37.28,1731.39
buyer_1,Luis,28,ES56209552778483068985,TRX_N-00019-98885837,2022-01-08T13:55:25,Bilbao,Expense,gifts,-182.08,1549.31
buyer_1,Luis,28,ES56209552778483068985,TRX_N-00020-07546603,2022-01-09T14:30:52,Bilbao,Expense,food,-90.98,1458.33
buyer_1,Luis,28,ES56209552778483068985,TRX_N-00021-15953828,2022-01-09T22:52:46,Bilbao,Expense,transport,-46.23,1412.1
buyer_1,Luis,28,ES56209552778483068985,TRX_N-00022-65331980,2022-01-10T18:09:27,Bilbao,Expense,education,-49.82,1362.28
buyer_1,Luis,28,ES56209552778483068985,TRX_N-00023-78894035,2022-01-11T17:18:34,Bilbao,Expense,repairs,-183.57,1178.71
buyer_1,Luis,28,ES56209552778483068985,TRX_N-00024-01332840,2022-01-12T11:15:15,Bilbao,Expense,food,-123.39,1055.32
buyer_1,Luis,28,ES56209552778483068985,TRX_N-00025-32460035,2022-01-13T18:38:58,Bilbao,Expense,healthcare,-42.36,1012.96
buyer_1,Luis,28,ES56209552778483068985,TRX_N-00026-25863696,2022-01-15T10:06:05,Bilbao,Expense,repairs,-202.0,810.96
buyer_1,Luis,28,ES56209552778483068985,TRX_N-00027-09399656,2022-01-17T15:53:40,Bilbao,Expense,cash,-100.0,710.96
buyer_1,Luis,28,ES56209552778483068985,TRX_N-00028-85667471,2022-01-20T13:37:33,Bilbao,Expense,cash,-100.0,610.96
buyer_1,Luis,28,ES56209552778483068985,TRX_N-00029-29784770,2022-01-23T11:48:59,Bilbao,Expense,education,-60.53,550.43
buyer_1,Luis,28,ES56209552778483068985,TRX_N-00030-39124547,2022-01-24T19:16:20,Bilbao,Expense,clothing,-52.57,497.86
buyer_1,Luis,28,ES56209552778483068985,TRX_N-00031-35439284,2022-01-25T10:57:39,Bilbao,Expense,gifts,-508.19,-10.33
buyer_1,Luis,28,ES56209552778483068985,TRX_N-00032-85660822,2022-01-26T09:07:41,Bilbao,Expense,cash,-100.0,-110.33
buyer_1,Luis,28,ES56209552778483068985,TRX_N-00033-58729272,2022-01-27T19:25:41,Bilbao,Expense,leisure,-60.6,-170.93
buyer_1,Luis,28,ES56209552778483068985,TRX_N-00034-13422027,2022-01-28T21:27:26,Bilbao,Expense,cash,-100.0,-270.93
buyer_1,Luis,28,ES56209552778483068985,TRX_N-00035-85618571,2022-01-29T20:37:36,Errenteria,Expense,cash,-100.0,-370.93
buyer_1,Luis,28,ES56209552778483068985,TRX_N-00036-53366689,2022-01-30T18:45:08,Bilbao,Expense,transport,-47.86,-418.79
buyer_1,Luis,28,ES56209552778483068985,TRX_N-00037-63004559,2022-01-30T12:08:03,Bilbao,Expense,gifts,-791.65,-1210.44
buyer_1,Luis,28,ES56209552778483068985,TRX_N-00038-48089845,2022-02-01T18:57:41,Bilbao,incomes,salary,1403.02,192.58
buyer_1,Luis,28,ES56209552778483068985,TRX_N-00039-44919653,2022-02-01T18:57:41,Bilbao,incomes,salary_partner,1319.6,1512.18
buyer_1,Luis,28,ES56209552778483068985,TRX_N-00040-44579545,2022-02-03T15:59:46,Bilbao,Expense,education,-66.27,1445.91
buyer_1,Luis,28,ES56209552778483068985,TRX_N-00041-99859387,2022-02-03T15:23:57,Bilbao,expenses,children,-82.74,1363.17
buyer_1,Luis,28,ES56209552778483068985,TRX_N-00042-96943481,2022-02-04T13:18:32,Bilbao,expenses,mortgage,-731.08,632.09
buyer_1,Luis,28,ES56209552778483068985,TRX_N-00043-26950863,2022-02-04T10:29:51,Bilbao,Expense,gifts,-476.35,155.74
buyer_1,Luis,28,ES56209552778483068985,TRX_N-00044-90197387,2022-02-05T10:45:23,Bilbao,expenses,internet,-42.0,113.74
buyer_1,Luis,28,ES56209552778483068985,TRX_N-00045-79798488,2022-02-05T19:41:02,Bilbao,expenses,phone,-43.93,69.81
buyer_1,Luis,28,ES56209552778483068985,TRX_N-00046-24151488,2022-02-05T13:13:11,Sopela,Expense,transport,-72.72,-2.91
buyer_1,Luis,28,ES56209552778483068985,TRX_N-00047-22067293,2022-02-06T17:57:52,Bilbao,expenses,gas,-63.34,-66.25
buyer_1,Luis,28,ES56209552778483068985,TRX_N-00048-57672772,2022-02-06T08:44:25,Bilbao,Expense,repairs,-207.82,-274.07
buyer_1,Luis,28,ES56209552778483068985,TRX_N-00049-40759606,2022-02-08T18:05:20,Bilbao,expenses,water,-44.25,-318.32
buyer_1,Luis,28,ES56209552778483068985,TRX_N-00050-82792277,2022-02-08T16:17:35,Bilbao,expenses,electricity,-82.27,-400.59
buyer_1,Luis,28,ES56209552778483068985,TRX_N-00051-48022040,2022-02-08T18:01:53,Bilbao,Expense,cash,-100.0,-500.59
buyer_1,Luis,28,ES56209552778483068985,TRX_N-00052-84919705,2022-02-08T15:53:32,Bilbao,Expense,gifts,-553.23,-1053.82
buyer_1,Luis,28,ES56209552778483068985,TRX_N-00053-47822007,2022-02-09T19:22:46,Bilbao,Expense,repairs,-188.93,-1242.75
buyer_1,Luis,28,ES56209552778483068985,TRX_N-00054-54341147,2022-02-10T13:11:13,Bilbao,Expense,healthcare,-154.09,-1396.84
buyer_1,Luis,28,ES56209552778483068985,TRX_N-00055-47351310,2022-02-12T09:16:19,Sopela,Expense,leisure,-69.72,-1466.56
buyer_1,Luis,28,ES56209552778483068985,TRX_N-00056-63367820,2022-02-14T18:55:48,Llodio,Expense,healthcare,-156.19,-1622.75
buyer_1,Luis,28,ES56209552778483068985,TRX_N-00057-43469116,2022-02-15T01:45:28,Bilbao,Expense,appliances,-187.04,-1809.79
buyer_1,Luis,28,ES56209552778483068985,TRX_N-00058-44097865,2022-02-16T16:24:25,Bilbao,Expense,cash,-100.0,-1909.79
buyer_1,Luis,28,ES56209552778483068985,TRX_N-00059-92640198,2022-02-20T18:10:20,Bilbao,Expense,cash,-100.0,-2009.79
buyer_1,Luis,28,ES56209552778483068985,TRX_N-00060-22013080,2022-02-22T16:01:52,Bilbao,Expense,education,-43.19,-2052.98
buyer_1,Luis,28,ES56209552778483068985,TRX_N-00061-36593951,2022-02-23T10:34:17,Bilbao,Expense,education,-50.1,-2103.08
buyer_1,Luis,28,ES56209552778483068985,TRX_N-00062-30992139,2022-02-25T18:37:04,Bilbao,Expense,leisure,-63.99,-2167.07
buyer_1,Luis,28,ES56209552778483068985,TRX_N-00063-70828614,2022-02-25T13:23:38,Bilbao,expenses,children,-122.7,-2289.77
buyer_1,Luis,28,ES56209552778483068985,TRX_N-00064-12896764,2022-02-26T18:36:44,Sestao,Expense,education,-48.6,-2338.37
buyer_1,Luis,28,ES56209552778483068985,TRX_N-00065-33171299,2022-02-28T16:09:52,Bilbao,Expense,travel,-1062.88,-3401.25
buyer_1,Luis,28,ES56209552778483068985,TRX_N-00066-20108198,2022-03-01T13:51:47,Bilbao,incomes,salary,1403.02,-1998.23
buyer_1,Luis,28,ES56209552778483068985,TRX_N-00067-26947753,2022-03-01T13:51:47,Bilbao,incomes,salary_partner,1319.6,-678.63
buyer_1,Luis,28,ES56209552778483068985,TRX_N-00068-36863901,2022-03-01T13:51:47,Bilbao,incomes,extra_income,186.09,-492.54
buyer_1,Luis,28,ES56209552778483068985,TRX_N-00069-20888770,2022-03-01T19:07:39,Bilbao,Expense,leisure,-36.22,-528.76
buyer_1,Luis,28,ES56209552778483068985,TRX_N-00070-09726505,2022-03-02T17:05:08,Bilbao,Expense,leisure,-41.92,-570.68
buyer_1,Luis,28,ES56209552778483068985,TRX_N-00071-47024583,2022-03-04T08:39:48,Bilbao,expenses,mortgage,-731.08,-1301.76
buyer_1,Luis,28,ES56209552778483068985,TRX_N-00072-50040142,2022-03-04T23:47:01,Bilbao,Expense,cash,-100.0,-1401.76
buyer_1,Luis,28,ES56209552778483068985,TRX_N-00073-12413081,2022-03-06T09:16:58,Bilbao,expenses,electricity,-27.77,-1429.53
buyer_1,Luis,28,ES56209552778483068985,TRX_N-00074-76438061,2022-03-07T12:26:53,Bilbao,expenses,water,-32.12,-1461.65
buyer_1,Luis,28,ES56209552778483068985,TRX_N-00075-15192085,2022-03-07T12:12:01,Bilbao,expenses,gas,-37.93,-1499.58
buyer_1,Luis,28,ES56209552778483068985,TRX_N-00076-63419179,2022-03-07T12:52:32,Bilbao,expenses,internet,-42.0,-1541.58
buyer_1,Luis,28,ES56209552778483068985,TRX_N-00077-26179439,2022-03-07T17:26:43,Bilbao,expenses,phone,-33.66,-1575.24
buyer_1,Luis,28,ES56209552778483068985,TRX_N-00078-22916067,2022-03-07T19:25:11,Bilbao,Expense,clothing,-74.53,-1649.77
buyer_1,Luis,28,ES56209552778483068985,TRX_N-00079-89395613,2022-03-07T12:48:48,Irun,Expense,appliances,-204.55,-1854.32
buyer_1,Luis,28,ES56209552778483068985,TRX_N-00080-76468255,2022-03-07T13:53:08,Bilbao,Expense,gifts,-404.42,-2258.74
buyer_1,Luis,28,ES56209552778483068985,TRX_N-00081-78674271,2022-03-08T15:51:05,Bilbao,Expense,leisure,-34.66,-2293.4
buyer_1,Luis,28,ES56209552778483068985,TRX_N-00082-37673612,2022-03-13T15:54:35,Bilbao,Expense,cash,-100.0,-2393.4
buyer_1,Luis,28,ES56209552778483068985,TRX_N-00083-04344899,2022-03-15T19:51:13,Bilbao,Expense,food,-102.44,-2495.84
buyer_1,Luis,28,ES56209552778483068985,TRX_N-00084-78313784,2022-03-15T15:32:48,Bilbao,Expense,cash,-100.0,-2595.84
buyer_1,Luis,28,ES56209552778483068985,TRX_N-00085-52385132,2022-03-15T12:05:53,Berango,Expense,repairs,-157.97,-2753.81
buyer_1,Luis,28,ES56209552778483068985,TRX_N-00086-63486621,2022-03-16T17:05:41,Bilbao,Expense,cash,-100.0,-2853.81
buyer_1,Luis,28,ES56209552778483068985,TRX_N-00087-14660535,2022-03-17T12:26:47,Oy√≥n-Oion,Expense,travel,-1443.42,-4297.23
buyer_1,Luis,28,ES56209552778483068985,TRX_N-00088-63488901,2022-03-18T13:09:35,Bilbao,Expense,cash,-100.0,-4397.23
buyer_1,Luis,28,ES56209552778483068985,TRX_N-00089-63434826,2022-03-19T15:21:47,Bilbao,Expense,cash,-100.0,-4497.23
buyer_1,Luis,28,ES56209552778483068985,TRX_N-00090-47139806,2022-03-20T08:40:24,Bilbao,Expense,food,-66.63,-4563.86
buyer_1,Luis,28,ES56209552778483068985,TRX_N-00091-91721356,2022-03-20T00:43:51,Sestao,Expense,clothing,-53.57,-4617.43
buyer_1,Luis,28,ES56209552778483068985,TRX_N-00092-40993606,2022-03-21T19:30:38,Elciego,Expense,transport,-66.66,-4684.09
buyer_1,Luis,28,ES56209552778483068985,TRX_N-00093-68731858,2022-03-24T09:05:02,Bilbao,Expense,leisure,-77.39,-4761.48
buyer_1,Luis,28,ES56209552778483068985,TRX_N-00094-21142169,2022-03-26T10:15:53,Hondarribia,Expense,transport,-56.7,-4818.18
buyer_1,Luis,28,ES56209552778483068985,TRX_N-00095-19014899,2022-03-27T16:32:05,Bilbao,Expense,leisure,-61.86,-4880.04
buyer_1,Luis,28,ES56209552778483068985,TRX_N-00096-96399048,2022-03-28T17:14:47,Bilbao,Expense,leisure,-54.56,-4934.6
buyer_1,Luis,28,ES56209552778483068985,TRX_N-00097-79346950,2022-04-01T10:20:44,Bilbao,incomes,salary,1403.02,-3531.58
buyer_1,Luis,28,ES56209552778483068985,TRX_N-00098-86403403,2022-04-01T10:20:44,Bilbao,incomes,salary_partner,1319.6,-2211.98
buyer_1,Luis,28,ES56209552778483068985,TRX_N-00099-08589265,2022-04-01T03:32:35,Bilbao,Expense,transport,-73.66,-2285.64
buyer_1,Luis,28,ES56209552778483068985,TRX_N-00100-66274982,2022-04-01T13:29:48,Pasaia,Expense,leisure,-30.82,-2316.46
buyer_1,Luis,28,ES56209552778483068985,TRX_N-00101-53411832,2022-04-02T15:26:58,Bilbao,Expense,healthcare,-60.4,-2376.86
buyer_1,Luis,28,ES56209552778483068985,TRX_N-00102-32934740,2022-04-03T15:55:50,Bilbao,Expense,repairs,-272.57,-2649.43
buyer_1,Luis,28,ES56209552778483068985,TRX_N-00103-28670103,2022-04-04T20:35:58,Bilbao,expenses,mortgage,-731.08,-3380.51
buyer_1,Luis,28,ES56209552778483068985,TRX_N-00104-77204595,2022-04-04T09:23:57,Bilbao,Expense,food,-63.87,-3444.38
buyer_1,Luis,28,ES56209552778483068985,TRX_N-00105-15442319,2022-04-04T01:02:14,Oy√≥n-Oion,Expense,cash,-100.0,-3544.38
buyer_1,Luis,28,ES56209552778483068985,TRX_N-00106-58661186,2022-04-05T12:17:37,Bilbao,expenses,water,-30.3,-3574.68
buyer_1,Luis,28,ES56209552778483068985,TRX_N-00107-62421922,2022-04-05T20:13:57,Bilbao,expenses,electricity,-79.8,-3654.48
buyer_1,Luis,28,ES56209552778483068985,TRX_N-00108-60031790,2022-04-05T18:03:43,Bilbao,expenses,gas,-34.6,-3689.08
buyer_1,Luis,28,ES56209552778483068985,TRX_N-00109-06190344,2022-04-05T22:14:43,Bilbao,expenses,internet,-42.0,-3731.08
buyer_1,Luis,28,ES56209552778483068985,TRX_N-00110-94176964,2022-04-05T17:58:32,Bilbao,Expense,food,-70.03,-3801.11
buyer_1,Luis,28,ES56209552778483068985,TRX_N-00111-96997299,2022-04-05T15:49:59,Pasaia,Expense,transport,-78.24,-3879.35
buyer_1,Luis,28,ES56209552778483068985,TRX_N-00112-17842206,2022-04-05T17:10:50,Bilbao,Expense,cash,-100.0,-3979.35
buyer_1,Luis,28,ES56209552778483068985,TRX_N-00113-95145090,2022-04-06T16:58:04,Lasarte-Oria,Expense,cash,-100.0,-4079.35
buyer_1,Luis,28,ES56209552778483068985,TRX_N-00114-49319847,2022-04-08T14:19:52,Bilbao,expenses,phone,-41.27,-4120.62
buyer_1,Luis,28,ES56209552778483068985,TRX_N-00115-72373338,2022-04-08T17:02:26,Bilbao,Expense,food,-104.49,-4225.11
buyer_1,Luis,28,ES56209552778483068985,TRX_N-00116-08406896,2022-04-09T13:07:53,Getxo,Expense,education,-67.88,-4292.99
buyer_1,Luis,28,ES56209552778483068985,TRX_N-00117-11014582,2022-04-10T10:14:14,Bilbao,Expense,food,-67.53,-4360.52
buyer_1,Luis,28,ES56209552778483068985,TRX_N-00118-62612107,2022-04-10T12:15:56,Salvatierra/Agurain,Expense,appliances,-286.34,-4646.86
buyer_1,Luis,28,ES56209552778483068985,TRX_N-00119-69426642,2022-04-11T20:34:04,Bilbao,Expense,food,-103.79,-4750.65
buyer_1,Luis,28,ES56209552778483068985,TRX_N-00120-42392241,2022-04-11T21:10:07,Bilbao,Expense,leisure,-31.18,-4781.83
buyer_1,Luis,28,ES56209552778483068985,TRX_N-00121-07632267,2022-04-11T20:34:10,Errenteria,Expense,repairs,-96.57,-4878.4
buyer_1,Luis,28,ES56209552778483068985,TRX_N-00122-51249228,2022-04-12T18:35:04,Bilbao,Expense,repairs,-167.5,-5045.9
buyer_1,Luis,28,ES56209552778483068985,TRX_N-00123-93190979,2022-04-16T01:26:50,Bilbao,Expense,repairs,-169.31,-5215.21
buyer_1,Luis,28,ES56209552778483068985,TRX_N-00124-13803132,2022-04-18T17:07:13,Bilbao,Expense,repairs,-91.11,-5306.32
buyer_1,Luis,28,ES56209552778483068985,TRX_N-00125-91238991,2022-04-20T19:14:27,Erandio,Expense,leisure,-61.96,-5368.28
buyer_1,Luis,28,ES56209552778483068985,TRX_N-00126-41604830,2022-04-22T09:03:02,Bilbao,Expense,cash,-100.0,-5468.28
buyer_1,Luis,28,ES56209552778483068985,TRX_N-00127-95426788,2022-04-23T13:58:15,Bilbao,Expense,cash,-100.0,-5568.28
buyer_1,Luis,28,ES56209552778483068985,TRX_N-00128-69383002,2022-04-24T13:53:07,Hondarribia,Expense,leisure,-43.55,-5611.83
buyer_1,Luis,28,ES56209552778483068985,TRX_N-00129-31379906,2022-04-25T08:15:34,Bilbao,expenses,children,-124.5,-5736.33
buyer_1,Luis,28,ES56209552778483068985,TRX_N-00130-46278194,2022-04-26T16:42:29,Bilbao,Expense,food,-87.83,-5824.16
buyer_1,Luis,28,ES56209552778483068985,TRX_N-00131-71088878,2022-04-27T18:45:03,Bilbao,Expense,repairs,-218.86,-6043.02
buyer_1,Luis,28,ES56209552778483068985,TRX_N-00132-11883738,2022-04-29T16:48:12,Bilbao,Expense,food,-62.17,-6105.19
buyer_1,Luis,28,ES56209552778483068985,TRX_N-00133-47443904,2022-04-29T13:30:58,Bilbao,Expense,repairs,-282.14,-6387.33
buyer_1,Luis,28,ES56209552778483068985,TRX_N-00134-94650008,2022-05-01T23:16:41,Bilbao,incomes,salary,1403.02,-4984.31
buyer_1,Luis,28,ES56209552778483068985,TRX_N-00135-63180145,2022-05-01T23:16:41,Bilbao,incomes,salary_partner,1319.6,-3664.71
buyer_1,Luis,28,ES56209552778483068985,TRX_N-00136-57862984,2022-05-01T16:32:45,Bilbao,Expense,leisure,-73.76,-3738.47
buyer_1,Luis,28,ES56209552778483068985,TRX_N-00137-26809270,2022-05-02T01:59:49,Bilbao,Expense,transport,-48.18,-3786.65
buyer_1,Luis,28,ES56209552778483068985,TRX_N-00138-10572964,2022-05-04T15:01:49,Bilbao,expenses,mortgage,-731.08,-4517.73
buyer_1,Luis,28,ES56209552778483068985,TRX_N-00139-29806888,2022-05-04T13:28:46,Bilbao,Expense,food,-75.71,-4593.44
buyer_1,Luis,28,ES56209552778483068985,TRX_N-00140-97583999,2022-05-05T12:57:56,Bilbao,expenses,gas,-96.74,-4690.18
buyer_1,Luis,28,ES56209552778483068985,TRX_N-00141-23629930,2022-05-05T12:39:29,Bilbao,expenses,phone,-30.03,-4720.21
buyer_1,Luis,28,ES56209552778483068985,TRX_N-00142-08938695,2022-05-06T11:49:33,Bilbao,expenses,electricity,-22.6,-4742.81
buyer_1,Luis,28,ES56209552778483068985,TRX_N-00143-98543153,2022-05-06T03:15:18,Bilbao,Expense,leisure,-54.21,-4797.02
buyer_1,Luis,28,ES56209552778483068985,TRX_N-00144-32895576,2022-05-07T23:53:48,Bilbao,expenses,internet,-42.0,-4839.02
buyer_1,Luis,28,ES56209552778483068985,TRX_N-00145-72919692,2022-05-07T05:43:46,Bilbao,Expense,clothing,-109.55,-4948.57
buyer_1,Luis,28,ES56209552778483068985,TRX_N-00146-66269327,2022-05-08T22:58:13,Bilbao,expenses,water,-36.61,-4985.18
buyer_1,Luis,28,ES56209552778483068985,TRX_N-00147-47742512,2022-05-09T16:19:05,Sopela,Expense,cash,-100.0,-5085.18
buyer_1,Luis,28,ES56209552778483068985,TRX_N-00148-98041087,2022-05-09T15:49:07,Bilbao,Expense,appliances,-244.21,-5329.39
buyer_1,Luis,28,ES56209552778483068985,TRX_N-00149-09191527,2022-05-11T12:57:14,Bilbao,Expense,cash,-100.0,-5429.39
buyer_1,Luis,28,ES56209552778483068985,TRX_N-00150-33603610,2022-05-14T09:07:27,Bilbao,Expense,food,-93.43,-5522.82
buyer_1,Luis,28,ES56209552778483068985,TRX_N-00151-66016568,2022-05-15T18:07:09,Bilbao,Expense,leisure,-40.14,-5562.96
buyer_1,Luis,28,ES56209552778483068985,TRX_N-00152-36430303,2022-05-17T08:28:07,Bilbao,Expense,transport,-54.64,-5617.6
buyer_1,Luis,28,ES56209552778483068985,TRX_N-00153-73127453,2022-05-18T08:25:34,Bilbao,Expense,repairs,-307.04,-5924.64
buyer_1,Luis,28,ES56209552778483068985,TRX_N-00154-24219493,2022-05-19T13:42:24,Bilbao,Expense,cash,-100.0,-6024.64
buyer_1,Luis,28,ES56209552778483068985,TRX_N-00155-85530827,2022-05-22T10:33:04,Durango,Expense,cash,-100.0,-6124.64
buyer_1,Luis,28,ES56209552778483068985,TRX_N-00156-63381014,2022-05-23T20:43:59,Bilbao,Expense,healthcare,-41.64,-6166.28
buyer_1,Luis,28,ES56209552778483068985,TRX_N-00157-02218171,2022-05-26T17:57:16,Durango,Expense,food,-74.91,-6241.19
buyer_1,Luis,28,ES56209552778483068985,TRX_N-00158-26107908,2022-05-27T16:05:18,Leioa,Expense,repairs,-164.46,-6405.65
buyer_1,Luis,28,ES56209552778483068985,TRX_N-00159-68056174,2022-05-28T13:23:30,Leioa,Expense,leisure,-22.14,-6427.79
buyer_1,Luis,28,ES56209552778483068985,TRX_N-00160-25199697,2022-05-30T15:56:54,Bilbao,Expense,leisure,-77.83,-6505.62
buyer_1,Luis,28,ES56209552778483068985,TRX_N-00161-66212022,2022-05-31T19:00:23,Bilbao,Expense,food,-120.99,-6626.61
buyer_1,Luis,28,ES56209552778483068985,TRX_N-00162-69891868,2022-05-31T16:13:10,Bilbao,Expense,healthcare,-76.08,-6702.69
buyer_1,Luis,28,ES56209552778483068985,TRX_N-00163-24902891,2022-06-01T18:59:53,Bilbao,incomes,salary,1403.02,-5299.67
buyer_1,Luis,28,ES56209552778483068985,TRX_N-00164-70712884,2022-06-01T18:59:53,Bilbao,incomes,salary_partner,1319.6,-3980.07
buyer_1,Luis,28,ES56209552778483068985,TRX_N-00165-70883253,2022-06-01T18:59:53,Bilbao,incomes,extra_income,186.09,-3793.98
buyer_1,Luis,28,ES56209552778483068985,TRX_N-00166-19760283,2022-06-01T18:59:53,Bilbao,incomes,salary_bonus,1018.45,-2775.53
buyer_1,Luis,28,ES56209552778483068985,TRX_N-00167-57024153,2022-06-01T18:59:53,Bilbao,incomes,salary_partner_bonus,1024.54,-1750.99
buyer_1,Luis,28,ES56209552778483068985,TRX_N-00168-03183672,2022-06-01T09:56:44,Bilbao,expenses,taxes,-1527.61,-3278.6
buyer_1,Luis,28,ES56209552778483068985,TRX_N-00169-18158791,2022-06-01T06:39:45,Bilbao,expenses,insurance,-452.83,-3731.43
buyer_1,Luis,28,ES56209552778483068985,TRX_N-00170-76338346,2022-06-01T21:18:26,Bilbao,Expense,food,-98.05,-3829.48
buyer_1,Luis,28,ES56209552778483068985,TRX_N-00171-88576082,2022-06-01T18:48:42,Bilbao,Expense,transport,-89.35,-3918.83
buyer_1,Luis,28,ES56209552778483068985,TRX_N-00172-33519697,2022-06-04T12:17:30,Bilbao,expenses,mortgage,-731.08,-4649.91
buyer_1,Luis,28,ES56209552778483068985,TRX_N-00173-32441022,2022-06-04T08:23:55,Basauri,Expense,food,-60.82,-4710.73
buyer_1,Luis,28,ES56209552778483068985,TRX_N-00174-44674242,2022-06-04T19:07:06,Bilbao,Expense,transport,-55.67,-4766.4
buyer_1,Luis,28,ES56209552778483068985,TRX_N-00175-07290171,2022-06-04T12:16:43,Bilbao,expenses,children,-111.47,-4877.87
buyer_1,Luis,28,ES56209552778483068985,TRX_N-00176-03463218,2022-06-05T18:35:24,Bilbao,expenses,water,-21.01,-4898.88
buyer_1,Luis,28,ES56209552778483068985,TRX_N-00177-87462855,2022-06-06T09:20:31,Bilbao,expenses,internet,-42.0,-4940.88
buyer_1,Luis,28,ES56209552778483068985,TRX_N-00178-18603405,2022-06-07T20:03:56,Bilbao,expenses,electricity,-71.82,-5012.7
buyer_1,Luis,28,ES56209552778483068985,TRX_N-00179-52745174,2022-06-07T15:06:20,Bilbao,Expense,food,-97.74,-5110.44
buyer_1,Luis,28,ES56209552778483068985,TRX_N-00180-02790497,2022-06-08T11:11:23,Bilbao,expenses,gas,-62.6,-5173.04
buyer_1,Luis,28,ES56209552778483068985,TRX_N-00181-43575198,2022-06-08T16:41:34,Bilbao,expenses,phone,-31.15,-5204.19
buyer_1,Luis,28,ES56209552778483068985,TRX_N-00182-85925023,2022-06-08T19:54:47,Mungia,Expense,food,-61.04,-5265.23
buyer_1,Luis,28,ES56209552778483068985,TRX_N-00183-37225261,2022-06-08T23:35:28,Bilbao,expenses,children,-248.55,-5513.78
buyer_1,Luis,28,ES56209552778483068985,TRX_N-00184-07773542,2022-06-10T10:22:38,Bilbao,Expense,transport,-61.51,-5575.29
buyer_1,Luis,28,ES56209552778483068985,TRX_N-00185-34863112,2022-06-10T01:01:55,Bilbao,Expense,leisure,-34.42,-5609.71
buyer_1,Luis,28,ES56209552778483068985,TRX_N-00186-71817708,2022-06-12T12:44:18,Bilbao,Expense,leisure,-44.85,-5654.56
buyer_1,Luis,28,ES56209552778483068985,TRX_N-00187-61401949,2022-06-14T01:49:31,Bilbao,Expense,leisure,-46.22,-5700.78
buyer_1,Luis,28,ES56209552778483068985,TRX_N-00188-40541544,2022-06-14T22:05:24,Bilbao,Expense,appliances,-317.02,-6017.8
buyer_1,Luis,28,ES56209552778483068985,TRX_N-00189-47962132,2022-06-14T15:19:58,Bilbao,Expense,gifts,-553.6,-6571.4
buyer_1,Luis,28,ES56209552778483068985,TRX_N-00190-64910973,2022-06-15T09:10:47,Sopela,Expense,leisure,-78.91,-6650.31
buyer_1,Luis,28,ES56209552778483068985,TRX_N-00191-36767699,2022-06-17T11:38:37,Iru√±a de Oca,Expense,food,-66.56,-6716.87
buyer_1,Luis,28,ES56209552778483068985,TRX_N-00192-35109746,2022-06-17T21:50:53,Bilbao,Expense,leisure,-25.87,-6742.74
buyer_1,Luis,28,ES56209552778483068985,TRX_N-00193-20669454,2022-06-17T18:36:14,Bilbao,Expense,cash,-100.0,-6842.74
buyer_1,Luis,28,ES56209552778483068985,TRX_N-00194-61003735,2022-06-18T13:45:32,Basauri,Expense,gifts,-397.45,-7240.19
buyer_1,Luis,28,ES56209552778483068985,TRX_N-00195-99372358,2022-06-21T10:08:40,Bilbao,Expense,food,-105.31,-7345.5
buyer_1,Luis,28,ES56209552778483068985,TRX_N-00196-65861883,2022-06-21T16:29:00,Bilbao,Expense,cash,-100.0,-7445.5
buyer_1,Luis,28,ES56209552778483068985,TRX_N-00197-19638662,2022-06-22T09:58:09,Bilbao,Expense,transport,-49.96,-7495.46
buyer_1,Luis,28,ES56209552778483068985,TRX_N-00198-68506284,2022-06-22T04:50:16,Bilbao,Expense,healthcare,-126.64,-7622.1
buyer_1,Luis,28,ES56209552778483068985,TRX_N-00199-61881791,2022-06-23T20:28:54,Bilbao,Expense,leisure,-72.8,-7694.9
buyer_1,Luis,28,ES56209552778483068985,TRX_N-00200-05803032,2022-06-28T04:50:45,Bilbao,Expense,cash,-100.0,-7794.9
buyer_1,Luis,28,ES56209552778483068985,TRX_N-00201-92654457,2022-06-29T14:57:44,Bilbao,Expense,leisure,-73.64,-7868.54
buyer_1,Luis,28,ES56209552778483068985,TRX_N-00202-69730422,2022-07-01T15:43:43,Bilbao,incomes,salary,1403.02,-6465.52
buyer_1,Luis,28,ES56209552778483068985,TRX_N-00203-83569398,2022-07-01T15:43:43,Bilbao,incomes,salary_partner,1319.6,-5145.92
buyer_1,Luis,28,ES56209552778483068985,TRX_N-00204-59763187,2022-07-02T17:09:33,Bilbao,expenses,children,-99.29,-5245.21
buyer_1,Luis,28,ES56209552778483068985,TRX_N-00205-25837996,2022-07-04T20:02:17,Bilbao,expenses,mortgage,-731.08,-5976.29
buyer_1,Luis,28,ES56209552778483068985,TRX_N-00206-62638636,2022-07-05T14:53:26,Bilbao,expenses,internet,-42.0,-6018.29
buyer_1,Luis,28,ES56209552778483068985,TRX_N-00207-06375619,2022-07-05T13:43:24,Bilbao,Expense,education,-62.74,-6081.03
buyer_1,Luis,28,ES56209552778483068985,TRX_N-00208-60759281,2022-07-05T16:41:17,Salvatierra/Agurain,Expense,cash,-100.0,-6181.03
buyer_1,Luis,28,ES56209552778483068985,TRX_N-00209-34915213,2022-07-06T16:28:09,Bilbao,Expense,food,-76.34,-6257.37
buyer_1,Luis,28,ES56209552778483068985,TRX_N-00210-60853939,2022-07-07T16:49:44,Bilbao,expenses,gas,-105.77,-6363.14
buyer_1,Luis,28,ES56209552778483068985,TRX_N-00211-18949365,2022-07-08T20:22:38,Bilbao,expenses,water,-25.55,-6388.69
buyer_1,Luis,28,ES56209552778483068985,TRX_N-00212-56662899,2022-07-08T00:58:35,Bilbao,expenses,electricity,-56.46,-6445.15
buyer_1,Luis,28,ES56209552778483068985,TRX_N-00213-58929633,2022-07-08T23:00:22,Bilbao,expenses,phone,-40.84,-6485.99
buyer_1,Luis,28,ES56209552778483068985,TRX_N-00214-74989974,2022-07-12T09:09:01,Lasarte-Oria,Expense,repairs,-262.28,-6748.27
buyer_1,Luis,28,ES56209552778483068985,TRX_N-00215-19273455,2022-07-15T14:27:18,Arrasate,Expense,healthcare,-184.13,-6932.4
buyer_1,Luis,28,ES56209552778483068985,TRX_N-00216-47768913,2022-07-17T15:38:22,Bilbao,Expense,gifts,-25.31,-6957.71
buyer_1,Luis,28,ES56209552778483068985,TRX_N-00217-51842924,2022-07-19T23:36:27,Bilbao,Expense,leisure,-19.15,-6976.86
buyer_1,Luis,28,ES56209552778483068985,TRX_N-00218-70496524,2022-07-20T16:58:30,Bilbao,Expense,food,-101.04,-7077.9
buyer_1,Luis,28,ES56209552778483068985,TRX_N-00219-55735775,2022-07-22T11:30:58,Bilbao,Expense,food,-86.87,-7164.77
buyer_1,Luis,28,ES56209552778483068985,TRX_N-00220-09020781,2022-07-23T19:13:00,Sestao,Expense,gifts,-27.96,-7192.73
buyer_1,Luis,28,ES56209552778483068985,TRX_N-00221-47500226,2022-07-23T10:06:52,Bilbao,expenses,children,-268.24,-7460.97
buyer_1,Luis,28,ES56209552778483068985,TRX_N-00222-35139486,2022-07-24T09:02:52,Bilbao,Expense,transport,-49.04,-7510.01
buyer_1,Luis,28,ES56209552778483068985,TRX_N-00223-90338364,2022-07-25T08:45:40,Bilbao,Expense,gifts,-119.11,-7629.12
buyer_1,Luis,28,ES56209552778483068985,TRX_N-00224-25386169,2022-07-26T18:27:40,Bilbao,Expense,food,-93.45,-7722.57
buyer_1,Luis,28,ES56209552778483068985,TRX_N-00225-35189718,2022-07-27T16:17:06,Bilbao,Expense,leisure,-83.34,-7805.91
buyer_1,Luis,28,ES56209552778483068985,TRX_N-00226-93262323,2022-07-28T22:06:34,Bilbao,Expense,food,-107.97,-7913.88
buyer_1,Luis,28,ES56209552778483068985,TRX_N-00227-02931525,2022-07-29T13:11:58,Bilbao,Expense,cash,-100.0,-8013.88
buyer_1,Luis,28,ES56209552778483068985,TRX_N-00228-30991211,2022-07-30T17:15:36,Bilbao,Expense,repairs,-108.77,-8122.65
buyer_1,Luis,28,ES56209552778483068985,TRX_N-00229-17450967,2022-07-31T12:21:33,Vitoria-Gasteiz,Expense,clothing,-152.08,-8274.73
buyer_1,Luis,28,ES56209552778483068985,TRX_N-00230-90687329,2022-08-01T11:01:17,Bilbao,incomes,salary,1403.02,-6871.71
buyer_1,Luis,28,ES56209552778483068985,TRX_N-00231-88849011,2022-08-01T11:01:17,Bilbao,incomes,salary_partner,1319.6,-5552.11
buyer_1,Luis,28,ES56209552778483068985,TRX_N-00232-33168810,2022-08-01T02:19:27,Bilbao,Expense,food,-88.02,-5640.13
buyer_1,Luis,28,ES56209552778483068985,TRX_N-00233-25428052,2022-08-01T14:26:27,Bilbao,Expense,travel,-1448.68,-7088.81
buyer_1,Luis,28,ES56209552778483068985,TRX_N-00234-33804282,2022-08-03T13:19:05,Bilbao,Expense,clothing,-159.98,-7248.79
buyer_1,Luis,28,ES56209552778483068985,TRX_N-00235-33650528,2022-08-03T12:33:00,Bilbao,Expense,education,-58.25,-7307.04
buyer_1,Luis,28,ES56209552778483068985,TRX_N-00236-51905008,2022-08-04T17:18:43,Bilbao,expenses,mortgage,-731.08,-8038.12
buyer_1,Luis,28,ES56209552778483068985,TRX_N-00237-18672178,2022-08-05T14:33:58,Bilbao,Expense,leisure,-24.02,-8062.14
buyer_1,Luis,28,ES56209552778483068985,TRX_N-00238-58851646,2022-08-06T14:26:37,Bilbao,expenses,water,-21.46,-8083.6
buyer_1,Luis,28,ES56209552778483068985,TRX_N-00239-49514467,2022-08-06T11:37:07,Bilbao,expenses,gas,-108.2,-8191.8
buyer_1,Luis,28,ES56209552778483068985,TRX_N-00240-80591477,2022-08-06T21:52:40,Bilbao,Expense,transport,-58.34,-8250.14
buyer_1,Luis,28,ES56209552778483068985,TRX_N-00241-92184607,2022-08-07T01:47:10,Bilbao,expenses,internet,-42.0,-8292.14
buyer_1,Luis,28,ES56209552778483068985,TRX_N-00242-91974455,2022-08-07T17:38:16,Bilbao,expenses,phone,-36.34,-8328.48
buyer_1,Luis,28,ES56209552778483068985,TRX_N-00243-86553143,2022-08-07T13:59:36,Bilbao,Expense,food,-89.08,-8417.56
buyer_1,Luis,28,ES56209552778483068985,TRX_N-00244-73138635,2022-08-07T13:14:28,Bilbao,Expense,healthcare,-84.15,-8501.71
buyer_1,Luis,28,ES56209552778483068985,TRX_N-00245-87808361,2022-08-08T19:37:16,Bilbao,expenses,electricity,-77.23,-8578.94
buyer_1,Luis,28,ES56209552778483068985,TRX_N-00246-19268057,2022-08-09T11:07:45,Iru√±a de Oca,Expense,food,-74.27,-8653.21
buyer_1,Luis,28,ES56209552778483068985,TRX_N-00247-99052107,2022-08-09T20:27:18,Durango,Expense,leisure,-72.17,-8725.38
buyer_1,Luis,28,ES56209552778483068985,TRX_N-00248-93196235,2022-08-10T11:41:46,Vitoria-Gasteiz,Expense,food,-107.73,-8833.11
buyer_1,Luis,28,ES56209552778483068985,TRX_N-00249-72303108,2022-08-11T10:39:54,Bilbao,Expense,cash,-100.0,-8933.11
buyer_1,Luis,28,ES56209552778483068985,TRX_N-00250-15273418,2022-08-12T11:51:07,Getxo,Expense,gifts,-332.29,-9265.4
buyer_1,Luis,28,ES56209552778483068985,TRX_N-00251-14821317,2022-08-13T17:38:45,Bilbao,Expense,leisure,-80.82,-9346.22
buyer_1,Luis,28,ES56209552778483068985,TRX_N-00252-90681081,2022-08-14T13:41:50,Bilbao,Expense,food,-60.51,-9406.73
buyer_1,Luis,28,ES56209552778483068985,TRX_N-00253-70973080,2022-08-14T18:31:50,Bilbao,Expense,transport,-57.08,-9463.81
buyer_1,Luis,28,ES56209552778483068985,TRX_N-00254-07684535,2022-08-14T15:37:15,Bilbao,expenses,children,-112.89,-9576.7
buyer_1,Luis,28,ES56209552778483068985,TRX_N-00255-05069107,2022-08-15T09:33:30,Bilbao,Expense,clothing,-121.81,-9698.51
buyer_1,Luis,28,ES56209552778483068985,TRX_N-00256-38971396,2022-08-17T14:22:01,Bilbao,Expense,leisure,-72.18,-9770.69
buyer_1,Luis,28,ES56209552778483068985,TRX_N-00257-81093891,2022-08-17T15:01:09,Llodio,Expense,cash,-100.0,-9870.69
buyer_1,Luis,28,ES56209552778483068985,TRX_N-00258-67046828,2022-08-18T13:16:21,Bilbao,Expense,travel,-1670.99,-11541.68
buyer_1,Luis,28,ES56209552778483068985,TRX_N-00259-51090980,2022-08-20T16:02:39,Bilbao,Expense,clothing,-49.0,-11590.68
buyer_1,Luis,28,ES56209552778483068985,TRX_N-00260-92216699,2022-08-23T05:14:29,Bilbao,Expense,transport,-59.56,-11650.24
buyer_1,Luis,28,ES56209552778483068985,TRX_N-00261-88853489,2022-08-23T09:50:12,Bilbao,Expense,gifts,-528.19,-12178.43
buyer_1,Luis,28,ES56209552778483068985,TRX_N-00262-21430777,2022-08-25T09:59:30,Bilbao,Expense,cash,-100.0,-12278.43
buyer_1,Luis,28,ES56209552778483068985,TRX_N-00263-47484560,2022-08-26T02:12:55,Donostia,Expense,food,-71.96,-12350.39
buyer_1,Luis,28,ES56209552778483068985,TRX_N-00264-71364643,2022-08-28T18:11:41,Andoain,Expense,healthcare,-68.69,-12419.08
buyer_1,Luis,28,ES56209552778483068985,TRX_N-00265-46112398,2022-08-29T16:56:51,Bilbao,Expense,food,-124.3,-12543.38
buyer_1,Luis,28,ES56209552778483068985,TRX_N-00266-60103197,2022-08-29T23:49:55,Bilbao,Expense,gifts,-312.6,-12855.98
buyer_1,Luis,28,ES56209552778483068985,TRX_N-00267-06144651,2022-08-30T12:33:19,Alegr√≠a-Dulantzi,Expense,food,-80.91,-12936.89
buyer_1,Luis,28,ES56209552778483068985,TRX_N-00268-28672015,2022-08-31T15:04:31,Bilbao,Expense,cash,-100.0,-13036.89
buyer_1,Luis,28,ES56209552778483068985,TRX_N-00269-51758993,2022-09-01T12:29:53,Bilbao,incomes,salary,1403.02,-11633.87
buyer_1,Luis,28,ES56209552778483068985,TRX_N-00270-16918877,2022-09-01T12:29:53,Bilbao,incomes,salary_partner,1319.6,-10314.27
buyer_1,Luis,28,ES56209552778483068985,TRX_N-00271-45831036,2022-09-01T12:29:53,Bilbao,incomes,extra_income,186.09,-10128.18
buyer_1,Luis,28,ES56209552778483068985,TRX_N-00272-12979465,2022-09-02T09:49:43,Bilbao,Expense,food,-85.79,-10213.97
buyer_1,Luis,28,ES56209552778483068985,TRX_N-00273-64284593,2022-09-02T14:14:45,Bilbao,Expense,cash,-100.0,-10313.97
buyer_1,Luis,28,ES56209552778483068985,TRX_N-00274-52213485,2022-09-04T20:32:26,Bilbao,expenses,mortgage,-731.08,-11045.05
buyer_1,Luis,28,ES56209552778483068985,TRX_N-00275-06213131,2022-09-04T16:21:26,Bilbao,Expense,appliances,-278.96,-11324.01
buyer_1,Luis,28,ES56209552778483068985,TRX_N-00276-20709624,2022-09-05T17:18:02,Bilbao,expenses,water,-23.06,-11347.07
buyer_1,Luis,28,ES56209552778483068985,TRX_N-00277-66875159,2022-09-05T10:03:51,Bilbao,expenses,electricity,-73.32,-11420.39
buyer_1,Luis,28,ES56209552778483068985,TRX_N-00278-75240182,2022-09-05T18:01:26,Bilbao,expenses,internet,-42.0,-11462.39
buyer_1,Luis,28,ES56209552778483068985,TRX_N-00279-73958685,2022-09-05T14:57:21,Bilbao,expenses,phone,-35.14,-11497.53
buyer_1,Luis,28,ES56209552778483068985,TRX_N-00280-27249904,2022-09-06T13:00:05,Bilbao,Expense,cash,-100.0,-11597.53
buyer_1,Luis,28,ES56209552778483068985,TRX_N-00281-88432999,2022-09-06T17:43:16,Bilbao,Expense,repairs,-82.87,-11680.4
buyer_1,Luis,28,ES56209552778483068985,TRX_N-00282-62797879,2022-09-08T14:23:17,Bilbao,expenses,gas,-92.45,-11772.85
buyer_1,Luis,28,ES56209552778483068985,TRX_N-00283-10056135,2022-09-08T10:34:19,Bilbao,Expense,cash,-100.0,-11872.85
buyer_1,Luis,28,ES56209552778483068985,TRX_N-00284-96424986,2022-09-10T13:45:56,Bilbao,Expense,leisure,-66.27,-11939.12
buyer_1,Luis,28,ES56209552778483068985,TRX_N-00285-60402448,2022-09-10T13:32:50,Bilbao,Expense,clothing,-134.3,-12073.42
buyer_1,Luis,28,ES56209552778483068985,TRX_N-00286-94883317,2022-09-10T15:26:16,Bilbao,Expense,gifts,-808.81,-12882.23
buyer_1,Luis,28,ES56209552778483068985,TRX_N-00287-23225729,2022-09-11T02:02:42,Bilbao,Expense,leisure,-70.68,-12952.91
buyer_1,Luis,28,ES56209552778483068985,TRX_N-00288-80312848,2022-09-11T13:51:23,Bilbao,Expense,cash,-100.0,-13052.91
buyer_1,Luis,28,ES56209552778483068985,TRX_N-00289-75907051,2022-09-15T18:35:57,Bilbao,Expense,transport,-61.86,-13114.77
buyer_1,Luis,28,ES56209552778483068985,TRX_N-00290-02745342,2022-09-16T18:36:08,Vitoria-Gasteiz,Expense,gifts,-600.92,-13715.69
buyer_1,Luis,28,ES56209552778483068985,TRX_N-00291-66430631,2022-09-18T04:26:45,Bilbao,Expense,healthcare,-135.94,-13851.63
buyer_1,Luis,28,ES56209552778483068985,TRX_N-00292-69852325,2022-09-19T16:16:50,Bilbao,Expense,food,-77.11,-13928.74
buyer_1,Luis,28,ES56209552778483068985,TRX_N-00293-84560618,2022-09-20T15:18:44,Erandio,Expense,gifts,-247.56,-14176.3
buyer_1,Luis,28,ES56209552778483068985,TRX_N-00294-90740529,2022-09-21T08:56:34,Bilbao,Expense,food,-99.92,-14276.22
buyer_1,Luis,28,ES56209552778483068985,TRX_N-00295-07309236,2022-09-24T16:51:16,Bilbao,Expense,food,-103.7,-14379.92
buyer_1,Luis,28,ES56209552778483068985,TRX_N-00296-08065583,2022-09-24T08:51:19,Bilbao,Expense,leisure,-70.78,-14450.7
buyer_1,Luis,28,ES56209552778483068985,TRX_N-00297-26245719,2022-09-27T14:21:34,Bilbao,Expense,food,-64.19,-14514.89
buyer_1,Luis,28,ES56209552778483068985,TRX_N-00298-04301417,2022-09-27T11:36:07,Bilbao,Expense,leisure,-39.51,-14554.4
buyer_1,Luis,28,ES56209552778483068985,TRX_N-00299-99601981,2022-09-28T20:46:28,Bilbao,Expense,leisure,-31.44,-14585.84
buyer_1,Luis,28,ES56209552778483068985,TRX_N-00300-09226860,2022-09-30T12:44:34,Bilbao,Expense,leisure,-46.07,-14631.91
buyer_1,Luis,28,ES56209552778483068985,TRX_N-00301-19523959,2022-10-01T11:50:13,Bilbao,incomes,salary,1403.02,-13228.89
buyer_1,Luis,28,ES56209552778483068985,TRX_N-00302-07553593,2022-10-01T11:50:13,Bilbao,incomes,salary_partner,1319.6,-11909.29
buyer_1,Luis,28,ES56209552778483068985,TRX_N-00303-51406885,2022-10-01T16:38:54,Bilbao,Expense,leisure,-57.1,-11966.39
buyer_1,Luis,28,ES56209552778483068985,TRX_N-00304-46761903,2022-10-02T20:35:30,Sestao,Expense,repairs,-206.16,-12172.55
buyer_1,Luis,28,ES56209552778483068985,TRX_N-00305-51554273,2022-10-04T13:36:25,Bilbao,expenses,mortgage,-731.08,-12903.63
buyer_1,Luis,28,ES56209552778483068985,TRX_N-00306-10921624,2022-10-04T11:35:08,Bermeo,Expense,cash,-100.0,-13003.63
buyer_1,Luis,28,ES56209552778483068985,TRX_N-00307-19145255,2022-10-04T12:56:17,Bilbao,Expense,repairs,-117.39,-13121.02
buyer_1,Luis,28,ES56209552778483068985,TRX_N-00308-49359060,2022-10-05T08:18:34,Bilbao,expenses,water,-42.95,-13163.97
buyer_1,Luis,28,ES56209552778483068985,TRX_N-00309-17469350,2022-10-05T20:58:36,Bilbao,expenses,phone,-35.58,-13199.55
buyer_1,Luis,28,ES56209552778483068985,TRX_N-00310-92494967,2022-10-05T12:55:33,Bilbao,Expense,food,-81.92,-13281.47
buyer_1,Luis,28,ES56209552778483068985,TRX_N-00311-01346913,2022-10-05T17:13:08,Bilbao,Expense,leisure,-18.3,-13299.77
buyer_1,Luis,28,ES56209552778483068985,TRX_N-00312-00223888,2022-10-05T06:23:04,Bilbao,Expense,cash,-100.0,-13399.77
buyer_1,Luis,28,ES56209552778483068985,TRX_N-00313-22678653,2022-10-06T03:45:19,Bilbao,Expense,repairs,-71.39,-13471.16
buyer_1,Luis,28,ES56209552778483068985,TRX_N-00314-61816395,2022-10-07T11:36:25,Bilbao,Expense,cash,-100.0,-13571.16
buyer_1,Luis,28,ES56209552778483068985,TRX_N-00315-60790439,2022-10-08T19:25:59,Bilbao,expenses,electricity,-73.14,-13644.3
buyer_1,Luis,28,ES56209552778483068985,TRX_N-00316-27050145,2022-10-08T05:21:01,Bilbao,expenses,gas,-90.72,-13735.02
buyer_1,Luis,28,ES56209552778483068985,TRX_N-00317-87913900,2022-10-08T09:54:24,Bilbao,expenses,internet,-42.0,-13777.02
buyer_1,Luis,28,ES56209552778483068985,TRX_N-00318-75660978,2022-10-14T13:24:17,Bilbao,Expense,transport,-89.34,-13866.36
buyer_1,Luis,28,ES56209552778483068985,TRX_N-00319-95151989,2022-10-18T08:11:51,Amurrio,Expense,cash,-100.0,-13966.36
buyer_1,Luis,28,ES56209552778483068985,TRX_N-00320-41359463,2022-10-19T19:27:44,Bilbao,Expense,repairs,-173.38,-14139.74
buyer_1,Luis,28,ES56209552778483068985,TRX_N-00321-80868317,2022-10-22T14:03:58,Bilbao,Expense,food,-123.83,-14263.57
buyer_1,Luis,28,ES56209552778483068985,TRX_N-00322-07952770,2022-10-22T19:25:32,Bilbao,Expense,cash,-100.0,-14363.57
buyer_1,Luis,28,ES56209552778483068985,TRX_N-00323-18995817,2022-10-22T21:20:29,Bilbao,Expense,repairs,-188.98,-14552.55
buyer_1,Luis,28,ES56209552778483068985,TRX_N-00324-33676640,2022-10-23T19:45:58,Bilbao,Expense,repairs,-191.57,-14744.12
buyer_1,Luis,28,ES56209552778483068985,TRX_N-00325-55261830,2022-10-23T08:06:15,Bilbao,Expense,gifts,-397.24,-15141.36
buyer_1,Luis,28,ES56209552778483068985,TRX_N-00326-56319236,2022-10-25T18:42:00,Bilbao,Expense,clothing,-84.09,-15225.45
buyer_1,Luis,28,ES56209552778483068985,TRX_N-00327-01861053,2022-10-26T19:15:57,Bilbao,Expense,cash,-100.0,-15325.45
buyer_1,Luis,28,ES56209552778483068985,TRX_N-00328-22439035,2022-10-28T18:13:46,Bilbao,Expense,repairs,-276.55,-15602.0
buyer_1,Luis,28,ES56209552778483068985,TRX_N-00329-45528708,2022-11-01T19:13:29,Bilbao,incomes,salary,1403.02,-14198.98
buyer_1,Luis,28,ES56209552778483068985,TRX_N-00330-08168745,2022-11-01T19:13:29,Bilbao,incomes,salary_partner,1319.6,-12879.38
buyer_1,Luis,28,ES56209552778483068985,TRX_N-00331-76630825,2022-11-01T00:52:39,Bilbao,Expense,clothing,-57.28,-12936.66
buyer_1,Luis,28,ES56209552778483068985,TRX_N-00332-36136307,2022-11-01T20:09:08,Bilbao,Expense,education,-45.4,-12982.06
buyer_1,Luis,28,ES56209552778483068985,TRX_N-00333-42904626,2022-11-01T16:09:09,Bilbao,Expense,appliances,-336.41,-13318.47
buyer_1,Luis,28,ES56209552778483068985,TRX_N-00334-99362950,2022-11-02T20:50:57,Bilbao,Expense,gifts,-57.53,-13376.0
buyer_1,Luis,28,ES56209552778483068985,TRX_N-00335-02122555,2022-11-03T11:59:46,Irun,Expense,food,-61.74,-13437.74
buyer_1,Luis,28,ES56209552778483068985,TRX_N-00336-11619133,2022-11-03T08:56:02,Bilbao,Expense,gifts,-848.19,-14285.93
buyer_1,Luis,28,ES56209552778483068985,TRX_N-00337-67398618,2022-11-04T23:04:03,Bilbao,expenses,mortgage,-731.08,-15017.01
buyer_1,Luis,28,ES56209552778483068985,TRX_N-00338-90180873,2022-11-04T20:29:12,Bilbao,Expense,transport,-88.37,-15105.38
buyer_1,Luis,28,ES56209552778483068985,TRX_N-00339-89286360,2022-11-05T15:00:05,Bilbao,expenses,internet,-42.0,-15147.38
buyer_1,Luis,28,ES56209552778483068985,TRX_N-00340-31981751,2022-11-06T11:32:06,Bilbao,expenses,gas,-50.23,-15197.61
buyer_1,Luis,28,ES56209552778483068985,TRX_N-00341-81391886,2022-11-06T16:28:55,Bilbao,expenses,phone,-38.23,-15235.84
buyer_1,Luis,28,ES56209552778483068985,TRX_N-00342-83711403,2022-11-06T08:48:36,Bilbao,Expense,cash,-100.0,-15335.84
buyer_1,Luis,28,ES56209552778483068985,TRX_N-00343-24932582,2022-11-06T23:57:26,Bilbao,expenses,children,-172.95,-15508.79
buyer_1,Luis,28,ES56209552778483068985,TRX_N-00344-69842122,2022-11-07T15:26:37,Leioa,Expense,travel,-1028.39,-16537.18
buyer_1,Luis,28,ES56209552778483068985,TRX_N-00345-89275952,2022-11-08T08:19:15,Bilbao,expenses,water,-37.01,-16574.19
buyer_1,Luis,28,ES56209552778483068985,TRX_N-00346-46199984,2022-11-08T09:45:01,Bilbao,expenses,electricity,-88.79,-16662.98
buyer_1,Luis,28,ES56209552778483068985,TRX_N-00347-54308363,2022-11-08T17:32:40,Mungia,Expense,repairs,-214.5,-16877.48
buyer_1,Luis,28,ES56209552778483068985,TRX_N-00348-26416853,2022-11-09T23:22:26,Bilbao,Expense,food,-64.92,-16942.4
buyer_1,Luis,28,ES56209552778483068985,TRX_N-00349-72634641,2022-11-10T14:58:52,Bilbao,Expense,healthcare,-138.47,-17080.87
buyer_1,Luis,28,ES56209552778483068985,TRX_N-00350-81717732,2022-11-10T20:15:23,Bilbao,Expense,cash,-100.0,-17180.87
buyer_1,Luis,28,ES56209552778483068985,TRX_N-00351-86968613,2022-11-12T18:59:14,Bilbao,Expense,gifts,-802.11,-17982.98
buyer_1,Luis,28,ES56209552778483068985,TRX_N-00352-97373361,2022-11-13T11:44:37,Bilbao,Expense,cash,-100.0,-18082.98
buyer_1,Luis,28,ES56209552778483068985,TRX_N-00353-21154976,2022-11-18T10:03:18,Bilbao,Expense,cash,-100.0,-18182.98
buyer_1,Luis,28,ES56209552778483068985,TRX_N-00354-67266973,2022-11-22T13:56:54,Bilbao,Expense,food,-76.07,-18259.05
buyer_1,Luis,28,ES56209552778483068985,TRX_N-00355-54748761,2022-11-22T11:26:19,Bilbao,Expense,travel,-1066.17,-19325.22
buyer_1,Luis,28,ES56209552778483068985,TRX_N-00356-70388445,2022-11-23T14:18:28,Bilbao,Expense,food,-83.83,-19409.05
buyer_1,Luis,28,ES56209552778483068985,TRX_N-00357-88502084,2022-11-25T19:08:45,Getxo,Expense,travel,-526.14,-19935.19
buyer_1,Luis,28,ES56209552778483068985,TRX_N-00358-76645925,2022-11-27T19:56:36,Bilbao,Expense,food,-105.96,-20041.15
buyer_1,Luis,28,ES56209552778483068985,TRX_N-00359-07135310,2022-11-27T23:28:27,Bilbao,Expense,transport,-65.13,-20106.28
buyer_1,Luis,28,ES56209552778483068985,TRX_N-00360-37680432,2022-11-28T01:03:08,Bilbao,Expense,travel,-731.59,-20837.87
buyer_1,Luis,28,ES56209552778483068985,TRX_N-00361-32878804,2022-11-29T00:18:23,Bilbao,Expense,transport,-51.68,-20889.55
buyer_1,Luis,28,ES56209552778483068985,TRX_N-00362-37719479,2022-11-30T20:58:44,Bilbao,Expense,repairs,-169.37,-21058.92
buyer_1,Luis,28,ES56209552778483068985,TRX_N-00363-15223416,2022-12-01T08:33:55,Bilbao,incomes,salary,1403.02,-19655.9
buyer_1,Luis,28,ES56209552778483068985,TRX_N-00364-62690662,2022-12-01T08:33:55,Bilbao,incomes,salary_partner,1319.6,-18336.3
buyer_1,Luis,28,ES56209552778483068985,TRX_N-00365-79512608,2022-12-01T08:33:55,Bilbao,incomes,salary_bonus,1063.25,-17273.05
buyer_1,Luis,28,ES56209552778483068985,TRX_N-00366-45680162,2022-12-01T08:33:55,Bilbao,incomes,salary_partner_bonus,934.12,-16338.93
buyer_1,Luis,28,ES56209552778483068985,TRX_N-00367-37841128,2022-12-01T12:22:26,Pasaia,Expense,leisure,-84.35,-16423.28
buyer_1,Luis,28,ES56209552778483068985,TRX_N-00368-87587129,2022-12-02T13:51:02,Bilbao,Expense,cash,-100.0,-16523.28
buyer_1,Luis,28,ES56209552778483068985,TRX_N-00369-54830972,2022-12-03T08:24:09,Bilbao,Expense,cash,-100.0,-16623.28
buyer_1,Luis,28,ES56209552778483068985,TRX_N-00370-70690270,2022-12-04T11:03:17,Bilbao,expenses,mortgage,-731.08,-17354.36
buyer_1,Luis,28,ES56209552778483068985,TRX_N-00371-83165787,2022-12-04T01:57:32,Bilbao,Expense,food,-100.63,-17454.99
buyer_1,Luis,28,ES56209552778483068985,TRX_N-00372-25922404,2022-12-05T14:00:34,Bilbao,expenses,electricity,-65.65,-17520.64
buyer_1,Luis,28,ES56209552778483068985,TRX_N-00373-10735101,2022-12-08T13:06:42,Bilbao,expenses,water,-42.0,-17562.64
buyer_1,Luis,28,ES56209552778483068985,TRX_N-00374-11818513,2022-12-08T15:02:59,Bilbao,expenses,gas,-52.39,-17615.03
buyer_1,Luis,28,ES56209552778483068985,TRX_N-00375-51315993,2022-12-08T05:49:08,Bilbao,expenses,internet,-42.0,-17657.03
buyer_1,Luis,28,ES56209552778483068985,TRX_N-00376-59454703,2022-12-08T10:46:27,Bilbao,expenses,phone,-33.46,-17690.49
buyer_1,Luis,28,ES56209552778483068985,TRX_N-00377-93579374,2022-12-08T18:52:37,Bilbao,Expense,healthcare,-156.12,-17846.61
buyer_1,Luis,28,ES56209552778483068985,TRX_N-00378-55233598,2022-12-08T08:21:45,Erandio,Expense,cash,-100.0,-17946.61
buyer_1,Luis,28,ES56209552778483068985,TRX_N-00379-41984459,2022-12-09T23:46:25,Bilbao,Expense,repairs,-152.62,-18099.23
buyer_1,Luis,28,ES56209552778483068985,TRX_N-00380-63027137,2022-12-10T21:35:00,Bilbao,Expense,food,-71.2,-18170.43
buyer_1,Luis,28,ES56209552778483068985,TRX_N-00381-60632540,2022-12-10T21:03:53,Bilbao,Expense,leisure,-72.43,-18242.86
buyer_1,Luis,28,ES56209552778483068985,TRX_N-00382-97935838,2022-12-12T14:06:56,Oy√≥n-Oion,Expense,food,-105.36,-18348.22
buyer_1,Luis,28,ES56209552778483068985,TRX_N-00383-52414025,2022-12-13T15:27:26,Zarautz,Expense,cash,-100.0,-18448.22
buyer_1,Luis,28,ES56209552778483068985,TRX_N-00384-58282022,2022-12-13T17:56:26,Bilbao,Expense,repairs,-280.59,-18728.81
buyer_1,Luis,28,ES56209552778483068985,TRX_N-00385-80054567,2022-12-14T08:33:05,Bilbao,Expense,food,-106.85,-18835.66
buyer_1,Luis,28,ES56209552778483068985,TRX_N-00386-28795793,2022-12-15T08:51:18,Bilbao,Expense,gifts,-67.8,-18903.46
buyer_1,Luis,28,ES56209552778483068985,TRX_N-00387-04874035,2022-12-18T15:39:44,Bilbao,Expense,cash,-100.0,-19003.46
buyer_1,Luis,28,ES56209552778483068985,TRX_N-00388-73473618,2022-12-19T07:04:27,Bilbao,Expense,leisure,-49.05,-19052.51
buyer_1,Luis,28,ES56209552778483068985,TRX_N-00389-62365979,2022-12-20T09:54:30,Bilbao,Expense,leisure,-19.1,-19071.61
buyer_1,Luis,28,ES56209552778483068985,TRX_N-00390-26879592,2022-12-20T19:36:30,Bilbao,Expense,cash,-100.0,-19171.61
buyer_1,Luis,28,ES56209552778483068985,TRX_N-00391-65282291,2022-12-22T21:53:48,Bilbao,expenses,children,-213.2,-19384.81
buyer_1,Luis,28,ES56209552778483068985,TRX_N-00392-37109835,2022-12-23T19:44:12,Labastida,Expense,food,-63.95,-19448.76
buyer_1,Luis,28,ES56209552778483068985,TRX_N-00393-29714930,2022-12-23T09:39:22,Bilbao,Expense,cash,-100.0,-19548.76
buyer_1,Luis,28,ES56209552778483068985,TRX_N-00394-28619787,2022-12-24T18:46:08,Bilbao,Expense,transport,-40.95,-19589.71
buyer_1,Luis,28,ES56209552778483068985,TRX_N-00395-80963301,2022-12-26T13:40:43,Bilbao,Expense,transport,-58.37,-19648.08
buyer_1,Luis,28,ES56209552778483068985,TRX_N-00396-99355721,2022-12-29T19:31:58,Bilbao,Expense,gifts,-319.23,-19967.31
buyer_1,Luis,28,ES56209552778483068985,TRX_N-00397-26585179,2023-01-01T18:19:24,Bilbao,incomes,salary,1443.95,-18523.36
buyer_1,Luis,28,ES56209552778483068985,TRX_N-00398-04801787,2023-01-01T18:19:24,Bilbao,incomes,salary_partner,1358.1,-17165.26
buyer_1,Luis,28,ES56209552778483068985,TRX_N-00399-06530890,2023-01-01T18:19:24,Bilbao,incomes,extra_income,186.09,-16979.17
buyer_1,Luis,28,ES56209552778483068985,TRX_N-00400-29029924,2023-01-03T18:50:20,Bilbao,Expense,cash,-100.0,-17079.17
buyer_1,Luis,28,ES56209552778483068985,TRX_N-00401-48085722,2023-01-04T13:58:10,Bilbao,expenses,mortgage,-731.08,-17810.25
buyer_1,Luis,28,ES56209552778483068985,TRX_N-00402-14603164,2023-01-04T14:03:53,Bilbao,Expense,appliances,-381.57,-18191.82
buyer_1,Luis,28,ES56209552778483068985,TRX_N-00403-91934435,2023-01-05T20:53:25,Bilbao,Expense,leisure,-31.99,-18223.81
buyer_1,Luis,28,ES56209552778483068985,TRX_N-00404-21524165,2023-01-06T16:28:12,Bilbao,expenses,water,-34.3,-18258.11
buyer_1,Luis,28,ES56209552778483068985,TRX_N-00405-36379785,2023-01-06T08:31:37,Bilbao,Expense,food,-85.77,-18343.88
buyer_1,Luis,28,ES56209552778483068985,TRX_N-00406-93744437,2023-01-07T14:41:48,Bilbao,expenses,electricity,-47.46,-18391.34
buyer_1,Luis,28,ES56209552778483068985,TRX_N-00407-72971615,2023-01-07T15:21:34,Basauri,Expense,repairs,-116.31,-18507.65
buyer_1,Luis,28,ES56209552778483068985,TRX_N-00408-83535523,2023-01-08T09:43:39,Bilbao,expenses,internet,-42.0,-18549.65
buyer_1,Luis,28,ES56209552778483068985,TRX_N-00409-85831844,2023-01-08T10:32:34,Bilbao,expenses,gas,-85.57,-18635.22
buyer_1,Luis,28,ES56209552778483068985,TRX_N-00410-76460804,2023-01-08T08:58:46,Bilbao,expenses,phone,-42.88,-18678.1
buyer_1,Luis,28,ES56209552778483068985,TRX_N-00411-18077680,2023-01-10T11:34:25,Bilbao,Expense,repairs,-29.62,-18707.72
buyer_1,Luis,28,ES56209552778483068985,TRX_N-00412-00639999,2023-01-12T10:26:33,Oy√≥n-Oion,Expense,transport,-51.28,-18759.0
buyer_1,Luis,28,ES56209552778483068985,TRX_N-00413-92031741,2023-01-13T10:26:03,Bilbao,Expense,food,-103.55,-18862.55
buyer_1,Luis,28,ES56209552778483068985,TRX_N-00414-65567226,2023-01-16T12:10:30,Iru√±a de Oca,Expense,food,-122.7,-18985.25
buyer_1,Luis,28,ES56209552778483068985,TRX_N-00415-42185774,2023-01-16T09:15:05,Bilbao,Expense,clothing,-126.29,-19111.54
buyer_1,Luis,28,ES56209552778483068985,TRX_N-00416-35850315,2023-01-18T13:05:31,Bilbao,expenses,children,-124.92,-19236.46
buyer_1,Luis,28,ES56209552778483068985,TRX_N-00417-65145700,2023-01-19T13:31:27,Bilbao,Expense,food,-92.53,-19328.99
buyer_1,Luis,28,ES56209552778483068985,TRX_N-00418-83615354,2023-01-19T19:24:24,Bilbao,Expense,gifts,-300.63,-19629.62
buyer_1,Luis,28,ES56209552778483068985,TRX_N-00419-68344317,2023-01-20T08:39:50,Bilbao,Expense,travel,-1481.42,-21111.04
buyer_1,Luis,28,ES56209552778483068985,TRX_N-00420-94513900,2023-01-21T20:28:53,Bilbao,expenses,children,-199.68,-21310.72
buyer_1,Luis,28,ES56209552778483068985,TRX_N-00421-27704003,2023-01-22T17:20:37,Bilbao,Expense,food,-64.41,-21375.13
buyer_1,Luis,28,ES56209552778483068985,TRX_N-00422-95851152,2023-01-22T17:36:27,Bilbao,Expense,cash,-100.0,-21475.13
buyer_1,Luis,28,ES56209552778483068985,TRX_N-00423-48927616,2023-01-25T13:29:10,Bilbao,expenses,children,-123.02,-21598.15
buyer_1,Luis,28,ES56209552778483068985,TRX_N-00424-88214000,2023-01-26T16:34:01,Bilbao,Expense,leisure,-23.04,-21621.19
buyer_1,Luis,28,ES56209552778483068985,TRX_N-00425-86054598,2023-01-26T19:05:41,Bilbao,Expense,cash,-100.0,-21721.19
buyer_1,Luis,28,ES56209552778483068985,TRX_N-00426-19878149,2023-01-27T22:16:47,Bilbao,Expense,cash,-100.0,-21821.19
buyer_1,Luis,28,ES56209552778483068985,TRX_N-00427-39354044,2023-01-28T10:07:09,Alegr√≠a-Dulantzi,Expense,gifts,-152.27,-21973.46
buyer_1,Luis,28,ES56209552778483068985,TRX_N-00428-75800198,2023-01-29T15:16:53,Bilbao,Expense,leisure,-55.71,-22029.17
buyer_1,Luis,28,ES56209552778483068985,TRX_N-00429-07234902,2023-01-30T14:32:42,Bilbao,Expense,cash,-100.0,-22129.17
buyer_1,Luis,28,ES56209552778483068985,TRX_N-00430-25567290,2023-02-01T17:46:03,Bilbao,incomes,salary,1443.95,-20685.22
buyer_1,Luis,28,ES56209552778483068985,TRX_N-00431-99145678,2023-02-01T17:46:03,Bilbao,incomes,salary_partner,1358.1,-19327.12
buyer_1,Luis,28,ES56209552778483068985,TRX_N-00432-88768908,2023-02-01T11:10:27,Bilbao,Expense,cash,-100.0,-19427.12
buyer_1,Luis,28,ES56209552778483068985,TRX_N-00433-19200302,2023-02-01T06:30:57,Bilbao,Expense,gifts,-427.03,-19854.15
buyer_1,Luis,28,ES56209552778483068985,TRX_N-00434-56482063,2023-02-02T16:56:47,Bilbao,Expense,food,-116.11,-19970.26
buyer_1,Luis,28,ES56209552778483068985,TRX_N-00435-07927940,2023-02-04T13:25:25,Bilbao,expenses,mortgage,-731.08,-20701.34
buyer_1,Luis,28,ES56209552778483068985,TRX_N-00436-85737445,2023-02-04T11:38:01,Bilbao,Expense,clothing,-81.38,-20782.72
buyer_1,Luis,28,ES56209552778483068985,TRX_N-00437-04969686,2023-02-05T10:47:03,Bilbao,expenses,gas,-74.18,-20856.9
buyer_1,Luis,28,ES56209552778483068985,TRX_N-00438-25660766,2023-02-05T08:47:53,Bilbao,expenses,internet,-42.0,-20898.9
buyer_1,Luis,28,ES56209552778483068985,TRX_N-00439-98365433,2023-02-06T09:41:16,Bilbao,Expense,education,-49.72,-20948.62
buyer_1,Luis,28,ES56209552778483068985,TRX_N-00440-59927647,2023-02-07T21:03:42,Bilbao,Expense,food,-119.37,-21067.99
buyer_1,Luis,28,ES56209552778483068985,TRX_N-00441-73770877,2023-02-07T07:26:05,Bilbao,Expense,transport,-46.9,-21114.89
buyer_1,Luis,28,ES56209552778483068985,TRX_N-00442-74387397,2023-02-08T09:50:00,Bilbao,expenses,water,-43.12,-21158.01
buyer_1,Luis,28,ES56209552778483068985,TRX_N-00443-65074541,2023-02-08T05:17:42,Bilbao,expenses,phone,-33.23,-21191.24
buyer_1,Luis,28,ES56209552778483068985,TRX_N-00444-55893122,2023-02-08T14:16:37,Bilbao,expenses,electricity,-46.21,-21237.45
buyer_1,Luis,28,ES56209552778483068985,TRX_N-00445-31484982,2023-02-08T12:36:34,Bilbao,Expense,transport,-86.66,-21324.11
buyer_1,Luis,28,ES56209552778483068985,TRX_N-00446-51292659,2023-02-09T18:57:21,Bilbao,Expense,repairs,-94.5,-21418.61
buyer_1,Luis,28,ES56209552778483068985,TRX_N-00447-41266521,2023-02-13T12:54:33,Bilbao,Expense,leisure,-56.09,-21474.7
buyer_1,Luis,28,ES56209552778483068985,TRX_N-00448-98034498,2023-02-14T09:35:47,Bilbao,Expense,cash,-100.0,-21574.7
buyer_1,Luis,28,ES56209552778483068985,TRX_N-00449-75052968,2023-02-14T13:59:58,Zuia,Expense,repairs,-282.15,-21856.85
buyer_1,Luis,28,ES56209552778483068985,TRX_N-00450-82475794,2023-02-15T18:37:25,Bilbao,Expense,clothing,-125.14,-21981.99
buyer_1,Luis,28,ES56209552778483068985,TRX_N-00451-58523208,2023-02-16T16:53:03,Bilbao,Expense,transport,-60.61,-22042.6
buyer_1,Luis,28,ES56209552778483068985,TRX_N-00452-00841976,2023-02-17T13:29:20,Bilbao,expenses,children,-278.0,-22320.6
buyer_1,Luis,28,ES56209552778483068985,TRX_N-00453-10797063,2023-02-18T15:02:19,Bilbao,Expense,food,-75.12,-22395.72
buyer_1,Luis,28,ES56209552778483068985,TRX_N-00454-94309698,2023-02-18T13:54:14,Bilbao,Expense,leisure,-54.55,-22450.27
buyer_1,Luis,28,ES56209552778483068985,TRX_N-00455-31327804,2023-02-18T09:42:55,Bilbao,Expense,appliances,-333.05,-22783.32
buyer_1,Luis,28,ES56209552778483068985,TRX_N-00456-82203466,2023-02-19T12:11:19,Bilbao,Expense,repairs,-70.49,-22853.81
buyer_1,Luis,28,ES56209552778483068985,TRX_N-00457-19506377,2023-02-20T12:17:41,Elciego,Expense,food,-66.42,-22920.23
buyer_1,Luis,28,ES56209552778483068985,TRX_N-00458-17958075,2023-02-20T13:09:02,Bilbao,Expense,clothing,-62.2,-22982.43
buyer_1,Luis,28,ES56209552778483068985,TRX_N-00459-16251394,2023-02-20T20:05:14,Bilbao,Expense,appliances,-337.21,-23319.64
buyer_1,Luis,28,ES56209552778483068985,TRX_N-00460-78654265,2023-02-20T01:54:02,Bilbao,Expense,gifts,-144.52,-23464.16
buyer_1,Luis,28,ES56209552778483068985,TRX_N-00461-40349179,2023-02-23T14:47:39,Portugalete,Expense,cash,-100.0,-23564.16
buyer_1,Luis,28,ES56209552778483068985,TRX_N-00462-91311091,2023-02-23T11:40:32,Bilbao,Expense,repairs,-99.21,-23663.37
buyer_1,Luis,28,ES56209552778483068985,TRX_N-00463-24349471,2023-02-24T14:41:44,Bilbao,Expense,clothing,-62.12,-23725.49
buyer_1,Luis,28,ES56209552778483068985,TRX_N-00464-63849166,2023-02-25T22:17:39,Llodio,Expense,transport,-78.88,-23804.37
buyer_1,Luis,28,ES56209552778483068985,TRX_N-00465-26921913,2023-02-25T14:10:44,Bilbao,Expense,education,-57.81,-23862.18
buyer_1,Luis,28,ES56209552778483068985,TRX_N-00466-18012576,2023-02-26T17:57:40,Bilbao,Expense,gifts,-256.73,-24118.91
buyer_1,Luis,28,ES56209552778483068985,TRX_N-00467-01851878,2023-02-27T13:31:09,Bilbao,Expense,cash,-100.0,-24218.91
buyer_1,Luis,28,ES56209552778483068985,TRX_N-00468-60804084,2023-03-01T10:32:40,Bilbao,incomes,salary,1443.95,-22774.96
buyer_1,Luis,28,ES56209552778483068985,TRX_N-00469-69942291,2023-03-01T10:32:40,Bilbao,incomes,salary_partner,1358.1,-21416.86
buyer_1,Luis,28,ES56209552778483068985,TRX_N-00470-55625817,2023-03-01T11:42:45,Bilbao,Expense,food,-71.56,-21488.42
buyer_1,Luis,28,ES56209552778483068985,TRX_N-00471-89566664,2023-03-02T19:04:42,Bilbao,Expense,cash,-100.0,-21588.42
buyer_1,Luis,28,ES56209552778483068985,TRX_N-00472-30539625,2023-03-04T21:09:20,Bilbao,expenses,mortgage,-731.08,-22319.5
buyer_1,Luis,28,ES56209552778483068985,TRX_N-00473-93220788,2023-03-04T14:23:43,Bilbao,Expense,transport,-74.7,-22394.2
buyer_1,Luis,28,ES56209552778483068985,TRX_N-00474-75352466,2023-03-05T15:18:19,Bilbao,expenses,water,-38.56,-22432.76
buyer_1,Luis,28,ES56209552778483068985,TRX_N-00475-98902093,2023-03-05T18:27:51,Bilbao,expenses,gas,-113.73,-22546.49
buyer_1,Luis,28,ES56209552778483068985,TRX_N-00476-36637305,2023-03-05T20:55:15,Bilbao,expenses,internet,-42.0,-22588.49
buyer_1,Luis,28,ES56209552778483068985,TRX_N-00477-53907239,2023-03-06T18:47:05,Bilbao,expenses,electricity,-28.26,-22616.75
buyer_1,Luis,28,ES56209552778483068985,TRX_N-00478-16856094,2023-03-06T17:09:17,Bilbao,Expense,transport,-55.83,-22672.58
buyer_1,Luis,28,ES56209552778483068985,TRX_N-00479-94678536,2023-03-06T06:08:33,Bilbao,Expense,repairs,-308.38,-22980.96
buyer_1,Luis,28,ES56209552778483068985,TRX_N-00480-63045990,2023-03-07T19:37:21,Bilbao,expenses,children,-126.5,-23107.46
buyer_1,Luis,28,ES56209552778483068985,TRX_N-00481-28726742,2023-03-08T13:50:38,Bilbao,expenses,phone,-35.56,-23143.02
buyer_1,Luis,28,ES56209552778483068985,TRX_N-00482-39412312,2023-03-08T18:51:36,Getxo,Expense,transport,-76.92,-23219.94
buyer_1,Luis,28,ES56209552778483068985,TRX_N-00483-38001843,2023-03-08T16:05:56,Leioa,Expense,leisure,-83.43,-23303.37
buyer_1,Luis,28,ES56209552778483068985,TRX_N-00484-96861826,2023-03-08T16:15:10,Bilbao,Expense,cash,-100.0,-23403.37
buyer_1,Luis,28,ES56209552778483068985,TRX_N-00485-36633760,2023-03-09T10:36:24,Bilbao,Expense,food,-101.37,-23504.74
buyer_1,Luis,28,ES56209552778483068985,TRX_N-00486-12820658,2023-03-09T14:15:32,Bilbao,Expense,clothing,-125.72,-23630.46
buyer_1,Luis,28,ES56209552778483068985,TRX_N-00487-37043855,2023-03-10T21:01:45,Bilbao,Expense,cash,-100.0,-23730.46
buyer_1,Luis,28,ES56209552778483068985,TRX_N-00488-76694352,2023-03-13T15:28:50,Bilbao,Expense,education,-63.08,-23793.54
buyer_1,Luis,28,ES56209552778483068985,TRX_N-00489-62544037,2023-03-14T20:48:20,Lasarte-Oria,Expense,appliances,-319.62,-24113.16
buyer_1,Luis,28,ES56209552778483068985,TRX_N-00490-81660952,2023-03-18T12:24:41,Bilbao,Expense,leisure,-76.61,-24189.77
buyer_1,Luis,28,ES56209552778483068985,TRX_N-00491-83317485,2023-03-18T19:01:48,Bermeo,Expense,clothing,-142.37,-24332.14
buyer_1,Luis,28,ES56209552778483068985,TRX_N-00492-90094919,2023-03-18T12:22:20,Bilbao,expenses,children,-138.58,-24470.72
buyer_1,Luis,28,ES56209552778483068985,TRX_N-00493-43986845,2023-03-20T16:59:55,Bilbao,Expense,food,-65.41,-24536.13
buyer_1,Luis,28,ES56209552778483068985,TRX_N-00494-07258139,2023-03-22T14:21:02,Bilbao,Expense,transport,-87.31,-24623.44
buyer_1,Luis,28,ES56209552778483068985,TRX_N-00495-16105227,2023-03-22T13:03:56,Bilbao,Expense,clothing,-48.55,-24671.99
buyer_1,Luis,28,ES56209552778483068985,TRX_N-00496-50306685,2023-03-22T14:03:32,Bilbao,Expense,cash,-100.0,-24771.99
buyer_1,Luis,28,ES56209552778483068985,TRX_N-00497-97144303,2023-03-24T17:46:29,Bilbao,Expense,food,-74.52,-24846.51
buyer_1,Luis,28,ES56209552778483068985,TRX_N-00498-55216868,2023-03-24T17:54:28,Bilbao,Expense,transport,-71.08,-24917.59
buyer_1,Luis,28,ES56209552778483068985,TRX_N-00499-94829912,2023-03-24T13:48:51,Erandio,Expense,gifts,-660.45,-25578.04
buyer_1,Luis,28,ES56209552778483068985,TRX_N-00500-20873221,2023-03-25T01:13:12,Bilbao,Expense,transport,-72.85,-25650.89
buyer_1,Luis,28,ES56209552778483068985,TRX_N-00501-95150960,2023-03-26T08:10:09,Bilbao,Expense,food,-109.87,-25760.76
buyer_1,Luis,28,ES56209552778483068985,TRX_N-00502-63644023,2023-03-26T15:03:29,Bilbao,Expense,repairs,-210.86,-25971.62
buyer_1,Luis,28,ES56209552778483068985,TRX_N-00503-61508222,2023-03-27T09:21:15,Bilbao,Expense,transport,-59.31,-26030.93
buyer_1,Luis,28,ES56209552778483068985,TRX_N-00504-79580412,2023-03-27T13:19:05,Bilbao,Expense,cash,-100.0,-26130.93
buyer_1,Luis,28,ES56209552778483068985,TRX_N-00505-57016625,2023-03-30T10:28:23,Bilbao,Expense,food,-102.52,-26233.45
buyer_1,Luis,28,ES56209552778483068985,TRX_N-00506-75545346,2023-03-31T22:26:43,Bilbao,Expense,transport,-47.07,-26280.52
buyer_1,Luis,28,ES56209552778483068985,TRX_N-00507-35284070,2023-04-01T20:51:12,Bilbao,incomes,salary,1443.95,-24836.57
buyer_1,Luis,28,ES56209552778483068985,TRX_N-00508-89081066,2023-04-01T20:51:12,Bilbao,incomes,salary_partner,1358.1,-23478.47
buyer_1,Luis,28,ES56209552778483068985,TRX_N-00509-48135830,2023-04-01T20:51:12,Bilbao,incomes,extra_income,186.09,-23292.38
buyer_1,Luis,28,ES56209552778483068985,TRX_N-00510-28760549,2023-04-01T20:59:55,Errenteria,Expense,clothing,-143.19,-23435.57
buyer_1,Luis,28,ES56209552778483068985,TRX_N-00511-62694111,2023-04-01T13:19:49,Bilbao,expenses,children,-157.01,-23592.58
buyer_1,Luis,28,ES56209552778483068985,TRX_N-00512-42918578,2023-04-02T02:44:36,Bilbao,Expense,food,-116.4,-23708.98
buyer_1,Luis,28,ES56209552778483068985,TRX_N-00513-71644269,2023-04-02T20:26:46,Bilbao,Expense,leisure,-80.36,-23789.34
buyer_1,Luis,28,ES56209552778483068985,TRX_N-00514-02752470,2023-04-04T13:54:48,Bilbao,expenses,mortgage,-731.08,-24520.42
buyer_1,Luis,28,ES56209552778483068985,TRX_N-00515-18778350,2023-04-05T08:24:15,Bilbao,Expense,transport,-61.75,-24582.17
buyer_1,Luis,28,ES56209552778483068985,TRX_N-00516-96779913,2023-04-05T20:02:50,Bilbao,Expense,leisure,-65.68,-24647.85
buyer_1,Luis,28,ES56209552778483068985,TRX_N-00517-09487268,2023-04-06T23:51:21,Bilbao,expenses,phone,-33.83,-24681.68
buyer_1,Luis,28,ES56209552778483068985,TRX_N-00518-31300351,2023-04-06T11:09:54,Bilbao,Expense,food,-73.01,-24754.69
buyer_1,Luis,28,ES56209552778483068985,TRX_N-00519-14743971,2023-04-06T10:20:31,Bilbao,Expense,cash,-100.0,-24854.69
buyer_1,Luis,28,ES56209552778483068985,TRX_N-00520-69052234,2023-04-08T10:25:44,Bilbao,expenses,electricity,-68.27,-24922.96
buyer_1,Luis,28,ES56209552778483068985,TRX_N-00521-82132671,2023-04-08T18:59:55,Bilbao,expenses,water,-34.43,-24957.39
buyer_1,Luis,28,ES56209552778483068985,TRX_N-00522-18521220,2023-04-08T21:12:16,Bilbao,expenses,gas,-47.36,-25004.75
buyer_1,Luis,28,ES56209552778483068985,TRX_N-00523-97638148,2023-04-08T16:09:04,Bilbao,expenses,internet,-42.0,-25046.75
buyer_1,Luis,28,ES56209552778483068985,TRX_N-00524-23392550,2023-04-09T14:06:55,Errenteria,Expense,food,-100.64,-25147.39
buyer_1,Luis,28,ES56209552778483068985,TRX_N-00525-85541337,2023-04-09T20:23:18,Bilbao,Expense,cash,-100.0,-25247.39
buyer_1,Luis,28,ES56209552778483068985,TRX_N-00526-80754191,2023-04-11T10:28:56,Bilbao,Expense,clothing,-129.04,-25376.43
buyer_1,Luis,28,ES56209552778483068985,TRX_N-00527-84021873,2023-04-13T20:10:26,Bilbao,Expense,appliances,-180.29,-25556.72
buyer_1,Luis,28,ES56209552778483068985,TRX_N-00528-13528860,2023-04-14T18:02:57,Bilbao,Expense,repairs,-224.1,-25780.82
buyer_1,Luis,28,ES56209552778483068985,TRX_N-00529-56735819,2023-04-15T17:18:04,Bilbao,Expense,food,-113.76,-25894.58
buyer_1,Luis,28,ES56209552778483068985,TRX_N-00530-38228435,2023-04-15T16:38:35,Santurtzi,Expense,leisure,-40.94,-25935.52
buyer_1,Luis,28,ES56209552778483068985,TRX_N-00531-06251253,2023-04-16T11:05:29,Bilbao,Expense,transport,-75.94,-26011.46
buyer_1,Luis,28,ES56209552778483068985,TRX_N-00532-21215028,2023-04-16T12:42:01,Bilbao,Expense,repairs,-159.2,-26170.66
buyer_1,Luis,28,ES56209552778483068985,TRX_N-00533-18423143,2023-04-18T08:04:42,Bilbao,Expense,cash,-100.0,-26270.66
buyer_1,Luis,28,ES56209552778483068985,TRX_N-00534-21965053,2023-04-19T12:37:55,Alegr√≠a-Dulantzi,Expense,transport,-63.99,-26334.65
buyer_1,Luis,28,ES56209552778483068985,TRX_N-00535-79717794,2023-04-19T18:32:51,Bilbao,Expense,clothing,-107.84,-26442.49
buyer_1,Luis,28,ES56209552778483068985,TRX_N-00536-99612663,2023-04-21T12:24:05,Bilbao,Expense,transport,-88.98,-26531.47
buyer_1,Luis,28,ES56209552778483068985,TRX_N-00537-07050044,2023-04-21T11:29:32,Bilbao,Expense,cash,-100.0,-26631.47
buyer_1,Luis,28,ES56209552778483068985,TRX_N-00538-35103880,2023-04-22T18:44:53,Bilbao,Expense,food,-63.38,-26694.85
buyer_1,Luis,28,ES56209552778483068985,TRX_N-00539-34778143,2023-04-22T06:52:48,Bilbao,Expense,healthcare,-165.5,-26860.35
buyer_1,Luis,28,ES56209552778483068985,TRX_N-00540-84930929,2023-04-25T06:10:42,Bilbao,Expense,cash,-100.0,-26960.35
buyer_1,Luis,28,ES56209552778483068985,TRX_N-00541-31783837,2023-04-26T10:41:14,Bilbao,Expense,cash,-100.0,-27060.35
buyer_1,Luis,28,ES56209552778483068985,TRX_N-00542-78692474,2023-04-27T21:12:47,Bilbao,Expense,travel,-1509.56,-28569.91
buyer_1,Luis,28,ES56209552778483068985,TRX_N-00543-18325516,2023-04-28T04:14:14,Amurrio,Expense,transport,-45.28,-28615.19
buyer_1,Luis,28,ES56209552778483068985,TRX_N-00544-52465046,2023-04-28T04:07:30,Bilbao,Expense,leisure,-43.94,-28659.13
buyer_1,Luis,28,ES56209552778483068985,TRX_N-00545-38680442,2023-04-30T10:40:16,Bilbao,Expense,food,-88.75,-28747.88
buyer_1,Luis,28,ES56209552778483068985,TRX_N-00546-27566195,2023-04-30T19:32:09,Bilbao,Expense,appliances,-178.57,-28926.45
buyer_1,Luis,28,ES56209552778483068985,TRX_N-00547-44007628,2023-05-01T22:40:49,Bilbao,incomes,salary,1443.95,-27482.5
buyer_1,Luis,28,ES56209552778483068985,TRX_N-00548-16271556,2023-05-01T22:40:49,Bilbao,incomes,salary_partner,1358.1,-26124.4
buyer_1,Luis,28,ES56209552778483068985,TRX_N-00549-89326327,2023-05-01T11:18:48,Alegr√≠a-Dulantzi,Expense,education,-67.96,-26192.36
buyer_1,Luis,28,ES56209552778483068985,TRX_N-00550-10471892,2023-05-01T15:46:04,Portugalete,Expense,repairs,-189.76,-26382.12
buyer_1,Luis,28,ES56209552778483068985,TRX_N-00551-28756005,2023-05-02T16:03:21,Bilbao,Expense,healthcare,-75.63,-26457.75
buyer_1,Luis,28,ES56209552778483068985,TRX_N-00552-03666617,2023-05-02T19:16:37,Salvatierra/Agurain,Expense,cash,-100.0,-26557.75
buyer_1,Luis,28,ES56209552778483068985,TRX_N-00553-91066848,2023-05-03T09:11:46,Eibar,Expense,food,-92.03,-26649.78
buyer_1,Luis,28,ES56209552778483068985,TRX_N-00554-51991045,2023-05-03T09:09:15,Bilbao,Expense,cash,-100.0,-26749.78
buyer_1,Luis,28,ES56209552778483068985,TRX_N-00555-96254816,2023-05-04T16:54:19,Bilbao,expenses,mortgage,-731.08,-27480.86
buyer_1,Luis,28,ES56209552778483068985,TRX_N-00556-73089655,2023-05-05T09:59:42,Bilbao,expenses,gas,-89.52,-27570.38
buyer_1,Luis,28,ES56209552778483068985,TRX_N-00557-99142630,2023-05-05T19:03:22,Bilbao,expenses,internet,-42.0,-27612.38
buyer_1,Luis,28,ES56209552778483068985,TRX_N-00558-82367354,2023-05-06T10:03:21,Bilbao,expenses,electricity,-87.86,-27700.24
buyer_1,Luis,28,ES56209552778483068985,TRX_N-00559-84124835,2023-05-07T10:03:59,Bilbao,expenses,water,-22.32,-27722.56
buyer_1,Luis,28,ES56209552778483068985,TRX_N-00560-98892852,2023-05-07T23:55:35,Bilbao,Expense,gifts,-592.79,-28315.35
buyer_1,Luis,28,ES56209552778483068985,TRX_N-00561-05482962,2023-05-08T12:49:09,Bilbao,expenses,phone,-40.08,-28355.43
buyer_1,Luis,28,ES56209552778483068985,TRX_N-00562-84571841,2023-05-08T15:46:26,Bilbao,Expense,cash,-100.0,-28455.43
buyer_1,Luis,28,ES56209552778483068985,TRX_N-00563-07025070,2023-05-09T08:56:44,Arrasate,Expense,clothing,-156.09,-28611.52
buyer_1,Luis,28,ES56209552778483068985,TRX_N-00564-39296439,2023-05-12T10:53:37,Bilbao,Expense,transport,-47.8,-28659.32
buyer_1,Luis,28,ES56209552778483068985,TRX_N-00565-51970345,2023-05-13T22:17:09,Bilbao,Expense,cash,-100.0,-28759.32
buyer_1,Luis,28,ES56209552778483068985,TRX_N-00566-49290636,2023-05-14T08:07:21,Bilbao,Expense,transport,-40.59,-28799.91
buyer_1,Luis,28,ES56209552778483068985,TRX_N-00567-76963988,2023-05-16T09:22:39,Bilbao,Expense,food,-68.99,-28868.9
buyer_1,Luis,28,ES56209552778483068985,TRX_N-00568-02196211,2023-05-16T00:40:44,Arrasate,Expense,leisure,-57.98,-28926.88
buyer_1,Luis,28,ES56209552778483068985,TRX_N-00569-98695176,2023-05-17T04:35:45,Iru√±a de Oca,Expense,cash,-100.0,-29026.88
buyer_1,Luis,28,ES56209552778483068985,TRX_N-00570-39992447,2023-05-18T11:37:59,Bilbao,Expense,food,-112.84,-29139.72
buyer_1,Luis,28,ES56209552778483068985,TRX_N-00571-78744745,2023-05-21T18:49:13,Bilbao,Expense,food,-73.95,-29213.67
buyer_1,Luis,28,ES56209552778483068985,TRX_N-00572-34785031,2023-05-21T20:30:43,Iru√±a de Oca,Expense,transport,-89.02,-29302.69
buyer_1,Luis,28,ES56209552778483068985,TRX_N-00573-13342573,2023-05-22T08:17:57,Berango,Expense,leisure,-18.34,-29321.03
buyer_1,Luis,28,ES56209552778483068985,TRX_N-00574-27054962,2023-05-23T10:12:55,Bilbao,Expense,leisure,-43.92,-29364.95
buyer_1,Luis,28,ES56209552778483068985,TRX_N-00575-31319345,2023-05-23T17:04:02,Andoain,Expense,cash,-100.0,-29464.95
buyer_1,Luis,28,ES56209552778483068985,TRX_N-00576-57851641,2023-05-27T10:19:37,Basauri,Expense,leisure,-79.71,-29544.66
buyer_1,Luis,28,ES56209552778483068985,TRX_N-00577-48493542,2023-05-27T13:37:56,Bilbao,Expense,repairs,-30.12,-29574.78
buyer_1,Luis,28,ES56209552778483068985,TRX_N-00578-89443241,2023-05-28T22:28:23,Bilbao,Expense,food,-111.28,-29686.06
buyer_1,Luis,28,ES56209552778483068985,TRX_N-00579-21988090,2023-05-28T09:41:20,Bilbao,Expense,clothing,-119.71,-29805.77
buyer_1,Luis,28,ES56209552778483068985,TRX_N-00580-07448541,2023-05-30T19:01:11,Portugalete,Expense,cash,-100.0,-29905.77
buyer_1,Luis,28,ES56209552778483068985,TRX_N-00581-68412080,2023-05-31T23:56:26,Pasaia,Expense,leisure,-36.01,-29941.78
buyer_1,Luis,28,ES56209552778483068985,TRX_N-00582-57240188,2023-06-01T15:09:23,Bilbao,incomes,salary,1443.95,-28497.83
buyer_1,Luis,28,ES56209552778483068985,TRX_N-00583-62236476,2023-06-01T15:09:23,Bilbao,incomes,salary_partner,1358.1,-27139.73
buyer_1,Luis,28,ES56209552778483068985,TRX_N-00584-41010395,2023-06-01T15:09:23,Bilbao,incomes,salary_bonus,1091.96,-26047.77
buyer_1,Luis,28,ES56209552778483068985,TRX_N-00585-81895566,2023-06-01T15:09:23,Bilbao,incomes,salary_partner_bonus,960.79,-25086.98
buyer_1,Luis,28,ES56209552778483068985,TRX_N-00586-77310825,2023-06-02T10:01:53,Bilbao,Expense,leisure,-68.51,-25155.49
buyer_1,Luis,28,ES56209552778483068985,TRX_N-00587-80796068,2023-06-03T15:20:00,Bilbao,Expense,clothing,-104.85,-25260.34
buyer_1,Luis,28,ES56209552778483068985,TRX_N-00588-34673188,2023-06-03T15:49:04,Zuia,Expense,cash,-100.0,-25360.34
buyer_1,Luis,28,ES56209552778483068985,TRX_N-00589-18676224,2023-06-04T17:53:20,Bilbao,expenses,mortgage,-731.08,-26091.42
buyer_1,Luis,28,ES56209552778483068985,TRX_N-00590-88441087,2023-06-04T11:08:35,Bilbao,expenses,taxes,-1536.4,-27627.82
buyer_1,Luis,28,ES56209552778483068985,TRX_N-00591-06708154,2023-06-04T19:27:16,Bilbao,expenses,insurance,-305.81,-27933.63
buyer_1,Luis,28,ES56209552778483068985,TRX_N-00592-53080350,2023-06-05T20:05:24,Bilbao,expenses,phone,-39.61,-27973.24
buyer_1,Luis,28,ES56209552778483068985,TRX_N-00593-80008927,2023-06-06T08:28:49,Hondarribia,Expense,gifts,-308.05,-28281.29
buyer_1,Luis,28,ES56209552778483068985,TRX_N-00594-74425766,2023-06-08T13:37:22,Bilbao,expenses,gas,-48.89,-28330.18
buyer_1,Luis,28,ES56209552778483068985,TRX_N-00595-46745478,2023-06-08T19:34:12,Bilbao,expenses,water,-32.69,-28362.87
buyer_1,Luis,28,ES56209552778483068985,TRX_N-00596-17592667,2023-06-08T13:41:38,Bilbao,expenses,electricity,-89.04,-28451.91
buyer_1,Luis,28,ES56209552778483068985,TRX_N-00597-67160849,2023-06-08T09:18:02,Bilbao,expenses,internet,-42.0,-28493.91
buyer_1,Luis,28,ES56209552778483068985,TRX_N-00598-62254253,2023-06-08T08:34:03,Bilbao,Expense,leisure,-72.06,-28565.97
buyer_1,Luis,28,ES56209552778483068985,TRX_N-00599-87583630,2023-06-10T08:09:15,Irun,Expense,education,-76.58,-28642.55
buyer_1,Luis,28,ES56209552778483068985,TRX_N-00600-77997632,2023-06-11T11:40:58,Bilbao,Expense,gifts,-628.98,-29271.53
buyer_1,Luis,28,ES56209552778483068985,TRX_N-00601-06083218,2023-06-13T13:12:58,Bilbao,Expense,cash,-100.0,-29371.53
buyer_1,Luis,28,ES56209552778483068985,TRX_N-00602-37739508,2023-06-15T09:57:30,Bilbao,Expense,transport,-44.58,-29416.11
buyer_1,Luis,28,ES56209552778483068985,TRX_N-00603-80770811,2023-06-15T18:12:19,Bilbao,Expense,gifts,-747.2,-30163.31
buyer_1,Luis,28,ES56209552778483068985,TRX_N-00604-52196673,2023-06-16T20:57:25,Bilbao,Expense,leisure,-61.31,-30224.62
buyer_1,Luis,28,ES56209552778483068985,TRX_N-00605-82967915,2023-06-16T18:24:31,Bilbao,Expense,cash,-100.0,-30324.62
buyer_1,Luis,28,ES56209552778483068985,TRX_N-00606-31565923,2023-06-17T15:39:10,Sopela,Expense,cash,-100.0,-30424.62
buyer_1,Luis,28,ES56209552778483068985,TRX_N-00607-42999998,2023-06-17T15:45:16,Elciego,Expense,repairs,-35.53,-30460.15
buyer_1,Luis,28,ES56209552778483068985,TRX_N-00608-64822070,2023-06-18T09:35:11,Eibar,Expense,clothing,-159.66,-30619.81
buyer_1,Luis,28,ES56209552778483068985,TRX_N-00609-45870658,2023-06-18T14:31:24,Bilbao,Expense,cash,-100.0,-30719.81
buyer_1,Luis,28,ES56209552778483068985,TRX_N-00610-91421140,2023-06-21T13:42:19,Bilbao,Expense,transport,-53.09,-30772.9
buyer_1,Luis,28,ES56209552778483068985,TRX_N-00611-47543142,2023-06-21T18:47:31,Bilbao,Expense,gifts,-181.27,-30954.17
buyer_1,Luis,28,ES56209552778483068985,TRX_N-00612-72266315,2023-06-22T21:55:55,Bilbao,Expense,cash,-100.0,-31054.17
buyer_1,Luis,28,ES56209552778483068985,TRX_N-00613-81435491,2023-06-22T12:44:57,Bilbao,Expense,gifts,-327.25,-31381.42
buyer_1,Luis,28,ES56209552778483068985,TRX_N-00614-62183983,2023-06-23T00:11:09,Bilbao,Expense,food,-90.34,-31471.76
buyer_1,Luis,28,ES56209552778483068985,TRX_N-00615-95024308,2023-06-23T08:08:06,Santurtzi,Expense,leisure,-42.62,-31514.38
buyer_1,Luis,28,ES56209552778483068985,TRX_N-00616-74465790,2023-06-24T19:20:52,Bilbao,Expense,transport,-83.74,-31598.12
buyer_1,Luis,28,ES56209552778483068985,TRX_N-00617-12873424,2023-06-25T11:27:09,Bilbao,Expense,cash,-100.0,-31698.12
buyer_1,Luis,28,ES56209552778483068985,TRX_N-00618-17657680,2023-06-25T15:43:50,Bilbao,Expense,repairs,-315.35,-32013.47
buyer_1,Luis,28,ES56209552778483068985,TRX_N-00619-07693253,2023-06-30T10:30:10,Amurrio,Expense,repairs,-322.29,-32335.76
buyer_1,Luis,28,ES56209552778483068985,TRX_N-00620-44846668,2023-07-01T20:42:27,Bilbao,incomes,salary,1443.95,-30891.81
buyer_1,Luis,28,ES56209552778483068985,TRX_N-00621-30979292,2023-07-01T20:42:27,Bilbao,incomes,salary_partner,1358.1,-29533.71
buyer_1,Luis,28,ES56209552778483068985,TRX_N-00622-57611233,2023-07-01T17:32:57,Bilbao,Expense,food,-105.87,-29639.58
buyer_1,Luis,28,ES56209552778483068985,TRX_N-00623-75030135,2023-07-02T18:06:05,Bilbao,Expense,food,-103.68,-29743.26
buyer_1,Luis,28,ES56209552778483068985,TRX_N-00624-17627355,2023-07-03T14:24:29,Bilbao,Expense,cash,-100.0,-29843.26
buyer_1,Luis,28,ES56209552778483068985,TRX_N-00625-94130073,2023-07-04T20:12:57,Bilbao,expenses,mortgage,-731.08,-30574.34
buyer_1,Luis,28,ES56209552778483068985,TRX_N-00626-78509601,2023-07-05T14:17:16,Bilbao,expenses,gas,-97.53,-30671.87
buyer_1,Luis,28,ES56209552778483068985,TRX_N-00627-29283207,2023-07-06T09:15:05,Bilbao,expenses,electricity,-60.36,-30732.23
buyer_1,Luis,28,ES56209552778483068985,TRX_N-00628-05658694,2023-07-06T08:40:15,Bilbao,expenses,phone,-32.2,-30764.43
buyer_1,Luis,28,ES56209552778483068985,TRX_N-00629-27069520,2023-07-06T13:31:09,Bilbao,Expense,food,-121.59,-30886.02
buyer_1,Luis,28,ES56209552778483068985,TRX_N-00630-10312838,2023-07-07T15:22:27,Bilbao,expenses,water,-24.66,-30910.68
buyer_1,Luis,28,ES56209552778483068985,TRX_N-00631-42916299,2023-07-07T16:29:46,Durango,Expense,transport,-87.3,-30997.98
buyer_1,Luis,28,ES56209552778483068985,TRX_N-00632-86210563,2023-07-07T12:46:45,Bilbao,Expense,repairs,-275.05,-31273.03
buyer_1,Luis,28,ES56209552778483068985,TRX_N-00633-22004943,2023-07-08T21:03:58,Bilbao,expenses,internet,-42.0,-31315.03
buyer_1,Luis,28,ES56209552778483068985,TRX_N-00634-78121853,2023-07-08T17:53:05,Bilbao,Expense,food,-65.53,-31380.56
buyer_1,Luis,28,ES56209552778483068985,TRX_N-00635-58114172,2023-07-09T13:59:45,Bilbao,Expense,clothing,-117.45,-31498.01
buyer_1,Luis,28,ES56209552778483068985,TRX_N-00636-38952251,2023-07-10T11:33:22,Bilbao,Expense,leisure,-80.42,-31578.43
buyer_1,Luis,28,ES56209552778483068985,TRX_N-00637-26790865,2023-07-10T12:28:50,Arrasate,Expense,clothing,-91.35,-31669.78
buyer_1,Luis,28,ES56209552778483068985,TRX_N-00638-77865317,2023-07-10T11:29:56,Bilbao,Expense,appliances,-346.55,-32016.33
buyer_1,Luis,28,ES56209552778483068985,TRX_N-00639-92760463,2023-07-11T13:10:18,Alegr√≠a-Dulantzi,Expense,food,-104.63,-32120.96
buyer_1,Luis,28,ES56209552778483068985,TRX_N-00640-27034825,2023-07-12T18:25:38,Bilbao,Expense,education,-70.79,-32191.75
buyer_1,Luis,28,ES56209552778483068985,TRX_N-00641-58015821,2023-07-14T15:01:13,Bilbao,Expense,transport,-59.43,-32251.18
buyer_1,Luis,28,ES56209552778483068985,TRX_N-00642-62195889,2023-07-14T20:06:19,Mungia,Expense,appliances,-136.62,-32387.8
buyer_1,Luis,28,ES56209552778483068985,TRX_N-00643-58523126,2023-07-15T12:43:54,Bilbao,Expense,cash,-100.0,-32487.8
buyer_1,Luis,28,ES56209552778483068985,TRX_N-00644-30170010,2023-07-17T14:51:13,Oy√≥n-Oion,Expense,food,-100.63,-32588.43
buyer_1,Luis,28,ES56209552778483068985,TRX_N-00645-71404220,2023-07-18T16:48:49,Bilbao,Expense,food,-66.08,-32654.51
buyer_1,Luis,28,ES56209552778483068985,TRX_N-00646-57711371,2023-07-19T13:37:20,Bilbao,Expense,cash,-100.0,-32754.51
buyer_1,Luis,28,ES56209552778483068985,TRX_N-00647-91849398,2023-07-22T14:18:39,Barakaldo,Expense,food,-102.25,-32856.76
buyer_1,Luis,28,ES56209552778483068985,TRX_N-00648-89966140,2023-07-23T21:34:23,Bilbao,Expense,transport,-55.73,-32912.49
buyer_1,Luis,28,ES56209552778483068985,TRX_N-00649-39070337,2023-07-25T10:47:20,Bilbao,Expense,food,-86.53,-32999.02
buyer_1,Luis,28,ES56209552778483068985,TRX_N-00650-40728542,2023-07-25T16:01:03,Bilbao,Expense,cash,-100.0,-33099.02
buyer_1,Luis,28,ES56209552778483068985,TRX_N-00651-66246159,2023-07-26T05:08:54,Bilbao,Expense,cash,-100.0,-33199.02
buyer_1,Luis,28,ES56209552778483068985,TRX_N-00652-18857493,2023-07-28T17:36:50,Bilbao,Expense,food,-113.75,-33312.77
buyer_1,Luis,28,ES56209552778483068985,TRX_N-00653-29586677,2023-07-28T07:21:56,Bilbao,Expense,cash,-100.0,-33412.77
buyer_1,Luis,28,ES56209552778483068985,TRX_N-00654-07437905,2023-07-31T14:52:21,Bilbao,Expense,food,-74.67,-33487.44
buyer_1,Luis,28,ES56209552778483068985,TRX_N-00655-15235541,2023-08-01T16:40:34,Bilbao,incomes,salary,1443.95,-32043.49
buyer_1,Luis,28,ES56209552778483068985,TRX_N-00656-07987982,2023-08-01T16:40:34,Bilbao,incomes,salary_partner,1358.1,-30685.39
buyer_1,Luis,28,ES56209552778483068985,TRX_N-00657-70806331,2023-08-01T16:40:34,Bilbao,incomes,extra_income,186.09,-30499.3
buyer_1,Luis,28,ES56209552778483068985,TRX_N-00658-36385169,2023-08-01T16:05:11,Bilbao,Expense,transport,-62.86,-30562.16
buyer_1,Luis,28,ES56209552778483068985,TRX_N-00659-15003680,2023-08-01T01:48:22,Bilbao,Expense,gifts,-636.87,-31199.03
buyer_1,Luis,28,ES56209552778483068985,TRX_N-00660-15825034,2023-08-02T21:09:56,Vitoria-Gasteiz,Expense,transport,-86.14,-31285.17
buyer_1,Luis,28,ES56209552778483068985,TRX_N-00661-55470391,2023-08-04T08:40:47,Bilbao,expenses,mortgage,-731.08,-32016.25
buyer_1,Luis,28,ES56209552778483068985,TRX_N-00662-71758596,2023-08-04T17:39:12,Sestao,Expense,cash,-100.0,-32116.25
buyer_1,Luis,28,ES56209552778483068985,TRX_N-00663-80115507,2023-08-05T11:31:07,Bilbao,expenses,phone,-38.47,-32154.72
buyer_1,Luis,28,ES56209552778483068985,TRX_N-00664-39359826,2023-08-05T15:46:28,Bilbao,Expense,cash,-100.0,-32254.72
buyer_1,Luis,28,ES56209552778483068985,TRX_N-00665-06908750,2023-08-06T10:51:14,Bilbao,expenses,water,-36.62,-32291.34
buyer_1,Luis,28,ES56209552778483068985,TRX_N-00666-01835571,2023-08-06T08:57:45,Bilbao,expenses,internet,-42.0,-32333.34
buyer_1,Luis,28,ES56209552778483068985,TRX_N-00667-32241294,2023-08-06T10:34:36,Bilbao,Expense,clothing,-148.96,-32482.3
buyer_1,Luis,28,ES56209552778483068985,TRX_N-00668-40769517,2023-08-07T12:28:27,Bilbao,expenses,gas,-75.54,-32557.84
buyer_1,Luis,28,ES56209552778483068985,TRX_N-00669-88317174,2023-08-07T15:06:11,Bilbao,Expense,leisure,-40.01,-32597.85
buyer_1,Luis,28,ES56209552778483068985,TRX_N-00670-57493267,2023-08-08T11:44:35,Bilbao,expenses,electricity,-38.15,-32636.0
buyer_1,Luis,28,ES56209552778483068985,TRX_N-00671-96751656,2023-08-08T10:07:26,Durango,Expense,travel,-594.53,-33230.53
buyer_1,Luis,28,ES56209552778483068985,TRX_N-00672-03369010,2023-08-09T15:38:34,Andoain,Expense,leisure,-78.42,-33308.95
buyer_1,Luis,28,ES56209552778483068985,TRX_N-00673-80731844,2023-08-09T20:11:32,Bilbao,Expense,repairs,-291.49,-33600.44
buyer_1,Luis,28,ES56209552778483068985,TRX_N-00674-73392190,2023-08-14T04:29:34,Bilbao,Expense,transport,-87.11,-33687.55
buyer_1,Luis,28,ES56209552778483068985,TRX_N-00675-48470281,2023-08-14T07:19:11,Bilbao,Expense,gifts,-713.99,-34401.54
buyer_1,Luis,28,ES56209552778483068985,TRX_N-00676-78336796,2023-08-15T11:24:25,Bilbao,Expense,education,-67.17,-34468.71
buyer_1,Luis,28,ES56209552778483068985,TRX_N-00677-25848743,2023-08-15T11:28:56,Bilbao,Expense,cash,-100.0,-34568.71
buyer_1,Luis,28,ES56209552778483068985,TRX_N-00678-79767056,2023-08-16T17:57:18,Bilbao,Expense,gifts,-54.79,-34623.5
buyer_1,Luis,28,ES56209552778483068985,TRX_N-00679-18347475,2023-08-17T14:33:13,Santurtzi,Expense,education,-53.21,-34676.71
buyer_1,Luis,28,ES56209552778483068985,TRX_N-00680-95387712,2023-08-18T08:43:59,Bilbao,Expense,gifts,-676.17,-35352.88
buyer_1,Luis,28,ES56209552778483068985,TRX_N-00681-62722152,2023-08-19T15:29:48,Bilbao,Expense,cash,-100.0,-35452.88
buyer_1,Luis,28,ES56209552778483068985,TRX_N-00682-56140708,2023-08-19T11:46:30,Bilbao,Expense,appliances,-327.71,-35780.59
buyer_1,Luis,28,ES56209552778483068985,TRX_N-00683-07432537,2023-08-20T10:41:15,Bilbao,Expense,repairs,-121.3,-35901.89
buyer_1,Luis,28,ES56209552778483068985,TRX_N-00684-53766630,2023-08-22T01:37:52,Bilbao,Expense,education,-48.9,-35950.79
buyer_1,Luis,28,ES56209552778483068985,TRX_N-00685-82717551,2023-08-22T18:46:51,Pasaia,Expense,cash,-100.0,-36050.79
buyer_1,Luis,28,ES56209552778483068985,TRX_N-00686-35310391,2023-08-23T23:20:39,Bilbao,Expense,food,-88.28,-36139.07
buyer_1,Luis,28,ES56209552778483068985,TRX_N-00687-16231129,2023-08-24T11:16:46,Bilbao,Expense,transport,-73.68,-36212.75
buyer_1,Luis,28,ES56209552778483068985,TRX_N-00688-12563376,2023-08-26T12:05:51,Bilbao,Expense,food,-102.8,-36315.55
buyer_1,Luis,28,ES56209552778483068985,TRX_N-00689-67933580,2023-08-26T23:09:33,Bilbao,Expense,clothing,-86.73,-36402.28
buyer_1,Luis,28,ES56209552778483068985,TRX_N-00690-85051243,2023-08-26T15:47:31,Bilbao,Expense,gifts,-381.42,-36783.7
buyer_1,Luis,28,ES56209552778483068985,TRX_N-00691-72828433,2023-08-31T20:16:36,Bilbao,Expense,cash,-100.0,-36883.7
buyer_1,Luis,28,ES56209552778483068985,TRX_N-00692-16424948,2023-09-01T09:13:59,Bilbao,incomes,salary,1443.95,-35439.75
buyer_1,Luis,28,ES56209552778483068985,TRX_N-00693-45939525,2023-09-01T09:13:59,Bilbao,incomes,salary_partner,1358.1,-34081.65
buyer_1,Luis,28,ES56209552778483068985,TRX_N-00694-09685452,2023-09-01T16:24:11,Zarautz,Expense,food,-103.16,-34184.81
buyer_1,Luis,28,ES56209552778483068985,TRX_N-00695-38491868,2023-09-01T08:36:19,Lasarte-Oria,Expense,gifts,-669.7,-34854.51
buyer_1,Luis,28,ES56209552778483068985,TRX_N-00696-60510319,2023-09-02T07:41:02,Bilbao,expenses,children,-135.44,-34989.95
buyer_1,Luis,28,ES56209552778483068985,TRX_N-00697-06077103,2023-09-03T12:06:57,Bilbao,Expense,transport,-42.6,-35032.55
buyer_1,Luis,28,ES56209552778483068985,TRX_N-00698-63226871,2023-09-03T12:56:46,Bilbao,Expense,education,-74.85,-35107.4
buyer_1,Luis,28,ES56209552778483068985,TRX_N-00699-55736061,2023-09-04T19:22:00,Bilbao,expenses,mortgage,-731.08,-35838.48
buyer_1,Luis,28,ES56209552778483068985,TRX_N-00700-05736123,2023-09-05T12:01:47,Bilbao,expenses,water,-23.36,-35861.84
buyer_1,Luis,28,ES56209552778483068985,TRX_N-00701-13103610,2023-09-05T10:41:35,Bilbao,expenses,phone,-34.69,-35896.53
buyer_1,Luis,28,ES56209552778483068985,TRX_N-00702-96111817,2023-09-07T18:04:32,Bilbao,expenses,internet,-42.0,-35938.53
buyer_1,Luis,28,ES56209552778483068985,TRX_N-00703-85330897,2023-09-07T23:39:52,Bilbao,Expense,transport,-61.99,-36000.52
buyer_1,Luis,28,ES56209552778483068985,TRX_N-00704-12716911,2023-09-08T10:57:36,Bilbao,expenses,electricity,-88.33,-36088.85
buyer_1,Luis,28,ES56209552778483068985,TRX_N-00705-56852285,2023-09-08T13:39:28,Bilbao,expenses,gas,-51.89,-36140.74
buyer_1,Luis,28,ES56209552778483068985,TRX_N-00706-09329540,2023-09-08T13:29:15,Bilbao,Expense,leisure,-21.13,-36161.87
buyer_1,Luis,28,ES56209552778483068985,TRX_N-00707-53630769,2023-09-10T19:10:51,Bilbao,Expense,food,-109.88,-36271.75
buyer_1,Luis,28,ES56209552778483068985,TRX_N-00708-53321207,2023-09-10T20:54:09,Bilbao,Expense,leisure,-62.05,-36333.8
buyer_1,Luis,28,ES56209552778483068985,TRX_N-00709-10502693,2023-09-11T01:46:34,Bilbao,Expense,food,-68.19,-36401.99
buyer_1,Luis,28,ES56209552778483068985,TRX_N-00710-86208288,2023-09-11T08:07:18,Bilbao,Expense,cash,-100.0,-36501.99
buyer_1,Luis,28,ES56209552778483068985,TRX_N-00711-06292954,2023-09-12T13:47:12,Bilbao,Expense,transport,-72.67,-36574.66
buyer_1,Luis,28,ES56209552778483068985,TRX_N-00712-08509177,2023-09-13T08:53:12,Bilbao,Expense,food,-113.66,-36688.32
buyer_1,Luis,28,ES56209552778483068985,TRX_N-00713-52173333,2023-09-13T08:04:24,Galdakao,Expense,repairs,-51.68,-36740.0
buyer_1,Luis,28,ES56209552778483068985,TRX_N-00714-60635702,2023-09-13T21:36:26,Bilbao,Expense,gifts,-823.49,-37563.49
buyer_1,Luis,28,ES56209552778483068985,TRX_N-00715-98494789,2023-09-14T18:01:48,Salvatierra/Agurain,Expense,food,-121.09,-37684.58
buyer_1,Luis,28,ES56209552778483068985,TRX_N-00716-68968478,2023-09-15T19:51:41,Bilbao,Expense,leisure,-62.41,-37746.99
buyer_1,Luis,28,ES56209552778483068985,TRX_N-00717-86744425,2023-09-16T12:45:56,Bilbao,Expense,cash,-100.0,-37846.99
buyer_1,Luis,28,ES56209552778483068985,TRX_N-00718-15320342,2023-09-18T12:24:16,Bilbao,Expense,appliances,-292.81,-38139.8
buyer_1,Luis,28,ES56209552778483068985,TRX_N-00719-82449552,2023-09-19T11:19:18,Galdakao,Expense,repairs,-144.49,-38284.29
buyer_1,Luis,28,ES56209552778483068985,TRX_N-00720-96961987,2023-09-20T16:30:43,Bilbao,Expense,leisure,-42.92,-38327.21
buyer_1,Luis,28,ES56209552778483068985,TRX_N-00721-27486589,2023-09-23T23:19:47,Bilbao,Expense,repairs,-235.3,-38562.51
buyer_1,Luis,28,ES56209552778483068985,TRX_N-00722-51759329,2023-09-24T16:59:51,Bilbao,Expense,leisure,-50.68,-38613.19
buyer_1,Luis,28,ES56209552778483068985,TRX_N-00723-13147564,2023-09-24T14:52:15,Bilbao,Expense,cash,-100.0,-38713.19
buyer_1,Luis,28,ES56209552778483068985,TRX_N-00724-74563786,2023-09-25T15:31:25,Bilbao,Expense,repairs,-327.03,-39040.22
buyer_1,Luis,28,ES56209552778483068985,TRX_N-00725-21369550,2023-09-28T12:56:46,Bilbao,Expense,cash,-100.0,-39140.22
buyer_1,Luis,28,ES56209552778483068985,TRX_N-00726-52196434,2023-09-30T18:47:56,Bilbao,Expense,cash,-100.0,-39240.22
buyer_1,Luis,28,ES56209552778483068985,TRX_N-00727-91733694,2023-10-01T09:38:46,Bilbao,incomes,salary,1443.95,-37796.27
buyer_1,Luis,28,ES56209552778483068985,TRX_N-00728-64672816,2023-10-01T09:38:46,Bilbao,incomes,salary_partner,1358.1,-36438.17
buyer_1,Luis,28,ES56209552778483068985,TRX_N-00729-25695679,2023-10-01T16:08:36,Bilbao,Expense,gifts,-481.15,-36919.32
buyer_1,Luis,28,ES56209552778483068985,TRX_N-00730-67531973,2023-10-02T18:33:05,Bilbao,Expense,transport,-84.78,-37004.1
buyer_1,Luis,28,ES56209552778483068985,TRX_N-00731-55787116,2023-10-02T14:02:34,Bilbao,Expense,cash,-100.0,-37104.1
buyer_1,Luis,28,ES56209552778483068985,TRX_N-00732-50479219,2023-10-03T22:38:08,Bilbao,Expense,cash,-100.0,-37204.1
buyer_1,Luis,28,ES56209552778483068985,TRX_N-00733-88488765,2023-10-04T12:07:17,Bilbao,expenses,mortgage,-731.08,-37935.18
buyer_1,Luis,28,ES56209552778483068985,TRX_N-00734-17598574,2023-10-06T10:46:12,Bilbao,expenses,gas,-41.64,-37976.82
buyer_1,Luis,28,ES56209552778483068985,TRX_N-00735-96105812,2023-10-06T19:33:24,Hondarribia,Expense,food,-99.94,-38076.76
buyer_1,Luis,28,ES56209552778483068985,TRX_N-00736-10086059,2023-10-06T12:09:43,Bilbao,Expense,leisure,-35.54,-38112.3
buyer_1,Luis,28,ES56209552778483068985,TRX_N-00737-54282510,2023-10-07T08:09:19,Bilbao,expenses,internet,-42.0,-38154.3
buyer_1,Luis,28,ES56209552778483068985,TRX_N-00738-89391011,2023-10-08T16:09:52,Bilbao,expenses,water,-37.46,-38191.76
buyer_1,Luis,28,ES56209552778483068985,TRX_N-00739-92188065,2023-10-08T06:57:43,Bilbao,expenses,electricity,-76.22,-38267.98
buyer_1,Luis,28,ES56209552778483068985,TRX_N-00740-18792322,2023-10-08T08:54:00,Bilbao,expenses,phone,-37.39,-38305.37
buyer_1,Luis,28,ES56209552778483068985,TRX_N-00741-13832364,2023-10-08T18:30:31,Bilbao,Expense,repairs,-34.56,-38339.93
buyer_1,Luis,28,ES56209552778483068985,TRX_N-00742-34056999,2023-10-09T07:53:34,Bilbao,Expense,leisure,-28.46,-38368.39
buyer_1,Luis,28,ES56209552778483068985,TRX_N-00743-00426206,2023-10-10T11:54:28,Basauri,Expense,food,-86.54,-38454.93
buyer_1,Luis,28,ES56209552778483068985,TRX_N-00744-26264066,2023-10-10T08:04:54,Santurtzi,Expense,repairs,-57.54,-38512.47
buyer_1,Luis,28,ES56209552778483068985,TRX_N-00745-28791414,2023-10-12T11:37:47,Bilbao,expenses,children,-170.13,-38682.6
buyer_1,Luis,28,ES56209552778483068985,TRX_N-00746-52898169,2023-10-13T12:34:13,Bilbao,expenses,children,-72.19,-38754.79
buyer_1,Luis,28,ES56209552778483068985,TRX_N-00747-10174627,2023-10-20T14:15:53,Bilbao,Expense,repairs,-110.27,-38865.06
buyer_1,Luis,28,ES56209552778483068985,TRX_N-00748-94641025,2023-10-21T14:26:05,Bilbao,expenses,children,-85.97,-38951.03
buyer_1,Luis,28,ES56209552778483068985,TRX_N-00749-29921755,2023-10-23T05:31:31,Bilbao,Expense,cash,-100.0,-39051.03
buyer_1,Luis,28,ES56209552778483068985,TRX_N-00750-20967717,2023-10-23T18:08:05,Bilbao,Expense,appliances,-165.14,-39216.17
buyer_1,Luis,28,ES56209552778483068985,TRX_N-00751-40232949,2023-10-24T16:39:54,Bilbao,Expense,cash,-100.0,-39316.17
buyer_1,Luis,28,ES56209552778483068985,TRX_N-00752-70089394,2023-10-25T07:52:32,Bilbao,Expense,transport,-51.16,-39367.33
buyer_1,Luis,28,ES56209552778483068985,TRX_N-00753-07044876,2023-10-25T20:11:11,Bilbao,expenses,children,-173.5,-39540.83
buyer_1,Luis,28,ES56209552778483068985,TRX_N-00754-76591167,2023-10-27T21:14:01,Bilbao,Expense,cash,-100.0,-39640.83
buyer_1,Luis,28,ES56209552778483068985,TRX_N-00755-61125190,2023-10-28T20:47:53,Bilbao,Expense,healthcare,-116.24,-39757.07
buyer_1,Luis,28,ES56209552778483068985,TRX_N-00756-76441828,2023-10-28T19:23:22,Bilbao,expenses,children,-78.39,-39835.46
buyer_1,Luis,28,ES56209552778483068985,TRX_N-00757-86032240,2023-10-30T02:38:05,Bilbao,Expense,food,-86.81,-39922.27
buyer_1,Luis,28,ES56209552778483068985,TRX_N-00758-27041249,2023-10-30T11:23:55,Bilbao,Expense,repairs,-188.67,-40110.94
buyer_1,Luis,28,ES56209552778483068985,TRX_N-00759-20759067,2023-11-01T03:34:23,Bilbao,incomes,salary,1443.95,-38666.99
buyer_1,Luis,28,ES56209552778483068985,TRX_N-00760-43266655,2023-11-01T03:34:23,Bilbao,incomes,salary_partner,1358.1,-37308.89
buyer_1,Luis,28,ES56209552778483068985,TRX_N-00761-10207736,2023-11-01T03:34:23,Bilbao,incomes,extra_income,186.09,-37122.8
buyer_1,Luis,28,ES56209552778483068985,TRX_N-00762-07708658,2023-11-01T16:50:14,Bilbao,Expense,transport,-46.96,-37169.76
buyer_1,Luis,28,ES56209552778483068985,TRX_N-00763-84807512,2023-11-02T09:45:37,Mungia,Expense,food,-61.16,-37230.92
buyer_1,Luis,28,ES56209552778483068985,TRX_N-00764-66187277,2023-11-02T00:42:07,Bilbao,Expense,clothing,-142.25,-37373.17
buyer_1,Luis,28,ES56209552778483068985,TRX_N-00765-45895870,2023-11-02T11:26:56,Bilbao,Expense,cash,-100.0,-37473.17
buyer_1,Luis,28,ES56209552778483068985,TRX_N-00766-86560598,2023-11-04T01:13:48,Bilbao,expenses,mortgage,-731.08,-38204.25
buyer_1,Luis,28,ES56209552778483068985,TRX_N-00767-07012187,2023-11-04T08:38:35,Bilbao,Expense,leisure,-42.39,-38246.64
buyer_1,Luis,28,ES56209552778483068985,TRX_N-00768-19629341,2023-11-05T09:28:15,Bilbao,expenses,electricity,-54.01,-38300.65
buyer_1,Luis,28,ES56209552778483068985,TRX_N-00769-53243456,2023-11-05T12:20:22,Bilbao,expenses,phone,-30.21,-38330.86
buyer_1,Luis,28,ES56209552778483068985,TRX_N-00770-98676592,2023-11-05T16:55:23,Durango,Expense,repairs,-159.44,-38490.3
buyer_1,Luis,28,ES56209552778483068985,TRX_N-00771-57795290,2023-11-06T09:04:40,Bilbao,expenses,gas,-93.27,-38583.57
buyer_1,Luis,28,ES56209552778483068985,TRX_N-00772-00770382,2023-11-06T08:51:09,Zuia,Expense,healthcare,-92.21,-38675.78
buyer_1,Luis,28,ES56209552778483068985,TRX_N-00773-34624390,2023-11-06T17:20:44,Sopela,Expense,cash,-100.0,-38775.78
buyer_1,Luis,28,ES56209552778483068985,TRX_N-00774-69373760,2023-11-08T15:40:36,Bilbao,expenses,water,-21.06,-38796.84
buyer_1,Luis,28,ES56209552778483068985,TRX_N-00775-09247463,2023-11-08T12:21:37,Bilbao,expenses,internet,-42.0,-38838.84
buyer_1,Luis,28,ES56209552778483068985,TRX_N-00776-34022880,2023-11-08T15:52:45,Portugalete,Expense,food,-101.0,-38939.84
buyer_1,Luis,28,ES56209552778483068985,TRX_N-00777-31790128,2023-11-10T15:31:30,Bilbao,Expense,cash,-100.0,-39039.84
buyer_1,Luis,28,ES56209552778483068985,TRX_N-00778-08494646,2023-11-11T14:15:48,Bilbao,Expense,transport,-87.73,-39127.57
buyer_1,Luis,28,ES56209552778483068985,TRX_N-00779-44001181,2023-11-11T10:39:01,Bilbao,Expense,leisure,-33.51,-39161.08
buyer_1,Luis,28,ES56209552778483068985,TRX_N-00780-42966680,2023-11-13T15:28:00,Bilbao,Expense,leisure,-56.63,-39217.71
buyer_1,Luis,28,ES56209552778483068985,TRX_N-00781-48963561,2023-11-14T08:32:33,Bilbao,Expense,cash,-100.0,-39317.71
buyer_1,Luis,28,ES56209552778483068985,TRX_N-00782-37831211,2023-11-15T17:01:59,Bilbao,Expense,cash,-100.0,-39417.71
buyer_1,Luis,28,ES56209552778483068985,TRX_N-00783-71302474,2023-11-18T16:44:47,Bilbao,Expense,leisure,-68.83,-39486.54
buyer_1,Luis,28,ES56209552778483068985,TRX_N-00784-51954901,2023-11-19T11:09:50,Galdakao,Expense,leisure,-84.11,-39570.65
buyer_1,Luis,28,ES56209552778483068985,TRX_N-00785-68596232,2023-11-20T11:00:26,Bilbao,Expense,food,-116.8,-39687.45
buyer_1,Luis,28,ES56209552778483068985,TRX_N-00786-11881691,2023-11-21T18:23:12,Bilbao,Expense,education,-69.2,-39756.65
buyer_1,Luis,28,ES56209552778483068985,TRX_N-00787-46026162,2023-11-21T06:31:47,Bilbao,Expense,cash,-100.0,-39856.65
buyer_1,Luis,28,ES56209552778483068985,TRX_N-00788-64868167,2023-11-22T21:37:33,Bilbao,Expense,food,-115.68,-39972.33
buyer_1,Luis,28,ES56209552778483068985,TRX_N-00789-14192612,2023-11-24T09:27:37,Eibar,Expense,food,-65.62,-40037.95
buyer_1,Luis,28,ES56209552778483068985,TRX_N-00790-85284883,2023-11-24T21:31:03,Bilbao,Expense,leisure,-49.82,-40087.77
buyer_1,Luis,28,ES56209552778483068985,TRX_N-00791-48372563,2023-11-24T11:10:46,Bilbao,Expense,gifts,-569.19,-40656.96
buyer_1,Luis,28,ES56209552778483068985,TRX_N-00792-21874507,2023-11-26T03:49:37,Bilbao,Expense,food,-123.71,-40780.67
buyer_1,Luis,28,ES56209552778483068985,TRX_N-00793-86063083,2023-11-26T19:07:02,Bilbao,Expense,gifts,-291.77,-41072.44
buyer_1,Luis,28,ES56209552778483068985,TRX_N-00794-22040098,2023-11-27T14:36:43,Bilbao,Expense,food,-61.29,-41133.73
buyer_1,Luis,28,ES56209552778483068985,TRX_N-00795-45829988,2023-11-27T14:56:55,Hernani,Expense,cash,-100.0,-41233.73
buyer_1,Luis,28,ES56209552778483068985,TRX_N-00796-14679187,2023-11-29T14:41:04,Sestao,Expense,leisure,-30.36,-41264.09
buyer_1,Luis,28,ES56209552778483068985,TRX_N-00797-49729727,2023-11-29T12:39:06,Bilbao,expenses,children,-64.15,-41328.24
buyer_1,Luis,28,ES56209552778483068985,TRX_N-00798-08219838,2023-12-01T16:36:25,Bilbao,incomes,salary,1443.95,-39884.29
buyer_1,Luis,28,ES56209552778483068985,TRX_N-00799-59567587,2023-12-01T16:36:25,Bilbao,incomes,salary_partner,1358.1,-38526.19
buyer_1,Luis,28,ES56209552778483068985,TRX_N-00800-97558537,2023-12-01T16:36:25,Bilbao,incomes,salary_bonus,1032.13,-37494.06
buyer_1,Luis,28,ES56209552778483068985,TRX_N-00801-21599167,2023-12-01T16:36:25,Bilbao,incomes,salary_partner_bonus,1053.22,-36440.84
buyer_1,Luis,28,ES56209552778483068985,TRX_N-00802-46132821,2023-12-01T06:39:00,Bilbao,Expense,transport,-86.45,-36527.29
buyer_1,Luis,28,ES56209552778483068985,TRX_N-00803-05097062,2023-12-02T15:52:31,Bilbao,Expense,food,-119.38,-36646.67
buyer_1,Luis,28,ES56209552778483068985,TRX_N-00804-16715034,2023-12-02T08:48:13,Bilbao,Expense,cash,-100.0,-36746.67
buyer_1,Luis,28,ES56209552778483068985,TRX_N-00805-92371073,2023-12-04T08:44:47,Bilbao,expenses,mortgage,-731.08,-37477.75
buyer_1,Luis,28,ES56209552778483068985,TRX_N-00806-01859989,2023-12-05T20:48:39,Getxo,Expense,education,-70.95,-37548.7
buyer_1,Luis,28,ES56209552778483068985,TRX_N-00807-19045614,2023-12-06T00:46:56,Bilbao,expenses,electricity,-65.93,-37614.63
buyer_1,Luis,28,ES56209552778483068985,TRX_N-00808-99809652,2023-12-06T18:11:00,Bilbao,expenses,gas,-86.39,-37701.02
buyer_1,Luis,28,ES56209552778483068985,TRX_N-00809-54159320,2023-12-06T17:05:49,Bilbao,expenses,phone,-33.97,-37734.99
buyer_1,Luis,28,ES56209552778483068985,TRX_N-00810-67315459,2023-12-08T08:00:37,Bilbao,expenses,internet,-42.0,-37776.99
buyer_1,Luis,28,ES56209552778483068985,TRX_N-00811-09759192,2023-12-08T12:19:44,Bilbao,expenses,water,-40.88,-37817.87
buyer_1,Luis,28,ES56209552778483068985,TRX_N-00812-25132595,2023-12-10T14:30:05,Bilbao,Expense,transport,-52.48,-37870.35
buyer_1,Luis,28,ES56209552778483068985,TRX_N-00813-16633730,2023-12-10T14:54:18,Bilbao,Expense,leisure,-30.01,-37900.36
buyer_1,Luis,28,ES56209552778483068985,TRX_N-00814-43380542,2023-12-11T19:52:25,Bilbao,Expense,gifts,-25.26,-37925.62
buyer_1,Luis,28,ES56209552778483068985,TRX_N-00815-97878966,2023-12-13T09:49:56,Bilbao,Expense,travel,-1503.17,-39428.79
buyer_1,Luis,28,ES56209552778483068985,TRX_N-00816-64119946,2023-12-14T15:50:46,Bilbao,Expense,leisure,-28.5,-39457.29
buyer_1,Luis,28,ES56209552778483068985,TRX_N-00817-50139158,2023-12-14T23:19:12,Bilbao,Expense,repairs,-180.11,-39637.4
buyer_1,Luis,28,ES56209552778483068985,TRX_N-00818-50977610,2023-12-15T13:16:57,Bilbao,Expense,food,-76.32,-39713.72
buyer_1,Luis,28,ES56209552778483068985,TRX_N-00819-23674984,2023-12-15T23:20:44,Bilbao,Expense,transport,-55.27,-39768.99
buyer_1,Luis,28,ES56209552778483068985,TRX_N-00820-84781389,2023-12-15T15:35:20,Eibar,Expense,leisure,-73.88,-39842.87
buyer_1,Luis,28,ES56209552778483068985,TRX_N-00821-18732104,2023-12-15T18:25:22,Bilbao,Expense,appliances,-133.43,-39976.3
buyer_1,Luis,28,ES56209552778483068985,TRX_N-00822-15291180,2023-12-16T10:13:53,Bilbao,Expense,cash,-100.0,-40076.3
buyer_1,Luis,28,ES56209552778483068985,TRX_N-00823-70475123,2023-12-16T14:46:52,Bilbao,Expense,gifts,-153.31,-40229.61
buyer_1,Luis,28,ES56209552778483068985,TRX_N-00824-11164377,2023-12-18T13:03:40,Bilbao,Expense,food,-100.36,-40329.97
buyer_1,Luis,28,ES56209552778483068985,TRX_N-00825-30324439,2023-12-18T20:18:22,Bilbao,Expense,transport,-56.49,-40386.46
buyer_1,Luis,28,ES56209552778483068985,TRX_N-00826-82643001,2023-12-19T16:03:11,Bilbao,Expense,food,-83.92,-40470.38
buyer_1,Luis,28,ES56209552778483068985,TRX_N-00827-84797066,2023-12-19T20:08:03,Bilbao,expenses,children,-201.63,-40672.01
buyer_1,Luis,28,ES56209552778483068985,TRX_N-00828-58633379,2023-12-20T14:44:06,Bilbao,Expense,cash,-100.0,-40772.01
buyer_1,Luis,28,ES56209552778483068985,TRX_N-00829-35205682,2023-12-24T11:59:08,Bilbao,Expense,food,-122.37,-40894.38
buyer_1,Luis,28,ES56209552778483068985,TRX_N-00830-71828407,2023-12-24T17:35:44,Bilbao,Expense,clothing,-129.53,-41023.91
buyer_1,Luis,28,ES56209552778483068985,TRX_N-00831-85959599,2023-12-24T14:47:59,Eibar,Expense,gifts,-693.81,-41717.72
buyer_1,Luis,28,ES56209552778483068985,TRX_N-00832-27779920,2023-12-25T17:46:54,Bilbao,Expense,repairs,-195.49,-41913.21
buyer_1,Luis,28,ES56209552778483068985,TRX_N-00833-93738385,2023-12-26T20:55:57,Bilbao,Expense,transport,-74.46,-41987.67
buyer_1,Luis,28,ES56209552778483068985,TRX_N-00834-69044041,2023-12-30T18:59:46,Bilbao,Expense,clothing,-73.24,-42060.91
buyer_1,Luis,28,ES56209552778483068985,TRX_N-00835-36033064,2023-12-30T12:37:59,Bilbao,Expense,cash,-100.0,-42160.91
buyer_1,Luis,28,ES56209552778483068985,TRX_N-00836-58151920,2023-12-30T10:34:49,Bilbao,Expense,repairs,-236.12,-42397.03
buyer_1,Luis,28,ES56209552778483068985,TRX_N-00837-92600214,2023-12-31T14:47:58,Bilbao,Expense,repairs,-142.1,-42539.13
buyer_1,Luis,28,ES56209552778483068985,TRX_N-00838-71398357,2024-01-01T04:49:35,Bilbao,incomes,salary,1493.04,-41046.09
buyer_1,Luis,28,ES56209552778483068985,TRX_N-00839-47063524,2024-01-01T04:49:35,Bilbao,incomes,salary_partner,1404.27,-39641.82
buyer_1,Luis,28,ES56209552778483068985,TRX_N-00840-54200575,2024-01-01T10:17:43,Bilbao,Expense,transport,-63.29,-39705.11
buyer_1,Luis,28,ES56209552778483068985,TRX_N-00841-27360649,2024-01-04T08:08:58,Bilbao,expenses,mortgage,-731.08,-40436.19
buyer_1,Luis,28,ES56209552778483068985,TRX_N-00842-56725327,2024-01-05T15:56:26,Bilbao,expenses,water,-41.73,-40477.92
buyer_1,Luis,28,ES56209552778483068985,TRX_N-00843-86598728,2024-01-05T12:17:31,Bilbao,Expense,gifts,-197.4,-40675.32
buyer_1,Luis,28,ES56209552778483068985,TRX_N-00844-04216557,2024-01-07T06:49:14,Bilbao,expenses,electricity,-77.65,-40752.97
buyer_1,Luis,28,ES56209552778483068985,TRX_N-00845-41317357,2024-01-08T03:14:09,Bilbao,expenses,gas,-61.93,-40814.9
buyer_1,Luis,28,ES56209552778483068985,TRX_N-00846-99760482,2024-01-08T21:15:42,Bilbao,expenses,internet,-42.0,-40856.9
buyer_1,Luis,28,ES56209552778483068985,TRX_N-00847-29816169,2024-01-08T18:46:09,Bilbao,expenses,phone,-30.85,-40887.75
buyer_1,Luis,28,ES56209552778483068985,TRX_N-00848-44741233,2024-01-08T21:15:32,Bilbao,Expense,transport,-54.87,-40942.62
buyer_1,Luis,28,ES56209552778483068985,TRX_N-00849-26196861,2024-01-09T08:51:39,Santurtzi,Expense,food,-71.52,-41014.14
buyer_1,Luis,28,ES56209552778483068985,TRX_N-00850-52261312,2024-01-10T20:13:01,Pasaia,Expense,leisure,-51.35,-41065.49
buyer_1,Luis,28,ES56209552778483068985,TRX_N-00851-27310349,2024-01-10T12:42:19,Getxo,Expense,appliances,-246.45,-41311.94
buyer_1,Luis,28,ES56209552778483068985,TRX_N-00852-57334280,2024-01-11T12:59:29,Bilbao,Expense,food,-114.89,-41426.83
buyer_1,Luis,28,ES56209552778483068985,TRX_N-00853-06720112,2024-01-11T20:02:24,Santurtzi,Expense,clothing,-113.9,-41540.73
buyer_1,Luis,28,ES56209552778483068985,TRX_N-00854-58726701,2024-01-11T17:19:20,Bilbao,Expense,appliances,-282.85,-41823.58
buyer_1,Luis,28,ES56209552778483068985,TRX_N-00855-49296874,2024-01-13T08:55:19,Bilbao,Expense,transport,-74.23,-41897.81
buyer_1,Luis,28,ES56209552778483068985,TRX_N-00856-26903959,2024-01-14T13:03:06,Bilbao,Expense,transport,-61.99,-41959.8
buyer_1,Luis,28,ES56209552778483068985,TRX_N-00857-12466691,2024-01-20T08:26:57,Durango,Expense,clothing,-101.37,-42061.17
buyer_1,Luis,28,ES56209552778483068985,TRX_N-00858-98162783,2024-01-21T08:35:20,Bilbao,Expense,healthcare,-107.26,-42168.43
buyer_1,Luis,28,ES56209552778483068985,TRX_N-00859-23323860,2024-01-23T11:22:39,Bilbao,Expense,leisure,-44.74,-42213.17
buyer_1,Luis,28,ES56209552778483068985,TRX_N-00860-28077804,2024-01-24T11:18:34,Getxo,Expense,transport,-88.76,-42301.93
buyer_1,Luis,28,ES56209552778483068985,TRX_N-00861-18032108,2024-01-28T15:17:51,Bilbao,Expense,transport,-49.56,-42351.49
buyer_1,Luis,28,ES56209552778483068985,TRX_N-00862-62906641,2024-01-29T15:40:14,Bilbao,Expense,cash,-100.0,-42451.49
buyer_1,Luis,28,ES56209552778483068985,TRX_N-00863-75345076,2024-01-30T10:32:27,Bilbao,Expense,transport,-46.59,-42498.08
buyer_1,Luis,28,ES56209552778483068985,TRX_N-00864-60484010,2024-01-30T13:47:52,Bilbao,Expense,leisure,-54.32,-42552.4
buyer_1,Luis,28,ES56209552778483068985,TRX_N-00865-92632927,2024-02-01T15:36:20,Bilbao,incomes,salary,1493.04,-41059.36
buyer_1,Luis,28,ES56209552778483068985,TRX_N-00866-59471845,2024-02-01T15:36:20,Bilbao,incomes,salary_partner,1404.27,-39655.09
buyer_1,Luis,28,ES56209552778483068985,TRX_N-00867-40450271,2024-02-01T12:19:54,Bilbao,Expense,food,-101.89,-39756.98
buyer_1,Luis,28,ES56209552778483068985,TRX_N-00868-62900355,2024-02-02T15:43:02,Bilbao,expenses,children,-145.18,-39902.16
buyer_1,Luis,28,ES56209552778483068985,TRX_N-00869-90592573,2024-02-04T20:55:32,Bilbao,expenses,mortgage,-731.08,-40633.24
buyer_1,Luis,28,ES56209552778483068985,TRX_N-00870-47422369,2024-02-04T21:37:10,Bilbao,Expense,cash,-100.0,-40733.24
buyer_1,Luis,28,ES56209552778483068985,TRX_N-00871-78237082,2024-02-05T09:09:17,Bilbao,expenses,electricity,-29.11,-40762.35
buyer_1,Luis,28,ES56209552778483068985,TRX_N-00872-25897741,2024-02-05T14:25:45,Elciego,Expense,healthcare,-132.18,-40894.53
buyer_1,Luis,28,ES56209552778483068985,TRX_N-00873-43606110,2024-02-06T08:26:08,Bilbao,expenses,phone,-34.04,-40928.57
buyer_1,Luis,28,ES56209552778483068985,TRX_N-00874-93539859,2024-02-07T06:17:03,Bilbao,expenses,water,-28.93,-40957.5
buyer_1,Luis,28,ES56209552778483068985,TRX_N-00875-80245775,2024-02-07T14:46:53,Bilbao,Expense,transport,-60.44,-41017.94
buyer_1,Luis,28,ES56209552778483068985,TRX_N-00876-62379821,2024-02-07T15:12:04,Bilbao,Expense,education,-51.74,-41069.68
buyer_1,Luis,28,ES56209552778483068985,TRX_N-00877-25796582,2024-02-07T16:31:29,Bilbao,expenses,children,-243.77,-41313.45
buyer_1,Luis,28,ES56209552778483068985,TRX_N-00878-61182840,2024-02-08T23:57:36,Bilbao,expenses,gas,-88.98,-41402.43
buyer_1,Luis,28,ES56209552778483068985,TRX_N-00879-07124109,2024-02-08T19:59:56,Bilbao,expenses,internet,-42.0,-41444.43
buyer_1,Luis,28,ES56209552778483068985,TRX_N-00880-56191179,2024-02-08T09:53:02,Getxo,Expense,repairs,-159.12,-41603.55
buyer_1,Luis,28,ES56209552778483068985,TRX_N-00881-54253885,2024-02-13T16:18:00,Bilbao,Expense,cash,-100.0,-41703.55
buyer_1,Luis,28,ES56209552778483068985,TRX_N-00882-81714648,2024-02-15T14:15:22,Sopela,Expense,transport,-41.11,-41744.66
buyer_1,Luis,28,ES56209552778483068985,TRX_N-00883-98990565,2024-02-16T09:19:58,Bilbao,Expense,gifts,-350.3,-42094.96
buyer_1,Luis,28,ES56209552778483068985,TRX_N-00884-97887021,2024-02-17T12:21:43,Bilbao,Expense,gifts,-741.71,-42836.67
buyer_1,Luis,28,ES56209552778483068985,TRX_N-00885-28159255,2024-02-17T12:37:18,Bilbao,expenses,children,-56.09,-42892.76
buyer_1,Luis,28,ES56209552778483068985,TRX_N-00886-70538784,2024-02-19T13:01:57,Bilbao,Expense,transport,-62.31,-42955.07
buyer_1,Luis,28,ES56209552778483068985,TRX_N-00887-17994939,2024-02-19T17:44:55,Bilbao,Expense,gifts,-628.02,-43583.09
buyer_1,Luis,28,ES56209552778483068985,TRX_N-00888-87357369,2024-02-21T18:43:29,Galdakao,Expense,education,-54.42,-43637.51
buyer_1,Luis,28,ES56209552778483068985,TRX_N-00889-52884082,2024-02-22T18:41:14,Bilbao,Expense,leisure,-21.36,-43658.87
buyer_1,Luis,28,ES56209552778483068985,TRX_N-00890-08809600,2024-02-24T09:10:38,Bilbao,Expense,healthcare,-40.5,-43699.37
buyer_1,Luis,28,ES56209552778483068985,TRX_N-00891-53919349,2024-02-24T09:31:10,Bilbao,Expense,cash,-100.0,-43799.37
buyer_1,Luis,28,ES56209552778483068985,TRX_N-00892-47600091,2024-02-25T11:12:21,Bilbao,Expense,repairs,-241.9,-44041.27
buyer_1,Luis,28,ES56209552778483068985,TRX_N-00893-34033309,2024-02-26T14:50:13,Lasarte-Oria,Expense,clothing,-157.98,-44199.25
buyer_1,Luis,28,ES56209552778483068985,TRX_N-00894-67919259,2024-02-27T16:25:46,Bilbao,Expense,travel,-361.6,-44560.85
buyer_1,Luis,28,ES56209552778483068985,TRX_N-00895-11499435,2024-02-28T16:14:50,Bilbao,Expense,healthcare,-47.79,-44608.64
buyer_1,Luis,28,ES56209552778483068985,TRX_N-00896-50039855,2024-03-01T09:24:43,Bilbao,incomes,salary,1493.04,-43115.6
buyer_1,Luis,28,ES56209552778483068985,TRX_N-00897-18406675,2024-03-01T09:24:43,Bilbao,incomes,salary_partner,1404.27,-41711.33
buyer_1,Luis,28,ES56209552778483068985,TRX_N-00898-07973075,2024-03-01T09:24:43,Bilbao,incomes,extra_income,186.09,-41525.24
buyer_1,Luis,28,ES56209552778483068985,TRX_N-00899-32201942,2024-03-02T20:04:53,Bilbao,Expense,gifts,-769.96,-42295.2
buyer_1,Luis,28,ES56209552778483068985,TRX_N-00900-45258391,2024-03-04T15:20:02,Bilbao,expenses,mortgage,-731.08,-43026.28
buyer_1,Luis,28,ES56209552778483068985,TRX_N-00901-08055177,2024-03-05T22:37:06,Bilbao,expenses,gas,-101.92,-43128.2
buyer_1,Luis,28,ES56209552778483068985,TRX_N-00902-18307319,2024-03-05T23:32:15,Bilbao,expenses,phone,-40.52,-43168.72
buyer_1,Luis,28,ES56209552778483068985,TRX_N-00903-88439633,2024-03-05T16:06:04,Bilbao,Expense,transport,-63.6,-43232.32
buyer_1,Luis,28,ES56209552778483068985,TRX_N-00904-82352770,2024-03-05T21:23:35,Bilbao,expenses,children,-156.42,-43388.74
buyer_1,Luis,28,ES56209552778483068985,TRX_N-00905-36195424,2024-03-06T07:58:19,Bilbao,expenses,electricity,-44.84,-43433.58
buyer_1,Luis,28,ES56209552778483068985,TRX_N-00906-81724873,2024-03-07T17:32:13,Bilbao,expenses,internet,-42.0,-43475.58
buyer_1,Luis,28,ES56209552778483068985,TRX_N-00907-27115727,2024-03-07T11:12:53,Bilbao,Expense,healthcare,-74.05,-43549.63
buyer_1,Luis,28,ES56209552778483068985,TRX_N-00908-81557062,2024-03-08T12:08:13,Bilbao,expenses,water,-34.84,-43584.47
buyer_1,Luis,28,ES56209552778483068985,TRX_N-00909-61292230,2024-03-08T17:24:17,Bilbao,Expense,leisure,-53.92,-43638.39
buyer_1,Luis,28,ES56209552778483068985,TRX_N-00910-41701492,2024-03-08T22:57:08,Bilbao,Expense,cash,-100.0,-43738.39
buyer_1,Luis,28,ES56209552778483068985,TRX_N-00911-93522971,2024-03-10T18:33:47,Bilbao,Expense,cash,-100.0,-43838.39
buyer_1,Luis,28,ES56209552778483068985,TRX_N-00912-66170611,2024-03-11T11:58:54,Labastida,Expense,cash,-100.0,-43938.39
buyer_1,Luis,28,ES56209552778483068985,TRX_N-00913-61139802,2024-03-17T01:25:37,Zarautz,Expense,cash,-100.0,-44038.39
buyer_1,Luis,28,ES56209552778483068985,TRX_N-00914-84074630,2024-03-20T23:16:25,Bilbao,Expense,repairs,-276.66,-44315.05
buyer_1,Luis,28,ES56209552778483068985,TRX_N-00915-90551615,2024-03-21T22:03:21,Bilbao,Expense,leisure,-72.11,-44387.16
buyer_1,Luis,28,ES56209552778483068985,TRX_N-00916-94469873,2024-03-22T08:06:56,Bilbao,Expense,travel,-1215.18,-45602.34
buyer_1,Luis,28,ES56209552778483068985,TRX_N-00917-18992216,2024-03-23T21:11:15,Zarautz,Expense,leisure,-23.61,-45625.95
buyer_1,Luis,28,ES56209552778483068985,TRX_N-00918-01908674,2024-03-23T21:10:49,Bilbao,Expense,cash,-100.0,-45725.95
buyer_1,Luis,28,ES56209552778483068985,TRX_N-00919-45550363,2024-03-24T07:02:21,Bilbao,Expense,leisure,-61.91,-45787.86
buyer_1,Luis,28,ES56209552778483068985,TRX_N-00920-13999223,2024-03-25T10:33:54,Bilbao,Expense,gifts,-609.89,-46397.75
buyer_1,Luis,28,ES56209552778483068985,TRX_N-00921-67943447,2024-03-27T18:14:30,Bilbao,Expense,leisure,-75.5,-46473.25
buyer_1,Luis,28,ES56209552778483068985,TRX_N-00922-58852415,2024-03-27T16:41:19,Zarautz,Expense,repairs,-93.35,-46566.6
buyer_1,Luis,28,ES56209552778483068985,TRX_N-00923-73611224,2024-03-28T09:46:29,Bilbao,Expense,clothing,-57.32,-46623.92
buyer_1,Luis,28,ES56209552778483068985,TRX_N-00924-79374630,2024-03-28T08:12:23,Bilbao,Expense,cash,-100.0,-46723.92
buyer_1,Luis,28,ES56209552778483068985,TRX_N-00925-05631176,2024-03-28T15:05:27,Bilbao,expenses,children,-151.3,-46875.22
buyer_1,Luis,28,ES56209552778483068985,TRX_N-00926-63619681,2024-03-29T23:48:58,Iru√±a de Oca,Expense,cash,-100.0,-46975.22
buyer_1,Luis,28,ES56209552778483068985,TRX_N-00927-26963348,2024-03-30T18:44:02,Bilbao,Expense,food,-82.85,-47058.07
buyer_1,Luis,28,ES56209552778483068985,TRX_N-00928-36187712,2024-03-30T17:50:24,Galdakao,Expense,clothing,-52.41,-47110.48
buyer_1,Luis,28,ES56209552778483068985,TRX_N-00929-65165967,2024-03-31T14:22:12,Bilbao,Expense,food,-99.94,-47210.42
buyer_1,Luis,28,ES56209552778483068985,TRX_N-00930-07036936,2024-04-01T18:22:34,Bilbao,incomes,salary,1493.04,-45717.38
buyer_1,Luis,28,ES56209552778483068985,TRX_N-00931-88617147,2024-04-01T18:22:34,Bilbao,incomes,salary_partner,1404.27,-44313.11
buyer_1,Luis,28,ES56209552778483068985,TRX_N-00932-06887374,2024-04-01T10:53:46,Bilbao,Expense,cash,-100.0,-44413.11
buyer_1,Luis,28,ES56209552778483068985,TRX_N-00933-98161415,2024-04-03T20:27:37,Bilbao,expenses,children,-79.95,-44493.06
buyer_1,Luis,28,ES56209552778483068985,TRX_N-00934-81124489,2024-04-04T22:00:03,Bilbao,expenses,mortgage,-731.08,-45224.14
buyer_1,Luis,28,ES56209552778483068985,TRX_N-00935-60583465,2024-04-05T11:36:49,Bilbao,Expense,leisure,-82.1,-45306.24
buyer_1,Luis,28,ES56209552778483068985,TRX_N-00936-67057733,2024-04-05T19:50:18,Elciego,Expense,cash,-100.0,-45406.24
buyer_1,Luis,28,ES56209552778483068985,TRX_N-00937-88800430,2024-04-06T22:24:33,Bilbao,expenses,electricity,-59.09,-45465.33
buyer_1,Luis,28,ES56209552778483068985,TRX_N-00938-12046365,2024-04-06T12:46:59,Bilbao,Expense,clothing,-60.55,-45525.88
buyer_1,Luis,28,ES56209552778483068985,TRX_N-00939-72803220,2024-04-06T23:53:39,Bilbao,Expense,cash,-100.0,-45625.88
buyer_1,Luis,28,ES56209552778483068985,TRX_N-00940-11658791,2024-04-06T17:35:27,Bilbao,Expense,gifts,-508.93,-46134.81
buyer_1,Luis,28,ES56209552778483068985,TRX_N-00941-14586675,2024-04-07T16:56:09,Bilbao,expenses,water,-25.54,-46160.35
buyer_1,Luis,28,ES56209552778483068985,TRX_N-00942-41996360,2024-04-07T08:34:57,Bilbao,expenses,internet,-42.0,-46202.35
buyer_1,Luis,28,ES56209552778483068985,TRX_N-00943-23438892,2024-04-08T10:59:51,Bilbao,expenses,gas,-37.16,-46239.51
buyer_1,Luis,28,ES56209552778483068985,TRX_N-00944-11851189,2024-04-08T17:21:33,Bilbao,expenses,phone,-40.01,-46279.52
buyer_1,Luis,28,ES56209552778483068985,TRX_N-00945-31570882,2024-04-08T17:44:01,Salvatierra/Agurain,Expense,repairs,-56.27,-46335.79
buyer_1,Luis,28,ES56209552778483068985,TRX_N-00946-57486071,2024-04-12T07:41:31,Bilbao,Expense,food,-74.57,-46410.36
buyer_1,Luis,28,ES56209552778483068985,TRX_N-00947-19009822,2024-04-12T12:22:43,Bilbao,Expense,gifts,-384.71,-46795.07
buyer_1,Luis,28,ES56209552778483068985,TRX_N-00948-78982169,2024-04-13T21:31:09,Bilbao,Expense,travel,-549.0,-47344.07
buyer_1,Luis,28,ES56209552778483068985,TRX_N-00949-89399796,2024-04-14T18:39:42,Bilbao,Expense,food,-103.13,-47447.2
buyer_1,Luis,28,ES56209552778483068985,TRX_N-00950-15643952,2024-04-15T15:54:18,Bilbao,expenses,children,-94.44,-47541.64
buyer_1,Luis,28,ES56209552778483068985,TRX_N-00951-84323589,2024-04-22T03:41:39,Bilbao,Expense,food,-85.64,-47627.28
buyer_1,Luis,28,ES56209552778483068985,TRX_N-00952-95139682,2024-04-24T19:41:54,Bilbao,Expense,leisure,-26.21,-47653.49
buyer_1,Luis,28,ES56209552778483068985,TRX_N-00953-05138954,2024-04-24T08:21:07,Bilbao,expenses,children,-243.53,-47897.02
buyer_1,Luis,28,ES56209552778483068985,TRX_N-00954-53456575,2024-04-27T12:26:18,Bilbao,Expense,transport,-65.88,-47962.9
buyer_1,Luis,28,ES56209552778483068985,TRX_N-00955-75878019,2024-04-27T20:24:09,Bilbao,Expense,cash,-100.0,-48062.9
buyer_1,Luis,28,ES56209552778483068985,TRX_N-00956-67106142,2024-04-27T05:46:39,Bilbao,Expense,appliances,-201.15,-48264.05
buyer_1,Luis,28,ES56209552778483068985,TRX_N-00957-41614481,2024-04-28T20:19:06,Arrasate,Expense,leisure,-28.98,-48293.03
buyer_1,Luis,28,ES56209552778483068985,TRX_N-00958-53596353,2024-04-28T20:26:06,Donostia,Expense,gifts,-115.43,-48408.46
buyer_1,Luis,28,ES56209552778483068985,TRX_N-00959-52917261,2024-04-29T09:19:46,Llodio,Expense,leisure,-21.33,-48429.79
buyer_1,Luis,28,ES56209552778483068985,TRX_N-00960-17024513,2024-04-29T12:58:00,Bilbao,Expense,healthcare,-116.33,-48546.12
buyer_1,Luis,28,ES56209552778483068985,TRX_N-00961-03740883,2024-04-29T04:59:35,Bilbao,Expense,repairs,-274.69,-48820.81
buyer_1,Luis,28,ES56209552778483068985,TRX_N-00962-60721046,2024-04-30T19:47:26,Barakaldo,Expense,food,-124.73,-48945.54
buyer_1,Luis,28,ES56209552778483068985,TRX_N-00963-23476357,2024-04-30T17:06:41,Bilbao,Expense,leisure,-81.42,-49026.96
buyer_1,Luis,28,ES56209552778483068985,TRX_N-00964-48813738,2024-05-01T12:19:18,Bilbao,incomes,salary,1493.04,-47533.92
buyer_1,Luis,28,ES56209552778483068985,TRX_N-00965-33990923,2024-05-01T12:19:18,Bilbao,incomes,salary_partner,1404.27,-46129.65
buyer_1,Luis,28,ES56209552778483068985,TRX_N-00966-97444477,2024-05-02T13:02:05,Bilbao,Expense,cash,-100.0,-46229.65
buyer_1,Luis,28,ES56209552778483068985,TRX_N-00967-76866578,2024-05-03T15:20:11,Bilbao,Expense,clothing,-45.18,-46274.83
buyer_1,Luis,28,ES56209552778483068985,TRX_N-00968-75621981,2024-05-04T10:15:54,Bilbao,expenses,mortgage,-731.08,-47005.91
buyer_1,Luis,28,ES56209552778483068985,TRX_N-00969-71456889,2024-05-05T14:03:36,Bilbao,expenses,electricity,-76.32,-47082.23
buyer_1,Luis,28,ES56209552778483068985,TRX_N-00970-27651489,2024-05-05T16:12:13,Bilbao,Expense,leisure,-44.9,-47127.13
buyer_1,Luis,28,ES56209552778483068985,TRX_N-00971-52093764,2024-05-05T04:24:42,Bilbao,Expense,clothing,-51.66,-47178.79
buyer_1,Luis,28,ES56209552778483068985,TRX_N-00972-49904506,2024-05-05T13:20:13,Bilbao,Expense,cash,-100.0,-47278.79
buyer_1,Luis,28,ES56209552778483068985,TRX_N-00973-11892988,2024-05-05T15:12:14,Bilbao,Expense,gifts,-349.02,-47627.81
buyer_1,Luis,28,ES56209552778483068985,TRX_N-00974-78394037,2024-05-06T09:16:02,Bilbao,expenses,gas,-79.23,-47707.04
buyer_1,Luis,28,ES56209552778483068985,TRX_N-00975-13081061,2024-05-06T21:28:36,Sestao,Expense,healthcare,-105.44,-47812.48
buyer_1,Luis,28,ES56209552778483068985,TRX_N-00976-25197182,2024-05-06T16:27:40,Bilbao,Expense,cash,-100.0,-47912.48
buyer_1,Luis,28,ES56209552778483068985,TRX_N-00977-22140830,2024-05-08T20:46:38,Bilbao,expenses,water,-35.9,-47948.38
buyer_1,Luis,28,ES56209552778483068985,TRX_N-00978-40930940,2024-05-08T18:16:28,Bilbao,expenses,internet,-42.0,-47990.38
buyer_1,Luis,28,ES56209552778483068985,TRX_N-00979-73526022,2024-05-08T16:19:43,Bilbao,expenses,phone,-41.05,-48031.43
buyer_1,Luis,28,ES56209552778483068985,TRX_N-00980-28914075,2024-05-09T17:45:52,Bilbao,Expense,transport,-46.34,-48077.77
buyer_1,Luis,28,ES56209552778483068985,TRX_N-00981-35231741,2024-05-10T21:24:56,Labastida,Expense,gifts,-358.12,-48435.89
buyer_1,Luis,28,ES56209552778483068985,TRX_N-00982-53326372,2024-05-11T13:25:18,Bilbao,Expense,food,-80.27,-48516.16
buyer_1,Luis,28,ES56209552778483068985,TRX_N-00983-75115941,2024-05-11T10:57:00,Bilbao,Expense,cash,-100.0,-48616.16
buyer_1,Luis,28,ES56209552778483068985,TRX_N-00984-88091783,2024-05-12T13:13:31,Bilbao,Expense,food,-91.16,-48707.32
buyer_1,Luis,28,ES56209552778483068985,TRX_N-00985-95229054,2024-05-12T13:09:52,Bilbao,Expense,transport,-64.22,-48771.54
buyer_1,Luis,28,ES56209552778483068985,TRX_N-00986-09005030,2024-05-13T16:41:16,Bilbao,Expense,education,-59.23,-48830.77
buyer_1,Luis,28,ES56209552778483068985,TRX_N-00987-73519948,2024-05-13T16:47:01,Bilbao,Expense,travel,-325.56,-49156.33
buyer_1,Luis,28,ES56209552778483068985,TRX_N-00988-65468026,2024-05-14T20:48:10,Bilbao,Expense,leisure,-19.21,-49175.54
buyer_1,Luis,28,ES56209552778483068985,TRX_N-00989-96141318,2024-05-15T07:56:14,Bilbao,Expense,food,-68.85,-49244.39
buyer_1,Luis,28,ES56209552778483068985,TRX_N-00990-59085183,2024-05-15T10:49:02,Sopela,Expense,transport,-65.6,-49309.99
buyer_1,Luis,28,ES56209552778483068985,TRX_N-00991-90223179,2024-05-17T09:47:43,Bilbao,Expense,clothing,-90.85,-49400.84
buyer_1,Luis,28,ES56209552778483068985,TRX_N-00992-14433470,2024-05-18T11:25:43,Bilbao,Expense,transport,-85.38,-49486.22
buyer_1,Luis,28,ES56209552778483068985,TRX_N-00993-79255594,2024-05-19T19:53:05,Bilbao,Expense,food,-89.92,-49576.14
buyer_1,Luis,28,ES56209552778483068985,TRX_N-00994-44877356,2024-05-21T04:48:58,Bilbao,Expense,repairs,-72.07,-49648.21
buyer_1,Luis,28,ES56209552778483068985,TRX_N-00995-45181477,2024-05-23T10:30:50,Bilbao,expenses,children,-248.0,-49896.21
buyer_1,Luis,28,ES56209552778483068985,TRX_N-00996-41215807,2024-05-25T16:00:46,Bilbao,Expense,leisure,-21.04,-49917.25
buyer_1,Luis,28,ES56209552778483068985,TRX_N-00997-38040560,2024-05-25T22:54:34,Bilbao,expenses,children,-65.79,-49983.04
buyer_1,Luis,28,ES56209552778483068985,TRX_N-00998-81879864,2024-05-26T12:11:06,Bilbao,Expense,food,-122.09,-50105.13
buyer_1,Luis,28,ES56209552778483068985,TRX_N-00999-03612980,2024-05-26T23:18:28,Bilbao,Expense,leisure,-18.31,-50123.44
buyer_1,Luis,28,ES56209552778483068985,TRX_N-01000-70390428,2024-05-26T23:36:23,Bilbao,Expense,cash,-100.0,-50223.44
buyer_1,Luis,28,ES56209552778483068985,TRX_N-01001-59739041,2024-05-29T11:23:53,Bilbao,Expense,clothing,-46.14,-50269.58
buyer_1,Luis,28,ES56209552778483068985,TRX_N-01002-25628276,2024-05-30T18:46:59,Bilbao,Expense,food,-83.43,-50353.01
buyer_1,Luis,28,ES56209552778483068985,TRX_N-01003-75653280,2024-05-30T21:17:58,Amurrio,Expense,transport,-64.77,-50417.78
buyer_1,Luis,28,ES56209552778483068985,TRX_N-01004-57888234,2024-06-01T09:42:42,Bilbao,incomes,salary,1493.04,-48924.74
buyer_1,Luis,28,ES56209552778483068985,TRX_N-01005-43154787,2024-06-01T09:42:42,Bilbao,incomes,salary_partner,1404.27,-47520.47
buyer_1,Luis,28,ES56209552778483068985,TRX_N-01006-75644372,2024-06-01T09:42:42,Bilbao,incomes,extra_income,186.09,-47334.38
buyer_1,Luis,28,ES56209552778483068985,TRX_N-01007-68684380,2024-06-01T09:42:42,Bilbao,incomes,salary_bonus,1088.85,-46245.53
buyer_1,Luis,28,ES56209552778483068985,TRX_N-01008-90319854,2024-06-01T09:42:42,Bilbao,incomes,salary_partner_bonus,1016.47,-45229.06
buyer_1,Luis,28,ES56209552778483068985,TRX_N-01009-96961126,2024-06-01T18:49:15,Bilbao,expenses,taxes,-1333.34,-46562.4
buyer_1,Luis,28,ES56209552778483068985,TRX_N-01010-19504464,2024-06-01T17:30:20,Bilbao,expenses,insurance,-425.23,-46987.63
buyer_1,Luis,28,ES56209552778483068985,TRX_N-01011-32093227,2024-06-01T20:30:03,Bilbao,Expense,food,-74.43,-47062.06
buyer_1,Luis,28,ES56209552778483068985,TRX_N-01012-16080850,2024-06-01T18:13:47,Bilbao,Expense,cash,-100.0,-47162.06
buyer_1,Luis,28,ES56209552778483068985,TRX_N-01013-79633951,2024-06-02T23:07:10,Errenteria,Expense,leisure,-40.19,-47202.25
buyer_1,Luis,28,ES56209552778483068985,TRX_N-01014-26124220,2024-06-04T17:25:55,Bilbao,expenses,mortgage,-731.08,-47933.33
buyer_1,Luis,28,ES56209552778483068985,TRX_N-01015-17378317,2024-06-04T09:11:19,Bilbao,Expense,leisure,-53.67,-47987.0
buyer_1,Luis,28,ES56209552778483068985,TRX_N-01016-09098884,2024-06-05T14:20:36,Bilbao,expenses,phone,-31.87,-48018.87
buyer_1,Luis,28,ES56209552778483068985,TRX_N-01017-19972665,2024-06-06T18:07:00,Bilbao,Expense,transport,-75.82,-48094.69
buyer_1,Luis,28,ES56209552778483068985,TRX_N-01018-77530884,2024-06-06T20:48:52,Bilbao,Expense,leisure,-64.69,-48159.38
buyer_1,Luis,28,ES56209552778483068985,TRX_N-01019-69702258,2024-06-08T16:50:56,Bilbao,expenses,water,-34.07,-48193.45
buyer_1,Luis,28,ES56209552778483068985,TRX_N-01020-48725073,2024-06-08T20:16:41,Bilbao,expenses,electricity,-59.79,-48253.24
buyer_1,Luis,28,ES56209552778483068985,TRX_N-01021-87655800,2024-06-08T21:47:34,Bilbao,expenses,gas,-36.66,-48289.9
buyer_1,Luis,28,ES56209552778483068985,TRX_N-01022-61617824,2024-06-08T18:08:36,Bilbao,expenses,internet,-42.0,-48331.9
buyer_1,Luis,28,ES56209552778483068985,TRX_N-01023-42128012,2024-06-08T11:48:25,Bilbao,Expense,transport,-69.41,-48401.31
buyer_1,Luis,28,ES56209552778483068985,TRX_N-01024-48317871,2024-06-09T10:22:55,Bilbao,Expense,cash,-100.0,-48501.31
buyer_1,Luis,28,ES56209552778483068985,TRX_N-01025-46712578,2024-06-10T12:56:11,Bilbao,Expense,cash,-100.0,-48601.31
buyer_1,Luis,28,ES56209552778483068985,TRX_N-01026-40851998,2024-06-11T17:33:52,Bilbao,Expense,appliances,-95.97,-48697.28
buyer_1,Luis,28,ES56209552778483068985,TRX_N-01027-45102527,2024-06-11T19:16:38,Bilbao,Expense,repairs,-134.2,-48831.48
buyer_1,Luis,28,ES56209552778483068985,TRX_N-01028-43278050,2024-06-14T20:47:33,Bilbao,Expense,clothing,-86.25,-48917.73
buyer_1,Luis,28,ES56209552778483068985,TRX_N-01029-60258971,2024-06-14T23:48:57,Bilbao,Expense,repairs,-174.65,-49092.38
buyer_1,Luis,28,ES56209552778483068985,TRX_N-01030-84291962,2024-06-15T11:10:20,Bilbao,Expense,food,-89.44,-49181.82
buyer_1,Luis,28,ES56209552778483068985,TRX_N-01031-89160400,2024-06-15T19:08:22,Bilbao,Expense,healthcare,-132.66,-49314.48
buyer_1,Luis,28,ES56209552778483068985,TRX_N-01032-37835788,2024-06-15T15:53:38,Zuia,Expense,cash,-100.0,-49414.48
buyer_1,Luis,28,ES56209552778483068985,TRX_N-01033-77302720,2024-06-16T12:13:16,Bilbao,Expense,food,-94.04,-49508.52
buyer_1,Luis,28,ES56209552778483068985,TRX_N-01034-32958200,2024-06-17T16:36:41,Mungia,Expense,gifts,-168.51,-49677.03
buyer_1,Luis,28,ES56209552778483068985,TRX_N-01035-40370118,2024-06-19T18:18:14,Bilbao,Expense,food,-123.34,-49800.37
buyer_1,Luis,28,ES56209552778483068985,TRX_N-01036-50634397,2024-06-20T17:08:30,Bilbao,Expense,healthcare,-138.28,-49938.65
buyer_1,Luis,28,ES56209552778483068985,TRX_N-01037-69214360,2024-06-21T15:39:35,Bilbao,Expense,appliances,-117.96,-50056.61
buyer_1,Luis,28,ES56209552778483068985,TRX_N-01038-98816709,2024-06-22T18:53:35,Galdakao,Expense,repairs,-99.74,-50156.35
buyer_1,Luis,28,ES56209552778483068985,TRX_N-01039-98065890,2024-06-22T08:53:43,Bilbao,Expense,gifts,-137.86,-50294.21
buyer_1,Luis,28,ES56209552778483068985,TRX_N-01040-76347047,2024-06-24T21:32:56,Bilbao,Expense,transport,-41.29,-50335.5
buyer_1,Luis,28,ES56209552778483068985,TRX_N-01041-87583451,2024-06-26T08:02:36,Bilbao,Expense,transport,-49.4,-50384.9
buyer_1,Luis,28,ES56209552778483068985,TRX_N-01042-82492004,2024-06-26T10:40:02,Bilbao,Expense,cash,-100.0,-50484.9
buyer_1,Luis,28,ES56209552778483068985,TRX_N-01043-18069963,2024-06-27T19:24:47,Bilbao,Expense,clothing,-148.76,-50633.66
buyer_1,Luis,28,ES56209552778483068985,TRX_N-01044-50867548,2024-06-27T14:45:20,Bilbao,Expense,healthcare,-86.11,-50719.77
buyer_1,Luis,28,ES56209552778483068985,TRX_N-01045-88325311,2024-06-28T14:21:21,Bilbao,Expense,leisure,-24.63,-50744.4
buyer_1,Luis,28,ES56209552778483068985,TRX_N-01046-23804659,2024-06-30T21:52:52,Erandio,Expense,cash,-100.0,-50844.4
buyer_1,Luis,28,ES56209552778483068985,TRX_N-01047-91649987,2024-07-01T01:19:09,Bilbao,incomes,salary,1493.04,-49351.36
buyer_1,Luis,28,ES56209552778483068985,TRX_N-01048-00604134,2024-07-01T01:19:09,Bilbao,incomes,salary_partner,1404.27,-47947.09
buyer_1,Luis,28,ES56209552778483068985,TRX_N-01049-74459190,2024-07-02T17:17:31,Bilbao,Expense,cash,-100.0,-48047.09
buyer_1,Luis,28,ES56209552778483068985,TRX_N-01050-78191324,2024-07-02T13:28:46,Bilbao,Expense,gifts,-762.58,-48809.67
buyer_1,Luis,28,ES56209552778483068985,TRX_N-01051-14956070,2024-07-03T13:30:28,Bilbao,Expense,leisure,-60.87,-48870.54
buyer_1,Luis,28,ES56209552778483068985,TRX_N-01052-98435877,2024-07-04T18:42:02,Bilbao,expenses,mortgage,-731.08,-49601.62
buyer_1,Luis,28,ES56209552778483068985,TRX_N-01053-21324570,2024-07-04T07:21:49,Bilbao,Expense,transport,-75.64,-49677.26
buyer_1,Luis,28,ES56209552778483068985,TRX_N-01054-07839446,2024-07-05T13:46:40,Bilbao,expenses,electricity,-60.97,-49738.23
buyer_1,Luis,28,ES56209552778483068985,TRX_N-01055-79948576,2024-07-05T23:03:14,Bilbao,expenses,internet,-42.0,-49780.23
buyer_1,Luis,28,ES56209552778483068985,TRX_N-01056-65223662,2024-07-05T11:12:39,Bilbao,expenses,phone,-33.55,-49813.78
buyer_1,Luis,28,ES56209552778483068985,TRX_N-01057-28601091,2024-07-05T17:39:29,Bilbao,Expense,transport,-85.7,-49899.48
buyer_1,Luis,28,ES56209552778483068985,TRX_N-01058-41259269,2024-07-05T22:00:32,Bilbao,Expense,cash,-100.0,-49999.48
buyer_1,Luis,28,ES56209552778483068985,TRX_N-01059-15058509,2024-07-06T09:48:57,Bilbao,expenses,water,-32.95,-50032.43
buyer_1,Luis,28,ES56209552778483068985,TRX_N-01060-19537319,2024-07-06T17:42:43,Bilbao,expenses,gas,-110.67,-50143.1
buyer_1,Luis,28,ES56209552778483068985,TRX_N-01061-24814169,2024-07-10T00:38:37,Bilbao,Expense,food,-76.75,-50219.85
buyer_1,Luis,28,ES56209552778483068985,TRX_N-01062-33411684,2024-07-10T12:33:46,Bilbao,Expense,transport,-69.95,-50289.8
buyer_1,Luis,28,ES56209552778483068985,TRX_N-01063-42532880,2024-07-10T20:14:51,Bilbao,Expense,travel,-1397.35,-51687.15
buyer_1,Luis,28,ES56209552778483068985,TRX_N-01064-41271267,2024-07-11T15:56:44,Bilbao,Expense,leisure,-45.41,-51732.56
buyer_1,Luis,28,ES56209552778483068985,TRX_N-01065-58102219,2024-07-15T08:45:31,Bilbao,Expense,cash,-100.0,-51832.56
buyer_1,Luis,28,ES56209552778483068985,TRX_N-01066-97059074,2024-07-15T16:14:14,Bilbao,Expense,repairs,-218.47,-52051.03
buyer_1,Luis,28,ES56209552778483068985,TRX_N-01067-83971296,2024-07-16T18:34:27,Bilbao,Expense,leisure,-81.47,-52132.5
buyer_1,Luis,28,ES56209552778483068985,TRX_N-01068-97259339,2024-07-19T12:34:38,Bilbao,Expense,education,-57.0,-52189.5
buyer_1,Luis,28,ES56209552778483068985,TRX_N-01069-36164161,2024-07-19T09:14:38,Bilbao,expenses,children,-149.29,-52338.79
buyer_1,Luis,28,ES56209552778483068985,TRX_N-01070-51422079,2024-07-20T10:30:25,Bilbao,Expense,cash,-100.0,-52438.79
buyer_1,Luis,28,ES56209552778483068985,TRX_N-01071-34239499,2024-07-23T12:28:26,Bilbao,Expense,cash,-100.0,-52538.79
buyer_1,Luis,28,ES56209552778483068985,TRX_N-01072-06308305,2024-07-25T13:15:26,Bilbao,Expense,food,-101.16,-52639.95
buyer_1,Luis,28,ES56209552778483068985,TRX_N-01073-45317335,2024-07-25T19:37:59,Bilbao,Expense,clothing,-143.37,-52783.32
buyer_1,Luis,28,ES56209552778483068985,TRX_N-01074-22225759,2024-07-26T01:34:48,Bilbao,Expense,food,-85.98,-52869.3
buyer_1,Luis,28,ES56209552778483068985,TRX_N-01075-35530845,2024-07-26T13:43:08,Bilbao,Expense,leisure,-48.04,-52917.34
buyer_1,Luis,28,ES56209552778483068985,TRX_N-01076-52896478,2024-07-26T12:21:57,Bilbao,Expense,gifts,-743.26,-53660.6
buyer_1,Luis,28,ES56209552778483068985,TRX_N-01077-10804283,2024-07-27T00:27:05,Erandio,Expense,food,-80.81,-53741.41
buyer_1,Luis,28,ES56209552778483068985,TRX_N-01078-01382386,2024-07-29T18:13:31,Bilbao,Expense,transport,-73.7,-53815.11
buyer_1,Luis,28,ES56209552778483068985,TRX_N-01079-18627544,2024-07-30T08:17:09,Arrasate,Expense,cash,-100.0,-53915.11
buyer_1,Luis,28,ES56209552778483068985,TRX_N-01080-90408478,2024-07-31T11:31:13,Barakaldo,Expense,cash,-100.0,-54015.11
buyer_1,Luis,28,ES56209552778483068985,TRX_N-01081-35123515,2024-08-01T12:30:32,Bilbao,incomes,salary,1493.04,-52522.07
buyer_1,Luis,28,ES56209552778483068985,TRX_N-01082-15264131,2024-08-01T12:30:32,Bilbao,incomes,salary_partner,1404.27,-51117.8
buyer_1,Luis,28,ES56209552778483068985,TRX_N-01083-65608136,2024-08-01T21:40:48,Errenteria,Expense,leisure,-40.66,-51158.46
buyer_1,Luis,28,ES56209552778483068985,TRX_N-01084-08080691,2024-08-04T08:56:16,Bilbao,expenses,mortgage,-731.08,-51889.54
buyer_1,Luis,28,ES56209552778483068985,TRX_N-01085-94706023,2024-08-04T20:41:13,Bilbao,Expense,food,-77.41,-51966.95
buyer_1,Luis,28,ES56209552778483068985,TRX_N-01086-03899826,2024-08-04T10:21:12,Erandio,Expense,leisure,-73.49,-52040.44
buyer_1,Luis,28,ES56209552778483068985,TRX_N-01087-34292843,2024-08-04T22:41:54,Bilbao,Expense,cash,-100.0,-52140.44
buyer_1,Luis,28,ES56209552778483068985,TRX_N-01088-10105926,2024-08-05T04:39:06,Bilbao,expenses,water,-44.36,-52184.8
buyer_1,Luis,28,ES56209552778483068985,TRX_N-01089-44341576,2024-08-05T18:58:52,Bilbao,expenses,electricity,-64.75,-52249.55
buyer_1,Luis,28,ES56209552778483068985,TRX_N-01090-76890928,2024-08-05T19:18:25,Bilbao,Expense,leisure,-72.21,-52321.76
buyer_1,Luis,28,ES56209552778483068985,TRX_N-01091-05583940,2024-08-06T08:17:23,Bilbao,expenses,phone,-35.72,-52357.48
buyer_1,Luis,28,ES56209552778483068985,TRX_N-01092-36219921,2024-08-06T14:21:10,Bilbao,Expense,healthcare,-123.13,-52480.61
buyer_1,Luis,28,ES56209552778483068985,TRX_N-01093-89394770,2024-08-07T09:40:58,Bilbao,expenses,internet,-42.0,-52522.61
buyer_1,Luis,28,ES56209552778483068985,TRX_N-01094-05762742,2024-08-07T18:10:50,Eibar,Expense,appliances,-328.68,-52851.29
buyer_1,Luis,28,ES56209552778483068985,TRX_N-01095-15837321,2024-08-08T08:20:18,Bilbao,expenses,gas,-53.4,-52904.69
buyer_1,Luis,28,ES56209552778483068985,TRX_N-01096-40920612,2024-08-08T13:55:03,Bilbao,Expense,gifts,-518.57,-53423.26
buyer_1,Luis,28,ES56209552778483068985,TRX_N-01097-89415989,2024-08-09T16:07:01,Bilbao,Expense,clothing,-151.78,-53575.04
buyer_1,Luis,28,ES56209552778483068985,TRX_N-01098-88904700,2024-08-11T20:06:21,Barakaldo,Expense,transport,-48.79,-53623.83
buyer_1,Luis,28,ES56209552778483068985,TRX_N-01099-75555031,2024-08-11T08:36:22,Bilbao,Expense,leisure,-26.44,-53650.27
buyer_1,Luis,28,ES56209552778483068985,TRX_N-01100-00816385,2024-08-12T12:35:11,Bilbao,Expense,food,-100.95,-53751.22
buyer_1,Luis,28,ES56209552778483068985,TRX_N-01101-35409160,2024-08-12T18:00:59,Bilbao,Expense,transport,-70.69,-53821.91
buyer_1,Luis,28,ES56209552778483068985,TRX_N-01102-42800615,2024-08-12T11:24:18,Basauri,Expense,clothing,-56.66,-53878.57
buyer_1,Luis,28,ES56209552778483068985,TRX_N-01103-70601908,2024-08-13T11:34:29,Bilbao,Expense,transport,-78.51,-53957.08
buyer_1,Luis,28,ES56209552778483068985,TRX_N-01104-27900915,2024-08-13T09:02:40,Bilbao,Expense,cash,-100.0,-54057.08
buyer_1,Luis,28,ES56209552778483068985,TRX_N-01105-26939824,2024-08-16T15:59:07,Bilbao,expenses,children,-262.03,-54319.11
buyer_1,Luis,28,ES56209552778483068985,TRX_N-01106-22596611,2024-08-17T11:38:06,Bilbao,expenses,children,-225.67,-54544.78
buyer_1,Luis,28,ES56209552778483068985,TRX_N-01107-78577025,2024-08-18T23:09:23,Bilbao,Expense,cash,-100.0,-54644.78
buyer_1,Luis,28,ES56209552778483068985,TRX_N-01108-68885678,2024-08-20T11:43:45,Bilbao,Expense,gifts,-318.78,-54963.56
buyer_1,Luis,28,ES56209552778483068985,TRX_N-01109-32838460,2024-08-23T20:54:19,Bilbao,Expense,cash,-100.0,-55063.56
buyer_1,Luis,28,ES56209552778483068985,TRX_N-01110-22239959,2024-08-23T20:06:57,Bilbao,Expense,repairs,-210.05,-55273.61
buyer_1,Luis,28,ES56209552778483068985,TRX_N-01111-74881055,2024-08-23T20:41:08,Bilbao,expenses,children,-137.9,-55411.51
buyer_1,Luis,28,ES56209552778483068985,TRX_N-01112-26412337,2024-08-25T17:28:42,Bilbao,expenses,children,-109.15,-55520.66
buyer_1,Luis,28,ES56209552778483068985,TRX_N-01113-55337917,2024-08-27T02:37:28,Bilbao,Expense,cash,-100.0,-55620.66
buyer_1,Luis,28,ES56209552778483068985,TRX_N-01114-71462511,2024-08-28T10:05:23,Bilbao,Expense,gifts,-164.24,-55784.9
buyer_1,Luis,28,ES56209552778483068985,TRX_N-01115-86667630,2024-08-30T20:38:43,Bilbao,Expense,leisure,-30.49,-55815.39
buyer_1,Luis,28,ES56209552778483068985,TRX_N-01116-00842480,2024-09-01T11:08:33,Bilbao,incomes,salary,1493.04,-54322.35
buyer_1,Luis,28,ES56209552778483068985,TRX_N-01117-30111671,2024-09-01T11:08:33,Bilbao,incomes,salary_partner,1404.27,-52918.08
buyer_1,Luis,28,ES56209552778483068985,TRX_N-01118-14636608,2024-09-01T11:08:33,Bilbao,incomes,extra_income,186.09,-52731.99
buyer_1,Luis,28,ES56209552778483068985,TRX_N-01119-23650962,2024-09-01T10:12:49,Bilbao,Expense,food,-119.5,-52851.49
buyer_1,Luis,28,ES56209552778483068985,TRX_N-01120-70409758,2024-09-01T12:08:09,Bilbao,Expense,leisure,-55.38,-52906.87
buyer_1,Luis,28,ES56209552778483068985,TRX_N-01121-53773513,2024-09-03T19:29:43,Bilbao,Expense,cash,-100.0,-53006.87
buyer_1,Luis,28,ES56209552778483068985,TRX_N-01122-30939466,2024-09-04T17:30:59,Bilbao,expenses,mortgage,-731.08,-53737.95
buyer_1,Luis,28,ES56209552778483068985,TRX_N-01123-25269282,2024-09-04T22:39:04,Elciego,Expense,leisure,-69.19,-53807.14
buyer_1,Luis,28,ES56209552778483068985,TRX_N-01124-04287011,2024-09-04T22:17:17,Bilbao,Expense,cash,-100.0,-53907.14
buyer_1,Luis,28,ES56209552778483068985,TRX_N-01125-99012334,2024-09-05T23:44:39,Bilbao,expenses,phone,-39.16,-53946.3
buyer_1,Luis,28,ES56209552778483068985,TRX_N-01126-39382158,2024-09-05T11:11:42,Getxo,Expense,food,-110.7,-54057.0
buyer_1,Luis,28,ES56209552778483068985,TRX_N-01127-49788092,2024-09-08T18:12:27,Bilbao,expenses,water,-34.31,-54091.31
buyer_1,Luis,28,ES56209552778483068985,TRX_N-01128-97396669,2024-09-08T13:04:37,Bilbao,expenses,electricity,-39.19,-54130.5
buyer_1,Luis,28,ES56209552778483068985,TRX_N-01129-21867068,2024-09-08T17:54:12,Bilbao,expenses,gas,-70.93,-54201.43
buyer_1,Luis,28,ES56209552778483068985,TRX_N-01130-56127395,2024-09-08T17:26:02,Bilbao,expenses,internet,-42.0,-54243.43
buyer_1,Luis,28,ES56209552778483068985,TRX_N-01131-26669704,2024-09-09T17:12:33,Bilbao,Expense,leisure,-46.51,-54289.94
buyer_1,Luis,28,ES56209552778483068985,TRX_N-01132-98400655,2024-09-11T17:29:47,Bilbao,Expense,repairs,-285.76,-54575.7
buyer_1,Luis,28,ES56209552778483068985,TRX_N-01133-62245990,2024-09-11T18:30:05,Bilbao,expenses,children,-279.54,-54855.24
buyer_1,Luis,28,ES56209552778483068985,TRX_N-01134-94156944,2024-09-12T12:27:38,Bilbao,Expense,education,-62.23,-54917.47
buyer_1,Luis,28,ES56209552778483068985,TRX_N-01135-48109695,2024-09-13T10:46:35,Bilbao,Expense,transport,-56.29,-54973.76
buyer_1,Luis,28,ES56209552778483068985,TRX_N-01136-86561328,2024-09-13T04:44:33,Bilbao,Expense,education,-74.8,-55048.56
buyer_1,Luis,28,ES56209552778483068985,TRX_N-01137-93343828,2024-09-14T11:31:33,Bilbao,Expense,food,-95.62,-55144.18
buyer_1,Luis,28,ES56209552778483068985,TRX_N-01138-92559091,2024-09-15T04:20:22,Bilbao,Expense,leisure,-27.46,-55171.64
buyer_1,Luis,28,ES56209552778483068985,TRX_N-01139-96128846,2024-09-17T13:37:55,Bilbao,Expense,repairs,-89.67,-55261.31
buyer_1,Luis,28,ES56209552778483068985,TRX_N-01140-88578559,2024-09-18T12:16:58,Mungia,Expense,cash,-100.0,-55361.31
buyer_1,Luis,28,ES56209552778483068985,TRX_N-01141-16255998,2024-09-18T11:27:55,Bilbao,Expense,repairs,-311.71,-55673.02
buyer_1,Luis,28,ES56209552778483068985,TRX_N-01142-72064409,2024-09-20T12:11:52,Bilbao,Expense,food,-105.72,-55778.74
buyer_1,Luis,28,ES56209552778483068985,TRX_N-01143-48959937,2024-09-21T12:13:17,Durango,Expense,cash,-100.0,-55878.74
buyer_1,Luis,28,ES56209552778483068985,TRX_N-01144-75594782,2024-09-24T19:33:08,Bilbao,Expense,gifts,-67.96,-55946.7
buyer_1,Luis,28,ES56209552778483068985,TRX_N-01145-55129385,2024-09-26T18:17:18,Durango,Expense,food,-73.65,-56020.35
buyer_1,Luis,28,ES56209552778483068985,TRX_N-01146-65884309,2024-09-27T18:47:51,Bilbao,Expense,gifts,-214.54,-56234.89
buyer_1,Luis,28,ES56209552778483068985,TRX_N-01147-38196336,2024-09-28T16:46:49,Bilbao,Expense,cash,-100.0,-56334.89
buyer_1,Luis,28,ES56209552778483068985,TRX_N-01148-33184563,2024-09-29T10:01:49,Bilbao,expenses,children,-230.92,-56565.81
buyer_1,Luis,28,ES56209552778483068985,TRX_N-01149-59922411,2024-09-30T13:33:10,Llodio,Expense,cash,-100.0,-56665.81
buyer_1,Luis,28,ES56209552778483068985,TRX_N-01150-96775273,2024-09-30T17:14:49,Durango,Expense,repairs,-56.58,-56722.39
buyer_1,Luis,28,ES56209552778483068985,TRX_N-01151-68120130,2024-10-01T05:10:25,Bilbao,incomes,salary,1493.04,-55229.35
buyer_1,Luis,28,ES56209552778483068985,TRX_N-01152-64131010,2024-10-01T05:10:25,Bilbao,incomes,salary_partner,1404.27,-53825.08
buyer_1,Luis,28,ES56209552778483068985,TRX_N-01153-83107719,2024-10-01T23:09:32,Bilbao,Expense,food,-73.45,-53898.53
buyer_1,Luis,28,ES56209552778483068985,TRX_N-01154-07722988,2024-10-01T17:30:54,Bilbao,Expense,education,-78.19,-53976.72
buyer_1,Luis,28,ES56209552778483068985,TRX_N-01155-76646918,2024-10-02T11:08:08,Iru√±a de Oca,Expense,repairs,-296.18,-54272.9
buyer_1,Luis,28,ES56209552778483068985,TRX_N-01156-43599554,2024-10-03T09:28:15,Bilbao,Expense,leisure,-19.79,-54292.69
buyer_1,Luis,28,ES56209552778483068985,TRX_N-01157-87212407,2024-10-04T17:26:23,Bilbao,expenses,mortgage,-731.08,-55023.77
buyer_1,Luis,28,ES56209552778483068985,TRX_N-01158-87536769,2024-10-04T21:32:50,Bilbao,Expense,transport,-66.39,-55090.16
buyer_1,Luis,28,ES56209552778483068985,TRX_N-01159-62364855,2024-10-05T17:09:41,Bilbao,Expense,leisure,-84.22,-55174.38
buyer_1,Luis,28,ES56209552778483068985,TRX_N-01160-12200021,2024-10-06T17:06:32,Bilbao,expenses,phone,-43.62,-55218.0
buyer_1,Luis,28,ES56209552778483068985,TRX_N-01161-54248716,2024-10-08T10:35:58,Bilbao,expenses,water,-29.91,-55247.91
buyer_1,Luis,28,ES56209552778483068985,TRX_N-01162-07754491,2024-10-08T13:25:25,Bilbao,expenses,electricity,-67.05,-55314.96
buyer_1,Luis,28,ES56209552778483068985,TRX_N-01163-07190762,2024-10-08T06:44:54,Bilbao,expenses,gas,-30.97,-55345.93
buyer_1,Luis,28,ES56209552778483068985,TRX_N-01164-61306610,2024-10-08T20:28:08,Bilbao,expenses,internet,-42.0,-55387.93
buyer_1,Luis,28,ES56209552778483068985,TRX_N-01165-53880020,2024-10-08T02:42:17,Bilbao,Expense,leisure,-72.83,-55460.76
buyer_2,Carmen,40,ES76209527435549498601,TRX_N-00001-10021847,2022-01-01T16:12:00,Zarautz,incomes,salary,1277.97,2990.78
buyer_2,Carmen,40,ES76209527435549498601,TRX_N-00002-04434485,2022-01-01T16:12:00,Zarautz,incomes,salary_partner,985.77,3976.55
buyer_2,Carmen,40,ES76209527435549498601,TRX_N-00003-68417308,2022-01-01T22:07:23,Zarautz,Expense,food,-93.76,3882.79
buyer_2,Carmen,40,ES76209527435549498601,TRX_N-00004-38198701,2022-01-04T18:35:26,Zarautz,expenses,mortgage,-713.14,3169.65
buyer_2,Carmen,40,ES76209527435549498601,TRX_N-00005-57558056,2022-01-04T11:27:35,Zarautz,Expense,education,-50.59,3119.06
buyer_2,Carmen,40,ES76209527435549498601,TRX_N-00006-05146026,2022-01-05T12:15:32,Zarautz,expenses,electricity,-51.86,3067.2
buyer_2,Carmen,40,ES76209527435549498601,TRX_N-00007-16730860,2022-01-05T10:59:08,Zarautz,expenses,gas,-50.96,3016.24
buyer_2,Carmen,40,ES76209527435549498601,TRX_N-00008-49276301,2022-01-05T16:53:39,Zarautz,Expense,healthcare,-77.72,2938.52
buyer_2,Carmen,40,ES76209527435549498601,TRX_N-00009-22076693,2022-01-06T13:46:44,Zarautz,expenses,water,-21.12,2917.4
buyer_2,Carmen,40,ES76209527435549498601,TRX_N-00010-55180598,2022-01-06T15:24:13,Zarautz,expenses,phone,-34.61,2882.79
buyer_2,Carmen,40,ES76209527435549498601,TRX_N-00011-20023390,2022-01-06T19:48:13,Zarautz,Expense,leisure,-20.68,2862.11
buyer_2,Carmen,40,ES76209527435549498601,TRX_N-00012-10379093,2022-01-06T15:48:08,Zarautz,Expense,cash,-100.0,2762.11
buyer_2,Carmen,40,ES76209527435549498601,TRX_N-00013-23104612,2022-01-07T21:37:06,Zarautz,Expense,leisure,-79.21,2682.9
buyer_2,Carmen,40,ES76209527435549498601,TRX_N-00014-88322436,2022-01-07T14:08:50,Zarautz,Expense,cash,-100.0,2582.9
buyer_2,Carmen,40,ES76209527435549498601,TRX_N-00015-85937900,2022-01-08T04:56:44,Zarautz,expenses,internet,-42.0,2540.9
buyer_2,Carmen,40,ES76209527435549498601,TRX_N-00016-98262519,2022-01-08T06:21:03,Zarautz,Expense,cash,-100.0,2440.9
buyer_2,Carmen,40,ES76209527435549498601,TRX_N-00017-45324903,2022-01-09T13:16:16,Irun,Expense,education,-52.54,2388.36
buyer_2,Carmen,40,ES76209527435549498601,TRX_N-00018-69083015,2022-01-10T23:15:55,Zarautz,Expense,cash,-100.0,2288.36
buyer_2,Carmen,40,ES76209527435549498601,TRX_N-00019-64542720,2022-01-12T11:17:33,Zarautz,Expense,leisure,-55.82,2232.54
buyer_2,Carmen,40,ES76209527435549498601,TRX_N-00020-51843278,2022-01-12T13:26:36,Mungia,Expense,clothing,-110.02,2122.52
buyer_2,Carmen,40,ES76209527435549498601,TRX_N-00021-28296359,2022-01-14T09:17:27,Zarautz,Expense,transport,-73.09,2049.43
buyer_2,Carmen,40,ES76209527435549498601,TRX_N-00022-98810529,2022-01-15T15:45:20,Zarautz,Expense,leisure,-84.52,1964.91
buyer_2,Carmen,40,ES76209527435549498601,TRX_N-00023-13361454,2022-01-15T14:46:24,Zarautz,Expense,cash,-100.0,1864.91
buyer_2,Carmen,40,ES76209527435549498601,TRX_N-00024-47953499,2022-01-16T16:00:44,Zarautz,Expense,food,-113.2,1751.71
buyer_2,Carmen,40,ES76209527435549498601,TRX_N-00025-82492654,2022-01-17T09:04:12,Zarautz,Expense,clothing,-153.38,1598.33
buyer_2,Carmen,40,ES76209527435549498601,TRX_N-00026-86950774,2022-01-17T14:41:38,Basauri,Expense,cash,-100.0,1498.33
buyer_2,Carmen,40,ES76209527435549498601,TRX_N-00027-63356686,2022-01-18T10:03:15,Zarautz,Expense,leisure,-73.06,1425.27
buyer_2,Carmen,40,ES76209527435549498601,TRX_N-00028-08709478,2022-01-18T08:33:48,Zarautz,Expense,education,-64.65,1360.62
buyer_2,Carmen,40,ES76209527435549498601,TRX_N-00029-95597764,2022-01-19T09:44:59,Leioa,Expense,cash,-100.0,1260.62
buyer_2,Carmen,40,ES76209527435549498601,TRX_N-00030-05538019,2022-01-20T09:11:27,Zarautz,Expense,food,-68.2,1192.42
buyer_2,Carmen,40,ES76209527435549498601,TRX_N-00031-66404154,2022-01-23T23:23:55,Zarautz,Expense,leisure,-65.44,1126.98
buyer_2,Carmen,40,ES76209527435549498601,TRX_N-00032-18370770,2022-01-24T17:35:23,Zarautz,Expense,food,-82.46,1044.52
buyer_2,Carmen,40,ES76209527435549498601,TRX_N-00033-43710077,2022-01-24T04:59:21,Zarautz,Expense,leisure,-41.16,1003.36
buyer_2,Carmen,40,ES76209527435549498601,TRX_N-00034-76992228,2022-01-24T16:36:02,Hondarribia,Expense,cash,-100.0,903.36
buyer_2,Carmen,40,ES76209527435549498601,TRX_N-00035-82704887,2022-01-24T18:09:38,Zarautz,Expense,travel,-811.48,91.88
buyer_2,Carmen,40,ES76209527435549498601,TRX_N-00036-40463441,2022-01-27T15:37:21,Zarautz,Expense,cash,-100.0,-8.12
buyer_2,Carmen,40,ES76209527435549498601,TRX_N-00037-72528200,2022-01-28T18:58:34,Zarautz,Expense,gifts,-175.94,-184.06
buyer_2,Carmen,40,ES76209527435549498601,TRX_N-00038-48940327,2022-01-29T08:32:24,Zarautz,Expense,food,-89.48,-273.54
buyer_2,Carmen,40,ES76209527435549498601,TRX_N-00039-83569327,2022-01-30T21:50:00,Zarautz,Expense,transport,-84.22,-357.76
buyer_2,Carmen,40,ES76209527435549498601,TRX_N-00040-93562355,2022-01-31T15:31:22,Zarautz,Expense,repairs,-214.48,-572.24
buyer_2,Carmen,40,ES76209527435549498601,TRX_N-00041-80052701,2022-01-31T10:23:24,Zarautz,expenses,children,-267.12,-839.36
buyer_2,Carmen,40,ES76209527435549498601,TRX_N-00042-13266264,2022-02-01T16:33:47,Zarautz,incomes,salary,1277.97,438.61
buyer_2,Carmen,40,ES76209527435549498601,TRX_N-00043-63945400,2022-02-01T16:33:47,Zarautz,incomes,salary_partner,985.77,1424.38
buyer_2,Carmen,40,ES76209527435549498601,TRX_N-00044-69934498,2022-02-04T16:04:52,Zarautz,expenses,mortgage,-713.14,711.24
buyer_2,Carmen,40,ES76209527435549498601,TRX_N-00045-90680389,2022-02-04T10:36:58,Zarautz,Expense,cash,-100.0,611.24
buyer_2,Carmen,40,ES76209527435549498601,TRX_N-00046-74575995,2022-02-05T12:29:59,Zarautz,expenses,phone,-39.93,571.31
buyer_2,Carmen,40,ES76209527435549498601,TRX_N-00047-08270177,2022-02-05T08:59:03,Zarautz,Expense,food,-116.19,455.12
buyer_2,Carmen,40,ES76209527435549498601,TRX_N-00048-75571266,2022-02-05T19:44:04,Zarautz,Expense,cash,-100.0,355.12
buyer_2,Carmen,40,ES76209527435549498601,TRX_N-00049-86429796,2022-02-06T13:25:52,Zarautz,Expense,leisure,-24.55,330.57
buyer_2,Carmen,40,ES76209527435549498601,TRX_N-00050-85426432,2022-02-06T22:47:21,Zuia,Expense,clothing,-114.19,216.38
buyer_2,Carmen,40,ES76209527435549498601,TRX_N-00051-25729997,2022-02-07T09:18:11,Amurrio,Expense,food,-79.36,137.02
buyer_2,Carmen,40,ES76209527435549498601,TRX_N-00052-77533082,2022-02-07T12:43:48,Leioa,Expense,transport,-73.45,63.57
buyer_2,Carmen,40,ES76209527435549498601,TRX_N-00053-85748969,2022-02-08T16:23:33,Zarautz,expenses,gas,-81.2,-17.63
buyer_2,Carmen,40,ES76209527435549498601,TRX_N-00054-34362595,2022-02-08T12:27:08,Zarautz,expenses,water,-36.13,-53.76
buyer_2,Carmen,40,ES76209527435549498601,TRX_N-00055-47565273,2022-02-08T18:50:14,Zarautz,expenses,electricity,-47.77,-101.53
buyer_2,Carmen,40,ES76209527435549498601,TRX_N-00056-52363607,2022-02-08T10:30:12,Zarautz,expenses,internet,-42.0,-143.53
buyer_2,Carmen,40,ES76209527435549498601,TRX_N-00057-63835075,2022-02-08T19:02:20,Zarautz,Expense,transport,-67.81,-211.34
buyer_2,Carmen,40,ES76209527435549498601,TRX_N-00058-03015944,2022-02-08T09:56:41,Zarautz,Expense,cash,-100.0,-311.34
buyer_2,Carmen,40,ES76209527435549498601,TRX_N-00059-90326702,2022-02-13T19:07:04,Zarautz,Expense,food,-83.7,-395.04
buyer_2,Carmen,40,ES76209527435549498601,TRX_N-00060-17357401,2022-02-15T20:57:05,Zarautz,Expense,cash,-100.0,-495.04
buyer_2,Carmen,40,ES76209527435549498601,TRX_N-00061-41187639,2022-02-16T15:18:30,Labastida,Expense,transport,-64.8,-559.84
buyer_2,Carmen,40,ES76209527435549498601,TRX_N-00062-47489277,2022-02-20T11:17:39,Zarautz,Expense,leisure,-19.21,-579.05
buyer_2,Carmen,40,ES76209527435549498601,TRX_N-00063-59153090,2022-02-20T08:03:00,Zarautz,Expense,gifts,-64.66,-643.71
buyer_2,Carmen,40,ES76209527435549498601,TRX_N-00064-49992113,2022-02-21T15:13:53,Zarautz,Expense,food,-104.38,-748.09
buyer_2,Carmen,40,ES76209527435549498601,TRX_N-00065-57345405,2022-02-21T17:44:46,Zarautz,Expense,transport,-87.74,-835.83
buyer_2,Carmen,40,ES76209527435549498601,TRX_N-00066-18981591,2022-02-21T22:35:57,Zarautz,Expense,leisure,-67.57,-903.4
buyer_2,Carmen,40,ES76209527435549498601,TRX_N-00067-74098362,2022-02-21T21:18:14,Zarautz,expenses,children,-251.78,-1155.18
buyer_2,Carmen,40,ES76209527435549498601,TRX_N-00068-24286441,2022-02-22T10:22:38,Zarautz,Expense,clothing,-70.02,-1225.2
buyer_2,Carmen,40,ES76209527435549498601,TRX_N-00069-77583196,2022-02-23T16:15:02,Zarautz,Expense,gifts,-265.47,-1490.67
buyer_2,Carmen,40,ES76209527435549498601,TRX_N-00070-37139058,2022-02-24T20:24:55,Zarautz,Expense,food,-87.42,-1578.09
buyer_2,Carmen,40,ES76209527435549498601,TRX_N-00071-02416672,2022-02-25T14:29:12,Galdakao,Expense,food,-107.75,-1685.84
buyer_2,Carmen,40,ES76209527435549498601,TRX_N-00072-22432429,2022-02-25T14:47:45,Zarautz,Expense,repairs,-105.31,-1791.15
buyer_2,Carmen,40,ES76209527435549498601,TRX_N-00073-14826525,2022-02-27T16:20:55,Zarautz,Expense,clothing,-148.27,-1939.42
buyer_2,Carmen,40,ES76209527435549498601,TRX_N-00074-67927830,2022-02-28T16:09:31,Zarautz,Expense,food,-76.97,-2016.39
buyer_2,Carmen,40,ES76209527435549498601,TRX_N-00075-96228235,2022-02-28T18:48:48,Zarautz,Expense,appliances,-144.97,-2161.36
buyer_2,Carmen,40,ES76209527435549498601,TRX_N-00076-55261879,2022-03-01T08:44:40,Zarautz,incomes,salary,1277.97,-883.39
buyer_2,Carmen,40,ES76209527435549498601,TRX_N-00077-39373466,2022-03-01T08:44:40,Zarautz,incomes,salary_partner,985.77,102.38
buyer_2,Carmen,40,ES76209527435549498601,TRX_N-00078-94367175,2022-03-01T08:44:40,Zarautz,incomes,extra_income,144.79,247.17
buyer_2,Carmen,40,ES76209527435549498601,TRX_N-00079-86816466,2022-03-02T19:51:43,Zarautz,Expense,repairs,-128.77,118.4
buyer_2,Carmen,40,ES76209527435549498601,TRX_N-00080-20397007,2022-03-03T14:44:51,Zarautz,Expense,leisure,-21.31,97.09
buyer_2,Carmen,40,ES76209527435549498601,TRX_N-00081-58453440,2022-03-04T16:43:05,Zarautz,expenses,mortgage,-713.14,-616.05
buyer_2,Carmen,40,ES76209527435549498601,TRX_N-00082-01957657,2022-03-05T20:41:29,Zarautz,expenses,water,-30.16,-646.21
buyer_2,Carmen,40,ES76209527435549498601,TRX_N-00083-84956328,2022-03-05T14:06:21,Zarautz,Expense,food,-89.31,-735.52
buyer_2,Carmen,40,ES76209527435549498601,TRX_N-00084-94412030,2022-03-05T09:21:59,Amurrio,Expense,transport,-43.79,-779.31
buyer_2,Carmen,40,ES76209527435549498601,TRX_N-00085-08444851,2022-03-06T12:12:33,Zarautz,expenses,internet,-42.0,-821.31
buyer_2,Carmen,40,ES76209527435549498601,TRX_N-00086-65841052,2022-03-07T12:02:29,Zarautz,expenses,electricity,-39.94,-861.25
buyer_2,Carmen,40,ES76209527435549498601,TRX_N-00087-01424137,2022-03-07T12:25:01,Zarautz,Expense,education,-44.65,-905.9
buyer_2,Carmen,40,ES76209527435549498601,TRX_N-00088-96185789,2022-03-08T14:58:18,Zarautz,expenses,gas,-97.41,-1003.31
buyer_2,Carmen,40,ES76209527435549498601,TRX_N-00089-66611328,2022-03-08T11:49:26,Zarautz,expenses,phone,-35.25,-1038.56
buyer_2,Carmen,40,ES76209527435549498601,TRX_N-00090-45447648,2022-03-08T17:07:07,Zarautz,expenses,children,-172.26,-1210.82
buyer_2,Carmen,40,ES76209527435549498601,TRX_N-00091-92752132,2022-03-09T22:01:18,Zarautz,Expense,clothing,-83.89,-1294.71
buyer_2,Carmen,40,ES76209527435549498601,TRX_N-00092-86647912,2022-03-10T18:12:22,Zarautz,Expense,leisure,-54.86,-1349.57
buyer_2,Carmen,40,ES76209527435549498601,TRX_N-00093-13276446,2022-03-11T19:46:20,Zarautz,Expense,food,-117.04,-1466.61
buyer_2,Carmen,40,ES76209527435549498601,TRX_N-00094-47879994,2022-03-13T09:21:07,Zarautz,Expense,leisure,-70.54,-1537.15
buyer_2,Carmen,40,ES76209527435549498601,TRX_N-00095-03951868,2022-03-14T19:14:19,Zarautz,Expense,leisure,-37.39,-1574.54
buyer_2,Carmen,40,ES76209527435549498601,TRX_N-00096-80151075,2022-03-14T19:59:03,Zarautz,Expense,healthcare,-89.75,-1664.29
buyer_2,Carmen,40,ES76209527435549498601,TRX_N-00097-08755261,2022-03-14T15:13:52,Amurrio,Expense,cash,-100.0,-1764.29
buyer_2,Carmen,40,ES76209527435549498601,TRX_N-00098-53433639,2022-03-15T13:20:28,Zarautz,Expense,gifts,-359.72,-2124.01
buyer_2,Carmen,40,ES76209527435549498601,TRX_N-00099-63974529,2022-03-17T03:36:21,Zarautz,Expense,healthcare,-117.2,-2241.21
buyer_2,Carmen,40,ES76209527435549498601,TRX_N-00100-82010530,2022-03-18T13:10:40,Getxo,Expense,gifts,-779.09,-3020.3
buyer_2,Carmen,40,ES76209527435549498601,TRX_N-00101-86453733,2022-03-20T19:26:52,Zarautz,Expense,cash,-100.0,-3120.3
buyer_2,Carmen,40,ES76209527435549498601,TRX_N-00102-01650252,2022-03-20T17:07:55,Zarautz,Expense,appliances,-198.62,-3318.92
buyer_2,Carmen,40,ES76209527435549498601,TRX_N-00103-23676977,2022-03-20T17:29:38,Zarautz,Expense,repairs,-55.92,-3374.84
buyer_2,Carmen,40,ES76209527435549498601,TRX_N-00104-60506980,2022-03-22T15:53:31,Zarautz,Expense,repairs,-31.33,-3406.17
buyer_2,Carmen,40,ES76209527435549498601,TRX_N-00105-52293270,2022-03-24T14:50:24,Zarautz,Expense,cash,-100.0,-3506.17
buyer_2,Carmen,40,ES76209527435549498601,TRX_N-00106-98587507,2022-03-25T18:23:48,Zarautz,Expense,cash,-100.0,-3606.17
buyer_2,Carmen,40,ES76209527435549498601,TRX_N-00107-72852338,2022-03-29T15:39:44,Santurtzi,Expense,food,-110.56,-3716.73
buyer_2,Carmen,40,ES76209527435549498601,TRX_N-00108-62281318,2022-04-01T15:49:02,Zarautz,incomes,salary,1277.97,-2438.76
buyer_2,Carmen,40,ES76209527435549498601,TRX_N-00109-95886698,2022-04-01T15:49:02,Zarautz,incomes,salary_partner,985.77,-1452.99
buyer_2,Carmen,40,ES76209527435549498601,TRX_N-00110-36451204,2022-04-02T21:39:07,Zarautz,expenses,children,-225.05,-1678.04
buyer_2,Carmen,40,ES76209527435549498601,TRX_N-00111-55028598,2022-04-03T23:39:03,Leioa,Expense,cash,-100.0,-1778.04
buyer_2,Carmen,40,ES76209527435549498601,TRX_N-00112-56990329,2022-04-04T16:02:43,Zarautz,expenses,mortgage,-713.14,-2491.18
buyer_2,Carmen,40,ES76209527435549498601,TRX_N-00113-09254965,2022-04-04T08:22:48,Zarautz,Expense,leisure,-37.07,-2528.25
buyer_2,Carmen,40,ES76209527435549498601,TRX_N-00114-29428564,2022-04-05T08:12:15,Zarautz,expenses,water,-42.25,-2570.5
buyer_2,Carmen,40,ES76209527435549498601,TRX_N-00115-82792607,2022-04-05T12:59:43,Zarautz,expenses,gas,-80.05,-2650.55
buyer_2,Carmen,40,ES76209527435549498601,TRX_N-00116-76838527,2022-04-05T12:36:27,Zarautz,expenses,internet,-42.0,-2692.55
buyer_2,Carmen,40,ES76209527435549498601,TRX_N-00117-83013405,2022-04-05T12:16:36,Barakaldo,Expense,cash,-100.0,-2792.55
buyer_2,Carmen,40,ES76209527435549498601,TRX_N-00118-06229242,2022-04-06T06:52:24,Zarautz,expenses,electricity,-82.25,-2874.8
buyer_2,Carmen,40,ES76209527435549498601,TRX_N-00119-50279106,2022-04-06T21:46:20,Zarautz,Expense,repairs,-208.64,-3083.44
buyer_2,Carmen,40,ES76209527435549498601,TRX_N-00120-66722856,2022-04-07T10:43:57,Zarautz,expenses,phone,-34.32,-3117.76
buyer_2,Carmen,40,ES76209527435549498601,TRX_N-00121-00019039,2022-04-07T19:21:07,Bermeo,Expense,food,-80.09,-3197.85
buyer_2,Carmen,40,ES76209527435549498601,TRX_N-00122-19310479,2022-04-07T12:18:05,Zarautz,Expense,cash,-100.0,-3297.85
buyer_2,Carmen,40,ES76209527435549498601,TRX_N-00123-30540524,2022-04-08T23:19:07,Zarautz,Expense,leisure,-49.52,-3347.37
buyer_2,Carmen,40,ES76209527435549498601,TRX_N-00124-08426568,2022-04-08T12:06:35,Zarautz,Expense,cash,-100.0,-3447.37
buyer_2,Carmen,40,ES76209527435549498601,TRX_N-00125-37091334,2022-04-08T03:13:57,Zarautz,Expense,gifts,-391.22,-3838.59
buyer_2,Carmen,40,ES76209527435549498601,TRX_N-00126-49854746,2022-04-09T07:45:10,Zarautz,Expense,leisure,-57.17,-3895.76
buyer_2,Carmen,40,ES76209527435549498601,TRX_N-00127-15817887,2022-04-10T23:52:51,Zarautz,Expense,gifts,-37.97,-3933.73
buyer_2,Carmen,40,ES76209527435549498601,TRX_N-00128-82348173,2022-04-11T17:09:05,Zarautz,Expense,cash,-100.0,-4033.73
buyer_2,Carmen,40,ES76209527435549498601,TRX_N-00129-64330348,2022-04-12T14:29:55,Hernani,Expense,leisure,-31.63,-4065.36
buyer_2,Carmen,40,ES76209527435549498601,TRX_N-00130-26859285,2022-04-12T14:52:22,Zarautz,Expense,appliances,-355.91,-4421.27
buyer_2,Carmen,40,ES76209527435549498601,TRX_N-00131-48400165,2022-04-12T15:04:09,Zarautz,Expense,gifts,-143.99,-4565.26
buyer_2,Carmen,40,ES76209527435549498601,TRX_N-00132-16309486,2022-04-14T17:50:49,Zarautz,Expense,leisure,-42.44,-4607.7
buyer_2,Carmen,40,ES76209527435549498601,TRX_N-00133-79261673,2022-04-15T14:08:52,Zarautz,Expense,cash,-100.0,-4707.7
buyer_2,Carmen,40,ES76209527435549498601,TRX_N-00134-35463370,2022-04-15T08:50:28,Zarautz,Expense,gifts,-118.72,-4826.42
buyer_2,Carmen,40,ES76209527435549498601,TRX_N-00135-27892675,2022-04-16T11:08:46,Zarautz,Expense,food,-116.77,-4943.19
buyer_2,Carmen,40,ES76209527435549498601,TRX_N-00136-40121002,2022-04-17T19:32:31,Zarautz,Expense,food,-123.05,-5066.24
buyer_2,Carmen,40,ES76209527435549498601,TRX_N-00137-65922548,2022-04-19T08:28:06,Zarautz,Expense,food,-72.35,-5138.59
buyer_2,Carmen,40,ES76209527435549498601,TRX_N-00138-75840170,2022-04-19T12:41:41,Portugalete,Expense,transport,-68.55,-5207.14
buyer_2,Carmen,40,ES76209527435549498601,TRX_N-00139-71584448,2022-04-20T06:42:21,Zarautz,Expense,leisure,-63.66,-5270.8
buyer_2,Carmen,40,ES76209527435549498601,TRX_N-00140-30943194,2022-04-20T16:00:32,Zarautz,Expense,education,-63.72,-5334.52
buyer_2,Carmen,40,ES76209527435549498601,TRX_N-00141-57091839,2022-04-20T13:46:11,Zarautz,Expense,repairs,-153.68,-5488.2
buyer_2,Carmen,40,ES76209527435549498601,TRX_N-00142-85097581,2022-04-21T20:03:28,Zarautz,Expense,food,-90.47,-5578.67
buyer_2,Carmen,40,ES76209527435549498601,TRX_N-00143-81452331,2022-04-21T08:57:34,Zarautz,Expense,gifts,-298.95,-5877.62
buyer_2,Carmen,40,ES76209527435549498601,TRX_N-00144-92668608,2022-04-22T12:22:21,Alegr√≠a-Dulantzi,Expense,food,-110.48,-5988.1
buyer_2,Carmen,40,ES76209527435549498601,TRX_N-00145-41977597,2022-04-22T14:49:53,Zarautz,Expense,leisure,-19.16,-6007.26
buyer_2,Carmen,40,ES76209527435549498601,TRX_N-00146-93978631,2022-04-24T15:28:10,Llodio,Expense,food,-118.6,-6125.86
buyer_2,Carmen,40,ES76209527435549498601,TRX_N-00147-63321487,2022-04-25T18:58:38,Zarautz,Expense,cash,-100.0,-6225.86
buyer_2,Carmen,40,ES76209527435549498601,TRX_N-00148-49346014,2022-04-26T19:15:31,Hondarribia,Expense,leisure,-57.05,-6282.91
buyer_2,Carmen,40,ES76209527435549498601,TRX_N-00149-64415531,2022-04-28T19:04:20,Salvatierra/Agurain,Expense,clothing,-114.83,-6397.74
buyer_2,Carmen,40,ES76209527435549498601,TRX_N-00150-29302831,2022-04-28T06:55:07,Zarautz,Expense,cash,-100.0,-6497.74
buyer_2,Carmen,40,ES76209527435549498601,TRX_N-00151-66147223,2022-04-29T18:47:53,Zarautz,Expense,leisure,-18.32,-6516.06
buyer_2,Carmen,40,ES76209527435549498601,TRX_N-00152-86796913,2022-04-29T19:58:12,Zarautz,Expense,clothing,-63.27,-6579.33
buyer_2,Carmen,40,ES76209527435549498601,TRX_N-00153-70561261,2022-04-30T07:31:18,Zarautz,Expense,food,-106.2,-6685.53
buyer_2,Carmen,40,ES76209527435549498601,TRX_N-00154-11557149,2022-04-30T10:31:10,Zarautz,Expense,healthcare,-122.22,-6807.75
buyer_2,Carmen,40,ES76209527435549498601,TRX_N-00155-92943346,2022-04-30T21:31:46,Zarautz,Expense,cash,-100.0,-6907.75
buyer_2,Carmen,40,ES76209527435549498601,TRX_N-00156-48718825,2022-05-01T20:28:58,Zarautz,incomes,salary,1277.97,-5629.78
buyer_2,Carmen,40,ES76209527435549498601,TRX_N-00157-96224484,2022-05-01T20:28:58,Zarautz,incomes,salary_partner,985.77,-4644.01
buyer_2,Carmen,40,ES76209527435549498601,TRX_N-00158-66535478,2022-05-02T11:57:55,Zarautz,Expense,transport,-69.35,-4713.36
buyer_2,Carmen,40,ES76209527435549498601,TRX_N-00159-09187567,2022-05-02T12:50:56,Zarautz,Expense,cash,-100.0,-4813.36
buyer_2,Carmen,40,ES76209527435549498601,TRX_N-00160-58491819,2022-05-03T20:03:49,Barakaldo,Expense,leisure,-34.4,-4847.76
buyer_2,Carmen,40,ES76209527435549498601,TRX_N-00161-50853787,2022-05-04T13:29:43,Zarautz,expenses,mortgage,-713.14,-5560.9
buyer_2,Carmen,40,ES76209527435549498601,TRX_N-00162-06820706,2022-05-04T11:25:07,Zarautz,Expense,food,-92.36,-5653.26
buyer_2,Carmen,40,ES76209527435549498601,TRX_N-00163-85026551,2022-05-05T20:40:05,Zarautz,expenses,water,-43.21,-5696.47
buyer_2,Carmen,40,ES76209527435549498601,TRX_N-00164-13245604,2022-05-05T10:55:09,Zarautz,expenses,phone,-33.35,-5729.82
buyer_2,Carmen,40,ES76209527435549498601,TRX_N-00165-58350534,2022-05-05T10:27:13,Eibar,Expense,transport,-61.83,-5791.65
buyer_2,Carmen,40,ES76209527435549498601,TRX_N-00166-79072224,2022-05-06T19:59:32,Zarautz,Expense,repairs,-314.54,-6106.19
buyer_2,Carmen,40,ES76209527435549498601,TRX_N-00167-60706265,2022-05-07T14:16:28,Zarautz,Expense,leisure,-69.69,-6175.88
buyer_2,Carmen,40,ES76209527435549498601,TRX_N-00168-37129326,2022-05-08T18:24:15,Zarautz,expenses,electricity,-65.66,-6241.54
buyer_2,Carmen,40,ES76209527435549498601,TRX_N-00169-57876169,2022-05-08T10:37:22,Zarautz,expenses,gas,-105.81,-6347.35
buyer_2,Carmen,40,ES76209527435549498601,TRX_N-00170-68935892,2022-05-08T09:23:31,Zarautz,expenses,internet,-42.0,-6389.35
buyer_2,Carmen,40,ES76209527435549498601,TRX_N-00171-50637839,2022-05-08T08:19:40,Irun,Expense,gifts,-265.3,-6654.65
buyer_2,Carmen,40,ES76209527435549498601,TRX_N-00172-07246129,2022-05-09T07:33:58,Vitoria-Gasteiz,Expense,healthcare,-60.68,-6715.33
buyer_2,Carmen,40,ES76209527435549498601,TRX_N-00173-46847644,2022-05-10T10:11:57,Zarautz,Expense,cash,-100.0,-6815.33
buyer_2,Carmen,40,ES76209527435549498601,TRX_N-00174-52306856,2022-05-11T10:52:51,Zarautz,Expense,cash,-100.0,-6915.33
buyer_2,Carmen,40,ES76209527435549498601,TRX_N-00175-44542886,2022-05-13T19:49:22,Zarautz,Expense,leisure,-64.52,-6979.85
buyer_2,Carmen,40,ES76209527435549498601,TRX_N-00176-63772761,2022-05-13T19:52:00,Zarautz,Expense,cash,-100.0,-7079.85
buyer_2,Carmen,40,ES76209527435549498601,TRX_N-00177-51294153,2022-05-13T18:42:13,Zarautz,Expense,gifts,-753.87,-7833.72
buyer_2,Carmen,40,ES76209527435549498601,TRX_N-00178-29826679,2022-05-14T23:57:54,Zarautz,Expense,cash,-100.0,-7933.72
buyer_2,Carmen,40,ES76209527435549498601,TRX_N-00179-66925117,2022-05-17T11:19:36,Zarautz,Expense,transport,-81.85,-8015.57
buyer_2,Carmen,40,ES76209527435549498601,TRX_N-00180-15605993,2022-05-18T12:11:34,Zarautz,expenses,children,-212.17,-8227.74
buyer_2,Carmen,40,ES76209527435549498601,TRX_N-00181-24716423,2022-05-19T13:28:46,Zarautz,Expense,appliances,-330.68,-8558.42
buyer_2,Carmen,40,ES76209527435549498601,TRX_N-00182-39597283,2022-05-19T10:07:08,Zarautz,Expense,gifts,-121.12,-8679.54
buyer_2,Carmen,40,ES76209527435549498601,TRX_N-00183-47043840,2022-05-21T17:51:32,Zarautz,Expense,transport,-41.58,-8721.12
buyer_2,Carmen,40,ES76209527435549498601,TRX_N-00184-25966694,2022-05-21T11:04:51,Zarautz,expenses,children,-198.33,-8919.45
buyer_2,Carmen,40,ES76209527435549498601,TRX_N-00185-96093226,2022-05-22T10:04:05,Zarautz,Expense,cash,-100.0,-9019.45
buyer_2,Carmen,40,ES76209527435549498601,TRX_N-00186-11323541,2022-05-23T00:57:26,Zarautz,Expense,healthcare,-135.85,-9155.3
buyer_2,Carmen,40,ES76209527435549498601,TRX_N-00187-86065754,2022-05-26T17:34:41,Getxo,Expense,food,-91.85,-9247.15
buyer_2,Carmen,40,ES76209527435549498601,TRX_N-00188-30737087,2022-05-26T20:02:08,Zarautz,Expense,cash,-100.0,-9347.15
buyer_2,Carmen,40,ES76209527435549498601,TRX_N-00189-09335006,2022-05-28T16:38:27,Zarautz,Expense,leisure,-25.7,-9372.85
buyer_2,Carmen,40,ES76209527435549498601,TRX_N-00190-06977153,2022-05-28T10:14:52,Bermeo,Expense,education,-69.51,-9442.36
buyer_2,Carmen,40,ES76209527435549498601,TRX_N-00191-02974908,2022-05-29T13:28:59,Zarautz,Expense,leisure,-77.15,-9519.51
buyer_2,Carmen,40,ES76209527435549498601,TRX_N-00192-30310421,2022-05-29T12:18:10,Getxo,Expense,gifts,-474.93,-9994.44
buyer_2,Carmen,40,ES76209527435549498601,TRX_N-00193-05729114,2022-05-30T11:31:38,Zarautz,Expense,leisure,-80.31,-10074.75
buyer_2,Carmen,40,ES76209527435549498601,TRX_N-00194-63232187,2022-06-01T19:57:11,Zarautz,incomes,salary,1277.97,-8796.78
buyer_2,Carmen,40,ES76209527435549498601,TRX_N-00195-68257378,2022-06-01T19:57:11,Zarautz,incomes,salary_partner,985.77,-7811.01
buyer_2,Carmen,40,ES76209527435549498601,TRX_N-00196-63762530,2022-06-01T19:57:11,Zarautz,incomes,extra_income,144.79,-7666.22
buyer_2,Carmen,40,ES76209527435549498601,TRX_N-00197-58768690,2022-06-01T19:57:11,Zarautz,incomes,salary_bonus,986.64,-6679.58
buyer_2,Carmen,40,ES76209527435549498601,TRX_N-00198-58567986,2022-06-01T19:57:11,Zarautz,incomes,salary_partner_bonus,733.47,-5946.11
buyer_2,Carmen,40,ES76209527435549498601,TRX_N-00199-27483487,2022-06-01T19:34:05,Zarautz,Expense,education,-55.5,-6001.61
buyer_2,Carmen,40,ES76209527435549498601,TRX_N-00200-89934802,2022-06-02T12:25:16,Zarautz,Expense,transport,-63.72,-6065.33
buyer_2,Carmen,40,ES76209527435549498601,TRX_N-00201-36377179,2022-06-04T18:15:59,Zarautz,expenses,mortgage,-713.14,-6778.47
buyer_2,Carmen,40,ES76209527435549498601,TRX_N-00202-61309760,2022-06-05T22:05:10,Zarautz,expenses,water,-35.98,-6814.45
buyer_2,Carmen,40,ES76209527435549498601,TRX_N-00203-61111905,2022-06-05T08:30:27,Zarautz,expenses,electricity,-63.56,-6878.01
buyer_2,Carmen,40,ES76209527435549498601,TRX_N-00204-13073902,2022-06-05T17:46:59,Pasaia,Expense,education,-57.32,-6935.33
buyer_2,Carmen,40,ES76209527435549498601,TRX_N-00205-34215107,2022-06-06T09:13:18,Zarautz,expenses,internet,-42.0,-6977.33
buyer_2,Carmen,40,ES76209527435549498601,TRX_N-00206-30805498,2022-06-07T20:31:50,Zarautz,expenses,gas,-34.86,-7012.19
buyer_2,Carmen,40,ES76209527435549498601,TRX_N-00207-50579499,2022-06-07T10:26:39,Zarautz,Expense,food,-79.9,-7092.09
buyer_2,Carmen,40,ES76209527435549498601,TRX_N-00208-98416537,2022-06-08T20:13:47,Zarautz,expenses,phone,-31.09,-7123.18
buyer_2,Carmen,40,ES76209527435549498601,TRX_N-00209-59083917,2022-06-09T14:54:21,Zarautz,Expense,leisure,-66.93,-7190.11
buyer_2,Carmen,40,ES76209527435549498601,TRX_N-00210-84765484,2022-06-14T11:36:06,Zarautz,Expense,education,-78.41,-7268.52
buyer_2,Carmen,40,ES76209527435549498601,TRX_N-00211-76366226,2022-06-14T16:36:59,Zarautz,Expense,repairs,-70.96,-7339.48
buyer_2,Carmen,40,ES76209527435549498601,TRX_N-00212-71990163,2022-06-16T12:52:08,Zarautz,Expense,food,-78.97,-7418.45
buyer_2,Carmen,40,ES76209527435549498601,TRX_N-00213-32050796,2022-06-17T11:26:13,Zarautz,Expense,leisure,-66.18,-7484.63
buyer_2,Carmen,40,ES76209527435549498601,TRX_N-00214-98140109,2022-06-18T14:19:24,Zarautz,Expense,leisure,-49.6,-7534.23
buyer_2,Carmen,40,ES76209527435549498601,TRX_N-00215-45634395,2022-06-20T08:13:26,Zarautz,Expense,leisure,-39.27,-7573.5
buyer_2,Carmen,40,ES76209527435549498601,TRX_N-00216-23192027,2022-06-20T05:34:46,Zarautz,Expense,gifts,-404.96,-7978.46
buyer_2,Carmen,40,ES76209527435549498601,TRX_N-00217-06872460,2022-06-21T12:05:48,Zarautz,Expense,leisure,-29.32,-8007.78
buyer_2,Carmen,40,ES76209527435549498601,TRX_N-00218-30398437,2022-06-23T23:25:12,Zarautz,Expense,food,-97.53,-8105.31
buyer_2,Carmen,40,ES76209527435549498601,TRX_N-00219-29203352,2022-06-24T23:29:06,Zarautz,Expense,cash,-100.0,-8205.31
buyer_2,Carmen,40,ES76209527435549498601,TRX_N-00220-72994922,2022-06-26T12:50:07,Zarautz,expenses,children,-53.81,-8259.12
buyer_2,Carmen,40,ES76209527435549498601,TRX_N-00221-08222362,2022-06-27T10:36:30,Zarautz,Expense,food,-87.62,-8346.74
buyer_2,Carmen,40,ES76209527435549498601,TRX_N-00222-21271197,2022-06-28T13:49:05,Zarautz,Expense,leisure,-25.51,-8372.25
buyer_2,Carmen,40,ES76209527435549498601,TRX_N-00223-83526503,2022-06-29T12:11:03,Zarautz,Expense,leisure,-78.57,-8450.82
buyer_2,Carmen,40,ES76209527435549498601,TRX_N-00224-57523470,2022-07-01T14:27:13,Zarautz,incomes,salary,1277.97,-7172.85
buyer_2,Carmen,40,ES76209527435549498601,TRX_N-00225-85394637,2022-07-01T14:27:13,Zarautz,incomes,salary_partner,985.77,-6187.08
buyer_2,Carmen,40,ES76209527435549498601,TRX_N-00226-26681748,2022-07-01T10:47:20,Zarautz,Expense,leisure,-49.87,-6236.95
buyer_2,Carmen,40,ES76209527435549498601,TRX_N-00227-68737633,2022-07-02T11:18:49,Basauri,Expense,healthcare,-134.4,-6371.35
buyer_2,Carmen,40,ES76209527435549498601,TRX_N-00228-54991094,2022-07-02T09:58:16,Zarautz,Expense,repairs,-166.06,-6537.41
buyer_2,Carmen,40,ES76209527435549498601,TRX_N-00229-26515372,2022-07-03T12:26:17,Zarautz,Expense,transport,-75.0,-6612.41
buyer_2,Carmen,40,ES76209527435549498601,TRX_N-00230-96562367,2022-07-04T21:15:21,Zarautz,expenses,mortgage,-713.14,-7325.55
buyer_2,Carmen,40,ES76209527435549498601,TRX_N-00231-11420072,2022-07-04T10:02:51,Zarautz,Expense,food,-93.01,-7418.56
buyer_2,Carmen,40,ES76209527435549498601,TRX_N-00232-74783911,2022-07-05T22:55:37,Zarautz,Expense,transport,-87.02,-7505.58
buyer_2,Carmen,40,ES76209527435549498601,TRX_N-00233-75501895,2022-07-05T16:29:30,Zarautz,Expense,leisure,-63.28,-7568.86
buyer_2,Carmen,40,ES76209527435549498601,TRX_N-00234-01921144,2022-07-06T18:49:46,Zarautz,expenses,water,-40.47,-7609.33
buyer_2,Carmen,40,ES76209527435549498601,TRX_N-00235-25689976,2022-07-07T12:58:23,Zarautz,Expense,healthcare,-91.12,-7700.45
buyer_2,Carmen,40,ES76209527435549498601,TRX_N-00236-27278984,2022-07-08T07:47:42,Zarautz,expenses,electricity,-44.52,-7744.97
buyer_2,Carmen,40,ES76209527435549498601,TRX_N-00237-58649688,2022-07-08T16:37:52,Zarautz,expenses,gas,-78.82,-7823.79
buyer_2,Carmen,40,ES76209527435549498601,TRX_N-00238-29349453,2022-07-08T15:19:34,Zarautz,expenses,internet,-42.0,-7865.79
buyer_2,Carmen,40,ES76209527435549498601,TRX_N-00239-69038488,2022-07-08T11:49:40,Zarautz,expenses,phone,-32.15,-7897.94
buyer_2,Carmen,40,ES76209527435549498601,TRX_N-00240-23186233,2022-07-08T13:57:48,Zarautz,Expense,clothing,-129.62,-8027.56
buyer_2,Carmen,40,ES76209527435549498601,TRX_N-00241-76987376,2022-07-09T12:59:43,Zarautz,Expense,education,-42.94,-8070.5
buyer_2,Carmen,40,ES76209527435549498601,TRX_N-00242-88532558,2022-07-11T20:54:51,Zarautz,Expense,food,-117.38,-8187.88
buyer_2,Carmen,40,ES76209527435549498601,TRX_N-00243-99276499,2022-07-13T20:32:23,Zarautz,Expense,cash,-100.0,-8287.88
buyer_2,Carmen,40,ES76209527435549498601,TRX_N-00244-41440284,2022-07-14T16:46:23,Basauri,Expense,healthcare,-176.19,-8464.07
buyer_2,Carmen,40,ES76209527435549498601,TRX_N-00245-82046458,2022-07-16T09:01:34,Zarautz,Expense,repairs,-217.22,-8681.29
buyer_2,Carmen,40,ES76209527435549498601,TRX_N-00246-69718127,2022-07-17T12:08:52,Labastida,Expense,food,-70.44,-8751.73
buyer_2,Carmen,40,ES76209527435549498601,TRX_N-00247-40176718,2022-07-19T20:29:43,Lasarte-Oria,Expense,clothing,-58.16,-8809.89
buyer_2,Carmen,40,ES76209527435549498601,TRX_N-00248-54187901,2022-07-19T13:08:16,Zarautz,Expense,repairs,-293.19,-9103.08
buyer_2,Carmen,40,ES76209527435549498601,TRX_N-00249-92322327,2022-07-21T15:06:03,Portugalete,Expense,education,-71.47,-9174.55
buyer_2,Carmen,40,ES76209527435549498601,TRX_N-00250-64809577,2022-07-21T19:30:23,Zarautz,expenses,children,-233.18,-9407.73
buyer_2,Carmen,40,ES76209527435549498601,TRX_N-00251-33584760,2022-07-22T15:08:30,Zarautz,Expense,transport,-77.4,-9485.13
buyer_2,Carmen,40,ES76209527435549498601,TRX_N-00252-51620305,2022-07-24T01:52:15,Zarautz,Expense,food,-86.23,-9571.36
buyer_2,Carmen,40,ES76209527435549498601,TRX_N-00253-53006733,2022-07-24T08:18:09,Zarautz,Expense,transport,-54.55,-9625.91
buyer_2,Carmen,40,ES76209527435549498601,TRX_N-00254-47797984,2022-07-25T11:26:07,Zarautz,Expense,repairs,-330.12,-9956.03
buyer_2,Carmen,40,ES76209527435549498601,TRX_N-00255-17024169,2022-07-26T17:04:51,Zarautz,Expense,repairs,-218.47,-10174.5
buyer_2,Carmen,40,ES76209527435549498601,TRX_N-00256-87524578,2022-07-26T20:24:47,Zarautz,expenses,children,-168.27,-10342.77
buyer_2,Carmen,40,ES76209527435549498601,TRX_N-00257-63500386,2022-07-27T19:12:33,Sestao,Expense,food,-94.87,-10437.64
buyer_2,Carmen,40,ES76209527435549498601,TRX_N-00258-90536696,2022-07-28T11:30:23,Zarautz,Expense,transport,-70.77,-10508.41
buyer_2,Carmen,40,ES76209527435549498601,TRX_N-00259-19455314,2022-07-28T13:20:24,Zarautz,Expense,gifts,-827.92,-11336.33
buyer_2,Carmen,40,ES76209527435549498601,TRX_N-00260-17463075,2022-07-29T16:49:15,Zarautz,Expense,food,-67.6,-11403.93
buyer_2,Carmen,40,ES76209527435549498601,TRX_N-00261-06431996,2022-07-29T17:43:50,Errenteria,Expense,clothing,-149.19,-11553.12
buyer_2,Carmen,40,ES76209527435549498601,TRX_N-00262-43332403,2022-08-01T12:32:00,Zarautz,incomes,salary,1277.97,-10275.15
buyer_2,Carmen,40,ES76209527435549498601,TRX_N-00263-91908593,2022-08-01T12:32:00,Zarautz,incomes,salary_partner,985.77,-9289.38
buyer_2,Carmen,40,ES76209527435549498601,TRX_N-00264-61521070,2022-08-02T13:11:09,Zarautz,Expense,appliances,-280.13,-9569.51
buyer_2,Carmen,40,ES76209527435549498601,TRX_N-00265-02845456,2022-08-04T21:02:52,Zarautz,expenses,mortgage,-713.14,-10282.65
buyer_2,Carmen,40,ES76209527435549498601,TRX_N-00266-05439925,2022-08-04T14:45:32,Hondarribia,Expense,food,-115.1,-10397.75
buyer_2,Carmen,40,ES76209527435549498601,TRX_N-00267-25856951,2022-08-05T10:44:52,Zarautz,expenses,phone,-36.33,-10434.08
buyer_2,Carmen,40,ES76209527435549498601,TRX_N-00268-74954771,2022-08-06T18:43:25,Zarautz,Expense,leisure,-19.17,-10453.25
buyer_2,Carmen,40,ES76209527435549498601,TRX_N-00269-75253066,2022-08-07T16:44:13,Zarautz,expenses,electricity,-73.46,-10526.71
buyer_2,Carmen,40,ES76209527435549498601,TRX_N-00270-71250503,2022-08-08T12:28:56,Zarautz,expenses,water,-21.12,-10547.83
buyer_2,Carmen,40,ES76209527435549498601,TRX_N-00271-90487043,2022-08-08T20:07:29,Zarautz,expenses,gas,-79.17,-10627.0
buyer_2,Carmen,40,ES76209527435549498601,TRX_N-00272-69464945,2022-08-08T20:30:38,Zarautz,expenses,internet,-42.0,-10669.0
buyer_2,Carmen,40,ES76209527435549498601,TRX_N-00273-03453851,2022-08-08T18:04:44,Zarautz,Expense,cash,-100.0,-10769.0
buyer_2,Carmen,40,ES76209527435549498601,TRX_N-00274-35241134,2022-08-09T15:12:41,Zarautz,Expense,education,-45.86,-10814.86
buyer_2,Carmen,40,ES76209527435549498601,TRX_N-00275-34317873,2022-08-11T16:01:09,Zarautz,Expense,education,-70.59,-10885.45
buyer_2,Carmen,40,ES76209527435549498601,TRX_N-00276-88110933,2022-08-13T11:17:07,Zarautz,Expense,gifts,-183.78,-11069.23
buyer_2,Carmen,40,ES76209527435549498601,TRX_N-00277-54164154,2022-08-19T18:55:27,Zarautz,Expense,clothing,-106.57,-11175.8
buyer_2,Carmen,40,ES76209527435549498601,TRX_N-00278-75044926,2022-08-20T22:15:35,Zarautz,Expense,cash,-100.0,-11275.8
buyer_2,Carmen,40,ES76209527435549498601,TRX_N-00279-95701918,2022-08-22T22:30:24,Zarautz,Expense,clothing,-150.99,-11426.79
buyer_2,Carmen,40,ES76209527435549498601,TRX_N-00280-55966655,2022-08-22T23:45:47,Zarautz,Expense,appliances,-306.89,-11733.68
buyer_2,Carmen,40,ES76209527435549498601,TRX_N-00281-31653748,2022-08-25T17:38:55,Zarautz,Expense,transport,-84.34,-11818.02
buyer_2,Carmen,40,ES76209527435549498601,TRX_N-00282-83712146,2022-08-30T06:36:05,Getxo,Expense,food,-100.71,-11918.73
buyer_2,Carmen,40,ES76209527435549498601,TRX_N-00283-82492355,2022-08-30T16:15:08,Zarautz,Expense,transport,-53.64,-11972.37
buyer_2,Carmen,40,ES76209527435549498601,TRX_N-00284-41206658,2022-08-30T16:46:47,Zarautz,Expense,leisure,-25.7,-11998.07
buyer_2,Carmen,40,ES76209527435549498601,TRX_N-00285-96562581,2022-08-31T16:09:49,Eibar,Expense,education,-77.14,-12075.21
buyer_2,Carmen,40,ES76209527435549498601,TRX_N-00286-97792701,2022-09-01T04:25:36,Zarautz,incomes,salary,1277.97,-10797.24
buyer_2,Carmen,40,ES76209527435549498601,TRX_N-00287-04090314,2022-09-01T04:25:36,Zarautz,incomes,salary_partner,985.77,-9811.47
buyer_2,Carmen,40,ES76209527435549498601,TRX_N-00288-81898753,2022-09-01T04:25:36,Zarautz,incomes,extra_income,144.79,-9666.68
buyer_2,Carmen,40,ES76209527435549498601,TRX_N-00289-66043679,2022-09-03T11:21:06,Zarautz,Expense,gifts,-339.99,-10006.67
buyer_2,Carmen,40,ES76209527435549498601,TRX_N-00290-88023139,2022-09-04T17:33:42,Zarautz,expenses,mortgage,-713.14,-10719.81
buyer_2,Carmen,40,ES76209527435549498601,TRX_N-00291-60022275,2022-09-04T13:44:33,Zarautz,Expense,gifts,-595.54,-11315.35
buyer_2,Carmen,40,ES76209527435549498601,TRX_N-00292-54254793,2022-09-05T17:11:51,Zarautz,expenses,internet,-42.0,-11357.35
buyer_2,Carmen,40,ES76209527435549498601,TRX_N-00293-20871983,2022-09-06T09:07:16,Zarautz,expenses,water,-42.59,-11399.94
buyer_2,Carmen,40,ES76209527435549498601,TRX_N-00294-16520148,2022-09-06T13:33:41,Zarautz,expenses,electricity,-33.4,-11433.34
buyer_2,Carmen,40,ES76209527435549498601,TRX_N-00295-87940651,2022-09-06T19:45:48,Zarautz,expenses,gas,-60.23,-11493.57
buyer_2,Carmen,40,ES76209527435549498601,TRX_N-00296-48763591,2022-09-06T19:21:26,Zarautz,expenses,children,-250.83,-11744.4
buyer_2,Carmen,40,ES76209527435549498601,TRX_N-00297-37687893,2022-09-07T22:31:24,Zarautz,expenses,phone,-32.13,-11776.53
buyer_2,Carmen,40,ES76209527435549498601,TRX_N-00298-80730988,2022-09-07T16:39:50,Zarautz,Expense,leisure,-25.54,-11802.07
buyer_2,Carmen,40,ES76209527435549498601,TRX_N-00299-63226031,2022-09-07T16:06:38,Zarautz,Expense,clothing,-135.26,-11937.33
buyer_2,Carmen,40,ES76209527435549498601,TRX_N-00300-22454533,2022-09-07T12:56:32,Zarautz,Expense,cash,-100.0,-12037.33
buyer_2,Carmen,40,ES76209527435549498601,TRX_N-00301-35129391,2022-09-08T14:17:36,Irun,Expense,appliances,-113.68,-12151.01
buyer_2,Carmen,40,ES76209527435549498601,TRX_N-00302-72143235,2022-09-09T18:47:28,Vitoria-Gasteiz,Expense,transport,-74.42,-12225.43
buyer_2,Carmen,40,ES76209527435549498601,TRX_N-00303-11024121,2022-09-10T08:49:22,Zarautz,Expense,food,-67.66,-12293.09
buyer_2,Carmen,40,ES76209527435549498601,TRX_N-00304-93982420,2022-09-10T11:10:31,Zarautz,Expense,transport,-70.08,-12363.17
buyer_2,Carmen,40,ES76209527435549498601,TRX_N-00305-96276309,2022-09-11T18:48:24,Zarautz,Expense,education,-62.97,-12426.14
buyer_2,Carmen,40,ES76209527435549498601,TRX_N-00306-42614644,2022-09-12T16:03:58,Basauri,Expense,clothing,-151.22,-12577.36
buyer_2,Carmen,40,ES76209527435549498601,TRX_N-00307-32931628,2022-09-12T13:06:47,Zarautz,Expense,cash,-100.0,-12677.36
buyer_2,Carmen,40,ES76209527435549498601,TRX_N-00308-74518743,2022-09-13T08:54:21,Zarautz,Expense,leisure,-64.08,-12741.44
buyer_2,Carmen,40,ES76209527435549498601,TRX_N-00309-62174165,2022-09-13T19:13:13,Zarautz,Expense,gifts,-274.77,-13016.21
buyer_2,Carmen,40,ES76209527435549498601,TRX_N-00310-45988928,2022-09-14T14:57:51,Zarautz,Expense,leisure,-30.61,-13046.82
buyer_2,Carmen,40,ES76209527435549498601,TRX_N-00311-44940674,2022-09-14T14:36:23,Andoain,Expense,cash,-100.0,-13146.82
buyer_2,Carmen,40,ES76209527435549498601,TRX_N-00312-74896244,2022-09-15T08:13:00,Zarautz,Expense,transport,-52.89,-13199.71
buyer_2,Carmen,40,ES76209527435549498601,TRX_N-00313-90337266,2022-09-15T13:30:19,Zarautz,Expense,cash,-100.0,-13299.71
buyer_2,Carmen,40,ES76209527435549498601,TRX_N-00314-95736371,2022-09-17T14:19:54,Durango,Expense,food,-77.7,-13377.41
buyer_2,Carmen,40,ES76209527435549498601,TRX_N-00315-13087278,2022-09-18T08:07:06,Zarautz,Expense,transport,-81.11,-13458.52
buyer_2,Carmen,40,ES76209527435549498601,TRX_N-00316-94199384,2022-09-19T14:52:05,Zarautz,Expense,transport,-45.1,-13503.62
buyer_2,Carmen,40,ES76209527435549498601,TRX_N-00317-70385923,2022-09-21T20:47:53,Zarautz,Expense,education,-46.24,-13549.86
buyer_2,Carmen,40,ES76209527435549498601,TRX_N-00318-42151033,2022-09-21T09:32:47,Zarautz,Expense,cash,-100.0,-13649.86
buyer_2,Carmen,40,ES76209527435549498601,TRX_N-00319-67858735,2022-09-22T08:41:04,Zarautz,Expense,food,-99.84,-13749.7
buyer_2,Carmen,40,ES76209527435549498601,TRX_N-00320-62923889,2022-09-24T09:59:54,Zarautz,Expense,clothing,-45.55,-13795.25
buyer_2,Carmen,40,ES76209527435549498601,TRX_N-00321-15858485,2022-09-25T14:21:23,Zarautz,Expense,clothing,-125.46,-13920.71
buyer_2,Carmen,40,ES76209527435549498601,TRX_N-00322-31779771,2022-09-26T19:15:59,Zarautz,Expense,leisure,-80.05,-14000.76
buyer_2,Carmen,40,ES76209527435549498601,TRX_N-00323-83303657,2022-09-28T08:47:27,Zarautz,Expense,transport,-83.42,-14084.18
buyer_2,Carmen,40,ES76209527435549498601,TRX_N-00324-76204143,2022-09-28T10:31:25,Zarautz,Expense,education,-42.85,-14127.03
buyer_2,Carmen,40,ES76209527435549498601,TRX_N-00325-50289039,2022-09-30T16:26:07,Zarautz,Expense,food,-83.64,-14210.67
buyer_2,Carmen,40,ES76209527435549498601,TRX_N-00326-80894700,2022-10-01T17:02:57,Zarautz,incomes,salary,1277.97,-12932.7
buyer_2,Carmen,40,ES76209527435549498601,TRX_N-00327-23135491,2022-10-01T17:02:57,Zarautz,incomes,salary_partner,985.77,-11946.93
buyer_2,Carmen,40,ES76209527435549498601,TRX_N-00328-02195029,2022-10-01T17:50:15,Zarautz,Expense,clothing,-56.47,-12003.4
buyer_2,Carmen,40,ES76209527435549498601,TRX_N-00329-34873384,2022-10-03T23:18:32,Zarautz,expenses,children,-105.63,-12109.03
buyer_2,Carmen,40,ES76209527435549498601,TRX_N-00330-43799574,2022-10-04T08:51:36,Zarautz,expenses,mortgage,-713.14,-12822.17
buyer_2,Carmen,40,ES76209527435549498601,TRX_N-00331-23184877,2022-10-04T11:19:54,Zarautz,Expense,leisure,-78.37,-12900.54
buyer_2,Carmen,40,ES76209527435549498601,TRX_N-00332-06731100,2022-10-05T12:56:25,Zarautz,expenses,internet,-42.0,-12942.54
buyer_2,Carmen,40,ES76209527435549498601,TRX_N-00333-99520850,2022-10-06T22:12:05,Zarautz,expenses,water,-37.83,-12980.37
buyer_2,Carmen,40,ES76209527435549498601,TRX_N-00334-52040925,2022-10-06T10:11:16,Zarautz,expenses,phone,-40.89,-13021.26
buyer_2,Carmen,40,ES76209527435549498601,TRX_N-00335-45371544,2022-10-06T22:07:14,Basauri,Expense,transport,-56.11,-13077.37
buyer_2,Carmen,40,ES76209527435549498601,TRX_N-00336-58508253,2022-10-07T20:05:15,Zarautz,Expense,education,-63.68,-13141.05
buyer_2,Carmen,40,ES76209527435549498601,TRX_N-00337-98677212,2022-10-07T16:19:24,Zarautz,Expense,cash,-100.0,-13241.05
buyer_2,Carmen,40,ES76209527435549498601,TRX_N-00338-26373739,2022-10-08T08:51:59,Zarautz,expenses,gas,-49.61,-13290.66
buyer_2,Carmen,40,ES76209527435549498601,TRX_N-00339-47886816,2022-10-08T12:37:13,Zarautz,expenses,electricity,-45.14,-13335.8
buyer_2,Carmen,40,ES76209527435549498601,TRX_N-00340-35870755,2022-10-09T15:05:29,Zarautz,Expense,repairs,-319.38,-13655.18
buyer_2,Carmen,40,ES76209527435549498601,TRX_N-00341-68564023,2022-10-10T13:08:40,Llodio,Expense,food,-66.69,-13721.87
buyer_2,Carmen,40,ES76209527435549498601,TRX_N-00342-98082309,2022-10-10T19:20:30,Zarautz,Expense,travel,-1413.35,-15135.22
buyer_2,Carmen,40,ES76209527435549498601,TRX_N-00343-39958727,2022-10-12T10:25:46,Llodio,Expense,food,-85.41,-15220.63
buyer_2,Carmen,40,ES76209527435549498601,TRX_N-00344-73670738,2022-10-12T08:31:38,Zarautz,Expense,leisure,-24.56,-15245.19
buyer_2,Carmen,40,ES76209527435549498601,TRX_N-00345-99998069,2022-10-12T19:53:44,Zarautz,Expense,education,-64.14,-15309.33
buyer_2,Carmen,40,ES76209527435549498601,TRX_N-00346-43161701,2022-10-13T11:07:25,Andoain,Expense,clothing,-146.05,-15455.38
buyer_2,Carmen,40,ES76209527435549498601,TRX_N-00347-81088612,2022-10-14T14:39:21,Zarautz,Expense,food,-96.47,-15551.85
buyer_2,Carmen,40,ES76209527435549498601,TRX_N-00348-47256692,2022-10-14T22:03:50,Zarautz,Expense,leisure,-50.19,-15602.04
buyer_2,Carmen,40,ES76209527435549498601,TRX_N-00349-57975419,2022-10-15T20:12:48,Zarautz,Expense,cash,-100.0,-15702.04
buyer_2,Carmen,40,ES76209527435549498601,TRX_N-00350-26350882,2022-10-17T15:31:23,Zarautz,Expense,food,-119.06,-15821.1
buyer_2,Carmen,40,ES76209527435549498601,TRX_N-00351-09830145,2022-10-19T13:17:26,Iru√±a de Oca,Expense,cash,-100.0,-15921.1
buyer_2,Carmen,40,ES76209527435549498601,TRX_N-00352-74440169,2022-10-20T17:48:11,Zarautz,Expense,transport,-63.25,-15984.35
buyer_2,Carmen,40,ES76209527435549498601,TRX_N-00353-84070959,2022-10-20T17:25:35,Zarautz,Expense,leisure,-59.42,-16043.77
buyer_2,Carmen,40,ES76209527435549498601,TRX_N-00354-93646074,2022-10-21T09:50:06,Zarautz,Expense,leisure,-52.31,-16096.08
buyer_2,Carmen,40,ES76209527435549498601,TRX_N-00355-03131969,2022-10-21T17:38:05,Zarautz,expenses,children,-241.8,-16337.88
buyer_2,Carmen,40,ES76209527435549498601,TRX_N-00356-56966119,2022-10-25T00:09:32,Zarautz,Expense,repairs,-210.58,-16548.46
buyer_2,Carmen,40,ES76209527435549498601,TRX_N-00357-07410416,2022-10-26T01:36:37,Donostia,Expense,repairs,-189.26,-16737.72
buyer_2,Carmen,40,ES76209527435549498601,TRX_N-00358-68141344,2022-10-30T16:29:32,Zarautz,Expense,transport,-60.64,-16798.36
buyer_2,Carmen,40,ES76209527435549498601,TRX_N-00359-66659500,2022-11-01T07:44:14,Zarautz,incomes,salary,1277.97,-15520.39
buyer_2,Carmen,40,ES76209527435549498601,TRX_N-00360-25855505,2022-11-01T07:44:14,Zarautz,incomes,salary_partner,985.77,-14534.62
buyer_2,Carmen,40,ES76209527435549498601,TRX_N-00361-58681360,2022-11-01T11:43:27,Leioa,Expense,cash,-100.0,-14634.62
buyer_2,Carmen,40,ES76209527435549498601,TRX_N-00362-71238924,2022-11-01T23:46:26,Zarautz,Expense,repairs,-306.64,-14941.26
buyer_2,Carmen,40,ES76209527435549498601,TRX_N-00363-92191946,2022-11-02T19:09:14,Zarautz,Expense,cash,-100.0,-15041.26
buyer_2,Carmen,40,ES76209527435549498601,TRX_N-00364-70750064,2022-11-03T16:09:31,Zarautz,Expense,transport,-44.35,-15085.61
buyer_2,Carmen,40,ES76209527435549498601,TRX_N-00365-67090168,2022-11-03T17:50:28,Zarautz,Expense,education,-62.0,-15147.61
buyer_2,Carmen,40,ES76209527435549498601,TRX_N-00366-95685433,2022-11-04T18:36:59,Zarautz,expenses,mortgage,-713.14,-15860.75
buyer_2,Carmen,40,ES76209527435549498601,TRX_N-00367-58800061,2022-11-05T11:48:48,Zarautz,expenses,water,-24.9,-15885.65
buyer_2,Carmen,40,ES76209527435549498601,TRX_N-00368-07321498,2022-11-05T20:48:04,Zarautz,Expense,gifts,-707.14,-16592.79
buyer_2,Carmen,40,ES76209527435549498601,TRX_N-00369-13024077,2022-11-06T14:46:47,Zarautz,expenses,gas,-77.84,-16670.63
buyer_2,Carmen,40,ES76209527435549498601,TRX_N-00370-38861740,2022-11-06T17:02:44,Zarautz,Expense,transport,-60.13,-16730.76
buyer_2,Carmen,40,ES76209527435549498601,TRX_N-00371-27892866,2022-11-07T10:58:10,Zarautz,expenses,electricity,-44.01,-16774.77
buyer_2,Carmen,40,ES76209527435549498601,TRX_N-00372-68671333,2022-11-07T13:11:29,Zarautz,expenses,internet,-42.0,-16816.77
buyer_2,Carmen,40,ES76209527435549498601,TRX_N-00373-37065905,2022-11-08T11:29:40,Zarautz,expenses,phone,-41.02,-16857.79
buyer_2,Carmen,40,ES76209527435549498601,TRX_N-00374-26352607,2022-11-08T13:40:26,Zarautz,Expense,gifts,-738.16,-17595.95
buyer_2,Carmen,40,ES76209527435549498601,TRX_N-00375-20220896,2022-11-09T16:15:33,Zarautz,Expense,transport,-82.63,-17678.58
buyer_2,Carmen,40,ES76209527435549498601,TRX_N-00376-13314122,2022-11-09T08:35:23,Zarautz,Expense,clothing,-84.62,-17763.2
buyer_2,Carmen,40,ES76209527435549498601,TRX_N-00377-74311142,2022-11-09T20:58:19,Zarautz,Expense,repairs,-296.76,-18059.96
buyer_2,Carmen,40,ES76209527435549498601,TRX_N-00378-78444864,2022-11-12T06:25:16,Iru√±a de Oca,Expense,food,-102.37,-18162.33
buyer_2,Carmen,40,ES76209527435549498601,TRX_N-00379-11294823,2022-11-13T17:34:11,Zarautz,Expense,cash,-100.0,-18262.33
buyer_2,Carmen,40,ES76209527435549498601,TRX_N-00380-10944211,2022-11-13T18:57:34,Zarautz,Expense,gifts,-733.61,-18995.94
buyer_2,Carmen,40,ES76209527435549498601,TRX_N-00381-79190918,2022-11-14T15:48:51,Zarautz,Expense,cash,-100.0,-19095.94
buyer_2,Carmen,40,ES76209527435549498601,TRX_N-00382-59204204,2022-11-16T11:48:24,Zarautz,Expense,leisure,-38.45,-19134.39
buyer_2,Carmen,40,ES76209527435549498601,TRX_N-00383-78020633,2022-11-17T09:00:48,Bermeo,Expense,food,-121.28,-19255.67
buyer_2,Carmen,40,ES76209527435549498601,TRX_N-00384-36810586,2022-11-17T09:24:01,Zarautz,Expense,appliances,-255.64,-19511.31
buyer_2,Carmen,40,ES76209527435549498601,TRX_N-00385-73751833,2022-11-19T10:39:01,Portugalete,Expense,food,-79.76,-19591.07
buyer_2,Carmen,40,ES76209527435549498601,TRX_N-00386-93683319,2022-11-19T15:43:10,Zarautz,Expense,leisure,-21.95,-19613.02
buyer_2,Carmen,40,ES76209527435549498601,TRX_N-00387-06326658,2022-11-20T17:42:10,Zarautz,Expense,repairs,-256.68,-19869.7
buyer_2,Carmen,40,ES76209527435549498601,TRX_N-00388-78719440,2022-11-23T15:45:30,Zarautz,Expense,education,-58.78,-19928.48
buyer_2,Carmen,40,ES76209527435549498601,TRX_N-00389-42005538,2022-11-24T19:27:33,Zarautz,Expense,transport,-64.1,-19992.58
buyer_2,Carmen,40,ES76209527435549498601,TRX_N-00390-79281139,2022-11-24T14:41:53,Zarautz,Expense,repairs,-212.08,-20204.66
buyer_2,Carmen,40,ES76209527435549498601,TRX_N-00391-32074833,2022-11-26T23:41:10,Zarautz,Expense,education,-71.88,-20276.54
buyer_2,Carmen,40,ES76209527435549498601,TRX_N-00392-86308323,2022-11-27T18:39:15,Zarautz,Expense,repairs,-132.83,-20409.37
buyer_2,Carmen,40,ES76209527435549498601,TRX_N-00393-73680821,2022-11-28T08:19:40,Zarautz,Expense,transport,-67.72,-20477.09
buyer_2,Carmen,40,ES76209527435549498601,TRX_N-00394-77516423,2022-11-28T19:08:51,Zarautz,Expense,leisure,-52.99,-20530.08
buyer_2,Carmen,40,ES76209527435549498601,TRX_N-00395-14071750,2022-11-30T14:03:53,Zarautz,Expense,clothing,-45.76,-20575.84
buyer_2,Carmen,40,ES76209527435549498601,TRX_N-00396-65994546,2022-11-30T08:57:43,Portugalete,Expense,appliances,-209.79,-20785.63
buyer_2,Carmen,40,ES76209527435549498601,TRX_N-00397-93683342,2022-12-01T08:14:43,Zarautz,incomes,salary,1277.97,-19507.66
buyer_2,Carmen,40,ES76209527435549498601,TRX_N-00398-88493501,2022-12-01T08:14:43,Zarautz,incomes,salary_partner,985.77,-18521.89
buyer_2,Carmen,40,ES76209527435549498601,TRX_N-00399-72635430,2022-12-01T08:14:43,Zarautz,incomes,salary_bonus,900.0,-17621.89
buyer_2,Carmen,40,ES76209527435549498601,TRX_N-00400-40732537,2022-12-01T08:14:43,Zarautz,incomes,salary_partner_bonus,779.56,-16842.33
buyer_2,Carmen,40,ES76209527435549498601,TRX_N-00401-49582799,2022-12-01T16:35:39,Pasaia,Expense,food,-109.97,-16952.3
buyer_2,Carmen,40,ES76209527435549498601,TRX_N-00402-18249957,2022-12-01T08:43:46,Zarautz,Expense,clothing,-63.54,-17015.84
buyer_2,Carmen,40,ES76209527435549498601,TRX_N-00403-93428284,2022-12-03T16:10:56,Zarautz,Expense,transport,-55.42,-17071.26
buyer_2,Carmen,40,ES76209527435549498601,TRX_N-00404-25494997,2022-12-03T15:05:06,Sopela,Expense,leisure,-36.56,-17107.82
buyer_2,Carmen,40,ES76209527435549498601,TRX_N-00405-35053616,2022-12-03T08:41:37,Zarautz,expenses,children,-128.09,-17235.91
buyer_2,Carmen,40,ES76209527435549498601,TRX_N-00406-63711534,2022-12-04T20:48:23,Zarautz,expenses,mortgage,-713.14,-17949.05
buyer_2,Carmen,40,ES76209527435549498601,TRX_N-00407-49732053,2022-12-04T10:18:54,Zarautz,Expense,leisure,-64.86,-18013.91
buyer_2,Carmen,40,ES76209527435549498601,TRX_N-00408-05429888,2022-12-04T10:50:41,Zarautz,Expense,cash,-100.0,-18113.91
buyer_2,Carmen,40,ES76209527435549498601,TRX_N-00409-15877457,2022-12-04T19:43:42,Zarautz,expenses,children,-232.09,-18346.0
buyer_2,Carmen,40,ES76209527435549498601,TRX_N-00410-68124903,2022-12-06T08:52:33,Zarautz,expenses,electricity,-56.79,-18402.79
buyer_2,Carmen,40,ES76209527435549498601,TRX_N-00411-50315365,2022-12-06T20:19:42,Sestao,Expense,leisure,-28.16,-18430.95
buyer_2,Carmen,40,ES76209527435549498601,TRX_N-00412-21121231,2022-12-06T15:29:27,Vitoria-Gasteiz,Expense,cash,-100.0,-18530.95
buyer_2,Carmen,40,ES76209527435549498601,TRX_N-00413-47331354,2022-12-07T09:15:44,Zarautz,expenses,water,-22.6,-18553.55
buyer_2,Carmen,40,ES76209527435549498601,TRX_N-00414-22740255,2022-12-07T18:42:35,Zarautz,expenses,gas,-56.97,-18610.52
buyer_2,Carmen,40,ES76209527435549498601,TRX_N-00415-63719344,2022-12-08T09:46:23,Zarautz,expenses,internet,-42.0,-18652.52
buyer_2,Carmen,40,ES76209527435549498601,TRX_N-00416-94918411,2022-12-08T09:02:13,Zarautz,expenses,phone,-31.2,-18683.72
buyer_2,Carmen,40,ES76209527435549498601,TRX_N-00417-76941987,2022-12-09T12:16:45,Zarautz,Expense,cash,-100.0,-18783.72
buyer_2,Carmen,40,ES76209527435549498601,TRX_N-00418-87324713,2022-12-11T08:58:04,Zarautz,Expense,clothing,-86.02,-18869.74
buyer_2,Carmen,40,ES76209527435549498601,TRX_N-00419-77296616,2022-12-12T19:26:53,Zarautz,Expense,cash,-100.0,-18969.74
buyer_2,Carmen,40,ES76209527435549498601,TRX_N-00420-51173090,2022-12-13T11:12:01,Zarautz,Expense,healthcare,-98.84,-19068.58
buyer_2,Carmen,40,ES76209527435549498601,TRX_N-00421-32834221,2022-12-13T11:59:29,Zarautz,Expense,gifts,-474.6,-19543.18
buyer_2,Carmen,40,ES76209527435549498601,TRX_N-00422-58767908,2022-12-14T14:17:53,Zarautz,Expense,transport,-49.97,-19593.15
buyer_2,Carmen,40,ES76209527435549498601,TRX_N-00423-29205640,2022-12-14T08:52:57,Zarautz,Expense,appliances,-169.74,-19762.89
buyer_2,Carmen,40,ES76209527435549498601,TRX_N-00424-21178495,2022-12-16T10:25:49,Zarautz,Expense,cash,-100.0,-19862.89
buyer_2,Carmen,40,ES76209527435549498601,TRX_N-00425-12842544,2022-12-16T12:37:11,Zarautz,Expense,repairs,-28.06,-19890.95
buyer_2,Carmen,40,ES76209527435549498601,TRX_N-00426-95710220,2022-12-17T09:27:42,Zarautz,expenses,children,-187.1,-20078.05
buyer_2,Carmen,40,ES76209527435549498601,TRX_N-00427-78861800,2022-12-19T18:14:03,Zarautz,Expense,food,-94.48,-20172.53
buyer_2,Carmen,40,ES76209527435549498601,TRX_N-00428-95251885,2022-12-20T16:05:05,Zarautz,expenses,children,-66.75,-20239.28
buyer_2,Carmen,40,ES76209527435549498601,TRX_N-00429-92025189,2022-12-22T15:22:09,Zarautz,Expense,leisure,-72.83,-20312.11
buyer_2,Carmen,40,ES76209527435549498601,TRX_N-00430-18130844,2022-12-22T09:01:53,Zarautz,Expense,repairs,-110.27,-20422.38
buyer_2,Carmen,40,ES76209527435549498601,TRX_N-00431-96067460,2022-12-23T19:18:04,Hernani,Expense,food,-102.97,-20525.35
buyer_2,Carmen,40,ES76209527435549498601,TRX_N-00432-61845892,2022-12-24T10:58:55,Zarautz,Expense,cash,-100.0,-20625.35
buyer_2,Carmen,40,ES76209527435549498601,TRX_N-00433-36229839,2022-12-25T23:35:17,Zarautz,Expense,leisure,-83.11,-20708.46
buyer_2,Carmen,40,ES76209527435549498601,TRX_N-00434-62334902,2022-12-26T16:16:26,Zarautz,Expense,food,-118.48,-20826.94
buyer_2,Carmen,40,ES76209527435549498601,TRX_N-00435-83399140,2022-12-27T18:01:16,Zarautz,Expense,cash,-100.0,-20926.94
buyer_2,Carmen,40,ES76209527435549498601,TRX_N-00436-89579244,2022-12-29T11:05:53,Zarautz,Expense,healthcare,-129.0,-21055.94
buyer_2,Carmen,40,ES76209527435549498601,TRX_N-00437-84630388,2022-12-30T09:53:08,Zarautz,Expense,clothing,-138.81,-21194.75
buyer_2,Carmen,40,ES76209527435549498601,TRX_N-00438-78408705,2023-01-01T13:45:05,Zarautz,incomes,salary,1322.05,-19872.7
buyer_2,Carmen,40,ES76209527435549498601,TRX_N-00439-49135695,2023-01-01T13:45:05,Zarautz,incomes,salary_partner,1019.77,-18852.93
buyer_2,Carmen,40,ES76209527435549498601,TRX_N-00440-05021248,2023-01-01T13:45:05,Zarautz,incomes,extra_income,144.79,-18708.14
buyer_2,Carmen,40,ES76209527435549498601,TRX_N-00441-07417554,2023-01-04T13:02:19,Zarautz,expenses,mortgage,-713.14,-19421.28
buyer_2,Carmen,40,ES76209527435549498601,TRX_N-00442-09028120,2023-01-04T09:58:15,Zarautz,Expense,food,-104.58,-19525.86
buyer_2,Carmen,40,ES76209527435549498601,TRX_N-00443-17530892,2023-01-04T17:03:28,Zarautz,Expense,transport,-80.88,-19606.74
buyer_2,Carmen,40,ES76209527435549498601,TRX_N-00444-21808341,2023-01-05T11:28:28,Zarautz,expenses,electricity,-56.86,-19663.6
buyer_2,Carmen,40,ES76209527435549498601,TRX_N-00445-06233901,2023-01-05T19:48:42,Zarautz,expenses,gas,-48.68,-19712.28
buyer_2,Carmen,40,ES76209527435549498601,TRX_N-00446-61362840,2023-01-05T14:21:10,Galdakao,Expense,cash,-100.0,-19812.28
buyer_2,Carmen,40,ES76209527435549498601,TRX_N-00447-28604498,2023-01-06T12:15:32,Zarautz,expenses,phone,-42.29,-19854.57
buyer_2,Carmen,40,ES76209527435549498601,TRX_N-00448-91868175,2023-01-06T11:32:44,Zarautz,Expense,transport,-86.87,-19941.44
buyer_2,Carmen,40,ES76209527435549498601,TRX_N-00449-14436774,2023-01-06T00:58:43,Zarautz,Expense,healthcare,-70.65,-20012.09
buyer_2,Carmen,40,ES76209527435549498601,TRX_N-00450-42966626,2023-01-07T08:21:32,Zarautz,Expense,transport,-41.23,-20053.32
buyer_2,Carmen,40,ES76209527435549498601,TRX_N-00451-95864444,2023-01-08T19:39:28,Zarautz,expenses,water,-34.93,-20088.25
buyer_2,Carmen,40,ES76209527435549498601,TRX_N-00452-74657558,2023-01-08T12:39:29,Zarautz,expenses,internet,-42.0,-20130.25
buyer_2,Carmen,40,ES76209527435549498601,TRX_N-00453-01983254,2023-01-09T14:34:38,Zarautz,Expense,transport,-41.69,-20171.94
buyer_2,Carmen,40,ES76209527435549498601,TRX_N-00454-79350673,2023-01-09T10:45:34,Zarautz,Expense,leisure,-34.21,-20206.15
buyer_2,Carmen,40,ES76209527435549498601,TRX_N-00455-18874021,2023-01-09T18:21:45,Galdakao,Expense,healthcare,-155.84,-20361.99
buyer_2,Carmen,40,ES76209527435549498601,TRX_N-00456-71223176,2023-01-10T14:05:10,Sopela,Expense,gifts,-422.4,-20784.39
buyer_2,Carmen,40,ES76209527435549498601,TRX_N-00457-30572957,2023-01-11T16:26:47,Zarautz,Expense,food,-71.84,-20856.23
buyer_2,Carmen,40,ES76209527435549498601,TRX_N-00458-09338925,2023-01-11T09:16:31,Zarautz,Expense,transport,-68.25,-20924.48
buyer_2,Carmen,40,ES76209527435549498601,TRX_N-00459-74991411,2023-01-12T08:05:43,Zarautz,Expense,cash,-100.0,-21024.48
buyer_2,Carmen,40,ES76209527435549498601,TRX_N-00460-69804744,2023-01-12T20:17:47,Zarautz,Expense,gifts,-404.17,-21428.65
buyer_2,Carmen,40,ES76209527435549498601,TRX_N-00461-73595284,2023-01-13T19:07:43,Zarautz,Expense,cash,-100.0,-21528.65
buyer_2,Carmen,40,ES76209527435549498601,TRX_N-00462-82126304,2023-01-13T15:20:01,Berango,Expense,appliances,-212.6,-21741.25
buyer_2,Carmen,40,ES76209527435549498601,TRX_N-00463-44681059,2023-01-13T16:24:19,Zarautz,Expense,gifts,-522.69,-22263.94
buyer_2,Carmen,40,ES76209527435549498601,TRX_N-00464-82607600,2023-01-15T15:27:39,Eibar,Expense,repairs,-237.32,-22501.26
buyer_2,Carmen,40,ES76209527435549498601,TRX_N-00465-99769831,2023-01-16T22:16:14,Zarautz,Expense,gifts,-773.66,-23274.92
buyer_2,Carmen,40,ES76209527435549498601,TRX_N-00466-87994785,2023-01-17T11:28:33,Zarautz,Expense,transport,-72.55,-23347.47
buyer_2,Carmen,40,ES76209527435549498601,TRX_N-00467-48532193,2023-01-17T19:15:19,Zarautz,Expense,leisure,-80.91,-23428.38
buyer_2,Carmen,40,ES76209527435549498601,TRX_N-00468-00732419,2023-01-18T13:44:52,Zarautz,Expense,transport,-48.02,-23476.4
buyer_2,Carmen,40,ES76209527435549498601,TRX_N-00469-65049816,2023-01-19T11:09:04,Zarautz,Expense,travel,-872.07,-24348.47
buyer_2,Carmen,40,ES76209527435549498601,TRX_N-00470-33890145,2023-01-23T05:22:58,Zarautz,Expense,gifts,-457.82,-24806.29
buyer_2,Carmen,40,ES76209527435549498601,TRX_N-00471-07690714,2023-01-24T08:47:59,Getxo,Expense,food,-92.87,-24899.16
buyer_2,Carmen,40,ES76209527435549498601,TRX_N-00472-88087013,2023-01-24T18:18:24,Zarautz,Expense,repairs,-56.03,-24955.19
buyer_2,Carmen,40,ES76209527435549498601,TRX_N-00473-24524879,2023-01-25T09:35:31,Zarautz,Expense,food,-76.19,-25031.38
buyer_2,Carmen,40,ES76209527435549498601,TRX_N-00474-55581543,2023-01-25T20:58:46,Zarautz,Expense,cash,-100.0,-25131.38
buyer_2,Carmen,40,ES76209527435549498601,TRX_N-00475-97812012,2023-01-25T19:22:42,Zarautz,Expense,gifts,-224.53,-25355.91
buyer_2,Carmen,40,ES76209527435549498601,TRX_N-00476-22552768,2023-01-26T18:48:19,Zarautz,Expense,clothing,-83.15,-25439.06
buyer_2,Carmen,40,ES76209527435549498601,TRX_N-00477-50357514,2023-01-27T20:34:55,Zarautz,expenses,children,-83.27,-25522.33
buyer_2,Carmen,40,ES76209527435549498601,TRX_N-00478-36084384,2023-01-29T05:31:50,Zarautz,Expense,food,-111.51,-25633.84
buyer_2,Carmen,40,ES76209527435549498601,TRX_N-00479-56325381,2023-01-30T18:01:16,Zarautz,Expense,food,-63.51,-25697.35
buyer_2,Carmen,40,ES76209527435549498601,TRX_N-00480-46808610,2023-01-30T09:59:00,Zarautz,Expense,cash,-100.0,-25797.35
buyer_2,Carmen,40,ES76209527435549498601,TRX_N-00481-18579701,2023-02-01T08:45:31,Zarautz,incomes,salary,1322.05,-24475.3
buyer_2,Carmen,40,ES76209527435549498601,TRX_N-00482-50927315,2023-02-01T08:45:31,Zarautz,incomes,salary_partner,1019.77,-23455.53
buyer_2,Carmen,40,ES76209527435549498601,TRX_N-00483-90601196,2023-02-04T12:47:10,Zarautz,expenses,mortgage,-713.14,-24168.67
buyer_2,Carmen,40,ES76209527435549498601,TRX_N-00484-50551966,2023-02-05T13:42:13,Zarautz,expenses,water,-36.4,-24205.07
buyer_2,Carmen,40,ES76209527435549498601,TRX_N-00485-92181228,2023-02-05T13:37:32,Zarautz,expenses,phone,-39.67,-24244.74
buyer_2,Carmen,40,ES76209527435549498601,TRX_N-00486-86246596,2023-02-06T19:56:46,Arrasate,Expense,transport,-72.86,-24317.6
buyer_2,Carmen,40,ES76209527435549498601,TRX_N-00487-81169292,2023-02-08T14:05:10,Zarautz,expenses,gas,-102.29,-24419.89
buyer_2,Carmen,40,ES76209527435549498601,TRX_N-00488-31781933,2023-02-08T14:35:18,Zarautz,expenses,electricity,-75.77,-24495.66
buyer_2,Carmen,40,ES76209527435549498601,TRX_N-00489-67653455,2023-02-08T14:09:24,Zarautz,expenses,internet,-42.0,-24537.66
buyer_2,Carmen,40,ES76209527435549498601,TRX_N-00490-94949452,2023-02-08T09:56:45,Zarautz,Expense,food,-115.37,-24653.03
buyer_2,Carmen,40,ES76209527435549498601,TRX_N-00491-05454034,2023-02-08T10:05:28,Berango,Expense,cash,-100.0,-24753.03
buyer_2,Carmen,40,ES76209527435549498601,TRX_N-00492-27942934,2023-02-08T18:07:04,Zarautz,Expense,gifts,-496.28,-25249.31
buyer_2,Carmen,40,ES76209527435549498601,TRX_N-00493-97330553,2023-02-09T19:17:07,Zarautz,Expense,food,-87.86,-25337.17
buyer_2,Carmen,40,ES76209527435549498601,TRX_N-00494-48131384,2023-02-10T12:57:43,Zuia,Expense,clothing,-94.4,-25431.57
buyer_2,Carmen,40,ES76209527435549498601,TRX_N-00495-26653358,2023-02-10T12:20:38,Zarautz,Expense,cash,-100.0,-25531.57
buyer_2,Carmen,40,ES76209527435549498601,TRX_N-00496-65171284,2023-02-11T17:08:11,Zarautz,Expense,transport,-74.18,-25605.75
buyer_2,Carmen,40,ES76209527435549498601,TRX_N-00497-04542264,2023-02-11T18:13:51,Zarautz,Expense,appliances,-204.34,-25810.09
buyer_2,Carmen,40,ES76209527435549498601,TRX_N-00498-15028982,2023-02-14T03:36:42,Zarautz,Expense,transport,-78.21,-25888.3
buyer_2,Carmen,40,ES76209527435549498601,TRX_N-00499-16033486,2023-02-15T09:02:57,Zarautz,Expense,travel,-946.4,-26834.7
buyer_2,Carmen,40,ES76209527435549498601,TRX_N-00500-38585215,2023-02-15T20:13:44,Zarautz,expenses,children,-129.48,-26964.18
buyer_2,Carmen,40,ES76209527435549498601,TRX_N-00501-16983666,2023-02-17T21:48:38,Eibar,Expense,transport,-56.76,-27020.94
buyer_2,Carmen,40,ES76209527435549498601,TRX_N-00502-06159678,2023-02-19T14:28:05,Zarautz,Expense,healthcare,-54.91,-27075.85
buyer_2,Carmen,40,ES76209527435549498601,TRX_N-00503-15662092,2023-02-19T10:02:25,Zarautz,Expense,travel,-1881.76,-28957.61
buyer_2,Carmen,40,ES76209527435549498601,TRX_N-00504-35417964,2023-02-20T14:26:40,Zarautz,expenses,children,-263.92,-29221.53
buyer_2,Carmen,40,ES76209527435549498601,TRX_N-00505-22728381,2023-02-22T23:54:02,Zarautz,Expense,repairs,-194.72,-29416.25
buyer_2,Carmen,40,ES76209527435549498601,TRX_N-00506-42507291,2023-02-23T17:20:19,Zarautz,Expense,food,-113.59,-29529.84
buyer_2,Carmen,40,ES76209527435549498601,TRX_N-00507-70701056,2023-02-23T09:49:22,Zarautz,Expense,education,-46.8,-29576.64
buyer_2,Carmen,40,ES76209527435549498601,TRX_N-00508-24890530,2023-02-23T22:06:37,Zarautz,Expense,cash,-100.0,-29676.64
buyer_2,Carmen,40,ES76209527435549498601,TRX_N-00509-05149842,2023-02-24T18:00:43,Zarautz,Expense,food,-117.77,-29794.41
buyer_2,Carmen,40,ES76209527435549498601,TRX_N-00510-28312850,2023-02-24T20:42:19,Zarautz,Expense,leisure,-79.96,-29874.37
buyer_2,Carmen,40,ES76209527435549498601,TRX_N-00511-61581848,2023-02-24T14:28:25,Zarautz,Expense,cash,-100.0,-29974.37
buyer_2,Carmen,40,ES76209527435549498601,TRX_N-00512-27727295,2023-02-25T20:17:33,Zarautz,Expense,leisure,-20.09,-29994.46
buyer_2,Carmen,40,ES76209527435549498601,TRX_N-00513-97634146,2023-02-25T16:54:00,Zarautz,Expense,healthcare,-119.45,-30113.91
buyer_2,Carmen,40,ES76209527435549498601,TRX_N-00514-35086800,2023-02-25T19:45:43,Zarautz,expenses,children,-56.96,-30170.87
buyer_2,Carmen,40,ES76209527435549498601,TRX_N-00515-47381677,2023-02-27T12:26:02,Arrasate,Expense,food,-107.21,-30278.08
buyer_2,Carmen,40,ES76209527435549498601,TRX_N-00516-28731868,2023-03-01T01:58:56,Zarautz,incomes,salary,1322.05,-28956.03
buyer_2,Carmen,40,ES76209527435549498601,TRX_N-00517-55606317,2023-03-01T01:58:56,Zarautz,incomes,salary_partner,1019.77,-27936.26
buyer_2,Carmen,40,ES76209527435549498601,TRX_N-00518-57380597,2023-03-01T20:48:54,Iru√±a de Oca,Expense,food,-80.45,-28016.71
buyer_2,Carmen,40,ES76209527435549498601,TRX_N-00519-80952873,2023-03-01T17:58:12,Zarautz,Expense,repairs,-107.8,-28124.51
buyer_2,Carmen,40,ES76209527435549498601,TRX_N-00520-96016443,2023-03-02T05:25:15,Zarautz,Expense,cash,-100.0,-28224.51
buyer_2,Carmen,40,ES76209527435549498601,TRX_N-00521-67937849,2023-03-03T15:30:24,Zarautz,Expense,transport,-84.3,-28308.81
buyer_2,Carmen,40,ES76209527435549498601,TRX_N-00522-22751571,2023-03-04T14:52:38,Zarautz,expenses,mortgage,-713.14,-29021.95
buyer_2,Carmen,40,ES76209527435549498601,TRX_N-00523-62446792,2023-03-04T10:42:29,Zarautz,Expense,education,-68.65,-29090.6
buyer_2,Carmen,40,ES76209527435549498601,TRX_N-00524-89301796,2023-03-04T19:51:47,Zarautz,Expense,cash,-100.0,-29190.6
buyer_2,Carmen,40,ES76209527435549498601,TRX_N-00525-67771350,2023-03-04T04:51:29,Zarautz,Expense,repairs,-197.67,-29388.27
buyer_2,Carmen,40,ES76209527435549498601,TRX_N-00526-17409609,2023-03-06T15:06:15,Zarautz,expenses,water,-29.27,-29417.54
buyer_2,Carmen,40,ES76209527435549498601,TRX_N-00527-02541742,2023-03-06T18:34:06,Zarautz,expenses,internet,-42.0,-29459.54
buyer_2,Carmen,40,ES76209527435549498601,TRX_N-00528-17031920,2023-03-06T12:45:14,Zarautz,expenses,phone,-30.54,-29490.08
buyer_2,Carmen,40,ES76209527435549498601,TRX_N-00529-57954301,2023-03-06T00:04:35,Zarautz,Expense,transport,-86.34,-29576.42
buyer_2,Carmen,40,ES76209527435549498601,TRX_N-00530-27390189,2023-03-07T10:25:23,Hernani,Expense,food,-96.14,-29672.56
buyer_2,Carmen,40,ES76209527435549498601,TRX_N-00531-27939800,2023-03-08T14:27:52,Zarautz,expenses,electricity,-65.41,-29737.97
buyer_2,Carmen,40,ES76209527435549498601,TRX_N-00532-28015320,2023-03-08T20:34:26,Zarautz,expenses,gas,-107.06,-29845.03
buyer_2,Carmen,40,ES76209527435549498601,TRX_N-00533-29264595,2023-03-08T19:48:34,Zarautz,Expense,gifts,-273.07,-30118.1
buyer_2,Carmen,40,ES76209527435549498601,TRX_N-00534-19661692,2023-03-09T14:47:35,Zarautz,Expense,transport,-50.41,-30168.51
buyer_2,Carmen,40,ES76209527435549498601,TRX_N-00535-30378238,2023-03-09T15:53:08,Zarautz,Expense,leisure,-29.95,-30198.46
buyer_2,Carmen,40,ES76209527435549498601,TRX_N-00536-43204142,2023-03-11T21:56:20,Zarautz,Expense,leisure,-73.2,-30271.66
buyer_2,Carmen,40,ES76209527435549498601,TRX_N-00537-55495260,2023-03-12T07:05:58,Zarautz,Expense,repairs,-285.14,-30556.8
buyer_2,Carmen,40,ES76209527435549498601,TRX_N-00538-05756058,2023-03-14T09:50:06,Elciego,Expense,gifts,-787.68,-31344.48
buyer_2,Carmen,40,ES76209527435549498601,TRX_N-00539-85181869,2023-03-15T17:01:13,Zarautz,Expense,food,-95.16,-31439.64
buyer_2,Carmen,40,ES76209527435549498601,TRX_N-00540-57873447,2023-03-16T13:15:15,Zarautz,Expense,cash,-100.0,-31539.64
buyer_2,Carmen,40,ES76209527435549498601,TRX_N-00541-46201161,2023-03-17T03:26:23,Zarautz,Expense,repairs,-84.98,-31624.62
buyer_2,Carmen,40,ES76209527435549498601,TRX_N-00542-63962496,2023-03-18T16:53:21,Zarautz,Expense,food,-89.33,-31713.95
buyer_2,Carmen,40,ES76209527435549498601,TRX_N-00543-35484171,2023-03-18T15:57:26,Zarautz,Expense,appliances,-141.05,-31855.0
buyer_2,Carmen,40,ES76209527435549498601,TRX_N-00544-85653165,2023-03-19T14:07:39,Zarautz,Expense,food,-81.02,-31936.02
buyer_2,Carmen,40,ES76209527435549498601,TRX_N-00545-99864599,2023-03-19T20:02:03,Zarautz,Expense,cash,-100.0,-32036.02
buyer_2,Carmen,40,ES76209527435549498601,TRX_N-00546-51396458,2023-03-20T19:41:37,Zarautz,Expense,cash,-100.0,-32136.02
buyer_2,Carmen,40,ES76209527435549498601,TRX_N-00547-75168423,2023-03-21T10:30:01,Zarautz,Expense,cash,-100.0,-32236.02
buyer_2,Carmen,40,ES76209527435549498601,TRX_N-00548-57838112,2023-03-22T16:42:46,Zarautz,Expense,food,-90.35,-32326.37
buyer_2,Carmen,40,ES76209527435549498601,TRX_N-00549-93566847,2023-03-25T16:55:28,Zarautz,Expense,food,-62.5,-32388.87
buyer_2,Carmen,40,ES76209527435549498601,TRX_N-00550-79411243,2023-03-25T12:56:02,Zarautz,Expense,leisure,-69.49,-32458.36
buyer_2,Carmen,40,ES76209527435549498601,TRX_N-00551-62745098,2023-03-25T15:29:03,Zarautz,Expense,cash,-100.0,-32558.36
buyer_2,Carmen,40,ES76209527435549498601,TRX_N-00552-07609816,2023-03-26T08:49:28,Zarautz,Expense,leisure,-22.95,-32581.31
buyer_2,Carmen,40,ES76209527435549498601,TRX_N-00553-08659662,2023-03-27T18:43:53,Zarautz,Expense,food,-107.34,-32688.65
buyer_2,Carmen,40,ES76209527435549498601,TRX_N-00554-03655383,2023-03-29T22:35:05,Zarautz,Expense,cash,-100.0,-32788.65
buyer_2,Carmen,40,ES76209527435549498601,TRX_N-00555-77741389,2023-03-30T23:09:54,Zarautz,Expense,transport,-56.81,-32845.46
buyer_2,Carmen,40,ES76209527435549498601,TRX_N-00556-02447495,2023-03-31T11:10:43,Zarautz,Expense,transport,-40.41,-32885.87
buyer_2,Carmen,40,ES76209527435549498601,TRX_N-00557-58377634,2023-04-01T17:13:01,Zarautz,incomes,salary,1322.05,-31563.82
buyer_2,Carmen,40,ES76209527435549498601,TRX_N-00558-81937048,2023-04-01T17:13:01,Zarautz,incomes,salary_partner,1019.77,-30544.05
buyer_2,Carmen,40,ES76209527435549498601,TRX_N-00559-13066086,2023-04-02T02:04:55,Zarautz,Expense,healthcare,-186.21,-30730.26
buyer_2,Carmen,40,ES76209527435549498601,TRX_N-00560-04061477,2023-04-03T23:35:17,Zarautz,Expense,food,-118.65,-30848.91
buyer_2,Carmen,40,ES76209527435549498601,TRX_N-00561-05213537,2023-04-03T08:34:23,Bilbao,Expense,leisure,-43.8,-30892.71
buyer_2,Carmen,40,ES76209527435549498601,TRX_N-00562-48715072,2023-04-03T08:12:23,Zarautz,Expense,education,-60.5,-30953.21
buyer_2,Carmen,40,ES76209527435549498601,TRX_N-00563-10700225,2023-04-04T18:48:49,Zarautz,expenses,mortgage,-713.14,-31666.35
buyer_2,Carmen,40,ES76209527435549498601,TRX_N-00564-56621176,2023-04-05T10:34:59,Zarautz,expenses,water,-24.1,-31690.45
buyer_2,Carmen,40,ES76209527435549498601,TRX_N-00565-92285848,2023-04-05T17:37:55,Zarautz,expenses,internet,-42.0,-31732.45
buyer_2,Carmen,40,ES76209527435549498601,TRX_N-00566-76055502,2023-04-06T14:36:15,Zarautz,Expense,food,-90.9,-31823.35
buyer_2,Carmen,40,ES76209527435549498601,TRX_N-00567-45759138,2023-04-06T19:15:12,Zarautz,Expense,cash,-100.0,-31923.35
buyer_2,Carmen,40,ES76209527435549498601,TRX_N-00568-72478146,2023-04-07T12:59:54,Zarautz,Expense,gifts,-848.67,-32772.02
buyer_2,Carmen,40,ES76209527435549498601,TRX_N-00569-04178802,2023-04-08T16:39:57,Zarautz,expenses,electricity,-85.7,-32857.72
buyer_2,Carmen,40,ES76209527435549498601,TRX_N-00570-66556459,2023-04-08T09:32:22,Zarautz,expenses,gas,-107.35,-32965.07
buyer_2,Carmen,40,ES76209527435549498601,TRX_N-00571-47501702,2023-04-08T15:29:56,Zarautz,expenses,phone,-39.74,-33004.81
buyer_2,Carmen,40,ES76209527435549498601,TRX_N-00572-25498266,2023-04-09T07:26:56,Zarautz,Expense,transport,-75.71,-33080.52
buyer_2,Carmen,40,ES76209527435549498601,TRX_N-00573-69834157,2023-04-11T07:40:26,Zarautz,Expense,clothing,-55.34,-33135.86
buyer_2,Carmen,40,ES76209527435549498601,TRX_N-00574-02902891,2023-04-11T08:34:40,Zarautz,Expense,gifts,-690.13,-33825.99
buyer_2,Carmen,40,ES76209527435549498601,TRX_N-00575-65168439,2023-04-13T20:50:25,Zarautz,Expense,food,-67.35,-33893.34
buyer_2,Carmen,40,ES76209527435549498601,TRX_N-00576-91226044,2023-04-16T18:46:04,Zarautz,Expense,leisure,-40.95,-33934.29
buyer_2,Carmen,40,ES76209527435549498601,TRX_N-00577-71886371,2023-04-16T20:06:38,Zarautz,Expense,education,-71.21,-34005.5
buyer_2,Carmen,40,ES76209527435549498601,TRX_N-00578-69601789,2023-04-18T13:11:52,Zarautz,Expense,food,-61.59,-34067.09
buyer_2,Carmen,40,ES76209527435549498601,TRX_N-00579-69733212,2023-04-18T11:46:27,Zarautz,Expense,leisure,-20.78,-34087.87
buyer_2,Carmen,40,ES76209527435549498601,TRX_N-00580-66267440,2023-04-19T15:13:14,Santurtzi,Expense,food,-115.89,-34203.76
buyer_2,Carmen,40,ES76209527435549498601,TRX_N-00581-78869595,2023-04-21T09:43:54,Zarautz,Expense,leisure,-58.62,-34262.38
buyer_2,Carmen,40,ES76209527435549498601,TRX_N-00582-89974920,2023-04-21T16:06:33,Zarautz,Expense,repairs,-326.13,-34588.51
buyer_2,Carmen,40,ES76209527435549498601,TRX_N-00583-06553606,2023-04-22T13:27:06,Zarautz,Expense,repairs,-128.29,-34716.8
buyer_2,Carmen,40,ES76209527435549498601,TRX_N-00584-77403438,2023-04-23T19:36:43,Zarautz,Expense,cash,-100.0,-34816.8
buyer_2,Carmen,40,ES76209527435549498601,TRX_N-00585-55994351,2023-04-24T09:07:00,Zarautz,Expense,food,-88.69,-34905.49
buyer_2,Carmen,40,ES76209527435549498601,TRX_N-00586-88747096,2023-04-25T17:18:00,Zarautz,Expense,transport,-71.54,-34977.03
buyer_2,Carmen,40,ES76209527435549498601,TRX_N-00587-69798675,2023-04-26T13:27:01,Zarautz,Expense,cash,-100.0,-35077.03
buyer_2,Carmen,40,ES76209527435549498601,TRX_N-00588-51855713,2023-04-27T17:50:39,Zarautz,Expense,food,-121.43,-35198.46
buyer_2,Carmen,40,ES76209527435549498601,TRX_N-00589-67759399,2023-04-27T12:29:09,Zarautz,Expense,travel,-1519.49,-36717.95
buyer_2,Carmen,40,ES76209527435549498601,TRX_N-00590-01939577,2023-04-28T06:41:24,Oy√≥n-Oion,Expense,leisure,-29.88,-36747.83
buyer_2,Carmen,40,ES76209527435549498601,TRX_N-00591-47629647,2023-04-29T13:38:16,Zarautz,Expense,cash,-100.0,-36847.83
buyer_2,Carmen,40,ES76209527435549498601,TRX_N-00592-25431078,2023-05-01T08:13:23,Zarautz,incomes,salary,1322.05,-35525.78
buyer_2,Carmen,40,ES76209527435549498601,TRX_N-00593-92175550,2023-05-01T08:13:23,Zarautz,incomes,salary_partner,1019.77,-34506.01
buyer_2,Carmen,40,ES76209527435549498601,TRX_N-00594-78053792,2023-05-01T08:13:23,Zarautz,incomes,extra_income,144.79,-34361.22
buyer_2,Carmen,40,ES76209527435549498601,TRX_N-00595-70727856,2023-05-01T16:39:35,Errenteria,Expense,leisure,-18.93,-34380.15
buyer_2,Carmen,40,ES76209527435549498601,TRX_N-00596-47090637,2023-05-04T16:26:21,Zarautz,expenses,mortgage,-713.14,-35093.29
buyer_2,Carmen,40,ES76209527435549498601,TRX_N-00597-95611671,2023-05-04T21:14:58,Zarautz,Expense,cash,-100.0,-35193.29
buyer_2,Carmen,40,ES76209527435549498601,TRX_N-00598-76374618,2023-05-05T17:25:38,Zarautz,expenses,electricity,-80.13,-35273.42
buyer_2,Carmen,40,ES76209527435549498601,TRX_N-00599-41080104,2023-05-05T00:50:22,Zarautz,expenses,gas,-65.18,-35338.6
buyer_2,Carmen,40,ES76209527435549498601,TRX_N-00600-08987176,2023-05-05T10:32:17,Zarautz,expenses,internet,-42.0,-35380.6
buyer_2,Carmen,40,ES76209527435549498601,TRX_N-00601-59151858,2023-05-05T12:14:39,Zarautz,Expense,leisure,-20.49,-35401.09
buyer_2,Carmen,40,ES76209527435549498601,TRX_N-00602-54232708,2023-05-07T14:56:30,Zarautz,expenses,phone,-44.25,-35445.34
buyer_2,Carmen,40,ES76209527435549498601,TRX_N-00603-11784931,2023-05-08T20:11:51,Zarautz,expenses,water,-32.66,-35478.0
buyer_2,Carmen,40,ES76209527435549498601,TRX_N-00604-68200089,2023-05-09T15:50:21,Zarautz,Expense,cash,-100.0,-35578.0
buyer_2,Carmen,40,ES76209527435549498601,TRX_N-00605-18874769,2023-05-10T11:59:03,Zarautz,Expense,transport,-47.66,-35625.66
buyer_2,Carmen,40,ES76209527435549498601,TRX_N-00606-99341737,2023-05-10T06:54:00,Zarautz,Expense,travel,-408.83,-36034.49
buyer_2,Carmen,40,ES76209527435549498601,TRX_N-00607-46038491,2023-05-11T13:01:17,Zarautz,Expense,leisure,-41.84,-36076.33
buyer_2,Carmen,40,ES76209527435549498601,TRX_N-00608-93742047,2023-05-11T18:29:44,Arrasate,Expense,education,-55.02,-36131.35
buyer_2,Carmen,40,ES76209527435549498601,TRX_N-00609-66992489,2023-05-14T11:19:58,Iru√±a de Oca,Expense,cash,-100.0,-36231.35
buyer_2,Carmen,40,ES76209527435549498601,TRX_N-00610-05451351,2023-05-15T10:16:22,Zarautz,Expense,food,-73.33,-36304.68
buyer_2,Carmen,40,ES76209527435549498601,TRX_N-00611-12588846,2023-05-15T16:16:49,Zarautz,Expense,transport,-45.25,-36349.93
buyer_2,Carmen,40,ES76209527435549498601,TRX_N-00612-46305941,2023-05-15T12:48:50,Bilbao,Expense,leisure,-60.86,-36410.79
buyer_2,Carmen,40,ES76209527435549498601,TRX_N-00613-82636447,2023-05-17T13:40:16,Zarautz,Expense,leisure,-80.22,-36491.01
buyer_2,Carmen,40,ES76209527435549498601,TRX_N-00614-49031861,2023-05-20T08:38:03,Zarautz,Expense,transport,-70.47,-36561.48
buyer_2,Carmen,40,ES76209527435549498601,TRX_N-00615-42543478,2023-05-20T20:24:33,Zarautz,Expense,cash,-100.0,-36661.48
buyer_2,Carmen,40,ES76209527435549498601,TRX_N-00616-60913223,2023-05-22T12:04:22,Zarautz,Expense,cash,-100.0,-36761.48
buyer_2,Carmen,40,ES76209527435549498601,TRX_N-00617-53066177,2023-05-23T19:29:27,Zarautz,Expense,leisure,-39.9,-36801.38
buyer_2,Carmen,40,ES76209527435549498601,TRX_N-00618-40339696,2023-05-23T14:23:37,Zarautz,Expense,gifts,-311.54,-37112.92
buyer_2,Carmen,40,ES76209527435549498601,TRX_N-00619-31677184,2023-05-24T19:03:06,Zarautz,Expense,food,-117.17,-37230.09
buyer_2,Carmen,40,ES76209527435549498601,TRX_N-00620-29857894,2023-05-24T13:51:12,Zarautz,Expense,cash,-100.0,-37330.09
buyer_2,Carmen,40,ES76209527435549498601,TRX_N-00621-00524404,2023-05-26T15:19:25,Zarautz,Expense,food,-94.16,-37424.25
buyer_2,Carmen,40,ES76209527435549498601,TRX_N-00622-12088949,2023-05-27T21:05:21,Zarautz,expenses,children,-51.15,-37475.4
buyer_2,Carmen,40,ES76209527435549498601,TRX_N-00623-63276299,2023-05-28T11:19:06,Zarautz,Expense,cash,-100.0,-37575.4
buyer_2,Carmen,40,ES76209527435549498601,TRX_N-00624-40008200,2023-05-30T12:33:54,Zarautz,Expense,repairs,-188.47,-37763.87
buyer_2,Carmen,40,ES76209527435549498601,TRX_N-00625-95866779,2023-06-01T18:58:41,Zarautz,incomes,salary,1322.05,-36441.82
buyer_2,Carmen,40,ES76209527435549498601,TRX_N-00626-80368278,2023-06-01T18:58:41,Zarautz,incomes,salary_partner,1019.77,-35422.05
buyer_2,Carmen,40,ES76209527435549498601,TRX_N-00627-15350606,2023-06-01T18:58:41,Zarautz,incomes,salary_bonus,1055.54,-34366.51
buyer_2,Carmen,40,ES76209527435549498601,TRX_N-00628-23354723,2023-06-01T18:58:41,Zarautz,incomes,salary_partner_bonus,772.34,-33594.17
buyer_2,Carmen,40,ES76209527435549498601,TRX_N-00629-39061338,2023-06-02T08:58:54,Zarautz,Expense,transport,-76.05,-33670.22
buyer_2,Carmen,40,ES76209527435549498601,TRX_N-00630-22956691,2023-06-02T21:13:01,Zarautz,Expense,clothing,-50.24,-33720.46
buyer_2,Carmen,40,ES76209527435549498601,TRX_N-00631-68796115,2023-06-02T14:46:52,Erandio,Expense,repairs,-215.86,-33936.32
buyer_2,Carmen,40,ES76209527435549498601,TRX_N-00632-92704722,2023-06-03T13:56:00,Zarautz,Expense,food,-123.49,-34059.81
buyer_2,Carmen,40,ES76209527435549498601,TRX_N-00633-10972201,2023-06-03T18:17:11,Zarautz,Expense,transport,-57.7,-34117.51
buyer_2,Carmen,40,ES76209527435549498601,TRX_N-00634-70420382,2023-06-03T16:28:10,Zarautz,Expense,leisure,-74.68,-34192.19
buyer_2,Carmen,40,ES76209527435549498601,TRX_N-00635-32520965,2023-06-04T08:09:24,Zarautz,expenses,mortgage,-713.14,-34905.33
buyer_2,Carmen,40,ES76209527435549498601,TRX_N-00636-79072831,2023-06-04T19:32:55,Zarautz,Expense,clothing,-142.42,-35047.75
buyer_2,Carmen,40,ES76209527435549498601,TRX_N-00637-40626614,2023-06-05T19:27:44,Zarautz,Expense,food,-109.13,-35156.88
buyer_2,Carmen,40,ES76209527435549498601,TRX_N-00638-32142874,2023-06-05T08:38:51,Zarautz,Expense,appliances,-287.93,-35444.81
buyer_2,Carmen,40,ES76209527435549498601,TRX_N-00639-46098236,2023-06-06T01:42:56,Zarautz,Expense,food,-81.86,-35526.67
buyer_2,Carmen,40,ES76209527435549498601,TRX_N-00640-23566628,2023-06-06T19:23:16,Zarautz,Expense,leisure,-67.7,-35594.37
buyer_2,Carmen,40,ES76209527435549498601,TRX_N-00641-86751357,2023-06-07T23:18:13,Zarautz,expenses,water,-40.8,-35635.17
buyer_2,Carmen,40,ES76209527435549498601,TRX_N-00642-18841537,2023-06-07T12:35:54,Zarautz,expenses,electricity,-85.71,-35720.88
buyer_2,Carmen,40,ES76209527435549498601,TRX_N-00643-69832938,2023-06-07T18:33:17,Zarautz,Expense,food,-118.63,-35839.51
buyer_2,Carmen,40,ES76209527435549498601,TRX_N-00644-64790400,2023-06-07T20:56:09,Errenteria,Expense,repairs,-56.78,-35896.29
buyer_2,Carmen,40,ES76209527435549498601,TRX_N-00645-60386976,2023-06-08T11:09:34,Zarautz,expenses,gas,-53.24,-35949.53
buyer_2,Carmen,40,ES76209527435549498601,TRX_N-00646-08074664,2023-06-08T14:43:55,Zarautz,expenses,internet,-42.0,-35991.53
buyer_2,Carmen,40,ES76209527435549498601,TRX_N-00647-23312746,2023-06-08T00:01:27,Zarautz,expenses,phone,-41.67,-36033.2
buyer_2,Carmen,40,ES76209527435549498601,TRX_N-00648-31949632,2023-06-12T18:22:31,Vitoria-Gasteiz,Expense,food,-110.78,-36143.98
buyer_2,Carmen,40,ES76209527435549498601,TRX_N-00649-88544142,2023-06-12T14:26:27,Zarautz,Expense,gifts,-796.27,-36940.25
buyer_2,Carmen,40,ES76209527435549498601,TRX_N-00650-43515026,2023-06-13T16:10:38,Zarautz,Expense,repairs,-296.77,-37237.02
buyer_2,Carmen,40,ES76209527435549498601,TRX_N-00651-92416398,2023-06-14T08:48:10,Zarautz,Expense,healthcare,-167.65,-37404.67
buyer_2,Carmen,40,ES76209527435549498601,TRX_N-00652-29059049,2023-06-15T17:41:29,Zarautz,Expense,food,-104.19,-37508.86
buyer_2,Carmen,40,ES76209527435549498601,TRX_N-00653-22487380,2023-06-19T17:11:17,Zarautz,Expense,cash,-100.0,-37608.86
buyer_2,Carmen,40,ES76209527435549498601,TRX_N-00654-34994042,2023-06-19T02:09:25,Zarautz,expenses,children,-170.72,-37779.58
buyer_2,Carmen,40,ES76209527435549498601,TRX_N-00655-76480336,2023-06-20T08:28:52,Zarautz,Expense,food,-80.1,-37859.68
buyer_2,Carmen,40,ES76209527435549498601,TRX_N-00656-42972430,2023-06-21T13:31:44,Zarautz,Expense,cash,-100.0,-37959.68
buyer_2,Carmen,40,ES76209527435549498601,TRX_N-00657-85229606,2023-06-21T13:45:07,Zarautz,Expense,gifts,-381.98,-38341.66
buyer_2,Carmen,40,ES76209527435549498601,TRX_N-00658-58413408,2023-06-25T17:59:52,Zarautz,Expense,food,-73.24,-38414.9
buyer_2,Carmen,40,ES76209527435549498601,TRX_N-00659-56299750,2023-06-25T23:41:25,Zarautz,Expense,transport,-50.84,-38465.74
buyer_2,Carmen,40,ES76209527435549498601,TRX_N-00660-30204109,2023-06-25T19:07:36,Zarautz,Expense,repairs,-61.04,-38526.78
buyer_2,Carmen,40,ES76209527435549498601,TRX_N-00661-62683022,2023-06-26T11:58:16,Bermeo,Expense,food,-92.13,-38618.91
buyer_2,Carmen,40,ES76209527435549498601,TRX_N-00662-40231430,2023-06-28T21:55:36,Bermeo,Expense,food,-74.11,-38693.02
buyer_2,Carmen,40,ES76209527435549498601,TRX_N-00663-41828844,2023-06-29T19:29:24,Zarautz,Expense,leisure,-83.54,-38776.56
buyer_2,Carmen,40,ES76209527435549498601,TRX_N-00664-48322003,2023-06-29T19:02:02,Zarautz,Expense,cash,-100.0,-38876.56
buyer_2,Carmen,40,ES76209527435549498601,TRX_N-00665-16998868,2023-07-01T12:45:41,Zarautz,incomes,salary,1322.05,-37554.51
buyer_2,Carmen,40,ES76209527435549498601,TRX_N-00666-00254168,2023-07-01T12:45:41,Zarautz,incomes,salary_partner,1019.77,-36534.74
buyer_2,Carmen,40,ES76209527435549498601,TRX_N-00667-20087286,2023-07-01T07:55:49,Zarautz,Expense,leisure,-74.67,-36609.41
buyer_2,Carmen,40,ES76209527435549498601,TRX_N-00668-17565670,2023-07-04T13:30:08,Zarautz,expenses,mortgage,-713.14,-37322.55
buyer_2,Carmen,40,ES76209527435549498601,TRX_N-00669-26419529,2023-07-04T04:17:10,Zarautz,Expense,cash,-100.0,-37422.55
buyer_2,Carmen,40,ES76209527435549498601,TRX_N-00670-49785721,2023-07-05T08:44:22,Zarautz,Expense,education,-64.98,-37487.53
buyer_2,Carmen,40,ES76209527435549498601,TRX_N-00671-49121830,2023-07-06T20:15:27,Zarautz,expenses,water,-42.48,-37530.01
buyer_2,Carmen,40,ES76209527435549498601,TRX_N-00672-61722056,2023-07-06T20:12:07,Zarautz,expenses,internet,-42.0,-37572.01
buyer_2,Carmen,40,ES76209527435549498601,TRX_N-00673-04412525,2023-07-06T18:08:36,Zarautz,expenses,phone,-36.85,-37608.86
buyer_2,Carmen,40,ES76209527435549498601,TRX_N-00674-11888191,2023-07-06T12:51:06,Zarautz,Expense,food,-70.64,-37679.5
buyer_2,Carmen,40,ES76209527435549498601,TRX_N-00675-05703565,2023-07-08T14:35:22,Zarautz,expenses,electricity,-44.93,-37724.43
buyer_2,Carmen,40,ES76209527435549498601,TRX_N-00676-62462640,2023-07-08T02:44:35,Zarautz,expenses,gas,-31.74,-37756.17
buyer_2,Carmen,40,ES76209527435549498601,TRX_N-00677-29797663,2023-07-08T10:11:21,Elciego,Expense,clothing,-159.7,-37915.87
buyer_2,Carmen,40,ES76209527435549498601,TRX_N-00678-07800168,2023-07-10T22:58:18,Zarautz,Expense,food,-81.99,-37997.86
buyer_2,Carmen,40,ES76209527435549498601,TRX_N-00679-83715845,2023-07-11T15:42:42,Zarautz,Expense,transport,-75.22,-38073.08
buyer_2,Carmen,40,ES76209527435549498601,TRX_N-00680-85886304,2023-07-12T09:50:14,Zarautz,Expense,transport,-57.46,-38130.54
buyer_2,Carmen,40,ES76209527435549498601,TRX_N-00681-05728879,2023-07-14T18:07:48,Zarautz,Expense,transport,-44.16,-38174.7
buyer_2,Carmen,40,ES76209527435549498601,TRX_N-00682-77060217,2023-07-14T14:05:11,Zarautz,Expense,gifts,-309.67,-38484.37
buyer_2,Carmen,40,ES76209527435549498601,TRX_N-00683-28749205,2023-07-15T19:08:49,Zarautz,Expense,transport,-66.46,-38550.83
buyer_2,Carmen,40,ES76209527435549498601,TRX_N-00684-49388564,2023-07-22T20:39:31,Zarautz,Expense,repairs,-207.9,-38758.73
buyer_2,Carmen,40,ES76209527435549498601,TRX_N-00685-28465780,2023-07-24T16:27:35,Zarautz,Expense,cash,-100.0,-38858.73
buyer_2,Carmen,40,ES76209527435549498601,TRX_N-00686-82729488,2023-07-24T09:14:38,Zarautz,Expense,appliances,-209.98,-39068.71
buyer_2,Carmen,40,ES76209527435549498601,TRX_N-00687-26831423,2023-07-25T16:23:35,Zarautz,Expense,food,-97.9,-39166.61
buyer_2,Carmen,40,ES76209527435549498601,TRX_N-00688-01675739,2023-07-25T09:17:02,Sopela,Expense,transport,-47.94,-39214.55
buyer_2,Carmen,40,ES76209527435549498601,TRX_N-00689-33088923,2023-07-26T11:35:02,Zarautz,Expense,healthcare,-56.79,-39271.34
buyer_2,Carmen,40,ES76209527435549498601,TRX_N-00690-20360297,2023-07-26T19:02:49,Zarautz,Expense,repairs,-262.7,-39534.04
buyer_2,Carmen,40,ES76209527435549498601,TRX_N-00691-65336527,2023-07-28T11:32:19,Zarautz,Expense,food,-118.34,-39652.38
buyer_2,Carmen,40,ES76209527435549498601,TRX_N-00692-64562540,2023-07-31T19:29:32,Zarautz,Expense,healthcare,-142.02,-39794.4
buyer_2,Carmen,40,ES76209527435549498601,TRX_N-00693-54246550,2023-07-31T06:52:25,Zarautz,Expense,cash,-100.0,-39894.4
buyer_2,Carmen,40,ES76209527435549498601,TRX_N-00694-81641153,2023-08-01T12:42:47,Zarautz,incomes,salary,1322.05,-38572.35
buyer_2,Carmen,40,ES76209527435549498601,TRX_N-00695-41079194,2023-08-01T12:42:47,Zarautz,incomes,salary_partner,1019.77,-37552.58
buyer_2,Carmen,40,ES76209527435549498601,TRX_N-00696-28181780,2023-08-03T12:06:15,Zarautz,Expense,transport,-87.72,-37640.3
buyer_2,Carmen,40,ES76209527435549498601,TRX_N-00697-95143777,2023-08-04T15:44:24,Zarautz,expenses,mortgage,-713.14,-38353.44
buyer_2,Carmen,40,ES76209527435549498601,TRX_N-00698-35606705,2023-08-05T22:02:07,Zarautz,Expense,gifts,-516.29,-38869.73
buyer_2,Carmen,40,ES76209527435549498601,TRX_N-00699-01804088,2023-08-06T07:50:10,Zarautz,expenses,phone,-33.06,-38902.79
buyer_2,Carmen,40,ES76209527435549498601,TRX_N-00700-68996699,2023-08-07T09:25:25,Zarautz,expenses,gas,-66.9,-38969.69
buyer_2,Carmen,40,ES76209527435549498601,TRX_N-00701-53635655,2023-08-07T18:28:20,Donostia,Expense,travel,-502.25,-39471.94
buyer_2,Carmen,40,ES76209527435549498601,TRX_N-00702-17041024,2023-08-08T19:00:16,Zarautz,expenses,water,-31.98,-39503.92
buyer_2,Carmen,40,ES76209527435549498601,TRX_N-00703-81241776,2023-08-08T09:13:30,Zarautz,expenses,electricity,-61.01,-39564.93
buyer_2,Carmen,40,ES76209527435549498601,TRX_N-00704-97961821,2023-08-08T21:18:16,Zarautz,expenses,internet,-42.0,-39606.93
buyer_2,Carmen,40,ES76209527435549498601,TRX_N-00705-93626933,2023-08-10T14:15:20,Zarautz,Expense,transport,-52.93,-39659.86
buyer_2,Carmen,40,ES76209527435549498601,TRX_N-00706-62886294,2023-08-10T21:26:58,Portugalete,Expense,leisure,-69.94,-39729.8
buyer_2,Carmen,40,ES76209527435549498601,TRX_N-00707-40479761,2023-08-11T18:32:59,Zarautz,Expense,cash,-100.0,-39829.8
buyer_2,Carmen,40,ES76209527435549498601,TRX_N-00708-52643177,2023-08-11T16:50:27,Zarautz,Expense,gifts,-772.03,-40601.83
buyer_2,Carmen,40,ES76209527435549498601,TRX_N-00709-14074380,2023-08-12T12:14:25,Zarautz,Expense,gifts,-752.64,-41354.47
buyer_2,Carmen,40,ES76209527435549498601,TRX_N-00710-61896688,2023-08-14T16:38:06,Zarautz,Expense,leisure,-79.5,-41433.97
buyer_2,Carmen,40,ES76209527435549498601,TRX_N-00711-66298618,2023-08-15T22:58:44,Zarautz,Expense,transport,-69.24,-41503.21
buyer_2,Carmen,40,ES76209527435549498601,TRX_N-00712-12386034,2023-08-15T20:20:40,Zarautz,Expense,healthcare,-80.53,-41583.74
buyer_2,Carmen,40,ES76209527435549498601,TRX_N-00713-66539415,2023-08-17T16:38:42,Zarautz,Expense,food,-113.42,-41697.16
buyer_2,Carmen,40,ES76209527435549498601,TRX_N-00714-53691016,2023-08-17T08:55:20,Zarautz,Expense,cash,-100.0,-41797.16
buyer_2,Carmen,40,ES76209527435549498601,TRX_N-00715-64656707,2023-08-18T16:33:31,Zarautz,Expense,leisure,-62.78,-41859.94
buyer_2,Carmen,40,ES76209527435549498601,TRX_N-00716-80076411,2023-08-20T13:01:23,Zarautz,Expense,food,-66.88,-41926.82
buyer_2,Carmen,40,ES76209527435549498601,TRX_N-00717-40941768,2023-08-20T12:53:04,Zarautz,Expense,clothing,-116.28,-42043.1
buyer_2,Carmen,40,ES76209527435549498601,TRX_N-00718-94665555,2023-08-20T09:14:29,Zarautz,Expense,cash,-100.0,-42143.1
buyer_2,Carmen,40,ES76209527435549498601,TRX_N-00719-93358745,2023-08-21T18:43:13,Zarautz,Expense,food,-120.38,-42263.48
buyer_2,Carmen,40,ES76209527435549498601,TRX_N-00720-87490093,2023-08-22T19:49:04,Sopela,Expense,transport,-52.65,-42316.13
buyer_2,Carmen,40,ES76209527435549498601,TRX_N-00721-26660210,2023-08-23T17:22:27,Zarautz,Expense,travel,-533.69,-42849.82
buyer_2,Carmen,40,ES76209527435549498601,TRX_N-00722-39017065,2023-08-25T16:24:20,Zarautz,Expense,travel,-1706.91,-44556.73
buyer_2,Carmen,40,ES76209527435549498601,TRX_N-00723-88634231,2023-08-26T03:32:53,Zarautz,Expense,leisure,-25.04,-44581.77
buyer_2,Carmen,40,ES76209527435549498601,TRX_N-00724-44681587,2023-08-27T08:34:41,Zarautz,Expense,food,-76.77,-44658.54
buyer_2,Carmen,40,ES76209527435549498601,TRX_N-00725-18957504,2023-08-28T19:55:33,Zarautz,Expense,food,-80.22,-44738.76
buyer_2,Carmen,40,ES76209527435549498601,TRX_N-00726-84840301,2023-08-28T15:48:41,Zarautz,expenses,children,-218.23,-44956.99
buyer_2,Carmen,40,ES76209527435549498601,TRX_N-00727-57202082,2023-08-29T12:32:16,Zarautz,Expense,cash,-100.0,-45056.99
buyer_2,Carmen,40,ES76209527435549498601,TRX_N-00728-63694936,2023-08-31T15:51:56,Zarautz,Expense,food,-119.11,-45176.1
buyer_2,Carmen,40,ES76209527435549498601,TRX_N-00729-19534015,2023-09-01T18:49:15,Zarautz,incomes,salary,1322.05,-43854.05
buyer_2,Carmen,40,ES76209527435549498601,TRX_N-00730-10749275,2023-09-01T18:49:15,Zarautz,incomes,salary_partner,1019.77,-42834.28
buyer_2,Carmen,40,ES76209527435549498601,TRX_N-00731-94553247,2023-09-01T18:49:15,Zarautz,incomes,extra_income,144.79,-42689.49
buyer_2,Carmen,40,ES76209527435549498601,TRX_N-00732-02816375,2023-09-02T09:01:43,Zarautz,Expense,food,-81.34,-42770.83
buyer_2,Carmen,40,ES76209527435549498601,TRX_N-00733-61425542,2023-09-02T12:53:48,Zarautz,Expense,repairs,-156.79,-42927.62
buyer_2,Carmen,40,ES76209527435549498601,TRX_N-00734-11572271,2023-09-04T22:01:33,Zarautz,expenses,mortgage,-713.14,-43640.76
buyer_2,Carmen,40,ES76209527435549498601,TRX_N-00735-75946119,2023-09-05T11:19:21,Zarautz,expenses,gas,-100.43,-43741.19
buyer_2,Carmen,40,ES76209527435549498601,TRX_N-00736-14331042,2023-09-05T10:03:48,Zarautz,Expense,transport,-58.77,-43799.96
buyer_2,Carmen,40,ES76209527435549498601,TRX_N-00737-30080077,2023-09-06T06:29:19,Zarautz,expenses,water,-37.35,-43837.31
buyer_2,Carmen,40,ES76209527435549498601,TRX_N-00738-71016924,2023-09-06T10:26:00,Zarautz,expenses,phone,-42.72,-43880.03
buyer_2,Carmen,40,ES76209527435549498601,TRX_N-00739-33897666,2023-09-06T09:28:10,Zarautz,Expense,cash,-100.0,-43980.03
buyer_2,Carmen,40,ES76209527435549498601,TRX_N-00740-22868023,2023-09-07T09:27:22,Bilbao,Expense,healthcare,-56.23,-44036.26
buyer_2,Carmen,40,ES76209527435549498601,TRX_N-00741-82470762,2023-09-07T19:26:07,Zarautz,expenses,children,-185.28,-44221.54
buyer_2,Carmen,40,ES76209527435549498601,TRX_N-00742-91623526,2023-09-08T22:19:01,Zarautz,expenses,electricity,-79.02,-44300.56
buyer_2,Carmen,40,ES76209527435549498601,TRX_N-00743-18767906,2023-09-08T05:25:18,Zarautz,expenses,internet,-42.0,-44342.56
buyer_2,Carmen,40,ES76209527435549498601,TRX_N-00744-63200936,2023-09-10T15:05:13,Zarautz,Expense,food,-65.87,-44408.43
buyer_2,Carmen,40,ES76209527435549498601,TRX_N-00745-22049809,2023-09-10T09:09:25,Zarautz,Expense,healthcare,-51.21,-44459.64
buyer_2,Carmen,40,ES76209527435549498601,TRX_N-00746-23569441,2023-09-11T12:55:48,Zarautz,Expense,gifts,-735.15,-45194.79
buyer_2,Carmen,40,ES76209527435549498601,TRX_N-00747-15830637,2023-09-13T10:34:41,Zarautz,Expense,clothing,-133.1,-45327.89
buyer_2,Carmen,40,ES76209527435549498601,TRX_N-00748-77249393,2023-09-13T09:32:00,Zarautz,Expense,healthcare,-149.72,-45477.61
buyer_2,Carmen,40,ES76209527435549498601,TRX_N-00749-66638520,2023-09-14T16:17:44,Zarautz,Expense,cash,-100.0,-45577.61
buyer_2,Carmen,40,ES76209527435549498601,TRX_N-00750-38039139,2023-09-15T18:22:05,Arrasate,Expense,leisure,-82.4,-45660.01
buyer_2,Carmen,40,ES76209527435549498601,TRX_N-00751-57975489,2023-09-15T12:37:47,Zarautz,Expense,appliances,-187.16,-45847.17
buyer_2,Carmen,40,ES76209527435549498601,TRX_N-00752-66348804,2023-09-17T09:25:58,Zarautz,Expense,gifts,-249.27,-46096.44
buyer_2,Carmen,40,ES76209527435549498601,TRX_N-00753-14894002,2023-09-18T19:25:33,Zarautz,Expense,cash,-100.0,-46196.44
buyer_2,Carmen,40,ES76209527435549498601,TRX_N-00754-10434576,2023-09-21T10:29:11,Zarautz,Expense,education,-77.21,-46273.65
buyer_2,Carmen,40,ES76209527435549498601,TRX_N-00755-59049958,2023-09-22T17:13:14,Salvatierra/Agurain,Expense,transport,-44.56,-46318.21
buyer_2,Carmen,40,ES76209527435549498601,TRX_N-00756-09748244,2023-09-23T14:34:49,Zarautz,Expense,gifts,-824.5,-47142.71
buyer_2,Carmen,40,ES76209527435549498601,TRX_N-00757-54890677,2023-09-24T12:53:06,Zarautz,Expense,cash,-100.0,-47242.71
buyer_2,Carmen,40,ES76209527435549498601,TRX_N-00758-50545887,2023-09-24T09:38:07,Zarautz,Expense,repairs,-318.71,-47561.42
buyer_2,Carmen,40,ES76209527435549498601,TRX_N-00759-03271967,2023-09-24T14:55:06,Zarautz,expenses,children,-53.21,-47614.63
buyer_2,Carmen,40,ES76209527435549498601,TRX_N-00760-02507931,2023-09-25T08:55:49,Zarautz,Expense,food,-78.29,-47692.92
buyer_2,Carmen,40,ES76209527435549498601,TRX_N-00761-26400224,2023-09-26T19:45:23,Zarautz,Expense,gifts,-28.85,-47721.77
buyer_2,Carmen,40,ES76209527435549498601,TRX_N-00762-89751753,2023-09-29T14:29:38,Zarautz,expenses,children,-219.61,-47941.38
buyer_2,Carmen,40,ES76209527435549498601,TRX_N-00763-67924653,2023-09-30T18:02:38,Zarautz,Expense,leisure,-36.77,-47978.15
buyer_2,Carmen,40,ES76209527435549498601,TRX_N-00764-76142828,2023-09-30T20:17:50,Zarautz,Expense,clothing,-121.34,-48099.49
buyer_2,Carmen,40,ES76209527435549498601,TRX_N-00765-94527222,2023-10-01T16:25:37,Zarautz,incomes,salary,1322.05,-46777.44
buyer_2,Carmen,40,ES76209527435549498601,TRX_N-00766-09113271,2023-10-01T16:25:37,Zarautz,incomes,salary_partner,1019.77,-45757.67
buyer_2,Carmen,40,ES76209527435549498601,TRX_N-00767-82538320,2023-10-02T08:24:54,Zarautz,Expense,food,-60.2,-45817.87
buyer_2,Carmen,40,ES76209527435549498601,TRX_N-00768-87594456,2023-10-02T04:05:34,Zarautz,Expense,cash,-100.0,-45917.87
buyer_2,Carmen,40,ES76209527435549498601,TRX_N-00769-51626036,2023-10-03T19:31:34,Zarautz,Expense,gifts,-326.67,-46244.54
buyer_2,Carmen,40,ES76209527435549498601,TRX_N-00770-01989727,2023-10-04T13:36:53,Zarautz,expenses,mortgage,-713.14,-46957.68
buyer_2,Carmen,40,ES76209527435549498601,TRX_N-00771-24424338,2023-10-04T18:51:29,Zarautz,Expense,gifts,-370.68,-47328.36
buyer_2,Carmen,40,ES76209527435549498601,TRX_N-00772-64770486,2023-10-05T11:34:44,Zarautz,expenses,internet,-42.0,-47370.36
buyer_2,Carmen,40,ES76209527435549498601,TRX_N-00773-93195996,2023-10-06T21:47:47,Zarautz,expenses,gas,-105.32,-47475.68
buyer_2,Carmen,40,ES76209527435549498601,TRX_N-00774-50651417,2023-10-06T18:19:42,Zarautz,Expense,food,-108.78,-47584.46
buyer_2,Carmen,40,ES76209527435549498601,TRX_N-00775-48251287,2023-10-06T20:37:23,Zarautz,Expense,transport,-59.0,-47643.46
buyer_2,Carmen,40,ES76209527435549498601,TRX_N-00776-58807156,2023-10-06T11:13:03,Zarautz,Expense,clothing,-60.47,-47703.93
buyer_2,Carmen,40,ES76209527435549498601,TRX_N-00777-12329078,2023-10-07T14:59:06,Zarautz,expenses,electricity,-70.29,-47774.22
buyer_2,Carmen,40,ES76209527435549498601,TRX_N-00778-02521811,2023-10-08T14:57:15,Zarautz,expenses,phone,-42.81,-47817.03
buyer_2,Carmen,40,ES76209527435549498601,TRX_N-00779-71193064,2023-10-08T14:39:59,Zarautz,expenses,water,-42.08,-47859.11
buyer_2,Carmen,40,ES76209527435549498601,TRX_N-00780-44520474,2023-10-11T14:00:06,Iru√±a de Oca,Expense,repairs,-253.85,-48112.96
buyer_2,Carmen,40,ES76209527435549498601,TRX_N-00781-47819388,2023-10-11T22:07:27,Mungia,Expense,gifts,-397.38,-48510.34
buyer_2,Carmen,40,ES76209527435549498601,TRX_N-00782-28521168,2023-10-15T13:48:48,Zarautz,Expense,food,-107.52,-48617.86
buyer_2,Carmen,40,ES76209527435549498601,TRX_N-00783-52235730,2023-10-16T10:49:15,Zarautz,Expense,cash,-100.0,-48717.86
buyer_2,Carmen,40,ES76209527435549498601,TRX_N-00784-38610612,2023-10-16T17:53:06,Zarautz,Expense,repairs,-219.72,-48937.58
buyer_2,Carmen,40,ES76209527435549498601,TRX_N-00785-80088734,2023-10-17T18:20:12,Getxo,Expense,food,-72.68,-49010.26
buyer_2,Carmen,40,ES76209527435549498601,TRX_N-00786-03679990,2023-10-17T13:57:28,Zarautz,Expense,repairs,-322.75,-49333.01
buyer_2,Carmen,40,ES76209527435549498601,TRX_N-00787-39119448,2023-10-19T19:12:10,Zarautz,Expense,cash,-100.0,-49433.01
buyer_2,Carmen,40,ES76209527435549498601,TRX_N-00788-15794604,2023-10-21T19:37:15,Pasaia,Expense,leisure,-75.16,-49508.17
buyer_2,Carmen,40,ES76209527435549498601,TRX_N-00789-70732873,2023-10-23T16:08:21,Andoain,Expense,clothing,-125.88,-49634.05
buyer_2,Carmen,40,ES76209527435549498601,TRX_N-00790-92297694,2023-10-23T01:55:14,Zarautz,expenses,children,-279.13,-49913.18
buyer_2,Carmen,40,ES76209527435549498601,TRX_N-00791-73156164,2023-10-24T08:12:20,Santurtzi,Expense,food,-92.56,-50005.74
buyer_2,Carmen,40,ES76209527435549498601,TRX_N-00792-72784713,2023-10-24T22:22:50,Zarautz,Expense,cash,-100.0,-50105.74
buyer_2,Carmen,40,ES76209527435549498601,TRX_N-00793-46441505,2023-10-25T20:50:05,Vitoria-Gasteiz,Expense,transport,-87.61,-50193.35
buyer_2,Carmen,40,ES76209527435549498601,TRX_N-00794-43281816,2023-10-25T20:25:02,Zarautz,Expense,travel,-1277.17,-51470.52
buyer_2,Carmen,40,ES76209527435549498601,TRX_N-00795-20933566,2023-10-25T11:04:21,Zarautz,Expense,repairs,-79.33,-51549.85
buyer_2,Carmen,40,ES76209527435549498601,TRX_N-00796-24334086,2023-10-26T20:48:06,Zarautz,Expense,transport,-42.72,-51592.57
buyer_2,Carmen,40,ES76209527435549498601,TRX_N-00797-02966468,2023-10-26T17:32:37,Oy√≥n-Oion,Expense,education,-47.31,-51639.88
buyer_2,Carmen,40,ES76209527435549498601,TRX_N-00798-40581236,2023-10-27T21:31:14,Zarautz,Expense,repairs,-213.51,-51853.39
buyer_2,Carmen,40,ES76209527435549498601,TRX_N-00799-30050362,2023-10-28T20:37:59,Zarautz,Expense,transport,-73.81,-51927.2
buyer_2,Carmen,40,ES76209527435549498601,TRX_N-00800-33944375,2023-10-30T16:52:26,Zarautz,expenses,children,-278.45,-52205.65
buyer_2,Carmen,40,ES76209527435549498601,TRX_N-00801-96205240,2023-11-01T05:46:29,Zarautz,incomes,salary,1322.05,-50883.6
buyer_2,Carmen,40,ES76209527435549498601,TRX_N-00802-20274025,2023-11-01T05:46:29,Zarautz,incomes,salary_partner,1019.77,-49863.83
buyer_2,Carmen,40,ES76209527435549498601,TRX_N-00803-40547497,2023-11-02T17:49:49,Zarautz,Expense,cash,-100.0,-49963.83
buyer_2,Carmen,40,ES76209527435549498601,TRX_N-00804-36822803,2023-11-03T17:25:51,Basauri,Expense,food,-62.57,-50026.4
buyer_2,Carmen,40,ES76209527435549498601,TRX_N-00805-68673262,2023-11-04T02:32:43,Zarautz,expenses,mortgage,-713.14,-50739.54
buyer_2,Carmen,40,ES76209527435549498601,TRX_N-00806-20482908,2023-11-04T17:40:25,Zarautz,Expense,clothing,-85.92,-50825.46
buyer_2,Carmen,40,ES76209527435549498601,TRX_N-00807-48033281,2023-11-05T08:02:10,Zarautz,expenses,gas,-80.53,-50905.99
buyer_2,Carmen,40,ES76209527435549498601,TRX_N-00808-70446065,2023-11-06T12:09:19,Zarautz,expenses,water,-38.18,-50944.17
buyer_2,Carmen,40,ES76209527435549498601,TRX_N-00809-03383099,2023-11-07T07:19:08,Zarautz,expenses,electricity,-86.47,-51030.64
buyer_2,Carmen,40,ES76209527435549498601,TRX_N-00810-37869693,2023-11-07T05:16:58,Berango,Expense,transport,-72.8,-51103.44
buyer_2,Carmen,40,ES76209527435549498601,TRX_N-00811-17767673,2023-11-08T19:35:07,Zarautz,expenses,phone,-41.07,-51144.51
buyer_2,Carmen,40,ES76209527435549498601,TRX_N-00812-23878972,2023-11-08T10:58:43,Zarautz,expenses,internet,-42.0,-51186.51
buyer_2,Carmen,40,ES76209527435549498601,TRX_N-00813-19206477,2023-11-08T10:20:31,Zarautz,Expense,leisure,-62.49,-51249.0
buyer_2,Carmen,40,ES76209527435549498601,TRX_N-00814-89284678,2023-11-11T23:31:21,Zuia,Expense,cash,-100.0,-51349.0
buyer_2,Carmen,40,ES76209527435549498601,TRX_N-00815-09503626,2023-11-11T17:38:20,Zarautz,expenses,children,-193.3,-51542.3
buyer_2,Carmen,40,ES76209527435549498601,TRX_N-00816-25665783,2023-11-19T21:25:24,Eibar,Expense,transport,-48.96,-51591.26
buyer_2,Carmen,40,ES76209527435549498601,TRX_N-00817-52286531,2023-11-22T15:57:07,Zarautz,Expense,food,-95.5,-51686.76
buyer_2,Carmen,40,ES76209527435549498601,TRX_N-00818-77629634,2023-11-22T15:26:08,Zarautz,Expense,appliances,-408.56,-52095.32
buyer_2,Carmen,40,ES76209527435549498601,TRX_N-00819-39777387,2023-11-23T19:59:17,Zarautz,Expense,transport,-76.86,-52172.18
buyer_2,Carmen,40,ES76209527435549498601,TRX_N-00820-54363752,2023-11-25T10:38:13,Zarautz,Expense,food,-118.55,-52290.73
buyer_2,Carmen,40,ES76209527435549498601,TRX_N-00821-97302517,2023-11-25T11:03:10,Mungia,Expense,clothing,-50.72,-52341.45
buyer_2,Carmen,40,ES76209527435549498601,TRX_N-00822-11064340,2023-11-26T18:58:21,Zarautz,Expense,cash,-100.0,-52441.45
buyer_2,Carmen,40,ES76209527435549498601,TRX_N-00823-47802275,2023-11-27T11:41:29,Zarautz,Expense,cash,-100.0,-52541.45
buyer_2,Carmen,40,ES76209527435549498601,TRX_N-00824-05059277,2023-11-28T15:07:32,Zarautz,Expense,gifts,-87.3,-52628.75
buyer_2,Carmen,40,ES76209527435549498601,TRX_N-00825-87956979,2023-11-30T16:10:06,Arrasate,Expense,food,-113.42,-52742.17
buyer_2,Carmen,40,ES76209527435549498601,TRX_N-00826-42072519,2023-11-30T14:45:40,Zarautz,Expense,gifts,-97.02,-52839.19
buyer_2,Carmen,40,ES76209527435549498601,TRX_N-00827-67080780,2023-12-01T20:20:20,Zarautz,incomes,salary,1322.05,-51517.14
buyer_2,Carmen,40,ES76209527435549498601,TRX_N-00828-12178651,2023-12-01T20:20:20,Zarautz,incomes,salary_partner,1019.77,-50497.37
buyer_2,Carmen,40,ES76209527435549498601,TRX_N-00829-98939843,2023-12-01T20:20:20,Zarautz,incomes,extra_income,144.79,-50352.58
buyer_2,Carmen,40,ES76209527435549498601,TRX_N-00830-95577901,2023-12-01T20:20:20,Zarautz,incomes,salary_bonus,946.73,-49405.85
buyer_2,Carmen,40,ES76209527435549498601,TRX_N-00831-77797273,2023-12-01T20:20:20,Zarautz,incomes,salary_partner_bonus,733.74,-48672.11
buyer_2,Carmen,40,ES76209527435549498601,TRX_N-00832-04807777,2023-12-02T02:08:39,Zarautz,Expense,cash,-100.0,-48772.11
buyer_2,Carmen,40,ES76209527435549498601,TRX_N-00833-03730218,2023-12-04T08:08:15,Zarautz,expenses,mortgage,-713.14,-49485.25
buyer_2,Carmen,40,ES76209527435549498601,TRX_N-00834-37821328,2023-12-06T19:56:29,Zarautz,expenses,water,-35.32,-49520.57
buyer_2,Carmen,40,ES76209527435549498601,TRX_N-00835-80606869,2023-12-06T18:49:10,Zarautz,expenses,electricity,-27.75,-49548.32
buyer_2,Carmen,40,ES76209527435549498601,TRX_N-00836-86316625,2023-12-06T18:32:01,Zarautz,expenses,internet,-42.0,-49590.32
buyer_2,Carmen,40,ES76209527435549498601,TRX_N-00837-23431411,2023-12-06T18:25:04,Zarautz,expenses,phone,-32.29,-49622.61
buyer_2,Carmen,40,ES76209527435549498601,TRX_N-00838-45985033,2023-12-06T20:54:48,Zarautz,Expense,leisure,-29.11,-49651.72
buyer_2,Carmen,40,ES76209527435549498601,TRX_N-00839-11460278,2023-12-06T10:23:27,Zarautz,Expense,cash,-100.0,-49751.72
buyer_2,Carmen,40,ES76209527435549498601,TRX_N-00840-47962191,2023-12-07T04:00:53,Zarautz,Expense,leisure,-79.38,-49831.1
buyer_2,Carmen,40,ES76209527435549498601,TRX_N-00841-24492718,2023-12-08T10:43:46,Zarautz,expenses,gas,-66.09,-49897.19
buyer_2,Carmen,40,ES76209527435549498601,TRX_N-00842-69124865,2023-12-09T08:21:24,Zarautz,Expense,transport,-86.81,-49984.0
buyer_2,Carmen,40,ES76209527435549498601,TRX_N-00843-32087420,2023-12-09T20:12:04,Zarautz,Expense,leisure,-53.22,-50037.22
buyer_2,Carmen,40,ES76209527435549498601,TRX_N-00844-43042253,2023-12-09T14:26:44,Zarautz,Expense,clothing,-123.82,-50161.04
buyer_2,Carmen,40,ES76209527435549498601,TRX_N-00845-47362056,2023-12-09T19:37:16,Zarautz,Expense,travel,-1339.83,-51500.87
buyer_2,Carmen,40,ES76209527435549498601,TRX_N-00846-80224495,2023-12-10T10:53:27,Zarautz,Expense,transport,-72.2,-51573.07
buyer_2,Carmen,40,ES76209527435549498601,TRX_N-00847-91158988,2023-12-10T14:31:53,Durango,Expense,healthcare,-90.94,-51664.01
buyer_2,Carmen,40,ES76209527435549498601,TRX_N-00848-74913333,2023-12-11T10:44:21,Zarautz,Expense,leisure,-68.62,-51732.63
buyer_2,Carmen,40,ES76209527435549498601,TRX_N-00849-27546878,2023-12-12T18:19:29,Zuia,Expense,leisure,-34.3,-51766.93
buyer_2,Carmen,40,ES76209527435549498601,TRX_N-00850-28517300,2023-12-13T17:00:30,Zarautz,Expense,education,-45.85,-51812.78
buyer_2,Carmen,40,ES76209527435549498601,TRX_N-00851-57916242,2023-12-15T18:17:05,Zarautz,Expense,cash,-100.0,-51912.78
buyer_2,Carmen,40,ES76209527435549498601,TRX_N-00852-16111784,2023-12-15T23:01:51,Zarautz,Expense,gifts,-649.23,-52562.01
buyer_2,Carmen,40,ES76209527435549498601,TRX_N-00853-93446823,2023-12-18T23:06:51,Zarautz,Expense,transport,-56.17,-52618.18
buyer_2,Carmen,40,ES76209527435549498601,TRX_N-00854-72605304,2023-12-18T17:22:24,Amurrio,Expense,leisure,-33.02,-52651.2
buyer_2,Carmen,40,ES76209527435549498601,TRX_N-00855-33288991,2023-12-18T10:48:09,Zarautz,Expense,repairs,-98.19,-52749.39
buyer_2,Carmen,40,ES76209527435549498601,TRX_N-00856-59267254,2023-12-19T15:18:34,Zarautz,Expense,leisure,-22.91,-52772.3
buyer_2,Carmen,40,ES76209527435549498601,TRX_N-00857-95374292,2023-12-21T21:21:47,Zarautz,Expense,transport,-47.66,-52819.96
buyer_2,Carmen,40,ES76209527435549498601,TRX_N-00858-49693584,2023-12-23T10:18:01,Zarautz,Expense,clothing,-124.76,-52944.72
buyer_2,Carmen,40,ES76209527435549498601,TRX_N-00859-63563783,2023-12-24T09:50:16,Zarautz,Expense,appliances,-206.56,-53151.28
buyer_2,Carmen,40,ES76209527435549498601,TRX_N-00860-03058249,2023-12-24T17:55:44,Zarautz,Expense,repairs,-188.16,-53339.44
buyer_2,Carmen,40,ES76209527435549498601,TRX_N-00861-26103111,2023-12-24T15:39:12,Zarautz,expenses,children,-142.3,-53481.74
buyer_2,Carmen,40,ES76209527435549498601,TRX_N-00862-58689646,2023-12-25T09:01:03,Zarautz,Expense,leisure,-46.59,-53528.33
buyer_2,Carmen,40,ES76209527435549498601,TRX_N-00863-58741350,2023-12-26T11:25:20,Zarautz,Expense,food,-86.82,-53615.15
buyer_2,Carmen,40,ES76209527435549498601,TRX_N-00864-08659522,2023-12-26T18:29:27,Zarautz,Expense,leisure,-60.01,-53675.16
buyer_2,Carmen,40,ES76209527435549498601,TRX_N-00865-21873827,2023-12-27T17:30:35,Zarautz,Expense,transport,-79.6,-53754.76
buyer_2,Carmen,40,ES76209527435549498601,TRX_N-00866-15555693,2023-12-28T19:44:48,Zarautz,Expense,education,-55.95,-53810.71
buyer_2,Carmen,40,ES76209527435549498601,TRX_N-00867-19238784,2023-12-30T08:10:48,Zarautz,Expense,transport,-69.37,-53880.08
buyer_2,Carmen,40,ES76209527435549498601,TRX_N-00868-07043889,2023-12-31T10:30:02,Zarautz,Expense,repairs,-62.25,-53942.33
buyer_2,Carmen,40,ES76209527435549498601,TRX_N-00869-30172103,2024-01-01T11:00:58,Zarautz,incomes,salary,1367.52,-52574.81
buyer_2,Carmen,40,ES76209527435549498601,TRX_N-00870-68334448,2024-01-01T11:00:58,Zarautz,incomes,salary_partner,1054.84,-51519.97
buyer_2,Carmen,40,ES76209527435549498601,TRX_N-00871-56778929,2024-01-01T11:34:26,Zarautz,Expense,transport,-84.77,-51604.74
buyer_2,Carmen,40,ES76209527435549498601,TRX_N-00872-65201997,2024-01-03T11:50:08,Zarautz,Expense,education,-73.61,-51678.35
buyer_2,Carmen,40,ES76209527435549498601,TRX_N-00873-75413238,2024-01-03T10:27:31,Zarautz,expenses,children,-90.93,-51769.28
buyer_2,Carmen,40,ES76209527435549498601,TRX_N-00874-80227258,2024-01-04T17:36:41,Zarautz,expenses,mortgage,-713.14,-52482.42
buyer_2,Carmen,40,ES76209527435549498601,TRX_N-00875-06427414,2024-01-05T12:55:54,Zarautz,expenses,electricity,-85.57,-52567.99
buyer_2,Carmen,40,ES76209527435549498601,TRX_N-00876-41433960,2024-01-05T22:53:14,Zarautz,expenses,gas,-94.09,-52662.08
buyer_2,Carmen,40,ES76209527435549498601,TRX_N-00877-21905391,2024-01-05T14:53:09,Zarautz,Expense,food,-101.51,-52763.59
buyer_2,Carmen,40,ES76209527435549498601,TRX_N-00878-44130193,2024-01-06T11:03:09,Zarautz,Expense,travel,-1327.64,-54091.23
buyer_2,Carmen,40,ES76209527435549498601,TRX_N-00879-32139031,2024-01-07T11:24:11,Zarautz,expenses,water,-23.28,-54114.51
buyer_2,Carmen,40,ES76209527435549498601,TRX_N-00880-00286897,2024-01-08T19:40:58,Zarautz,expenses,internet,-42.0,-54156.51
buyer_2,Carmen,40,ES76209527435549498601,TRX_N-00881-17555976,2024-01-08T22:26:10,Zarautz,expenses,phone,-37.68,-54194.19
buyer_2,Carmen,40,ES76209527435549498601,TRX_N-00882-97854630,2024-01-09T00:08:30,Zarautz,Expense,leisure,-68.41,-54262.6
buyer_2,Carmen,40,ES76209527435549498601,TRX_N-00883-03728675,2024-01-09T17:46:59,Zarautz,Expense,repairs,-190.46,-54453.06
buyer_2,Carmen,40,ES76209527435549498601,TRX_N-00884-50401657,2024-01-13T15:32:18,Zarautz,Expense,healthcare,-143.28,-54596.34
buyer_2,Carmen,40,ES76209527435549498601,TRX_N-00885-89556290,2024-01-13T18:45:29,Zarautz,Expense,cash,-100.0,-54696.34
buyer_2,Carmen,40,ES76209527435549498601,TRX_N-00886-75453847,2024-01-14T20:15:08,Zarautz,Expense,food,-71.24,-54767.58
buyer_2,Carmen,40,ES76209527435549498601,TRX_N-00887-86383812,2024-01-16T13:01:41,Zarautz,Expense,transport,-43.14,-54810.72
buyer_2,Carmen,40,ES76209527435549498601,TRX_N-00888-28569650,2024-01-19T15:21:43,Zarautz,Expense,food,-92.86,-54903.58
buyer_2,Carmen,40,ES76209527435549498601,TRX_N-00889-09701437,2024-01-20T11:37:39,Zarautz,Expense,food,-101.15,-55004.73
buyer_2,Carmen,40,ES76209527435549498601,TRX_N-00890-38824418,2024-01-21T12:48:59,Zarautz,Expense,leisure,-73.89,-55078.62
buyer_2,Carmen,40,ES76209527435549498601,TRX_N-00891-90403965,2024-01-23T16:42:22,Zarautz,Expense,cash,-100.0,-55178.62
buyer_2,Carmen,40,ES76209527435549498601,TRX_N-00892-25492873,2024-01-23T18:39:00,Zarautz,Expense,appliances,-241.05,-55419.67
buyer_2,Carmen,40,ES76209527435549498601,TRX_N-00893-72960791,2024-01-24T17:03:30,Zarautz,Expense,cash,-100.0,-55519.67
buyer_2,Carmen,40,ES76209527435549498601,TRX_N-00894-15473364,2024-01-25T13:37:54,Zarautz,Expense,leisure,-28.6,-55548.27
buyer_2,Carmen,40,ES76209527435549498601,TRX_N-00895-00150272,2024-01-27T10:51:58,Zarautz,expenses,children,-218.66,-55766.93
buyer_2,Carmen,40,ES76209527435549498601,TRX_N-00896-79425415,2024-01-28T16:04:43,Zarautz,Expense,appliances,-212.77,-55979.7
buyer_2,Carmen,40,ES76209527435549498601,TRX_N-00897-76689881,2024-01-30T11:16:26,Zarautz,Expense,leisure,-32.7,-56012.4
buyer_2,Carmen,40,ES76209527435549498601,TRX_N-00898-85451202,2024-01-30T16:58:55,Zarautz,expenses,children,-265.69,-56278.09
buyer_2,Carmen,40,ES76209527435549498601,TRX_N-00899-34511900,2024-01-31T20:43:23,Zarautz,Expense,food,-111.81,-56389.9
buyer_2,Carmen,40,ES76209527435549498601,TRX_N-00900-73726234,2024-02-01T16:09:30,Zarautz,incomes,salary,1367.52,-55022.38
buyer_2,Carmen,40,ES76209527435549498601,TRX_N-00901-75934545,2024-02-01T16:09:30,Zarautz,incomes,salary_partner,1054.84,-53967.54
buyer_2,Carmen,40,ES76209527435549498601,TRX_N-00902-34930774,2024-02-01T10:17:00,Zarautz,Expense,food,-103.38,-54070.92
buyer_2,Carmen,40,ES76209527435549498601,TRX_N-00903-96027608,2024-02-02T15:01:54,Arrasate,Expense,cash,-100.0,-54170.92
buyer_2,Carmen,40,ES76209527435549498601,TRX_N-00904-27401241,2024-02-03T00:57:18,Zarautz,Expense,food,-102.28,-54273.2
buyer_2,Carmen,40,ES76209527435549498601,TRX_N-00905-31446749,2024-02-03T12:50:33,Zarautz,Expense,leisure,-31.84,-54305.04
buyer_2,Carmen,40,ES76209527435549498601,TRX_N-00906-47929003,2024-02-04T08:50:58,Zarautz,expenses,mortgage,-713.14,-55018.18
buyer_2,Carmen,40,ES76209527435549498601,TRX_N-00907-40865311,2024-02-04T17:45:54,Zarautz,Expense,gifts,-760.79,-55778.97
buyer_2,Carmen,40,ES76209527435549498601,TRX_N-00908-80051302,2024-02-05T15:27:51,Zarautz,expenses,electricity,-52.15,-55831.12
buyer_2,Carmen,40,ES76209527435549498601,TRX_N-00909-68905361,2024-02-05T02:54:23,Zarautz,expenses,internet,-42.0,-55873.12
buyer_2,Carmen,40,ES76209527435549498601,TRX_N-00910-21326667,2024-02-05T20:08:04,Hernani,Expense,transport,-75.93,-55949.05
buyer_2,Carmen,40,ES76209527435549498601,TRX_N-00911-27066074,2024-02-06T17:32:09,Zarautz,expenses,phone,-34.69,-55983.74
buyer_2,Carmen,40,ES76209527435549498601,TRX_N-00912-65505641,2024-02-06T08:33:49,Zarautz,Expense,cash,-100.0,-56083.74
buyer_2,Carmen,40,ES76209527435549498601,TRX_N-00913-93919457,2024-02-08T09:36:54,Zarautz,expenses,water,-23.57,-56107.31
buyer_2,Carmen,40,ES76209527435549498601,TRX_N-00914-70491791,2024-02-08T13:52:10,Zarautz,expenses,gas,-31.18,-56138.49
buyer_2,Carmen,40,ES76209527435549498601,TRX_N-00915-57807187,2024-02-08T18:27:57,Zarautz,Expense,food,-96.06,-56234.55
buyer_2,Carmen,40,ES76209527435549498601,TRX_N-00916-06386727,2024-02-10T20:44:03,Zarautz,Expense,gifts,-216.27,-56450.82
buyer_2,Carmen,40,ES76209527435549498601,TRX_N-00917-18784245,2024-02-12T15:14:42,Pasaia,Expense,food,-84.26,-56535.08
buyer_2,Carmen,40,ES76209527435549498601,TRX_N-00918-89313421,2024-02-13T20:35:18,Zarautz,Expense,repairs,-89.36,-56624.44
buyer_2,Carmen,40,ES76209527435549498601,TRX_N-00919-80376086,2024-02-15T03:21:02,Zarautz,Expense,leisure,-66.52,-56690.96
buyer_2,Carmen,40,ES76209527435549498601,TRX_N-00920-20156461,2024-02-23T22:36:07,Zuia,Expense,transport,-51.94,-56742.9
buyer_2,Carmen,40,ES76209527435549498601,TRX_N-00921-32704070,2024-02-27T20:44:12,Zarautz,Expense,food,-104.76,-56847.66
buyer_2,Carmen,40,ES76209527435549498601,TRX_N-00922-44311194,2024-03-01T20:12:05,Zarautz,incomes,salary,1367.52,-55480.14
buyer_2,Carmen,40,ES76209527435549498601,TRX_N-00923-54490402,2024-03-01T20:12:05,Zarautz,incomes,salary_partner,1054.84,-54425.3
buyer_2,Carmen,40,ES76209527435549498601,TRX_N-00924-89840652,2024-03-01T06:29:44,Sopela,Expense,leisure,-22.78,-54448.08
buyer_2,Carmen,40,ES76209527435549498601,TRX_N-00925-71496647,2024-03-02T18:13:42,Zarautz,Expense,repairs,-82.75,-54530.83
buyer_2,Carmen,40,ES76209527435549498601,TRX_N-00926-91814562,2024-03-03T01:08:25,Zarautz,Expense,repairs,-245.49,-54776.32
buyer_2,Carmen,40,ES76209527435549498601,TRX_N-00927-19424560,2024-03-04T13:39:58,Zarautz,expenses,mortgage,-713.14,-55489.46
buyer_2,Carmen,40,ES76209527435549498601,TRX_N-00928-27239362,2024-03-05T15:00:19,Zarautz,expenses,water,-34.59,-55524.05
buyer_2,Carmen,40,ES76209527435549498601,TRX_N-00929-17728866,2024-03-05T20:19:00,Zarautz,Expense,cash,-100.0,-55624.05
buyer_2,Carmen,40,ES76209527435549498601,TRX_N-00930-01477476,2024-03-07T17:22:00,Zarautz,expenses,gas,-54.48,-55678.53
buyer_2,Carmen,40,ES76209527435549498601,TRX_N-00931-74015885,2024-03-07T16:27:00,Zarautz,Expense,cash,-100.0,-55778.53
buyer_2,Carmen,40,ES76209527435549498601,TRX_N-00932-47083858,2024-03-08T08:40:28,Zarautz,expenses,electricity,-41.75,-55820.28
buyer_2,Carmen,40,ES76209527435549498601,TRX_N-00933-94235797,2024-03-08T13:56:48,Zarautz,expenses,internet,-42.0,-55862.28
buyer_2,Carmen,40,ES76209527435549498601,TRX_N-00934-55111508,2024-03-08T18:18:51,Zarautz,expenses,phone,-43.69,-55905.97
buyer_2,Carmen,40,ES76209527435549498601,TRX_N-00935-71473083,2024-03-08T14:06:52,Zarautz,Expense,cash,-100.0,-56005.97
buyer_2,Carmen,40,ES76209527435549498601,TRX_N-00936-83012700,2024-03-09T14:03:02,Zarautz,Expense,cash,-100.0,-56105.97
buyer_2,Carmen,40,ES76209527435549498601,TRX_N-00937-81844615,2024-03-10T22:48:15,Zarautz,Expense,food,-62.38,-56168.35
buyer_2,Carmen,40,ES76209527435549498601,TRX_N-00938-26328884,2024-03-11T02:35:14,Zarautz,Expense,food,-63.5,-56231.85
buyer_2,Carmen,40,ES76209527435549498601,TRX_N-00939-26041444,2024-03-11T11:39:38,Zarautz,Expense,repairs,-197.81,-56429.66
buyer_2,Carmen,40,ES76209527435549498601,TRX_N-00940-15099440,2024-03-15T21:48:03,Hernani,Expense,clothing,-87.06,-56516.72
buyer_2,Carmen,40,ES76209527435549498601,TRX_N-00941-69805749,2024-03-16T16:48:37,Zarautz,Expense,cash,-100.0,-56616.72
buyer_2,Carmen,40,ES76209527435549498601,TRX_N-00942-08279540,2024-03-17T16:26:21,Zarautz,Expense,food,-87.87,-56704.59
buyer_2,Carmen,40,ES76209527435549498601,TRX_N-00943-99369809,2024-03-17T15:19:40,Zarautz,Expense,clothing,-120.45,-56825.04
buyer_2,Carmen,40,ES76209527435549498601,TRX_N-00944-80949242,2024-03-18T17:47:56,Zarautz,Expense,cash,-100.0,-56925.04
buyer_2,Carmen,40,ES76209527435549498601,TRX_N-00945-53840980,2024-03-20T09:35:25,Zarautz,Expense,food,-105.64,-57030.68
buyer_2,Carmen,40,ES76209527435549498601,TRX_N-00946-53355579,2024-03-22T09:52:16,Zarautz,Expense,cash,-100.0,-57130.68
buyer_2,Carmen,40,ES76209527435549498601,TRX_N-00947-92897658,2024-03-22T13:28:34,Zarautz,Expense,gifts,-501.55,-57632.23
buyer_2,Carmen,40,ES76209527435549498601,TRX_N-00948-09328454,2024-03-22T11:07:55,Zarautz,expenses,children,-146.63,-57778.86
buyer_2,Carmen,40,ES76209527435549498601,TRX_N-00949-77811621,2024-03-27T10:24:41,Zarautz,Expense,transport,-47.84,-57826.7
buyer_2,Carmen,40,ES76209527435549498601,TRX_N-00950-24701472,2024-03-28T13:54:15,Zarautz,Expense,leisure,-69.93,-57896.63
buyer_2,Carmen,40,ES76209527435549498601,TRX_N-00951-00114109,2024-03-29T11:08:12,Zarautz,Expense,cash,-100.0,-57996.63
buyer_2,Carmen,40,ES76209527435549498601,TRX_N-00952-01588522,2024-04-01T23:21:53,Zarautz,incomes,salary,1367.52,-56629.11
buyer_2,Carmen,40,ES76209527435549498601,TRX_N-00953-91213064,2024-04-01T23:21:53,Zarautz,incomes,salary_partner,1054.84,-55574.27
buyer_2,Carmen,40,ES76209527435549498601,TRX_N-00954-77596857,2024-04-01T23:21:53,Zarautz,incomes,extra_income,144.79,-55429.48
buyer_2,Carmen,40,ES76209527435549498601,TRX_N-00955-97331187,2024-04-01T20:55:32,Zarautz,Expense,transport,-41.0,-55470.48
buyer_2,Carmen,40,ES76209527435549498601,TRX_N-00956-16748704,2024-04-02T14:16:42,Zarautz,Expense,cash,-100.0,-55570.48
buyer_2,Carmen,40,ES76209527435549498601,TRX_N-00957-86910319,2024-04-03T16:09:38,Zarautz,Expense,food,-68.93,-55639.41
buyer_2,Carmen,40,ES76209527435549498601,TRX_N-00958-19115974,2024-04-03T03:52:31,Zarautz,Expense,cash,-100.0,-55739.41
buyer_2,Carmen,40,ES76209527435549498601,TRX_N-00959-02014341,2024-04-03T14:23:04,Zarautz,expenses,children,-247.84,-55987.25
buyer_2,Carmen,40,ES76209527435549498601,TRX_N-00960-81882310,2024-04-04T20:24:50,Zarautz,expenses,mortgage,-713.14,-56700.39
buyer_2,Carmen,40,ES76209527435549498601,TRX_N-00961-38142692,2024-04-05T20:59:58,Zarautz,expenses,gas,-66.76,-56767.15
buyer_2,Carmen,40,ES76209527435549498601,TRX_N-00962-88280720,2024-04-05T19:54:08,Zarautz,expenses,internet,-42.0,-56809.15
buyer_2,Carmen,40,ES76209527435549498601,TRX_N-00963-68951471,2024-04-06T16:25:37,Zarautz,expenses,phone,-39.26,-56848.41
buyer_2,Carmen,40,ES76209527435549498601,TRX_N-00964-05242333,2024-04-06T09:40:10,Zarautz,Expense,leisure,-18.68,-56867.09
buyer_2,Carmen,40,ES76209527435549498601,TRX_N-00965-86248003,2024-04-07T10:38:21,Zarautz,Expense,cash,-100.0,-56967.09
buyer_2,Carmen,40,ES76209527435549498601,TRX_N-00966-24374891,2024-04-08T18:36:17,Zarautz,expenses,water,-22.35,-56989.44
buyer_2,Carmen,40,ES76209527435549498601,TRX_N-00967-16291101,2024-04-08T20:06:31,Zarautz,expenses,electricity,-61.32,-57050.76
buyer_2,Carmen,40,ES76209527435549498601,TRX_N-00968-38619906,2024-04-10T14:09:22,Zarautz,Expense,leisure,-36.98,-57087.74
buyer_2,Carmen,40,ES76209527435549498601,TRX_N-00969-94827796,2024-04-10T15:24:39,Errenteria,Expense,clothing,-150.74,-57238.48
buyer_2,Carmen,40,ES76209527435549498601,TRX_N-00970-33564332,2024-04-10T15:19:50,Zarautz,Expense,repairs,-275.28,-57513.76
buyer_2,Carmen,40,ES76209527435549498601,TRX_N-00971-45724842,2024-04-11T14:44:59,Zarautz,Expense,food,-78.79,-57592.55
buyer_2,Carmen,40,ES76209527435549498601,TRX_N-00972-70890299,2024-04-11T05:57:35,Zarautz,expenses,children,-53.74,-57646.29
buyer_2,Carmen,40,ES76209527435549498601,TRX_N-00973-36172759,2024-04-12T15:01:44,Zarautz,Expense,food,-66.63,-57712.92
buyer_2,Carmen,40,ES76209527435549498601,TRX_N-00974-95465426,2024-04-12T06:34:52,Zarautz,Expense,gifts,-171.73,-57884.65
buyer_2,Carmen,40,ES76209527435549498601,TRX_N-00975-22347952,2024-04-13T21:34:02,Zarautz,Expense,leisure,-29.73,-57914.38
buyer_2,Carmen,40,ES76209527435549498601,TRX_N-00976-39239012,2024-04-14T13:37:56,Zarautz,Expense,clothing,-49.33,-57963.71
buyer_2,Carmen,40,ES76209527435549498601,TRX_N-00977-61831585,2024-04-14T12:06:07,Zarautz,Expense,cash,-100.0,-58063.71
buyer_2,Carmen,40,ES76209527435549498601,TRX_N-00978-03031583,2024-04-17T15:54:22,Durango,Expense,leisure,-68.74,-58132.45
buyer_2,Carmen,40,ES76209527435549498601,TRX_N-00979-43711501,2024-04-18T14:12:17,Zarautz,Expense,cash,-100.0,-58232.45
buyer_2,Carmen,40,ES76209527435549498601,TRX_N-00980-53001252,2024-04-19T14:10:29,Zarautz,Expense,transport,-69.51,-58301.96
buyer_2,Carmen,40,ES76209527435549498601,TRX_N-00981-77216228,2024-04-19T20:52:05,Berango,Expense,repairs,-171.11,-58473.07
buyer_2,Carmen,40,ES76209527435549498601,TRX_N-00982-36953222,2024-04-21T04:16:27,Arrasate,Expense,transport,-74.7,-58547.77
buyer_2,Carmen,40,ES76209527435549498601,TRX_N-00983-50237479,2024-04-21T12:43:37,Zarautz,Expense,leisure,-25.23,-58573.0
buyer_2,Carmen,40,ES76209527435549498601,TRX_N-00984-11186099,2024-04-21T07:18:57,Zarautz,Expense,education,-59.78,-58632.78
buyer_2,Carmen,40,ES76209527435549498601,TRX_N-00985-54717688,2024-04-21T17:43:18,Zarautz,expenses,children,-64.09,-58696.87
buyer_2,Carmen,40,ES76209527435549498601,TRX_N-00986-90561694,2024-04-24T15:36:26,Errenteria,Expense,transport,-84.49,-58781.36
buyer_2,Carmen,40,ES76209527435549498601,TRX_N-00987-73863290,2024-04-24T19:01:46,Zarautz,Expense,leisure,-64.15,-58845.51
buyer_2,Carmen,40,ES76209527435549498601,TRX_N-00988-45121087,2024-04-27T14:01:47,Zarautz,Expense,leisure,-54.17,-58899.68
buyer_2,Carmen,40,ES76209527435549498601,TRX_N-00989-68108162,2024-04-28T19:43:21,Andoain,Expense,leisure,-63.16,-58962.84
buyer_2,Carmen,40,ES76209527435549498601,TRX_N-00990-68301337,2024-04-28T15:05:22,Zarautz,Expense,cash,-100.0,-59062.84
buyer_2,Carmen,40,ES76209527435549498601,TRX_N-00991-60817267,2024-04-30T11:21:03,Zarautz,Expense,clothing,-114.21,-59177.05
buyer_2,Carmen,40,ES76209527435549498601,TRX_N-00992-36089077,2024-05-01T13:02:04,Zarautz,incomes,salary,1367.52,-57809.53
buyer_2,Carmen,40,ES76209527435549498601,TRX_N-00993-66829105,2024-05-01T13:02:04,Zarautz,incomes,salary_partner,1054.84,-56754.69
buyer_2,Carmen,40,ES76209527435549498601,TRX_N-00994-60876419,2024-05-01T09:09:35,Zarautz,Expense,repairs,-317.41,-57072.1
buyer_2,Carmen,40,ES76209527435549498601,TRX_N-00995-91823891,2024-05-02T14:02:56,Zarautz,Expense,transport,-69.82,-57141.92
buyer_2,Carmen,40,ES76209527435549498601,TRX_N-00996-71074243,2024-05-03T15:50:05,Zarautz,Expense,healthcare,-49.67,-57191.59
buyer_2,Carmen,40,ES76209527435549498601,TRX_N-00997-29059978,2024-05-04T16:26:11,Zarautz,expenses,mortgage,-713.14,-57904.73
buyer_2,Carmen,40,ES76209527435549498601,TRX_N-00998-60312554,2024-05-04T20:27:30,Zarautz,Expense,leisure,-30.14,-57934.87
buyer_2,Carmen,40,ES76209527435549498601,TRX_N-00999-94994340,2024-05-05T09:04:19,Zarautz,expenses,water,-31.95,-57966.82
buyer_2,Carmen,40,ES76209527435549498601,TRX_N-01000-41702574,2024-05-05T14:24:05,Zarautz,expenses,gas,-96.7,-58063.52
buyer_2,Carmen,40,ES76209527435549498601,TRX_N-01001-80295530,2024-05-05T09:31:55,Lasarte-Oria,Expense,transport,-41.91,-58105.43
buyer_2,Carmen,40,ES76209527435549498601,TRX_N-01002-04569505,2024-05-05T10:29:36,Zarautz,Expense,clothing,-68.81,-58174.24
buyer_2,Carmen,40,ES76209527435549498601,TRX_N-01003-66050942,2024-05-05T12:20:03,Zarautz,Expense,cash,-100.0,-58274.24
buyer_2,Carmen,40,ES76209527435549498601,TRX_N-01004-84699453,2024-05-06T15:43:03,Zarautz,expenses,phone,-41.2,-58315.44
buyer_2,Carmen,40,ES76209527435549498601,TRX_N-01005-15571142,2024-05-07T09:57:46,Zarautz,expenses,internet,-42.0,-58357.44
buyer_2,Carmen,40,ES76209527435549498601,TRX_N-01006-72191191,2024-05-07T12:12:06,Zarautz,Expense,repairs,-41.73,-58399.17
buyer_2,Carmen,40,ES76209527435549498601,TRX_N-01007-48506832,2024-05-08T09:11:11,Zarautz,expenses,electricity,-61.84,-58461.01
buyer_2,Carmen,40,ES76209527435549498601,TRX_N-01008-13050419,2024-05-08T19:00:56,Zarautz,Expense,clothing,-59.68,-58520.69
buyer_2,Carmen,40,ES76209527435549498601,TRX_N-01009-11155532,2024-05-09T10:54:06,Zarautz,Expense,repairs,-219.76,-58740.45
buyer_2,Carmen,40,ES76209527435549498601,TRX_N-01010-13967261,2024-05-10T08:01:18,Zarautz,Expense,cash,-100.0,-58840.45
buyer_2,Carmen,40,ES76209527435549498601,TRX_N-01011-86768763,2024-05-11T16:25:42,Zarautz,Expense,food,-66.9,-58907.35
buyer_2,Carmen,40,ES76209527435549498601,TRX_N-01012-94596327,2024-05-11T09:33:54,Zarautz,Expense,cash,-100.0,-59007.35
buyer_2,Carmen,40,ES76209527435549498601,TRX_N-01013-12393247,2024-05-16T21:15:51,Zarautz,Expense,food,-91.55,-59098.9
buyer_2,Carmen,40,ES76209527435549498601,TRX_N-01014-88036097,2024-05-18T22:04:40,Zarautz,Expense,food,-112.3,-59211.2
buyer_2,Carmen,40,ES76209527435549498601,TRX_N-01015-28096631,2024-05-19T18:09:36,Zarautz,Expense,cash,-100.0,-59311.2
buyer_2,Carmen,40,ES76209527435549498601,TRX_N-01016-38339998,2024-05-20T20:49:39,Zarautz,Expense,gifts,-702.57,-60013.77
buyer_2,Carmen,40,ES76209527435549498601,TRX_N-01017-62156409,2024-05-21T15:27:46,Zarautz,Expense,food,-89.1,-60102.87
buyer_2,Carmen,40,ES76209527435549498601,TRX_N-01018-64481361,2024-05-21T10:22:05,Zarautz,expenses,children,-68.17,-60171.04
buyer_2,Carmen,40,ES76209527435549498601,TRX_N-01019-53185177,2024-05-22T09:58:12,Zarautz,Expense,leisure,-62.67,-60233.71
buyer_2,Carmen,40,ES76209527435549498601,TRX_N-01020-34743153,2024-05-23T19:41:45,Zarautz,Expense,clothing,-76.8,-60310.51
buyer_2,Carmen,40,ES76209527435549498601,TRX_N-01021-69072243,2024-05-25T12:57:26,Zarautz,Expense,leisure,-58.1,-60368.61
buyer_2,Carmen,40,ES76209527435549498601,TRX_N-01022-14444558,2024-05-25T01:35:30,Zarautz,Expense,healthcare,-124.68,-60493.29
buyer_2,Carmen,40,ES76209527435549498601,TRX_N-01023-77280166,2024-05-26T20:18:30,Zarautz,Expense,repairs,-112.87,-60606.16
buyer_2,Carmen,40,ES76209527435549498601,TRX_N-01024-78902481,2024-05-27T08:13:27,Zarautz,Expense,cash,-100.0,-60706.16
buyer_2,Carmen,40,ES76209527435549498601,TRX_N-01025-33122973,2024-05-28T14:38:41,Zarautz,Expense,transport,-85.65,-60791.81
buyer_2,Carmen,40,ES76209527435549498601,TRX_N-01026-60181017,2024-05-28T19:34:31,Zarautz,Expense,leisure,-73.29,-60865.1
buyer_2,Carmen,40,ES76209527435549498601,TRX_N-01027-33815534,2024-05-28T12:35:19,Zarautz,Expense,cash,-100.0,-60965.1
buyer_2,Carmen,40,ES76209527435549498601,TRX_N-01028-04348285,2024-05-28T18:12:39,Zarautz,expenses,children,-194.06,-61159.16
buyer_2,Carmen,40,ES76209527435549498601,TRX_N-01029-63065495,2024-05-29T14:19:54,Zarautz,Expense,cash,-100.0,-61259.16
buyer_2,Carmen,40,ES76209527435549498601,TRX_N-01030-47613658,2024-05-30T11:01:16,Sestao,Expense,appliances,-144.45,-61403.61
buyer_2,Carmen,40,ES76209527435549498601,TRX_N-01031-42258278,2024-06-01T14:15:33,Zarautz,incomes,salary,1367.52,-60036.09
buyer_2,Carmen,40,ES76209527435549498601,TRX_N-01032-28143548,2024-06-01T14:15:33,Zarautz,incomes,salary_partner,1054.84,-58981.25
buyer_2,Carmen,40,ES76209527435549498601,TRX_N-01033-88024148,2024-06-01T14:15:33,Zarautz,incomes,salary_bonus,1002.32,-57978.93
buyer_2,Carmen,40,ES76209527435549498601,TRX_N-01034-47939136,2024-06-01T14:15:33,Zarautz,incomes,salary_partner_bonus,818.34,-57160.59
buyer_2,Carmen,40,ES76209527435549498601,TRX_N-01035-60133283,2024-06-01T09:38:08,Portugalete,Expense,cash,-100.0,-57260.59
buyer_2,Carmen,40,ES76209527435549498601,TRX_N-01036-17589598,2024-06-02T21:52:44,Zarautz,Expense,leisure,-65.36,-57325.95
buyer_2,Carmen,40,ES76209527435549498601,TRX_N-01037-54879977,2024-06-04T18:21:01,Zarautz,expenses,mortgage,-713.14,-58039.09
buyer_2,Carmen,40,ES76209527435549498601,TRX_N-01038-84881421,2024-06-04T17:59:05,Zarautz,Expense,food,-61.7,-58100.79
buyer_2,Carmen,40,ES76209527435549498601,TRX_N-01039-62911748,2024-06-04T01:35:58,Zarautz,Expense,cash,-100.0,-58200.79
buyer_2,Carmen,40,ES76209527435549498601,TRX_N-01040-42781893,2024-06-05T17:29:18,Zarautz,expenses,electricity,-83.98,-58284.77
buyer_2,Carmen,40,ES76209527435549498601,TRX_N-01041-95871070,2024-06-06T19:36:04,Zarautz,expenses,gas,-73.04,-58357.81
buyer_2,Carmen,40,ES76209527435549498601,TRX_N-01042-24630640,2024-06-06T13:50:14,Zarautz,expenses,internet,-42.0,-58399.81
buyer_2,Carmen,40,ES76209527435549498601,TRX_N-01043-10821872,2024-06-06T10:24:53,Zarautz,expenses,phone,-34.85,-58434.66
buyer_2,Carmen,40,ES76209527435549498601,TRX_N-01044-48387452,2024-06-07T13:15:09,Iru√±a de Oca,Expense,healthcare,-152.25,-58586.91
buyer_2,Carmen,40,ES76209527435549498601,TRX_N-01045-96982761,2024-06-08T19:48:53,Zarautz,expenses,water,-21.54,-58608.45
buyer_2,Carmen,40,ES76209527435549498601,TRX_N-01046-41662847,2024-06-08T12:51:19,Zarautz,Expense,clothing,-88.13,-58696.58
buyer_2,Carmen,40,ES76209527435549498601,TRX_N-01047-79810242,2024-06-09T08:41:30,Sestao,Expense,transport,-43.21,-58739.79
buyer_2,Carmen,40,ES76209527435549498601,TRX_N-01048-46795761,2024-06-10T16:51:38,Zarautz,Expense,travel,-679.89,-59419.68
buyer_2,Carmen,40,ES76209527435549498601,TRX_N-01049-17644496,2024-06-11T09:10:27,Zarautz,Expense,transport,-50.22,-59469.9
buyer_2,Carmen,40,ES76209527435549498601,TRX_N-01050-83141674,2024-06-11T17:46:34,Zarautz,Expense,repairs,-202.06,-59671.96
buyer_2,Carmen,40,ES76209527435549498601,TRX_N-01051-41440107,2024-06-12T20:21:05,Zarautz,expenses,children,-102.19,-59774.15
buyer_2,Carmen,40,ES76209527435549498601,TRX_N-01052-77037707,2024-06-14T11:15:56,Zarautz,Expense,food,-102.34,-59876.49
buyer_2,Carmen,40,ES76209527435549498601,TRX_N-01053-18309530,2024-06-14T22:38:01,Zarautz,Expense,cash,-100.0,-59976.49
buyer_2,Carmen,40,ES76209527435549498601,TRX_N-01054-11692161,2024-06-15T12:04:54,Zarautz,Expense,leisure,-65.53,-60042.02
buyer_2,Carmen,40,ES76209527435549498601,TRX_N-01055-25498329,2024-06-16T14:37:53,Zarautz,Expense,food,-93.27,-60135.29
buyer_2,Carmen,40,ES76209527435549498601,TRX_N-01056-80284397,2024-06-16T13:59:06,Galdakao,Expense,cash,-100.0,-60235.29
buyer_2,Carmen,40,ES76209527435549498601,TRX_N-01057-00554297,2024-06-18T20:01:55,Zarautz,Expense,transport,-89.79,-60325.08
buyer_2,Carmen,40,ES76209527435549498601,TRX_N-01058-47974987,2024-06-24T18:27:04,Erandio,Expense,leisure,-83.89,-60408.97
buyer_2,Carmen,40,ES76209527435549498601,TRX_N-01059-37770894,2024-06-25T10:15:06,Zarautz,Expense,clothing,-57.0,-60465.97
buyer_2,Carmen,40,ES76209527435549498601,TRX_N-01060-75061740,2024-06-26T13:30:38,Zarautz,Expense,food,-119.66,-60585.63
buyer_2,Carmen,40,ES76209527435549498601,TRX_N-01061-32654185,2024-06-26T23:46:36,Zarautz,Expense,leisure,-41.13,-60626.76
buyer_2,Carmen,40,ES76209527435549498601,TRX_N-01062-82208744,2024-06-26T21:12:49,Zarautz,Expense,gifts,-245.97,-60872.73
buyer_2,Carmen,40,ES76209527435549498601,TRX_N-01063-61068663,2024-06-27T08:14:40,Zarautz,Expense,food,-78.41,-60951.14
buyer_2,Carmen,40,ES76209527435549498601,TRX_N-01064-28602824,2024-06-27T09:33:28,Zarautz,Expense,leisure,-20.95,-60972.09
buyer_2,Carmen,40,ES76209527435549498601,TRX_N-01065-85823013,2024-06-28T10:13:21,Zarautz,Expense,food,-98.96,-61071.05
buyer_2,Carmen,40,ES76209527435549498601,TRX_N-01066-52621055,2024-06-28T21:20:24,Llodio,Expense,healthcare,-69.83,-61140.88
buyer_2,Carmen,40,ES76209527435549498601,TRX_N-01067-91857565,2024-06-28T19:12:20,Zarautz,Expense,repairs,-227.86,-61368.74
buyer_2,Carmen,40,ES76209527435549498601,TRX_N-01068-98111539,2024-06-29T16:18:16,Zarautz,Expense,food,-85.09,-61453.83
buyer_2,Carmen,40,ES76209527435549498601,TRX_N-01069-64260796,2024-06-30T19:30:17,Zarautz,Expense,transport,-59.97,-61513.8
buyer_2,Carmen,40,ES76209527435549498601,TRX_N-01070-11053029,2024-06-30T14:47:06,Zarautz,Expense,clothing,-60.73,-61574.53
buyer_2,Carmen,40,ES76209527435549498601,TRX_N-01071-76986456,2024-07-01T17:49:59,Zarautz,incomes,salary,1367.52,-60207.01
buyer_2,Carmen,40,ES76209527435549498601,TRX_N-01072-07400657,2024-07-01T17:49:59,Zarautz,incomes,salary_partner,1054.84,-59152.17
buyer_2,Carmen,40,ES76209527435549498601,TRX_N-01073-30282332,2024-07-01T17:49:59,Zarautz,incomes,extra_income,144.79,-59007.38
buyer_2,Carmen,40,ES76209527435549498601,TRX_N-01074-56560130,2024-07-01T15:43:30,Zarautz,Expense,leisure,-24.62,-59032.0
buyer_2,Carmen,40,ES76209527435549498601,TRX_N-01075-90754605,2024-07-01T10:51:24,Zarautz,Expense,gifts,-800.82,-59832.82
buyer_2,Carmen,40,ES76209527435549498601,TRX_N-01076-53366306,2024-07-02T16:34:34,Zarautz,Expense,transport,-40.93,-59873.75
buyer_2,Carmen,40,ES76209527435549498601,TRX_N-01077-39159963,2024-07-03T21:54:04,Zarautz,Expense,appliances,-340.44,-60214.19
buyer_2,Carmen,40,ES76209527435549498601,TRX_N-01078-99829615,2024-07-03T14:31:18,Zarautz,expenses,children,-56.97,-60271.16
buyer_2,Carmen,40,ES76209527435549498601,TRX_N-01079-98372666,2024-07-04T20:31:54,Zarautz,expenses,mortgage,-713.14,-60984.3
buyer_2,Carmen,40,ES76209527435549498601,TRX_N-01080-20339536,2024-07-04T11:57:11,Zarautz,Expense,food,-91.09,-61075.39
buyer_2,Carmen,40,ES76209527435549498601,TRX_N-01081-24691362,2024-07-05T16:21:13,Zarautz,Expense,gifts,-185.17,-61260.56
buyer_2,Carmen,40,ES76209527435549498601,TRX_N-01082-69969492,2024-07-06T20:42:21,Zarautz,expenses,water,-29.65,-61290.21
buyer_2,Carmen,40,ES76209527435549498601,TRX_N-01083-01330041,2024-07-06T08:25:39,Zarautz,expenses,gas,-84.66,-61374.87
buyer_2,Carmen,40,ES76209527435549498601,TRX_N-01084-70565778,2024-07-06T08:16:02,Zarautz,expenses,internet,-42.0,-61416.87
buyer_2,Carmen,40,ES76209527435549498601,TRX_N-01085-37980443,2024-07-06T11:44:45,Zarautz,expenses,phone,-37.7,-61454.57
buyer_2,Carmen,40,ES76209527435549498601,TRX_N-01086-16336694,2024-07-06T11:48:41,Zarautz,Expense,food,-110.27,-61564.84
buyer_2,Carmen,40,ES76209527435549498601,TRX_N-01087-15835102,2024-07-06T18:46:00,Bilbao,Expense,leisure,-47.4,-61612.24
buyer_2,Carmen,40,ES76209527435549498601,TRX_N-01088-44594646,2024-07-06T08:11:17,Zarautz,Expense,education,-58.97,-61671.21
buyer_2,Carmen,40,ES76209527435549498601,TRX_N-01089-97645657,2024-07-07T14:57:46,Zarautz,Expense,cash,-100.0,-61771.21
buyer_2,Carmen,40,ES76209527435549498601,TRX_N-01090-79953020,2024-07-08T13:55:04,Zarautz,expenses,electricity,-73.4,-61844.61
buyer_2,Carmen,40,ES76209527435549498601,TRX_N-01091-67831260,2024-07-09T10:02:05,Zarautz,Expense,repairs,-37.57,-61882.18
buyer_2,Carmen,40,ES76209527435549498601,TRX_N-01092-27736947,2024-07-11T13:18:59,Zarautz,Expense,food,-75.84,-61958.02
buyer_2,Carmen,40,ES76209527435549498601,TRX_N-01093-00373407,2024-07-13T10:15:56,Zarautz,Expense,education,-48.4,-62006.42
buyer_2,Carmen,40,ES76209527435549498601,TRX_N-01094-93459419,2024-07-16T09:58:18,Zarautz,Expense,leisure,-20.61,-62027.03
buyer_2,Carmen,40,ES76209527435549498601,TRX_N-01095-52367511,2024-07-17T16:26:08,Zarautz,Expense,transport,-68.82,-62095.85
buyer_2,Carmen,40,ES76209527435549498601,TRX_N-01096-98966913,2024-07-18T12:34:08,Zarautz,Expense,food,-74.85,-62170.7
buyer_2,Carmen,40,ES76209527435549498601,TRX_N-01097-04127528,2024-07-18T10:30:11,Zarautz,expenses,children,-158.97,-62329.67
buyer_2,Carmen,40,ES76209527435549498601,TRX_N-01098-08580288,2024-07-19T23:07:34,Zarautz,Expense,leisure,-36.5,-62366.17
buyer_2,Carmen,40,ES76209527435549498601,TRX_N-01099-29100380,2024-07-19T19:32:41,Zarautz,Expense,appliances,-231.43,-62597.6
buyer_2,Carmen,40,ES76209527435549498601,TRX_N-01100-49095572,2024-07-23T17:03:50,Zarautz,Expense,gifts,-137.95,-62735.55
buyer_2,Carmen,40,ES76209527435549498601,TRX_N-01101-15692613,2024-07-24T11:19:36,Zarautz,Expense,transport,-67.3,-62802.85
buyer_2,Carmen,40,ES76209527435549498601,TRX_N-01102-14682082,2024-07-25T08:54:28,Sopela,Expense,leisure,-55.25,-62858.1
buyer_2,Carmen,40,ES76209527435549498601,TRX_N-01103-20795350,2024-07-25T10:39:33,Zarautz,Expense,repairs,-149.86,-63007.96
buyer_2,Carmen,40,ES76209527435549498601,TRX_N-01104-00531364,2024-07-26T12:26:57,Zarautz,Expense,gifts,-292.49,-63300.45
buyer_2,Carmen,40,ES76209527435549498601,TRX_N-01105-08123454,2024-07-27T19:03:28,Zarautz,Expense,transport,-63.4,-63363.85
buyer_2,Carmen,40,ES76209527435549498601,TRX_N-01106-20952244,2024-07-27T17:42:38,Zarautz,Expense,gifts,-618.29,-63982.14
buyer_2,Carmen,40,ES76209527435549498601,TRX_N-01107-62067501,2024-07-30T20:46:11,Zarautz,Expense,leisure,-71.07,-64053.21
buyer_2,Carmen,40,ES76209527435549498601,TRX_N-01108-89877164,2024-07-31T16:22:48,Llodio,Expense,food,-98.5,-64151.71
buyer_2,Carmen,40,ES76209527435549498601,TRX_N-01109-54106886,2024-07-31T13:32:29,Zarautz,Expense,transport,-55.31,-64207.02
buyer_2,Carmen,40,ES76209527435549498601,TRX_N-01110-03869547,2024-07-31T09:14:25,Vitoria-Gasteiz,Expense,leisure,-55.03,-64262.05
buyer_2,Carmen,40,ES76209527435549498601,TRX_N-01111-76264199,2024-08-01T18:08:38,Zarautz,incomes,salary,1367.52,-62894.53
buyer_2,Carmen,40,ES76209527435549498601,TRX_N-01112-35394167,2024-08-01T18:08:38,Zarautz,incomes,salary_partner,1054.84,-61839.69
buyer_2,Carmen,40,ES76209527435549498601,TRX_N-01113-00985265,2024-08-01T11:04:48,Zarautz,Expense,food,-123.87,-61963.56
buyer_2,Carmen,40,ES76209527435549498601,TRX_N-01114-22865487,2024-08-03T15:21:53,Zarautz,Expense,food,-67.34,-62030.9
buyer_2,Carmen,40,ES76209527435549498601,TRX_N-01115-10810200,2024-08-03T11:11:14,Zarautz,Expense,cash,-100.0,-62130.9
buyer_2,Carmen,40,ES76209527435549498601,TRX_N-01116-26025625,2024-08-04T06:44:37,Zarautz,expenses,mortgage,-713.14,-62844.04
buyer_2,Carmen,40,ES76209527435549498601,TRX_N-01117-40545536,2024-08-05T18:44:30,Zarautz,expenses,phone,-36.03,-62880.07
buyer_2,Carmen,40,ES76209527435549498601,TRX_N-01118-72692362,2024-08-06T09:49:40,Zarautz,Expense,transport,-79.09,-62959.16
buyer_2,Carmen,40,ES76209527435549498601,TRX_N-01119-86604714,2024-08-06T14:34:31,Barakaldo,Expense,cash,-100.0,-63059.16
buyer_2,Carmen,40,ES76209527435549498601,TRX_N-01120-84418796,2024-08-07T15:03:32,Zarautz,Expense,food,-91.91,-63151.07
buyer_2,Carmen,40,ES76209527435549498601,TRX_N-01121-66299267,2024-08-07T17:15:58,Zarautz,Expense,leisure,-75.16,-63226.23
buyer_2,Carmen,40,ES76209527435549498601,TRX_N-01122-55491774,2024-08-07T21:09:45,Zarautz,Expense,cash,-100.0,-63326.23
buyer_2,Carmen,40,ES76209527435549498601,TRX_N-01123-07432265,2024-08-08T21:00:52,Zarautz,expenses,water,-25.61,-63351.84
buyer_2,Carmen,40,ES76209527435549498601,TRX_N-01124-98952395,2024-08-08T11:05:20,Zarautz,expenses,electricity,-52.28,-63404.12
buyer_2,Carmen,40,ES76209527435549498601,TRX_N-01125-30299013,2024-08-08T16:45:58,Zarautz,expenses,gas,-63.23,-63467.35
buyer_2,Carmen,40,ES76209527435549498601,TRX_N-01126-03003736,2024-08-08T08:18:13,Zarautz,expenses,internet,-42.0,-63509.35
buyer_2,Carmen,40,ES76209527435549498601,TRX_N-01127-77081963,2024-08-08T09:15:32,Zarautz,Expense,food,-119.09,-63628.44
buyer_2,Carmen,40,ES76209527435549498601,TRX_N-01128-09975801,2024-08-08T06:40:36,Durango,Expense,clothing,-82.48,-63710.92
buyer_2,Carmen,40,ES76209527435549498601,TRX_N-01129-71539334,2024-08-08T09:23:51,Zarautz,Expense,gifts,-114.42,-63825.34
buyer_2,Carmen,40,ES76209527435549498601,TRX_N-01130-18121177,2024-08-09T16:13:20,Zarautz,Expense,food,-98.23,-63923.57
buyer_2,Carmen,40,ES76209527435549498601,TRX_N-01131-37793093,2024-08-09T15:23:47,Zarautz,Expense,transport,-82.11,-64005.68
buyer_2,Carmen,40,ES76209527435549498601,TRX_N-01132-55205504,2024-08-11T14:21:37,Zarautz,Expense,transport,-56.02,-64061.7
buyer_2,Carmen,40,ES76209527435549498601,TRX_N-01133-98938497,2024-08-11T07:30:34,Zarautz,Expense,leisure,-21.98,-64083.68
buyer_2,Carmen,40,ES76209527435549498601,TRX_N-01134-27900426,2024-08-11T12:18:20,Zarautz,Expense,repairs,-299.87,-64383.55
buyer_2,Carmen,40,ES76209527435549498601,TRX_N-01135-16360945,2024-08-12T18:29:24,Zarautz,Expense,leisure,-79.59,-64463.14
buyer_2,Carmen,40,ES76209527435549498601,TRX_N-01136-72789101,2024-08-13T11:14:12,Zarautz,Expense,leisure,-32.34,-64495.48
buyer_2,Carmen,40,ES76209527435549498601,TRX_N-01137-43104365,2024-08-14T23:16:40,Zarautz,Expense,food,-60.05,-64555.53
buyer_2,Carmen,40,ES76209527435549498601,TRX_N-01138-48782807,2024-08-14T12:05:14,Zarautz,expenses,children,-238.82,-64794.35
buyer_2,Carmen,40,ES76209527435549498601,TRX_N-01139-54666824,2024-08-16T12:48:42,Leioa,Expense,education,-43.74,-64838.09
buyer_2,Carmen,40,ES76209527435549498601,TRX_N-01140-96424019,2024-08-17T14:11:31,Zarautz,Expense,leisure,-26.34,-64864.43
buyer_2,Carmen,40,ES76209527435549498601,TRX_N-01141-28425503,2024-08-17T19:59:20,Zarautz,Expense,gifts,-527.02,-65391.45
buyer_2,Carmen,40,ES76209527435549498601,TRX_N-01142-52539043,2024-08-19T09:26:14,Zarautz,Expense,gifts,-816.33,-66207.78
buyer_2,Carmen,40,ES76209527435549498601,TRX_N-01143-31810348,2024-08-21T12:23:57,Zarautz,Expense,cash,-100.0,-66307.78
buyer_2,Carmen,40,ES76209527435549498601,TRX_N-01144-35359657,2024-08-25T18:26:41,Zarautz,Expense,food,-88.32,-66396.1
buyer_2,Carmen,40,ES76209527435549498601,TRX_N-01145-88592944,2024-08-25T13:05:24,Zarautz,Expense,repairs,-260.72,-66656.82
buyer_2,Carmen,40,ES76209527435549498601,TRX_N-01146-24098109,2024-08-26T16:59:15,Arrasate,Expense,leisure,-33.62,-66690.44
buyer_2,Carmen,40,ES76209527435549498601,TRX_N-01147-72590010,2024-08-27T22:45:16,Zarautz,Expense,cash,-100.0,-66790.44
buyer_2,Carmen,40,ES76209527435549498601,TRX_N-01148-05792826,2024-08-27T08:30:49,Zarautz,expenses,children,-246.45,-67036.89
buyer_2,Carmen,40,ES76209527435549498601,TRX_N-01149-64424175,2024-08-28T21:37:47,Zarautz,Expense,leisure,-52.6,-67089.49
buyer_2,Carmen,40,ES76209527435549498601,TRX_N-01150-79996967,2024-08-29T17:53:04,Zarautz,Expense,clothing,-48.67,-67138.16
buyer_2,Carmen,40,ES76209527435549498601,TRX_N-01151-41329167,2024-08-29T11:05:09,Zarautz,Expense,gifts,-428.24,-67566.4
buyer_2,Carmen,40,ES76209527435549498601,TRX_N-01152-14743412,2024-08-29T21:17:07,Zarautz,expenses,children,-160.13,-67726.53
buyer_2,Carmen,40,ES76209527435549498601,TRX_N-01153-59913593,2024-08-30T15:17:18,Zarautz,Expense,healthcare,-172.76,-67899.29
buyer_2,Carmen,40,ES76209527435549498601,TRX_N-01154-88909067,2024-08-30T08:33:04,Zarautz,Expense,cash,-100.0,-67999.29
buyer_2,Carmen,40,ES76209527435549498601,TRX_N-01155-89080283,2024-08-31T11:23:25,Zarautz,Expense,food,-119.92,-68119.21
buyer_2,Carmen,40,ES76209527435549498601,TRX_N-01156-53997670,2024-08-31T19:34:38,Zarautz,Expense,clothing,-143.35,-68262.56
buyer_2,Carmen,40,ES76209527435549498601,TRX_N-01157-07161931,2024-09-01T17:35:16,Zarautz,incomes,salary,1367.52,-66895.04
buyer_2,Carmen,40,ES76209527435549498601,TRX_N-01158-40164331,2024-09-01T17:35:16,Zarautz,incomes,salary_partner,1054.84,-65840.2
buyer_2,Carmen,40,ES76209527435549498601,TRX_N-01159-55595640,2024-09-02T22:53:09,Zarautz,Expense,education,-66.44,-65906.64
buyer_2,Carmen,40,ES76209527435549498601,TRX_N-01160-55493533,2024-09-04T20:55:41,Zarautz,expenses,mortgage,-713.14,-66619.78
buyer_2,Carmen,40,ES76209527435549498601,TRX_N-01161-13948388,2024-09-04T22:26:19,Zarautz,Expense,healthcare,-153.56,-66773.34
buyer_2,Carmen,40,ES76209527435549498601,TRX_N-01162-01508912,2024-09-06T20:01:34,Zarautz,expenses,electricity,-69.57,-66842.91
buyer_2,Carmen,40,ES76209527435549498601,TRX_N-01163-49483982,2024-09-07T20:14:38,Zarautz,Expense,transport,-83.47,-66926.38
buyer_2,Carmen,40,ES76209527435549498601,TRX_N-01164-42382902,2024-09-08T18:13:31,Zarautz,expenses,water,-35.52,-66961.9
buyer_2,Carmen,40,ES76209527435549498601,TRX_N-01165-01256976,2024-09-08T09:37:50,Zarautz,expenses,gas,-39.14,-67001.04
buyer_2,Carmen,40,ES76209527435549498601,TRX_N-01166-33216011,2024-09-08T15:14:37,Zarautz,expenses,internet,-42.0,-67043.04
buyer_2,Carmen,40,ES76209527435549498601,TRX_N-01167-93878076,2024-09-08T21:47:32,Zarautz,expenses,phone,-31.54,-67074.58
buyer_2,Carmen,40,ES76209527435549498601,TRX_N-01168-22106476,2024-09-09T15:20:44,Zarautz,Expense,food,-80.06,-67154.64
buyer_2,Carmen,40,ES76209527435549498601,TRX_N-01169-47322671,2024-09-09T14:56:50,Zarautz,expenses,children,-68.69,-67223.33
buyer_2,Carmen,40,ES76209527435549498601,TRX_N-01170-03774447,2024-09-11T11:05:52,Zarautz,Expense,transport,-41.02,-67264.35
buyer_2,Carmen,40,ES76209527435549498601,TRX_N-01171-92799101,2024-09-12T22:19:12,Zarautz,Expense,leisure,-59.44,-67323.79
buyer_2,Carmen,40,ES76209527435549498601,TRX_N-01172-57808302,2024-09-12T11:38:06,Zarautz,Expense,repairs,-289.31,-67613.1
buyer_2,Carmen,40,ES76209527435549498601,TRX_N-01173-29275609,2024-09-13T18:56:20,Mungia,Expense,food,-84.03,-67697.13
buyer_2,Carmen,40,ES76209527435549498601,TRX_N-01174-43243645,2024-09-13T12:40:31,Zarautz,Expense,cash,-100.0,-67797.13
buyer_2,Carmen,40,ES76209527435549498601,TRX_N-01175-24355504,2024-09-13T20:40:04,Eibar,Expense,repairs,-191.83,-67988.96
buyer_2,Carmen,40,ES76209527435549498601,TRX_N-01176-88486153,2024-09-14T17:08:48,Zarautz,Expense,repairs,-41.39,-68030.35
buyer_2,Carmen,40,ES76209527435549498601,TRX_N-01177-00058650,2024-09-16T09:16:14,Zarautz,Expense,leisure,-20.71,-68051.06
buyer_2,Carmen,40,ES76209527435549498601,TRX_N-01178-39170825,2024-09-18T20:27:41,Zarautz,Expense,cash,-100.0,-68151.06
buyer_2,Carmen,40,ES76209527435549498601,TRX_N-01179-72232892,2024-09-19T22:35:35,Berango,Expense,leisure,-35.44,-68186.5
buyer_2,Carmen,40,ES76209527435549498601,TRX_N-01180-53342517,2024-09-19T21:06:47,Basauri,Expense,healthcare,-114.42,-68300.92
buyer_2,Carmen,40,ES76209527435549498601,TRX_N-01181-37527680,2024-09-21T17:24:56,Zarautz,Expense,cash,-100.0,-68400.92
buyer_2,Carmen,40,ES76209527435549498601,TRX_N-01182-18640267,2024-09-23T12:21:24,Zarautz,Expense,appliances,-319.23,-68720.15
buyer_2,Carmen,40,ES76209527435549498601,TRX_N-01183-85394854,2024-09-24T22:31:56,Zarautz,Expense,gifts,-189.21,-68909.36
buyer_2,Carmen,40,ES76209527435549498601,TRX_N-01184-54150544,2024-09-26T08:11:52,Arrasate,Expense,leisure,-36.64,-68946.0
buyer_2,Carmen,40,ES76209527435549498601,TRX_N-01185-31464844,2024-09-26T15:31:41,Zarautz,Expense,clothing,-127.46,-69073.46
buyer_2,Carmen,40,ES76209527435549498601,TRX_N-01186-86720826,2024-09-27T11:05:26,Zuia,Expense,transport,-83.07,-69156.53
buyer_2,Carmen,40,ES76209527435549498601,TRX_N-01187-38125718,2024-09-27T13:08:32,Zarautz,Expense,appliances,-239.44,-69395.97
buyer_2,Carmen,40,ES76209527435549498601,TRX_N-01188-53601512,2024-09-27T18:12:23,Zarautz,Expense,gifts,-202.0,-69597.97
buyer_2,Carmen,40,ES76209527435549498601,TRX_N-01189-22115102,2024-09-28T14:28:45,Leioa,Expense,leisure,-81.59,-69679.56
buyer_2,Carmen,40,ES76209527435549498601,TRX_N-01190-23845726,2024-09-29T16:09:12,Berango,Expense,food,-76.68,-69756.24
buyer_2,Carmen,40,ES76209527435549498601,TRX_N-01191-53476511,2024-10-01T13:38:51,Zarautz,incomes,salary,1367.52,-68388.72
buyer_2,Carmen,40,ES76209527435549498601,TRX_N-01192-53066557,2024-10-01T13:38:51,Zarautz,incomes,salary_partner,1054.84,-67333.88
buyer_2,Carmen,40,ES76209527435549498601,TRX_N-01193-59337911,2024-10-01T13:38:51,Zarautz,incomes,extra_income,144.79,-67189.09
buyer_2,Carmen,40,ES76209527435549498601,TRX_N-01194-66932572,2024-10-03T09:09:26,Zarautz,Expense,leisure,-42.12,-67231.21
buyer_2,Carmen,40,ES76209527435549498601,TRX_N-01195-38324891,2024-10-04T14:40:23,Zarautz,expenses,mortgage,-713.14,-67944.35
buyer_2,Carmen,40,ES76209527435549498601,TRX_N-01196-51668307,2024-10-05T17:00:15,Zarautz,expenses,water,-38.21,-67982.56
buyer_2,Carmen,40,ES76209527435549498601,TRX_N-01197-19723844,2024-10-06T20:43:04,Zarautz,expenses,internet,-42.0,-68024.56
buyer_2,Carmen,40,ES76209527435549498601,TRX_N-01198-52082835,2024-10-06T19:04:34,Zarautz,Expense,food,-97.39,-68121.95
buyer_2,Carmen,40,ES76209527435549498601,TRX_N-01199-42047999,2024-10-07T21:50:36,Zarautz,expenses,phone,-43.61,-68165.56
buyer_2,Carmen,40,ES76209527435549498601,TRX_N-01200-33012791,2024-10-07T11:05:23,Berango,Expense,food,-75.38,-68240.94
buyer_2,Carmen,40,ES76209527435549498601,TRX_N-01201-80628096,2024-10-08T14:48:53,Zarautz,expenses,electricity,-27.28,-68268.22
buyer_2,Carmen,40,ES76209527435549498601,TRX_N-01202-21962247,2024-10-08T17:24:50,Zarautz,expenses,gas,-39.53,-68307.75
buyer_3,Ana,35,ES85209524939783321778,TRX_N-00001-48541360,2022-01-01T16:24:37,Amurrio,incomes,salary,1383.21,3164.52
buyer_3,Ana,35,ES85209524939783321778,TRX_N-00002-81759604,2022-01-01T16:24:37,Amurrio,incomes,salary_partner,1361.44,4525.96
buyer_3,Ana,35,ES85209524939783321778,TRX_N-00003-82825316,2022-01-01T17:12:22,Amurrio,expenses,children,-274.37,4251.59
buyer_3,Ana,35,ES85209524939783321778,TRX_N-00004-83799495,2022-01-04T16:50:32,Amurrio,expenses,mortgage,-912.03,3339.56
buyer_3,Ana,35,ES85209524939783321778,TRX_N-00005-17007301,2022-01-04T00:58:41,Amurrio,Expense,travel,-816.65,2522.91
buyer_3,Ana,35,ES85209524939783321778,TRX_N-00006-51049143,2022-01-05T09:30:05,Amurrio,expenses,gas,-89.5,2433.41
buyer_3,Ana,35,ES85209524939783321778,TRX_N-00007-01086537,2022-01-06T23:11:52,Amurrio,expenses,water,-34.19,2399.22
buyer_3,Ana,35,ES85209524939783321778,TRX_N-00008-86694247,2022-01-06T08:01:21,Amurrio,expenses,internet,-42.0,2357.22
buyer_3,Ana,35,ES85209524939783321778,TRX_N-00009-67676741,2022-01-07T07:53:35,Amurrio,expenses,phone,-35.56,2321.66
buyer_3,Ana,35,ES85209524939783321778,TRX_N-00010-95315338,2022-01-08T12:09:41,Amurrio,expenses,electricity,-37.98,2283.68
buyer_3,Ana,35,ES85209524939783321778,TRX_N-00011-88748322,2022-01-08T13:41:11,Amurrio,Expense,cash,-100.0,2183.68
buyer_3,Ana,35,ES85209524939783321778,TRX_N-00012-89332491,2022-01-09T09:42:35,Amurrio,Expense,transport,-75.57,2108.11
buyer_3,Ana,35,ES85209524939783321778,TRX_N-00013-93027791,2022-01-09T10:38:47,Amurrio,Expense,leisure,-48.38,2059.73
buyer_3,Ana,35,ES85209524939783321778,TRX_N-00014-48662838,2022-01-10T17:23:25,Amurrio,Expense,clothing,-59.13,2000.6
buyer_3,Ana,35,ES85209524939783321778,TRX_N-00015-30682124,2022-01-11T16:03:38,Amurrio,Expense,cash,-100.0,1900.6
buyer_3,Ana,35,ES85209524939783321778,TRX_N-00016-78208597,2022-01-14T15:38:39,Amurrio,Expense,transport,-47.31,1853.29
buyer_3,Ana,35,ES85209524939783321778,TRX_N-00017-77458219,2022-01-15T12:04:46,Amurrio,Expense,cash,-100.0,1753.29
buyer_3,Ana,35,ES85209524939783321778,TRX_N-00018-45675393,2022-01-16T19:16:43,Amurrio,Expense,leisure,-76.46,1676.83
buyer_3,Ana,35,ES85209524939783321778,TRX_N-00019-56514312,2022-01-16T15:46:11,Amurrio,Expense,cash,-100.0,1576.83
buyer_3,Ana,35,ES85209524939783321778,TRX_N-00020-84059881,2022-01-18T16:57:41,Amurrio,Expense,leisure,-45.93,1530.9
buyer_3,Ana,35,ES85209524939783321778,TRX_N-00021-26608798,2022-01-19T20:10:04,Amurrio,Expense,cash,-100.0,1430.9
buyer_3,Ana,35,ES85209524939783321778,TRX_N-00022-62218385,2022-01-20T12:53:17,Amurrio,Expense,leisure,-80.66,1350.24
buyer_3,Ana,35,ES85209524939783321778,TRX_N-00023-53052814,2022-01-21T16:38:56,Amurrio,Expense,clothing,-129.14,1221.1
buyer_3,Ana,35,ES85209524939783321778,TRX_N-00024-71515923,2022-01-22T13:14:35,Amurrio,Expense,healthcare,-99.84,1121.26
buyer_3,Ana,35,ES85209524939783321778,TRX_N-00025-42593376,2022-01-23T00:48:46,Amurrio,Expense,clothing,-89.87,1031.39
buyer_3,Ana,35,ES85209524939783321778,TRX_N-00026-50337376,2022-01-25T13:21:45,Portugalete,Expense,cash,-100.0,931.39
buyer_3,Ana,35,ES85209524939783321778,TRX_N-00027-11068265,2022-01-27T05:29:43,Amurrio,Expense,transport,-66.89,864.5
buyer_3,Ana,35,ES85209524939783321778,TRX_N-00028-57257078,2022-01-27T23:47:00,Amurrio,Expense,cash,-100.0,764.5
buyer_3,Ana,35,ES85209524939783321778,TRX_N-00029-80068306,2022-01-27T04:08:45,Amurrio,Expense,repairs,-296.47,468.03
buyer_3,Ana,35,ES85209524939783321778,TRX_N-00030-65730585,2022-01-30T14:00:18,Irun,Expense,leisure,-78.26,389.77
buyer_3,Ana,35,ES85209524939783321778,TRX_N-00031-30981344,2022-01-31T14:08:20,Sestao,Expense,food,-112.09,277.68
buyer_3,Ana,35,ES85209524939783321778,TRX_N-00032-08471892,2022-02-01T08:23:51,Amurrio,incomes,salary,1383.21,1660.89
buyer_3,Ana,35,ES85209524939783321778,TRX_N-00033-89504816,2022-02-01T08:23:51,Amurrio,incomes,salary_partner,1361.44,3022.33
buyer_3,Ana,35,ES85209524939783321778,TRX_N-00034-45773903,2022-02-03T13:01:40,Amurrio,Expense,education,-56.42,2965.91
buyer_3,Ana,35,ES85209524939783321778,TRX_N-00035-90506350,2022-02-04T11:48:43,Amurrio,expenses,mortgage,-912.03,2053.88
buyer_3,Ana,35,ES85209524939783321778,TRX_N-00036-73514129,2022-02-04T12:35:06,Amurrio,Expense,clothing,-105.84,1948.04
buyer_3,Ana,35,ES85209524939783321778,TRX_N-00037-69809126,2022-02-05T17:15:20,Amurrio,expenses,water,-30.61,1917.43
buyer_3,Ana,35,ES85209524939783321778,TRX_N-00038-47545149,2022-02-06T17:37:53,Amurrio,expenses,phone,-40.95,1876.48
buyer_3,Ana,35,ES85209524939783321778,TRX_N-00039-83947079,2022-02-06T13:39:34,Amurrio,Expense,food,-68.23,1808.25
buyer_3,Ana,35,ES85209524939783321778,TRX_N-00040-58091353,2022-02-06T19:38:39,Amurrio,expenses,children,-213.09,1595.16
buyer_3,Ana,35,ES85209524939783321778,TRX_N-00041-54116226,2022-02-07T17:23:16,Amurrio,expenses,gas,-81.48,1513.68
buyer_3,Ana,35,ES85209524939783321778,TRX_N-00042-21495795,2022-02-08T19:41:53,Amurrio,expenses,internet,-42.0,1471.68
buyer_3,Ana,35,ES85209524939783321778,TRX_N-00043-51208334,2022-02-08T18:52:01,Amurrio,expenses,electricity,-37.8,1433.88
buyer_3,Ana,35,ES85209524939783321778,TRX_N-00044-53472894,2022-02-09T21:05:49,Amurrio,Expense,education,-47.78,1386.1
buyer_3,Ana,35,ES85209524939783321778,TRX_N-00045-01870001,2022-02-10T20:54:17,Galdakao,Expense,transport,-58.91,1327.19
buyer_3,Ana,35,ES85209524939783321778,TRX_N-00046-78957581,2022-02-10T17:49:48,Amurrio,Expense,repairs,-63.83,1263.36
buyer_3,Ana,35,ES85209524939783321778,TRX_N-00047-16808520,2022-02-11T15:13:33,Amurrio,Expense,transport,-44.54,1218.82
buyer_3,Ana,35,ES85209524939783321778,TRX_N-00048-17172511,2022-02-15T17:56:11,Amurrio,Expense,food,-120.55,1098.27
buyer_3,Ana,35,ES85209524939783321778,TRX_N-00049-84568519,2022-02-16T11:36:00,Sestao,Expense,food,-87.23,1011.04
buyer_3,Ana,35,ES85209524939783321778,TRX_N-00050-19799790,2022-02-16T18:10:25,Amurrio,Expense,clothing,-119.21,891.83
buyer_3,Ana,35,ES85209524939783321778,TRX_N-00051-64453159,2022-02-17T12:03:28,Amurrio,Expense,leisure,-57.48,834.35
buyer_3,Ana,35,ES85209524939783321778,TRX_N-00052-22240461,2022-02-18T15:47:10,Amurrio,Expense,food,-99.82,734.53
buyer_3,Ana,35,ES85209524939783321778,TRX_N-00053-59386692,2022-02-18T14:17:10,Amurrio,Expense,education,-75.83,658.7
buyer_3,Ana,35,ES85209524939783321778,TRX_N-00054-30336215,2022-02-20T11:26:13,Amurrio,Expense,transport,-88.31,570.39
buyer_3,Ana,35,ES85209524939783321778,TRX_N-00055-51351754,2022-02-20T15:43:48,Leioa,Expense,cash,-100.0,470.39
buyer_3,Ana,35,ES85209524939783321778,TRX_N-00056-49347316,2022-02-21T13:59:08,Amurrio,Expense,transport,-64.05,406.34
buyer_3,Ana,35,ES85209524939783321778,TRX_N-00057-18670384,2022-02-22T11:20:28,Amurrio,Expense,clothing,-100.48,305.86
buyer_3,Ana,35,ES85209524939783321778,TRX_N-00058-21881560,2022-02-23T08:02:37,Llodio,Expense,education,-57.07,248.79
buyer_3,Ana,35,ES85209524939783321778,TRX_N-00059-87635037,2022-02-24T17:22:05,Amurrio,Expense,cash,-100.0,148.79
buyer_3,Ana,35,ES85209524939783321778,TRX_N-00060-84414525,2022-02-25T17:23:39,Amurrio,Expense,leisure,-79.78,69.01
buyer_3,Ana,35,ES85209524939783321778,TRX_N-00061-05437948,2022-02-25T20:47:21,Amurrio,expenses,children,-217.16,-148.15
buyer_3,Ana,35,ES85209524939783321778,TRX_N-00062-09359665,2022-02-26T20:26:00,Amurrio,Expense,leisure,-83.0,-231.15
buyer_3,Ana,35,ES85209524939783321778,TRX_N-00063-00743084,2022-03-01T13:22:22,Amurrio,incomes,salary,1383.21,1152.06
buyer_3,Ana,35,ES85209524939783321778,TRX_N-00064-12732059,2022-03-01T13:22:22,Amurrio,incomes,salary_partner,1361.44,2513.5
buyer_3,Ana,35,ES85209524939783321778,TRX_N-00065-00662232,2022-03-01T13:22:22,Amurrio,incomes,extra_income,257.05,2770.55
buyer_3,Ana,35,ES85209524939783321778,TRX_N-00066-75835221,2022-03-01T14:04:09,Santurtzi,Expense,food,-83.39,2687.16
buyer_3,Ana,35,ES85209524939783321778,TRX_N-00067-36868876,2022-03-01T19:35:19,Amurrio,Expense,leisure,-29.81,2657.35
buyer_3,Ana,35,ES85209524939783321778,TRX_N-00068-42554545,2022-03-01T16:05:37,Amurrio,Expense,repairs,-250.01,2407.34
buyer_3,Ana,35,ES85209524939783321778,TRX_N-00069-39094185,2022-03-03T01:13:02,Amurrio,Expense,leisure,-74.61,2332.73
buyer_3,Ana,35,ES85209524939783321778,TRX_N-00070-65164631,2022-03-04T19:35:34,Amurrio,expenses,mortgage,-912.03,1420.7
buyer_3,Ana,35,ES85209524939783321778,TRX_N-00071-16295913,2022-03-04T20:50:12,Amurrio,Expense,cash,-100.0,1320.7
buyer_3,Ana,35,ES85209524939783321778,TRX_N-00072-07294797,2022-03-04T17:33:38,Amurrio,Expense,gifts,-266.12,1054.58
buyer_3,Ana,35,ES85209524939783321778,TRX_N-00073-49825919,2022-03-05T19:58:44,Amurrio,Expense,transport,-78.84,975.74
buyer_3,Ana,35,ES85209524939783321778,TRX_N-00074-94274876,2022-03-06T11:57:44,Amurrio,expenses,phone,-40.21,935.53
buyer_3,Ana,35,ES85209524939783321778,TRX_N-00075-00495612,2022-03-06T18:56:19,Amurrio,Expense,food,-93.33,842.2
buyer_3,Ana,35,ES85209524939783321778,TRX_N-00076-27144002,2022-03-06T04:40:12,Pasaia,Expense,clothing,-85.46,756.74
buyer_3,Ana,35,ES85209524939783321778,TRX_N-00077-92853758,2022-03-06T18:32:28,Amurrio,Expense,gifts,-93.77,662.97
buyer_3,Ana,35,ES85209524939783321778,TRX_N-00078-29348545,2022-03-06T21:52:39,Amurrio,expenses,children,-151.68,511.29
buyer_3,Ana,35,ES85209524939783321778,TRX_N-00079-84363216,2022-03-07T15:00:26,Amurrio,Expense,cash,-100.0,411.29
buyer_3,Ana,35,ES85209524939783321778,TRX_N-00080-54290797,2022-03-08T15:14:12,Amurrio,expenses,water,-39.06,372.23
buyer_3,Ana,35,ES85209524939783321778,TRX_N-00081-41593150,2022-03-08T09:01:07,Amurrio,expenses,electricity,-81.34,290.89
buyer_3,Ana,35,ES85209524939783321778,TRX_N-00082-81473699,2022-03-08T13:53:12,Amurrio,expenses,gas,-108.78,182.11
buyer_3,Ana,35,ES85209524939783321778,TRX_N-00083-85698969,2022-03-08T01:51:10,Amurrio,expenses,internet,-42.0,140.11
buyer_3,Ana,35,ES85209524939783321778,TRX_N-00084-38127314,2022-03-08T08:10:38,Amurrio,Expense,cash,-100.0,40.11
buyer_3,Ana,35,ES85209524939783321778,TRX_N-00085-69310748,2022-03-09T23:08:26,Irun,Expense,food,-84.22,-44.11
buyer_3,Ana,35,ES85209524939783321778,TRX_N-00086-90588484,2022-03-13T11:55:12,Amurrio,Expense,healthcare,-102.26,-146.37
buyer_3,Ana,35,ES85209524939783321778,TRX_N-00087-45106987,2022-03-15T09:28:04,Amurrio,Expense,education,-47.49,-193.86
buyer_3,Ana,35,ES85209524939783321778,TRX_N-00088-82987079,2022-03-15T08:31:29,Amurrio,Expense,gifts,-603.36,-797.22
buyer_3,Ana,35,ES85209524939783321778,TRX_N-00089-10284003,2022-03-16T11:32:27,Amurrio,Expense,clothing,-70.69,-867.91
buyer_3,Ana,35,ES85209524939783321778,TRX_N-00090-68474216,2022-03-16T10:07:31,Amurrio,Expense,cash,-100.0,-967.91
buyer_3,Ana,35,ES85209524939783321778,TRX_N-00091-87829964,2022-03-17T21:23:26,Amurrio,Expense,transport,-45.18,-1013.09
buyer_3,Ana,35,ES85209524939783321778,TRX_N-00092-19686615,2022-03-17T11:11:49,Amurrio,Expense,leisure,-46.23,-1059.32
buyer_3,Ana,35,ES85209524939783321778,TRX_N-00093-94828437,2022-03-17T08:07:24,Arrasate,Expense,clothing,-70.08,-1129.4
buyer_3,Ana,35,ES85209524939783321778,TRX_N-00094-25717195,2022-03-19T08:19:55,Amurrio,Expense,leisure,-41.31,-1170.71
buyer_3,Ana,35,ES85209524939783321778,TRX_N-00095-07826111,2022-03-20T14:12:32,Amurrio,Expense,transport,-82.74,-1253.45
buyer_3,Ana,35,ES85209524939783321778,TRX_N-00096-55352598,2022-03-24T08:32:48,Amurrio,Expense,leisure,-36.79,-1290.24
buyer_3,Ana,35,ES85209524939783321778,TRX_N-00097-91014625,2022-03-28T23:58:59,Amurrio,Expense,transport,-40.7,-1330.94
buyer_3,Ana,35,ES85209524939783321778,TRX_N-00098-62799346,2022-03-28T14:03:20,Labastida,Expense,leisure,-63.49,-1394.43
buyer_3,Ana,35,ES85209524939783321778,TRX_N-00099-89434518,2022-03-29T09:24:02,Amurrio,Expense,leisure,-20.98,-1415.41
buyer_3,Ana,35,ES85209524939783321778,TRX_N-00100-20280291,2022-03-29T04:21:29,Amurrio,Expense,cash,-100.0,-1515.41
buyer_3,Ana,35,ES85209524939783321778,TRX_N-00101-83014954,2022-04-01T16:38:57,Amurrio,incomes,salary,1383.21,-132.2
buyer_3,Ana,35,ES85209524939783321778,TRX_N-00102-64415569,2022-04-01T16:38:57,Amurrio,incomes,salary_partner,1361.44,1229.24
buyer_3,Ana,35,ES85209524939783321778,TRX_N-00103-09480219,2022-04-01T13:58:37,Amurrio,Expense,transport,-81.47,1147.77
buyer_3,Ana,35,ES85209524939783321778,TRX_N-00104-75800637,2022-04-01T23:04:47,Amurrio,Expense,appliances,-325.66,822.11
buyer_3,Ana,35,ES85209524939783321778,TRX_N-00105-38466036,2022-04-04T19:17:24,Amurrio,expenses,mortgage,-912.03,-89.92
buyer_3,Ana,35,ES85209524939783321778,TRX_N-00106-16525860,2022-04-05T22:25:23,Amurrio,expenses,phone,-32.29,-122.21
buyer_3,Ana,35,ES85209524939783321778,TRX_N-00107-52768983,2022-04-05T18:24:10,Amurrio,Expense,food,-63.5,-185.71
buyer_3,Ana,35,ES85209524939783321778,TRX_N-00108-66125601,2022-04-06T20:14:13,Amurrio,expenses,internet,-42.0,-227.71
buyer_3,Ana,35,ES85209524939783321778,TRX_N-00109-26228202,2022-04-08T18:21:24,Amurrio,expenses,gas,-113.44,-341.15
buyer_3,Ana,35,ES85209524939783321778,TRX_N-00110-54304149,2022-04-08T16:13:56,Amurrio,expenses,water,-26.72,-367.87
buyer_3,Ana,35,ES85209524939783321778,TRX_N-00111-05921796,2022-04-08T17:36:16,Amurrio,expenses,electricity,-58.29,-426.16
buyer_3,Ana,35,ES85209524939783321778,TRX_N-00112-32105032,2022-04-08T19:52:10,Amurrio,Expense,food,-88.93,-515.09
buyer_3,Ana,35,ES85209524939783321778,TRX_N-00113-94034299,2022-04-10T20:55:32,Amurrio,Expense,food,-91.78,-606.87
buyer_3,Ana,35,ES85209524939783321778,TRX_N-00114-87991290,2022-04-10T10:30:45,Amurrio,Expense,healthcare,-147.27,-754.14
buyer_3,Ana,35,ES85209524939783321778,TRX_N-00115-00802321,2022-04-11T13:04:31,Amurrio,Expense,food,-90.17,-844.31
buyer_3,Ana,35,ES85209524939783321778,TRX_N-00116-23978906,2022-04-12T09:54:27,Amurrio,Expense,leisure,-73.48,-917.79
buyer_3,Ana,35,ES85209524939783321778,TRX_N-00117-98390889,2022-04-15T16:31:12,Amurrio,Expense,transport,-68.62,-986.41
buyer_3,Ana,35,ES85209524939783321778,TRX_N-00118-14610712,2022-04-15T18:11:32,Hernani,Expense,repairs,-43.77,-1030.18
buyer_3,Ana,35,ES85209524939783321778,TRX_N-00119-00834016,2022-04-16T06:54:17,Leioa,Expense,food,-89.46,-1119.64
buyer_3,Ana,35,ES85209524939783321778,TRX_N-00120-06005086,2022-04-16T16:12:01,Amurrio,Expense,transport,-86.85,-1206.49
buyer_3,Ana,35,ES85209524939783321778,TRX_N-00121-96249255,2022-04-16T11:26:54,Zarautz,Expense,cash,-100.0,-1306.49
buyer_3,Ana,35,ES85209524939783321778,TRX_N-00122-31885024,2022-04-16T23:28:06,Amurrio,Expense,gifts,-268.8,-1575.29
buyer_3,Ana,35,ES85209524939783321778,TRX_N-00123-86669506,2022-04-18T09:04:06,Amurrio,Expense,food,-122.99,-1698.28
buyer_3,Ana,35,ES85209524939783321778,TRX_N-00124-18606308,2022-04-18T23:37:45,Berango,Expense,cash,-100.0,-1798.28
buyer_3,Ana,35,ES85209524939783321778,TRX_N-00125-61421439,2022-04-20T20:26:17,Amurrio,Expense,leisure,-42.19,-1840.47
buyer_3,Ana,35,ES85209524939783321778,TRX_N-00126-59420352,2022-04-24T17:55:43,Amurrio,Expense,leisure,-43.26,-1883.73
buyer_3,Ana,35,ES85209524939783321778,TRX_N-00127-89992809,2022-04-26T16:47:47,Amurrio,Expense,food,-91.57,-1975.3
buyer_3,Ana,35,ES85209524939783321778,TRX_N-00128-03195961,2022-04-26T20:35:43,Amurrio,Expense,appliances,-339.86,-2315.16
buyer_3,Ana,35,ES85209524939783321778,TRX_N-00129-49346278,2022-04-30T19:19:13,Amurrio,Expense,food,-106.25,-2421.41
buyer_3,Ana,35,ES85209524939783321778,TRX_N-00130-34873555,2022-04-30T17:58:48,Amurrio,Expense,cash,-100.0,-2521.41
buyer_3,Ana,35,ES85209524939783321778,TRX_N-00131-43905452,2022-05-01T10:07:01,Amurrio,incomes,salary,1383.21,-1138.2
buyer_3,Ana,35,ES85209524939783321778,TRX_N-00132-42888341,2022-05-01T10:07:01,Amurrio,incomes,salary_partner,1361.44,223.24
buyer_3,Ana,35,ES85209524939783321778,TRX_N-00133-92165671,2022-05-01T16:41:30,Amurrio,Expense,food,-118.98,104.26
buyer_3,Ana,35,ES85209524939783321778,TRX_N-00134-83934452,2022-05-01T15:43:18,Berango,Expense,cash,-100.0,4.26
buyer_3,Ana,35,ES85209524939783321778,TRX_N-00135-65139893,2022-05-02T10:54:41,Amurrio,Expense,food,-120.95,-116.69
buyer_3,Ana,35,ES85209524939783321778,TRX_N-00136-80544017,2022-05-02T16:15:12,Amurrio,Expense,appliances,-133.39,-250.08
buyer_3,Ana,35,ES85209524939783321778,TRX_N-00137-97434341,2022-05-03T07:04:06,Vitoria-Gasteiz,Expense,food,-81.88,-331.96
buyer_3,Ana,35,ES85209524939783321778,TRX_N-00138-66369777,2022-05-03T23:51:17,Amurrio,Expense,leisure,-26.77,-358.73
buyer_3,Ana,35,ES85209524939783321778,TRX_N-00139-82102064,2022-05-04T10:30:24,Amurrio,expenses,mortgage,-912.03,-1270.76
buyer_3,Ana,35,ES85209524939783321778,TRX_N-00140-45554054,2022-05-04T09:24:53,Amurrio,Expense,clothing,-63.0,-1333.76
buyer_3,Ana,35,ES85209524939783321778,TRX_N-00141-59876964,2022-05-05T18:43:31,Amurrio,expenses,gas,-81.41,-1415.17
buyer_3,Ana,35,ES85209524939783321778,TRX_N-00142-30949525,2022-05-06T14:34:46,Amurrio,expenses,internet,-42.0,-1457.17
buyer_3,Ana,35,ES85209524939783321778,TRX_N-00143-48148080,2022-05-06T20:59:20,Lasarte-Oria,Expense,leisure,-21.81,-1478.98
buyer_3,Ana,35,ES85209524939783321778,TRX_N-00144-26020489,2022-05-06T16:15:21,Amurrio,Expense,clothing,-74.21,-1553.19
buyer_3,Ana,35,ES85209524939783321778,TRX_N-00145-16751480,2022-05-06T18:03:06,Amurrio,expenses,children,-60.25,-1613.44
buyer_3,Ana,35,ES85209524939783321778,TRX_N-00146-80825909,2022-05-07T16:38:39,Amurrio,expenses,phone,-42.71,-1656.15
buyer_3,Ana,35,ES85209524939783321778,TRX_N-00147-62419506,2022-05-08T14:01:35,Amurrio,expenses,electricity,-37.02,-1693.17
buyer_3,Ana,35,ES85209524939783321778,TRX_N-00148-67053694,2022-05-08T00:47:56,Amurrio,expenses,water,-32.79,-1725.96
buyer_3,Ana,35,ES85209524939783321778,TRX_N-00149-56561288,2022-05-09T16:19:36,Elciego,Expense,food,-66.47,-1792.43
buyer_3,Ana,35,ES85209524939783321778,TRX_N-00150-46821797,2022-05-09T13:57:40,Portugalete,Expense,clothing,-76.17,-1868.6
buyer_3,Ana,35,ES85209524939783321778,TRX_N-00151-59171526,2022-05-11T15:53:42,Amurrio,Expense,food,-78.44,-1947.04
buyer_3,Ana,35,ES85209524939783321778,TRX_N-00152-37031134,2022-05-12T09:07:15,Irun,Expense,healthcare,-123.24,-2070.28
buyer_3,Ana,35,ES85209524939783321778,TRX_N-00153-84240598,2022-05-13T08:07:28,Amurrio,Expense,food,-69.35,-2139.63
buyer_3,Ana,35,ES85209524939783321778,TRX_N-00154-00499008,2022-05-15T10:22:39,Amurrio,Expense,cash,-100.0,-2239.63
buyer_3,Ana,35,ES85209524939783321778,TRX_N-00155-91462398,2022-05-16T14:56:22,Amurrio,Expense,leisure,-80.14,-2319.77
buyer_3,Ana,35,ES85209524939783321778,TRX_N-00156-95773121,2022-05-18T11:50:36,Amurrio,Expense,food,-111.93,-2431.7
buyer_3,Ana,35,ES85209524939783321778,TRX_N-00157-93110680,2022-05-19T16:35:51,Amurrio,Expense,clothing,-122.59,-2554.29
buyer_3,Ana,35,ES85209524939783321778,TRX_N-00158-27301698,2022-05-19T19:29:55,Amurrio,Expense,cash,-100.0,-2654.29
buyer_3,Ana,35,ES85209524939783321778,TRX_N-00159-05407163,2022-05-19T20:03:10,Amurrio,expenses,children,-135.87,-2790.16
buyer_3,Ana,35,ES85209524939783321778,TRX_N-00160-34824439,2022-05-20T11:20:06,Amurrio,Expense,appliances,-325.48,-3115.64
buyer_3,Ana,35,ES85209524939783321778,TRX_N-00161-26184171,2022-05-21T09:22:28,Amurrio,Expense,cash,-100.0,-3215.64
buyer_3,Ana,35,ES85209524939783321778,TRX_N-00162-59910171,2022-05-23T17:37:40,Amurrio,Expense,gifts,-651.03,-3866.67
buyer_3,Ana,35,ES85209524939783321778,TRX_N-00163-65387985,2022-05-24T17:50:22,Amurrio,Expense,food,-70.67,-3937.34
buyer_3,Ana,35,ES85209524939783321778,TRX_N-00164-54198255,2022-05-25T17:57:36,Amurrio,Expense,clothing,-57.49,-3994.83
buyer_3,Ana,35,ES85209524939783321778,TRX_N-00165-40806867,2022-05-25T16:22:45,Amurrio,expenses,children,-193.33,-4188.16
buyer_3,Ana,35,ES85209524939783321778,TRX_N-00166-70427395,2022-05-26T17:57:52,Amurrio,Expense,cash,-100.0,-4288.16
buyer_3,Ana,35,ES85209524939783321778,TRX_N-00167-41599629,2022-05-27T19:45:16,Amurrio,Expense,cash,-100.0,-4388.16
buyer_3,Ana,35,ES85209524939783321778,TRX_N-00168-12095717,2022-05-28T19:33:24,Amurrio,Expense,clothing,-137.91,-4526.07
buyer_3,Ana,35,ES85209524939783321778,TRX_N-00169-78420003,2022-05-29T06:56:06,Amurrio,Expense,food,-86.71,-4612.78
buyer_3,Ana,35,ES85209524939783321778,TRX_N-00170-50331909,2022-05-31T13:29:00,Amurrio,Expense,repairs,-257.43,-4870.21
buyer_3,Ana,35,ES85209524939783321778,TRX_N-00171-42963727,2022-06-01T09:41:47,Amurrio,incomes,salary,1383.21,-3487.0
buyer_3,Ana,35,ES85209524939783321778,TRX_N-00172-18697754,2022-06-01T09:41:47,Amurrio,incomes,salary_partner,1361.44,-2125.56
buyer_3,Ana,35,ES85209524939783321778,TRX_N-00173-03264996,2022-06-01T09:41:47,Amurrio,incomes,extra_income,257.05,-1868.51
buyer_3,Ana,35,ES85209524939783321778,TRX_N-00174-11605862,2022-06-01T09:41:47,Amurrio,incomes,salary_bonus,980.69,-887.82
buyer_3,Ana,35,ES85209524939783321778,TRX_N-00175-92663291,2022-06-01T09:41:47,Amurrio,incomes,salary_partner_bonus,1021.13,133.31
buyer_3,Ana,35,ES85209524939783321778,TRX_N-00176-91400149,2022-06-03T09:37:44,Amurrio,Expense,leisure,-51.21,82.1
buyer_3,Ana,35,ES85209524939783321778,TRX_N-00177-31963471,2022-06-03T10:28:23,Amurrio,Expense,cash,-100.0,-17.9
buyer_3,Ana,35,ES85209524939783321778,TRX_N-00178-80216318,2022-06-03T14:35:59,Amurrio,Expense,appliances,-141.48,-159.38
buyer_3,Ana,35,ES85209524939783321778,TRX_N-00179-10486001,2022-06-04T16:16:53,Amurrio,expenses,mortgage,-912.03,-1071.41
buyer_3,Ana,35,ES85209524939783321778,TRX_N-00180-21706365,2022-06-06T09:51:07,Amurrio,expenses,water,-40.74,-1112.15
buyer_3,Ana,35,ES85209524939783321778,TRX_N-00181-73316948,2022-06-07T11:28:15,Amurrio,expenses,gas,-39.08,-1151.23
buyer_3,Ana,35,ES85209524939783321778,TRX_N-00182-32885043,2022-06-08T23:50:43,Amurrio,expenses,phone,-37.84,-1189.07
buyer_3,Ana,35,ES85209524939783321778,TRX_N-00183-67640735,2022-06-08T10:40:44,Amurrio,expenses,electricity,-59.68,-1248.75
buyer_3,Ana,35,ES85209524939783321778,TRX_N-00184-37996774,2022-06-08T04:59:14,Amurrio,expenses,internet,-42.0,-1290.75
buyer_3,Ana,35,ES85209524939783321778,TRX_N-00185-53729092,2022-06-09T10:22:36,Amurrio,expenses,children,-116.15,-1406.9
buyer_3,Ana,35,ES85209524939783321778,TRX_N-00186-46350973,2022-06-10T15:22:56,Amurrio,Expense,transport,-42.01,-1448.91
buyer_3,Ana,35,ES85209524939783321778,TRX_N-00187-66275340,2022-06-11T20:54:00,Amurrio,Expense,transport,-84.65,-1533.56
buyer_3,Ana,35,ES85209524939783321778,TRX_N-00188-01752928,2022-06-12T09:13:25,Amurrio,Expense,repairs,-110.15,-1643.71
buyer_3,Ana,35,ES85209524939783321778,TRX_N-00189-96628736,2022-06-13T09:07:55,Amurrio,Expense,transport,-72.54,-1716.25
buyer_3,Ana,35,ES85209524939783321778,TRX_N-00190-84474841,2022-06-14T10:16:41,Berango,Expense,cash,-100.0,-1816.25
buyer_3,Ana,35,ES85209524939783321778,TRX_N-00191-52694935,2022-06-15T09:14:24,Amurrio,Expense,transport,-70.58,-1886.83
buyer_3,Ana,35,ES85209524939783321778,TRX_N-00192-55718626,2022-06-17T17:30:23,Amurrio,Expense,leisure,-71.03,-1957.86
buyer_3,Ana,35,ES85209524939783321778,TRX_N-00193-50647578,2022-06-20T11:55:43,Erandio,Expense,food,-79.99,-2037.85
buyer_3,Ana,35,ES85209524939783321778,TRX_N-00194-92374724,2022-06-20T19:00:27,Mungia,Expense,transport,-47.33,-2085.18
buyer_3,Ana,35,ES85209524939783321778,TRX_N-00195-33108027,2022-06-20T23:03:55,Amurrio,Expense,leisure,-34.37,-2119.55
buyer_3,Ana,35,ES85209524939783321778,TRX_N-00196-67800122,2022-06-20T14:32:16,Amurrio,Expense,education,-73.74,-2193.29
buyer_3,Ana,35,ES85209524939783321778,TRX_N-00197-79692021,2022-06-21T13:46:53,Bermeo,Expense,repairs,-326.87,-2520.16
buyer_3,Ana,35,ES85209524939783321778,TRX_N-00198-62049711,2022-06-22T07:35:09,Amurrio,Expense,leisure,-23.88,-2544.04
buyer_3,Ana,35,ES85209524939783321778,TRX_N-00199-60825917,2022-06-23T08:43:27,Amurrio,Expense,leisure,-62.36,-2606.4
buyer_3,Ana,35,ES85209524939783321778,TRX_N-00200-69407306,2022-06-23T16:53:25,Errenteria,Expense,cash,-100.0,-2706.4
buyer_3,Ana,35,ES85209524939783321778,TRX_N-00201-53398304,2022-06-29T10:06:23,Amurrio,Expense,leisure,-50.84,-2757.24
buyer_3,Ana,35,ES85209524939783321778,TRX_N-00202-96231704,2022-06-30T10:03:24,Amurrio,Expense,cash,-100.0,-2857.24
buyer_3,Ana,35,ES85209524939783321778,TRX_N-00203-53425488,2022-07-01T11:58:39,Amurrio,incomes,salary,1383.21,-1474.03
buyer_3,Ana,35,ES85209524939783321778,TRX_N-00204-83305865,2022-07-01T11:58:39,Amurrio,incomes,salary_partner,1361.44,-112.59
buyer_3,Ana,35,ES85209524939783321778,TRX_N-00205-63605476,2022-07-01T12:04:50,Amurrio,Expense,education,-62.9,-175.49
buyer_3,Ana,35,ES85209524939783321778,TRX_N-00206-07295277,2022-07-01T13:08:46,Amurrio,Expense,gifts,-473.63,-649.12
buyer_3,Ana,35,ES85209524939783321778,TRX_N-00207-29899840,2022-07-03T06:45:06,Amurrio,Expense,food,-75.63,-724.75
buyer_3,Ana,35,ES85209524939783321778,TRX_N-00208-42919352,2022-07-04T16:04:54,Amurrio,expenses,mortgage,-912.03,-1636.78
buyer_3,Ana,35,ES85209524939783321778,TRX_N-00209-65585615,2022-07-04T11:40:11,Amurrio,Expense,food,-89.25,-1726.03
buyer_3,Ana,35,ES85209524939783321778,TRX_N-00210-76369008,2022-07-04T13:47:21,Amurrio,Expense,cash,-100.0,-1826.03
buyer_3,Ana,35,ES85209524939783321778,TRX_N-00211-70568716,2022-07-04T15:05:50,Amurrio,Expense,appliances,-315.06,-2141.09
buyer_3,Ana,35,ES85209524939783321778,TRX_N-00212-09615352,2022-07-05T18:59:12,Amurrio,expenses,electricity,-89.11,-2230.2
buyer_3,Ana,35,ES85209524939783321778,TRX_N-00213-68107973,2022-07-05T12:23:22,Amurrio,expenses,gas,-86.66,-2316.86
buyer_3,Ana,35,ES85209524939783321778,TRX_N-00214-48318559,2022-07-05T10:33:18,Amurrio,expenses,phone,-41.63,-2358.49
buyer_3,Ana,35,ES85209524939783321778,TRX_N-00215-82596853,2022-07-06T17:38:10,Amurrio,Expense,leisure,-50.1,-2408.59
buyer_3,Ana,35,ES85209524939783321778,TRX_N-00216-22984671,2022-07-07T18:41:48,Amurrio,expenses,water,-23.04,-2431.63
buyer_3,Ana,35,ES85209524939783321778,TRX_N-00217-70995742,2022-07-07T14:56:10,Amurrio,expenses,internet,-42.0,-2473.63
buyer_3,Ana,35,ES85209524939783321778,TRX_N-00218-45359944,2022-07-09T18:04:24,Amurrio,Expense,gifts,-567.44,-3041.07
buyer_3,Ana,35,ES85209524939783321778,TRX_N-00219-29253025,2022-07-10T12:20:25,Amurrio,Expense,food,-122.62,-3163.69
buyer_3,Ana,35,ES85209524939783321778,TRX_N-00220-88362601,2022-07-11T20:34:49,Amurrio,Expense,education,-70.34,-3234.03
buyer_3,Ana,35,ES85209524939783321778,TRX_N-00221-65970759,2022-07-13T19:39:21,Amurrio,Expense,cash,-100.0,-3334.03
buyer_3,Ana,35,ES85209524939783321778,TRX_N-00222-04601646,2022-07-15T08:26:43,Amurrio,Expense,food,-124.68,-3458.71
buyer_3,Ana,35,ES85209524939783321778,TRX_N-00223-98105795,2022-07-15T19:48:37,Amurrio,Expense,cash,-100.0,-3558.71
buyer_3,Ana,35,ES85209524939783321778,TRX_N-00224-23606796,2022-07-16T15:32:41,Portugalete,Expense,cash,-100.0,-3658.71
buyer_3,Ana,35,ES85209524939783321778,TRX_N-00225-02647718,2022-07-16T20:35:05,Amurrio,expenses,children,-140.49,-3799.2
buyer_3,Ana,35,ES85209524939783321778,TRX_N-00226-18482153,2022-07-17T19:19:17,Amurrio,Expense,education,-51.54,-3850.74
buyer_3,Ana,35,ES85209524939783321778,TRX_N-00227-82999396,2022-07-19T20:26:03,Amurrio,Expense,healthcare,-82.28,-3933.02
buyer_3,Ana,35,ES85209524939783321778,TRX_N-00228-12936183,2022-07-19T10:14:00,Amurrio,Expense,cash,-100.0,-4033.02
buyer_3,Ana,35,ES85209524939783321778,TRX_N-00229-20519421,2022-07-20T12:29:24,Amurrio,Expense,clothing,-96.52,-4129.54
buyer_3,Ana,35,ES85209524939783321778,TRX_N-00230-21457478,2022-07-21T09:22:12,Amurrio,Expense,transport,-43.74,-4173.28
buyer_3,Ana,35,ES85209524939783321778,TRX_N-00231-56136337,2022-07-21T09:08:02,Erandio,Expense,leisure,-51.31,-4224.59
buyer_3,Ana,35,ES85209524939783321778,TRX_N-00232-30744061,2022-07-21T02:17:00,Amurrio,Expense,gifts,-500.49,-4725.08
buyer_3,Ana,35,ES85209524939783321778,TRX_N-00233-15521110,2022-07-23T16:18:49,Amurrio,Expense,cash,-100.0,-4825.08
buyer_3,Ana,35,ES85209524939783321778,TRX_N-00234-37411298,2022-07-26T20:38:27,Amurrio,Expense,cash,-100.0,-4925.08
buyer_3,Ana,35,ES85209524939783321778,TRX_N-00235-34488462,2022-07-28T12:48:49,Hondarribia,Expense,education,-58.28,-4983.36
buyer_3,Ana,35,ES85209524939783321778,TRX_N-00236-32712585,2022-07-30T17:04:27,Amurrio,Expense,leisure,-66.59,-5049.95
buyer_3,Ana,35,ES85209524939783321778,TRX_N-00237-72225903,2022-07-31T09:16:30,Amurrio,Expense,food,-98.03,-5147.98
buyer_3,Ana,35,ES85209524939783321778,TRX_N-00238-47404010,2022-07-31T14:27:20,Amurrio,Expense,appliances,-86.65,-5234.63
buyer_3,Ana,35,ES85209524939783321778,TRX_N-00239-39011171,2022-08-01T16:45:42,Amurrio,incomes,salary,1383.21,-3851.42
buyer_3,Ana,35,ES85209524939783321778,TRX_N-00240-23577401,2022-08-01T16:45:42,Amurrio,incomes,salary_partner,1361.44,-2489.98
buyer_3,Ana,35,ES85209524939783321778,TRX_N-00241-27359593,2022-08-01T16:21:05,Amurrio,Expense,transport,-63.59,-2553.57
buyer_3,Ana,35,ES85209524939783321778,TRX_N-00242-88428501,2022-08-04T17:26:35,Amurrio,expenses,mortgage,-912.03,-3465.6
buyer_3,Ana,35,ES85209524939783321778,TRX_N-00243-92083279,2022-08-04T19:00:19,Amurrio,Expense,leisure,-26.24,-3491.84
buyer_3,Ana,35,ES85209524939783321778,TRX_N-00244-24856683,2022-08-04T09:48:42,Portugalete,Expense,cash,-100.0,-3591.84
buyer_3,Ana,35,ES85209524939783321778,TRX_N-00245-34053456,2022-08-05T19:55:01,Amurrio,expenses,water,-25.88,-3617.72
buyer_3,Ana,35,ES85209524939783321778,TRX_N-00246-08503957,2022-08-05T17:16:54,Amurrio,expenses,gas,-49.57,-3667.29
buyer_3,Ana,35,ES85209524939783321778,TRX_N-00247-74090635,2022-08-05T12:22:18,Amurrio,expenses,phone,-41.11,-3708.4
buyer_3,Ana,35,ES85209524939783321778,TRX_N-00248-77517569,2022-08-05T09:58:34,Amurrio,Expense,cash,-100.0,-3808.4
buyer_3,Ana,35,ES85209524939783321778,TRX_N-00249-64367177,2022-08-05T18:22:07,Amurrio,expenses,children,-196.02,-4004.42
buyer_3,Ana,35,ES85209524939783321778,TRX_N-00250-52667377,2022-08-06T17:55:13,Amurrio,expenses,electricity,-28.59,-4033.01
buyer_3,Ana,35,ES85209524939783321778,TRX_N-00251-00781140,2022-08-06T20:24:36,Amurrio,Expense,cash,-100.0,-4133.01
buyer_3,Ana,35,ES85209524939783321778,TRX_N-00252-94901669,2022-08-06T14:57:05,Amurrio,Expense,appliances,-339.85,-4472.86
buyer_3,Ana,35,ES85209524939783321778,TRX_N-00253-11013765,2022-08-07T00:42:26,Amurrio,Expense,food,-122.22,-4595.08
buyer_3,Ana,35,ES85209524939783321778,TRX_N-00254-02656313,2022-08-07T15:55:07,Amurrio,Expense,cash,-100.0,-4695.08
buyer_3,Ana,35,ES85209524939783321778,TRX_N-00255-75045297,2022-08-08T01:26:38,Amurrio,expenses,internet,-42.0,-4737.08
buyer_3,Ana,35,ES85209524939783321778,TRX_N-00256-44089144,2022-08-08T12:12:41,Amurrio,Expense,clothing,-152.65,-4889.73
buyer_3,Ana,35,ES85209524939783321778,TRX_N-00257-47757040,2022-08-09T15:29:52,Bilbao,Expense,cash,-100.0,-4989.73
buyer_3,Ana,35,ES85209524939783321778,TRX_N-00258-65559466,2022-08-10T17:37:02,Amurrio,Expense,healthcare,-189.03,-5178.76
buyer_3,Ana,35,ES85209524939783321778,TRX_N-00259-74918303,2022-08-14T09:20:37,Amurrio,Expense,repairs,-133.78,-5312.54
buyer_3,Ana,35,ES85209524939783321778,TRX_N-00260-54400177,2022-08-18T10:10:05,Santurtzi,Expense,leisure,-62.05,-5374.59
buyer_3,Ana,35,ES85209524939783321778,TRX_N-00261-47885959,2022-08-19T12:06:59,Pasaia,Expense,leisure,-56.23,-5430.82
buyer_3,Ana,35,ES85209524939783321778,TRX_N-00262-81554732,2022-08-21T21:14:39,Erandio,Expense,education,-74.58,-5505.4
buyer_3,Ana,35,ES85209524939783321778,TRX_N-00263-87232485,2022-08-23T21:03:22,Zarautz,Expense,cash,-100.0,-5605.4
buyer_3,Ana,35,ES85209524939783321778,TRX_N-00264-77408671,2022-08-26T09:57:22,Amurrio,Expense,food,-80.32,-5685.72
buyer_3,Ana,35,ES85209524939783321778,TRX_N-00265-17997651,2022-08-26T10:28:21,Amurrio,Expense,cash,-100.0,-5785.72
buyer_3,Ana,35,ES85209524939783321778,TRX_N-00266-66098643,2022-08-31T18:16:56,Amurrio,Expense,education,-63.94,-5849.66
buyer_3,Ana,35,ES85209524939783321778,TRX_N-00267-79002922,2022-09-01T10:06:35,Amurrio,incomes,salary,1383.21,-4466.45
buyer_3,Ana,35,ES85209524939783321778,TRX_N-00268-21295354,2022-09-01T10:06:35,Amurrio,incomes,salary_partner,1361.44,-3105.01
buyer_3,Ana,35,ES85209524939783321778,TRX_N-00269-69704743,2022-09-02T09:48:22,Amurrio,expenses,children,-75.87,-3180.88
buyer_3,Ana,35,ES85209524939783321778,TRX_N-00270-77176364,2022-09-03T20:57:00,Amurrio,Expense,leisure,-49.29,-3230.17
buyer_3,Ana,35,ES85209524939783321778,TRX_N-00271-89761448,2022-09-03T19:47:26,Amurrio,Expense,cash,-100.0,-3330.17
buyer_3,Ana,35,ES85209524939783321778,TRX_N-00272-31075676,2022-09-04T11:48:23,Amurrio,expenses,mortgage,-912.03,-4242.2
buyer_3,Ana,35,ES85209524939783321778,TRX_N-00273-24602409,2022-09-04T13:32:56,Oy√≥n-Oion,Expense,clothing,-134.73,-4376.93
buyer_3,Ana,35,ES85209524939783321778,TRX_N-00274-60327556,2022-09-04T19:31:52,Amurrio,Expense,travel,-313.78,-4690.71
buyer_3,Ana,35,ES85209524939783321778,TRX_N-00275-71715410,2022-09-05T16:20:23,Amurrio,Expense,repairs,-284.92,-4975.63
buyer_3,Ana,35,ES85209524939783321778,TRX_N-00276-55901012,2022-09-06T20:01:07,Amurrio,expenses,electricity,-86.49,-5062.12
buyer_3,Ana,35,ES85209524939783321778,TRX_N-00277-68459399,2022-09-06T16:25:22,Amurrio,expenses,gas,-93.44,-5155.56
buyer_3,Ana,35,ES85209524939783321778,TRX_N-00278-99911648,2022-09-07T08:25:53,Amurrio,expenses,phone,-36.63,-5192.19
buyer_3,Ana,35,ES85209524939783321778,TRX_N-00279-28239970,2022-09-08T09:59:27,Amurrio,expenses,internet,-42.0,-5234.19
buyer_3,Ana,35,ES85209524939783321778,TRX_N-00280-77757644,2022-09-08T15:29:43,Amurrio,expenses,water,-23.1,-5257.29
buyer_3,Ana,35,ES85209524939783321778,TRX_N-00281-94215375,2022-09-09T18:51:52,Amurrio,Expense,repairs,-186.49,-5443.78
buyer_3,Ana,35,ES85209524939783321778,TRX_N-00282-62757886,2022-09-15T15:52:03,Amurrio,Expense,transport,-57.57,-5501.35
buyer_3,Ana,35,ES85209524939783321778,TRX_N-00283-57465534,2022-09-15T13:28:17,Amurrio,Expense,travel,-1401.04,-6902.39
buyer_3,Ana,35,ES85209524939783321778,TRX_N-00284-82795577,2022-09-16T15:10:56,Amurrio,Expense,clothing,-72.68,-6975.07
buyer_3,Ana,35,ES85209524939783321778,TRX_N-00285-38921602,2022-09-17T10:17:53,Basauri,Expense,gifts,-347.17,-7322.24
buyer_3,Ana,35,ES85209524939783321778,TRX_N-00286-42136351,2022-09-18T13:52:46,Alegr√≠a-Dulantzi,Expense,repairs,-53.16,-7375.4
buyer_3,Ana,35,ES85209524939783321778,TRX_N-00287-24800348,2022-09-19T14:00:56,Basauri,Expense,cash,-100.0,-7475.4
buyer_3,Ana,35,ES85209524939783321778,TRX_N-00288-01022055,2022-09-22T22:18:56,Amurrio,Expense,food,-102.95,-7578.35
buyer_3,Ana,35,ES85209524939783321778,TRX_N-00289-57817966,2022-09-25T14:44:46,Amurrio,Expense,leisure,-53.62,-7631.97
buyer_3,Ana,35,ES85209524939783321778,TRX_N-00290-38201878,2022-09-25T09:56:56,Amurrio,Expense,cash,-100.0,-7731.97
buyer_3,Ana,35,ES85209524939783321778,TRX_N-00291-92708328,2022-09-28T20:03:25,Amurrio,Expense,transport,-76.86,-7808.83
buyer_3,Ana,35,ES85209524939783321778,TRX_N-00292-74318927,2022-09-28T14:15:20,Amurrio,Expense,repairs,-211.9,-8020.73
buyer_3,Ana,35,ES85209524939783321778,TRX_N-00293-65302122,2022-09-29T20:41:49,Vitoria-Gasteiz,Expense,cash,-100.0,-8120.73
buyer_3,Ana,35,ES85209524939783321778,TRX_N-00294-77126091,2022-09-30T12:57:04,Zuia,Expense,food,-108.09,-8228.82
buyer_3,Ana,35,ES85209524939783321778,TRX_N-00295-93323854,2022-09-30T15:40:37,Hondarribia,Expense,transport,-43.76,-8272.58
buyer_3,Ana,35,ES85209524939783321778,TRX_N-00296-54554676,2022-09-30T15:40:28,Amurrio,expenses,children,-183.49,-8456.07
buyer_3,Ana,35,ES85209524939783321778,TRX_N-00297-76324362,2022-10-01T10:57:32,Amurrio,incomes,salary,1383.21,-7072.86
buyer_3,Ana,35,ES85209524939783321778,TRX_N-00298-35088952,2022-10-01T10:57:32,Amurrio,incomes,salary_partner,1361.44,-5711.42
buyer_3,Ana,35,ES85209524939783321778,TRX_N-00299-12818026,2022-10-01T10:57:32,Amurrio,incomes,extra_income,257.05,-5454.37
buyer_3,Ana,35,ES85209524939783321778,TRX_N-00300-54444504,2022-10-01T18:35:46,Amurrio,Expense,food,-75.49,-5529.86
buyer_3,Ana,35,ES85209524939783321778,TRX_N-00301-98371389,2022-10-01T16:08:48,Amurrio,Expense,transport,-82.52,-5612.38
buyer_3,Ana,35,ES85209524939783321778,TRX_N-00302-90578724,2022-10-02T16:17:29,Amurrio,Expense,transport,-81.76,-5694.14
buyer_3,Ana,35,ES85209524939783321778,TRX_N-00303-23289243,2022-10-02T18:25:12,Amurrio,Expense,cash,-100.0,-5794.14
buyer_3,Ana,35,ES85209524939783321778,TRX_N-00304-72216544,2022-10-03T19:23:26,Amurrio,Expense,food,-76.0,-5870.14
buyer_3,Ana,35,ES85209524939783321778,TRX_N-00305-88086471,2022-10-04T01:56:10,Amurrio,expenses,mortgage,-912.03,-6782.17
buyer_3,Ana,35,ES85209524939783321778,TRX_N-00306-96344276,2022-10-07T06:00:22,Amurrio,expenses,gas,-64.73,-6846.9
buyer_3,Ana,35,ES85209524939783321778,TRX_N-00307-09032303,2022-10-08T17:52:11,Amurrio,expenses,internet,-42.0,-6888.9
buyer_3,Ana,35,ES85209524939783321778,TRX_N-00308-73445819,2022-10-08T14:38:38,Amurrio,expenses,water,-24.93,-6913.83
buyer_3,Ana,35,ES85209524939783321778,TRX_N-00309-72120488,2022-10-08T16:52:55,Amurrio,expenses,electricity,-82.6,-6996.43
buyer_3,Ana,35,ES85209524939783321778,TRX_N-00310-62150872,2022-10-08T14:08:30,Amurrio,expenses,phone,-31.27,-7027.7
buyer_3,Ana,35,ES85209524939783321778,TRX_N-00311-51341931,2022-10-09T11:11:13,Amurrio,Expense,education,-77.18,-7104.88
buyer_3,Ana,35,ES85209524939783321778,TRX_N-00312-11878259,2022-10-10T23:38:44,Amurrio,Expense,food,-124.64,-7229.52
buyer_3,Ana,35,ES85209524939783321778,TRX_N-00313-88070985,2022-10-10T16:21:48,Amurrio,Expense,cash,-100.0,-7329.52
buyer_3,Ana,35,ES85209524939783321778,TRX_N-00314-15491812,2022-10-10T12:10:24,Amurrio,Expense,repairs,-315.72,-7645.24
buyer_3,Ana,35,ES85209524939783321778,TRX_N-00315-38174868,2022-10-11T21:56:28,Amurrio,expenses,children,-224.74,-7869.98
buyer_3,Ana,35,ES85209524939783321778,TRX_N-00316-18287130,2022-10-12T17:16:27,Amurrio,Expense,leisure,-29.57,-7899.55
buyer_3,Ana,35,ES85209524939783321778,TRX_N-00317-76712465,2022-10-12T10:51:53,Pasaia,Expense,clothing,-89.14,-7988.69
buyer_3,Ana,35,ES85209524939783321778,TRX_N-00318-83855221,2022-10-17T13:56:48,Amurrio,Expense,food,-114.16,-8102.85
buyer_3,Ana,35,ES85209524939783321778,TRX_N-00319-63662601,2022-10-17T15:44:43,Amurrio,Expense,travel,-591.13,-8693.98
buyer_3,Ana,35,ES85209524939783321778,TRX_N-00320-99644821,2022-10-18T10:25:32,Amurrio,Expense,cash,-100.0,-8793.98
buyer_3,Ana,35,ES85209524939783321778,TRX_N-00321-23605197,2022-10-19T11:58:00,Amurrio,Expense,leisure,-21.66,-8815.64
buyer_3,Ana,35,ES85209524939783321778,TRX_N-00322-39598085,2022-10-19T18:54:39,Amurrio,Expense,cash,-100.0,-8915.64
buyer_3,Ana,35,ES85209524939783321778,TRX_N-00323-33636799,2022-10-21T21:52:59,Amurrio,Expense,leisure,-35.59,-8951.23
buyer_3,Ana,35,ES85209524939783321778,TRX_N-00324-83142725,2022-10-21T16:06:10,Amurrio,Expense,gifts,-55.67,-9006.9
buyer_3,Ana,35,ES85209524939783321778,TRX_N-00325-89713798,2022-10-22T14:49:42,Amurrio,Expense,gifts,-722.49,-9729.39
buyer_3,Ana,35,ES85209524939783321778,TRX_N-00326-73098205,2022-10-23T06:31:08,Amurrio,expenses,children,-113.4,-9842.79
buyer_3,Ana,35,ES85209524939783321778,TRX_N-00327-55733146,2022-10-25T19:55:59,Amurrio,Expense,food,-102.13,-9944.92
buyer_3,Ana,35,ES85209524939783321778,TRX_N-00328-73958081,2022-10-26T12:48:12,Amurrio,Expense,clothing,-83.32,-10028.24
buyer_3,Ana,35,ES85209524939783321778,TRX_N-00329-98195332,2022-10-28T13:39:25,Amurrio,Expense,transport,-61.07,-10089.31
buyer_3,Ana,35,ES85209524939783321778,TRX_N-00330-71931585,2022-11-01T18:02:04,Amurrio,incomes,salary,1383.21,-8706.1
buyer_3,Ana,35,ES85209524939783321778,TRX_N-00331-98451412,2022-11-01T18:02:04,Amurrio,incomes,salary_partner,1361.44,-7344.66
buyer_3,Ana,35,ES85209524939783321778,TRX_N-00332-36738292,2022-11-01T21:59:31,Amurrio,Expense,food,-105.22,-7449.88
buyer_3,Ana,35,ES85209524939783321778,TRX_N-00333-21150399,2022-11-01T23:14:47,Hondarribia,Expense,leisure,-20.47,-7470.35
buyer_3,Ana,35,ES85209524939783321778,TRX_N-00334-37872619,2022-11-01T16:19:33,Amurrio,Expense,cash,-100.0,-7570.35
buyer_3,Ana,35,ES85209524939783321778,TRX_N-00335-90743257,2022-11-01T09:32:08,Amurrio,Expense,appliances,-362.9,-7933.25
buyer_3,Ana,35,ES85209524939783321778,TRX_N-00336-72435451,2022-11-02T20:46:52,Bermeo,Expense,clothing,-57.24,-7990.49
buyer_3,Ana,35,ES85209524939783321778,TRX_N-00337-30952265,2022-11-04T15:47:42,Amurrio,expenses,mortgage,-912.03,-8902.52
buyer_3,Ana,35,ES85209524939783321778,TRX_N-00338-96452405,2022-11-04T10:54:37,Amurrio,Expense,food,-84.01,-8986.53
buyer_3,Ana,35,ES85209524939783321778,TRX_N-00339-61625900,2022-11-05T13:53:11,Amurrio,expenses,phone,-43.34,-9029.87
buyer_3,Ana,35,ES85209524939783321778,TRX_N-00340-45867860,2022-11-05T20:05:35,Amurrio,Expense,leisure,-26.87,-9056.74
buyer_3,Ana,35,ES85209524939783321778,TRX_N-00341-26657704,2022-11-06T08:53:13,Amurrio,expenses,water,-39.27,-9096.01
buyer_3,Ana,35,ES85209524939783321778,TRX_N-00342-54436571,2022-11-06T18:36:20,Salvatierra/Agurain,Expense,education,-59.34,-9155.35
buyer_3,Ana,35,ES85209524939783321778,TRX_N-00343-75270503,2022-11-08T11:46:51,Amurrio,expenses,electricity,-82.02,-9237.37
buyer_3,Ana,35,ES85209524939783321778,TRX_N-00344-09104589,2022-11-08T23:34:59,Amurrio,expenses,internet,-42.0,-9279.37
buyer_3,Ana,35,ES85209524939783321778,TRX_N-00345-28798660,2022-11-08T17:06:21,Amurrio,expenses,gas,-75.56,-9354.93
buyer_3,Ana,35,ES85209524939783321778,TRX_N-00346-02593852,2022-11-08T20:35:07,Amurrio,Expense,food,-121.72,-9476.65
buyer_3,Ana,35,ES85209524939783321778,TRX_N-00347-97244332,2022-11-09T14:06:28,Amurrio,Expense,healthcare,-111.51,-9588.16
buyer_3,Ana,35,ES85209524939783321778,TRX_N-00348-26920109,2022-11-10T12:45:00,Galdakao,Expense,repairs,-277.24,-9865.4
buyer_3,Ana,35,ES85209524939783321778,TRX_N-00349-88582405,2022-11-11T02:20:45,Amurrio,Expense,transport,-56.15,-9921.55
buyer_3,Ana,35,ES85209524939783321778,TRX_N-00350-58162019,2022-11-14T20:19:17,Amurrio,Expense,cash,-100.0,-10021.55
buyer_3,Ana,35,ES85209524939783321778,TRX_N-00351-05428453,2022-11-15T22:37:32,Amurrio,Expense,food,-71.8,-10093.35
buyer_3,Ana,35,ES85209524939783321778,TRX_N-00352-30126612,2022-11-16T18:34:19,Amurrio,Expense,leisure,-37.62,-10130.97
buyer_3,Ana,35,ES85209524939783321778,TRX_N-00353-45006683,2022-11-17T22:11:53,Amurrio,Expense,repairs,-248.62,-10379.59
buyer_3,Ana,35,ES85209524939783321778,TRX_N-00354-58533101,2022-11-18T16:50:40,Amurrio,Expense,appliances,-307.46,-10687.05
buyer_3,Ana,35,ES85209524939783321778,TRX_N-00355-86506460,2022-11-19T00:57:11,Oy√≥n-Oion,Expense,education,-46.12,-10733.17
buyer_3,Ana,35,ES85209524939783321778,TRX_N-00356-94799554,2022-11-19T11:35:14,Amurrio,Expense,cash,-100.0,-10833.17
buyer_3,Ana,35,ES85209524939783321778,TRX_N-00357-35836036,2022-11-20T07:05:23,Amurrio,Expense,repairs,-186.49,-11019.66
buyer_3,Ana,35,ES85209524939783321778,TRX_N-00358-92362618,2022-11-21T03:19:29,Irun,Expense,transport,-67.24,-11086.9
buyer_3,Ana,35,ES85209524939783321778,TRX_N-00359-68259001,2022-11-21T08:48:48,Amurrio,Expense,leisure,-26.7,-11113.6
buyer_3,Ana,35,ES85209524939783321778,TRX_N-00360-78844175,2022-11-23T17:47:03,Amurrio,Expense,food,-67.33,-11180.93
buyer_3,Ana,35,ES85209524939783321778,TRX_N-00361-64223247,2022-11-23T23:33:54,Amurrio,Expense,transport,-69.97,-11250.9
buyer_3,Ana,35,ES85209524939783321778,TRX_N-00362-75491393,2022-11-24T06:01:22,Amurrio,Expense,repairs,-167.3,-11418.2
buyer_3,Ana,35,ES85209524939783321778,TRX_N-00363-65280688,2022-11-25T23:55:26,Amurrio,Expense,food,-85.49,-11503.69
buyer_3,Ana,35,ES85209524939783321778,TRX_N-00364-96490060,2022-11-25T08:54:10,Amurrio,Expense,transport,-66.55,-11570.24
buyer_3,Ana,35,ES85209524939783321778,TRX_N-00365-07359584,2022-11-27T13:37:51,Errenteria,Expense,food,-100.05,-11670.29
buyer_3,Ana,35,ES85209524939783321778,TRX_N-00366-26540390,2022-11-27T13:42:31,Amurrio,Expense,cash,-100.0,-11770.29
buyer_3,Ana,35,ES85209524939783321778,TRX_N-00367-19110815,2022-11-28T13:25:23,Basauri,Expense,food,-109.4,-11879.69
buyer_3,Ana,35,ES85209524939783321778,TRX_N-00368-17383007,2022-12-01T19:03:14,Amurrio,incomes,salary,1383.21,-10496.48
buyer_3,Ana,35,ES85209524939783321778,TRX_N-00369-47564165,2022-12-01T19:03:14,Amurrio,incomes,salary_partner,1361.44,-9135.04
buyer_3,Ana,35,ES85209524939783321778,TRX_N-00370-50910763,2022-12-01T19:03:14,Amurrio,incomes,salary_bonus,1039.38,-8095.66
buyer_3,Ana,35,ES85209524939783321778,TRX_N-00371-41084646,2022-12-01T19:03:14,Amurrio,incomes,salary_partner_bonus,1088.63,-7007.03
buyer_3,Ana,35,ES85209524939783321778,TRX_N-00372-60229371,2022-12-01T19:34:51,Amurrio,Expense,leisure,-39.86,-7046.89
buyer_3,Ana,35,ES85209524939783321778,TRX_N-00373-12075328,2022-12-02T17:20:18,Amurrio,Expense,food,-115.04,-7161.93
buyer_3,Ana,35,ES85209524939783321778,TRX_N-00374-74970173,2022-12-03T12:10:07,Amurrio,Expense,transport,-63.58,-7225.51
buyer_3,Ana,35,ES85209524939783321778,TRX_N-00375-27065309,2022-12-03T13:55:49,Amurrio,Expense,leisure,-28.99,-7254.5
buyer_3,Ana,35,ES85209524939783321778,TRX_N-00376-76529206,2022-12-03T08:52:37,Amurrio,Expense,cash,-100.0,-7354.5
buyer_3,Ana,35,ES85209524939783321778,TRX_N-00377-69080743,2022-12-03T08:56:35,Amurrio,Expense,appliances,-239.0,-7593.5
buyer_3,Ana,35,ES85209524939783321778,TRX_N-00378-44722733,2022-12-03T18:57:53,Amurrio,Expense,repairs,-324.1,-7917.6
buyer_3,Ana,35,ES85209524939783321778,TRX_N-00379-18363163,2022-12-04T11:38:50,Amurrio,expenses,mortgage,-912.03,-8829.63
buyer_3,Ana,35,ES85209524939783321778,TRX_N-00380-72022513,2022-12-04T23:28:17,Amurrio,Expense,clothing,-141.02,-8970.65
buyer_3,Ana,35,ES85209524939783321778,TRX_N-00381-15133445,2022-12-05T14:51:13,Amurrio,Expense,healthcare,-44.34,-9014.99
buyer_3,Ana,35,ES85209524939783321778,TRX_N-00382-06273396,2022-12-06T17:14:54,Amurrio,expenses,phone,-39.64,-9054.63
buyer_3,Ana,35,ES85209524939783321778,TRX_N-00383-95214364,2022-12-06T08:10:40,Oy√≥n-Oion,Expense,leisure,-33.56,-9088.19
buyer_3,Ana,35,ES85209524939783321778,TRX_N-00384-39295678,2022-12-07T10:58:43,Amurrio,expenses,water,-41.78,-9129.97
buyer_3,Ana,35,ES85209524939783321778,TRX_N-00385-85624704,2022-12-07T23:38:22,Amurrio,Expense,education,-66.64,-9196.61
buyer_3,Ana,35,ES85209524939783321778,TRX_N-00386-62486391,2022-12-08T11:57:11,Amurrio,expenses,electricity,-35.48,-9232.09
buyer_3,Ana,35,ES85209524939783321778,TRX_N-00387-11436974,2022-12-08T11:27:59,Amurrio,expenses,gas,-61.19,-9293.28
buyer_3,Ana,35,ES85209524939783321778,TRX_N-00388-88931827,2022-12-08T15:41:43,Amurrio,expenses,internet,-42.0,-9335.28
buyer_3,Ana,35,ES85209524939783321778,TRX_N-00389-77663927,2022-12-08T18:36:38,Amurrio,Expense,cash,-100.0,-9435.28
buyer_3,Ana,35,ES85209524939783321778,TRX_N-00390-84799449,2022-12-09T12:48:31,Amurrio,Expense,food,-106.32,-9541.6
buyer_3,Ana,35,ES85209524939783321778,TRX_N-00391-01268928,2022-12-11T03:32:31,Salvatierra/Agurain,Expense,food,-75.22,-9616.82
buyer_3,Ana,35,ES85209524939783321778,TRX_N-00392-85148817,2022-12-14T14:26:13,Amurrio,Expense,repairs,-289.43,-9906.25
buyer_3,Ana,35,ES85209524939783321778,TRX_N-00393-82121817,2022-12-14T10:52:49,Amurrio,expenses,children,-201.62,-10107.87
buyer_3,Ana,35,ES85209524939783321778,TRX_N-00394-48683030,2022-12-17T16:29:34,Amurrio,Expense,leisure,-39.45,-10147.32
buyer_3,Ana,35,ES85209524939783321778,TRX_N-00395-01267147,2022-12-17T13:09:11,Amurrio,Expense,gifts,-397.78,-10545.1
buyer_3,Ana,35,ES85209524939783321778,TRX_N-00396-34024559,2022-12-17T10:35:17,Amurrio,expenses,children,-196.75,-10741.85
buyer_3,Ana,35,ES85209524939783321778,TRX_N-00397-09214187,2022-12-19T09:37:12,Amurrio,Expense,leisure,-50.94,-10792.79
buyer_3,Ana,35,ES85209524939783321778,TRX_N-00398-97261821,2022-12-20T21:19:35,Berango,Expense,transport,-61.71,-10854.5
buyer_3,Ana,35,ES85209524939783321778,TRX_N-00399-84798759,2022-12-22T10:01:14,Eibar,Expense,food,-111.17,-10965.67
buyer_3,Ana,35,ES85209524939783321778,TRX_N-00400-14388736,2022-12-22T11:15:44,Amurrio,Expense,leisure,-30.85,-10996.52
buyer_3,Ana,35,ES85209524939783321778,TRX_N-00401-56114522,2022-12-22T20:20:31,Amurrio,Expense,repairs,-144.83,-11141.35
buyer_3,Ana,35,ES85209524939783321778,TRX_N-00402-49703276,2022-12-23T17:16:01,Amurrio,Expense,food,-80.15,-11221.5
buyer_3,Ana,35,ES85209524939783321778,TRX_N-00403-70352259,2022-12-23T20:39:20,Amurrio,Expense,cash,-100.0,-11321.5
buyer_3,Ana,35,ES85209524939783321778,TRX_N-00404-03350604,2022-12-26T09:33:09,Amurrio,Expense,food,-64.46,-11385.96
buyer_3,Ana,35,ES85209524939783321778,TRX_N-00405-41434931,2022-12-28T10:27:10,Amurrio,Expense,gifts,-765.31,-12151.27
buyer_3,Ana,35,ES85209524939783321778,TRX_N-00406-10481028,2022-12-29T15:45:10,Berango,Expense,food,-114.5,-12265.77
buyer_3,Ana,35,ES85209524939783321778,TRX_N-00407-32231189,2022-12-29T11:36:38,Pasaia,Expense,clothing,-80.8,-12346.57
buyer_3,Ana,35,ES85209524939783321778,TRX_N-00408-95362547,2022-12-29T22:16:45,Amurrio,expenses,children,-81.31,-12427.88
buyer_3,Ana,35,ES85209524939783321778,TRX_N-00409-05149568,2022-12-30T14:09:38,Lasarte-Oria,Expense,cash,-100.0,-12527.88
buyer_3,Ana,35,ES85209524939783321778,TRX_N-00410-45227445,2022-12-31T10:33:36,Amurrio,Expense,leisure,-76.52,-12604.4
buyer_3,Ana,35,ES85209524939783321778,TRX_N-00411-79996790,2023-01-01T19:01:01,Amurrio,incomes,salary,1438.44,-11165.96
buyer_3,Ana,35,ES85209524939783321778,TRX_N-00412-13124477,2023-01-01T19:01:01,Amurrio,incomes,salary_partner,1415.8,-9750.16
buyer_3,Ana,35,ES85209524939783321778,TRX_N-00413-10829462,2023-01-02T16:20:57,Amurrio,Expense,food,-65.57,-9815.73
buyer_3,Ana,35,ES85209524939783321778,TRX_N-00414-95956362,2023-01-02T11:36:20,Labastida,Expense,cash,-100.0,-9915.73
buyer_3,Ana,35,ES85209524939783321778,TRX_N-00415-99789652,2023-01-04T16:06:33,Amurrio,expenses,mortgage,-912.03,-10827.76
buyer_3,Ana,35,ES85209524939783321778,TRX_N-00416-40982686,2023-01-04T15:47:45,Amurrio,Expense,travel,-1848.52,-12676.28
buyer_3,Ana,35,ES85209524939783321778,TRX_N-00417-87948262,2023-01-04T20:27:16,Amurrio,Expense,repairs,-42.68,-12718.96
buyer_3,Ana,35,ES85209524939783321778,TRX_N-00418-39038638,2023-01-06T19:04:24,Amurrio,expenses,gas,-78.54,-12797.5
buyer_3,Ana,35,ES85209524939783321778,TRX_N-00419-78131595,2023-01-07T17:29:24,Amurrio,expenses,internet,-42.0,-12839.5
buyer_3,Ana,35,ES85209524939783321778,TRX_N-00420-18710258,2023-01-08T18:19:14,Amurrio,expenses,water,-29.1,-12868.6
buyer_3,Ana,35,ES85209524939783321778,TRX_N-00421-62180535,2023-01-08T16:01:32,Amurrio,expenses,electricity,-23.0,-12891.6
buyer_3,Ana,35,ES85209524939783321778,TRX_N-00422-50826041,2023-01-08T08:00:35,Amurrio,expenses,phone,-36.82,-12928.42
buyer_3,Ana,35,ES85209524939783321778,TRX_N-00423-00515560,2023-01-10T07:03:48,Santurtzi,Expense,transport,-85.53,-13013.95
buyer_3,Ana,35,ES85209524939783321778,TRX_N-00424-56835119,2023-01-11T11:25:15,Iru√±a de Oca,Expense,leisure,-56.27,-13070.22
buyer_3,Ana,35,ES85209524939783321778,TRX_N-00425-42250967,2023-01-15T15:26:53,Irun,Expense,leisure,-35.15,-13105.37
buyer_3,Ana,35,ES85209524939783321778,TRX_N-00426-67182214,2023-01-16T22:50:35,Amurrio,Expense,cash,-100.0,-13205.37
buyer_3,Ana,35,ES85209524939783321778,TRX_N-00427-40471496,2023-01-18T14:50:00,Amurrio,Expense,gifts,-607.91,-13813.28
buyer_3,Ana,35,ES85209524939783321778,TRX_N-00428-44864893,2023-01-20T08:49:19,Amurrio,Expense,cash,-100.0,-13913.28
buyer_3,Ana,35,ES85209524939783321778,TRX_N-00429-76880256,2023-01-21T19:24:25,Amurrio,Expense,cash,-100.0,-14013.28
buyer_3,Ana,35,ES85209524939783321778,TRX_N-00430-06007378,2023-01-21T08:02:47,Amurrio,Expense,gifts,-658.5,-14671.78
buyer_3,Ana,35,ES85209524939783321778,TRX_N-00431-07037127,2023-01-22T17:55:47,Zuia,Expense,leisure,-84.91,-14756.69
buyer_3,Ana,35,ES85209524939783321778,TRX_N-00432-24098899,2023-01-25T08:16:55,Amurrio,Expense,transport,-59.59,-14816.28
buyer_3,Ana,35,ES85209524939783321778,TRX_N-00433-05878681,2023-01-25T16:37:33,Amurrio,expenses,children,-103.89,-14920.17
buyer_3,Ana,35,ES85209524939783321778,TRX_N-00434-53194522,2023-01-27T11:03:28,Amurrio,Expense,travel,-689.58,-15609.75
buyer_3,Ana,35,ES85209524939783321778,TRX_N-00435-35976766,2023-01-27T16:18:01,Amurrio,Expense,repairs,-289.19,-15898.94
buyer_3,Ana,35,ES85209524939783321778,TRX_N-00436-45450159,2023-01-27T12:20:29,Amurrio,expenses,children,-187.86,-16086.8
buyer_3,Ana,35,ES85209524939783321778,TRX_N-00437-23225310,2023-01-28T10:30:48,Amurrio,Expense,transport,-46.99,-16133.79
buyer_3,Ana,35,ES85209524939783321778,TRX_N-00438-67409819,2023-01-31T17:05:45,Amurrio,Expense,cash,-100.0,-16233.79
buyer_3,Ana,35,ES85209524939783321778,TRX_N-00439-89854086,2023-02-01T11:50:29,Amurrio,incomes,salary,1438.44,-14795.35
buyer_3,Ana,35,ES85209524939783321778,TRX_N-00440-39670120,2023-02-01T11:50:29,Amurrio,incomes,salary_partner,1415.8,-13379.55
buyer_3,Ana,35,ES85209524939783321778,TRX_N-00441-71844410,2023-02-01T11:50:29,Amurrio,incomes,extra_income,257.05,-13122.5
buyer_3,Ana,35,ES85209524939783321778,TRX_N-00442-45224599,2023-02-03T15:26:02,Amurrio,Expense,cash,-100.0,-13222.5
buyer_3,Ana,35,ES85209524939783321778,TRX_N-00443-37469447,2023-02-03T16:29:46,Amurrio,Expense,gifts,-363.62,-13586.12
buyer_3,Ana,35,ES85209524939783321778,TRX_N-00444-84042195,2023-02-04T08:24:22,Amurrio,expenses,mortgage,-912.03,-14498.15
buyer_3,Ana,35,ES85209524939783321778,TRX_N-00445-26788079,2023-02-05T16:52:29,Amurrio,expenses,phone,-33.73,-14531.88
buyer_3,Ana,35,ES85209524939783321778,TRX_N-00446-04988076,2023-02-05T20:30:42,Amurrio,Expense,transport,-67.38,-14599.26
buyer_3,Ana,35,ES85209524939783321778,TRX_N-00447-73197539,2023-02-05T07:38:45,Amurrio,Expense,cash,-100.0,-14699.26
buyer_3,Ana,35,ES85209524939783321778,TRX_N-00448-56021575,2023-02-06T18:28:03,Amurrio,expenses,water,-37.12,-14736.38
buyer_3,Ana,35,ES85209524939783321778,TRX_N-00449-11093192,2023-02-06T17:39:09,Amurrio,expenses,children,-69.66,-14806.04
buyer_3,Ana,35,ES85209524939783321778,TRX_N-00450-36480852,2023-02-07T08:35:02,Amurrio,Expense,leisure,-37.9,-14843.94
buyer_3,Ana,35,ES85209524939783321778,TRX_N-00451-14963739,2023-02-07T13:00:49,Amurrio,Expense,cash,-100.0,-14943.94
buyer_3,Ana,35,ES85209524939783321778,TRX_N-00452-92160012,2023-02-08T12:56:30,Amurrio,expenses,electricity,-40.57,-14984.51
buyer_3,Ana,35,ES85209524939783321778,TRX_N-00453-50459836,2023-02-08T09:21:48,Amurrio,expenses,gas,-48.47,-15032.98
buyer_3,Ana,35,ES85209524939783321778,TRX_N-00454-16393725,2023-02-08T09:22:54,Amurrio,expenses,internet,-42.0,-15074.98
buyer_3,Ana,35,ES85209524939783321778,TRX_N-00455-38867686,2023-02-08T15:22:29,Sestao,Expense,leisure,-32.38,-15107.36
buyer_3,Ana,35,ES85209524939783321778,TRX_N-00456-99308347,2023-02-09T17:37:27,Amurrio,Expense,food,-79.39,-15186.75
buyer_3,Ana,35,ES85209524939783321778,TRX_N-00457-62081714,2023-02-09T15:38:52,Amurrio,Expense,education,-53.69,-15240.44
buyer_3,Ana,35,ES85209524939783321778,TRX_N-00458-61473775,2023-02-09T10:40:43,Alegr√≠a-Dulantzi,Expense,cash,-100.0,-15340.44
buyer_3,Ana,35,ES85209524939783321778,TRX_N-00459-65304863,2023-02-09T11:03:17,Amurrio,Expense,gifts,-132.16,-15472.6
buyer_3,Ana,35,ES85209524939783321778,TRX_N-00460-74326370,2023-02-11T14:37:18,Amurrio,expenses,children,-195.47,-15668.07
buyer_3,Ana,35,ES85209524939783321778,TRX_N-00461-92997987,2023-02-12T11:17:44,Hernani,Expense,transport,-58.24,-15726.31
buyer_3,Ana,35,ES85209524939783321778,TRX_N-00462-99041097,2023-02-14T10:20:54,Amurrio,Expense,food,-87.46,-15813.77
buyer_3,Ana,35,ES85209524939783321778,TRX_N-00463-19486165,2023-02-14T11:26:39,Amurrio,Expense,cash,-100.0,-15913.77
buyer_3,Ana,35,ES85209524939783321778,TRX_N-00464-83387601,2023-02-15T13:20:36,Amurrio,Expense,clothing,-62.61,-15976.38
buyer_3,Ana,35,ES85209524939783321778,TRX_N-00465-36074663,2023-02-15T04:37:38,Amurrio,Expense,cash,-100.0,-16076.38
buyer_3,Ana,35,ES85209524939783321778,TRX_N-00466-03038547,2023-02-19T15:23:37,Amurrio,expenses,children,-101.37,-16177.75
buyer_3,Ana,35,ES85209524939783321778,TRX_N-00467-68588004,2023-02-20T19:04:14,Amurrio,Expense,gifts,-53.46,-16231.21
buyer_3,Ana,35,ES85209524939783321778,TRX_N-00468-88564930,2023-02-21T03:56:05,Zuia,Expense,healthcare,-145.92,-16377.13
buyer_3,Ana,35,ES85209524939783321778,TRX_N-00469-19305951,2023-02-23T16:04:24,Durango,Expense,leisure,-47.82,-16424.95
buyer_3,Ana,35,ES85209524939783321778,TRX_N-00470-72295097,2023-02-23T14:21:37,Amurrio,Expense,healthcare,-144.19,-16569.14
buyer_3,Ana,35,ES85209524939783321778,TRX_N-00471-28558828,2023-02-26T10:15:39,Amurrio,Expense,food,-96.78,-16665.92
buyer_3,Ana,35,ES85209524939783321778,TRX_N-00472-25948302,2023-02-26T08:29:48,Amurrio,Expense,leisure,-39.26,-16705.18
buyer_3,Ana,35,ES85209524939783321778,TRX_N-00473-86037878,2023-02-27T13:21:50,Amurrio,Expense,transport,-53.42,-16758.6
buyer_3,Ana,35,ES85209524939783321778,TRX_N-00474-17142375,2023-03-01T16:38:22,Amurrio,incomes,salary,1438.44,-15320.16
buyer_3,Ana,35,ES85209524939783321778,TRX_N-00475-29949019,2023-03-01T16:38:22,Amurrio,incomes,salary_partner,1415.8,-13904.36
buyer_3,Ana,35,ES85209524939783321778,TRX_N-00476-81509291,2023-03-01T20:43:20,Portugalete,Expense,food,-95.54,-13999.9
buyer_3,Ana,35,ES85209524939783321778,TRX_N-00477-43716062,2023-03-01T14:50:18,Portugalete,Expense,repairs,-152.88,-14152.78
buyer_3,Ana,35,ES85209524939783321778,TRX_N-00478-45425539,2023-03-02T11:53:48,Hondarribia,Expense,gifts,-542.48,-14695.26
buyer_3,Ana,35,ES85209524939783321778,TRX_N-00479-73726912,2023-03-04T09:40:39,Amurrio,expenses,mortgage,-912.03,-15607.29
buyer_3,Ana,35,ES85209524939783321778,TRX_N-00480-64546241,2023-03-04T22:23:49,Amurrio,Expense,appliances,-131.21,-15738.5
buyer_3,Ana,35,ES85209524939783321778,TRX_N-00481-00263753,2023-03-04T16:47:04,Amurrio,expenses,children,-52.0,-15790.5
buyer_3,Ana,35,ES85209524939783321778,TRX_N-00482-41900336,2023-03-05T16:13:31,Amurrio,expenses,electricity,-41.6,-15832.1
buyer_3,Ana,35,ES85209524939783321778,TRX_N-00483-16801882,2023-03-05T15:21:17,Amurrio,expenses,gas,-47.53,-15879.63
buyer_3,Ana,35,ES85209524939783321778,TRX_N-00484-81252676,2023-03-05T13:45:21,Amurrio,expenses,internet,-42.0,-15921.63
buyer_3,Ana,35,ES85209524939783321778,TRX_N-00485-42196235,2023-03-05T13:39:45,Amurrio,expenses,phone,-37.72,-15959.35
buyer_3,Ana,35,ES85209524939783321778,TRX_N-00486-26303923,2023-03-05T13:07:32,Eibar,Expense,transport,-74.03,-16033.38
buyer_3,Ana,35,ES85209524939783321778,TRX_N-00487-20353819,2023-03-06T10:03:07,Amurrio,Expense,transport,-56.24,-16089.62
buyer_3,Ana,35,ES85209524939783321778,TRX_N-00488-76326188,2023-03-08T19:04:52,Amurrio,expenses,water,-21.28,-16110.9
buyer_3,Ana,35,ES85209524939783321778,TRX_N-00489-01873548,2023-03-08T11:53:35,Arrasate,Expense,travel,-1032.82,-17143.72
buyer_3,Ana,35,ES85209524939783321778,TRX_N-00490-18035723,2023-03-08T18:54:04,Amurrio,Expense,repairs,-35.53,-17179.25
buyer_3,Ana,35,ES85209524939783321778,TRX_N-00491-51024956,2023-03-09T15:18:52,Amurrio,Expense,gifts,-267.48,-17446.73
buyer_3,Ana,35,ES85209524939783321778,TRX_N-00492-74260840,2023-03-10T17:49:48,Amurrio,Expense,leisure,-25.63,-17472.36
buyer_3,Ana,35,ES85209524939783321778,TRX_N-00493-61915118,2023-03-10T15:27:26,Amurrio,Expense,healthcare,-99.46,-17571.82
buyer_3,Ana,35,ES85209524939783321778,TRX_N-00494-00274093,2023-03-12T12:38:03,Amurrio,Expense,clothing,-64.28,-17636.1
buyer_3,Ana,35,ES85209524939783321778,TRX_N-00495-53650999,2023-03-12T14:27:25,Amurrio,Expense,repairs,-308.84,-17944.94
buyer_3,Ana,35,ES85209524939783321778,TRX_N-00496-18795052,2023-03-15T16:31:08,Santurtzi,Expense,food,-77.41,-18022.35
buyer_3,Ana,35,ES85209524939783321778,TRX_N-00497-36889019,2023-03-16T13:49:33,Amurrio,Expense,cash,-100.0,-18122.35
buyer_3,Ana,35,ES85209524939783321778,TRX_N-00498-95105864,2023-03-18T05:56:50,Amurrio,Expense,cash,-100.0,-18222.35
buyer_3,Ana,35,ES85209524939783321778,TRX_N-00499-44874404,2023-03-19T17:55:58,Amurrio,Expense,transport,-66.73,-18289.08
buyer_3,Ana,35,ES85209524939783321778,TRX_N-00500-59692350,2023-03-20T20:54:25,Amurrio,Expense,transport,-77.5,-18366.58
buyer_3,Ana,35,ES85209524939783321778,TRX_N-00501-02738835,2023-03-22T09:52:44,Amurrio,Expense,food,-65.62,-18432.2
buyer_3,Ana,35,ES85209524939783321778,TRX_N-00502-89564714,2023-03-22T17:58:09,Amurrio,Expense,repairs,-63.26,-18495.46
buyer_3,Ana,35,ES85209524939783321778,TRX_N-00503-04401466,2023-03-23T12:33:12,Amurrio,Expense,gifts,-459.13,-18954.59
buyer_3,Ana,35,ES85209524939783321778,TRX_N-00504-02563114,2023-03-24T14:52:12,Amurrio,Expense,cash,-100.0,-19054.59
buyer_3,Ana,35,ES85209524939783321778,TRX_N-00505-22312106,2023-03-25T01:36:20,Amurrio,Expense,repairs,-56.53,-19111.12
buyer_3,Ana,35,ES85209524939783321778,TRX_N-00506-77600781,2023-03-27T10:02:15,Amurrio,Expense,transport,-59.09,-19170.21
buyer_3,Ana,35,ES85209524939783321778,TRX_N-00507-97978950,2023-03-27T08:21:23,Amurrio,Expense,leisure,-80.75,-19250.96
buyer_3,Ana,35,ES85209524939783321778,TRX_N-00508-51097153,2023-03-29T15:12:57,Amurrio,Expense,education,-77.79,-19328.75
buyer_3,Ana,35,ES85209524939783321778,TRX_N-00509-31346405,2023-03-31T13:26:26,Amurrio,Expense,repairs,-99.07,-19427.82
buyer_3,Ana,35,ES85209524939783321778,TRX_N-00510-81811255,2023-04-01T20:00:12,Amurrio,incomes,salary,1438.44,-17989.38
buyer_3,Ana,35,ES85209524939783321778,TRX_N-00511-09408430,2023-04-01T20:00:12,Amurrio,incomes,salary_partner,1415.8,-16573.58
buyer_3,Ana,35,ES85209524939783321778,TRX_N-00512-10009158,2023-04-01T16:44:07,Amurrio,Expense,leisure,-46.06,-16619.64
buyer_3,Ana,35,ES85209524939783321778,TRX_N-00513-84435821,2023-04-02T10:40:11,Oy√≥n-Oion,Expense,leisure,-43.18,-16662.82
buyer_3,Ana,35,ES85209524939783321778,TRX_N-00514-18374722,2023-04-02T11:54:59,Amurrio,expenses,children,-139.25,-16802.07
buyer_3,Ana,35,ES85209524939783321778,TRX_N-00515-09873678,2023-04-03T14:35:03,Sopela,Expense,food,-110.1,-16912.17
buyer_3,Ana,35,ES85209524939783321778,TRX_N-00516-15534789,2023-04-03T20:38:38,Amurrio,Expense,leisure,-67.91,-16980.08
buyer_3,Ana,35,ES85209524939783321778,TRX_N-00517-29092499,2023-04-04T16:27:21,Amurrio,expenses,mortgage,-912.03,-17892.11
buyer_3,Ana,35,ES85209524939783321778,TRX_N-00518-50764528,2023-04-04T23:06:11,Amurrio,Expense,food,-63.42,-17955.53
buyer_3,Ana,35,ES85209524939783321778,TRX_N-00519-41645582,2023-04-04T13:32:23,Amurrio,expenses,children,-181.3,-18136.83
buyer_3,Ana,35,ES85209524939783321778,TRX_N-00520-62870945,2023-04-05T09:24:04,Amurrio,expenses,water,-44.03,-18180.86
buyer_3,Ana,35,ES85209524939783321778,TRX_N-00521-00447312,2023-04-05T19:42:59,Amurrio,expenses,gas,-43.6,-18224.46
buyer_3,Ana,35,ES85209524939783321778,TRX_N-00522-55151564,2023-04-05T17:20:59,Amurrio,Expense,food,-87.41,-18311.87
buyer_3,Ana,35,ES85209524939783321778,TRX_N-00523-00972646,2023-04-05T14:05:45,Amurrio,Expense,education,-62.45,-18374.32
buyer_3,Ana,35,ES85209524939783321778,TRX_N-00524-07711631,2023-04-06T12:32:34,Berango,Expense,food,-72.29,-18446.61
buyer_3,Ana,35,ES85209524939783321778,TRX_N-00525-21670026,2023-04-07T13:09:28,Amurrio,expenses,electricity,-65.53,-18512.14
buyer_3,Ana,35,ES85209524939783321778,TRX_N-00526-83061630,2023-04-08T18:08:15,Amurrio,expenses,internet,-42.0,-18554.14
buyer_3,Ana,35,ES85209524939783321778,TRX_N-00527-23523984,2023-04-08T13:57:37,Amurrio,expenses,phone,-32.89,-18587.03
buyer_3,Ana,35,ES85209524939783321778,TRX_N-00528-01306925,2023-04-08T20:35:03,Amurrio,Expense,leisure,-32.55,-18619.58
buyer_3,Ana,35,ES85209524939783321778,TRX_N-00529-17122510,2023-04-08T22:37:55,Amurrio,Expense,travel,-1679.39,-20298.97
buyer_3,Ana,35,ES85209524939783321778,TRX_N-00530-05187367,2023-04-09T10:21:29,Alegr√≠a-Dulantzi,Expense,leisure,-19.17,-20318.14
buyer_3,Ana,35,ES85209524939783321778,TRX_N-00531-55248032,2023-04-11T14:22:14,Amurrio,Expense,repairs,-291.11,-20609.25
buyer_3,Ana,35,ES85209524939783321778,TRX_N-00532-90907956,2023-04-14T09:32:31,Amurrio,Expense,gifts,-563.7,-21172.95
buyer_3,Ana,35,ES85209524939783321778,TRX_N-00533-88806165,2023-04-15T21:36:29,Amurrio,Expense,leisure,-30.67,-21203.62
buyer_3,Ana,35,ES85209524939783321778,TRX_N-00534-70637535,2023-04-15T11:52:40,Amurrio,Expense,healthcare,-143.52,-21347.14
buyer_3,Ana,35,ES85209524939783321778,TRX_N-00535-22469787,2023-04-17T12:17:30,Amurrio,Expense,transport,-56.62,-21403.76
buyer_3,Ana,35,ES85209524939783321778,TRX_N-00536-32272962,2023-04-17T11:06:31,Amurrio,Expense,leisure,-31.54,-21435.3
buyer_3,Ana,35,ES85209524939783321778,TRX_N-00537-16256234,2023-04-17T15:08:59,Amurrio,Expense,cash,-100.0,-21535.3
buyer_3,Ana,35,ES85209524939783321778,TRX_N-00538-44260951,2023-04-18T18:23:17,Vitoria-Gasteiz,Expense,cash,-100.0,-21635.3
buyer_3,Ana,35,ES85209524939783321778,TRX_N-00539-76358229,2023-04-20T13:50:14,Amurrio,Expense,healthcare,-55.4,-21690.7
buyer_3,Ana,35,ES85209524939783321778,TRX_N-00540-00884815,2023-04-22T18:29:26,Amurrio,Expense,gifts,-31.57,-21722.27
buyer_3,Ana,35,ES85209524939783321778,TRX_N-00541-08248019,2023-04-25T11:54:38,Amurrio,Expense,leisure,-18.4,-21740.67
buyer_3,Ana,35,ES85209524939783321778,TRX_N-00542-64242631,2023-04-26T13:58:29,Bermeo,Expense,leisure,-41.62,-21782.29
buyer_3,Ana,35,ES85209524939783321778,TRX_N-00543-89162590,2023-04-26T17:14:43,Amurrio,Expense,cash,-100.0,-21882.29
buyer_3,Ana,35,ES85209524939783321778,TRX_N-00544-72311789,2023-04-29T18:04:42,Amurrio,Expense,food,-97.09,-21979.38
buyer_3,Ana,35,ES85209524939783321778,TRX_N-00545-75372020,2023-04-29T09:06:41,Amurrio,Expense,gifts,-659.65,-22639.03
buyer_3,Ana,35,ES85209524939783321778,TRX_N-00546-90445395,2023-05-01T14:14:15,Amurrio,incomes,salary,1438.44,-21200.59
buyer_3,Ana,35,ES85209524939783321778,TRX_N-00547-73743895,2023-05-01T14:14:15,Amurrio,incomes,salary_partner,1415.8,-19784.79
buyer_3,Ana,35,ES85209524939783321778,TRX_N-00548-60554587,2023-05-03T10:20:22,Amurrio,Expense,repairs,-49.34,-19834.13
buyer_3,Ana,35,ES85209524939783321778,TRX_N-00549-95656547,2023-05-03T12:40:38,Amurrio,expenses,children,-198.6,-20032.73
buyer_3,Ana,35,ES85209524939783321778,TRX_N-00550-39337068,2023-05-04T14:23:19,Amurrio,expenses,mortgage,-912.03,-20944.76
buyer_3,Ana,35,ES85209524939783321778,TRX_N-00551-75134554,2023-05-05T17:42:03,Amurrio,expenses,phone,-39.75,-20984.51
buyer_3,Ana,35,ES85209524939783321778,TRX_N-00552-05455226,2023-05-05T13:14:06,Amurrio,Expense,leisure,-47.57,-21032.08
buyer_3,Ana,35,ES85209524939783321778,TRX_N-00553-64283014,2023-05-06T10:00:51,Amurrio,Expense,gifts,-719.74,-21751.82
buyer_3,Ana,35,ES85209524939783321778,TRX_N-00554-40341193,2023-05-08T09:58:45,Amurrio,expenses,electricity,-36.46,-21788.28
buyer_3,Ana,35,ES85209524939783321778,TRX_N-00555-38592728,2023-05-08T13:41:27,Amurrio,expenses,internet,-42.0,-21830.28
buyer_3,Ana,35,ES85209524939783321778,TRX_N-00556-10192614,2023-05-08T22:39:11,Amurrio,expenses,water,-40.12,-21870.4
buyer_3,Ana,35,ES85209524939783321778,TRX_N-00557-28839668,2023-05-08T14:53:15,Amurrio,expenses,gas,-87.27,-21957.67
buyer_3,Ana,35,ES85209524939783321778,TRX_N-00558-03380946,2023-05-08T17:46:22,Amurrio,Expense,cash,-100.0,-22057.67
buyer_3,Ana,35,ES85209524939783321778,TRX_N-00559-10142266,2023-05-09T12:03:17,Berango,Expense,healthcare,-83.01,-22140.68
buyer_3,Ana,35,ES85209524939783321778,TRX_N-00560-90871625,2023-05-09T11:18:01,Amurrio,expenses,children,-71.11,-22211.79
buyer_3,Ana,35,ES85209524939783321778,TRX_N-00561-69459001,2023-05-11T08:44:58,Amurrio,Expense,cash,-100.0,-22311.79
buyer_3,Ana,35,ES85209524939783321778,TRX_N-00562-39718598,2023-05-12T18:22:38,Amurrio,Expense,food,-60.41,-22372.2
buyer_3,Ana,35,ES85209524939783321778,TRX_N-00563-18030397,2023-05-12T11:48:29,Amurrio,Expense,gifts,-25.64,-22397.84
buyer_3,Ana,35,ES85209524939783321778,TRX_N-00564-12749725,2023-05-13T12:33:42,Amurrio,Expense,healthcare,-136.82,-22534.66
buyer_3,Ana,35,ES85209524939783321778,TRX_N-00565-20795519,2023-05-15T18:34:10,Amurrio,Expense,repairs,-96.9,-22631.56
buyer_3,Ana,35,ES85209524939783321778,TRX_N-00566-78304177,2023-05-17T22:44:12,Amurrio,Expense,repairs,-147.53,-22779.09
buyer_3,Ana,35,ES85209524939783321778,TRX_N-00567-78505442,2023-05-22T12:45:20,Amurrio,Expense,education,-65.27,-22844.36
buyer_3,Ana,35,ES85209524939783321778,TRX_N-00568-79424181,2023-05-27T12:38:13,Amurrio,Expense,transport,-76.46,-22920.82
buyer_3,Ana,35,ES85209524939783321778,TRX_N-00569-29457815,2023-05-27T15:52:41,Amurrio,expenses,children,-177.65,-23098.47
buyer_3,Ana,35,ES85209524939783321778,TRX_N-00570-83959052,2023-05-28T18:20:25,Leioa,Expense,cash,-100.0,-23198.47
buyer_3,Ana,35,ES85209524939783321778,TRX_N-00571-95932857,2023-06-01T14:38:25,Amurrio,incomes,salary,1438.44,-21760.03
buyer_3,Ana,35,ES85209524939783321778,TRX_N-00572-09322555,2023-06-01T14:38:25,Amurrio,incomes,salary_partner,1415.8,-20344.23
buyer_3,Ana,35,ES85209524939783321778,TRX_N-00573-86166126,2023-06-01T14:38:25,Amurrio,incomes,extra_income,257.05,-20087.18
buyer_3,Ana,35,ES85209524939783321778,TRX_N-00574-80807405,2023-06-01T14:38:25,Amurrio,incomes,salary_bonus,1070.31,-19016.87
buyer_3,Ana,35,ES85209524939783321778,TRX_N-00575-44870241,2023-06-01T14:38:25,Amurrio,incomes,salary_partner_bonus,1020.55,-17996.32
buyer_3,Ana,35,ES85209524939783321778,TRX_N-00576-89137856,2023-06-02T22:01:41,Labastida,Expense,cash,-100.0,-18096.32
buyer_3,Ana,35,ES85209524939783321778,TRX_N-00577-23090036,2023-06-03T10:18:37,Amurrio,Expense,food,-82.14,-18178.46
buyer_3,Ana,35,ES85209524939783321778,TRX_N-00578-31206538,2023-06-04T19:44:23,Amurrio,expenses,mortgage,-912.03,-19090.49
buyer_3,Ana,35,ES85209524939783321778,TRX_N-00579-58158918,2023-06-04T14:19:06,Amurrio,Expense,cash,-100.0,-19190.49
buyer_3,Ana,35,ES85209524939783321778,TRX_N-00580-78622330,2023-06-05T20:58:26,Amurrio,expenses,electricity,-56.68,-19247.17
buyer_3,Ana,35,ES85209524939783321778,TRX_N-00581-08031160,2023-06-05T13:00:49,Amurrio,Expense,gifts,-160.95,-19408.12
buyer_3,Ana,35,ES85209524939783321778,TRX_N-00582-34637086,2023-06-06T13:22:47,Lasarte-Oria,Expense,leisure,-56.94,-19465.06
buyer_3,Ana,35,ES85209524939783321778,TRX_N-00583-45548846,2023-06-06T08:46:40,Amurrio,Expense,clothing,-105.89,-19570.95
buyer_3,Ana,35,ES85209524939783321778,TRX_N-00584-90355574,2023-06-08T18:55:10,Amurrio,expenses,water,-44.39,-19615.34
buyer_3,Ana,35,ES85209524939783321778,TRX_N-00585-72344785,2023-06-08T16:05:44,Amurrio,expenses,gas,-112.91,-19728.25
buyer_3,Ana,35,ES85209524939783321778,TRX_N-00586-51787313,2023-06-08T20:50:16,Amurrio,expenses,internet,-42.0,-19770.25
buyer_3,Ana,35,ES85209524939783321778,TRX_N-00587-87442598,2023-06-08T14:18:57,Amurrio,expenses,phone,-32.24,-19802.49
buyer_3,Ana,35,ES85209524939783321778,TRX_N-00588-94515301,2023-06-09T07:45:14,Amurrio,Expense,food,-108.28,-19910.77
buyer_3,Ana,35,ES85209524939783321778,TRX_N-00589-97449442,2023-06-09T15:43:14,Amurrio,Expense,gifts,-353.63,-20264.4
buyer_3,Ana,35,ES85209524939783321778,TRX_N-00590-85440844,2023-06-10T15:32:42,Amurrio,Expense,repairs,-83.02,-20347.42
buyer_3,Ana,35,ES85209524939783321778,TRX_N-00591-26936428,2023-06-16T13:17:31,Amurrio,Expense,education,-57.78,-20405.2
buyer_3,Ana,35,ES85209524939783321778,TRX_N-00592-13990169,2023-06-18T12:01:58,Amurrio,Expense,clothing,-64.31,-20469.51
buyer_3,Ana,35,ES85209524939783321778,TRX_N-00593-88515255,2023-06-19T15:06:07,Amurrio,Expense,healthcare,-168.72,-20638.23
buyer_3,Ana,35,ES85209524939783321778,TRX_N-00594-37956447,2023-06-20T18:50:41,Amurrio,Expense,transport,-49.72,-20687.95
buyer_3,Ana,35,ES85209524939783321778,TRX_N-00595-12925351,2023-06-20T12:45:06,Amurrio,Expense,clothing,-146.84,-20834.79
buyer_3,Ana,35,ES85209524939783321778,TRX_N-00596-87366724,2023-06-21T14:50:38,Amurrio,expenses,children,-130.35,-20965.14
buyer_3,Ana,35,ES85209524939783321778,TRX_N-00597-03467022,2023-06-23T06:30:45,Amurrio,Expense,transport,-81.16,-21046.3
buyer_3,Ana,35,ES85209524939783321778,TRX_N-00598-76215759,2023-06-23T02:54:19,Amurrio,Expense,leisure,-63.52,-21109.82
buyer_3,Ana,35,ES85209524939783321778,TRX_N-00599-49284847,2023-06-25T14:06:26,Amurrio,Expense,cash,-100.0,-21209.82
buyer_3,Ana,35,ES85209524939783321778,TRX_N-00600-26360630,2023-06-26T18:58:26,Amurrio,Expense,cash,-100.0,-21309.82
buyer_3,Ana,35,ES85209524939783321778,TRX_N-00601-53205357,2023-06-29T15:42:53,Amurrio,Expense,healthcare,-83.41,-21393.23
buyer_3,Ana,35,ES85209524939783321778,TRX_N-00602-27933947,2023-07-01T19:41:13,Amurrio,incomes,salary,1438.44,-19954.79
buyer_3,Ana,35,ES85209524939783321778,TRX_N-00603-75668254,2023-07-01T19:41:13,Amurrio,incomes,salary_partner,1415.8,-18538.99
buyer_3,Ana,35,ES85209524939783321778,TRX_N-00604-60624253,2023-07-01T09:12:56,Amurrio,Expense,repairs,-217.05,-18756.04
buyer_3,Ana,35,ES85209524939783321778,TRX_N-00605-33632273,2023-07-02T02:30:05,Amurrio,Expense,cash,-100.0,-18856.04
buyer_3,Ana,35,ES85209524939783321778,TRX_N-00606-12584520,2023-07-04T21:11:01,Amurrio,expenses,mortgage,-912.03,-19768.07
buyer_3,Ana,35,ES85209524939783321778,TRX_N-00607-74361498,2023-07-06T21:40:34,Amurrio,Expense,transport,-78.4,-19846.47
buyer_3,Ana,35,ES85209524939783321778,TRX_N-00608-34052416,2023-07-07T21:32:30,Amurrio,expenses,internet,-42.0,-19888.47
buyer_3,Ana,35,ES85209524939783321778,TRX_N-00609-98903466,2023-07-08T11:50:14,Amurrio,expenses,water,-33.35,-19921.82
buyer_3,Ana,35,ES85209524939783321778,TRX_N-00610-98903733,2023-07-08T13:31:13,Amurrio,expenses,electricity,-61.11,-19982.93
buyer_3,Ana,35,ES85209524939783321778,TRX_N-00611-87000326,2023-07-08T17:35:06,Amurrio,expenses,gas,-86.71,-20069.64
buyer_3,Ana,35,ES85209524939783321778,TRX_N-00612-81898865,2023-07-08T13:29:04,Amurrio,expenses,phone,-44.83,-20114.47
buyer_3,Ana,35,ES85209524939783321778,TRX_N-00613-36712901,2023-07-11T14:19:45,Amurrio,Expense,education,-49.28,-20163.75
buyer_3,Ana,35,ES85209524939783321778,TRX_N-00614-55705443,2023-07-11T14:49:42,Arrasate,Expense,appliances,-327.28,-20491.03
buyer_3,Ana,35,ES85209524939783321778,TRX_N-00615-01209565,2023-07-12T05:11:53,Amurrio,Expense,leisure,-68.35,-20559.38
buyer_3,Ana,35,ES85209524939783321778,TRX_N-00616-52028407,2023-07-12T15:20:51,Amurrio,Expense,repairs,-104.44,-20663.82
buyer_3,Ana,35,ES85209524939783321778,TRX_N-00617-51860979,2023-07-14T19:19:15,Eibar,Expense,cash,-100.0,-20763.82
buyer_3,Ana,35,ES85209524939783321778,TRX_N-00618-16423956,2023-07-15T10:42:14,Amurrio,Expense,transport,-87.99,-20851.81
buyer_3,Ana,35,ES85209524939783321778,TRX_N-00619-70488939,2023-07-16T17:12:47,Vitoria-Gasteiz,Expense,food,-120.17,-20971.98
buyer_3,Ana,35,ES85209524939783321778,TRX_N-00620-75667349,2023-07-16T12:25:47,Andoain,Expense,education,-77.18,-21049.16
buyer_3,Ana,35,ES85209524939783321778,TRX_N-00621-51701016,2023-07-16T10:20:51,Amurrio,Expense,cash,-100.0,-21149.16
buyer_3,Ana,35,ES85209524939783321778,TRX_N-00622-39439641,2023-07-18T19:43:36,Amurrio,Expense,transport,-60.77,-21209.93
buyer_3,Ana,35,ES85209524939783321778,TRX_N-00623-97602166,2023-07-19T16:07:14,Amurrio,Expense,leisure,-72.79,-21282.72
buyer_3,Ana,35,ES85209524939783321778,TRX_N-00624-33376890,2023-07-23T15:21:24,Amurrio,Expense,transport,-77.17,-21359.89
buyer_3,Ana,35,ES85209524939783321778,TRX_N-00625-57145009,2023-07-25T14:21:36,Amurrio,Expense,transport,-58.03,-21417.92
buyer_3,Ana,35,ES85209524939783321778,TRX_N-00626-28863313,2023-07-28T19:19:59,Amurrio,Expense,repairs,-167.2,-21585.12
buyer_3,Ana,35,ES85209524939783321778,TRX_N-00627-26178389,2023-07-29T20:56:20,Oy√≥n-Oion,Expense,transport,-83.01,-21668.13
buyer_3,Ana,35,ES85209524939783321778,TRX_N-00628-67320113,2023-07-29T10:47:05,Amurrio,Expense,cash,-100.0,-21768.13
buyer_3,Ana,35,ES85209524939783321778,TRX_N-00629-47584340,2023-08-01T01:29:17,Amurrio,incomes,salary,1438.44,-20329.69
buyer_3,Ana,35,ES85209524939783321778,TRX_N-00630-88948984,2023-08-01T01:29:17,Amurrio,incomes,salary_partner,1415.8,-18913.89
buyer_3,Ana,35,ES85209524939783321778,TRX_N-00631-44275436,2023-08-02T16:10:16,Leioa,Expense,transport,-56.54,-18970.43
buyer_3,Ana,35,ES85209524939783321778,TRX_N-00632-96285523,2023-08-04T15:37:58,Amurrio,expenses,mortgage,-912.03,-19882.46
buyer_3,Ana,35,ES85209524939783321778,TRX_N-00633-82328977,2023-08-05T23:19:41,Amurrio,expenses,phone,-38.49,-19920.95
buyer_3,Ana,35,ES85209524939783321778,TRX_N-00634-72050250,2023-08-05T20:00:55,Galdakao,Expense,education,-73.76,-19994.71
buyer_3,Ana,35,ES85209524939783321778,TRX_N-00635-78763194,2023-08-07T09:21:23,Amurrio,Expense,healthcare,-116.12,-20110.83
buyer_3,Ana,35,ES85209524939783321778,TRX_N-00636-20769660,2023-08-08T13:17:06,Amurrio,expenses,gas,-110.35,-20221.18
buyer_3,Ana,35,ES85209524939783321778,TRX_N-00637-01681605,2023-08-08T13:46:48,Amurrio,expenses,water,-26.26,-20247.44
buyer_3,Ana,35,ES85209524939783321778,TRX_N-00638-40454266,2023-08-08T11:56:16,Amurrio,expenses,electricity,-75.46,-20322.9
buyer_3,Ana,35,ES85209524939783321778,TRX_N-00639-42254392,2023-08-08T10:23:06,Amurrio,expenses,internet,-42.0,-20364.9
buyer_3,Ana,35,ES85209524939783321778,TRX_N-00640-37064483,2023-08-09T18:03:42,Amurrio,Expense,food,-70.79,-20435.69
buyer_3,Ana,35,ES85209524939783321778,TRX_N-00641-01944053,2023-08-11T08:05:01,Amurrio,Expense,repairs,-252.76,-20688.45
buyer_3,Ana,35,ES85209524939783321778,TRX_N-00642-22924747,2023-08-13T13:00:54,Amurrio,Expense,clothing,-106.32,-20794.77
buyer_3,Ana,35,ES85209524939783321778,TRX_N-00643-52493971,2023-08-13T19:44:18,Amurrio,Expense,cash,-100.0,-20894.77
buyer_3,Ana,35,ES85209524939783321778,TRX_N-00644-51883413,2023-08-14T18:54:16,Alegr√≠a-Dulantzi,Expense,healthcare,-120.2,-21014.97
buyer_3,Ana,35,ES85209524939783321778,TRX_N-00645-59582793,2023-08-16T11:22:09,Zarautz,Expense,food,-95.2,-21110.17
buyer_3,Ana,35,ES85209524939783321778,TRX_N-00646-50906217,2023-08-16T09:38:43,Amurrio,Expense,cash,-100.0,-21210.17
buyer_3,Ana,35,ES85209524939783321778,TRX_N-00647-00013965,2023-08-17T08:09:04,Amurrio,Expense,food,-102.57,-21312.74
buyer_3,Ana,35,ES85209524939783321778,TRX_N-00648-83261732,2023-08-18T15:43:01,Amurrio,Expense,cash,-100.0,-21412.74
buyer_3,Ana,35,ES85209524939783321778,TRX_N-00649-55046598,2023-08-19T11:12:16,Amurrio,Expense,healthcare,-70.53,-21483.27
buyer_3,Ana,35,ES85209524939783321778,TRX_N-00650-95205463,2023-08-22T09:05:51,Amurrio,Expense,clothing,-93.87,-21577.14
buyer_3,Ana,35,ES85209524939783321778,TRX_N-00651-62591072,2023-08-24T21:08:08,Amurrio,Expense,transport,-77.67,-21654.81
buyer_3,Ana,35,ES85209524939783321778,TRX_N-00652-63536204,2023-08-24T16:25:53,Amurrio,Expense,cash,-100.0,-21754.81
buyer_3,Ana,35,ES85209524939783321778,TRX_N-00653-69334835,2023-08-27T17:44:28,Amurrio,Expense,clothing,-157.64,-21912.45
buyer_3,Ana,35,ES85209524939783321778,TRX_N-00654-93314337,2023-08-30T17:37:59,Amurrio,Expense,clothing,-87.08,-21999.53
buyer_3,Ana,35,ES85209524939783321778,TRX_N-00655-39753666,2023-08-31T21:20:32,Pasaia,Expense,transport,-80.5,-22080.03
buyer_3,Ana,35,ES85209524939783321778,TRX_N-00656-60181358,2023-09-01T11:15:19,Amurrio,incomes,salary,1438.44,-20641.59
buyer_3,Ana,35,ES85209524939783321778,TRX_N-00657-56856417,2023-09-01T11:15:19,Amurrio,incomes,salary_partner,1415.8,-19225.79
buyer_3,Ana,35,ES85209524939783321778,TRX_N-00658-07915567,2023-09-01T11:15:19,Amurrio,incomes,extra_income,257.05,-18968.74
buyer_3,Ana,35,ES85209524939783321778,TRX_N-00659-48544949,2023-09-03T08:04:55,Amurrio,Expense,food,-106.66,-19075.4
buyer_3,Ana,35,ES85209524939783321778,TRX_N-00660-16610713,2023-09-04T08:56:51,Amurrio,expenses,mortgage,-912.03,-19987.43
buyer_3,Ana,35,ES85209524939783321778,TRX_N-00661-26734621,2023-09-06T12:18:41,Amurrio,expenses,internet,-42.0,-20029.43
buyer_3,Ana,35,ES85209524939783321778,TRX_N-00662-61437970,2023-09-08T19:07:07,Amurrio,expenses,water,-29.54,-20058.97
buyer_3,Ana,35,ES85209524939783321778,TRX_N-00663-09640912,2023-09-08T10:46:55,Amurrio,expenses,gas,-34.07,-20093.04
buyer_3,Ana,35,ES85209524939783321778,TRX_N-00664-25617567,2023-09-08T22:16:47,Amurrio,expenses,electricity,-33.41,-20126.45
buyer_3,Ana,35,ES85209524939783321778,TRX_N-00665-78532747,2023-09-08T16:11:57,Amurrio,expenses,phone,-39.05,-20165.5
buyer_3,Ana,35,ES85209524939783321778,TRX_N-00666-04230088,2023-09-08T19:10:24,Hondarribia,Expense,cash,-100.0,-20265.5
buyer_3,Ana,35,ES85209524939783321778,TRX_N-00667-04915239,2023-09-10T20:32:15,Amurrio,Expense,clothing,-61.08,-20326.58
buyer_3,Ana,35,ES85209524939783321778,TRX_N-00668-73499633,2023-09-12T12:32:06,Amurrio,Expense,gifts,-113.13,-20439.71
buyer_3,Ana,35,ES85209524939783321778,TRX_N-00669-30514044,2023-09-12T10:19:25,Amurrio,expenses,children,-121.92,-20561.63
buyer_3,Ana,35,ES85209524939783321778,TRX_N-00670-05042695,2023-09-13T10:52:40,Amurrio,Expense,cash,-100.0,-20661.63
buyer_3,Ana,35,ES85209524939783321778,TRX_N-00671-04358323,2023-09-14T22:29:31,Amurrio,Expense,food,-115.18,-20776.81
buyer_3,Ana,35,ES85209524939783321778,TRX_N-00672-10086816,2023-09-14T16:42:42,Amurrio,Expense,education,-71.96,-20848.77
buyer_3,Ana,35,ES85209524939783321778,TRX_N-00673-72318324,2023-09-16T19:01:30,Amurrio,Expense,gifts,-173.0,-21021.77
buyer_3,Ana,35,ES85209524939783321778,TRX_N-00674-28831923,2023-09-17T15:56:17,Amurrio,Expense,food,-71.89,-21093.66
buyer_3,Ana,35,ES85209524939783321778,TRX_N-00675-89852614,2023-09-17T14:23:10,Elciego,Expense,transport,-65.4,-21159.06
buyer_3,Ana,35,ES85209524939783321778,TRX_N-00676-29581092,2023-09-20T15:55:32,Amurrio,Expense,leisure,-41.9,-21200.96
buyer_3,Ana,35,ES85209524939783321778,TRX_N-00677-74970682,2023-09-20T12:01:33,Amurrio,Expense,gifts,-85.42,-21286.38
buyer_3,Ana,35,ES85209524939783321778,TRX_N-00678-81812469,2023-09-21T08:48:10,Amurrio,Expense,cash,-100.0,-21386.38
buyer_3,Ana,35,ES85209524939783321778,TRX_N-00679-15915454,2023-09-24T15:55:56,Amurrio,expenses,children,-139.24,-21525.62
buyer_3,Ana,35,ES85209524939783321778,TRX_N-00680-41655971,2023-09-25T18:31:31,Amurrio,Expense,cash,-100.0,-21625.62
buyer_3,Ana,35,ES85209524939783321778,TRX_N-00681-20346582,2023-09-25T03:31:45,Amurrio,Expense,appliances,-255.03,-21880.65
buyer_3,Ana,35,ES85209524939783321778,TRX_N-00682-26745676,2023-09-26T12:19:28,Barakaldo,Expense,food,-104.72,-21985.37
buyer_3,Ana,35,ES85209524939783321778,TRX_N-00683-15750911,2023-09-26T14:58:23,Amurrio,Expense,cash,-100.0,-22085.37
buyer_3,Ana,35,ES85209524939783321778,TRX_N-00684-96967158,2023-09-27T18:28:22,Labastida,Expense,transport,-54.57,-22139.94
buyer_3,Ana,35,ES85209524939783321778,TRX_N-00685-22386107,2023-09-30T18:30:20,Amurrio,expenses,children,-182.35,-22322.29
buyer_3,Ana,35,ES85209524939783321778,TRX_N-00686-69924011,2023-10-01T16:31:37,Amurrio,incomes,salary,1438.44,-20883.85
buyer_3,Ana,35,ES85209524939783321778,TRX_N-00687-89510635,2023-10-01T16:31:37,Amurrio,incomes,salary_partner,1415.8,-19468.05
buyer_3,Ana,35,ES85209524939783321778,TRX_N-00688-70718151,2023-10-01T22:06:36,Salvatierra/Agurain,Expense,healthcare,-44.04,-19512.09
buyer_3,Ana,35,ES85209524939783321778,TRX_N-00689-95131631,2023-10-04T10:45:58,Amurrio,expenses,mortgage,-912.03,-20424.12
buyer_3,Ana,35,ES85209524939783321778,TRX_N-00690-33059654,2023-10-05T18:26:48,Amurrio,expenses,electricity,-57.26,-20481.38
buyer_3,Ana,35,ES85209524939783321778,TRX_N-00691-76467876,2023-10-06T13:05:43,Amurrio,expenses,water,-31.59,-20512.97
buyer_3,Ana,35,ES85209524939783321778,TRX_N-00692-71210621,2023-10-07T13:07:39,Amurrio,expenses,internet,-42.0,-20554.97
buyer_3,Ana,35,ES85209524939783321778,TRX_N-00693-83703340,2023-10-08T16:25:51,Amurrio,expenses,phone,-40.5,-20595.47
buyer_3,Ana,35,ES85209524939783321778,TRX_N-00694-25555390,2023-10-08T08:17:12,Amurrio,expenses,gas,-93.76,-20689.23
buyer_3,Ana,35,ES85209524939783321778,TRX_N-00695-82062715,2023-10-09T16:05:02,Amurrio,Expense,food,-93.5,-20782.73
buyer_3,Ana,35,ES85209524939783321778,TRX_N-00696-81295516,2023-10-11T17:54:13,Bermeo,Expense,transport,-52.47,-20835.2
buyer_3,Ana,35,ES85209524939783321778,TRX_N-00697-30443930,2023-10-13T12:47:36,Amurrio,Expense,food,-120.7,-20955.9
buyer_3,Ana,35,ES85209524939783321778,TRX_N-00698-56469669,2023-10-14T12:27:59,Amurrio,expenses,children,-159.9,-21115.8
buyer_3,Ana,35,ES85209524939783321778,TRX_N-00699-09960796,2023-10-16T16:05:07,Amurrio,Expense,food,-115.37,-21231.17
buyer_3,Ana,35,ES85209524939783321778,TRX_N-00700-57719588,2023-10-17T08:18:19,Amurrio,Expense,transport,-87.19,-21318.36
buyer_3,Ana,35,ES85209524939783321778,TRX_N-00701-18467924,2023-10-18T19:38:18,Amurrio,Expense,food,-119.31,-21437.67
buyer_3,Ana,35,ES85209524939783321778,TRX_N-00702-38219049,2023-10-18T14:25:09,Getxo,Expense,cash,-100.0,-21537.67
buyer_3,Ana,35,ES85209524939783321778,TRX_N-00703-87611939,2023-10-22T14:44:41,Amurrio,Expense,food,-98.35,-21636.02
buyer_3,Ana,35,ES85209524939783321778,TRX_N-00704-86320058,2023-10-22T12:54:22,Amurrio,Expense,leisure,-74.19,-21710.21
buyer_3,Ana,35,ES85209524939783321778,TRX_N-00705-61104542,2023-10-23T16:36:39,Amurrio,Expense,gifts,-817.36,-22527.57
buyer_3,Ana,35,ES85209524939783321778,TRX_N-00706-65461075,2023-10-24T18:13:47,Mungia,Expense,transport,-61.58,-22589.15
buyer_3,Ana,35,ES85209524939783321778,TRX_N-00707-36259495,2023-10-24T21:08:11,Amurrio,Expense,cash,-100.0,-22689.15
buyer_3,Ana,35,ES85209524939783321778,TRX_N-00708-64991499,2023-10-24T08:50:57,Amurrio,Expense,repairs,-286.39,-22975.54
buyer_3,Ana,35,ES85209524939783321778,TRX_N-00709-37059372,2023-10-25T15:04:40,Amurrio,Expense,transport,-51.91,-23027.45
buyer_3,Ana,35,ES85209524939783321778,TRX_N-00710-89380002,2023-10-25T14:11:46,Amurrio,Expense,leisure,-33.89,-23061.34
buyer_3,Ana,35,ES85209524939783321778,TRX_N-00711-61513234,2023-10-27T10:55:53,Amurrio,Expense,appliances,-258.53,-23319.87
buyer_3,Ana,35,ES85209524939783321778,TRX_N-00712-11108424,2023-10-30T22:52:05,Amurrio,Expense,food,-77.03,-23396.9
buyer_3,Ana,35,ES85209524939783321778,TRX_N-00713-28071171,2023-11-01T16:51:08,Amurrio,incomes,salary,1438.44,-21958.46
buyer_3,Ana,35,ES85209524939783321778,TRX_N-00714-96016818,2023-11-01T16:51:08,Amurrio,incomes,salary_partner,1415.8,-20542.66
buyer_3,Ana,35,ES85209524939783321778,TRX_N-00715-86995260,2023-11-01T13:47:34,Amurrio,Expense,appliances,-94.9,-20637.56
buyer_3,Ana,35,ES85209524939783321778,TRX_N-00716-07198111,2023-11-02T16:42:01,Amurrio,Expense,repairs,-124.63,-20762.19
buyer_3,Ana,35,ES85209524939783321778,TRX_N-00717-60864997,2023-11-03T15:06:57,Amurrio,Expense,transport,-50.31,-20812.5
buyer_3,Ana,35,ES85209524939783321778,TRX_N-00718-47189176,2023-11-03T16:09:35,Amurrio,Expense,cash,-100.0,-20912.5
buyer_3,Ana,35,ES85209524939783321778,TRX_N-00719-00755406,2023-11-04T12:14:59,Amurrio,expenses,mortgage,-912.03,-21824.53
buyer_3,Ana,35,ES85209524939783321778,TRX_N-00720-29299320,2023-11-05T15:42:04,Amurrio,expenses,electricity,-75.96,-21900.49
buyer_3,Ana,35,ES85209524939783321778,TRX_N-00721-68570570,2023-11-05T09:54:38,Amurrio,expenses,gas,-74.99,-21975.48
buyer_3,Ana,35,ES85209524939783321778,TRX_N-00722-88715463,2023-11-05T09:37:51,Amurrio,expenses,internet,-42.0,-22017.48
buyer_3,Ana,35,ES85209524939783321778,TRX_N-00723-17717327,2023-11-05T16:17:20,Amurrio,expenses,phone,-35.95,-22053.43
buyer_3,Ana,35,ES85209524939783321778,TRX_N-00724-32052561,2023-11-06T12:58:54,Amurrio,Expense,leisure,-78.63,-22132.06
buyer_3,Ana,35,ES85209524939783321778,TRX_N-00725-84579646,2023-11-07T11:01:01,Amurrio,expenses,water,-44.61,-22176.67
buyer_3,Ana,35,ES85209524939783321778,TRX_N-00726-01697041,2023-11-07T15:52:53,Amurrio,Expense,food,-95.95,-22272.62
buyer_3,Ana,35,ES85209524939783321778,TRX_N-00727-88994733,2023-11-09T09:25:42,Amurrio,Expense,food,-120.99,-22393.61
buyer_3,Ana,35,ES85209524939783321778,TRX_N-00728-55175894,2023-11-09T08:55:13,Mungia,Expense,cash,-100.0,-22493.61
buyer_3,Ana,35,ES85209524939783321778,TRX_N-00729-59162896,2023-11-10T12:34:18,Amurrio,Expense,leisure,-40.79,-22534.4
buyer_3,Ana,35,ES85209524939783321778,TRX_N-00730-92768931,2023-11-10T20:07:31,Amurrio,Expense,cash,-100.0,-22634.4
buyer_3,Ana,35,ES85209524939783321778,TRX_N-00731-16546015,2023-11-11T21:32:10,Amurrio,Expense,healthcare,-66.87,-22701.27
buyer_3,Ana,35,ES85209524939783321778,TRX_N-00732-50003233,2023-11-11T14:27:28,Leioa,Expense,gifts,-670.66,-23371.93
buyer_3,Ana,35,ES85209524939783321778,TRX_N-00733-53503714,2023-11-12T16:09:32,Amurrio,Expense,transport,-82.91,-23454.84
buyer_3,Ana,35,ES85209524939783321778,TRX_N-00734-49409446,2023-11-12T15:44:22,Amurrio,Expense,leisure,-28.76,-23483.6
buyer_3,Ana,35,ES85209524939783321778,TRX_N-00735-26127437,2023-11-15T09:46:26,Amurrio,Expense,food,-122.23,-23605.83
buyer_3,Ana,35,ES85209524939783321778,TRX_N-00736-87996193,2023-11-18T11:16:01,Amurrio,Expense,repairs,-75.3,-23681.13
buyer_3,Ana,35,ES85209524939783321778,TRX_N-00737-84641531,2023-11-19T19:23:54,Amurrio,Expense,education,-59.24,-23740.37
buyer_3,Ana,35,ES85209524939783321778,TRX_N-00738-14215975,2023-11-20T21:51:03,Amurrio,expenses,children,-267.34,-24007.71
buyer_3,Ana,35,ES85209524939783321778,TRX_N-00739-32018000,2023-11-22T08:47:59,Amurrio,Expense,food,-80.85,-24088.56
buyer_3,Ana,35,ES85209524939783321778,TRX_N-00740-74826623,2023-11-22T17:02:50,Amurrio,Expense,clothing,-56.11,-24144.67
buyer_3,Ana,35,ES85209524939783321778,TRX_N-00741-18564683,2023-11-23T16:29:34,Amurrio,Expense,travel,-1848.62,-25993.29
buyer_3,Ana,35,ES85209524939783321778,TRX_N-00742-60287205,2023-11-24T15:50:07,Amurrio,Expense,food,-115.94,-26109.23
buyer_3,Ana,35,ES85209524939783321778,TRX_N-00743-43499714,2023-11-24T22:24:11,Amurrio,Expense,transport,-53.93,-26163.16
buyer_3,Ana,35,ES85209524939783321778,TRX_N-00744-78040877,2023-11-24T12:43:50,Andoain,Expense,leisure,-18.85,-26182.01
buyer_3,Ana,35,ES85209524939783321778,TRX_N-00745-54418785,2023-11-24T22:09:46,Amurrio,Expense,cash,-100.0,-26282.01
buyer_3,Ana,35,ES85209524939783321778,TRX_N-00746-73660112,2023-11-24T14:51:07,Amurrio,expenses,children,-269.73,-26551.74
buyer_3,Ana,35,ES85209524939783321778,TRX_N-00747-46340358,2023-11-27T18:37:08,Amurrio,Expense,transport,-83.65,-26635.39
buyer_3,Ana,35,ES85209524939783321778,TRX_N-00748-96368819,2023-11-28T17:05:23,Amurrio,Expense,appliances,-221.97,-26857.36
buyer_3,Ana,35,ES85209524939783321778,TRX_N-00749-11554803,2023-12-01T20:15:24,Amurrio,incomes,salary,1438.44,-25418.92
buyer_3,Ana,35,ES85209524939783321778,TRX_N-00750-58918895,2023-12-01T20:15:24,Amurrio,incomes,salary_partner,1415.8,-24003.12
buyer_3,Ana,35,ES85209524939783321778,TRX_N-00751-93135323,2023-12-01T20:15:24,Amurrio,incomes,extra_income,257.05,-23746.07
buyer_3,Ana,35,ES85209524939783321778,TRX_N-00752-74329242,2023-12-01T20:15:24,Amurrio,incomes,salary_bonus,1109.22,-22636.85
buyer_3,Ana,35,ES85209524939783321778,TRX_N-00753-66212219,2023-12-01T20:15:24,Amurrio,incomes,salary_partner_bonus,1046.43,-21590.42
buyer_3,Ana,35,ES85209524939783321778,TRX_N-00754-84451663,2023-12-01T03:05:39,Amurrio,Expense,cash,-100.0,-21690.42
buyer_3,Ana,35,ES85209524939783321778,TRX_N-00755-81688887,2023-12-02T08:28:46,Amurrio,Expense,food,-117.29,-21807.71
buyer_3,Ana,35,ES85209524939783321778,TRX_N-00756-89245551,2023-12-03T09:13:13,Amurrio,Expense,appliances,-101.79,-21909.5
buyer_3,Ana,35,ES85209524939783321778,TRX_N-00757-60008100,2023-12-04T23:23:50,Amurrio,expenses,mortgage,-912.03,-22821.53
buyer_3,Ana,35,ES85209524939783321778,TRX_N-00758-24943994,2023-12-04T11:39:36,Amurrio,Expense,transport,-89.84,-22911.37
buyer_3,Ana,35,ES85209524939783321778,TRX_N-00759-59815227,2023-12-05T11:19:07,Amurrio,expenses,electricity,-88.87,-23000.24
buyer_3,Ana,35,ES85209524939783321778,TRX_N-00760-71473862,2023-12-05T10:10:11,Amurrio,expenses,internet,-42.0,-23042.24
buyer_3,Ana,35,ES85209524939783321778,TRX_N-00761-12527808,2023-12-07T04:37:24,Amurrio,expenses,phone,-31.82,-23074.06
buyer_3,Ana,35,ES85209524939783321778,TRX_N-00762-11243170,2023-12-07T08:02:37,Amurrio,Expense,leisure,-48.57,-23122.63
buyer_3,Ana,35,ES85209524939783321778,TRX_N-00763-08814567,2023-12-08T19:06:29,Amurrio,expenses,water,-34.84,-23157.47
buyer_3,Ana,35,ES85209524939783321778,TRX_N-00764-24774770,2023-12-08T13:29:37,Amurrio,expenses,gas,-42.51,-23199.98
buyer_3,Ana,35,ES85209524939783321778,TRX_N-00765-98854822,2023-12-09T20:50:29,Bermeo,Expense,transport,-61.27,-23261.25
buyer_3,Ana,35,ES85209524939783321778,TRX_N-00766-32431649,2023-12-09T14:26:19,Amurrio,Expense,gifts,-754.55,-24015.8
buyer_3,Ana,35,ES85209524939783321778,TRX_N-00767-31614777,2023-12-10T18:34:44,Amurrio,Expense,clothing,-60.24,-24076.04
buyer_3,Ana,35,ES85209524939783321778,TRX_N-00768-63208737,2023-12-11T17:20:34,Amurrio,Expense,transport,-60.92,-24136.96
buyer_3,Ana,35,ES85209524939783321778,TRX_N-00769-45813092,2023-12-12T12:58:47,Amurrio,Expense,leisure,-31.5,-24168.46
buyer_3,Ana,35,ES85209524939783321778,TRX_N-00770-22270081,2023-12-12T11:25:26,Amurrio,Expense,repairs,-231.39,-24399.85
buyer_3,Ana,35,ES85209524939783321778,TRX_N-00771-85735741,2023-12-13T14:32:47,Amurrio,expenses,children,-87.92,-24487.77
buyer_3,Ana,35,ES85209524939783321778,TRX_N-00772-64811155,2023-12-14T03:14:11,Irun,Expense,food,-106.16,-24593.93
buyer_3,Ana,35,ES85209524939783321778,TRX_N-00773-95247836,2023-12-15T18:24:13,Amurrio,Expense,food,-90.75,-24684.68
buyer_3,Ana,35,ES85209524939783321778,TRX_N-00774-72520679,2023-12-15T08:36:15,Amurrio,Expense,repairs,-217.41,-24902.09
buyer_3,Ana,35,ES85209524939783321778,TRX_N-00775-03694746,2023-12-16T15:57:16,Amurrio,Expense,food,-92.2,-24994.29
buyer_3,Ana,35,ES85209524939783321778,TRX_N-00776-45795358,2023-12-16T10:35:16,Amurrio,Expense,clothing,-60.76,-25055.05
buyer_3,Ana,35,ES85209524939783321778,TRX_N-00777-71134124,2023-12-18T17:23:07,Amurrio,Expense,cash,-100.0,-25155.05
buyer_3,Ana,35,ES85209524939783321778,TRX_N-00778-16381071,2023-12-18T02:48:18,Amurrio,Expense,appliances,-247.88,-25402.93
buyer_3,Ana,35,ES85209524939783321778,TRX_N-00779-81959212,2023-12-19T06:14:56,Amurrio,Expense,repairs,-76.59,-25479.52
buyer_3,Ana,35,ES85209524939783321778,TRX_N-00780-81123684,2023-12-21T20:19:50,Sestao,Expense,food,-91.46,-25570.98
buyer_3,Ana,35,ES85209524939783321778,TRX_N-00781-92019048,2023-12-22T13:07:16,Arrasate,Expense,travel,-1026.36,-26597.34
buyer_3,Ana,35,ES85209524939783321778,TRX_N-00782-55564167,2023-12-24T14:32:21,Andoain,Expense,leisure,-78.83,-26676.17
buyer_3,Ana,35,ES85209524939783321778,TRX_N-00783-68786362,2023-12-24T17:27:04,Amurrio,Expense,cash,-100.0,-26776.17
buyer_3,Ana,35,ES85209524939783321778,TRX_N-00784-24279451,2023-12-25T02:44:42,Amurrio,Expense,food,-95.96,-26872.13
buyer_3,Ana,35,ES85209524939783321778,TRX_N-00785-61940246,2023-12-25T17:33:15,Durango,Expense,transport,-65.53,-26937.66
buyer_3,Ana,35,ES85209524939783321778,TRX_N-00786-72059301,2023-12-25T11:48:03,Amurrio,expenses,children,-54.51,-26992.17
buyer_3,Ana,35,ES85209524939783321778,TRX_N-00787-27726383,2023-12-27T10:04:26,Amurrio,Expense,repairs,-172.41,-27164.58
buyer_3,Ana,35,ES85209524939783321778,TRX_N-00788-73096914,2023-12-28T19:15:53,Berango,Expense,transport,-49.35,-27213.93
buyer_3,Ana,35,ES85209524939783321778,TRX_N-00789-07941275,2023-12-28T15:43:21,Amurrio,Expense,education,-71.88,-27285.81
buyer_3,Ana,35,ES85209524939783321778,TRX_N-00790-44934099,2023-12-29T15:36:06,Amurrio,Expense,leisure,-43.01,-27328.82
buyer_3,Ana,35,ES85209524939783321778,TRX_N-00791-71228531,2023-12-29T16:12:52,Amurrio,Expense,cash,-100.0,-27428.82
buyer_3,Ana,35,ES85209524939783321778,TRX_N-00792-04364785,2023-12-29T14:04:48,Amurrio,Expense,appliances,-180.64,-27609.46
buyer_3,Ana,35,ES85209524939783321778,TRX_N-00793-95420416,2023-12-31T11:56:04,Sestao,Expense,cash,-100.0,-27709.46
buyer_3,Ana,35,ES85209524939783321778,TRX_N-00794-36557315,2024-01-01T08:15:30,Amurrio,incomes,salary,1485.65,-26223.81
buyer_3,Ana,35,ES85209524939783321778,TRX_N-00795-47659165,2024-01-01T08:15:30,Amurrio,incomes,salary_partner,1462.27,-24761.54
buyer_3,Ana,35,ES85209524939783321778,TRX_N-00796-89577663,2024-01-01T12:40:01,Alegr√≠a-Dulantzi,Expense,transport,-75.59,-24837.13
buyer_3,Ana,35,ES85209524939783321778,TRX_N-00797-58996461,2024-01-01T10:40:19,Amurrio,Expense,clothing,-116.43,-24953.56
buyer_3,Ana,35,ES85209524939783321778,TRX_N-00798-14311326,2024-01-02T11:01:47,Amurrio,Expense,healthcare,-144.64,-25098.2
buyer_3,Ana,35,ES85209524939783321778,TRX_N-00799-50252462,2024-01-02T20:47:40,Amurrio,Expense,repairs,-40.94,-25139.14
buyer_3,Ana,35,ES85209524939783321778,TRX_N-00800-33604924,2024-01-03T11:26:41,Amurrio,expenses,children,-108.08,-25247.22
buyer_3,Ana,35,ES85209524939783321778,TRX_N-00801-79693971,2024-01-04T06:17:22,Amurrio,expenses,mortgage,-912.03,-26159.25
buyer_3,Ana,35,ES85209524939783321778,TRX_N-00802-28107499,2024-01-04T10:11:51,Santurtzi,Expense,appliances,-280.33,-26439.58
buyer_3,Ana,35,ES85209524939783321778,TRX_N-00803-71731875,2024-01-06T19:37:40,Amurrio,expenses,gas,-95.42,-26535.0
buyer_3,Ana,35,ES85209524939783321778,TRX_N-00804-67268796,2024-01-07T20:48:09,Amurrio,expenses,electricity,-84.62,-26619.62
buyer_3,Ana,35,ES85209524939783321778,TRX_N-00805-34867018,2024-01-07T20:37:11,Amurrio,Expense,leisure,-67.07,-26686.69
buyer_3,Ana,35,ES85209524939783321778,TRX_N-00806-14130212,2024-01-07T09:37:58,Pasaia,Expense,cash,-100.0,-26786.69
buyer_3,Ana,35,ES85209524939783321778,TRX_N-00807-29904017,2024-01-07T13:19:30,Amurrio,Expense,gifts,-596.45,-27383.14
buyer_3,Ana,35,ES85209524939783321778,TRX_N-00808-50008497,2024-01-08T07:25:15,Amurrio,expenses,water,-27.76,-27410.9
buyer_3,Ana,35,ES85209524939783321778,TRX_N-00809-21889374,2024-01-08T19:39:00,Amurrio,expenses,internet,-42.0,-27452.9
buyer_3,Ana,35,ES85209524939783321778,TRX_N-00810-05522495,2024-01-08T16:06:36,Amurrio,expenses,phone,-36.68,-27489.58
buyer_3,Ana,35,ES85209524939783321778,TRX_N-00811-68823459,2024-01-09T11:18:37,Amurrio,expenses,children,-185.36,-27674.94
buyer_3,Ana,35,ES85209524939783321778,TRX_N-00812-21778402,2024-01-10T08:10:56,Amurrio,expenses,children,-126.26,-27801.2
buyer_3,Ana,35,ES85209524939783321778,TRX_N-00813-81089131,2024-01-11T10:56:01,Amurrio,Expense,education,-72.86,-27874.06
buyer_3,Ana,35,ES85209524939783321778,TRX_N-00814-92777633,2024-01-12T07:24:20,Pasaia,Expense,leisure,-53.55,-27927.61
buyer_3,Ana,35,ES85209524939783321778,TRX_N-00815-90928500,2024-01-14T17:31:23,Amurrio,Expense,healthcare,-101.02,-28028.63
buyer_3,Ana,35,ES85209524939783321778,TRX_N-00816-16359185,2024-01-16T11:07:46,Amurrio,Expense,education,-73.84,-28102.47
buyer_3,Ana,35,ES85209524939783321778,TRX_N-00817-23138427,2024-01-17T17:12:23,Mungia,Expense,repairs,-254.8,-28357.27
buyer_3,Ana,35,ES85209524939783321778,TRX_N-00818-59326791,2024-01-21T21:44:11,Amurrio,Expense,healthcare,-106.41,-28463.68
buyer_3,Ana,35,ES85209524939783321778,TRX_N-00819-62477582,2024-01-21T12:46:26,Amurrio,Expense,cash,-100.0,-28563.68
buyer_3,Ana,35,ES85209524939783321778,TRX_N-00820-70129281,2024-01-23T12:03:51,Amurrio,Expense,leisure,-58.99,-28622.67
buyer_3,Ana,35,ES85209524939783321778,TRX_N-00821-51775656,2024-01-27T18:52:31,Oy√≥n-Oion,Expense,repairs,-36.3,-28658.97
buyer_3,Ana,35,ES85209524939783321778,TRX_N-00822-72205111,2024-01-28T01:57:06,Amurrio,Expense,food,-100.27,-28759.24
buyer_3,Ana,35,ES85209524939783321778,TRX_N-00823-70180193,2024-01-28T18:28:15,Amurrio,Expense,gifts,-707.51,-29466.75
buyer_3,Ana,35,ES85209524939783321778,TRX_N-00824-61946811,2024-01-29T11:19:43,Amurrio,Expense,leisure,-53.32,-29520.07
buyer_3,Ana,35,ES85209524939783321778,TRX_N-00825-84717040,2024-01-29T16:42:12,Amurrio,Expense,repairs,-239.63,-29759.7
buyer_3,Ana,35,ES85209524939783321778,TRX_N-00826-62834685,2024-01-30T20:56:03,Getxo,Expense,food,-90.24,-29849.94
buyer_3,Ana,35,ES85209524939783321778,TRX_N-00827-93578454,2024-01-30T09:26:11,Amurrio,Expense,gifts,-435.97,-30285.91
buyer_3,Ana,35,ES85209524939783321778,TRX_N-00828-48509471,2024-01-31T15:58:18,Amurrio,Expense,healthcare,-71.45,-30357.36
buyer_3,Ana,35,ES85209524939783321778,TRX_N-00829-24403224,2024-01-31T16:22:25,Amurrio,Expense,repairs,-205.87,-30563.23
buyer_3,Ana,35,ES85209524939783321778,TRX_N-00830-03545231,2024-02-01T17:38:25,Amurrio,incomes,salary,1485.65,-29077.58
buyer_3,Ana,35,ES85209524939783321778,TRX_N-00831-09640559,2024-02-01T17:38:25,Amurrio,incomes,salary_partner,1462.27,-27615.31
buyer_3,Ana,35,ES85209524939783321778,TRX_N-00832-65975908,2024-02-02T10:31:32,Amurrio,Expense,cash,-100.0,-27715.31
buyer_3,Ana,35,ES85209524939783321778,TRX_N-00833-46024039,2024-02-04T09:40:31,Amurrio,expenses,mortgage,-912.03,-28627.34
buyer_3,Ana,35,ES85209524939783321778,TRX_N-00834-54365622,2024-02-04T11:45:30,Amurrio,Expense,gifts,-653.32,-29280.66
buyer_3,Ana,35,ES85209524939783321778,TRX_N-00835-24185553,2024-02-05T10:25:26,Amurrio,expenses,internet,-42.0,-29322.66
buyer_3,Ana,35,ES85209524939783321778,TRX_N-00836-44772080,2024-02-05T00:58:32,Amurrio,expenses,phone,-34.38,-29357.04
buyer_3,Ana,35,ES85209524939783321778,TRX_N-00837-91562515,2024-02-05T19:30:03,Amurrio,Expense,transport,-67.26,-29424.3
buyer_3,Ana,35,ES85209524939783321778,TRX_N-00838-47369711,2024-02-06T09:20:38,Amurrio,expenses,electricity,-35.49,-29459.79
buyer_3,Ana,35,ES85209524939783321778,TRX_N-00839-68190711,2024-02-06T06:10:23,Amurrio,Expense,gifts,-212.19,-29671.98
buyer_3,Ana,35,ES85209524939783321778,TRX_N-00840-53636962,2024-02-08T09:12:15,Amurrio,expenses,water,-40.84,-29712.82
buyer_3,Ana,35,ES85209524939783321778,TRX_N-00841-96110957,2024-02-08T12:36:37,Amurrio,expenses,gas,-67.74,-29780.56
buyer_3,Ana,35,ES85209524939783321778,TRX_N-00842-17485104,2024-02-08T23:39:47,Amurrio,Expense,clothing,-111.72,-29892.28
buyer_3,Ana,35,ES85209524939783321778,TRX_N-00843-76396462,2024-02-08T21:28:21,Amurrio,Expense,education,-73.54,-29965.82
buyer_3,Ana,35,ES85209524939783321778,TRX_N-00844-31602301,2024-02-11T12:30:09,Getxo,Expense,cash,-100.0,-30065.82
buyer_3,Ana,35,ES85209524939783321778,TRX_N-00845-35220503,2024-02-12T18:27:44,Amurrio,Expense,food,-68.76,-30134.58
buyer_3,Ana,35,ES85209524939783321778,TRX_N-00846-12126328,2024-02-12T19:37:53,Amurrio,Expense,transport,-49.8,-30184.38
buyer_3,Ana,35,ES85209524939783321778,TRX_N-00847-39209882,2024-02-12T21:09:23,Amurrio,Expense,cash,-100.0,-30284.38
buyer_3,Ana,35,ES85209524939783321778,TRX_N-00848-59522184,2024-02-13T17:24:06,Amurrio,Expense,food,-92.53,-30376.91
buyer_3,Ana,35,ES85209524939783321778,TRX_N-00849-27365495,2024-02-14T18:40:01,Amurrio,Expense,cash,-100.0,-30476.91
buyer_3,Ana,35,ES85209524939783321778,TRX_N-00850-82880857,2024-02-14T14:53:08,Amurrio,Expense,repairs,-33.98,-30510.89
buyer_3,Ana,35,ES85209524939783321778,TRX_N-00851-16592604,2024-02-15T16:40:26,Amurrio,Expense,leisure,-54.83,-30565.72
buyer_3,Ana,35,ES85209524939783321778,TRX_N-00852-20561773,2024-02-15T08:28:15,Amurrio,Expense,cash,-100.0,-30665.72
buyer_3,Ana,35,ES85209524939783321778,TRX_N-00853-39475324,2024-02-16T14:58:21,Donostia,Expense,repairs,-104.71,-30770.43
buyer_3,Ana,35,ES85209524939783321778,TRX_N-00854-98716874,2024-02-19T13:09:54,Amurrio,Expense,food,-118.16,-30888.59
buyer_3,Ana,35,ES85209524939783321778,TRX_N-00855-94666098,2024-02-19T13:31:52,Amurrio,Expense,transport,-77.01,-30965.6
buyer_3,Ana,35,ES85209524939783321778,TRX_N-00856-94554587,2024-02-19T08:05:10,Amurrio,Expense,cash,-100.0,-31065.6
buyer_3,Ana,35,ES85209524939783321778,TRX_N-00857-01005582,2024-02-20T16:03:40,Amurrio,Expense,leisure,-45.34,-31110.94
buyer_3,Ana,35,ES85209524939783321778,TRX_N-00858-55318426,2024-02-21T23:37:11,Amurrio,Expense,gifts,-519.54,-31630.48
buyer_3,Ana,35,ES85209524939783321778,TRX_N-00859-29745555,2024-02-23T12:52:13,Amurrio,Expense,leisure,-72.29,-31702.77
buyer_3,Ana,35,ES85209524939783321778,TRX_N-00860-17647590,2024-02-26T16:56:27,Amurrio,Expense,food,-72.92,-31775.69
buyer_3,Ana,35,ES85209524939783321778,TRX_N-00861-51926946,2024-02-26T12:44:44,Amurrio,Expense,leisure,-41.01,-31816.7
buyer_3,Ana,35,ES85209524939783321778,TRX_N-00862-57167860,2024-02-26T17:46:33,Amurrio,Expense,appliances,-130.91,-31947.61
buyer_3,Ana,35,ES85209524939783321778,TRX_N-00863-74868311,2024-02-26T20:06:59,Amurrio,Expense,gifts,-584.52,-32532.13
buyer_3,Ana,35,ES85209524939783321778,TRX_N-00864-04441470,2024-02-27T11:58:09,Amurrio,Expense,food,-114.72,-32646.85
buyer_3,Ana,35,ES85209524939783321778,TRX_N-00865-67927134,2024-02-28T20:11:10,Amurrio,Expense,transport,-65.63,-32712.48
buyer_3,Ana,35,ES85209524939783321778,TRX_N-00866-22359115,2024-02-28T09:08:23,Mungia,Expense,clothing,-121.89,-32834.37
buyer_3,Ana,35,ES85209524939783321778,TRX_N-00867-50076027,2024-02-28T10:44:25,Amurrio,Expense,cash,-100.0,-32934.37
buyer_3,Ana,35,ES85209524939783321778,TRX_N-00868-31789730,2024-02-28T12:02:08,Salvatierra/Agurain,Expense,appliances,-375.57,-33309.94
buyer_3,Ana,35,ES85209524939783321778,TRX_N-00869-43604493,2024-02-29T18:08:00,Amurrio,Expense,clothing,-115.61,-33425.55
buyer_3,Ana,35,ES85209524939783321778,TRX_N-00870-49515575,2024-02-29T09:05:53,Amurrio,Expense,cash,-100.0,-33525.55
buyer_3,Ana,35,ES85209524939783321778,TRX_N-00871-93539000,2024-03-01T08:25:16,Amurrio,incomes,salary,1485.65,-32039.9
buyer_3,Ana,35,ES85209524939783321778,TRX_N-00872-83661358,2024-03-01T08:25:16,Amurrio,incomes,salary_partner,1462.27,-30577.63
buyer_3,Ana,35,ES85209524939783321778,TRX_N-00873-44238969,2024-03-01T15:34:00,Getxo,Expense,leisure,-66.46,-30644.09
buyer_3,Ana,35,ES85209524939783321778,TRX_N-00874-57147028,2024-03-01T19:00:59,Amurrio,Expense,cash,-100.0,-30744.09
buyer_3,Ana,35,ES85209524939783321778,TRX_N-00875-59446860,2024-03-02T13:03:00,Vitoria-Gasteiz,Expense,travel,-710.44,-31454.53
buyer_3,Ana,35,ES85209524939783321778,TRX_N-00876-02969936,2024-03-03T23:27:47,Amurrio,Expense,food,-93.26,-31547.79
buyer_3,Ana,35,ES85209524939783321778,TRX_N-00877-42527046,2024-03-04T15:30:12,Amurrio,expenses,mortgage,-912.03,-32459.82
buyer_3,Ana,35,ES85209524939783321778,TRX_N-00878-54366013,2024-03-05T18:58:50,Amurrio,expenses,phone,-34.5,-32494.32
buyer_3,Ana,35,ES85209524939783321778,TRX_N-00879-14702052,2024-03-06T19:39:00,Amurrio,Expense,food,-79.74,-32574.06
buyer_3,Ana,35,ES85209524939783321778,TRX_N-00880-15112938,2024-03-06T12:03:30,Amurrio,Expense,transport,-50.9,-32624.96
buyer_3,Ana,35,ES85209524939783321778,TRX_N-00881-30812154,2024-03-06T14:15:26,Amurrio,Expense,leisure,-51.99,-32676.95
buyer_3,Ana,35,ES85209524939783321778,TRX_N-00882-04308270,2024-03-08T11:05:00,Amurrio,expenses,electricity,-74.27,-32751.22
buyer_3,Ana,35,ES85209524939783321778,TRX_N-00883-88003642,2024-03-08T11:11:07,Amurrio,expenses,gas,-64.32,-32815.54
buyer_3,Ana,35,ES85209524939783321778,TRX_N-00884-14415143,2024-03-08T10:59:02,Amurrio,expenses,water,-20.37,-32835.91
buyer_3,Ana,35,ES85209524939783321778,TRX_N-00885-39118813,2024-03-08T16:26:34,Amurrio,expenses,internet,-42.0,-32877.91
buyer_3,Ana,35,ES85209524939783321778,TRX_N-00886-48532438,2024-03-08T11:26:13,Amurrio,Expense,food,-87.37,-32965.28
buyer_3,Ana,35,ES85209524939783321778,TRX_N-00887-38856300,2024-03-08T17:34:07,Amurrio,Expense,leisure,-56.36,-33021.64
buyer_3,Ana,35,ES85209524939783321778,TRX_N-00888-16339077,2024-03-08T21:13:50,Amurrio,Expense,gifts,-709.82,-33731.46
buyer_3,Ana,35,ES85209524939783321778,TRX_N-00889-61004464,2024-03-10T13:27:55,Zarautz,Expense,cash,-100.0,-33831.46
buyer_3,Ana,35,ES85209524939783321778,TRX_N-00890-94695392,2024-03-12T20:33:26,Amurrio,expenses,children,-54.35,-33885.81
buyer_3,Ana,35,ES85209524939783321778,TRX_N-00891-84371102,2024-03-14T18:25:10,Amurrio,Expense,leisure,-64.01,-33949.82
buyer_3,Ana,35,ES85209524939783321778,TRX_N-00892-15256667,2024-03-15T04:16:56,Amurrio,Expense,cash,-100.0,-34049.82
buyer_3,Ana,35,ES85209524939783321778,TRX_N-00893-51418226,2024-03-17T17:40:13,Amurrio,Expense,food,-106.11,-34155.93
buyer_3,Ana,35,ES85209524939783321778,TRX_N-00894-49553776,2024-03-17T13:42:40,Amurrio,Expense,gifts,-529.72,-34685.65
buyer_3,Ana,35,ES85209524939783321778,TRX_N-00895-97861055,2024-03-18T10:52:56,Amurrio,Expense,cash,-100.0,-34785.65
buyer_3,Ana,35,ES85209524939783321778,TRX_N-00896-61722042,2024-03-19T20:27:24,Amurrio,Expense,food,-75.54,-34861.19
buyer_3,Ana,35,ES85209524939783321778,TRX_N-00897-23298104,2024-03-19T15:06:49,Amurrio,Expense,leisure,-55.95,-34917.14
buyer_3,Ana,35,ES85209524939783321778,TRX_N-00898-78811939,2024-03-21T09:44:10,Amurrio,Expense,repairs,-122.26,-35039.4
buyer_3,Ana,35,ES85209524939783321778,TRX_N-00899-66294475,2024-03-22T12:55:38,Amurrio,Expense,transport,-53.81,-35093.21
buyer_3,Ana,35,ES85209524939783321778,TRX_N-00900-06636394,2024-03-23T15:08:54,Amurrio,Expense,gifts,-837.8,-35931.01
buyer_3,Ana,35,ES85209524939783321778,TRX_N-00901-47813801,2024-03-24T18:11:32,Amurrio,Expense,food,-99.18,-36030.19
buyer_3,Ana,35,ES85209524939783321778,TRX_N-00902-30936119,2024-03-24T12:25:52,Amurrio,Expense,repairs,-39.23,-36069.42
buyer_3,Ana,35,ES85209524939783321778,TRX_N-00903-80700730,2024-03-26T23:20:54,Amurrio,Expense,healthcare,-82.91,-36152.33
buyer_3,Ana,35,ES85209524939783321778,TRX_N-00904-76675605,2024-03-28T13:01:43,Amurrio,Expense,repairs,-143.66,-36295.99
buyer_3,Ana,35,ES85209524939783321778,TRX_N-00905-23363834,2024-03-29T10:20:03,Sopela,Expense,food,-97.75,-36393.74
buyer_3,Ana,35,ES85209524939783321778,TRX_N-00906-50644750,2024-03-30T22:28:10,Amurrio,Expense,gifts,-143.17,-36536.91
buyer_3,Ana,35,ES85209524939783321778,TRX_N-00907-99873018,2024-04-01T13:22:29,Amurrio,incomes,salary,1485.65,-35051.26
buyer_3,Ana,35,ES85209524939783321778,TRX_N-00908-86417317,2024-04-01T13:22:29,Amurrio,incomes,salary_partner,1462.27,-33588.99
buyer_3,Ana,35,ES85209524939783321778,TRX_N-00909-16007945,2024-04-01T13:22:29,Amurrio,incomes,extra_income,257.05,-33331.94
buyer_3,Ana,35,ES85209524939783321778,TRX_N-00910-89762611,2024-04-01T10:26:25,Amurrio,Expense,leisure,-32.99,-33364.93
buyer_3,Ana,35,ES85209524939783321778,TRX_N-00911-69032518,2024-04-02T01:34:10,Amurrio,Expense,food,-67.65,-33432.58
buyer_3,Ana,35,ES85209524939783321778,TRX_N-00912-18174450,2024-04-04T09:38:14,Amurrio,expenses,mortgage,-912.03,-34344.61
buyer_3,Ana,35,ES85209524939783321778,TRX_N-00913-77617170,2024-04-04T08:36:12,Barakaldo,Expense,food,-65.55,-34410.16
buyer_3,Ana,35,ES85209524939783321778,TRX_N-00914-35894692,2024-04-04T08:43:20,Lasarte-Oria,Expense,leisure,-57.13,-34467.29
buyer_3,Ana,35,ES85209524939783321778,TRX_N-00915-03566930,2024-04-04T10:55:47,Amurrio,Expense,cash,-100.0,-34567.29
buyer_3,Ana,35,ES85209524939783321778,TRX_N-00916-31422268,2024-04-05T09:38:14,Amurrio,expenses,water,-39.36,-34606.65
buyer_3,Ana,35,ES85209524939783321778,TRX_N-00917-12896531,2024-04-06T18:55:12,Amurrio,Expense,leisure,-18.48,-34625.13
buyer_3,Ana,35,ES85209524939783321778,TRX_N-00918-31020149,2024-04-06T21:36:33,Portugalete,Expense,appliances,-175.04,-34800.17
buyer_3,Ana,35,ES85209524939783321778,TRX_N-00919-99575067,2024-04-07T16:19:48,Amurrio,expenses,internet,-42.0,-34842.17
buyer_3,Ana,35,ES85209524939783321778,TRX_N-00920-66574712,2024-04-08T13:15:05,Amurrio,expenses,phone,-34.53,-34876.7
buyer_3,Ana,35,ES85209524939783321778,TRX_N-00921-18084870,2024-04-08T15:41:25,Amurrio,expenses,electricity,-40.93,-34917.63
buyer_3,Ana,35,ES85209524939783321778,TRX_N-00922-43989863,2024-04-08T10:04:15,Amurrio,expenses,gas,-82.43,-35000.06
buyer_3,Ana,35,ES85209524939783321778,TRX_N-00923-63978143,2024-04-08T12:47:36,Amurrio,expenses,children,-133.09,-35133.15
buyer_3,Ana,35,ES85209524939783321778,TRX_N-00924-61990207,2024-04-09T18:16:19,Amurrio,Expense,transport,-73.52,-35206.67
buyer_3,Ana,35,ES85209524939783321778,TRX_N-00925-31876416,2024-04-10T12:28:33,Amurrio,Expense,food,-100.61,-35307.28
buyer_3,Ana,35,ES85209524939783321778,TRX_N-00926-66077558,2024-04-12T19:01:16,Amurrio,Expense,food,-74.92,-35382.2
buyer_3,Ana,35,ES85209524939783321778,TRX_N-00927-88084736,2024-04-12T10:21:10,Barakaldo,Expense,cash,-100.0,-35482.2
buyer_3,Ana,35,ES85209524939783321778,TRX_N-00928-06791031,2024-04-13T12:54:28,Amurrio,Expense,transport,-83.49,-35565.69
buyer_3,Ana,35,ES85209524939783321778,TRX_N-00929-40523108,2024-04-14T12:57:37,Amurrio,Expense,repairs,-171.55,-35737.24
buyer_3,Ana,35,ES85209524939783321778,TRX_N-00930-92106781,2024-04-14T16:45:31,Basauri,Expense,gifts,-286.61,-36023.85
buyer_3,Ana,35,ES85209524939783321778,TRX_N-00931-90933028,2024-04-15T00:29:04,Amurrio,Expense,transport,-64.31,-36088.16
buyer_3,Ana,35,ES85209524939783321778,TRX_N-00932-08091108,2024-04-15T17:04:16,Amurrio,Expense,cash,-100.0,-36188.16
buyer_3,Ana,35,ES85209524939783321778,TRX_N-00933-04993858,2024-04-15T06:49:01,Amurrio,Expense,repairs,-282.87,-36471.03
buyer_3,Ana,35,ES85209524939783321778,TRX_N-00934-12000552,2024-04-16T16:23:57,Amurrio,Expense,leisure,-66.34,-36537.37
buyer_3,Ana,35,ES85209524939783321778,TRX_N-00935-70137135,2024-04-16T23:15:19,Amurrio,Expense,gifts,-541.97,-37079.34
buyer_3,Ana,35,ES85209524939783321778,TRX_N-00936-28976762,2024-04-17T12:04:22,Amurrio,Expense,leisure,-47.94,-37127.28
buyer_3,Ana,35,ES85209524939783321778,TRX_N-00937-23815160,2024-04-19T10:46:07,Amurrio,Expense,cash,-100.0,-37227.28
buyer_3,Ana,35,ES85209524939783321778,TRX_N-00938-21704836,2024-04-20T12:03:26,Amurrio,Expense,food,-68.62,-37295.9
buyer_3,Ana,35,ES85209524939783321778,TRX_N-00939-56271937,2024-04-21T06:34:44,Amurrio,Expense,education,-44.11,-37340.01
buyer_3,Ana,35,ES85209524939783321778,TRX_N-00940-00944349,2024-04-21T10:09:13,Amurrio,Expense,repairs,-110.28,-37450.29
buyer_3,Ana,35,ES85209524939783321778,TRX_N-00941-55207783,2024-04-24T22:53:45,Amurrio,Expense,food,-83.4,-37533.69
buyer_3,Ana,35,ES85209524939783321778,TRX_N-00942-43926065,2024-04-25T13:00:44,Amurrio,Expense,clothing,-54.18,-37587.87
buyer_3,Ana,35,ES85209524939783321778,TRX_N-00943-04616369,2024-04-25T09:37:40,Bermeo,Expense,cash,-100.0,-37687.87
buyer_3,Ana,35,ES85209524939783321778,TRX_N-00944-15711388,2024-04-28T17:35:20,Amurrio,Expense,food,-124.87,-37812.74
buyer_3,Ana,35,ES85209524939783321778,TRX_N-00945-46108559,2024-04-30T09:41:49,Oy√≥n-Oion,Expense,cash,-100.0,-37912.74
buyer_3,Ana,35,ES85209524939783321778,TRX_N-00946-90955107,2024-04-30T11:29:48,Amurrio,Expense,repairs,-331.13,-38243.87
buyer_3,Ana,35,ES85209524939783321778,TRX_N-00947-02861012,2024-05-01T08:29:30,Amurrio,incomes,salary,1485.65,-36758.22
buyer_3,Ana,35,ES85209524939783321778,TRX_N-00948-82032235,2024-05-01T08:29:30,Amurrio,incomes,salary_partner,1462.27,-35295.95
buyer_3,Ana,35,ES85209524939783321778,TRX_N-00949-17757123,2024-05-02T14:21:21,Getxo,Expense,cash,-100.0,-35395.95
buyer_3,Ana,35,ES85209524939783321778,TRX_N-00950-40061212,2024-05-03T20:11:27,Amurrio,Expense,cash,-100.0,-35495.95
buyer_3,Ana,35,ES85209524939783321778,TRX_N-00951-07278999,2024-05-04T17:14:14,Amurrio,expenses,mortgage,-912.03,-36407.98
buyer_3,Ana,35,ES85209524939783321778,TRX_N-00952-89409157,2024-05-04T20:06:57,Amurrio,Expense,transport,-56.11,-36464.09
buyer_3,Ana,35,ES85209524939783321778,TRX_N-00953-06291078,2024-05-04T13:38:13,Amurrio,Expense,repairs,-163.88,-36627.97
buyer_3,Ana,35,ES85209524939783321778,TRX_N-00954-17253302,2024-05-05T13:11:11,Amurrio,expenses,gas,-90.11,-36718.08
buyer_3,Ana,35,ES85209524939783321778,TRX_N-00955-75417996,2024-05-05T15:18:46,Amurrio,expenses,phone,-31.72,-36749.8
buyer_3,Ana,35,ES85209524939783321778,TRX_N-00956-37929597,2024-05-05T08:00:35,Donostia,Expense,transport,-64.85,-36814.65
buyer_3,Ana,35,ES85209524939783321778,TRX_N-00957-70073482,2024-05-07T23:19:46,Amurrio,expenses,internet,-42.0,-36856.65
buyer_3,Ana,35,ES85209524939783321778,TRX_N-00958-56891480,2024-05-07T11:28:23,Amurrio,Expense,transport,-86.09,-36942.74
buyer_3,Ana,35,ES85209524939783321778,TRX_N-00959-29344142,2024-05-08T15:27:28,Amurrio,expenses,water,-30.69,-36973.43
buyer_3,Ana,35,ES85209524939783321778,TRX_N-00960-61246348,2024-05-08T22:30:28,Amurrio,expenses,electricity,-49.74,-37023.17
buyer_3,Ana,35,ES85209524939783321778,TRX_N-00961-38450598,2024-05-08T06:28:43,Amurrio,Expense,food,-65.95,-37089.12
buyer_3,Ana,35,ES85209524939783321778,TRX_N-00962-96577930,2024-05-08T19:46:23,Amurrio,Expense,repairs,-114.89,-37204.01
buyer_3,Ana,35,ES85209524939783321778,TRX_N-00963-64959872,2024-05-09T13:27:54,Amurrio,Expense,gifts,-425.16,-37629.17
buyer_3,Ana,35,ES85209524939783321778,TRX_N-00964-89884510,2024-05-10T10:11:16,Amurrio,Expense,appliances,-240.23,-37869.4
buyer_3,Ana,35,ES85209524939783321778,TRX_N-00965-32813311,2024-05-15T08:13:44,Amurrio,Expense,travel,-1266.77,-39136.17
buyer_3,Ana,35,ES85209524939783321778,TRX_N-00966-88288188,2024-05-15T09:39:17,Amurrio,Expense,repairs,-217.49,-39353.66
buyer_3,Ana,35,ES85209524939783321778,TRX_N-00967-54129918,2024-05-15T23:37:19,Amurrio,Expense,gifts,-70.58,-39424.24
buyer_3,Ana,35,ES85209524939783321778,TRX_N-00968-81613865,2024-05-18T06:48:36,Amurrio,Expense,transport,-40.48,-39464.72
buyer_3,Ana,35,ES85209524939783321778,TRX_N-00969-11670956,2024-05-19T13:47:05,Bilbao,Expense,food,-115.46,-39580.18
buyer_3,Ana,35,ES85209524939783321778,TRX_N-00970-29444943,2024-05-20T12:44:15,Elciego,Expense,clothing,-121.33,-39701.51
buyer_3,Ana,35,ES85209524939783321778,TRX_N-00971-58578888,2024-05-20T18:46:10,Amurrio,Expense,cash,-100.0,-39801.51
buyer_3,Ana,35,ES85209524939783321778,TRX_N-00972-20968032,2024-05-21T12:28:32,Amurrio,Expense,leisure,-36.89,-39838.4
buyer_3,Ana,35,ES85209524939783321778,TRX_N-00973-99126777,2024-05-21T20:08:22,Sestao,Expense,repairs,-305.01,-40143.41
buyer_3,Ana,35,ES85209524939783321778,TRX_N-00974-71680334,2024-05-24T13:51:23,Amurrio,Expense,food,-109.19,-40252.6
buyer_3,Ana,35,ES85209524939783321778,TRX_N-00975-29577045,2024-05-27T16:10:50,Zuia,Expense,food,-67.93,-40320.53
buyer_3,Ana,35,ES85209524939783321778,TRX_N-00976-44114945,2024-05-27T15:00:55,Amurrio,Expense,repairs,-306.67,-40627.2
buyer_3,Ana,35,ES85209524939783321778,TRX_N-00977-67513304,2024-05-28T08:40:50,Amurrio,Expense,cash,-100.0,-40727.2
buyer_3,Ana,35,ES85209524939783321778,TRX_N-00978-80016913,2024-06-01T08:43:59,Amurrio,incomes,salary,1485.65,-39241.55
buyer_3,Ana,35,ES85209524939783321778,TRX_N-00979-96676889,2024-06-01T08:43:59,Amurrio,incomes,salary_partner,1462.27,-37779.28
buyer_3,Ana,35,ES85209524939783321778,TRX_N-00980-31429026,2024-06-01T08:43:59,Amurrio,incomes,salary_bonus,1058.42,-36720.86
buyer_3,Ana,35,ES85209524939783321778,TRX_N-00981-92971372,2024-06-01T08:43:59,Amurrio,incomes,salary_partner_bonus,1054.33,-35666.53
buyer_3,Ana,35,ES85209524939783321778,TRX_N-00982-98343198,2024-06-03T19:09:08,Amurrio,Expense,food,-119.79,-35786.32
buyer_3,Ana,35,ES85209524939783321778,TRX_N-00983-48391665,2024-06-03T10:17:49,Amurrio,Expense,healthcare,-162.43,-35948.75
buyer_3,Ana,35,ES85209524939783321778,TRX_N-00984-37128088,2024-06-04T12:46:04,Amurrio,expenses,mortgage,-912.03,-36860.78
buyer_3,Ana,35,ES85209524939783321778,TRX_N-00985-18866678,2024-06-04T12:37:18,Amurrio,Expense,cash,-100.0,-36960.78
buyer_3,Ana,35,ES85209524939783321778,TRX_N-00986-90363895,2024-06-05T20:04:39,Amurrio,expenses,phone,-42.66,-37003.44
buyer_3,Ana,35,ES85209524939783321778,TRX_N-00987-54618673,2024-06-05T15:50:19,Amurrio,Expense,transport,-72.85,-37076.29
buyer_3,Ana,35,ES85209524939783321778,TRX_N-00988-35129947,2024-06-06T15:48:27,Amurrio,expenses,gas,-45.71,-37122.0
buyer_3,Ana,35,ES85209524939783321778,TRX_N-00989-97327845,2024-06-06T17:24:05,Sopela,Expense,transport,-47.17,-37169.17
buyer_3,Ana,35,ES85209524939783321778,TRX_N-00990-60475650,2024-06-06T21:34:09,Salvatierra/Agurain,Expense,clothing,-57.79,-37226.96
buyer_3,Ana,35,ES85209524939783321778,TRX_N-00991-87503548,2024-06-07T15:01:56,Amurrio,expenses,water,-42.83,-37269.79
buyer_3,Ana,35,ES85209524939783321778,TRX_N-00992-40412445,2024-06-07T18:57:32,Amurrio,expenses,internet,-42.0,-37311.79
buyer_3,Ana,35,ES85209524939783321778,TRX_N-00993-97326054,2024-06-07T20:11:24,Amurrio,expenses,children,-154.5,-37466.29
buyer_3,Ana,35,ES85209524939783321778,TRX_N-00994-85566717,2024-06-08T23:45:23,Amurrio,expenses,electricity,-22.95,-37489.24
buyer_3,Ana,35,ES85209524939783321778,TRX_N-00995-36420465,2024-06-09T08:20:54,Amurrio,Expense,transport,-66.98,-37556.22
buyer_3,Ana,35,ES85209524939783321778,TRX_N-00996-67385196,2024-06-10T17:42:03,Amurrio,Expense,gifts,-524.61,-38080.83
buyer_3,Ana,35,ES85209524939783321778,TRX_N-00997-90956193,2024-06-11T19:44:21,Portugalete,Expense,cash,-100.0,-38180.83
buyer_3,Ana,35,ES85209524939783321778,TRX_N-00998-20510343,2024-06-13T16:44:36,Amurrio,expenses,children,-76.39,-38257.22
buyer_3,Ana,35,ES85209524939783321778,TRX_N-00999-62635762,2024-06-14T16:42:25,Oy√≥n-Oion,Expense,food,-63.63,-38320.85
buyer_3,Ana,35,ES85209524939783321778,TRX_N-01000-62705837,2024-06-15T11:00:05,Amurrio,Expense,clothing,-78.98,-38399.83
buyer_3,Ana,35,ES85209524939783321778,TRX_N-01001-66330415,2024-06-16T00:15:42,Hondarribia,Expense,food,-93.76,-38493.59
buyer_3,Ana,35,ES85209524939783321778,TRX_N-01002-97638522,2024-06-17T11:00:23,Amurrio,Expense,leisure,-79.48,-38573.07
buyer_3,Ana,35,ES85209524939783321778,TRX_N-01003-06368065,2024-06-18T09:55:09,Amurrio,Expense,cash,-100.0,-38673.07
buyer_3,Ana,35,ES85209524939783321778,TRX_N-01004-84093998,2024-06-19T22:40:54,Amurrio,Expense,transport,-55.41,-38728.48
buyer_3,Ana,35,ES85209524939783321778,TRX_N-01005-52694797,2024-06-19T09:18:59,Amurrio,Expense,cash,-100.0,-38828.48
buyer_3,Ana,35,ES85209524939783321778,TRX_N-01006-23442211,2024-06-21T14:18:40,Arrasate,Expense,cash,-100.0,-38928.48
buyer_3,Ana,35,ES85209524939783321778,TRX_N-01007-92824872,2024-06-22T12:43:48,Amurrio,Expense,gifts,-774.73,-39703.21
buyer_3,Ana,35,ES85209524939783321778,TRX_N-01008-59174970,2024-06-24T17:33:13,Amurrio,Expense,cash,-100.0,-39803.21
buyer_3,Ana,35,ES85209524939783321778,TRX_N-01009-02151586,2024-06-24T19:40:40,Amurrio,expenses,children,-111.61,-39914.82
buyer_3,Ana,35,ES85209524939783321778,TRX_N-01010-19146970,2024-06-27T12:39:29,Amurrio,Expense,cash,-100.0,-40014.82
buyer_3,Ana,35,ES85209524939783321778,TRX_N-01011-44499371,2024-06-28T19:21:10,Amurrio,Expense,leisure,-76.85,-40091.67
buyer_3,Ana,35,ES85209524939783321778,TRX_N-01012-31649699,2024-06-29T19:23:37,Amurrio,Expense,leisure,-83.41,-40175.08
buyer_3,Ana,35,ES85209524939783321778,TRX_N-01013-65682575,2024-07-01T11:09:36,Amurrio,incomes,salary,1485.65,-38689.43
buyer_3,Ana,35,ES85209524939783321778,TRX_N-01014-57920379,2024-07-01T11:09:36,Amurrio,incomes,salary_partner,1462.27,-37227.16
buyer_3,Ana,35,ES85209524939783321778,TRX_N-01015-41051397,2024-07-01T11:09:36,Amurrio,incomes,extra_income,257.05,-36970.11
buyer_3,Ana,35,ES85209524939783321778,TRX_N-01016-56728123,2024-07-01T02:19:26,Amurrio,Expense,leisure,-72.86,-37042.97
buyer_3,Ana,35,ES85209524939783321778,TRX_N-01017-86802895,2024-07-01T20:43:45,Amurrio,Expense,education,-75.08,-37118.05
buyer_3,Ana,35,ES85209524939783321778,TRX_N-01018-90097076,2024-07-01T09:57:46,Amurrio,Expense,repairs,-179.53,-37297.58
buyer_3,Ana,35,ES85209524939783321778,TRX_N-01019-89325914,2024-07-02T18:58:10,Amurrio,Expense,leisure,-44.64,-37342.22
buyer_3,Ana,35,ES85209524939783321778,TRX_N-01020-44059407,2024-07-02T22:07:57,Amurrio,Expense,repairs,-273.33,-37615.55
buyer_3,Ana,35,ES85209524939783321778,TRX_N-01021-35563691,2024-07-02T13:00:36,Amurrio,expenses,children,-157.33,-37772.88
buyer_3,Ana,35,ES85209524939783321778,TRX_N-01022-89827348,2024-07-04T22:19:28,Amurrio,expenses,mortgage,-912.03,-38684.91
buyer_3,Ana,35,ES85209524939783321778,TRX_N-01023-78487796,2024-07-04T11:18:51,Amurrio,Expense,clothing,-74.27,-38759.18
buyer_3,Ana,35,ES85209524939783321778,TRX_N-01024-83360820,2024-07-05T15:35:16,Amurrio,expenses,electricity,-87.28,-38846.46
buyer_3,Ana,35,ES85209524939783321778,TRX_N-01025-64645231,2024-07-05T20:15:28,Mungia,Expense,leisure,-74.82,-38921.28
buyer_3,Ana,35,ES85209524939783321778,TRX_N-01026-37490437,2024-07-05T15:32:51,Amurrio,Expense,cash,-100.0,-39021.28
buyer_3,Ana,35,ES85209524939783321778,TRX_N-01027-52636829,2024-07-05T09:36:33,Amurrio,Expense,repairs,-156.59,-39177.87
buyer_3,Ana,35,ES85209524939783321778,TRX_N-01028-18770471,2024-07-06T11:12:07,Amurrio,expenses,water,-31.58,-39209.45
buyer_3,Ana,35,ES85209524939783321778,TRX_N-01029-49890409,2024-07-06T19:00:46,Amurrio,expenses,gas,-58.79,-39268.24
buyer_3,Ana,35,ES85209524939783321778,TRX_N-01030-57385825,2024-07-06T09:47:09,Amurrio,expenses,internet,-42.0,-39310.24
buyer_3,Ana,35,ES85209524939783321778,TRX_N-01031-11682453,2024-07-06T14:33:39,Amurrio,Expense,leisure,-52.73,-39362.97
buyer_3,Ana,35,ES85209524939783321778,TRX_N-01032-87567046,2024-07-07T14:22:47,Amurrio,Expense,cash,-100.0,-39462.97
buyer_3,Ana,35,ES85209524939783321778,TRX_N-01033-94613468,2024-07-08T13:24:43,Amurrio,expenses,phone,-44.49,-39507.46
buyer_3,Ana,35,ES85209524939783321778,TRX_N-01034-99969814,2024-07-08T10:10:45,Amurrio,Expense,cash,-100.0,-39607.46
buyer_3,Ana,35,ES85209524939783321778,TRX_N-01035-02584065,2024-07-10T13:21:05,Barakaldo,Expense,education,-65.2,-39672.66
buyer_3,Ana,35,ES85209524939783321778,TRX_N-01036-13477586,2024-07-12T19:49:10,Amurrio,Expense,healthcare,-49.27,-39721.93
buyer_3,Ana,35,ES85209524939783321778,TRX_N-01037-88939068,2024-07-15T22:02:07,Amurrio,Expense,education,-60.67,-39782.6
buyer_3,Ana,35,ES85209524939783321778,TRX_N-01038-40878957,2024-07-16T16:57:45,Amurrio,Expense,transport,-62.35,-39844.95
buyer_3,Ana,35,ES85209524939783321778,TRX_N-01039-81101907,2024-07-18T19:04:41,Amurrio,Expense,food,-71.17,-39916.12
buyer_3,Ana,35,ES85209524939783321778,TRX_N-01040-48599831,2024-07-18T15:14:51,Amurrio,Expense,leisure,-23.42,-39939.54
buyer_3,Ana,35,ES85209524939783321778,TRX_N-01041-25699921,2024-07-20T21:56:13,Pasaia,Expense,cash,-100.0,-40039.54
buyer_3,Ana,35,ES85209524939783321778,TRX_N-01042-80736670,2024-07-22T18:29:24,Amurrio,Expense,cash,-100.0,-40139.54
buyer_3,Ana,35,ES85209524939783321778,TRX_N-01043-61586722,2024-07-23T18:19:28,Amurrio,Expense,food,-118.97,-40258.51
buyer_3,Ana,35,ES85209524939783321778,TRX_N-01044-78038197,2024-07-25T07:44:30,Amurrio,Expense,repairs,-113.32,-40371.83
buyer_3,Ana,35,ES85209524939783321778,TRX_N-01045-67181762,2024-07-26T10:53:54,Amurrio,Expense,cash,-100.0,-40471.83
buyer_3,Ana,35,ES85209524939783321778,TRX_N-01046-49898983,2024-07-27T17:00:30,Amurrio,Expense,leisure,-55.76,-40527.59
buyer_3,Ana,35,ES85209524939783321778,TRX_N-01047-98913443,2024-07-27T14:26:45,Llodio,Expense,clothing,-78.98,-40606.57
buyer_3,Ana,35,ES85209524939783321778,TRX_N-01048-59448866,2024-07-30T17:24:20,Amurrio,Expense,food,-106.12,-40712.69
buyer_3,Ana,35,ES85209524939783321778,TRX_N-01049-88263575,2024-07-31T08:10:38,Amurrio,Expense,cash,-100.0,-40812.69
buyer_3,Ana,35,ES85209524939783321778,TRX_N-01050-06987874,2024-08-01T20:14:04,Amurrio,incomes,salary,1485.65,-39327.04
buyer_3,Ana,35,ES85209524939783321778,TRX_N-01051-41195268,2024-08-01T20:14:04,Amurrio,incomes,salary_partner,1462.27,-37864.77
buyer_3,Ana,35,ES85209524939783321778,TRX_N-01052-00133755,2024-08-01T22:15:19,Amurrio,Expense,food,-82.51,-37947.28
buyer_3,Ana,35,ES85209524939783321778,TRX_N-01053-14935235,2024-08-04T23:24:10,Amurrio,expenses,mortgage,-912.03,-38859.31
buyer_3,Ana,35,ES85209524939783321778,TRX_N-01054-12434048,2024-08-04T20:41:13,Amurrio,Expense,leisure,-27.5,-38886.81
buyer_3,Ana,35,ES85209524939783321778,TRX_N-01055-97927458,2024-08-05T08:07:48,Amurrio,expenses,water,-28.99,-38915.8
buyer_3,Ana,35,ES85209524939783321778,TRX_N-01056-42010291,2024-08-05T17:11:49,Amurrio,expenses,gas,-36.24,-38952.04
buyer_3,Ana,35,ES85209524939783321778,TRX_N-01057-04023935,2024-08-05T10:08:35,Amurrio,expenses,internet,-42.0,-38994.04
buyer_3,Ana,35,ES85209524939783321778,TRX_N-01058-31809020,2024-08-05T18:12:08,Amurrio,expenses,phone,-38.7,-39032.74
buyer_3,Ana,35,ES85209524939783321778,TRX_N-01059-73844063,2024-08-06T19:52:28,Amurrio,Expense,food,-82.14,-39114.88
buyer_3,Ana,35,ES85209524939783321778,TRX_N-01060-36123231,2024-08-06T13:03:18,Amurrio,Expense,appliances,-96.09,-39210.97
buyer_3,Ana,35,ES85209524939783321778,TRX_N-01061-94057180,2024-08-08T18:43:35,Amurrio,expenses,electricity,-51.75,-39262.72
buyer_3,Ana,35,ES85209524939783321778,TRX_N-01062-87479610,2024-08-08T12:44:39,Amurrio,Expense,transport,-86.89,-39349.61
buyer_3,Ana,35,ES85209524939783321778,TRX_N-01063-54206939,2024-08-09T13:00:02,Durango,Expense,cash,-100.0,-39449.61
buyer_3,Ana,35,ES85209524939783321778,TRX_N-01064-49147438,2024-08-09T03:50:01,Amurrio,Expense,gifts,-225.4,-39675.01
buyer_3,Ana,35,ES85209524939783321778,TRX_N-01065-37612497,2024-08-10T14:12:54,Vitoria-Gasteiz,Expense,appliances,-93.39,-39768.4
buyer_3,Ana,35,ES85209524939783321778,TRX_N-01066-12506873,2024-08-11T21:51:46,Amurrio,Expense,gifts,-497.31,-40265.71
buyer_3,Ana,35,ES85209524939783321778,TRX_N-01067-81167898,2024-08-17T17:35:32,Amurrio,Expense,repairs,-85.34,-40351.05
buyer_3,Ana,35,ES85209524939783321778,TRX_N-01068-09665873,2024-08-18T20:33:43,Amurrio,expenses,children,-83.52,-40434.57
buyer_3,Ana,35,ES85209524939783321778,TRX_N-01069-01138442,2024-08-21T11:46:27,Amurrio,Expense,appliances,-392.99,-40827.56
buyer_3,Ana,35,ES85209524939783321778,TRX_N-01070-09434546,2024-08-23T22:27:55,Amurrio,Expense,leisure,-57.1,-40884.66
buyer_3,Ana,35,ES85209524939783321778,TRX_N-01071-38973829,2024-08-25T14:52:01,Amurrio,Expense,food,-110.81,-40995.47
buyer_3,Ana,35,ES85209524939783321778,TRX_N-01072-71600454,2024-08-25T19:21:53,Amurrio,Expense,education,-54.51,-41049.98
buyer_3,Ana,35,ES85209524939783321778,TRX_N-01073-71868074,2024-09-01T16:14:53,Amurrio,incomes,salary,1485.65,-39564.33
buyer_3,Ana,35,ES85209524939783321778,TRX_N-01074-43944806,2024-09-01T16:14:53,Amurrio,incomes,salary_partner,1462.27,-38102.06
buyer_3,Ana,35,ES85209524939783321778,TRX_N-01075-45766243,2024-09-01T12:51:21,Amurrio,Expense,transport,-87.96,-38190.02
buyer_3,Ana,35,ES85209524939783321778,TRX_N-01076-69760946,2024-09-01T18:41:45,Amurrio,Expense,repairs,-139.78,-38329.8
buyer_3,Ana,35,ES85209524939783321778,TRX_N-01077-37086568,2024-09-02T11:25:31,Hernani,Expense,leisure,-30.92,-38360.72
buyer_3,Ana,35,ES85209524939783321778,TRX_N-01078-85361956,2024-09-02T15:08:47,Pasaia,Expense,appliances,-336.3,-38697.02
buyer_3,Ana,35,ES85209524939783321778,TRX_N-01079-38112778,2024-09-03T05:13:24,Amurrio,Expense,clothing,-72.97,-38769.99
buyer_3,Ana,35,ES85209524939783321778,TRX_N-01080-78052100,2024-09-04T10:40:36,Amurrio,expenses,mortgage,-912.03,-39682.02
buyer_3,Ana,35,ES85209524939783321778,TRX_N-01081-70070992,2024-09-04T18:59:08,Amurrio,Expense,repairs,-206.83,-39888.85
buyer_3,Ana,35,ES85209524939783321778,TRX_N-01082-52491333,2024-09-05T18:33:54,Amurrio,Expense,food,-93.33,-39982.18
buyer_3,Ana,35,ES85209524939783321778,TRX_N-01083-51614641,2024-09-05T10:46:12,Amurrio,expenses,children,-279.67,-40261.85
buyer_3,Ana,35,ES85209524939783321778,TRX_N-01084-53415982,2024-09-06T04:09:48,Amurrio,expenses,phone,-34.18,-40296.03
buyer_3,Ana,35,ES85209524939783321778,TRX_N-01085-94374608,2024-09-07T10:00:51,Amurrio,expenses,electricity,-23.3,-40319.33
buyer_3,Ana,35,ES85209524939783321778,TRX_N-01086-22119315,2024-09-07T18:35:45,Oy√≥n-Oion,Expense,cash,-100.0,-40419.33
buyer_3,Ana,35,ES85209524939783321778,TRX_N-01087-42910892,2024-09-07T22:48:02,Getxo,Expense,appliances,-150.44,-40569.77
buyer_3,Ana,35,ES85209524939783321778,TRX_N-01088-39021760,2024-09-08T22:49:44,Amurrio,expenses,gas,-75.82,-40645.59
buyer_3,Ana,35,ES85209524939783321778,TRX_N-01089-12429086,2024-09-08T02:12:50,Amurrio,expenses,water,-24.76,-40670.35
buyer_3,Ana,35,ES85209524939783321778,TRX_N-01090-95209240,2024-09-08T10:43:05,Amurrio,expenses,internet,-42.0,-40712.35
buyer_3,Ana,35,ES85209524939783321778,TRX_N-01091-91416041,2024-09-08T14:39:15,Amurrio,Expense,cash,-100.0,-40812.35
buyer_3,Ana,35,ES85209524939783321778,TRX_N-01092-61506202,2024-09-09T13:49:41,Amurrio,Expense,leisure,-76.32,-40888.67
buyer_3,Ana,35,ES85209524939783321778,TRX_N-01093-04000066,2024-09-10T11:36:24,Amurrio,Expense,education,-58.8,-40947.47
buyer_3,Ana,35,ES85209524939783321778,TRX_N-01094-28418051,2024-09-10T20:02:18,Amurrio,expenses,children,-66.45,-41013.92
buyer_3,Ana,35,ES85209524939783321778,TRX_N-01095-93237739,2024-09-12T11:58:00,Amurrio,Expense,cash,-100.0,-41113.92
buyer_3,Ana,35,ES85209524939783321778,TRX_N-01096-70064545,2024-09-13T12:19:51,Amurrio,Expense,cash,-100.0,-41213.92
buyer_3,Ana,35,ES85209524939783321778,TRX_N-01097-45829090,2024-09-14T20:56:33,Amurrio,Expense,appliances,-98.34,-41312.26
buyer_3,Ana,35,ES85209524939783321778,TRX_N-01098-83897535,2024-09-15T08:39:53,Amurrio,Expense,clothing,-99.74,-41412.0
buyer_3,Ana,35,ES85209524939783321778,TRX_N-01099-74821046,2024-09-15T14:30:17,Amurrio,Expense,repairs,-65.87,-41477.87
buyer_3,Ana,35,ES85209524939783321778,TRX_N-01100-82311117,2024-09-18T00:22:43,Getxo,Expense,food,-88.45,-41566.32
buyer_3,Ana,35,ES85209524939783321778,TRX_N-01101-20947890,2024-09-18T13:35:36,Basauri,Expense,transport,-53.08,-41619.4
buyer_3,Ana,35,ES85209524939783321778,TRX_N-01102-89660623,2024-09-19T18:19:54,Amurrio,Expense,food,-106.46,-41725.86
buyer_3,Ana,35,ES85209524939783321778,TRX_N-01103-34150260,2024-09-22T14:41:16,Amurrio,Expense,food,-95.65,-41821.51
buyer_3,Ana,35,ES85209524939783321778,TRX_N-01104-04601365,2024-09-23T08:05:55,Amurrio,Expense,cash,-100.0,-41921.51
buyer_3,Ana,35,ES85209524939783321778,TRX_N-01105-82037199,2024-09-23T19:45:16,Vitoria-Gasteiz,Expense,gifts,-170.9,-42092.41
buyer_3,Ana,35,ES85209524939783321778,TRX_N-01106-32394888,2024-09-24T16:53:11,Amurrio,Expense,food,-87.8,-42180.21
buyer_3,Ana,35,ES85209524939783321778,TRX_N-01107-23615860,2024-09-25T08:25:12,Amurrio,Expense,education,-72.13,-42252.34
buyer_3,Ana,35,ES85209524939783321778,TRX_N-01108-50075543,2024-09-26T11:21:07,Amurrio,Expense,transport,-64.04,-42316.38
buyer_3,Ana,35,ES85209524939783321778,TRX_N-01109-01571891,2024-09-26T15:44:45,Amurrio,Expense,appliances,-354.07,-42670.45
buyer_3,Ana,35,ES85209524939783321778,TRX_N-01110-19775551,2024-09-27T15:14:01,Amurrio,Expense,leisure,-68.12,-42738.57
buyer_3,Ana,35,ES85209524939783321778,TRX_N-01111-05734723,2024-09-27T08:38:42,Amurrio,Expense,repairs,-308.61,-43047.18
buyer_3,Ana,35,ES85209524939783321778,TRX_N-01112-48944669,2024-09-29T16:20:43,Amurrio,Expense,food,-100.06,-43147.24
buyer_3,Ana,35,ES85209524939783321778,TRX_N-01113-26562377,2024-09-30T16:13:45,Amurrio,Expense,food,-92.92,-43240.16
buyer_3,Ana,35,ES85209524939783321778,TRX_N-01114-18445674,2024-09-30T14:33:35,Amurrio,Expense,cash,-100.0,-43340.16
buyer_3,Ana,35,ES85209524939783321778,TRX_N-01115-16143440,2024-10-01T17:05:03,Amurrio,incomes,salary,1485.65,-41854.51
buyer_3,Ana,35,ES85209524939783321778,TRX_N-01116-86358353,2024-10-01T17:05:03,Amurrio,incomes,salary_partner,1462.27,-40392.24
buyer_3,Ana,35,ES85209524939783321778,TRX_N-01117-16682358,2024-10-01T13:46:34,Amurrio,Expense,gifts,-114.77,-40507.01
buyer_3,Ana,35,ES85209524939783321778,TRX_N-01118-19399897,2024-10-03T20:28:42,Amurrio,Expense,repairs,-322.16,-40829.17
buyer_3,Ana,35,ES85209524939783321778,TRX_N-01119-61806498,2024-10-04T08:44:19,Amurrio,expenses,mortgage,-912.03,-41741.2
buyer_3,Ana,35,ES85209524939783321778,TRX_N-01120-31872010,2024-10-05T17:07:08,Amurrio,expenses,water,-29.06,-41770.26
buyer_3,Ana,35,ES85209524939783321778,TRX_N-01121-08914825,2024-10-05T01:22:55,Vitoria-Gasteiz,Expense,appliances,-311.5,-42081.76
buyer_3,Ana,35,ES85209524939783321778,TRX_N-01122-92719651,2024-10-06T21:26:13,Amurrio,expenses,internet,-42.0,-42123.76
buyer_3,Ana,35,ES85209524939783321778,TRX_N-01123-05487357,2024-10-07T13:57:38,Amurrio,Expense,food,-105.88,-42229.64
buyer_3,Ana,35,ES85209524939783321778,TRX_N-01124-75537855,2024-10-07T07:53:40,Amurrio,Expense,cash,-100.0,-42329.64
buyer_3,Ana,35,ES85209524939783321778,TRX_N-01125-16332647,2024-10-08T01:10:15,Amurrio,expenses,gas,-87.66,-42417.3
buyer_3,Ana,35,ES85209524939783321778,TRX_N-01126-41443553,2024-10-08T13:07:36,Amurrio,expenses,phone,-41.21,-42458.51
buyer_3,Ana,35,ES85209524939783321778,TRX_N-01127-17552467,2024-10-08T05:48:33,Amurrio,expenses,electricity,-54.29,-42512.8
buyer_3,Ana,35,ES85209524939783321778,TRX_N-01128-20925229,2024-10-08T08:31:09,Amurrio,Expense,cash,-100.0,-42612.8
buyer_4,Jorge,50,ES97209511410504980753,TRX_N-00001-31302123,2022-01-01T09:18:25,Galdakao,incomes,salary,1474.03,3384.66
buyer_4,Jorge,50,ES97209511410504980753,TRX_N-00002-14377074,2022-01-01T09:18:25,Galdakao,incomes,salary_partner,1195.75,4580.41
buyer_4,Jorge,50,ES97209511410504980753,TRX_N-00003-61601827,2022-01-02T11:45:18,Galdakao,Expense,food,-86.29,4494.12
buyer_4,Jorge,50,ES97209511410504980753,TRX_N-00004-73386139,2022-01-02T18:52:23,Galdakao,Expense,education,-78.14,4415.98
buyer_4,Jorge,50,ES97209511410504980753,TRX_N-00005-31416789,2022-01-03T23:51:20,Galdakao,Expense,repairs,-283.27,4132.71
buyer_4,Jorge,50,ES97209511410504980753,TRX_N-00006-84993536,2022-01-04T15:34:22,Galdakao,expenses,mortgage,-863.85,3268.86
buyer_4,Jorge,50,ES97209511410504980753,TRX_N-00007-60604014,2022-01-05T19:02:54,Galdakao,expenses,gas,-113.09,3155.77
buyer_4,Jorge,50,ES97209511410504980753,TRX_N-00008-35609795,2022-01-05T07:59:41,Galdakao,expenses,internet,-42.0,3113.77
buyer_4,Jorge,50,ES97209511410504980753,TRX_N-00009-50773928,2022-01-05T17:12:45,Galdakao,Expense,repairs,-50.01,3063.76
buyer_4,Jorge,50,ES97209511410504980753,TRX_N-00010-32583827,2022-01-07T10:02:00,Galdakao,expenses,phone,-35.33,3028.43
buyer_4,Jorge,50,ES97209511410504980753,TRX_N-00011-40635598,2022-01-07T18:43:08,Galdakao,Expense,cash,-100.0,2928.43
buyer_4,Jorge,50,ES97209511410504980753,TRX_N-00012-78866548,2022-01-08T21:34:14,Galdakao,expenses,water,-42.18,2886.25
buyer_4,Jorge,50,ES97209511410504980753,TRX_N-00013-81559782,2022-01-08T09:10:17,Galdakao,expenses,electricity,-82.59,2803.66
buyer_4,Jorge,50,ES97209511410504980753,TRX_N-00014-47379794,2022-01-08T15:34:48,Galdakao,Expense,cash,-100.0,2703.66
buyer_4,Jorge,50,ES97209511410504980753,TRX_N-00015-30935874,2022-01-08T00:19:10,Galdakao,Expense,repairs,-36.28,2667.38
buyer_4,Jorge,50,ES97209511410504980753,TRX_N-00016-63474300,2022-01-11T11:27:26,Galdakao,Expense,leisure,-41.6,2625.78
buyer_4,Jorge,50,ES97209511410504980753,TRX_N-00017-78336336,2022-01-11T16:04:38,Galdakao,Expense,cash,-100.0,2525.78
buyer_4,Jorge,50,ES97209511410504980753,TRX_N-00018-04766389,2022-01-14T19:58:33,Galdakao,Expense,education,-77.04,2448.74
buyer_4,Jorge,50,ES97209511410504980753,TRX_N-00019-47267191,2022-01-17T12:04:27,Galdakao,Expense,food,-82.61,2366.13
buyer_4,Jorge,50,ES97209511410504980753,TRX_N-00020-69698134,2022-01-18T20:54:58,Galdakao,Expense,food,-104.96,2261.17
buyer_4,Jorge,50,ES97209511410504980753,TRX_N-00021-52952173,2022-01-18T17:18:06,Galdakao,Expense,transport,-55.68,2205.49
buyer_4,Jorge,50,ES97209511410504980753,TRX_N-00022-89934474,2022-01-18T10:02:45,Galdakao,Expense,gifts,-499.55,1705.94
buyer_4,Jorge,50,ES97209511410504980753,TRX_N-00023-51803204,2022-01-20T15:10:58,Galdakao,Expense,repairs,-256.07,1449.87
buyer_4,Jorge,50,ES97209511410504980753,TRX_N-00024-69638455,2022-01-21T13:26:52,Galdakao,Expense,transport,-77.4,1372.47
buyer_4,Jorge,50,ES97209511410504980753,TRX_N-00025-27423168,2022-01-23T20:43:32,Pasaia,Expense,transport,-81.57,1290.9
buyer_4,Jorge,50,ES97209511410504980753,TRX_N-00026-29858447,2022-01-25T16:20:00,Galdakao,expenses,children,-178.91,1111.99
buyer_4,Jorge,50,ES97209511410504980753,TRX_N-00027-78990534,2022-01-26T19:32:25,Eibar,Expense,clothing,-155.8,956.19
buyer_4,Jorge,50,ES97209511410504980753,TRX_N-00028-20916604,2022-01-27T16:51:51,Galdakao,Expense,food,-95.21,860.98
buyer_4,Jorge,50,ES97209511410504980753,TRX_N-00029-86851745,2022-01-27T03:08:25,Galdakao,Expense,transport,-72.37,788.61
buyer_4,Jorge,50,ES97209511410504980753,TRX_N-00030-28362177,2022-01-28T14:00:50,Galdakao,Expense,transport,-41.96,746.65
buyer_4,Jorge,50,ES97209511410504980753,TRX_N-00031-24962853,2022-01-31T12:10:40,Galdakao,Expense,food,-80.07,666.58
buyer_4,Jorge,50,ES97209511410504980753,TRX_N-00032-16742395,2022-01-31T11:03:27,Pasaia,Expense,cash,-100.0,566.58
buyer_4,Jorge,50,ES97209511410504980753,TRX_N-00033-34110496,2022-01-31T09:48:24,Galdakao,Expense,appliances,-161.37,405.21
buyer_4,Jorge,50,ES97209511410504980753,TRX_N-00034-15210325,2022-02-01T14:35:14,Galdakao,incomes,salary,1474.03,1879.24
buyer_4,Jorge,50,ES97209511410504980753,TRX_N-00035-15308443,2022-02-01T14:35:14,Galdakao,incomes,salary_partner,1195.75,3074.99
buyer_4,Jorge,50,ES97209511410504980753,TRX_N-00036-46622388,2022-02-01T15:06:01,Galdakao,Expense,clothing,-94.31,2980.68
buyer_4,Jorge,50,ES97209511410504980753,TRX_N-00037-68929264,2022-02-03T16:12:27,Galdakao,Expense,repairs,-51.05,2929.63
buyer_4,Jorge,50,ES97209511410504980753,TRX_N-00038-49006903,2022-02-04T13:24:39,Galdakao,expenses,mortgage,-863.85,2065.78
buyer_4,Jorge,50,ES97209511410504980753,TRX_N-00039-84626992,2022-02-05T08:59:01,Galdakao,expenses,phone,-34.2,2031.58
buyer_4,Jorge,50,ES97209511410504980753,TRX_N-00040-04902381,2022-02-05T20:47:47,Galdakao,Expense,clothing,-122.93,1908.65
buyer_4,Jorge,50,ES97209511410504980753,TRX_N-00041-91615173,2022-02-07T12:49:40,Galdakao,expenses,gas,-77.29,1831.36
buyer_4,Jorge,50,ES97209511410504980753,TRX_N-00042-23710395,2022-02-07T18:49:10,Galdakao,expenses,internet,-42.0,1789.36
buyer_4,Jorge,50,ES97209511410504980753,TRX_N-00043-67345660,2022-02-07T17:18:44,Galdakao,Expense,transport,-67.55,1721.81
buyer_4,Jorge,50,ES97209511410504980753,TRX_N-00044-16617390,2022-02-07T23:04:08,Galdakao,Expense,repairs,-153.17,1568.64
buyer_4,Jorge,50,ES97209511410504980753,TRX_N-00045-64785064,2022-02-08T15:33:46,Galdakao,expenses,water,-28.13,1540.51
buyer_4,Jorge,50,ES97209511410504980753,TRX_N-00046-43661128,2022-02-08T13:26:32,Galdakao,expenses,electricity,-24.61,1515.9
buyer_4,Jorge,50,ES97209511410504980753,TRX_N-00047-28117096,2022-02-09T08:37:15,Galdakao,Expense,food,-97.33,1418.57
buyer_4,Jorge,50,ES97209511410504980753,TRX_N-00048-47081290,2022-02-10T18:35:39,Galdakao,Expense,cash,-100.0,1318.57
buyer_4,Jorge,50,ES97209511410504980753,TRX_N-00049-53538219,2022-02-12T19:05:04,Galdakao,Expense,leisure,-41.27,1277.3
buyer_4,Jorge,50,ES97209511410504980753,TRX_N-00050-30089283,2022-02-15T16:24:54,Leioa,Expense,food,-71.52,1205.78
buyer_4,Jorge,50,ES97209511410504980753,TRX_N-00051-50294319,2022-02-16T09:02:11,Galdakao,Expense,transport,-84.47,1121.31
buyer_4,Jorge,50,ES97209511410504980753,TRX_N-00052-50350755,2022-02-16T10:25:32,Galdakao,Expense,healthcare,-38.8,1082.51
buyer_4,Jorge,50,ES97209511410504980753,TRX_N-00053-24604018,2022-02-16T11:26:09,Galdakao,Expense,cash,-100.0,982.51
buyer_4,Jorge,50,ES97209511410504980753,TRX_N-00054-13041900,2022-02-17T17:52:48,Galdakao,Expense,food,-64.76,917.75
buyer_4,Jorge,50,ES97209511410504980753,TRX_N-00055-87132695,2022-02-17T14:30:07,Zuia,Expense,leisure,-63.46,854.29
buyer_4,Jorge,50,ES97209511410504980753,TRX_N-00056-89884710,2022-02-17T23:33:21,Galdakao,Expense,repairs,-123.69,730.6
buyer_4,Jorge,50,ES97209511410504980753,TRX_N-00057-05761689,2022-02-18T09:24:58,Galdakao,Expense,appliances,-340.02,390.58
buyer_4,Jorge,50,ES97209511410504980753,TRX_N-00058-50428873,2022-02-19T16:08:09,Alegr√≠a-Dulantzi,Expense,leisure,-78.41,312.17
buyer_4,Jorge,50,ES97209511410504980753,TRX_N-00059-12426670,2022-02-20T17:42:19,Galdakao,Expense,cash,-100.0,212.17
buyer_4,Jorge,50,ES97209511410504980753,TRX_N-00060-38265773,2022-02-20T14:01:48,Labastida,Expense,gifts,-692.09,-479.92
buyer_4,Jorge,50,ES97209511410504980753,TRX_N-00061-60095117,2022-02-22T09:39:45,Galdakao,Expense,leisure,-80.14,-560.06
buyer_4,Jorge,50,ES97209511410504980753,TRX_N-00062-41982474,2022-02-24T08:22:12,Galdakao,Expense,gifts,-394.47,-954.53
buyer_4,Jorge,50,ES97209511410504980753,TRX_N-00063-69199178,2022-02-25T19:41:22,Galdakao,Expense,food,-91.03,-1045.56
buyer_4,Jorge,50,ES97209511410504980753,TRX_N-00064-87868529,2022-02-26T12:11:46,Sopela,Expense,transport,-64.22,-1109.78
buyer_4,Jorge,50,ES97209511410504980753,TRX_N-00065-36792659,2022-02-26T15:52:47,Galdakao,Expense,repairs,-332.18,-1441.96
buyer_4,Jorge,50,ES97209511410504980753,TRX_N-00066-90616868,2022-03-01T10:10:07,Galdakao,incomes,salary,1474.03,32.07
buyer_4,Jorge,50,ES97209511410504980753,TRX_N-00067-72923924,2022-03-01T10:10:07,Galdakao,incomes,salary_partner,1195.75,1227.82
buyer_4,Jorge,50,ES97209511410504980753,TRX_N-00068-42497920,2022-03-02T20:06:57,Hernani,Expense,healthcare,-55.0,1172.82
buyer_4,Jorge,50,ES97209511410504980753,TRX_N-00069-07609452,2022-03-02T11:18:30,Galdakao,Expense,repairs,-95.98,1076.84
buyer_4,Jorge,50,ES97209511410504980753,TRX_N-00070-90194365,2022-03-04T05:27:15,Galdakao,expenses,mortgage,-863.85,212.99
buyer_4,Jorge,50,ES97209511410504980753,TRX_N-00071-97733304,2022-03-05T15:36:36,Galdakao,expenses,gas,-41.38,171.61
buyer_4,Jorge,50,ES97209511410504980753,TRX_N-00072-72751661,2022-03-06T11:27:42,Galdakao,expenses,electricity,-33.4,138.21
buyer_4,Jorge,50,ES97209511410504980753,TRX_N-00073-80823312,2022-03-06T19:27:30,Galdakao,expenses,internet,-42.0,96.21
buyer_4,Jorge,50,ES97209511410504980753,TRX_N-00074-17648152,2022-03-07T10:50:27,Galdakao,expenses,water,-28.12,68.09
buyer_4,Jorge,50,ES97209511410504980753,TRX_N-00075-87927890,2022-03-08T14:01:33,Galdakao,expenses,phone,-44.13,23.96
buyer_4,Jorge,50,ES97209511410504980753,TRX_N-00076-43828595,2022-03-09T14:40:06,Sopela,Expense,food,-79.34,-55.38
buyer_4,Jorge,50,ES97209511410504980753,TRX_N-00077-06128741,2022-03-10T14:22:54,Galdakao,Expense,food,-111.36,-166.74
buyer_4,Jorge,50,ES97209511410504980753,TRX_N-00078-57473888,2022-03-10T23:32:24,Galdakao,Expense,clothing,-92.78,-259.52
buyer_4,Jorge,50,ES97209511410504980753,TRX_N-00079-25399814,2022-03-10T18:55:17,Galdakao,Expense,repairs,-121.13,-380.65
buyer_4,Jorge,50,ES97209511410504980753,TRX_N-00080-76429809,2022-03-12T18:25:07,Galdakao,Expense,cash,-100.0,-480.65
buyer_4,Jorge,50,ES97209511410504980753,TRX_N-00081-35018118,2022-03-13T15:23:04,Getxo,Expense,transport,-73.87,-554.52
buyer_4,Jorge,50,ES97209511410504980753,TRX_N-00082-17401717,2022-03-13T08:52:45,Elciego,Expense,cash,-100.0,-654.52
buyer_4,Jorge,50,ES97209511410504980753,TRX_N-00083-75125562,2022-03-14T14:10:17,Galdakao,Expense,food,-76.92,-731.44
buyer_4,Jorge,50,ES97209511410504980753,TRX_N-00084-31977415,2022-03-14T08:00:30,Galdakao,Expense,leisure,-84.26,-815.7
buyer_4,Jorge,50,ES97209511410504980753,TRX_N-00085-35773654,2022-03-15T09:00:30,Galdakao,Expense,cash,-100.0,-915.7
buyer_4,Jorge,50,ES97209511410504980753,TRX_N-00086-81916618,2022-03-16T17:17:30,Galdakao,Expense,healthcare,-109.73,-1025.43
buyer_4,Jorge,50,ES97209511410504980753,TRX_N-00087-47191842,2022-03-17T16:32:15,Galdakao,Expense,cash,-100.0,-1125.43
buyer_4,Jorge,50,ES97209511410504980753,TRX_N-00088-10269797,2022-03-19T22:43:26,Galdakao,Expense,leisure,-52.11,-1177.54
buyer_4,Jorge,50,ES97209511410504980753,TRX_N-00089-35357620,2022-03-20T10:04:15,Donostia,Expense,clothing,-61.76,-1239.3
buyer_4,Jorge,50,ES97209511410504980753,TRX_N-00090-73324015,2022-03-20T17:13:11,Galdakao,Expense,cash,-100.0,-1339.3
buyer_4,Jorge,50,ES97209511410504980753,TRX_N-00091-98836583,2022-03-22T18:34:36,Galdakao,Expense,cash,-100.0,-1439.3
buyer_4,Jorge,50,ES97209511410504980753,TRX_N-00092-73970035,2022-03-23T13:42:57,Galdakao,expenses,children,-171.62,-1610.92
buyer_4,Jorge,50,ES97209511410504980753,TRX_N-00093-92353910,2022-03-24T17:08:35,Galdakao,Expense,leisure,-22.69,-1633.61
buyer_4,Jorge,50,ES97209511410504980753,TRX_N-00094-58344815,2022-03-25T10:40:40,Galdakao,Expense,gifts,-169.33,-1802.94
buyer_4,Jorge,50,ES97209511410504980753,TRX_N-00095-20180862,2022-03-25T20:16:59,Galdakao,expenses,children,-151.85,-1954.79
buyer_4,Jorge,50,ES97209511410504980753,TRX_N-00096-20283720,2022-03-26T06:50:08,Galdakao,expenses,children,-222.05,-2176.84
buyer_4,Jorge,50,ES97209511410504980753,TRX_N-00097-28553718,2022-03-29T08:12:23,Galdakao,Expense,food,-61.19,-2238.03
buyer_4,Jorge,50,ES97209511410504980753,TRX_N-00098-13885156,2022-03-29T16:11:49,Galdakao,expenses,children,-78.45,-2316.48
buyer_4,Jorge,50,ES97209511410504980753,TRX_N-00099-94676098,2022-04-01T17:01:18,Galdakao,incomes,salary,1474.03,-842.45
buyer_4,Jorge,50,ES97209511410504980753,TRX_N-00100-27626444,2022-04-01T17:01:18,Galdakao,incomes,salary_partner,1195.75,353.3
buyer_4,Jorge,50,ES97209511410504980753,TRX_N-00101-64844609,2022-04-01T17:01:18,Galdakao,incomes,extra_income,273.62,626.92
buyer_4,Jorge,50,ES97209511410504980753,TRX_N-00102-46481593,2022-04-01T00:57:20,Galdakao,Expense,healthcare,-144.56,482.36
buyer_4,Jorge,50,ES97209511410504980753,TRX_N-00103-40461393,2022-04-01T14:50:56,Alegr√≠a-Dulantzi,Expense,gifts,-813.31,-330.95
buyer_4,Jorge,50,ES97209511410504980753,TRX_N-00104-97382505,2022-04-02T15:05:03,Galdakao,Expense,food,-73.84,-404.79
buyer_4,Jorge,50,ES97209511410504980753,TRX_N-00105-56226232,2022-04-03T10:16:57,Galdakao,Expense,healthcare,-78.0,-482.79
buyer_4,Jorge,50,ES97209511410504980753,TRX_N-00106-31385875,2022-04-04T03:46:07,Galdakao,expenses,mortgage,-863.85,-1346.64
buyer_4,Jorge,50,ES97209511410504980753,TRX_N-00107-00055958,2022-04-04T16:34:15,Galdakao,Expense,cash,-100.0,-1446.64
buyer_4,Jorge,50,ES97209511410504980753,TRX_N-00108-51181570,2022-04-05T16:17:14,Galdakao,expenses,phone,-41.13,-1487.77
buyer_4,Jorge,50,ES97209511410504980753,TRX_N-00109-07715377,2022-04-07T20:46:53,Galdakao,Expense,education,-71.15,-1558.92
buyer_4,Jorge,50,ES97209511410504980753,TRX_N-00110-70165852,2022-04-08T13:17:16,Galdakao,expenses,water,-42.85,-1601.77
buyer_4,Jorge,50,ES97209511410504980753,TRX_N-00111-63689724,2022-04-08T11:31:51,Galdakao,expenses,electricity,-48.73,-1650.5
buyer_4,Jorge,50,ES97209511410504980753,TRX_N-00112-47026951,2022-04-08T18:19:20,Galdakao,expenses,internet,-42.0,-1692.5
buyer_4,Jorge,50,ES97209511410504980753,TRX_N-00113-20404941,2022-04-08T08:51:09,Galdakao,expenses,gas,-99.97,-1792.47
buyer_4,Jorge,50,ES97209511410504980753,TRX_N-00114-65555890,2022-04-08T13:47:06,Galdakao,Expense,cash,-100.0,-1892.47
buyer_4,Jorge,50,ES97209511410504980753,TRX_N-00115-79591567,2022-04-09T21:05:19,Galdakao,Expense,transport,-82.99,-1975.46
buyer_4,Jorge,50,ES97209511410504980753,TRX_N-00116-51290732,2022-04-10T04:42:46,Galdakao,Expense,healthcare,-121.36,-2096.82
buyer_4,Jorge,50,ES97209511410504980753,TRX_N-00117-16103295,2022-04-10T19:01:57,Galdakao,Expense,repairs,-27.66,-2124.48
buyer_4,Jorge,50,ES97209511410504980753,TRX_N-00118-63791720,2022-04-11T15:10:15,Galdakao,Expense,food,-78.54,-2203.02
buyer_4,Jorge,50,ES97209511410504980753,TRX_N-00119-48515911,2022-04-13T20:21:06,Galdakao,Expense,leisure,-31.06,-2234.08
buyer_4,Jorge,50,ES97209511410504980753,TRX_N-00120-27367977,2022-04-13T07:06:24,Galdakao,Expense,cash,-100.0,-2334.08
buyer_4,Jorge,50,ES97209511410504980753,TRX_N-00121-73831533,2022-04-14T17:00:05,Galdakao,Expense,food,-91.29,-2425.37
buyer_4,Jorge,50,ES97209511410504980753,TRX_N-00122-31210156,2022-04-14T16:54:10,Galdakao,Expense,education,-61.68,-2487.05
buyer_4,Jorge,50,ES97209511410504980753,TRX_N-00123-84957786,2022-04-14T12:14:50,Galdakao,expenses,children,-243.27,-2730.32
buyer_4,Jorge,50,ES97209511410504980753,TRX_N-00124-34522543,2022-04-15T03:44:38,Bermeo,Expense,food,-77.01,-2807.33
buyer_4,Jorge,50,ES97209511410504980753,TRX_N-00125-96334998,2022-04-15T08:46:54,Galdakao,Expense,leisure,-83.2,-2890.53
buyer_4,Jorge,50,ES97209511410504980753,TRX_N-00126-83551469,2022-04-16T17:23:00,Galdakao,Expense,cash,-100.0,-2990.53
buyer_4,Jorge,50,ES97209511410504980753,TRX_N-00127-78983520,2022-04-17T11:05:46,Labastida,Expense,clothing,-159.3,-3149.83
buyer_4,Jorge,50,ES97209511410504980753,TRX_N-00128-88881589,2022-04-17T06:27:00,Llodio,Expense,education,-48.7,-3198.53
buyer_4,Jorge,50,ES97209511410504980753,TRX_N-00129-03059598,2022-04-17T20:35:25,Leioa,Expense,travel,-568.39,-3766.92
buyer_4,Jorge,50,ES97209511410504980753,TRX_N-00130-39767148,2022-04-18T15:15:35,Galdakao,Expense,transport,-87.01,-3853.93
buyer_4,Jorge,50,ES97209511410504980753,TRX_N-00131-31423085,2022-04-18T12:54:09,Berango,Expense,clothing,-139.28,-3993.21
buyer_4,Jorge,50,ES97209511410504980753,TRX_N-00132-19301597,2022-04-19T09:39:45,Galdakao,Expense,food,-67.25,-4060.46
buyer_4,Jorge,50,ES97209511410504980753,TRX_N-00133-23752143,2022-04-20T15:26:39,Galdakao,Expense,repairs,-279.13,-4339.59
buyer_4,Jorge,50,ES97209511410504980753,TRX_N-00134-99248561,2022-04-21T20:44:49,Galdakao,Expense,food,-72.74,-4412.33
buyer_4,Jorge,50,ES97209511410504980753,TRX_N-00135-86317250,2022-04-21T09:46:03,Lasarte-Oria,Expense,transport,-89.14,-4501.47
buyer_4,Jorge,50,ES97209511410504980753,TRX_N-00136-20725691,2022-04-21T10:04:01,Galdakao,Expense,cash,-100.0,-4601.47
buyer_4,Jorge,50,ES97209511410504980753,TRX_N-00137-64279318,2022-04-22T15:36:21,Galdakao,Expense,transport,-65.17,-4666.64
buyer_4,Jorge,50,ES97209511410504980753,TRX_N-00138-99909174,2022-04-22T04:03:31,Galdakao,Expense,healthcare,-122.56,-4789.2
buyer_4,Jorge,50,ES97209511410504980753,TRX_N-00139-77846062,2022-04-23T11:58:32,Galdakao,Expense,repairs,-273.91,-5063.11
buyer_4,Jorge,50,ES97209511410504980753,TRX_N-00140-02078886,2022-04-24T09:16:15,Galdakao,Expense,cash,-100.0,-5163.11
buyer_4,Jorge,50,ES97209511410504980753,TRX_N-00141-04810068,2022-04-26T10:32:02,Galdakao,Expense,gifts,-302.68,-5465.79
buyer_4,Jorge,50,ES97209511410504980753,TRX_N-00142-31963351,2022-04-29T18:57:22,Galdakao,Expense,transport,-88.92,-5554.71
buyer_4,Jorge,50,ES97209511410504980753,TRX_N-00143-30170308,2022-04-30T18:00:52,Galdakao,Expense,leisure,-24.61,-5579.32
buyer_4,Jorge,50,ES97209511410504980753,TRX_N-00144-94924177,2022-05-01T14:15:49,Galdakao,incomes,salary,1474.03,-4105.29
buyer_4,Jorge,50,ES97209511410504980753,TRX_N-00145-92993318,2022-05-01T14:15:49,Galdakao,incomes,salary_partner,1195.75,-2909.54
buyer_4,Jorge,50,ES97209511410504980753,TRX_N-00146-12494078,2022-05-02T13:37:34,Galdakao,Expense,food,-65.5,-2975.04
buyer_4,Jorge,50,ES97209511410504980753,TRX_N-00147-39883848,2022-05-03T21:15:07,Galdakao,Expense,repairs,-241.66,-3216.7
buyer_4,Jorge,50,ES97209511410504980753,TRX_N-00148-60400992,2022-05-04T19:20:33,Galdakao,expenses,mortgage,-863.85,-4080.55
buyer_4,Jorge,50,ES97209511410504980753,TRX_N-00149-13224420,2022-05-05T16:30:19,Sestao,Expense,leisure,-29.0,-4109.55
buyer_4,Jorge,50,ES97209511410504980753,TRX_N-00150-38455017,2022-05-06T17:34:55,Galdakao,Expense,repairs,-296.73,-4406.28
buyer_4,Jorge,50,ES97209511410504980753,TRX_N-00151-60206857,2022-05-07T21:18:08,Galdakao,expenses,electricity,-44.32,-4450.6
buyer_4,Jorge,50,ES97209511410504980753,TRX_N-00152-50448607,2022-05-07T12:21:35,Galdakao,Expense,clothing,-48.47,-4499.07
buyer_4,Jorge,50,ES97209511410504980753,TRX_N-00153-39138056,2022-05-07T07:16:06,Galdakao,Expense,repairs,-247.4,-4746.47
buyer_4,Jorge,50,ES97209511410504980753,TRX_N-00154-96822455,2022-05-08T11:15:27,Galdakao,expenses,water,-24.56,-4771.03
buyer_4,Jorge,50,ES97209511410504980753,TRX_N-00155-83860823,2022-05-08T09:22:54,Galdakao,expenses,gas,-66.82,-4837.85
buyer_4,Jorge,50,ES97209511410504980753,TRX_N-00156-41774004,2022-05-08T17:29:30,Galdakao,expenses,internet,-42.0,-4879.85
buyer_4,Jorge,50,ES97209511410504980753,TRX_N-00157-01189765,2022-05-08T08:02:24,Galdakao,expenses,phone,-32.59,-4912.44
buyer_4,Jorge,50,ES97209511410504980753,TRX_N-00158-09975935,2022-05-08T11:45:21,Galdakao,Expense,food,-81.63,-4994.07
buyer_4,Jorge,50,ES97209511410504980753,TRX_N-00159-70757385,2022-05-08T17:48:42,Galdakao,Expense,repairs,-209.84,-5203.91
buyer_4,Jorge,50,ES97209511410504980753,TRX_N-00160-48702221,2022-05-08T11:06:05,Galdakao,expenses,children,-94.88,-5298.79
buyer_4,Jorge,50,ES97209511410504980753,TRX_N-00161-55602251,2022-05-11T19:08:01,Errenteria,Expense,food,-100.69,-5399.48
buyer_4,Jorge,50,ES97209511410504980753,TRX_N-00162-04968300,2022-05-11T11:59:43,Galdakao,Expense,education,-53.11,-5452.59
buyer_4,Jorge,50,ES97209511410504980753,TRX_N-00163-01721190,2022-05-13T09:17:09,Galdakao,Expense,education,-56.98,-5509.57
buyer_4,Jorge,50,ES97209511410504980753,TRX_N-00164-22263492,2022-05-15T12:41:37,Galdakao,Expense,education,-76.1,-5585.67
buyer_4,Jorge,50,ES97209511410504980753,TRX_N-00165-02880050,2022-05-16T20:18:34,Galdakao,Expense,cash,-100.0,-5685.67
buyer_4,Jorge,50,ES97209511410504980753,TRX_N-00166-21226702,2022-05-18T16:32:53,Galdakao,Expense,gifts,-466.03,-6151.7
buyer_4,Jorge,50,ES97209511410504980753,TRX_N-00167-70403463,2022-05-20T20:11:40,Galdakao,Expense,gifts,-521.31,-6673.01
buyer_4,Jorge,50,ES97209511410504980753,TRX_N-00168-97729658,2022-05-21T07:25:03,Galdakao,Expense,food,-76.46,-6749.47
buyer_4,Jorge,50,ES97209511410504980753,TRX_N-00169-00523729,2022-05-21T22:50:02,Galdakao,Expense,healthcare,-124.99,-6874.46
buyer_4,Jorge,50,ES97209511410504980753,TRX_N-00170-01467312,2022-05-22T11:37:22,Galdakao,Expense,leisure,-36.6,-6911.06
buyer_4,Jorge,50,ES97209511410504980753,TRX_N-00171-25367837,2022-05-27T19:01:36,Berango,Expense,travel,-745.58,-7656.64
buyer_4,Jorge,50,ES97209511410504980753,TRX_N-00172-30509075,2022-05-29T18:05:41,Galdakao,Expense,food,-89.24,-7745.88
buyer_4,Jorge,50,ES97209511410504980753,TRX_N-00173-93665610,2022-05-29T11:35:28,Galdakao,Expense,cash,-100.0,-7845.88
buyer_4,Jorge,50,ES97209511410504980753,TRX_N-00174-52192112,2022-05-30T10:48:37,Galdakao,Expense,cash,-100.0,-7945.88
buyer_4,Jorge,50,ES97209511410504980753,TRX_N-00175-95321185,2022-05-31T07:36:22,Galdakao,expenses,children,-228.04,-8173.92
buyer_4,Jorge,50,ES97209511410504980753,TRX_N-00176-60786930,2022-06-01T11:46:19,Galdakao,incomes,salary,1474.03,-6699.89
buyer_4,Jorge,50,ES97209511410504980753,TRX_N-00177-12529797,2022-06-01T11:46:19,Galdakao,incomes,salary_partner,1195.75,-5504.14
buyer_4,Jorge,50,ES97209511410504980753,TRX_N-00178-98155682,2022-06-01T11:46:19,Galdakao,incomes,salary_bonus,1130.46,-4373.68
buyer_4,Jorge,50,ES97209511410504980753,TRX_N-00179-24366431,2022-06-01T11:46:19,Galdakao,incomes,salary_partner_bonus,892.22,-3481.46
buyer_4,Jorge,50,ES97209511410504980753,TRX_N-00180-06583874,2022-06-02T08:28:03,Galdakao,Expense,education,-50.65,-3532.11
buyer_4,Jorge,50,ES97209511410504980753,TRX_N-00181-94761321,2022-06-04T08:43:59,Galdakao,expenses,mortgage,-863.85,-4395.96
buyer_4,Jorge,50,ES97209511410504980753,TRX_N-00182-35213209,2022-06-04T02:17:29,Galdakao,Expense,repairs,-153.19,-4549.15
buyer_4,Jorge,50,ES97209511410504980753,TRX_N-00183-63264758,2022-06-05T13:30:27,Galdakao,expenses,internet,-42.0,-4591.15
buyer_4,Jorge,50,ES97209511410504980753,TRX_N-00184-48626015,2022-06-05T20:08:18,Galdakao,expenses,phone,-32.32,-4623.47
buyer_4,Jorge,50,ES97209511410504980753,TRX_N-00185-11606205,2022-06-05T10:02:49,Galdakao,Expense,leisure,-68.05,-4691.52
buyer_4,Jorge,50,ES97209511410504980753,TRX_N-00186-22422866,2022-06-06T13:26:42,Galdakao,expenses,gas,-106.15,-4797.67
buyer_4,Jorge,50,ES97209511410504980753,TRX_N-00187-25193210,2022-06-06T00:30:44,Galdakao,Expense,gifts,-582.17,-5379.84
buyer_4,Jorge,50,ES97209511410504980753,TRX_N-00188-47136973,2022-06-08T16:40:15,Galdakao,expenses,water,-35.12,-5414.96
buyer_4,Jorge,50,ES97209511410504980753,TRX_N-00189-34125328,2022-06-08T16:49:23,Galdakao,expenses,electricity,-35.63,-5450.59
buyer_4,Jorge,50,ES97209511410504980753,TRX_N-00190-58041837,2022-06-08T17:10:40,Durango,Expense,food,-76.45,-5527.04
buyer_4,Jorge,50,ES97209511410504980753,TRX_N-00191-92837592,2022-06-10T11:40:04,Zuia,Expense,leisure,-54.39,-5581.43
buyer_4,Jorge,50,ES97209511410504980753,TRX_N-00192-00033773,2022-06-13T18:17:20,Galdakao,Expense,food,-85.85,-5667.28
buyer_4,Jorge,50,ES97209511410504980753,TRX_N-00193-83284060,2022-06-20T12:43:09,Galdakao,Expense,transport,-78.37,-5745.65
buyer_4,Jorge,50,ES97209511410504980753,TRX_N-00194-69172699,2022-06-22T20:01:35,Galdakao,expenses,children,-208.56,-5954.21
buyer_4,Jorge,50,ES97209511410504980753,TRX_N-00195-10628540,2022-06-23T10:21:23,Berango,Expense,leisure,-32.8,-5987.01
buyer_4,Jorge,50,ES97209511410504980753,TRX_N-00196-86863364,2022-06-26T06:23:25,Galdakao,Expense,repairs,-41.55,-6028.56
buyer_4,Jorge,50,ES97209511410504980753,TRX_N-00197-89333407,2022-06-27T21:27:54,Galdakao,Expense,clothing,-152.37,-6180.93
buyer_4,Jorge,50,ES97209511410504980753,TRX_N-00198-08121037,2022-06-27T20:23:06,Leioa,Expense,cash,-100.0,-6280.93
buyer_4,Jorge,50,ES97209511410504980753,TRX_N-00199-97573449,2022-06-30T21:23:48,Galdakao,Expense,clothing,-93.65,-6374.58
buyer_4,Jorge,50,ES97209511410504980753,TRX_N-00200-14309662,2022-07-01T14:59:27,Galdakao,incomes,salary,1474.03,-4900.55
buyer_4,Jorge,50,ES97209511410504980753,TRX_N-00201-79886477,2022-07-01T14:59:27,Galdakao,incomes,salary_partner,1195.75,-3704.8
buyer_4,Jorge,50,ES97209511410504980753,TRX_N-00202-61707995,2022-07-01T14:59:27,Galdakao,incomes,extra_income,273.62,-3431.18
buyer_4,Jorge,50,ES97209511410504980753,TRX_N-00203-78771951,2022-07-02T20:54:08,Santurtzi,Expense,transport,-51.39,-3482.57
buyer_4,Jorge,50,ES97209511410504980753,TRX_N-00204-15615240,2022-07-03T12:53:32,Sopela,Expense,education,-45.55,-3528.12
buyer_4,Jorge,50,ES97209511410504980753,TRX_N-00205-73872218,2022-07-04T18:43:27,Galdakao,expenses,mortgage,-863.85,-4391.97
buyer_4,Jorge,50,ES97209511410504980753,TRX_N-00206-81690077,2022-07-05T18:26:41,Galdakao,expenses,electricity,-71.57,-4463.54
buyer_4,Jorge,50,ES97209511410504980753,TRX_N-00207-61786572,2022-07-05T05:05:30,Galdakao,expenses,internet,-42.0,-4505.54
buyer_4,Jorge,50,ES97209511410504980753,TRX_N-00208-49681840,2022-07-05T16:11:16,Galdakao,expenses,phone,-36.37,-4541.91
buyer_4,Jorge,50,ES97209511410504980753,TRX_N-00209-85352343,2022-07-05T11:46:48,Galdakao,Expense,repairs,-236.29,-4778.2
buyer_4,Jorge,50,ES97209511410504980753,TRX_N-00210-22626073,2022-07-06T05:34:47,Andoain,Expense,cash,-100.0,-4878.2
buyer_4,Jorge,50,ES97209511410504980753,TRX_N-00211-23633634,2022-07-06T16:18:40,Galdakao,Expense,repairs,-91.65,-4969.85
buyer_4,Jorge,50,ES97209511410504980753,TRX_N-00212-80219388,2022-07-08T19:08:39,Galdakao,expenses,gas,-108.12,-5077.97
buyer_4,Jorge,50,ES97209511410504980753,TRX_N-00213-95953496,2022-07-08T19:14:42,Galdakao,expenses,water,-22.85,-5100.82
buyer_4,Jorge,50,ES97209511410504980753,TRX_N-00214-05469062,2022-07-08T09:40:32,Galdakao,Expense,food,-119.28,-5220.1
buyer_4,Jorge,50,ES97209511410504980753,TRX_N-00215-28721579,2022-07-09T10:50:20,Santurtzi,Expense,education,-67.26,-5287.36
buyer_4,Jorge,50,ES97209511410504980753,TRX_N-00216-92253177,2022-07-10T20:07:25,Galdakao,Expense,appliances,-88.71,-5376.07
buyer_4,Jorge,50,ES97209511410504980753,TRX_N-00217-23485066,2022-07-12T14:46:41,Salvatierra/Agurain,Expense,clothing,-150.35,-5526.42
buyer_4,Jorge,50,ES97209511410504980753,TRX_N-00218-60304241,2022-07-12T17:38:28,Galdakao,Expense,cash,-100.0,-5626.42
buyer_4,Jorge,50,ES97209511410504980753,TRX_N-00219-03092967,2022-07-13T05:04:58,Galdakao,Expense,food,-65.48,-5691.9
buyer_4,Jorge,50,ES97209511410504980753,TRX_N-00220-62959988,2022-07-14T19:21:02,Galdakao,Expense,food,-96.7,-5788.6
buyer_4,Jorge,50,ES97209511410504980753,TRX_N-00221-97663206,2022-07-15T05:09:02,Andoain,Expense,gifts,-375.72,-6164.32
buyer_4,Jorge,50,ES97209511410504980753,TRX_N-00222-46554629,2022-07-17T13:43:36,Galdakao,Expense,leisure,-37.52,-6201.84
buyer_4,Jorge,50,ES97209511410504980753,TRX_N-00223-72662448,2022-07-20T00:55:50,Galdakao,Expense,food,-63.73,-6265.57
buyer_4,Jorge,50,ES97209511410504980753,TRX_N-00224-07365060,2022-07-22T15:43:24,Galdakao,Expense,cash,-100.0,-6365.57
buyer_4,Jorge,50,ES97209511410504980753,TRX_N-00225-81264950,2022-07-22T12:54:57,Santurtzi,Expense,gifts,-165.97,-6531.54
buyer_4,Jorge,50,ES97209511410504980753,TRX_N-00226-99995138,2022-07-23T21:36:07,Galdakao,Expense,food,-76.6,-6608.14
buyer_4,Jorge,50,ES97209511410504980753,TRX_N-00227-23520270,2022-07-24T16:43:12,Galdakao,expenses,children,-105.19,-6713.33
buyer_4,Jorge,50,ES97209511410504980753,TRX_N-00228-67617245,2022-07-25T18:43:10,Galdakao,Expense,food,-82.95,-6796.28
buyer_4,Jorge,50,ES97209511410504980753,TRX_N-00229-75941399,2022-07-26T13:14:26,Erandio,Expense,cash,-100.0,-6896.28
buyer_4,Jorge,50,ES97209511410504980753,TRX_N-00230-40711522,2022-07-27T13:09:27,Leioa,Expense,clothing,-122.13,-7018.41
buyer_4,Jorge,50,ES97209511410504980753,TRX_N-00231-03055613,2022-07-31T14:48:16,Galdakao,Expense,food,-123.47,-7141.88
buyer_4,Jorge,50,ES97209511410504980753,TRX_N-00232-98038623,2022-07-31T12:13:51,Galdakao,expenses,children,-195.11,-7336.99
buyer_4,Jorge,50,ES97209511410504980753,TRX_N-00233-10576538,2022-08-01T13:58:02,Galdakao,incomes,salary,1474.03,-5862.96
buyer_4,Jorge,50,ES97209511410504980753,TRX_N-00234-90025815,2022-08-01T13:58:02,Galdakao,incomes,salary_partner,1195.75,-4667.21
buyer_4,Jorge,50,ES97209511410504980753,TRX_N-00235-21592754,2022-08-02T17:58:33,Bermeo,Expense,food,-115.75,-4782.96
buyer_4,Jorge,50,ES97209511410504980753,TRX_N-00236-55075106,2022-08-03T09:51:44,Galdakao,expenses,children,-91.47,-4874.43
buyer_4,Jorge,50,ES97209511410504980753,TRX_N-00237-01319639,2022-08-04T13:59:25,Galdakao,expenses,mortgage,-863.85,-5738.28
buyer_4,Jorge,50,ES97209511410504980753,TRX_N-00238-69733750,2022-08-05T21:38:07,Galdakao,expenses,internet,-42.0,-5780.28
buyer_4,Jorge,50,ES97209511410504980753,TRX_N-00239-77352067,2022-08-06T22:14:59,Galdakao,expenses,electricity,-84.41,-5864.69
buyer_4,Jorge,50,ES97209511410504980753,TRX_N-00240-60115530,2022-08-08T19:56:03,Galdakao,expenses,water,-25.08,-5889.77
buyer_4,Jorge,50,ES97209511410504980753,TRX_N-00241-96541248,2022-08-08T09:00:32,Galdakao,expenses,gas,-70.42,-5960.19
buyer_4,Jorge,50,ES97209511410504980753,TRX_N-00242-08556781,2022-08-08T12:46:00,Galdakao,expenses,phone,-44.17,-6004.36
buyer_4,Jorge,50,ES97209511410504980753,TRX_N-00243-21002610,2022-08-09T13:22:37,Galdakao,Expense,transport,-83.1,-6087.46
buyer_4,Jorge,50,ES97209511410504980753,TRX_N-00244-43216167,2022-08-11T15:25:28,Galdakao,Expense,food,-123.91,-6211.37
buyer_4,Jorge,50,ES97209511410504980753,TRX_N-00245-12954339,2022-08-11T00:41:12,Galdakao,Expense,leisure,-28.97,-6240.34
buyer_4,Jorge,50,ES97209511410504980753,TRX_N-00246-86562563,2022-08-13T18:03:27,Galdakao,Expense,transport,-77.59,-6317.93
buyer_4,Jorge,50,ES97209511410504980753,TRX_N-00247-18622309,2022-08-15T11:30:01,Galdakao,Expense,clothing,-48.33,-6366.26
buyer_4,Jorge,50,ES97209511410504980753,TRX_N-00248-37793237,2022-08-15T14:41:57,Galdakao,Expense,repairs,-142.66,-6508.92
buyer_4,Jorge,50,ES97209511410504980753,TRX_N-00249-56301243,2022-08-20T09:05:48,Galdakao,Expense,transport,-43.4,-6552.32
buyer_4,Jorge,50,ES97209511410504980753,TRX_N-00250-71591380,2022-08-21T13:00:52,Galdakao,Expense,food,-121.83,-6674.15
buyer_4,Jorge,50,ES97209511410504980753,TRX_N-00251-15335166,2022-08-21T16:41:12,Galdakao,Expense,transport,-67.49,-6741.64
buyer_4,Jorge,50,ES97209511410504980753,TRX_N-00252-80129437,2022-08-25T15:20:16,Galdakao,Expense,transport,-48.27,-6789.91
buyer_4,Jorge,50,ES97209511410504980753,TRX_N-00253-15668778,2022-08-30T18:55:28,Galdakao,Expense,healthcare,-70.58,-6860.49
buyer_4,Jorge,50,ES97209511410504980753,TRX_N-00254-70320402,2022-08-31T18:23:56,Galdakao,Expense,clothing,-77.31,-6937.8
buyer_4,Jorge,50,ES97209511410504980753,TRX_N-00255-65899588,2022-09-01T05:50:21,Galdakao,incomes,salary,1474.03,-5463.77
buyer_4,Jorge,50,ES97209511410504980753,TRX_N-00256-12072132,2022-09-01T05:50:21,Galdakao,incomes,salary_partner,1195.75,-4268.02
buyer_4,Jorge,50,ES97209511410504980753,TRX_N-00257-58742991,2022-09-03T15:41:41,Galdakao,Expense,travel,-1782.58,-6050.6
buyer_4,Jorge,50,ES97209511410504980753,TRX_N-00258-91698877,2022-09-04T09:39:51,Galdakao,expenses,mortgage,-863.85,-6914.45
buyer_4,Jorge,50,ES97209511410504980753,TRX_N-00259-10179995,2022-09-05T18:10:22,Salvatierra/Agurain,Expense,education,-44.15,-6958.6
buyer_4,Jorge,50,ES97209511410504980753,TRX_N-00260-32842607,2022-09-06T08:42:24,Galdakao,expenses,gas,-81.85,-7040.45
buyer_4,Jorge,50,ES97209511410504980753,TRX_N-00261-69851632,2022-09-06T09:36:32,Galdakao,Expense,food,-70.62,-7111.07
buyer_4,Jorge,50,ES97209511410504980753,TRX_N-00262-33790180,2022-09-06T18:45:20,Galdakao,Expense,cash,-100.0,-7211.07
buyer_4,Jorge,50,ES97209511410504980753,TRX_N-00263-45666825,2022-09-08T18:15:27,Galdakao,expenses,water,-38.26,-7249.33
buyer_4,Jorge,50,ES97209511410504980753,TRX_N-00264-71179921,2022-09-08T12:28:20,Galdakao,expenses,phone,-44.34,-7293.67
buyer_4,Jorge,50,ES97209511410504980753,TRX_N-00265-84799729,2022-09-08T11:51:13,Galdakao,expenses,electricity,-32.54,-7326.21
buyer_4,Jorge,50,ES97209511410504980753,TRX_N-00266-92655854,2022-09-08T08:24:14,Galdakao,expenses,internet,-42.0,-7368.21
buyer_4,Jorge,50,ES97209511410504980753,TRX_N-00267-84199267,2022-09-10T09:44:31,Getxo,Expense,transport,-66.52,-7434.73
buyer_4,Jorge,50,ES97209511410504980753,TRX_N-00268-88414932,2022-09-11T17:15:19,Galdakao,Expense,clothing,-49.24,-7483.97
buyer_4,Jorge,50,ES97209511410504980753,TRX_N-00269-00303445,2022-09-14T11:38:13,Galdakao,Expense,cash,-100.0,-7583.97
buyer_4,Jorge,50,ES97209511410504980753,TRX_N-00270-11951601,2022-09-14T09:32:34,Galdakao,Expense,repairs,-316.47,-7900.44
buyer_4,Jorge,50,ES97209511410504980753,TRX_N-00271-29070120,2022-09-16T11:16:48,Galdakao,Expense,gifts,-203.0,-8103.44
buyer_4,Jorge,50,ES97209511410504980753,TRX_N-00272-47848133,2022-09-18T09:00:31,Galdakao,Expense,food,-71.67,-8175.11
buyer_4,Jorge,50,ES97209511410504980753,TRX_N-00273-85417387,2022-09-19T13:18:58,Galdakao,Expense,healthcare,-120.44,-8295.55
buyer_4,Jorge,50,ES97209511410504980753,TRX_N-00274-47516354,2022-09-21T08:51:47,Galdakao,Expense,cash,-100.0,-8395.55
buyer_4,Jorge,50,ES97209511410504980753,TRX_N-00275-48981820,2022-09-22T07:26:59,Galdakao,Expense,leisure,-41.86,-8437.41
buyer_4,Jorge,50,ES97209511410504980753,TRX_N-00276-59485355,2022-09-22T09:36:19,Galdakao,Expense,cash,-100.0,-8537.41
buyer_4,Jorge,50,ES97209511410504980753,TRX_N-00277-95187969,2022-09-23T19:32:33,Galdakao,Expense,food,-124.49,-8661.9
buyer_4,Jorge,50,ES97209511410504980753,TRX_N-00278-28841358,2022-09-23T14:35:31,Galdakao,Expense,transport,-60.63,-8722.53
buyer_4,Jorge,50,ES97209511410504980753,TRX_N-00279-70382902,2022-09-23T12:01:51,Zuia,Expense,leisure,-77.01,-8799.54
buyer_4,Jorge,50,ES97209511410504980753,TRX_N-00280-18077156,2022-09-23T09:11:56,Galdakao,Expense,cash,-100.0,-8899.54
buyer_4,Jorge,50,ES97209511410504980753,TRX_N-00281-96351665,2022-09-23T10:57:19,Galdakao,Expense,repairs,-63.34,-8962.88
buyer_4,Jorge,50,ES97209511410504980753,TRX_N-00282-98678986,2022-09-26T04:07:26,Galdakao,Expense,leisure,-38.52,-9001.4
buyer_4,Jorge,50,ES97209511410504980753,TRX_N-00283-28631162,2022-09-26T19:51:58,Zarautz,Expense,repairs,-139.89,-9141.29
buyer_4,Jorge,50,ES97209511410504980753,TRX_N-00284-42811242,2022-09-27T15:43:19,Galdakao,Expense,gifts,-138.26,-9279.55
buyer_4,Jorge,50,ES97209511410504980753,TRX_N-00285-32705481,2022-09-29T19:21:26,Basauri,Expense,education,-62.78,-9342.33
buyer_4,Jorge,50,ES97209511410504980753,TRX_N-00286-13807370,2022-09-30T02:29:53,Galdakao,Expense,education,-51.87,-9394.2
buyer_4,Jorge,50,ES97209511410504980753,TRX_N-00287-57101016,2022-09-30T00:41:42,Hondarribia,Expense,repairs,-260.49,-9654.69
buyer_4,Jorge,50,ES97209511410504980753,TRX_N-00288-69917267,2022-10-01T13:30:37,Galdakao,incomes,salary,1474.03,-8180.66
buyer_4,Jorge,50,ES97209511410504980753,TRX_N-00289-47586610,2022-10-01T13:30:37,Galdakao,incomes,salary_partner,1195.75,-6984.91
buyer_4,Jorge,50,ES97209511410504980753,TRX_N-00290-41166600,2022-10-01T13:30:37,Galdakao,incomes,extra_income,273.62,-6711.29
buyer_4,Jorge,50,ES97209511410504980753,TRX_N-00291-08658453,2022-10-01T20:33:54,Galdakao,Expense,transport,-71.69,-6782.98
buyer_4,Jorge,50,ES97209511410504980753,TRX_N-00292-33442598,2022-10-01T13:50:59,Galdakao,Expense,travel,-1293.68,-8076.66
buyer_4,Jorge,50,ES97209511410504980753,TRX_N-00293-11058809,2022-10-01T14:39:02,Galdakao,Expense,repairs,-237.59,-8314.25
buyer_4,Jorge,50,ES97209511410504980753,TRX_N-00294-88536588,2022-10-03T09:39:47,Galdakao,Expense,gifts,-685.54,-8999.79
buyer_4,Jorge,50,ES97209511410504980753,TRX_N-00295-66660078,2022-10-04T16:27:03,Galdakao,expenses,mortgage,-863.85,-9863.64
buyer_4,Jorge,50,ES97209511410504980753,TRX_N-00296-12608973,2022-10-05T12:51:38,Galdakao,Expense,food,-108.86,-9972.5
buyer_4,Jorge,50,ES97209511410504980753,TRX_N-00297-03010190,2022-10-05T08:21:25,Galdakao,Expense,leisure,-56.72,-10029.22
buyer_4,Jorge,50,ES97209511410504980753,TRX_N-00298-28097186,2022-10-05T18:41:45,Galdakao,Expense,cash,-100.0,-10129.22
buyer_4,Jorge,50,ES97209511410504980753,TRX_N-00299-35791448,2022-10-06T07:39:55,Galdakao,expenses,electricity,-84.39,-10213.61
buyer_4,Jorge,50,ES97209511410504980753,TRX_N-00300-16567016,2022-10-06T15:51:46,Galdakao,expenses,gas,-95.78,-10309.39
buyer_4,Jorge,50,ES97209511410504980753,TRX_N-00301-54294772,2022-10-07T08:24:13,Galdakao,Expense,cash,-100.0,-10409.39
buyer_4,Jorge,50,ES97209511410504980753,TRX_N-00302-01247343,2022-10-08T20:17:26,Galdakao,expenses,water,-41.51,-10450.9
buyer_4,Jorge,50,ES97209511410504980753,TRX_N-00303-17403496,2022-10-08T21:45:12,Galdakao,expenses,internet,-42.0,-10492.9
buyer_4,Jorge,50,ES97209511410504980753,TRX_N-00304-39641889,2022-10-08T20:45:29,Galdakao,expenses,phone,-42.12,-10535.02
buyer_4,Jorge,50,ES97209511410504980753,TRX_N-00305-65768424,2022-10-10T09:20:19,Galdakao,Expense,leisure,-19.12,-10554.14
buyer_4,Jorge,50,ES97209511410504980753,TRX_N-00306-88908031,2022-10-11T13:54:39,Galdakao,Expense,leisure,-41.63,-10595.77
buyer_4,Jorge,50,ES97209511410504980753,TRX_N-00307-73295894,2022-10-12T16:44:08,Galdakao,Expense,leisure,-59.43,-10655.2
buyer_4,Jorge,50,ES97209511410504980753,TRX_N-00308-02621946,2022-10-13T07:01:38,Galdakao,Expense,clothing,-155.68,-10810.88
buyer_4,Jorge,50,ES97209511410504980753,TRX_N-00309-74358770,2022-10-13T14:14:03,Galdakao,Expense,cash,-100.0,-10910.88
buyer_4,Jorge,50,ES97209511410504980753,TRX_N-00310-00479729,2022-10-15T11:34:55,Galdakao,Expense,food,-90.37,-11001.25
buyer_4,Jorge,50,ES97209511410504980753,TRX_N-00311-81208957,2022-10-15T20:08:21,Alegr√≠a-Dulantzi,Expense,cash,-100.0,-11101.25
buyer_4,Jorge,50,ES97209511410504980753,TRX_N-00312-27864727,2022-10-16T20:40:48,Galdakao,Expense,clothing,-95.54,-11196.79
buyer_4,Jorge,50,ES97209511410504980753,TRX_N-00313-43600380,2022-10-17T14:14:36,Galdakao,Expense,food,-81.32,-11278.11
buyer_4,Jorge,50,ES97209511410504980753,TRX_N-00314-39023050,2022-10-17T18:04:26,Galdakao,Expense,gifts,-706.49,-11984.6
buyer_4,Jorge,50,ES97209511410504980753,TRX_N-00315-66535347,2022-10-18T21:19:58,Galdakao,Expense,transport,-81.19,-12065.79
buyer_4,Jorge,50,ES97209511410504980753,TRX_N-00316-70358646,2022-10-20T19:23:57,Bilbao,Expense,transport,-67.32,-12133.11
buyer_4,Jorge,50,ES97209511410504980753,TRX_N-00317-85611072,2022-10-22T20:14:15,Galdakao,Expense,cash,-100.0,-12233.11
buyer_4,Jorge,50,ES97209511410504980753,TRX_N-00318-14139845,2022-10-23T09:15:45,Galdakao,Expense,clothing,-68.94,-12302.05
buyer_4,Jorge,50,ES97209511410504980753,TRX_N-00319-79454241,2022-10-24T19:14:14,Galdakao,Expense,transport,-63.02,-12365.07
buyer_4,Jorge,50,ES97209511410504980753,TRX_N-00320-63964078,2022-10-24T14:34:18,Galdakao,Expense,repairs,-85.59,-12450.66
buyer_4,Jorge,50,ES97209511410504980753,TRX_N-00321-35951016,2022-10-26T08:12:07,Galdakao,Expense,food,-77.7,-12528.36
buyer_4,Jorge,50,ES97209511410504980753,TRX_N-00322-71237976,2022-10-27T19:50:48,Galdakao,Expense,travel,-732.61,-13260.97
buyer_4,Jorge,50,ES97209511410504980753,TRX_N-00323-28072847,2022-10-27T08:47:49,Santurtzi,Expense,repairs,-200.4,-13461.37
buyer_4,Jorge,50,ES97209511410504980753,TRX_N-00324-03692744,2022-10-28T19:45:36,Galdakao,expenses,children,-112.31,-13573.68
buyer_4,Jorge,50,ES97209511410504980753,TRX_N-00325-38552102,2022-10-30T15:04:16,Galdakao,Expense,transport,-79.99,-13653.67
buyer_4,Jorge,50,ES97209511410504980753,TRX_N-00326-50097202,2022-10-31T15:19:31,Galdakao,Expense,appliances,-190.26,-13843.93
buyer_4,Jorge,50,ES97209511410504980753,TRX_N-00327-23998050,2022-11-01T14:34:47,Galdakao,incomes,salary,1474.03,-12369.9
buyer_4,Jorge,50,ES97209511410504980753,TRX_N-00328-47731417,2022-11-01T14:34:47,Galdakao,incomes,salary_partner,1195.75,-11174.15
buyer_4,Jorge,50,ES97209511410504980753,TRX_N-00329-83719669,2022-11-01T13:06:41,Galdakao,Expense,food,-76.03,-11250.18
buyer_4,Jorge,50,ES97209511410504980753,TRX_N-00330-13516077,2022-11-02T23:45:24,Elciego,Expense,transport,-40.77,-11290.95
buyer_4,Jorge,50,ES97209511410504980753,TRX_N-00331-91153668,2022-11-02T12:10:37,Galdakao,Expense,cash,-100.0,-11390.95
buyer_4,Jorge,50,ES97209511410504980753,TRX_N-00332-34482744,2022-11-02T16:53:15,Galdakao,Expense,appliances,-202.37,-11593.32
buyer_4,Jorge,50,ES97209511410504980753,TRX_N-00333-37018980,2022-11-04T20:33:40,Galdakao,expenses,mortgage,-863.85,-12457.17
buyer_4,Jorge,50,ES97209511410504980753,TRX_N-00334-95340536,2022-11-04T13:58:04,Galdakao,Expense,food,-118.12,-12575.29
buyer_4,Jorge,50,ES97209511410504980753,TRX_N-00335-14711519,2022-11-04T03:48:40,Bermeo,Expense,leisure,-20.94,-12596.23
buyer_4,Jorge,50,ES97209511410504980753,TRX_N-00336-02211002,2022-11-04T03:24:54,Galdakao,Expense,appliances,-117.61,-12713.84
buyer_4,Jorge,50,ES97209511410504980753,TRX_N-00337-23229170,2022-11-05T18:42:56,Galdakao,expenses,water,-39.01,-12752.85
buyer_4,Jorge,50,ES97209511410504980753,TRX_N-00338-76543565,2022-11-05T16:29:08,Galdakao,expenses,internet,-42.0,-12794.85
buyer_4,Jorge,50,ES97209511410504980753,TRX_N-00339-88111626,2022-11-05T20:38:02,Galdakao,Expense,education,-43.71,-12838.56
buyer_4,Jorge,50,ES97209511410504980753,TRX_N-00340-34274752,2022-11-05T08:36:33,Galdakao,Expense,cash,-100.0,-12938.56
buyer_4,Jorge,50,ES97209511410504980753,TRX_N-00341-97787495,2022-11-06T17:07:28,Galdakao,expenses,electricity,-67.82,-13006.38
buyer_4,Jorge,50,ES97209511410504980753,TRX_N-00342-92342985,2022-11-06T14:00:35,Galdakao,Expense,food,-112.85,-13119.23
buyer_4,Jorge,50,ES97209511410504980753,TRX_N-00343-27990770,2022-11-07T08:28:14,Galdakao,expenses,gas,-79.44,-13198.67
buyer_4,Jorge,50,ES97209511410504980753,TRX_N-00344-91101089,2022-11-08T08:16:35,Galdakao,expenses,phone,-32.01,-13230.68
buyer_4,Jorge,50,ES97209511410504980753,TRX_N-00345-99042806,2022-11-08T17:16:04,Galdakao,Expense,food,-75.73,-13306.41
buyer_4,Jorge,50,ES97209511410504980753,TRX_N-00346-88076360,2022-11-08T23:24:39,Galdakao,Expense,healthcare,-151.08,-13457.49
buyer_4,Jorge,50,ES97209511410504980753,TRX_N-00347-24814172,2022-11-08T22:16:40,Galdakao,Expense,cash,-100.0,-13557.49
buyer_4,Jorge,50,ES97209511410504980753,TRX_N-00348-16860880,2022-11-09T19:19:28,Galdakao,Expense,transport,-70.46,-13627.95
buyer_4,Jorge,50,ES97209511410504980753,TRX_N-00349-13170173,2022-11-09T18:41:30,Galdakao,Expense,cash,-100.0,-13727.95
buyer_4,Jorge,50,ES97209511410504980753,TRX_N-00350-24935365,2022-11-09T00:51:22,Santurtzi,Expense,repairs,-168.44,-13896.39
buyer_4,Jorge,50,ES97209511410504980753,TRX_N-00351-15542725,2022-11-13T06:19:12,Galdakao,Expense,food,-119.41,-14015.8
buyer_4,Jorge,50,ES97209511410504980753,TRX_N-00352-53752352,2022-11-13T18:31:49,Galdakao,Expense,gifts,-225.11,-14240.91
buyer_4,Jorge,50,ES97209511410504980753,TRX_N-00353-64869739,2022-11-14T10:07:49,Alegr√≠a-Dulantzi,Expense,cash,-100.0,-14340.91
buyer_4,Jorge,50,ES97209511410504980753,TRX_N-00354-72524811,2022-11-15T16:59:34,Galdakao,Expense,appliances,-269.63,-14610.54
buyer_4,Jorge,50,ES97209511410504980753,TRX_N-00355-92895632,2022-11-17T19:05:15,Galdakao,Expense,gifts,-180.89,-14791.43
buyer_4,Jorge,50,ES97209511410504980753,TRX_N-00356-97573581,2022-11-18T20:28:09,Galdakao,Expense,leisure,-55.66,-14847.09
buyer_4,Jorge,50,ES97209511410504980753,TRX_N-00357-17106358,2022-11-20T17:26:04,Galdakao,Expense,cash,-100.0,-14947.09
buyer_4,Jorge,50,ES97209511410504980753,TRX_N-00358-87962489,2022-11-20T20:18:50,Galdakao,Expense,repairs,-88.8,-15035.89
buyer_4,Jorge,50,ES97209511410504980753,TRX_N-00359-38810223,2022-11-21T14:08:38,Galdakao,Expense,transport,-73.57,-15109.46
buyer_4,Jorge,50,ES97209511410504980753,TRX_N-00360-96606349,2022-11-21T11:27:27,Getxo,Expense,travel,-439.25,-15548.71
buyer_4,Jorge,50,ES97209511410504980753,TRX_N-00361-27431605,2022-11-25T20:19:14,Galdakao,Expense,transport,-40.41,-15589.12
buyer_4,Jorge,50,ES97209511410504980753,TRX_N-00362-21728106,2022-11-26T15:13:49,Galdakao,Expense,education,-66.52,-15655.64
buyer_4,Jorge,50,ES97209511410504980753,TRX_N-00363-50717827,2022-11-26T17:32:17,Hondarribia,Expense,cash,-100.0,-15755.64
buyer_4,Jorge,50,ES97209511410504980753,TRX_N-00364-67479709,2022-11-28T19:29:43,Galdakao,Expense,travel,-1092.96,-16848.6
buyer_4,Jorge,50,ES97209511410504980753,TRX_N-00365-39428947,2022-11-28T10:40:16,Galdakao,expenses,children,-178.0,-17026.6
buyer_4,Jorge,50,ES97209511410504980753,TRX_N-00366-74659106,2022-12-01T12:30:10,Galdakao,incomes,salary,1474.03,-15552.57
buyer_4,Jorge,50,ES97209511410504980753,TRX_N-00367-33616559,2022-12-01T12:30:10,Galdakao,incomes,salary_partner,1195.75,-14356.82
buyer_4,Jorge,50,ES97209511410504980753,TRX_N-00368-12195795,2022-12-01T12:30:10,Galdakao,incomes,salary_bonus,1076.92,-13279.9
buyer_4,Jorge,50,ES97209511410504980753,TRX_N-00369-50000416,2022-12-01T12:30:10,Galdakao,incomes,salary_partner_bonus,898.42,-12381.48
buyer_4,Jorge,50,ES97209511410504980753,TRX_N-00370-09634251,2022-12-01T15:59:36,Galdakao,Expense,food,-96.58,-12478.06
buyer_4,Jorge,50,ES97209511410504980753,TRX_N-00371-45483155,2022-12-01T09:54:44,Llodio,Expense,cash,-100.0,-12578.06
buyer_4,Jorge,50,ES97209511410504980753,TRX_N-00372-96352070,2022-12-03T08:06:53,Galdakao,Expense,repairs,-293.19,-12871.25
buyer_4,Jorge,50,ES97209511410504980753,TRX_N-00373-26839397,2022-12-04T08:05:17,Galdakao,expenses,mortgage,-863.85,-13735.1
buyer_4,Jorge,50,ES97209511410504980753,TRX_N-00374-24834341,2022-12-04T16:15:29,Berango,Expense,cash,-100.0,-13835.1
buyer_4,Jorge,50,ES97209511410504980753,TRX_N-00375-07953222,2022-12-05T16:01:11,Galdakao,expenses,water,-27.82,-13862.92
buyer_4,Jorge,50,ES97209511410504980753,TRX_N-00376-09560228,2022-12-06T08:38:14,Galdakao,expenses,electricity,-87.13,-13950.05
buyer_4,Jorge,50,ES97209511410504980753,TRX_N-00377-87643742,2022-12-06T18:06:19,Galdakao,expenses,internet,-42.0,-13992.05
buyer_4,Jorge,50,ES97209511410504980753,TRX_N-00378-76555048,2022-12-06T16:16:31,Galdakao,expenses,phone,-35.95,-14028.0
buyer_4,Jorge,50,ES97209511410504980753,TRX_N-00379-23920171,2022-12-08T20:41:24,Galdakao,expenses,gas,-38.18,-14066.18
buyer_4,Jorge,50,ES97209511410504980753,TRX_N-00380-25120681,2022-12-08T21:56:44,Galdakao,Expense,leisure,-76.51,-14142.69
buyer_4,Jorge,50,ES97209511410504980753,TRX_N-00381-63993660,2022-12-14T08:29:00,Erandio,Expense,food,-78.66,-14221.35
buyer_4,Jorge,50,ES97209511410504980753,TRX_N-00382-58269989,2022-12-14T09:16:22,Galdakao,Expense,clothing,-146.18,-14367.53
buyer_4,Jorge,50,ES97209511410504980753,TRX_N-00383-91970787,2022-12-14T08:10:39,Galdakao,Expense,repairs,-137.23,-14504.76
buyer_4,Jorge,50,ES97209511410504980753,TRX_N-00384-34108720,2022-12-16T09:52:46,Galdakao,Expense,leisure,-30.92,-14535.68
buyer_4,Jorge,50,ES97209511410504980753,TRX_N-00385-47678835,2022-12-17T15:05:41,Galdakao,Expense,food,-86.06,-14621.74
buyer_4,Jorge,50,ES97209511410504980753,TRX_N-00386-48756053,2022-12-18T09:28:17,Galdakao,Expense,appliances,-280.89,-14902.63
buyer_4,Jorge,50,ES97209511410504980753,TRX_N-00387-08643620,2022-12-20T22:22:32,Galdakao,Expense,transport,-76.11,-14978.74
buyer_4,Jorge,50,ES97209511410504980753,TRX_N-00388-90531972,2022-12-21T10:31:07,Galdakao,Expense,transport,-53.17,-15031.91
buyer_4,Jorge,50,ES97209511410504980753,TRX_N-00389-14960876,2022-12-22T10:12:23,Galdakao,Expense,food,-90.35,-15122.26
buyer_4,Jorge,50,ES97209511410504980753,TRX_N-00390-94711707,2022-12-22T18:24:18,Galdakao,Expense,transport,-72.3,-15194.56
buyer_4,Jorge,50,ES97209511410504980753,TRX_N-00391-63714640,2022-12-23T17:18:56,Galdakao,Expense,repairs,-100.52,-15295.08
buyer_4,Jorge,50,ES97209511410504980753,TRX_N-00392-93598071,2022-12-24T13:37:11,Galdakao,Expense,leisure,-42.12,-15337.2
buyer_4,Jorge,50,ES97209511410504980753,TRX_N-00393-60588003,2022-12-24T13:45:54,Berango,Expense,cash,-100.0,-15437.2
buyer_4,Jorge,50,ES97209511410504980753,TRX_N-00394-00417521,2022-12-25T16:57:59,Iru√±a de Oca,Expense,food,-72.81,-15510.01
buyer_4,Jorge,50,ES97209511410504980753,TRX_N-00395-58960843,2022-12-26T08:02:12,Galdakao,Expense,cash,-100.0,-15610.01
buyer_4,Jorge,50,ES97209511410504980753,TRX_N-00396-87120686,2022-12-27T04:41:19,Zarautz,Expense,leisure,-79.76,-15689.77
buyer_4,Jorge,50,ES97209511410504980753,TRX_N-00397-30080847,2022-12-28T17:07:45,Galdakao,Expense,leisure,-79.45,-15769.22
buyer_4,Jorge,50,ES97209511410504980753,TRX_N-00398-03917867,2022-12-30T22:08:41,Galdakao,Expense,cash,-100.0,-15869.22
buyer_4,Jorge,50,ES97209511410504980753,TRX_N-00399-63470596,2022-12-30T14:32:38,Galdakao,Expense,gifts,-111.71,-15980.93
buyer_4,Jorge,50,ES97209511410504980753,TRX_N-00400-96274128,2022-12-31T13:24:43,Iru√±a de Oca,Expense,leisure,-30.96,-16011.89
buyer_4,Jorge,50,ES97209511410504980753,TRX_N-00401-19125580,2023-01-01T14:04:31,Galdakao,incomes,salary,1526.6,-14485.29
buyer_4,Jorge,50,ES97209511410504980753,TRX_N-00402-00754601,2023-01-01T14:04:31,Galdakao,incomes,salary_partner,1238.4,-13246.89
buyer_4,Jorge,50,ES97209511410504980753,TRX_N-00403-93739694,2023-01-01T14:43:06,Galdakao,Expense,leisure,-19.02,-13265.91
buyer_4,Jorge,50,ES97209511410504980753,TRX_N-00404-71143751,2023-01-02T22:45:24,Galdakao,Expense,repairs,-195.88,-13461.79
buyer_4,Jorge,50,ES97209511410504980753,TRX_N-00405-46824787,2023-01-03T15:48:56,Galdakao,Expense,cash,-100.0,-13561.79
buyer_4,Jorge,50,ES97209511410504980753,TRX_N-00406-40238277,2023-01-04T07:17:54,Galdakao,expenses,mortgage,-863.85,-14425.64
buyer_4,Jorge,50,ES97209511410504980753,TRX_N-00407-87672112,2023-01-04T17:15:55,Galdakao,Expense,leisure,-63.31,-14488.95
buyer_4,Jorge,50,ES97209511410504980753,TRX_N-00408-34488341,2023-01-04T16:53:22,Galdakao,Expense,repairs,-118.86,-14607.81
buyer_4,Jorge,50,ES97209511410504980753,TRX_N-00409-47401083,2023-01-05T09:10:33,Galdakao,expenses,water,-22.22,-14630.03
buyer_4,Jorge,50,ES97209511410504980753,TRX_N-00410-92635312,2023-01-05T08:46:31,Galdakao,expenses,electricity,-38.31,-14668.34
buyer_4,Jorge,50,ES97209511410504980753,TRX_N-00411-81668138,2023-01-05T18:08:21,Galdakao,Expense,transport,-75.09,-14743.43
buyer_4,Jorge,50,ES97209511410504980753,TRX_N-00412-44734869,2023-01-05T13:48:04,Galdakao,Expense,cash,-100.0,-14843.43
buyer_4,Jorge,50,ES97209511410504980753,TRX_N-00413-49480270,2023-01-07T11:15:08,Galdakao,Expense,leisure,-41.81,-14885.24
buyer_4,Jorge,50,ES97209511410504980753,TRX_N-00414-75820452,2023-01-07T17:58:48,Galdakao,Expense,cash,-100.0,-14985.24
buyer_4,Jorge,50,ES97209511410504980753,TRX_N-00415-32044279,2023-01-08T14:48:43,Galdakao,expenses,gas,-38.39,-15023.63
buyer_4,Jorge,50,ES97209511410504980753,TRX_N-00416-55575258,2023-01-08T11:29:34,Galdakao,expenses,internet,-42.0,-15065.63
buyer_4,Jorge,50,ES97209511410504980753,TRX_N-00417-66465397,2023-01-08T10:45:04,Galdakao,expenses,phone,-36.66,-15102.29
buyer_4,Jorge,50,ES97209511410504980753,TRX_N-00418-42658882,2023-01-09T17:14:41,Galdakao,Expense,food,-103.08,-15205.37
buyer_4,Jorge,50,ES97209511410504980753,TRX_N-00419-59427375,2023-01-10T11:11:57,Bermeo,Expense,leisure,-54.15,-15259.52
buyer_4,Jorge,50,ES97209511410504980753,TRX_N-00420-42365897,2023-01-10T21:38:06,Galdakao,Expense,healthcare,-63.89,-15323.41
buyer_4,Jorge,50,ES97209511410504980753,TRX_N-00421-51755320,2023-01-10T15:25:56,Salvatierra/Agurain,Expense,cash,-100.0,-15423.41
buyer_4,Jorge,50,ES97209511410504980753,TRX_N-00422-13318624,2023-01-11T01:30:32,Mungia,Expense,cash,-100.0,-15523.41
buyer_4,Jorge,50,ES97209511410504980753,TRX_N-00423-31775548,2023-01-11T13:02:51,Galdakao,expenses,children,-214.39,-15737.8
buyer_4,Jorge,50,ES97209511410504980753,TRX_N-00424-02451097,2023-01-12T10:23:23,Galdakao,Expense,cash,-100.0,-15837.8
buyer_4,Jorge,50,ES97209511410504980753,TRX_N-00425-20401781,2023-01-13T08:23:06,Galdakao,Expense,cash,-100.0,-15937.8
buyer_4,Jorge,50,ES97209511410504980753,TRX_N-00426-17219443,2023-01-14T03:54:07,Galdakao,Expense,leisure,-62.97,-16000.77
buyer_4,Jorge,50,ES97209511410504980753,TRX_N-00427-29661284,2023-01-16T08:38:42,Galdakao,Expense,cash,-100.0,-16100.77
buyer_4,Jorge,50,ES97209511410504980753,TRX_N-00428-27663740,2023-01-17T10:13:21,Galdakao,Expense,transport,-42.76,-16143.53
buyer_4,Jorge,50,ES97209511410504980753,TRX_N-00429-00565613,2023-01-18T10:10:45,Galdakao,Expense,cash,-100.0,-16243.53
buyer_4,Jorge,50,ES97209511410504980753,TRX_N-00430-31495696,2023-01-20T17:18:33,Galdakao,Expense,cash,-100.0,-16343.53
buyer_4,Jorge,50,ES97209511410504980753,TRX_N-00431-33661504,2023-01-21T19:22:59,Galdakao,Expense,cash,-100.0,-16443.53
buyer_4,Jorge,50,ES97209511410504980753,TRX_N-00432-75443958,2023-01-22T20:13:56,Alegr√≠a-Dulantzi,Expense,transport,-86.03,-16529.56
buyer_4,Jorge,50,ES97209511410504980753,TRX_N-00433-01179221,2023-01-23T13:05:12,Llodio,Expense,gifts,-166.61,-16696.17
buyer_4,Jorge,50,ES97209511410504980753,TRX_N-00434-97120818,2023-01-24T11:38:18,Galdakao,Expense,gifts,-52.65,-16748.82
buyer_4,Jorge,50,ES97209511410504980753,TRX_N-00435-23821504,2023-01-25T22:36:28,Galdakao,Expense,healthcare,-134.16,-16882.98
buyer_4,Jorge,50,ES97209511410504980753,TRX_N-00436-40506097,2023-01-28T14:18:19,Galdakao,Expense,clothing,-84.93,-16967.91
buyer_4,Jorge,50,ES97209511410504980753,TRX_N-00437-84614169,2023-01-30T11:27:11,Galdakao,Expense,transport,-46.64,-17014.55
buyer_4,Jorge,50,ES97209511410504980753,TRX_N-00438-03144042,2023-01-30T19:04:33,Galdakao,Expense,leisure,-26.52,-17041.07
buyer_4,Jorge,50,ES97209511410504980753,TRX_N-00439-05649922,2023-02-01T19:58:33,Galdakao,incomes,salary,1526.6,-15514.47
buyer_4,Jorge,50,ES97209511410504980753,TRX_N-00440-84877857,2023-02-01T19:58:33,Galdakao,incomes,salary_partner,1238.4,-14276.07
buyer_4,Jorge,50,ES97209511410504980753,TRX_N-00441-60850787,2023-02-01T19:58:33,Galdakao,incomes,extra_income,273.62,-14002.45
buyer_4,Jorge,50,ES97209511410504980753,TRX_N-00442-36467962,2023-02-01T11:40:06,Galdakao,Expense,clothing,-118.01,-14120.46
buyer_4,Jorge,50,ES97209511410504980753,TRX_N-00443-98568435,2023-02-01T11:18:57,Galdakao,Expense,repairs,-97.62,-14218.08
buyer_4,Jorge,50,ES97209511410504980753,TRX_N-00444-30018067,2023-02-02T10:23:09,Galdakao,Expense,food,-114.04,-14332.12
buyer_4,Jorge,50,ES97209511410504980753,TRX_N-00445-63231292,2023-02-02T18:23:36,Galdakao,Expense,repairs,-74.71,-14406.83
buyer_4,Jorge,50,ES97209511410504980753,TRX_N-00446-79213681,2023-02-03T19:12:38,Galdakao,Expense,transport,-65.01,-14471.84
buyer_4,Jorge,50,ES97209511410504980753,TRX_N-00447-54033181,2023-02-04T18:45:52,Galdakao,expenses,mortgage,-863.85,-15335.69
buyer_4,Jorge,50,ES97209511410504980753,TRX_N-00448-09268675,2023-02-04T09:50:01,Galdakao,Expense,transport,-77.17,-15412.86
buyer_4,Jorge,50,ES97209511410504980753,TRX_N-00449-86000820,2023-02-04T10:13:31,Galdakao,Expense,leisure,-56.68,-15469.54
buyer_4,Jorge,50,ES97209511410504980753,TRX_N-00450-12352158,2023-02-05T20:50:27,Galdakao,expenses,electricity,-55.42,-15524.96
buyer_4,Jorge,50,ES97209511410504980753,TRX_N-00451-80536805,2023-02-06T08:35:41,Galdakao,expenses,phone,-34.55,-15559.51
buyer_4,Jorge,50,ES97209511410504980753,TRX_N-00452-47015211,2023-02-07T14:41:32,Galdakao,Expense,food,-119.35,-15678.86
buyer_4,Jorge,50,ES97209511410504980753,TRX_N-00453-07437855,2023-02-08T16:33:37,Galdakao,expenses,water,-20.56,-15699.42
buyer_4,Jorge,50,ES97209511410504980753,TRX_N-00454-86026593,2023-02-08T16:25:25,Galdakao,expenses,gas,-55.56,-15754.98
buyer_4,Jorge,50,ES97209511410504980753,TRX_N-00455-29044816,2023-02-08T10:11:29,Galdakao,expenses,internet,-42.0,-15796.98
buyer_4,Jorge,50,ES97209511410504980753,TRX_N-00456-01539253,2023-02-08T09:33:25,Galdakao,Expense,leisure,-32.98,-15829.96
buyer_4,Jorge,50,ES97209511410504980753,TRX_N-00457-19489643,2023-02-11T22:12:01,Galdakao,Expense,leisure,-52.07,-15882.03
buyer_4,Jorge,50,ES97209511410504980753,TRX_N-00458-38759073,2023-02-11T11:39:22,Galdakao,Expense,repairs,-234.99,-16117.02
buyer_4,Jorge,50,ES97209511410504980753,TRX_N-00459-90629095,2023-02-12T15:19:34,Galdakao,Expense,food,-101.32,-16218.34
buyer_4,Jorge,50,ES97209511410504980753,TRX_N-00460-33493271,2023-02-12T13:29:16,Llodio,Expense,leisure,-65.78,-16284.12
buyer_4,Jorge,50,ES97209511410504980753,TRX_N-00461-48828733,2023-02-12T12:14:37,Galdakao,expenses,children,-81.2,-16365.32
buyer_4,Jorge,50,ES97209511410504980753,TRX_N-00462-28106603,2023-02-14T08:01:55,Erandio,Expense,gifts,-312.37,-16677.69
buyer_4,Jorge,50,ES97209511410504980753,TRX_N-00463-53449894,2023-02-16T20:14:01,Galdakao,Expense,cash,-100.0,-16777.69
buyer_4,Jorge,50,ES97209511410504980753,TRX_N-00464-14439089,2023-02-17T18:17:50,Galdakao,Expense,transport,-42.4,-16820.09
buyer_4,Jorge,50,ES97209511410504980753,TRX_N-00465-17924541,2023-02-17T18:56:49,Galdakao,Expense,travel,-1298.85,-18118.94
buyer_4,Jorge,50,ES97209511410504980753,TRX_N-00466-49005028,2023-02-18T10:46:16,Galdakao,Expense,transport,-61.46,-18180.4
buyer_4,Jorge,50,ES97209511410504980753,TRX_N-00467-51697148,2023-02-19T08:01:12,Galdakao,Expense,food,-123.45,-18303.85
buyer_4,Jorge,50,ES97209511410504980753,TRX_N-00468-06765969,2023-02-20T13:49:00,Galdakao,Expense,food,-95.87,-18399.72
buyer_4,Jorge,50,ES97209511410504980753,TRX_N-00469-90477890,2023-02-20T19:13:40,Galdakao,Expense,leisure,-55.33,-18455.05
buyer_4,Jorge,50,ES97209511410504980753,TRX_N-00470-71479922,2023-02-21T09:02:14,Hernani,Expense,transport,-87.73,-18542.78
buyer_4,Jorge,50,ES97209511410504980753,TRX_N-00471-59791655,2023-02-23T16:34:29,Galdakao,Expense,cash,-100.0,-18642.78
buyer_4,Jorge,50,ES97209511410504980753,TRX_N-00472-62005944,2023-02-27T17:56:05,Galdakao,Expense,food,-82.7,-18725.48
buyer_4,Jorge,50,ES97209511410504980753,TRX_N-00473-19534891,2023-02-27T20:59:57,Galdakao,Expense,transport,-83.71,-18809.19
buyer_4,Jorge,50,ES97209511410504980753,TRX_N-00474-65040953,2023-02-28T11:38:53,Hernani,Expense,cash,-100.0,-18909.19
buyer_4,Jorge,50,ES97209511410504980753,TRX_N-00475-76319170,2023-03-01T18:26:16,Galdakao,incomes,salary,1526.6,-17382.59
buyer_4,Jorge,50,ES97209511410504980753,TRX_N-00476-76153553,2023-03-01T18:26:16,Galdakao,incomes,salary_partner,1238.4,-16144.19
buyer_4,Jorge,50,ES97209511410504980753,TRX_N-00477-87613229,2023-03-02T20:29:14,Galdakao,Expense,clothing,-155.64,-16299.83
buyer_4,Jorge,50,ES97209511410504980753,TRX_N-00478-90583187,2023-03-02T00:38:22,Galdakao,expenses,children,-171.87,-16471.7
buyer_4,Jorge,50,ES97209511410504980753,TRX_N-00479-18939713,2023-03-03T13:52:11,Galdakao,Expense,cash,-100.0,-16571.7
buyer_4,Jorge,50,ES97209511410504980753,TRX_N-00480-31509272,2023-03-04T20:57:04,Galdakao,expenses,mortgage,-863.85,-17435.55
buyer_4,Jorge,50,ES97209511410504980753,TRX_N-00481-60849304,2023-03-04T09:49:55,Galdakao,Expense,food,-122.11,-17557.66
buyer_4,Jorge,50,ES97209511410504980753,TRX_N-00482-76119331,2023-03-04T07:15:49,Galdakao,Expense,transport,-85.61,-17643.27
buyer_4,Jorge,50,ES97209511410504980753,TRX_N-00483-91050677,2023-03-04T09:26:56,Galdakao,Expense,leisure,-39.13,-17682.4
buyer_4,Jorge,50,ES97209511410504980753,TRX_N-00484-83433494,2023-03-04T12:15:15,Galdakao,Expense,gifts,-152.69,-17835.09
buyer_4,Jorge,50,ES97209511410504980753,TRX_N-00485-23829010,2023-03-05T13:38:05,Galdakao,expenses,water,-30.84,-17865.93
buyer_4,Jorge,50,ES97209511410504980753,TRX_N-00486-69529697,2023-03-05T17:37:42,Galdakao,Expense,repairs,-146.24,-18012.17
buyer_4,Jorge,50,ES97209511410504980753,TRX_N-00487-75946968,2023-03-06T04:56:09,Galdakao,expenses,electricity,-27.93,-18040.1
buyer_4,Jorge,50,ES97209511410504980753,TRX_N-00488-97919473,2023-03-06T13:27:58,Galdakao,expenses,gas,-95.57,-18135.67
buyer_4,Jorge,50,ES97209511410504980753,TRX_N-00489-34205973,2023-03-08T08:17:51,Galdakao,expenses,internet,-42.0,-18177.67
buyer_4,Jorge,50,ES97209511410504980753,TRX_N-00490-53771956,2023-03-08T10:46:30,Galdakao,expenses,phone,-41.25,-18218.92
buyer_4,Jorge,50,ES97209511410504980753,TRX_N-00491-05129862,2023-03-08T21:10:58,Galdakao,Expense,transport,-43.05,-18261.97
buyer_4,Jorge,50,ES97209511410504980753,TRX_N-00492-79048146,2023-03-08T15:05:09,Galdakao,Expense,cash,-100.0,-18361.97
buyer_4,Jorge,50,ES97209511410504980753,TRX_N-00493-65986863,2023-03-09T17:13:31,Mungia,Expense,food,-81.96,-18443.93
buyer_4,Jorge,50,ES97209511410504980753,TRX_N-00494-70791140,2023-03-13T05:32:40,Galdakao,Expense,repairs,-201.42,-18645.35
buyer_4,Jorge,50,ES97209511410504980753,TRX_N-00495-65298787,2023-03-13T17:10:30,Galdakao,Expense,gifts,-604.81,-19250.16
buyer_4,Jorge,50,ES97209511410504980753,TRX_N-00496-50218068,2023-03-14T20:26:25,Bermeo,Expense,healthcare,-94.12,-19344.28
buyer_4,Jorge,50,ES97209511410504980753,TRX_N-00497-64494324,2023-03-14T13:22:01,Galdakao,Expense,cash,-100.0,-19444.28
buyer_4,Jorge,50,ES97209511410504980753,TRX_N-00498-48916878,2023-03-15T12:00:07,Galdakao,Expense,food,-105.19,-19549.47
buyer_4,Jorge,50,ES97209511410504980753,TRX_N-00499-67138604,2023-03-15T09:03:16,Amurrio,Expense,clothing,-78.46,-19627.93
buyer_4,Jorge,50,ES97209511410504980753,TRX_N-00500-58269076,2023-03-17T09:20:42,Galdakao,Expense,food,-70.82,-19698.75
buyer_4,Jorge,50,ES97209511410504980753,TRX_N-00501-81536749,2023-03-17T22:51:26,Bilbao,Expense,gifts,-32.83,-19731.58
buyer_4,Jorge,50,ES97209511410504980753,TRX_N-00502-02671638,2023-03-19T11:11:36,Galdakao,Expense,food,-62.57,-19794.15
buyer_4,Jorge,50,ES97209511410504980753,TRX_N-00503-68576687,2023-03-19T19:49:52,Galdakao,Expense,education,-60.56,-19854.71
buyer_4,Jorge,50,ES97209511410504980753,TRX_N-00504-05462459,2023-03-20T19:44:39,Galdakao,Expense,appliances,-287.6,-20142.31
buyer_4,Jorge,50,ES97209511410504980753,TRX_N-00505-07885523,2023-03-21T10:22:00,Galdakao,Expense,transport,-75.25,-20217.56
buyer_4,Jorge,50,ES97209511410504980753,TRX_N-00506-92084609,2023-03-21T12:36:35,Bilbao,Expense,leisure,-38.82,-20256.38
buyer_4,Jorge,50,ES97209511410504980753,TRX_N-00507-08724020,2023-03-21T15:10:28,Galdakao,Expense,repairs,-305.7,-20562.08
buyer_4,Jorge,50,ES97209511410504980753,TRX_N-00508-77811938,2023-03-23T21:36:07,Galdakao,Expense,repairs,-325.96,-20888.04
buyer_4,Jorge,50,ES97209511410504980753,TRX_N-00509-02677317,2023-03-24T10:17:16,Santurtzi,Expense,repairs,-104.48,-20992.52
buyer_4,Jorge,50,ES97209511410504980753,TRX_N-00510-73074420,2023-03-28T08:06:01,Galdakao,Expense,leisure,-18.02,-21010.54
buyer_4,Jorge,50,ES97209511410504980753,TRX_N-00511-76753488,2023-03-29T14:11:21,Bilbao,Expense,leisure,-74.51,-21085.05
buyer_4,Jorge,50,ES97209511410504980753,TRX_N-00512-70624939,2023-03-30T21:51:20,Galdakao,Expense,food,-82.26,-21167.31
buyer_4,Jorge,50,ES97209511410504980753,TRX_N-00513-08770243,2023-03-30T18:37:22,Galdakao,Expense,cash,-100.0,-21267.31
buyer_4,Jorge,50,ES97209511410504980753,TRX_N-00514-05918765,2023-03-31T19:45:52,Basauri,Expense,cash,-100.0,-21367.31
buyer_4,Jorge,50,ES97209511410504980753,TRX_N-00515-75962196,2023-04-01T12:04:24,Galdakao,incomes,salary,1526.6,-19840.71
buyer_4,Jorge,50,ES97209511410504980753,TRX_N-00516-12506487,2023-04-01T12:04:24,Galdakao,incomes,salary_partner,1238.4,-18602.31
buyer_4,Jorge,50,ES97209511410504980753,TRX_N-00517-84383508,2023-04-02T21:02:14,Erandio,Expense,education,-74.14,-18676.45
buyer_4,Jorge,50,ES97209511410504980753,TRX_N-00518-55089076,2023-04-03T20:37:52,Galdakao,Expense,food,-60.97,-18737.42
buyer_4,Jorge,50,ES97209511410504980753,TRX_N-00519-65254976,2023-04-03T04:49:56,Galdakao,Expense,leisure,-29.05,-18766.47
buyer_4,Jorge,50,ES97209511410504980753,TRX_N-00520-23971134,2023-04-03T10:37:48,Galdakao,Expense,cash,-100.0,-18866.47
buyer_4,Jorge,50,ES97209511410504980753,TRX_N-00521-73887998,2023-04-04T08:42:27,Galdakao,expenses,mortgage,-863.85,-19730.32
buyer_4,Jorge,50,ES97209511410504980753,TRX_N-00522-97213966,2023-04-04T21:25:56,Galdakao,Expense,cash,-100.0,-19830.32
buyer_4,Jorge,50,ES97209511410504980753,TRX_N-00523-12905752,2023-04-05T18:14:45,Galdakao,expenses,water,-43.25,-19873.57
buyer_4,Jorge,50,ES97209511410504980753,TRX_N-00524-07429464,2023-04-05T17:36:53,Galdakao,expenses,electricity,-20.11,-19893.68
buyer_4,Jorge,50,ES97209511410504980753,TRX_N-00525-81987626,2023-04-05T21:10:12,Galdakao,Expense,cash,-100.0,-19993.68
buyer_4,Jorge,50,ES97209511410504980753,TRX_N-00526-98239528,2023-04-06T18:26:43,Galdakao,Expense,transport,-51.22,-20044.9
buyer_4,Jorge,50,ES97209511410504980753,TRX_N-00527-66298177,2023-04-07T23:10:53,Galdakao,expenses,gas,-55.91,-20100.81
buyer_4,Jorge,50,ES97209511410504980753,TRX_N-00528-44617672,2023-04-08T11:44:15,Galdakao,expenses,internet,-42.0,-20142.81
buyer_4,Jorge,50,ES97209511410504980753,TRX_N-00529-86009142,2023-04-08T15:16:19,Galdakao,expenses,phone,-35.93,-20178.74
buyer_4,Jorge,50,ES97209511410504980753,TRX_N-00530-83941778,2023-04-08T16:47:38,Galdakao,Expense,cash,-100.0,-20278.74
buyer_4,Jorge,50,ES97209511410504980753,TRX_N-00531-22450048,2023-04-11T00:36:14,Galdakao,expenses,children,-151.95,-20430.69
buyer_4,Jorge,50,ES97209511410504980753,TRX_N-00532-86721855,2023-04-14T17:16:51,Sestao,Expense,food,-124.65,-20555.34
buyer_4,Jorge,50,ES97209511410504980753,TRX_N-00533-62749420,2023-04-14T13:43:00,Galdakao,Expense,cash,-100.0,-20655.34
buyer_4,Jorge,50,ES97209511410504980753,TRX_N-00534-84444474,2023-04-15T04:46:32,Salvatierra/Agurain,Expense,repairs,-194.03,-20849.37
buyer_4,Jorge,50,ES97209511410504980753,TRX_N-00535-04655193,2023-04-16T23:15:17,Galdakao,Expense,food,-60.47,-20909.84
buyer_4,Jorge,50,ES97209511410504980753,TRX_N-00536-44699811,2023-04-18T16:25:19,Sestao,Expense,cash,-100.0,-21009.84
buyer_4,Jorge,50,ES97209511410504980753,TRX_N-00537-47580197,2023-04-18T17:28:41,Galdakao,Expense,repairs,-187.46,-21197.3
buyer_4,Jorge,50,ES97209511410504980753,TRX_N-00538-99223128,2023-04-19T09:19:25,Galdakao,Expense,education,-56.35,-21253.65
buyer_4,Jorge,50,ES97209511410504980753,TRX_N-00539-11512742,2023-04-20T21:34:47,Galdakao,Expense,leisure,-73.77,-21327.42
buyer_4,Jorge,50,ES97209511410504980753,TRX_N-00540-50694627,2023-04-21T22:00:36,Hernani,Expense,transport,-70.59,-21398.01
buyer_4,Jorge,50,ES97209511410504980753,TRX_N-00541-87991644,2023-04-25T18:35:59,Galdakao,Expense,leisure,-68.1,-21466.11
buyer_4,Jorge,50,ES97209511410504980753,TRX_N-00542-91996151,2023-04-25T08:29:34,Galdakao,Expense,cash,-100.0,-21566.11
buyer_4,Jorge,50,ES97209511410504980753,TRX_N-00543-70842998,2023-04-26T06:41:41,Galdakao,Expense,clothing,-84.61,-21650.72
buyer_4,Jorge,50,ES97209511410504980753,TRX_N-00544-97815455,2023-04-26T16:23:17,Galdakao,Expense,appliances,-393.15,-22043.87
buyer_4,Jorge,50,ES97209511410504980753,TRX_N-00545-17678865,2023-04-28T11:23:39,Galdakao,Expense,food,-102.21,-22146.08
buyer_4,Jorge,50,ES97209511410504980753,TRX_N-00546-78854576,2023-04-29T11:06:09,Galdakao,Expense,leisure,-70.5,-22216.58
buyer_4,Jorge,50,ES97209511410504980753,TRX_N-00547-31999674,2023-04-29T13:10:47,Galdakao,Expense,clothing,-74.84,-22291.42
buyer_4,Jorge,50,ES97209511410504980753,TRX_N-00548-73963235,2023-04-30T11:44:43,Galdakao,Expense,transport,-72.18,-22363.6
buyer_4,Jorge,50,ES97209511410504980753,TRX_N-00549-06681886,2023-05-01T09:42:18,Galdakao,incomes,salary,1526.6,-20837.0
buyer_4,Jorge,50,ES97209511410504980753,TRX_N-00550-99412030,2023-05-01T09:42:18,Galdakao,incomes,salary_partner,1238.4,-19598.6
buyer_4,Jorge,50,ES97209511410504980753,TRX_N-00551-45804232,2023-05-01T17:15:16,Galdakao,Expense,cash,-100.0,-19698.6
buyer_4,Jorge,50,ES97209511410504980753,TRX_N-00552-97501512,2023-05-02T14:53:26,Galdakao,expenses,children,-205.19,-19903.79
buyer_4,Jorge,50,ES97209511410504980753,TRX_N-00553-40092756,2023-05-03T19:43:29,Galdakao,Expense,food,-100.91,-20004.7
buyer_4,Jorge,50,ES97209511410504980753,TRX_N-00554-32760275,2023-05-04T04:48:28,Galdakao,expenses,mortgage,-863.85,-20868.55
buyer_4,Jorge,50,ES97209511410504980753,TRX_N-00555-09495469,2023-05-04T13:18:03,Galdakao,Expense,gifts,-831.24,-21699.79
buyer_4,Jorge,50,ES97209511410504980753,TRX_N-00556-95854163,2023-05-05T01:00:21,Galdakao,expenses,electricity,-70.13,-21769.92
buyer_4,Jorge,50,ES97209511410504980753,TRX_N-00557-60333675,2023-05-05T22:40:29,Galdakao,Expense,food,-74.16,-21844.08
buyer_4,Jorge,50,ES97209511410504980753,TRX_N-00558-11659916,2023-05-05T12:28:26,Galdakao,Expense,transport,-45.3,-21889.38
buyer_4,Jorge,50,ES97209511410504980753,TRX_N-00559-12386825,2023-05-06T08:30:25,Galdakao,expenses,gas,-69.99,-21959.37
buyer_4,Jorge,50,ES97209511410504980753,TRX_N-00560-42941685,2023-05-06T10:05:29,Galdakao,expenses,internet,-42.0,-22001.37
buyer_4,Jorge,50,ES97209511410504980753,TRX_N-00561-46685300,2023-05-07T14:24:19,Galdakao,Expense,gifts,-199.74,-22201.11
buyer_4,Jorge,50,ES97209511410504980753,TRX_N-00562-75009545,2023-05-08T11:43:23,Galdakao,expenses,water,-23.64,-22224.75
buyer_4,Jorge,50,ES97209511410504980753,TRX_N-00563-30719313,2023-05-08T08:49:44,Galdakao,expenses,phone,-37.54,-22262.29
buyer_4,Jorge,50,ES97209511410504980753,TRX_N-00564-84942207,2023-05-08T13:13:09,Galdakao,Expense,cash,-100.0,-22362.29
buyer_4,Jorge,50,ES97209511410504980753,TRX_N-00565-30313215,2023-05-09T23:10:13,Galdakao,Expense,cash,-100.0,-22462.29
buyer_4,Jorge,50,ES97209511410504980753,TRX_N-00566-64609001,2023-05-10T09:29:14,Galdakao,Expense,food,-75.57,-22537.86
buyer_4,Jorge,50,ES97209511410504980753,TRX_N-00567-81661902,2023-05-10T09:01:14,Galdakao,Expense,cash,-100.0,-22637.86
buyer_4,Jorge,50,ES97209511410504980753,TRX_N-00568-37614794,2023-05-12T12:16:52,Galdakao,Expense,leisure,-40.73,-22678.59
buyer_4,Jorge,50,ES97209511410504980753,TRX_N-00569-41823611,2023-05-14T20:26:05,Galdakao,Expense,food,-97.76,-22776.35
buyer_4,Jorge,50,ES97209511410504980753,TRX_N-00570-07379396,2023-05-14T11:44:55,Galdakao,Expense,cash,-100.0,-22876.35
buyer_4,Jorge,50,ES97209511410504980753,TRX_N-00571-93519754,2023-05-17T15:19:21,Galdakao,Expense,food,-124.16,-23000.51
buyer_4,Jorge,50,ES97209511410504980753,TRX_N-00572-70291308,2023-05-19T19:29:53,Galdakao,Expense,cash,-100.0,-23100.51
buyer_4,Jorge,50,ES97209511410504980753,TRX_N-00573-87488765,2023-05-19T13:43:23,Durango,Expense,repairs,-130.84,-23231.35
buyer_4,Jorge,50,ES97209511410504980753,TRX_N-00574-59953852,2023-05-20T13:06:14,Galdakao,Expense,cash,-100.0,-23331.35
buyer_4,Jorge,50,ES97209511410504980753,TRX_N-00575-71452524,2023-05-21T13:53:53,Galdakao,Expense,repairs,-266.07,-23597.42
buyer_4,Jorge,50,ES97209511410504980753,TRX_N-00576-73536285,2023-05-22T08:33:42,Galdakao,Expense,food,-110.7,-23708.12
buyer_4,Jorge,50,ES97209511410504980753,TRX_N-00577-02501497,2023-05-23T19:20:12,Irun,Expense,clothing,-75.07,-23783.19
buyer_4,Jorge,50,ES97209511410504980753,TRX_N-00578-41385035,2023-05-24T20:33:43,Galdakao,Expense,food,-98.67,-23881.86
buyer_4,Jorge,50,ES97209511410504980753,TRX_N-00579-24193182,2023-05-24T09:47:49,Galdakao,Expense,leisure,-28.72,-23910.58
buyer_4,Jorge,50,ES97209511410504980753,TRX_N-00580-46419424,2023-05-24T04:39:52,Galdakao,Expense,clothing,-95.74,-24006.32
buyer_4,Jorge,50,ES97209511410504980753,TRX_N-00581-91372485,2023-05-30T08:24:26,Galdakao,Expense,cash,-100.0,-24106.32
buyer_4,Jorge,50,ES97209511410504980753,TRX_N-00582-67706137,2023-06-01T09:50:25,Galdakao,incomes,salary,1526.6,-22579.72
buyer_4,Jorge,50,ES97209511410504980753,TRX_N-00583-39500336,2023-06-01T09:50:25,Galdakao,incomes,salary_partner,1238.4,-21341.32
buyer_4,Jorge,50,ES97209511410504980753,TRX_N-00584-74081683,2023-06-01T09:50:25,Galdakao,incomes,extra_income,273.62,-21067.7
buyer_4,Jorge,50,ES97209511410504980753,TRX_N-00585-95928128,2023-06-01T09:50:25,Galdakao,incomes,salary_bonus,1214.88,-19852.82
buyer_4,Jorge,50,ES97209511410504980753,TRX_N-00586-17280275,2023-06-01T09:50:25,Galdakao,incomes,salary_partner_bonus,948.81,-18904.01
buyer_4,Jorge,50,ES97209511410504980753,TRX_N-00587-37188446,2023-06-02T16:28:36,Zarautz,Expense,education,-68.13,-18972.14
buyer_4,Jorge,50,ES97209511410504980753,TRX_N-00588-00643109,2023-06-03T15:17:10,Galdakao,Expense,cash,-100.0,-19072.14
buyer_4,Jorge,50,ES97209511410504980753,TRX_N-00589-38718416,2023-06-03T20:50:06,Galdakao,Expense,gifts,-437.65,-19509.79
buyer_4,Jorge,50,ES97209511410504980753,TRX_N-00590-09062923,2023-06-04T23:56:20,Galdakao,expenses,mortgage,-863.85,-20373.64
buyer_4,Jorge,50,ES97209511410504980753,TRX_N-00591-97088511,2023-06-05T17:03:36,Galdakao,expenses,electricity,-67.3,-20440.94
buyer_4,Jorge,50,ES97209511410504980753,TRX_N-00592-66018110,2023-06-05T15:50:04,Galdakao,expenses,gas,-42.95,-20483.89
buyer_4,Jorge,50,ES97209511410504980753,TRX_N-00593-27480402,2023-06-05T01:59:16,Galdakao,expenses,internet,-42.0,-20525.89
buyer_4,Jorge,50,ES97209511410504980753,TRX_N-00594-54525620,2023-06-06T17:03:30,Galdakao,expenses,water,-34.32,-20560.21
buyer_4,Jorge,50,ES97209511410504980753,TRX_N-00595-56248464,2023-06-06T12:33:14,Galdakao,expenses,phone,-44.46,-20604.67
buyer_4,Jorge,50,ES97209511410504980753,TRX_N-00596-06841899,2023-06-06T16:52:00,Sopela,Expense,appliances,-137.36,-20742.03
buyer_4,Jorge,50,ES97209511410504980753,TRX_N-00597-31123008,2023-06-06T16:03:48,Galdakao,Expense,gifts,-743.87,-21485.9
buyer_4,Jorge,50,ES97209511410504980753,TRX_N-00598-14349303,2023-06-06T21:00:40,Galdakao,expenses,children,-65.57,-21551.47
buyer_4,Jorge,50,ES97209511410504980753,TRX_N-00599-84427505,2023-06-07T16:49:58,Bermeo,Expense,food,-60.9,-21612.37
buyer_4,Jorge,50,ES97209511410504980753,TRX_N-00600-65118484,2023-06-08T08:53:33,Galdakao,Expense,cash,-100.0,-21712.37
buyer_4,Jorge,50,ES97209511410504980753,TRX_N-00601-50712518,2023-06-09T11:58:46,Galdakao,Expense,transport,-53.8,-21766.17
buyer_4,Jorge,50,ES97209511410504980753,TRX_N-00602-43305916,2023-06-10T23:18:38,Irun,Expense,transport,-85.41,-21851.58
buyer_4,Jorge,50,ES97209511410504980753,TRX_N-00603-57704567,2023-06-11T00:19:13,Galdakao,Expense,transport,-89.28,-21940.86
buyer_4,Jorge,50,ES97209511410504980753,TRX_N-00604-07383337,2023-06-11T21:54:13,Galdakao,Expense,cash,-100.0,-22040.86
buyer_4,Jorge,50,ES97209511410504980753,TRX_N-00605-83439207,2023-06-12T22:36:40,Galdakao,Expense,food,-79.51,-22120.37
buyer_4,Jorge,50,ES97209511410504980753,TRX_N-00606-04800966,2023-06-13T17:02:53,Galdakao,Expense,healthcare,-65.08,-22185.45
buyer_4,Jorge,50,ES97209511410504980753,TRX_N-00607-28428026,2023-06-16T12:48:24,Vitoria-Gasteiz,Expense,clothing,-143.78,-22329.23
buyer_4,Jorge,50,ES97209511410504980753,TRX_N-00608-95028840,2023-06-20T17:51:03,Galdakao,Expense,leisure,-36.26,-22365.49
buyer_4,Jorge,50,ES97209511410504980753,TRX_N-00609-88381440,2023-06-20T20:49:46,Galdakao,Expense,education,-51.71,-22417.2
buyer_4,Jorge,50,ES97209511410504980753,TRX_N-00610-63704665,2023-06-21T15:21:34,Galdakao,Expense,food,-110.58,-22527.78
buyer_4,Jorge,50,ES97209511410504980753,TRX_N-00611-91136472,2023-06-22T22:21:30,Leioa,Expense,healthcare,-124.71,-22652.49
buyer_4,Jorge,50,ES97209511410504980753,TRX_N-00612-15708332,2023-06-23T11:12:02,Galdakao,Expense,leisure,-69.76,-22722.25
buyer_4,Jorge,50,ES97209511410504980753,TRX_N-00613-49206935,2023-06-24T21:49:26,Vitoria-Gasteiz,Expense,cash,-100.0,-22822.25
buyer_4,Jorge,50,ES97209511410504980753,TRX_N-00614-78960905,2023-06-27T10:16:42,Leioa,Expense,education,-45.21,-22867.46
buyer_4,Jorge,50,ES97209511410504980753,TRX_N-00615-53482478,2023-06-29T08:26:19,Galdakao,Expense,transport,-50.07,-22917.53
buyer_4,Jorge,50,ES97209511410504980753,TRX_N-00616-20132439,2023-06-30T11:48:34,Galdakao,Expense,transport,-65.26,-22982.79
buyer_4,Jorge,50,ES97209511410504980753,TRX_N-00617-23650282,2023-07-01T12:56:48,Galdakao,incomes,salary,1526.6,-21456.19
buyer_4,Jorge,50,ES97209511410504980753,TRX_N-00618-49541545,2023-07-01T12:56:48,Galdakao,incomes,salary_partner,1238.4,-20217.79
buyer_4,Jorge,50,ES97209511410504980753,TRX_N-00619-90355205,2023-07-02T22:02:47,Galdakao,Expense,healthcare,-114.14,-20331.93
buyer_4,Jorge,50,ES97209511410504980753,TRX_N-00620-67011594,2023-07-03T18:31:54,Donostia,Expense,food,-77.71,-20409.64
buyer_4,Jorge,50,ES97209511410504980753,TRX_N-00621-98700708,2023-07-04T09:23:12,Galdakao,expenses,mortgage,-863.85,-21273.49
buyer_4,Jorge,50,ES97209511410504980753,TRX_N-00622-73258116,2023-07-04T19:23:19,Galdakao,Expense,leisure,-32.33,-21305.82
buyer_4,Jorge,50,ES97209511410504980753,TRX_N-00623-38913779,2023-07-05T15:09:18,Galdakao,expenses,electricity,-41.46,-21347.28
buyer_4,Jorge,50,ES97209511410504980753,TRX_N-00624-11332864,2023-07-05T07:37:56,Galdakao,expenses,gas,-68.84,-21416.12
buyer_4,Jorge,50,ES97209511410504980753,TRX_N-00625-12281850,2023-07-06T20:07:22,Lasarte-Oria,Expense,transport,-69.74,-21485.86
buyer_4,Jorge,50,ES97209511410504980753,TRX_N-00626-11117680,2023-07-07T22:14:41,Galdakao,expenses,internet,-42.0,-21527.86
buyer_4,Jorge,50,ES97209511410504980753,TRX_N-00627-45362050,2023-07-08T10:59:59,Galdakao,expenses,water,-29.42,-21557.28
buyer_4,Jorge,50,ES97209511410504980753,TRX_N-00628-04930175,2023-07-08T13:16:35,Galdakao,expenses,phone,-32.64,-21589.92
buyer_4,Jorge,50,ES97209511410504980753,TRX_N-00629-22293735,2023-07-10T20:58:43,Galdakao,Expense,food,-66.63,-21656.55
buyer_4,Jorge,50,ES97209511410504980753,TRX_N-00630-48920893,2023-07-11T15:53:14,Galdakao,Expense,cash,-100.0,-21756.55
buyer_4,Jorge,50,ES97209511410504980753,TRX_N-00631-17958154,2023-07-11T20:20:48,Galdakao,Expense,repairs,-286.24,-22042.79
buyer_4,Jorge,50,ES97209511410504980753,TRX_N-00632-38715354,2023-07-12T14:09:00,Galdakao,Expense,food,-89.96,-22132.75
buyer_4,Jorge,50,ES97209511410504980753,TRX_N-00633-84428600,2023-07-14T16:28:21,Bermeo,Expense,transport,-56.29,-22189.04
buyer_4,Jorge,50,ES97209511410504980753,TRX_N-00634-13822925,2023-07-14T14:20:07,Galdakao,Expense,cash,-100.0,-22289.04
buyer_4,Jorge,50,ES97209511410504980753,TRX_N-00635-66909611,2023-07-15T19:45:54,Galdakao,Expense,healthcare,-72.03,-22361.07
buyer_4,Jorge,50,ES97209511410504980753,TRX_N-00636-23579829,2023-07-15T10:02:19,Durango,Expense,cash,-100.0,-22461.07
buyer_4,Jorge,50,ES97209511410504980753,TRX_N-00637-02823228,2023-07-18T20:09:58,Galdakao,Expense,leisure,-49.49,-22510.56
buyer_4,Jorge,50,ES97209511410504980753,TRX_N-00638-34593014,2023-07-21T16:35:38,Galdakao,Expense,food,-78.45,-22589.01
buyer_4,Jorge,50,ES97209511410504980753,TRX_N-00639-08192028,2023-07-21T16:18:37,Galdakao,Expense,clothing,-55.76,-22644.77
buyer_4,Jorge,50,ES97209511410504980753,TRX_N-00640-72198887,2023-07-23T22:32:34,Galdakao,Expense,transport,-51.94,-22696.71
buyer_4,Jorge,50,ES97209511410504980753,TRX_N-00641-77740093,2023-07-26T16:11:09,Galdakao,Expense,food,-97.97,-22794.68
buyer_4,Jorge,50,ES97209511410504980753,TRX_N-00642-33224813,2023-07-29T23:42:39,Galdakao,Expense,food,-78.55,-22873.23
buyer_4,Jorge,50,ES97209511410504980753,TRX_N-00643-78702079,2023-07-31T15:54:51,Iru√±a de Oca,Expense,gifts,-203.84,-23077.07
buyer_4,Jorge,50,ES97209511410504980753,TRX_N-00644-54739097,2023-08-01T14:34:17,Galdakao,incomes,salary,1526.6,-21550.47
buyer_4,Jorge,50,ES97209511410504980753,TRX_N-00645-31213749,2023-08-01T14:34:17,Galdakao,incomes,salary_partner,1238.4,-20312.07
buyer_4,Jorge,50,ES97209511410504980753,TRX_N-00646-68709786,2023-08-01T19:38:34,Alegr√≠a-Dulantzi,Expense,food,-69.85,-20381.92
buyer_4,Jorge,50,ES97209511410504980753,TRX_N-00647-36686636,2023-08-01T14:56:16,Galdakao,Expense,transport,-67.94,-20449.86
buyer_4,Jorge,50,ES97209511410504980753,TRX_N-00648-88392997,2023-08-01T18:53:00,Galdakao,Expense,leisure,-63.09,-20512.95
buyer_4,Jorge,50,ES97209511410504980753,TRX_N-00649-51199238,2023-08-02T08:34:49,Galdakao,Expense,food,-89.47,-20602.42
buyer_4,Jorge,50,ES97209511410504980753,TRX_N-00650-13288012,2023-08-03T15:35:43,Galdakao,Expense,transport,-49.97,-20652.39
buyer_4,Jorge,50,ES97209511410504980753,TRX_N-00651-88940063,2023-08-04T21:43:46,Galdakao,expenses,mortgage,-863.85,-21516.24
buyer_4,Jorge,50,ES97209511410504980753,TRX_N-00652-69099400,2023-08-05T05:57:52,Galdakao,expenses,internet,-42.0,-21558.24
buyer_4,Jorge,50,ES97209511410504980753,TRX_N-00653-78122139,2023-08-05T16:38:17,Galdakao,expenses,phone,-38.99,-21597.23
buyer_4,Jorge,50,ES97209511410504980753,TRX_N-00654-26625401,2023-08-05T18:14:36,Galdakao,Expense,transport,-44.3,-21641.53
buyer_4,Jorge,50,ES97209511410504980753,TRX_N-00655-48606300,2023-08-06T19:38:27,Galdakao,expenses,electricity,-86.23,-21727.76
buyer_4,Jorge,50,ES97209511410504980753,TRX_N-00656-53972741,2023-08-07T20:13:38,Galdakao,expenses,water,-32.12,-21759.88
buyer_4,Jorge,50,ES97209511410504980753,TRX_N-00657-76326564,2023-08-07T17:30:59,Galdakao,expenses,gas,-36.66,-21796.54
buyer_4,Jorge,50,ES97209511410504980753,TRX_N-00658-34201509,2023-08-07T18:56:52,Galdakao,Expense,cash,-100.0,-21896.54
buyer_4,Jorge,50,ES97209511410504980753,TRX_N-00659-45783673,2023-08-08T09:43:29,Arrasate,Expense,food,-89.02,-21985.56
buyer_4,Jorge,50,ES97209511410504980753,TRX_N-00660-76955407,2023-08-09T19:30:44,Galdakao,Expense,transport,-47.79,-22033.35
buyer_4,Jorge,50,ES97209511410504980753,TRX_N-00661-52931150,2023-08-09T05:44:04,Galdakao,Expense,clothing,-81.08,-22114.43
buyer_4,Jorge,50,ES97209511410504980753,TRX_N-00662-51654702,2023-08-10T19:28:51,Galdakao,Expense,repairs,-34.73,-22149.16
buyer_4,Jorge,50,ES97209511410504980753,TRX_N-00663-10093809,2023-08-11T09:22:54,Galdakao,Expense,food,-117.66,-22266.82
buyer_4,Jorge,50,ES97209511410504980753,TRX_N-00664-09166826,2023-08-11T18:41:53,Galdakao,Expense,transport,-63.54,-22330.36
buyer_4,Jorge,50,ES97209511410504980753,TRX_N-00665-80514435,2023-08-11T08:44:30,Galdakao,Expense,leisure,-29.7,-22360.06
buyer_4,Jorge,50,ES97209511410504980753,TRX_N-00666-53257286,2023-08-12T23:54:51,Eibar,Expense,clothing,-90.32,-22450.38
buyer_4,Jorge,50,ES97209511410504980753,TRX_N-00667-65040158,2023-08-12T15:12:12,Galdakao,Expense,gifts,-734.75,-23185.13
buyer_4,Jorge,50,ES97209511410504980753,TRX_N-00668-03417831,2023-08-13T20:40:38,Arrasate,Expense,appliances,-310.94,-23496.07
buyer_4,Jorge,50,ES97209511410504980753,TRX_N-00669-89690186,2023-08-14T20:48:10,Galdakao,Expense,cash,-100.0,-23596.07
buyer_4,Jorge,50,ES97209511410504980753,TRX_N-00670-84263564,2023-08-15T12:27:28,Galdakao,Expense,food,-105.11,-23701.18
buyer_4,Jorge,50,ES97209511410504980753,TRX_N-00671-84694162,2023-08-18T21:35:42,Galdakao,Expense,gifts,-605.06,-24306.24
buyer_4,Jorge,50,ES97209511410504980753,TRX_N-00672-50492134,2023-08-19T05:36:32,Galdakao,Expense,transport,-54.65,-24360.89
buyer_4,Jorge,50,ES97209511410504980753,TRX_N-00673-66921186,2023-08-20T14:54:21,Bermeo,Expense,cash,-100.0,-24460.89
buyer_4,Jorge,50,ES97209511410504980753,TRX_N-00674-06524181,2023-08-22T16:42:48,Galdakao,Expense,gifts,-228.38,-24689.27
buyer_4,Jorge,50,ES97209511410504980753,TRX_N-00675-41849562,2023-08-27T11:03:54,Amurrio,Expense,clothing,-96.15,-24785.42
buyer_4,Jorge,50,ES97209511410504980753,TRX_N-00676-46472065,2023-08-30T14:16:03,Galdakao,Expense,transport,-80.65,-24866.07
buyer_4,Jorge,50,ES97209511410504980753,TRX_N-00677-04671009,2023-08-31T07:55:07,Pasaia,Expense,gifts,-843.38,-25709.45
buyer_4,Jorge,50,ES97209511410504980753,TRX_N-00678-49955121,2023-09-01T04:26:22,Galdakao,incomes,salary,1526.6,-24182.85
buyer_4,Jorge,50,ES97209511410504980753,TRX_N-00679-30935978,2023-09-01T04:26:22,Galdakao,incomes,salary_partner,1238.4,-22944.45
buyer_4,Jorge,50,ES97209511410504980753,TRX_N-00680-22248855,2023-09-01T04:26:22,Galdakao,incomes,extra_income,273.62,-22670.83
buyer_4,Jorge,50,ES97209511410504980753,TRX_N-00681-08469612,2023-09-02T14:58:28,Galdakao,Expense,transport,-42.47,-22713.3
buyer_4,Jorge,50,ES97209511410504980753,TRX_N-00682-78698635,2023-09-04T21:16:15,Galdakao,expenses,mortgage,-863.85,-23577.15
buyer_4,Jorge,50,ES97209511410504980753,TRX_N-00683-49164081,2023-09-04T07:28:21,Galdakao,Expense,leisure,-23.89,-23601.04
buyer_4,Jorge,50,ES97209511410504980753,TRX_N-00684-60181309,2023-09-06T09:24:07,Galdakao,expenses,electricity,-64.02,-23665.06
buyer_4,Jorge,50,ES97209511410504980753,TRX_N-00685-72381880,2023-09-06T16:51:57,Irun,Expense,leisure,-23.62,-23688.68
buyer_4,Jorge,50,ES97209511410504980753,TRX_N-00686-95038523,2023-09-08T08:34:13,Galdakao,expenses,phone,-42.89,-23731.57
buyer_4,Jorge,50,ES97209511410504980753,TRX_N-00687-72913419,2023-09-08T16:21:39,Galdakao,expenses,water,-32.03,-23763.6
buyer_4,Jorge,50,ES97209511410504980753,TRX_N-00688-51643898,2023-09-08T20:52:00,Galdakao,expenses,gas,-78.62,-23842.22
buyer_4,Jorge,50,ES97209511410504980753,TRX_N-00689-28420756,2023-09-08T19:28:26,Galdakao,expenses,internet,-42.0,-23884.22
buyer_4,Jorge,50,ES97209511410504980753,TRX_N-00690-05837516,2023-09-08T10:37:54,Durango,Expense,food,-87.51,-23971.73
buyer_4,Jorge,50,ES97209511410504980753,TRX_N-00691-97454909,2023-09-08T10:22:32,Mungia,Expense,leisure,-22.07,-23993.8
buyer_4,Jorge,50,ES97209511410504980753,TRX_N-00692-47185983,2023-09-08T12:55:46,Galdakao,Expense,appliances,-413.08,-24406.88
buyer_4,Jorge,50,ES97209511410504980753,TRX_N-00693-64573037,2023-09-09T13:05:05,Erandio,Expense,food,-66.9,-24473.78
buyer_4,Jorge,50,ES97209511410504980753,TRX_N-00694-67775420,2023-09-09T19:13:45,Galdakao,Expense,transport,-68.13,-24541.91
buyer_4,Jorge,50,ES97209511410504980753,TRX_N-00695-63632492,2023-09-09T10:39:08,Galdakao,Expense,cash,-100.0,-24641.91
buyer_4,Jorge,50,ES97209511410504980753,TRX_N-00696-79198226,2023-09-09T18:17:27,Galdakao,expenses,children,-93.7,-24735.61
buyer_4,Jorge,50,ES97209511410504980753,TRX_N-00697-91619613,2023-09-10T13:35:09,Galdakao,Expense,food,-83.79,-24819.4
buyer_4,Jorge,50,ES97209511410504980753,TRX_N-00698-94329087,2023-09-10T12:40:48,Galdakao,Expense,leisure,-51.25,-24870.65
buyer_4,Jorge,50,ES97209511410504980753,TRX_N-00699-90964186,2023-09-13T09:22:28,Galdakao,Expense,leisure,-39.62,-24910.27
buyer_4,Jorge,50,ES97209511410504980753,TRX_N-00700-92677671,2023-09-14T12:17:37,Galdakao,Expense,leisure,-64.67,-24974.94
buyer_4,Jorge,50,ES97209511410504980753,TRX_N-00701-45909052,2023-09-17T09:28:30,Galdakao,Expense,transport,-84.27,-25059.21
buyer_4,Jorge,50,ES97209511410504980753,TRX_N-00702-59417950,2023-09-19T15:07:32,Galdakao,Expense,food,-109.76,-25168.97
buyer_4,Jorge,50,ES97209511410504980753,TRX_N-00703-57023390,2023-09-19T17:35:34,Galdakao,expenses,children,-164.09,-25333.06
buyer_4,Jorge,50,ES97209511410504980753,TRX_N-00704-55013831,2023-09-21T12:56:03,Galdakao,Expense,cash,-100.0,-25433.06
buyer_4,Jorge,50,ES97209511410504980753,TRX_N-00705-06871305,2023-09-21T15:38:21,Galdakao,Expense,appliances,-148.1,-25581.16
buyer_4,Jorge,50,ES97209511410504980753,TRX_N-00706-43286105,2023-09-22T16:16:53,Galdakao,Expense,leisure,-37.05,-25618.21
buyer_4,Jorge,50,ES97209511410504980753,TRX_N-00707-28832867,2023-09-23T21:00:59,Galdakao,Expense,food,-84.57,-25702.78
buyer_4,Jorge,50,ES97209511410504980753,TRX_N-00708-05899657,2023-09-23T19:23:03,Galdakao,Expense,transport,-74.77,-25777.55
buyer_4,Jorge,50,ES97209511410504980753,TRX_N-00709-34184630,2023-09-23T11:36:29,Galdakao,Expense,leisure,-70.6,-25848.15
buyer_4,Jorge,50,ES97209511410504980753,TRX_N-00710-88311973,2023-09-23T15:11:16,Galdakao,Expense,cash,-100.0,-25948.15
buyer_4,Jorge,50,ES97209511410504980753,TRX_N-00711-42329265,2023-09-24T10:45:40,Galdakao,Expense,leisure,-43.03,-25991.18
buyer_4,Jorge,50,ES97209511410504980753,TRX_N-00712-48624181,2023-09-24T16:19:13,Galdakao,Expense,healthcare,-45.78,-26036.96
buyer_4,Jorge,50,ES97209511410504980753,TRX_N-00713-51917217,2023-09-25T15:30:03,Galdakao,Expense,leisure,-51.77,-26088.73
buyer_4,Jorge,50,ES97209511410504980753,TRX_N-00714-44007537,2023-09-25T05:46:44,Galdakao,Expense,clothing,-49.25,-26137.98
buyer_4,Jorge,50,ES97209511410504980753,TRX_N-00715-79844811,2023-09-27T08:14:46,Galdakao,Expense,education,-54.93,-26192.91
buyer_4,Jorge,50,ES97209511410504980753,TRX_N-00716-17505032,2023-09-28T18:13:32,Galdakao,Expense,food,-95.48,-26288.39
buyer_4,Jorge,50,ES97209511410504980753,TRX_N-00717-07423637,2023-09-30T18:03:01,Galdakao,Expense,cash,-100.0,-26388.39
buyer_4,Jorge,50,ES97209511410504980753,TRX_N-00718-12418104,2023-10-01T22:25:05,Galdakao,incomes,salary,1526.6,-24861.79
buyer_4,Jorge,50,ES97209511410504980753,TRX_N-00719-82173919,2023-10-01T22:25:05,Galdakao,incomes,salary_partner,1238.4,-23623.39
buyer_4,Jorge,50,ES97209511410504980753,TRX_N-00720-88776960,2023-10-01T09:53:27,Galdakao,Expense,cash,-100.0,-23723.39
buyer_4,Jorge,50,ES97209511410504980753,TRX_N-00721-57780888,2023-10-02T15:54:12,Galdakao,Expense,transport,-67.65,-23791.04
buyer_4,Jorge,50,ES97209511410504980753,TRX_N-00722-24723609,2023-10-02T09:43:27,Galdakao,Expense,gifts,-38.97,-23830.01
buyer_4,Jorge,50,ES97209511410504980753,TRX_N-00723-56402309,2023-10-03T22:24:42,Galdakao,Expense,food,-122.12,-23952.13
buyer_4,Jorge,50,ES97209511410504980753,TRX_N-00724-79764414,2023-10-04T04:05:59,Galdakao,expenses,mortgage,-863.85,-24815.98
buyer_4,Jorge,50,ES97209511410504980753,TRX_N-00725-39798986,2023-10-05T08:54:43,Galdakao,expenses,internet,-42.0,-24857.98
buyer_4,Jorge,50,ES97209511410504980753,TRX_N-00726-63263048,2023-10-06T15:09:28,Galdakao,expenses,electricity,-52.69,-24910.67
buyer_4,Jorge,50,ES97209511410504980753,TRX_N-00727-84303545,2023-10-06T10:41:29,Galdakao,expenses,gas,-34.69,-24945.36
buyer_4,Jorge,50,ES97209511410504980753,TRX_N-00728-10325371,2023-10-06T16:24:39,Galdakao,Expense,transport,-56.77,-25002.13
buyer_4,Jorge,50,ES97209511410504980753,TRX_N-00729-40203162,2023-10-07T15:46:06,Galdakao,expenses,water,-35.99,-25038.12
buyer_4,Jorge,50,ES97209511410504980753,TRX_N-00730-78808017,2023-10-07T19:05:47,Galdakao,Expense,clothing,-131.96,-25170.08
buyer_4,Jorge,50,ES97209511410504980753,TRX_N-00731-19483881,2023-10-07T16:18:52,Galdakao,expenses,children,-71.84,-25241.92
buyer_4,Jorge,50,ES97209511410504980753,TRX_N-00732-93230244,2023-10-08T12:17:37,Galdakao,expenses,phone,-30.47,-25272.39
buyer_4,Jorge,50,ES97209511410504980753,TRX_N-00733-58342525,2023-10-08T08:39:56,Galdakao,Expense,education,-44.95,-25317.34
buyer_4,Jorge,50,ES97209511410504980753,TRX_N-00734-83375732,2023-10-08T16:43:50,Galdakao,Expense,cash,-100.0,-25417.34
buyer_4,Jorge,50,ES97209511410504980753,TRX_N-00735-77665805,2023-10-10T23:01:59,Barakaldo,Expense,gifts,-97.42,-25514.76
buyer_4,Jorge,50,ES97209511410504980753,TRX_N-00736-24747984,2023-10-11T08:02:18,Galdakao,Expense,repairs,-322.0,-25836.76
buyer_4,Jorge,50,ES97209511410504980753,TRX_N-00737-20688750,2023-10-12T08:48:23,Amurrio,Expense,cash,-100.0,-25936.76
buyer_4,Jorge,50,ES97209511410504980753,TRX_N-00738-16534542,2023-10-13T14:57:41,Galdakao,Expense,cash,-100.0,-26036.76
buyer_4,Jorge,50,ES97209511410504980753,TRX_N-00739-01379768,2023-10-14T14:17:27,Galdakao,Expense,clothing,-69.71,-26106.47
buyer_4,Jorge,50,ES97209511410504980753,TRX_N-00740-49484710,2023-10-17T20:03:39,Galdakao,Expense,food,-121.25,-26227.72
buyer_4,Jorge,50,ES97209511410504980753,TRX_N-00741-61967548,2023-10-17T16:42:20,Galdakao,Expense,cash,-100.0,-26327.72
buyer_4,Jorge,50,ES97209511410504980753,TRX_N-00742-89638667,2023-10-18T08:41:52,Galdakao,Expense,transport,-83.32,-26411.04
buyer_4,Jorge,50,ES97209511410504980753,TRX_N-00743-47020060,2023-10-18T23:02:43,Galdakao,expenses,children,-155.65,-26566.69
buyer_4,Jorge,50,ES97209511410504980753,TRX_N-00744-80052031,2023-10-20T15:51:14,Galdakao,Expense,food,-76.25,-26642.94
buyer_4,Jorge,50,ES97209511410504980753,TRX_N-00745-73522751,2023-10-20T12:15:38,Galdakao,Expense,healthcare,-169.55,-26812.49
buyer_4,Jorge,50,ES97209511410504980753,TRX_N-00746-67921057,2023-10-21T10:38:01,Galdakao,Expense,transport,-44.31,-26856.8
buyer_4,Jorge,50,ES97209511410504980753,TRX_N-00747-41044756,2023-10-21T08:24:09,Galdakao,Expense,appliances,-235.95,-27092.75
buyer_4,Jorge,50,ES97209511410504980753,TRX_N-00748-09741909,2023-10-22T11:34:44,Galdakao,Expense,gifts,-117.78,-27210.53
buyer_4,Jorge,50,ES97209511410504980753,TRX_N-00749-68791891,2023-10-22T02:55:13,Galdakao,expenses,children,-61.79,-27272.32
buyer_4,Jorge,50,ES97209511410504980753,TRX_N-00750-10972310,2023-10-25T22:35:36,Berango,Expense,clothing,-119.0,-27391.32
buyer_4,Jorge,50,ES97209511410504980753,TRX_N-00751-82104681,2023-10-25T13:18:19,Portugalete,Expense,repairs,-167.25,-27558.57
buyer_4,Jorge,50,ES97209511410504980753,TRX_N-00752-20298826,2023-10-26T14:54:15,Galdakao,Expense,gifts,-630.97,-28189.54
buyer_4,Jorge,50,ES97209511410504980753,TRX_N-00753-17515216,2023-10-27T12:13:22,Galdakao,Expense,gifts,-583.54,-28773.08
buyer_4,Jorge,50,ES97209511410504980753,TRX_N-00754-37562827,2023-10-28T06:36:12,Galdakao,Expense,cash,-100.0,-28873.08
buyer_4,Jorge,50,ES97209511410504980753,TRX_N-00755-87959525,2023-10-30T10:38:41,Basauri,Expense,clothing,-84.52,-28957.6
buyer_4,Jorge,50,ES97209511410504980753,TRX_N-00756-27873847,2023-10-30T14:30:09,Galdakao,Expense,gifts,-796.65,-29754.25
buyer_4,Jorge,50,ES97209511410504980753,TRX_N-00757-46493854,2023-11-01T17:34:57,Galdakao,incomes,salary,1526.6,-28227.65
buyer_4,Jorge,50,ES97209511410504980753,TRX_N-00758-43267473,2023-11-01T17:34:57,Galdakao,incomes,salary_partner,1238.4,-26989.25
buyer_4,Jorge,50,ES97209511410504980753,TRX_N-00759-19525677,2023-11-01T20:03:26,Galdakao,Expense,cash,-100.0,-27089.25
buyer_4,Jorge,50,ES97209511410504980753,TRX_N-00760-81067302,2023-11-02T13:40:20,Galdakao,Expense,education,-69.48,-27158.73
buyer_4,Jorge,50,ES97209511410504980753,TRX_N-00761-54009197,2023-11-02T09:19:38,Galdakao,expenses,children,-202.96,-27361.69
buyer_4,Jorge,50,ES97209511410504980753,TRX_N-00762-03611500,2023-11-04T15:26:54,Galdakao,expenses,mortgage,-863.85,-28225.54
buyer_4,Jorge,50,ES97209511410504980753,TRX_N-00763-80944684,2023-11-04T14:37:45,Galdakao,Expense,cash,-100.0,-28325.54
buyer_4,Jorge,50,ES97209511410504980753,TRX_N-00764-50623731,2023-11-05T14:37:57,Galdakao,expenses,water,-31.06,-28356.6
buyer_4,Jorge,50,ES97209511410504980753,TRX_N-00765-58312615,2023-11-05T12:07:50,Galdakao,expenses,phone,-39.5,-28396.1
buyer_4,Jorge,50,ES97209511410504980753,TRX_N-00766-98407402,2023-11-05T11:14:42,Getxo,Expense,cash,-100.0,-28496.1
buyer_4,Jorge,50,ES97209511410504980753,TRX_N-00767-77915472,2023-11-07T21:16:45,Sopela,Expense,transport,-61.23,-28557.33
buyer_4,Jorge,50,ES97209511410504980753,TRX_N-00768-33425793,2023-11-08T22:28:09,Galdakao,expenses,electricity,-28.6,-28585.93
buyer_4,Jorge,50,ES97209511410504980753,TRX_N-00769-61242724,2023-11-08T22:09:16,Galdakao,expenses,gas,-66.51,-28652.44
buyer_4,Jorge,50,ES97209511410504980753,TRX_N-00770-90219210,2023-11-08T15:07:13,Galdakao,expenses,internet,-42.0,-28694.44
buyer_4,Jorge,50,ES97209511410504980753,TRX_N-00771-41290992,2023-11-08T16:29:25,Galdakao,Expense,food,-104.51,-28798.95
buyer_4,Jorge,50,ES97209511410504980753,TRX_N-00772-19641880,2023-11-10T08:49:48,Galdakao,Expense,leisure,-21.44,-28820.39
buyer_4,Jorge,50,ES97209511410504980753,TRX_N-00773-66951652,2023-11-10T13:21:42,Galdakao,Expense,gifts,-647.06,-29467.45
buyer_4,Jorge,50,ES97209511410504980753,TRX_N-00774-87167838,2023-11-11T12:25:23,Iru√±a de Oca,Expense,clothing,-94.26,-29561.71
buyer_4,Jorge,50,ES97209511410504980753,TRX_N-00775-15765271,2023-11-12T10:12:20,Galdakao,Expense,food,-75.27,-29636.98
buyer_4,Jorge,50,ES97209511410504980753,TRX_N-00776-49880501,2023-11-15T19:12:22,Galdakao,Expense,clothing,-87.23,-29724.21
buyer_4,Jorge,50,ES97209511410504980753,TRX_N-00777-24610849,2023-11-16T18:07:09,Galdakao,Expense,transport,-88.18,-29812.39
buyer_4,Jorge,50,ES97209511410504980753,TRX_N-00778-91637847,2023-11-16T11:11:32,Galdakao,Expense,clothing,-104.21,-29916.6
buyer_4,Jorge,50,ES97209511410504980753,TRX_N-00779-25882741,2023-11-16T20:53:47,Galdakao,Expense,repairs,-136.0,-30052.6
buyer_4,Jorge,50,ES97209511410504980753,TRX_N-00780-34186846,2023-11-19T06:02:45,Galdakao,Expense,transport,-55.9,-30108.5
buyer_4,Jorge,50,ES97209511410504980753,TRX_N-00781-45514875,2023-11-26T17:06:30,Galdakao,Expense,food,-61.62,-30170.12
buyer_4,Jorge,50,ES97209511410504980753,TRX_N-00782-22361176,2023-11-26T09:24:46,Galdakao,Expense,transport,-64.58,-30234.7
buyer_4,Jorge,50,ES97209511410504980753,TRX_N-00783-12968670,2023-11-26T16:24:25,Galdakao,Expense,clothing,-153.48,-30388.18
buyer_4,Jorge,50,ES97209511410504980753,TRX_N-00784-95300976,2023-11-27T11:17:55,Berango,Expense,leisure,-71.55,-30459.73
buyer_4,Jorge,50,ES97209511410504980753,TRX_N-00785-34233248,2023-11-27T08:33:25,Galdakao,Expense,education,-63.36,-30523.09
buyer_4,Jorge,50,ES97209511410504980753,TRX_N-00786-09366055,2023-11-27T12:07:37,Galdakao,Expense,appliances,-108.58,-30631.67
buyer_4,Jorge,50,ES97209511410504980753,TRX_N-00787-27361875,2023-11-28T13:08:54,Galdakao,expenses,children,-197.46,-30829.13
buyer_4,Jorge,50,ES97209511410504980753,TRX_N-00788-94851714,2023-11-29T10:39:16,Galdakao,Expense,transport,-50.44,-30879.57
buyer_4,Jorge,50,ES97209511410504980753,TRX_N-00789-44503777,2023-11-29T10:05:56,Galdakao,Expense,gifts,-204.77,-31084.34
buyer_4,Jorge,50,ES97209511410504980753,TRX_N-00790-07458901,2023-11-30T18:30:01,Leioa,Expense,food,-117.4,-31201.74
buyer_4,Jorge,50,ES97209511410504980753,TRX_N-00791-97826476,2023-11-30T09:27:40,Galdakao,Expense,education,-71.13,-31272.87
buyer_4,Jorge,50,ES97209511410504980753,TRX_N-00792-45022531,2023-12-01T18:09:41,Galdakao,incomes,salary,1526.6,-29746.27
buyer_4,Jorge,50,ES97209511410504980753,TRX_N-00793-85621595,2023-12-01T18:09:41,Galdakao,incomes,salary_partner,1238.4,-28507.87
buyer_4,Jorge,50,ES97209511410504980753,TRX_N-00794-41154274,2023-12-01T18:09:41,Galdakao,incomes,extra_income,273.62,-28234.25
buyer_4,Jorge,50,ES97209511410504980753,TRX_N-00795-99759219,2023-12-01T18:09:41,Galdakao,incomes,salary_bonus,1094.88,-27139.37
buyer_4,Jorge,50,ES97209511410504980753,TRX_N-00796-17030706,2023-12-01T18:09:41,Galdakao,incomes,salary_partner_bonus,873.83,-26265.54
buyer_4,Jorge,50,ES97209511410504980753,TRX_N-00797-01862554,2023-12-02T12:09:33,Irun,Expense,food,-74.32,-26339.86
buyer_4,Jorge,50,ES97209511410504980753,TRX_N-00798-33696885,2023-12-03T20:57:51,Galdakao,Expense,repairs,-171.85,-26511.71
buyer_4,Jorge,50,ES97209511410504980753,TRX_N-00799-13400653,2023-12-04T10:02:47,Galdakao,expenses,mortgage,-863.85,-27375.56
buyer_4,Jorge,50,ES97209511410504980753,TRX_N-00800-97785861,2023-12-04T10:25:56,Bermeo,Expense,gifts,-34.37,-27409.93
buyer_4,Jorge,50,ES97209511410504980753,TRX_N-00801-16456402,2023-12-04T19:06:22,Galdakao,expenses,children,-267.17,-27677.1
buyer_4,Jorge,50,ES97209511410504980753,TRX_N-00802-43138387,2023-12-06T08:12:40,Galdakao,Expense,cash,-100.0,-27777.1
buyer_4,Jorge,50,ES97209511410504980753,TRX_N-00803-29953074,2023-12-08T20:08:53,Galdakao,expenses,internet,-42.0,-27819.1
buyer_4,Jorge,50,ES97209511410504980753,TRX_N-00804-91947829,2023-12-08T02:15:48,Galdakao,expenses,water,-44.54,-27863.64
buyer_4,Jorge,50,ES97209511410504980753,TRX_N-00805-66610608,2023-12-08T13:38:08,Galdakao,expenses,electricity,-47.77,-27911.41
buyer_4,Jorge,50,ES97209511410504980753,TRX_N-00806-15862120,2023-12-08T22:43:09,Galdakao,expenses,gas,-76.71,-27988.12
buyer_4,Jorge,50,ES97209511410504980753,TRX_N-00807-75524772,2023-12-08T08:23:31,Galdakao,expenses,phone,-39.86,-28027.98
buyer_4,Jorge,50,ES97209511410504980753,TRX_N-00808-55105388,2023-12-12T14:11:42,Galdakao,Expense,food,-74.86,-28102.84
buyer_4,Jorge,50,ES97209511410504980753,TRX_N-00809-99170641,2023-12-13T15:54:57,Galdakao,Expense,food,-62.55,-28165.39
buyer_4,Jorge,50,ES97209511410504980753,TRX_N-00810-71488364,2023-12-13T23:20:48,Galdakao,Expense,cash,-100.0,-28265.39
buyer_4,Jorge,50,ES97209511410504980753,TRX_N-00811-82903626,2023-12-16T09:25:21,Galdakao,Expense,food,-120.37,-28385.76
buyer_4,Jorge,50,ES97209511410504980753,TRX_N-00812-45488260,2023-12-17T17:13:08,Galdakao,Expense,leisure,-27.98,-28413.74
buyer_4,Jorge,50,ES97209511410504980753,TRX_N-00813-12122847,2023-12-17T01:34:31,Galdakao,Expense,cash,-100.0,-28513.74
buyer_4,Jorge,50,ES97209511410504980753,TRX_N-00814-97466023,2023-12-18T00:39:26,Amurrio,Expense,leisure,-75.79,-28589.53
buyer_4,Jorge,50,ES97209511410504980753,TRX_N-00815-80911688,2023-12-19T15:16:52,Galdakao,Expense,food,-79.43,-28668.96
buyer_4,Jorge,50,ES97209511410504980753,TRX_N-00816-60541182,2023-12-20T16:03:41,Galdakao,Expense,gifts,-690.25,-29359.21
buyer_4,Jorge,50,ES97209511410504980753,TRX_N-00817-26578460,2023-12-20T19:26:21,Galdakao,expenses,children,-189.86,-29549.07
buyer_4,Jorge,50,ES97209511410504980753,TRX_N-00818-03129933,2023-12-21T16:56:48,Galdakao,Expense,food,-103.13,-29652.2
buyer_4,Jorge,50,ES97209511410504980753,TRX_N-00819-64411966,2023-12-21T18:07:59,Galdakao,Expense,leisure,-49.0,-29701.2
buyer_4,Jorge,50,ES97209511410504980753,TRX_N-00820-12549008,2023-12-24T02:27:57,Galdakao,Expense,cash,-100.0,-29801.2
buyer_4,Jorge,50,ES97209511410504980753,TRX_N-00821-33160946,2023-12-25T20:23:10,Galdakao,Expense,appliances,-135.35,-29936.55
buyer_4,Jorge,50,ES97209511410504980753,TRX_N-00822-07125928,2023-12-26T17:16:02,Hernani,Expense,cash,-100.0,-30036.55
buyer_4,Jorge,50,ES97209511410504980753,TRX_N-00823-79664541,2023-12-27T11:36:44,Galdakao,Expense,education,-62.63,-30099.18
buyer_4,Jorge,50,ES97209511410504980753,TRX_N-00824-14424527,2023-12-28T09:43:42,Galdakao,Expense,food,-72.87,-30172.05
buyer_4,Jorge,50,ES97209511410504980753,TRX_N-00825-21973782,2023-12-28T18:33:09,Galdakao,Expense,travel,-924.27,-31096.32
buyer_4,Jorge,50,ES97209511410504980753,TRX_N-00826-39205044,2023-12-28T09:47:49,Santurtzi,Expense,gifts,-95.15,-31191.47
buyer_4,Jorge,50,ES97209511410504980753,TRX_N-00827-29310039,2023-12-30T14:10:02,Galdakao,expenses,children,-102.4,-31293.87
buyer_4,Jorge,50,ES97209511410504980753,TRX_N-00828-97491922,2023-12-31T05:31:31,Galdakao,Expense,cash,-100.0,-31393.87
buyer_4,Jorge,50,ES97209511410504980753,TRX_N-00829-48090551,2024-01-01T08:48:25,Galdakao,incomes,salary,1557.3,-29836.57
buyer_4,Jorge,50,ES97209511410504980753,TRX_N-00830-08912354,2024-01-01T08:48:25,Galdakao,incomes,salary_partner,1263.31,-28573.26
buyer_4,Jorge,50,ES97209511410504980753,TRX_N-00831-58470629,2024-01-02T08:54:46,Galdakao,Expense,healthcare,-85.66,-28658.92
buyer_4,Jorge,50,ES97209511410504980753,TRX_N-00832-50400610,2024-01-04T08:56:45,Galdakao,expenses,mortgage,-863.85,-29522.77
buyer_4,Jorge,50,ES97209511410504980753,TRX_N-00833-90631364,2024-01-04T09:41:29,Galdakao,Expense,transport,-63.2,-29585.97
buyer_4,Jorge,50,ES97209511410504980753,TRX_N-00834-88674544,2024-01-04T09:57:45,Mungia,Expense,leisure,-23.48,-29609.45
buyer_4,Jorge,50,ES97209511410504980753,TRX_N-00835-31032979,2024-01-05T17:07:08,Galdakao,expenses,internet,-42.0,-29651.45
buyer_4,Jorge,50,ES97209511410504980753,TRX_N-00836-14132609,2024-01-06T13:08:36,Galdakao,Expense,leisure,-39.35,-29690.8
buyer_4,Jorge,50,ES97209511410504980753,TRX_N-00837-83193661,2024-01-08T10:46:39,Galdakao,expenses,gas,-30.94,-29721.74
buyer_4,Jorge,50,ES97209511410504980753,TRX_N-00838-93365400,2024-01-08T19:47:27,Galdakao,expenses,water,-35.74,-29757.48
buyer_4,Jorge,50,ES97209511410504980753,TRX_N-00839-75084721,2024-01-08T03:28:46,Galdakao,expenses,electricity,-56.3,-29813.78
buyer_4,Jorge,50,ES97209511410504980753,TRX_N-00840-17929748,2024-01-08T00:32:47,Galdakao,expenses,phone,-44.32,-29858.1
buyer_4,Jorge,50,ES97209511410504980753,TRX_N-00841-30157058,2024-01-08T12:42:02,Galdakao,Expense,food,-85.27,-29943.37
buyer_4,Jorge,50,ES97209511410504980753,TRX_N-00842-19215074,2024-01-08T14:13:12,Galdakao,Expense,cash,-100.0,-30043.37
buyer_4,Jorge,50,ES97209511410504980753,TRX_N-00843-14496682,2024-01-09T10:23:12,Galdakao,Expense,repairs,-301.08,-30344.45
buyer_4,Jorge,50,ES97209511410504980753,TRX_N-00844-17106532,2024-01-10T09:09:08,Galdakao,Expense,gifts,-245.6,-30590.05
buyer_4,Jorge,50,ES97209511410504980753,TRX_N-00845-11930741,2024-01-12T08:17:39,Galdakao,Expense,transport,-83.69,-30673.74
buyer_4,Jorge,50,ES97209511410504980753,TRX_N-00846-04125098,2024-01-15T10:49:45,Galdakao,Expense,cash,-100.0,-30773.74
buyer_4,Jorge,50,ES97209511410504980753,TRX_N-00847-45964323,2024-01-16T01:37:34,Galdakao,Expense,leisure,-34.64,-30808.38
buyer_4,Jorge,50,ES97209511410504980753,TRX_N-00848-11164873,2024-01-17T12:24:22,Galdakao,Expense,appliances,-136.54,-30944.92
buyer_4,Jorge,50,ES97209511410504980753,TRX_N-00849-48704531,2024-01-18T18:02:27,Galdakao,Expense,transport,-82.22,-31027.14
buyer_4,Jorge,50,ES97209511410504980753,TRX_N-00850-45475710,2024-01-18T10:40:15,Galdakao,Expense,cash,-100.0,-31127.14
buyer_4,Jorge,50,ES97209511410504980753,TRX_N-00851-40072542,2024-01-21T11:55:15,Galdakao,Expense,leisure,-55.88,-31183.02
buyer_4,Jorge,50,ES97209511410504980753,TRX_N-00852-52652102,2024-01-21T19:36:05,Galdakao,Expense,healthcare,-73.72,-31256.74
buyer_4,Jorge,50,ES97209511410504980753,TRX_N-00853-81374411,2024-01-23T17:30:09,Galdakao,Expense,food,-110.41,-31367.15
buyer_4,Jorge,50,ES97209511410504980753,TRX_N-00854-32628066,2024-01-23T18:48:17,Galdakao,Expense,cash,-100.0,-31467.15
buyer_4,Jorge,50,ES97209511410504980753,TRX_N-00855-03915518,2024-01-25T08:53:44,Galdakao,Expense,transport,-51.95,-31519.1
buyer_4,Jorge,50,ES97209511410504980753,TRX_N-00856-37694789,2024-01-27T12:37:58,Galdakao,Expense,clothing,-64.52,-31583.62
buyer_4,Jorge,50,ES97209511410504980753,TRX_N-00857-93382853,2024-01-29T16:44:34,Arrasate,Expense,cash,-100.0,-31683.62
buyer_4,Jorge,50,ES97209511410504980753,TRX_N-00858-19728197,2024-01-30T08:31:09,Salvatierra/Agurain,Expense,food,-78.57,-31762.19
buyer_4,Jorge,50,ES97209511410504980753,TRX_N-00859-44850315,2024-01-31T14:11:59,Galdakao,Expense,cash,-100.0,-31862.19
buyer_4,Jorge,50,ES97209511410504980753,TRX_N-00860-63357004,2024-01-31T17:09:27,Galdakao,Expense,repairs,-155.75,-32017.94
buyer_4,Jorge,50,ES97209511410504980753,TRX_N-00861-09307545,2024-02-01T11:17:17,Galdakao,incomes,salary,1557.3,-30460.64
buyer_4,Jorge,50,ES97209511410504980753,TRX_N-00862-31419626,2024-02-01T11:17:17,Galdakao,incomes,salary_partner,1263.31,-29197.33
buyer_4,Jorge,50,ES97209511410504980753,TRX_N-00863-60392054,2024-02-03T23:18:34,Galdakao,Expense,leisure,-39.49,-29236.82
buyer_4,Jorge,50,ES97209511410504980753,TRX_N-00864-26756429,2024-02-04T13:54:08,Galdakao,expenses,mortgage,-863.85,-30100.67
buyer_4,Jorge,50,ES97209511410504980753,TRX_N-00865-90067049,2024-02-04T06:53:00,Galdakao,Expense,cash,-100.0,-30200.67
buyer_4,Jorge,50,ES97209511410504980753,TRX_N-00866-87551485,2024-02-04T13:44:14,Galdakao,Expense,repairs,-111.08,-30311.75
buyer_4,Jorge,50,ES97209511410504980753,TRX_N-00867-50596276,2024-02-05T15:14:33,Galdakao,expenses,phone,-34.37,-30346.12
buyer_4,Jorge,50,ES97209511410504980753,TRX_N-00868-01047967,2024-02-05T11:21:37,Galdakao,Expense,cash,-100.0,-30446.12
buyer_4,Jorge,50,ES97209511410504980753,TRX_N-00869-79957326,2024-02-06T12:41:57,Galdakao,Expense,cash,-100.0,-30546.12
buyer_4,Jorge,50,ES97209511410504980753,TRX_N-00870-78175084,2024-02-07T16:52:07,Mungia,Expense,transport,-46.36,-30592.48
buyer_4,Jorge,50,ES97209511410504980753,TRX_N-00871-68294462,2024-02-07T11:58:20,Galdakao,Expense,education,-76.62,-30669.1
buyer_4,Jorge,50,ES97209511410504980753,TRX_N-00872-28361074,2024-02-08T21:17:24,Galdakao,expenses,water,-20.99,-30690.09
buyer_4,Jorge,50,ES97209511410504980753,TRX_N-00873-97874472,2024-02-08T17:35:52,Galdakao,expenses,electricity,-35.68,-30725.77
buyer_4,Jorge,50,ES97209511410504980753,TRX_N-00874-65942990,2024-02-08T20:13:51,Galdakao,expenses,gas,-91.54,-30817.31
buyer_4,Jorge,50,ES97209511410504980753,TRX_N-00875-97751070,2024-02-08T13:24:16,Galdakao,expenses,internet,-42.0,-30859.31
buyer_4,Jorge,50,ES97209511410504980753,TRX_N-00876-81548832,2024-02-08T02:36:34,Galdakao,Expense,education,-76.18,-30935.49
buyer_4,Jorge,50,ES97209511410504980753,TRX_N-00877-16472044,2024-02-09T23:22:13,Galdakao,Expense,cash,-100.0,-31035.49
buyer_4,Jorge,50,ES97209511410504980753,TRX_N-00878-70740943,2024-02-11T04:23:11,Santurtzi,Expense,cash,-100.0,-31135.49
buyer_4,Jorge,50,ES97209511410504980753,TRX_N-00879-01169554,2024-02-13T16:28:09,Galdakao,Expense,food,-123.33,-31258.82
buyer_4,Jorge,50,ES97209511410504980753,TRX_N-00880-61624171,2024-02-13T21:03:36,Galdakao,expenses,children,-132.83,-31391.65
buyer_4,Jorge,50,ES97209511410504980753,TRX_N-00881-19669518,2024-02-14T13:50:21,Galdakao,Expense,food,-72.91,-31464.56
buyer_4,Jorge,50,ES97209511410504980753,TRX_N-00882-31875029,2024-02-14T15:18:44,Andoain,Expense,repairs,-108.44,-31573.0
buyer_4,Jorge,50,ES97209511410504980753,TRX_N-00883-78195798,2024-02-15T19:38:16,Galdakao,Expense,leisure,-18.77,-31591.77
buyer_4,Jorge,50,ES97209511410504980753,TRX_N-00884-36348239,2024-02-17T16:26:01,Galdakao,Expense,leisure,-79.3,-31671.07
buyer_4,Jorge,50,ES97209511410504980753,TRX_N-00885-13302198,2024-02-18T18:27:35,Galdakao,expenses,children,-276.73,-31947.8
buyer_4,Jorge,50,ES97209511410504980753,TRX_N-00886-37261327,2024-02-19T13:26:34,Galdakao,Expense,transport,-60.98,-32008.78
buyer_4,Jorge,50,ES97209511410504980753,TRX_N-00887-05838879,2024-02-19T20:58:40,Galdakao,Expense,cash,-100.0,-32108.78
buyer_4,Jorge,50,ES97209511410504980753,TRX_N-00888-12978138,2024-02-21T20:54:13,Galdakao,Expense,leisure,-30.75,-32139.53
buyer_4,Jorge,50,ES97209511410504980753,TRX_N-00889-25290267,2024-02-21T12:32:36,Galdakao,Expense,cash,-100.0,-32239.53
buyer_4,Jorge,50,ES97209511410504980753,TRX_N-00890-34054121,2024-02-23T21:00:03,Galdakao,Expense,food,-106.92,-32346.45
buyer_4,Jorge,50,ES97209511410504980753,TRX_N-00891-16317815,2024-02-23T03:17:48,Galdakao,Expense,clothing,-123.91,-32470.36
buyer_4,Jorge,50,ES97209511410504980753,TRX_N-00892-93277963,2024-02-24T16:13:51,Portugalete,Expense,cash,-100.0,-32570.36
buyer_4,Jorge,50,ES97209511410504980753,TRX_N-00893-73815337,2024-02-24T15:34:55,Basauri,Expense,appliances,-136.41,-32706.77
buyer_4,Jorge,50,ES97209511410504980753,TRX_N-00894-67808632,2024-02-25T22:42:11,Galdakao,Expense,food,-93.34,-32800.11
buyer_4,Jorge,50,ES97209511410504980753,TRX_N-00895-00422128,2024-02-25T19:42:31,Galdakao,Expense,cash,-100.0,-32900.11
buyer_4,Jorge,50,ES97209511410504980753,TRX_N-00896-22507886,2024-02-26T16:26:16,Galdakao,Expense,food,-76.98,-32977.09
buyer_4,Jorge,50,ES97209511410504980753,TRX_N-00897-71514356,2024-02-28T20:10:26,Galdakao,Expense,repairs,-142.42,-33119.51
buyer_4,Jorge,50,ES97209511410504980753,TRX_N-00898-20537838,2024-03-01T08:05:58,Galdakao,incomes,salary,1557.3,-31562.21
buyer_4,Jorge,50,ES97209511410504980753,TRX_N-00899-31138283,2024-03-01T08:05:58,Galdakao,incomes,salary_partner,1263.31,-30298.9
buyer_4,Jorge,50,ES97209511410504980753,TRX_N-00900-42204204,2024-03-01T08:05:58,Galdakao,incomes,extra_income,273.62,-30025.28
buyer_4,Jorge,50,ES97209511410504980753,TRX_N-00901-95300119,2024-03-04T13:13:25,Galdakao,expenses,mortgage,-863.85,-30889.13
buyer_4,Jorge,50,ES97209511410504980753,TRX_N-00902-14387507,2024-03-05T14:04:21,Galdakao,expenses,internet,-42.0,-30931.13
buyer_4,Jorge,50,ES97209511410504980753,TRX_N-00903-97510120,2024-03-06T11:52:37,Galdakao,Expense,leisure,-34.61,-30965.74
buyer_4,Jorge,50,ES97209511410504980753,TRX_N-00904-93682346,2024-03-07T00:44:05,Galdakao,expenses,gas,-36.42,-31002.16
buyer_4,Jorge,50,ES97209511410504980753,TRX_N-00905-77523300,2024-03-07T08:09:54,Galdakao,Expense,education,-58.91,-31061.07
buyer_4,Jorge,50,ES97209511410504980753,TRX_N-00906-17949491,2024-03-07T20:51:51,Galdakao,Expense,gifts,-168.41,-31229.48
buyer_4,Jorge,50,ES97209511410504980753,TRX_N-00907-83152802,2024-03-08T13:12:48,Galdakao,expenses,water,-25.17,-31254.65
buyer_4,Jorge,50,ES97209511410504980753,TRX_N-00908-35072981,2024-03-08T10:05:05,Galdakao,expenses,electricity,-73.98,-31328.63
buyer_4,Jorge,50,ES97209511410504980753,TRX_N-00909-13106103,2024-03-08T18:49:22,Galdakao,expenses,phone,-30.77,-31359.4
buyer_4,Jorge,50,ES97209511410504980753,TRX_N-00910-77804965,2024-03-08T16:10:07,Galdakao,Expense,repairs,-210.61,-31570.01
buyer_4,Jorge,50,ES97209511410504980753,TRX_N-00911-65899707,2024-03-10T13:42:35,Llodio,Expense,cash,-100.0,-31670.01
buyer_4,Jorge,50,ES97209511410504980753,TRX_N-00912-58245040,2024-03-11T22:47:11,Iru√±a de Oca,Expense,food,-89.73,-31759.74
buyer_4,Jorge,50,ES97209511410504980753,TRX_N-00913-20157515,2024-03-12T17:49:19,Galdakao,Expense,transport,-65.77,-31825.51
buyer_4,Jorge,50,ES97209511410504980753,TRX_N-00914-01851991,2024-03-12T20:05:38,Galdakao,Expense,education,-77.19,-31902.7
buyer_4,Jorge,50,ES97209511410504980753,TRX_N-00915-57189295,2024-03-14T20:49:41,Galdakao,Expense,food,-87.37,-31990.07
buyer_4,Jorge,50,ES97209511410504980753,TRX_N-00916-01653707,2024-03-16T18:21:51,Galdakao,Expense,cash,-100.0,-32090.07
buyer_4,Jorge,50,ES97209511410504980753,TRX_N-00917-12247466,2024-03-17T08:09:58,Galdakao,expenses,children,-65.11,-32155.18
buyer_4,Jorge,50,ES97209511410504980753,TRX_N-00918-62142429,2024-03-20T11:48:45,Galdakao,Expense,repairs,-122.34,-32277.52
buyer_4,Jorge,50,ES97209511410504980753,TRX_N-00919-51868218,2024-03-23T20:04:45,Galdakao,Expense,food,-119.83,-32397.35
buyer_4,Jorge,50,ES97209511410504980753,TRX_N-00920-49367739,2024-03-23T12:02:30,Galdakao,Expense,leisure,-19.2,-32416.55
buyer_4,Jorge,50,ES97209511410504980753,TRX_N-00921-85162037,2024-03-23T20:53:37,Galdakao,Expense,cash,-100.0,-32516.55
buyer_4,Jorge,50,ES97209511410504980753,TRX_N-00922-35049033,2024-03-24T20:54:10,Galdakao,Expense,clothing,-103.88,-32620.43
buyer_4,Jorge,50,ES97209511410504980753,TRX_N-00923-06034566,2024-03-24T13:03:26,Galdakao,Expense,repairs,-280.8,-32901.23
buyer_4,Jorge,50,ES97209511410504980753,TRX_N-00924-88710143,2024-03-24T13:55:35,Zarautz,Expense,gifts,-633.85,-33535.08
buyer_4,Jorge,50,ES97209511410504980753,TRX_N-00925-52424836,2024-03-27T09:01:23,Galdakao,Expense,food,-81.47,-33616.55
buyer_4,Jorge,50,ES97209511410504980753,TRX_N-00926-99356172,2024-03-28T08:07:03,Galdakao,Expense,education,-66.91,-33683.46
buyer_4,Jorge,50,ES97209511410504980753,TRX_N-00927-76840531,2024-03-29T11:39:53,Galdakao,Expense,healthcare,-157.53,-33840.99
buyer_4,Jorge,50,ES97209511410504980753,TRX_N-00928-10162436,2024-03-31T02:37:13,Galdakao,expenses,children,-236.85,-34077.84
buyer_4,Jorge,50,ES97209511410504980753,TRX_N-00929-04773009,2024-04-01T13:49:19,Galdakao,incomes,salary,1557.3,-32520.54
buyer_4,Jorge,50,ES97209511410504980753,TRX_N-00930-70731796,2024-04-01T13:49:19,Galdakao,incomes,salary_partner,1263.31,-31257.23
buyer_4,Jorge,50,ES97209511410504980753,TRX_N-00931-60766173,2024-04-01T18:39:09,Galdakao,Expense,food,-68.23,-31325.46
buyer_4,Jorge,50,ES97209511410504980753,TRX_N-00932-83724740,2024-04-03T22:42:02,Galdakao,Expense,clothing,-108.12,-31433.58
buyer_4,Jorge,50,ES97209511410504980753,TRX_N-00933-42973732,2024-04-04T13:03:26,Galdakao,expenses,mortgage,-863.85,-32297.43
buyer_4,Jorge,50,ES97209511410504980753,TRX_N-00934-22469700,2024-04-05T22:49:41,Galdakao,expenses,electricity,-31.11,-32328.54
buyer_4,Jorge,50,ES97209511410504980753,TRX_N-00935-19371183,2024-04-05T13:28:03,Galdakao,Expense,repairs,-258.11,-32586.65
buyer_4,Jorge,50,ES97209511410504980753,TRX_N-00936-53828830,2024-04-06T10:18:47,Galdakao,expenses,gas,-108.71,-32695.36
buyer_4,Jorge,50,ES97209511410504980753,TRX_N-00937-66121122,2024-04-06T16:08:58,Galdakao,expenses,internet,-42.0,-32737.36
buyer_4,Jorge,50,ES97209511410504980753,TRX_N-00938-92127877,2024-04-08T18:07:12,Galdakao,expenses,water,-30.71,-32768.07
buyer_4,Jorge,50,ES97209511410504980753,TRX_N-00939-19528735,2024-04-08T13:45:44,Galdakao,expenses,phone,-39.45,-32807.52
buyer_4,Jorge,50,ES97209511410504980753,TRX_N-00940-53991874,2024-04-08T20:23:27,Galdakao,Expense,transport,-64.57,-32872.09
buyer_4,Jorge,50,ES97209511410504980753,TRX_N-00941-93757509,2024-04-09T08:54:35,Donostia,Expense,repairs,-188.77,-33060.86
buyer_4,Jorge,50,ES97209511410504980753,TRX_N-00942-73752677,2024-04-11T09:18:07,Galdakao,Expense,cash,-100.0,-33160.86
buyer_4,Jorge,50,ES97209511410504980753,TRX_N-00943-76605526,2024-04-16T19:03:48,Galdakao,Expense,leisure,-57.4,-33218.26
buyer_4,Jorge,50,ES97209511410504980753,TRX_N-00944-39498367,2024-04-16T10:35:49,Galdakao,Expense,education,-64.49,-33282.75
buyer_4,Jorge,50,ES97209511410504980753,TRX_N-00945-08545799,2024-04-16T20:51:43,Galdakao,Expense,repairs,-91.79,-33374.54
buyer_4,Jorge,50,ES97209511410504980753,TRX_N-00946-77414821,2024-04-17T18:03:35,Galdakao,Expense,clothing,-126.56,-33501.1
buyer_4,Jorge,50,ES97209511410504980753,TRX_N-00947-12859720,2024-04-17T18:51:29,Galdakao,Expense,cash,-100.0,-33601.1
buyer_4,Jorge,50,ES97209511410504980753,TRX_N-00948-66837350,2024-04-19T20:39:40,Galdakao,Expense,healthcare,-141.07,-33742.17
buyer_4,Jorge,50,ES97209511410504980753,TRX_N-00949-20102914,2024-04-20T10:58:07,Galdakao,Expense,leisure,-78.95,-33821.12
buyer_4,Jorge,50,ES97209511410504980753,TRX_N-00950-40160344,2024-04-24T05:22:20,Durango,Expense,cash,-100.0,-33921.12
buyer_4,Jorge,50,ES97209511410504980753,TRX_N-00951-46162266,2024-04-25T10:17:34,Galdakao,expenses,children,-83.18,-34004.3
buyer_4,Jorge,50,ES97209511410504980753,TRX_N-00952-59868064,2024-04-30T13:10:50,Galdakao,Expense,transport,-63.05,-34067.35
buyer_4,Jorge,50,ES97209511410504980753,TRX_N-00953-88050262,2024-04-30T20:37:27,Eibar,Expense,leisure,-59.04,-34126.39
buyer_4,Jorge,50,ES97209511410504980753,TRX_N-00954-67295567,2024-04-30T12:08:58,Galdakao,Expense,cash,-100.0,-34226.39
buyer_4,Jorge,50,ES97209511410504980753,TRX_N-00955-95012686,2024-05-01T10:26:36,Galdakao,incomes,salary,1557.3,-32669.09
buyer_4,Jorge,50,ES97209511410504980753,TRX_N-00956-81529147,2024-05-01T10:26:36,Galdakao,incomes,salary_partner,1263.31,-31405.78
buyer_4,Jorge,50,ES97209511410504980753,TRX_N-00957-61473878,2024-05-01T10:57:28,Galdakao,Expense,healthcare,-119.94,-31525.72
buyer_4,Jorge,50,ES97209511410504980753,TRX_N-00958-33978051,2024-05-02T09:18:11,Galdakao,Expense,cash,-100.0,-31625.72
buyer_4,Jorge,50,ES97209511410504980753,TRX_N-00959-66258638,2024-05-03T13:01:12,Galdakao,Expense,transport,-83.06,-31708.78
buyer_4,Jorge,50,ES97209511410504980753,TRX_N-00960-42313196,2024-05-04T10:08:46,Galdakao,expenses,mortgage,-863.85,-32572.63
buyer_4,Jorge,50,ES97209511410504980753,TRX_N-00961-04289528,2024-05-04T16:34:07,Oy√≥n-Oion,Expense,food,-88.19,-32660.82
buyer_4,Jorge,50,ES97209511410504980753,TRX_N-00962-35226240,2024-05-04T12:40:33,Alegr√≠a-Dulantzi,Expense,cash,-100.0,-32760.82
buyer_4,Jorge,50,ES97209511410504980753,TRX_N-00963-77859413,2024-05-04T01:44:28,Galdakao,Expense,gifts,-535.16,-33295.98
buyer_4,Jorge,50,ES97209511410504980753,TRX_N-00964-06371658,2024-05-05T10:57:11,Galdakao,expenses,water,-44.75,-33340.73
buyer_4,Jorge,50,ES97209511410504980753,TRX_N-00965-54692507,2024-05-05T19:35:18,Galdakao,Expense,gifts,-409.82,-33750.55
buyer_4,Jorge,50,ES97209511410504980753,TRX_N-00966-63603211,2024-05-06T17:35:52,Galdakao,Expense,leisure,-36.21,-33786.76
buyer_4,Jorge,50,ES97209511410504980753,TRX_N-00967-28874971,2024-05-06T19:30:24,Galdakao,Expense,education,-71.88,-33858.64
buyer_4,Jorge,50,ES97209511410504980753,TRX_N-00968-88906871,2024-05-07T11:03:51,Galdakao,expenses,electricity,-25.12,-33883.76
buyer_4,Jorge,50,ES97209511410504980753,TRX_N-00969-68933001,2024-05-07T11:51:27,Galdakao,expenses,internet,-42.0,-33925.76
buyer_4,Jorge,50,ES97209511410504980753,TRX_N-00970-58666210,2024-05-07T20:19:58,Galdakao,expenses,phone,-43.15,-33968.91
buyer_4,Jorge,50,ES97209511410504980753,TRX_N-00971-19559114,2024-05-07T14:15:20,Galdakao,Expense,food,-102.42,-34071.33
buyer_4,Jorge,50,ES97209511410504980753,TRX_N-00972-44130669,2024-05-07T09:23:33,Galdakao,expenses,children,-111.39,-34182.72
buyer_4,Jorge,50,ES97209511410504980753,TRX_N-00973-06808854,2024-05-08T11:11:23,Galdakao,expenses,gas,-103.66,-34286.38
buyer_4,Jorge,50,ES97209511410504980753,TRX_N-00974-57301061,2024-05-08T11:03:21,Galdakao,Expense,food,-67.58,-34353.96
buyer_4,Jorge,50,ES97209511410504980753,TRX_N-00975-20557133,2024-05-09T23:34:01,Galdakao,Expense,cash,-100.0,-34453.96
buyer_4,Jorge,50,ES97209511410504980753,TRX_N-00976-09292158,2024-05-10T12:51:36,Galdakao,Expense,food,-105.98,-34559.94
buyer_4,Jorge,50,ES97209511410504980753,TRX_N-00977-03792836,2024-05-11T10:11:15,Galdakao,Expense,cash,-100.0,-34659.94
buyer_4,Jorge,50,ES97209511410504980753,TRX_N-00978-80567958,2024-05-11T08:16:05,Galdakao,Expense,gifts,-732.31,-35392.25
buyer_4,Jorge,50,ES97209511410504980753,TRX_N-00979-45774300,2024-05-11T16:29:30,Galdakao,expenses,children,-51.03,-35443.28
buyer_4,Jorge,50,ES97209511410504980753,TRX_N-00980-87081058,2024-05-12T08:49:59,Galdakao,Expense,leisure,-73.98,-35517.26
buyer_4,Jorge,50,ES97209511410504980753,TRX_N-00981-77691704,2024-05-12T15:27:22,Galdakao,Expense,cash,-100.0,-35617.26
buyer_4,Jorge,50,ES97209511410504980753,TRX_N-00982-47157834,2024-05-13T14:46:31,Galdakao,Expense,education,-61.43,-35678.69
buyer_4,Jorge,50,ES97209511410504980753,TRX_N-00983-91869730,2024-05-14T11:53:05,Llodio,Expense,cash,-100.0,-35778.69
buyer_4,Jorge,50,ES97209511410504980753,TRX_N-00984-02367163,2024-05-16T20:16:54,Vitoria-Gasteiz,Expense,cash,-100.0,-35878.69
buyer_4,Jorge,50,ES97209511410504980753,TRX_N-00985-86388317,2024-05-17T12:03:16,Sestao,Expense,cash,-100.0,-35978.69
buyer_4,Jorge,50,ES97209511410504980753,TRX_N-00986-07955035,2024-05-19T20:20:29,Iru√±a de Oca,Expense,food,-61.42,-36040.11
buyer_4,Jorge,50,ES97209511410504980753,TRX_N-00987-15329007,2024-05-20T15:07:19,Galdakao,Expense,transport,-79.17,-36119.28
buyer_4,Jorge,50,ES97209511410504980753,TRX_N-00988-97390285,2024-05-21T06:28:42,Galdakao,Expense,leisure,-48.4,-36167.68
buyer_4,Jorge,50,ES97209511410504980753,TRX_N-00989-49277769,2024-05-21T17:29:32,Galdakao,Expense,education,-56.65,-36224.33
buyer_4,Jorge,50,ES97209511410504980753,TRX_N-00990-49920813,2024-05-21T10:47:56,Galdakao,expenses,children,-273.92,-36498.25
buyer_4,Jorge,50,ES97209511410504980753,TRX_N-00991-59718772,2024-05-23T13:32:17,Elciego,Expense,food,-113.44,-36611.69
buyer_4,Jorge,50,ES97209511410504980753,TRX_N-00992-03555294,2024-05-25T14:25:45,Basauri,Expense,food,-65.22,-36676.91
buyer_4,Jorge,50,ES97209511410504980753,TRX_N-00993-53373393,2024-05-28T14:29:19,Galdakao,Expense,cash,-100.0,-36776.91
buyer_4,Jorge,50,ES97209511410504980753,TRX_N-00994-11465255,2024-05-30T11:35:00,Galdakao,Expense,appliances,-328.59,-37105.5
buyer_4,Jorge,50,ES97209511410504980753,TRX_N-00995-10743401,2024-05-31T20:55:27,Galdakao,Expense,travel,-399.15,-37504.65
buyer_4,Jorge,50,ES97209511410504980753,TRX_N-00996-24433345,2024-06-01T11:20:12,Galdakao,incomes,salary,1557.3,-35947.35
buyer_4,Jorge,50,ES97209511410504980753,TRX_N-00997-24715259,2024-06-01T11:20:12,Galdakao,incomes,salary_partner,1263.31,-34684.04
buyer_4,Jorge,50,ES97209511410504980753,TRX_N-00998-27030565,2024-06-01T11:20:12,Galdakao,incomes,salary_bonus,1165.97,-33518.07
buyer_4,Jorge,50,ES97209511410504980753,TRX_N-00999-97143927,2024-06-01T11:20:12,Galdakao,incomes,salary_partner_bonus,896.26,-32621.81
buyer_4,Jorge,50,ES97209511410504980753,TRX_N-01000-07153685,2024-06-01T08:16:04,Llodio,Expense,leisure,-56.54,-32678.35
buyer_4,Jorge,50,ES97209511410504980753,TRX_N-01001-24333018,2024-06-03T18:30:53,Galdakao,Expense,gifts,-196.03,-32874.38
buyer_4,Jorge,50,ES97209511410504980753,TRX_N-01002-63288418,2024-06-04T10:55:43,Galdakao,expenses,mortgage,-863.85,-33738.23
buyer_4,Jorge,50,ES97209511410504980753,TRX_N-01003-58015393,2024-06-04T03:27:15,Galdakao,Expense,clothing,-147.02,-33885.25
buyer_4,Jorge,50,ES97209511410504980753,TRX_N-01004-30558081,2024-06-04T12:14:52,Galdakao,Expense,cash,-100.0,-33985.25
buyer_4,Jorge,50,ES97209511410504980753,TRX_N-01005-76065589,2024-06-06T19:56:23,Galdakao,expenses,water,-21.59,-34006.84
buyer_4,Jorge,50,ES97209511410504980753,TRX_N-01006-83589594,2024-06-06T11:52:37,Galdakao,Expense,repairs,-267.75,-34274.59
buyer_4,Jorge,50,ES97209511410504980753,TRX_N-01007-61767260,2024-06-08T12:51:25,Galdakao,expenses,electricity,-45.25,-34319.84
buyer_4,Jorge,50,ES97209511410504980753,TRX_N-01008-92956525,2024-06-08T20:46:48,Galdakao,expenses,gas,-54.69,-34374.53
buyer_4,Jorge,50,ES97209511410504980753,TRX_N-01009-08668321,2024-06-08T17:51:11,Galdakao,expenses,internet,-42.0,-34416.53
buyer_4,Jorge,50,ES97209511410504980753,TRX_N-01010-62624420,2024-06-08T21:18:42,Galdakao,expenses,phone,-30.98,-34447.51
buyer_4,Jorge,50,ES97209511410504980753,TRX_N-01011-83543703,2024-06-09T05:49:47,Galdakao,Expense,clothing,-107.96,-34555.47
buyer_4,Jorge,50,ES97209511410504980753,TRX_N-01012-06410059,2024-06-12T09:54:19,Galdakao,Expense,food,-107.7,-34663.17
buyer_4,Jorge,50,ES97209511410504980753,TRX_N-01013-68181423,2024-06-12T18:33:40,Galdakao,Expense,transport,-57.39,-34720.56
buyer_4,Jorge,50,ES97209511410504980753,TRX_N-01014-83368537,2024-06-12T10:01:24,Galdakao,Expense,leisure,-40.07,-34760.63
buyer_4,Jorge,50,ES97209511410504980753,TRX_N-01015-44961862,2024-06-13T02:02:50,Sopela,Expense,food,-120.12,-34880.75
buyer_4,Jorge,50,ES97209511410504980753,TRX_N-01016-01263766,2024-06-16T19:33:13,Zuia,Expense,repairs,-231.4,-35112.15
buyer_4,Jorge,50,ES97209511410504980753,TRX_N-01017-64137971,2024-06-17T15:44:30,Galdakao,Expense,leisure,-77.63,-35189.78
buyer_4,Jorge,50,ES97209511410504980753,TRX_N-01018-71581226,2024-06-17T12:05:13,Galdakao,Expense,cash,-100.0,-35289.78
buyer_4,Jorge,50,ES97209511410504980753,TRX_N-01019-69013121,2024-06-18T13:37:01,Galdakao,Expense,cash,-100.0,-35389.78
buyer_4,Jorge,50,ES97209511410504980753,TRX_N-01020-53952579,2024-06-18T22:56:57,Galdakao,Expense,gifts,-653.62,-36043.4
buyer_4,Jorge,50,ES97209511410504980753,TRX_N-01021-55151323,2024-06-22T08:28:07,Galdakao,Expense,food,-80.49,-36123.89
buyer_4,Jorge,50,ES97209511410504980753,TRX_N-01022-01916904,2024-06-22T13:41:12,Galdakao,Expense,leisure,-79.07,-36202.96
buyer_4,Jorge,50,ES97209511410504980753,TRX_N-01023-65805543,2024-06-24T10:08:53,Leioa,Expense,food,-61.89,-36264.85
buyer_4,Jorge,50,ES97209511410504980753,TRX_N-01024-71983048,2024-06-25T21:57:42,Bilbao,Expense,food,-121.92,-36386.77
buyer_4,Jorge,50,ES97209511410504980753,TRX_N-01025-69057670,2024-06-25T17:07:54,Galdakao,Expense,transport,-78.2,-36464.97
buyer_4,Jorge,50,ES97209511410504980753,TRX_N-01026-36541248,2024-06-25T08:06:56,Galdakao,Expense,leisure,-59.54,-36524.51
buyer_4,Jorge,50,ES97209511410504980753,TRX_N-01027-53157338,2024-06-25T06:13:32,Galdakao,Expense,cash,-100.0,-36624.51
buyer_4,Jorge,50,ES97209511410504980753,TRX_N-01028-69505226,2024-06-25T18:27:41,Galdakao,Expense,travel,-1080.37,-37704.88
buyer_4,Jorge,50,ES97209511410504980753,TRX_N-01029-79414836,2024-06-25T16:08:36,Galdakao,expenses,children,-238.49,-37943.37
buyer_4,Jorge,50,ES97209511410504980753,TRX_N-01030-76811054,2024-06-26T17:44:11,Galdakao,expenses,children,-248.98,-38192.35
buyer_4,Jorge,50,ES97209511410504980753,TRX_N-01031-83115428,2024-07-01T10:39:32,Galdakao,incomes,salary,1557.3,-36635.05
buyer_4,Jorge,50,ES97209511410504980753,TRX_N-01032-19760195,2024-07-01T10:39:32,Galdakao,incomes,salary_partner,1263.31,-35371.74
buyer_4,Jorge,50,ES97209511410504980753,TRX_N-01033-00075404,2024-07-01T10:39:32,Galdakao,incomes,extra_income,273.62,-35098.12
buyer_4,Jorge,50,ES97209511410504980753,TRX_N-01034-32726066,2024-07-01T13:23:11,Galdakao,Expense,leisure,-32.09,-35130.21
buyer_4,Jorge,50,ES97209511410504980753,TRX_N-01035-64676636,2024-07-02T18:52:21,Galdakao,Expense,food,-64.36,-35194.57
buyer_4,Jorge,50,ES97209511410504980753,TRX_N-01036-73654556,2024-07-03T13:20:28,Galdakao,Expense,food,-61.86,-35256.43
buyer_4,Jorge,50,ES97209511410504980753,TRX_N-01037-41387216,2024-07-03T12:54:22,Galdakao,Expense,education,-69.8,-35326.23
buyer_4,Jorge,50,ES97209511410504980753,TRX_N-01038-52739597,2024-07-03T15:49:38,Basauri,Expense,cash,-100.0,-35426.23
buyer_4,Jorge,50,ES97209511410504980753,TRX_N-01039-53523534,2024-07-04T08:21:44,Galdakao,expenses,mortgage,-863.85,-36290.08
buyer_4,Jorge,50,ES97209511410504980753,TRX_N-01040-67219061,2024-07-05T10:37:49,Galdakao,expenses,electricity,-40.49,-36330.57
buyer_4,Jorge,50,ES97209511410504980753,TRX_N-01041-73907339,2024-07-05T10:11:06,Galdakao,expenses,phone,-33.59,-36364.16
buyer_4,Jorge,50,ES97209511410504980753,TRX_N-01042-64392602,2024-07-06T14:30:41,Galdakao,expenses,gas,-106.94,-36471.1
buyer_4,Jorge,50,ES97209511410504980753,TRX_N-01043-75880776,2024-07-07T15:45:01,Galdakao,expenses,internet,-42.0,-36513.1
buyer_4,Jorge,50,ES97209511410504980753,TRX_N-01044-44747490,2024-07-07T14:55:23,Galdakao,Expense,food,-105.85,-36618.95
buyer_4,Jorge,50,ES97209511410504980753,TRX_N-01045-28054486,2024-07-07T09:40:57,Galdakao,Expense,transport,-71.3,-36690.25
buyer_4,Jorge,50,ES97209511410504980753,TRX_N-01046-13721550,2024-07-08T14:37:28,Galdakao,expenses,water,-37.14,-36727.39
buyer_4,Jorge,50,ES97209511410504980753,TRX_N-01047-62423691,2024-07-08T20:50:18,Galdakao,Expense,food,-80.02,-36807.41
buyer_4,Jorge,50,ES97209511410504980753,TRX_N-01048-43616221,2024-07-08T16:26:03,Galdakao,expenses,children,-104.06,-36911.47
buyer_4,Jorge,50,ES97209511410504980753,TRX_N-01049-23112845,2024-07-10T11:30:15,Galdakao,Expense,transport,-89.3,-37000.77
buyer_4,Jorge,50,ES97209511410504980753,TRX_N-01050-49212452,2024-07-10T06:24:45,Getxo,Expense,leisure,-36.67,-37037.44
buyer_4,Jorge,50,ES97209511410504980753,TRX_N-01051-17440170,2024-07-12T17:45:22,Galdakao,Expense,repairs,-72.97,-37110.41
buyer_4,Jorge,50,ES97209511410504980753,TRX_N-01052-22164832,2024-07-14T16:39:47,Galdakao,Expense,cash,-100.0,-37210.41
buyer_4,Jorge,50,ES97209511410504980753,TRX_N-01053-64632472,2024-07-15T14:23:24,Galdakao,Expense,transport,-78.29,-37288.7
buyer_4,Jorge,50,ES97209511410504980753,TRX_N-01054-17363014,2024-07-15T09:27:29,Galdakao,Expense,leisure,-82.32,-37371.02
buyer_4,Jorge,50,ES97209511410504980753,TRX_N-01055-04143583,2024-07-15T15:09:45,Galdakao,Expense,education,-78.71,-37449.73
buyer_4,Jorge,50,ES97209511410504980753,TRX_N-01056-16617770,2024-07-16T16:35:03,Galdakao,Expense,food,-70.24,-37519.97
buyer_4,Jorge,50,ES97209511410504980753,TRX_N-01057-19304918,2024-07-17T18:02:35,Galdakao,Expense,clothing,-65.45,-37585.42
buyer_4,Jorge,50,ES97209511410504980753,TRX_N-01058-13419486,2024-07-17T18:43:28,Galdakao,Expense,gifts,-111.04,-37696.46
buyer_4,Jorge,50,ES97209511410504980753,TRX_N-01059-62779984,2024-07-20T15:56:23,Galdakao,Expense,healthcare,-100.53,-37796.99
buyer_4,Jorge,50,ES97209511410504980753,TRX_N-01060-16291182,2024-07-21T12:33:05,Galdakao,Expense,food,-65.22,-37862.21
buyer_4,Jorge,50,ES97209511410504980753,TRX_N-01061-49349048,2024-07-22T20:01:33,Galdakao,Expense,education,-69.72,-37931.93
buyer_4,Jorge,50,ES97209511410504980753,TRX_N-01062-79997536,2024-07-23T19:57:20,Galdakao,Expense,food,-100.78,-38032.71
buyer_4,Jorge,50,ES97209511410504980753,TRX_N-01063-79895656,2024-07-24T10:58:32,Galdakao,Expense,transport,-57.11,-38089.82
buyer_4,Jorge,50,ES97209511410504980753,TRX_N-01064-60960535,2024-07-24T09:43:51,Galdakao,Expense,cash,-100.0,-38189.82
buyer_4,Jorge,50,ES97209511410504980753,TRX_N-01065-23145296,2024-07-24T14:02:14,Galdakao,Expense,repairs,-210.99,-38400.81
buyer_4,Jorge,50,ES97209511410504980753,TRX_N-01066-30581570,2024-07-27T17:03:34,Galdakao,expenses,children,-225.66,-38626.47
buyer_4,Jorge,50,ES97209511410504980753,TRX_N-01067-80860984,2024-07-28T18:52:01,Galdakao,Expense,food,-82.24,-38708.71
buyer_4,Jorge,50,ES97209511410504980753,TRX_N-01068-79435662,2024-07-29T16:14:16,Galdakao,Expense,clothing,-70.28,-38778.99
buyer_4,Jorge,50,ES97209511410504980753,TRX_N-01069-43543834,2024-07-29T15:23:03,Galdakao,Expense,repairs,-65.94,-38844.93
buyer_4,Jorge,50,ES97209511410504980753,TRX_N-01070-73627140,2024-07-29T19:01:05,Galdakao,Expense,gifts,-309.94,-39154.87
buyer_4,Jorge,50,ES97209511410504980753,TRX_N-01071-16457989,2024-07-30T08:05:42,Galdakao,Expense,cash,-100.0,-39254.87
buyer_4,Jorge,50,ES97209511410504980753,TRX_N-01072-12399556,2024-07-31T11:23:13,Bermeo,Expense,repairs,-253.1,-39507.97
buyer_4,Jorge,50,ES97209511410504980753,TRX_N-01073-97885467,2024-08-01T17:32:04,Galdakao,incomes,salary,1557.3,-37950.67
buyer_4,Jorge,50,ES97209511410504980753,TRX_N-01074-64277653,2024-08-01T17:32:04,Galdakao,incomes,salary_partner,1263.31,-36687.36
buyer_4,Jorge,50,ES97209511410504980753,TRX_N-01075-52566627,2024-08-03T19:59:39,Lasarte-Oria,Expense,food,-105.42,-36792.78
buyer_4,Jorge,50,ES97209511410504980753,TRX_N-01076-65312330,2024-08-04T14:30:04,Galdakao,expenses,mortgage,-863.85,-37656.63
buyer_4,Jorge,50,ES97209511410504980753,TRX_N-01077-76266480,2024-08-04T12:02:27,Galdakao,Expense,appliances,-187.63,-37844.26
buyer_4,Jorge,50,ES97209511410504980753,TRX_N-01078-99261228,2024-08-04T17:38:43,Galdakao,Expense,gifts,-451.63,-38295.89
buyer_4,Jorge,50,ES97209511410504980753,TRX_N-01079-15028142,2024-08-06T14:51:26,Galdakao,expenses,water,-25.75,-38321.64
buyer_4,Jorge,50,ES97209511410504980753,TRX_N-01080-32763237,2024-08-06T22:51:34,Galdakao,Expense,leisure,-24.99,-38346.63
buyer_4,Jorge,50,ES97209511410504980753,TRX_N-01081-51856916,2024-08-06T19:57:59,Galdakao,Expense,education,-64.63,-38411.26
buyer_4,Jorge,50,ES97209511410504980753,TRX_N-01082-70259768,2024-08-07T20:22:17,Galdakao,Expense,food,-66.68,-38477.94
buyer_4,Jorge,50,ES97209511410504980753,TRX_N-01083-25721348,2024-08-08T11:54:13,Galdakao,expenses,internet,-42.0,-38519.94
buyer_4,Jorge,50,ES97209511410504980753,TRX_N-01084-91514856,2024-08-08T08:40:07,Galdakao,expenses,electricity,-71.57,-38591.51
buyer_4,Jorge,50,ES97209511410504980753,TRX_N-01085-50958944,2024-08-08T14:22:34,Galdakao,expenses,gas,-51.39,-38642.9
buyer_4,Jorge,50,ES97209511410504980753,TRX_N-01086-42271298,2024-08-08T14:31:27,Galdakao,expenses,phone,-33.81,-38676.71
buyer_4,Jorge,50,ES97209511410504980753,TRX_N-01087-27095319,2024-08-08T22:41:52,Galdakao,Expense,cash,-100.0,-38776.71
buyer_4,Jorge,50,ES97209511410504980753,TRX_N-01088-23297621,2024-08-09T18:18:25,Galdakao,Expense,cash,-100.0,-38876.71
buyer_4,Jorge,50,ES97209511410504980753,TRX_N-01089-75350160,2024-08-09T08:36:21,Galdakao,Expense,repairs,-149.19,-39025.9
buyer_4,Jorge,50,ES97209511410504980753,TRX_N-01090-77474516,2024-08-11T19:18:29,Galdakao,Expense,transport,-49.28,-39075.18
buyer_4,Jorge,50,ES97209511410504980753,TRX_N-01091-86389543,2024-08-17T10:08:38,Hondarribia,Expense,food,-82.29,-39157.47
buyer_4,Jorge,50,ES97209511410504980753,TRX_N-01092-51331510,2024-08-17T07:58:43,Galdakao,Expense,gifts,-203.56,-39361.03
buyer_4,Jorge,50,ES97209511410504980753,TRX_N-01093-99877157,2024-08-18T05:33:23,Galdakao,Expense,transport,-82.35,-39443.38
buyer_4,Jorge,50,ES97209511410504980753,TRX_N-01094-57163099,2024-08-20T11:09:44,Galdakao,Expense,food,-101.33,-39544.71
buyer_4,Jorge,50,ES97209511410504980753,TRX_N-01095-64555797,2024-08-20T08:54:13,Galdakao,Expense,leisure,-29.08,-39573.79
buyer_4,Jorge,50,ES97209511410504980753,TRX_N-01096-97387045,2024-08-20T18:42:15,Mungia,Expense,cash,-100.0,-39673.79
buyer_4,Jorge,50,ES97209511410504980753,TRX_N-01097-40101066,2024-08-21T00:46:56,Galdakao,Expense,repairs,-62.57,-39736.36
buyer_4,Jorge,50,ES97209511410504980753,TRX_N-01098-96460678,2024-08-24T12:22:47,Galdakao,Expense,food,-79.84,-39816.2
buyer_4,Jorge,50,ES97209511410504980753,TRX_N-01099-30992047,2024-08-25T12:30:44,Galdakao,Expense,food,-79.7,-39895.9
buyer_4,Jorge,50,ES97209511410504980753,TRX_N-01100-87560991,2024-08-25T10:55:02,Galdakao,Expense,leisure,-59.93,-39955.83
buyer_4,Jorge,50,ES97209511410504980753,TRX_N-01101-66764136,2024-08-26T13:41:49,Galdakao,Expense,food,-111.17,-40067.0
buyer_4,Jorge,50,ES97209511410504980753,TRX_N-01102-32661539,2024-08-26T17:51:02,Galdakao,Expense,cash,-100.0,-40167.0
buyer_4,Jorge,50,ES97209511410504980753,TRX_N-01103-19053341,2024-08-27T13:00:04,Oy√≥n-Oion,Expense,leisure,-26.88,-40193.88
buyer_4,Jorge,50,ES97209511410504980753,TRX_N-01104-48356414,2024-08-30T16:56:13,Galdakao,Expense,appliances,-241.78,-40435.66
buyer_4,Jorge,50,ES97209511410504980753,TRX_N-01105-99543987,2024-09-01T16:30:43,Galdakao,incomes,salary,1557.3,-38878.36
buyer_4,Jorge,50,ES97209511410504980753,TRX_N-01106-62917438,2024-09-01T16:30:43,Galdakao,incomes,salary_partner,1263.31,-37615.05
buyer_4,Jorge,50,ES97209511410504980753,TRX_N-01107-19957031,2024-09-02T14:28:13,Erandio,Expense,food,-119.2,-37734.25
buyer_4,Jorge,50,ES97209511410504980753,TRX_N-01108-66755346,2024-09-02T18:28:11,Galdakao,Expense,cash,-100.0,-37834.25
buyer_4,Jorge,50,ES97209511410504980753,TRX_N-01109-67204726,2024-09-02T20:13:52,Galdakao,Expense,gifts,-391.27,-38225.52
buyer_4,Jorge,50,ES97209511410504980753,TRX_N-01110-56449078,2024-09-03T05:58:16,Donostia,Expense,gifts,-661.46,-38886.98
buyer_4,Jorge,50,ES97209511410504980753,TRX_N-01111-41814399,2024-09-04T09:07:28,Galdakao,expenses,mortgage,-863.85,-39750.83
buyer_4,Jorge,50,ES97209511410504980753,TRX_N-01112-72050072,2024-09-05T19:01:33,Galdakao,expenses,water,-22.51,-39773.34
buyer_4,Jorge,50,ES97209511410504980753,TRX_N-01113-22900262,2024-09-05T10:26:15,Galdakao,expenses,internet,-42.0,-39815.34
buyer_4,Jorge,50,ES97209511410504980753,TRX_N-01114-07806644,2024-09-05T10:26:27,Galdakao,expenses,phone,-34.7,-39850.04
buyer_4,Jorge,50,ES97209511410504980753,TRX_N-01115-80834289,2024-09-06T11:57:46,Galdakao,expenses,electricity,-86.13,-39936.17
buyer_4,Jorge,50,ES97209511410504980753,TRX_N-01116-82262518,2024-09-06T14:25:58,Galdakao,Expense,leisure,-46.27,-39982.44
buyer_4,Jorge,50,ES97209511410504980753,TRX_N-01117-59343768,2024-09-07T10:37:09,Galdakao,expenses,gas,-33.73,-40016.17
buyer_4,Jorge,50,ES97209511410504980753,TRX_N-01118-04988341,2024-09-07T14:07:41,Galdakao,Expense,repairs,-239.77,-40255.94
buyer_4,Jorge,50,ES97209511410504980753,TRX_N-01119-91376554,2024-09-08T11:26:44,Galdakao,Expense,leisure,-25.03,-40280.97
buyer_4,Jorge,50,ES97209511410504980753,TRX_N-01120-72960351,2024-09-08T14:50:15,Galdakao,Expense,cash,-100.0,-40380.97
buyer_4,Jorge,50,ES97209511410504980753,TRX_N-01121-89891971,2024-09-09T20:08:39,Barakaldo,Expense,transport,-48.1,-40429.07
buyer_4,Jorge,50,ES97209511410504980753,TRX_N-01122-53727081,2024-09-09T14:51:43,Galdakao,Expense,leisure,-58.52,-40487.59
buyer_4,Jorge,50,ES97209511410504980753,TRX_N-01123-68496878,2024-09-09T20:56:44,Galdakao,Expense,travel,-980.15,-41467.74
buyer_4,Jorge,50,ES97209511410504980753,TRX_N-01124-20198922,2024-09-10T22:02:27,Galdakao,Expense,education,-69.69,-41537.43
buyer_4,Jorge,50,ES97209511410504980753,TRX_N-01125-85561146,2024-09-11T21:22:09,Galdakao,Expense,cash,-100.0,-41637.43
buyer_4,Jorge,50,ES97209511410504980753,TRX_N-01126-76548283,2024-09-12T19:48:53,Galdakao,Expense,cash,-100.0,-41737.43
buyer_4,Jorge,50,ES97209511410504980753,TRX_N-01127-34781770,2024-09-13T07:06:01,Galdakao,Expense,repairs,-113.24,-41850.67
buyer_4,Jorge,50,ES97209511410504980753,TRX_N-01128-41115591,2024-09-15T05:56:17,Donostia,Expense,cash,-100.0,-41950.67
buyer_4,Jorge,50,ES97209511410504980753,TRX_N-01129-35194695,2024-09-20T13:08:13,Galdakao,Expense,leisure,-21.72,-41972.39
buyer_4,Jorge,50,ES97209511410504980753,TRX_N-01130-48910886,2024-09-22T11:15:31,Durango,Expense,transport,-48.17,-42020.56
buyer_4,Jorge,50,ES97209511410504980753,TRX_N-01131-87742064,2024-09-23T03:10:20,Galdakao,Expense,transport,-65.57,-42086.13
buyer_4,Jorge,50,ES97209511410504980753,TRX_N-01132-33810332,2024-09-23T10:01:57,Galdakao,Expense,education,-71.98,-42158.11
buyer_4,Jorge,50,ES97209511410504980753,TRX_N-01133-11808814,2024-09-24T10:39:59,Getxo,Expense,leisure,-42.89,-42201.0
buyer_4,Jorge,50,ES97209511410504980753,TRX_N-01134-90999730,2024-09-25T13:07:55,Galdakao,Expense,food,-119.95,-42320.95
buyer_4,Jorge,50,ES97209511410504980753,TRX_N-01135-65264215,2024-09-26T02:17:37,Galdakao,expenses,children,-241.8,-42562.75
buyer_4,Jorge,50,ES97209511410504980753,TRX_N-01136-76084934,2024-09-27T11:31:06,Galdakao,Expense,food,-105.51,-42668.26
buyer_4,Jorge,50,ES97209511410504980753,TRX_N-01137-72814432,2024-09-29T11:30:52,Galdakao,Expense,transport,-47.83,-42716.09
buyer_4,Jorge,50,ES97209511410504980753,TRX_N-01138-30550604,2024-09-30T00:30:22,Galdakao,Expense,clothing,-134.29,-42850.38
buyer_4,Jorge,50,ES97209511410504980753,TRX_N-01139-30000628,2024-10-01T19:44:59,Galdakao,incomes,salary,1557.3,-41293.08
buyer_4,Jorge,50,ES97209511410504980753,TRX_N-01140-17855616,2024-10-01T19:44:59,Galdakao,incomes,salary_partner,1263.31,-40029.77
buyer_4,Jorge,50,ES97209511410504980753,TRX_N-01141-60381135,2024-10-01T19:44:59,Galdakao,incomes,extra_income,273.62,-39756.15
buyer_4,Jorge,50,ES97209511410504980753,TRX_N-01142-66627596,2024-10-02T23:17:18,Galdakao,Expense,repairs,-264.34,-40020.49
buyer_4,Jorge,50,ES97209511410504980753,TRX_N-01143-19393105,2024-10-03T12:52:15,Galdakao,Expense,cash,-100.0,-40120.49
buyer_4,Jorge,50,ES97209511410504980753,TRX_N-01144-23977898,2024-10-04T21:56:42,Galdakao,expenses,mortgage,-863.85,-40984.34
buyer_4,Jorge,50,ES97209511410504980753,TRX_N-01145-95884502,2024-10-05T15:40:16,Galdakao,expenses,electricity,-39.49,-41023.83
buyer_4,Jorge,50,ES97209511410504980753,TRX_N-01146-75184152,2024-10-05T22:22:51,Galdakao,expenses,gas,-44.9,-41068.73
buyer_4,Jorge,50,ES97209511410504980753,TRX_N-01147-92114279,2024-10-06T20:09:45,Galdakao,Expense,food,-78.35,-41147.08
buyer_4,Jorge,50,ES97209511410504980753,TRX_N-01148-95479779,2024-10-07T22:27:53,Galdakao,expenses,children,-62.03,-41209.11
buyer_4,Jorge,50,ES97209511410504980753,TRX_N-01149-25324897,2024-10-08T10:57:34,Galdakao,expenses,phone,-39.13,-41248.24
buyer_4,Jorge,50,ES97209511410504980753,TRX_N-01150-83009117,2024-10-08T17:43:45,Galdakao,expenses,water,-37.47,-41285.71
buyer_4,Jorge,50,ES97209511410504980753,TRX_N-01151-13820399,2024-10-08T11:01:26,Galdakao,expenses,internet,-42.0,-41327.71
buyer_5,Sara,30,ES56209524809385928875,TRX_N-00001-08961217,2022-01-01T10:08:24,Donostia,incomes,salary,1534.52,2677.34
buyer_5,Sara,30,ES56209524809385928875,TRX_N-00002-83753558,2022-01-01T10:08:24,Donostia,incomes,salary_partner,1395.62,4072.96
buyer_5,Sara,30,ES56209524809385928875,TRX_N-00003-03965009,2022-01-02T20:55:18,Donostia,Expense,appliances,-383.37,3689.59
buyer_5,Sara,30,ES56209524809385928875,TRX_N-00004-51636987,2022-01-03T11:41:40,Donostia,Expense,transport,-73.9,3615.69
buyer_5,Sara,30,ES56209524809385928875,TRX_N-00005-49716928,2022-01-04T04:35:10,Donostia,expenses,mortgage,-901.62,2714.07
buyer_5,Sara,30,ES56209524809385928875,TRX_N-00006-46791279,2022-01-05T19:09:13,Donostia,expenses,phone,-32.33,2681.74
buyer_5,Sara,30,ES56209524809385928875,TRX_N-00007-08272424,2022-01-05T20:37:05,Donostia,Expense,food,-118.15,2563.59
buyer_5,Sara,30,ES56209524809385928875,TRX_N-00008-84684952,2022-01-06T08:49:44,Donostia,expenses,water,-37.59,2526.0
buyer_5,Sara,30,ES56209524809385928875,TRX_N-00009-72115206,2022-01-06T06:42:56,Donostia,expenses,gas,-60.4,2465.6
buyer_5,Sara,30,ES56209524809385928875,TRX_N-00010-14674715,2022-01-06T02:00:40,Donostia,Expense,food,-111.83,2353.77
buyer_5,Sara,30,ES56209524809385928875,TRX_N-00011-33577178,2022-01-06T17:01:43,Donostia,Expense,education,-66.75,2287.02
buyer_5,Sara,30,ES56209524809385928875,TRX_N-00012-58956688,2022-01-07T20:39:57,Donostia,expenses,electricity,-46.46,2240.56
buyer_5,Sara,30,ES56209524809385928875,TRX_N-00013-07553572,2022-01-08T18:11:35,Donostia,expenses,internet,-42.0,2198.56
buyer_5,Sara,30,ES56209524809385928875,TRX_N-00014-60133758,2022-01-10T14:00:21,Donostia,Expense,food,-124.57,2073.99
buyer_5,Sara,30,ES56209524809385928875,TRX_N-00015-12913579,2022-01-10T11:50:08,Santurtzi,Expense,leisure,-52.43,2021.56
buyer_5,Sara,30,ES56209524809385928875,TRX_N-00016-44540837,2022-01-11T02:55:50,Donostia,Expense,food,-106.19,1915.37
buyer_5,Sara,30,ES56209524809385928875,TRX_N-00017-15848152,2022-01-12T20:12:36,Donostia,Expense,leisure,-46.03,1869.34
buyer_5,Sara,30,ES56209524809385928875,TRX_N-00018-26159364,2022-01-13T16:31:57,Donostia,Expense,cash,-100.0,1769.34
buyer_5,Sara,30,ES56209524809385928875,TRX_N-00019-81874850,2022-01-14T14:00:19,Donostia,Expense,food,-84.55,1684.79
buyer_5,Sara,30,ES56209524809385928875,TRX_N-00020-41151226,2022-01-14T13:43:46,Donostia,Expense,leisure,-77.38,1607.41
buyer_5,Sara,30,ES56209524809385928875,TRX_N-00021-43290849,2022-01-14T22:38:11,Donostia,Expense,cash,-100.0,1507.41
buyer_5,Sara,30,ES56209524809385928875,TRX_N-00022-81172083,2022-01-15T17:45:43,Eibar,Expense,repairs,-154.17,1353.24
buyer_5,Sara,30,ES56209524809385928875,TRX_N-00023-07687821,2022-01-16T09:34:28,Donostia,Expense,leisure,-30.2,1323.04
buyer_5,Sara,30,ES56209524809385928875,TRX_N-00024-53050971,2022-01-17T08:43:30,Donostia,Expense,leisure,-72.83,1250.21
buyer_5,Sara,30,ES56209524809385928875,TRX_N-00025-43017950,2022-01-18T09:09:08,Donostia,Expense,cash,-100.0,1150.21
buyer_5,Sara,30,ES56209524809385928875,TRX_N-00026-86733162,2022-01-19T02:36:30,Donostia,Expense,healthcare,-62.91,1087.3
buyer_5,Sara,30,ES56209524809385928875,TRX_N-00027-83681601,2022-01-21T13:07:00,Donostia,Expense,cash,-100.0,987.3
buyer_5,Sara,30,ES56209524809385928875,TRX_N-00028-08776386,2022-01-23T16:45:56,Donostia,Expense,gifts,-370.85,616.45
buyer_5,Sara,30,ES56209524809385928875,TRX_N-00029-52505805,2022-01-24T19:41:19,Donostia,Expense,food,-76.1,540.35
buyer_5,Sara,30,ES56209524809385928875,TRX_N-00030-96844171,2022-01-26T10:46:20,Donostia,Expense,food,-84.39,455.96
buyer_5,Sara,30,ES56209524809385928875,TRX_N-00031-20126278,2022-01-26T07:25:56,Sopela,Expense,cash,-100.0,355.96
buyer_5,Sara,30,ES56209524809385928875,TRX_N-00032-20926860,2022-01-26T22:49:15,Donostia,Expense,gifts,-193.28,162.68
buyer_5,Sara,30,ES56209524809385928875,TRX_N-00033-34180346,2022-01-27T14:17:34,Donostia,Expense,food,-79.11,83.57
buyer_5,Sara,30,ES56209524809385928875,TRX_N-00034-02037176,2022-01-27T12:05:50,Bilbao,Expense,cash,-100.0,-16.43
buyer_5,Sara,30,ES56209524809385928875,TRX_N-00035-82441501,2022-01-28T10:49:46,Donostia,Expense,cash,-100.0,-116.43
buyer_5,Sara,30,ES56209524809385928875,TRX_N-00036-61711664,2022-01-29T12:22:40,Donostia,Expense,leisure,-30.14,-146.57
buyer_5,Sara,30,ES56209524809385928875,TRX_N-00037-12020386,2022-01-29T13:25:38,Donostia,Expense,travel,-1412.03,-1558.6
buyer_5,Sara,30,ES56209524809385928875,TRX_N-00038-12100308,2022-01-29T17:03:13,Donostia,Expense,repairs,-172.0,-1730.6
buyer_5,Sara,30,ES56209524809385928875,TRX_N-00039-75642974,2022-01-31T17:37:39,Donostia,Expense,food,-73.41,-1804.01
buyer_5,Sara,30,ES56209524809385928875,TRX_N-00040-42498691,2022-02-01T11:13:19,Donostia,incomes,salary,1534.52,-269.49
buyer_5,Sara,30,ES56209524809385928875,TRX_N-00041-92050585,2022-02-01T11:13:19,Donostia,incomes,salary_partner,1395.62,1126.13
buyer_5,Sara,30,ES56209524809385928875,TRX_N-00042-60847639,2022-02-02T01:04:20,Donostia,Expense,gifts,-215.58,910.55
buyer_5,Sara,30,ES56209524809385928875,TRX_N-00043-18209926,2022-02-03T05:21:51,Donostia,Expense,leisure,-35.39,875.16
buyer_5,Sara,30,ES56209524809385928875,TRX_N-00044-09906015,2022-02-03T03:17:04,Donostia,Expense,cash,-100.0,775.16
buyer_5,Sara,30,ES56209524809385928875,TRX_N-00045-23042789,2022-02-03T16:30:06,Donostia,expenses,children,-275.08,500.08
buyer_5,Sara,30,ES56209524809385928875,TRX_N-00046-53332505,2022-02-04T23:50:16,Donostia,expenses,mortgage,-901.62,-401.54
buyer_5,Sara,30,ES56209524809385928875,TRX_N-00047-84134247,2022-02-04T02:59:18,Donostia,Expense,food,-110.43,-511.97
buyer_5,Sara,30,ES56209524809385928875,TRX_N-00048-95094724,2022-02-04T13:56:54,Donostia,Expense,travel,-1821.4,-2333.37
buyer_5,Sara,30,ES56209524809385928875,TRX_N-00049-10811139,2022-02-05T13:13:16,Donostia,expenses,phone,-39.45,-2372.82
buyer_5,Sara,30,ES56209524809385928875,TRX_N-00050-59999424,2022-02-05T16:11:17,Donostia,Expense,food,-93.82,-2466.64
buyer_5,Sara,30,ES56209524809385928875,TRX_N-00051-85614986,2022-02-06T07:00:36,Donostia,expenses,electricity,-24.96,-2491.6
buyer_5,Sara,30,ES56209524809385928875,TRX_N-00052-49812877,2022-02-06T09:59:56,Irun,Expense,transport,-75.27,-2566.87
buyer_5,Sara,30,ES56209524809385928875,TRX_N-00053-28103909,2022-02-07T10:18:40,Donostia,expenses,gas,-85.95,-2652.82
buyer_5,Sara,30,ES56209524809385928875,TRX_N-00054-25382496,2022-02-07T20:23:03,Donostia,Expense,transport,-53.36,-2706.18
buyer_5,Sara,30,ES56209524809385928875,TRX_N-00055-88021692,2022-02-07T09:43:36,Donostia,Expense,healthcare,-108.95,-2815.13
buyer_5,Sara,30,ES56209524809385928875,TRX_N-00056-53784772,2022-02-07T15:57:42,Pasaia,Expense,cash,-100.0,-2915.13
buyer_5,Sara,30,ES56209524809385928875,TRX_N-00057-22282573,2022-02-08T18:55:28,Donostia,expenses,internet,-42.0,-2957.13
buyer_5,Sara,30,ES56209524809385928875,TRX_N-00058-57249520,2022-02-08T14:01:28,Donostia,expenses,water,-43.43,-3000.56
buyer_5,Sara,30,ES56209524809385928875,TRX_N-00059-38043675,2022-02-08T17:11:28,Arrasate,Expense,transport,-72.53,-3073.09
buyer_5,Sara,30,ES56209524809385928875,TRX_N-00060-76629945,2022-02-08T12:32:26,Oy√≥n-Oion,Expense,healthcare,-112.1,-3185.19
buyer_5,Sara,30,ES56209524809385928875,TRX_N-00061-67504725,2022-02-08T19:09:38,Donostia,Expense,cash,-100.0,-3285.19
buyer_5,Sara,30,ES56209524809385928875,TRX_N-00062-58592951,2022-02-09T20:22:38,Donostia,Expense,leisure,-64.97,-3350.16
buyer_5,Sara,30,ES56209524809385928875,TRX_N-00063-90958177,2022-02-09T18:21:08,Donostia,Expense,repairs,-60.93,-3411.09
buyer_5,Sara,30,ES56209524809385928875,TRX_N-00064-45140656,2022-02-10T09:00:53,Bilbao,Expense,transport,-89.04,-3500.13
buyer_5,Sara,30,ES56209524809385928875,TRX_N-00065-81907090,2022-02-10T18:55:03,Donostia,Expense,cash,-100.0,-3600.13
buyer_5,Sara,30,ES56209524809385928875,TRX_N-00066-75583275,2022-02-10T08:56:46,Mungia,Expense,gifts,-117.26,-3717.39
buyer_5,Sara,30,ES56209524809385928875,TRX_N-00067-12579091,2022-02-11T18:40:44,Donostia,Expense,transport,-71.76,-3789.15
buyer_5,Sara,30,ES56209524809385928875,TRX_N-00068-22005761,2022-02-13T14:15:42,Donostia,Expense,transport,-89.62,-3878.77
buyer_5,Sara,30,ES56209524809385928875,TRX_N-00069-20652439,2022-02-13T18:05:36,Llodio,Expense,education,-46.6,-3925.37
buyer_5,Sara,30,ES56209524809385928875,TRX_N-00070-84835167,2022-02-14T03:45:33,Donostia,Expense,transport,-58.65,-3984.02
buyer_5,Sara,30,ES56209524809385928875,TRX_N-00071-31790592,2022-02-14T11:26:41,Donostia,Expense,healthcare,-87.26,-4071.28
buyer_5,Sara,30,ES56209524809385928875,TRX_N-00072-51125316,2022-02-15T17:52:38,Hondarribia,Expense,repairs,-77.6,-4148.88
buyer_5,Sara,30,ES56209524809385928875,TRX_N-00073-31488371,2022-02-16T05:56:11,Donostia,Expense,cash,-100.0,-4248.88
buyer_5,Sara,30,ES56209524809385928875,TRX_N-00074-95419580,2022-02-18T08:39:37,Donostia,Expense,leisure,-18.45,-4267.33
buyer_5,Sara,30,ES56209524809385928875,TRX_N-00075-05937877,2022-02-18T09:57:42,Donostia,Expense,clothing,-73.92,-4341.25
buyer_5,Sara,30,ES56209524809385928875,TRX_N-00076-78906186,2022-02-21T12:08:49,Donostia,Expense,food,-111.79,-4453.04
buyer_5,Sara,30,ES56209524809385928875,TRX_N-00077-53081733,2022-02-23T15:30:51,Donostia,Expense,food,-60.34,-4513.38
buyer_5,Sara,30,ES56209524809385928875,TRX_N-00078-89582293,2022-02-23T17:04:26,Donostia,Expense,leisure,-58.62,-4572.0
buyer_5,Sara,30,ES56209524809385928875,TRX_N-00079-60046497,2022-02-24T09:04:50,Donostia,Expense,transport,-69.52,-4641.52
buyer_5,Sara,30,ES56209524809385928875,TRX_N-00080-78301737,2022-02-27T10:50:18,Santurtzi,Expense,leisure,-34.18,-4675.7
buyer_5,Sara,30,ES56209524809385928875,TRX_N-00081-95207440,2022-02-28T11:02:41,Donostia,Expense,transport,-44.26,-4719.96
buyer_5,Sara,30,ES56209524809385928875,TRX_N-00082-51316518,2022-02-28T08:03:26,Donostia,Expense,gifts,-205.6,-4925.56
buyer_5,Sara,30,ES56209524809385928875,TRX_N-00083-76144443,2022-03-01T11:05:17,Donostia,incomes,salary,1534.52,-3391.04
buyer_5,Sara,30,ES56209524809385928875,TRX_N-00084-45603637,2022-03-01T11:05:17,Donostia,incomes,salary_partner,1395.62,-1995.42
buyer_5,Sara,30,ES56209524809385928875,TRX_N-00085-57484508,2022-03-01T11:05:17,Donostia,incomes,extra_income,273.26,-1722.16
buyer_5,Sara,30,ES56209524809385928875,TRX_N-00086-54909050,2022-03-01T16:35:16,Donostia,expenses,children,-264.55,-1986.71
buyer_5,Sara,30,ES56209524809385928875,TRX_N-00087-89672731,2022-03-02T11:40:35,Donostia,Expense,leisure,-78.09,-2064.8
buyer_5,Sara,30,ES56209524809385928875,TRX_N-00088-56818441,2022-03-02T13:30:21,Donostia,Expense,cash,-100.0,-2164.8
buyer_5,Sara,30,ES56209524809385928875,TRX_N-00089-01068159,2022-03-03T20:07:59,Donostia,Expense,repairs,-198.23,-2363.03
buyer_5,Sara,30,ES56209524809385928875,TRX_N-00090-96766830,2022-03-04T12:49:50,Donostia,expenses,mortgage,-901.62,-3264.65
buyer_5,Sara,30,ES56209524809385928875,TRX_N-00091-16575109,2022-03-04T10:02:10,Donostia,expenses,children,-154.62,-3419.27
buyer_5,Sara,30,ES56209524809385928875,TRX_N-00092-82966850,2022-03-05T07:32:31,Donostia,expenses,gas,-71.87,-3491.14
buyer_5,Sara,30,ES56209524809385928875,TRX_N-00093-62343215,2022-03-05T04:57:44,Donostia,expenses,internet,-42.0,-3533.14
buyer_5,Sara,30,ES56209524809385928875,TRX_N-00094-32948335,2022-03-05T17:55:02,Donostia,Expense,leisure,-66.58,-3599.72
buyer_5,Sara,30,ES56209524809385928875,TRX_N-00095-02789680,2022-03-05T10:38:40,Donostia,Expense,cash,-100.0,-3699.72
buyer_5,Sara,30,ES56209524809385928875,TRX_N-00096-50462424,2022-03-05T08:36:50,Donostia,expenses,children,-141.82,-3841.54
buyer_5,Sara,30,ES56209524809385928875,TRX_N-00097-29726542,2022-03-06T12:01:20,Donostia,Expense,education,-73.1,-3914.64
buyer_5,Sara,30,ES56209524809385928875,TRX_N-00098-27815581,2022-03-07T21:13:30,Donostia,expenses,water,-25.22,-3939.86
buyer_5,Sara,30,ES56209524809385928875,TRX_N-00099-49431214,2022-03-07T05:46:18,Donostia,Expense,food,-61.97,-4001.83
buyer_5,Sara,30,ES56209524809385928875,TRX_N-00100-00433495,2022-03-07T10:52:50,Donostia,Expense,cash,-100.0,-4101.83
buyer_5,Sara,30,ES56209524809385928875,TRX_N-00101-24384894,2022-03-07T10:48:46,Donostia,Expense,appliances,-258.78,-4360.61
buyer_5,Sara,30,ES56209524809385928875,TRX_N-00102-37926505,2022-03-07T16:56:57,Getxo,Expense,gifts,-644.24,-5004.85
buyer_5,Sara,30,ES56209524809385928875,TRX_N-00103-78119414,2022-03-08T22:16:28,Donostia,expenses,electricity,-71.9,-5076.75
buyer_5,Sara,30,ES56209524809385928875,TRX_N-00104-39096278,2022-03-08T10:04:21,Donostia,expenses,phone,-37.91,-5114.66
buyer_5,Sara,30,ES56209524809385928875,TRX_N-00105-06873058,2022-03-08T23:47:42,Donostia,Expense,gifts,-196.91,-5311.57
buyer_5,Sara,30,ES56209524809385928875,TRX_N-00106-43879546,2022-03-08T07:21:55,Donostia,expenses,children,-203.39,-5514.96
buyer_5,Sara,30,ES56209524809385928875,TRX_N-00107-94500130,2022-03-09T19:30:13,Mungia,Expense,food,-112.09,-5627.05
buyer_5,Sara,30,ES56209524809385928875,TRX_N-00108-11588120,2022-03-09T08:37:16,Donostia,Expense,gifts,-62.97,-5690.02
buyer_5,Sara,30,ES56209524809385928875,TRX_N-00109-86850591,2022-03-09T09:25:14,Donostia,expenses,children,-100.59,-5790.61
buyer_5,Sara,30,ES56209524809385928875,TRX_N-00110-01858019,2022-03-12T11:48:49,Donostia,Expense,cash,-100.0,-5890.61
buyer_5,Sara,30,ES56209524809385928875,TRX_N-00111-97195098,2022-03-14T00:50:36,Donostia,Expense,transport,-46.13,-5936.74
buyer_5,Sara,30,ES56209524809385928875,TRX_N-00112-58421706,2022-03-14T08:03:47,Donostia,Expense,leisure,-62.71,-5999.45
buyer_5,Sara,30,ES56209524809385928875,TRX_N-00113-39849939,2022-03-14T11:56:09,Elciego,Expense,education,-59.64,-6059.09
buyer_5,Sara,30,ES56209524809385928875,TRX_N-00114-10595755,2022-03-15T11:33:36,Donostia,Expense,cash,-100.0,-6159.09
buyer_5,Sara,30,ES56209524809385928875,TRX_N-00115-19600460,2022-03-15T15:53:12,Donostia,Expense,appliances,-302.13,-6461.22
buyer_5,Sara,30,ES56209524809385928875,TRX_N-00116-69951034,2022-03-16T03:04:34,Donostia,Expense,food,-64.15,-6525.37
buyer_5,Sara,30,ES56209524809385928875,TRX_N-00117-45481827,2022-03-16T19:08:38,Portugalete,Expense,cash,-100.0,-6625.37
buyer_5,Sara,30,ES56209524809385928875,TRX_N-00118-16948169,2022-03-16T10:32:30,Donostia,Expense,appliances,-306.59,-6931.96
buyer_5,Sara,30,ES56209524809385928875,TRX_N-00119-91133309,2022-03-16T06:43:45,Andoain,Expense,gifts,-345.42,-7277.38
buyer_5,Sara,30,ES56209524809385928875,TRX_N-00120-80520166,2022-03-18T23:17:57,Donostia,Expense,food,-108.8,-7386.18
buyer_5,Sara,30,ES56209524809385928875,TRX_N-00121-29484305,2022-03-18T14:28:30,Donostia,Expense,repairs,-205.0,-7591.18
buyer_5,Sara,30,ES56209524809385928875,TRX_N-00122-73356240,2022-03-18T13:10:50,Donostia,expenses,children,-50.43,-7641.61
buyer_5,Sara,30,ES56209524809385928875,TRX_N-00123-88050459,2022-03-19T08:56:40,Donostia,Expense,cash,-100.0,-7741.61
buyer_5,Sara,30,ES56209524809385928875,TRX_N-00124-95805481,2022-03-20T10:16:32,Donostia,Expense,transport,-89.28,-7830.89
buyer_5,Sara,30,ES56209524809385928875,TRX_N-00125-15383628,2022-03-20T19:41:00,Donostia,Expense,clothing,-88.11,-7919.0
buyer_5,Sara,30,ES56209524809385928875,TRX_N-00126-76118401,2022-03-22T00:46:27,Donostia,expenses,children,-211.09,-8130.09
buyer_5,Sara,30,ES56209524809385928875,TRX_N-00127-89658574,2022-03-23T03:48:17,Galdakao,Expense,food,-65.0,-8195.09
buyer_5,Sara,30,ES56209524809385928875,TRX_N-00128-17306645,2022-03-23T12:13:00,Donostia,Expense,cash,-100.0,-8295.09
buyer_5,Sara,30,ES56209524809385928875,TRX_N-00129-86244943,2022-03-24T19:44:25,Donostia,Expense,food,-124.01,-8419.1
buyer_5,Sara,30,ES56209524809385928875,TRX_N-00130-03567846,2022-03-24T14:42:38,Donostia,Expense,gifts,-336.17,-8755.27
buyer_5,Sara,30,ES56209524809385928875,TRX_N-00131-79969679,2022-03-25T16:43:29,Donostia,Expense,cash,-100.0,-8855.27
buyer_5,Sara,30,ES56209524809385928875,TRX_N-00132-03897216,2022-03-25T16:13:52,Donostia,Expense,gifts,-716.88,-9572.15
buyer_5,Sara,30,ES56209524809385928875,TRX_N-00133-67409166,2022-03-25T19:46:27,Donostia,expenses,children,-86.95,-9659.1
buyer_5,Sara,30,ES56209524809385928875,TRX_N-00134-99531274,2022-03-28T14:44:10,Sopela,Expense,cash,-100.0,-9759.1
buyer_5,Sara,30,ES56209524809385928875,TRX_N-00135-32005561,2022-03-28T14:37:13,Donostia,expenses,children,-220.64,-9979.74
buyer_5,Sara,30,ES56209524809385928875,TRX_N-00136-33506035,2022-03-29T16:34:58,Donostia,Expense,appliances,-262.14,-10241.88
buyer_5,Sara,30,ES56209524809385928875,TRX_N-00137-89737827,2022-03-30T10:53:06,Donostia,Expense,transport,-48.36,-10290.24
buyer_5,Sara,30,ES56209524809385928875,TRX_N-00138-51287262,2022-03-30T10:07:08,Donostia,Expense,cash,-100.0,-10390.24
buyer_5,Sara,30,ES56209524809385928875,TRX_N-00139-34219347,2022-04-01T14:31:47,Donostia,incomes,salary,1534.52,-8855.72
buyer_5,Sara,30,ES56209524809385928875,TRX_N-00140-20506110,2022-04-01T14:31:47,Donostia,incomes,salary_partner,1395.62,-7460.1
buyer_5,Sara,30,ES56209524809385928875,TRX_N-00141-03736109,2022-04-02T20:39:45,Donostia,Expense,education,-45.62,-7505.72
buyer_5,Sara,30,ES56209524809385928875,TRX_N-00142-27902502,2022-04-02T19:26:54,Donostia,Expense,cash,-100.0,-7605.72
buyer_5,Sara,30,ES56209524809385928875,TRX_N-00143-53136363,2022-04-02T17:01:33,Alegr√≠a-Dulantzi,Expense,repairs,-87.15,-7692.87
buyer_5,Sara,30,ES56209524809385928875,TRX_N-00144-57335102,2022-04-03T14:09:31,Donostia,Expense,cash,-100.0,-7792.87
buyer_5,Sara,30,ES56209524809385928875,TRX_N-00145-35406746,2022-04-03T19:09:10,Zarautz,Expense,travel,-967.28,-8760.15
buyer_5,Sara,30,ES56209524809385928875,TRX_N-00146-28115517,2022-04-04T06:18:02,Donostia,expenses,mortgage,-901.62,-9661.77
buyer_5,Sara,30,ES56209524809385928875,TRX_N-00147-06215978,2022-04-04T14:42:39,Donostia,Expense,leisure,-37.49,-9699.26
buyer_5,Sara,30,ES56209524809385928875,TRX_N-00148-55598282,2022-04-04T05:25:12,Donostia,Expense,repairs,-278.61,-9977.87
buyer_5,Sara,30,ES56209524809385928875,TRX_N-00149-43530817,2022-04-05T15:27:50,Alegr√≠a-Dulantzi,Expense,leisure,-77.2,-10055.07
buyer_5,Sara,30,ES56209524809385928875,TRX_N-00150-70402428,2022-04-06T05:40:09,Donostia,expenses,electricity,-59.41,-10114.48
buyer_5,Sara,30,ES56209524809385928875,TRX_N-00151-97125959,2022-04-06T01:12:24,Donostia,expenses,phone,-35.01,-10149.49
buyer_5,Sara,30,ES56209524809385928875,TRX_N-00152-14908170,2022-04-08T22:08:13,Donostia,expenses,internet,-42.0,-10191.49
buyer_5,Sara,30,ES56209524809385928875,TRX_N-00153-05525709,2022-04-08T19:59:38,Donostia,expenses,water,-31.65,-10223.14
buyer_5,Sara,30,ES56209524809385928875,TRX_N-00154-30570033,2022-04-08T00:53:13,Donostia,expenses,gas,-50.12,-10273.26
buyer_5,Sara,30,ES56209524809385928875,TRX_N-00155-63686548,2022-04-08T19:51:46,Irun,Expense,cash,-100.0,-10373.26
buyer_5,Sara,30,ES56209524809385928875,TRX_N-00156-33626977,2022-04-09T11:15:28,Donostia,Expense,cash,-100.0,-10473.26
buyer_5,Sara,30,ES56209524809385928875,TRX_N-00157-43953168,2022-04-09T17:38:19,Donostia,Expense,gifts,-358.35,-10831.61
buyer_5,Sara,30,ES56209524809385928875,TRX_N-00158-55128475,2022-04-10T10:18:26,Donostia,Expense,transport,-63.73,-10895.34
buyer_5,Sara,30,ES56209524809385928875,TRX_N-00159-14057280,2022-04-11T09:17:01,Donostia,Expense,food,-87.54,-10982.88
buyer_5,Sara,30,ES56209524809385928875,TRX_N-00160-08392072,2022-04-12T11:24:35,Donostia,Expense,food,-67.23,-11050.11
buyer_5,Sara,30,ES56209524809385928875,TRX_N-00161-38777149,2022-04-16T16:02:12,Donostia,Expense,transport,-57.13,-11107.24
buyer_5,Sara,30,ES56209524809385928875,TRX_N-00162-29099612,2022-04-17T14:05:50,Donostia,expenses,children,-172.21,-11279.45
buyer_5,Sara,30,ES56209524809385928875,TRX_N-00163-88212330,2022-04-19T09:35:12,Donostia,Expense,leisure,-26.93,-11306.38
buyer_5,Sara,30,ES56209524809385928875,TRX_N-00164-41341827,2022-04-20T10:46:26,Donostia,Expense,leisure,-69.3,-11375.68
buyer_5,Sara,30,ES56209524809385928875,TRX_N-00165-60547473,2022-04-20T15:31:51,Donostia,Expense,education,-50.44,-11426.12
buyer_5,Sara,30,ES56209524809385928875,TRX_N-00166-99867437,2022-04-22T10:10:11,Andoain,Expense,food,-69.81,-11495.93
buyer_5,Sara,30,ES56209524809385928875,TRX_N-00167-38145370,2022-04-23T17:14:45,Donostia,Expense,healthcare,-127.25,-11623.18
buyer_5,Sara,30,ES56209524809385928875,TRX_N-00168-44426449,2022-04-24T01:47:13,Donostia,Expense,education,-76.57,-11699.75
buyer_5,Sara,30,ES56209524809385928875,TRX_N-00169-62771515,2022-04-25T19:29:59,Donostia,Expense,leisure,-58.1,-11757.85
buyer_5,Sara,30,ES56209524809385928875,TRX_N-00170-10529885,2022-04-26T06:11:25,Salvatierra/Agurain,Expense,leisure,-27.37,-11785.22
buyer_5,Sara,30,ES56209524809385928875,TRX_N-00171-92574900,2022-04-26T17:20:34,Donostia,Expense,clothing,-46.05,-11831.27
buyer_5,Sara,30,ES56209524809385928875,TRX_N-00172-59597778,2022-04-27T18:56:45,Donostia,Expense,leisure,-52.28,-11883.55
buyer_5,Sara,30,ES56209524809385928875,TRX_N-00173-75887599,2022-04-27T19:25:09,Donostia,Expense,clothing,-137.8,-12021.35
buyer_5,Sara,30,ES56209524809385928875,TRX_N-00174-94412650,2022-04-27T10:21:45,Donostia,Expense,cash,-100.0,-12121.35
buyer_5,Sara,30,ES56209524809385928875,TRX_N-00175-74616317,2022-04-27T13:01:25,Arrasate,Expense,appliances,-155.19,-12276.54
buyer_5,Sara,30,ES56209524809385928875,TRX_N-00176-00129539,2022-05-01T12:15:08,Donostia,incomes,salary,1534.52,-10742.02
buyer_5,Sara,30,ES56209524809385928875,TRX_N-00177-17394093,2022-05-01T12:15:08,Donostia,incomes,salary_partner,1395.62,-9346.4
buyer_5,Sara,30,ES56209524809385928875,TRX_N-00178-28056069,2022-05-01T04:25:31,Donostia,Expense,food,-87.46,-9433.86
buyer_5,Sara,30,ES56209524809385928875,TRX_N-00179-44049069,2022-05-01T15:42:17,Donostia,Expense,leisure,-62.18,-9496.04
buyer_5,Sara,30,ES56209524809385928875,TRX_N-00180-44359393,2022-05-01T18:59:24,Donostia,Expense,healthcare,-168.8,-9664.84
buyer_5,Sara,30,ES56209524809385928875,TRX_N-00181-93085576,2022-05-02T20:52:14,Donostia,Expense,gifts,-71.53,-9736.37
buyer_5,Sara,30,ES56209524809385928875,TRX_N-00182-11268171,2022-05-04T18:42:02,Donostia,expenses,mortgage,-901.62,-10637.99
buyer_5,Sara,30,ES56209524809385928875,TRX_N-00183-38293689,2022-05-05T14:58:29,Errenteria,Expense,cash,-100.0,-10737.99
buyer_5,Sara,30,ES56209524809385928875,TRX_N-00184-57826943,2022-05-06T20:08:36,Donostia,expenses,electricity,-88.09,-10826.08
buyer_5,Sara,30,ES56209524809385928875,TRX_N-00185-62300542,2022-05-06T11:13:12,Donostia,expenses,gas,-102.97,-10929.05
buyer_5,Sara,30,ES56209524809385928875,TRX_N-00186-68361091,2022-05-06T13:51:47,Donostia,expenses,phone,-31.87,-10960.92
buyer_5,Sara,30,ES56209524809385928875,TRX_N-00187-02300186,2022-05-06T11:42:28,Donostia,Expense,transport,-79.01,-11039.93
buyer_5,Sara,30,ES56209524809385928875,TRX_N-00188-87109382,2022-05-07T14:07:14,Donostia,expenses,water,-21.59,-11061.52
buyer_5,Sara,30,ES56209524809385928875,TRX_N-00189-80332333,2022-05-07T14:56:45,Durango,Expense,transport,-75.36,-11136.88
buyer_5,Sara,30,ES56209524809385928875,TRX_N-00190-84277249,2022-05-08T23:57:54,Donostia,expenses,internet,-42.0,-11178.88
buyer_5,Sara,30,ES56209524809385928875,TRX_N-00191-66713907,2022-05-08T23:56:31,Donostia,Expense,food,-107.6,-11286.48
buyer_5,Sara,30,ES56209524809385928875,TRX_N-00192-06017326,2022-05-08T18:18:43,Donostia,Expense,transport,-64.98,-11351.46
buyer_5,Sara,30,ES56209524809385928875,TRX_N-00193-24174706,2022-05-08T16:38:31,Donostia,Expense,leisure,-23.86,-11375.32
buyer_5,Sara,30,ES56209524809385928875,TRX_N-00194-47939131,2022-05-08T12:35:32,Donostia,Expense,cash,-100.0,-11475.32
buyer_5,Sara,30,ES56209524809385928875,TRX_N-00195-84177371,2022-05-08T23:42:54,Donostia,Expense,gifts,-149.73,-11625.05
buyer_5,Sara,30,ES56209524809385928875,TRX_N-00196-26061145,2022-05-09T07:41:48,Donostia,expenses,children,-86.85,-11711.9
buyer_5,Sara,30,ES56209524809385928875,TRX_N-00197-60818697,2022-05-11T14:00:38,Donostia,Expense,gifts,-563.32,-12275.22
buyer_5,Sara,30,ES56209524809385928875,TRX_N-00198-99637902,2022-05-12T20:02:19,Donostia,Expense,transport,-86.35,-12361.57
buyer_5,Sara,30,ES56209524809385928875,TRX_N-00199-21487054,2022-05-12T18:42:45,Donostia,Expense,cash,-100.0,-12461.57
buyer_5,Sara,30,ES56209524809385928875,TRX_N-00200-56013845,2022-05-13T17:30:56,Donostia,Expense,cash,-100.0,-12561.57
buyer_5,Sara,30,ES56209524809385928875,TRX_N-00201-12759733,2022-05-15T15:56:53,Donostia,Expense,leisure,-77.15,-12638.72
buyer_5,Sara,30,ES56209524809385928875,TRX_N-00202-03685402,2022-05-16T07:28:48,Donostia,Expense,food,-113.96,-12752.68
buyer_5,Sara,30,ES56209524809385928875,TRX_N-00203-24077325,2022-05-16T12:24:05,Galdakao,Expense,cash,-100.0,-12852.68
buyer_5,Sara,30,ES56209524809385928875,TRX_N-00204-46400740,2022-05-17T14:13:51,Donostia,Expense,healthcare,-46.01,-12898.69
buyer_5,Sara,30,ES56209524809385928875,TRX_N-00205-29423906,2022-05-20T11:23:44,Donostia,Expense,leisure,-50.65,-12949.34
buyer_5,Sara,30,ES56209524809385928875,TRX_N-00206-84510600,2022-05-20T10:48:42,Donostia,Expense,repairs,-269.46,-13218.8
buyer_5,Sara,30,ES56209524809385928875,TRX_N-00207-89393128,2022-05-23T08:11:47,Donostia,Expense,food,-118.14,-13336.94
buyer_5,Sara,30,ES56209524809385928875,TRX_N-00208-37917256,2022-05-24T15:24:06,Donostia,Expense,food,-62.33,-13399.27
buyer_5,Sara,30,ES56209524809385928875,TRX_N-00209-96406189,2022-05-24T13:20:53,Donostia,Expense,transport,-69.44,-13468.71
buyer_5,Sara,30,ES56209524809385928875,TRX_N-00210-56505400,2022-05-26T16:16:43,Donostia,Expense,leisure,-32.72,-13501.43
buyer_5,Sara,30,ES56209524809385928875,TRX_N-00211-52909391,2022-05-27T18:29:45,Donostia,Expense,food,-69.15,-13570.58
buyer_5,Sara,30,ES56209524809385928875,TRX_N-00212-20630173,2022-05-27T10:16:40,Donostia,Expense,healthcare,-155.52,-13726.1
buyer_5,Sara,30,ES56209524809385928875,TRX_N-00213-67812425,2022-05-27T10:27:51,Donostia,Expense,cash,-100.0,-13826.1
buyer_5,Sara,30,ES56209524809385928875,TRX_N-00214-97659695,2022-05-28T01:29:46,Donostia,Expense,leisure,-81.81,-13907.91
buyer_5,Sara,30,ES56209524809385928875,TRX_N-00215-21392734,2022-05-29T16:44:26,Donostia,Expense,food,-78.58,-13986.49
buyer_5,Sara,30,ES56209524809385928875,TRX_N-00216-00423060,2022-05-30T13:39:19,Salvatierra/Agurain,Expense,cash,-100.0,-14086.49
buyer_5,Sara,30,ES56209524809385928875,TRX_N-00217-91565567,2022-05-31T09:55:14,Donostia,Expense,food,-120.85,-14207.34
buyer_5,Sara,30,ES56209524809385928875,TRX_N-00218-24318478,2022-06-01T15:21:22,Donostia,incomes,salary,1534.52,-12672.82
buyer_5,Sara,30,ES56209524809385928875,TRX_N-00219-23758459,2022-06-01T15:21:22,Donostia,incomes,salary_partner,1395.62,-11277.2
buyer_5,Sara,30,ES56209524809385928875,TRX_N-00220-94101301,2022-06-01T15:21:22,Donostia,incomes,extra_income,273.26,-11003.94
buyer_5,Sara,30,ES56209524809385928875,TRX_N-00221-39173137,2022-06-01T15:21:22,Donostia,incomes,salary_bonus,1209.24,-9794.7
buyer_5,Sara,30,ES56209524809385928875,TRX_N-00222-23076644,2022-06-01T15:21:22,Donostia,incomes,salary_partner_bonus,1089.74,-8704.96
buyer_5,Sara,30,ES56209524809385928875,TRX_N-00223-90755256,2022-06-01T18:31:59,Donostia,Expense,repairs,-97.37,-8802.33
buyer_5,Sara,30,ES56209524809385928875,TRX_N-00224-30421284,2022-06-04T20:13:34,Donostia,expenses,mortgage,-901.62,-9703.95
buyer_5,Sara,30,ES56209524809385928875,TRX_N-00225-49540879,2022-06-04T13:46:37,Donostia,Expense,food,-122.88,-9826.83
buyer_5,Sara,30,ES56209524809385928875,TRX_N-00226-97378143,2022-06-04T07:58:57,Lasarte-Oria,Expense,leisure,-22.23,-9849.06
buyer_5,Sara,30,ES56209524809385928875,TRX_N-00227-41886419,2022-06-04T18:50:44,Donostia,Expense,cash,-100.0,-9949.06
buyer_5,Sara,30,ES56209524809385928875,TRX_N-00228-29436838,2022-06-04T13:54:25,Donostia,Expense,appliances,-270.49,-10219.55
buyer_5,Sara,30,ES56209524809385928875,TRX_N-00229-14357744,2022-06-05T16:04:24,Donostia,expenses,phone,-43.96,-10263.51
buyer_5,Sara,30,ES56209524809385928875,TRX_N-00230-24162640,2022-06-05T10:27:36,Donostia,Expense,cash,-100.0,-10363.51
buyer_5,Sara,30,ES56209524809385928875,TRX_N-00231-61187970,2022-06-07T01:52:26,Donostia,expenses,water,-27.41,-10390.92
buyer_5,Sara,30,ES56209524809385928875,TRX_N-00232-23083544,2022-06-07T07:07:29,Donostia,Expense,food,-98.35,-10489.27
buyer_5,Sara,30,ES56209524809385928875,TRX_N-00233-42531321,2022-06-07T23:41:11,Donostia,Expense,leisure,-67.89,-10557.16
buyer_5,Sara,30,ES56209524809385928875,TRX_N-00234-63006593,2022-06-08T23:07:12,Donostia,expenses,electricity,-63.36,-10620.52
buyer_5,Sara,30,ES56209524809385928875,TRX_N-00235-36514754,2022-06-08T13:41:46,Donostia,expenses,gas,-87.24,-10707.76
buyer_5,Sara,30,ES56209524809385928875,TRX_N-00236-56255201,2022-06-08T14:21:03,Donostia,expenses,internet,-42.0,-10749.76
buyer_5,Sara,30,ES56209524809385928875,TRX_N-00237-50893402,2022-06-08T16:06:52,Donostia,Expense,healthcare,-179.51,-10929.27
buyer_5,Sara,30,ES56209524809385928875,TRX_N-00238-59486389,2022-06-11T14:57:26,Eibar,Expense,cash,-100.0,-11029.27
buyer_5,Sara,30,ES56209524809385928875,TRX_N-00239-59591315,2022-06-12T00:42:15,Donostia,Expense,food,-122.64,-11151.91
buyer_5,Sara,30,ES56209524809385928875,TRX_N-00240-45601614,2022-06-15T10:31:42,Donostia,Expense,appliances,-132.45,-11284.36
buyer_5,Sara,30,ES56209524809385928875,TRX_N-00241-57542039,2022-06-17T13:49:09,Vitoria-Gasteiz,Expense,food,-60.29,-11344.65
buyer_5,Sara,30,ES56209524809385928875,TRX_N-00242-45543162,2022-06-17T02:58:14,Lasarte-Oria,Expense,healthcare,-147.79,-11492.44
buyer_5,Sara,30,ES56209524809385928875,TRX_N-00243-04443670,2022-06-17T13:21:55,Durango,Expense,cash,-100.0,-11592.44
buyer_5,Sara,30,ES56209524809385928875,TRX_N-00244-47157952,2022-06-18T09:48:13,Irun,Expense,healthcare,-62.27,-11654.71
buyer_5,Sara,30,ES56209524809385928875,TRX_N-00245-58409538,2022-06-20T14:30:15,Bilbao,Expense,gifts,-548.51,-12203.22
buyer_5,Sara,30,ES56209524809385928875,TRX_N-00246-75663920,2022-06-21T00:01:01,Donostia,Expense,transport,-60.73,-12263.95
buyer_5,Sara,30,ES56209524809385928875,TRX_N-00247-94821148,2022-06-21T23:55:51,Donostia,Expense,cash,-100.0,-12363.95
buyer_5,Sara,30,ES56209524809385928875,TRX_N-00248-19212900,2022-06-21T15:41:51,Zarautz,Expense,gifts,-220.39,-12584.34
buyer_5,Sara,30,ES56209524809385928875,TRX_N-00249-54757626,2022-06-23T11:40:02,Donostia,Expense,cash,-100.0,-12684.34
buyer_5,Sara,30,ES56209524809385928875,TRX_N-00250-23103650,2022-06-24T20:33:52,Donostia,Expense,gifts,-263.63,-12947.97
buyer_5,Sara,30,ES56209524809385928875,TRX_N-00251-64472724,2022-06-26T10:54:18,Donostia,Expense,cash,-100.0,-13047.97
buyer_5,Sara,30,ES56209524809385928875,TRX_N-00252-85369617,2022-06-28T12:17:38,Donostia,Expense,leisure,-71.65,-13119.62
buyer_5,Sara,30,ES56209524809385928875,TRX_N-00253-82298488,2022-06-29T20:00:04,Donostia,Expense,gifts,-730.88,-13850.5
buyer_5,Sara,30,ES56209524809385928875,TRX_N-00254-87918864,2022-06-30T13:10:47,Getxo,Expense,cash,-100.0,-13950.5
buyer_5,Sara,30,ES56209524809385928875,TRX_N-00255-91099270,2022-07-01T13:58:26,Donostia,incomes,salary,1534.52,-12415.98
buyer_5,Sara,30,ES56209524809385928875,TRX_N-00256-10462193,2022-07-01T13:58:26,Donostia,incomes,salary_partner,1395.62,-11020.36
buyer_5,Sara,30,ES56209524809385928875,TRX_N-00257-45803971,2022-07-02T17:38:40,Donostia,Expense,food,-97.23,-11117.59
buyer_5,Sara,30,ES56209524809385928875,TRX_N-00258-34893625,2022-07-03T09:34:02,Donostia,Expense,healthcare,-114.73,-11232.32
buyer_5,Sara,30,ES56209524809385928875,TRX_N-00259-97213166,2022-07-04T18:05:05,Donostia,expenses,mortgage,-901.62,-12133.94
buyer_5,Sara,30,ES56209524809385928875,TRX_N-00260-91049871,2022-07-05T14:15:35,Donostia,expenses,water,-21.77,-12155.71
buyer_5,Sara,30,ES56209524809385928875,TRX_N-00261-45696699,2022-07-05T23:49:33,Donostia,expenses,internet,-42.0,-12197.71
buyer_5,Sara,30,ES56209524809385928875,TRX_N-00262-82313927,2022-07-06T02:11:24,Donostia,expenses,gas,-105.1,-12302.81
buyer_5,Sara,30,ES56209524809385928875,TRX_N-00263-50679431,2022-07-06T17:35:26,Donostia,Expense,cash,-100.0,-12402.81
buyer_5,Sara,30,ES56209524809385928875,TRX_N-00264-70302450,2022-07-07T08:39:37,Donostia,Expense,gifts,-776.39,-13179.2
buyer_5,Sara,30,ES56209524809385928875,TRX_N-00265-25836398,2022-07-08T17:34:50,Donostia,expenses,electricity,-44.48,-13223.68
buyer_5,Sara,30,ES56209524809385928875,TRX_N-00266-99330340,2022-07-08T20:48:16,Donostia,expenses,phone,-37.41,-13261.09
buyer_5,Sara,30,ES56209524809385928875,TRX_N-00267-25185009,2022-07-08T16:44:10,Donostia,Expense,cash,-100.0,-13361.09
buyer_5,Sara,30,ES56209524809385928875,TRX_N-00268-33890438,2022-07-09T12:10:04,Donostia,Expense,transport,-48.42,-13409.51
buyer_5,Sara,30,ES56209524809385928875,TRX_N-00269-45418196,2022-07-10T03:07:32,Donostia,Expense,repairs,-300.99,-13710.5
buyer_5,Sara,30,ES56209524809385928875,TRX_N-00270-89531683,2022-07-12T16:40:13,Donostia,Expense,food,-82.14,-13792.64
buyer_5,Sara,30,ES56209524809385928875,TRX_N-00271-58851719,2022-07-14T10:03:18,Iru√±a de Oca,Expense,gifts,-96.79,-13889.43
buyer_5,Sara,30,ES56209524809385928875,TRX_N-00272-66631898,2022-07-15T13:56:38,Eibar,Expense,education,-76.37,-13965.8
buyer_5,Sara,30,ES56209524809385928875,TRX_N-00273-39879666,2022-07-18T08:01:01,Donostia,Expense,food,-67.5,-14033.3
buyer_5,Sara,30,ES56209524809385928875,TRX_N-00274-27155438,2022-07-19T16:48:53,Donostia,Expense,transport,-45.75,-14079.05
buyer_5,Sara,30,ES56209524809385928875,TRX_N-00275-94308959,2022-07-21T15:34:55,Donostia,Expense,cash,-100.0,-14179.05
buyer_5,Sara,30,ES56209524809385928875,TRX_N-00276-25740649,2022-07-23T22:26:33,Donostia,Expense,food,-67.42,-14246.47
buyer_5,Sara,30,ES56209524809385928875,TRX_N-00277-70440972,2022-07-23T16:40:31,Donostia,Expense,clothing,-154.28,-14400.75
buyer_5,Sara,30,ES56209524809385928875,TRX_N-00278-83071836,2022-07-24T09:16:48,Donostia,Expense,leisure,-43.45,-14444.2
buyer_5,Sara,30,ES56209524809385928875,TRX_N-00279-86265109,2022-07-25T09:30:45,Donostia,Expense,transport,-54.87,-14499.07
buyer_5,Sara,30,ES56209524809385928875,TRX_N-00280-99505548,2022-07-27T18:15:08,Donostia,Expense,cash,-100.0,-14599.07
buyer_5,Sara,30,ES56209524809385928875,TRX_N-00281-30539315,2022-07-29T08:17:47,Donostia,Expense,gifts,-476.03,-15075.1
buyer_5,Sara,30,ES56209524809385928875,TRX_N-00282-07677334,2022-07-30T21:47:03,Donostia,Expense,clothing,-96.31,-15171.41
buyer_5,Sara,30,ES56209524809385928875,TRX_N-00283-25767230,2022-07-31T23:09:43,Donostia,Expense,leisure,-23.81,-15195.22
buyer_5,Sara,30,ES56209524809385928875,TRX_N-00284-98843576,2022-08-01T15:57:10,Donostia,incomes,salary,1534.52,-13660.7
buyer_5,Sara,30,ES56209524809385928875,TRX_N-00285-84260904,2022-08-01T15:57:10,Donostia,incomes,salary_partner,1395.62,-12265.08
buyer_5,Sara,30,ES56209524809385928875,TRX_N-00286-72699740,2022-08-01T21:14:24,Donostia,Expense,repairs,-169.48,-12434.56
buyer_5,Sara,30,ES56209524809385928875,TRX_N-00287-54496151,2022-08-02T17:04:02,Donostia,Expense,food,-82.02,-12516.58
buyer_5,Sara,30,ES56209524809385928875,TRX_N-00288-96705996,2022-08-02T00:09:39,Donostia,Expense,leisure,-22.76,-12539.34
buyer_5,Sara,30,ES56209524809385928875,TRX_N-00289-67175256,2022-08-02T08:25:18,Donostia,Expense,education,-57.6,-12596.94
buyer_5,Sara,30,ES56209524809385928875,TRX_N-00290-81574538,2022-08-03T08:47:16,Donostia,expenses,children,-247.57,-12844.51
buyer_5,Sara,30,ES56209524809385928875,TRX_N-00291-64772029,2022-08-04T17:45:33,Donostia,expenses,mortgage,-901.62,-13746.13
buyer_5,Sara,30,ES56209524809385928875,TRX_N-00292-21875779,2022-08-04T15:03:14,Donostia,Expense,cash,-100.0,-13846.13
buyer_5,Sara,30,ES56209524809385928875,TRX_N-00293-35136737,2022-08-05T23:48:35,Donostia,expenses,phone,-32.6,-13878.73
buyer_5,Sara,30,ES56209524809385928875,TRX_N-00294-09042925,2022-08-05T17:14:17,Donostia,Expense,leisure,-69.34,-13948.07
buyer_5,Sara,30,ES56209524809385928875,TRX_N-00295-49977088,2022-08-05T10:42:40,Donostia,Expense,education,-75.82,-14023.89
buyer_5,Sara,30,ES56209524809385928875,TRX_N-00296-74517623,2022-08-05T11:07:43,Santurtzi,Expense,gifts,-333.11,-14357.0
buyer_5,Sara,30,ES56209524809385928875,TRX_N-00297-03962138,2022-08-06T13:59:39,Donostia,Expense,food,-104.98,-14461.98
buyer_5,Sara,30,ES56209524809385928875,TRX_N-00298-60480154,2022-08-07T17:54:47,Donostia,expenses,internet,-42.0,-14503.98
buyer_5,Sara,30,ES56209524809385928875,TRX_N-00299-61663650,2022-08-08T15:27:18,Donostia,expenses,water,-21.27,-14525.25
buyer_5,Sara,30,ES56209524809385928875,TRX_N-00300-13844171,2022-08-08T14:02:46,Donostia,expenses,electricity,-41.58,-14566.83
buyer_5,Sara,30,ES56209524809385928875,TRX_N-00301-14489233,2022-08-08T20:51:26,Donostia,expenses,gas,-62.28,-14629.11
buyer_5,Sara,30,ES56209524809385928875,TRX_N-00302-25136157,2022-08-08T17:23:06,Zarautz,Expense,cash,-100.0,-14729.11
buyer_5,Sara,30,ES56209524809385928875,TRX_N-00303-05234091,2022-08-09T19:25:32,Donostia,Expense,repairs,-269.93,-14999.04
buyer_5,Sara,30,ES56209524809385928875,TRX_N-00304-33512757,2022-08-09T11:39:10,Vitoria-Gasteiz,Expense,gifts,-741.76,-15740.8
buyer_5,Sara,30,ES56209524809385928875,TRX_N-00305-49212744,2022-08-10T08:36:44,Donostia,Expense,repairs,-159.29,-15900.09
buyer_5,Sara,30,ES56209524809385928875,TRX_N-00306-11435409,2022-08-11T16:13:41,Hernani,Expense,clothing,-79.87,-15979.96
buyer_5,Sara,30,ES56209524809385928875,TRX_N-00307-42686785,2022-08-12T17:17:34,Donostia,Expense,transport,-86.71,-16066.67
buyer_5,Sara,30,ES56209524809385928875,TRX_N-00308-78319543,2022-08-13T08:09:15,Donostia,Expense,transport,-73.16,-16139.83
buyer_5,Sara,30,ES56209524809385928875,TRX_N-00309-93375594,2022-08-15T11:06:16,Donostia,Expense,clothing,-84.89,-16224.72
buyer_5,Sara,30,ES56209524809385928875,TRX_N-00310-60975767,2022-08-15T14:17:08,Oy√≥n-Oion,Expense,cash,-100.0,-16324.72
buyer_5,Sara,30,ES56209524809385928875,TRX_N-00311-19618633,2022-08-16T12:24:46,Donostia,Expense,food,-114.83,-16439.55
buyer_5,Sara,30,ES56209524809385928875,TRX_N-00312-13765787,2022-08-16T15:28:30,Donostia,Expense,education,-62.13,-16501.68
buyer_5,Sara,30,ES56209524809385928875,TRX_N-00313-71950642,2022-08-16T10:11:27,Donostia,Expense,cash,-100.0,-16601.68
buyer_5,Sara,30,ES56209524809385928875,TRX_N-00314-97195848,2022-08-17T11:20:24,Portugalete,Expense,cash,-100.0,-16701.68
buyer_5,Sara,30,ES56209524809385928875,TRX_N-00315-88777606,2022-08-18T15:02:15,Donostia,Expense,food,-62.35,-16764.03
buyer_5,Sara,30,ES56209524809385928875,TRX_N-00316-34405921,2022-08-19T13:37:03,Donostia,Expense,leisure,-39.26,-16803.29
buyer_5,Sara,30,ES56209524809385928875,TRX_N-00317-96685764,2022-08-20T19:13:05,Donostia,Expense,food,-108.51,-16911.8
buyer_5,Sara,30,ES56209524809385928875,TRX_N-00318-21667799,2022-08-21T23:28:53,Donostia,Expense,leisure,-65.41,-16977.21
buyer_5,Sara,30,ES56209524809385928875,TRX_N-00319-93131593,2022-08-21T15:40:21,Donostia,Expense,clothing,-95.98,-17073.19
buyer_5,Sara,30,ES56209524809385928875,TRX_N-00320-09950633,2022-08-21T08:18:11,Donostia,Expense,appliances,-232.72,-17305.91
buyer_5,Sara,30,ES56209524809385928875,TRX_N-00321-89081997,2022-08-21T11:56:41,Donostia,Expense,gifts,-829.76,-18135.67
buyer_5,Sara,30,ES56209524809385928875,TRX_N-00322-74692599,2022-08-22T10:07:24,Donostia,Expense,cash,-100.0,-18235.67
buyer_5,Sara,30,ES56209524809385928875,TRX_N-00323-54513361,2022-08-23T08:00:58,Donostia,Expense,repairs,-142.77,-18378.44
buyer_5,Sara,30,ES56209524809385928875,TRX_N-00324-05756660,2022-08-24T19:44:20,Donostia,Expense,food,-89.81,-18468.25
buyer_5,Sara,30,ES56209524809385928875,TRX_N-00325-91938010,2022-08-24T06:58:59,Donostia,Expense,cash,-100.0,-18568.25
buyer_5,Sara,30,ES56209524809385928875,TRX_N-00326-93893019,2022-08-24T13:01:09,Donostia,Expense,gifts,-554.69,-19122.94
buyer_5,Sara,30,ES56209524809385928875,TRX_N-00327-03349927,2022-08-25T13:37:34,Vitoria-Gasteiz,Expense,leisure,-37.52,-19160.46
buyer_5,Sara,30,ES56209524809385928875,TRX_N-00328-68156412,2022-08-26T18:11:17,Donostia,Expense,healthcare,-60.96,-19221.42
buyer_5,Sara,30,ES56209524809385928875,TRX_N-00329-78188218,2022-08-27T11:04:54,Donostia,Expense,cash,-100.0,-19321.42
buyer_5,Sara,30,ES56209524809385928875,TRX_N-00330-19648631,2022-08-29T10:08:02,Donostia,Expense,clothing,-95.58,-19417.0
buyer_5,Sara,30,ES56209524809385928875,TRX_N-00331-68808414,2022-08-29T19:31:11,Donostia,Expense,education,-64.8,-19481.8
buyer_5,Sara,30,ES56209524809385928875,TRX_N-00332-01408125,2022-08-30T12:28:08,Donostia,Expense,clothing,-92.76,-19574.56
buyer_5,Sara,30,ES56209524809385928875,TRX_N-00333-93873247,2022-08-31T02:56:54,Andoain,Expense,food,-66.77,-19641.33
buyer_5,Sara,30,ES56209524809385928875,TRX_N-00334-34796275,2022-09-01T08:07:55,Donostia,incomes,salary,1534.52,-18106.81
buyer_5,Sara,30,ES56209524809385928875,TRX_N-00335-79909609,2022-09-01T08:07:55,Donostia,incomes,salary_partner,1395.62,-16711.19
buyer_5,Sara,30,ES56209524809385928875,TRX_N-00336-57780324,2022-09-02T14:08:57,Donostia,Expense,healthcare,-154.52,-16865.71
buyer_5,Sara,30,ES56209524809385928875,TRX_N-00337-08199165,2022-09-02T10:22:47,Iru√±a de Oca,Expense,cash,-100.0,-16965.71
buyer_5,Sara,30,ES56209524809385928875,TRX_N-00338-63727748,2022-09-03T17:46:13,Donostia,Expense,repairs,-56.79,-17022.5
buyer_5,Sara,30,ES56209524809385928875,TRX_N-00339-59550780,2022-09-04T19:26:54,Donostia,expenses,mortgage,-901.62,-17924.12
buyer_5,Sara,30,ES56209524809385928875,TRX_N-00340-62839698,2022-09-05T10:41:22,Donostia,expenses,electricity,-42.81,-17966.93
buyer_5,Sara,30,ES56209524809385928875,TRX_N-00341-49130387,2022-09-05T21:21:34,Donostia,Expense,food,-68.81,-18035.74
buyer_5,Sara,30,ES56209524809385928875,TRX_N-00342-70935357,2022-09-06T10:03:30,Donostia,Expense,appliances,-280.64,-18316.38
buyer_5,Sara,30,ES56209524809385928875,TRX_N-00343-90420112,2022-09-07T19:32:37,Donostia,expenses,water,-41.51,-18357.89
buyer_5,Sara,30,ES56209524809385928875,TRX_N-00344-99226824,2022-09-07T12:29:07,Donostia,expenses,phone,-32.6,-18390.49
buyer_5,Sara,30,ES56209524809385928875,TRX_N-00345-03513063,2022-09-08T17:14:34,Donostia,expenses,internet,-42.0,-18432.49
buyer_5,Sara,30,ES56209524809385928875,TRX_N-00346-92282578,2022-09-08T09:26:20,Donostia,expenses,gas,-97.0,-18529.49
buyer_5,Sara,30,ES56209524809385928875,TRX_N-00347-67854269,2022-09-08T18:18:47,Donostia,Expense,cash,-100.0,-18629.49
buyer_5,Sara,30,ES56209524809385928875,TRX_N-00348-31872430,2022-09-09T08:05:24,Donostia,Expense,food,-109.62,-18739.11
buyer_5,Sara,30,ES56209524809385928875,TRX_N-00349-66872805,2022-09-09T10:28:07,Donostia,Expense,leisure,-56.84,-18795.95
buyer_5,Sara,30,ES56209524809385928875,TRX_N-00350-23832866,2022-09-10T16:29:34,Donostia,Expense,education,-78.66,-18874.61
buyer_5,Sara,30,ES56209524809385928875,TRX_N-00351-04625534,2022-09-10T00:11:29,Donostia,Expense,cash,-100.0,-18974.61
buyer_5,Sara,30,ES56209524809385928875,TRX_N-00352-96884675,2022-09-11T13:10:41,Donostia,Expense,transport,-42.69,-19017.3
buyer_5,Sara,30,ES56209524809385928875,TRX_N-00353-96502774,2022-09-11T14:24:00,Donostia,Expense,clothing,-146.6,-19163.9
buyer_5,Sara,30,ES56209524809385928875,TRX_N-00354-07360056,2022-09-12T23:49:04,Donostia,Expense,cash,-100.0,-19263.9
buyer_5,Sara,30,ES56209524809385928875,TRX_N-00355-79920451,2022-09-13T09:22:54,Donostia,Expense,clothing,-61.82,-19325.72
buyer_5,Sara,30,ES56209524809385928875,TRX_N-00356-80300335,2022-09-17T19:46:22,Donostia,Expense,cash,-100.0,-19425.72
buyer_5,Sara,30,ES56209524809385928875,TRX_N-00357-21678517,2022-09-17T18:13:39,Donostia,Expense,repairs,-268.37,-19694.09
buyer_5,Sara,30,ES56209524809385928875,TRX_N-00358-61625003,2022-09-18T07:41:14,Donostia,Expense,transport,-85.48,-19779.57
buyer_5,Sara,30,ES56209524809385928875,TRX_N-00359-31157431,2022-09-19T16:45:25,Donostia,Expense,cash,-100.0,-19879.57
buyer_5,Sara,30,ES56209524809385928875,TRX_N-00360-28728049,2022-09-19T21:40:06,Donostia,Expense,gifts,-159.51,-20039.08
buyer_5,Sara,30,ES56209524809385928875,TRX_N-00361-44668317,2022-09-21T12:27:17,Donostia,Expense,education,-45.14,-20084.22
buyer_5,Sara,30,ES56209524809385928875,TRX_N-00362-21202926,2022-09-24T13:50:53,Alegr√≠a-Dulantzi,Expense,education,-47.53,-20131.75
buyer_5,Sara,30,ES56209524809385928875,TRX_N-00363-81343574,2022-09-26T08:48:18,Donostia,Expense,food,-89.14,-20220.89
buyer_5,Sara,30,ES56209524809385928875,TRX_N-00364-31697032,2022-09-26T15:50:59,Donostia,Expense,gifts,-795.66,-21016.55
buyer_5,Sara,30,ES56209524809385928875,TRX_N-00365-12215412,2022-09-27T11:52:54,Donostia,Expense,transport,-71.55,-21088.1
buyer_5,Sara,30,ES56209524809385928875,TRX_N-00366-47315604,2022-09-29T11:06:54,Donostia,Expense,food,-120.58,-21208.68
buyer_5,Sara,30,ES56209524809385928875,TRX_N-00367-20298555,2022-09-29T16:12:05,Donostia,Expense,leisure,-31.89,-21240.57
buyer_5,Sara,30,ES56209524809385928875,TRX_N-00368-04910131,2022-09-30T08:04:39,Donostia,Expense,travel,-1603.96,-22844.53
buyer_5,Sara,30,ES56209524809385928875,TRX_N-00369-33108176,2022-09-30T22:57:49,Basauri,Expense,gifts,-562.24,-23406.77
buyer_5,Sara,30,ES56209524809385928875,TRX_N-00370-47694786,2022-10-01T17:15:36,Donostia,incomes,salary,1534.52,-21872.25
buyer_5,Sara,30,ES56209524809385928875,TRX_N-00371-36170368,2022-10-01T17:15:36,Donostia,incomes,salary_partner,1395.62,-20476.63
buyer_5,Sara,30,ES56209524809385928875,TRX_N-00372-02645153,2022-10-01T17:15:36,Donostia,incomes,extra_income,273.26,-20203.37
buyer_5,Sara,30,ES56209524809385928875,TRX_N-00373-15297763,2022-10-01T12:42:40,Donostia,Expense,food,-64.73,-20268.1
buyer_5,Sara,30,ES56209524809385928875,TRX_N-00374-10992710,2022-10-03T08:40:50,Donostia,Expense,cash,-100.0,-20368.1
buyer_5,Sara,30,ES56209524809385928875,TRX_N-00375-98259815,2022-10-04T01:40:39,Donostia,expenses,mortgage,-901.62,-21269.72
buyer_5,Sara,30,ES56209524809385928875,TRX_N-00376-89585322,2022-10-05T03:14:58,Donostia,expenses,phone,-41.78,-21311.5
buyer_5,Sara,30,ES56209524809385928875,TRX_N-00377-68832897,2022-10-05T08:11:37,Donostia,Expense,food,-88.33,-21399.83
buyer_5,Sara,30,ES56209524809385928875,TRX_N-00378-23911713,2022-10-05T14:45:18,Donostia,Expense,education,-44.16,-21443.99
buyer_5,Sara,30,ES56209524809385928875,TRX_N-00379-83632609,2022-10-05T14:21:09,Salvatierra/Agurain,Expense,gifts,-241.0,-21684.99
buyer_5,Sara,30,ES56209524809385928875,TRX_N-00380-27706791,2022-10-06T13:10:32,Donostia,Expense,cash,-100.0,-21784.99
buyer_5,Sara,30,ES56209524809385928875,TRX_N-00381-46937788,2022-10-08T12:53:58,Donostia,expenses,internet,-42.0,-21826.99
buyer_5,Sara,30,ES56209524809385928875,TRX_N-00382-13776433,2022-10-08T19:15:08,Donostia,expenses,water,-30.65,-21857.64
buyer_5,Sara,30,ES56209524809385928875,TRX_N-00383-66988226,2022-10-08T20:20:23,Donostia,expenses,electricity,-69.45,-21927.09
buyer_5,Sara,30,ES56209524809385928875,TRX_N-00384-24597413,2022-10-08T04:34:22,Donostia,expenses,gas,-55.43,-21982.52
buyer_5,Sara,30,ES56209524809385928875,TRX_N-00385-87069839,2022-10-08T16:57:36,Donostia,Expense,food,-121.68,-22104.2
buyer_5,Sara,30,ES56209524809385928875,TRX_N-00386-16416384,2022-10-09T14:43:29,Donostia,Expense,healthcare,-93.09,-22197.29
buyer_5,Sara,30,ES56209524809385928875,TRX_N-00387-44834785,2022-10-09T18:28:47,Iru√±a de Oca,Expense,cash,-100.0,-22297.29
buyer_5,Sara,30,ES56209524809385928875,TRX_N-00388-83729506,2022-10-10T16:58:08,Donostia,Expense,leisure,-66.31,-22363.6
buyer_5,Sara,30,ES56209524809385928875,TRX_N-00389-14748527,2022-10-10T12:39:06,Donostia,Expense,clothing,-131.49,-22495.09
buyer_5,Sara,30,ES56209524809385928875,TRX_N-00390-28210351,2022-10-10T08:40:17,Donostia,Expense,cash,-100.0,-22595.09
buyer_5,Sara,30,ES56209524809385928875,TRX_N-00391-90431793,2022-10-11T18:53:14,Donostia,Expense,food,-95.51,-22690.6
buyer_5,Sara,30,ES56209524809385928875,TRX_N-00392-68852392,2022-10-12T19:03:47,Donostia,Expense,food,-116.98,-22807.58
buyer_5,Sara,30,ES56209524809385928875,TRX_N-00393-79334678,2022-10-13T22:27:30,Donostia,Expense,repairs,-104.16,-22911.74
buyer_5,Sara,30,ES56209524809385928875,TRX_N-00394-46182365,2022-10-14T17:43:51,Donostia,expenses,children,-228.51,-23140.25
buyer_5,Sara,30,ES56209524809385928875,TRX_N-00395-10761603,2022-10-15T14:34:15,Donostia,Expense,healthcare,-181.77,-23322.02
buyer_5,Sara,30,ES56209524809385928875,TRX_N-00396-10441107,2022-10-18T10:22:11,Leioa,Expense,cash,-100.0,-23422.02
buyer_5,Sara,30,ES56209524809385928875,TRX_N-00397-27214287,2022-10-19T19:48:13,Donostia,Expense,leisure,-75.7,-23497.72
buyer_5,Sara,30,ES56209524809385928875,TRX_N-00398-20899736,2022-10-20T14:42:09,Getxo,Expense,leisure,-34.52,-23532.24
buyer_5,Sara,30,ES56209524809385928875,TRX_N-00399-79068528,2022-10-20T23:59:08,Donostia,Expense,cash,-100.0,-23632.24
buyer_5,Sara,30,ES56209524809385928875,TRX_N-00400-47483668,2022-10-22T15:07:52,Donostia,Expense,food,-85.81,-23718.05
buyer_5,Sara,30,ES56209524809385928875,TRX_N-00401-93805126,2022-10-23T21:37:13,Donostia,Expense,education,-71.66,-23789.71
buyer_5,Sara,30,ES56209524809385928875,TRX_N-00402-83452306,2022-10-23T00:34:01,Donostia,Expense,cash,-100.0,-23889.71
buyer_5,Sara,30,ES56209524809385928875,TRX_N-00403-41646404,2022-10-24T20:30:29,Vitoria-Gasteiz,Expense,cash,-100.0,-23989.71
buyer_5,Sara,30,ES56209524809385928875,TRX_N-00404-38490410,2022-10-24T23:42:06,Donostia,Expense,gifts,-148.05,-24137.76
buyer_5,Sara,30,ES56209524809385928875,TRX_N-00405-85906275,2022-10-26T17:33:24,Llodio,Expense,cash,-100.0,-24237.76
buyer_5,Sara,30,ES56209524809385928875,TRX_N-00406-14610704,2022-10-27T17:07:14,Donostia,Expense,transport,-74.4,-24312.16
buyer_5,Sara,30,ES56209524809385928875,TRX_N-00407-10312658,2022-10-30T05:21:13,Donostia,Expense,travel,-399.13,-24711.29
buyer_5,Sara,30,ES56209524809385928875,TRX_N-00408-24646897,2022-10-31T09:11:20,Donostia,Expense,food,-119.21,-24830.5
buyer_5,Sara,30,ES56209524809385928875,TRX_N-00409-52541133,2022-10-31T18:37:16,Portugalete,Expense,leisure,-64.35,-24894.85
buyer_5,Sara,30,ES56209524809385928875,TRX_N-00410-96052377,2022-11-01T20:29:16,Donostia,incomes,salary,1534.52,-23360.33
buyer_5,Sara,30,ES56209524809385928875,TRX_N-00411-84701657,2022-11-01T20:29:16,Donostia,incomes,salary_partner,1395.62,-21964.71
buyer_5,Sara,30,ES56209524809385928875,TRX_N-00412-80227046,2022-11-03T14:10:28,Lasarte-Oria,Expense,food,-111.59,-22076.3
buyer_5,Sara,30,ES56209524809385928875,TRX_N-00413-58770321,2022-11-04T13:53:20,Donostia,expenses,mortgage,-901.62,-22977.92
buyer_5,Sara,30,ES56209524809385928875,TRX_N-00414-22794344,2022-11-05T07:46:37,Donostia,expenses,electricity,-42.87,-23020.79
buyer_5,Sara,30,ES56209524809385928875,TRX_N-00415-65192433,2022-11-05T23:17:57,Donostia,expenses,gas,-98.4,-23119.19
buyer_5,Sara,30,ES56209524809385928875,TRX_N-00416-05044103,2022-11-06T15:25:11,Donostia,expenses,phone,-33.29,-23152.48
buyer_5,Sara,30,ES56209524809385928875,TRX_N-00417-59875518,2022-11-06T16:42:34,Donostia,Expense,healthcare,-82.9,-23235.38
buyer_5,Sara,30,ES56209524809385928875,TRX_N-00418-94417904,2022-11-06T13:47:39,Donostia,Expense,education,-58.2,-23293.58
buyer_5,Sara,30,ES56209524809385928875,TRX_N-00419-23205643,2022-11-07T15:38:19,Donostia,expenses,water,-23.94,-23317.52
buyer_5,Sara,30,ES56209524809385928875,TRX_N-00420-82821481,2022-11-07T11:58:20,Donostia,Expense,leisure,-20.8,-23338.32
buyer_5,Sara,30,ES56209524809385928875,TRX_N-00421-38313452,2022-11-07T08:37:07,Zuia,Expense,gifts,-818.51,-24156.83
buyer_5,Sara,30,ES56209524809385928875,TRX_N-00422-98690016,2022-11-08T17:10:31,Donostia,expenses,internet,-42.0,-24198.83
buyer_5,Sara,30,ES56209524809385928875,TRX_N-00423-90621090,2022-11-09T06:54:33,Donostia,Expense,leisure,-62.58,-24261.41
buyer_5,Sara,30,ES56209524809385928875,TRX_N-00424-89063347,2022-11-09T22:50:30,Barakaldo,Expense,gifts,-797.97,-25059.38
buyer_5,Sara,30,ES56209524809385928875,TRX_N-00425-65246666,2022-11-11T18:57:41,Donostia,Expense,repairs,-28.28,-25087.66
buyer_5,Sara,30,ES56209524809385928875,TRX_N-00426-18035094,2022-11-12T16:19:33,Donostia,Expense,transport,-66.93,-25154.59
buyer_5,Sara,30,ES56209524809385928875,TRX_N-00427-48043246,2022-11-13T02:31:13,Donostia,Expense,travel,-1693.03,-26847.62
buyer_5,Sara,30,ES56209524809385928875,TRX_N-00428-94983081,2022-11-14T11:51:25,Donostia,Expense,food,-90.12,-26937.74
buyer_5,Sara,30,ES56209524809385928875,TRX_N-00429-31832755,2022-11-17T18:28:12,Donostia,expenses,children,-234.41,-27172.15
buyer_5,Sara,30,ES56209524809385928875,TRX_N-00430-45948543,2022-11-18T20:11:09,Donostia,Expense,food,-96.44,-27268.59
buyer_5,Sara,30,ES56209524809385928875,TRX_N-00431-97402000,2022-11-18T23:04:34,Donostia,Expense,cash,-100.0,-27368.59
buyer_5,Sara,30,ES56209524809385928875,TRX_N-00432-75571482,2022-11-19T23:24:00,Donostia,Expense,appliances,-291.94,-27660.53
buyer_5,Sara,30,ES56209524809385928875,TRX_N-00433-10442468,2022-11-20T14:38:19,Berango,Expense,leisure,-24.33,-27684.86
buyer_5,Sara,30,ES56209524809385928875,TRX_N-00434-68341772,2022-11-20T12:35:20,Donostia,Expense,education,-50.24,-27735.1
buyer_5,Sara,30,ES56209524809385928875,TRX_N-00435-47676229,2022-11-22T06:20:56,Lasarte-Oria,Expense,food,-108.97,-27844.07
buyer_5,Sara,30,ES56209524809385928875,TRX_N-00436-37410534,2022-11-23T23:01:17,Donostia,Expense,food,-120.01,-27964.08
buyer_5,Sara,30,ES56209524809385928875,TRX_N-00437-67303004,2022-11-23T20:03:42,Donostia,expenses,children,-248.38,-28212.46
buyer_5,Sara,30,ES56209524809385928875,TRX_N-00438-01813319,2022-11-24T19:15:38,Donostia,Expense,food,-118.64,-28331.1
buyer_5,Sara,30,ES56209524809385928875,TRX_N-00439-49998139,2022-11-26T16:20:25,Donostia,Expense,food,-60.06,-28391.16
buyer_5,Sara,30,ES56209524809385928875,TRX_N-00440-99714328,2022-11-26T23:07:49,Donostia,Expense,clothing,-150.93,-28542.09
buyer_5,Sara,30,ES56209524809385928875,TRX_N-00441-75173690,2022-11-27T14:11:27,Donostia,Expense,leisure,-59.02,-28601.11
buyer_5,Sara,30,ES56209524809385928875,TRX_N-00442-20453310,2022-11-27T08:26:58,Donostia,Expense,education,-66.13,-28667.24
buyer_5,Sara,30,ES56209524809385928875,TRX_N-00443-13583692,2022-11-30T17:02:57,Santurtzi,Expense,leisure,-60.18,-28727.42
buyer_5,Sara,30,ES56209524809385928875,TRX_N-00444-76593711,2022-12-01T10:07:08,Donostia,incomes,salary,1534.52,-27192.9
buyer_5,Sara,30,ES56209524809385928875,TRX_N-00445-25966186,2022-12-01T10:07:08,Donostia,incomes,salary_partner,1395.62,-25797.28
buyer_5,Sara,30,ES56209524809385928875,TRX_N-00446-66136650,2022-12-01T10:07:08,Donostia,incomes,salary_bonus,1119.91,-24677.37
buyer_5,Sara,30,ES56209524809385928875,TRX_N-00447-00541651,2022-12-01T10:07:08,Donostia,incomes,salary_partner_bonus,1090.51,-23586.86
buyer_5,Sara,30,ES56209524809385928875,TRX_N-00448-55516100,2022-12-03T16:09:35,Donostia,Expense,cash,-100.0,-23686.86
buyer_5,Sara,30,ES56209524809385928875,TRX_N-00449-00886439,2022-12-04T16:28:00,Donostia,expenses,mortgage,-901.62,-24588.48
buyer_5,Sara,30,ES56209524809385928875,TRX_N-00450-53233895,2022-12-04T08:19:11,Donostia,Expense,food,-84.18,-24672.66
buyer_5,Sara,30,ES56209524809385928875,TRX_N-00451-75714203,2022-12-04T21:35:27,Donostia,Expense,leisure,-65.61,-24738.27
buyer_5,Sara,30,ES56209524809385928875,TRX_N-00452-00241275,2022-12-05T13:26:23,Donostia,expenses,water,-24.29,-24762.56
buyer_5,Sara,30,ES56209524809385928875,TRX_N-00453-13522866,2022-12-06T00:10:23,Donostia,expenses,gas,-33.07,-24795.63
buyer_5,Sara,30,ES56209524809385928875,TRX_N-00454-11216893,2022-12-06T13:19:08,Donostia,expenses,internet,-42.0,-24837.63
buyer_5,Sara,30,ES56209524809385928875,TRX_N-00455-36465874,2022-12-07T13:18:18,Bilbao,Expense,transport,-59.71,-24897.34
buyer_5,Sara,30,ES56209524809385928875,TRX_N-00456-71065669,2022-12-07T10:46:17,Donostia,Expense,clothing,-148.06,-25045.4
buyer_5,Sara,30,ES56209524809385928875,TRX_N-00457-46205321,2022-12-08T10:37:58,Donostia,expenses,electricity,-23.81,-25069.21
buyer_5,Sara,30,ES56209524809385928875,TRX_N-00458-03456742,2022-12-08T19:22:32,Donostia,expenses,phone,-33.82,-25103.03
buyer_5,Sara,30,ES56209524809385928875,TRX_N-00459-36739659,2022-12-08T16:12:07,Barakaldo,Expense,cash,-100.0,-25203.03
buyer_5,Sara,30,ES56209524809385928875,TRX_N-00460-26330996,2022-12-09T18:05:40,Donostia,Expense,clothing,-74.83,-25277.86
buyer_5,Sara,30,ES56209524809385928875,TRX_N-00461-63615987,2022-12-09T18:09:40,Donostia,Expense,appliances,-252.12,-25529.98
buyer_5,Sara,30,ES56209524809385928875,TRX_N-00462-40859474,2022-12-10T14:14:13,Donostia,Expense,food,-82.28,-25612.26
buyer_5,Sara,30,ES56209524809385928875,TRX_N-00463-43854818,2022-12-10T09:29:20,Donostia,Expense,leisure,-81.24,-25693.5
buyer_5,Sara,30,ES56209524809385928875,TRX_N-00464-46002775,2022-12-12T16:57:26,Donostia,Expense,leisure,-56.25,-25749.75
buyer_5,Sara,30,ES56209524809385928875,TRX_N-00465-12879258,2022-12-13T10:03:03,Donostia,Expense,cash,-100.0,-25849.75
buyer_5,Sara,30,ES56209524809385928875,TRX_N-00466-28245002,2022-12-14T13:05:57,Donostia,Expense,food,-65.48,-25915.23
buyer_5,Sara,30,ES56209524809385928875,TRX_N-00467-79944509,2022-12-14T12:10:18,Donostia,Expense,transport,-75.1,-25990.33
buyer_5,Sara,30,ES56209524809385928875,TRX_N-00468-33395494,2022-12-14T11:02:19,Donostia,Expense,leisure,-50.5,-26040.83
buyer_5,Sara,30,ES56209524809385928875,TRX_N-00469-52688368,2022-12-14T21:11:17,Donostia,Expense,healthcare,-70.02,-26110.85
buyer_5,Sara,30,ES56209524809385928875,TRX_N-00470-61792085,2022-12-16T01:30:45,Donostia,Expense,transport,-63.92,-26174.77
buyer_5,Sara,30,ES56209524809385928875,TRX_N-00471-54399138,2022-12-18T08:01:27,Lasarte-Oria,Expense,food,-84.71,-26259.48
buyer_5,Sara,30,ES56209524809385928875,TRX_N-00472-22066505,2022-12-18T19:33:46,Donostia,Expense,repairs,-149.15,-26408.63
buyer_5,Sara,30,ES56209524809385928875,TRX_N-00473-96823680,2022-12-19T13:00:16,Donostia,Expense,leisure,-23.46,-26432.09
buyer_5,Sara,30,ES56209524809385928875,TRX_N-00474-32941072,2022-12-19T16:29:53,Errenteria,Expense,cash,-100.0,-26532.09
buyer_5,Sara,30,ES56209524809385928875,TRX_N-00475-00839307,2022-12-22T23:04:34,Llodio,Expense,transport,-59.43,-26591.52
buyer_5,Sara,30,ES56209524809385928875,TRX_N-00476-99759905,2022-12-25T17:02:35,Donostia,Expense,food,-73.38,-26664.9
buyer_5,Sara,30,ES56209524809385928875,TRX_N-00477-39595971,2022-12-25T03:40:50,Donostia,Expense,leisure,-43.11,-26708.01
buyer_5,Sara,30,ES56209524809385928875,TRX_N-00478-99984053,2022-12-26T00:33:42,Donostia,Expense,leisure,-77.96,-26785.97
buyer_5,Sara,30,ES56209524809385928875,TRX_N-00479-36344958,2022-12-27T13:09:30,Donostia,Expense,leisure,-76.06,-26862.03
buyer_5,Sara,30,ES56209524809385928875,TRX_N-00480-77033713,2022-12-28T23:24:12,Oy√≥n-Oion,Expense,food,-103.87,-26965.9
buyer_5,Sara,30,ES56209524809385928875,TRX_N-00481-27665115,2022-12-29T09:51:11,Donostia,Expense,leisure,-47.23,-27013.13
buyer_5,Sara,30,ES56209524809385928875,TRX_N-00482-61429138,2022-12-31T20:35:26,Donostia,Expense,appliances,-145.01,-27158.14
buyer_5,Sara,30,ES56209524809385928875,TRX_N-00483-64559598,2023-01-01T21:54:33,Donostia,incomes,salary,1588.08,-25570.06
buyer_5,Sara,30,ES56209524809385928875,TRX_N-00484-64697243,2023-01-01T21:54:33,Donostia,incomes,salary_partner,1444.33,-24125.73
buyer_5,Sara,30,ES56209524809385928875,TRX_N-00485-19070716,2023-01-01T13:48:37,Bermeo,Expense,food,-85.38,-24211.11
buyer_5,Sara,30,ES56209524809385928875,TRX_N-00486-21311318,2023-01-01T18:07:56,Donostia,Expense,cash,-100.0,-24311.11
buyer_5,Sara,30,ES56209524809385928875,TRX_N-00487-45155336,2023-01-02T15:33:27,Donostia,Expense,leisure,-33.12,-24344.23
buyer_5,Sara,30,ES56209524809385928875,TRX_N-00488-08710586,2023-01-03T10:30:08,Basauri,Expense,transport,-58.32,-24402.55
buyer_5,Sara,30,ES56209524809385928875,TRX_N-00489-35759001,2023-01-04T08:54:17,Donostia,expenses,mortgage,-901.62,-25304.17
buyer_5,Sara,30,ES56209524809385928875,TRX_N-00490-03936623,2023-01-05T12:09:26,Donostia,expenses,gas,-78.97,-25383.14
buyer_5,Sara,30,ES56209524809385928875,TRX_N-00491-60755382,2023-01-05T11:17:22,Donostia,Expense,food,-61.8,-25444.94
buyer_5,Sara,30,ES56209524809385928875,TRX_N-00492-43383707,2023-01-05T08:52:27,Donostia,Expense,repairs,-41.17,-25486.11
buyer_5,Sara,30,ES56209524809385928875,TRX_N-00493-94577555,2023-01-07T21:13:08,Donostia,expenses,phone,-38.78,-25524.89
buyer_5,Sara,30,ES56209524809385928875,TRX_N-00494-05186003,2023-01-07T14:21:55,Errenteria,Expense,food,-104.25,-25629.14
buyer_5,Sara,30,ES56209524809385928875,TRX_N-00495-87170083,2023-01-08T12:25:43,Donostia,expenses,water,-39.23,-25668.37
buyer_5,Sara,30,ES56209524809385928875,TRX_N-00496-72026493,2023-01-08T11:40:48,Donostia,expenses,electricity,-29.47,-25697.84
buyer_5,Sara,30,ES56209524809385928875,TRX_N-00497-20673658,2023-01-08T08:16:47,Donostia,expenses,internet,-42.0,-25739.84
buyer_5,Sara,30,ES56209524809385928875,TRX_N-00498-44057412,2023-01-09T02:38:26,Donostia,Expense,food,-79.93,-25819.77
buyer_5,Sara,30,ES56209524809385928875,TRX_N-00499-64808609,2023-01-09T23:30:16,Donostia,expenses,children,-272.95,-26092.72
buyer_5,Sara,30,ES56209524809385928875,TRX_N-00500-76141543,2023-01-10T11:29:35,Donostia,Expense,cash,-100.0,-26192.72
buyer_5,Sara,30,ES56209524809385928875,TRX_N-00501-78136538,2023-01-11T16:56:36,Donostia,Expense,leisure,-79.06,-26271.78
buyer_5,Sara,30,ES56209524809385928875,TRX_N-00502-43632576,2023-01-11T20:23:18,Donostia,Expense,repairs,-119.73,-26391.51
buyer_5,Sara,30,ES56209524809385928875,TRX_N-00503-25870458,2023-01-13T10:47:13,Berango,Expense,food,-87.2,-26478.71
buyer_5,Sara,30,ES56209524809385928875,TRX_N-00504-14304897,2023-01-14T12:06:49,Donostia,Expense,cash,-100.0,-26578.71
buyer_5,Sara,30,ES56209524809385928875,TRX_N-00505-97921190,2023-01-17T23:56:57,Donostia,Expense,transport,-43.78,-26622.49
buyer_5,Sara,30,ES56209524809385928875,TRX_N-00506-39980821,2023-01-17T18:53:26,Donostia,Expense,clothing,-88.37,-26710.86
buyer_5,Sara,30,ES56209524809385928875,TRX_N-00507-21600538,2023-01-20T13:02:02,Donostia,Expense,leisure,-72.57,-26783.43
buyer_5,Sara,30,ES56209524809385928875,TRX_N-00508-70052912,2023-01-20T14:51:20,Donostia,Expense,cash,-100.0,-26883.43
buyer_5,Sara,30,ES56209524809385928875,TRX_N-00509-81898449,2023-01-22T11:49:35,Donostia,Expense,healthcare,-45.02,-26928.45
buyer_5,Sara,30,ES56209524809385928875,TRX_N-00510-53615762,2023-01-22T23:25:17,Donostia,expenses,children,-103.9,-27032.35
buyer_5,Sara,30,ES56209524809385928875,TRX_N-00511-53229308,2023-01-23T19:17:04,Donostia,Expense,healthcare,-100.51,-27132.86
buyer_5,Sara,30,ES56209524809385928875,TRX_N-00512-41515283,2023-01-27T19:31:56,Donostia,Expense,clothing,-159.61,-27292.47
buyer_5,Sara,30,ES56209524809385928875,TRX_N-00513-98217158,2023-01-27T08:53:24,Donostia,Expense,cash,-100.0,-27392.47
buyer_5,Sara,30,ES56209524809385928875,TRX_N-00514-52669042,2023-01-27T14:08:42,Donostia,Expense,appliances,-173.41,-27565.88
buyer_5,Sara,30,ES56209524809385928875,TRX_N-00515-24166783,2023-01-28T20:26:45,Donostia,Expense,leisure,-40.64,-27606.52
buyer_5,Sara,30,ES56209524809385928875,TRX_N-00516-24424116,2023-01-28T15:39:38,Donostia,Expense,travel,-685.21,-28291.73
buyer_5,Sara,30,ES56209524809385928875,TRX_N-00517-75782775,2023-01-31T12:12:45,Irun,Expense,cash,-100.0,-28391.73
buyer_5,Sara,30,ES56209524809385928875,TRX_N-00518-51072278,2023-02-01T13:09:38,Donostia,incomes,salary,1588.08,-26803.65
buyer_5,Sara,30,ES56209524809385928875,TRX_N-00519-86878812,2023-02-01T13:09:38,Donostia,incomes,salary_partner,1444.33,-25359.32
buyer_5,Sara,30,ES56209524809385928875,TRX_N-00520-36338462,2023-02-01T13:09:38,Donostia,incomes,extra_income,273.26,-25086.06
buyer_5,Sara,30,ES56209524809385928875,TRX_N-00521-83550435,2023-02-02T16:38:27,Donostia,Expense,leisure,-73.12,-25159.18
buyer_5,Sara,30,ES56209524809385928875,TRX_N-00522-38351907,2023-02-03T08:06:14,Donostia,Expense,cash,-100.0,-25259.18
buyer_5,Sara,30,ES56209524809385928875,TRX_N-00523-76958511,2023-02-04T18:13:01,Donostia,expenses,mortgage,-901.62,-26160.8
buyer_5,Sara,30,ES56209524809385928875,TRX_N-00524-52879855,2023-02-04T20:53:33,Donostia,Expense,education,-71.35,-26232.15
buyer_5,Sara,30,ES56209524809385928875,TRX_N-00525-15512720,2023-02-04T15:50:25,Donostia,expenses,children,-269.09,-26501.24
buyer_5,Sara,30,ES56209524809385928875,TRX_N-00526-87945761,2023-02-05T14:27:21,Donostia,expenses,water,-43.75,-26544.99
buyer_5,Sara,30,ES56209524809385928875,TRX_N-00527-76302707,2023-02-05T06:17:20,Donostia,expenses,phone,-44.72,-26589.71
buyer_5,Sara,30,ES56209524809385928875,TRX_N-00528-46205260,2023-02-05T17:44:39,Donostia,Expense,food,-74.85,-26664.56
buyer_5,Sara,30,ES56209524809385928875,TRX_N-00529-35662121,2023-02-06T11:58:31,Donostia,expenses,gas,-46.47,-26711.03
buyer_5,Sara,30,ES56209524809385928875,TRX_N-00530-24525163,2023-02-06T20:21:37,Donostia,Expense,education,-66.73,-26777.76
buyer_5,Sara,30,ES56209524809385928875,TRX_N-00531-79442650,2023-02-07T19:04:06,Donostia,expenses,internet,-42.0,-26819.76
buyer_5,Sara,30,ES56209524809385928875,TRX_N-00532-65012648,2023-02-08T16:42:53,Donostia,expenses,electricity,-42.77,-26862.53
buyer_5,Sara,30,ES56209524809385928875,TRX_N-00533-62728318,2023-02-09T23:57:56,Donostia,Expense,travel,-785.14,-27647.67
buyer_5,Sara,30,ES56209524809385928875,TRX_N-00534-89953769,2023-02-12T03:18:11,Getxo,Expense,leisure,-29.19,-27676.86
buyer_5,Sara,30,ES56209524809385928875,TRX_N-00535-47272273,2023-02-12T09:57:18,Donostia,Expense,clothing,-111.97,-27788.83
buyer_5,Sara,30,ES56209524809385928875,TRX_N-00536-99004645,2023-02-13T23:44:38,Zarautz,Expense,repairs,-277.64,-28066.47
buyer_5,Sara,30,ES56209524809385928875,TRX_N-00537-69927200,2023-02-15T19:52:33,Donostia,Expense,cash,-100.0,-28166.47
buyer_5,Sara,30,ES56209524809385928875,TRX_N-00538-49946220,2023-02-16T13:48:12,Donostia,Expense,food,-73.94,-28240.41
buyer_5,Sara,30,ES56209524809385928875,TRX_N-00539-34845126,2023-02-17T09:06:56,Errenteria,Expense,cash,-100.0,-28340.41
buyer_5,Sara,30,ES56209524809385928875,TRX_N-00540-38320117,2023-02-20T21:00:46,Donostia,Expense,food,-83.63,-28424.04
buyer_5,Sara,30,ES56209524809385928875,TRX_N-00541-75966983,2023-02-21T18:36:28,Donostia,Expense,cash,-100.0,-28524.04
buyer_5,Sara,30,ES56209524809385928875,TRX_N-00542-32916506,2023-02-23T11:01:35,Alegr√≠a-Dulantzi,Expense,food,-108.67,-28632.71
buyer_5,Sara,30,ES56209524809385928875,TRX_N-00543-34400023,2023-02-24T00:49:45,Donostia,Expense,appliances,-393.07,-29025.78
buyer_5,Sara,30,ES56209524809385928875,TRX_N-00544-10245368,2023-02-24T19:11:20,Donostia,Expense,repairs,-36.41,-29062.19
buyer_5,Sara,30,ES56209524809385928875,TRX_N-00545-46193025,2023-02-25T01:08:56,Donostia,Expense,cash,-100.0,-29162.19
buyer_5,Sara,30,ES56209524809385928875,TRX_N-00546-87834163,2023-02-25T19:30:59,Donostia,Expense,repairs,-43.32,-29205.51
buyer_5,Sara,30,ES56209524809385928875,TRX_N-00547-10438859,2023-02-26T12:06:05,Donostia,Expense,leisure,-39.21,-29244.72
buyer_5,Sara,30,ES56209524809385928875,TRX_N-00548-10662319,2023-02-27T14:56:09,Donostia,Expense,food,-86.19,-29330.91
buyer_5,Sara,30,ES56209524809385928875,TRX_N-00549-21816272,2023-03-01T20:26:31,Donostia,incomes,salary,1588.08,-27742.83
buyer_5,Sara,30,ES56209524809385928875,TRX_N-00550-23896528,2023-03-01T20:26:31,Donostia,incomes,salary_partner,1444.33,-26298.5
buyer_5,Sara,30,ES56209524809385928875,TRX_N-00551-30142220,2023-03-02T20:35:28,Donostia,Expense,cash,-100.0,-26398.5
buyer_5,Sara,30,ES56209524809385928875,TRX_N-00552-70465270,2023-03-03T14:32:52,Donostia,Expense,transport,-80.84,-26479.34
buyer_5,Sara,30,ES56209524809385928875,TRX_N-00553-79350192,2023-03-04T18:03:06,Donostia,expenses,mortgage,-901.62,-27380.96
buyer_5,Sara,30,ES56209524809385928875,TRX_N-00554-91749717,2023-03-04T18:14:33,Eibar,Expense,healthcare,-58.84,-27439.8
buyer_5,Sara,30,ES56209524809385928875,TRX_N-00555-18940428,2023-03-05T18:01:28,Donostia,expenses,internet,-42.0,-27481.8
buyer_5,Sara,30,ES56209524809385928875,TRX_N-00556-32500404,2023-03-05T15:51:19,Donostia,expenses,phone,-41.21,-27523.01
buyer_5,Sara,30,ES56209524809385928875,TRX_N-00557-22963094,2023-03-06T20:06:59,Donostia,Expense,clothing,-78.66,-27601.67
buyer_5,Sara,30,ES56209524809385928875,TRX_N-00558-09506005,2023-03-06T14:41:19,Llodio,Expense,cash,-100.0,-27701.67
buyer_5,Sara,30,ES56209524809385928875,TRX_N-00559-64702887,2023-03-06T16:13:25,Donostia,Expense,repairs,-76.68,-27778.35
buyer_5,Sara,30,ES56209524809385928875,TRX_N-00560-96391733,2023-03-06T15:10:03,Donostia,expenses,children,-275.65,-28054.0
buyer_5,Sara,30,ES56209524809385928875,TRX_N-00561-94901160,2023-03-07T13:48:16,Donostia,expenses,gas,-75.42,-28129.42
buyer_5,Sara,30,ES56209524809385928875,TRX_N-00562-34384641,2023-03-08T20:39:38,Donostia,expenses,electricity,-40.73,-28170.15
buyer_5,Sara,30,ES56209524809385928875,TRX_N-00563-53850791,2023-03-08T08:28:57,Donostia,expenses,water,-35.43,-28205.58
buyer_5,Sara,30,ES56209524809385928875,TRX_N-00564-98431513,2023-03-08T11:32:01,Donostia,Expense,food,-116.04,-28321.62
buyer_5,Sara,30,ES56209524809385928875,TRX_N-00565-72853710,2023-03-09T16:19:19,Donostia,Expense,cash,-100.0,-28421.62
buyer_5,Sara,30,ES56209524809385928875,TRX_N-00566-02211926,2023-03-12T12:56:19,Elciego,Expense,gifts,-477.55,-28899.17
buyer_5,Sara,30,ES56209524809385928875,TRX_N-00567-72097714,2023-03-15T14:38:07,Donostia,Expense,cash,-100.0,-28999.17
buyer_5,Sara,30,ES56209524809385928875,TRX_N-00568-42753171,2023-03-16T14:05:29,Donostia,Expense,repairs,-40.95,-29040.12
buyer_5,Sara,30,ES56209524809385928875,TRX_N-00569-99010934,2023-03-18T09:31:19,Portugalete,Expense,cash,-100.0,-29140.12
buyer_5,Sara,30,ES56209524809385928875,TRX_N-00570-16903503,2023-03-19T18:59:47,Donostia,Expense,cash,-100.0,-29240.12
buyer_5,Sara,30,ES56209524809385928875,TRX_N-00571-84578499,2023-03-20T11:00:47,Donostia,Expense,food,-66.87,-29306.99
buyer_5,Sara,30,ES56209524809385928875,TRX_N-00572-86851050,2023-03-20T04:47:20,Vitoria-Gasteiz,Expense,cash,-100.0,-29406.99
buyer_5,Sara,30,ES56209524809385928875,TRX_N-00573-54278170,2023-03-21T17:21:42,Lasarte-Oria,Expense,cash,-100.0,-29506.99
buyer_5,Sara,30,ES56209524809385928875,TRX_N-00574-34692450,2023-03-21T12:11:50,Donostia,Expense,repairs,-93.13,-29600.12
buyer_5,Sara,30,ES56209524809385928875,TRX_N-00575-45910679,2023-03-22T22:40:23,Andoain,Expense,food,-114.73,-29714.85
buyer_5,Sara,30,ES56209524809385928875,TRX_N-00576-51611898,2023-03-24T19:16:01,Durango,Expense,transport,-42.76,-29757.61
buyer_5,Sara,30,ES56209524809385928875,TRX_N-00577-19819522,2023-03-26T21:53:35,Donostia,Expense,clothing,-85.95,-29843.56
buyer_5,Sara,30,ES56209524809385928875,TRX_N-00578-35174665,2023-03-26T16:55:06,Mungia,Expense,appliances,-351.49,-30195.05
buyer_5,Sara,30,ES56209524809385928875,TRX_N-00579-24339902,2023-03-27T18:41:30,Irun,Expense,cash,-100.0,-30295.05
buyer_5,Sara,30,ES56209524809385928875,TRX_N-00580-73032974,2023-03-29T08:33:43,Donostia,expenses,children,-79.3,-30374.35
buyer_5,Sara,30,ES56209524809385928875,TRX_N-00581-84362470,2023-03-30T08:31:29,Llodio,Expense,food,-99.89,-30474.24
buyer_5,Sara,30,ES56209524809385928875,TRX_N-00582-45246509,2023-04-01T20:53:50,Donostia,incomes,salary,1588.08,-28886.16
buyer_5,Sara,30,ES56209524809385928875,TRX_N-00583-34683826,2023-04-01T20:53:50,Donostia,incomes,salary_partner,1444.33,-27441.83
buyer_5,Sara,30,ES56209524809385928875,TRX_N-00584-63740960,2023-04-01T09:56:08,Donostia,Expense,gifts,-65.46,-27507.29
buyer_5,Sara,30,ES56209524809385928875,TRX_N-00585-84415896,2023-04-02T13:11:05,Donostia,Expense,education,-57.24,-27564.53
buyer_5,Sara,30,ES56209524809385928875,TRX_N-00586-33068602,2023-04-02T14:06:20,Donostia,Expense,cash,-100.0,-27664.53
buyer_5,Sara,30,ES56209524809385928875,TRX_N-00587-84092068,2023-04-03T12:03:06,Donostia,Expense,leisure,-18.66,-27683.19
buyer_5,Sara,30,ES56209524809385928875,TRX_N-00588-19213269,2023-04-04T20:45:23,Donostia,expenses,mortgage,-901.62,-28584.81
buyer_5,Sara,30,ES56209524809385928875,TRX_N-00589-65243243,2023-04-04T20:20:26,Donostia,Expense,transport,-74.18,-28658.99
buyer_5,Sara,30,ES56209524809385928875,TRX_N-00590-62434536,2023-04-04T16:57:17,Donostia,Expense,cash,-100.0,-28758.99
buyer_5,Sara,30,ES56209524809385928875,TRX_N-00591-08979688,2023-04-06T18:59:43,Donostia,expenses,gas,-52.42,-28811.41
buyer_5,Sara,30,ES56209524809385928875,TRX_N-00592-23845024,2023-04-06T10:02:59,Donostia,expenses,internet,-42.0,-28853.41
buyer_5,Sara,30,ES56209524809385928875,TRX_N-00593-76080284,2023-04-06T02:38:23,Donostia,Expense,leisure,-79.92,-28933.33
buyer_5,Sara,30,ES56209524809385928875,TRX_N-00594-72527310,2023-04-07T15:45:13,Donostia,expenses,electricity,-21.9,-28955.23
buyer_5,Sara,30,ES56209524809385928875,TRX_N-00595-51243610,2023-04-07T12:36:15,Donostia,Expense,transport,-74.06,-29029.29
buyer_5,Sara,30,ES56209524809385928875,TRX_N-00596-26842657,2023-04-08T09:30:55,Donostia,expenses,water,-34.59,-29063.88
buyer_5,Sara,30,ES56209524809385928875,TRX_N-00597-71853265,2023-04-08T10:42:21,Donostia,expenses,phone,-44.95,-29108.83
buyer_5,Sara,30,ES56209524809385928875,TRX_N-00598-23414158,2023-04-09T13:21:25,Donostia,Expense,cash,-100.0,-29208.83
buyer_5,Sara,30,ES56209524809385928875,TRX_N-00599-42353253,2023-04-12T08:39:56,Donostia,Expense,food,-81.72,-29290.55
buyer_5,Sara,30,ES56209524809385928875,TRX_N-00600-17944699,2023-04-13T11:39:38,Donostia,expenses,children,-235.22,-29525.77
buyer_5,Sara,30,ES56209524809385928875,TRX_N-00601-59295644,2023-04-14T10:30:01,Donostia,Expense,food,-64.43,-29590.2
buyer_5,Sara,30,ES56209524809385928875,TRX_N-00602-52708595,2023-04-17T17:45:02,Donostia,Expense,food,-123.37,-29713.57
buyer_5,Sara,30,ES56209524809385928875,TRX_N-00603-10616830,2023-04-17T02:06:39,Donostia,expenses,children,-70.49,-29784.06
buyer_5,Sara,30,ES56209524809385928875,TRX_N-00604-63312461,2023-04-19T10:51:21,Hernani,Expense,food,-95.48,-29879.54
buyer_5,Sara,30,ES56209524809385928875,TRX_N-00605-46996005,2023-04-21T19:54:56,Donostia,Expense,food,-97.57,-29977.11
buyer_5,Sara,30,ES56209524809385928875,TRX_N-00606-67414173,2023-04-22T08:17:07,Donostia,Expense,food,-68.57,-30045.68
buyer_5,Sara,30,ES56209524809385928875,TRX_N-00607-20233583,2023-04-23T06:31:23,Donostia,Expense,transport,-89.73,-30135.41
buyer_5,Sara,30,ES56209524809385928875,TRX_N-00608-82296163,2023-04-24T11:33:59,Donostia,Expense,healthcare,-143.32,-30278.73
buyer_5,Sara,30,ES56209524809385928875,TRX_N-00609-20756532,2023-04-24T08:51:51,Donostia,expenses,children,-79.25,-30357.98
buyer_5,Sara,30,ES56209524809385928875,TRX_N-00610-32709665,2023-04-27T13:20:45,Donostia,Expense,food,-114.94,-30472.92
buyer_5,Sara,30,ES56209524809385928875,TRX_N-00611-23482316,2023-04-27T20:29:49,Donostia,Expense,cash,-100.0,-30572.92
buyer_5,Sara,30,ES56209524809385928875,TRX_N-00612-71069846,2023-04-29T08:11:09,Lasarte-Oria,Expense,clothing,-151.95,-30724.87
buyer_5,Sara,30,ES56209524809385928875,TRX_N-00613-38966649,2023-04-29T20:29:23,Leioa,Expense,cash,-100.0,-30824.87
buyer_5,Sara,30,ES56209524809385928875,TRX_N-00614-85088443,2023-04-30T18:13:47,Bermeo,Expense,cash,-100.0,-30924.87
buyer_5,Sara,30,ES56209524809385928875,TRX_N-00615-21848115,2023-05-01T11:36:51,Donostia,incomes,salary,1588.08,-29336.79
buyer_5,Sara,30,ES56209524809385928875,TRX_N-00616-42152054,2023-05-01T11:36:51,Donostia,incomes,salary_partner,1444.33,-27892.46
buyer_5,Sara,30,ES56209524809385928875,TRX_N-00617-19499963,2023-05-01T11:36:51,Donostia,incomes,extra_income,273.26,-27619.2
buyer_5,Sara,30,ES56209524809385928875,TRX_N-00618-40426082,2023-05-01T17:56:26,Donostia,Expense,gifts,-345.09,-27964.29
buyer_5,Sara,30,ES56209524809385928875,TRX_N-00619-69596384,2023-05-03T13:13:11,Donostia,Expense,food,-90.03,-28054.32
buyer_5,Sara,30,ES56209524809385928875,TRX_N-00620-76273924,2023-05-04T14:32:08,Donostia,expenses,mortgage,-901.62,-28955.94
buyer_5,Sara,30,ES56209524809385928875,TRX_N-00621-12174743,2023-05-04T16:30:57,Donostia,Expense,transport,-45.53,-29001.47
buyer_5,Sara,30,ES56209524809385928875,TRX_N-00622-39981431,2023-05-04T11:25:46,Donostia,Expense,cash,-100.0,-29101.47
buyer_5,Sara,30,ES56209524809385928875,TRX_N-00623-10826224,2023-05-04T18:16:13,Sopela,Expense,repairs,-252.33,-29353.8
buyer_5,Sara,30,ES56209524809385928875,TRX_N-00624-59664894,2023-05-05T17:13:12,Donostia,Expense,gifts,-496.54,-29850.34
buyer_5,Sara,30,ES56209524809385928875,TRX_N-00625-08728249,2023-05-05T17:24:21,Donostia,expenses,children,-152.32,-30002.66
buyer_5,Sara,30,ES56209524809385928875,TRX_N-00626-34504898,2023-05-06T04:32:40,Donostia,expenses,internet,-42.0,-30044.66
buyer_5,Sara,30,ES56209524809385928875,TRX_N-00627-91537419,2023-05-06T17:10:21,Donostia,Expense,cash,-100.0,-30144.66
buyer_5,Sara,30,ES56209524809385928875,TRX_N-00628-80634568,2023-05-07T12:12:22,Donostia,expenses,electricity,-87.94,-30232.6
buyer_5,Sara,30,ES56209524809385928875,TRX_N-00629-27729044,2023-05-08T05:20:05,Donostia,expenses,phone,-35.06,-30267.66
buyer_5,Sara,30,ES56209524809385928875,TRX_N-00630-54560029,2023-05-08T13:21:43,Donostia,expenses,water,-36.39,-30304.05
buyer_5,Sara,30,ES56209524809385928875,TRX_N-00631-76769398,2023-05-08T23:17:13,Donostia,expenses,gas,-71.32,-30375.37
buyer_5,Sara,30,ES56209524809385928875,TRX_N-00632-08609450,2023-05-11T19:51:19,Donostia,Expense,food,-70.28,-30445.65
buyer_5,Sara,30,ES56209524809385928875,TRX_N-00633-42193485,2023-05-13T18:57:39,Donostia,Expense,food,-60.18,-30505.83
buyer_5,Sara,30,ES56209524809385928875,TRX_N-00634-58173404,2023-05-13T08:22:43,Donostia,Expense,cash,-100.0,-30605.83
buyer_5,Sara,30,ES56209524809385928875,TRX_N-00635-24702944,2023-05-14T16:12:54,Donostia,Expense,cash,-100.0,-30705.83
buyer_5,Sara,30,ES56209524809385928875,TRX_N-00636-19413629,2023-05-14T11:52:47,Donostia,Expense,gifts,-347.24,-31053.07
buyer_5,Sara,30,ES56209524809385928875,TRX_N-00637-40434054,2023-05-16T13:28:21,Portugalete,Expense,gifts,-276.63,-31329.7
buyer_5,Sara,30,ES56209524809385928875,TRX_N-00638-35928163,2023-05-17T17:50:46,Donostia,Expense,gifts,-107.24,-31436.94
buyer_5,Sara,30,ES56209524809385928875,TRX_N-00639-33299683,2023-05-18T12:22:38,Donostia,Expense,food,-112.41,-31549.35
buyer_5,Sara,30,ES56209524809385928875,TRX_N-00640-57076417,2023-05-18T13:14:05,Donostia,Expense,transport,-70.89,-31620.24
buyer_5,Sara,30,ES56209524809385928875,TRX_N-00641-78235128,2023-05-20T13:47:13,Donostia,Expense,transport,-63.99,-31684.23
buyer_5,Sara,30,ES56209524809385928875,TRX_N-00642-49279795,2023-05-21T20:47:50,Donostia,Expense,food,-74.63,-31758.86
buyer_5,Sara,30,ES56209524809385928875,TRX_N-00643-03624732,2023-05-21T23:21:38,Donostia,Expense,cash,-100.0,-31858.86
buyer_5,Sara,30,ES56209524809385928875,TRX_N-00644-68952835,2023-05-21T18:22:57,Donostia,expenses,children,-232.66,-32091.52
buyer_5,Sara,30,ES56209524809385928875,TRX_N-00645-17303366,2023-05-24T07:19:22,Donostia,Expense,appliances,-258.97,-32350.49
buyer_5,Sara,30,ES56209524809385928875,TRX_N-00646-82726824,2023-05-25T13:23:42,Donostia,Expense,transport,-78.7,-32429.19
buyer_5,Sara,30,ES56209524809385928875,TRX_N-00647-29342702,2023-05-25T15:52:29,Donostia,Expense,leisure,-75.99,-32505.18
buyer_5,Sara,30,ES56209524809385928875,TRX_N-00648-73017884,2023-05-25T11:31:22,Donostia,Expense,education,-67.99,-32573.17
buyer_5,Sara,30,ES56209524809385928875,TRX_N-00649-60067815,2023-05-28T08:26:30,Donostia,Expense,gifts,-830.6,-33403.77
buyer_5,Sara,30,ES56209524809385928875,TRX_N-00650-34305875,2023-05-29T11:57:34,Oy√≥n-Oion,Expense,cash,-100.0,-33503.77
buyer_5,Sara,30,ES56209524809385928875,TRX_N-00651-67143243,2023-06-01T11:17:57,Donostia,incomes,salary,1588.08,-31915.69
buyer_5,Sara,30,ES56209524809385928875,TRX_N-00652-32972121,2023-06-01T11:17:57,Donostia,incomes,salary_partner,1444.33,-30471.36
buyer_5,Sara,30,ES56209524809385928875,TRX_N-00653-19497440,2023-06-01T11:17:57,Donostia,incomes,salary_bonus,1254.31,-29217.05
buyer_5,Sara,30,ES56209524809385928875,TRX_N-00654-66673144,2023-06-01T11:17:57,Donostia,incomes,salary_partner_bonus,1076.12,-28140.93
buyer_5,Sara,30,ES56209524809385928875,TRX_N-00655-16181668,2023-06-01T17:43:59,Donostia,Expense,repairs,-325.61,-28466.54
buyer_5,Sara,30,ES56209524809385928875,TRX_N-00656-15687635,2023-06-02T10:12:53,Donostia,Expense,cash,-100.0,-28566.54
buyer_5,Sara,30,ES56209524809385928875,TRX_N-00657-07185590,2023-06-04T09:16:21,Donostia,expenses,mortgage,-901.62,-29468.16
buyer_5,Sara,30,ES56209524809385928875,TRX_N-00658-36955707,2023-06-04T16:08:02,Donostia,Expense,food,-65.06,-29533.22
buyer_5,Sara,30,ES56209524809385928875,TRX_N-00659-35226637,2023-06-04T12:12:04,Donostia,Expense,healthcare,-62.62,-29595.84
buyer_5,Sara,30,ES56209524809385928875,TRX_N-00660-27482482,2023-06-05T18:45:26,Donostia,expenses,water,-39.71,-29635.55
buyer_5,Sara,30,ES56209524809385928875,TRX_N-00661-25170062,2023-06-05T22:50:56,Donostia,expenses,electricity,-41.95,-29677.5
buyer_5,Sara,30,ES56209524809385928875,TRX_N-00662-67285131,2023-06-05T21:57:14,Donostia,expenses,phone,-32.42,-29709.92
buyer_5,Sara,30,ES56209524809385928875,TRX_N-00663-74485451,2023-06-05T23:05:42,Alegr√≠a-Dulantzi,Expense,repairs,-110.75,-29820.67
buyer_5,Sara,30,ES56209524809385928875,TRX_N-00664-00361330,2023-06-06T04:42:13,Donostia,expenses,gas,-45.97,-29866.64
buyer_5,Sara,30,ES56209524809385928875,TRX_N-00665-85357773,2023-06-06T01:13:59,Donostia,Expense,leisure,-18.65,-29885.29
buyer_5,Sara,30,ES56209524809385928875,TRX_N-00666-06178177,2023-06-08T09:19:54,Donostia,expenses,internet,-42.0,-29927.29
buyer_5,Sara,30,ES56209524809385928875,TRX_N-00667-98158866,2023-06-08T07:03:40,Donostia,Expense,cash,-100.0,-30027.29
buyer_5,Sara,30,ES56209524809385928875,TRX_N-00668-61878097,2023-06-09T16:41:22,Galdakao,Expense,repairs,-153.75,-30181.04
buyer_5,Sara,30,ES56209524809385928875,TRX_N-00669-94133793,2023-06-10T12:46:28,Donostia,Expense,cash,-100.0,-30281.04
buyer_5,Sara,30,ES56209524809385928875,TRX_N-00670-02341702,2023-06-10T11:50:09,Donostia,expenses,children,-166.98,-30448.02
buyer_5,Sara,30,ES56209524809385928875,TRX_N-00671-08774659,2023-06-11T16:33:50,Donostia,Expense,food,-80.3,-30528.32
buyer_5,Sara,30,ES56209524809385928875,TRX_N-00672-24965273,2023-06-12T11:33:35,Donostia,Expense,food,-61.34,-30589.66
buyer_5,Sara,30,ES56209524809385928875,TRX_N-00673-13353160,2023-06-12T14:44:13,Donostia,Expense,transport,-87.19,-30676.85
buyer_5,Sara,30,ES56209524809385928875,TRX_N-00674-58092751,2023-06-14T12:03:26,Vitoria-Gasteiz,Expense,repairs,-317.93,-30994.78
buyer_5,Sara,30,ES56209524809385928875,TRX_N-00675-95773280,2023-06-17T16:35:32,Amurrio,Expense,transport,-46.1,-31040.88
buyer_5,Sara,30,ES56209524809385928875,TRX_N-00676-22338502,2023-06-18T20:27:44,Donostia,expenses,children,-176.78,-31217.66
buyer_5,Sara,30,ES56209524809385928875,TRX_N-00677-69131114,2023-06-20T19:38:14,Donostia,Expense,repairs,-29.64,-31247.3
buyer_5,Sara,30,ES56209524809385928875,TRX_N-00678-38270848,2023-06-21T14:28:17,Donostia,Expense,leisure,-24.71,-31272.01
buyer_5,Sara,30,ES56209524809385928875,TRX_N-00679-18519923,2023-06-23T19:32:49,Donostia,Expense,food,-78.62,-31350.63
buyer_5,Sara,30,ES56209524809385928875,TRX_N-00680-89380318,2023-06-25T10:15:45,Donostia,Expense,transport,-48.77,-31399.4
buyer_5,Sara,30,ES56209524809385928875,TRX_N-00681-71543178,2023-06-26T20:00:00,Donostia,Expense,clothing,-155.68,-31555.08
buyer_5,Sara,30,ES56209524809385928875,TRX_N-00682-43142678,2023-06-28T04:04:33,Donostia,Expense,cash,-100.0,-31655.08
buyer_5,Sara,30,ES56209524809385928875,TRX_N-00683-78430432,2023-06-29T11:44:08,Donostia,Expense,food,-101.48,-31756.56
buyer_5,Sara,30,ES56209524809385928875,TRX_N-00684-26645253,2023-06-29T10:07:03,Hernani,Expense,appliances,-391.7,-32148.26
buyer_5,Sara,30,ES56209524809385928875,TRX_N-00685-40423779,2023-07-01T10:43:15,Donostia,incomes,salary,1588.08,-30560.18
buyer_5,Sara,30,ES56209524809385928875,TRX_N-00686-72395888,2023-07-01T10:43:15,Donostia,incomes,salary_partner,1444.33,-29115.85
buyer_5,Sara,30,ES56209524809385928875,TRX_N-00687-62205981,2023-07-02T21:21:04,Donostia,Expense,repairs,-201.64,-29317.49
buyer_5,Sara,30,ES56209524809385928875,TRX_N-00688-34563682,2023-07-04T10:42:06,Donostia,expenses,mortgage,-901.62,-30219.11
buyer_5,Sara,30,ES56209524809385928875,TRX_N-00689-28542508,2023-07-04T18:46:54,Donostia,Expense,leisure,-67.72,-30286.83
buyer_5,Sara,30,ES56209524809385928875,TRX_N-00690-26738672,2023-07-06T00:51:50,Donostia,Expense,transport,-82.92,-30369.75
buyer_5,Sara,30,ES56209524809385928875,TRX_N-00691-22095672,2023-07-06T20:17:29,Donostia,Expense,clothing,-150.83,-30520.58
buyer_5,Sara,30,ES56209524809385928875,TRX_N-00692-39630174,2023-07-07T18:00:09,Donostia,expenses,electricity,-76.6,-30597.18
buyer_5,Sara,30,ES56209524809385928875,TRX_N-00693-20752912,2023-07-07T07:08:15,Donostia,expenses,gas,-93.3,-30690.48
buyer_5,Sara,30,ES56209524809385928875,TRX_N-00694-05227868,2023-07-07T17:50:15,Donostia,expenses,internet,-42.0,-30732.48
buyer_5,Sara,30,ES56209524809385928875,TRX_N-00695-25287894,2023-07-07T21:45:36,Donostia,expenses,phone,-40.73,-30773.21
buyer_5,Sara,30,ES56209524809385928875,TRX_N-00696-09151988,2023-07-07T17:18:22,Arrasate,Expense,leisure,-22.97,-30796.18
buyer_5,Sara,30,ES56209524809385928875,TRX_N-00697-14587011,2023-07-07T11:13:38,Donostia,expenses,children,-258.51,-31054.69
buyer_5,Sara,30,ES56209524809385928875,TRX_N-00698-35173706,2023-07-08T14:21:05,Donostia,expenses,water,-34.01,-31088.7
buyer_5,Sara,30,ES56209524809385928875,TRX_N-00699-89342473,2023-07-08T12:03:38,Donostia,Expense,leisure,-58.43,-31147.13
buyer_5,Sara,30,ES56209524809385928875,TRX_N-00700-07061887,2023-07-08T06:44:56,Donostia,Expense,appliances,-80.22,-31227.35
buyer_5,Sara,30,ES56209524809385928875,TRX_N-00701-17820081,2023-07-09T00:07:15,Donostia,Expense,leisure,-66.54,-31293.89
buyer_5,Sara,30,ES56209524809385928875,TRX_N-00702-65914265,2023-07-09T15:42:02,Andoain,Expense,clothing,-153.51,-31447.4
buyer_5,Sara,30,ES56209524809385928875,TRX_N-00703-04422728,2023-07-11T22:28:25,Donostia,Expense,food,-123.4,-31570.8
buyer_5,Sara,30,ES56209524809385928875,TRX_N-00704-93429730,2023-07-11T16:12:01,Donostia,Expense,transport,-55.74,-31626.54
buyer_5,Sara,30,ES56209524809385928875,TRX_N-00705-40406772,2023-07-11T19:44:34,Donostia,expenses,children,-51.44,-31677.98
buyer_5,Sara,30,ES56209524809385928875,TRX_N-00706-02012776,2023-07-12T10:55:58,Bilbao,Expense,transport,-50.7,-31728.68
buyer_5,Sara,30,ES56209524809385928875,TRX_N-00707-92238543,2023-07-12T12:25:40,Iru√±a de Oca,Expense,leisure,-63.34,-31792.02
buyer_5,Sara,30,ES56209524809385928875,TRX_N-00708-79527252,2023-07-14T07:47:13,Donostia,Expense,food,-89.85,-31881.87
buyer_5,Sara,30,ES56209524809385928875,TRX_N-00709-89046168,2023-07-15T08:58:07,Donostia,Expense,transport,-65.51,-31947.38
buyer_5,Sara,30,ES56209524809385928875,TRX_N-00710-12905504,2023-07-15T09:05:24,Donostia,Expense,travel,-1340.95,-33288.33
buyer_5,Sara,30,ES56209524809385928875,TRX_N-00711-43954560,2023-07-16T13:36:51,Bermeo,Expense,clothing,-148.44,-33436.77
buyer_5,Sara,30,ES56209524809385928875,TRX_N-00712-42340261,2023-07-17T15:48:15,Donostia,Expense,food,-114.36,-33551.13
buyer_5,Sara,30,ES56209524809385928875,TRX_N-00713-27351754,2023-07-19T14:22:57,Donostia,Expense,leisure,-63.64,-33614.77
buyer_5,Sara,30,ES56209524809385928875,TRX_N-00714-63809073,2023-07-20T19:21:13,Donostia,Expense,cash,-100.0,-33714.77
buyer_5,Sara,30,ES56209524809385928875,TRX_N-00715-06559270,2023-07-23T23:16:54,Pasaia,Expense,cash,-100.0,-33814.77
buyer_5,Sara,30,ES56209524809385928875,TRX_N-00716-22733672,2023-07-23T22:55:08,Donostia,Expense,gifts,-687.52,-34502.29
buyer_5,Sara,30,ES56209524809385928875,TRX_N-00717-64094636,2023-07-24T22:18:10,Donostia,Expense,gifts,-848.68,-35350.97
buyer_5,Sara,30,ES56209524809385928875,TRX_N-00718-64858131,2023-07-25T20:17:48,Donostia,Expense,transport,-40.87,-35391.84
buyer_5,Sara,30,ES56209524809385928875,TRX_N-00719-29388578,2023-07-26T20:41:02,Donostia,Expense,repairs,-178.87,-35570.71
buyer_5,Sara,30,ES56209524809385928875,TRX_N-00720-04021347,2023-07-26T19:05:55,Donostia,Expense,gifts,-243.53,-35814.24
buyer_5,Sara,30,ES56209524809385928875,TRX_N-00721-87180219,2023-07-28T10:18:43,Leioa,Expense,transport,-61.38,-35875.62
buyer_5,Sara,30,ES56209524809385928875,TRX_N-00722-38653803,2023-07-28T20:59:31,Donostia,Expense,cash,-100.0,-35975.62
buyer_5,Sara,30,ES56209524809385928875,TRX_N-00723-07588375,2023-07-29T12:11:06,Donostia,Expense,cash,-100.0,-36075.62
buyer_5,Sara,30,ES56209524809385928875,TRX_N-00724-53046450,2023-08-01T05:29:51,Donostia,incomes,salary,1588.08,-34487.54
buyer_5,Sara,30,ES56209524809385928875,TRX_N-00725-24551507,2023-08-01T05:29:51,Donostia,incomes,salary_partner,1444.33,-33043.21
buyer_5,Sara,30,ES56209524809385928875,TRX_N-00726-48895927,2023-08-01T05:29:51,Donostia,incomes,extra_income,273.26,-32769.95
buyer_5,Sara,30,ES56209524809385928875,TRX_N-00727-29219297,2023-08-01T16:20:54,Donostia,Expense,food,-81.14,-32851.09
buyer_5,Sara,30,ES56209524809385928875,TRX_N-00728-21041548,2023-08-01T17:42:58,Donostia,Expense,leisure,-68.13,-32919.22
buyer_5,Sara,30,ES56209524809385928875,TRX_N-00729-70866606,2023-08-01T19:38:10,Donostia,Expense,clothing,-124.64,-33043.86
buyer_5,Sara,30,ES56209524809385928875,TRX_N-00730-22338153,2023-08-01T18:18:47,Donostia,Expense,cash,-100.0,-33143.86
buyer_5,Sara,30,ES56209524809385928875,TRX_N-00731-55959642,2023-08-02T22:41:41,Donostia,Expense,transport,-55.35,-33199.21
buyer_5,Sara,30,ES56209524809385928875,TRX_N-00732-58099018,2023-08-03T16:33:09,Donostia,Expense,gifts,-192.44,-33391.65
buyer_5,Sara,30,ES56209524809385928875,TRX_N-00733-85280349,2023-08-04T19:39:08,Donostia,expenses,mortgage,-901.62,-34293.27
buyer_5,Sara,30,ES56209524809385928875,TRX_N-00734-32924219,2023-08-05T08:42:42,Donostia,expenses,gas,-68.05,-34361.32
buyer_5,Sara,30,ES56209524809385928875,TRX_N-00735-18974884,2023-08-05T08:28:35,Donostia,Expense,food,-88.26,-34449.58
buyer_5,Sara,30,ES56209524809385928875,TRX_N-00736-70760836,2023-08-06T13:45:12,Donostia,expenses,phone,-37.35,-34486.93
buyer_5,Sara,30,ES56209524809385928875,TRX_N-00737-07033191,2023-08-07T12:16:06,Donostia,expenses,electricity,-73.63,-34560.56
buyer_5,Sara,30,ES56209524809385928875,TRX_N-00738-33153978,2023-08-08T11:12:25,Donostia,expenses,internet,-42.0,-34602.56
buyer_5,Sara,30,ES56209524809385928875,TRX_N-00739-59820773,2023-08-08T16:47:09,Donostia,expenses,water,-37.1,-34639.66
buyer_5,Sara,30,ES56209524809385928875,TRX_N-00740-09267767,2023-08-08T01:41:19,Donostia,Expense,transport,-48.26,-34687.92
buyer_5,Sara,30,ES56209524809385928875,TRX_N-00741-10479716,2023-08-09T07:59:07,Donostia,Expense,cash,-100.0,-34787.92
buyer_5,Sara,30,ES56209524809385928875,TRX_N-00742-77519050,2023-08-10T17:16:24,Donostia,Expense,cash,-100.0,-34887.92
buyer_5,Sara,30,ES56209524809385928875,TRX_N-00743-36826094,2023-08-11T21:40:00,Donostia,Expense,repairs,-219.14,-35107.06
buyer_5,Sara,30,ES56209524809385928875,TRX_N-00744-45669976,2023-08-12T17:34:35,Arrasate,Expense,food,-115.49,-35222.55
buyer_5,Sara,30,ES56209524809385928875,TRX_N-00745-47564209,2023-08-12T11:07:29,Donostia,Expense,appliances,-221.53,-35444.08
buyer_5,Sara,30,ES56209524809385928875,TRX_N-00746-13449441,2023-08-12T15:12:43,Donostia,expenses,children,-127.18,-35571.26
buyer_5,Sara,30,ES56209524809385928875,TRX_N-00747-18743208,2023-08-14T11:53:36,Donostia,Expense,leisure,-34.89,-35606.15
buyer_5,Sara,30,ES56209524809385928875,TRX_N-00748-88893292,2023-08-14T16:25:52,Donostia,Expense,repairs,-204.24,-35810.39
buyer_5,Sara,30,ES56209524809385928875,TRX_N-00749-90539904,2023-08-16T19:19:09,Donostia,Expense,gifts,-157.26,-35967.65
buyer_5,Sara,30,ES56209524809385928875,TRX_N-00750-62651092,2023-08-17T12:33:31,Donostia,Expense,food,-74.03,-36041.68
buyer_5,Sara,30,ES56209524809385928875,TRX_N-00751-06157733,2023-08-17T11:44:19,Salvatierra/Agurain,Expense,cash,-100.0,-36141.68
buyer_5,Sara,30,ES56209524809385928875,TRX_N-00752-39353412,2023-08-20T20:18:58,Arrasate,Expense,transport,-89.48,-36231.16
buyer_5,Sara,30,ES56209524809385928875,TRX_N-00753-54162526,2023-08-21T11:37:44,Donostia,Expense,transport,-73.5,-36304.66
buyer_5,Sara,30,ES56209524809385928875,TRX_N-00754-78292490,2023-08-21T17:55:07,Donostia,Expense,cash,-100.0,-36404.66
buyer_5,Sara,30,ES56209524809385928875,TRX_N-00755-97160632,2023-08-22T08:46:46,Alegr√≠a-Dulantzi,Expense,appliances,-277.84,-36682.5
buyer_5,Sara,30,ES56209524809385928875,TRX_N-00756-60385716,2023-08-24T08:49:00,Donostia,Expense,repairs,-251.18,-36933.68
buyer_5,Sara,30,ES56209524809385928875,TRX_N-00757-91491499,2023-08-27T08:56:17,Donostia,Expense,food,-103.95,-37037.63
buyer_5,Sara,30,ES56209524809385928875,TRX_N-00758-47046297,2023-08-27T19:02:37,Donostia,Expense,transport,-86.41,-37124.04
buyer_5,Sara,30,ES56209524809385928875,TRX_N-00759-60714310,2023-08-28T19:49:09,Donostia,Expense,leisure,-45.85,-37169.89
buyer_5,Sara,30,ES56209524809385928875,TRX_N-00760-77612376,2023-08-30T15:50:32,Sopela,Expense,cash,-100.0,-37269.89
buyer_5,Sara,30,ES56209524809385928875,TRX_N-00761-31118796,2023-08-31T08:54:24,Donostia,Expense,transport,-87.09,-37356.98
buyer_5,Sara,30,ES56209524809385928875,TRX_N-00762-28669686,2023-09-01T14:41:28,Donostia,incomes,salary,1588.08,-35768.9
buyer_5,Sara,30,ES56209524809385928875,TRX_N-00763-63453491,2023-09-01T14:41:28,Donostia,incomes,salary_partner,1444.33,-34324.57
buyer_5,Sara,30,ES56209524809385928875,TRX_N-00764-94203942,2023-09-01T14:38:39,Donostia,Expense,food,-107.25,-34431.82
buyer_5,Sara,30,ES56209524809385928875,TRX_N-00765-12982230,2023-09-03T19:22:11,Donostia,Expense,food,-115.05,-34546.87
buyer_5,Sara,30,ES56209524809385928875,TRX_N-00766-59237251,2023-09-03T16:05:07,Donostia,Expense,cash,-100.0,-34646.87
buyer_5,Sara,30,ES56209524809385928875,TRX_N-00767-08845692,2023-09-04T08:33:01,Donostia,expenses,mortgage,-901.62,-35548.49
buyer_5,Sara,30,ES56209524809385928875,TRX_N-00768-32736172,2023-09-04T13:59:45,Donostia,Expense,repairs,-330.65,-35879.14
buyer_5,Sara,30,ES56209524809385928875,TRX_N-00769-33086064,2023-09-05T08:03:52,Donostia,expenses,electricity,-28.42,-35907.56
buyer_5,Sara,30,ES56209524809385928875,TRX_N-00770-42081258,2023-09-05T14:44:57,Donostia,Expense,food,-61.29,-35968.85
buyer_5,Sara,30,ES56209524809385928875,TRX_N-00771-57957511,2023-09-05T21:34:04,Donostia,Expense,cash,-100.0,-36068.85
buyer_5,Sara,30,ES56209524809385928875,TRX_N-00772-98553240,2023-09-06T08:28:18,Donostia,expenses,water,-25.22,-36094.07
buyer_5,Sara,30,ES56209524809385928875,TRX_N-00773-04637933,2023-09-06T18:28:49,Donostia,expenses,internet,-42.0,-36136.07
buyer_5,Sara,30,ES56209524809385928875,TRX_N-00774-22720584,2023-09-06T09:43:05,Donostia,Expense,cash,-100.0,-36236.07
buyer_5,Sara,30,ES56209524809385928875,TRX_N-00775-66926242,2023-09-07T14:34:17,Santurtzi,Expense,food,-85.58,-36321.65
buyer_5,Sara,30,ES56209524809385928875,TRX_N-00776-13425762,2023-09-07T06:12:36,Donostia,expenses,children,-253.13,-36574.78
buyer_5,Sara,30,ES56209524809385928875,TRX_N-00777-16422581,2023-09-08T09:41:40,Donostia,expenses,gas,-106.21,-36680.99
buyer_5,Sara,30,ES56209524809385928875,TRX_N-00778-01864628,2023-09-08T12:52:03,Donostia,expenses,phone,-39.13,-36720.12
buyer_5,Sara,30,ES56209524809385928875,TRX_N-00779-47482603,2023-09-08T11:07:35,Donostia,Expense,food,-64.46,-36784.58
buyer_5,Sara,30,ES56209524809385928875,TRX_N-00780-16980362,2023-09-12T21:24:38,Donostia,Expense,food,-85.12,-36869.7
buyer_5,Sara,30,ES56209524809385928875,TRX_N-00781-67047787,2023-09-15T13:32:32,Donostia,Expense,food,-89.48,-36959.18
buyer_5,Sara,30,ES56209524809385928875,TRX_N-00782-74819179,2023-09-15T10:54:29,Donostia,Expense,cash,-100.0,-37059.18
buyer_5,Sara,30,ES56209524809385928875,TRX_N-00783-12052538,2023-09-16T20:10:43,Donostia,Expense,food,-95.79,-37154.97
buyer_5,Sara,30,ES56209524809385928875,TRX_N-00784-64132353,2023-09-16T20:53:52,Donostia,Expense,clothing,-145.75,-37300.72
buyer_5,Sara,30,ES56209524809385928875,TRX_N-00785-35532214,2023-09-16T01:16:39,Donostia,Expense,cash,-100.0,-37400.72
buyer_5,Sara,30,ES56209524809385928875,TRX_N-00786-18236547,2023-09-17T17:25:42,Donostia,Expense,education,-48.45,-37449.17
buyer_5,Sara,30,ES56209524809385928875,TRX_N-00787-40254615,2023-09-19T10:24:28,Donostia,Expense,transport,-46.59,-37495.76
buyer_5,Sara,30,ES56209524809385928875,TRX_N-00788-93428181,2023-09-19T14:35:51,Donostia,Expense,cash,-100.0,-37595.76
buyer_5,Sara,30,ES56209524809385928875,TRX_N-00789-43182580,2023-09-20T19:09:25,Donostia,expenses,children,-215.55,-37811.31
buyer_5,Sara,30,ES56209524809385928875,TRX_N-00790-51235430,2023-09-22T14:52:22,Donostia,Expense,leisure,-26.08,-37837.39
buyer_5,Sara,30,ES56209524809385928875,TRX_N-00791-41764997,2023-09-22T22:39:44,Zarautz,Expense,healthcare,-158.09,-37995.48
buyer_5,Sara,30,ES56209524809385928875,TRX_N-00792-70669582,2023-09-23T19:29:36,Irun,Expense,transport,-57.1,-38052.58
buyer_5,Sara,30,ES56209524809385928875,TRX_N-00793-29206338,2023-09-23T00:25:02,Donostia,Expense,healthcare,-167.46,-38220.04
buyer_5,Sara,30,ES56209524809385928875,TRX_N-00794-16179723,2023-09-26T08:53:43,Donostia,Expense,education,-70.91,-38290.95
buyer_5,Sara,30,ES56209524809385928875,TRX_N-00795-62698710,2023-10-01T15:55:28,Donostia,incomes,salary,1588.08,-36702.87
buyer_5,Sara,30,ES56209524809385928875,TRX_N-00796-20261907,2023-10-01T15:55:28,Donostia,incomes,salary_partner,1444.33,-35258.54
buyer_5,Sara,30,ES56209524809385928875,TRX_N-00797-49881899,2023-10-01T19:26:26,Donostia,Expense,cash,-100.0,-35358.54
buyer_5,Sara,30,ES56209524809385928875,TRX_N-00798-90820979,2023-10-01T17:22:17,Donostia,expenses,children,-205.15,-35563.69
buyer_5,Sara,30,ES56209524809385928875,TRX_N-00799-75747503,2023-10-02T18:15:29,Donostia,Expense,transport,-87.53,-35651.22
buyer_5,Sara,30,ES56209524809385928875,TRX_N-00800-16207163,2023-10-02T00:30:40,Donostia,Expense,healthcare,-68.75,-35719.97
buyer_5,Sara,30,ES56209524809385928875,TRX_N-00801-10715874,2023-10-04T17:14:44,Donostia,expenses,mortgage,-901.62,-36621.59
buyer_5,Sara,30,ES56209524809385928875,TRX_N-00802-34320181,2023-10-04T13:42:03,Donostia,Expense,clothing,-146.76,-36768.35
buyer_5,Sara,30,ES56209524809385928875,TRX_N-00803-86447114,2023-10-05T12:53:10,Donostia,expenses,water,-41.52,-36809.87
buyer_5,Sara,30,ES56209524809385928875,TRX_N-00804-25581177,2023-10-05T20:42:37,Donostia,Expense,leisure,-42.18,-36852.05
buyer_5,Sara,30,ES56209524809385928875,TRX_N-00805-37779593,2023-10-06T11:06:28,Donostia,expenses,internet,-42.0,-36894.05
buyer_5,Sara,30,ES56209524809385928875,TRX_N-00806-41352292,2023-10-06T14:40:09,Donostia,Expense,repairs,-177.27,-37071.32
buyer_5,Sara,30,ES56209524809385928875,TRX_N-00807-24964014,2023-10-07T15:17:37,Donostia,Expense,leisure,-83.45,-37154.77
buyer_5,Sara,30,ES56209524809385928875,TRX_N-00808-69117749,2023-10-07T16:05:45,Donostia,Expense,education,-61.4,-37216.17
buyer_5,Sara,30,ES56209524809385928875,TRX_N-00809-73213968,2023-10-07T16:25:21,Zuia,Expense,cash,-100.0,-37316.17
buyer_5,Sara,30,ES56209524809385928875,TRX_N-00810-23117936,2023-10-08T14:45:23,Donostia,expenses,gas,-101.6,-37417.77
buyer_5,Sara,30,ES56209524809385928875,TRX_N-00811-99620525,2023-10-08T22:59:44,Donostia,expenses,electricity,-31.66,-37449.43
buyer_5,Sara,30,ES56209524809385928875,TRX_N-00812-40419047,2023-10-08T10:10:02,Donostia,expenses,phone,-31.27,-37480.7
buyer_5,Sara,30,ES56209524809385928875,TRX_N-00813-19521689,2023-10-08T08:29:56,Donostia,Expense,transport,-84.1,-37564.8
buyer_5,Sara,30,ES56209524809385928875,TRX_N-00814-88085054,2023-10-09T15:18:53,Donostia,Expense,food,-124.95,-37689.75
buyer_5,Sara,30,ES56209524809385928875,TRX_N-00815-51100877,2023-10-09T20:13:39,Eibar,Expense,cash,-100.0,-37789.75
buyer_5,Sara,30,ES56209524809385928875,TRX_N-00816-86949775,2023-10-09T10:02:14,Donostia,Expense,repairs,-300.66,-38090.41
buyer_5,Sara,30,ES56209524809385928875,TRX_N-00817-36678275,2023-10-11T17:26:59,Donostia,expenses,children,-131.52,-38221.93
buyer_5,Sara,30,ES56209524809385928875,TRX_N-00818-17000304,2023-10-14T17:52:07,Amurrio,Expense,healthcare,-167.7,-38389.63
buyer_5,Sara,30,ES56209524809385928875,TRX_N-00819-07164312,2023-10-19T08:56:54,Donostia,Expense,cash,-100.0,-38489.63
buyer_5,Sara,30,ES56209524809385928875,TRX_N-00820-48032658,2023-10-20T20:09:34,Donostia,Expense,transport,-57.76,-38547.39
buyer_5,Sara,30,ES56209524809385928875,TRX_N-00821-67693998,2023-10-21T17:26:29,Donostia,Expense,cash,-100.0,-38647.39
buyer_5,Sara,30,ES56209524809385928875,TRX_N-00822-21384241,2023-10-22T15:43:18,Donostia,Expense,cash,-100.0,-38747.39
buyer_5,Sara,30,ES56209524809385928875,TRX_N-00823-03174621,2023-10-23T13:23:11,Donostia,Expense,clothing,-117.96,-38865.35
buyer_5,Sara,30,ES56209524809385928875,TRX_N-00824-68605379,2023-10-24T10:27:37,Zarautz,Expense,cash,-100.0,-38965.35
buyer_5,Sara,30,ES56209524809385928875,TRX_N-00825-24437240,2023-10-25T09:38:41,Donostia,Expense,cash,-100.0,-39065.35
buyer_5,Sara,30,ES56209524809385928875,TRX_N-00826-22431073,2023-10-26T02:29:58,Donostia,Expense,cash,-100.0,-39165.35
buyer_5,Sara,30,ES56209524809385928875,TRX_N-00827-84522782,2023-10-30T17:17:37,Donostia,Expense,food,-100.49,-39265.84
buyer_5,Sara,30,ES56209524809385928875,TRX_N-00828-93993371,2023-10-31T11:16:13,Donostia,Expense,transport,-89.25,-39355.09
buyer_5,Sara,30,ES56209524809385928875,TRX_N-00829-39387845,2023-11-01T13:12:35,Donostia,incomes,salary,1588.08,-37767.01
buyer_5,Sara,30,ES56209524809385928875,TRX_N-00830-79183694,2023-11-01T13:12:35,Donostia,incomes,salary_partner,1444.33,-36322.68
buyer_5,Sara,30,ES56209524809385928875,TRX_N-00831-61595130,2023-11-02T11:00:44,Erandio,Expense,food,-75.15,-36397.83
buyer_5,Sara,30,ES56209524809385928875,TRX_N-00832-43167687,2023-11-03T20:15:49,Donostia,Expense,food,-117.9,-36515.73
buyer_5,Sara,30,ES56209524809385928875,TRX_N-00833-28421733,2023-11-03T12:41:05,Donostia,Expense,repairs,-268.54,-36784.27
buyer_5,Sara,30,ES56209524809385928875,TRX_N-00834-37281716,2023-11-04T16:50:01,Donostia,expenses,mortgage,-901.62,-37685.89
buyer_5,Sara,30,ES56209524809385928875,TRX_N-00835-67114537,2023-11-05T20:24:58,Donostia,expenses,water,-31.43,-37717.32
buyer_5,Sara,30,ES56209524809385928875,TRX_N-00836-63896763,2023-11-05T09:42:56,Donostia,expenses,gas,-67.95,-37785.27
buyer_5,Sara,30,ES56209524809385928875,TRX_N-00837-84014057,2023-11-05T11:53:49,Donostia,expenses,internet,-42.0,-37827.27
buyer_5,Sara,30,ES56209524809385928875,TRX_N-00838-25553849,2023-11-05T16:47:22,Donostia,Expense,food,-74.84,-37902.11
buyer_5,Sara,30,ES56209524809385928875,TRX_N-00839-47492505,2023-11-05T09:42:01,Llodio,Expense,leisure,-47.26,-37949.37
buyer_5,Sara,30,ES56209524809385928875,TRX_N-00840-72043076,2023-11-05T08:25:12,Donostia,Expense,gifts,-719.84,-38669.21
buyer_5,Sara,30,ES56209524809385928875,TRX_N-00841-33806178,2023-11-07T15:24:00,Donostia,expenses,electricity,-87.6,-38756.81
buyer_5,Sara,30,ES56209524809385928875,TRX_N-00842-55844284,2023-11-07T10:15:32,Donostia,expenses,phone,-36.43,-38793.24
buyer_5,Sara,30,ES56209524809385928875,TRX_N-00843-17016124,2023-11-07T09:50:41,Donostia,Expense,cash,-100.0,-38893.24
buyer_5,Sara,30,ES56209524809385928875,TRX_N-00844-12435102,2023-11-10T10:54:14,Barakaldo,Expense,food,-94.79,-38988.03
buyer_5,Sara,30,ES56209524809385928875,TRX_N-00845-76778754,2023-11-11T08:14:30,Barakaldo,Expense,clothing,-128.5,-39116.53
buyer_5,Sara,30,ES56209524809385928875,TRX_N-00846-16306009,2023-11-12T11:18:14,Donostia,Expense,cash,-100.0,-39216.53
buyer_5,Sara,30,ES56209524809385928875,TRX_N-00847-57546783,2023-11-13T21:44:16,Berango,Expense,food,-65.45,-39281.98
buyer_5,Sara,30,ES56209524809385928875,TRX_N-00848-77199768,2023-11-15T17:45:21,Donostia,Expense,repairs,-300.43,-39582.41
buyer_5,Sara,30,ES56209524809385928875,TRX_N-00849-28011826,2023-11-16T19:31:45,Donostia,Expense,cash,-100.0,-39682.41
buyer_5,Sara,30,ES56209524809385928875,TRX_N-00850-82565042,2023-11-18T10:00:33,Donostia,Expense,transport,-75.14,-39757.55
buyer_5,Sara,30,ES56209524809385928875,TRX_N-00851-24971942,2023-11-18T11:14:36,Donostia,Expense,repairs,-172.59,-39930.14
buyer_5,Sara,30,ES56209524809385928875,TRX_N-00852-93166993,2023-11-20T17:49:22,Donostia,Expense,leisure,-79.61,-40009.75
buyer_5,Sara,30,ES56209524809385928875,TRX_N-00853-80983099,2023-11-22T09:50:59,Donostia,Expense,transport,-88.93,-40098.68
buyer_5,Sara,30,ES56209524809385928875,TRX_N-00854-06165539,2023-11-22T18:36:58,Donostia,Expense,clothing,-139.17,-40237.85
buyer_5,Sara,30,ES56209524809385928875,TRX_N-00855-60845178,2023-11-24T21:17:35,Donostia,Expense,cash,-100.0,-40337.85
buyer_5,Sara,30,ES56209524809385928875,TRX_N-00856-72277192,2023-11-27T15:17:31,Donostia,Expense,food,-122.41,-40460.26
buyer_5,Sara,30,ES56209524809385928875,TRX_N-00857-34567315,2023-11-27T00:53:56,Donostia,Expense,cash,-100.0,-40560.26
buyer_5,Sara,30,ES56209524809385928875,TRX_N-00858-77565424,2023-11-28T20:35:24,Donostia,Expense,cash,-100.0,-40660.26
buyer_5,Sara,30,ES56209524809385928875,TRX_N-00859-97627187,2023-11-28T08:54:24,Donostia,Expense,appliances,-362.02,-41022.28
buyer_5,Sara,30,ES56209524809385928875,TRX_N-00860-89820834,2023-11-30T14:45:16,Donostia,Expense,cash,-100.0,-41122.28
buyer_5,Sara,30,ES56209524809385928875,TRX_N-00861-06600430,2023-12-01T13:14:01,Donostia,incomes,salary,1588.08,-39534.2
buyer_5,Sara,30,ES56209524809385928875,TRX_N-00862-44112152,2023-12-01T13:14:01,Donostia,incomes,salary_partner,1444.33,-38089.87
buyer_5,Sara,30,ES56209524809385928875,TRX_N-00863-98668532,2023-12-01T13:14:01,Donostia,incomes,extra_income,273.26,-37816.61
buyer_5,Sara,30,ES56209524809385928875,TRX_N-00864-99858437,2023-12-01T13:14:01,Donostia,incomes,salary_bonus,1185.02,-36631.59
buyer_5,Sara,30,ES56209524809385928875,TRX_N-00865-08965429,2023-12-01T13:14:01,Donostia,incomes,salary_partner_bonus,1111.37,-35520.22
buyer_5,Sara,30,ES56209524809385928875,TRX_N-00866-86790543,2023-12-01T11:39:33,Donostia,Expense,healthcare,-83.84,-35604.06
buyer_5,Sara,30,ES56209524809385928875,TRX_N-00867-22177151,2023-12-02T18:53:03,Donostia,Expense,cash,-100.0,-35704.06
buyer_5,Sara,30,ES56209524809385928875,TRX_N-00868-70962652,2023-12-02T13:22:28,Donostia,Expense,repairs,-295.95,-36000.01
buyer_5,Sara,30,ES56209524809385928875,TRX_N-00869-97796517,2023-12-03T21:34:53,Donostia,Expense,food,-105.65,-36105.66
buyer_5,Sara,30,ES56209524809385928875,TRX_N-00870-93640240,2023-12-04T14:19:08,Donostia,expenses,mortgage,-901.62,-37007.28
buyer_5,Sara,30,ES56209524809385928875,TRX_N-00871-44809946,2023-12-05T11:48:10,Donostia,expenses,electricity,-76.68,-37083.96
buyer_5,Sara,30,ES56209524809385928875,TRX_N-00872-62281720,2023-12-05T12:44:39,Donostia,Expense,healthcare,-114.46,-37198.42
buyer_5,Sara,30,ES56209524809385928875,TRX_N-00873-41125243,2023-12-05T21:19:10,Donostia,Expense,repairs,-89.88,-37288.3
buyer_5,Sara,30,ES56209524809385928875,TRX_N-00874-51467530,2023-12-06T11:38:48,Donostia,expenses,gas,-43.32,-37331.62
buyer_5,Sara,30,ES56209524809385928875,TRX_N-00875-85135217,2023-12-06T23:31:47,Bilbao,Expense,clothing,-92.75,-37424.37
buyer_5,Sara,30,ES56209524809385928875,TRX_N-00876-71200808,2023-12-06T18:04:38,Donostia,Expense,cash,-100.0,-37524.37
buyer_5,Sara,30,ES56209524809385928875,TRX_N-00877-70714964,2023-12-07T10:25:38,Donostia,Expense,cash,-100.0,-37624.37
buyer_5,Sara,30,ES56209524809385928875,TRX_N-00878-44442780,2023-12-08T21:28:20,Donostia,expenses,water,-33.72,-37658.09
buyer_5,Sara,30,ES56209524809385928875,TRX_N-00879-48686890,2023-12-08T11:20:16,Donostia,expenses,internet,-42.0,-37700.09
buyer_5,Sara,30,ES56209524809385928875,TRX_N-00880-40121982,2023-12-08T15:43:46,Donostia,expenses,phone,-44.35,-37744.44
buyer_5,Sara,30,ES56209524809385928875,TRX_N-00881-15446375,2023-12-10T22:06:03,Donostia,Expense,cash,-100.0,-37844.44
buyer_5,Sara,30,ES56209524809385928875,TRX_N-00882-09988886,2023-12-11T08:57:13,Donostia,Expense,food,-114.02,-37958.46
buyer_5,Sara,30,ES56209524809385928875,TRX_N-00883-95323987,2023-12-13T14:37:17,Donostia,Expense,cash,-100.0,-38058.46
buyer_5,Sara,30,ES56209524809385928875,TRX_N-00884-80434820,2023-12-14T16:56:00,Donostia,Expense,gifts,-678.34,-38736.8
buyer_5,Sara,30,ES56209524809385928875,TRX_N-00885-05250129,2023-12-15T13:59:37,Donostia,Expense,food,-89.31,-38826.11
buyer_5,Sara,30,ES56209524809385928875,TRX_N-00886-28379400,2023-12-15T15:01:21,Getxo,Expense,clothing,-112.51,-38938.62
buyer_5,Sara,30,ES56209524809385928875,TRX_N-00887-97493285,2023-12-15T09:16:37,Donostia,Expense,healthcare,-158.54,-39097.16
buyer_5,Sara,30,ES56209524809385928875,TRX_N-00888-00444386,2023-12-15T13:51:24,Mungia,Expense,cash,-100.0,-39197.16
buyer_5,Sara,30,ES56209524809385928875,TRX_N-00889-79033773,2023-12-17T17:08:25,Donostia,Expense,healthcare,-55.07,-39252.23
buyer_5,Sara,30,ES56209524809385928875,TRX_N-00890-69803035,2023-12-19T15:39:06,Vitoria-Gasteiz,Expense,food,-117.56,-39369.79
buyer_5,Sara,30,ES56209524809385928875,TRX_N-00891-17595070,2023-12-19T13:16:45,Donostia,Expense,leisure,-76.84,-39446.63
buyer_5,Sara,30,ES56209524809385928875,TRX_N-00892-52209133,2023-12-19T18:15:00,Donostia,Expense,healthcare,-154.11,-39600.74
buyer_5,Sara,30,ES56209524809385928875,TRX_N-00893-61965943,2023-12-19T00:28:35,Donostia,Expense,cash,-100.0,-39700.74
buyer_5,Sara,30,ES56209524809385928875,TRX_N-00894-36371538,2023-12-20T10:59:26,Donostia,Expense,cash,-100.0,-39800.74
buyer_5,Sara,30,ES56209524809385928875,TRX_N-00895-30374912,2023-12-21T16:38:17,Donostia,Expense,transport,-44.19,-39844.93
buyer_5,Sara,30,ES56209524809385928875,TRX_N-00896-22780235,2023-12-22T06:01:10,Donostia,Expense,transport,-89.5,-39934.43
buyer_5,Sara,30,ES56209524809385928875,TRX_N-00897-35201268,2023-12-22T20:21:42,Donostia,Expense,cash,-100.0,-40034.43
buyer_5,Sara,30,ES56209524809385928875,TRX_N-00898-12515691,2023-12-23T17:32:00,Donostia,Expense,leisure,-74.73,-40109.16
buyer_5,Sara,30,ES56209524809385928875,TRX_N-00899-63389944,2023-12-24T22:32:47,Bermeo,Expense,cash,-100.0,-40209.16
buyer_5,Sara,30,ES56209524809385928875,TRX_N-00900-11815845,2023-12-25T10:55:36,Donostia,Expense,leisure,-71.53,-40280.69
buyer_5,Sara,30,ES56209524809385928875,TRX_N-00901-76405637,2023-12-26T20:28:56,Barakaldo,Expense,leisure,-21.58,-40302.27
buyer_5,Sara,30,ES56209524809385928875,TRX_N-00902-82558246,2023-12-28T20:37:23,Donostia,Expense,transport,-70.41,-40372.68
buyer_5,Sara,30,ES56209524809385928875,TRX_N-00903-58685198,2023-12-29T20:53:24,Donostia,Expense,repairs,-240.24,-40612.92
buyer_5,Sara,30,ES56209524809385928875,TRX_N-00904-48597623,2023-12-30T18:33:43,Donostia,Expense,gifts,-309.54,-40922.46
buyer_5,Sara,30,ES56209524809385928875,TRX_N-00905-37702468,2024-01-01T22:18:16,Donostia,incomes,salary,1628.21,-39294.25
buyer_5,Sara,30,ES56209524809385928875,TRX_N-00906-73031719,2024-01-01T22:18:16,Donostia,incomes,salary_partner,1480.83,-37813.42
buyer_5,Sara,30,ES56209524809385928875,TRX_N-00907-22244485,2024-01-03T19:56:25,Donostia,Expense,food,-113.95,-37927.37
buyer_5,Sara,30,ES56209524809385928875,TRX_N-00908-89090644,2024-01-04T21:40:23,Donostia,expenses,mortgage,-901.62,-38828.99
buyer_5,Sara,30,ES56209524809385928875,TRX_N-00909-70313528,2024-01-04T13:22:55,Donostia,Expense,clothing,-57.72,-38886.71
buyer_5,Sara,30,ES56209524809385928875,TRX_N-00910-34148893,2024-01-06T15:15:44,Donostia,expenses,gas,-85.58,-38972.29
buyer_5,Sara,30,ES56209524809385928875,TRX_N-00911-04079322,2024-01-06T02:21:13,Zuia,Expense,food,-113.23,-39085.52
buyer_5,Sara,30,ES56209524809385928875,TRX_N-00912-41217690,2024-01-06T20:33:34,Donostia,expenses,children,-115.72,-39201.24
buyer_5,Sara,30,ES56209524809385928875,TRX_N-00913-48657359,2024-01-07T14:32:01,Donostia,expenses,water,-32.01,-39233.25
buyer_5,Sara,30,ES56209524809385928875,TRX_N-00914-12115725,2024-01-07T08:37:28,Donostia,expenses,phone,-36.53,-39269.78
buyer_5,Sara,30,ES56209524809385928875,TRX_N-00915-04423885,2024-01-08T16:21:14,Donostia,expenses,internet,-42.0,-39311.78
buyer_5,Sara,30,ES56209524809385928875,TRX_N-00916-51765344,2024-01-08T04:31:03,Donostia,expenses,electricity,-45.46,-39357.24
buyer_5,Sara,30,ES56209524809385928875,TRX_N-00917-89081383,2024-01-08T19:03:26,Donostia,Expense,healthcare,-169.15,-39526.39
buyer_5,Sara,30,ES56209524809385928875,TRX_N-00918-63547640,2024-01-08T11:57:06,Donostia,Expense,cash,-100.0,-39626.39
buyer_5,Sara,30,ES56209524809385928875,TRX_N-00919-19135162,2024-01-08T14:59:41,Donostia,Expense,travel,-1602.66,-41229.05
buyer_5,Sara,30,ES56209524809385928875,TRX_N-00920-90484638,2024-01-09T15:54:39,Donostia,Expense,leisure,-40.68,-41269.73
buyer_5,Sara,30,ES56209524809385928875,TRX_N-00921-01483922,2024-01-10T14:27:27,Donostia,Expense,cash,-100.0,-41369.73
buyer_5,Sara,30,ES56209524809385928875,TRX_N-00922-75785667,2024-01-13T12:19:00,Donostia,Expense,repairs,-80.53,-41450.26
buyer_5,Sara,30,ES56209524809385928875,TRX_N-00923-05589621,2024-01-15T13:13:36,Donostia,Expense,food,-108.84,-41559.1
buyer_5,Sara,30,ES56209524809385928875,TRX_N-00924-17194881,2024-01-16T22:06:46,Donostia,Expense,food,-84.31,-41643.41
buyer_5,Sara,30,ES56209524809385928875,TRX_N-00925-60352084,2024-01-17T22:15:02,Donostia,Expense,transport,-58.63,-41702.04
buyer_5,Sara,30,ES56209524809385928875,TRX_N-00926-20173809,2024-01-19T11:51:32,Donostia,Expense,leisure,-39.84,-41741.88
buyer_5,Sara,30,ES56209524809385928875,TRX_N-00927-79299097,2024-01-22T18:29:51,Donostia,Expense,cash,-100.0,-41841.88
buyer_5,Sara,30,ES56209524809385928875,TRX_N-00928-50004771,2024-01-23T11:46:04,Donostia,Expense,gifts,-215.85,-42057.73
buyer_5,Sara,30,ES56209524809385928875,TRX_N-00929-77141912,2024-01-24T18:09:08,Donostia,Expense,cash,-100.0,-42157.73
buyer_5,Sara,30,ES56209524809385928875,TRX_N-00930-48855760,2024-01-28T17:48:23,Donostia,Expense,travel,-1872.33,-44030.06
buyer_5,Sara,30,ES56209524809385928875,TRX_N-00931-73231820,2024-01-30T12:24:39,Oy√≥n-Oion,Expense,food,-122.61,-44152.67
buyer_5,Sara,30,ES56209524809385928875,TRX_N-00932-65126608,2024-01-31T20:34:13,Donostia,Expense,cash,-100.0,-44252.67
buyer_5,Sara,30,ES56209524809385928875,TRX_N-00933-35779420,2024-02-01T21:19:35,Donostia,incomes,salary,1628.21,-42624.46
buyer_5,Sara,30,ES56209524809385928875,TRX_N-00934-66870132,2024-02-01T21:19:35,Donostia,incomes,salary_partner,1480.83,-41143.63
buyer_5,Sara,30,ES56209524809385928875,TRX_N-00935-76397505,2024-02-01T15:50:17,Donostia,Expense,food,-76.94,-41220.57
buyer_5,Sara,30,ES56209524809385928875,TRX_N-00936-93094596,2024-02-03T21:59:49,Donostia,expenses,children,-77.47,-41298.04
buyer_5,Sara,30,ES56209524809385928875,TRX_N-00937-50880870,2024-02-04T17:07:18,Donostia,expenses,mortgage,-901.62,-42199.66
buyer_5,Sara,30,ES56209524809385928875,TRX_N-00938-99617729,2024-02-05T12:44:02,Donostia,expenses,electricity,-67.22,-42266.88
buyer_5,Sara,30,ES56209524809385928875,TRX_N-00939-96293185,2024-02-05T11:09:16,Donostia,Expense,education,-52.29,-42319.17
buyer_5,Sara,30,ES56209524809385928875,TRX_N-00940-65965265,2024-02-06T15:01:38,Donostia,expenses,water,-39.07,-42358.24
buyer_5,Sara,30,ES56209524809385928875,TRX_N-00941-66902485,2024-02-06T16:06:28,Donostia,expenses,gas,-86.58,-42444.82
buyer_5,Sara,30,ES56209524809385928875,TRX_N-00942-20648425,2024-02-07T14:30:53,Llodio,Expense,cash,-100.0,-42544.82
buyer_5,Sara,30,ES56209524809385928875,TRX_N-00943-87361155,2024-02-07T23:24:01,Iru√±a de Oca,Expense,repairs,-292.6,-42837.42
buyer_5,Sara,30,ES56209524809385928875,TRX_N-00944-50039020,2024-02-08T17:58:39,Donostia,expenses,phone,-36.8,-42874.22
buyer_5,Sara,30,ES56209524809385928875,TRX_N-00945-45747951,2024-02-08T09:40:35,Donostia,expenses,internet,-42.0,-42916.22
buyer_5,Sara,30,ES56209524809385928875,TRX_N-00946-69190955,2024-02-10T15:34:27,Donostia,expenses,children,-273.34,-43189.56
buyer_5,Sara,30,ES56209524809385928875,TRX_N-00947-80127055,2024-02-13T09:47:05,Donostia,Expense,cash,-100.0,-43289.56
buyer_5,Sara,30,ES56209524809385928875,TRX_N-00948-12228136,2024-02-13T12:40:05,Donostia,Expense,repairs,-304.99,-43594.55
buyer_5,Sara,30,ES56209524809385928875,TRX_N-00949-40671628,2024-02-14T12:38:15,Donostia,Expense,leisure,-71.55,-43666.1
buyer_5,Sara,30,ES56209524809385928875,TRX_N-00950-06209453,2024-02-15T09:25:03,Donostia,Expense,food,-116.09,-43782.19
buyer_5,Sara,30,ES56209524809385928875,TRX_N-00951-79439259,2024-02-16T07:58:00,Donostia,Expense,repairs,-73.69,-43855.88
buyer_5,Sara,30,ES56209524809385928875,TRX_N-00952-44975536,2024-02-18T21:52:36,Donostia,Expense,leisure,-76.11,-43931.99
buyer_5,Sara,30,ES56209524809385928875,TRX_N-00953-70469688,2024-02-18T12:03:07,Donostia,Expense,appliances,-281.63,-44213.62
buyer_5,Sara,30,ES56209524809385928875,TRX_N-00954-78668792,2024-02-18T16:08:39,Donostia,Expense,gifts,-605.77,-44819.39
buyer_5,Sara,30,ES56209524809385928875,TRX_N-00955-06419739,2024-02-20T16:32:04,Donostia,Expense,clothing,-136.38,-44955.77
buyer_5,Sara,30,ES56209524809385928875,TRX_N-00956-12183654,2024-02-21T09:44:20,Donostia,Expense,food,-66.18,-45021.95
buyer_5,Sara,30,ES56209524809385928875,TRX_N-00957-80194397,2024-02-22T08:41:27,Donostia,Expense,food,-85.02,-45106.97
buyer_5,Sara,30,ES56209524809385928875,TRX_N-00958-00294713,2024-02-22T12:12:46,Donostia,Expense,transport,-88.34,-45195.31
buyer_5,Sara,30,ES56209524809385928875,TRX_N-00959-88939815,2024-02-22T15:16:13,Hernani,Expense,cash,-100.0,-45295.31
buyer_5,Sara,30,ES56209524809385928875,TRX_N-00960-98384160,2024-02-24T11:24:55,Labastida,Expense,leisure,-50.67,-45345.98
buyer_5,Sara,30,ES56209524809385928875,TRX_N-00961-85345113,2024-02-24T21:38:24,Donostia,Expense,appliances,-392.5,-45738.48
buyer_5,Sara,30,ES56209524809385928875,TRX_N-00962-73020707,2024-02-25T12:28:27,Salvatierra/Agurain,Expense,cash,-100.0,-45838.48
buyer_5,Sara,30,ES56209524809385928875,TRX_N-00963-33593285,2024-02-26T10:42:37,Donostia,Expense,clothing,-94.13,-45932.61
buyer_5,Sara,30,ES56209524809385928875,TRX_N-00964-14466102,2024-02-26T12:07:04,Donostia,expenses,children,-173.42,-46106.03
buyer_5,Sara,30,ES56209524809385928875,TRX_N-00965-81435986,2024-02-27T18:17:57,Donostia,Expense,cash,-100.0,-46206.03
buyer_5,Sara,30,ES56209524809385928875,TRX_N-00966-87469617,2024-02-27T20:47:06,Donostia,expenses,children,-65.4,-46271.43
buyer_5,Sara,30,ES56209524809385928875,TRX_N-00967-45922340,2024-02-28T19:34:37,Donostia,Expense,leisure,-25.02,-46296.45
buyer_5,Sara,30,ES56209524809385928875,TRX_N-00968-66701715,2024-02-29T14:08:25,Irun,Expense,food,-60.48,-46356.93
buyer_5,Sara,30,ES56209524809385928875,TRX_N-00969-39485895,2024-02-29T09:17:04,Donostia,Expense,transport,-80.56,-46437.49
buyer_5,Sara,30,ES56209524809385928875,TRX_N-00970-18166883,2024-03-01T19:54:41,Donostia,incomes,salary,1628.21,-44809.28
buyer_5,Sara,30,ES56209524809385928875,TRX_N-00971-55316311,2024-03-01T19:54:41,Donostia,incomes,salary_partner,1480.83,-43328.45
buyer_5,Sara,30,ES56209524809385928875,TRX_N-00972-12597511,2024-03-01T13:42:43,Donostia,Expense,food,-103.39,-43431.84
buyer_5,Sara,30,ES56209524809385928875,TRX_N-00973-57394706,2024-03-01T18:32:26,Barakaldo,Expense,transport,-40.7,-43472.54
buyer_5,Sara,30,ES56209524809385928875,TRX_N-00974-76688352,2024-03-01T20:13:59,Donostia,Expense,leisure,-24.81,-43497.35
buyer_5,Sara,30,ES56209524809385928875,TRX_N-00975-87877391,2024-03-04T01:37:41,Donostia,expenses,mortgage,-901.62,-44398.97
buyer_5,Sara,30,ES56209524809385928875,TRX_N-00976-39777518,2024-03-05T13:19:15,Donostia,expenses,electricity,-45.88,-44444.85
buyer_5,Sara,30,ES56209524809385928875,TRX_N-00977-26239931,2024-03-05T16:45:06,Donostia,expenses,phone,-36.46,-44481.31
buyer_5,Sara,30,ES56209524809385928875,TRX_N-00978-64142794,2024-03-05T13:18:05,Donostia,Expense,leisure,-40.3,-44521.61
buyer_5,Sara,30,ES56209524809385928875,TRX_N-00979-63373515,2024-03-05T13:11:58,Donostia,Expense,gifts,-555.1,-45076.71
buyer_5,Sara,30,ES56209524809385928875,TRX_N-00980-71024955,2024-03-06T09:02:47,Donostia,expenses,internet,-42.0,-45118.71
buyer_5,Sara,30,ES56209524809385928875,TRX_N-00981-85680810,2024-03-06T20:39:15,Donostia,Expense,education,-69.47,-45188.18
buyer_5,Sara,30,ES56209524809385928875,TRX_N-00982-98798389,2024-03-06T17:42:06,Donostia,Expense,cash,-100.0,-45288.18
buyer_5,Sara,30,ES56209524809385928875,TRX_N-00983-48076717,2024-03-07T11:08:22,Donostia,Expense,travel,-527.36,-45815.54
buyer_5,Sara,30,ES56209524809385928875,TRX_N-00984-14437594,2024-03-08T12:37:30,Donostia,expenses,water,-20.16,-45835.7
buyer_5,Sara,30,ES56209524809385928875,TRX_N-00985-17419359,2024-03-08T13:21:50,Donostia,expenses,gas,-39.36,-45875.06
buyer_5,Sara,30,ES56209524809385928875,TRX_N-00986-71280978,2024-03-08T20:57:19,Donostia,Expense,food,-65.16,-45940.22
buyer_5,Sara,30,ES56209524809385928875,TRX_N-00987-37378122,2024-03-09T13:13:23,Arrasate,Expense,education,-52.44,-45992.66
buyer_5,Sara,30,ES56209524809385928875,TRX_N-00988-11615811,2024-03-11T13:40:13,Donostia,Expense,leisure,-68.8,-46061.46
buyer_5,Sara,30,ES56209524809385928875,TRX_N-00989-00642048,2024-03-12T12:28:11,Donostia,Expense,cash,-100.0,-46161.46
buyer_5,Sara,30,ES56209524809385928875,TRX_N-00990-21740009,2024-03-14T19:02:24,Donostia,Expense,food,-76.73,-46238.19
buyer_5,Sara,30,ES56209524809385928875,TRX_N-00991-03822179,2024-03-14T12:11:22,Donostia,Expense,gifts,-816.32,-47054.51
buyer_5,Sara,30,ES56209524809385928875,TRX_N-00992-74574046,2024-03-15T11:20:07,Llodio,Expense,clothing,-120.42,-47174.93
buyer_5,Sara,30,ES56209524809385928875,TRX_N-00993-07442433,2024-03-16T16:08:10,Pasaia,Expense,food,-112.89,-47287.82
buyer_5,Sara,30,ES56209524809385928875,TRX_N-00994-96813491,2024-03-17T23:02:28,Donostia,Expense,appliances,-378.71,-47666.53
buyer_5,Sara,30,ES56209524809385928875,TRX_N-00995-56954790,2024-03-20T19:29:33,Donostia,Expense,gifts,-643.17,-48309.7
buyer_5,Sara,30,ES56209524809385928875,TRX_N-00996-56976451,2024-03-21T17:42:25,Basauri,Expense,appliances,-230.26,-48539.96
buyer_5,Sara,30,ES56209524809385928875,TRX_N-00997-23930465,2024-03-22T04:29:38,Donostia,expenses,children,-158.94,-48698.9
buyer_5,Sara,30,ES56209524809385928875,TRX_N-00998-20760600,2024-03-23T20:54:15,Donostia,Expense,food,-65.95,-48764.85
buyer_5,Sara,30,ES56209524809385928875,TRX_N-00999-68416843,2024-03-27T11:31:48,Donostia,Expense,cash,-100.0,-48864.85
buyer_5,Sara,30,ES56209524809385928875,TRX_N-01000-46802891,2024-03-28T17:05:29,Donostia,Expense,cash,-100.0,-48964.85
buyer_5,Sara,30,ES56209524809385928875,TRX_N-01001-81419449,2024-03-29T22:17:13,Alegr√≠a-Dulantzi,Expense,clothing,-71.4,-49036.25
buyer_5,Sara,30,ES56209524809385928875,TRX_N-01002-78869198,2024-03-31T17:58:58,Donostia,Expense,transport,-89.96,-49126.21
buyer_5,Sara,30,ES56209524809385928875,TRX_N-01003-36167053,2024-03-31T10:56:29,Eibar,Expense,cash,-100.0,-49226.21
buyer_5,Sara,30,ES56209524809385928875,TRX_N-01004-82087555,2024-04-01T09:12:42,Donostia,incomes,salary,1628.21,-47598.0
buyer_5,Sara,30,ES56209524809385928875,TRX_N-01005-02294924,2024-04-01T09:12:42,Donostia,incomes,salary_partner,1480.83,-46117.17
buyer_5,Sara,30,ES56209524809385928875,TRX_N-01006-46220063,2024-04-01T09:12:42,Donostia,incomes,extra_income,273.26,-45843.91
buyer_5,Sara,30,ES56209524809385928875,TRX_N-01007-23674957,2024-04-03T12:26:49,Donostia,Expense,cash,-100.0,-45943.91
buyer_5,Sara,30,ES56209524809385928875,TRX_N-01008-42719794,2024-04-04T21:49:30,Donostia,expenses,mortgage,-901.62,-46845.53
buyer_5,Sara,30,ES56209524809385928875,TRX_N-01009-96626099,2024-04-04T21:30:55,Donostia,Expense,food,-93.25,-46938.78
buyer_5,Sara,30,ES56209524809385928875,TRX_N-01010-53380433,2024-04-05T22:10:55,Donostia,expenses,water,-22.1,-46960.88
buyer_5,Sara,30,ES56209524809385928875,TRX_N-01011-88015593,2024-04-05T13:27:28,Donostia,Expense,gifts,-669.7,-47630.58
buyer_5,Sara,30,ES56209524809385928875,TRX_N-01012-85546580,2024-04-06T19:07:32,Donostia,Expense,food,-120.4,-47750.98
buyer_5,Sara,30,ES56209524809385928875,TRX_N-01013-75833926,2024-04-06T10:09:48,Donostia,Expense,gifts,-632.71,-48383.69
buyer_5,Sara,30,ES56209524809385928875,TRX_N-01014-94408113,2024-04-07T17:09:29,Donostia,Expense,clothing,-83.59,-48467.28
buyer_5,Sara,30,ES56209524809385928875,TRX_N-01015-51794945,2024-04-07T04:43:31,Donostia,Expense,cash,-100.0,-48567.28
buyer_5,Sara,30,ES56209524809385928875,TRX_N-01016-23140671,2024-04-08T17:42:56,Donostia,expenses,electricity,-35.99,-48603.27
buyer_5,Sara,30,ES56209524809385928875,TRX_N-01017-01200667,2024-04-08T09:00:01,Donostia,expenses,gas,-84.11,-48687.38
buyer_5,Sara,30,ES56209524809385928875,TRX_N-01018-85214115,2024-04-08T14:19:19,Donostia,expenses,internet,-42.0,-48729.38
buyer_5,Sara,30,ES56209524809385928875,TRX_N-01019-98525179,2024-04-08T12:54:19,Donostia,expenses,phone,-39.52,-48768.9
buyer_5,Sara,30,ES56209524809385928875,TRX_N-01020-26499856,2024-04-09T18:24:15,Donostia,Expense,food,-112.35,-48881.25
buyer_5,Sara,30,ES56209524809385928875,TRX_N-01021-46302922,2024-04-09T18:18:12,Donostia,Expense,transport,-41.48,-48922.73
buyer_5,Sara,30,ES56209524809385928875,TRX_N-01022-27611759,2024-04-09T15:39:02,Donostia,Expense,healthcare,-53.77,-48976.5
buyer_5,Sara,30,ES56209524809385928875,TRX_N-01023-85675361,2024-04-09T08:22:27,Donostia,Expense,cash,-100.0,-49076.5
buyer_5,Sara,30,ES56209524809385928875,TRX_N-01024-74938855,2024-04-09T04:56:16,Donostia,Expense,appliances,-368.08,-49444.58
buyer_5,Sara,30,ES56209524809385928875,TRX_N-01025-70927707,2024-04-12T08:23:20,Andoain,Expense,repairs,-281.64,-49726.22
buyer_5,Sara,30,ES56209524809385928875,TRX_N-01026-90346046,2024-04-14T20:01:25,Santurtzi,Expense,education,-73.27,-49799.49
buyer_5,Sara,30,ES56209524809385928875,TRX_N-01027-58213751,2024-04-19T15:59:50,Donostia,Expense,leisure,-38.56,-49838.05
buyer_5,Sara,30,ES56209524809385928875,TRX_N-01028-68964734,2024-04-19T10:10:54,Donostia,Expense,clothing,-117.71,-49955.76
buyer_5,Sara,30,ES56209524809385928875,TRX_N-01029-30279032,2024-04-19T20:44:03,Donostia,Expense,cash,-100.0,-50055.76
buyer_5,Sara,30,ES56209524809385928875,TRX_N-01030-16958545,2024-04-21T17:29:08,Donostia,Expense,repairs,-200.86,-50256.62
buyer_5,Sara,30,ES56209524809385928875,TRX_N-01031-55663652,2024-04-22T17:41:41,Donostia,Expense,clothing,-55.12,-50311.74
buyer_5,Sara,30,ES56209524809385928875,TRX_N-01032-20975386,2024-04-23T20:00:19,Donostia,Expense,transport,-48.88,-50360.62
buyer_5,Sara,30,ES56209524809385928875,TRX_N-01033-23160805,2024-04-23T08:33:42,Donostia,Expense,cash,-100.0,-50460.62
buyer_5,Sara,30,ES56209524809385928875,TRX_N-01034-40814671,2024-04-25T16:14:31,Pasaia,Expense,cash,-100.0,-50560.62
buyer_5,Sara,30,ES56209524809385928875,TRX_N-01035-29240217,2024-04-26T13:40:05,Donostia,Expense,education,-52.98,-50613.6
buyer_5,Sara,30,ES56209524809385928875,TRX_N-01036-91666586,2024-04-28T21:00:45,Donostia,Expense,food,-84.65,-50698.25
buyer_5,Sara,30,ES56209524809385928875,TRX_N-01037-74351944,2024-04-28T17:17:12,Donostia,expenses,children,-178.94,-50877.19
buyer_5,Sara,30,ES56209524809385928875,TRX_N-01038-08538556,2024-04-29T11:44:05,Donostia,Expense,clothing,-81.34,-50958.53
buyer_5,Sara,30,ES56209524809385928875,TRX_N-01039-23499865,2024-04-29T17:28:03,Donostia,Expense,healthcare,-45.01,-51003.54
buyer_5,Sara,30,ES56209524809385928875,TRX_N-01040-53993315,2024-04-30T14:06:52,Donostia,Expense,food,-82.66,-51086.2
buyer_5,Sara,30,ES56209524809385928875,TRX_N-01041-67534803,2024-04-30T10:22:06,Donostia,Expense,leisure,-70.51,-51156.71
buyer_5,Sara,30,ES56209524809385928875,TRX_N-01042-34682004,2024-05-01T12:30:50,Donostia,incomes,salary,1628.21,-49528.5
buyer_5,Sara,30,ES56209524809385928875,TRX_N-01043-76184119,2024-05-01T12:30:50,Donostia,incomes,salary_partner,1480.83,-48047.67
buyer_5,Sara,30,ES56209524809385928875,TRX_N-01044-26241680,2024-05-01T23:14:45,Donostia,expenses,children,-194.85,-48242.52
buyer_5,Sara,30,ES56209524809385928875,TRX_N-01045-63275736,2024-05-02T14:18:06,Donostia,Expense,food,-109.34,-48351.86
buyer_5,Sara,30,ES56209524809385928875,TRX_N-01046-39724411,2024-05-02T12:37:28,Donostia,Expense,transport,-72.17,-48424.03
buyer_5,Sara,30,ES56209524809385928875,TRX_N-01047-82271880,2024-05-03T16:30:31,Alegr√≠a-Dulantzi,Expense,food,-65.8,-48489.83
buyer_5,Sara,30,ES56209524809385928875,TRX_N-01048-48539640,2024-05-03T20:35:59,Donostia,Expense,cash,-100.0,-48589.83
buyer_5,Sara,30,ES56209524809385928875,TRX_N-01049-83035633,2024-05-04T04:10:31,Donostia,expenses,mortgage,-901.62,-49491.45
buyer_5,Sara,30,ES56209524809385928875,TRX_N-01050-70466313,2024-05-04T09:06:38,Donostia,Expense,leisure,-44.82,-49536.27
buyer_5,Sara,30,ES56209524809385928875,TRX_N-01051-19316870,2024-05-04T22:07:32,Donostia,Expense,cash,-100.0,-49636.27
buyer_5,Sara,30,ES56209524809385928875,TRX_N-01052-72378520,2024-05-05T01:05:32,Donostia,Expense,leisure,-21.22,-49657.49
buyer_5,Sara,30,ES56209524809385928875,TRX_N-01053-86370323,2024-05-05T14:24:18,Iru√±a de Oca,Expense,travel,-1397.73,-51055.22
buyer_5,Sara,30,ES56209524809385928875,TRX_N-01054-49753228,2024-05-05T09:43:54,Donostia,Expense,appliances,-388.46,-51443.68
buyer_5,Sara,30,ES56209524809385928875,TRX_N-01055-65230150,2024-05-05T15:55:35,Donostia,Expense,repairs,-29.41,-51473.09
buyer_5,Sara,30,ES56209524809385928875,TRX_N-01056-01228859,2024-05-06T08:02:51,Donostia,expenses,water,-35.44,-51508.53
buyer_5,Sara,30,ES56209524809385928875,TRX_N-01057-20496345,2024-05-06T16:23:06,Donostia,Expense,repairs,-79.81,-51588.34
buyer_5,Sara,30,ES56209524809385928875,TRX_N-01058-94563912,2024-05-07T20:54:36,Donostia,expenses,phone,-31.96,-51620.3
buyer_5,Sara,30,ES56209524809385928875,TRX_N-01059-94342968,2024-05-08T23:14:05,Donostia,expenses,electricity,-79.16,-51699.46
buyer_5,Sara,30,ES56209524809385928875,TRX_N-01060-97945641,2024-05-08T17:40:42,Donostia,expenses,gas,-109.59,-51809.05
buyer_5,Sara,30,ES56209524809385928875,TRX_N-01061-24857983,2024-05-08T00:43:16,Donostia,expenses,internet,-42.0,-51851.05
buyer_5,Sara,30,ES56209524809385928875,TRX_N-01062-27879923,2024-05-08T22:41:22,Donostia,Expense,food,-81.29,-51932.34
buyer_5,Sara,30,ES56209524809385928875,TRX_N-01063-69254154,2024-05-08T11:46:46,Donostia,Expense,gifts,-268.46,-52200.8
buyer_5,Sara,30,ES56209524809385928875,TRX_N-01064-18080987,2024-05-09T17:10:27,Donostia,Expense,food,-64.68,-52265.48
buyer_5,Sara,30,ES56209524809385928875,TRX_N-01065-59701372,2024-05-09T11:31:49,Donostia,Expense,transport,-78.29,-52343.77
buyer_5,Sara,30,ES56209524809385928875,TRX_N-01066-63263776,2024-05-11T10:42:29,Vitoria-Gasteiz,Expense,clothing,-123.18,-52466.95
buyer_5,Sara,30,ES56209524809385928875,TRX_N-01067-50044722,2024-05-11T01:37:14,Salvatierra/Agurain,Expense,cash,-100.0,-52566.95
buyer_5,Sara,30,ES56209524809385928875,TRX_N-01068-66176976,2024-05-14T18:58:05,Donostia,Expense,leisure,-69.81,-52636.76
buyer_5,Sara,30,ES56209524809385928875,TRX_N-01069-09254290,2024-05-16T11:46:01,Donostia,Expense,gifts,-75.61,-52712.37
buyer_5,Sara,30,ES56209524809385928875,TRX_N-01070-75001240,2024-05-17T17:25:09,Donostia,Expense,cash,-100.0,-52812.37
buyer_5,Sara,30,ES56209524809385928875,TRX_N-01071-07269494,2024-05-18T10:57:01,Donostia,Expense,appliances,-335.35,-53147.72
buyer_5,Sara,30,ES56209524809385928875,TRX_N-01072-42815037,2024-05-19T08:17:36,Pasaia,Expense,leisure,-71.93,-53219.65
buyer_5,Sara,30,ES56209524809385928875,TRX_N-01073-03543134,2024-05-20T13:44:29,Llodio,Expense,leisure,-26.49,-53246.14
buyer_5,Sara,30,ES56209524809385928875,TRX_N-01074-99264251,2024-05-20T22:47:19,Donostia,Expense,cash,-100.0,-53346.14
buyer_5,Sara,30,ES56209524809385928875,TRX_N-01075-14674502,2024-05-24T19:27:11,Donostia,Expense,leisure,-64.25,-53410.39
buyer_5,Sara,30,ES56209524809385928875,TRX_N-01076-71956752,2024-05-25T12:11:02,Donostia,Expense,travel,-434.73,-53845.12
buyer_5,Sara,30,ES56209524809385928875,TRX_N-01077-80357275,2024-05-26T13:25:54,Donostia,Expense,leisure,-70.44,-53915.56
buyer_5,Sara,30,ES56209524809385928875,TRX_N-01078-42678082,2024-05-26T06:46:47,Donostia,Expense,cash,-100.0,-54015.56
buyer_5,Sara,30,ES56209524809385928875,TRX_N-01079-57772796,2024-05-27T17:33:33,Donostia,Expense,food,-90.14,-54105.7
buyer_5,Sara,30,ES56209524809385928875,TRX_N-01080-68242790,2024-05-28T20:43:56,Donostia,Expense,leisure,-62.31,-54168.01
buyer_5,Sara,30,ES56209524809385928875,TRX_N-01081-55038381,2024-05-29T15:44:05,Eibar,Expense,education,-49.49,-54217.5
buyer_5,Sara,30,ES56209524809385928875,TRX_N-01082-69827526,2024-06-01T17:50:48,Donostia,incomes,salary,1628.21,-52589.29
buyer_5,Sara,30,ES56209524809385928875,TRX_N-01083-90918214,2024-06-01T17:50:48,Donostia,incomes,salary_partner,1480.83,-51108.46
buyer_5,Sara,30,ES56209524809385928875,TRX_N-01084-69427955,2024-06-01T17:50:48,Donostia,incomes,salary_bonus,1175.89,-49932.57
buyer_5,Sara,30,ES56209524809385928875,TRX_N-01085-24407724,2024-06-01T17:50:48,Donostia,incomes,salary_partner_bonus,1091.16,-48841.41
buyer_5,Sara,30,ES56209524809385928875,TRX_N-01086-82645081,2024-06-02T19:31:07,Alegr√≠a-Dulantzi,Expense,repairs,-77.36,-48918.77
buyer_5,Sara,30,ES56209524809385928875,TRX_N-01087-72112689,2024-06-03T09:00:49,Salvatierra/Agurain,Expense,food,-66.88,-48985.65
buyer_5,Sara,30,ES56209524809385928875,TRX_N-01088-98547585,2024-06-04T12:56:13,Donostia,expenses,mortgage,-901.62,-49887.27
buyer_5,Sara,30,ES56209524809385928875,TRX_N-01089-74873533,2024-06-04T17:57:27,Donostia,Expense,transport,-74.71,-49961.98
buyer_5,Sara,30,ES56209524809385928875,TRX_N-01090-83120473,2024-06-04T23:52:29,Donostia,Expense,leisure,-31.72,-49993.7
buyer_5,Sara,30,ES56209524809385928875,TRX_N-01091-72924152,2024-06-05T17:41:35,Donostia,expenses,electricity,-20.39,-50014.09
buyer_5,Sara,30,ES56209524809385928875,TRX_N-01092-98598508,2024-06-05T08:09:32,Donostia,expenses,gas,-40.25,-50054.34
buyer_5,Sara,30,ES56209524809385928875,TRX_N-01093-84568125,2024-06-06T19:10:14,Donostia,Expense,gifts,-659.61,-50713.95
buyer_5,Sara,30,ES56209524809385928875,TRX_N-01094-08257073,2024-06-07T19:15:20,Donostia,Expense,cash,-100.0,-50813.95
buyer_5,Sara,30,ES56209524809385928875,TRX_N-01095-64721706,2024-06-07T15:12:16,Galdakao,Expense,gifts,-562.21,-51376.16
buyer_5,Sara,30,ES56209524809385928875,TRX_N-01096-94275994,2024-06-08T16:28:36,Donostia,expenses,water,-34.61,-51410.77
buyer_5,Sara,30,ES56209524809385928875,TRX_N-01097-34601325,2024-06-08T16:50:47,Donostia,expenses,internet,-42.0,-51452.77
buyer_5,Sara,30,ES56209524809385928875,TRX_N-01098-59192601,2024-06-08T13:37:01,Donostia,expenses,phone,-32.62,-51485.39
buyer_5,Sara,30,ES56209524809385928875,TRX_N-01099-71181440,2024-06-10T22:21:32,Donostia,Expense,education,-43.23,-51528.62
buyer_5,Sara,30,ES56209524809385928875,TRX_N-01100-92041605,2024-06-11T21:35:13,Donostia,Expense,clothing,-88.71,-51617.33
buyer_5,Sara,30,ES56209524809385928875,TRX_N-01101-49366328,2024-06-12T20:25:23,Donostia,Expense,healthcare,-114.59,-51731.92
buyer_5,Sara,30,ES56209524809385928875,TRX_N-01102-97335388,2024-06-13T12:23:08,Donostia,Expense,repairs,-169.0,-51900.92
buyer_5,Sara,30,ES56209524809385928875,TRX_N-01103-81660767,2024-06-14T19:07:10,Donostia,Expense,transport,-86.2,-51987.12
buyer_5,Sara,30,ES56209524809385928875,TRX_N-01104-87803251,2024-06-14T14:21:36,Donostia,Expense,clothing,-83.25,-52070.37
buyer_5,Sara,30,ES56209524809385928875,TRX_N-01105-09979348,2024-06-14T11:22:40,Donostia,Expense,gifts,-210.37,-52280.74
buyer_5,Sara,30,ES56209524809385928875,TRX_N-01106-95920118,2024-06-17T22:20:06,Donostia,Expense,cash,-100.0,-52380.74
buyer_5,Sara,30,ES56209524809385928875,TRX_N-01107-66688727,2024-06-18T11:17:46,Arrasate,Expense,transport,-81.92,-52462.66
buyer_5,Sara,30,ES56209524809385928875,TRX_N-01108-15131879,2024-06-18T21:22:45,Barakaldo,Expense,repairs,-207.26,-52669.92
buyer_5,Sara,30,ES56209524809385928875,TRX_N-01109-05365488,2024-06-19T15:12:09,Donostia,Expense,clothing,-49.91,-52719.83
buyer_5,Sara,30,ES56209524809385928875,TRX_N-01110-69932860,2024-06-20T20:34:12,Barakaldo,Expense,transport,-75.3,-52795.13
buyer_5,Sara,30,ES56209524809385928875,TRX_N-01111-96264577,2024-06-21T19:59:39,Donostia,Expense,leisure,-40.77,-52835.9
buyer_5,Sara,30,ES56209524809385928875,TRX_N-01112-41465935,2024-06-22T18:31:40,Mungia,Expense,cash,-100.0,-52935.9
buyer_5,Sara,30,ES56209524809385928875,TRX_N-01113-93314269,2024-06-24T14:41:24,Donostia,Expense,gifts,-396.67,-53332.57
buyer_5,Sara,30,ES56209524809385928875,TRX_N-01114-67079967,2024-06-25T16:46:17,Donostia,Expense,transport,-41.88,-53374.45
buyer_5,Sara,30,ES56209524809385928875,TRX_N-01115-88905466,2024-06-26T19:47:56,Donostia,Expense,food,-68.24,-53442.69
buyer_5,Sara,30,ES56209524809385928875,TRX_N-01116-15996744,2024-06-26T19:46:59,Donostia,Expense,repairs,-170.93,-53613.62
buyer_5,Sara,30,ES56209524809385928875,TRX_N-01117-46302211,2024-06-27T10:07:46,Donostia,Expense,cash,-100.0,-53713.62
buyer_5,Sara,30,ES56209524809385928875,TRX_N-01118-21050359,2024-06-30T10:16:46,Donostia,Expense,food,-111.66,-53825.28
buyer_5,Sara,30,ES56209524809385928875,TRX_N-01119-87910249,2024-06-30T15:50:45,Donostia,Expense,transport,-70.28,-53895.56
buyer_5,Sara,30,ES56209524809385928875,TRX_N-01120-27148655,2024-07-01T11:04:24,Donostia,incomes,salary,1628.21,-52267.35
buyer_5,Sara,30,ES56209524809385928875,TRX_N-01121-45216808,2024-07-01T11:04:24,Donostia,incomes,salary_partner,1480.83,-50786.52
buyer_5,Sara,30,ES56209524809385928875,TRX_N-01122-61227926,2024-07-01T14:55:02,Donostia,Expense,cash,-100.0,-50886.52
buyer_5,Sara,30,ES56209524809385928875,TRX_N-01123-00640396,2024-07-04T19:08:24,Donostia,expenses,mortgage,-901.62,-51788.14
buyer_5,Sara,30,ES56209524809385928875,TRX_N-01124-55444866,2024-07-04T11:43:18,Irun,Expense,cash,-100.0,-51888.14
buyer_5,Sara,30,ES56209524809385928875,TRX_N-01125-93967033,2024-07-05T11:06:22,Donostia,expenses,phone,-37.5,-51925.64
buyer_5,Sara,30,ES56209524809385928875,TRX_N-01126-29326338,2024-07-06T13:46:39,Eibar,Expense,cash,-100.0,-52025.64
buyer_5,Sara,30,ES56209524809385928875,TRX_N-01127-42557859,2024-07-07T19:04:49,Donostia,expenses,water,-23.58,-52049.22
buyer_5,Sara,30,ES56209524809385928875,TRX_N-01128-38457006,2024-07-07T10:04:44,Donostia,expenses,internet,-42.0,-52091.22
buyer_5,Sara,30,ES56209524809385928875,TRX_N-01129-29034777,2024-07-07T11:09:42,Donostia,Expense,clothing,-113.61,-52204.83
buyer_5,Sara,30,ES56209524809385928875,TRX_N-01130-59294421,2024-07-07T20:28:29,Donostia,Expense,appliances,-232.56,-52437.39
buyer_5,Sara,30,ES56209524809385928875,TRX_N-01131-65095433,2024-07-08T18:22:15,Donostia,expenses,gas,-42.43,-52479.82
buyer_5,Sara,30,ES56209524809385928875,TRX_N-01132-55323530,2024-07-08T00:06:30,Donostia,expenses,electricity,-63.36,-52543.18
buyer_5,Sara,30,ES56209524809385928875,TRX_N-01133-68981409,2024-07-08T14:25:13,Durango,Expense,food,-74.94,-52618.12
buyer_5,Sara,30,ES56209524809385928875,TRX_N-01134-97187858,2024-07-13T15:21:10,Donostia,Expense,food,-89.54,-52707.66
buyer_5,Sara,30,ES56209524809385928875,TRX_N-01135-21530620,2024-07-14T17:49:40,Donostia,Expense,transport,-66.18,-52773.84
buyer_5,Sara,30,ES56209524809385928875,TRX_N-01136-72085051,2024-07-14T12:06:09,Donostia,Expense,cash,-100.0,-52873.84
buyer_5,Sara,30,ES56209524809385928875,TRX_N-01137-36014385,2024-07-15T13:34:19,Portugalete,Expense,cash,-100.0,-52973.84
buyer_5,Sara,30,ES56209524809385928875,TRX_N-01138-43164169,2024-07-16T16:02:44,Donostia,Expense,appliances,-364.21,-53338.05
buyer_5,Sara,30,ES56209524809385928875,TRX_N-01139-55751631,2024-07-16T09:18:07,Donostia,expenses,children,-276.54,-53614.59
buyer_5,Sara,30,ES56209524809385928875,TRX_N-01140-45656263,2024-07-18T22:18:03,Arrasate,Expense,gifts,-391.5,-54006.09
buyer_5,Sara,30,ES56209524809385928875,TRX_N-01141-03843422,2024-07-20T14:44:56,Donostia,Expense,food,-90.93,-54097.02
buyer_5,Sara,30,ES56209524809385928875,TRX_N-01142-39832530,2024-07-22T15:54:43,Hernani,Expense,cash,-100.0,-54197.02
buyer_5,Sara,30,ES56209524809385928875,TRX_N-01143-26536667,2024-07-23T12:53:04,Donostia,Expense,cash,-100.0,-54297.02
buyer_5,Sara,30,ES56209524809385928875,TRX_N-01144-27778364,2024-07-26T19:07:02,Donostia,Expense,education,-56.32,-54353.34
buyer_5,Sara,30,ES56209524809385928875,TRX_N-01145-63720159,2024-07-27T12:23:51,Donostia,Expense,repairs,-87.53,-54440.87
buyer_5,Sara,30,ES56209524809385928875,TRX_N-01146-41074340,2024-07-27T13:47:51,Donostia,Expense,gifts,-768.56,-55209.43
buyer_5,Sara,30,ES56209524809385928875,TRX_N-01147-95251626,2024-07-28T10:43:49,Sopela,Expense,cash,-100.0,-55309.43
buyer_5,Sara,30,ES56209524809385928875,TRX_N-01148-98554368,2024-07-30T18:03:39,Donostia,Expense,education,-71.85,-55381.28
buyer_5,Sara,30,ES56209524809385928875,TRX_N-01149-90442658,2024-07-31T19:51:51,Donostia,Expense,cash,-100.0,-55481.28
buyer_5,Sara,30,ES56209524809385928875,TRX_N-01150-98643115,2024-07-31T15:18:25,Donostia,expenses,children,-116.69,-55597.97
buyer_5,Sara,30,ES56209524809385928875,TRX_N-01151-75417867,2024-08-01T10:01:21,Donostia,incomes,salary,1628.21,-53969.76
buyer_5,Sara,30,ES56209524809385928875,TRX_N-01152-20531797,2024-08-01T10:01:21,Donostia,incomes,salary_partner,1480.83,-52488.93
buyer_5,Sara,30,ES56209524809385928875,TRX_N-01153-11410823,2024-08-01T10:01:21,Donostia,incomes,extra_income,273.26,-52215.67
buyer_5,Sara,30,ES56209524809385928875,TRX_N-01154-62865194,2024-08-01T14:32:25,Donostia,Expense,gifts,-393.45,-52609.12
buyer_5,Sara,30,ES56209524809385928875,TRX_N-01155-09658748,2024-08-01T10:40:48,Donostia,expenses,children,-59.65,-52668.77
buyer_5,Sara,30,ES56209524809385928875,TRX_N-01156-25698385,2024-08-02T16:08:49,Donostia,Expense,leisure,-44.61,-52713.38
buyer_5,Sara,30,ES56209524809385928875,TRX_N-01157-09070837,2024-08-02T12:52:27,Vitoria-Gasteiz,Expense,healthcare,-62.28,-52775.66
buyer_5,Sara,30,ES56209524809385928875,TRX_N-01158-86512603,2024-08-02T14:40:56,Donostia,Expense,cash,-100.0,-52875.66
buyer_5,Sara,30,ES56209524809385928875,TRX_N-01159-20198075,2024-08-04T22:43:36,Donostia,expenses,mortgage,-901.62,-53777.28
buyer_5,Sara,30,ES56209524809385928875,TRX_N-01160-68001358,2024-08-04T10:31:13,Donostia,Expense,food,-112.43,-53889.71
buyer_5,Sara,30,ES56209524809385928875,TRX_N-01161-00028895,2024-08-05T09:10:21,Donostia,expenses,water,-31.97,-53921.68
buyer_5,Sara,30,ES56209524809385928875,TRX_N-01162-35061204,2024-08-05T14:28:06,Donostia,expenses,phone,-39.28,-53960.96
buyer_5,Sara,30,ES56209524809385928875,TRX_N-01163-11216582,2024-08-05T12:23:51,Donostia,Expense,repairs,-308.67,-54269.63
buyer_5,Sara,30,ES56209524809385928875,TRX_N-01164-68363160,2024-08-06T16:39:30,Donostia,Expense,cash,-100.0,-54369.63
buyer_5,Sara,30,ES56209524809385928875,TRX_N-01165-90012869,2024-08-07T19:36:10,Donostia,expenses,gas,-82.23,-54451.86
buyer_5,Sara,30,ES56209524809385928875,TRX_N-01166-38242934,2024-08-07T13:53:39,Donostia,Expense,food,-94.36,-54546.22
buyer_5,Sara,30,ES56209524809385928875,TRX_N-01167-51210906,2024-08-07T20:21:34,Donostia,Expense,leisure,-30.21,-54576.43
buyer_5,Sara,30,ES56209524809385928875,TRX_N-01168-28782780,2024-08-07T17:34:52,Sopela,Expense,education,-53.19,-54629.62
buyer_5,Sara,30,ES56209524809385928875,TRX_N-01169-05365646,2024-08-08T11:27:11,Donostia,expenses,electricity,-62.35,-54691.97
buyer_5,Sara,30,ES56209524809385928875,TRX_N-01170-68684628,2024-08-08T18:20:16,Donostia,expenses,internet,-42.0,-54733.97
buyer_5,Sara,30,ES56209524809385928875,TRX_N-01171-99867859,2024-08-08T17:48:45,Donostia,Expense,education,-53.05,-54787.02
buyer_5,Sara,30,ES56209524809385928875,TRX_N-01172-10064400,2024-08-09T16:04:43,Labastida,Expense,food,-80.37,-54867.39
buyer_5,Sara,30,ES56209524809385928875,TRX_N-01173-72748895,2024-08-09T02:36:49,Donostia,Expense,transport,-40.23,-54907.62
buyer_5,Sara,30,ES56209524809385928875,TRX_N-01174-40300503,2024-08-10T04:07:33,Donostia,Expense,cash,-100.0,-55007.62
buyer_5,Sara,30,ES56209524809385928875,TRX_N-01175-73937051,2024-08-10T13:03:22,Donostia,Expense,travel,-1165.58,-56173.2
buyer_5,Sara,30,ES56209524809385928875,TRX_N-01176-25817848,2024-08-10T10:36:19,Zuia,Expense,appliances,-364.07,-56537.27
buyer_5,Sara,30,ES56209524809385928875,TRX_N-01177-48643720,2024-08-11T18:23:38,Mungia,Expense,transport,-88.07,-56625.34
buyer_5,Sara,30,ES56209524809385928875,TRX_N-01178-01894425,2024-08-11T21:20:41,Donostia,Expense,education,-52.41,-56677.75
buyer_5,Sara,30,ES56209524809385928875,TRX_N-01179-92859262,2024-08-11T01:09:30,Donostia,Expense,cash,-100.0,-56777.75
buyer_5,Sara,30,ES56209524809385928875,TRX_N-01180-09300067,2024-08-12T20:51:39,Sopela,Expense,repairs,-33.02,-56810.77
buyer_5,Sara,30,ES56209524809385928875,TRX_N-01181-64427977,2024-08-13T15:17:32,Donostia,Expense,food,-102.89,-56913.66
buyer_5,Sara,30,ES56209524809385928875,TRX_N-01182-83069991,2024-08-14T19:48:32,Donostia,Expense,cash,-100.0,-57013.66
buyer_5,Sara,30,ES56209524809385928875,TRX_N-01183-78344028,2024-08-17T09:37:03,Donostia,Expense,food,-97.18,-57110.84
buyer_5,Sara,30,ES56209524809385928875,TRX_N-01184-56053500,2024-08-18T09:06:48,Donostia,Expense,leisure,-77.14,-57187.98
buyer_5,Sara,30,ES56209524809385928875,TRX_N-01185-67488636,2024-08-22T20:39:44,Donostia,Expense,transport,-71.08,-57259.06
buyer_5,Sara,30,ES56209524809385928875,TRX_N-01186-07513408,2024-08-23T16:30:21,Donostia,Expense,gifts,-546.04,-57805.1
buyer_5,Sara,30,ES56209524809385928875,TRX_N-01187-13726467,2024-08-24T20:21:02,Donostia,Expense,food,-115.12,-57920.22
buyer_5,Sara,30,ES56209524809385928875,TRX_N-01188-08312405,2024-08-24T11:13:31,Donostia,Expense,cash,-100.0,-58020.22
buyer_5,Sara,30,ES56209524809385928875,TRX_N-01189-35810728,2024-08-25T16:05:25,Donostia,Expense,repairs,-175.88,-58196.1
buyer_5,Sara,30,ES56209524809385928875,TRX_N-01190-27633982,2024-08-27T09:56:52,Donostia,Expense,food,-93.61,-58289.71
buyer_5,Sara,30,ES56209524809385928875,TRX_N-01191-87353081,2024-08-28T13:17:45,Donostia,Expense,food,-119.8,-58409.51
buyer_5,Sara,30,ES56209524809385928875,TRX_N-01192-32784895,2024-08-28T09:18:42,Donostia,Expense,cash,-100.0,-58509.51
buyer_5,Sara,30,ES56209524809385928875,TRX_N-01193-77700508,2024-08-29T15:31:17,Donostia,Expense,travel,-348.97,-58858.48
buyer_5,Sara,30,ES56209524809385928875,TRX_N-01194-70761202,2024-08-30T03:34:33,Donostia,Expense,transport,-62.41,-58920.89
buyer_5,Sara,30,ES56209524809385928875,TRX_N-01195-05405097,2024-08-30T09:19:56,Donostia,Expense,appliances,-306.6,-59227.49
buyer_5,Sara,30,ES56209524809385928875,TRX_N-01196-05191855,2024-08-31T00:16:50,Donostia,Expense,travel,-736.18,-59963.67
buyer_5,Sara,30,ES56209524809385928875,TRX_N-01197-75832531,2024-09-01T10:39:10,Donostia,incomes,salary,1628.21,-58335.46
buyer_5,Sara,30,ES56209524809385928875,TRX_N-01198-24483384,2024-09-01T10:39:10,Donostia,incomes,salary_partner,1480.83,-56854.63
buyer_5,Sara,30,ES56209524809385928875,TRX_N-01199-28173358,2024-09-01T15:05:48,Donostia,Expense,leisure,-79.65,-56934.28
buyer_5,Sara,30,ES56209524809385928875,TRX_N-01200-62364642,2024-09-01T12:45:04,Donostia,Expense,appliances,-119.46,-57053.74
buyer_5,Sara,30,ES56209524809385928875,TRX_N-01201-86675661,2024-09-02T09:48:07,Donostia,Expense,cash,-100.0,-57153.74
buyer_5,Sara,30,ES56209524809385928875,TRX_N-01202-28118669,2024-09-04T04:16:15,Donostia,expenses,mortgage,-901.62,-58055.36
buyer_5,Sara,30,ES56209524809385928875,TRX_N-01203-04608116,2024-09-05T22:49:31,Donostia,expenses,gas,-67.36,-58122.72
buyer_5,Sara,30,ES56209524809385928875,TRX_N-01204-18067258,2024-09-05T07:10:18,Donostia,Expense,leisure,-21.45,-58144.17
buyer_5,Sara,30,ES56209524809385928875,TRX_N-01205-45361454,2024-09-05T21:57:55,Donostia,Expense,appliances,-110.03,-58254.2
buyer_5,Sara,30,ES56209524809385928875,TRX_N-01206-26679894,2024-09-06T08:19:10,Donostia,expenses,phone,-43.77,-58297.97
buyer_5,Sara,30,ES56209524809385928875,TRX_N-01207-84797479,2024-09-06T07:07:39,Donostia,Expense,food,-92.44,-58390.41
buyer_5,Sara,30,ES56209524809385928875,TRX_N-01208-07634806,2024-09-06T21:58:32,Donostia,Expense,cash,-100.0,-58490.41
buyer_5,Sara,30,ES56209524809385928875,TRX_N-01209-00553520,2024-09-07T08:58:06,Donostia,Expense,leisure,-51.14,-58541.55
buyer_5,Sara,30,ES56209524809385928875,TRX_N-01210-16519201,2024-09-08T08:36:00,Donostia,expenses,internet,-42.0,-58583.55
buyer_5,Sara,30,ES56209524809385928875,TRX_N-01211-71985230,2024-09-08T17:53:07,Donostia,expenses,water,-22.58,-58606.13
buyer_5,Sara,30,ES56209524809385928875,TRX_N-01212-59199929,2024-09-08T19:13:30,Donostia,expenses,electricity,-23.08,-58629.21
buyer_5,Sara,30,ES56209524809385928875,TRX_N-01213-60330754,2024-09-08T10:15:09,Donostia,Expense,food,-120.52,-58749.73
buyer_5,Sara,30,ES56209524809385928875,TRX_N-01214-68885756,2024-09-10T18:59:32,Donostia,Expense,leisure,-84.92,-58834.65
buyer_5,Sara,30,ES56209524809385928875,TRX_N-01215-30719721,2024-09-10T20:38:34,Donostia,Expense,appliances,-94.58,-58929.23
buyer_5,Sara,30,ES56209524809385928875,TRX_N-01216-35895834,2024-09-11T08:39:04,Labastida,Expense,leisure,-30.08,-58959.31
buyer_5,Sara,30,ES56209524809385928875,TRX_N-01217-73361726,2024-09-12T17:00:04,Donostia,Expense,cash,-100.0,-59059.31
buyer_5,Sara,30,ES56209524809385928875,TRX_N-01218-82674786,2024-09-13T15:56:41,Bilbao,Expense,cash,-100.0,-59159.31
buyer_5,Sara,30,ES56209524809385928875,TRX_N-01219-59618627,2024-09-16T22:05:27,Donostia,Expense,education,-58.45,-59217.76
buyer_5,Sara,30,ES56209524809385928875,TRX_N-01220-87009629,2024-09-18T09:21:57,Donostia,Expense,transport,-62.87,-59280.63
buyer_5,Sara,30,ES56209524809385928875,TRX_N-01221-97763422,2024-09-18T12:19:51,Donostia,Expense,repairs,-131.19,-59411.82
buyer_5,Sara,30,ES56209524809385928875,TRX_N-01222-12953981,2024-09-19T09:15:48,Donostia,Expense,transport,-73.64,-59485.46
buyer_5,Sara,30,ES56209524809385928875,TRX_N-01223-32521770,2024-09-21T08:52:54,Donostia,Expense,education,-66.87,-59552.33
buyer_5,Sara,30,ES56209524809385928875,TRX_N-01224-93937427,2024-09-23T15:58:17,Donostia,Expense,food,-93.21,-59645.54
buyer_5,Sara,30,ES56209524809385928875,TRX_N-01225-94673359,2024-09-26T13:05:15,Donostia,Expense,cash,-100.0,-59745.54
buyer_5,Sara,30,ES56209524809385928875,TRX_N-01226-30575320,2024-09-26T19:29:16,Donostia,expenses,children,-51.37,-59796.91
buyer_5,Sara,30,ES56209524809385928875,TRX_N-01227-84657204,2024-10-01T15:21:40,Donostia,incomes,salary,1628.21,-58168.7
buyer_5,Sara,30,ES56209524809385928875,TRX_N-01228-91494788,2024-10-01T15:21:40,Donostia,incomes,salary_partner,1480.83,-56687.87
buyer_5,Sara,30,ES56209524809385928875,TRX_N-01229-93752062,2024-10-01T20:41:23,Arrasate,Expense,food,-89.09,-56776.96
buyer_5,Sara,30,ES56209524809385928875,TRX_N-01230-04038816,2024-10-01T19:48:24,Donostia,Expense,healthcare,-159.86,-56936.82
buyer_5,Sara,30,ES56209524809385928875,TRX_N-01231-46961577,2024-10-01T13:04:36,Donostia,Expense,appliances,-235.22,-57172.04
buyer_5,Sara,30,ES56209524809385928875,TRX_N-01232-94931614,2024-10-04T10:14:25,Donostia,expenses,mortgage,-901.62,-58073.66
buyer_5,Sara,30,ES56209524809385928875,TRX_N-01233-01276545,2024-10-04T20:46:56,Donostia,Expense,transport,-68.33,-58141.99
buyer_5,Sara,30,ES56209524809385928875,TRX_N-01234-49628095,2024-10-04T11:53:05,Arrasate,Expense,education,-75.76,-58217.75
buyer_5,Sara,30,ES56209524809385928875,TRX_N-01235-68018258,2024-10-05T10:06:55,Donostia,expenses,internet,-42.0,-58259.75
buyer_5,Sara,30,ES56209524809385928875,TRX_N-01236-44528618,2024-10-05T11:29:14,Donostia,Expense,clothing,-132.34,-58392.09
buyer_5,Sara,30,ES56209524809385928875,TRX_N-01237-74575080,2024-10-05T20:13:37,Donostia,Expense,cash,-100.0,-58492.09
buyer_5,Sara,30,ES56209524809385928875,TRX_N-01238-50604652,2024-10-06T18:03:39,Donostia,expenses,electricity,-86.72,-58578.81
buyer_5,Sara,30,ES56209524809385928875,TRX_N-01239-09147110,2024-10-06T13:18:16,Donostia,expenses,phone,-43.51,-58622.32
buyer_5,Sara,30,ES56209524809385928875,TRX_N-01240-52915610,2024-10-07T05:48:59,Donostia,expenses,gas,-102.6,-58724.92
buyer_5,Sara,30,ES56209524809385928875,TRX_N-01241-17441897,2024-10-08T20:58:42,Donostia,expenses,water,-29.28,-58754.2
buyer_6,Manuel,45,ES02209555428642879798,TRX_N-00001-63139312,2022-01-01T20:20:13,Vitoria-Gasteiz,incomes,salary,1338.32,2963.3
buyer_6,Manuel,45,ES02209555428642879798,TRX_N-00002-92663061,2022-01-01T20:20:13,Vitoria-Gasteiz,incomes,salary_partner,1297.2,4260.5
buyer_6,Manuel,45,ES02209555428642879798,TRX_N-00003-40449789,2022-01-02T10:09:23,Vitoria-Gasteiz,Expense,transport,-50.91,4209.59
buyer_6,Manuel,45,ES02209555428642879798,TRX_N-00004-79356745,2022-01-04T21:49:07,Vitoria-Gasteiz,expenses,mortgage,-998.07,3211.52
buyer_6,Manuel,45,ES02209555428642879798,TRX_N-00005-13964134,2022-01-04T13:54:46,Vitoria-Gasteiz,Expense,food,-88.73,3122.79
buyer_6,Manuel,45,ES02209555428642879798,TRX_N-00006-56393081,2022-01-06T15:19:14,Vitoria-Gasteiz,Expense,cash,-100.0,3022.79
buyer_6,Manuel,45,ES02209555428642879798,TRX_N-00007-57769915,2022-01-07T14:41:35,Vitoria-Gasteiz,Expense,food,-117.99,2904.8
buyer_6,Manuel,45,ES02209555428642879798,TRX_N-00008-72635533,2022-01-08T08:54:22,Vitoria-Gasteiz,expenses,electricity,-74.16,2830.64
buyer_6,Manuel,45,ES02209555428642879798,TRX_N-00009-15488332,2022-01-08T16:14:11,Vitoria-Gasteiz,expenses,internet,-42.0,2788.64
buyer_6,Manuel,45,ES02209555428642879798,TRX_N-00010-60715963,2022-01-08T17:02:47,Vitoria-Gasteiz,expenses,phone,-39.74,2748.9
buyer_6,Manuel,45,ES02209555428642879798,TRX_N-00011-51271937,2022-01-08T21:39:59,Vitoria-Gasteiz,expenses,water,-40.98,2707.92
buyer_6,Manuel,45,ES02209555428642879798,TRX_N-00012-02628869,2022-01-08T19:39:20,Vitoria-Gasteiz,expenses,gas,-71.9,2636.02
buyer_6,Manuel,45,ES02209555428642879798,TRX_N-00013-38075943,2022-01-08T18:13:42,Vitoria-Gasteiz,Expense,clothing,-142.55,2493.47
buyer_6,Manuel,45,ES02209555428642879798,TRX_N-00014-25564972,2022-01-10T12:09:50,Vitoria-Gasteiz,Expense,cash,-100.0,2393.47
buyer_6,Manuel,45,ES02209555428642879798,TRX_N-00015-34568025,2022-01-11T19:39:12,Vitoria-Gasteiz,Expense,cash,-100.0,2293.47
buyer_6,Manuel,45,ES02209555428642879798,TRX_N-00016-92487926,2022-01-11T11:14:44,Vitoria-Gasteiz,expenses,children,-155.4,2138.07
buyer_6,Manuel,45,ES02209555428642879798,TRX_N-00017-17800297,2022-01-12T03:55:25,Bermeo,Expense,cash,-100.0,2038.07
buyer_6,Manuel,45,ES02209555428642879798,TRX_N-00018-37369458,2022-01-13T13:17:15,Vitoria-Gasteiz,Expense,transport,-77.35,1960.72
buyer_6,Manuel,45,ES02209555428642879798,TRX_N-00019-71326683,2022-01-13T08:39:45,Vitoria-Gasteiz,Expense,appliances,-101.24,1859.48
buyer_6,Manuel,45,ES02209555428642879798,TRX_N-00020-33553226,2022-01-15T08:10:27,Vitoria-Gasteiz,Expense,leisure,-48.48,1811.0
buyer_6,Manuel,45,ES02209555428642879798,TRX_N-00021-07068154,2022-01-15T08:21:16,Vitoria-Gasteiz,Expense,education,-70.33,1740.67
buyer_6,Manuel,45,ES02209555428642879798,TRX_N-00022-61979287,2022-01-16T13:42:50,Zuia,Expense,food,-87.91,1652.76
buyer_6,Manuel,45,ES02209555428642879798,TRX_N-00023-02069943,2022-01-16T01:44:38,Vitoria-Gasteiz,Expense,clothing,-101.43,1551.33
buyer_6,Manuel,45,ES02209555428642879798,TRX_N-00024-58291369,2022-01-16T17:05:20,Vitoria-Gasteiz,expenses,children,-69.92,1481.41
buyer_6,Manuel,45,ES02209555428642879798,TRX_N-00025-41246889,2022-01-17T20:11:19,Vitoria-Gasteiz,Expense,food,-79.92,1401.49
buyer_6,Manuel,45,ES02209555428642879798,TRX_N-00026-32515860,2022-01-19T17:38:13,Vitoria-Gasteiz,Expense,cash,-100.0,1301.49
buyer_6,Manuel,45,ES02209555428642879798,TRX_N-00027-23310033,2022-01-22T19:42:55,Vitoria-Gasteiz,Expense,transport,-58.36,1243.13
buyer_6,Manuel,45,ES02209555428642879798,TRX_N-00028-14828233,2022-01-23T14:18:19,Vitoria-Gasteiz,Expense,gifts,-105.75,1137.38
buyer_6,Manuel,45,ES02209555428642879798,TRX_N-00029-54884808,2022-01-24T15:02:18,Vitoria-Gasteiz,Expense,food,-107.94,1029.44
buyer_6,Manuel,45,ES02209555428642879798,TRX_N-00030-69604084,2022-01-25T13:27:56,Vitoria-Gasteiz,Expense,food,-95.66,933.78
buyer_6,Manuel,45,ES02209555428642879798,TRX_N-00031-81712093,2022-01-25T10:36:14,Vitoria-Gasteiz,Expense,cash,-100.0,833.78
buyer_6,Manuel,45,ES02209555428642879798,TRX_N-00032-67844183,2022-01-26T09:51:18,Vitoria-Gasteiz,Expense,cash,-100.0,733.78
buyer_6,Manuel,45,ES02209555428642879798,TRX_N-00033-37510644,2022-01-27T18:13:11,Vitoria-Gasteiz,Expense,education,-54.09,679.69
buyer_6,Manuel,45,ES02209555428642879798,TRX_N-00034-67616285,2022-01-28T19:21:47,Vitoria-Gasteiz,expenses,children,-135.36,544.33
buyer_6,Manuel,45,ES02209555428642879798,TRX_N-00035-29928690,2022-01-29T18:11:24,Vitoria-Gasteiz,Expense,leisure,-52.79,491.54
buyer_6,Manuel,45,ES02209555428642879798,TRX_N-00036-33681234,2022-02-01T09:50:47,Vitoria-Gasteiz,incomes,salary,1338.32,1829.86
buyer_6,Manuel,45,ES02209555428642879798,TRX_N-00037-22877981,2022-02-01T09:50:47,Vitoria-Gasteiz,incomes,salary_partner,1297.2,3127.06
buyer_6,Manuel,45,ES02209555428642879798,TRX_N-00038-02530433,2022-02-01T11:11:06,Donostia,Expense,cash,-100.0,3027.06
buyer_6,Manuel,45,ES02209555428642879798,TRX_N-00039-82712240,2022-02-01T12:02:05,Vitoria-Gasteiz,Expense,gifts,-176.17,2850.89
buyer_6,Manuel,45,ES02209555428642879798,TRX_N-00040-20537038,2022-02-03T04:16:22,Vitoria-Gasteiz,Expense,transport,-50.41,2800.48
buyer_6,Manuel,45,ES02209555428642879798,TRX_N-00041-08685223,2022-02-04T17:55:49,Vitoria-Gasteiz,expenses,mortgage,-998.07,1802.41
buyer_6,Manuel,45,ES02209555428642879798,TRX_N-00042-49739162,2022-02-04T10:15:50,Vitoria-Gasteiz,Expense,leisure,-59.77,1742.64
buyer_6,Manuel,45,ES02209555428642879798,TRX_N-00043-44018663,2022-02-05T23:03:31,Vitoria-Gasteiz,expenses,water,-39.81,1702.83
buyer_6,Manuel,45,ES02209555428642879798,TRX_N-00044-33586964,2022-02-06T20:22:31,Oy√≥n-Oion,Expense,clothing,-62.75,1640.08
buyer_6,Manuel,45,ES02209555428642879798,TRX_N-00045-79441833,2022-02-06T10:46:19,Vitoria-Gasteiz,Expense,healthcare,-186.2,1453.88
buyer_6,Manuel,45,ES02209555428642879798,TRX_N-00046-51071345,2022-02-06T17:39:21,Vitoria-Gasteiz,Expense,gifts,-502.14,951.74
buyer_6,Manuel,45,ES02209555428642879798,TRX_N-00047-95530671,2022-02-08T09:22:52,Vitoria-Gasteiz,expenses,phone,-35.81,915.93
buyer_6,Manuel,45,ES02209555428642879798,TRX_N-00048-20229445,2022-02-08T05:31:56,Vitoria-Gasteiz,expenses,electricity,-52.43,863.5
buyer_6,Manuel,45,ES02209555428642879798,TRX_N-00049-57593412,2022-02-08T16:13:44,Vitoria-Gasteiz,expenses,gas,-87.51,775.99
buyer_6,Manuel,45,ES02209555428642879798,TRX_N-00050-19306355,2022-02-08T18:27:13,Vitoria-Gasteiz,expenses,internet,-42.0,733.99
buyer_6,Manuel,45,ES02209555428642879798,TRX_N-00051-18299826,2022-02-08T20:50:48,Vitoria-Gasteiz,Expense,transport,-49.87,684.12
buyer_6,Manuel,45,ES02209555428642879798,TRX_N-00052-87574655,2022-02-08T16:04:54,Vitoria-Gasteiz,Expense,appliances,-396.15,287.97
buyer_6,Manuel,45,ES02209555428642879798,TRX_N-00053-17766803,2022-02-08T20:15:34,Vitoria-Gasteiz,Expense,repairs,-142.78,145.19
buyer_6,Manuel,45,ES02209555428642879798,TRX_N-00054-22707836,2022-02-09T12:18:05,Vitoria-Gasteiz,Expense,transport,-66.46,78.73
buyer_6,Manuel,45,ES02209555428642879798,TRX_N-00055-06072518,2022-02-09T15:17:53,Pasaia,Expense,cash,-100.0,-21.27
buyer_6,Manuel,45,ES02209555428642879798,TRX_N-00056-82885334,2022-02-11T08:18:47,Vitoria-Gasteiz,Expense,appliances,-403.8,-425.07
buyer_6,Manuel,45,ES02209555428642879798,TRX_N-00057-37254143,2022-02-12T13:31:18,Arrasate,Expense,food,-83.62,-508.69
buyer_6,Manuel,45,ES02209555428642879798,TRX_N-00058-46076461,2022-02-13T16:50:18,Vitoria-Gasteiz,Expense,education,-60.54,-569.23
buyer_6,Manuel,45,ES02209555428642879798,TRX_N-00059-94161739,2022-02-14T18:50:09,Vitoria-Gasteiz,Expense,cash,-100.0,-669.23
buyer_6,Manuel,45,ES02209555428642879798,TRX_N-00060-58166738,2022-02-16T11:34:25,Vitoria-Gasteiz,Expense,cash,-100.0,-769.23
buyer_6,Manuel,45,ES02209555428642879798,TRX_N-00061-50516674,2022-02-18T18:10:21,Labastida,Expense,leisure,-60.31,-829.54
buyer_6,Manuel,45,ES02209555428642879798,TRX_N-00062-40050324,2022-02-18T14:54:22,Vitoria-Gasteiz,Expense,gifts,-35.61,-865.15
buyer_6,Manuel,45,ES02209555428642879798,TRX_N-00063-51775454,2022-02-18T13:17:52,Vitoria-Gasteiz,expenses,children,-161.65,-1026.8
buyer_6,Manuel,45,ES02209555428642879798,TRX_N-00064-28003115,2022-02-20T13:35:07,Vitoria-Gasteiz,Expense,food,-122.87,-1149.67
buyer_6,Manuel,45,ES02209555428642879798,TRX_N-00065-09467960,2022-02-22T18:08:16,Vitoria-Gasteiz,Expense,repairs,-319.0,-1468.67
buyer_6,Manuel,45,ES02209555428642879798,TRX_N-00066-90707340,2022-02-23T18:47:12,Vitoria-Gasteiz,Expense,cash,-100.0,-1568.67
buyer_6,Manuel,45,ES02209555428642879798,TRX_N-00067-89520563,2022-02-24T11:57:36,Vitoria-Gasteiz,Expense,clothing,-94.35,-1663.02
buyer_6,Manuel,45,ES02209555428642879798,TRX_N-00068-33829631,2022-03-01T03:17:01,Vitoria-Gasteiz,incomes,salary,1338.32,-324.7
buyer_6,Manuel,45,ES02209555428642879798,TRX_N-00069-87426690,2022-03-01T03:17:01,Vitoria-Gasteiz,incomes,salary_partner,1297.2,972.5
buyer_6,Manuel,45,ES02209555428642879798,TRX_N-00070-26685189,2022-03-01T18:18:22,Vitoria-Gasteiz,Expense,food,-85.14,887.36
buyer_6,Manuel,45,ES02209555428642879798,TRX_N-00071-25632936,2022-03-01T17:28:58,Vitoria-Gasteiz,Expense,transport,-75.27,812.09
buyer_6,Manuel,45,ES02209555428642879798,TRX_N-00072-23842411,2022-03-01T15:49:07,Vitoria-Gasteiz,Expense,healthcare,-108.24,703.85
buyer_6,Manuel,45,ES02209555428642879798,TRX_N-00073-43024506,2022-03-04T17:44:59,Vitoria-Gasteiz,expenses,mortgage,-998.07,-294.22
buyer_6,Manuel,45,ES02209555428642879798,TRX_N-00074-99951911,2022-03-04T09:18:38,Vitoria-Gasteiz,Expense,leisure,-20.83,-315.05
buyer_6,Manuel,45,ES02209555428642879798,TRX_N-00075-15150269,2022-03-05T14:46:17,Vitoria-Gasteiz,expenses,electricity,-23.3,-338.35
buyer_6,Manuel,45,ES02209555428642879798,TRX_N-00076-95725546,2022-03-05T18:42:49,Vitoria-Gasteiz,expenses,phone,-31.32,-369.67
buyer_6,Manuel,45,ES02209555428642879798,TRX_N-00077-38904612,2022-03-05T09:38:15,Vitoria-Gasteiz,Expense,leisure,-70.97,-440.64
buyer_6,Manuel,45,ES02209555428642879798,TRX_N-00078-44601806,2022-03-05T13:28:08,Vitoria-Gasteiz,Expense,cash,-100.0,-540.64
buyer_6,Manuel,45,ES02209555428642879798,TRX_N-00079-29887349,2022-03-06T16:05:26,Vitoria-Gasteiz,expenses,gas,-72.37,-613.01
buyer_6,Manuel,45,ES02209555428642879798,TRX_N-00080-09286163,2022-03-07T18:11:02,Vitoria-Gasteiz,expenses,water,-29.29,-642.3
buyer_6,Manuel,45,ES02209555428642879798,TRX_N-00081-92938582,2022-03-07T13:20:54,Vitoria-Gasteiz,expenses,internet,-42.0,-684.3
buyer_6,Manuel,45,ES02209555428642879798,TRX_N-00082-58038432,2022-03-07T14:21:18,Vitoria-Gasteiz,Expense,food,-106.59,-790.89
buyer_6,Manuel,45,ES02209555428642879798,TRX_N-00083-82011269,2022-03-07T13:12:33,Vitoria-Gasteiz,Expense,repairs,-49.12,-840.01
buyer_6,Manuel,45,ES02209555428642879798,TRX_N-00084-51343267,2022-03-10T19:03:36,Vitoria-Gasteiz,Expense,food,-68.87,-908.88
buyer_6,Manuel,45,ES02209555428642879798,TRX_N-00085-08724398,2022-03-10T13:14:35,Sestao,Expense,cash,-100.0,-1008.88
buyer_6,Manuel,45,ES02209555428642879798,TRX_N-00086-97371444,2022-03-11T08:03:13,Vitoria-Gasteiz,Expense,repairs,-38.89,-1047.77
buyer_6,Manuel,45,ES02209555428642879798,TRX_N-00087-99709582,2022-03-12T05:04:58,Vitoria-Gasteiz,Expense,cash,-100.0,-1147.77
buyer_6,Manuel,45,ES02209555428642879798,TRX_N-00088-80219919,2022-03-13T17:02:39,Vitoria-Gasteiz,Expense,appliances,-418.83,-1566.6
buyer_6,Manuel,45,ES02209555428642879798,TRX_N-00089-92997304,2022-03-14T18:14:41,Vitoria-Gasteiz,Expense,repairs,-269.18,-1835.78
buyer_6,Manuel,45,ES02209555428642879798,TRX_N-00090-59287650,2022-03-15T23:05:59,Llodio,Expense,cash,-100.0,-1935.78
buyer_6,Manuel,45,ES02209555428642879798,TRX_N-00091-05390562,2022-03-15T09:04:05,Vitoria-Gasteiz,Expense,appliances,-135.97,-2071.75
buyer_6,Manuel,45,ES02209555428642879798,TRX_N-00092-22633768,2022-03-16T20:43:51,Vitoria-Gasteiz,Expense,leisure,-39.78,-2111.53
buyer_6,Manuel,45,ES02209555428642879798,TRX_N-00093-22183986,2022-03-17T20:48:04,Vitoria-Gasteiz,Expense,food,-83.13,-2194.66
buyer_6,Manuel,45,ES02209555428642879798,TRX_N-00094-33155695,2022-03-17T18:54:02,Vitoria-Gasteiz,Expense,cash,-100.0,-2294.66
buyer_6,Manuel,45,ES02209555428642879798,TRX_N-00095-62664450,2022-03-18T13:18:06,Vitoria-Gasteiz,Expense,leisure,-20.57,-2315.23
buyer_6,Manuel,45,ES02209555428642879798,TRX_N-00096-48920629,2022-03-18T11:52:43,Llodio,Expense,education,-68.18,-2383.41
buyer_6,Manuel,45,ES02209555428642879798,TRX_N-00097-08205259,2022-03-20T23:00:02,Vitoria-Gasteiz,Expense,food,-95.19,-2478.6
buyer_6,Manuel,45,ES02209555428642879798,TRX_N-00098-73460612,2022-03-22T15:22:59,Vitoria-Gasteiz,Expense,cash,-100.0,-2578.6
buyer_6,Manuel,45,ES02209555428642879798,TRX_N-00099-66996261,2022-03-22T12:46:23,Vitoria-Gasteiz,Expense,gifts,-606.07,-3184.67
buyer_6,Manuel,45,ES02209555428642879798,TRX_N-00100-56332167,2022-03-26T18:20:11,Vitoria-Gasteiz,Expense,food,-109.44,-3294.11
buyer_6,Manuel,45,ES02209555428642879798,TRX_N-00101-54562741,2022-03-26T09:05:50,Vitoria-Gasteiz,Expense,leisure,-84.56,-3378.67
buyer_6,Manuel,45,ES02209555428642879798,TRX_N-00102-73565422,2022-03-27T18:09:56,Vitoria-Gasteiz,Expense,gifts,-440.66,-3819.33
buyer_6,Manuel,45,ES02209555428642879798,TRX_N-00103-33520615,2022-03-28T17:32:47,Vitoria-Gasteiz,Expense,food,-89.82,-3909.15
buyer_6,Manuel,45,ES02209555428642879798,TRX_N-00104-08963671,2022-03-30T10:02:45,Vitoria-Gasteiz,Expense,healthcare,-147.07,-4056.22
buyer_6,Manuel,45,ES02209555428642879798,TRX_N-00105-88777558,2022-03-30T18:32:19,Amurrio,Expense,cash,-100.0,-4156.22
buyer_6,Manuel,45,ES02209555428642879798,TRX_N-00106-99441017,2022-04-01T20:42:17,Vitoria-Gasteiz,incomes,salary,1338.32,-2817.9
buyer_6,Manuel,45,ES02209555428642879798,TRX_N-00107-96661852,2022-04-01T20:42:17,Vitoria-Gasteiz,incomes,salary_partner,1297.2,-1520.7
buyer_6,Manuel,45,ES02209555428642879798,TRX_N-00108-01680322,2022-04-01T20:42:17,Vitoria-Gasteiz,incomes,extra_income,235.66,-1285.04
buyer_6,Manuel,45,ES02209555428642879798,TRX_N-00109-96384129,2022-04-01T19:05:33,Vitoria-Gasteiz,Expense,food,-96.95,-1381.99
buyer_6,Manuel,45,ES02209555428642879798,TRX_N-00110-52754133,2022-04-01T16:55:53,Vitoria-Gasteiz,Expense,transport,-85.18,-1467.17
buyer_6,Manuel,45,ES02209555428642879798,TRX_N-00111-94648021,2022-04-02T14:59:07,Vitoria-Gasteiz,Expense,cash,-100.0,-1567.17
buyer_6,Manuel,45,ES02209555428642879798,TRX_N-00112-50573425,2022-04-03T13:25:39,Erandio,Expense,education,-73.88,-1641.05
buyer_6,Manuel,45,ES02209555428642879798,TRX_N-00113-05101854,2022-04-03T19:25:36,Vitoria-Gasteiz,Expense,gifts,-142.99,-1784.04
buyer_6,Manuel,45,ES02209555428642879798,TRX_N-00114-85942232,2022-04-04T20:59:11,Vitoria-Gasteiz,expenses,mortgage,-998.07,-2782.11
buyer_6,Manuel,45,ES02209555428642879798,TRX_N-00115-09665212,2022-04-04T09:41:35,Vitoria-Gasteiz,Expense,leisure,-51.93,-2834.04
buyer_6,Manuel,45,ES02209555428642879798,TRX_N-00116-18141237,2022-04-05T14:32:11,Sopela,Expense,transport,-89.49,-2923.53
buyer_6,Manuel,45,ES02209555428642879798,TRX_N-00117-45311602,2022-04-05T10:27:57,Vitoria-Gasteiz,Expense,education,-58.49,-2982.02
buyer_6,Manuel,45,ES02209555428642879798,TRX_N-00118-35497998,2022-04-05T21:17:21,Vitoria-Gasteiz,Expense,travel,-862.56,-3844.58
buyer_6,Manuel,45,ES02209555428642879798,TRX_N-00119-46447532,2022-04-06T23:56:06,Vitoria-Gasteiz,expenses,electricity,-52.27,-3896.85
buyer_6,Manuel,45,ES02209555428642879798,TRX_N-00120-64956422,2022-04-06T17:04:29,Vitoria-Gasteiz,Expense,education,-58.3,-3955.15
buyer_6,Manuel,45,ES02209555428642879798,TRX_N-00121-48492649,2022-04-07T10:26:08,Vitoria-Gasteiz,expenses,water,-23.43,-3978.58
buyer_6,Manuel,45,ES02209555428642879798,TRX_N-00122-57408537,2022-04-07T16:45:38,Vitoria-Gasteiz,Expense,clothing,-153.77,-4132.35
buyer_6,Manuel,45,ES02209555428642879798,TRX_N-00123-65819374,2022-04-07T15:26:57,Vitoria-Gasteiz,Expense,education,-71.21,-4203.56
buyer_6,Manuel,45,ES02209555428642879798,TRX_N-00124-80595945,2022-04-07T13:00:44,Vitoria-Gasteiz,Expense,cash,-100.0,-4303.56
buyer_6,Manuel,45,ES02209555428642879798,TRX_N-00125-38995488,2022-04-08T12:41:33,Vitoria-Gasteiz,expenses,gas,-49.23,-4352.79
buyer_6,Manuel,45,ES02209555428642879798,TRX_N-00126-48603927,2022-04-08T00:43:40,Vitoria-Gasteiz,expenses,internet,-42.0,-4394.79
buyer_6,Manuel,45,ES02209555428642879798,TRX_N-00127-03304335,2022-04-08T17:57:26,Vitoria-Gasteiz,expenses,phone,-37.3,-4432.09
buyer_6,Manuel,45,ES02209555428642879798,TRX_N-00128-04028144,2022-04-08T16:49:42,Donostia,Expense,leisure,-81.29,-4513.38
buyer_6,Manuel,45,ES02209555428642879798,TRX_N-00129-66205098,2022-04-15T17:53:11,Vitoria-Gasteiz,Expense,cash,-100.0,-4613.38
buyer_6,Manuel,45,ES02209555428642879798,TRX_N-00130-58867225,2022-04-16T08:18:37,Vitoria-Gasteiz,Expense,food,-69.13,-4682.51
buyer_6,Manuel,45,ES02209555428642879798,TRX_N-00131-05598520,2022-04-16T13:48:43,Vitoria-Gasteiz,Expense,cash,-100.0,-4782.51
buyer_6,Manuel,45,ES02209555428642879798,TRX_N-00132-78039961,2022-04-18T22:14:15,Vitoria-Gasteiz,Expense,gifts,-27.13,-4809.64
buyer_6,Manuel,45,ES02209555428642879798,TRX_N-00133-90717852,2022-04-19T17:23:11,Iru√±a de Oca,Expense,food,-120.89,-4930.53
buyer_6,Manuel,45,ES02209555428642879798,TRX_N-00134-99294164,2022-04-20T01:19:32,Vitoria-Gasteiz,Expense,appliances,-191.14,-5121.67
buyer_6,Manuel,45,ES02209555428642879798,TRX_N-00135-79565007,2022-04-21T15:43:48,Vitoria-Gasteiz,Expense,food,-90.17,-5211.84
buyer_6,Manuel,45,ES02209555428642879798,TRX_N-00136-26582640,2022-04-25T18:00:49,Portugalete,Expense,food,-77.13,-5288.97
buyer_6,Manuel,45,ES02209555428642879798,TRX_N-00137-47544986,2022-04-25T10:44:18,Vitoria-Gasteiz,Expense,cash,-100.0,-5388.97
buyer_6,Manuel,45,ES02209555428642879798,TRX_N-00138-62389734,2022-04-25T12:18:28,Vitoria-Gasteiz,expenses,children,-215.21,-5604.18
buyer_6,Manuel,45,ES02209555428642879798,TRX_N-00139-87419951,2022-04-26T08:00:59,Vitoria-Gasteiz,Expense,healthcare,-179.6,-5783.78
buyer_6,Manuel,45,ES02209555428642879798,TRX_N-00140-88362353,2022-04-28T13:34:32,Oy√≥n-Oion,Expense,travel,-1585.99,-7369.77
buyer_6,Manuel,45,ES02209555428642879798,TRX_N-00141-06178442,2022-04-28T09:06:46,Vitoria-Gasteiz,Expense,gifts,-668.89,-8038.66
buyer_6,Manuel,45,ES02209555428642879798,TRX_N-00142-53766562,2022-04-30T16:31:42,Vitoria-Gasteiz,Expense,cash,-100.0,-8138.66
buyer_6,Manuel,45,ES02209555428642879798,TRX_N-00143-48739758,2022-05-01T17:11:03,Vitoria-Gasteiz,incomes,salary,1338.32,-6800.34
buyer_6,Manuel,45,ES02209555428642879798,TRX_N-00144-98773613,2022-05-01T17:11:03,Vitoria-Gasteiz,incomes,salary_partner,1297.2,-5503.14
buyer_6,Manuel,45,ES02209555428642879798,TRX_N-00145-88722063,2022-05-01T17:03:04,Labastida,Expense,cash,-100.0,-5603.14
buyer_6,Manuel,45,ES02209555428642879798,TRX_N-00146-33809394,2022-05-01T00:32:27,Vitoria-Gasteiz,Expense,appliances,-91.05,-5694.19
buyer_6,Manuel,45,ES02209555428642879798,TRX_N-00147-12005432,2022-05-01T10:58:44,Vitoria-Gasteiz,Expense,gifts,-529.84,-6224.03
buyer_6,Manuel,45,ES02209555428642879798,TRX_N-00148-55677984,2022-05-03T14:26:02,Oy√≥n-Oion,Expense,food,-119.27,-6343.3
buyer_6,Manuel,45,ES02209555428642879798,TRX_N-00149-69552721,2022-05-04T16:03:48,Vitoria-Gasteiz,expenses,mortgage,-998.07,-7341.37
buyer_6,Manuel,45,ES02209555428642879798,TRX_N-00150-54626788,2022-05-04T17:13:32,Portugalete,Expense,transport,-62.19,-7403.56
buyer_6,Manuel,45,ES02209555428642879798,TRX_N-00151-70756349,2022-05-04T12:02:37,Vitoria-Gasteiz,Expense,leisure,-68.49,-7472.05
buyer_6,Manuel,45,ES02209555428642879798,TRX_N-00152-79460568,2022-05-05T17:13:19,Vitoria-Gasteiz,expenses,phone,-39.05,-7511.1
buyer_6,Manuel,45,ES02209555428642879798,TRX_N-00153-57117294,2022-05-05T08:00:35,Vitoria-Gasteiz,Expense,clothing,-92.03,-7603.13
buyer_6,Manuel,45,ES02209555428642879798,TRX_N-00154-04699819,2022-05-05T13:06:02,Vitoria-Gasteiz,Expense,cash,-100.0,-7703.13
buyer_6,Manuel,45,ES02209555428642879798,TRX_N-00155-38301950,2022-05-08T19:54:07,Vitoria-Gasteiz,expenses,water,-21.37,-7724.5
buyer_6,Manuel,45,ES02209555428642879798,TRX_N-00156-50315649,2022-05-08T14:49:13,Vitoria-Gasteiz,expenses,electricity,-20.26,-7744.76
buyer_6,Manuel,45,ES02209555428642879798,TRX_N-00157-69302428,2022-05-08T11:35:07,Vitoria-Gasteiz,expenses,gas,-54.37,-7799.13
buyer_6,Manuel,45,ES02209555428642879798,TRX_N-00158-64819540,2022-05-08T20:11:32,Vitoria-Gasteiz,expenses,internet,-42.0,-7841.13
buyer_6,Manuel,45,ES02209555428642879798,TRX_N-00159-98917221,2022-05-08T19:18:44,Galdakao,Expense,cash,-100.0,-7941.13
buyer_6,Manuel,45,ES02209555428642879798,TRX_N-00160-91933847,2022-05-08T21:01:43,Zuia,Expense,repairs,-229.21,-8170.34
buyer_6,Manuel,45,ES02209555428642879798,TRX_N-00161-65920472,2022-05-09T10:42:08,Sopela,Expense,education,-73.71,-8244.05
buyer_6,Manuel,45,ES02209555428642879798,TRX_N-00162-74935080,2022-05-10T16:19:23,Vitoria-Gasteiz,Expense,leisure,-57.96,-8302.01
buyer_6,Manuel,45,ES02209555428642879798,TRX_N-00163-45884212,2022-05-12T19:45:35,Vitoria-Gasteiz,Expense,cash,-100.0,-8402.01
buyer_6,Manuel,45,ES02209555428642879798,TRX_N-00164-75173760,2022-05-13T17:38:36,Labastida,Expense,food,-61.02,-8463.03
buyer_6,Manuel,45,ES02209555428642879798,TRX_N-00165-20011597,2022-05-13T16:45:32,Barakaldo,Expense,healthcare,-139.23,-8602.26
buyer_6,Manuel,45,ES02209555428642879798,TRX_N-00166-15505533,2022-05-13T19:52:45,Zarautz,Expense,cash,-100.0,-8702.26
buyer_6,Manuel,45,ES02209555428642879798,TRX_N-00167-64195970,2022-05-13T09:55:25,Vitoria-Gasteiz,Expense,gifts,-74.02,-8776.28
buyer_6,Manuel,45,ES02209555428642879798,TRX_N-00168-43574906,2022-05-14T04:15:11,Vitoria-Gasteiz,Expense,food,-110.0,-8886.28
buyer_6,Manuel,45,ES02209555428642879798,TRX_N-00169-02232400,2022-05-16T17:41:54,Eibar,Expense,food,-60.22,-8946.5
buyer_6,Manuel,45,ES02209555428642879798,TRX_N-00170-24721194,2022-05-16T12:40:13,Vitoria-Gasteiz,Expense,leisure,-48.06,-8994.56
buyer_6,Manuel,45,ES02209555428642879798,TRX_N-00171-93097107,2022-05-18T23:20:39,Vitoria-Gasteiz,Expense,transport,-46.61,-9041.17
buyer_6,Manuel,45,ES02209555428642879798,TRX_N-00172-64488504,2022-05-20T14:16:01,Berango,Expense,repairs,-187.05,-9228.22
buyer_6,Manuel,45,ES02209555428642879798,TRX_N-00173-12031749,2022-05-21T13:13:49,Vitoria-Gasteiz,Expense,gifts,-547.21,-9775.43
buyer_6,Manuel,45,ES02209555428642879798,TRX_N-00174-19331100,2022-05-22T17:53:14,Durango,Expense,cash,-100.0,-9875.43
buyer_6,Manuel,45,ES02209555428642879798,TRX_N-00175-56426397,2022-05-23T14:32:03,Vitoria-Gasteiz,Expense,education,-48.04,-9923.47
buyer_6,Manuel,45,ES02209555428642879798,TRX_N-00176-85254135,2022-05-23T15:52:00,Vitoria-Gasteiz,Expense,repairs,-206.73,-10130.2
buyer_6,Manuel,45,ES02209555428642879798,TRX_N-00177-66979323,2022-05-24T22:15:59,Vitoria-Gasteiz,Expense,food,-95.68,-10225.88
buyer_6,Manuel,45,ES02209555428642879798,TRX_N-00178-75569495,2022-05-24T10:44:51,Hondarribia,Expense,leisure,-78.2,-10304.08
buyer_6,Manuel,45,ES02209555428642879798,TRX_N-00179-05625789,2022-05-25T09:44:14,Vitoria-Gasteiz,Expense,repairs,-32.15,-10336.23
buyer_6,Manuel,45,ES02209555428642879798,TRX_N-00180-02938932,2022-05-26T15:11:43,Vitoria-Gasteiz,expenses,children,-151.62,-10487.85
buyer_6,Manuel,45,ES02209555428642879798,TRX_N-00181-61087500,2022-05-27T20:55:49,Vitoria-Gasteiz,Expense,education,-57.26,-10545.11
buyer_6,Manuel,45,ES02209555428642879798,TRX_N-00182-70130403,2022-05-28T08:10:09,Vitoria-Gasteiz,Expense,leisure,-22.64,-10567.75
buyer_6,Manuel,45,ES02209555428642879798,TRX_N-00183-64854314,2022-05-28T17:37:42,Vitoria-Gasteiz,expenses,children,-235.29,-10803.04
buyer_6,Manuel,45,ES02209555428642879798,TRX_N-00184-81720039,2022-05-29T13:46:22,Vitoria-Gasteiz,Expense,food,-115.48,-10918.52
buyer_6,Manuel,45,ES02209555428642879798,TRX_N-00185-65481168,2022-05-29T13:38:11,Vitoria-Gasteiz,Expense,appliances,-281.12,-11199.64
buyer_6,Manuel,45,ES02209555428642879798,TRX_N-00186-36299110,2022-05-30T08:02:40,Arrasate,Expense,food,-118.62,-11318.26
buyer_6,Manuel,45,ES02209555428642879798,TRX_N-00187-68952333,2022-05-31T18:24:48,Vitoria-Gasteiz,Expense,cash,-100.0,-11418.26
buyer_6,Manuel,45,ES02209555428642879798,TRX_N-00188-93472638,2022-06-01T10:20:03,Vitoria-Gasteiz,incomes,salary,1338.32,-10079.94
buyer_6,Manuel,45,ES02209555428642879798,TRX_N-00189-34752729,2022-06-01T10:20:03,Vitoria-Gasteiz,incomes,salary_partner,1297.2,-8782.74
buyer_6,Manuel,45,ES02209555428642879798,TRX_N-00190-04670720,2022-06-01T10:20:03,Vitoria-Gasteiz,incomes,salary_bonus,950.48,-7832.26
buyer_6,Manuel,45,ES02209555428642879798,TRX_N-00191-75364783,2022-06-01T10:20:03,Vitoria-Gasteiz,incomes,salary_partner_bonus,986.28,-6845.98
buyer_6,Manuel,45,ES02209555428642879798,TRX_N-00192-60500302,2022-06-01T11:42:02,Oy√≥n-Oion,Expense,leisure,-76.2,-6922.18
buyer_6,Manuel,45,ES02209555428642879798,TRX_N-00193-09979116,2022-06-02T12:04:45,Vitoria-Gasteiz,Expense,repairs,-265.75,-7187.93
buyer_6,Manuel,45,ES02209555428642879798,TRX_N-00194-10790324,2022-06-03T11:25:43,Vitoria-Gasteiz,Expense,repairs,-294.96,-7482.89
buyer_6,Manuel,45,ES02209555428642879798,TRX_N-00195-18954921,2022-06-04T13:32:03,Vitoria-Gasteiz,expenses,mortgage,-998.07,-8480.96
buyer_6,Manuel,45,ES02209555428642879798,TRX_N-00196-95670367,2022-06-04T15:03:45,Vitoria-Gasteiz,Expense,transport,-57.43,-8538.39
buyer_6,Manuel,45,ES02209555428642879798,TRX_N-00197-27008509,2022-06-04T09:11:16,Vitoria-Gasteiz,Expense,cash,-100.0,-8638.39
buyer_6,Manuel,45,ES02209555428642879798,TRX_N-00198-81474551,2022-06-05T17:49:06,Vitoria-Gasteiz,Expense,leisure,-50.64,-8689.03
buyer_6,Manuel,45,ES02209555428642879798,TRX_N-00199-84777748,2022-06-06T14:56:16,Vitoria-Gasteiz,Expense,repairs,-55.0,-8744.03
buyer_6,Manuel,45,ES02209555428642879798,TRX_N-00200-98291135,2022-06-07T15:44:05,Vitoria-Gasteiz,expenses,water,-34.23,-8778.26
buyer_6,Manuel,45,ES02209555428642879798,TRX_N-00201-42104541,2022-06-07T08:33:39,Vitoria-Gasteiz,expenses,electricity,-29.25,-8807.51
buyer_6,Manuel,45,ES02209555428642879798,TRX_N-00202-86424580,2022-06-07T17:04:48,Vitoria-Gasteiz,expenses,phone,-43.75,-8851.26
buyer_6,Manuel,45,ES02209555428642879798,TRX_N-00203-65363712,2022-06-08T13:51:36,Vitoria-Gasteiz,expenses,gas,-44.94,-8896.2
buyer_6,Manuel,45,ES02209555428642879798,TRX_N-00204-65025118,2022-06-08T20:29:07,Vitoria-Gasteiz,expenses,internet,-42.0,-8938.2
buyer_6,Manuel,45,ES02209555428642879798,TRX_N-00205-51580409,2022-06-09T19:28:10,Durango,Expense,leisure,-26.97,-8965.17
buyer_6,Manuel,45,ES02209555428642879798,TRX_N-00206-05394817,2022-06-11T22:45:38,Errenteria,Expense,gifts,-428.55,-9393.72
buyer_6,Manuel,45,ES02209555428642879798,TRX_N-00207-53970166,2022-06-12T18:38:17,Vitoria-Gasteiz,Expense,food,-120.53,-9514.25
buyer_6,Manuel,45,ES02209555428642879798,TRX_N-00208-40840081,2022-06-14T09:58:06,Vitoria-Gasteiz,Expense,cash,-100.0,-9614.25
buyer_6,Manuel,45,ES02209555428642879798,TRX_N-00209-63969212,2022-06-16T11:01:18,Eibar,Expense,leisure,-61.21,-9675.46
buyer_6,Manuel,45,ES02209555428642879798,TRX_N-00210-78210179,2022-06-18T20:47:46,Vitoria-Gasteiz,Expense,leisure,-53.99,-9729.45
buyer_6,Manuel,45,ES02209555428642879798,TRX_N-00211-68099773,2022-06-18T08:41:43,Vitoria-Gasteiz,Expense,gifts,-34.84,-9764.29
buyer_6,Manuel,45,ES02209555428642879798,TRX_N-00212-75426503,2022-06-19T20:44:59,Vitoria-Gasteiz,Expense,food,-104.24,-9868.53
buyer_6,Manuel,45,ES02209555428642879798,TRX_N-00213-98678343,2022-06-19T19:45:18,Lasarte-Oria,Expense,cash,-100.0,-9968.53
buyer_6,Manuel,45,ES02209555428642879798,TRX_N-00214-13736771,2022-06-20T15:27:23,Vitoria-Gasteiz,expenses,children,-87.98,-10056.51
buyer_6,Manuel,45,ES02209555428642879798,TRX_N-00215-38436904,2022-06-22T10:11:49,Vitoria-Gasteiz,Expense,cash,-100.0,-10156.51
buyer_6,Manuel,45,ES02209555428642879798,TRX_N-00216-96262516,2022-06-22T12:07:01,Vitoria-Gasteiz,Expense,gifts,-268.16,-10424.67
buyer_6,Manuel,45,ES02209555428642879798,TRX_N-00217-55749728,2022-06-23T12:22:08,Vitoria-Gasteiz,Expense,travel,-905.32,-11329.99
buyer_6,Manuel,45,ES02209555428642879798,TRX_N-00218-30195252,2022-06-24T22:23:17,Vitoria-Gasteiz,Expense,leisure,-21.3,-11351.29
buyer_6,Manuel,45,ES02209555428642879798,TRX_N-00219-76849218,2022-06-25T13:49:10,Durango,Expense,repairs,-199.54,-11550.83
buyer_6,Manuel,45,ES02209555428642879798,TRX_N-00220-01840673,2022-06-26T09:10:58,Hondarribia,Expense,transport,-68.51,-11619.34
buyer_6,Manuel,45,ES02209555428642879798,TRX_N-00221-37939634,2022-06-30T23:46:34,Vitoria-Gasteiz,Expense,transport,-58.98,-11678.32
buyer_6,Manuel,45,ES02209555428642879798,TRX_N-00222-28187989,2022-07-01T20:48:06,Vitoria-Gasteiz,incomes,salary,1338.32,-10340.0
buyer_6,Manuel,45,ES02209555428642879798,TRX_N-00223-19893797,2022-07-01T20:48:06,Vitoria-Gasteiz,incomes,salary_partner,1297.2,-9042.8
buyer_6,Manuel,45,ES02209555428642879798,TRX_N-00224-82434836,2022-07-01T20:48:06,Vitoria-Gasteiz,incomes,extra_income,235.66,-8807.14
buyer_6,Manuel,45,ES02209555428642879798,TRX_N-00225-55801639,2022-07-01T10:09:44,Vitoria-Gasteiz,Expense,food,-102.43,-8909.57
buyer_6,Manuel,45,ES02209555428642879798,TRX_N-00226-41852714,2022-07-02T16:22:58,Bermeo,Expense,clothing,-79.13,-8988.7
buyer_6,Manuel,45,ES02209555428642879798,TRX_N-00227-13530159,2022-07-04T12:07:58,Vitoria-Gasteiz,expenses,mortgage,-998.07,-9986.77
buyer_6,Manuel,45,ES02209555428642879798,TRX_N-00228-30901745,2022-07-04T19:12:12,Vitoria-Gasteiz,Expense,clothing,-80.62,-10067.39
buyer_6,Manuel,45,ES02209555428642879798,TRX_N-00229-49307968,2022-07-04T09:29:45,Irun,Expense,cash,-100.0,-10167.39
buyer_6,Manuel,45,ES02209555428642879798,TRX_N-00230-57982904,2022-07-05T23:28:20,Vitoria-Gasteiz,expenses,electricity,-50.61,-10218.0
buyer_6,Manuel,45,ES02209555428642879798,TRX_N-00231-10988085,2022-07-05T14:24:31,Vitoria-Gasteiz,expenses,internet,-42.0,-10260.0
buyer_6,Manuel,45,ES02209555428642879798,TRX_N-00232-69880382,2022-07-05T16:04:13,Vitoria-Gasteiz,Expense,healthcare,-100.21,-10360.21
buyer_6,Manuel,45,ES02209555428642879798,TRX_N-00233-95664398,2022-07-05T15:26:57,Vitoria-Gasteiz,Expense,cash,-100.0,-10460.21
buyer_6,Manuel,45,ES02209555428642879798,TRX_N-00234-43211549,2022-07-06T02:17:26,Vitoria-Gasteiz,expenses,gas,-108.75,-10568.96
buyer_6,Manuel,45,ES02209555428642879798,TRX_N-00235-31935420,2022-07-06T18:55:37,Vitoria-Gasteiz,expenses,phone,-42.28,-10611.24
buyer_6,Manuel,45,ES02209555428642879798,TRX_N-00236-98652370,2022-07-08T19:36:57,Vitoria-Gasteiz,expenses,water,-42.05,-10653.29
buyer_6,Manuel,45,ES02209555428642879798,TRX_N-00237-09392078,2022-07-08T12:45:15,Vitoria-Gasteiz,Expense,leisure,-39.45,-10692.74
buyer_6,Manuel,45,ES02209555428642879798,TRX_N-00238-41085668,2022-07-10T12:04:38,Vitoria-Gasteiz,Expense,leisure,-62.21,-10754.95
buyer_6,Manuel,45,ES02209555428642879798,TRX_N-00239-72836717,2022-07-11T07:05:22,Vitoria-Gasteiz,Expense,education,-78.76,-10833.71
buyer_6,Manuel,45,ES02209555428642879798,TRX_N-00240-29062019,2022-07-11T20:02:32,Vitoria-Gasteiz,Expense,repairs,-154.96,-10988.67
buyer_6,Manuel,45,ES02209555428642879798,TRX_N-00241-74868796,2022-07-14T12:24:54,Vitoria-Gasteiz,Expense,food,-63.61,-11052.28
buyer_6,Manuel,45,ES02209555428642879798,TRX_N-00242-04088835,2022-07-14T12:21:33,Vitoria-Gasteiz,Expense,cash,-100.0,-11152.28
buyer_6,Manuel,45,ES02209555428642879798,TRX_N-00243-71110806,2022-07-15T16:58:28,Vitoria-Gasteiz,Expense,clothing,-81.7,-11233.98
buyer_6,Manuel,45,ES02209555428642879798,TRX_N-00244-24388066,2022-07-15T12:59:10,Amurrio,Expense,travel,-1665.85,-12899.83
buyer_6,Manuel,45,ES02209555428642879798,TRX_N-00245-00616508,2022-07-16T14:26:04,Vitoria-Gasteiz,Expense,transport,-82.38,-12982.21
buyer_6,Manuel,45,ES02209555428642879798,TRX_N-00246-20509895,2022-07-17T19:08:32,Vitoria-Gasteiz,Expense,healthcare,-165.7,-13147.91
buyer_6,Manuel,45,ES02209555428642879798,TRX_N-00247-32198409,2022-07-19T19:37:16,Vitoria-Gasteiz,Expense,appliances,-162.53,-13310.44
buyer_6,Manuel,45,ES02209555428642879798,TRX_N-00248-79140151,2022-07-19T18:06:57,Vitoria-Gasteiz,Expense,gifts,-110.8,-13421.24
buyer_6,Manuel,45,ES02209555428642879798,TRX_N-00249-53335781,2022-07-20T17:38:25,Vitoria-Gasteiz,Expense,leisure,-64.87,-13486.11
buyer_6,Manuel,45,ES02209555428642879798,TRX_N-00250-77081274,2022-07-22T13:22:39,Vitoria-Gasteiz,Expense,gifts,-592.26,-14078.37
buyer_6,Manuel,45,ES02209555428642879798,TRX_N-00251-36048275,2022-07-23T17:01:33,Vitoria-Gasteiz,Expense,leisure,-68.64,-14147.01
buyer_6,Manuel,45,ES02209555428642879798,TRX_N-00252-75125298,2022-07-23T18:30:52,Vitoria-Gasteiz,Expense,cash,-100.0,-14247.01
buyer_6,Manuel,45,ES02209555428642879798,TRX_N-00253-66852984,2022-07-24T20:18:50,Vitoria-Gasteiz,Expense,clothing,-112.52,-14359.53
buyer_6,Manuel,45,ES02209555428642879798,TRX_N-00254-44420774,2022-07-27T18:18:57,Barakaldo,Expense,repairs,-225.62,-14585.15
buyer_6,Manuel,45,ES02209555428642879798,TRX_N-00255-93442888,2022-07-29T21:01:36,Vitoria-Gasteiz,Expense,appliances,-231.0,-14816.15
buyer_6,Manuel,45,ES02209555428642879798,TRX_N-00256-04362940,2022-07-29T08:47:40,Vitoria-Gasteiz,expenses,children,-207.03,-15023.18
buyer_6,Manuel,45,ES02209555428642879798,TRX_N-00257-61771413,2022-07-30T00:12:22,Vitoria-Gasteiz,Expense,leisure,-50.36,-15073.54
buyer_6,Manuel,45,ES02209555428642879798,TRX_N-00258-54916786,2022-07-30T12:56:20,Vitoria-Gasteiz,Expense,travel,-883.25,-15956.79
buyer_6,Manuel,45,ES02209555428642879798,TRX_N-00259-84675958,2022-07-31T17:51:35,Vitoria-Gasteiz,Expense,cash,-100.0,-16056.79
buyer_6,Manuel,45,ES02209555428642879798,TRX_N-00260-41917835,2022-08-01T16:54:58,Vitoria-Gasteiz,incomes,salary,1338.32,-14718.47
buyer_6,Manuel,45,ES02209555428642879798,TRX_N-00261-01949144,2022-08-01T16:54:58,Vitoria-Gasteiz,incomes,salary_partner,1297.2,-13421.27
buyer_6,Manuel,45,ES02209555428642879798,TRX_N-00262-53587110,2022-08-01T08:14:23,Vitoria-Gasteiz,Expense,cash,-100.0,-13521.27
buyer_6,Manuel,45,ES02209555428642879798,TRX_N-00263-02475219,2022-08-02T14:08:07,Vitoria-Gasteiz,Expense,gifts,-701.12,-14222.39
buyer_6,Manuel,45,ES02209555428642879798,TRX_N-00264-13025220,2022-08-03T16:02:20,Vitoria-Gasteiz,Expense,leisure,-60.72,-14283.11
buyer_6,Manuel,45,ES02209555428642879798,TRX_N-00265-29035488,2022-08-04T14:15:39,Vitoria-Gasteiz,expenses,mortgage,-998.07,-15281.18
buyer_6,Manuel,45,ES02209555428642879798,TRX_N-00266-71973865,2022-08-04T14:53:36,Errenteria,Expense,transport,-76.95,-15358.13
buyer_6,Manuel,45,ES02209555428642879798,TRX_N-00267-64698192,2022-08-04T21:35:56,Vitoria-Gasteiz,Expense,clothing,-104.2,-15462.33
buyer_6,Manuel,45,ES02209555428642879798,TRX_N-00268-85974095,2022-08-04T10:28:07,Vitoria-Gasteiz,Expense,cash,-100.0,-15562.33
buyer_6,Manuel,45,ES02209555428642879798,TRX_N-00269-96029366,2022-08-06T18:47:19,Santurtzi,Expense,food,-124.3,-15686.63
buyer_6,Manuel,45,ES02209555428642879798,TRX_N-00270-53977681,2022-08-07T23:47:58,Vitoria-Gasteiz,expenses,gas,-101.04,-15787.67
buyer_6,Manuel,45,ES02209555428642879798,TRX_N-00271-14397348,2022-08-07T09:40:16,Vitoria-Gasteiz,expenses,phone,-43.57,-15831.24
buyer_6,Manuel,45,ES02209555428642879798,TRX_N-00272-50211421,2022-08-07T20:57:18,Vitoria-Gasteiz,Expense,food,-99.5,-15930.74
buyer_6,Manuel,45,ES02209555428642879798,TRX_N-00273-92950843,2022-08-08T22:09:33,Vitoria-Gasteiz,expenses,internet,-42.0,-15972.74
buyer_6,Manuel,45,ES02209555428642879798,TRX_N-00274-96313124,2022-08-08T16:15:46,Vitoria-Gasteiz,expenses,water,-41.81,-16014.55
buyer_6,Manuel,45,ES02209555428642879798,TRX_N-00275-54972270,2022-08-08T08:16:40,Vitoria-Gasteiz,expenses,electricity,-52.11,-16066.66
buyer_6,Manuel,45,ES02209555428642879798,TRX_N-00276-82787136,2022-08-08T12:34:31,Andoain,Expense,cash,-100.0,-16166.66
buyer_6,Manuel,45,ES02209555428642879798,TRX_N-00277-56942903,2022-08-10T14:33:33,Vitoria-Gasteiz,Expense,leisure,-48.4,-16215.06
buyer_6,Manuel,45,ES02209555428642879798,TRX_N-00278-44156146,2022-08-11T20:40:22,Bilbao,Expense,leisure,-66.7,-16281.76
buyer_6,Manuel,45,ES02209555428642879798,TRX_N-00279-50619794,2022-08-11T09:36:24,Vitoria-Gasteiz,Expense,cash,-100.0,-16381.76
buyer_6,Manuel,45,ES02209555428642879798,TRX_N-00280-58308511,2022-08-11T08:24:42,Vitoria-Gasteiz,Expense,gifts,-58.41,-16440.17
buyer_6,Manuel,45,ES02209555428642879798,TRX_N-00281-13764205,2022-08-12T17:11:47,Vitoria-Gasteiz,Expense,leisure,-50.11,-16490.28
buyer_6,Manuel,45,ES02209555428642879798,TRX_N-00282-48977075,2022-08-17T08:50:53,Vitoria-Gasteiz,Expense,food,-88.19,-16578.47
buyer_6,Manuel,45,ES02209555428642879798,TRX_N-00283-16179614,2022-08-17T16:16:04,Vitoria-Gasteiz,Expense,gifts,-102.85,-16681.32
buyer_6,Manuel,45,ES02209555428642879798,TRX_N-00284-19401550,2022-08-18T14:46:36,Vitoria-Gasteiz,Expense,food,-119.9,-16801.22
buyer_6,Manuel,45,ES02209555428642879798,TRX_N-00285-85594434,2022-08-18T06:45:27,Vitoria-Gasteiz,Expense,leisure,-38.69,-16839.91
buyer_6,Manuel,45,ES02209555428642879798,TRX_N-00286-33870770,2022-08-19T20:38:07,Vitoria-Gasteiz,Expense,healthcare,-54.52,-16894.43
buyer_6,Manuel,45,ES02209555428642879798,TRX_N-00287-14378646,2022-08-19T22:09:26,Vitoria-Gasteiz,Expense,appliances,-311.12,-17205.55
buyer_6,Manuel,45,ES02209555428642879798,TRX_N-00288-92456641,2022-08-20T08:05:50,Vitoria-Gasteiz,Expense,healthcare,-189.09,-17394.64
buyer_6,Manuel,45,ES02209555428642879798,TRX_N-00289-49036562,2022-08-21T16:06:14,Vitoria-Gasteiz,expenses,children,-97.69,-17492.33
buyer_6,Manuel,45,ES02209555428642879798,TRX_N-00290-74795285,2022-08-22T09:42:35,Vitoria-Gasteiz,Expense,gifts,-769.93,-18262.26
buyer_6,Manuel,45,ES02209555428642879798,TRX_N-00291-23821925,2022-08-25T13:01:35,Vitoria-Gasteiz,Expense,education,-60.15,-18322.41
buyer_6,Manuel,45,ES02209555428642879798,TRX_N-00292-85243643,2022-08-26T13:30:45,Vitoria-Gasteiz,Expense,travel,-1220.59,-19543.0
buyer_6,Manuel,45,ES02209555428642879798,TRX_N-00293-37896688,2022-08-27T01:57:13,Vitoria-Gasteiz,Expense,food,-74.75,-19617.75
buyer_6,Manuel,45,ES02209555428642879798,TRX_N-00294-81701634,2022-08-27T16:10:10,Vitoria-Gasteiz,Expense,clothing,-116.97,-19734.72
buyer_6,Manuel,45,ES02209555428642879798,TRX_N-00295-32122774,2022-08-28T05:09:45,Vitoria-Gasteiz,Expense,leisure,-29.12,-19763.84
buyer_6,Manuel,45,ES02209555428642879798,TRX_N-00296-57056565,2022-08-30T10:01:25,Vitoria-Gasteiz,Expense,cash,-100.0,-19863.84
buyer_6,Manuel,45,ES02209555428642879798,TRX_N-00297-64853159,2022-09-01T17:49:13,Vitoria-Gasteiz,incomes,salary,1338.32,-18525.52
buyer_6,Manuel,45,ES02209555428642879798,TRX_N-00298-76605141,2022-09-01T17:49:13,Vitoria-Gasteiz,incomes,salary_partner,1297.2,-17228.32
buyer_6,Manuel,45,ES02209555428642879798,TRX_N-00299-22852482,2022-09-01T16:19:07,Vitoria-Gasteiz,Expense,travel,-1830.93,-19059.25
buyer_6,Manuel,45,ES02209555428642879798,TRX_N-00300-41935564,2022-09-02T15:33:35,Vitoria-Gasteiz,Expense,transport,-57.63,-19116.88
buyer_6,Manuel,45,ES02209555428642879798,TRX_N-00301-17226238,2022-09-02T08:36:25,Bermeo,Expense,education,-75.14,-19192.02
buyer_6,Manuel,45,ES02209555428642879798,TRX_N-00302-75151374,2022-09-03T19:19:26,Vitoria-Gasteiz,Expense,food,-97.21,-19289.23
buyer_6,Manuel,45,ES02209555428642879798,TRX_N-00303-23287671,2022-09-03T08:41:52,Vitoria-Gasteiz,Expense,clothing,-95.37,-19384.6
buyer_6,Manuel,45,ES02209555428642879798,TRX_N-00304-79284833,2022-09-04T14:09:02,Vitoria-Gasteiz,expenses,mortgage,-998.07,-20382.67
buyer_6,Manuel,45,ES02209555428642879798,TRX_N-00305-85410012,2022-09-05T11:40:50,Vitoria-Gasteiz,expenses,electricity,-36.36,-20419.03
buyer_6,Manuel,45,ES02209555428642879798,TRX_N-00306-13757523,2022-09-05T19:42:52,Vitoria-Gasteiz,Expense,food,-105.8,-20524.83
buyer_6,Manuel,45,ES02209555428642879798,TRX_N-00307-79565683,2022-09-05T17:16:34,Vitoria-Gasteiz,Expense,cash,-100.0,-20624.83
buyer_6,Manuel,45,ES02209555428642879798,TRX_N-00308-18823359,2022-09-06T10:14:16,Vitoria-Gasteiz,expenses,phone,-31.82,-20656.65
buyer_6,Manuel,45,ES02209555428642879798,TRX_N-00309-76060137,2022-09-07T16:08:01,Vitoria-Gasteiz,expenses,gas,-77.63,-20734.28
buyer_6,Manuel,45,ES02209555428642879798,TRX_N-00310-47034497,2022-09-07T19:56:38,Vitoria-Gasteiz,Expense,cash,-100.0,-20834.28
buyer_6,Manuel,45,ES02209555428642879798,TRX_N-00311-95550671,2022-09-07T11:21:11,Vitoria-Gasteiz,Expense,gifts,-781.49,-21615.77
buyer_6,Manuel,45,ES02209555428642879798,TRX_N-00312-85198714,2022-09-08T07:55:43,Vitoria-Gasteiz,expenses,water,-29.31,-21645.08
buyer_6,Manuel,45,ES02209555428642879798,TRX_N-00313-91840772,2022-09-08T12:40:35,Vitoria-Gasteiz,expenses,internet,-42.0,-21687.08
buyer_6,Manuel,45,ES02209555428642879798,TRX_N-00314-67885484,2022-09-10T19:26:48,Vitoria-Gasteiz,Expense,transport,-43.89,-21730.97
buyer_6,Manuel,45,ES02209555428642879798,TRX_N-00315-26452218,2022-09-10T21:10:43,Vitoria-Gasteiz,Expense,leisure,-69.95,-21800.92
buyer_6,Manuel,45,ES02209555428642879798,TRX_N-00316-19540257,2022-09-10T15:35:45,Vitoria-Gasteiz,Expense,cash,-100.0,-21900.92
buyer_6,Manuel,45,ES02209555428642879798,TRX_N-00317-10205061,2022-09-10T18:59:41,Vitoria-Gasteiz,Expense,repairs,-246.05,-22146.97
buyer_6,Manuel,45,ES02209555428642879798,TRX_N-00318-54693217,2022-09-11T09:27:01,Vitoria-Gasteiz,Expense,transport,-87.67,-22234.64
buyer_6,Manuel,45,ES02209555428642879798,TRX_N-00319-79160807,2022-09-11T12:40:48,Vitoria-Gasteiz,Expense,cash,-100.0,-22334.64
buyer_6,Manuel,45,ES02209555428642879798,TRX_N-00320-53999500,2022-09-12T12:58:17,Vitoria-Gasteiz,Expense,cash,-100.0,-22434.64
buyer_6,Manuel,45,ES02209555428642879798,TRX_N-00321-89598073,2022-09-13T11:49:08,Vitoria-Gasteiz,expenses,children,-106.21,-22540.85
buyer_6,Manuel,45,ES02209555428642879798,TRX_N-00322-78518625,2022-09-14T17:00:32,Vitoria-Gasteiz,Expense,transport,-54.54,-22595.39
buyer_6,Manuel,45,ES02209555428642879798,TRX_N-00323-09433022,2022-09-18T08:47:26,Vitoria-Gasteiz,Expense,cash,-100.0,-22695.39
buyer_6,Manuel,45,ES02209555428642879798,TRX_N-00324-01278702,2022-09-19T12:12:15,Vitoria-Gasteiz,Expense,food,-76.33,-22771.72
buyer_6,Manuel,45,ES02209555428642879798,TRX_N-00325-10862185,2022-09-22T19:11:22,Vitoria-Gasteiz,Expense,education,-71.59,-22843.31
buyer_6,Manuel,45,ES02209555428642879798,TRX_N-00326-88429909,2022-09-23T08:28:55,Vitoria-Gasteiz,Expense,education,-46.82,-22890.13
buyer_6,Manuel,45,ES02209555428642879798,TRX_N-00327-81052902,2022-09-23T15:35:42,Vitoria-Gasteiz,Expense,repairs,-112.46,-23002.59
buyer_6,Manuel,45,ES02209555428642879798,TRX_N-00328-62727419,2022-09-24T18:30:51,Vitoria-Gasteiz,Expense,cash,-100.0,-23102.59
buyer_6,Manuel,45,ES02209555428642879798,TRX_N-00329-58623393,2022-09-26T19:19:19,Vitoria-Gasteiz,Expense,food,-105.69,-23208.28
buyer_6,Manuel,45,ES02209555428642879798,TRX_N-00330-11631034,2022-09-26T14:28:30,Vitoria-Gasteiz,Expense,leisure,-57.13,-23265.41
buyer_6,Manuel,45,ES02209555428642879798,TRX_N-00331-99484532,2022-09-26T19:36:40,Amurrio,Expense,clothing,-48.39,-23313.8
buyer_6,Manuel,45,ES02209555428642879798,TRX_N-00332-02924619,2022-09-26T14:22:04,Mungia,Expense,repairs,-148.8,-23462.6
buyer_6,Manuel,45,ES02209555428642879798,TRX_N-00333-01201497,2022-09-26T17:52:34,Vitoria-Gasteiz,expenses,children,-259.62,-23722.22
buyer_6,Manuel,45,ES02209555428642879798,TRX_N-00334-44176077,2022-09-27T09:40:15,Vitoria-Gasteiz,Expense,food,-100.32,-23822.54
buyer_6,Manuel,45,ES02209555428642879798,TRX_N-00335-69934289,2022-09-28T17:27:57,Vitoria-Gasteiz,Expense,cash,-100.0,-23922.54
buyer_6,Manuel,45,ES02209555428642879798,TRX_N-00336-92977432,2022-09-29T13:16:32,Vitoria-Gasteiz,Expense,cash,-100.0,-24022.54
buyer_6,Manuel,45,ES02209555428642879798,TRX_N-00337-06544692,2022-10-01T08:20:07,Vitoria-Gasteiz,incomes,salary,1338.32,-22684.22
buyer_6,Manuel,45,ES02209555428642879798,TRX_N-00338-92690981,2022-10-01T08:20:07,Vitoria-Gasteiz,incomes,salary_partner,1297.2,-21387.02
buyer_6,Manuel,45,ES02209555428642879798,TRX_N-00339-92666821,2022-10-01T08:20:07,Vitoria-Gasteiz,incomes,extra_income,235.66,-21151.36
buyer_6,Manuel,45,ES02209555428642879798,TRX_N-00340-37035124,2022-10-03T12:08:33,Vitoria-Gasteiz,expenses,children,-63.52,-21214.88
buyer_6,Manuel,45,ES02209555428642879798,TRX_N-00341-18274483,2022-10-04T20:51:48,Vitoria-Gasteiz,expenses,mortgage,-998.07,-22212.95
buyer_6,Manuel,45,ES02209555428642879798,TRX_N-00342-91252728,2022-10-04T15:28:57,Vitoria-Gasteiz,Expense,leisure,-72.32,-22285.27
buyer_6,Manuel,45,ES02209555428642879798,TRX_N-00343-31100448,2022-10-04T12:17:15,Vitoria-Gasteiz,Expense,cash,-100.0,-22385.27
buyer_6,Manuel,45,ES02209555428642879798,TRX_N-00344-31331615,2022-10-05T10:00:03,Vitoria-Gasteiz,expenses,internet,-42.0,-22427.27
buyer_6,Manuel,45,ES02209555428642879798,TRX_N-00345-80410934,2022-10-05T09:54:03,Vitoria-Gasteiz,Expense,cash,-100.0,-22527.27
buyer_6,Manuel,45,ES02209555428642879798,TRX_N-00346-42428736,2022-10-06T13:24:34,Vitoria-Gasteiz,expenses,gas,-78.6,-22605.87
buyer_6,Manuel,45,ES02209555428642879798,TRX_N-00347-25275718,2022-10-06T12:52:39,Vitoria-Gasteiz,expenses,phone,-40.2,-22646.07
buyer_6,Manuel,45,ES02209555428642879798,TRX_N-00348-86584876,2022-10-06T16:15:00,Vitoria-Gasteiz,Expense,leisure,-19.32,-22665.39
buyer_6,Manuel,45,ES02209555428642879798,TRX_N-00349-58477723,2022-10-06T13:38:46,Vitoria-Gasteiz,Expense,education,-44.14,-22709.53
buyer_6,Manuel,45,ES02209555428642879798,TRX_N-00350-40668372,2022-10-06T12:13:54,Vitoria-Gasteiz,expenses,children,-94.2,-22803.73
buyer_6,Manuel,45,ES02209555428642879798,TRX_N-00351-66350744,2022-10-07T16:56:39,Vitoria-Gasteiz,Expense,food,-69.14,-22872.87
buyer_6,Manuel,45,ES02209555428642879798,TRX_N-00352-09363914,2022-10-07T09:36:01,Vitoria-Gasteiz,Expense,cash,-100.0,-22972.87
buyer_6,Manuel,45,ES02209555428642879798,TRX_N-00353-86110596,2022-10-08T11:11:57,Vitoria-Gasteiz,expenses,electricity,-83.33,-23056.2
buyer_6,Manuel,45,ES02209555428642879798,TRX_N-00354-86421440,2022-10-08T12:00:29,Vitoria-Gasteiz,expenses,water,-20.35,-23076.55
buyer_6,Manuel,45,ES02209555428642879798,TRX_N-00355-54788494,2022-10-08T08:41:17,Vitoria-Gasteiz,Expense,cash,-100.0,-23176.55
buyer_6,Manuel,45,ES02209555428642879798,TRX_N-00356-55460027,2022-10-09T12:26:27,Vitoria-Gasteiz,Expense,leisure,-59.05,-23235.6
buyer_6,Manuel,45,ES02209555428642879798,TRX_N-00357-11328987,2022-10-09T09:43:30,Vitoria-Gasteiz,Expense,healthcare,-145.41,-23381.01
buyer_6,Manuel,45,ES02209555428642879798,TRX_N-00358-71331144,2022-10-09T17:07:06,Vitoria-Gasteiz,Expense,cash,-100.0,-23481.01
buyer_6,Manuel,45,ES02209555428642879798,TRX_N-00359-84550065,2022-10-10T21:29:02,Bilbao,Expense,transport,-85.11,-23566.12
buyer_6,Manuel,45,ES02209555428642879798,TRX_N-00360-95816271,2022-10-10T18:43:51,Vitoria-Gasteiz,Expense,clothing,-156.44,-23722.56
buyer_6,Manuel,45,ES02209555428642879798,TRX_N-00361-89187040,2022-10-11T08:48:18,Oy√≥n-Oion,Expense,cash,-100.0,-23822.56
buyer_6,Manuel,45,ES02209555428642879798,TRX_N-00362-96179063,2022-10-11T18:57:12,Vitoria-Gasteiz,expenses,children,-200.83,-24023.39
buyer_6,Manuel,45,ES02209555428642879798,TRX_N-00363-15999826,2022-10-14T19:57:56,Zuia,Expense,food,-113.36,-24136.75
buyer_6,Manuel,45,ES02209555428642879798,TRX_N-00364-44889313,2022-10-14T08:03:30,Labastida,Expense,cash,-100.0,-24236.75
buyer_6,Manuel,45,ES02209555428642879798,TRX_N-00365-26816417,2022-10-15T01:04:25,Vitoria-Gasteiz,Expense,food,-62.52,-24299.27
buyer_6,Manuel,45,ES02209555428642879798,TRX_N-00366-01712307,2022-10-15T22:25:28,Getxo,Expense,repairs,-104.79,-24404.06
buyer_6,Manuel,45,ES02209555428642879798,TRX_N-00367-59106840,2022-10-17T18:01:45,Vitoria-Gasteiz,Expense,cash,-100.0,-24504.06
buyer_6,Manuel,45,ES02209555428642879798,TRX_N-00368-39263545,2022-10-17T13:38:57,Vitoria-Gasteiz,Expense,gifts,-254.5,-24758.56
buyer_6,Manuel,45,ES02209555428642879798,TRX_N-00369-65483668,2022-10-18T02:08:52,Vitoria-Gasteiz,Expense,cash,-100.0,-24858.56
buyer_6,Manuel,45,ES02209555428642879798,TRX_N-00370-91370258,2022-10-19T08:43:24,Vitoria-Gasteiz,Expense,cash,-100.0,-24958.56
buyer_6,Manuel,45,ES02209555428642879798,TRX_N-00371-63142161,2022-10-20T18:08:16,Vitoria-Gasteiz,Expense,food,-98.41,-25056.97
buyer_6,Manuel,45,ES02209555428642879798,TRX_N-00372-49280493,2022-10-21T13:04:53,Vitoria-Gasteiz,Expense,transport,-66.65,-25123.62
buyer_6,Manuel,45,ES02209555428642879798,TRX_N-00373-19332599,2022-10-21T12:18:08,Vitoria-Gasteiz,Expense,repairs,-182.87,-25306.49
buyer_6,Manuel,45,ES02209555428642879798,TRX_N-00374-74366620,2022-10-22T12:08:43,Vitoria-Gasteiz,Expense,cash,-100.0,-25406.49
buyer_6,Manuel,45,ES02209555428642879798,TRX_N-00375-05388094,2022-10-23T15:20:34,Sopela,Expense,food,-62.85,-25469.34
buyer_6,Manuel,45,ES02209555428642879798,TRX_N-00376-20649036,2022-10-24T17:59:41,Vitoria-Gasteiz,Expense,transport,-50.18,-25519.52
buyer_6,Manuel,45,ES02209555428642879798,TRX_N-00377-51193794,2022-10-25T09:56:38,Vitoria-Gasteiz,Expense,cash,-100.0,-25619.52
buyer_6,Manuel,45,ES02209555428642879798,TRX_N-00378-50916253,2022-10-28T22:03:02,Vitoria-Gasteiz,Expense,leisure,-49.41,-25668.93
buyer_6,Manuel,45,ES02209555428642879798,TRX_N-00379-24518001,2022-10-29T13:51:28,Elciego,Expense,cash,-100.0,-25768.93
buyer_6,Manuel,45,ES02209555428642879798,TRX_N-00380-64352262,2022-10-30T11:47:09,Vitoria-Gasteiz,Expense,cash,-100.0,-25868.93
buyer_6,Manuel,45,ES02209555428642879798,TRX_N-00381-36114770,2022-10-30T18:35:19,Vitoria-Gasteiz,Expense,repairs,-125.48,-25994.41
buyer_6,Manuel,45,ES02209555428642879798,TRX_N-00382-48863089,2022-11-01T10:54:16,Vitoria-Gasteiz,incomes,salary,1338.32,-24656.09
buyer_6,Manuel,45,ES02209555428642879798,TRX_N-00383-38831495,2022-11-01T10:54:16,Vitoria-Gasteiz,incomes,salary_partner,1297.2,-23358.89
buyer_6,Manuel,45,ES02209555428642879798,TRX_N-00384-95093230,2022-11-01T16:54:54,Vitoria-Gasteiz,Expense,repairs,-192.21,-23551.1
buyer_6,Manuel,45,ES02209555428642879798,TRX_N-00385-36022169,2022-11-01T13:06:32,Vitoria-Gasteiz,Expense,gifts,-234.96,-23786.06
buyer_6,Manuel,45,ES02209555428642879798,TRX_N-00386-52791021,2022-11-03T15:00:39,Vitoria-Gasteiz,Expense,leisure,-59.97,-23846.03
buyer_6,Manuel,45,ES02209555428642879798,TRX_N-00387-47838985,2022-11-04T17:55:31,Vitoria-Gasteiz,expenses,mortgage,-998.07,-24844.1
buyer_6,Manuel,45,ES02209555428642879798,TRX_N-00388-24838461,2022-11-04T09:34:41,Vitoria-Gasteiz,Expense,gifts,-386.17,-25230.27
buyer_6,Manuel,45,ES02209555428642879798,TRX_N-00389-01116725,2022-11-05T12:22:01,Vitoria-Gasteiz,expenses,internet,-42.0,-25272.27
buyer_6,Manuel,45,ES02209555428642879798,TRX_N-00390-04828136,2022-11-05T15:59:12,Arrasate,Expense,repairs,-315.02,-25587.29
buyer_6,Manuel,45,ES02209555428642879798,TRX_N-00391-90632073,2022-11-05T13:29:35,Vitoria-Gasteiz,expenses,children,-180.56,-25767.85
buyer_6,Manuel,45,ES02209555428642879798,TRX_N-00392-10904749,2022-11-06T20:46:02,Vitoria-Gasteiz,expenses,electricity,-26.23,-25794.08
buyer_6,Manuel,45,ES02209555428642879798,TRX_N-00393-95929133,2022-11-08T02:54:34,Vitoria-Gasteiz,expenses,water,-25.6,-25819.68
buyer_6,Manuel,45,ES02209555428642879798,TRX_N-00394-63504930,2022-11-08T09:54:08,Vitoria-Gasteiz,expenses,gas,-70.05,-25889.73
buyer_6,Manuel,45,ES02209555428642879798,TRX_N-00395-01143583,2022-11-08T13:42:04,Vitoria-Gasteiz,expenses,phone,-40.94,-25930.67
buyer_6,Manuel,45,ES02209555428642879798,TRX_N-00396-57703223,2022-11-08T13:18:56,Vitoria-Gasteiz,Expense,cash,-100.0,-26030.67
buyer_6,Manuel,45,ES02209555428642879798,TRX_N-00397-74177003,2022-11-11T08:55:12,Galdakao,Expense,transport,-71.12,-26101.79
buyer_6,Manuel,45,ES02209555428642879798,TRX_N-00398-91034926,2022-11-11T20:10:35,Vitoria-Gasteiz,Expense,leisure,-42.47,-26144.26
buyer_6,Manuel,45,ES02209555428642879798,TRX_N-00399-08175849,2022-11-11T00:30:05,Vitoria-Gasteiz,Expense,appliances,-182.81,-26327.07
buyer_6,Manuel,45,ES02209555428642879798,TRX_N-00400-85327062,2022-11-12T08:52:28,Alegr√≠a-Dulantzi,Expense,repairs,-260.93,-26588.0
buyer_6,Manuel,45,ES02209555428642879798,TRX_N-00401-30440833,2022-11-14T19:21:02,Vitoria-Gasteiz,Expense,food,-112.8,-26700.8
buyer_6,Manuel,45,ES02209555428642879798,TRX_N-00402-35570521,2022-11-19T09:59:35,Vitoria-Gasteiz,Expense,cash,-100.0,-26800.8
buyer_6,Manuel,45,ES02209555428642879798,TRX_N-00403-26585551,2022-11-21T09:47:44,Vitoria-Gasteiz,Expense,leisure,-66.57,-26867.37
buyer_6,Manuel,45,ES02209555428642879798,TRX_N-00404-14617157,2022-11-22T06:53:02,Vitoria-Gasteiz,Expense,leisure,-68.57,-26935.94
buyer_6,Manuel,45,ES02209555428642879798,TRX_N-00405-44979894,2022-11-23T15:42:21,Vitoria-Gasteiz,Expense,leisure,-24.63,-26960.57
buyer_6,Manuel,45,ES02209555428642879798,TRX_N-00406-84839800,2022-11-24T19:11:31,Vitoria-Gasteiz,Expense,cash,-100.0,-27060.57
buyer_6,Manuel,45,ES02209555428642879798,TRX_N-00407-24397468,2022-11-25T14:07:52,Andoain,Expense,food,-120.66,-27181.23
buyer_6,Manuel,45,ES02209555428642879798,TRX_N-00408-52167391,2022-11-25T08:33:41,Galdakao,Expense,clothing,-91.65,-27272.88
buyer_6,Manuel,45,ES02209555428642879798,TRX_N-00409-61183457,2022-11-25T15:51:25,Vitoria-Gasteiz,Expense,appliances,-186.7,-27459.58
buyer_6,Manuel,45,ES02209555428642879798,TRX_N-00410-65549027,2022-11-28T09:27:57,Vitoria-Gasteiz,Expense,leisure,-64.96,-27524.54
buyer_6,Manuel,45,ES02209555428642879798,TRX_N-00411-63739496,2022-11-28T18:11:00,Vitoria-Gasteiz,Expense,healthcare,-173.65,-27698.19
buyer_6,Manuel,45,ES02209555428642879798,TRX_N-00412-63728830,2022-11-30T08:43:55,Vitoria-Gasteiz,Expense,leisure,-43.3,-27741.49
buyer_6,Manuel,45,ES02209555428642879798,TRX_N-00413-38102570,2022-11-30T19:02:36,Arrasate,Expense,cash,-100.0,-27841.49
buyer_6,Manuel,45,ES02209555428642879798,TRX_N-00414-49652768,2022-12-01T12:26:46,Vitoria-Gasteiz,incomes,salary,1338.32,-26503.17
buyer_6,Manuel,45,ES02209555428642879798,TRX_N-00415-40436309,2022-12-01T12:26:46,Vitoria-Gasteiz,incomes,salary_partner,1297.2,-25205.97
buyer_6,Manuel,45,ES02209555428642879798,TRX_N-00416-33804257,2022-12-01T12:26:46,Vitoria-Gasteiz,incomes,salary_bonus,942.25,-24263.72
buyer_6,Manuel,45,ES02209555428642879798,TRX_N-00417-32164653,2022-12-01T12:26:46,Vitoria-Gasteiz,incomes,salary_partner_bonus,1022.76,-23240.96
buyer_6,Manuel,45,ES02209555428642879798,TRX_N-00418-03407851,2022-12-03T15:31:32,Basauri,Expense,leisure,-24.84,-23265.8
buyer_6,Manuel,45,ES02209555428642879798,TRX_N-00419-82030922,2022-12-03T13:20:29,Vitoria-Gasteiz,Expense,clothing,-45.64,-23311.44
buyer_6,Manuel,45,ES02209555428642879798,TRX_N-00420-21324879,2022-12-03T02:53:27,Donostia,Expense,cash,-100.0,-23411.44
buyer_6,Manuel,45,ES02209555428642879798,TRX_N-00421-80208443,2022-12-04T09:19:53,Vitoria-Gasteiz,expenses,mortgage,-998.07,-24409.51
buyer_6,Manuel,45,ES02209555428642879798,TRX_N-00422-70870302,2022-12-05T23:31:04,Vitoria-Gasteiz,expenses,phone,-40.84,-24450.35
buyer_6,Manuel,45,ES02209555428642879798,TRX_N-00423-99053225,2022-12-06T10:20:16,Pasaia,Expense,repairs,-267.98,-24718.33
buyer_6,Manuel,45,ES02209555428642879798,TRX_N-00424-21282264,2022-12-07T07:34:26,Vitoria-Gasteiz,expenses,internet,-42.0,-24760.33
buyer_6,Manuel,45,ES02209555428642879798,TRX_N-00425-63407838,2022-12-07T10:00:46,Vitoria-Gasteiz,Expense,leisure,-31.89,-24792.22
buyer_6,Manuel,45,ES02209555428642879798,TRX_N-00426-97933115,2022-12-07T11:05:48,Vitoria-Gasteiz,Expense,education,-71.49,-24863.71
buyer_6,Manuel,45,ES02209555428642879798,TRX_N-00427-59036290,2022-12-08T09:43:08,Vitoria-Gasteiz,expenses,electricity,-80.17,-24943.88
buyer_6,Manuel,45,ES02209555428642879798,TRX_N-00428-63478838,2022-12-08T18:45:18,Vitoria-Gasteiz,expenses,water,-37.49,-24981.37
buyer_6,Manuel,45,ES02209555428642879798,TRX_N-00429-34280893,2022-12-08T17:47:55,Vitoria-Gasteiz,expenses,gas,-67.81,-25049.18
buyer_6,Manuel,45,ES02209555428642879798,TRX_N-00430-62850341,2022-12-08T19:55:53,Vitoria-Gasteiz,Expense,transport,-83.68,-25132.86
buyer_6,Manuel,45,ES02209555428642879798,TRX_N-00431-43455696,2022-12-08T09:29:04,Vitoria-Gasteiz,Expense,cash,-100.0,-25232.86
buyer_6,Manuel,45,ES02209555428642879798,TRX_N-00432-63554932,2022-12-09T11:51:17,Vitoria-Gasteiz,Expense,leisure,-26.03,-25258.89
buyer_6,Manuel,45,ES02209555428642879798,TRX_N-00433-62160657,2022-12-10T20:22:08,Vitoria-Gasteiz,Expense,cash,-100.0,-25358.89
buyer_6,Manuel,45,ES02209555428642879798,TRX_N-00434-56716894,2022-12-11T15:44:53,Vitoria-Gasteiz,Expense,clothing,-69.54,-25428.43
buyer_6,Manuel,45,ES02209555428642879798,TRX_N-00435-96464264,2022-12-11T06:11:45,Vitoria-Gasteiz,Expense,repairs,-296.08,-25724.51
buyer_6,Manuel,45,ES02209555428642879798,TRX_N-00436-99404840,2022-12-12T08:02:45,Vitoria-Gasteiz,Expense,cash,-100.0,-25824.51
buyer_6,Manuel,45,ES02209555428642879798,TRX_N-00437-17406231,2022-12-13T19:29:07,Vitoria-Gasteiz,Expense,clothing,-75.95,-25900.46
buyer_6,Manuel,45,ES02209555428642879798,TRX_N-00438-87061856,2022-12-14T15:06:40,Vitoria-Gasteiz,Expense,cash,-100.0,-26000.46
buyer_6,Manuel,45,ES02209555428642879798,TRX_N-00439-20026697,2022-12-21T12:45:11,Arrasate,Expense,cash,-100.0,-26100.46
buyer_6,Manuel,45,ES02209555428642879798,TRX_N-00440-63129910,2022-12-22T11:52:54,Vitoria-Gasteiz,Expense,food,-123.31,-26223.77
buyer_6,Manuel,45,ES02209555428642879798,TRX_N-00441-14731197,2022-12-23T23:12:32,Vitoria-Gasteiz,Expense,education,-59.7,-26283.47
buyer_6,Manuel,45,ES02209555428642879798,TRX_N-00442-29969792,2022-12-23T14:49:30,Vitoria-Gasteiz,expenses,children,-204.33,-26487.8
buyer_6,Manuel,45,ES02209555428642879798,TRX_N-00443-48634343,2022-12-24T14:47:52,Vitoria-Gasteiz,Expense,cash,-100.0,-26587.8
buyer_6,Manuel,45,ES02209555428642879798,TRX_N-00444-74576082,2022-12-25T18:50:33,Amurrio,Expense,gifts,-743.89,-27331.69
buyer_6,Manuel,45,ES02209555428642879798,TRX_N-00445-96103707,2022-12-26T10:14:29,Leioa,Expense,food,-61.49,-27393.18
buyer_6,Manuel,45,ES02209555428642879798,TRX_N-00446-25627164,2023-01-01T11:31:38,Vitoria-Gasteiz,incomes,salary,1387.48,-26005.7
buyer_6,Manuel,45,ES02209555428642879798,TRX_N-00447-11992964,2023-01-01T11:31:38,Vitoria-Gasteiz,incomes,salary_partner,1344.84,-24660.86
buyer_6,Manuel,45,ES02209555428642879798,TRX_N-00448-69741107,2023-01-03T14:59:41,Vitoria-Gasteiz,Expense,leisure,-64.05,-24724.91
buyer_6,Manuel,45,ES02209555428642879798,TRX_N-00449-90893492,2023-01-03T07:00:40,Vitoria-Gasteiz,Expense,repairs,-297.58,-25022.49
buyer_6,Manuel,45,ES02209555428642879798,TRX_N-00450-88699577,2023-01-04T08:36:43,Vitoria-Gasteiz,expenses,mortgage,-998.07,-26020.56
buyer_6,Manuel,45,ES02209555428642879798,TRX_N-00451-50394990,2023-01-05T10:05:37,Vitoria-Gasteiz,expenses,water,-25.16,-26045.72
buyer_6,Manuel,45,ES02209555428642879798,TRX_N-00452-84948599,2023-01-05T20:43:48,Vitoria-Gasteiz,expenses,gas,-67.02,-26112.74
buyer_6,Manuel,45,ES02209555428642879798,TRX_N-00453-67462670,2023-01-05T13:05:18,Vitoria-Gasteiz,expenses,phone,-34.65,-26147.39
buyer_6,Manuel,45,ES02209555428642879798,TRX_N-00454-11663571,2023-01-06T13:01:12,Vitoria-Gasteiz,expenses,internet,-42.0,-26189.39
buyer_6,Manuel,45,ES02209555428642879798,TRX_N-00455-93358782,2023-01-06T11:12:56,Vitoria-Gasteiz,Expense,leisure,-34.43,-26223.82
buyer_6,Manuel,45,ES02209555428642879798,TRX_N-00456-67541472,2023-01-07T10:18:58,Vitoria-Gasteiz,expenses,electricity,-85.42,-26309.24
buyer_6,Manuel,45,ES02209555428642879798,TRX_N-00457-79731195,2023-01-07T20:34:33,Vitoria-Gasteiz,Expense,cash,-100.0,-26409.24
buyer_6,Manuel,45,ES02209555428642879798,TRX_N-00458-25173782,2023-01-11T12:47:27,Vitoria-Gasteiz,Expense,clothing,-70.51,-26479.75
buyer_6,Manuel,45,ES02209555428642879798,TRX_N-00459-71011165,2023-01-11T08:09:55,Vitoria-Gasteiz,Expense,cash,-100.0,-26579.75
buyer_6,Manuel,45,ES02209555428642879798,TRX_N-00460-81388620,2023-01-13T19:56:26,Salvatierra/Agurain,Expense,repairs,-238.57,-26818.32
buyer_6,Manuel,45,ES02209555428642879798,TRX_N-00461-27779668,2023-01-16T20:16:07,Vitoria-Gasteiz,Expense,cash,-100.0,-26918.32
buyer_6,Manuel,45,ES02209555428642879798,TRX_N-00462-14379540,2023-01-17T20:00:18,Vitoria-Gasteiz,Expense,food,-117.43,-27035.75
buyer_6,Manuel,45,ES02209555428642879798,TRX_N-00463-16489687,2023-01-19T08:19:19,Vitoria-Gasteiz,Expense,food,-71.11,-27106.86
buyer_6,Manuel,45,ES02209555428642879798,TRX_N-00464-05786754,2023-01-20T19:22:14,Vitoria-Gasteiz,Expense,food,-70.07,-27176.93
buyer_6,Manuel,45,ES02209555428642879798,TRX_N-00465-86949234,2023-01-22T00:48:47,Vitoria-Gasteiz,Expense,food,-109.06,-27285.99
buyer_6,Manuel,45,ES02209555428642879798,TRX_N-00466-22555866,2023-01-23T13:40:03,Vitoria-Gasteiz,Expense,healthcare,-106.99,-27392.98
buyer_6,Manuel,45,ES02209555428642879798,TRX_N-00467-18105028,2023-01-24T12:10:34,Vitoria-Gasteiz,Expense,cash,-100.0,-27492.98
buyer_6,Manuel,45,ES02209555428642879798,TRX_N-00468-28145328,2023-01-25T18:49:05,Vitoria-Gasteiz,Expense,transport,-60.14,-27553.12
buyer_6,Manuel,45,ES02209555428642879798,TRX_N-00469-85426923,2023-01-25T18:53:36,Vitoria-Gasteiz,Expense,cash,-100.0,-27653.12
buyer_6,Manuel,45,ES02209555428642879798,TRX_N-00470-07212611,2023-01-28T12:27:24,Iru√±a de Oca,Expense,cash,-100.0,-27753.12
buyer_6,Manuel,45,ES02209555428642879798,TRX_N-00471-98317906,2023-01-29T15:03:48,Labastida,Expense,healthcare,-138.92,-27892.04
buyer_6,Manuel,45,ES02209555428642879798,TRX_N-00472-23294329,2023-01-31T16:20:52,Vitoria-Gasteiz,Expense,food,-74.97,-27967.01
buyer_6,Manuel,45,ES02209555428642879798,TRX_N-00473-44708273,2023-02-01T20:14:52,Vitoria-Gasteiz,incomes,salary,1387.48,-26579.53
buyer_6,Manuel,45,ES02209555428642879798,TRX_N-00474-80973106,2023-02-01T20:14:52,Vitoria-Gasteiz,incomes,salary_partner,1344.84,-25234.69
buyer_6,Manuel,45,ES02209555428642879798,TRX_N-00475-31621587,2023-02-01T20:14:52,Vitoria-Gasteiz,incomes,extra_income,235.66,-24999.03
buyer_6,Manuel,45,ES02209555428642879798,TRX_N-00476-62371316,2023-02-01T11:28:28,Vitoria-Gasteiz,Expense,leisure,-80.88,-25079.91
buyer_6,Manuel,45,ES02209555428642879798,TRX_N-00477-69252723,2023-02-02T00:56:41,Vitoria-Gasteiz,Expense,food,-63.55,-25143.46
buyer_6,Manuel,45,ES02209555428642879798,TRX_N-00478-43917426,2023-02-02T20:04:42,Vitoria-Gasteiz,expenses,children,-113.15,-25256.61
buyer_6,Manuel,45,ES02209555428642879798,TRX_N-00479-01044179,2023-02-03T20:44:52,Vitoria-Gasteiz,Expense,cash,-100.0,-25356.61
buyer_6,Manuel,45,ES02209555428642879798,TRX_N-00480-05235538,2023-02-04T00:16:51,Vitoria-Gasteiz,expenses,mortgage,-998.07,-26354.68
buyer_6,Manuel,45,ES02209555428642879798,TRX_N-00481-84977476,2023-02-05T10:26:57,Vitoria-Gasteiz,expenses,water,-25.12,-26379.8
buyer_6,Manuel,45,ES02209555428642879798,TRX_N-00482-04952318,2023-02-05T12:14:26,Vitoria-Gasteiz,expenses,electricity,-83.46,-26463.26
buyer_6,Manuel,45,ES02209555428642879798,TRX_N-00483-05801042,2023-02-05T21:54:20,Vitoria-Gasteiz,expenses,gas,-71.43,-26534.69
buyer_6,Manuel,45,ES02209555428642879798,TRX_N-00484-06104984,2023-02-05T20:14:56,Vitoria-Gasteiz,expenses,phone,-35.31,-26570.0
buyer_6,Manuel,45,ES02209555428642879798,TRX_N-00485-47405973,2023-02-05T17:22:33,Vitoria-Gasteiz,Expense,food,-121.53,-26691.53
buyer_6,Manuel,45,ES02209555428642879798,TRX_N-00486-84693971,2023-02-05T08:38:53,Vitoria-Gasteiz,Expense,clothing,-125.88,-26817.41
buyer_6,Manuel,45,ES02209555428642879798,TRX_N-00487-92967316,2023-02-05T11:20:50,Vitoria-Gasteiz,Expense,cash,-100.0,-26917.41
buyer_6,Manuel,45,ES02209555428642879798,TRX_N-00488-13777231,2023-02-06T20:22:45,Vitoria-Gasteiz,Expense,cash,-100.0,-27017.41
buyer_6,Manuel,45,ES02209555428642879798,TRX_N-00489-86944984,2023-02-06T20:51:39,Vitoria-Gasteiz,Expense,repairs,-117.45,-27134.86
buyer_6,Manuel,45,ES02209555428642879798,TRX_N-00490-62671696,2023-02-07T11:29:52,Vitoria-Gasteiz,expenses,internet,-42.0,-27176.86
buyer_6,Manuel,45,ES02209555428642879798,TRX_N-00491-48177140,2023-02-07T16:02:58,Hondarribia,Expense,food,-112.88,-27289.74
buyer_6,Manuel,45,ES02209555428642879798,TRX_N-00492-92090821,2023-02-07T22:04:16,Vitoria-Gasteiz,Expense,cash,-100.0,-27389.74
buyer_6,Manuel,45,ES02209555428642879798,TRX_N-00493-20080742,2023-02-08T18:42:24,Vitoria-Gasteiz,Expense,transport,-49.45,-27439.19
buyer_6,Manuel,45,ES02209555428642879798,TRX_N-00494-64557387,2023-02-10T11:20:20,Sopela,Expense,food,-68.8,-27507.99
buyer_6,Manuel,45,ES02209555428642879798,TRX_N-00495-30136930,2023-02-10T08:44:28,Vitoria-Gasteiz,Expense,clothing,-155.98,-27663.97
buyer_6,Manuel,45,ES02209555428642879798,TRX_N-00496-72850766,2023-02-11T19:22:17,Llodio,Expense,food,-72.65,-27736.62
buyer_6,Manuel,45,ES02209555428642879798,TRX_N-00497-19628021,2023-02-11T00:35:21,Vitoria-Gasteiz,Expense,leisure,-77.01,-27813.63
buyer_6,Manuel,45,ES02209555428642879798,TRX_N-00498-78752626,2023-02-11T17:32:59,Vitoria-Gasteiz,Expense,cash,-100.0,-27913.63
buyer_6,Manuel,45,ES02209555428642879798,TRX_N-00499-14877661,2023-02-13T11:21:12,Vitoria-Gasteiz,Expense,healthcare,-46.31,-27959.94
buyer_6,Manuel,45,ES02209555428642879798,TRX_N-00500-39719930,2023-02-13T16:02:34,Vitoria-Gasteiz,Expense,cash,-100.0,-28059.94
buyer_6,Manuel,45,ES02209555428642879798,TRX_N-00501-69692732,2023-02-14T15:50:49,Vitoria-Gasteiz,Expense,leisure,-29.83,-28089.77
buyer_6,Manuel,45,ES02209555428642879798,TRX_N-00502-99836175,2023-02-14T15:44:15,Vitoria-Gasteiz,Expense,repairs,-119.14,-28208.91
buyer_6,Manuel,45,ES02209555428642879798,TRX_N-00503-12595089,2023-02-15T15:55:49,Vitoria-Gasteiz,Expense,transport,-53.91,-28262.82
buyer_6,Manuel,45,ES02209555428642879798,TRX_N-00504-06550457,2023-02-16T11:14:46,Vitoria-Gasteiz,Expense,gifts,-217.85,-28480.67
buyer_6,Manuel,45,ES02209555428642879798,TRX_N-00505-26745190,2023-02-18T18:25:25,Vitoria-Gasteiz,Expense,transport,-50.98,-28531.65
buyer_6,Manuel,45,ES02209555428642879798,TRX_N-00506-49022239,2023-02-19T13:00:14,Vitoria-Gasteiz,Expense,transport,-85.29,-28616.94
buyer_6,Manuel,45,ES02209555428642879798,TRX_N-00507-17484621,2023-02-19T08:24:59,Durango,Expense,cash,-100.0,-28716.94
buyer_6,Manuel,45,ES02209555428642879798,TRX_N-00508-39646824,2023-02-21T17:17:18,Vitoria-Gasteiz,Expense,clothing,-130.4,-28847.34
buyer_6,Manuel,45,ES02209555428642879798,TRX_N-00509-16237326,2023-02-22T15:08:08,Vitoria-Gasteiz,Expense,cash,-100.0,-28947.34
buyer_6,Manuel,45,ES02209555428642879798,TRX_N-00510-96148616,2023-02-23T19:40:57,Getxo,Expense,cash,-100.0,-29047.34
buyer_6,Manuel,45,ES02209555428642879798,TRX_N-00511-40964783,2023-02-26T03:42:16,Bilbao,Expense,food,-84.04,-29131.38
buyer_6,Manuel,45,ES02209555428642879798,TRX_N-00512-72401388,2023-02-26T11:22:24,Vitoria-Gasteiz,Expense,transport,-79.63,-29211.01
buyer_6,Manuel,45,ES02209555428642879798,TRX_N-00513-23746187,2023-02-26T15:22:46,Vitoria-Gasteiz,Expense,cash,-100.0,-29311.01
buyer_6,Manuel,45,ES02209555428642879798,TRX_N-00514-07024498,2023-03-01T20:17:44,Vitoria-Gasteiz,incomes,salary,1387.48,-27923.53
buyer_6,Manuel,45,ES02209555428642879798,TRX_N-00515-37947533,2023-03-01T20:17:44,Vitoria-Gasteiz,incomes,salary_partner,1344.84,-26578.69
buyer_6,Manuel,45,ES02209555428642879798,TRX_N-00516-55001952,2023-03-01T10:49:18,Vitoria-Gasteiz,Expense,repairs,-56.32,-26635.01
buyer_6,Manuel,45,ES02209555428642879798,TRX_N-00517-33347956,2023-03-02T08:42:27,Vitoria-Gasteiz,Expense,food,-70.59,-26705.6
buyer_6,Manuel,45,ES02209555428642879798,TRX_N-00518-38315732,2023-03-03T14:01:36,Vitoria-Gasteiz,Expense,food,-88.26,-26793.86
buyer_6,Manuel,45,ES02209555428642879798,TRX_N-00519-84371600,2023-03-04T13:59:49,Vitoria-Gasteiz,expenses,mortgage,-998.07,-27791.93
buyer_6,Manuel,45,ES02209555428642879798,TRX_N-00520-05842803,2023-03-05T08:11:15,Vitoria-Gasteiz,expenses,water,-37.66,-27829.59
buyer_6,Manuel,45,ES02209555428642879798,TRX_N-00521-71262576,2023-03-05T17:57:32,Vitoria-Gasteiz,expenses,phone,-38.0,-27867.59
buyer_6,Manuel,45,ES02209555428642879798,TRX_N-00522-13173723,2023-03-06T16:38:51,Vitoria-Gasteiz,expenses,gas,-49.95,-27917.54
buyer_6,Manuel,45,ES02209555428642879798,TRX_N-00523-97533809,2023-03-06T11:50:52,Vitoria-Gasteiz,Expense,leisure,-20.45,-27937.99
buyer_6,Manuel,45,ES02209555428642879798,TRX_N-00524-85266020,2023-03-07T18:48:37,Vitoria-Gasteiz,expenses,internet,-42.0,-27979.99
buyer_6,Manuel,45,ES02209555428642879798,TRX_N-00525-87373290,2023-03-07T17:34:40,Portugalete,Expense,cash,-100.0,-28079.99
buyer_6,Manuel,45,ES02209555428642879798,TRX_N-00526-92656198,2023-03-08T20:36:10,Vitoria-Gasteiz,expenses,electricity,-34.25,-28114.24
buyer_6,Manuel,45,ES02209555428642879798,TRX_N-00527-64437849,2023-03-09T02:45:07,Vitoria-Gasteiz,Expense,cash,-100.0,-28214.24
buyer_6,Manuel,45,ES02209555428642879798,TRX_N-00528-92379330,2023-03-12T20:07:54,Vitoria-Gasteiz,Expense,food,-117.93,-28332.17
buyer_6,Manuel,45,ES02209555428642879798,TRX_N-00529-15887396,2023-03-12T05:30:36,Vitoria-Gasteiz,Expense,transport,-60.64,-28392.81
buyer_6,Manuel,45,ES02209555428642879798,TRX_N-00530-42922462,2023-03-12T12:19:33,Vitoria-Gasteiz,Expense,leisure,-20.35,-28413.16
buyer_6,Manuel,45,ES02209555428642879798,TRX_N-00531-76125942,2023-03-12T20:23:35,Vitoria-Gasteiz,Expense,cash,-100.0,-28513.16
buyer_6,Manuel,45,ES02209555428642879798,TRX_N-00532-22275716,2023-03-15T17:03:11,Irun,Expense,transport,-72.65,-28585.81
buyer_6,Manuel,45,ES02209555428642879798,TRX_N-00533-96166244,2023-03-15T20:18:35,Vitoria-Gasteiz,Expense,clothing,-85.36,-28671.17
buyer_6,Manuel,45,ES02209555428642879798,TRX_N-00534-20959100,2023-03-16T02:21:10,Vitoria-Gasteiz,Expense,gifts,-239.89,-28911.06
buyer_6,Manuel,45,ES02209555428642879798,TRX_N-00535-15738470,2023-03-17T23:11:37,Vitoria-Gasteiz,Expense,food,-124.38,-29035.44
buyer_6,Manuel,45,ES02209555428642879798,TRX_N-00536-05279878,2023-03-18T16:56:13,Vitoria-Gasteiz,Expense,cash,-100.0,-29135.44
buyer_6,Manuel,45,ES02209555428642879798,TRX_N-00537-52583098,2023-03-19T16:21:03,Vitoria-Gasteiz,Expense,cash,-100.0,-29235.44
buyer_6,Manuel,45,ES02209555428642879798,TRX_N-00538-06018151,2023-03-19T11:44:31,Vitoria-Gasteiz,Expense,repairs,-80.84,-29316.28
buyer_6,Manuel,45,ES02209555428642879798,TRX_N-00539-95521922,2023-03-20T01:07:44,Vitoria-Gasteiz,Expense,appliances,-115.41,-29431.69
buyer_6,Manuel,45,ES02209555428642879798,TRX_N-00540-37805466,2023-03-21T17:42:32,Vitoria-Gasteiz,Expense,food,-96.3,-29527.99
buyer_6,Manuel,45,ES02209555428642879798,TRX_N-00541-31017036,2023-03-21T13:02:36,Galdakao,Expense,cash,-100.0,-29627.99
buyer_6,Manuel,45,ES02209555428642879798,TRX_N-00542-06895004,2023-03-21T04:57:21,Vitoria-Gasteiz,expenses,children,-73.57,-29701.56
buyer_6,Manuel,45,ES02209555428642879798,TRX_N-00543-21033132,2023-03-22T06:04:35,Vitoria-Gasteiz,Expense,repairs,-93.73,-29795.29
buyer_6,Manuel,45,ES02209555428642879798,TRX_N-00544-44595817,2023-03-25T08:09:02,Vitoria-Gasteiz,expenses,children,-222.64,-30017.93
buyer_6,Manuel,45,ES02209555428642879798,TRX_N-00545-65100425,2023-03-26T11:08:19,Vitoria-Gasteiz,Expense,leisure,-69.73,-30087.66
buyer_6,Manuel,45,ES02209555428642879798,TRX_N-00546-16254900,2023-03-28T16:14:45,Portugalete,Expense,travel,-639.69,-30727.35
buyer_6,Manuel,45,ES02209555428642879798,TRX_N-00547-65803664,2023-03-28T09:35:37,Vitoria-Gasteiz,expenses,children,-223.24,-30950.59
buyer_6,Manuel,45,ES02209555428642879798,TRX_N-00548-12156713,2023-03-29T21:15:25,Vitoria-Gasteiz,Expense,leisure,-75.16,-31025.75
buyer_6,Manuel,45,ES02209555428642879798,TRX_N-00549-65701863,2023-03-31T10:03:58,Bilbao,Expense,transport,-88.72,-31114.47
buyer_6,Manuel,45,ES02209555428642879798,TRX_N-00550-67375482,2023-03-31T15:17:14,Vitoria-Gasteiz,Expense,leisure,-26.46,-31140.93
buyer_6,Manuel,45,ES02209555428642879798,TRX_N-00551-55006077,2023-04-01T16:15:13,Vitoria-Gasteiz,incomes,salary,1387.48,-29753.45
buyer_6,Manuel,45,ES02209555428642879798,TRX_N-00552-68127171,2023-04-01T16:15:13,Vitoria-Gasteiz,incomes,salary_partner,1344.84,-28408.61
buyer_6,Manuel,45,ES02209555428642879798,TRX_N-00553-68697245,2023-04-01T15:20:09,Vitoria-Gasteiz,Expense,clothing,-86.0,-28494.61
buyer_6,Manuel,45,ES02209555428642879798,TRX_N-00554-92814240,2023-04-02T20:27:31,Sopela,Expense,food,-101.37,-28595.98
buyer_6,Manuel,45,ES02209555428642879798,TRX_N-00555-19799638,2023-04-04T21:01:14,Vitoria-Gasteiz,expenses,mortgage,-998.07,-29594.05
buyer_6,Manuel,45,ES02209555428642879798,TRX_N-00556-23175002,2023-04-04T20:38:33,Vitoria-Gasteiz,Expense,food,-119.9,-29713.95
buyer_6,Manuel,45,ES02209555428642879798,TRX_N-00557-93415201,2023-04-05T09:22:25,Vitoria-Gasteiz,Expense,repairs,-203.77,-29917.72
buyer_6,Manuel,45,ES02209555428642879798,TRX_N-00558-14330869,2023-04-06T10:34:45,Vitoria-Gasteiz,expenses,phone,-30.05,-29947.77
buyer_6,Manuel,45,ES02209555428642879798,TRX_N-00559-35042648,2023-04-07T11:49:49,Vitoria-Gasteiz,expenses,water,-32.4,-29980.17
buyer_6,Manuel,45,ES02209555428642879798,TRX_N-00560-13862410,2023-04-08T10:25:17,Vitoria-Gasteiz,expenses,internet,-42.0,-30022.17
buyer_6,Manuel,45,ES02209555428642879798,TRX_N-00561-37683078,2023-04-08T11:06:26,Vitoria-Gasteiz,expenses,electricity,-72.5,-30094.67
buyer_6,Manuel,45,ES02209555428642879798,TRX_N-00562-75346595,2023-04-08T20:31:14,Vitoria-Gasteiz,expenses,gas,-107.05,-30201.72
buyer_6,Manuel,45,ES02209555428642879798,TRX_N-00563-62688269,2023-04-09T10:39:49,Vitoria-Gasteiz,Expense,transport,-77.38,-30279.1
buyer_6,Manuel,45,ES02209555428642879798,TRX_N-00564-16045639,2023-04-10T16:16:03,Vitoria-Gasteiz,expenses,children,-169.92,-30449.02
buyer_6,Manuel,45,ES02209555428642879798,TRX_N-00565-26697142,2023-04-14T09:42:45,Vitoria-Gasteiz,Expense,repairs,-180.71,-30629.73
buyer_6,Manuel,45,ES02209555428642879798,TRX_N-00566-76267727,2023-04-15T10:37:49,Vitoria-Gasteiz,Expense,clothing,-64.19,-30693.92
buyer_6,Manuel,45,ES02209555428642879798,TRX_N-00567-66656114,2023-04-15T12:50:26,Vitoria-Gasteiz,Expense,cash,-100.0,-30793.92
buyer_6,Manuel,45,ES02209555428642879798,TRX_N-00568-10386572,2023-04-16T18:17:39,Vitoria-Gasteiz,Expense,cash,-100.0,-30893.92
buyer_6,Manuel,45,ES02209555428642879798,TRX_N-00569-91598901,2023-04-18T13:35:09,Galdakao,Expense,food,-120.01,-31013.93
buyer_6,Manuel,45,ES02209555428642879798,TRX_N-00570-47823537,2023-04-20T16:59:53,Vitoria-Gasteiz,Expense,leisure,-78.89,-31092.82
buyer_6,Manuel,45,ES02209555428642879798,TRX_N-00571-52296620,2023-04-20T01:27:17,Vitoria-Gasteiz,Expense,cash,-100.0,-31192.82
buyer_6,Manuel,45,ES02209555428642879798,TRX_N-00572-65433295,2023-04-21T21:24:02,Vitoria-Gasteiz,Expense,cash,-100.0,-31292.82
buyer_6,Manuel,45,ES02209555428642879798,TRX_N-00573-74034204,2023-04-21T10:25:16,Vitoria-Gasteiz,Expense,repairs,-261.32,-31554.14
buyer_6,Manuel,45,ES02209555428642879798,TRX_N-00574-78934027,2023-04-23T12:24:00,Vitoria-Gasteiz,Expense,transport,-75.92,-31630.06
buyer_6,Manuel,45,ES02209555428642879798,TRX_N-00575-25067027,2023-04-23T11:31:50,Vitoria-Gasteiz,Expense,repairs,-218.97,-31849.03
buyer_6,Manuel,45,ES02209555428642879798,TRX_N-00576-38403448,2023-04-24T17:18:34,Vitoria-Gasteiz,Expense,food,-81.42,-31930.45
buyer_6,Manuel,45,ES02209555428642879798,TRX_N-00577-79115182,2023-04-24T23:52:53,Vitoria-Gasteiz,Expense,leisure,-44.42,-31974.87
buyer_6,Manuel,45,ES02209555428642879798,TRX_N-00578-91828703,2023-04-24T06:58:14,Vitoria-Gasteiz,Expense,appliances,-265.99,-32240.86
buyer_6,Manuel,45,ES02209555428642879798,TRX_N-00579-60953028,2023-04-25T08:39:47,Vitoria-Gasteiz,Expense,clothing,-71.33,-32312.19
buyer_6,Manuel,45,ES02209555428642879798,TRX_N-00580-21553607,2023-04-26T18:08:04,Vitoria-Gasteiz,Expense,transport,-58.64,-32370.83
buyer_6,Manuel,45,ES02209555428642879798,TRX_N-00581-06084370,2023-04-27T12:00:39,Vitoria-Gasteiz,Expense,transport,-76.52,-32447.35
buyer_6,Manuel,45,ES02209555428642879798,TRX_N-00582-10651330,2023-04-28T16:47:33,Portugalete,Expense,transport,-89.22,-32536.57
buyer_6,Manuel,45,ES02209555428642879798,TRX_N-00583-35850392,2023-04-29T06:13:34,Vitoria-Gasteiz,Expense,transport,-82.29,-32618.86
buyer_6,Manuel,45,ES02209555428642879798,TRX_N-00584-30354607,2023-05-01T16:26:20,Vitoria-Gasteiz,incomes,salary,1387.48,-31231.38
buyer_6,Manuel,45,ES02209555428642879798,TRX_N-00585-64413194,2023-05-01T16:26:20,Vitoria-Gasteiz,incomes,salary_partner,1344.84,-29886.54
buyer_6,Manuel,45,ES02209555428642879798,TRX_N-00586-42747920,2023-05-02T21:32:04,Vitoria-Gasteiz,Expense,transport,-79.3,-29965.84
buyer_6,Manuel,45,ES02209555428642879798,TRX_N-00587-68626192,2023-05-02T15:18:34,Sopela,Expense,gifts,-335.14,-30300.98
buyer_6,Manuel,45,ES02209555428642879798,TRX_N-00588-23331291,2023-05-04T02:24:48,Vitoria-Gasteiz,expenses,mortgage,-998.07,-31299.05
buyer_6,Manuel,45,ES02209555428642879798,TRX_N-00589-73552298,2023-05-05T14:03:56,Vitoria-Gasteiz,expenses,water,-40.09,-31339.14
buyer_6,Manuel,45,ES02209555428642879798,TRX_N-00590-73088131,2023-05-05T14:53:34,Vitoria-Gasteiz,Expense,repairs,-256.23,-31595.37
buyer_6,Manuel,45,ES02209555428642879798,TRX_N-00591-12922733,2023-05-06T11:52:36,Vitoria-Gasteiz,expenses,electricity,-51.77,-31647.14
buyer_6,Manuel,45,ES02209555428642879798,TRX_N-00592-47048911,2023-05-06T19:14:13,Vitoria-Gasteiz,expenses,gas,-113.98,-31761.12
buyer_6,Manuel,45,ES02209555428642879798,TRX_N-00593-55686742,2023-05-06T14:15:52,Vitoria-Gasteiz,expenses,internet,-42.0,-31803.12
buyer_6,Manuel,45,ES02209555428642879798,TRX_N-00594-05582782,2023-05-06T01:23:39,Vitoria-Gasteiz,Expense,leisure,-58.52,-31861.64
buyer_6,Manuel,45,ES02209555428642879798,TRX_N-00595-97361525,2023-05-07T17:33:38,Vitoria-Gasteiz,expenses,phone,-30.33,-31891.97
buyer_6,Manuel,45,ES02209555428642879798,TRX_N-00596-44929836,2023-05-07T15:35:21,Lasarte-Oria,Expense,cash,-100.0,-31991.97
buyer_6,Manuel,45,ES02209555428642879798,TRX_N-00597-44432729,2023-05-08T19:01:33,Vitoria-Gasteiz,Expense,healthcare,-107.87,-32099.84
buyer_6,Manuel,45,ES02209555428642879798,TRX_N-00598-77007266,2023-05-09T21:37:36,Vitoria-Gasteiz,Expense,leisure,-31.86,-32131.7
buyer_6,Manuel,45,ES02209555428642879798,TRX_N-00599-28741747,2023-05-09T10:22:46,Vitoria-Gasteiz,expenses,children,-101.95,-32233.65
buyer_6,Manuel,45,ES02209555428642879798,TRX_N-00600-09694073,2023-05-10T18:48:31,Vitoria-Gasteiz,Expense,cash,-100.0,-32333.65
buyer_6,Manuel,45,ES02209555428642879798,TRX_N-00601-97188355,2023-05-13T17:58:04,Vitoria-Gasteiz,Expense,education,-69.08,-32402.73
buyer_6,Manuel,45,ES02209555428642879798,TRX_N-00602-78190925,2023-05-13T11:22:10,Vitoria-Gasteiz,Expense,cash,-100.0,-32502.73
buyer_6,Manuel,45,ES02209555428642879798,TRX_N-00603-88408797,2023-05-16T17:45:11,Vitoria-Gasteiz,Expense,transport,-66.62,-32569.35
buyer_6,Manuel,45,ES02209555428642879798,TRX_N-00604-98409368,2023-05-16T15:55:58,Vitoria-Gasteiz,Expense,leisure,-21.93,-32591.28
buyer_6,Manuel,45,ES02209555428642879798,TRX_N-00605-45939532,2023-05-19T13:52:44,Zuia,Expense,cash,-100.0,-32691.28
buyer_6,Manuel,45,ES02209555428642879798,TRX_N-00606-04642369,2023-05-20T13:48:51,Vitoria-Gasteiz,Expense,transport,-43.46,-32734.74
buyer_6,Manuel,45,ES02209555428642879798,TRX_N-00607-24041785,2023-05-20T18:47:13,Berango,Expense,cash,-100.0,-32834.74
buyer_6,Manuel,45,ES02209555428642879798,TRX_N-00608-89593091,2023-05-20T16:23:29,Vitoria-Gasteiz,Expense,gifts,-257.22,-33091.96
buyer_6,Manuel,45,ES02209555428642879798,TRX_N-00609-36256807,2023-05-21T11:50:20,Vitoria-Gasteiz,Expense,leisure,-65.79,-33157.75
buyer_6,Manuel,45,ES02209555428642879798,TRX_N-00610-06443337,2023-05-21T13:12:28,Vitoria-Gasteiz,Expense,repairs,-48.65,-33206.4
buyer_6,Manuel,45,ES02209555428642879798,TRX_N-00611-22549508,2023-05-21T19:29:14,Vitoria-Gasteiz,Expense,gifts,-627.81,-33834.21
buyer_6,Manuel,45,ES02209555428642879798,TRX_N-00612-13776929,2023-05-22T13:22:03,Vitoria-Gasteiz,expenses,children,-167.5,-34001.71
buyer_6,Manuel,45,ES02209555428642879798,TRX_N-00613-45927008,2023-05-23T16:13:44,Vitoria-Gasteiz,Expense,transport,-63.75,-34065.46
buyer_6,Manuel,45,ES02209555428642879798,TRX_N-00614-59781727,2023-05-23T16:53:25,Vitoria-Gasteiz,Expense,leisure,-29.98,-34095.44
buyer_6,Manuel,45,ES02209555428642879798,TRX_N-00615-85999312,2023-05-23T01:22:49,Sestao,Expense,cash,-100.0,-34195.44
buyer_6,Manuel,45,ES02209555428642879798,TRX_N-00616-67923196,2023-05-24T08:00:42,Vitoria-Gasteiz,expenses,children,-98.63,-34294.07
buyer_6,Manuel,45,ES02209555428642879798,TRX_N-00617-41969420,2023-05-27T13:33:49,Vitoria-Gasteiz,Expense,transport,-59.09,-34353.16
buyer_6,Manuel,45,ES02209555428642879798,TRX_N-00618-36047412,2023-05-27T15:05:46,Vitoria-Gasteiz,Expense,leisure,-82.67,-34435.83
buyer_6,Manuel,45,ES02209555428642879798,TRX_N-00619-69988388,2023-05-29T16:24:46,Vitoria-Gasteiz,Expense,education,-68.77,-34504.6
buyer_6,Manuel,45,ES02209555428642879798,TRX_N-00620-25479416,2023-05-30T09:02:48,Vitoria-Gasteiz,Expense,food,-72.63,-34577.23
buyer_6,Manuel,45,ES02209555428642879798,TRX_N-00621-48807654,2023-06-01T20:05:31,Vitoria-Gasteiz,incomes,salary,1387.48,-33189.75
buyer_6,Manuel,45,ES02209555428642879798,TRX_N-00622-55962053,2023-06-01T20:05:31,Vitoria-Gasteiz,incomes,salary_partner,1344.84,-31844.91
buyer_6,Manuel,45,ES02209555428642879798,TRX_N-00623-22116165,2023-06-01T20:05:31,Vitoria-Gasteiz,incomes,extra_income,235.66,-31609.25
buyer_6,Manuel,45,ES02209555428642879798,TRX_N-00624-53023855,2023-06-01T20:05:31,Vitoria-Gasteiz,incomes,salary_bonus,1039.07,-30570.18
buyer_6,Manuel,45,ES02209555428642879798,TRX_N-00625-04603463,2023-06-01T20:05:31,Vitoria-Gasteiz,incomes,salary_partner_bonus,1045.32,-29524.86
buyer_6,Manuel,45,ES02209555428642879798,TRX_N-00626-09887382,2023-06-02T18:55:41,Vitoria-Gasteiz,Expense,food,-102.47,-29627.33
buyer_6,Manuel,45,ES02209555428642879798,TRX_N-00627-47042427,2023-06-04T10:06:33,Vitoria-Gasteiz,expenses,mortgage,-998.07,-30625.4
buyer_6,Manuel,45,ES02209555428642879798,TRX_N-00628-58203326,2023-06-04T12:45:31,Vitoria-Gasteiz,Expense,cash,-100.0,-30725.4
buyer_6,Manuel,45,ES02209555428642879798,TRX_N-00629-90331570,2023-06-05T18:07:37,Vitoria-Gasteiz,expenses,water,-32.32,-30757.72
buyer_6,Manuel,45,ES02209555428642879798,TRX_N-00630-92962390,2023-06-05T22:04:25,Vitoria-Gasteiz,expenses,internet,-42.0,-30799.72
buyer_6,Manuel,45,ES02209555428642879798,TRX_N-00631-73039410,2023-06-06T16:32:29,Vitoria-Gasteiz,expenses,electricity,-38.13,-30837.85
buyer_6,Manuel,45,ES02209555428642879798,TRX_N-00632-91709692,2023-06-06T08:06:54,Vitoria-Gasteiz,expenses,gas,-50.27,-30888.12
buyer_6,Manuel,45,ES02209555428642879798,TRX_N-00633-91079555,2023-06-06T12:05:34,Vitoria-Gasteiz,Expense,food,-62.98,-30951.1
buyer_6,Manuel,45,ES02209555428642879798,TRX_N-00634-60735200,2023-06-06T20:21:05,Vitoria-Gasteiz,expenses,children,-69.04,-31020.14
buyer_6,Manuel,45,ES02209555428642879798,TRX_N-00635-55300612,2023-06-07T17:51:59,Durango,Expense,healthcare,-178.99,-31199.13
buyer_6,Manuel,45,ES02209555428642879798,TRX_N-00636-82082008,2023-06-08T14:06:14,Vitoria-Gasteiz,expenses,phone,-30.84,-31229.97
buyer_6,Manuel,45,ES02209555428642879798,TRX_N-00637-87018785,2023-06-08T08:04:49,Vitoria-Gasteiz,expenses,children,-236.45,-31466.42
buyer_6,Manuel,45,ES02209555428642879798,TRX_N-00638-31962878,2023-06-09T20:55:38,Vitoria-Gasteiz,expenses,children,-208.14,-31674.56
buyer_6,Manuel,45,ES02209555428642879798,TRX_N-00639-88577688,2023-06-12T20:17:56,Vitoria-Gasteiz,Expense,clothing,-62.73,-31737.29
buyer_6,Manuel,45,ES02209555428642879798,TRX_N-00640-15011511,2023-06-13T16:31:40,Vitoria-Gasteiz,Expense,cash,-100.0,-31837.29
buyer_6,Manuel,45,ES02209555428642879798,TRX_N-00641-73657449,2023-06-13T23:05:15,Vitoria-Gasteiz,Expense,repairs,-47.26,-31884.55
buyer_6,Manuel,45,ES02209555428642879798,TRX_N-00642-11911404,2023-06-13T07:22:54,Vitoria-Gasteiz,expenses,children,-71.04,-31955.59
buyer_6,Manuel,45,ES02209555428642879798,TRX_N-00643-79034067,2023-06-15T04:58:18,Vitoria-Gasteiz,Expense,food,-119.54,-32075.13
buyer_6,Manuel,45,ES02209555428642879798,TRX_N-00644-46829529,2023-06-15T18:37:32,Vitoria-Gasteiz,Expense,healthcare,-106.29,-32181.42
buyer_6,Manuel,45,ES02209555428642879798,TRX_N-00645-34568146,2023-06-16T19:45:20,Vitoria-Gasteiz,Expense,food,-79.66,-32261.08
buyer_6,Manuel,45,ES02209555428642879798,TRX_N-00646-91550276,2023-06-16T22:24:58,Vitoria-Gasteiz,Expense,transport,-80.55,-32341.63
buyer_6,Manuel,45,ES02209555428642879798,TRX_N-00647-11056471,2023-06-16T16:56:48,Vitoria-Gasteiz,Expense,cash,-100.0,-32441.63
buyer_6,Manuel,45,ES02209555428642879798,TRX_N-00648-98673981,2023-06-17T19:47:17,Vitoria-Gasteiz,Expense,food,-85.43,-32527.06
buyer_6,Manuel,45,ES02209555428642879798,TRX_N-00649-70162989,2023-06-19T08:24:27,Vitoria-Gasteiz,Expense,leisure,-62.35,-32589.41
buyer_6,Manuel,45,ES02209555428642879798,TRX_N-00650-98557857,2023-06-19T10:27:40,Vitoria-Gasteiz,Expense,cash,-100.0,-32689.41
buyer_6,Manuel,45,ES02209555428642879798,TRX_N-00651-38784448,2023-06-20T17:53:19,Vitoria-Gasteiz,Expense,cash,-100.0,-32789.41
buyer_6,Manuel,45,ES02209555428642879798,TRX_N-00652-02316186,2023-06-20T18:52:44,Vitoria-Gasteiz,expenses,children,-56.92,-32846.33
buyer_6,Manuel,45,ES02209555428642879798,TRX_N-00653-54487463,2023-06-23T11:26:42,Vitoria-Gasteiz,Expense,leisure,-68.12,-32914.45
buyer_6,Manuel,45,ES02209555428642879798,TRX_N-00654-95594965,2023-06-23T16:16:20,Portugalete,Expense,cash,-100.0,-33014.45
buyer_6,Manuel,45,ES02209555428642879798,TRX_N-00655-46649729,2023-06-25T21:41:11,Vitoria-Gasteiz,Expense,gifts,-780.26,-33794.71
buyer_6,Manuel,45,ES02209555428642879798,TRX_N-00656-76368124,2023-06-26T16:09:21,Alegr√≠a-Dulantzi,Expense,cash,-100.0,-33894.71
buyer_6,Manuel,45,ES02209555428642879798,TRX_N-00657-28275089,2023-06-26T10:30:33,Vitoria-Gasteiz,Expense,gifts,-453.09,-34347.8
buyer_6,Manuel,45,ES02209555428642879798,TRX_N-00658-61955691,2023-06-27T22:52:14,Vitoria-Gasteiz,Expense,leisure,-37.74,-34385.54
buyer_6,Manuel,45,ES02209555428642879798,TRX_N-00659-11547474,2023-06-28T17:55:38,Iru√±a de Oca,Expense,gifts,-740.26,-35125.8
buyer_6,Manuel,45,ES02209555428642879798,TRX_N-00660-79803032,2023-06-30T13:29:51,Vitoria-Gasteiz,Expense,education,-42.76,-35168.56
buyer_6,Manuel,45,ES02209555428642879798,TRX_N-00661-71109837,2023-06-30T16:11:28,Eibar,Expense,cash,-100.0,-35268.56
buyer_6,Manuel,45,ES02209555428642879798,TRX_N-00662-58110034,2023-07-01T16:22:02,Vitoria-Gasteiz,incomes,salary,1387.48,-33881.08
buyer_6,Manuel,45,ES02209555428642879798,TRX_N-00663-74783222,2023-07-01T16:22:02,Vitoria-Gasteiz,incomes,salary_partner,1344.84,-32536.24
buyer_6,Manuel,45,ES02209555428642879798,TRX_N-00664-40221115,2023-07-01T15:38:19,Vitoria-Gasteiz,Expense,healthcare,-119.69,-32655.93
buyer_6,Manuel,45,ES02209555428642879798,TRX_N-00665-24562311,2023-07-01T09:44:23,Vitoria-Gasteiz,Expense,cash,-100.0,-32755.93
buyer_6,Manuel,45,ES02209555428642879798,TRX_N-00666-10156811,2023-07-02T14:04:45,Sestao,Expense,food,-111.74,-32867.67
buyer_6,Manuel,45,ES02209555428642879798,TRX_N-00667-46527710,2023-07-02T18:47:05,Vitoria-Gasteiz,Expense,transport,-76.87,-32944.54
buyer_6,Manuel,45,ES02209555428642879798,TRX_N-00668-26798851,2023-07-04T09:51:58,Vitoria-Gasteiz,expenses,mortgage,-998.07,-33942.61
buyer_6,Manuel,45,ES02209555428642879798,TRX_N-00669-08933578,2023-07-05T18:43:00,Vitoria-Gasteiz,expenses,gas,-46.93,-33989.54
buyer_6,Manuel,45,ES02209555428642879798,TRX_N-00670-98511499,2023-07-05T16:09:10,Vitoria-Gasteiz,expenses,phone,-38.57,-34028.11
buyer_6,Manuel,45,ES02209555428642879798,TRX_N-00671-77947445,2023-07-05T22:49:48,Vitoria-Gasteiz,Expense,clothing,-54.98,-34083.09
buyer_6,Manuel,45,ES02209555428642879798,TRX_N-00672-71424939,2023-07-06T09:35:08,Vitoria-Gasteiz,expenses,electricity,-34.15,-34117.24
buyer_6,Manuel,45,ES02209555428642879798,TRX_N-00673-80409740,2023-07-06T18:49:16,Vitoria-Gasteiz,Expense,food,-83.14,-34200.38
buyer_6,Manuel,45,ES02209555428642879798,TRX_N-00674-71804730,2023-07-06T10:51:07,Vitoria-Gasteiz,Expense,cash,-100.0,-34300.38
buyer_6,Manuel,45,ES02209555428642879798,TRX_N-00675-80955937,2023-07-07T08:28:25,Vitoria-Gasteiz,expenses,water,-36.66,-34337.04
buyer_6,Manuel,45,ES02209555428642879798,TRX_N-00676-22200944,2023-07-08T12:48:01,Vitoria-Gasteiz,expenses,internet,-42.0,-34379.04
buyer_6,Manuel,45,ES02209555428642879798,TRX_N-00677-64250676,2023-07-08T06:54:11,Vitoria-Gasteiz,Expense,food,-80.55,-34459.59
buyer_6,Manuel,45,ES02209555428642879798,TRX_N-00678-63938396,2023-07-09T10:23:47,Vitoria-Gasteiz,Expense,transport,-83.7,-34543.29
buyer_6,Manuel,45,ES02209555428642879798,TRX_N-00679-00539128,2023-07-11T11:46:48,Erandio,Expense,gifts,-168.95,-34712.24
buyer_6,Manuel,45,ES02209555428642879798,TRX_N-00680-73947070,2023-07-13T11:07:20,Vitoria-Gasteiz,Expense,leisure,-35.4,-34747.64
buyer_6,Manuel,45,ES02209555428642879798,TRX_N-00681-24659568,2023-07-13T11:03:50,Llodio,Expense,gifts,-832.35,-35579.99
buyer_6,Manuel,45,ES02209555428642879798,TRX_N-00682-34357026,2023-07-14T22:59:57,Vitoria-Gasteiz,Expense,cash,-100.0,-35679.99
buyer_6,Manuel,45,ES02209555428642879798,TRX_N-00683-07200137,2023-07-15T15:24:25,Vitoria-Gasteiz,Expense,repairs,-89.36,-35769.35
buyer_6,Manuel,45,ES02209555428642879798,TRX_N-00684-37426525,2023-07-17T17:59:16,Vitoria-Gasteiz,Expense,transport,-83.79,-35853.14
buyer_6,Manuel,45,ES02209555428642879798,TRX_N-00685-83334161,2023-07-17T18:23:08,Vitoria-Gasteiz,Expense,cash,-100.0,-35953.14
buyer_6,Manuel,45,ES02209555428642879798,TRX_N-00686-26974787,2023-07-19T16:02:59,Vitoria-Gasteiz,Expense,education,-74.81,-36027.95
buyer_6,Manuel,45,ES02209555428642879798,TRX_N-00687-70383335,2023-07-21T14:21:44,Vitoria-Gasteiz,Expense,leisure,-32.45,-36060.4
buyer_6,Manuel,45,ES02209555428642879798,TRX_N-00688-74864659,2023-07-21T16:56:32,Vitoria-Gasteiz,Expense,cash,-100.0,-36160.4
buyer_6,Manuel,45,ES02209555428642879798,TRX_N-00689-74368958,2023-07-22T09:29:19,Vitoria-Gasteiz,Expense,food,-85.08,-36245.48
buyer_6,Manuel,45,ES02209555428642879798,TRX_N-00690-94218747,2023-07-25T19:30:56,Vitoria-Gasteiz,Expense,food,-123.9,-36369.38
buyer_6,Manuel,45,ES02209555428642879798,TRX_N-00691-71714073,2023-07-25T15:58:10,Erandio,Expense,cash,-100.0,-36469.38
buyer_6,Manuel,45,ES02209555428642879798,TRX_N-00692-88777529,2023-07-25T12:33:55,Vitoria-Gasteiz,Expense,travel,-493.56,-36962.94
buyer_6,Manuel,45,ES02209555428642879798,TRX_N-00693-58525044,2023-07-26T11:00:40,Vitoria-Gasteiz,expenses,children,-216.7,-37179.64
buyer_6,Manuel,45,ES02209555428642879798,TRX_N-00694-34652940,2023-07-27T13:17:31,Vitoria-Gasteiz,Expense,appliances,-246.51,-37426.15
buyer_6,Manuel,45,ES02209555428642879798,TRX_N-00695-02698941,2023-07-28T02:24:01,Vitoria-Gasteiz,Expense,repairs,-175.75,-37601.9
buyer_6,Manuel,45,ES02209555428642879798,TRX_N-00696-32567675,2023-07-29T14:58:56,Vitoria-Gasteiz,Expense,healthcare,-95.36,-37697.26
buyer_6,Manuel,45,ES02209555428642879798,TRX_N-00697-98273495,2023-07-29T18:44:48,Bermeo,Expense,cash,-100.0,-37797.26
buyer_6,Manuel,45,ES02209555428642879798,TRX_N-00698-09128316,2023-07-30T13:17:47,Vitoria-Gasteiz,Expense,leisure,-70.15,-37867.41
buyer_6,Manuel,45,ES02209555428642879798,TRX_N-00699-43953445,2023-08-01T13:16:59,Vitoria-Gasteiz,incomes,salary,1387.48,-36479.93
buyer_6,Manuel,45,ES02209555428642879798,TRX_N-00700-26880316,2023-08-01T13:16:59,Vitoria-Gasteiz,incomes,salary_partner,1344.84,-35135.09
buyer_6,Manuel,45,ES02209555428642879798,TRX_N-00701-20883694,2023-08-01T09:10:36,Pasaia,Expense,food,-87.24,-35222.33
buyer_6,Manuel,45,ES02209555428642879798,TRX_N-00702-78804145,2023-08-01T22:12:19,Vitoria-Gasteiz,Expense,cash,-100.0,-35322.33
buyer_6,Manuel,45,ES02209555428642879798,TRX_N-00703-22978863,2023-08-02T22:17:46,Vitoria-Gasteiz,Expense,leisure,-53.77,-35376.1
buyer_6,Manuel,45,ES02209555428642879798,TRX_N-00704-84915349,2023-08-04T15:31:24,Vitoria-Gasteiz,expenses,mortgage,-998.07,-36374.17
buyer_6,Manuel,45,ES02209555428642879798,TRX_N-00705-80793796,2023-08-04T18:54:29,Vitoria-Gasteiz,Expense,food,-64.43,-36438.6
buyer_6,Manuel,45,ES02209555428642879798,TRX_N-00706-77036399,2023-08-04T17:25:16,Vitoria-Gasteiz,Expense,education,-76.78,-36515.38
buyer_6,Manuel,45,ES02209555428642879798,TRX_N-00707-67396956,2023-08-05T08:56:06,Vitoria-Gasteiz,expenses,internet,-42.0,-36557.38
buyer_6,Manuel,45,ES02209555428642879798,TRX_N-00708-88635815,2023-08-05T02:14:51,Vitoria-Gasteiz,Expense,clothing,-120.95,-36678.33
buyer_6,Manuel,45,ES02209555428642879798,TRX_N-00709-48446334,2023-08-06T12:20:33,Vitoria-Gasteiz,Expense,healthcare,-172.31,-36850.64
buyer_6,Manuel,45,ES02209555428642879798,TRX_N-00710-86632511,2023-08-07T15:08:16,Oy√≥n-Oion,Expense,cash,-100.0,-36950.64
buyer_6,Manuel,45,ES02209555428642879798,TRX_N-00711-51512031,2023-08-08T18:09:49,Vitoria-Gasteiz,expenses,water,-41.4,-36992.04
buyer_6,Manuel,45,ES02209555428642879798,TRX_N-00712-66631644,2023-08-08T05:48:58,Vitoria-Gasteiz,expenses,electricity,-66.26,-37058.3
buyer_6,Manuel,45,ES02209555428642879798,TRX_N-00713-74821546,2023-08-08T09:06:55,Vitoria-Gasteiz,expenses,gas,-92.37,-37150.67
buyer_6,Manuel,45,ES02209555428642879798,TRX_N-00714-49764309,2023-08-08T18:15:04,Vitoria-Gasteiz,expenses,phone,-44.26,-37194.93
buyer_6,Manuel,45,ES02209555428642879798,TRX_N-00715-85674234,2023-08-10T20:23:22,Vitoria-Gasteiz,Expense,cash,-100.0,-37294.93
buyer_6,Manuel,45,ES02209555428642879798,TRX_N-00716-94976250,2023-08-11T23:17:25,Vitoria-Gasteiz,expenses,children,-64.9,-37359.83
buyer_6,Manuel,45,ES02209555428642879798,TRX_N-00717-05235503,2023-08-13T17:32:52,Vitoria-Gasteiz,Expense,food,-119.85,-37479.68
buyer_6,Manuel,45,ES02209555428642879798,TRX_N-00718-27665787,2023-08-16T09:49:15,Vitoria-Gasteiz,Expense,transport,-81.36,-37561.04
buyer_6,Manuel,45,ES02209555428642879798,TRX_N-00719-90877774,2023-08-16T18:09:52,Vitoria-Gasteiz,expenses,children,-54.08,-37615.12
buyer_6,Manuel,45,ES02209555428642879798,TRX_N-00720-02816290,2023-08-18T16:56:58,Vitoria-Gasteiz,Expense,repairs,-154.92,-37770.04
buyer_6,Manuel,45,ES02209555428642879798,TRX_N-00721-41664209,2023-08-21T13:23:42,Vitoria-Gasteiz,Expense,cash,-100.0,-37870.04
buyer_6,Manuel,45,ES02209555428642879798,TRX_N-00722-24541342,2023-08-23T10:03:34,Andoain,Expense,food,-101.21,-37971.25
buyer_6,Manuel,45,ES02209555428642879798,TRX_N-00723-53733941,2023-08-23T05:25:37,Vitoria-Gasteiz,Expense,healthcare,-87.12,-38058.37
buyer_6,Manuel,45,ES02209555428642879798,TRX_N-00724-65732019,2023-08-23T16:40:23,Vitoria-Gasteiz,Expense,cash,-100.0,-38158.37
buyer_6,Manuel,45,ES02209555428642879798,TRX_N-00725-19030299,2023-08-24T12:08:44,Vitoria-Gasteiz,Expense,repairs,-128.03,-38286.4
buyer_6,Manuel,45,ES02209555428642879798,TRX_N-00726-28769560,2023-08-24T00:00:49,Vitoria-Gasteiz,Expense,gifts,-747.38,-39033.78
buyer_6,Manuel,45,ES02209555428642879798,TRX_N-00727-52938453,2023-08-25T15:12:51,Vitoria-Gasteiz,Expense,food,-94.59,-39128.37
buyer_6,Manuel,45,ES02209555428642879798,TRX_N-00728-80907373,2023-08-25T19:12:17,Vitoria-Gasteiz,Expense,appliances,-175.7,-39304.07
buyer_6,Manuel,45,ES02209555428642879798,TRX_N-00729-67103709,2023-08-27T13:36:56,Vitoria-Gasteiz,Expense,leisure,-25.69,-39329.76
buyer_6,Manuel,45,ES02209555428642879798,TRX_N-00730-33504533,2023-08-28T16:40:08,Vitoria-Gasteiz,Expense,food,-122.85,-39452.61
buyer_6,Manuel,45,ES02209555428642879798,TRX_N-00731-67395521,2023-08-29T12:29:08,Vitoria-Gasteiz,Expense,education,-69.35,-39521.96
buyer_6,Manuel,45,ES02209555428642879798,TRX_N-00732-83746750,2023-08-29T08:41:22,Basauri,Expense,gifts,-405.16,-39927.12
buyer_6,Manuel,45,ES02209555428642879798,TRX_N-00733-54088202,2023-08-30T09:04:59,Vitoria-Gasteiz,Expense,appliances,-343.29,-40270.41
buyer_6,Manuel,45,ES02209555428642879798,TRX_N-00734-25573673,2023-08-31T08:23:28,Vitoria-Gasteiz,Expense,travel,-1736.02,-42006.43
buyer_6,Manuel,45,ES02209555428642879798,TRX_N-00735-69137428,2023-09-01T11:32:27,Vitoria-Gasteiz,incomes,salary,1387.48,-40618.95
buyer_6,Manuel,45,ES02209555428642879798,TRX_N-00736-33856077,2023-09-01T11:32:27,Vitoria-Gasteiz,incomes,salary_partner,1344.84,-39274.11
buyer_6,Manuel,45,ES02209555428642879798,TRX_N-00737-06221595,2023-09-03T12:52:53,Llodio,Expense,leisure,-56.53,-39330.64
buyer_6,Manuel,45,ES02209555428642879798,TRX_N-00738-70954902,2023-09-03T20:42:32,Vitoria-Gasteiz,Expense,cash,-100.0,-39430.64
buyer_6,Manuel,45,ES02209555428642879798,TRX_N-00739-50015057,2023-09-04T20:49:53,Vitoria-Gasteiz,expenses,mortgage,-998.07,-40428.71
buyer_6,Manuel,45,ES02209555428642879798,TRX_N-00740-15259450,2023-09-05T05:30:02,Vitoria-Gasteiz,expenses,electricity,-26.46,-40455.17
buyer_6,Manuel,45,ES02209555428642879798,TRX_N-00741-37482639,2023-09-05T20:19:57,Vitoria-Gasteiz,expenses,phone,-41.16,-40496.33
buyer_6,Manuel,45,ES02209555428642879798,TRX_N-00742-97988737,2023-09-05T17:26:13,Vitoria-Gasteiz,Expense,clothing,-98.24,-40594.57
buyer_6,Manuel,45,ES02209555428642879798,TRX_N-00743-14136442,2023-09-06T20:10:10,Vitoria-Gasteiz,expenses,water,-24.72,-40619.29
buyer_6,Manuel,45,ES02209555428642879798,TRX_N-00744-30189635,2023-09-06T16:04:47,Vitoria-Gasteiz,Expense,food,-90.05,-40709.34
buyer_6,Manuel,45,ES02209555428642879798,TRX_N-00745-93910094,2023-09-07T15:34:55,Vitoria-Gasteiz,expenses,gas,-104.89,-40814.23
buyer_6,Manuel,45,ES02209555428642879798,TRX_N-00746-94444659,2023-09-07T15:06:14,Vitoria-Gasteiz,Expense,healthcare,-73.62,-40887.85
buyer_6,Manuel,45,ES02209555428642879798,TRX_N-00747-79333759,2023-09-07T09:41:04,Vitoria-Gasteiz,Expense,travel,-319.23,-41207.08
buyer_6,Manuel,45,ES02209555428642879798,TRX_N-00748-37019956,2023-09-08T15:03:41,Vitoria-Gasteiz,expenses,internet,-42.0,-41249.08
buyer_6,Manuel,45,ES02209555428642879798,TRX_N-00749-03776797,2023-09-08T13:56:05,Vitoria-Gasteiz,Expense,food,-91.82,-41340.9
buyer_6,Manuel,45,ES02209555428642879798,TRX_N-00750-42026794,2023-09-09T10:03:55,Vitoria-Gasteiz,Expense,cash,-100.0,-41440.9
buyer_6,Manuel,45,ES02209555428642879798,TRX_N-00751-34643952,2023-09-10T20:06:08,Vitoria-Gasteiz,Expense,cash,-100.0,-41540.9
buyer_6,Manuel,45,ES02209555428642879798,TRX_N-00752-86262347,2023-09-11T18:32:40,Vitoria-Gasteiz,Expense,cash,-100.0,-41640.9
buyer_6,Manuel,45,ES02209555428642879798,TRX_N-00753-37641864,2023-09-13T19:58:30,Arrasate,Expense,healthcare,-89.82,-41730.72
buyer_6,Manuel,45,ES02209555428642879798,TRX_N-00754-22546837,2023-09-13T17:22:01,Vitoria-Gasteiz,Expense,cash,-100.0,-41830.72
buyer_6,Manuel,45,ES02209555428642879798,TRX_N-00755-91628125,2023-09-14T14:24:53,Vitoria-Gasteiz,Expense,travel,-1763.93,-43594.65
buyer_6,Manuel,45,ES02209555428642879798,TRX_N-00756-81326975,2023-09-15T00:50:30,Getxo,Expense,cash,-100.0,-43694.65
buyer_6,Manuel,45,ES02209555428642879798,TRX_N-00757-09435123,2023-09-17T23:46:55,Vitoria-Gasteiz,Expense,food,-79.15,-43773.8
buyer_6,Manuel,45,ES02209555428642879798,TRX_N-00758-10387135,2023-09-17T18:43:09,Vitoria-Gasteiz,Expense,clothing,-51.05,-43824.85
buyer_6,Manuel,45,ES02209555428642879798,TRX_N-00759-87121116,2023-09-17T07:46:35,Vitoria-Gasteiz,Expense,repairs,-55.1,-43879.95
buyer_6,Manuel,45,ES02209555428642879798,TRX_N-00760-58291198,2023-09-19T08:55:31,Vitoria-Gasteiz,Expense,clothing,-129.09,-44009.04
buyer_6,Manuel,45,ES02209555428642879798,TRX_N-00761-53970458,2023-09-20T09:39:19,Vitoria-Gasteiz,Expense,clothing,-159.69,-44168.73
buyer_6,Manuel,45,ES02209555428642879798,TRX_N-00762-85338281,2023-09-21T10:17:53,Vitoria-Gasteiz,Expense,food,-81.5,-44250.23
buyer_6,Manuel,45,ES02209555428642879798,TRX_N-00763-77829245,2023-09-25T09:25:08,Vitoria-Gasteiz,Expense,leisure,-76.5,-44326.73
buyer_6,Manuel,45,ES02209555428642879798,TRX_N-00764-55543839,2023-09-26T06:39:49,Vitoria-Gasteiz,Expense,transport,-65.09,-44391.82
buyer_6,Manuel,45,ES02209555428642879798,TRX_N-00765-20171925,2023-09-29T08:40:44,Vitoria-Gasteiz,Expense,cash,-100.0,-44491.82
buyer_6,Manuel,45,ES02209555428642879798,TRX_N-00766-64678169,2023-09-29T20:49:32,Vitoria-Gasteiz,Expense,repairs,-218.92,-44710.74
buyer_6,Manuel,45,ES02209555428642879798,TRX_N-00767-98464519,2023-09-30T08:07:33,Vitoria-Gasteiz,Expense,transport,-85.29,-44796.03
buyer_6,Manuel,45,ES02209555428642879798,TRX_N-00768-96726954,2023-09-30T03:16:15,Vitoria-Gasteiz,Expense,leisure,-31.64,-44827.67
buyer_6,Manuel,45,ES02209555428642879798,TRX_N-00769-21185457,2023-10-01T08:00:19,Vitoria-Gasteiz,incomes,salary,1387.48,-43440.19
buyer_6,Manuel,45,ES02209555428642879798,TRX_N-00770-34878769,2023-10-01T08:00:19,Vitoria-Gasteiz,incomes,salary_partner,1344.84,-42095.35
buyer_6,Manuel,45,ES02209555428642879798,TRX_N-00771-85930313,2023-10-01T08:00:19,Vitoria-Gasteiz,incomes,extra_income,235.66,-41859.69
buyer_6,Manuel,45,ES02209555428642879798,TRX_N-00772-31555049,2023-10-03T19:54:02,Galdakao,Expense,clothing,-93.29,-41952.98
buyer_6,Manuel,45,ES02209555428642879798,TRX_N-00773-41352655,2023-10-04T14:30:36,Vitoria-Gasteiz,expenses,mortgage,-998.07,-42951.05
buyer_6,Manuel,45,ES02209555428642879798,TRX_N-00774-44103521,2023-10-05T19:37:21,Vitoria-Gasteiz,expenses,internet,-42.0,-42993.05
buyer_6,Manuel,45,ES02209555428642879798,TRX_N-00775-51268146,2023-10-05T17:46:19,Vitoria-Gasteiz,expenses,phone,-34.16,-43027.21
buyer_6,Manuel,45,ES02209555428642879798,TRX_N-00776-15193221,2023-10-06T03:39:37,Vitoria-Gasteiz,expenses,water,-36.72,-43063.93
buyer_6,Manuel,45,ES02209555428642879798,TRX_N-00777-47690152,2023-10-06T19:55:33,Vitoria-Gasteiz,Expense,education,-69.47,-43133.4
buyer_6,Manuel,45,ES02209555428642879798,TRX_N-00778-06120840,2023-10-08T15:37:10,Vitoria-Gasteiz,expenses,gas,-36.19,-43169.59
buyer_6,Manuel,45,ES02209555428642879798,TRX_N-00779-56491475,2023-10-08T14:25:34,Vitoria-Gasteiz,expenses,electricity,-70.92,-43240.51
buyer_6,Manuel,45,ES02209555428642879798,TRX_N-00780-42435309,2023-10-08T07:36:33,Irun,Expense,transport,-45.82,-43286.33
buyer_6,Manuel,45,ES02209555428642879798,TRX_N-00781-03164492,2023-10-13T18:09:29,Vitoria-Gasteiz,Expense,cash,-100.0,-43386.33
buyer_6,Manuel,45,ES02209555428642879798,TRX_N-00782-17179590,2023-10-15T17:54:21,Vitoria-Gasteiz,Expense,leisure,-44.97,-43431.3
buyer_6,Manuel,45,ES02209555428642879798,TRX_N-00783-86446549,2023-10-16T17:42:10,Vitoria-Gasteiz,Expense,leisure,-40.5,-43471.8
buyer_6,Manuel,45,ES02209555428642879798,TRX_N-00784-34202905,2023-10-17T14:26:15,Vitoria-Gasteiz,Expense,gifts,-670.57,-44142.37
buyer_6,Manuel,45,ES02209555428642879798,TRX_N-00785-93539280,2023-10-18T14:54:28,Vitoria-Gasteiz,Expense,food,-97.16,-44239.53
buyer_6,Manuel,45,ES02209555428642879798,TRX_N-00786-88656380,2023-10-18T20:34:50,Vitoria-Gasteiz,Expense,healthcare,-100.64,-44340.17
buyer_6,Manuel,45,ES02209555428642879798,TRX_N-00787-24657436,2023-10-19T23:27:56,Vitoria-Gasteiz,Expense,clothing,-150.17,-44490.34
buyer_6,Manuel,45,ES02209555428642879798,TRX_N-00788-35278909,2023-10-21T18:37:34,Vitoria-Gasteiz,Expense,food,-74.53,-44564.87
buyer_6,Manuel,45,ES02209555428642879798,TRX_N-00789-08993271,2023-10-22T23:13:37,Vitoria-Gasteiz,Expense,cash,-100.0,-44664.87
buyer_6,Manuel,45,ES02209555428642879798,TRX_N-00790-46382045,2023-10-24T18:20:42,Vitoria-Gasteiz,expenses,children,-263.41,-44928.28
buyer_6,Manuel,45,ES02209555428642879798,TRX_N-00791-24668154,2023-10-26T10:54:05,Vitoria-Gasteiz,Expense,cash,-100.0,-45028.28
buyer_6,Manuel,45,ES02209555428642879798,TRX_N-00792-71131490,2023-10-26T08:40:50,Vitoria-Gasteiz,Expense,travel,-742.31,-45770.59
buyer_6,Manuel,45,ES02209555428642879798,TRX_N-00793-62992100,2023-10-26T02:04:50,Vitoria-Gasteiz,Expense,repairs,-73.14,-45843.73
buyer_6,Manuel,45,ES02209555428642879798,TRX_N-00794-90679325,2023-10-27T08:54:22,Vitoria-Gasteiz,Expense,leisure,-70.2,-45913.93
buyer_6,Manuel,45,ES02209555428642879798,TRX_N-00795-46612407,2023-10-27T19:11:09,Vitoria-Gasteiz,Expense,cash,-100.0,-46013.93
buyer_6,Manuel,45,ES02209555428642879798,TRX_N-00796-37300844,2023-10-27T18:18:52,Vitoria-Gasteiz,Expense,repairs,-189.22,-46203.15
buyer_6,Manuel,45,ES02209555428642879798,TRX_N-00797-19633149,2023-10-31T01:57:23,Vitoria-Gasteiz,Expense,leisure,-29.19,-46232.34
buyer_6,Manuel,45,ES02209555428642879798,TRX_N-00798-43036757,2023-11-01T13:37:09,Vitoria-Gasteiz,incomes,salary,1387.48,-44844.86
buyer_6,Manuel,45,ES02209555428642879798,TRX_N-00799-30183369,2023-11-01T13:37:09,Vitoria-Gasteiz,incomes,salary_partner,1344.84,-43500.02
buyer_6,Manuel,45,ES02209555428642879798,TRX_N-00800-26893689,2023-11-01T22:32:19,Vitoria-Gasteiz,Expense,education,-74.58,-43574.6
buyer_6,Manuel,45,ES02209555428642879798,TRX_N-00801-78956767,2023-11-02T11:04:40,Vitoria-Gasteiz,Expense,gifts,-94.6,-43669.2
buyer_6,Manuel,45,ES02209555428642879798,TRX_N-00802-30175606,2023-11-03T20:41:28,Vitoria-Gasteiz,Expense,transport,-54.66,-43723.86
buyer_6,Manuel,45,ES02209555428642879798,TRX_N-00803-91621342,2023-11-04T17:26:08,Vitoria-Gasteiz,expenses,mortgage,-998.07,-44721.93
buyer_6,Manuel,45,ES02209555428642879798,TRX_N-00804-20874082,2023-11-04T14:44:34,Vitoria-Gasteiz,Expense,repairs,-308.63,-45030.56
buyer_6,Manuel,45,ES02209555428642879798,TRX_N-00805-45890477,2023-11-05T12:30:49,Vitoria-Gasteiz,expenses,water,-31.7,-45062.26
buyer_6,Manuel,45,ES02209555428642879798,TRX_N-00806-00472580,2023-11-05T10:03:43,Vitoria-Gasteiz,expenses,electricity,-27.12,-45089.38
buyer_6,Manuel,45,ES02209555428642879798,TRX_N-00807-01497380,2023-11-05T15:21:02,Vitoria-Gasteiz,expenses,children,-214.49,-45303.87
buyer_6,Manuel,45,ES02209555428642879798,TRX_N-00808-57261492,2023-11-08T15:25:20,Vitoria-Gasteiz,expenses,phone,-33.88,-45337.75
buyer_6,Manuel,45,ES02209555428642879798,TRX_N-00809-67813609,2023-11-08T15:58:52,Vitoria-Gasteiz,expenses,gas,-67.32,-45405.07
buyer_6,Manuel,45,ES02209555428642879798,TRX_N-00810-24075128,2023-11-08T21:47:15,Vitoria-Gasteiz,expenses,internet,-42.0,-45447.07
buyer_6,Manuel,45,ES02209555428642879798,TRX_N-00811-30357381,2023-11-09T01:23:15,Vitoria-Gasteiz,Expense,transport,-63.37,-45510.44
buyer_6,Manuel,45,ES02209555428642879798,TRX_N-00812-73686333,2023-11-09T16:02:12,Vitoria-Gasteiz,Expense,clothing,-83.83,-45594.27
buyer_6,Manuel,45,ES02209555428642879798,TRX_N-00813-32713749,2023-11-10T09:14:57,Vitoria-Gasteiz,Expense,transport,-52.93,-45647.2
buyer_6,Manuel,45,ES02209555428642879798,TRX_N-00814-61428497,2023-11-11T09:44:45,Vitoria-Gasteiz,Expense,education,-63.75,-45710.95
buyer_6,Manuel,45,ES02209555428642879798,TRX_N-00815-69133990,2023-11-12T09:56:01,Vitoria-Gasteiz,Expense,cash,-100.0,-45810.95
buyer_6,Manuel,45,ES02209555428642879798,TRX_N-00816-42275207,2023-11-15T22:20:01,Vitoria-Gasteiz,Expense,travel,-1396.61,-47207.56
buyer_6,Manuel,45,ES02209555428642879798,TRX_N-00817-56236952,2023-11-16T16:41:22,Vitoria-Gasteiz,Expense,cash,-100.0,-47307.56
buyer_6,Manuel,45,ES02209555428642879798,TRX_N-00818-51087211,2023-11-17T19:41:02,Mungia,Expense,food,-98.74,-47406.3
buyer_6,Manuel,45,ES02209555428642879798,TRX_N-00819-00292642,2023-11-17T11:59:48,Vitoria-Gasteiz,Expense,transport,-71.27,-47477.57
buyer_6,Manuel,45,ES02209555428642879798,TRX_N-00820-51499893,2023-11-21T14:38:37,Barakaldo,Expense,transport,-78.37,-47555.94
buyer_6,Manuel,45,ES02209555428642879798,TRX_N-00821-90797679,2023-11-21T10:04:28,Hernani,Expense,leisure,-62.84,-47618.78
buyer_6,Manuel,45,ES02209555428642879798,TRX_N-00822-63950139,2023-11-21T11:42:45,Amurrio,Expense,cash,-100.0,-47718.78
buyer_6,Manuel,45,ES02209555428642879798,TRX_N-00823-54436729,2023-11-22T21:59:04,Vitoria-Gasteiz,Expense,food,-99.03,-47817.81
buyer_6,Manuel,45,ES02209555428642879798,TRX_N-00824-08082538,2023-11-23T12:28:58,Vitoria-Gasteiz,Expense,cash,-100.0,-47917.81
buyer_6,Manuel,45,ES02209555428642879798,TRX_N-00825-69754697,2023-11-24T12:38:47,Vitoria-Gasteiz,Expense,food,-63.57,-47981.38
buyer_6,Manuel,45,ES02209555428642879798,TRX_N-00826-28687938,2023-11-24T08:37:52,Vitoria-Gasteiz,Expense,transport,-47.5,-48028.88
buyer_6,Manuel,45,ES02209555428642879798,TRX_N-00827-76831796,2023-11-24T05:11:32,Vitoria-Gasteiz,Expense,cash,-100.0,-48128.88
buyer_6,Manuel,45,ES02209555428642879798,TRX_N-00828-05738726,2023-11-25T16:08:26,Donostia,Expense,leisure,-32.58,-48161.46
buyer_6,Manuel,45,ES02209555428642879798,TRX_N-00829-18533962,2023-11-26T14:03:18,Vitoria-Gasteiz,Expense,food,-106.96,-48268.42
buyer_6,Manuel,45,ES02209555428642879798,TRX_N-00830-57428456,2023-11-27T10:31:51,Eibar,Expense,clothing,-119.96,-48388.38
buyer_6,Manuel,45,ES02209555428642879798,TRX_N-00831-90009342,2023-11-27T16:01:59,Galdakao,Expense,cash,-100.0,-48488.38
buyer_6,Manuel,45,ES02209555428642879798,TRX_N-00832-57174707,2023-11-28T15:56:58,Vitoria-Gasteiz,Expense,appliances,-332.71,-48821.09
buyer_6,Manuel,45,ES02209555428642879798,TRX_N-00833-83778031,2023-11-29T11:49:42,Vitoria-Gasteiz,Expense,food,-95.51,-48916.6
buyer_6,Manuel,45,ES02209555428642879798,TRX_N-00834-36362150,2023-11-29T16:21:15,Vitoria-Gasteiz,Expense,healthcare,-125.22,-49041.82
buyer_6,Manuel,45,ES02209555428642879798,TRX_N-00835-62412649,2023-12-01T16:00:45,Vitoria-Gasteiz,incomes,salary,1387.48,-47654.34
buyer_6,Manuel,45,ES02209555428642879798,TRX_N-00836-67411880,2023-12-01T16:00:45,Vitoria-Gasteiz,incomes,salary_partner,1344.84,-46309.5
buyer_6,Manuel,45,ES02209555428642879798,TRX_N-00837-88179691,2023-12-01T16:00:45,Vitoria-Gasteiz,incomes,salary_bonus,1057.04,-45252.46
buyer_6,Manuel,45,ES02209555428642879798,TRX_N-00838-62052437,2023-12-01T16:00:45,Vitoria-Gasteiz,incomes,salary_partner_bonus,1037.87,-44214.59
buyer_6,Manuel,45,ES02209555428642879798,TRX_N-00839-45222692,2023-12-01T16:45:10,Portugalete,Expense,repairs,-65.81,-44280.4
buyer_6,Manuel,45,ES02209555428642879798,TRX_N-00840-10924151,2023-12-02T10:29:32,Vitoria-Gasteiz,expenses,children,-268.59,-44548.99
buyer_6,Manuel,45,ES02209555428642879798,TRX_N-00841-27221266,2023-12-04T16:51:43,Vitoria-Gasteiz,expenses,mortgage,-998.07,-45547.06
buyer_6,Manuel,45,ES02209555428642879798,TRX_N-00842-81903622,2023-12-05T04:56:58,Vitoria-Gasteiz,expenses,water,-39.62,-45586.68
buyer_6,Manuel,45,ES02209555428642879798,TRX_N-00843-48175027,2023-12-05T11:39:36,Vitoria-Gasteiz,expenses,electricity,-55.23,-45641.91
buyer_6,Manuel,45,ES02209555428642879798,TRX_N-00844-73332728,2023-12-05T14:56:28,Vitoria-Gasteiz,Expense,cash,-100.0,-45741.91
buyer_6,Manuel,45,ES02209555428642879798,TRX_N-00845-29479610,2023-12-06T14:58:45,Vitoria-Gasteiz,expenses,gas,-65.67,-45807.58
buyer_6,Manuel,45,ES02209555428642879798,TRX_N-00846-18011366,2023-12-06T19:16:47,Vitoria-Gasteiz,expenses,internet,-42.0,-45849.58
buyer_6,Manuel,45,ES02209555428642879798,TRX_N-00847-22366876,2023-12-06T12:06:04,Vitoria-Gasteiz,expenses,phone,-43.91,-45893.49
buyer_6,Manuel,45,ES02209555428642879798,TRX_N-00848-09295979,2023-12-06T10:23:09,Vitoria-Gasteiz,Expense,repairs,-235.35,-46128.84
buyer_6,Manuel,45,ES02209555428642879798,TRX_N-00849-14384573,2023-12-07T15:49:50,Vitoria-Gasteiz,Expense,food,-110.12,-46238.96
buyer_6,Manuel,45,ES02209555428642879798,TRX_N-00850-53552462,2023-12-07T16:26:22,Vitoria-Gasteiz,Expense,cash,-100.0,-46338.96
buyer_6,Manuel,45,ES02209555428642879798,TRX_N-00851-33618089,2023-12-07T12:24:51,Vitoria-Gasteiz,expenses,children,-85.55,-46424.51
buyer_6,Manuel,45,ES02209555428642879798,TRX_N-00852-38881217,2023-12-11T15:21:08,Vitoria-Gasteiz,expenses,children,-52.54,-46477.05
buyer_6,Manuel,45,ES02209555428642879798,TRX_N-00853-55407901,2023-12-14T14:04:02,Vitoria-Gasteiz,Expense,food,-118.51,-46595.56
buyer_6,Manuel,45,ES02209555428642879798,TRX_N-00854-50714869,2023-12-14T17:50:33,Vitoria-Gasteiz,Expense,cash,-100.0,-46695.56
buyer_6,Manuel,45,ES02209555428642879798,TRX_N-00855-93744272,2023-12-16T12:24:55,Vitoria-Gasteiz,Expense,repairs,-73.05,-46768.61
buyer_6,Manuel,45,ES02209555428642879798,TRX_N-00856-21112212,2023-12-17T19:20:54,Vitoria-Gasteiz,Expense,leisure,-40.24,-46808.85
buyer_6,Manuel,45,ES02209555428642879798,TRX_N-00857-74137859,2023-12-18T13:35:49,Lasarte-Oria,Expense,cash,-100.0,-46908.85
buyer_6,Manuel,45,ES02209555428642879798,TRX_N-00858-49978215,2023-12-19T18:37:31,Vitoria-Gasteiz,Expense,leisure,-26.8,-46935.65
buyer_6,Manuel,45,ES02209555428642879798,TRX_N-00859-53258119,2023-12-20T15:50:17,Vitoria-Gasteiz,Expense,clothing,-52.7,-46988.35
buyer_6,Manuel,45,ES02209555428642879798,TRX_N-00860-88119598,2023-12-20T15:52:46,Vitoria-Gasteiz,Expense,education,-61.76,-47050.11
buyer_6,Manuel,45,ES02209555428642879798,TRX_N-00861-98587647,2023-12-22T11:43:48,Vitoria-Gasteiz,Expense,leisure,-68.65,-47118.76
buyer_6,Manuel,45,ES02209555428642879798,TRX_N-00862-55895829,2023-12-22T20:34:19,Vitoria-Gasteiz,Expense,appliances,-242.61,-47361.37
buyer_6,Manuel,45,ES02209555428642879798,TRX_N-00863-20031853,2023-12-24T14:19:31,Vitoria-Gasteiz,Expense,repairs,-30.11,-47391.48
buyer_6,Manuel,45,ES02209555428642879798,TRX_N-00864-54056229,2023-12-29T08:06:18,Vitoria-Gasteiz,Expense,gifts,-361.19,-47752.67
buyer_6,Manuel,45,ES02209555428642879798,TRX_N-00865-68311440,2023-12-30T19:31:45,Vitoria-Gasteiz,Expense,repairs,-79.58,-47832.25
buyer_6,Manuel,45,ES02209555428642879798,TRX_N-00866-19594012,2023-12-31T05:04:19,Donostia,Expense,repairs,-119.05,-47951.3
buyer_6,Manuel,45,ES02209555428642879798,TRX_N-00867-21942535,2024-01-01T17:42:00,Vitoria-Gasteiz,incomes,salary,1425.89,-46525.41
buyer_6,Manuel,45,ES02209555428642879798,TRX_N-00868-41138136,2024-01-01T17:42:00,Vitoria-Gasteiz,incomes,salary_partner,1382.07,-45143.34
buyer_6,Manuel,45,ES02209555428642879798,TRX_N-00869-59310755,2024-01-03T11:00:22,Vitoria-Gasteiz,Expense,cash,-100.0,-45243.34
buyer_6,Manuel,45,ES02209555428642879798,TRX_N-00870-00257684,2024-01-04T18:38:51,Vitoria-Gasteiz,expenses,mortgage,-998.07,-46241.41
buyer_6,Manuel,45,ES02209555428642879798,TRX_N-00871-62263176,2024-01-04T12:20:55,Vitoria-Gasteiz,Expense,leisure,-68.59,-46310.0
buyer_6,Manuel,45,ES02209555428642879798,TRX_N-00872-11784736,2024-01-05T15:26:19,Vitoria-Gasteiz,expenses,water,-34.13,-46344.13
buyer_6,Manuel,45,ES02209555428642879798,TRX_N-00873-57596669,2024-01-05T16:41:28,Vitoria-Gasteiz,expenses,phone,-42.82,-46386.95
buyer_6,Manuel,45,ES02209555428642879798,TRX_N-00874-99448676,2024-01-05T16:42:02,Vitoria-Gasteiz,Expense,food,-121.19,-46508.14
buyer_6,Manuel,45,ES02209555428642879798,TRX_N-00875-71075532,2024-01-05T14:27:07,Vitoria-Gasteiz,Expense,repairs,-293.44,-46801.58
buyer_6,Manuel,45,ES02209555428642879798,TRX_N-00876-23953967,2024-01-06T19:59:36,Vitoria-Gasteiz,expenses,children,-267.75,-47069.33
buyer_6,Manuel,45,ES02209555428642879798,TRX_N-00877-70219762,2024-01-08T20:44:47,Vitoria-Gasteiz,expenses,electricity,-20.11,-47089.44
buyer_6,Manuel,45,ES02209555428642879798,TRX_N-00878-36557869,2024-01-08T15:25:51,Vitoria-Gasteiz,expenses,gas,-106.98,-47196.42
buyer_6,Manuel,45,ES02209555428642879798,TRX_N-00879-45248315,2024-01-08T20:59:37,Vitoria-Gasteiz,expenses,internet,-42.0,-47238.42
buyer_6,Manuel,45,ES02209555428642879798,TRX_N-00880-10759801,2024-01-08T10:36:21,Vitoria-Gasteiz,Expense,cash,-100.0,-47338.42
buyer_6,Manuel,45,ES02209555428642879798,TRX_N-00881-86519997,2024-01-09T09:08:51,Vitoria-Gasteiz,Expense,food,-67.73,-47406.15
buyer_6,Manuel,45,ES02209555428642879798,TRX_N-00882-89609685,2024-01-10T17:52:10,Vitoria-Gasteiz,Expense,food,-108.48,-47514.63
buyer_6,Manuel,45,ES02209555428642879798,TRX_N-00883-27753536,2024-01-10T14:37:23,Vitoria-Gasteiz,Expense,transport,-58.66,-47573.29
buyer_6,Manuel,45,ES02209555428642879798,TRX_N-00884-53074193,2024-01-11T03:13:48,Donostia,Expense,food,-65.67,-47638.96
buyer_6,Manuel,45,ES02209555428642879798,TRX_N-00885-21507363,2024-01-12T22:27:46,Vitoria-Gasteiz,Expense,transport,-51.0,-47689.96
buyer_6,Manuel,45,ES02209555428642879798,TRX_N-00886-07126186,2024-01-13T09:47:51,Vitoria-Gasteiz,Expense,cash,-100.0,-47789.96
buyer_6,Manuel,45,ES02209555428642879798,TRX_N-00887-17296265,2024-01-13T08:47:33,Vitoria-Gasteiz,Expense,repairs,-299.74,-48089.7
buyer_6,Manuel,45,ES02209555428642879798,TRX_N-00888-46695938,2024-01-13T08:22:02,Vitoria-Gasteiz,Expense,gifts,-404.04,-48493.74
buyer_6,Manuel,45,ES02209555428642879798,TRX_N-00889-77639151,2024-01-16T12:30:29,Vitoria-Gasteiz,Expense,transport,-45.85,-48539.59
buyer_6,Manuel,45,ES02209555428642879798,TRX_N-00890-12139390,2024-01-17T14:50:12,Hernani,Expense,transport,-67.26,-48606.85
buyer_6,Manuel,45,ES02209555428642879798,TRX_N-00891-49072075,2024-01-18T14:03:03,Vitoria-Gasteiz,Expense,gifts,-690.14,-49296.99
buyer_6,Manuel,45,ES02209555428642879798,TRX_N-00892-08150483,2024-01-19T13:08:56,Vitoria-Gasteiz,Expense,cash,-100.0,-49396.99
buyer_6,Manuel,45,ES02209555428642879798,TRX_N-00893-87457773,2024-01-20T13:14:03,Arrasate,Expense,transport,-53.91,-49450.9
buyer_6,Manuel,45,ES02209555428642879798,TRX_N-00894-81649420,2024-01-20T22:06:30,Vitoria-Gasteiz,Expense,travel,-1743.98,-51194.88
buyer_6,Manuel,45,ES02209555428642879798,TRX_N-00895-80860044,2024-01-21T15:40:08,Vitoria-Gasteiz,expenses,children,-156.39,-51351.27
buyer_6,Manuel,45,ES02209555428642879798,TRX_N-00896-60996552,2024-01-23T18:39:22,Vitoria-Gasteiz,Expense,food,-105.82,-51457.09
buyer_6,Manuel,45,ES02209555428642879798,TRX_N-00897-81919265,2024-01-26T03:17:51,Vitoria-Gasteiz,Expense,food,-85.45,-51542.54
buyer_6,Manuel,45,ES02209555428642879798,TRX_N-00898-47149729,2024-01-28T01:14:17,Bilbao,Expense,food,-107.74,-51650.28
buyer_6,Manuel,45,ES02209555428642879798,TRX_N-00899-98918220,2024-01-28T16:42:29,Sestao,Expense,transport,-88.25,-51738.53
buyer_6,Manuel,45,ES02209555428642879798,TRX_N-00900-14716197,2024-01-28T18:02:49,Vitoria-Gasteiz,Expense,leisure,-65.68,-51804.21
buyer_6,Manuel,45,ES02209555428642879798,TRX_N-00901-02760599,2024-01-28T04:52:51,Vitoria-Gasteiz,Expense,gifts,-772.81,-52577.02
buyer_6,Manuel,45,ES02209555428642879798,TRX_N-00902-31907327,2024-01-29T18:06:28,Vitoria-Gasteiz,expenses,children,-119.88,-52696.9
buyer_6,Manuel,45,ES02209555428642879798,TRX_N-00903-48828544,2024-01-30T14:46:55,Vitoria-Gasteiz,Expense,food,-118.35,-52815.25
buyer_6,Manuel,45,ES02209555428642879798,TRX_N-00904-42461857,2024-01-30T09:31:43,Vitoria-Gasteiz,Expense,leisure,-53.62,-52868.87
buyer_6,Manuel,45,ES02209555428642879798,TRX_N-00905-67598010,2024-01-30T17:02:36,Arrasate,Expense,clothing,-138.88,-53007.75
buyer_6,Manuel,45,ES02209555428642879798,TRX_N-00906-45682254,2024-01-31T11:45:48,Vitoria-Gasteiz,Expense,education,-48.13,-53055.88
buyer_6,Manuel,45,ES02209555428642879798,TRX_N-00907-97228479,2024-01-31T08:52:09,Vitoria-Gasteiz,Expense,repairs,-285.96,-53341.84
buyer_6,Manuel,45,ES02209555428642879798,TRX_N-00908-57855197,2024-02-01T09:22:36,Vitoria-Gasteiz,incomes,salary,1425.89,-51915.95
buyer_6,Manuel,45,ES02209555428642879798,TRX_N-00909-04923808,2024-02-01T09:22:36,Vitoria-Gasteiz,incomes,salary_partner,1382.07,-50533.88
buyer_6,Manuel,45,ES02209555428642879798,TRX_N-00910-06565556,2024-02-01T09:22:36,Vitoria-Gasteiz,incomes,extra_income,235.66,-50298.22
buyer_6,Manuel,45,ES02209555428642879798,TRX_N-00911-36025791,2024-02-01T00:06:43,Vitoria-Gasteiz,Expense,healthcare,-58.61,-50356.83
buyer_6,Manuel,45,ES02209555428642879798,TRX_N-00912-76239177,2024-02-04T10:56:19,Vitoria-Gasteiz,expenses,mortgage,-998.07,-51354.9
buyer_6,Manuel,45,ES02209555428642879798,TRX_N-00913-72587854,2024-02-05T08:05:50,Vitoria-Gasteiz,expenses,electricity,-73.51,-51428.41
buyer_6,Manuel,45,ES02209555428642879798,TRX_N-00914-97997454,2024-02-05T15:16:39,Vitoria-Gasteiz,expenses,phone,-34.5,-51462.91
buyer_6,Manuel,45,ES02209555428642879798,TRX_N-00915-95170807,2024-02-05T15:10:53,Vitoria-Gasteiz,Expense,food,-89.56,-51552.47
buyer_6,Manuel,45,ES02209555428642879798,TRX_N-00916-33266275,2024-02-05T20:23:21,Vitoria-Gasteiz,Expense,leisure,-28.13,-51580.6
buyer_6,Manuel,45,ES02209555428642879798,TRX_N-00917-25391668,2024-02-06T20:32:37,Vitoria-Gasteiz,expenses,gas,-86.42,-51667.02
buyer_6,Manuel,45,ES02209555428642879798,TRX_N-00918-02550944,2024-02-06T08:23:07,Vitoria-Gasteiz,Expense,transport,-54.63,-51721.65
buyer_6,Manuel,45,ES02209555428642879798,TRX_N-00919-29857281,2024-02-07T08:04:37,Vitoria-Gasteiz,Expense,food,-77.06,-51798.71
buyer_6,Manuel,45,ES02209555428642879798,TRX_N-00920-07848234,2024-02-07T23:37:29,Hernani,Expense,healthcare,-130.18,-51928.89
buyer_6,Manuel,45,ES02209555428642879798,TRX_N-00921-94085572,2024-02-08T14:48:43,Vitoria-Gasteiz,expenses,water,-20.33,-51949.22
buyer_6,Manuel,45,ES02209555428642879798,TRX_N-00922-54300377,2024-02-08T06:32:08,Vitoria-Gasteiz,expenses,internet,-42.0,-51991.22
buyer_6,Manuel,45,ES02209555428642879798,TRX_N-00923-06666027,2024-02-08T13:19:44,Vitoria-Gasteiz,Expense,cash,-100.0,-52091.22
buyer_6,Manuel,45,ES02209555428642879798,TRX_N-00924-47217625,2024-02-09T19:20:00,Vitoria-Gasteiz,Expense,gifts,-191.42,-52282.64
buyer_6,Manuel,45,ES02209555428642879798,TRX_N-00925-47569305,2024-02-12T10:09:05,Vitoria-Gasteiz,Expense,appliances,-125.86,-52408.5
buyer_6,Manuel,45,ES02209555428642879798,TRX_N-00926-39796882,2024-02-13T16:32:02,Vitoria-Gasteiz,Expense,cash,-100.0,-52508.5
buyer_6,Manuel,45,ES02209555428642879798,TRX_N-00927-02113432,2024-02-15T11:29:57,Vitoria-Gasteiz,Expense,cash,-100.0,-52608.5
buyer_6,Manuel,45,ES02209555428642879798,TRX_N-00928-32686511,2024-02-16T19:40:44,Vitoria-Gasteiz,Expense,clothing,-158.1,-52766.6
buyer_6,Manuel,45,ES02209555428642879798,TRX_N-00929-85424536,2024-02-16T08:04:39,Basauri,Expense,repairs,-120.84,-52887.44
buyer_6,Manuel,45,ES02209555428642879798,TRX_N-00930-70907780,2024-02-17T23:45:26,Vitoria-Gasteiz,Expense,food,-60.41,-52947.85
buyer_6,Manuel,45,ES02209555428642879798,TRX_N-00931-41157513,2024-02-17T22:23:48,Vitoria-Gasteiz,Expense,transport,-40.14,-52987.99
buyer_6,Manuel,45,ES02209555428642879798,TRX_N-00932-75517325,2024-02-17T18:08:29,Vitoria-Gasteiz,Expense,cash,-100.0,-53087.99
buyer_6,Manuel,45,ES02209555428642879798,TRX_N-00933-71840103,2024-02-18T10:55:56,Vitoria-Gasteiz,Expense,cash,-100.0,-53187.99
buyer_6,Manuel,45,ES02209555428642879798,TRX_N-00934-33320774,2024-02-20T04:37:22,Vitoria-Gasteiz,Expense,cash,-100.0,-53287.99
buyer_6,Manuel,45,ES02209555428642879798,TRX_N-00935-03335643,2024-02-21T17:45:34,Galdakao,Expense,cash,-100.0,-53387.99
buyer_6,Manuel,45,ES02209555428642879798,TRX_N-00936-04574186,2024-02-21T16:40:13,Vitoria-Gasteiz,Expense,gifts,-519.51,-53907.5
buyer_6,Manuel,45,ES02209555428642879798,TRX_N-00937-81315682,2024-02-24T19:12:08,Vitoria-Gasteiz,Expense,cash,-100.0,-54007.5
buyer_6,Manuel,45,ES02209555428642879798,TRX_N-00938-38611474,2024-02-24T17:30:41,Vitoria-Gasteiz,Expense,repairs,-72.83,-54080.33
buyer_6,Manuel,45,ES02209555428642879798,TRX_N-00939-04415347,2024-02-27T22:33:23,Vitoria-Gasteiz,Expense,food,-61.26,-54141.59
buyer_6,Manuel,45,ES02209555428642879798,TRX_N-00940-16592121,2024-03-01T20:57:24,Vitoria-Gasteiz,incomes,salary,1425.89,-52715.7
buyer_6,Manuel,45,ES02209555428642879798,TRX_N-00941-91862562,2024-03-01T20:57:24,Vitoria-Gasteiz,incomes,salary_partner,1382.07,-51333.63
buyer_6,Manuel,45,ES02209555428642879798,TRX_N-00942-03134676,2024-03-01T19:20:55,Vitoria-Gasteiz,Expense,repairs,-70.37,-51404.0
buyer_6,Manuel,45,ES02209555428642879798,TRX_N-00943-64361140,2024-03-02T23:31:00,Vitoria-Gasteiz,Expense,clothing,-140.4,-51544.4
buyer_6,Manuel,45,ES02209555428642879798,TRX_N-00944-11922855,2024-03-02T12:08:33,Vitoria-Gasteiz,Expense,education,-74.84,-51619.24
buyer_6,Manuel,45,ES02209555428642879798,TRX_N-00945-66879831,2024-03-03T21:43:37,Vitoria-Gasteiz,Expense,food,-122.18,-51741.42
buyer_6,Manuel,45,ES02209555428642879798,TRX_N-00946-28772886,2024-03-03T08:59:42,Vitoria-Gasteiz,Expense,cash,-100.0,-51841.42
buyer_6,Manuel,45,ES02209555428642879798,TRX_N-00947-70110331,2024-03-03T18:58:10,Vitoria-Gasteiz,Expense,repairs,-39.54,-51880.96
buyer_6,Manuel,45,ES02209555428642879798,TRX_N-00948-52115103,2024-03-04T13:10:04,Vitoria-Gasteiz,expenses,mortgage,-998.07,-52879.03
buyer_6,Manuel,45,ES02209555428642879798,TRX_N-00949-28992400,2024-03-04T19:35:44,Vitoria-Gasteiz,Expense,cash,-100.0,-52979.03
buyer_6,Manuel,45,ES02209555428642879798,TRX_N-00950-59463564,2024-03-05T21:08:44,Vitoria-Gasteiz,expenses,water,-29.27,-53008.3
buyer_6,Manuel,45,ES02209555428642879798,TRX_N-00951-31522686,2024-03-05T21:02:22,Vitoria-Gasteiz,expenses,phone,-34.28,-53042.58
buyer_6,Manuel,45,ES02209555428642879798,TRX_N-00952-73711388,2024-03-06T10:50:13,Vitoria-Gasteiz,expenses,internet,-42.0,-53084.58
buyer_6,Manuel,45,ES02209555428642879798,TRX_N-00953-66924322,2024-03-06T19:13:49,Vitoria-Gasteiz,Expense,appliances,-78.21,-53162.79
buyer_6,Manuel,45,ES02209555428642879798,TRX_N-00954-60437315,2024-03-07T11:18:22,Vitoria-Gasteiz,expenses,electricity,-78.37,-53241.16
buyer_6,Manuel,45,ES02209555428642879798,TRX_N-00955-31222682,2024-03-07T18:17:49,Vitoria-Gasteiz,Expense,leisure,-59.0,-53300.16
buyer_6,Manuel,45,ES02209555428642879798,TRX_N-00956-24689213,2024-03-08T21:59:41,Vitoria-Gasteiz,expenses,gas,-102.66,-53402.82
buyer_6,Manuel,45,ES02209555428642879798,TRX_N-00957-26017388,2024-03-08T17:27:17,Oy√≥n-Oion,Expense,repairs,-171.57,-53574.39
buyer_6,Manuel,45,ES02209555428642879798,TRX_N-00958-49755715,2024-03-09T13:51:32,Vitoria-Gasteiz,Expense,healthcare,-136.58,-53710.97
buyer_6,Manuel,45,ES02209555428642879798,TRX_N-00959-09815219,2024-03-09T19:06:46,Vitoria-Gasteiz,Expense,cash,-100.0,-53810.97
buyer_6,Manuel,45,ES02209555428642879798,TRX_N-00960-89490626,2024-03-13T12:58:42,Vitoria-Gasteiz,Expense,cash,-100.0,-53910.97
buyer_6,Manuel,45,ES02209555428642879798,TRX_N-00961-60106033,2024-03-14T11:24:57,Vitoria-Gasteiz,Expense,cash,-100.0,-54010.97
buyer_6,Manuel,45,ES02209555428642879798,TRX_N-00962-94413204,2024-03-16T20:27:51,Vitoria-Gasteiz,Expense,food,-65.7,-54076.67
buyer_6,Manuel,45,ES02209555428642879798,TRX_N-00963-24214482,2024-03-16T05:30:34,Vitoria-Gasteiz,Expense,cash,-100.0,-54176.67
buyer_6,Manuel,45,ES02209555428642879798,TRX_N-00964-93108957,2024-03-17T17:51:43,Vitoria-Gasteiz,Expense,leisure,-78.21,-54254.88
buyer_6,Manuel,45,ES02209555428642879798,TRX_N-00965-24304717,2024-03-18T23:05:58,Vitoria-Gasteiz,Expense,food,-114.01,-54368.89
buyer_6,Manuel,45,ES02209555428642879798,TRX_N-00966-69417742,2024-03-18T05:07:30,Vitoria-Gasteiz,Expense,repairs,-104.04,-54472.93
buyer_6,Manuel,45,ES02209555428642879798,TRX_N-00967-96922724,2024-03-20T20:09:37,Vitoria-Gasteiz,Expense,transport,-45.69,-54518.62
buyer_6,Manuel,45,ES02209555428642879798,TRX_N-00968-63201090,2024-03-20T12:07:30,Vitoria-Gasteiz,Expense,gifts,-204.66,-54723.28
buyer_6,Manuel,45,ES02209555428642879798,TRX_N-00969-80664438,2024-03-22T20:40:18,Vitoria-Gasteiz,Expense,cash,-100.0,-54823.28
buyer_6,Manuel,45,ES02209555428642879798,TRX_N-00970-62947245,2024-03-24T15:03:23,Hernani,Expense,food,-100.52,-54923.8
buyer_6,Manuel,45,ES02209555428642879798,TRX_N-00971-24262784,2024-03-25T13:21:06,Vitoria-Gasteiz,Expense,leisure,-65.55,-54989.35
buyer_6,Manuel,45,ES02209555428642879798,TRX_N-00972-43344226,2024-03-29T11:12:49,Durango,Expense,clothing,-57.59,-55046.94
buyer_6,Manuel,45,ES02209555428642879798,TRX_N-00973-00563225,2024-03-29T13:17:20,Vitoria-Gasteiz,Expense,healthcare,-104.0,-55150.94
buyer_6,Manuel,45,ES02209555428642879798,TRX_N-00974-81763032,2024-03-30T09:23:56,Vitoria-Gasteiz,Expense,transport,-75.3,-55226.24
buyer_6,Manuel,45,ES02209555428642879798,TRX_N-00975-76420279,2024-03-31T21:49:04,Vitoria-Gasteiz,Expense,food,-62.8,-55289.04
buyer_6,Manuel,45,ES02209555428642879798,TRX_N-00976-94631627,2024-03-31T09:26:03,Vitoria-Gasteiz,Expense,transport,-74.71,-55363.75
buyer_6,Manuel,45,ES02209555428642879798,TRX_N-00977-62460598,2024-03-31T11:42:00,Vitoria-Gasteiz,Expense,gifts,-188.05,-55551.8
buyer_6,Manuel,45,ES02209555428642879798,TRX_N-00978-40210985,2024-04-01T10:50:42,Vitoria-Gasteiz,incomes,salary,1425.89,-54125.91
buyer_6,Manuel,45,ES02209555428642879798,TRX_N-00979-37014244,2024-04-01T10:50:42,Vitoria-Gasteiz,incomes,salary_partner,1382.07,-52743.84
buyer_6,Manuel,45,ES02209555428642879798,TRX_N-00980-60451864,2024-04-01T19:51:41,Vitoria-Gasteiz,Expense,leisure,-21.44,-52765.28
buyer_6,Manuel,45,ES02209555428642879798,TRX_N-00981-63863176,2024-04-01T06:54:21,Andoain,Expense,cash,-100.0,-52865.28
buyer_6,Manuel,45,ES02209555428642879798,TRX_N-00982-32465177,2024-04-02T09:04:18,Vitoria-Gasteiz,Expense,food,-111.83,-52977.11
buyer_6,Manuel,45,ES02209555428642879798,TRX_N-00983-77631111,2024-04-04T09:46:55,Vitoria-Gasteiz,expenses,mortgage,-998.07,-53975.18
buyer_6,Manuel,45,ES02209555428642879798,TRX_N-00984-43119449,2024-04-04T17:33:05,Vitoria-Gasteiz,Expense,leisure,-59.75,-54034.93
buyer_6,Manuel,45,ES02209555428642879798,TRX_N-00985-11214275,2024-04-04T10:32:17,Vitoria-Gasteiz,Expense,cash,-100.0,-54134.93
buyer_6,Manuel,45,ES02209555428642879798,TRX_N-00986-67279411,2024-04-05T09:15:18,Vitoria-Gasteiz,expenses,internet,-42.0,-54176.93
buyer_6,Manuel,45,ES02209555428642879798,TRX_N-00987-92440076,2024-04-05T09:05:48,Vitoria-Gasteiz,Expense,food,-80.67,-54257.6
buyer_6,Manuel,45,ES02209555428642879798,TRX_N-00988-48633873,2024-04-06T11:22:21,Vitoria-Gasteiz,expenses,water,-32.05,-54289.65
buyer_6,Manuel,45,ES02209555428642879798,TRX_N-00989-59978193,2024-04-06T13:30:13,Vitoria-Gasteiz,expenses,electricity,-56.74,-54346.39
buyer_6,Manuel,45,ES02209555428642879798,TRX_N-00990-24199744,2024-04-06T21:07:30,Vitoria-Gasteiz,expenses,phone,-41.06,-54387.45
buyer_6,Manuel,45,ES02209555428642879798,TRX_N-00991-38047631,2024-04-07T12:29:56,Vitoria-Gasteiz,Expense,transport,-75.77,-54463.22
buyer_6,Manuel,45,ES02209555428642879798,TRX_N-00992-87151217,2024-04-07T13:01:52,Vitoria-Gasteiz,Expense,clothing,-117.06,-54580.28
buyer_6,Manuel,45,ES02209555428642879798,TRX_N-00993-01284145,2024-04-07T14:28:43,Eibar,Expense,healthcare,-56.6,-54636.88
buyer_6,Manuel,45,ES02209555428642879798,TRX_N-00994-96861711,2024-04-08T22:45:06,Vitoria-Gasteiz,expenses,gas,-34.77,-54671.65
buyer_6,Manuel,45,ES02209555428642879798,TRX_N-00995-88775389,2024-04-09T14:26:19,Vitoria-Gasteiz,Expense,food,-76.42,-54748.07
buyer_6,Manuel,45,ES02209555428642879798,TRX_N-00996-67562722,2024-04-10T09:31:53,Irun,Expense,leisure,-24.71,-54772.78
buyer_6,Manuel,45,ES02209555428642879798,TRX_N-00997-32698823,2024-04-12T11:06:02,Vitoria-Gasteiz,Expense,transport,-45.0,-54817.78
buyer_6,Manuel,45,ES02209555428642879798,TRX_N-00998-65294903,2024-04-13T17:57:20,Vitoria-Gasteiz,Expense,cash,-100.0,-54917.78
buyer_6,Manuel,45,ES02209555428642879798,TRX_N-00999-35364224,2024-04-14T20:28:17,Vitoria-Gasteiz,Expense,education,-46.52,-54964.3
buyer_6,Manuel,45,ES02209555428642879798,TRX_N-01000-82264593,2024-04-14T18:23:25,Vitoria-Gasteiz,Expense,cash,-100.0,-55064.3
buyer_6,Manuel,45,ES02209555428642879798,TRX_N-01001-28531321,2024-04-15T15:18:28,Vitoria-Gasteiz,Expense,transport,-84.53,-55148.83
buyer_6,Manuel,45,ES02209555428642879798,TRX_N-01002-99357680,2024-04-15T20:24:27,Vitoria-Gasteiz,Expense,leisure,-26.32,-55175.15
buyer_6,Manuel,45,ES02209555428642879798,TRX_N-01003-13696504,2024-04-16T12:27:32,Vitoria-Gasteiz,Expense,food,-75.48,-55250.63
buyer_6,Manuel,45,ES02209555428642879798,TRX_N-01004-03355181,2024-04-16T17:20:08,Vitoria-Gasteiz,Expense,gifts,-760.37,-56011.0
buyer_6,Manuel,45,ES02209555428642879798,TRX_N-01005-92959263,2024-04-17T12:50:44,Vitoria-Gasteiz,Expense,leisure,-27.07,-56038.07
buyer_6,Manuel,45,ES02209555428642879798,TRX_N-01006-73707819,2024-04-19T15:27:22,Vitoria-Gasteiz,Expense,transport,-85.04,-56123.11
buyer_6,Manuel,45,ES02209555428642879798,TRX_N-01007-19563277,2024-04-19T16:35:20,Vitoria-Gasteiz,Expense,cash,-100.0,-56223.11
buyer_6,Manuel,45,ES02209555428642879798,TRX_N-01008-15858979,2024-04-21T15:52:02,Vitoria-Gasteiz,Expense,repairs,-103.19,-56326.3
buyer_6,Manuel,45,ES02209555428642879798,TRX_N-01009-52514133,2024-04-22T00:24:06,Vitoria-Gasteiz,Expense,food,-85.53,-56411.83
buyer_6,Manuel,45,ES02209555428642879798,TRX_N-01010-86630591,2024-04-24T18:33:06,Vitoria-Gasteiz,Expense,repairs,-307.89,-56719.72
buyer_6,Manuel,45,ES02209555428642879798,TRX_N-01011-37483767,2024-04-24T08:09:01,Alegr√≠a-Dulantzi,Expense,gifts,-415.65,-57135.37
buyer_6,Manuel,45,ES02209555428642879798,TRX_N-01012-46676578,2024-04-25T12:00:22,Vitoria-Gasteiz,Expense,food,-64.33,-57199.7
buyer_6,Manuel,45,ES02209555428642879798,TRX_N-01013-88549736,2024-04-26T20:54:54,Vitoria-Gasteiz,Expense,appliances,-284.63,-57484.33
buyer_6,Manuel,45,ES02209555428642879798,TRX_N-01014-72789212,2024-04-27T13:08:52,Mungia,Expense,cash,-100.0,-57584.33
buyer_6,Manuel,45,ES02209555428642879798,TRX_N-01015-10656066,2024-04-28T08:33:29,Vitoria-Gasteiz,Expense,food,-67.46,-57651.79
buyer_6,Manuel,45,ES02209555428642879798,TRX_N-01016-59492809,2024-04-29T00:22:56,Vitoria-Gasteiz,Expense,transport,-79.57,-57731.36
buyer_6,Manuel,45,ES02209555428642879798,TRX_N-01017-95527569,2024-05-01T13:16:56,Vitoria-Gasteiz,incomes,salary,1425.89,-56305.47
buyer_6,Manuel,45,ES02209555428642879798,TRX_N-01018-83330495,2024-05-01T13:16:56,Vitoria-Gasteiz,incomes,salary_partner,1382.07,-54923.4
buyer_6,Manuel,45,ES02209555428642879798,TRX_N-01019-59436838,2024-05-01T13:16:56,Vitoria-Gasteiz,incomes,extra_income,235.66,-54687.74
buyer_6,Manuel,45,ES02209555428642879798,TRX_N-01020-56148295,2024-05-01T13:26:04,Vitoria-Gasteiz,Expense,education,-73.4,-54761.14
buyer_6,Manuel,45,ES02209555428642879798,TRX_N-01021-78337775,2024-05-02T20:17:05,Vitoria-Gasteiz,Expense,clothing,-106.97,-54868.11
buyer_6,Manuel,45,ES02209555428642879798,TRX_N-01022-93932084,2024-05-02T18:50:29,Vitoria-Gasteiz,Expense,repairs,-187.13,-55055.24
buyer_6,Manuel,45,ES02209555428642879798,TRX_N-01023-10827539,2024-05-03T08:18:38,Vitoria-Gasteiz,Expense,food,-111.7,-55166.94
buyer_6,Manuel,45,ES02209555428642879798,TRX_N-01024-62183100,2024-05-03T18:32:37,Vitoria-Gasteiz,Expense,cash,-100.0,-55266.94
buyer_6,Manuel,45,ES02209555428642879798,TRX_N-01025-02553704,2024-05-03T11:36:51,Vitoria-Gasteiz,Expense,repairs,-60.14,-55327.08
buyer_6,Manuel,45,ES02209555428642879798,TRX_N-01026-77247855,2024-05-03T08:30:59,Vitoria-Gasteiz,Expense,gifts,-439.05,-55766.13
buyer_6,Manuel,45,ES02209555428642879798,TRX_N-01027-03802220,2024-05-04T04:04:00,Vitoria-Gasteiz,expenses,mortgage,-998.07,-56764.2
buyer_6,Manuel,45,ES02209555428642879798,TRX_N-01028-43627242,2024-05-04T20:01:07,Vitoria-Gasteiz,Expense,transport,-41.14,-56805.34
buyer_6,Manuel,45,ES02209555428642879798,TRX_N-01029-21941340,2024-05-05T17:12:46,Vitoria-Gasteiz,Expense,leisure,-21.69,-56827.03
buyer_6,Manuel,45,ES02209555428642879798,TRX_N-01030-53151275,2024-05-06T14:14:50,Vitoria-Gasteiz,expenses,electricity,-40.92,-56867.95
buyer_6,Manuel,45,ES02209555428642879798,TRX_N-01031-43728742,2024-05-06T09:07:49,Vitoria-Gasteiz,Expense,appliances,-261.24,-57129.19
buyer_6,Manuel,45,ES02209555428642879798,TRX_N-01032-60251420,2024-05-07T12:22:03,Vitoria-Gasteiz,expenses,water,-40.11,-57169.3
buyer_6,Manuel,45,ES02209555428642879798,TRX_N-01033-61821543,2024-05-07T19:36:33,Vitoria-Gasteiz,expenses,gas,-55.0,-57224.3
buyer_6,Manuel,45,ES02209555428642879798,TRX_N-01034-83814335,2024-05-08T20:53:09,Vitoria-Gasteiz,expenses,internet,-42.0,-57266.3
buyer_6,Manuel,45,ES02209555428642879798,TRX_N-01035-56547550,2024-05-08T19:21:07,Vitoria-Gasteiz,expenses,phone,-40.87,-57307.17
buyer_6,Manuel,45,ES02209555428642879798,TRX_N-01036-00645363,2024-05-08T20:18:17,Vitoria-Gasteiz,Expense,leisure,-65.75,-57372.92
buyer_6,Manuel,45,ES02209555428642879798,TRX_N-01037-33975080,2024-05-10T11:21:35,Vitoria-Gasteiz,Expense,cash,-100.0,-57472.92
buyer_6,Manuel,45,ES02209555428642879798,TRX_N-01038-96262426,2024-05-11T10:25:47,Vitoria-Gasteiz,Expense,food,-107.32,-57580.24
buyer_6,Manuel,45,ES02209555428642879798,TRX_N-01039-70585601,2024-05-15T16:50:12,Errenteria,Expense,cash,-100.0,-57680.24
buyer_6,Manuel,45,ES02209555428642879798,TRX_N-01040-00709898,2024-05-16T07:50:52,Vitoria-Gasteiz,Expense,appliances,-104.94,-57785.18
buyer_6,Manuel,45,ES02209555428642879798,TRX_N-01041-59989424,2024-05-22T12:50:17,Vitoria-Gasteiz,Expense,cash,-100.0,-57885.18
buyer_6,Manuel,45,ES02209555428642879798,TRX_N-01042-09712829,2024-05-22T21:43:59,Vitoria-Gasteiz,expenses,children,-107.27,-57992.45
buyer_6,Manuel,45,ES02209555428642879798,TRX_N-01043-29905226,2024-05-23T19:04:22,Vitoria-Gasteiz,Expense,cash,-100.0,-58092.45
buyer_6,Manuel,45,ES02209555428642879798,TRX_N-01044-19789073,2024-05-25T18:10:37,Basauri,Expense,repairs,-174.63,-58267.08
buyer_6,Manuel,45,ES02209555428642879798,TRX_N-01045-33988429,2024-05-26T18:01:17,Vitoria-Gasteiz,Expense,leisure,-45.81,-58312.89
buyer_6,Manuel,45,ES02209555428642879798,TRX_N-01046-57669942,2024-05-27T16:47:28,Vitoria-Gasteiz,Expense,transport,-84.46,-58397.35
buyer_6,Manuel,45,ES02209555428642879798,TRX_N-01047-99293141,2024-05-28T08:17:38,Vitoria-Gasteiz,Expense,leisure,-70.45,-58467.8
buyer_6,Manuel,45,ES02209555428642879798,TRX_N-01048-07596873,2024-05-31T16:59:04,Vitoria-Gasteiz,Expense,repairs,-157.13,-58624.93
buyer_6,Manuel,45,ES02209555428642879798,TRX_N-01049-27687178,2024-06-01T17:32:09,Vitoria-Gasteiz,incomes,salary,1425.89,-57199.04
buyer_6,Manuel,45,ES02209555428642879798,TRX_N-01050-55701804,2024-06-01T17:32:09,Vitoria-Gasteiz,incomes,salary_partner,1382.07,-55816.97
buyer_6,Manuel,45,ES02209555428642879798,TRX_N-01051-42724999,2024-06-01T17:32:09,Vitoria-Gasteiz,incomes,salary_bonus,1009.23,-54807.74
buyer_6,Manuel,45,ES02209555428642879798,TRX_N-01052-36305766,2024-06-01T17:32:09,Vitoria-Gasteiz,incomes,salary_partner_bonus,1105.04,-53702.7
buyer_6,Manuel,45,ES02209555428642879798,TRX_N-01053-83633806,2024-06-02T22:28:50,Vitoria-Gasteiz,Expense,transport,-52.5,-53755.2
buyer_6,Manuel,45,ES02209555428642879798,TRX_N-01054-49554283,2024-06-03T23:40:22,Vitoria-Gasteiz,Expense,food,-76.56,-53831.76
buyer_6,Manuel,45,ES02209555428642879798,TRX_N-01055-03796574,2024-06-03T12:31:24,Vitoria-Gasteiz,Expense,repairs,-60.17,-53891.93
buyer_6,Manuel,45,ES02209555428642879798,TRX_N-01056-60345253,2024-06-04T18:47:49,Vitoria-Gasteiz,expenses,mortgage,-998.07,-54890.0
buyer_6,Manuel,45,ES02209555428642879798,TRX_N-01057-16417953,2024-06-05T20:27:56,Vitoria-Gasteiz,expenses,electricity,-21.84,-54911.84
buyer_6,Manuel,45,ES02209555428642879798,TRX_N-01058-73792514,2024-06-05T07:05:49,Vitoria-Gasteiz,expenses,internet,-42.0,-54953.84
buyer_6,Manuel,45,ES02209555428642879798,TRX_N-01059-09372416,2024-06-05T20:35:49,Vitoria-Gasteiz,Expense,travel,-536.25,-55490.09
buyer_6,Manuel,45,ES02209555428642879798,TRX_N-01060-50692505,2024-06-06T22:56:24,Vitoria-Gasteiz,expenses,water,-25.33,-55515.42
buyer_6,Manuel,45,ES02209555428642879798,TRX_N-01061-66028659,2024-06-06T02:27:40,Vitoria-Gasteiz,expenses,phone,-34.99,-55550.41
buyer_6,Manuel,45,ES02209555428642879798,TRX_N-01062-18610169,2024-06-06T16:25:01,Vitoria-Gasteiz,Expense,transport,-58.13,-55608.54
buyer_6,Manuel,45,ES02209555428642879798,TRX_N-01063-86036469,2024-06-06T09:59:42,Vitoria-Gasteiz,Expense,repairs,-224.78,-55833.32
buyer_6,Manuel,45,ES02209555428642879798,TRX_N-01064-76700612,2024-06-07T15:37:49,Vitoria-Gasteiz,Expense,education,-42.9,-55876.22
buyer_6,Manuel,45,ES02209555428642879798,TRX_N-01065-69334091,2024-06-08T00:07:27,Vitoria-Gasteiz,expenses,gas,-62.05,-55938.27
buyer_6,Manuel,45,ES02209555428642879798,TRX_N-01066-65636978,2024-06-08T07:00:50,Vitoria-Gasteiz,Expense,food,-65.91,-56004.18
buyer_6,Manuel,45,ES02209555428642879798,TRX_N-01067-88860276,2024-06-08T15:15:53,Vitoria-Gasteiz,Expense,transport,-58.71,-56062.89
buyer_6,Manuel,45,ES02209555428642879798,TRX_N-01068-27230443,2024-06-09T13:27:43,Vitoria-Gasteiz,Expense,food,-69.69,-56132.58
buyer_6,Manuel,45,ES02209555428642879798,TRX_N-01069-05464181,2024-06-09T08:52:35,Vitoria-Gasteiz,Expense,cash,-100.0,-56232.58
buyer_6,Manuel,45,ES02209555428642879798,TRX_N-01070-07198322,2024-06-10T10:10:47,Vitoria-Gasteiz,Expense,leisure,-42.32,-56274.9
buyer_6,Manuel,45,ES02209555428642879798,TRX_N-01071-39926183,2024-06-11T13:14:25,Vitoria-Gasteiz,Expense,leisure,-74.9,-56349.8
buyer_6,Manuel,45,ES02209555428642879798,TRX_N-01072-50224434,2024-06-11T14:32:42,Portugalete,Expense,gifts,-185.29,-56535.09
buyer_6,Manuel,45,ES02209555428642879798,TRX_N-01073-13532622,2024-06-12T15:35:02,Vitoria-Gasteiz,expenses,children,-72.35,-56607.44
buyer_6,Manuel,45,ES02209555428642879798,TRX_N-01074-99352545,2024-06-13T10:18:55,Vitoria-Gasteiz,Expense,transport,-48.77,-56656.21
buyer_6,Manuel,45,ES02209555428642879798,TRX_N-01075-48291690,2024-06-14T12:22:55,Vitoria-Gasteiz,Expense,leisure,-49.1,-56705.31
buyer_6,Manuel,45,ES02209555428642879798,TRX_N-01076-23695998,2024-06-16T16:08:30,Vitoria-Gasteiz,Expense,leisure,-20.82,-56726.13
buyer_6,Manuel,45,ES02209555428642879798,TRX_N-01077-02421671,2024-06-17T10:37:33,Vitoria-Gasteiz,Expense,cash,-100.0,-56826.13
buyer_6,Manuel,45,ES02209555428642879798,TRX_N-01078-10959611,2024-06-21T12:42:31,Vitoria-Gasteiz,expenses,children,-223.03,-57049.16
buyer_6,Manuel,45,ES02209555428642879798,TRX_N-01079-67307657,2024-06-22T12:17:28,Vitoria-Gasteiz,Expense,cash,-100.0,-57149.16
buyer_6,Manuel,45,ES02209555428642879798,TRX_N-01080-57188826,2024-06-27T14:41:28,Vitoria-Gasteiz,Expense,food,-86.89,-57236.05
buyer_6,Manuel,45,ES02209555428642879798,TRX_N-01081-44840891,2024-06-27T16:20:56,Zuia,Expense,gifts,-613.46,-57849.51
buyer_6,Manuel,45,ES02209555428642879798,TRX_N-01082-50395917,2024-06-28T11:18:04,Vitoria-Gasteiz,Expense,transport,-63.36,-57912.87
buyer_6,Manuel,45,ES02209555428642879798,TRX_N-01083-96680889,2024-06-28T13:42:15,Vitoria-Gasteiz,Expense,repairs,-32.74,-57945.61
buyer_6,Manuel,45,ES02209555428642879798,TRX_N-01084-12263461,2024-07-01T18:48:07,Vitoria-Gasteiz,incomes,salary,1425.89,-56519.72
buyer_6,Manuel,45,ES02209555428642879798,TRX_N-01085-41583368,2024-07-01T18:48:07,Vitoria-Gasteiz,incomes,salary_partner,1382.07,-55137.65
buyer_6,Manuel,45,ES02209555428642879798,TRX_N-01086-60327200,2024-07-04T21:05:50,Vitoria-Gasteiz,expenses,mortgage,-998.07,-56135.72
buyer_6,Manuel,45,ES02209555428642879798,TRX_N-01087-73970896,2024-07-05T19:30:03,Vitoria-Gasteiz,expenses,water,-33.05,-56168.77
buyer_6,Manuel,45,ES02209555428642879798,TRX_N-01088-35670879,2024-07-05T19:37:05,Vitoria-Gasteiz,expenses,electricity,-47.75,-56216.52
buyer_6,Manuel,45,ES02209555428642879798,TRX_N-01089-69025065,2024-07-05T14:45:33,Vitoria-Gasteiz,expenses,phone,-32.45,-56248.97
buyer_6,Manuel,45,ES02209555428642879798,TRX_N-01090-06293858,2024-07-07T09:47:14,Vitoria-Gasteiz,expenses,internet,-42.0,-56290.97
buyer_6,Manuel,45,ES02209555428642879798,TRX_N-01091-09496606,2024-07-07T09:43:17,Vitoria-Gasteiz,Expense,food,-121.48,-56412.45
buyer_6,Manuel,45,ES02209555428642879798,TRX_N-01092-74832775,2024-07-08T14:20:19,Vitoria-Gasteiz,expenses,gas,-71.34,-56483.79
buyer_6,Manuel,45,ES02209555428642879798,TRX_N-01093-94071890,2024-07-09T16:37:51,Vitoria-Gasteiz,Expense,education,-73.11,-56556.9
buyer_6,Manuel,45,ES02209555428642879798,TRX_N-01094-87989013,2024-07-10T16:22:14,Iru√±a de Oca,Expense,food,-122.38,-56679.28
buyer_6,Manuel,45,ES02209555428642879798,TRX_N-01095-95329579,2024-07-10T19:27:27,Vitoria-Gasteiz,Expense,transport,-83.72,-56763.0
buyer_6,Manuel,45,ES02209555428642879798,TRX_N-01096-31089966,2024-07-11T19:23:32,Vitoria-Gasteiz,Expense,transport,-87.34,-56850.34
buyer_6,Manuel,45,ES02209555428642879798,TRX_N-01097-66239049,2024-07-11T17:46:23,Vitoria-Gasteiz,Expense,cash,-100.0,-56950.34
buyer_6,Manuel,45,ES02209555428642879798,TRX_N-01098-40892805,2024-07-12T16:26:36,Vitoria-Gasteiz,Expense,travel,-1771.33,-58721.67
buyer_6,Manuel,45,ES02209555428642879798,TRX_N-01099-31812053,2024-07-13T12:40:19,Vitoria-Gasteiz,Expense,transport,-51.79,-58773.46
buyer_6,Manuel,45,ES02209555428642879798,TRX_N-01100-37823232,2024-07-13T14:50:31,Salvatierra/Agurain,Expense,cash,-100.0,-58873.46
buyer_6,Manuel,45,ES02209555428642879798,TRX_N-01101-35119074,2024-07-14T08:02:59,Vitoria-Gasteiz,Expense,transport,-88.99,-58962.45
buyer_6,Manuel,45,ES02209555428642879798,TRX_N-01102-50328900,2024-07-14T01:51:28,Arrasate,Expense,appliances,-275.32,-59237.77
buyer_6,Manuel,45,ES02209555428642879798,TRX_N-01103-01644558,2024-07-15T14:45:40,Basauri,Expense,gifts,-553.38,-59791.15
buyer_6,Manuel,45,ES02209555428642879798,TRX_N-01104-19126509,2024-07-16T19:04:17,Vitoria-Gasteiz,Expense,cash,-100.0,-59891.15
buyer_6,Manuel,45,ES02209555428642879798,TRX_N-01105-79288991,2024-07-18T10:40:20,Vitoria-Gasteiz,Expense,transport,-86.2,-59977.35
buyer_6,Manuel,45,ES02209555428642879798,TRX_N-01106-20504560,2024-07-20T08:25:54,Vitoria-Gasteiz,Expense,cash,-100.0,-60077.35
buyer_6,Manuel,45,ES02209555428642879798,TRX_N-01107-01037107,2024-07-21T08:35:27,Santurtzi,Expense,cash,-100.0,-60177.35
buyer_6,Manuel,45,ES02209555428642879798,TRX_N-01108-36375065,2024-07-23T08:15:55,Zarautz,Expense,food,-119.98,-60297.33
buyer_6,Manuel,45,ES02209555428642879798,TRX_N-01109-22763383,2024-07-24T14:49:44,Vitoria-Gasteiz,Expense,repairs,-138.3,-60435.63
buyer_6,Manuel,45,ES02209555428642879798,TRX_N-01110-30749545,2024-07-26T08:13:24,Vitoria-Gasteiz,Expense,leisure,-21.6,-60457.23
buyer_6,Manuel,45,ES02209555428642879798,TRX_N-01111-02909978,2024-07-27T20:09:36,Vitoria-Gasteiz,Expense,food,-81.24,-60538.47
buyer_6,Manuel,45,ES02209555428642879798,TRX_N-01112-15921018,2024-07-28T20:21:42,Santurtzi,Expense,healthcare,-186.07,-60724.54
buyer_6,Manuel,45,ES02209555428642879798,TRX_N-01113-50024776,2024-07-30T15:10:31,Vitoria-Gasteiz,Expense,repairs,-116.22,-60840.76
buyer_6,Manuel,45,ES02209555428642879798,TRX_N-01114-86277075,2024-07-31T08:24:17,Vitoria-Gasteiz,Expense,healthcare,-111.31,-60952.07
buyer_6,Manuel,45,ES02209555428642879798,TRX_N-01115-81312132,2024-08-01T16:18:38,Vitoria-Gasteiz,incomes,salary,1425.89,-59526.18
buyer_6,Manuel,45,ES02209555428642879798,TRX_N-01116-93592398,2024-08-01T16:18:38,Vitoria-Gasteiz,incomes,salary_partner,1382.07,-58144.11
buyer_6,Manuel,45,ES02209555428642879798,TRX_N-01117-30525331,2024-08-01T16:18:38,Vitoria-Gasteiz,incomes,extra_income,235.66,-57908.45
buyer_6,Manuel,45,ES02209555428642879798,TRX_N-01118-63557525,2024-08-01T08:13:23,Vitoria-Gasteiz,Expense,leisure,-70.92,-57979.37
buyer_6,Manuel,45,ES02209555428642879798,TRX_N-01119-29213610,2024-08-02T10:45:58,Vitoria-Gasteiz,Expense,repairs,-109.43,-58088.8
buyer_6,Manuel,45,ES02209555428642879798,TRX_N-01120-91828423,2024-08-04T11:37:19,Vitoria-Gasteiz,expenses,mortgage,-998.07,-59086.87
buyer_6,Manuel,45,ES02209555428642879798,TRX_N-01121-65769573,2024-08-05T11:59:47,Vitoria-Gasteiz,expenses,electricity,-75.29,-59162.16
buyer_6,Manuel,45,ES02209555428642879798,TRX_N-01122-81356286,2024-08-05T09:56:11,Vitoria-Gasteiz,Expense,travel,-1575.34,-60737.5
buyer_6,Manuel,45,ES02209555428642879798,TRX_N-01123-40366668,2024-08-06T12:18:15,Basauri,Expense,food,-109.77,-60847.27
buyer_6,Manuel,45,ES02209555428642879798,TRX_N-01124-45313783,2024-08-07T08:02:02,Vitoria-Gasteiz,expenses,internet,-42.0,-60889.27
buyer_6,Manuel,45,ES02209555428642879798,TRX_N-01125-71802510,2024-08-07T16:26:28,Vitoria-Gasteiz,expenses,phone,-44.98,-60934.25
buyer_6,Manuel,45,ES02209555428642879798,TRX_N-01126-54100970,2024-08-08T17:18:23,Vitoria-Gasteiz,expenses,gas,-60.23,-60994.48
buyer_6,Manuel,45,ES02209555428642879798,TRX_N-01127-45613397,2024-08-08T19:10:20,Vitoria-Gasteiz,expenses,water,-36.49,-61030.97
buyer_6,Manuel,45,ES02209555428642879798,TRX_N-01128-00491655,2024-08-08T12:49:41,Vitoria-Gasteiz,expenses,children,-244.01,-61274.98
buyer_6,Manuel,45,ES02209555428642879798,TRX_N-01129-90017763,2024-08-09T12:16:40,Vitoria-Gasteiz,Expense,food,-71.11,-61346.09
buyer_6,Manuel,45,ES02209555428642879798,TRX_N-01130-40226060,2024-08-09T17:46:32,Vitoria-Gasteiz,Expense,cash,-100.0,-61446.09
buyer_6,Manuel,45,ES02209555428642879798,TRX_N-01131-39819328,2024-08-12T14:43:45,Vitoria-Gasteiz,Expense,cash,-100.0,-61546.09
buyer_6,Manuel,45,ES02209555428642879798,TRX_N-01132-18539333,2024-08-12T22:58:15,Vitoria-Gasteiz,Expense,travel,-790.87,-62336.96
buyer_6,Manuel,45,ES02209555428642879798,TRX_N-01133-90926759,2024-08-13T15:00:46,Vitoria-Gasteiz,Expense,transport,-62.74,-62399.7
buyer_6,Manuel,45,ES02209555428642879798,TRX_N-01134-67505774,2024-08-15T13:05:30,Vitoria-Gasteiz,Expense,transport,-65.69,-62465.39
buyer_6,Manuel,45,ES02209555428642879798,TRX_N-01135-88895137,2024-08-17T10:58:28,Vitoria-Gasteiz,Expense,gifts,-398.9,-62864.29
buyer_6,Manuel,45,ES02209555428642879798,TRX_N-01136-75059000,2024-08-18T14:05:33,Elciego,Expense,food,-107.28,-62971.57
buyer_6,Manuel,45,ES02209555428642879798,TRX_N-01137-86668008,2024-08-21T13:22:22,Vitoria-Gasteiz,Expense,education,-74.28,-63045.85
buyer_6,Manuel,45,ES02209555428642879798,TRX_N-01138-55926985,2024-08-21T19:53:32,Vitoria-Gasteiz,Expense,cash,-100.0,-63145.85
buyer_6,Manuel,45,ES02209555428642879798,TRX_N-01139-60913599,2024-08-21T10:34:17,Vitoria-Gasteiz,Expense,gifts,-95.15,-63241.0
buyer_6,Manuel,45,ES02209555428642879798,TRX_N-01140-21948349,2024-08-22T11:51:51,Vitoria-Gasteiz,Expense,food,-68.58,-63309.58
buyer_6,Manuel,45,ES02209555428642879798,TRX_N-01141-35800196,2024-08-22T20:20:55,Llodio,Expense,transport,-65.56,-63375.14
buyer_6,Manuel,45,ES02209555428642879798,TRX_N-01142-83528979,2024-08-22T08:25:58,Vitoria-Gasteiz,Expense,education,-56.52,-63431.66
buyer_6,Manuel,45,ES02209555428642879798,TRX_N-01143-01765845,2024-08-22T15:47:18,Durango,Expense,appliances,-246.09,-63677.75
buyer_6,Manuel,45,ES02209555428642879798,TRX_N-01144-32229852,2024-08-27T14:51:16,Vitoria-Gasteiz,Expense,food,-67.54,-63745.29
buyer_6,Manuel,45,ES02209555428642879798,TRX_N-01145-08970143,2024-08-27T20:16:09,Vitoria-Gasteiz,Expense,repairs,-322.23,-64067.52
buyer_6,Manuel,45,ES02209555428642879798,TRX_N-01146-21456991,2024-08-28T18:48:20,Vitoria-Gasteiz,Expense,clothing,-74.08,-64141.6
buyer_6,Manuel,45,ES02209555428642879798,TRX_N-01147-53658872,2024-08-28T17:55:20,Vitoria-Gasteiz,Expense,education,-47.58,-64189.18
buyer_6,Manuel,45,ES02209555428642879798,TRX_N-01148-95584402,2024-08-28T10:46:55,Vitoria-Gasteiz,Expense,cash,-100.0,-64289.18
buyer_6,Manuel,45,ES02209555428642879798,TRX_N-01149-24105190,2024-08-29T08:22:39,Vitoria-Gasteiz,Expense,clothing,-81.1,-64370.28
buyer_6,Manuel,45,ES02209555428642879798,TRX_N-01150-10924485,2024-08-29T14:49:43,Vitoria-Gasteiz,Expense,education,-74.23,-64444.51
buyer_6,Manuel,45,ES02209555428642879798,TRX_N-01151-62840954,2024-08-31T18:26:19,Vitoria-Gasteiz,Expense,leisure,-84.49,-64529.0
buyer_6,Manuel,45,ES02209555428642879798,TRX_N-01152-64259643,2024-08-31T16:05:07,Vitoria-Gasteiz,Expense,cash,-100.0,-64629.0
buyer_6,Manuel,45,ES02209555428642879798,TRX_N-01153-26823171,2024-09-01T15:13:14,Vitoria-Gasteiz,incomes,salary,1425.89,-63203.11
buyer_6,Manuel,45,ES02209555428642879798,TRX_N-01154-57226313,2024-09-01T15:13:14,Vitoria-Gasteiz,incomes,salary_partner,1382.07,-61821.04
buyer_6,Manuel,45,ES02209555428642879798,TRX_N-01155-21385959,2024-09-04T09:59:08,Vitoria-Gasteiz,expenses,mortgage,-998.07,-62819.11
buyer_6,Manuel,45,ES02209555428642879798,TRX_N-01156-24899173,2024-09-04T14:00:18,Vitoria-Gasteiz,Expense,transport,-59.52,-62878.63
buyer_6,Manuel,45,ES02209555428642879798,TRX_N-01157-83743357,2024-09-04T08:54:44,Vitoria-Gasteiz,Expense,clothing,-141.36,-63019.99
buyer_6,Manuel,45,ES02209555428642879798,TRX_N-01158-82606274,2024-09-05T15:13:16,Vitoria-Gasteiz,expenses,water,-37.98,-63057.97
buyer_6,Manuel,45,ES02209555428642879798,TRX_N-01159-84644087,2024-09-06T18:42:03,Vitoria-Gasteiz,expenses,electricity,-31.52,-63089.49
buyer_6,Manuel,45,ES02209555428642879798,TRX_N-01160-09972945,2024-09-06T18:56:18,Vitoria-Gasteiz,expenses,internet,-42.0,-63131.49
buyer_6,Manuel,45,ES02209555428642879798,TRX_N-01161-11326930,2024-09-06T02:08:37,Vitoria-Gasteiz,Expense,leisure,-68.81,-63200.3
buyer_6,Manuel,45,ES02209555428642879798,TRX_N-01162-36246992,2024-09-07T16:37:32,Vitoria-Gasteiz,Expense,cash,-100.0,-63300.3
buyer_6,Manuel,45,ES02209555428642879798,TRX_N-01163-79199324,2024-09-08T15:43:28,Vitoria-Gasteiz,expenses,gas,-99.09,-63399.39
buyer_6,Manuel,45,ES02209555428642879798,TRX_N-01164-66108769,2024-09-08T20:18:32,Vitoria-Gasteiz,expenses,phone,-37.84,-63437.23
buyer_6,Manuel,45,ES02209555428642879798,TRX_N-01165-80982317,2024-09-08T04:40:52,Amurrio,Expense,cash,-100.0,-63537.23
buyer_6,Manuel,45,ES02209555428642879798,TRX_N-01166-79024161,2024-09-10T14:44:49,Vitoria-Gasteiz,Expense,clothing,-93.46,-63630.69
buyer_6,Manuel,45,ES02209555428642879798,TRX_N-01167-54660222,2024-09-10T01:24:12,Vitoria-Gasteiz,Expense,cash,-100.0,-63730.69
buyer_6,Manuel,45,ES02209555428642879798,TRX_N-01168-84352607,2024-09-10T20:38:13,Vitoria-Gasteiz,Expense,repairs,-223.79,-63954.48
buyer_6,Manuel,45,ES02209555428642879798,TRX_N-01169-43171251,2024-09-11T22:00:24,Mungia,Expense,transport,-50.49,-64004.97
buyer_6,Manuel,45,ES02209555428642879798,TRX_N-01170-46682643,2024-09-11T14:06:54,Vitoria-Gasteiz,Expense,leisure,-35.08,-64040.05
buyer_6,Manuel,45,ES02209555428642879798,TRX_N-01171-35092755,2024-09-11T10:07:17,Vitoria-Gasteiz,Expense,repairs,-91.52,-64131.57
buyer_6,Manuel,45,ES02209555428642879798,TRX_N-01172-94729201,2024-09-12T18:36:51,Vitoria-Gasteiz,Expense,leisure,-22.99,-64154.56
buyer_6,Manuel,45,ES02209555428642879798,TRX_N-01173-03547398,2024-09-16T15:22:48,Vitoria-Gasteiz,Expense,repairs,-248.13,-64402.69
buyer_6,Manuel,45,ES02209555428642879798,TRX_N-01174-28213196,2024-09-18T04:49:09,Vitoria-Gasteiz,Expense,cash,-100.0,-64502.69
buyer_6,Manuel,45,ES02209555428642879798,TRX_N-01175-97827896,2024-09-19T20:50:09,Vitoria-Gasteiz,Expense,food,-94.64,-64597.33
buyer_6,Manuel,45,ES02209555428642879798,TRX_N-01176-36865348,2024-09-19T16:48:35,Vitoria-Gasteiz,Expense,leisure,-30.67,-64628.0
buyer_6,Manuel,45,ES02209555428642879798,TRX_N-01177-65204303,2024-09-20T19:53:04,Zarautz,Expense,clothing,-61.34,-64689.34
buyer_6,Manuel,45,ES02209555428642879798,TRX_N-01178-91487247,2024-09-21T17:45:38,Vitoria-Gasteiz,Expense,transport,-41.73,-64731.07
buyer_6,Manuel,45,ES02209555428642879798,TRX_N-01179-85562348,2024-09-21T22:53:29,Vitoria-Gasteiz,Expense,repairs,-131.23,-64862.3
buyer_6,Manuel,45,ES02209555428642879798,TRX_N-01180-89488193,2024-09-23T10:34:56,Vitoria-Gasteiz,Expense,leisure,-23.59,-64885.89
buyer_6,Manuel,45,ES02209555428642879798,TRX_N-01181-15402786,2024-09-23T18:54:27,Vitoria-Gasteiz,Expense,healthcare,-99.51,-64985.4
buyer_6,Manuel,45,ES02209555428642879798,TRX_N-01182-25768353,2024-09-24T17:39:36,Vitoria-Gasteiz,Expense,education,-48.18,-65033.58
buyer_6,Manuel,45,ES02209555428642879798,TRX_N-01183-08125050,2024-09-24T12:38:26,Vitoria-Gasteiz,Expense,cash,-100.0,-65133.58
buyer_6,Manuel,45,ES02209555428642879798,TRX_N-01184-76767647,2024-09-24T15:04:57,Vitoria-Gasteiz,Expense,repairs,-104.94,-65238.52
buyer_6,Manuel,45,ES02209555428642879798,TRX_N-01185-40465632,2024-09-24T03:01:57,Vitoria-Gasteiz,expenses,children,-102.85,-65341.37
buyer_6,Manuel,45,ES02209555428642879798,TRX_N-01186-17686537,2024-09-26T20:03:16,Vitoria-Gasteiz,expenses,children,-51.45,-65392.82
buyer_6,Manuel,45,ES02209555428642879798,TRX_N-01187-33065463,2024-09-28T13:55:22,Basauri,Expense,cash,-100.0,-65492.82
buyer_6,Manuel,45,ES02209555428642879798,TRX_N-01188-61390950,2024-09-30T09:57:29,Vitoria-Gasteiz,Expense,food,-73.63,-65566.45
buyer_6,Manuel,45,ES02209555428642879798,TRX_N-01189-85584466,2024-09-30T08:43:00,Vitoria-Gasteiz,Expense,cash,-100.0,-65666.45
buyer_6,Manuel,45,ES02209555428642879798,TRX_N-01190-13002811,2024-10-01T12:02:15,Vitoria-Gasteiz,incomes,salary,1425.89,-64240.56
buyer_6,Manuel,45,ES02209555428642879798,TRX_N-01191-24166734,2024-10-01T12:02:15,Vitoria-Gasteiz,incomes,salary_partner,1382.07,-62858.49
buyer_6,Manuel,45,ES02209555428642879798,TRX_N-01192-61235066,2024-10-01T11:40:04,Vitoria-Gasteiz,Expense,transport,-62.27,-62920.76
buyer_6,Manuel,45,ES02209555428642879798,TRX_N-01193-31512581,2024-10-01T06:38:31,Durango,Expense,leisure,-68.22,-62988.98
buyer_6,Manuel,45,ES02209555428642879798,TRX_N-01194-21418076,2024-10-02T17:11:03,Vitoria-Gasteiz,Expense,transport,-50.16,-63039.14
buyer_6,Manuel,45,ES02209555428642879798,TRX_N-01195-55015618,2024-10-02T13:56:59,Vitoria-Gasteiz,Expense,gifts,-612.37,-63651.51
buyer_6,Manuel,45,ES02209555428642879798,TRX_N-01196-18061274,2024-10-03T22:12:56,Vitoria-Gasteiz,Expense,cash,-100.0,-63751.51
buyer_6,Manuel,45,ES02209555428642879798,TRX_N-01197-24109698,2024-10-04T10:58:03,Vitoria-Gasteiz,expenses,mortgage,-998.07,-64749.58
buyer_6,Manuel,45,ES02209555428642879798,TRX_N-01198-93590030,2024-10-04T15:17:26,Vitoria-Gasteiz,Expense,cash,-100.0,-64849.58
buyer_6,Manuel,45,ES02209555428642879798,TRX_N-01199-40764629,2024-10-05T14:00:58,Vitoria-Gasteiz,Expense,cash,-100.0,-64949.58
buyer_6,Manuel,45,ES02209555428642879798,TRX_N-01200-11004514,2024-10-06T16:40:46,Vitoria-Gasteiz,expenses,gas,-114.45,-65064.03
buyer_6,Manuel,45,ES02209555428642879798,TRX_N-01201-73409145,2024-10-06T14:19:03,Vitoria-Gasteiz,Expense,transport,-53.12,-65117.15
buyer_6,Manuel,45,ES02209555428642879798,TRX_N-01202-34399513,2024-10-08T09:58:50,Vitoria-Gasteiz,expenses,water,-42.92,-65160.07
buyer_6,Manuel,45,ES02209555428642879798,TRX_N-01203-28423886,2024-10-08T12:24:35,Vitoria-Gasteiz,expenses,phone,-41.49,-65201.56
buyer_6,Manuel,45,ES02209555428642879798,TRX_N-01204-83760870,2024-10-08T23:07:19,Vitoria-Gasteiz,expenses,electricity,-32.59,-65234.15
buyer_6,Manuel,45,ES02209555428642879798,TRX_N-01205-73138004,2024-10-08T10:05:54,Vitoria-Gasteiz,expenses,internet,-42.0,-65276.15
buyer_7,Mar√≠a,56,ES20209524514523730381,TRX_N-00001-79189190,2022-01-01T15:56:18,Portugalete,incomes,salary,1364.97,2987.24
buyer_7,Mar√≠a,56,ES20209524514523730381,TRX_N-00002-31884314,2022-01-01T15:56:18,Portugalete,incomes,salary_partner,1176.83,4164.07
buyer_7,Mar√≠a,56,ES20209524514523730381,TRX_N-00003-53376379,2022-01-01T11:35:12,Portugalete,Expense,food,-112.39,4051.68
buyer_7,Mar√≠a,56,ES20209524514523730381,TRX_N-00004-50827334,2022-01-01T17:39:24,Oy√≥n-Oion,Expense,leisure,-77.95,3973.73
buyer_7,Mar√≠a,56,ES20209524514523730381,TRX_N-00005-76984952,2022-01-03T15:07:41,Portugalete,Expense,leisure,-35.64,3938.09
buyer_7,Mar√≠a,56,ES20209524514523730381,TRX_N-00006-61695031,2022-01-04T20:18:25,Portugalete,expenses,mortgage,-786.19,3151.9
buyer_7,Mar√≠a,56,ES20209524514523730381,TRX_N-00007-49802876,2022-01-04T10:16:35,Portugalete,Expense,education,-59.56,3092.34
buyer_7,Mar√≠a,56,ES20209524514523730381,TRX_N-00008-56167834,2022-01-05T09:17:30,Zarautz,Expense,repairs,-290.73,2801.61
buyer_7,Mar√≠a,56,ES20209524514523730381,TRX_N-00009-88188318,2022-01-07T14:31:36,Portugalete,expenses,phone,-42.84,2758.77
buyer_7,Mar√≠a,56,ES20209524514523730381,TRX_N-00010-74141377,2022-01-07T11:43:50,Portugalete,Expense,cash,-100.0,2658.77
buyer_7,Mar√≠a,56,ES20209524514523730381,TRX_N-00011-04788082,2022-01-08T12:40:43,Portugalete,expenses,internet,-42.0,2616.77
buyer_7,Mar√≠a,56,ES20209524514523730381,TRX_N-00012-94260178,2022-01-08T12:52:38,Portugalete,expenses,water,-45.0,2571.77
buyer_7,Mar√≠a,56,ES20209524514523730381,TRX_N-00013-34328495,2022-01-08T15:33:12,Portugalete,expenses,electricity,-67.29,2504.48
buyer_7,Mar√≠a,56,ES20209524514523730381,TRX_N-00014-98763416,2022-01-08T03:04:57,Portugalete,expenses,gas,-54.57,2449.91
buyer_7,Mar√≠a,56,ES20209524514523730381,TRX_N-00015-69620692,2022-01-08T09:30:55,Portugalete,Expense,leisure,-33.81,2416.1
buyer_7,Mar√≠a,56,ES20209524514523730381,TRX_N-00016-18831268,2022-01-08T14:39:22,Portugalete,expenses,children,-260.48,2155.62
buyer_7,Mar√≠a,56,ES20209524514523730381,TRX_N-00017-36394408,2022-01-09T14:04:42,Portugalete,Expense,cash,-100.0,2055.62
buyer_7,Mar√≠a,56,ES20209524514523730381,TRX_N-00018-22942418,2022-01-09T17:12:35,Portugalete,expenses,children,-219.58,1836.04
buyer_7,Mar√≠a,56,ES20209524514523730381,TRX_N-00019-25671336,2022-01-11T16:55:00,Portugalete,Expense,food,-114.18,1721.86
buyer_7,Mar√≠a,56,ES20209524514523730381,TRX_N-00020-24736442,2022-01-11T20:20:13,Portugalete,Expense,leisure,-38.47,1683.39
buyer_7,Mar√≠a,56,ES20209524514523730381,TRX_N-00021-47480918,2022-01-11T11:36:05,Portugalete,Expense,clothing,-157.65,1525.74
buyer_7,Mar√≠a,56,ES20209524514523730381,TRX_N-00022-12417847,2022-01-11T10:53:50,Portugalete,Expense,repairs,-258.27,1267.47
buyer_7,Mar√≠a,56,ES20209524514523730381,TRX_N-00023-70268614,2022-01-14T05:17:48,Portugalete,Expense,leisure,-57.27,1210.2
buyer_7,Mar√≠a,56,ES20209524514523730381,TRX_N-00024-66025128,2022-01-16T09:09:44,Portugalete,Expense,cash,-100.0,1110.2
buyer_7,Mar√≠a,56,ES20209524514523730381,TRX_N-00025-42704933,2022-01-17T23:24:08,Portugalete,Expense,repairs,-240.71,869.49
buyer_7,Mar√≠a,56,ES20209524514523730381,TRX_N-00026-17165709,2022-01-18T20:35:20,Portugalete,Expense,food,-66.06,803.43
buyer_7,Mar√≠a,56,ES20209524514523730381,TRX_N-00027-47714683,2022-01-18T20:12:48,Portugalete,Expense,leisure,-63.89,739.54
buyer_7,Mar√≠a,56,ES20209524514523730381,TRX_N-00028-40116987,2022-01-18T08:54:11,Salvatierra/Agurain,Expense,education,-61.69,677.85
buyer_7,Mar√≠a,56,ES20209524514523730381,TRX_N-00029-07333893,2022-01-19T15:31:23,Portugalete,Expense,leisure,-73.75,604.1
buyer_7,Mar√≠a,56,ES20209524514523730381,TRX_N-00030-13459757,2022-01-21T16:51:01,Portugalete,Expense,clothing,-132.16,471.94
buyer_7,Mar√≠a,56,ES20209524514523730381,TRX_N-00031-21598278,2022-01-24T15:48:56,Portugalete,Expense,appliances,-370.95,100.99
buyer_7,Mar√≠a,56,ES20209524514523730381,TRX_N-00032-31446845,2022-01-25T00:09:45,Portugalete,Expense,food,-77.41,23.58
buyer_7,Mar√≠a,56,ES20209524514523730381,TRX_N-00033-36666434,2022-01-26T18:47:41,Eibar,Expense,leisure,-77.84,-54.26
buyer_7,Mar√≠a,56,ES20209524514523730381,TRX_N-00034-45898063,2022-01-27T17:14:49,Portugalete,Expense,food,-120.74,-175.0
buyer_7,Mar√≠a,56,ES20209524514523730381,TRX_N-00035-16729670,2022-01-27T15:57:20,Portugalete,Expense,healthcare,-93.56,-268.56
buyer_7,Mar√≠a,56,ES20209524514523730381,TRX_N-00036-40175862,2022-01-27T19:52:58,Portugalete,Expense,appliances,-163.69,-432.25
buyer_7,Mar√≠a,56,ES20209524514523730381,TRX_N-00037-81380951,2022-01-28T20:08:37,Portugalete,Expense,gifts,-749.75,-1182.0
buyer_7,Mar√≠a,56,ES20209524514523730381,TRX_N-00038-44724187,2022-01-29T19:44:23,Portugalete,Expense,repairs,-250.64,-1432.64
buyer_7,Mar√≠a,56,ES20209524514523730381,TRX_N-00039-53850702,2022-01-29T17:48:44,Portugalete,expenses,children,-255.35,-1687.99
buyer_7,Mar√≠a,56,ES20209524514523730381,TRX_N-00040-74516276,2022-01-30T05:37:04,Portugalete,Expense,cash,-100.0,-1787.99
buyer_7,Mar√≠a,56,ES20209524514523730381,TRX_N-00041-19071789,2022-01-30T11:46:49,Portugalete,Expense,gifts,-536.01,-2324.0
buyer_7,Mar√≠a,56,ES20209524514523730381,TRX_N-00042-71725190,2022-02-01T14:11:49,Portugalete,incomes,salary,1364.97,-959.03
buyer_7,Mar√≠a,56,ES20209524514523730381,TRX_N-00043-31469465,2022-02-01T14:11:49,Portugalete,incomes,salary_partner,1176.83,217.8
buyer_7,Mar√≠a,56,ES20209524514523730381,TRX_N-00044-81325555,2022-02-01T07:13:25,Portugalete,Expense,repairs,-77.35,140.45
buyer_7,Mar√≠a,56,ES20209524514523730381,TRX_N-00045-44307149,2022-02-03T15:16:36,Portugalete,Expense,food,-77.87,62.58
buyer_7,Mar√≠a,56,ES20209524514523730381,TRX_N-00046-07138349,2022-02-03T10:44:12,Portugalete,Expense,leisure,-80.53,-17.95
buyer_7,Mar√≠a,56,ES20209524514523730381,TRX_N-00047-69427266,2022-02-04T11:54:00,Portugalete,expenses,mortgage,-786.19,-804.14
buyer_7,Mar√≠a,56,ES20209524514523730381,TRX_N-00048-69533614,2022-02-04T10:49:17,Portugalete,Expense,food,-103.49,-907.63
buyer_7,Mar√≠a,56,ES20209524514523730381,TRX_N-00049-81509330,2022-02-05T21:49:40,Portugalete,Expense,education,-50.81,-958.44
buyer_7,Mar√≠a,56,ES20209524514523730381,TRX_N-00050-66404363,2022-02-06T15:35:12,Portugalete,expenses,internet,-42.0,-1000.44
buyer_7,Mar√≠a,56,ES20209524514523730381,TRX_N-00051-06762726,2022-02-06T15:22:14,Portugalete,expenses,phone,-44.9,-1045.34
buyer_7,Mar√≠a,56,ES20209524514523730381,TRX_N-00052-12331763,2022-02-06T22:40:22,Portugalete,Expense,leisure,-37.13,-1082.47
buyer_7,Mar√≠a,56,ES20209524514523730381,TRX_N-00053-62014936,2022-02-06T15:29:40,Portugalete,Expense,travel,-703.78,-1786.25
buyer_7,Mar√≠a,56,ES20209524514523730381,TRX_N-00054-83504809,2022-02-07T09:50:22,Portugalete,Expense,food,-69.33,-1855.58
buyer_7,Mar√≠a,56,ES20209524514523730381,TRX_N-00055-84763997,2022-02-08T15:41:58,Portugalete,expenses,water,-40.85,-1896.43
buyer_7,Mar√≠a,56,ES20209524514523730381,TRX_N-00056-77924505,2022-02-08T17:59:30,Portugalete,expenses,electricity,-41.69,-1938.12
buyer_7,Mar√≠a,56,ES20209524514523730381,TRX_N-00057-67266649,2022-02-08T11:15:45,Portugalete,expenses,gas,-64.19,-2002.31
buyer_7,Mar√≠a,56,ES20209524514523730381,TRX_N-00058-45257148,2022-02-11T09:47:55,Portugalete,Expense,food,-103.1,-2105.41
buyer_7,Mar√≠a,56,ES20209524514523730381,TRX_N-00059-32666216,2022-02-12T12:40:27,Portugalete,Expense,education,-51.31,-2156.72
buyer_7,Mar√≠a,56,ES20209524514523730381,TRX_N-00060-97419470,2022-02-13T12:15:04,Portugalete,Expense,leisure,-82.14,-2238.86
buyer_7,Mar√≠a,56,ES20209524514523730381,TRX_N-00061-39228951,2022-02-14T09:28:38,Portugalete,Expense,gifts,-351.61,-2590.47
buyer_7,Mar√≠a,56,ES20209524514523730381,TRX_N-00062-58022410,2022-02-16T13:42:43,Pasaia,Expense,food,-108.24,-2698.71
buyer_7,Mar√≠a,56,ES20209524514523730381,TRX_N-00063-46579954,2022-02-17T14:16:00,Portugalete,Expense,transport,-42.66,-2741.37
buyer_7,Mar√≠a,56,ES20209524514523730381,TRX_N-00064-94637646,2022-02-17T18:41:43,Portugalete,Expense,cash,-100.0,-2841.37
buyer_7,Mar√≠a,56,ES20209524514523730381,TRX_N-00065-23525370,2022-02-18T08:35:42,Portugalete,Expense,leisure,-42.96,-2884.33
buyer_7,Mar√≠a,56,ES20209524514523730381,TRX_N-00066-18338143,2022-02-21T20:50:43,Portugalete,Expense,food,-90.16,-2974.49
buyer_7,Mar√≠a,56,ES20209524514523730381,TRX_N-00067-31761481,2022-02-21T12:21:14,Portugalete,Expense,transport,-89.47,-3063.96
buyer_7,Mar√≠a,56,ES20209524514523730381,TRX_N-00068-95288854,2022-02-21T08:36:47,Portugalete,Expense,repairs,-92.12,-3156.08
buyer_7,Mar√≠a,56,ES20209524514523730381,TRX_N-00069-74542833,2022-02-27T22:56:36,Portugalete,Expense,repairs,-144.38,-3300.46
buyer_7,Mar√≠a,56,ES20209524514523730381,TRX_N-00070-96740631,2022-03-01T14:02:16,Portugalete,incomes,salary,1364.97,-1935.49
buyer_7,Mar√≠a,56,ES20209524514523730381,TRX_N-00071-93501742,2022-03-01T14:02:16,Portugalete,incomes,salary_partner,1176.83,-758.66
buyer_7,Mar√≠a,56,ES20209524514523730381,TRX_N-00072-69034800,2022-03-02T23:26:08,Portugalete,Expense,leisure,-68.08,-826.74
buyer_7,Mar√≠a,56,ES20209524514523730381,TRX_N-00073-72871224,2022-03-02T18:22:36,Amurrio,Expense,cash,-100.0,-926.74
buyer_7,Mar√≠a,56,ES20209524514523730381,TRX_N-00074-03970125,2022-03-03T02:55:45,Barakaldo,Expense,transport,-75.88,-1002.62
buyer_7,Mar√≠a,56,ES20209524514523730381,TRX_N-00075-07964510,2022-03-03T09:44:34,Portugalete,Expense,cash,-100.0,-1102.62
buyer_7,Mar√≠a,56,ES20209524514523730381,TRX_N-00076-82256736,2022-03-04T11:36:09,Portugalete,expenses,mortgage,-786.19,-1888.81
buyer_7,Mar√≠a,56,ES20209524514523730381,TRX_N-00077-15670616,2022-03-05T16:47:04,Portugalete,expenses,internet,-42.0,-1930.81
buyer_7,Mar√≠a,56,ES20209524514523730381,TRX_N-00078-61800992,2022-03-06T18:20:49,Portugalete,expenses,water,-23.81,-1954.62
buyer_7,Mar√≠a,56,ES20209524514523730381,TRX_N-00079-99979050,2022-03-06T09:40:38,Portugalete,Expense,food,-61.17,-2015.79
buyer_7,Mar√≠a,56,ES20209524514523730381,TRX_N-00080-11446681,2022-03-06T19:14:03,Portugalete,Expense,transport,-53.27,-2069.06
buyer_7,Mar√≠a,56,ES20209524514523730381,TRX_N-00081-59820809,2022-03-07T18:48:22,Portugalete,expenses,phone,-39.08,-2108.14
buyer_7,Mar√≠a,56,ES20209524514523730381,TRX_N-00082-24664082,2022-03-07T17:47:59,Galdakao,Expense,transport,-65.59,-2173.73
buyer_7,Mar√≠a,56,ES20209524514523730381,TRX_N-00083-62646412,2022-03-07T20:33:30,Portugalete,Expense,healthcare,-89.24,-2262.97
buyer_7,Mar√≠a,56,ES20209524514523730381,TRX_N-00084-53220521,2022-03-08T09:24:36,Portugalete,expenses,electricity,-25.25,-2288.22
buyer_7,Mar√≠a,56,ES20209524514523730381,TRX_N-00085-95251677,2022-03-08T08:58:37,Portugalete,expenses,gas,-106.23,-2394.45
buyer_7,Mar√≠a,56,ES20209524514523730381,TRX_N-00086-03471585,2022-03-08T12:45:17,Portugalete,Expense,cash,-100.0,-2494.45
buyer_7,Mar√≠a,56,ES20209524514523730381,TRX_N-00087-45735017,2022-03-09T20:31:55,Hondarribia,Expense,cash,-100.0,-2594.45
buyer_7,Mar√≠a,56,ES20209524514523730381,TRX_N-00088-50664230,2022-03-09T20:09:49,Portugalete,Expense,appliances,-276.22,-2870.67
buyer_7,Mar√≠a,56,ES20209524514523730381,TRX_N-00089-21366495,2022-03-12T16:32:12,Portugalete,Expense,cash,-100.0,-2970.67
buyer_7,Mar√≠a,56,ES20209524514523730381,TRX_N-00090-45188798,2022-03-16T13:06:30,Portugalete,Expense,transport,-86.54,-3057.21
buyer_7,Mar√≠a,56,ES20209524514523730381,TRX_N-00091-25020849,2022-03-18T13:01:18,Portugalete,Expense,transport,-78.85,-3136.06
buyer_7,Mar√≠a,56,ES20209524514523730381,TRX_N-00092-67966636,2022-03-19T09:41:49,Portugalete,Expense,repairs,-192.41,-3328.47
buyer_7,Mar√≠a,56,ES20209524514523730381,TRX_N-00093-76698780,2022-03-21T14:52:16,Portugalete,Expense,food,-99.2,-3427.67
buyer_7,Mar√≠a,56,ES20209524514523730381,TRX_N-00094-32015636,2022-03-21T10:51:52,Sestao,Expense,leisure,-82.61,-3510.28
buyer_7,Mar√≠a,56,ES20209524514523730381,TRX_N-00095-44348221,2022-03-24T23:34:20,Vitoria-Gasteiz,Expense,transport,-62.88,-3573.16
buyer_7,Mar√≠a,56,ES20209524514523730381,TRX_N-00096-80349848,2022-03-25T18:09:02,Portugalete,Expense,cash,-100.0,-3673.16
buyer_7,Mar√≠a,56,ES20209524514523730381,TRX_N-00097-70603654,2022-03-25T16:24:47,Portugalete,Expense,repairs,-265.49,-3938.65
buyer_7,Mar√≠a,56,ES20209524514523730381,TRX_N-00098-38021634,2022-03-25T15:57:27,Portugalete,expenses,children,-93.6,-4032.25
buyer_7,Mar√≠a,56,ES20209524514523730381,TRX_N-00099-16117806,2022-03-26T08:52:12,Portugalete,Expense,healthcare,-52.11,-4084.36
buyer_7,Mar√≠a,56,ES20209524514523730381,TRX_N-00100-48135176,2022-03-29T17:55:18,Portugalete,Expense,cash,-100.0,-4184.36
buyer_7,Mar√≠a,56,ES20209524514523730381,TRX_N-00101-59513766,2022-03-30T13:05:40,Portugalete,Expense,food,-101.22,-4285.58
buyer_7,Mar√≠a,56,ES20209524514523730381,TRX_N-00102-95701344,2022-03-30T18:46:09,Portugalete,expenses,children,-126.38,-4411.96
buyer_7,Mar√≠a,56,ES20209524514523730381,TRX_N-00103-38990990,2022-03-31T15:07:50,Portugalete,Expense,healthcare,-182.89,-4594.85
buyer_7,Mar√≠a,56,ES20209524514523730381,TRX_N-00104-51716736,2022-03-31T22:37:58,Portugalete,Expense,cash,-100.0,-4694.85
buyer_7,Mar√≠a,56,ES20209524514523730381,TRX_N-00105-27015644,2022-04-01T05:10:30,Portugalete,incomes,salary,1364.97,-3329.88
buyer_7,Mar√≠a,56,ES20209524514523730381,TRX_N-00106-92487219,2022-04-01T05:10:30,Portugalete,incomes,salary_partner,1176.83,-2153.05
buyer_7,Mar√≠a,56,ES20209524514523730381,TRX_N-00107-87499079,2022-04-01T05:10:30,Portugalete,incomes,extra_income,134.71,-2018.34
buyer_7,Mar√≠a,56,ES20209524514523730381,TRX_N-00108-96611624,2022-04-02T20:07:52,Portugalete,Expense,leisure,-72.54,-2090.88
buyer_7,Mar√≠a,56,ES20209524514523730381,TRX_N-00109-02345980,2022-04-02T14:01:16,Erandio,Expense,appliances,-170.95,-2261.83
buyer_7,Mar√≠a,56,ES20209524514523730381,TRX_N-00110-65062161,2022-04-04T22:04:13,Portugalete,expenses,mortgage,-786.19,-3048.02
buyer_7,Mar√≠a,56,ES20209524514523730381,TRX_N-00111-53523714,2022-04-05T11:23:59,Portugalete,expenses,internet,-42.0,-3090.02
buyer_7,Mar√≠a,56,ES20209524514523730381,TRX_N-00112-93170112,2022-04-06T15:42:27,Portugalete,expenses,gas,-102.38,-3192.4
buyer_7,Mar√≠a,56,ES20209524514523730381,TRX_N-00113-39196631,2022-04-06T12:39:09,Portugalete,expenses,phone,-32.72,-3225.12
buyer_7,Mar√≠a,56,ES20209524514523730381,TRX_N-00114-38981429,2022-04-07T16:48:13,Portugalete,Expense,cash,-100.0,-3325.12
buyer_7,Mar√≠a,56,ES20209524514523730381,TRX_N-00115-50436838,2022-04-08T09:52:06,Portugalete,expenses,water,-23.52,-3348.64
buyer_7,Mar√≠a,56,ES20209524514523730381,TRX_N-00116-62185728,2022-04-08T17:38:13,Portugalete,expenses,electricity,-71.84,-3420.48
buyer_7,Mar√≠a,56,ES20209524514523730381,TRX_N-00117-90867122,2022-04-09T03:20:44,Portugalete,Expense,transport,-47.26,-3467.74
buyer_7,Mar√≠a,56,ES20209524514523730381,TRX_N-00118-27884878,2022-04-09T15:26:46,Portugalete,Expense,healthcare,-58.54,-3526.28
buyer_7,Mar√≠a,56,ES20209524514523730381,TRX_N-00119-30478499,2022-04-11T09:08:10,Portugalete,Expense,cash,-100.0,-3626.28
buyer_7,Mar√≠a,56,ES20209524514523730381,TRX_N-00120-57260608,2022-04-11T12:11:39,Portugalete,Expense,travel,-586.78,-4213.06
buyer_7,Mar√≠a,56,ES20209524514523730381,TRX_N-00121-43111627,2022-04-13T10:46:36,Portugalete,Expense,cash,-100.0,-4313.06
buyer_7,Mar√≠a,56,ES20209524514523730381,TRX_N-00122-03883955,2022-04-14T08:27:17,Portugalete,Expense,transport,-44.33,-4357.39
buyer_7,Mar√≠a,56,ES20209524514523730381,TRX_N-00123-80576960,2022-04-14T12:05:07,Portugalete,expenses,children,-51.36,-4408.75
buyer_7,Mar√≠a,56,ES20209524514523730381,TRX_N-00124-34972826,2022-04-15T23:07:37,Portugalete,Expense,education,-64.41,-4473.16
buyer_7,Mar√≠a,56,ES20209524514523730381,TRX_N-00125-07435828,2022-04-15T20:35:16,Portugalete,Expense,cash,-100.0,-4573.16
buyer_7,Mar√≠a,56,ES20209524514523730381,TRX_N-00126-12849323,2022-04-15T21:42:25,Portugalete,Expense,repairs,-32.72,-4605.88
buyer_7,Mar√≠a,56,ES20209524514523730381,TRX_N-00127-77568215,2022-04-17T17:44:47,Vitoria-Gasteiz,Expense,education,-72.91,-4678.79
buyer_7,Mar√≠a,56,ES20209524514523730381,TRX_N-00128-38062132,2022-04-20T12:25:33,Andoain,Expense,clothing,-109.49,-4788.28
buyer_7,Mar√≠a,56,ES20209524514523730381,TRX_N-00129-38350469,2022-04-22T09:36:44,Portugalete,Expense,education,-56.34,-4844.62
buyer_7,Mar√≠a,56,ES20209524514523730381,TRX_N-00130-85348303,2022-04-23T09:02:58,Portugalete,Expense,cash,-100.0,-4944.62
buyer_7,Mar√≠a,56,ES20209524514523730381,TRX_N-00131-79097278,2022-04-24T16:57:44,Portugalete,Expense,cash,-100.0,-5044.62
buyer_7,Mar√≠a,56,ES20209524514523730381,TRX_N-00132-59179124,2022-04-26T16:43:54,Portugalete,Expense,appliances,-245.22,-5289.84
buyer_7,Mar√≠a,56,ES20209524514523730381,TRX_N-00133-31265800,2022-04-27T13:37:33,Portugalete,Expense,transport,-73.27,-5363.11
buyer_7,Mar√≠a,56,ES20209524514523730381,TRX_N-00134-30868403,2022-04-27T10:26:10,Portugalete,Expense,cash,-100.0,-5463.11
buyer_7,Mar√≠a,56,ES20209524514523730381,TRX_N-00135-35272719,2022-04-28T17:21:55,Portugalete,Expense,clothing,-97.51,-5560.62
buyer_7,Mar√≠a,56,ES20209524514523730381,TRX_N-00136-18533420,2022-04-28T00:48:28,Portugalete,Expense,gifts,-849.76,-6410.38
buyer_7,Mar√≠a,56,ES20209524514523730381,TRX_N-00137-08187845,2022-04-30T22:22:55,Portugalete,Expense,travel,-1106.08,-7516.46
buyer_7,Mar√≠a,56,ES20209524514523730381,TRX_N-00138-94162786,2022-05-01T19:21:40,Portugalete,incomes,salary,1364.97,-6151.49
buyer_7,Mar√≠a,56,ES20209524514523730381,TRX_N-00139-33234675,2022-05-01T19:21:40,Portugalete,incomes,salary_partner,1176.83,-4974.66
buyer_7,Mar√≠a,56,ES20209524514523730381,TRX_N-00140-50374827,2022-05-02T08:32:39,Portugalete,Expense,leisure,-19.8,-4994.46
buyer_7,Mar√≠a,56,ES20209524514523730381,TRX_N-00141-35642416,2022-05-03T05:19:47,Pasaia,Expense,travel,-773.64,-5768.1
buyer_7,Mar√≠a,56,ES20209524514523730381,TRX_N-00142-47132062,2022-05-03T18:10:41,Portugalete,Expense,repairs,-276.4,-6044.5
buyer_7,Mar√≠a,56,ES20209524514523730381,TRX_N-00143-37409837,2022-05-04T16:15:39,Portugalete,expenses,mortgage,-786.19,-6830.69
buyer_7,Mar√≠a,56,ES20209524514523730381,TRX_N-00144-50697882,2022-05-04T17:31:45,Portugalete,Expense,cash,-100.0,-6930.69
buyer_7,Mar√≠a,56,ES20209524514523730381,TRX_N-00145-76619171,2022-05-05T21:49:54,Portugalete,expenses,gas,-96.08,-7026.77
buyer_7,Mar√≠a,56,ES20209524514523730381,TRX_N-00146-77367054,2022-05-05T08:35:39,Portugalete,expenses,phone,-40.24,-7067.01
buyer_7,Mar√≠a,56,ES20209524514523730381,TRX_N-00147-24654787,2022-05-05T11:34:09,Iru√±a de Oca,Expense,leisure,-64.61,-7131.62
buyer_7,Mar√≠a,56,ES20209524514523730381,TRX_N-00148-77026928,2022-05-05T13:13:14,Labastida,Expense,healthcare,-125.16,-7256.78
buyer_7,Mar√≠a,56,ES20209524514523730381,TRX_N-00149-51484436,2022-05-05T17:16:15,Portugalete,Expense,cash,-100.0,-7356.78
buyer_7,Mar√≠a,56,ES20209524514523730381,TRX_N-00150-91438989,2022-05-06T12:20:03,Portugalete,expenses,water,-37.17,-7393.95
buyer_7,Mar√≠a,56,ES20209524514523730381,TRX_N-00151-74225907,2022-05-06T17:54:51,Portugalete,expenses,internet,-42.0,-7435.95
buyer_7,Mar√≠a,56,ES20209524514523730381,TRX_N-00152-47063777,2022-05-08T14:44:44,Portugalete,expenses,electricity,-48.43,-7484.38
buyer_7,Mar√≠a,56,ES20209524514523730381,TRX_N-00153-62472545,2022-05-09T19:07:49,Hondarribia,Expense,cash,-100.0,-7584.38
buyer_7,Mar√≠a,56,ES20209524514523730381,TRX_N-00154-95008749,2022-05-10T13:36:20,Portugalete,Expense,food,-85.11,-7669.49
buyer_7,Mar√≠a,56,ES20209524514523730381,TRX_N-00155-47028372,2022-05-10T19:48:31,Portugalete,Expense,transport,-63.56,-7733.05
buyer_7,Mar√≠a,56,ES20209524514523730381,TRX_N-00156-92479739,2022-05-10T12:28:13,Portugalete,Expense,cash,-100.0,-7833.05
buyer_7,Mar√≠a,56,ES20209524514523730381,TRX_N-00157-08258247,2022-05-11T18:41:44,Portugalete,Expense,food,-91.78,-7924.83
buyer_7,Mar√≠a,56,ES20209524514523730381,TRX_N-00158-09930692,2022-05-11T10:31:22,Portugalete,Expense,clothing,-146.39,-8071.22
buyer_7,Mar√≠a,56,ES20209524514523730381,TRX_N-00159-09820140,2022-05-12T19:26:26,Irun,Expense,cash,-100.0,-8171.22
buyer_7,Mar√≠a,56,ES20209524514523730381,TRX_N-00160-32526340,2022-05-13T02:46:36,Portugalete,Expense,transport,-47.05,-8218.27
buyer_7,Mar√≠a,56,ES20209524514523730381,TRX_N-00161-00272212,2022-05-13T10:45:50,Portugalete,Expense,cash,-100.0,-8318.27
buyer_7,Mar√≠a,56,ES20209524514523730381,TRX_N-00162-51572761,2022-05-15T16:00:58,Mungia,Expense,leisure,-49.4,-8367.67
buyer_7,Mar√≠a,56,ES20209524514523730381,TRX_N-00163-34446204,2022-05-16T12:56:18,Portugalete,Expense,education,-59.72,-8427.39
buyer_7,Mar√≠a,56,ES20209524514523730381,TRX_N-00164-33697628,2022-05-16T15:13:52,Portugalete,Expense,cash,-100.0,-8527.39
buyer_7,Mar√≠a,56,ES20209524514523730381,TRX_N-00165-82455509,2022-05-16T13:25:18,Portugalete,Expense,repairs,-148.69,-8676.08
buyer_7,Mar√≠a,56,ES20209524514523730381,TRX_N-00166-98486781,2022-05-19T19:05:16,Portugalete,expenses,children,-137.79,-8813.87
buyer_7,Mar√≠a,56,ES20209524514523730381,TRX_N-00167-59748274,2022-05-20T10:01:10,Portugalete,Expense,food,-120.24,-8934.11
buyer_7,Mar√≠a,56,ES20209524514523730381,TRX_N-00168-04133933,2022-05-21T10:09:27,Portugalete,Expense,leisure,-25.03,-8959.14
buyer_7,Mar√≠a,56,ES20209524514523730381,TRX_N-00169-59766936,2022-05-22T23:02:19,Amurrio,Expense,transport,-58.55,-9017.69
buyer_7,Mar√≠a,56,ES20209524514523730381,TRX_N-00170-64057281,2022-05-23T09:27:07,Portugalete,Expense,leisure,-84.22,-9101.91
buyer_7,Mar√≠a,56,ES20209524514523730381,TRX_N-00171-22578061,2022-05-23T14:03:40,Portugalete,Expense,gifts,-130.92,-9232.83
buyer_7,Mar√≠a,56,ES20209524514523730381,TRX_N-00172-31454794,2022-05-25T18:38:45,Portugalete,Expense,healthcare,-51.22,-9284.05
buyer_7,Mar√≠a,56,ES20209524514523730381,TRX_N-00173-60280180,2022-05-25T11:22:02,Leioa,Expense,cash,-100.0,-9384.05
buyer_7,Mar√≠a,56,ES20209524514523730381,TRX_N-00174-03481066,2022-05-27T13:02:28,Portugalete,expenses,children,-62.7,-9446.75
buyer_7,Mar√≠a,56,ES20209524514523730381,TRX_N-00175-54547706,2022-05-29T17:06:50,Portugalete,Expense,leisure,-64.49,-9511.24
buyer_7,Mar√≠a,56,ES20209524514523730381,TRX_N-00176-28459833,2022-05-30T19:59:51,Portugalete,Expense,food,-97.31,-9608.55
buyer_7,Mar√≠a,56,ES20209524514523730381,TRX_N-00177-68924684,2022-05-30T16:36:20,Portugalete,Expense,clothing,-74.51,-9683.06
buyer_7,Mar√≠a,56,ES20209524514523730381,TRX_N-00178-43885697,2022-05-31T14:02:26,Labastida,Expense,clothing,-69.7,-9752.76
buyer_7,Mar√≠a,56,ES20209524514523730381,TRX_N-00179-46527391,2022-05-31T10:36:50,Portugalete,Expense,cash,-100.0,-9852.76
buyer_7,Mar√≠a,56,ES20209524514523730381,TRX_N-00180-46236726,2022-05-31T19:50:23,Portugalete,Expense,repairs,-135.75,-9988.51
buyer_7,Mar√≠a,56,ES20209524514523730381,TRX_N-00181-33625323,2022-06-01T19:06:37,Portugalete,incomes,salary,1364.97,-8623.54
buyer_7,Mar√≠a,56,ES20209524514523730381,TRX_N-00182-20367232,2022-06-01T19:06:37,Portugalete,incomes,salary_partner,1176.83,-7446.71
buyer_7,Mar√≠a,56,ES20209524514523730381,TRX_N-00183-41731171,2022-06-01T19:06:37,Portugalete,incomes,salary_bonus,1076.69,-6370.02
buyer_7,Mar√≠a,56,ES20209524514523730381,TRX_N-00184-67665299,2022-06-01T19:06:37,Portugalete,incomes,salary_partner_bonus,936.32,-5433.7
buyer_7,Mar√≠a,56,ES20209524514523730381,TRX_N-00185-41611886,2022-06-03T18:04:57,Portugalete,Expense,food,-85.15,-5518.85
buyer_7,Mar√≠a,56,ES20209524514523730381,TRX_N-00186-97219536,2022-06-03T18:22:29,Portugalete,expenses,children,-138.84,-5657.69
buyer_7,Mar√≠a,56,ES20209524514523730381,TRX_N-00187-40447254,2022-06-04T15:00:02,Portugalete,expenses,mortgage,-786.19,-6443.88
buyer_7,Mar√≠a,56,ES20209524514523730381,TRX_N-00188-24388075,2022-06-04T11:26:01,Portugalete,Expense,transport,-56.89,-6500.77
buyer_7,Mar√≠a,56,ES20209524514523730381,TRX_N-00189-39622095,2022-06-04T14:16:16,Portugalete,Expense,cash,-100.0,-6600.77
buyer_7,Mar√≠a,56,ES20209524514523730381,TRX_N-00190-75553624,2022-06-05T11:47:30,Portugalete,expenses,internet,-42.0,-6642.77
buyer_7,Mar√≠a,56,ES20209524514523730381,TRX_N-00191-33380215,2022-06-05T10:28:52,Portugalete,expenses,phone,-31.2,-6673.97
buyer_7,Mar√≠a,56,ES20209524514523730381,TRX_N-00192-57198122,2022-06-05T21:22:43,Portugalete,Expense,repairs,-299.45,-6973.42
buyer_7,Mar√≠a,56,ES20209524514523730381,TRX_N-00193-53417254,2022-06-06T01:04:46,Portugalete,expenses,electricity,-50.7,-7024.12
buyer_7,Mar√≠a,56,ES20209524514523730381,TRX_N-00194-60240006,2022-06-06T15:43:17,Portugalete,expenses,gas,-37.76,-7061.88
buyer_7,Mar√≠a,56,ES20209524514523730381,TRX_N-00195-83854353,2022-06-07T20:43:35,Portugalete,Expense,repairs,-267.82,-7329.7
buyer_7,Mar√≠a,56,ES20209524514523730381,TRX_N-00196-93682257,2022-06-08T12:22:59,Portugalete,expenses,water,-29.42,-7359.12
buyer_7,Mar√≠a,56,ES20209524514523730381,TRX_N-00197-53634618,2022-06-08T12:04:51,Portugalete,Expense,food,-96.97,-7456.09
buyer_7,Mar√≠a,56,ES20209524514523730381,TRX_N-00198-34641530,2022-06-08T17:01:06,Portugalete,Expense,transport,-79.97,-7536.06
buyer_7,Mar√≠a,56,ES20209524514523730381,TRX_N-00199-16820341,2022-06-08T14:10:04,Portugalete,Expense,leisure,-67.27,-7603.33
buyer_7,Mar√≠a,56,ES20209524514523730381,TRX_N-00200-33356255,2022-06-09T13:09:36,Portugalete,Expense,leisure,-79.81,-7683.14
buyer_7,Mar√≠a,56,ES20209524514523730381,TRX_N-00201-44154970,2022-06-10T12:10:37,Portugalete,Expense,repairs,-255.1,-7938.24
buyer_7,Mar√≠a,56,ES20209524514523730381,TRX_N-00202-09213364,2022-06-11T16:56:42,Iru√±a de Oca,Expense,cash,-100.0,-8038.24
buyer_7,Mar√≠a,56,ES20209524514523730381,TRX_N-00203-38668534,2022-06-12T18:09:12,Portugalete,Expense,travel,-1852.2,-9890.44
buyer_7,Mar√≠a,56,ES20209524514523730381,TRX_N-00204-72847137,2022-06-14T10:15:28,Portugalete,Expense,clothing,-104.54,-9994.98
buyer_7,Mar√≠a,56,ES20209524514523730381,TRX_N-00205-97846985,2022-06-14T13:04:00,Portugalete,Expense,cash,-100.0,-10094.98
buyer_7,Mar√≠a,56,ES20209524514523730381,TRX_N-00206-14972238,2022-06-16T18:11:00,Portugalete,Expense,transport,-89.58,-10184.56
buyer_7,Mar√≠a,56,ES20209524514523730381,TRX_N-00207-51421071,2022-06-16T20:46:49,Portugalete,expenses,children,-59.91,-10244.47
buyer_7,Mar√≠a,56,ES20209524514523730381,TRX_N-00208-07551798,2022-06-17T16:38:36,Eibar,Expense,education,-56.19,-10300.66
buyer_7,Mar√≠a,56,ES20209524514523730381,TRX_N-00209-40537619,2022-06-17T15:06:13,Portugalete,Expense,cash,-100.0,-10400.66
buyer_7,Mar√≠a,56,ES20209524514523730381,TRX_N-00210-53832590,2022-06-19T09:42:50,Portugalete,Expense,clothing,-76.66,-10477.32
buyer_7,Mar√≠a,56,ES20209524514523730381,TRX_N-00211-18701774,2022-06-20T14:52:00,Portugalete,Expense,cash,-100.0,-10577.32
buyer_7,Mar√≠a,56,ES20209524514523730381,TRX_N-00212-72453718,2022-06-20T05:47:41,Portugalete,Expense,repairs,-54.87,-10632.19
buyer_7,Mar√≠a,56,ES20209524514523730381,TRX_N-00213-69461323,2022-06-22T16:06:02,Portugalete,Expense,leisure,-42.28,-10674.47
buyer_7,Mar√≠a,56,ES20209524514523730381,TRX_N-00214-27394332,2022-06-25T12:35:28,Eibar,Expense,leisure,-60.84,-10735.31
buyer_7,Mar√≠a,56,ES20209524514523730381,TRX_N-00215-44998476,2022-06-25T14:03:15,Berango,Expense,repairs,-113.56,-10848.87
buyer_7,Mar√≠a,56,ES20209524514523730381,TRX_N-00216-90460179,2022-06-26T09:34:45,Portugalete,Expense,healthcare,-95.53,-10944.4
buyer_7,Mar√≠a,56,ES20209524514523730381,TRX_N-00217-22461484,2022-06-28T12:01:53,Salvatierra/Agurain,Expense,leisure,-38.78,-10983.18
buyer_7,Mar√≠a,56,ES20209524514523730381,TRX_N-00218-85065395,2022-06-29T20:59:57,Portugalete,Expense,repairs,-178.66,-11161.84
buyer_7,Mar√≠a,56,ES20209524514523730381,TRX_N-00219-82965869,2022-06-30T09:06:45,Portugalete,Expense,transport,-81.34,-11243.18
buyer_7,Mar√≠a,56,ES20209524514523730381,TRX_N-00220-04722164,2022-06-30T13:14:17,Portugalete,Expense,cash,-100.0,-11343.18
buyer_7,Mar√≠a,56,ES20209524514523730381,TRX_N-00221-92343160,2022-07-01T15:40:16,Portugalete,incomes,salary,1364.97,-9978.21
buyer_7,Mar√≠a,56,ES20209524514523730381,TRX_N-00222-44242437,2022-07-01T15:40:16,Portugalete,incomes,salary_partner,1176.83,-8801.38
buyer_7,Mar√≠a,56,ES20209524514523730381,TRX_N-00223-48530134,2022-07-01T15:39:09,Portugalete,Expense,food,-83.97,-8885.35
buyer_7,Mar√≠a,56,ES20209524514523730381,TRX_N-00224-53555759,2022-07-01T19:51:25,Portugalete,Expense,repairs,-292.81,-9178.16
buyer_7,Mar√≠a,56,ES20209524514523730381,TRX_N-00225-40849958,2022-07-02T19:30:23,Portugalete,Expense,food,-121.26,-9299.42
buyer_7,Mar√≠a,56,ES20209524514523730381,TRX_N-00226-33261343,2022-07-04T08:37:26,Portugalete,expenses,mortgage,-786.19,-10085.61
buyer_7,Mar√≠a,56,ES20209524514523730381,TRX_N-00227-45535228,2022-07-04T12:40:08,Portugalete,Expense,food,-96.43,-10182.04
buyer_7,Mar√≠a,56,ES20209524514523730381,TRX_N-00228-02757690,2022-07-05T19:42:18,Portugalete,expenses,water,-41.62,-10223.66
buyer_7,Mar√≠a,56,ES20209524514523730381,TRX_N-00229-98627441,2022-07-05T10:19:51,Portugalete,expenses,internet,-42.0,-10265.66
buyer_7,Mar√≠a,56,ES20209524514523730381,TRX_N-00230-09939107,2022-07-05T08:56:32,Portugalete,Expense,cash,-100.0,-10365.66
buyer_7,Mar√≠a,56,ES20209524514523730381,TRX_N-00231-60002070,2022-07-06T20:31:24,Portugalete,expenses,gas,-59.2,-10424.86
buyer_7,Mar√≠a,56,ES20209524514523730381,TRX_N-00232-89149873,2022-07-06T10:33:48,Portugalete,Expense,healthcare,-117.59,-10542.45
buyer_7,Mar√≠a,56,ES20209524514523730381,TRX_N-00233-84571687,2022-07-06T21:12:15,Portugalete,Expense,education,-65.98,-10608.43
buyer_7,Mar√≠a,56,ES20209524514523730381,TRX_N-00234-00987666,2022-07-06T13:50:00,Llodio,Expense,cash,-100.0,-10708.43
buyer_7,Mar√≠a,56,ES20209524514523730381,TRX_N-00235-24982401,2022-07-07T20:54:08,Portugalete,Expense,food,-81.93,-10790.36
buyer_7,Mar√≠a,56,ES20209524514523730381,TRX_N-00236-82973016,2022-07-08T14:02:37,Portugalete,expenses,electricity,-74.65,-10865.01
buyer_7,Mar√≠a,56,ES20209524514523730381,TRX_N-00237-24560464,2022-07-08T18:00:15,Portugalete,expenses,phone,-40.14,-10905.15
buyer_7,Mar√≠a,56,ES20209524514523730381,TRX_N-00238-12353287,2022-07-08T08:28:43,Portugalete,Expense,travel,-981.79,-11886.94
buyer_7,Mar√≠a,56,ES20209524514523730381,TRX_N-00239-97689810,2022-07-09T18:34:21,Portugalete,Expense,transport,-70.87,-11957.81
buyer_7,Mar√≠a,56,ES20209524514523730381,TRX_N-00240-69300607,2022-07-11T23:22:44,Portugalete,Expense,repairs,-40.72,-11998.53
buyer_7,Mar√≠a,56,ES20209524514523730381,TRX_N-00241-40032786,2022-07-12T20:11:37,Elciego,Expense,leisure,-24.49,-12023.02
buyer_7,Mar√≠a,56,ES20209524514523730381,TRX_N-00242-58377004,2022-07-13T16:52:16,Hondarribia,Expense,cash,-100.0,-12123.02
buyer_7,Mar√≠a,56,ES20209524514523730381,TRX_N-00243-01742073,2022-07-18T15:43:42,Hernani,Expense,leisure,-83.2,-12206.22
buyer_7,Mar√≠a,56,ES20209524514523730381,TRX_N-00244-33085522,2022-07-19T11:46:37,Irun,Expense,transport,-52.94,-12259.16
buyer_7,Mar√≠a,56,ES20209524514523730381,TRX_N-00245-41025727,2022-07-20T16:33:03,Portugalete,Expense,cash,-100.0,-12359.16
buyer_7,Mar√≠a,56,ES20209524514523730381,TRX_N-00246-03272810,2022-07-22T15:34:04,Andoain,Expense,food,-74.07,-12433.23
buyer_7,Mar√≠a,56,ES20209524514523730381,TRX_N-00247-92544056,2022-07-23T17:46:30,Portugalete,Expense,cash,-100.0,-12533.23
buyer_7,Mar√≠a,56,ES20209524514523730381,TRX_N-00248-43508917,2022-07-24T07:39:50,Portugalete,Expense,food,-91.46,-12624.69
buyer_7,Mar√≠a,56,ES20209524514523730381,TRX_N-00249-00891876,2022-07-25T19:46:35,Portugalete,Expense,education,-52.08,-12676.77
buyer_7,Mar√≠a,56,ES20209524514523730381,TRX_N-00250-35752169,2022-07-26T13:56:49,Portugalete,Expense,cash,-100.0,-12776.77
buyer_7,Mar√≠a,56,ES20209524514523730381,TRX_N-00251-16605578,2022-07-27T20:06:02,Portugalete,Expense,appliances,-354.14,-13130.91
buyer_7,Mar√≠a,56,ES20209524514523730381,TRX_N-00252-42849933,2022-07-28T23:35:13,Portugalete,Expense,gifts,-848.03,-13978.94
buyer_7,Mar√≠a,56,ES20209524514523730381,TRX_N-00253-82093347,2022-07-29T15:16:41,Portugalete,Expense,food,-62.46,-14041.4
buyer_7,Mar√≠a,56,ES20209524514523730381,TRX_N-00254-91411974,2022-07-29T19:08:17,Portugalete,Expense,gifts,-99.15,-14140.55
buyer_7,Mar√≠a,56,ES20209524514523730381,TRX_N-00255-26765699,2022-07-30T18:46:00,Bermeo,Expense,transport,-44.33,-14184.88
buyer_7,Mar√≠a,56,ES20209524514523730381,TRX_N-00256-13194946,2022-07-30T16:58:21,Portugalete,Expense,cash,-100.0,-14284.88
buyer_7,Mar√≠a,56,ES20209524514523730381,TRX_N-00257-92941659,2022-08-01T22:53:15,Portugalete,incomes,salary,1364.97,-12919.91
buyer_7,Mar√≠a,56,ES20209524514523730381,TRX_N-00258-43713175,2022-08-01T22:53:15,Portugalete,incomes,salary_partner,1176.83,-11743.08
buyer_7,Mar√≠a,56,ES20209524514523730381,TRX_N-00259-48057625,2022-08-01T22:53:15,Portugalete,incomes,extra_income,134.71,-11608.37
buyer_7,Mar√≠a,56,ES20209524514523730381,TRX_N-00260-56448076,2022-08-03T09:58:11,Portugalete,Expense,transport,-73.83,-11682.2
buyer_7,Mar√≠a,56,ES20209524514523730381,TRX_N-00261-55368090,2022-08-04T18:56:07,Portugalete,expenses,mortgage,-786.19,-12468.39
buyer_7,Mar√≠a,56,ES20209524514523730381,TRX_N-00262-98571555,2022-08-04T14:41:17,Portugalete,Expense,food,-122.03,-12590.42
buyer_7,Mar√≠a,56,ES20209524514523730381,TRX_N-00263-90195510,2022-08-04T18:26:25,Portugalete,Expense,leisure,-31.0,-12621.42
buyer_7,Mar√≠a,56,ES20209524514523730381,TRX_N-00264-67895422,2022-08-04T17:29:31,Portugalete,Expense,cash,-100.0,-12721.42
buyer_7,Mar√≠a,56,ES20209524514523730381,TRX_N-00265-96603349,2022-08-05T15:08:22,Portugalete,expenses,internet,-42.0,-12763.42
buyer_7,Mar√≠a,56,ES20209524514523730381,TRX_N-00266-77553077,2022-08-05T18:27:56,Portugalete,expenses,phone,-43.14,-12806.56
buyer_7,Mar√≠a,56,ES20209524514523730381,TRX_N-00267-48098963,2022-08-06T19:35:43,Portugalete,Expense,food,-64.1,-12870.66
buyer_7,Mar√≠a,56,ES20209524514523730381,TRX_N-00268-60732859,2022-08-06T10:42:01,Portugalete,Expense,leisure,-58.96,-12929.62
buyer_7,Mar√≠a,56,ES20209524514523730381,TRX_N-00269-57746234,2022-08-07T10:44:03,Portugalete,expenses,electricity,-70.31,-12999.93
buyer_7,Mar√≠a,56,ES20209524514523730381,TRX_N-00270-37517563,2022-08-08T10:21:06,Portugalete,expenses,water,-39.38,-13039.31
buyer_7,Mar√≠a,56,ES20209524514523730381,TRX_N-00271-99852060,2022-08-08T09:51:38,Portugalete,expenses,gas,-88.56,-13127.87
buyer_7,Mar√≠a,56,ES20209524514523730381,TRX_N-00272-06353053,2022-08-08T23:54:23,Portugalete,Expense,food,-124.73,-13252.6
buyer_7,Mar√≠a,56,ES20209524514523730381,TRX_N-00273-04868991,2022-08-13T17:52:43,Portugalete,Expense,cash,-100.0,-13352.6
buyer_7,Mar√≠a,56,ES20209524514523730381,TRX_N-00274-18883050,2022-08-14T22:10:28,Portugalete,Expense,transport,-54.1,-13406.7
buyer_7,Mar√≠a,56,ES20209524514523730381,TRX_N-00275-22935718,2022-08-14T22:58:43,Portugalete,Expense,leisure,-30.25,-13436.95
buyer_7,Mar√≠a,56,ES20209524514523730381,TRX_N-00276-72638424,2022-08-16T20:17:23,Portugalete,Expense,cash,-100.0,-13536.95
buyer_7,Mar√≠a,56,ES20209524514523730381,TRX_N-00277-99301666,2022-08-17T13:13:40,Portugalete,Expense,cash,-100.0,-13636.95
buyer_7,Mar√≠a,56,ES20209524514523730381,TRX_N-00278-29935979,2022-08-20T20:37:21,Portugalete,Expense,travel,-1342.27,-14979.22
buyer_7,Mar√≠a,56,ES20209524514523730381,TRX_N-00279-07365784,2022-08-21T10:10:59,Portugalete,Expense,gifts,-530.79,-15510.01
buyer_7,Mar√≠a,56,ES20209524514523730381,TRX_N-00280-32601520,2022-08-22T11:26:36,Portugalete,Expense,cash,-100.0,-15610.01
buyer_7,Mar√≠a,56,ES20209524514523730381,TRX_N-00281-50918257,2022-08-26T19:42:08,Portugalete,expenses,children,-106.12,-15716.13
buyer_7,Mar√≠a,56,ES20209524514523730381,TRX_N-00282-51822520,2022-08-28T02:25:17,Portugalete,Expense,leisure,-28.8,-15744.93
buyer_7,Mar√≠a,56,ES20209524514523730381,TRX_N-00283-15925650,2022-08-29T10:24:16,Portugalete,Expense,cash,-100.0,-15844.93
buyer_7,Mar√≠a,56,ES20209524514523730381,TRX_N-00284-83539088,2022-08-29T09:12:08,Portugalete,Expense,appliances,-207.51,-16052.44
buyer_7,Mar√≠a,56,ES20209524514523730381,TRX_N-00285-25771238,2022-08-31T12:48:53,Portugalete,Expense,transport,-58.33,-16110.77
buyer_7,Mar√≠a,56,ES20209524514523730381,TRX_N-00286-74931381,2022-09-01T09:03:24,Portugalete,incomes,salary,1364.97,-14745.8
buyer_7,Mar√≠a,56,ES20209524514523730381,TRX_N-00287-15270291,2022-09-01T09:03:24,Portugalete,incomes,salary_partner,1176.83,-13568.97
buyer_7,Mar√≠a,56,ES20209524514523730381,TRX_N-00288-61844507,2022-09-01T19:26:18,Portugalete,Expense,food,-83.07,-13652.04
buyer_7,Mar√≠a,56,ES20209524514523730381,TRX_N-00289-56161493,2022-09-03T12:22:18,Portugalete,Expense,repairs,-220.02,-13872.06
buyer_7,Mar√≠a,56,ES20209524514523730381,TRX_N-00290-06111749,2022-09-04T20:46:25,Portugalete,expenses,mortgage,-786.19,-14658.25
buyer_7,Mar√≠a,56,ES20209524514523730381,TRX_N-00291-52504787,2022-09-05T13:37:13,Portugalete,expenses,electricity,-80.09,-14738.34
buyer_7,Mar√≠a,56,ES20209524514523730381,TRX_N-00292-97190563,2022-09-05T17:05:26,Portugalete,expenses,gas,-61.71,-14800.05
buyer_7,Mar√≠a,56,ES20209524514523730381,TRX_N-00293-97851262,2022-09-05T11:46:26,Portugalete,expenses,phone,-44.31,-14844.36
buyer_7,Mar√≠a,56,ES20209524514523730381,TRX_N-00294-97465485,2022-09-05T09:11:14,Portugalete,Expense,clothing,-73.64,-14918.0
buyer_7,Mar√≠a,56,ES20209524514523730381,TRX_N-00295-94523645,2022-09-05T20:30:57,Arrasate,Expense,cash,-100.0,-15018.0
buyer_7,Mar√≠a,56,ES20209524514523730381,TRX_N-00296-61256486,2022-09-06T16:43:56,Vitoria-Gasteiz,Expense,transport,-43.82,-15061.82
buyer_7,Mar√≠a,56,ES20209524514523730381,TRX_N-00297-88236766,2022-09-06T00:08:09,Portugalete,Expense,leisure,-37.35,-15099.17
buyer_7,Mar√≠a,56,ES20209524514523730381,TRX_N-00298-93312883,2022-09-07T08:50:06,Portugalete,expenses,water,-30.9,-15130.07
buyer_7,Mar√≠a,56,ES20209524514523730381,TRX_N-00299-01674331,2022-09-07T09:42:38,Portugalete,Expense,cash,-100.0,-15230.07
buyer_7,Mar√≠a,56,ES20209524514523730381,TRX_N-00300-06156946,2022-09-08T10:43:38,Portugalete,expenses,internet,-42.0,-15272.07
buyer_7,Mar√≠a,56,ES20209524514523730381,TRX_N-00301-26849901,2022-09-08T19:07:56,Llodio,Expense,food,-61.95,-15334.02
buyer_7,Mar√≠a,56,ES20209524514523730381,TRX_N-00302-97049253,2022-09-08T15:17:54,Portugalete,Expense,cash,-100.0,-15434.02
buyer_7,Mar√≠a,56,ES20209524514523730381,TRX_N-00303-36376126,2022-09-10T20:06:01,Portugalete,Expense,leisure,-34.52,-15468.54
buyer_7,Mar√≠a,56,ES20209524514523730381,TRX_N-00304-38505837,2022-09-11T05:20:41,Portugalete,Expense,food,-116.31,-15584.85
buyer_7,Mar√≠a,56,ES20209524514523730381,TRX_N-00305-23353279,2022-09-13T09:36:21,Salvatierra/Agurain,Expense,transport,-60.8,-15645.65
buyer_7,Mar√≠a,56,ES20209524514523730381,TRX_N-00306-38426946,2022-09-13T18:37:04,Salvatierra/Agurain,Expense,leisure,-36.72,-15682.37
buyer_7,Mar√≠a,56,ES20209524514523730381,TRX_N-00307-10127155,2022-09-16T18:15:26,Portugalete,Expense,food,-124.72,-15807.09
buyer_7,Mar√≠a,56,ES20209524514523730381,TRX_N-00308-93070412,2022-09-16T11:48:13,Labastida,Expense,transport,-56.87,-15863.96
buyer_7,Mar√≠a,56,ES20209524514523730381,TRX_N-00309-39092372,2022-09-16T21:08:12,Portugalete,Expense,cash,-100.0,-15963.96
buyer_7,Mar√≠a,56,ES20209524514523730381,TRX_N-00310-61974351,2022-09-17T08:09:34,Portugalete,Expense,education,-51.04,-16015.0
buyer_7,Mar√≠a,56,ES20209524514523730381,TRX_N-00311-28677730,2022-09-17T10:37:09,Portugalete,Expense,cash,-100.0,-16115.0
buyer_7,Mar√≠a,56,ES20209524514523730381,TRX_N-00312-23481431,2022-09-18T20:56:30,Portugalete,Expense,repairs,-293.8,-16408.8
buyer_7,Mar√≠a,56,ES20209524514523730381,TRX_N-00313-04920296,2022-09-20T20:42:53,Portugalete,Expense,cash,-100.0,-16508.8
buyer_7,Mar√≠a,56,ES20209524514523730381,TRX_N-00314-23851782,2022-09-20T19:48:44,Mungia,Expense,gifts,-304.17,-16812.97
buyer_7,Mar√≠a,56,ES20209524514523730381,TRX_N-00315-20151384,2022-09-21T18:35:05,Portugalete,Expense,clothing,-117.56,-16930.53
buyer_7,Mar√≠a,56,ES20209524514523730381,TRX_N-00316-63937388,2022-09-22T16:30:55,Portugalete,Expense,leisure,-64.5,-16995.03
buyer_7,Mar√≠a,56,ES20209524514523730381,TRX_N-00317-16668897,2022-09-22T16:29:31,Portugalete,Expense,cash,-100.0,-17095.03
buyer_7,Mar√≠a,56,ES20209524514523730381,TRX_N-00318-27048496,2022-09-23T16:52:57,Portugalete,Expense,food,-74.47,-17169.5
buyer_7,Mar√≠a,56,ES20209524514523730381,TRX_N-00319-89181015,2022-09-25T14:54:53,Portugalete,Expense,cash,-100.0,-17269.5
buyer_7,Mar√≠a,56,ES20209524514523730381,TRX_N-00320-53659335,2022-09-26T19:45:19,Portugalete,Expense,education,-66.0,-17335.5
buyer_7,Mar√≠a,56,ES20209524514523730381,TRX_N-00321-03936902,2022-09-27T08:24:27,Portugalete,Expense,clothing,-94.43,-17429.93
buyer_7,Mar√≠a,56,ES20209524514523730381,TRX_N-00322-31205709,2022-09-28T12:58:01,Mungia,Expense,appliances,-409.08,-17839.01
buyer_7,Mar√≠a,56,ES20209524514523730381,TRX_N-00323-58285312,2022-09-30T15:45:26,Portugalete,expenses,children,-84.31,-17923.32
buyer_7,Mar√≠a,56,ES20209524514523730381,TRX_N-00324-22069379,2022-10-01T09:56:24,Portugalete,incomes,salary,1364.97,-16558.35
buyer_7,Mar√≠a,56,ES20209524514523730381,TRX_N-00325-39594250,2022-10-01T09:56:24,Portugalete,incomes,salary_partner,1176.83,-15381.52
buyer_7,Mar√≠a,56,ES20209524514523730381,TRX_N-00326-10773864,2022-10-01T19:51:05,Portugalete,Expense,healthcare,-125.12,-15506.64
buyer_7,Mar√≠a,56,ES20209524514523730381,TRX_N-00327-22569182,2022-10-04T11:37:11,Portugalete,expenses,mortgage,-786.19,-16292.83
buyer_7,Mar√≠a,56,ES20209524514523730381,TRX_N-00328-36658471,2022-10-05T11:12:21,Portugalete,expenses,water,-24.46,-16317.29
buyer_7,Mar√≠a,56,ES20209524514523730381,TRX_N-00329-21211500,2022-10-05T16:27:01,Portugalete,expenses,internet,-42.0,-16359.29
buyer_7,Mar√≠a,56,ES20209524514523730381,TRX_N-00330-92134332,2022-10-05T21:46:54,Portugalete,Expense,transport,-81.64,-16440.93
buyer_7,Mar√≠a,56,ES20209524514523730381,TRX_N-00331-78508073,2022-10-05T11:01:27,Sestao,Expense,clothing,-154.1,-16595.03
buyer_7,Mar√≠a,56,ES20209524514523730381,TRX_N-00332-93616756,2022-10-05T00:42:59,Portugalete,Expense,cash,-100.0,-16695.03
buyer_7,Mar√≠a,56,ES20209524514523730381,TRX_N-00333-55501813,2022-10-05T11:46:39,Portugalete,Expense,repairs,-97.87,-16792.9
buyer_7,Mar√≠a,56,ES20209524514523730381,TRX_N-00334-05783722,2022-10-06T14:14:42,Portugalete,expenses,electricity,-21.75,-16814.65
buyer_7,Mar√≠a,56,ES20209524514523730381,TRX_N-00335-50696624,2022-10-06T19:48:29,Portugalete,Expense,food,-110.84,-16925.49
buyer_7,Mar√≠a,56,ES20209524514523730381,TRX_N-00336-71334981,2022-10-07T16:02:01,Portugalete,expenses,gas,-51.76,-16977.25
buyer_7,Mar√≠a,56,ES20209524514523730381,TRX_N-00337-66202855,2022-10-07T11:24:04,Portugalete,Expense,food,-104.65,-17081.9
buyer_7,Mar√≠a,56,ES20209524514523730381,TRX_N-00338-91035256,2022-10-07T05:16:25,Portugalete,Expense,repairs,-303.81,-17385.71
buyer_7,Mar√≠a,56,ES20209524514523730381,TRX_N-00339-30782863,2022-10-07T16:04:17,Portugalete,expenses,children,-204.42,-17590.13
buyer_7,Mar√≠a,56,ES20209524514523730381,TRX_N-00340-66632506,2022-10-08T19:14:38,Portugalete,expenses,phone,-32.69,-17622.82
buyer_7,Mar√≠a,56,ES20209524514523730381,TRX_N-00341-09224647,2022-10-08T18:45:32,Portugalete,Expense,appliances,-98.95,-17721.77
buyer_7,Mar√≠a,56,ES20209524514523730381,TRX_N-00342-00386557,2022-10-08T21:13:21,Portugalete,Expense,gifts,-491.29,-18213.06
buyer_7,Mar√≠a,56,ES20209524514523730381,TRX_N-00343-53435974,2022-10-09T17:23:02,Portugalete,Expense,cash,-100.0,-18313.06
buyer_7,Mar√≠a,56,ES20209524514523730381,TRX_N-00344-12811235,2022-10-11T17:07:46,Portugalete,Expense,leisure,-49.42,-18362.48
buyer_7,Mar√≠a,56,ES20209524514523730381,TRX_N-00345-48860596,2022-10-11T08:36:57,Zarautz,Expense,repairs,-64.67,-18427.15
buyer_7,Mar√≠a,56,ES20209524514523730381,TRX_N-00346-70785221,2022-10-11T21:43:52,Portugalete,expenses,children,-254.1,-18681.25
buyer_7,Mar√≠a,56,ES20209524514523730381,TRX_N-00347-66128105,2022-10-12T08:22:34,Labastida,Expense,appliances,-312.89,-18994.14
buyer_7,Mar√≠a,56,ES20209524514523730381,TRX_N-00348-94931120,2022-10-12T11:46:24,Portugalete,Expense,gifts,-606.96,-19601.1
buyer_7,Mar√≠a,56,ES20209524514523730381,TRX_N-00349-58880729,2022-10-13T16:15:43,Portugalete,Expense,food,-102.76,-19703.86
buyer_7,Mar√≠a,56,ES20209524514523730381,TRX_N-00350-10796178,2022-10-18T19:29:03,Barakaldo,Expense,cash,-100.0,-19803.86
buyer_7,Mar√≠a,56,ES20209524514523730381,TRX_N-00351-65681941,2022-10-20T23:39:25,Berango,Expense,repairs,-158.6,-19962.46
buyer_7,Mar√≠a,56,ES20209524514523730381,TRX_N-00352-20002825,2022-10-20T13:51:11,Portugalete,expenses,children,-196.27,-20158.73
buyer_7,Mar√≠a,56,ES20209524514523730381,TRX_N-00353-34884503,2022-10-23T20:11:20,Portugalete,Expense,cash,-100.0,-20258.73
buyer_7,Mar√≠a,56,ES20209524514523730381,TRX_N-00354-32641820,2022-10-24T22:15:03,Portugalete,Expense,cash,-100.0,-20358.73
buyer_7,Mar√≠a,56,ES20209524514523730381,TRX_N-00355-50335240,2022-10-25T15:39:56,Portugalete,Expense,leisure,-48.83,-20407.56
buyer_7,Mar√≠a,56,ES20209524514523730381,TRX_N-00356-34882460,2022-10-26T15:21:22,Portugalete,Expense,leisure,-41.54,-20449.1
buyer_7,Mar√≠a,56,ES20209524514523730381,TRX_N-00357-24998112,2022-10-26T09:51:01,Portugalete,Expense,appliances,-204.49,-20653.59
buyer_7,Mar√≠a,56,ES20209524514523730381,TRX_N-00358-02317237,2022-10-27T08:10:13,Portugalete,Expense,education,-51.2,-20704.79
buyer_7,Mar√≠a,56,ES20209524514523730381,TRX_N-00359-34440504,2022-10-28T15:14:32,Portugalete,Expense,transport,-49.3,-20754.09
buyer_7,Mar√≠a,56,ES20209524514523730381,TRX_N-00360-25292851,2022-10-30T17:03:37,Portugalete,Expense,healthcare,-149.78,-20903.87
buyer_7,Mar√≠a,56,ES20209524514523730381,TRX_N-00361-06912547,2022-10-30T09:13:05,Portugalete,Expense,gifts,-77.26,-20981.13
buyer_7,Mar√≠a,56,ES20209524514523730381,TRX_N-00362-20602426,2022-11-01T21:26:00,Portugalete,incomes,salary,1364.97,-19616.16
buyer_7,Mar√≠a,56,ES20209524514523730381,TRX_N-00363-25914683,2022-11-01T21:26:00,Portugalete,incomes,salary_partner,1176.83,-18439.33
buyer_7,Mar√≠a,56,ES20209524514523730381,TRX_N-00364-92997068,2022-11-01T19:29:39,Portugalete,Expense,food,-120.94,-18560.27
buyer_7,Mar√≠a,56,ES20209524514523730381,TRX_N-00365-21581522,2022-11-01T15:58:59,Portugalete,Expense,clothing,-99.2,-18659.47
buyer_7,Mar√≠a,56,ES20209524514523730381,TRX_N-00366-42515066,2022-11-02T19:37:30,Portugalete,Expense,food,-97.44,-18756.91
buyer_7,Mar√≠a,56,ES20209524514523730381,TRX_N-00367-30372663,2022-11-03T23:41:06,Portugalete,Expense,food,-99.79,-18856.7
buyer_7,Mar√≠a,56,ES20209524514523730381,TRX_N-00368-00119424,2022-11-03T05:24:01,Portugalete,Expense,repairs,-188.72,-19045.42
buyer_7,Mar√≠a,56,ES20209524514523730381,TRX_N-00369-49556243,2022-11-04T13:45:33,Portugalete,expenses,mortgage,-786.19,-19831.61
buyer_7,Mar√≠a,56,ES20209524514523730381,TRX_N-00370-48854609,2022-11-04T15:13:12,Portugalete,Expense,transport,-62.65,-19894.26
buyer_7,Mar√≠a,56,ES20209524514523730381,TRX_N-00371-75391687,2022-11-05T13:05:54,Portugalete,expenses,gas,-73.75,-19968.01
buyer_7,Mar√≠a,56,ES20209524514523730381,TRX_N-00372-54598378,2022-11-05T20:12:57,Portugalete,expenses,internet,-42.0,-20010.01
buyer_7,Mar√≠a,56,ES20209524514523730381,TRX_N-00373-35034177,2022-11-06T18:06:23,Portugalete,expenses,water,-26.01,-20036.02
buyer_7,Mar√≠a,56,ES20209524514523730381,TRX_N-00374-24766306,2022-11-06T08:04:48,Portugalete,expenses,phone,-32.75,-20068.77
buyer_7,Mar√≠a,56,ES20209524514523730381,TRX_N-00375-03714903,2022-11-06T18:55:43,Portugalete,Expense,cash,-100.0,-20168.77
buyer_7,Mar√≠a,56,ES20209524514523730381,TRX_N-00376-57143579,2022-11-06T15:21:06,Sestao,Expense,gifts,-243.37,-20412.14
buyer_7,Mar√≠a,56,ES20209524514523730381,TRX_N-00377-42278395,2022-11-07T17:18:17,Portugalete,Expense,leisure,-68.6,-20480.74
buyer_7,Mar√≠a,56,ES20209524514523730381,TRX_N-00378-25957083,2022-11-08T11:12:45,Portugalete,expenses,electricity,-49.46,-20530.2
buyer_7,Mar√≠a,56,ES20209524514523730381,TRX_N-00379-61615887,2022-11-08T09:58:08,Portugalete,Expense,transport,-55.5,-20585.7
buyer_7,Mar√≠a,56,ES20209524514523730381,TRX_N-00380-14926618,2022-11-08T08:59:11,Portugalete,Expense,leisure,-67.5,-20653.2
buyer_7,Mar√≠a,56,ES20209524514523730381,TRX_N-00381-99088878,2022-11-10T12:55:36,Portugalete,Expense,food,-65.27,-20718.47
buyer_7,Mar√≠a,56,ES20209524514523730381,TRX_N-00382-92233113,2022-11-10T11:38:10,Portugalete,Expense,education,-42.69,-20761.16
buyer_7,Mar√≠a,56,ES20209524514523730381,TRX_N-00383-41192974,2022-11-11T16:01:10,Portugalete,Expense,cash,-100.0,-20861.16
buyer_7,Mar√≠a,56,ES20209524514523730381,TRX_N-00384-04920055,2022-11-11T12:12:59,Portugalete,Expense,repairs,-263.44,-21124.6
buyer_7,Mar√≠a,56,ES20209524514523730381,TRX_N-00385-69654227,2022-11-12T15:13:33,Sestao,Expense,cash,-100.0,-21224.6
buyer_7,Mar√≠a,56,ES20209524514523730381,TRX_N-00386-79877182,2022-11-13T17:39:56,Portugalete,Expense,leisure,-83.61,-21308.21
buyer_7,Mar√≠a,56,ES20209524514523730381,TRX_N-00387-44052833,2022-11-13T13:34:27,Pasaia,Expense,repairs,-238.81,-21547.02
buyer_7,Mar√≠a,56,ES20209524514523730381,TRX_N-00388-83473398,2022-11-14T23:11:51,Portugalete,Expense,food,-93.96,-21640.98
buyer_7,Mar√≠a,56,ES20209524514523730381,TRX_N-00389-11660282,2022-11-14T10:15:06,Portugalete,Expense,cash,-100.0,-21740.98
buyer_7,Mar√≠a,56,ES20209524514523730381,TRX_N-00390-39614055,2022-11-17T08:19:23,Hernani,Expense,clothing,-84.3,-21825.28
buyer_7,Mar√≠a,56,ES20209524514523730381,TRX_N-00391-33345174,2022-11-18T18:53:30,Portugalete,Expense,gifts,-315.24,-22140.52
buyer_7,Mar√≠a,56,ES20209524514523730381,TRX_N-00392-66344730,2022-11-19T09:25:52,Portugalete,Expense,transport,-61.13,-22201.65
buyer_7,Mar√≠a,56,ES20209524514523730381,TRX_N-00393-15131923,2022-11-19T00:50:03,Portugalete,Expense,leisure,-77.67,-22279.32
buyer_7,Mar√≠a,56,ES20209524514523730381,TRX_N-00394-56978840,2022-11-19T05:29:05,Portugalete,Expense,cash,-100.0,-22379.32
buyer_7,Mar√≠a,56,ES20209524514523730381,TRX_N-00395-32499095,2022-11-20T08:23:00,Portugalete,Expense,repairs,-114.36,-22493.68
buyer_7,Mar√≠a,56,ES20209524514523730381,TRX_N-00396-29894749,2022-11-23T05:31:54,Portugalete,Expense,food,-77.97,-22571.65
buyer_7,Mar√≠a,56,ES20209524514523730381,TRX_N-00397-52189064,2022-11-24T16:21:14,Portugalete,Expense,food,-116.46,-22688.11
buyer_7,Mar√≠a,56,ES20209524514523730381,TRX_N-00398-07516514,2022-11-24T08:16:56,Portugalete,Expense,cash,-100.0,-22788.11
buyer_7,Mar√≠a,56,ES20209524514523730381,TRX_N-00399-72649366,2022-11-26T11:32:43,Portugalete,Expense,food,-105.18,-22893.29
buyer_7,Mar√≠a,56,ES20209524514523730381,TRX_N-00400-05893534,2022-11-27T15:42:25,Portugalete,Expense,education,-42.52,-22935.81
buyer_7,Mar√≠a,56,ES20209524514523730381,TRX_N-00401-85741411,2022-11-28T17:33:24,Portugalete,Expense,cash,-100.0,-23035.81
buyer_7,Mar√≠a,56,ES20209524514523730381,TRX_N-00402-79316973,2022-11-29T14:03:50,Portugalete,Expense,food,-114.69,-23150.5
buyer_7,Mar√≠a,56,ES20209524514523730381,TRX_N-00403-30553888,2022-11-29T10:17:40,Portugalete,Expense,leisure,-57.14,-23207.64
buyer_7,Mar√≠a,56,ES20209524514523730381,TRX_N-00404-07149590,2022-12-01T09:55:22,Portugalete,incomes,salary,1364.97,-21842.67
buyer_7,Mar√≠a,56,ES20209524514523730381,TRX_N-00405-99382905,2022-12-01T09:55:22,Portugalete,incomes,salary_partner,1176.83,-20665.84
buyer_7,Mar√≠a,56,ES20209524514523730381,TRX_N-00406-52538228,2022-12-01T09:55:22,Portugalete,incomes,extra_income,134.71,-20531.13
buyer_7,Mar√≠a,56,ES20209524514523730381,TRX_N-00407-20983566,2022-12-01T09:55:22,Portugalete,incomes,salary_bonus,998.29,-19532.84
buyer_7,Mar√≠a,56,ES20209524514523730381,TRX_N-00408-76582130,2022-12-01T09:55:22,Portugalete,incomes,salary_partner_bonus,866.62,-18666.22
buyer_7,Mar√≠a,56,ES20209524514523730381,TRX_N-00409-60303990,2022-12-02T13:15:30,Portugalete,Expense,food,-68.19,-18734.41
buyer_7,Mar√≠a,56,ES20209524514523730381,TRX_N-00410-39184335,2022-12-04T19:49:02,Portugalete,expenses,mortgage,-786.19,-19520.6
buyer_7,Mar√≠a,56,ES20209524514523730381,TRX_N-00411-51411288,2022-12-04T15:43:30,Pasaia,Expense,food,-106.65,-19627.25
buyer_7,Mar√≠a,56,ES20209524514523730381,TRX_N-00412-10432112,2022-12-04T20:06:06,Portugalete,Expense,repairs,-217.72,-19844.97
buyer_7,Mar√≠a,56,ES20209524514523730381,TRX_N-00413-55947671,2022-12-05T12:31:08,Portugalete,Expense,cash,-100.0,-19944.97
buyer_7,Mar√≠a,56,ES20209524514523730381,TRX_N-00414-95133911,2022-12-06T18:00:04,Portugalete,expenses,gas,-33.95,-19978.92
buyer_7,Mar√≠a,56,ES20209524514523730381,TRX_N-00415-54172278,2022-12-07T11:49:15,Portugalete,expenses,water,-35.87,-20014.79
buyer_7,Mar√≠a,56,ES20209524514523730381,TRX_N-00416-37134338,2022-12-07T10:52:44,Portugalete,expenses,internet,-42.0,-20056.79
buyer_7,Mar√≠a,56,ES20209524514523730381,TRX_N-00417-25052348,2022-12-08T05:58:05,Portugalete,expenses,electricity,-38.54,-20095.33
buyer_7,Mar√≠a,56,ES20209524514523730381,TRX_N-00418-02290393,2022-12-08T20:54:50,Portugalete,expenses,phone,-44.59,-20139.92
buyer_7,Mar√≠a,56,ES20209524514523730381,TRX_N-00419-43815379,2022-12-09T22:43:57,Portugalete,Expense,healthcare,-121.54,-20261.46
buyer_7,Mar√≠a,56,ES20209524514523730381,TRX_N-00420-14776000,2022-12-12T10:55:20,Portugalete,Expense,cash,-100.0,-20361.46
buyer_7,Mar√≠a,56,ES20209524514523730381,TRX_N-00421-51267968,2022-12-13T15:26:05,Portugalete,Expense,cash,-100.0,-20461.46
buyer_7,Mar√≠a,56,ES20209524514523730381,TRX_N-00422-15372290,2022-12-16T13:14:40,Portugalete,Expense,repairs,-89.19,-20550.65
buyer_7,Mar√≠a,56,ES20209524514523730381,TRX_N-00423-26926820,2022-12-17T15:24:02,Alegr√≠a-Dulantzi,Expense,cash,-100.0,-20650.65
buyer_7,Mar√≠a,56,ES20209524514523730381,TRX_N-00424-84304512,2022-12-18T03:51:52,Portugalete,Expense,food,-82.04,-20732.69
buyer_7,Mar√≠a,56,ES20209524514523730381,TRX_N-00425-16255413,2022-12-22T06:46:14,Portugalete,Expense,food,-68.25,-20800.94
buyer_7,Mar√≠a,56,ES20209524514523730381,TRX_N-00426-04199179,2022-12-22T12:06:32,Labastida,Expense,leisure,-49.18,-20850.12
buyer_7,Mar√≠a,56,ES20209524514523730381,TRX_N-00427-40206038,2022-12-22T15:03:14,Portugalete,Expense,cash,-100.0,-20950.12
buyer_7,Mar√≠a,56,ES20209524514523730381,TRX_N-00428-95284699,2022-12-23T19:49:55,Portugalete,Expense,clothing,-103.56,-21053.68
buyer_7,Mar√≠a,56,ES20209524514523730381,TRX_N-00429-82435446,2022-12-23T04:21:44,Portugalete,Expense,cash,-100.0,-21153.68
buyer_7,Mar√≠a,56,ES20209524514523730381,TRX_N-00430-79809749,2022-12-24T19:23:13,Portugalete,Expense,repairs,-207.92,-21361.6
buyer_7,Mar√≠a,56,ES20209524514523730381,TRX_N-00431-12791922,2022-12-25T12:55:51,Bilbao,Expense,cash,-100.0,-21461.6
buyer_7,Mar√≠a,56,ES20209524514523730381,TRX_N-00432-32870002,2022-12-27T17:30:40,Portugalete,Expense,education,-53.54,-21515.14
buyer_7,Mar√≠a,56,ES20209524514523730381,TRX_N-00433-67803092,2022-12-27T09:13:35,Portugalete,Expense,cash,-100.0,-21615.14
buyer_7,Mar√≠a,56,ES20209524514523730381,TRX_N-00434-61095104,2022-12-27T16:56:52,Portugalete,Expense,gifts,-58.84,-21673.98
buyer_7,Mar√≠a,56,ES20209524514523730381,TRX_N-00435-10911681,2023-01-01T21:31:26,Portugalete,incomes,salary,1417.21,-20256.77
buyer_7,Mar√≠a,56,ES20209524514523730381,TRX_N-00436-93132839,2023-01-01T21:31:26,Portugalete,incomes,salary_partner,1221.87,-19034.9
buyer_7,Mar√≠a,56,ES20209524514523730381,TRX_N-00437-94990752,2023-01-01T08:55:53,Portugalete,Expense,food,-77.16,-19112.06
buyer_7,Mar√≠a,56,ES20209524514523730381,TRX_N-00438-12112333,2023-01-01T23:34:30,Portugalete,Expense,clothing,-84.85,-19196.91
buyer_7,Mar√≠a,56,ES20209524514523730381,TRX_N-00439-23217355,2023-01-01T00:14:15,Portugalete,Expense,repairs,-124.16,-19321.07
buyer_7,Mar√≠a,56,ES20209524514523730381,TRX_N-00440-15999357,2023-01-02T16:36:36,Portugalete,Expense,education,-64.92,-19385.99
buyer_7,Mar√≠a,56,ES20209524514523730381,TRX_N-00441-88006872,2023-01-03T12:53:25,Portugalete,Expense,gifts,-554.54,-19940.53
buyer_7,Mar√≠a,56,ES20209524514523730381,TRX_N-00442-31344570,2023-01-04T13:48:24,Portugalete,expenses,mortgage,-786.19,-20726.72
buyer_7,Mar√≠a,56,ES20209524514523730381,TRX_N-00443-80736019,2023-01-04T13:25:45,Portugalete,Expense,cash,-100.0,-20826.72
buyer_7,Mar√≠a,56,ES20209524514523730381,TRX_N-00444-74949204,2023-01-05T18:25:34,Portugalete,expenses,internet,-42.0,-20868.72
buyer_7,Mar√≠a,56,ES20209524514523730381,TRX_N-00445-03206325,2023-01-05T20:19:07,Portugalete,expenses,phone,-41.66,-20910.38
buyer_7,Mar√≠a,56,ES20209524514523730381,TRX_N-00446-98609715,2023-01-05T09:05:24,Portugalete,Expense,transport,-77.68,-20988.06
buyer_7,Mar√≠a,56,ES20209524514523730381,TRX_N-00447-12644545,2023-01-05T19:36:20,Portugalete,Expense,leisure,-50.24,-21038.3
buyer_7,Mar√≠a,56,ES20209524514523730381,TRX_N-00448-85170783,2023-01-06T17:29:12,Portugalete,expenses,electricity,-59.94,-21098.24
buyer_7,Mar√≠a,56,ES20209524514523730381,TRX_N-00449-49330193,2023-01-06T14:29:08,Portugalete,Expense,leisure,-34.45,-21132.69
buyer_7,Mar√≠a,56,ES20209524514523730381,TRX_N-00450-77243755,2023-01-07T17:48:23,Portugalete,Expense,clothing,-64.73,-21197.42
buyer_7,Mar√≠a,56,ES20209524514523730381,TRX_N-00451-39651060,2023-01-08T20:35:50,Portugalete,expenses,water,-29.65,-21227.07
buyer_7,Mar√≠a,56,ES20209524514523730381,TRX_N-00452-23527086,2023-01-08T13:35:21,Portugalete,expenses,gas,-49.37,-21276.44
buyer_7,Mar√≠a,56,ES20209524514523730381,TRX_N-00453-82309141,2023-01-08T01:00:04,Portugalete,Expense,leisure,-33.31,-21309.75
buyer_7,Mar√≠a,56,ES20209524514523730381,TRX_N-00454-18260400,2023-01-09T14:43:26,Santurtzi,Expense,clothing,-82.1,-21391.85
buyer_7,Mar√≠a,56,ES20209524514523730381,TRX_N-00455-01134007,2023-01-09T12:22:37,Santurtzi,Expense,cash,-100.0,-21491.85
buyer_7,Mar√≠a,56,ES20209524514523730381,TRX_N-00456-87572978,2023-01-10T14:44:52,Portugalete,Expense,gifts,-208.4,-21700.25
buyer_7,Mar√≠a,56,ES20209524514523730381,TRX_N-00457-70027279,2023-01-10T16:50:29,Portugalete,expenses,children,-232.65,-21932.9
buyer_7,Mar√≠a,56,ES20209524514523730381,TRX_N-00458-08121920,2023-01-15T20:20:06,Portugalete,Expense,cash,-100.0,-22032.9
buyer_7,Mar√≠a,56,ES20209524514523730381,TRX_N-00459-20389813,2023-01-15T14:58:37,Irun,Expense,gifts,-477.71,-22510.61
buyer_7,Mar√≠a,56,ES20209524514523730381,TRX_N-00460-91831322,2023-01-16T23:22:51,Barakaldo,Expense,transport,-77.77,-22588.38
buyer_7,Mar√≠a,56,ES20209524514523730381,TRX_N-00461-62238187,2023-01-17T13:43:45,Portugalete,Expense,gifts,-406.53,-22994.91
buyer_7,Mar√≠a,56,ES20209524514523730381,TRX_N-00462-59407750,2023-01-18T09:40:39,Portugalete,Expense,cash,-100.0,-23094.91
buyer_7,Mar√≠a,56,ES20209524514523730381,TRX_N-00463-62793708,2023-01-18T14:18:51,Donostia,Expense,repairs,-135.58,-23230.49
buyer_7,Mar√≠a,56,ES20209524514523730381,TRX_N-00464-82687848,2023-01-19T14:48:06,Portugalete,Expense,food,-79.29,-23309.78
buyer_7,Mar√≠a,56,ES20209524514523730381,TRX_N-00465-96353995,2023-01-20T12:24:18,Portugalete,Expense,transport,-82.34,-23392.12
buyer_7,Mar√≠a,56,ES20209524514523730381,TRX_N-00466-97511276,2023-01-20T21:06:55,Portugalete,Expense,cash,-100.0,-23492.12
buyer_7,Mar√≠a,56,ES20209524514523730381,TRX_N-00467-79634937,2023-01-20T11:03:59,Portugalete,expenses,children,-60.15,-23552.27
buyer_7,Mar√≠a,56,ES20209524514523730381,TRX_N-00468-16305179,2023-01-22T15:40:17,Portugalete,Expense,transport,-52.08,-23604.35
buyer_7,Mar√≠a,56,ES20209524514523730381,TRX_N-00469-71445234,2023-01-23T10:27:32,Portugalete,Expense,leisure,-70.07,-23674.42
buyer_7,Mar√≠a,56,ES20209524514523730381,TRX_N-00470-53059649,2023-01-23T19:27:56,Pasaia,Expense,travel,-1148.96,-24823.38
buyer_7,Mar√≠a,56,ES20209524514523730381,TRX_N-00471-11546390,2023-01-24T23:24:48,Portugalete,Expense,transport,-58.69,-24882.07
buyer_7,Mar√≠a,56,ES20209524514523730381,TRX_N-00472-49441924,2023-01-24T12:45:12,Portugalete,Expense,leisure,-59.21,-24941.28
buyer_7,Mar√≠a,56,ES20209524514523730381,TRX_N-00473-48980455,2023-01-25T15:20:30,Portugalete,Expense,food,-97.43,-25038.71
buyer_7,Mar√≠a,56,ES20209524514523730381,TRX_N-00474-32554495,2023-01-28T09:30:52,Portugalete,Expense,education,-62.09,-25100.8
buyer_7,Mar√≠a,56,ES20209524514523730381,TRX_N-00475-97535863,2023-01-28T12:24:33,Eibar,Expense,cash,-100.0,-25200.8
buyer_7,Mar√≠a,56,ES20209524514523730381,TRX_N-00476-02288582,2023-01-29T10:38:12,Portugalete,Expense,healthcare,-137.33,-25338.13
buyer_7,Mar√≠a,56,ES20209524514523730381,TRX_N-00477-60027882,2023-01-30T03:00:39,Portugalete,Expense,food,-70.25,-25408.38
buyer_7,Mar√≠a,56,ES20209524514523730381,TRX_N-00478-64163507,2023-01-30T11:51:27,Portugalete,Expense,cash,-100.0,-25508.38
buyer_7,Mar√≠a,56,ES20209524514523730381,TRX_N-00479-24461870,2023-01-31T08:10:38,Arrasate,Expense,appliances,-78.92,-25587.3
buyer_7,Mar√≠a,56,ES20209524514523730381,TRX_N-00480-91655194,2023-02-01T21:00:18,Portugalete,incomes,salary,1417.21,-24170.09
buyer_7,Mar√≠a,56,ES20209524514523730381,TRX_N-00481-59835282,2023-02-01T21:00:18,Portugalete,incomes,salary_partner,1221.87,-22948.22
buyer_7,Mar√≠a,56,ES20209524514523730381,TRX_N-00482-57872271,2023-02-03T09:45:19,Portugalete,Expense,transport,-57.72,-23005.94
buyer_7,Mar√≠a,56,ES20209524514523730381,TRX_N-00483-12308316,2023-02-04T20:15:43,Portugalete,expenses,mortgage,-786.19,-23792.13
buyer_7,Mar√≠a,56,ES20209524514523730381,TRX_N-00484-25921850,2023-02-04T13:14:09,Portugalete,Expense,repairs,-30.26,-23822.39
buyer_7,Mar√≠a,56,ES20209524514523730381,TRX_N-00485-72892949,2023-02-05T19:41:21,Portugalete,expenses,internet,-42.0,-23864.39
buyer_7,Mar√≠a,56,ES20209524514523730381,TRX_N-00486-50234260,2023-02-05T09:31:28,Portugalete,Expense,clothing,-92.35,-23956.74
buyer_7,Mar√≠a,56,ES20209524514523730381,TRX_N-00487-57909505,2023-02-06T12:01:09,Portugalete,Expense,repairs,-323.18,-24279.92
buyer_7,Mar√≠a,56,ES20209524514523730381,TRX_N-00488-04719902,2023-02-07T18:41:23,Portugalete,expenses,phone,-40.52,-24320.44
buyer_7,Mar√≠a,56,ES20209524514523730381,TRX_N-00489-16308297,2023-02-07T18:24:57,Portugalete,Expense,leisure,-48.86,-24369.3
buyer_7,Mar√≠a,56,ES20209524514523730381,TRX_N-00490-28597141,2023-02-08T16:08:17,Portugalete,expenses,water,-45.0,-24414.3
buyer_7,Mar√≠a,56,ES20209524514523730381,TRX_N-00491-00915398,2023-02-08T00:44:06,Portugalete,expenses,electricity,-60.28,-24474.58
buyer_7,Mar√≠a,56,ES20209524514523730381,TRX_N-00492-12982007,2023-02-08T11:30:58,Portugalete,expenses,gas,-30.1,-24504.68
buyer_7,Mar√≠a,56,ES20209524514523730381,TRX_N-00493-57834470,2023-02-09T16:36:39,Salvatierra/Agurain,Expense,clothing,-137.59,-24642.27
buyer_7,Mar√≠a,56,ES20209524514523730381,TRX_N-00494-87035416,2023-02-10T16:18:18,Portugalete,Expense,food,-101.7,-24743.97
buyer_7,Mar√≠a,56,ES20209524514523730381,TRX_N-00495-61246514,2023-02-11T12:33:37,Portugalete,Expense,leisure,-28.72,-24772.69
buyer_7,Mar√≠a,56,ES20209524514523730381,TRX_N-00496-84261752,2023-02-14T20:38:53,Portugalete,Expense,healthcare,-156.2,-24928.89
buyer_7,Mar√≠a,56,ES20209524514523730381,TRX_N-00497-25453693,2023-02-14T15:36:18,Portugalete,Expense,cash,-100.0,-25028.89
buyer_7,Mar√≠a,56,ES20209524514523730381,TRX_N-00498-76738735,2023-02-16T10:53:25,Salvatierra/Agurain,Expense,clothing,-122.92,-25151.81
buyer_7,Mar√≠a,56,ES20209524514523730381,TRX_N-00499-74905163,2023-02-17T17:27:58,Portugalete,Expense,food,-81.4,-25233.21
buyer_7,Mar√≠a,56,ES20209524514523730381,TRX_N-00500-96139642,2023-02-18T16:23:23,Portugalete,Expense,leisure,-63.26,-25296.47
buyer_7,Mar√≠a,56,ES20209524514523730381,TRX_N-00501-55187688,2023-02-18T18:06:09,Portugalete,Expense,repairs,-50.12,-25346.59
buyer_7,Mar√≠a,56,ES20209524514523730381,TRX_N-00502-35788719,2023-02-19T12:34:36,Barakaldo,Expense,food,-61.87,-25408.46
buyer_7,Mar√≠a,56,ES20209524514523730381,TRX_N-00503-71504761,2023-02-19T11:13:42,Portugalete,Expense,education,-59.47,-25467.93
buyer_7,Mar√≠a,56,ES20209524514523730381,TRX_N-00504-10413581,2023-02-21T23:46:37,Portugalete,Expense,leisure,-22.48,-25490.41
buyer_7,Mar√≠a,56,ES20209524514523730381,TRX_N-00505-12349256,2023-02-21T11:12:19,Portugalete,Expense,clothing,-121.81,-25612.22
buyer_7,Mar√≠a,56,ES20209524514523730381,TRX_N-00506-84220267,2023-02-23T17:55:17,Alegr√≠a-Dulantzi,Expense,food,-90.37,-25702.59
buyer_7,Mar√≠a,56,ES20209524514523730381,TRX_N-00507-34979350,2023-02-24T09:28:42,Iru√±a de Oca,Expense,leisure,-28.76,-25731.35
buyer_7,Mar√≠a,56,ES20209524514523730381,TRX_N-00508-58199668,2023-02-24T19:55:35,Portugalete,Expense,cash,-100.0,-25831.35
buyer_7,Mar√≠a,56,ES20209524514523730381,TRX_N-00509-78952227,2023-02-26T08:06:53,Berango,Expense,food,-96.79,-25928.14
buyer_7,Mar√≠a,56,ES20209524514523730381,TRX_N-00510-35338856,2023-02-26T09:53:44,Portugalete,Expense,healthcare,-187.44,-26115.58
buyer_7,Mar√≠a,56,ES20209524514523730381,TRX_N-00511-28616577,2023-02-27T19:53:11,Portugalete,Expense,leisure,-33.12,-26148.7
buyer_7,Mar√≠a,56,ES20209524514523730381,TRX_N-00512-87863186,2023-02-28T11:02:00,Portugalete,Expense,leisure,-43.79,-26192.49
buyer_7,Mar√≠a,56,ES20209524514523730381,TRX_N-00513-18279936,2023-03-01T09:29:22,Portugalete,incomes,salary,1417.21,-24775.28
buyer_7,Mar√≠a,56,ES20209524514523730381,TRX_N-00514-34756505,2023-03-01T09:29:22,Portugalete,incomes,salary_partner,1221.87,-23553.41
buyer_7,Mar√≠a,56,ES20209524514523730381,TRX_N-00515-82058501,2023-03-01T09:29:22,Portugalete,incomes,extra_income,134.71,-23418.7
buyer_7,Mar√≠a,56,ES20209524514523730381,TRX_N-00516-66754715,2023-03-01T19:56:39,Portugalete,Expense,clothing,-159.09,-23577.79
buyer_7,Mar√≠a,56,ES20209524514523730381,TRX_N-00517-97986638,2023-03-01T20:57:25,Salvatierra/Agurain,Expense,cash,-100.0,-23677.79
buyer_7,Mar√≠a,56,ES20209524514523730381,TRX_N-00518-78001816,2023-03-02T09:53:45,Portugalete,Expense,leisure,-60.41,-23738.2
buyer_7,Mar√≠a,56,ES20209524514523730381,TRX_N-00519-10043945,2023-03-04T19:11:51,Portugalete,expenses,mortgage,-786.19,-24524.39
buyer_7,Mar√≠a,56,ES20209524514523730381,TRX_N-00520-51997519,2023-03-04T11:20:59,Portugalete,Expense,leisure,-57.48,-24581.87
buyer_7,Mar√≠a,56,ES20209524514523730381,TRX_N-00521-42705106,2023-03-05T11:20:41,Portugalete,expenses,water,-26.92,-24608.79
buyer_7,Mar√≠a,56,ES20209524514523730381,TRX_N-00522-74971218,2023-03-05T06:02:12,Portugalete,Expense,leisure,-61.41,-24670.2
buyer_7,Mar√≠a,56,ES20209524514523730381,TRX_N-00523-40793520,2023-03-05T14:09:09,Portugalete,Expense,cash,-100.0,-24770.2
buyer_7,Mar√≠a,56,ES20209524514523730381,TRX_N-00524-20151747,2023-03-06T01:13:46,Portugalete,expenses,gas,-63.04,-24833.24
buyer_7,Mar√≠a,56,ES20209524514523730381,TRX_N-00525-37798590,2023-03-06T08:45:35,Portugalete,expenses,internet,-42.0,-24875.24
buyer_7,Mar√≠a,56,ES20209524514523730381,TRX_N-00526-25546543,2023-03-06T17:01:39,Errenteria,Expense,education,-64.34,-24939.58
buyer_7,Mar√≠a,56,ES20209524514523730381,TRX_N-00527-57124653,2023-03-07T08:05:05,Portugalete,expenses,phone,-37.96,-24977.54
buyer_7,Mar√≠a,56,ES20209524514523730381,TRX_N-00528-22210637,2023-03-07T08:01:49,Portugalete,Expense,leisure,-40.38,-25017.92
buyer_7,Mar√≠a,56,ES20209524514523730381,TRX_N-00529-47587597,2023-03-08T22:41:26,Portugalete,expenses,electricity,-88.39,-25106.31
buyer_7,Mar√≠a,56,ES20209524514523730381,TRX_N-00530-37317688,2023-03-13T18:29:40,Portugalete,Expense,leisure,-71.85,-25178.16
buyer_7,Mar√≠a,56,ES20209524514523730381,TRX_N-00531-94788449,2023-03-13T13:19:01,Portugalete,Expense,clothing,-143.81,-25321.97
buyer_7,Mar√≠a,56,ES20209524514523730381,TRX_N-00532-97271814,2023-03-14T04:06:28,Portugalete,Expense,appliances,-384.8,-25706.77
buyer_7,Mar√≠a,56,ES20209524514523730381,TRX_N-00533-41880508,2023-03-16T12:58:29,Portugalete,Expense,leisure,-74.61,-25781.38
buyer_7,Mar√≠a,56,ES20209524514523730381,TRX_N-00534-25828531,2023-03-17T09:07:38,Portugalete,Expense,cash,-100.0,-25881.38
buyer_7,Mar√≠a,56,ES20209524514523730381,TRX_N-00535-50565718,2023-03-19T11:21:50,Portugalete,Expense,travel,-819.07,-26700.45
buyer_7,Mar√≠a,56,ES20209524514523730381,TRX_N-00536-32428096,2023-03-19T16:26:13,Donostia,Expense,repairs,-320.16,-27020.61
buyer_7,Mar√≠a,56,ES20209524514523730381,TRX_N-00537-60875405,2023-03-20T20:43:00,Portugalete,Expense,repairs,-163.03,-27183.64
buyer_7,Mar√≠a,56,ES20209524514523730381,TRX_N-00538-02917592,2023-03-21T11:20:23,Portugalete,expenses,children,-62.32,-27245.96
buyer_7,Mar√≠a,56,ES20209524514523730381,TRX_N-00539-80879884,2023-03-22T17:27:47,Portugalete,Expense,leisure,-22.3,-27268.26
buyer_7,Mar√≠a,56,ES20209524514523730381,TRX_N-00540-01678813,2023-03-27T10:07:57,Portugalete,Expense,leisure,-51.18,-27319.44
buyer_7,Mar√≠a,56,ES20209524514523730381,TRX_N-00541-04671991,2023-03-30T08:21:49,Portugalete,Expense,food,-100.94,-27420.38
buyer_7,Mar√≠a,56,ES20209524514523730381,TRX_N-00542-91950898,2023-03-30T22:03:41,Hondarribia,Expense,cash,-100.0,-27520.38
buyer_7,Mar√≠a,56,ES20209524514523730381,TRX_N-00543-19251497,2023-04-01T14:08:29,Portugalete,incomes,salary,1417.21,-26103.17
buyer_7,Mar√≠a,56,ES20209524514523730381,TRX_N-00544-21187831,2023-04-01T14:08:29,Portugalete,incomes,salary_partner,1221.87,-24881.3
buyer_7,Mar√≠a,56,ES20209524514523730381,TRX_N-00545-14415438,2023-04-01T11:02:15,Portugalete,Expense,leisure,-25.52,-24906.82
buyer_7,Mar√≠a,56,ES20209524514523730381,TRX_N-00546-63273093,2023-04-03T10:00:11,Salvatierra/Agurain,Expense,transport,-66.49,-24973.31
buyer_7,Mar√≠a,56,ES20209524514523730381,TRX_N-00547-61002744,2023-04-04T00:34:08,Portugalete,expenses,mortgage,-786.19,-25759.5
buyer_7,Mar√≠a,56,ES20209524514523730381,TRX_N-00548-34192957,2023-04-04T19:17:20,Portugalete,Expense,food,-123.78,-25883.28
buyer_7,Mar√≠a,56,ES20209524514523730381,TRX_N-00549-45496324,2023-04-04T13:16:28,Portugalete,Expense,leisure,-48.11,-25931.39
buyer_7,Mar√≠a,56,ES20209524514523730381,TRX_N-00550-79014891,2023-04-04T14:34:08,Portugalete,Expense,appliances,-219.64,-26151.03
buyer_7,Mar√≠a,56,ES20209524514523730381,TRX_N-00551-71598906,2023-04-04T13:22:36,Portugalete,Expense,repairs,-290.54,-26441.57
buyer_7,Mar√≠a,56,ES20209524514523730381,TRX_N-00552-23766061,2023-04-05T17:47:45,Portugalete,expenses,electricity,-36.93,-26478.5
buyer_7,Mar√≠a,56,ES20209524514523730381,TRX_N-00553-71545859,2023-04-05T12:19:54,Portugalete,expenses,internet,-42.0,-26520.5
buyer_7,Mar√≠a,56,ES20209524514523730381,TRX_N-00554-48356746,2023-04-05T22:48:54,Portugalete,Expense,transport,-79.15,-26599.65
buyer_7,Mar√≠a,56,ES20209524514523730381,TRX_N-00555-62483323,2023-04-05T14:01:42,Portugalete,Expense,leisure,-44.0,-26643.65
buyer_7,Mar√≠a,56,ES20209524514523730381,TRX_N-00556-36193636,2023-04-06T15:45:09,Portugalete,expenses,phone,-36.07,-26679.72
buyer_7,Mar√≠a,56,ES20209524514523730381,TRX_N-00557-21632743,2023-04-06T20:02:34,Portugalete,Expense,cash,-100.0,-26779.72
buyer_7,Mar√≠a,56,ES20209524514523730381,TRX_N-00558-37691646,2023-04-07T05:19:31,Portugalete,expenses,water,-44.03,-26823.75
buyer_7,Mar√≠a,56,ES20209524514523730381,TRX_N-00559-97135800,2023-04-08T18:10:57,Portugalete,expenses,gas,-43.71,-26867.46
buyer_7,Mar√≠a,56,ES20209524514523730381,TRX_N-00560-74857566,2023-04-08T09:44:24,Portugalete,Expense,food,-112.89,-26980.35
buyer_7,Mar√≠a,56,ES20209524514523730381,TRX_N-00561-11170302,2023-04-08T22:08:41,Portugalete,Expense,transport,-67.17,-27047.52
buyer_7,Mar√≠a,56,ES20209524514523730381,TRX_N-00562-22500423,2023-04-09T17:56:34,Portugalete,Expense,cash,-100.0,-27147.52
buyer_7,Mar√≠a,56,ES20209524514523730381,TRX_N-00563-87944593,2023-04-10T19:55:07,Zarautz,Expense,education,-73.18,-27220.7
buyer_7,Mar√≠a,56,ES20209524514523730381,TRX_N-00564-63887318,2023-04-10T13:38:12,Portugalete,Expense,gifts,-117.55,-27338.25
buyer_7,Mar√≠a,56,ES20209524514523730381,TRX_N-00565-85759220,2023-04-15T08:24:53,Portugalete,Expense,clothing,-154.28,-27492.53
buyer_7,Mar√≠a,56,ES20209524514523730381,TRX_N-00566-05085784,2023-04-15T13:41:39,Portugalete,expenses,children,-209.91,-27702.44
buyer_7,Mar√≠a,56,ES20209524514523730381,TRX_N-00567-40366213,2023-04-16T10:32:30,Pasaia,Expense,transport,-85.12,-27787.56
buyer_7,Mar√≠a,56,ES20209524514523730381,TRX_N-00568-06240191,2023-04-18T09:21:57,Labastida,Expense,food,-81.66,-27869.22
buyer_7,Mar√≠a,56,ES20209524514523730381,TRX_N-00569-33282721,2023-04-18T09:25:44,Portugalete,Expense,cash,-100.0,-27969.22
buyer_7,Mar√≠a,56,ES20209524514523730381,TRX_N-00570-22144205,2023-04-19T06:28:03,Portugalete,Expense,food,-95.28,-28064.5
buyer_7,Mar√≠a,56,ES20209524514523730381,TRX_N-00571-91134221,2023-04-20T14:11:39,Portugalete,Expense,healthcare,-67.04,-28131.54
buyer_7,Mar√≠a,56,ES20209524514523730381,TRX_N-00572-64812839,2023-04-20T09:54:34,Portugalete,expenses,children,-225.08,-28356.62
buyer_7,Mar√≠a,56,ES20209524514523730381,TRX_N-00573-00224779,2023-04-21T20:32:41,Erandio,Expense,cash,-100.0,-28456.62
buyer_7,Mar√≠a,56,ES20209524514523730381,TRX_N-00574-27258307,2023-04-22T11:18:55,Portugalete,Expense,leisure,-46.85,-28503.47
buyer_7,Mar√≠a,56,ES20209524514523730381,TRX_N-00575-34517216,2023-04-24T18:51:09,Portugalete,Expense,education,-44.69,-28548.16
buyer_7,Mar√≠a,56,ES20209524514523730381,TRX_N-00576-69614473,2023-04-26T15:57:03,Portugalete,Expense,food,-99.04,-28647.2
buyer_7,Mar√≠a,56,ES20209524514523730381,TRX_N-00577-27798459,2023-04-26T11:54:56,Durango,Expense,cash,-100.0,-28747.2
buyer_7,Mar√≠a,56,ES20209524514523730381,TRX_N-00578-72060428,2023-04-27T18:56:39,Portugalete,Expense,leisure,-60.99,-28808.19
buyer_7,Mar√≠a,56,ES20209524514523730381,TRX_N-00579-59175515,2023-04-29T09:15:47,Portugalete,Expense,clothing,-99.8,-28907.99
buyer_7,Mar√≠a,56,ES20209524514523730381,TRX_N-00580-95795246,2023-04-29T20:00:17,Bermeo,Expense,education,-78.87,-28986.86
buyer_7,Mar√≠a,56,ES20209524514523730381,TRX_N-00581-68176756,2023-05-01T11:24:05,Portugalete,incomes,salary,1417.21,-27569.65
buyer_7,Mar√≠a,56,ES20209524514523730381,TRX_N-00582-50987728,2023-05-01T11:24:05,Portugalete,incomes,salary_partner,1221.87,-26347.78
buyer_7,Mar√≠a,56,ES20209524514523730381,TRX_N-00583-48896301,2023-05-01T13:17:15,Basauri,Expense,transport,-79.05,-26426.83
buyer_7,Mar√≠a,56,ES20209524514523730381,TRX_N-00584-11816517,2023-05-01T13:01:47,Portugalete,Expense,cash,-100.0,-26526.83
buyer_7,Mar√≠a,56,ES20209524514523730381,TRX_N-00585-30438889,2023-05-02T19:35:35,Portugalete,Expense,cash,-100.0,-26626.83
buyer_7,Mar√≠a,56,ES20209524514523730381,TRX_N-00586-29739537,2023-05-04T19:06:56,Portugalete,expenses,mortgage,-786.19,-27413.02
buyer_7,Mar√≠a,56,ES20209524514523730381,TRX_N-00587-62125490,2023-05-04T20:46:07,Portugalete,Expense,food,-75.1,-27488.12
buyer_7,Mar√≠a,56,ES20209524514523730381,TRX_N-00588-86258216,2023-05-05T11:39:07,Portugalete,expenses,electricity,-43.61,-27531.73
buyer_7,Mar√≠a,56,ES20209524514523730381,TRX_N-00589-83581596,2023-05-05T08:27:42,Portugalete,expenses,gas,-77.89,-27609.62
buyer_7,Mar√≠a,56,ES20209524514523730381,TRX_N-00590-88258566,2023-05-05T22:10:44,Santurtzi,Expense,healthcare,-177.37,-27786.99
buyer_7,Mar√≠a,56,ES20209524514523730381,TRX_N-00591-34120783,2023-05-06T16:43:38,Portugalete,Expense,clothing,-120.39,-27907.38
buyer_7,Mar√≠a,56,ES20209524514523730381,TRX_N-00592-45620960,2023-05-06T13:03:09,Elciego,Expense,gifts,-802.94,-28710.32
buyer_7,Mar√≠a,56,ES20209524514523730381,TRX_N-00593-52442540,2023-05-08T18:59:59,Portugalete,expenses,water,-39.24,-28749.56
buyer_7,Mar√≠a,56,ES20209524514523730381,TRX_N-00594-95644718,2023-05-08T17:32:16,Portugalete,expenses,internet,-42.0,-28791.56
buyer_7,Mar√≠a,56,ES20209524514523730381,TRX_N-00595-53645267,2023-05-08T14:57:41,Portugalete,expenses,phone,-33.74,-28825.3
buyer_7,Mar√≠a,56,ES20209524514523730381,TRX_N-00596-38119966,2023-05-09T17:16:23,Portugalete,Expense,cash,-100.0,-28925.3
buyer_7,Mar√≠a,56,ES20209524514523730381,TRX_N-00597-31943409,2023-05-11T08:21:44,Portugalete,Expense,transport,-53.32,-28978.62
buyer_7,Mar√≠a,56,ES20209524514523730381,TRX_N-00598-24387879,2023-05-11T02:03:04,Portugalete,Expense,leisure,-71.41,-29050.03
buyer_7,Mar√≠a,56,ES20209524514523730381,TRX_N-00599-15322356,2023-05-12T18:09:16,Portugalete,Expense,repairs,-171.19,-29221.22
buyer_7,Mar√≠a,56,ES20209524514523730381,TRX_N-00600-10160652,2023-05-13T10:18:36,Portugalete,Expense,gifts,-506.81,-29728.03
buyer_7,Mar√≠a,56,ES20209524514523730381,TRX_N-00601-30172193,2023-05-17T13:40:36,Mungia,Expense,food,-61.1,-29789.13
buyer_7,Mar√≠a,56,ES20209524514523730381,TRX_N-00602-12602352,2023-05-17T10:17:52,Portugalete,Expense,cash,-100.0,-29889.13
buyer_7,Mar√≠a,56,ES20209524514523730381,TRX_N-00603-89537118,2023-05-18T15:52:08,Portugalete,Expense,food,-111.78,-30000.91
buyer_7,Mar√≠a,56,ES20209524514523730381,TRX_N-00604-31185331,2023-05-19T08:13:38,Portugalete,Expense,clothing,-150.41,-30151.32
buyer_7,Mar√≠a,56,ES20209524514523730381,TRX_N-00605-89184689,2023-05-22T11:19:07,Portugalete,expenses,children,-253.93,-30405.25
buyer_7,Mar√≠a,56,ES20209524514523730381,TRX_N-00606-71449688,2023-05-23T11:20:46,Portugalete,Expense,food,-119.3,-30524.55
buyer_7,Mar√≠a,56,ES20209524514523730381,TRX_N-00607-54202526,2023-05-25T18:58:23,Portugalete,Expense,food,-124.72,-30649.27
buyer_7,Mar√≠a,56,ES20209524514523730381,TRX_N-00608-28784372,2023-05-26T10:01:17,Eibar,Expense,gifts,-548.83,-31198.1
buyer_7,Mar√≠a,56,ES20209524514523730381,TRX_N-00609-22824075,2023-05-28T16:32:44,Portugalete,Expense,cash,-100.0,-31298.1
buyer_7,Mar√≠a,56,ES20209524514523730381,TRX_N-00610-88122167,2023-05-30T10:06:29,Errenteria,Expense,food,-78.12,-31376.22
buyer_7,Mar√≠a,56,ES20209524514523730381,TRX_N-00611-45286561,2023-05-30T03:17:40,Portugalete,Expense,leisure,-54.64,-31430.86
buyer_7,Mar√≠a,56,ES20209524514523730381,TRX_N-00612-62027079,2023-05-31T08:56:11,Hernani,Expense,transport,-75.26,-31506.12
buyer_7,Mar√≠a,56,ES20209524514523730381,TRX_N-00613-80956772,2023-06-01T09:26:31,Portugalete,incomes,salary,1417.21,-30088.91
buyer_7,Mar√≠a,56,ES20209524514523730381,TRX_N-00614-46146550,2023-06-01T09:26:31,Portugalete,incomes,salary_partner,1221.87,-28867.04
buyer_7,Mar√≠a,56,ES20209524514523730381,TRX_N-00615-65920578,2023-06-01T09:26:31,Portugalete,incomes,extra_income,134.71,-28732.33
buyer_7,Mar√≠a,56,ES20209524514523730381,TRX_N-00616-76290119,2023-06-01T09:26:31,Portugalete,incomes,salary_bonus,1037.16,-27695.17
buyer_7,Mar√≠a,56,ES20209524514523730381,TRX_N-00617-58049918,2023-06-01T09:26:31,Portugalete,incomes,salary_partner_bonus,936.18,-26758.99
buyer_7,Mar√≠a,56,ES20209524514523730381,TRX_N-00618-23014740,2023-06-02T16:03:35,Portugalete,Expense,gifts,-260.95,-27019.94
buyer_7,Mar√≠a,56,ES20209524514523730381,TRX_N-00619-54538026,2023-06-03T20:48:24,Portugalete,Expense,repairs,-208.46,-27228.4
buyer_7,Mar√≠a,56,ES20209524514523730381,TRX_N-00620-98994293,2023-06-04T19:03:14,Portugalete,expenses,mortgage,-786.19,-28014.59
buyer_7,Mar√≠a,56,ES20209524514523730381,TRX_N-00621-34350961,2023-06-04T18:08:48,Portugalete,Expense,food,-93.74,-28108.33
buyer_7,Mar√≠a,56,ES20209524514523730381,TRX_N-00622-19552286,2023-06-04T13:49:30,Portugalete,Expense,leisure,-40.95,-28149.28
buyer_7,Mar√≠a,56,ES20209524514523730381,TRX_N-00623-17378751,2023-06-04T15:23:50,Portugalete,Expense,healthcare,-80.32,-28229.6
buyer_7,Mar√≠a,56,ES20209524514523730381,TRX_N-00624-62345389,2023-06-05T03:31:07,Portugalete,expenses,water,-33.31,-28262.91
buyer_7,Mar√≠a,56,ES20209524514523730381,TRX_N-00625-83882159,2023-06-05T08:13:19,Portugalete,expenses,electricity,-73.14,-28336.05
buyer_7,Mar√≠a,56,ES20209524514523730381,TRX_N-00626-48806234,2023-06-05T09:01:33,Portugalete,expenses,internet,-42.0,-28378.05
buyer_7,Mar√≠a,56,ES20209524514523730381,TRX_N-00627-12094986,2023-06-06T19:00:12,Portugalete,Expense,clothing,-123.64,-28501.69
buyer_7,Mar√≠a,56,ES20209524514523730381,TRX_N-00628-61970274,2023-06-06T17:46:19,Salvatierra/Agurain,Expense,cash,-100.0,-28601.69
buyer_7,Mar√≠a,56,ES20209524514523730381,TRX_N-00629-00405678,2023-06-07T12:39:09,Portugalete,expenses,gas,-113.56,-28715.25
buyer_7,Mar√≠a,56,ES20209524514523730381,TRX_N-00630-87566255,2023-06-08T20:19:25,Portugalete,expenses,phone,-31.88,-28747.13
buyer_7,Mar√≠a,56,ES20209524514523730381,TRX_N-00631-75267760,2023-06-08T08:47:07,Portugalete,Expense,food,-80.35,-28827.48
buyer_7,Mar√≠a,56,ES20209524514523730381,TRX_N-00632-16978755,2023-06-11T01:28:14,Portugalete,Expense,food,-61.31,-28888.79
buyer_7,Mar√≠a,56,ES20209524514523730381,TRX_N-00633-38585481,2023-06-11T00:22:56,Portugalete,Expense,transport,-87.9,-28976.69
buyer_7,Mar√≠a,56,ES20209524514523730381,TRX_N-00634-55744881,2023-06-11T14:32:17,Portugalete,Expense,cash,-100.0,-29076.69
buyer_7,Mar√≠a,56,ES20209524514523730381,TRX_N-00635-19851390,2023-06-12T13:39:08,Portugalete,Expense,food,-62.32,-29139.01
buyer_7,Mar√≠a,56,ES20209524514523730381,TRX_N-00636-72861719,2023-06-13T20:00:35,Portugalete,Expense,appliances,-364.1,-29503.11
buyer_7,Mar√≠a,56,ES20209524514523730381,TRX_N-00637-29143191,2023-06-14T13:20:04,Portugalete,Expense,food,-113.64,-29616.75
buyer_7,Mar√≠a,56,ES20209524514523730381,TRX_N-00638-75303137,2023-06-14T18:51:30,Portugalete,Expense,leisure,-75.06,-29691.81
buyer_7,Mar√≠a,56,ES20209524514523730381,TRX_N-00639-27480410,2023-06-14T22:14:27,Portugalete,Expense,clothing,-119.3,-29811.11
buyer_7,Mar√≠a,56,ES20209524514523730381,TRX_N-00640-21066487,2023-06-14T18:24:44,Hondarribia,Expense,repairs,-61.11,-29872.22
buyer_7,Mar√≠a,56,ES20209524514523730381,TRX_N-00641-14613595,2023-06-15T09:27:07,Iru√±a de Oca,Expense,leisure,-29.73,-29901.95
buyer_7,Mar√≠a,56,ES20209524514523730381,TRX_N-00642-38667911,2023-06-15T18:22:43,Portugalete,Expense,repairs,-56.41,-29958.36
buyer_7,Mar√≠a,56,ES20209524514523730381,TRX_N-00643-82876022,2023-06-17T01:52:37,Portugalete,Expense,leisure,-58.28,-30016.64
buyer_7,Mar√≠a,56,ES20209524514523730381,TRX_N-00644-46493534,2023-06-17T17:55:46,Santurtzi,Expense,healthcare,-67.16,-30083.8
buyer_7,Mar√≠a,56,ES20209524514523730381,TRX_N-00645-15581812,2023-06-17T20:29:10,Sopela,Expense,cash,-100.0,-30183.8
buyer_7,Mar√≠a,56,ES20209524514523730381,TRX_N-00646-82997532,2023-06-20T13:20:48,Vitoria-Gasteiz,Expense,food,-73.96,-30257.76
buyer_7,Mar√≠a,56,ES20209524514523730381,TRX_N-00647-70101330,2023-06-20T11:05:16,Portugalete,Expense,transport,-62.39,-30320.15
buyer_7,Mar√≠a,56,ES20209524514523730381,TRX_N-00648-76503457,2023-06-21T15:45:07,Portugalete,Expense,leisure,-43.77,-30363.92
buyer_7,Mar√≠a,56,ES20209524514523730381,TRX_N-00649-33516197,2023-06-21T17:09:26,Portugalete,Expense,clothing,-65.26,-30429.18
buyer_7,Mar√≠a,56,ES20209524514523730381,TRX_N-00650-69894018,2023-06-23T15:49:05,Portugalete,Expense,food,-66.46,-30495.64
buyer_7,Mar√≠a,56,ES20209524514523730381,TRX_N-00651-28974489,2023-06-23T15:53:48,Portugalete,Expense,transport,-81.01,-30576.65
buyer_7,Mar√≠a,56,ES20209524514523730381,TRX_N-00652-04938157,2023-06-24T18:50:46,Portugalete,Expense,cash,-100.0,-30676.65
buyer_7,Mar√≠a,56,ES20209524514523730381,TRX_N-00653-55484389,2023-06-24T16:34:12,Portugalete,Expense,appliances,-211.63,-30888.28
buyer_7,Mar√≠a,56,ES20209524514523730381,TRX_N-00654-66774363,2023-06-26T09:37:24,Portugalete,Expense,clothing,-78.54,-30966.82
buyer_7,Mar√≠a,56,ES20209524514523730381,TRX_N-00655-73303030,2023-06-28T10:52:59,Portugalete,Expense,food,-91.2,-31058.02
buyer_7,Mar√≠a,56,ES20209524514523730381,TRX_N-00656-61237039,2023-06-28T09:32:03,Portugalete,Expense,repairs,-180.87,-31238.89
buyer_7,Mar√≠a,56,ES20209524514523730381,TRX_N-00657-31125083,2023-06-30T21:24:02,Portugalete,Expense,food,-117.92,-31356.81
buyer_7,Mar√≠a,56,ES20209524514523730381,TRX_N-00658-08258839,2023-06-30T12:23:42,Portugalete,Expense,cash,-100.0,-31456.81
buyer_7,Mar√≠a,56,ES20209524514523730381,TRX_N-00659-78455353,2023-07-01T12:18:32,Portugalete,incomes,salary,1417.21,-30039.6
buyer_7,Mar√≠a,56,ES20209524514523730381,TRX_N-00660-43281843,2023-07-01T12:18:32,Portugalete,incomes,salary_partner,1221.87,-28817.73
buyer_7,Mar√≠a,56,ES20209524514523730381,TRX_N-00661-21122722,2023-07-01T10:36:45,Berango,Expense,transport,-47.84,-28865.57
buyer_7,Mar√≠a,56,ES20209524514523730381,TRX_N-00662-97492717,2023-07-01T19:36:03,Portugalete,Expense,leisure,-41.06,-28906.63
buyer_7,Mar√≠a,56,ES20209524514523730381,TRX_N-00663-03195924,2023-07-03T11:22:27,Portugalete,Expense,repairs,-203.07,-29109.7
buyer_7,Mar√≠a,56,ES20209524514523730381,TRX_N-00664-75251058,2023-07-03T13:55:26,Portugalete,expenses,children,-231.66,-29341.36
buyer_7,Mar√≠a,56,ES20209524514523730381,TRX_N-00665-19661413,2023-07-04T15:10:01,Portugalete,expenses,mortgage,-786.19,-30127.55
buyer_7,Mar√≠a,56,ES20209524514523730381,TRX_N-00666-85928418,2023-07-05T11:34:55,Portugalete,expenses,gas,-33.31,-30160.86
buyer_7,Mar√≠a,56,ES20209524514523730381,TRX_N-00667-94619905,2023-07-05T19:52:42,Portugalete,expenses,internet,-42.0,-30202.86
buyer_7,Mar√≠a,56,ES20209524514523730381,TRX_N-00668-35706975,2023-07-05T14:22:05,Portugalete,expenses,phone,-33.46,-30236.32
buyer_7,Mar√≠a,56,ES20209524514523730381,TRX_N-00669-75988759,2023-07-05T08:29:52,Portugalete,Expense,food,-69.69,-30306.01
buyer_7,Mar√≠a,56,ES20209524514523730381,TRX_N-00670-64612964,2023-07-06T21:27:13,Portugalete,expenses,water,-23.3,-30329.31
buyer_7,Mar√≠a,56,ES20209524514523730381,TRX_N-00671-26441132,2023-07-06T20:47:53,Portugalete,expenses,electricity,-51.17,-30380.48
buyer_7,Mar√≠a,56,ES20209524514523730381,TRX_N-00672-18192470,2023-07-07T13:56:18,Portugalete,Expense,leisure,-68.45,-30448.93
buyer_7,Mar√≠a,56,ES20209524514523730381,TRX_N-00673-11070738,2023-07-10T13:25:06,Portugalete,Expense,repairs,-28.02,-30476.95
buyer_7,Mar√≠a,56,ES20209524514523730381,TRX_N-00674-05622758,2023-07-11T06:34:48,Portugalete,Expense,gifts,-589.0,-31065.95
buyer_7,Mar√≠a,56,ES20209524514523730381,TRX_N-00675-84414207,2023-07-14T17:39:44,Donostia,Expense,transport,-48.4,-31114.35
buyer_7,Mar√≠a,56,ES20209524514523730381,TRX_N-00676-44516823,2023-07-14T15:06:24,Portugalete,Expense,repairs,-321.59,-31435.94
buyer_7,Mar√≠a,56,ES20209524514523730381,TRX_N-00677-51608195,2023-07-17T19:53:07,Portugalete,Expense,leisure,-65.87,-31501.81
buyer_7,Mar√≠a,56,ES20209524514523730381,TRX_N-00678-42552980,2023-07-18T20:50:56,Sestao,Expense,education,-54.38,-31556.19
buyer_7,Mar√≠a,56,ES20209524514523730381,TRX_N-00679-70054317,2023-07-21T14:57:30,Portugalete,Expense,gifts,-448.19,-32004.38
buyer_7,Mar√≠a,56,ES20209524514523730381,TRX_N-00680-70826582,2023-07-23T08:44:17,Oy√≥n-Oion,Expense,transport,-41.02,-32045.4
buyer_7,Mar√≠a,56,ES20209524514523730381,TRX_N-00681-63743310,2023-07-23T18:35:32,Portugalete,Expense,cash,-100.0,-32145.4
buyer_7,Mar√≠a,56,ES20209524514523730381,TRX_N-00682-60874526,2023-07-24T17:32:53,Portugalete,Expense,appliances,-139.24,-32284.64
buyer_7,Mar√≠a,56,ES20209524514523730381,TRX_N-00683-95567745,2023-07-26T12:49:38,Portugalete,Expense,cash,-100.0,-32384.64
buyer_7,Mar√≠a,56,ES20209524514523730381,TRX_N-00684-14332715,2023-07-29T10:37:03,Galdakao,Expense,food,-118.46,-32503.1
buyer_7,Mar√≠a,56,ES20209524514523730381,TRX_N-00685-73730081,2023-07-29T13:19:17,Lasarte-Oria,Expense,cash,-100.0,-32603.1
buyer_7,Mar√≠a,56,ES20209524514523730381,TRX_N-00686-53472915,2023-07-31T08:51:12,Portugalete,Expense,leisure,-26.05,-32629.15
buyer_7,Mar√≠a,56,ES20209524514523730381,TRX_N-00687-89488647,2023-08-01T17:19:33,Portugalete,incomes,salary,1417.21,-31211.94
buyer_7,Mar√≠a,56,ES20209524514523730381,TRX_N-00688-93781337,2023-08-01T17:19:33,Portugalete,incomes,salary_partner,1221.87,-29990.07
buyer_7,Mar√≠a,56,ES20209524514523730381,TRX_N-00689-92349779,2023-08-02T09:43:46,Portugalete,expenses,children,-263.34,-30253.41
buyer_7,Mar√≠a,56,ES20209524514523730381,TRX_N-00690-64923744,2023-08-04T09:32:34,Portugalete,expenses,mortgage,-786.19,-31039.6
buyer_7,Mar√≠a,56,ES20209524514523730381,TRX_N-00691-20454513,2023-08-05T19:28:25,Portugalete,expenses,water,-36.26,-31075.86
buyer_7,Mar√≠a,56,ES20209524514523730381,TRX_N-00692-54254702,2023-08-05T17:48:04,Portugalete,expenses,electricity,-44.18,-31120.04
buyer_7,Mar√≠a,56,ES20209524514523730381,TRX_N-00693-42614857,2023-08-05T16:26:22,Portugalete,Expense,clothing,-150.56,-31270.6
buyer_7,Mar√≠a,56,ES20209524514523730381,TRX_N-00694-90834483,2023-08-05T20:34:17,Portugalete,Expense,education,-76.32,-31346.92
buyer_7,Mar√≠a,56,ES20209524514523730381,TRX_N-00695-35394283,2023-08-06T04:16:33,Portugalete,expenses,internet,-42.0,-31388.92
buyer_7,Mar√≠a,56,ES20209524514523730381,TRX_N-00696-95490648,2023-08-06T03:21:13,Portugalete,expenses,phone,-32.16,-31421.08
buyer_7,Mar√≠a,56,ES20209524514523730381,TRX_N-00697-87018413,2023-08-06T11:07:07,Portugalete,Expense,repairs,-157.37,-31578.45
buyer_7,Mar√≠a,56,ES20209524514523730381,TRX_N-00698-14212921,2023-08-08T10:14:24,Portugalete,expenses,gas,-76.94,-31655.39
buyer_7,Mar√≠a,56,ES20209524514523730381,TRX_N-00699-69024385,2023-08-11T19:18:31,Portugalete,Expense,food,-67.52,-31722.91
buyer_7,Mar√≠a,56,ES20209524514523730381,TRX_N-00700-82154797,2023-08-11T12:49:06,Portugalete,Expense,cash,-100.0,-31822.91
buyer_7,Mar√≠a,56,ES20209524514523730381,TRX_N-00701-90622418,2023-08-13T20:46:45,Portugalete,Expense,food,-89.7,-31912.61
buyer_7,Mar√≠a,56,ES20209524514523730381,TRX_N-00702-81625715,2023-08-13T11:11:22,Eibar,Expense,healthcare,-134.36,-32046.97
buyer_7,Mar√≠a,56,ES20209524514523730381,TRX_N-00703-96030958,2023-08-15T10:01:52,Portugalete,Expense,leisure,-57.7,-32104.67
buyer_7,Mar√≠a,56,ES20209524514523730381,TRX_N-00704-86516257,2023-08-16T11:44:54,Portugalete,Expense,leisure,-41.63,-32146.3
buyer_7,Mar√≠a,56,ES20209524514523730381,TRX_N-00705-78578732,2023-08-16T14:51:02,Portugalete,Expense,cash,-100.0,-32246.3
buyer_7,Mar√≠a,56,ES20209524514523730381,TRX_N-00706-40814741,2023-08-17T15:23:50,Erandio,Expense,food,-104.82,-32351.12
buyer_7,Mar√≠a,56,ES20209524514523730381,TRX_N-00707-29815807,2023-08-18T11:13:34,Elciego,Expense,cash,-100.0,-32451.12
buyer_7,Mar√≠a,56,ES20209524514523730381,TRX_N-00708-83357727,2023-08-21T16:40:03,Portugalete,Expense,food,-96.37,-32547.49
buyer_7,Mar√≠a,56,ES20209524514523730381,TRX_N-00709-39868051,2023-08-23T13:21:02,Portugalete,Expense,leisure,-33.82,-32581.31
buyer_7,Mar√≠a,56,ES20209524514523730381,TRX_N-00710-94549856,2023-08-24T11:30:42,Hernani,Expense,food,-119.5,-32700.81
buyer_7,Mar√≠a,56,ES20209524514523730381,TRX_N-00711-81962271,2023-08-24T14:33:43,Portugalete,Expense,leisure,-56.63,-32757.44
buyer_7,Mar√≠a,56,ES20209524514523730381,TRX_N-00712-53907026,2023-08-24T11:19:31,Portugalete,Expense,healthcare,-186.42,-32943.86
buyer_7,Mar√≠a,56,ES20209524514523730381,TRX_N-00713-36915079,2023-08-24T13:28:32,Sopela,Expense,repairs,-322.01,-33265.87
buyer_7,Mar√≠a,56,ES20209524514523730381,TRX_N-00714-85072071,2023-08-25T23:53:22,Portugalete,Expense,food,-63.56,-33329.43
buyer_7,Mar√≠a,56,ES20209524514523730381,TRX_N-00715-98024610,2023-08-25T20:16:43,Portugalete,expenses,children,-89.95,-33419.38
buyer_7,Mar√≠a,56,ES20209524514523730381,TRX_N-00716-12703686,2023-08-27T13:11:13,Erandio,Expense,food,-83.27,-33502.65
buyer_7,Mar√≠a,56,ES20209524514523730381,TRX_N-00717-58380016,2023-08-29T18:01:02,Alegr√≠a-Dulantzi,Expense,food,-103.43,-33606.08
buyer_7,Mar√≠a,56,ES20209524514523730381,TRX_N-00718-33630609,2023-08-29T18:33:02,Sopela,Expense,repairs,-172.82,-33778.9
buyer_7,Mar√≠a,56,ES20209524514523730381,TRX_N-00719-59273893,2023-08-30T17:05:31,Portugalete,Expense,transport,-65.52,-33844.42
buyer_7,Mar√≠a,56,ES20209524514523730381,TRX_N-00720-27772325,2023-08-30T10:27:45,Portugalete,Expense,cash,-100.0,-33944.42
buyer_7,Mar√≠a,56,ES20209524514523730381,TRX_N-00721-90046859,2023-08-31T12:26:47,Portugalete,Expense,cash,-100.0,-34044.42
buyer_7,Mar√≠a,56,ES20209524514523730381,TRX_N-00722-40570893,2023-09-01T08:42:17,Portugalete,incomes,salary,1417.21,-32627.21
buyer_7,Mar√≠a,56,ES20209524514523730381,TRX_N-00723-68284661,2023-09-01T08:42:17,Portugalete,incomes,salary_partner,1221.87,-31405.34
buyer_7,Mar√≠a,56,ES20209524514523730381,TRX_N-00724-12646100,2023-09-01T08:42:17,Portugalete,incomes,extra_income,134.71,-31270.63
buyer_7,Mar√≠a,56,ES20209524514523730381,TRX_N-00725-76877403,2023-09-02T20:46:43,Portugalete,Expense,leisure,-25.88,-31296.51
buyer_7,Mar√≠a,56,ES20209524514523730381,TRX_N-00726-10068700,2023-09-03T09:16:43,Portugalete,Expense,appliances,-355.48,-31651.99
buyer_7,Mar√≠a,56,ES20209524514523730381,TRX_N-00727-75396589,2023-09-03T15:52:12,Elciego,Expense,gifts,-28.33,-31680.32
buyer_7,Mar√≠a,56,ES20209524514523730381,TRX_N-00728-96829913,2023-09-04T14:48:17,Portugalete,expenses,mortgage,-786.19,-32466.51
buyer_7,Mar√≠a,56,ES20209524514523730381,TRX_N-00729-61494257,2023-09-04T10:19:40,Portugalete,Expense,transport,-77.48,-32543.99
buyer_7,Mar√≠a,56,ES20209524514523730381,TRX_N-00730-56231346,2023-09-05T23:17:51,Portugalete,expenses,internet,-42.0,-32585.99
buyer_7,Mar√≠a,56,ES20209524514523730381,TRX_N-00731-92133731,2023-09-05T09:12:03,Portugalete,Expense,food,-116.21,-32702.2
buyer_7,Mar√≠a,56,ES20209524514523730381,TRX_N-00732-71006531,2023-09-05T06:32:12,Portugalete,Expense,healthcare,-102.58,-32804.78
buyer_7,Mar√≠a,56,ES20209524514523730381,TRX_N-00733-09155579,2023-09-08T16:48:23,Portugalete,expenses,gas,-55.5,-32860.28
buyer_7,Mar√≠a,56,ES20209524514523730381,TRX_N-00734-17961522,2023-09-08T17:53:48,Portugalete,expenses,water,-33.55,-32893.83
buyer_7,Mar√≠a,56,ES20209524514523730381,TRX_N-00735-73219501,2023-09-08T23:14:39,Portugalete,expenses,electricity,-72.09,-32965.92
buyer_7,Mar√≠a,56,ES20209524514523730381,TRX_N-00736-31947743,2023-09-08T17:19:43,Portugalete,expenses,phone,-41.26,-33007.18
buyer_7,Mar√≠a,56,ES20209524514523730381,TRX_N-00737-10932952,2023-09-08T18:13:35,Portugalete,Expense,food,-100.56,-33107.74
buyer_7,Mar√≠a,56,ES20209524514523730381,TRX_N-00738-62956005,2023-09-08T17:10:59,Portugalete,Expense,cash,-100.0,-33207.74
buyer_7,Mar√≠a,56,ES20209524514523730381,TRX_N-00739-82416518,2023-09-10T20:18:12,Portugalete,Expense,gifts,-517.8,-33725.54
buyer_7,Mar√≠a,56,ES20209524514523730381,TRX_N-00740-15459435,2023-09-11T17:28:13,Portugalete,Expense,repairs,-311.92,-34037.46
buyer_7,Mar√≠a,56,ES20209524514523730381,TRX_N-00741-49104954,2023-09-12T06:09:01,Llodio,Expense,cash,-100.0,-34137.46
buyer_7,Mar√≠a,56,ES20209524514523730381,TRX_N-00742-20691733,2023-09-14T12:35:33,Alegr√≠a-Dulantzi,Expense,food,-79.32,-34216.78
buyer_7,Mar√≠a,56,ES20209524514523730381,TRX_N-00743-30914870,2023-09-14T09:03:45,Portugalete,Expense,cash,-100.0,-34316.78
buyer_7,Mar√≠a,56,ES20209524514523730381,TRX_N-00744-45398975,2023-09-15T03:45:58,Portugalete,Expense,cash,-100.0,-34416.78
buyer_7,Mar√≠a,56,ES20209524514523730381,TRX_N-00745-45937321,2023-09-19T20:02:49,Portugalete,Expense,transport,-42.16,-34458.94
buyer_7,Mar√≠a,56,ES20209524514523730381,TRX_N-00746-59503631,2023-09-21T17:37:36,Portugalete,Expense,leisure,-78.89,-34537.83
buyer_7,Mar√≠a,56,ES20209524514523730381,TRX_N-00747-33914291,2023-09-21T14:54:54,Portugalete,Expense,gifts,-319.07,-34856.9
buyer_7,Mar√≠a,56,ES20209524514523730381,TRX_N-00748-66384726,2023-09-22T21:44:44,Portugalete,Expense,cash,-100.0,-34956.9
buyer_7,Mar√≠a,56,ES20209524514523730381,TRX_N-00749-73017584,2023-09-24T23:09:40,Portugalete,Expense,transport,-53.05,-35009.95
buyer_7,Mar√≠a,56,ES20209524514523730381,TRX_N-00750-27430785,2023-09-24T19:34:19,Portugalete,Expense,cash,-100.0,-35109.95
buyer_7,Mar√≠a,56,ES20209524514523730381,TRX_N-00751-83486829,2023-09-25T08:29:26,Portugalete,Expense,food,-94.54,-35204.49
buyer_7,Mar√≠a,56,ES20209524514523730381,TRX_N-00752-46881379,2023-09-27T09:09:12,Portugalete,Expense,healthcare,-134.72,-35339.21
buyer_7,Mar√≠a,56,ES20209524514523730381,TRX_N-00753-85467626,2023-09-28T01:04:28,Portugalete,Expense,leisure,-22.25,-35361.46
buyer_7,Mar√≠a,56,ES20209524514523730381,TRX_N-00754-20530990,2023-09-28T20:48:49,Portugalete,Expense,appliances,-332.71,-35694.17
buyer_7,Mar√≠a,56,ES20209524514523730381,TRX_N-00755-06254992,2023-09-29T03:06:34,Galdakao,Expense,food,-61.53,-35755.7
buyer_7,Mar√≠a,56,ES20209524514523730381,TRX_N-00756-44424213,2023-10-01T11:07:38,Portugalete,incomes,salary,1417.21,-34338.49
buyer_7,Mar√≠a,56,ES20209524514523730381,TRX_N-00757-37143289,2023-10-01T11:07:38,Portugalete,incomes,salary_partner,1221.87,-33116.62
buyer_7,Mar√≠a,56,ES20209524514523730381,TRX_N-00758-59692698,2023-10-01T14:08:12,Portugalete,Expense,food,-91.27,-33207.89
buyer_7,Mar√≠a,56,ES20209524514523730381,TRX_N-00759-56629512,2023-10-01T11:53:30,Portugalete,Expense,cash,-100.0,-33307.89
buyer_7,Mar√≠a,56,ES20209524514523730381,TRX_N-00760-05674336,2023-10-02T12:01:12,Portugalete,Expense,leisure,-66.88,-33374.77
buyer_7,Mar√≠a,56,ES20209524514523730381,TRX_N-00761-05351031,2023-10-04T14:47:39,Portugalete,expenses,mortgage,-786.19,-34160.96
buyer_7,Mar√≠a,56,ES20209524514523730381,TRX_N-00762-60017490,2023-10-04T18:21:22,Portugalete,Expense,leisure,-46.57,-34207.53
buyer_7,Mar√≠a,56,ES20209524514523730381,TRX_N-00763-57893975,2023-10-05T09:26:15,Portugalete,expenses,phone,-42.22,-34249.75
buyer_7,Mar√≠a,56,ES20209524514523730381,TRX_N-00764-75695174,2023-10-06T15:57:56,Portugalete,expenses,electricity,-48.52,-34298.27
buyer_7,Mar√≠a,56,ES20209524514523730381,TRX_N-00765-19272843,2023-10-08T20:33:02,Portugalete,expenses,water,-29.25,-34327.52
buyer_7,Mar√≠a,56,ES20209524514523730381,TRX_N-00766-36144727,2023-10-08T02:35:08,Portugalete,expenses,gas,-53.23,-34380.75
buyer_7,Mar√≠a,56,ES20209524514523730381,TRX_N-00767-73886905,2023-10-08T18:32:21,Portugalete,expenses,internet,-42.0,-34422.75
buyer_7,Mar√≠a,56,ES20209524514523730381,TRX_N-00768-57473130,2023-10-08T20:32:04,Portugalete,Expense,transport,-76.45,-34499.2
buyer_7,Mar√≠a,56,ES20209524514523730381,TRX_N-00769-81583308,2023-10-09T01:43:34,Portugalete,Expense,cash,-100.0,-34599.2
buyer_7,Mar√≠a,56,ES20209524514523730381,TRX_N-00770-96458475,2023-10-09T19:40:36,Portugalete,Expense,gifts,-703.8,-35303.0
buyer_7,Mar√≠a,56,ES20209524514523730381,TRX_N-00771-57027795,2023-10-11T15:02:06,Portugalete,Expense,repairs,-72.69,-35375.69
buyer_7,Mar√≠a,56,ES20209524514523730381,TRX_N-00772-09518471,2023-10-13T02:56:08,Portugalete,Expense,gifts,-243.69,-35619.38
buyer_7,Mar√≠a,56,ES20209524514523730381,TRX_N-00773-32080596,2023-10-14T11:32:42,Portugalete,Expense,appliances,-398.59,-36017.97
buyer_7,Mar√≠a,56,ES20209524514523730381,TRX_N-00774-83678069,2023-10-15T16:48:28,Eibar,Expense,food,-65.82,-36083.79
buyer_7,Mar√≠a,56,ES20209524514523730381,TRX_N-00775-81486188,2023-10-16T19:47:25,Getxo,Expense,food,-77.94,-36161.73
buyer_7,Mar√≠a,56,ES20209524514523730381,TRX_N-00776-99212786,2023-10-16T03:28:25,Portugalete,Expense,education,-58.7,-36220.43
buyer_7,Mar√≠a,56,ES20209524514523730381,TRX_N-00777-71996212,2023-10-17T18:01:42,Portugalete,Expense,food,-97.77,-36318.2
buyer_7,Mar√≠a,56,ES20209524514523730381,TRX_N-00778-65871330,2023-10-18T10:00:57,Portugalete,Expense,transport,-65.54,-36383.74
buyer_7,Mar√≠a,56,ES20209524514523730381,TRX_N-00779-98580443,2023-10-18T08:04:45,Portugalete,Expense,clothing,-70.81,-36454.55
buyer_7,Mar√≠a,56,ES20209524514523730381,TRX_N-00780-23955796,2023-10-21T15:06:15,Portugalete,Expense,repairs,-179.88,-36634.43
buyer_7,Mar√≠a,56,ES20209524514523730381,TRX_N-00781-64125339,2023-10-23T08:58:40,Portugalete,Expense,appliances,-144.04,-36778.47
buyer_7,Mar√≠a,56,ES20209524514523730381,TRX_N-00782-85087006,2023-10-25T14:43:44,Portugalete,Expense,gifts,-328.28,-37106.75
buyer_7,Mar√≠a,56,ES20209524514523730381,TRX_N-00783-66677966,2023-10-26T16:22:18,Portugalete,Expense,leisure,-20.48,-37127.23
buyer_7,Mar√≠a,56,ES20209524514523730381,TRX_N-00784-06768618,2023-10-27T08:50:41,Portugalete,Expense,travel,-815.66,-37942.89
buyer_7,Mar√≠a,56,ES20209524514523730381,TRX_N-00785-65694788,2023-10-28T20:42:59,Portugalete,Expense,leisure,-42.7,-37985.59
buyer_7,Mar√≠a,56,ES20209524514523730381,TRX_N-00786-41491727,2023-10-29T01:48:46,Zarautz,Expense,clothing,-106.26,-38091.85
buyer_7,Mar√≠a,56,ES20209524514523730381,TRX_N-00787-67489582,2023-10-29T14:09:27,Portugalete,expenses,children,-158.93,-38250.78
buyer_7,Mar√≠a,56,ES20209524514523730381,TRX_N-00788-01795922,2023-10-30T15:23:36,Portugalete,Expense,education,-74.56,-38325.34
buyer_7,Mar√≠a,56,ES20209524514523730381,TRX_N-00789-08024249,2023-10-31T19:50:25,Portugalete,Expense,cash,-100.0,-38425.34
buyer_7,Mar√≠a,56,ES20209524514523730381,TRX_N-00790-81946511,2023-11-01T17:19:16,Portugalete,incomes,salary,1417.21,-37008.13
buyer_7,Mar√≠a,56,ES20209524514523730381,TRX_N-00791-74779178,2023-11-01T17:19:16,Portugalete,incomes,salary_partner,1221.87,-35786.26
buyer_7,Mar√≠a,56,ES20209524514523730381,TRX_N-00792-67207973,2023-11-01T17:12:43,Getxo,Expense,clothing,-66.89,-35853.15
buyer_7,Mar√≠a,56,ES20209524514523730381,TRX_N-00793-59910608,2023-11-03T11:58:45,Portugalete,Expense,clothing,-127.99,-35981.14
buyer_7,Mar√≠a,56,ES20209524514523730381,TRX_N-00794-32675656,2023-11-03T09:47:56,Llodio,Expense,gifts,-571.75,-36552.89
buyer_7,Mar√≠a,56,ES20209524514523730381,TRX_N-00795-10547125,2023-11-04T14:46:27,Portugalete,expenses,mortgage,-786.19,-37339.08
buyer_7,Mar√≠a,56,ES20209524514523730381,TRX_N-00796-03236771,2023-11-04T19:49:52,Portugalete,Expense,education,-65.76,-37404.84
buyer_7,Mar√≠a,56,ES20209524514523730381,TRX_N-00797-67530912,2023-11-05T10:58:38,Portugalete,expenses,electricity,-69.1,-37473.94
buyer_7,Mar√≠a,56,ES20209524514523730381,TRX_N-00798-34968520,2023-11-05T01:46:06,Portugalete,Expense,food,-89.89,-37563.83
buyer_7,Mar√≠a,56,ES20209524514523730381,TRX_N-00799-75775404,2023-11-05T10:31:26,Portugalete,Expense,cash,-100.0,-37663.83
buyer_7,Mar√≠a,56,ES20209524514523730381,TRX_N-00800-37567194,2023-11-05T20:02:04,Portugalete,expenses,children,-160.12,-37823.95
buyer_7,Mar√≠a,56,ES20209524514523730381,TRX_N-00801-89027744,2023-11-06T08:52:55,Portugalete,expenses,gas,-45.16,-37869.11
buyer_7,Mar√≠a,56,ES20209524514523730381,TRX_N-00802-01281938,2023-11-06T03:54:46,Portugalete,Expense,education,-53.52,-37922.63
buyer_7,Mar√≠a,56,ES20209524514523730381,TRX_N-00803-84943072,2023-11-07T08:05:06,Portugalete,expenses,internet,-42.0,-37964.63
buyer_7,Mar√≠a,56,ES20209524514523730381,TRX_N-00804-14712243,2023-11-07T09:13:14,Portugalete,Expense,transport,-44.95,-38009.58
buyer_7,Mar√≠a,56,ES20209524514523730381,TRX_N-00805-62876585,2023-11-08T22:44:03,Portugalete,expenses,water,-41.14,-38050.72
buyer_7,Mar√≠a,56,ES20209524514523730381,TRX_N-00806-45375870,2023-11-08T08:48:31,Portugalete,expenses,phone,-33.45,-38084.17
buyer_7,Mar√≠a,56,ES20209524514523730381,TRX_N-00807-33391963,2023-11-08T18:06:48,Basauri,Expense,food,-75.26,-38159.43
buyer_7,Mar√≠a,56,ES20209524514523730381,TRX_N-00808-05730233,2023-11-08T20:25:47,Amurrio,Expense,transport,-50.74,-38210.17
buyer_7,Mar√≠a,56,ES20209524514523730381,TRX_N-00809-11401419,2023-11-08T16:48:55,Portugalete,expenses,children,-92.36,-38302.53
buyer_7,Mar√≠a,56,ES20209524514523730381,TRX_N-00810-82632201,2023-11-12T22:41:34,Portugalete,Expense,food,-111.74,-38414.27
buyer_7,Mar√≠a,56,ES20209524514523730381,TRX_N-00811-41758202,2023-11-15T08:41:19,Portugalete,Expense,cash,-100.0,-38514.27
buyer_7,Mar√≠a,56,ES20209524514523730381,TRX_N-00812-77246503,2023-11-15T23:09:21,Portugalete,Expense,gifts,-838.24,-39352.51
buyer_7,Mar√≠a,56,ES20209524514523730381,TRX_N-00813-92929816,2023-11-16T02:15:38,Sopela,Expense,leisure,-38.65,-39391.16
buyer_7,Mar√≠a,56,ES20209524514523730381,TRX_N-00814-67213099,2023-11-17T07:53:34,Portugalete,Expense,cash,-100.0,-39491.16
buyer_7,Mar√≠a,56,ES20209524514523730381,TRX_N-00815-75939241,2023-11-18T08:25:17,Portugalete,Expense,leisure,-77.96,-39569.12
buyer_7,Mar√≠a,56,ES20209524514523730381,TRX_N-00816-71700834,2023-11-19T14:42:06,Eibar,Expense,cash,-100.0,-39669.12
buyer_7,Mar√≠a,56,ES20209524514523730381,TRX_N-00817-49721912,2023-11-23T22:13:01,Portugalete,Expense,leisure,-53.72,-39722.84
buyer_7,Mar√≠a,56,ES20209524514523730381,TRX_N-00818-24116452,2023-11-24T22:10:15,Alegr√≠a-Dulantzi,Expense,repairs,-260.42,-39983.26
buyer_7,Mar√≠a,56,ES20209524514523730381,TRX_N-00819-07419761,2023-11-25T12:18:35,Bilbao,Expense,food,-95.02,-40078.28
buyer_7,Mar√≠a,56,ES20209524514523730381,TRX_N-00820-79989570,2023-11-25T16:45:03,Portugalete,Expense,cash,-100.0,-40178.28
buyer_7,Mar√≠a,56,ES20209524514523730381,TRX_N-00821-24919970,2023-11-27T17:13:48,Portugalete,Expense,clothing,-155.35,-40333.63
buyer_7,Mar√≠a,56,ES20209524514523730381,TRX_N-00822-19906448,2023-11-27T10:52:54,Portugalete,Expense,education,-54.97,-40388.6
buyer_7,Mar√≠a,56,ES20209524514523730381,TRX_N-00823-77064445,2023-11-28T08:23:50,Portugalete,Expense,repairs,-105.87,-40494.47
buyer_7,Mar√≠a,56,ES20209524514523730381,TRX_N-00824-17677215,2023-11-29T18:22:53,Zuia,Expense,cash,-100.0,-40594.47
buyer_7,Mar√≠a,56,ES20209524514523730381,TRX_N-00825-87266003,2023-12-01T23:50:53,Portugalete,incomes,salary,1417.21,-39177.26
buyer_7,Mar√≠a,56,ES20209524514523730381,TRX_N-00826-09504789,2023-12-01T23:50:53,Portugalete,incomes,salary_partner,1221.87,-37955.39
buyer_7,Mar√≠a,56,ES20209524514523730381,TRX_N-00827-72204895,2023-12-01T23:50:53,Portugalete,incomes,salary_bonus,1061.31,-36894.08
buyer_7,Mar√≠a,56,ES20209524514523730381,TRX_N-00828-01025828,2023-12-01T23:50:53,Portugalete,incomes,salary_partner_bonus,920.35,-35973.73
buyer_7,Mar√≠a,56,ES20209524514523730381,TRX_N-00829-56988286,2023-12-01T19:02:42,Portugalete,Expense,leisure,-77.79,-36051.52
buyer_7,Mar√≠a,56,ES20209524514523730381,TRX_N-00830-60121507,2023-12-01T12:13:37,Portugalete,Expense,repairs,-57.63,-36109.15
buyer_7,Mar√≠a,56,ES20209524514523730381,TRX_N-00831-30822212,2023-12-02T15:30:42,Portugalete,Expense,food,-66.8,-36175.95
buyer_7,Mar√≠a,56,ES20209524514523730381,TRX_N-00832-96438244,2023-12-03T06:22:15,Portugalete,Expense,cash,-100.0,-36275.95
buyer_7,Mar√≠a,56,ES20209524514523730381,TRX_N-00833-51340345,2023-12-03T19:19:52,Portugalete,expenses,children,-79.4,-36355.35
buyer_7,Mar√≠a,56,ES20209524514523730381,TRX_N-00834-38062755,2023-12-04T15:34:44,Portugalete,expenses,mortgage,-786.19,-37141.54
buyer_7,Mar√≠a,56,ES20209524514523730381,TRX_N-00835-68301090,2023-12-04T15:02:41,Portugalete,Expense,appliances,-108.23,-37249.77
buyer_7,Mar√≠a,56,ES20209524514523730381,TRX_N-00836-22541582,2023-12-05T00:54:05,Portugalete,expenses,water,-37.02,-37286.79
buyer_7,Mar√≠a,56,ES20209524514523730381,TRX_N-00837-36901210,2023-12-05T22:40:47,Portugalete,expenses,internet,-42.0,-37328.79
buyer_7,Mar√≠a,56,ES20209524514523730381,TRX_N-00838-81155659,2023-12-05T17:45:15,Portugalete,Expense,gifts,-257.06,-37585.85
buyer_7,Mar√≠a,56,ES20209524514523730381,TRX_N-00839-99136648,2023-12-06T21:48:24,Portugalete,expenses,phone,-34.88,-37620.73
buyer_7,Mar√≠a,56,ES20209524514523730381,TRX_N-00840-39449113,2023-12-06T15:06:34,Portugalete,Expense,transport,-43.25,-37663.98
buyer_7,Mar√≠a,56,ES20209524514523730381,TRX_N-00841-87947080,2023-12-07T19:40:01,Portugalete,Expense,travel,-489.8,-38153.78
buyer_7,Mar√≠a,56,ES20209524514523730381,TRX_N-00842-10196572,2023-12-08T22:25:04,Portugalete,expenses,electricity,-68.84,-38222.62
buyer_7,Mar√≠a,56,ES20209524514523730381,TRX_N-00843-25806935,2023-12-08T08:49:10,Portugalete,expenses,gas,-37.88,-38260.5
buyer_7,Mar√≠a,56,ES20209524514523730381,TRX_N-00844-35382906,2023-12-09T08:22:17,Portugalete,Expense,transport,-73.93,-38334.43
buyer_7,Mar√≠a,56,ES20209524514523730381,TRX_N-00845-01448405,2023-12-11T10:26:31,Portugalete,Expense,food,-92.32,-38426.75
buyer_7,Mar√≠a,56,ES20209524514523730381,TRX_N-00846-80680251,2023-12-12T14:13:53,Portugalete,Expense,leisure,-47.14,-38473.89
buyer_7,Mar√≠a,56,ES20209524514523730381,TRX_N-00847-62838299,2023-12-13T11:24:37,Alegr√≠a-Dulantzi,Expense,appliances,-411.77,-38885.66
buyer_7,Mar√≠a,56,ES20209524514523730381,TRX_N-00848-61245342,2023-12-15T08:27:26,Portugalete,Expense,food,-97.91,-38983.57
buyer_7,Mar√≠a,56,ES20209524514523730381,TRX_N-00849-34807851,2023-12-15T11:35:10,Portugalete,Expense,cash,-100.0,-39083.57
buyer_7,Mar√≠a,56,ES20209524514523730381,TRX_N-00850-03366160,2023-12-16T15:55:29,Portugalete,Expense,food,-88.47,-39172.04
buyer_7,Mar√≠a,56,ES20209524514523730381,TRX_N-00851-79707588,2023-12-16T12:31:14,Oy√≥n-Oion,Expense,cash,-100.0,-39272.04
buyer_7,Mar√≠a,56,ES20209524514523730381,TRX_N-00852-82778094,2023-12-17T23:14:57,Portugalete,Expense,food,-120.33,-39392.37
buyer_7,Mar√≠a,56,ES20209524514523730381,TRX_N-00853-41075319,2023-12-18T10:57:28,Portugalete,Expense,healthcare,-150.34,-39542.71
buyer_7,Mar√≠a,56,ES20209524514523730381,TRX_N-00854-50716951,2023-12-19T12:05:17,Salvatierra/Agurain,Expense,food,-91.21,-39633.92
buyer_7,Mar√≠a,56,ES20209524514523730381,TRX_N-00855-24053925,2023-12-19T12:51:27,Portugalete,Expense,healthcare,-98.39,-39732.31
buyer_7,Mar√≠a,56,ES20209524514523730381,TRX_N-00856-41929254,2023-12-20T18:44:32,Portugalete,Expense,leisure,-70.24,-39802.55
buyer_7,Mar√≠a,56,ES20209524514523730381,TRX_N-00857-19944814,2023-12-20T15:33:45,Portugalete,Expense,gifts,-134.15,-39936.7
buyer_7,Mar√≠a,56,ES20209524514523730381,TRX_N-00858-51219232,2023-12-21T11:15:49,Portugalete,Expense,cash,-100.0,-40036.7
buyer_7,Mar√≠a,56,ES20209524514523730381,TRX_N-00859-90813363,2023-12-24T19:17:16,Portugalete,Expense,appliances,-262.19,-40298.89
buyer_7,Mar√≠a,56,ES20209524514523730381,TRX_N-00860-13396090,2023-12-25T15:25:26,Portugalete,Expense,transport,-68.44,-40367.33
buyer_7,Mar√≠a,56,ES20209524514523730381,TRX_N-00861-37127242,2023-12-26T18:58:42,Portugalete,Expense,cash,-100.0,-40467.33
buyer_7,Mar√≠a,56,ES20209524514523730381,TRX_N-00862-47290074,2023-12-26T15:58:20,Portugalete,Expense,appliances,-360.39,-40827.72
buyer_7,Mar√≠a,56,ES20209524514523730381,TRX_N-00863-61875376,2023-12-27T10:03:19,Portugalete,Expense,travel,-1281.38,-42109.1
buyer_7,Mar√≠a,56,ES20209524514523730381,TRX_N-00864-98279499,2023-12-28T11:01:23,Portugalete,Expense,food,-111.29,-42220.39
buyer_7,Mar√≠a,56,ES20209524514523730381,TRX_N-00865-51384108,2023-12-28T07:38:46,Portugalete,Expense,transport,-83.56,-42303.95
buyer_7,Mar√≠a,56,ES20209524514523730381,TRX_N-00866-30907506,2023-12-29T08:15:56,Portugalete,Expense,leisure,-47.58,-42351.53
buyer_7,Mar√≠a,56,ES20209524514523730381,TRX_N-00867-57988145,2023-12-29T12:47:40,Leioa,Expense,travel,-1719.26,-44070.79
buyer_7,Mar√≠a,56,ES20209524514523730381,TRX_N-00868-00244192,2024-01-01T16:53:24,Portugalete,incomes,salary,1452.4,-42618.39
buyer_7,Mar√≠a,56,ES20209524514523730381,TRX_N-00869-24015288,2024-01-01T16:53:24,Portugalete,incomes,salary_partner,1252.21,-41366.18
buyer_7,Mar√≠a,56,ES20209524514523730381,TRX_N-00870-38541554,2024-01-01T16:53:24,Portugalete,incomes,extra_income,134.71,-41231.47
buyer_7,Mar√≠a,56,ES20209524514523730381,TRX_N-00871-35889271,2024-01-01T21:12:13,Portugalete,Expense,food,-107.09,-41338.56
buyer_7,Mar√≠a,56,ES20209524514523730381,TRX_N-00872-40566943,2024-01-02T20:44:04,Portugalete,Expense,clothing,-149.89,-41488.45
buyer_7,Mar√≠a,56,ES20209524514523730381,TRX_N-00873-40898095,2024-01-02T12:57:11,Portugalete,Expense,repairs,-244.03,-41732.48
buyer_7,Mar√≠a,56,ES20209524514523730381,TRX_N-00874-15561856,2024-01-02T09:02:03,Portugalete,expenses,children,-236.21,-41968.69
buyer_7,Mar√≠a,56,ES20209524514523730381,TRX_N-00875-51454915,2024-01-03T08:54:29,Basauri,Expense,food,-88.4,-42057.09
buyer_7,Mar√≠a,56,ES20209524514523730381,TRX_N-00876-47548766,2024-01-03T08:09:05,Portugalete,Expense,cash,-100.0,-42157.09
buyer_7,Mar√≠a,56,ES20209524514523730381,TRX_N-00877-97586771,2024-01-04T10:47:17,Portugalete,expenses,mortgage,-786.19,-42943.28
buyer_7,Mar√≠a,56,ES20209524514523730381,TRX_N-00878-70009438,2024-01-04T15:36:39,Portugalete,expenses,children,-107.6,-43050.88
buyer_7,Mar√≠a,56,ES20209524514523730381,TRX_N-00879-06076040,2024-01-05T23:54:32,Portugalete,Expense,transport,-58.09,-43108.97
buyer_7,Mar√≠a,56,ES20209524514523730381,TRX_N-00880-84676874,2024-01-06T08:21:16,Portugalete,expenses,water,-35.98,-43144.95
buyer_7,Mar√≠a,56,ES20209524514523730381,TRX_N-00881-91613992,2024-01-06T15:04:41,Portugalete,Expense,food,-90.27,-43235.22
buyer_7,Mar√≠a,56,ES20209524514523730381,TRX_N-00882-93708871,2024-01-06T08:55:02,Portugalete,Expense,repairs,-28.94,-43264.16
buyer_7,Mar√≠a,56,ES20209524514523730381,TRX_N-00883-79690080,2024-01-07T19:55:24,Portugalete,Expense,food,-113.24,-43377.4
buyer_7,Mar√≠a,56,ES20209524514523730381,TRX_N-00884-30042419,2024-01-07T22:17:19,Portugalete,Expense,travel,-1837.33,-45214.73
buyer_7,Mar√≠a,56,ES20209524514523730381,TRX_N-00885-04438305,2024-01-08T10:22:12,Portugalete,expenses,internet,-42.0,-45256.73
buyer_7,Mar√≠a,56,ES20209524514523730381,TRX_N-00886-06020698,2024-01-08T19:18:11,Portugalete,expenses,electricity,-45.82,-45302.55
buyer_7,Mar√≠a,56,ES20209524514523730381,TRX_N-00887-49190848,2024-01-08T14:28:54,Portugalete,expenses,gas,-92.02,-45394.57
buyer_7,Mar√≠a,56,ES20209524514523730381,TRX_N-00888-23835549,2024-01-08T21:12:49,Portugalete,expenses,phone,-42.01,-45436.58
buyer_7,Mar√≠a,56,ES20209524514523730381,TRX_N-00889-46228845,2024-01-08T08:49:40,Amurrio,Expense,leisure,-53.67,-45490.25
buyer_7,Mar√≠a,56,ES20209524514523730381,TRX_N-00890-04338066,2024-01-10T19:06:04,Portugalete,Expense,food,-75.54,-45565.79
buyer_7,Mar√≠a,56,ES20209524514523730381,TRX_N-00891-81538738,2024-01-10T19:00:49,Portugalete,Expense,leisure,-22.36,-45588.15
buyer_7,Mar√≠a,56,ES20209524514523730381,TRX_N-00892-85519012,2024-01-11T13:47:03,Portugalete,Expense,leisure,-21.81,-45609.96
buyer_7,Mar√≠a,56,ES20209524514523730381,TRX_N-00893-29978430,2024-01-12T21:02:10,Portugalete,Expense,food,-90.5,-45700.46
buyer_7,Mar√≠a,56,ES20209524514523730381,TRX_N-00894-26147563,2024-01-12T09:18:48,Portugalete,Expense,leisure,-51.23,-45751.69
buyer_7,Mar√≠a,56,ES20209524514523730381,TRX_N-00895-19107679,2024-01-13T06:23:07,Portugalete,Expense,food,-117.35,-45869.04
buyer_7,Mar√≠a,56,ES20209524514523730381,TRX_N-00896-64161171,2024-01-13T12:41:51,Portugalete,Expense,transport,-69.13,-45938.17
buyer_7,Mar√≠a,56,ES20209524514523730381,TRX_N-00897-57085842,2024-01-13T10:16:01,Portugalete,expenses,children,-217.05,-46155.22
buyer_7,Mar√≠a,56,ES20209524514523730381,TRX_N-00898-05040259,2024-01-14T12:11:15,Portugalete,Expense,leisure,-38.25,-46193.47
buyer_7,Mar√≠a,56,ES20209524514523730381,TRX_N-00899-75545362,2024-01-16T02:05:16,Portugalete,Expense,appliances,-412.75,-46606.22
buyer_7,Mar√≠a,56,ES20209524514523730381,TRX_N-00900-95907773,2024-01-17T22:15:13,Portugalete,Expense,food,-115.82,-46722.04
buyer_7,Mar√≠a,56,ES20209524514523730381,TRX_N-00901-94347153,2024-01-18T18:21:15,Portugalete,Expense,food,-84.25,-46806.29
buyer_7,Mar√≠a,56,ES20209524514523730381,TRX_N-00902-12055359,2024-01-18T10:19:38,Portugalete,Expense,cash,-100.0,-46906.29
buyer_7,Mar√≠a,56,ES20209524514523730381,TRX_N-00903-13318984,2024-01-19T09:54:26,Portugalete,expenses,children,-243.32,-47149.61
buyer_7,Mar√≠a,56,ES20209524514523730381,TRX_N-00904-88425610,2024-01-20T15:29:54,Portugalete,Expense,food,-111.47,-47261.08
buyer_7,Mar√≠a,56,ES20209524514523730381,TRX_N-00905-74642917,2024-01-20T09:52:41,Portugalete,Expense,cash,-100.0,-47361.08
buyer_7,Mar√≠a,56,ES20209524514523730381,TRX_N-00906-28960108,2024-01-21T12:01:36,Portugalete,Expense,food,-112.84,-47473.92
buyer_7,Mar√≠a,56,ES20209524514523730381,TRX_N-00907-74965602,2024-01-21T20:07:56,Portugalete,Expense,leisure,-58.15,-47532.07
buyer_7,Mar√≠a,56,ES20209524514523730381,TRX_N-00908-84750110,2024-01-22T19:10:14,Portugalete,Expense,food,-118.17,-47650.24
buyer_7,Mar√≠a,56,ES20209524514523730381,TRX_N-00909-31877440,2024-01-22T18:57:39,Alegr√≠a-Dulantzi,Expense,cash,-100.0,-47750.24
buyer_7,Mar√≠a,56,ES20209524514523730381,TRX_N-00910-29654081,2024-01-24T13:51:33,Portugalete,Expense,transport,-88.27,-47838.51
buyer_7,Mar√≠a,56,ES20209524514523730381,TRX_N-00911-13317305,2024-01-24T10:45:11,Portugalete,Expense,leisure,-38.54,-47877.05
buyer_7,Mar√≠a,56,ES20209524514523730381,TRX_N-00912-27306460,2024-01-26T15:30:34,Portugalete,Expense,food,-89.09,-47966.14
buyer_7,Mar√≠a,56,ES20209524514523730381,TRX_N-00913-80717440,2024-01-27T15:09:50,Portugalete,Expense,cash,-100.0,-48066.14
buyer_7,Mar√≠a,56,ES20209524514523730381,TRX_N-00914-63986060,2024-01-28T10:47:21,Portugalete,Expense,repairs,-294.16,-48360.3
buyer_7,Mar√≠a,56,ES20209524514523730381,TRX_N-00915-16533713,2024-01-30T16:15:31,Portugalete,Expense,food,-105.21,-48465.51
buyer_7,Mar√≠a,56,ES20209524514523730381,TRX_N-00916-09760419,2024-01-31T21:24:10,Portugalete,Expense,leisure,-63.34,-48528.85
buyer_7,Mar√≠a,56,ES20209524514523730381,TRX_N-00917-23003812,2024-02-01T15:37:19,Portugalete,incomes,salary,1452.4,-47076.45
buyer_7,Mar√≠a,56,ES20209524514523730381,TRX_N-00918-05281437,2024-02-01T15:37:19,Portugalete,incomes,salary_partner,1252.21,-45824.24
buyer_7,Mar√≠a,56,ES20209524514523730381,TRX_N-00919-57048717,2024-02-01T11:15:10,Portugalete,Expense,healthcare,-177.52,-46001.76
buyer_7,Mar√≠a,56,ES20209524514523730381,TRX_N-00920-11948634,2024-02-04T15:52:33,Portugalete,expenses,mortgage,-786.19,-46787.95
buyer_7,Mar√≠a,56,ES20209524514523730381,TRX_N-00921-89306266,2024-02-04T08:05:34,Portugalete,Expense,leisure,-81.48,-46869.43
buyer_7,Mar√≠a,56,ES20209524514523730381,TRX_N-00922-49235364,2024-02-05T09:34:25,Portugalete,expenses,electricity,-26.05,-46895.48
buyer_7,Mar√≠a,56,ES20209524514523730381,TRX_N-00923-60325470,2024-02-06T08:58:45,Portugalete,expenses,water,-39.46,-46934.94
buyer_7,Mar√≠a,56,ES20209524514523730381,TRX_N-00924-22316244,2024-02-06T19:28:00,Bermeo,Expense,leisure,-51.02,-46985.96
buyer_7,Mar√≠a,56,ES20209524514523730381,TRX_N-00925-20628901,2024-02-06T21:24:17,Portugalete,Expense,cash,-100.0,-47085.96
buyer_7,Mar√≠a,56,ES20209524514523730381,TRX_N-00926-12062786,2024-02-08T19:55:37,Portugalete,expenses,gas,-76.2,-47162.16
buyer_7,Mar√≠a,56,ES20209524514523730381,TRX_N-00927-38931370,2024-02-08T12:35:22,Portugalete,expenses,internet,-42.0,-47204.16
buyer_7,Mar√≠a,56,ES20209524514523730381,TRX_N-00928-42384782,2024-02-08T13:25:14,Portugalete,expenses,phone,-43.7,-47247.86
buyer_7,Mar√≠a,56,ES20209524514523730381,TRX_N-00929-62904001,2024-02-08T13:42:13,Portugalete,Expense,food,-75.9,-47323.76
buyer_7,Mar√≠a,56,ES20209524514523730381,TRX_N-00930-48719653,2024-02-08T19:42:57,Portugalete,Expense,clothing,-96.36,-47420.12
buyer_7,Mar√≠a,56,ES20209524514523730381,TRX_N-00931-32301475,2024-02-08T08:24:49,Portugalete,Expense,cash,-100.0,-47520.12
buyer_7,Mar√≠a,56,ES20209524514523730381,TRX_N-00932-32977871,2024-02-09T11:54:22,Portugalete,Expense,cash,-100.0,-47620.12
buyer_7,Mar√≠a,56,ES20209524514523730381,TRX_N-00933-10509221,2024-02-09T09:02:49,Portugalete,Expense,repairs,-136.13,-47756.25
buyer_7,Mar√≠a,56,ES20209524514523730381,TRX_N-00934-91183663,2024-02-10T21:01:38,Portugalete,Expense,gifts,-474.71,-48230.96
buyer_7,Mar√≠a,56,ES20209524514523730381,TRX_N-00935-80375840,2024-02-11T07:14:00,Portugalete,Expense,cash,-100.0,-48330.96
buyer_7,Mar√≠a,56,ES20209524514523730381,TRX_N-00936-20068691,2024-02-11T17:04:13,Zarautz,Expense,appliances,-161.53,-48492.49
buyer_7,Mar√≠a,56,ES20209524514523730381,TRX_N-00937-84850893,2024-02-14T15:57:24,Portugalete,Expense,food,-67.49,-48559.98
buyer_7,Mar√≠a,56,ES20209524514523730381,TRX_N-00938-18775921,2024-02-15T22:03:52,Portugalete,Expense,food,-69.41,-48629.39
buyer_7,Mar√≠a,56,ES20209524514523730381,TRX_N-00939-81243837,2024-02-15T18:03:13,Portugalete,Expense,leisure,-46.03,-48675.42
buyer_7,Mar√≠a,56,ES20209524514523730381,TRX_N-00940-19327658,2024-02-15T08:36:17,Portugalete,Expense,healthcare,-92.32,-48767.74
buyer_7,Mar√≠a,56,ES20209524514523730381,TRX_N-00941-69519263,2024-02-18T15:09:18,Sopela,Expense,education,-52.84,-48820.58
buyer_7,Mar√≠a,56,ES20209524514523730381,TRX_N-00942-23449456,2024-02-19T10:24:05,Portugalete,Expense,transport,-57.36,-48877.94
buyer_7,Mar√≠a,56,ES20209524514523730381,TRX_N-00943-39140644,2024-02-23T19:41:46,Andoain,Expense,clothing,-101.67,-48979.61
buyer_7,Mar√≠a,56,ES20209524514523730381,TRX_N-00944-41378497,2024-02-23T10:52:25,Portugalete,Expense,repairs,-97.97,-49077.58
buyer_7,Mar√≠a,56,ES20209524514523730381,TRX_N-00945-29687232,2024-02-24T12:04:31,Portugalete,Expense,cash,-100.0,-49177.58
buyer_7,Mar√≠a,56,ES20209524514523730381,TRX_N-00946-98658614,2024-02-25T03:02:40,Salvatierra/Agurain,Expense,repairs,-127.62,-49305.2
buyer_7,Mar√≠a,56,ES20209524514523730381,TRX_N-00947-07957670,2024-02-27T19:30:56,Portugalete,Expense,education,-69.62,-49374.82
buyer_7,Mar√≠a,56,ES20209524514523730381,TRX_N-00948-33075372,2024-02-27T08:10:17,Portugalete,expenses,children,-130.58,-49505.4
buyer_7,Mar√≠a,56,ES20209524514523730381,TRX_N-00949-13433898,2024-02-28T15:50:04,Leioa,Expense,food,-61.98,-49567.38
buyer_7,Mar√≠a,56,ES20209524514523730381,TRX_N-00950-06123716,2024-02-28T19:14:04,Errenteria,Expense,travel,-1586.76,-51154.14
buyer_7,Mar√≠a,56,ES20209524514523730381,TRX_N-00951-67089039,2024-02-29T14:12:22,Portugalete,Expense,travel,-1094.59,-52248.73
buyer_7,Mar√≠a,56,ES20209524514523730381,TRX_N-00952-78014203,2024-03-01T15:18:09,Portugalete,incomes,salary,1452.4,-50796.33
buyer_7,Mar√≠a,56,ES20209524514523730381,TRX_N-00953-39789594,2024-03-01T15:18:09,Portugalete,incomes,salary_partner,1252.21,-49544.12
buyer_7,Mar√≠a,56,ES20209524514523730381,TRX_N-00954-43422780,2024-03-01T13:03:01,Portugalete,Expense,food,-86.54,-49630.66
buyer_7,Mar√≠a,56,ES20209524514523730381,TRX_N-00955-46474789,2024-03-01T12:36:30,Portugalete,Expense,clothing,-45.17,-49675.83
buyer_7,Mar√≠a,56,ES20209524514523730381,TRX_N-00956-04675459,2024-03-01T18:02:11,Portugalete,Expense,cash,-100.0,-49775.83
buyer_7,Mar√≠a,56,ES20209524514523730381,TRX_N-00957-54509467,2024-03-02T18:47:48,Portugalete,Expense,repairs,-236.11,-50011.94
buyer_7,Mar√≠a,56,ES20209524514523730381,TRX_N-00958-57268959,2024-03-03T20:24:03,Portugalete,Expense,leisure,-27.37,-50039.31
buyer_7,Mar√≠a,56,ES20209524514523730381,TRX_N-00959-08604569,2024-03-03T13:31:23,Portugalete,Expense,cash,-100.0,-50139.31
buyer_7,Mar√≠a,56,ES20209524514523730381,TRX_N-00960-73724251,2024-03-03T20:49:18,Portugalete,Expense,appliances,-357.67,-50496.98
buyer_7,Mar√≠a,56,ES20209524514523730381,TRX_N-00961-88361194,2024-03-04T15:05:30,Portugalete,expenses,mortgage,-786.19,-51283.17
buyer_7,Mar√≠a,56,ES20209524514523730381,TRX_N-00962-35482344,2024-03-04T12:23:57,Portugalete,Expense,food,-70.89,-51354.06
buyer_7,Mar√≠a,56,ES20209524514523730381,TRX_N-00963-51139229,2024-03-05T10:06:30,Portugalete,expenses,internet,-42.0,-51396.06
buyer_7,Mar√≠a,56,ES20209524514523730381,TRX_N-00964-28498294,2024-03-05T19:44:53,Portugalete,expenses,phone,-30.39,-51426.45
buyer_7,Mar√≠a,56,ES20209524514523730381,TRX_N-00965-13991251,2024-03-06T14:38:02,Portugalete,expenses,gas,-47.89,-51474.34
buyer_7,Mar√≠a,56,ES20209524514523730381,TRX_N-00966-95194936,2024-03-07T09:05:12,Bilbao,Expense,food,-65.88,-51540.22
buyer_7,Mar√≠a,56,ES20209524514523730381,TRX_N-00967-96778566,2024-03-07T18:57:26,Portugalete,Expense,travel,-1782.27,-53322.49
buyer_7,Mar√≠a,56,ES20209524514523730381,TRX_N-00968-44817271,2024-03-07T22:36:58,Portugalete,Expense,gifts,-217.94,-53540.43
buyer_7,Mar√≠a,56,ES20209524514523730381,TRX_N-00969-50673664,2024-03-08T22:08:26,Portugalete,expenses,water,-26.04,-53566.47
buyer_7,Mar√≠a,56,ES20209524514523730381,TRX_N-00970-55551380,2024-03-08T20:14:26,Portugalete,expenses,electricity,-52.94,-53619.41
buyer_7,Mar√≠a,56,ES20209524514523730381,TRX_N-00971-95426794,2024-03-11T19:06:54,Portugalete,Expense,food,-80.46,-53699.87
buyer_7,Mar√≠a,56,ES20209524514523730381,TRX_N-00972-51851577,2024-03-12T19:11:18,Mungia,Expense,cash,-100.0,-53799.87
buyer_7,Mar√≠a,56,ES20209524514523730381,TRX_N-00973-99952175,2024-03-13T19:04:56,Galdakao,Expense,cash,-100.0,-53899.87
buyer_7,Mar√≠a,56,ES20209524514523730381,TRX_N-00974-56754384,2024-03-13T23:16:48,Portugalete,expenses,children,-101.62,-54001.49
buyer_7,Mar√≠a,56,ES20209524514523730381,TRX_N-00975-82961058,2024-03-16T17:46:58,Portugalete,Expense,cash,-100.0,-54101.49
buyer_7,Mar√≠a,56,ES20209524514523730381,TRX_N-00976-58086130,2024-03-16T16:15:21,Portugalete,Expense,gifts,-328.66,-54430.15
buyer_7,Mar√≠a,56,ES20209524514523730381,TRX_N-00977-52908928,2024-03-19T14:40:03,Portugalete,expenses,children,-75.95,-54506.1
buyer_7,Mar√≠a,56,ES20209524514523730381,TRX_N-00978-04195048,2024-03-21T22:28:29,Portugalete,Expense,food,-93.95,-54600.05
buyer_7,Mar√≠a,56,ES20209524514523730381,TRX_N-00979-24548716,2024-03-21T08:51:19,Portugalete,Expense,leisure,-36.54,-54636.59
buyer_7,Mar√≠a,56,ES20209524514523730381,TRX_N-00980-05866044,2024-03-22T13:20:31,Portugalete,Expense,cash,-100.0,-54736.59
buyer_7,Mar√≠a,56,ES20209524514523730381,TRX_N-00981-43844789,2024-03-22T20:25:51,Portugalete,Expense,gifts,-80.0,-54816.59
buyer_7,Mar√≠a,56,ES20209524514523730381,TRX_N-00982-57596498,2024-03-23T12:06:39,Portugalete,Expense,transport,-66.25,-54882.84
buyer_7,Mar√≠a,56,ES20209524514523730381,TRX_N-00983-54797274,2024-03-25T18:34:18,Hondarribia,Expense,leisure,-38.16,-54921.0
buyer_7,Mar√≠a,56,ES20209524514523730381,TRX_N-00984-09547400,2024-03-25T18:20:35,Portugalete,Expense,cash,-100.0,-55021.0
buyer_7,Mar√≠a,56,ES20209524514523730381,TRX_N-00985-77713776,2024-03-26T15:22:46,Portugalete,Expense,transport,-66.89,-55087.89
buyer_7,Mar√≠a,56,ES20209524514523730381,TRX_N-00986-21271817,2024-03-27T18:47:35,Portugalete,Expense,gifts,-140.16,-55228.05
buyer_7,Mar√≠a,56,ES20209524514523730381,TRX_N-00987-87192745,2024-03-28T02:11:33,Portugalete,Expense,transport,-74.9,-55302.95
buyer_7,Mar√≠a,56,ES20209524514523730381,TRX_N-00988-85676341,2024-03-29T11:11:09,Portugalete,Expense,transport,-64.66,-55367.61
buyer_7,Mar√≠a,56,ES20209524514523730381,TRX_N-00989-86261653,2024-04-01T14:45:18,Portugalete,incomes,salary,1452.4,-53915.21
buyer_7,Mar√≠a,56,ES20209524514523730381,TRX_N-00990-32248590,2024-04-01T14:45:18,Portugalete,incomes,salary_partner,1252.21,-52663.0
buyer_7,Mar√≠a,56,ES20209524514523730381,TRX_N-00991-32812086,2024-04-03T17:32:53,Pasaia,Expense,leisure,-25.78,-52688.78
buyer_7,Mar√≠a,56,ES20209524514523730381,TRX_N-00992-60110714,2024-04-03T04:04:45,Portugalete,Expense,cash,-100.0,-52788.78
buyer_7,Mar√≠a,56,ES20209524514523730381,TRX_N-00993-24683704,2024-04-04T05:14:34,Portugalete,expenses,mortgage,-786.19,-53574.97
buyer_7,Mar√≠a,56,ES20209524514523730381,TRX_N-00994-69164758,2024-04-04T16:13:38,Portugalete,Expense,transport,-73.77,-53648.74
buyer_7,Mar√≠a,56,ES20209524514523730381,TRX_N-00995-10403643,2024-04-05T13:10:02,Durango,Expense,food,-88.81,-53737.55
buyer_7,Mar√≠a,56,ES20209524514523730381,TRX_N-00996-94066389,2024-04-06T14:02:21,Portugalete,expenses,water,-40.88,-53778.43
buyer_7,Mar√≠a,56,ES20209524514523730381,TRX_N-00997-87397799,2024-04-07T10:29:25,Portugalete,expenses,internet,-42.0,-53820.43
buyer_7,Mar√≠a,56,ES20209524514523730381,TRX_N-00998-42930685,2024-04-08T09:48:23,Portugalete,expenses,electricity,-50.74,-53871.17
buyer_7,Mar√≠a,56,ES20209524514523730381,TRX_N-00999-96985088,2024-04-08T20:30:46,Portugalete,expenses,gas,-38.05,-53909.22
buyer_7,Mar√≠a,56,ES20209524514523730381,TRX_N-01000-59094405,2024-04-08T09:52:28,Portugalete,expenses,phone,-31.01,-53940.23
buyer_7,Mar√≠a,56,ES20209524514523730381,TRX_N-01001-75857202,2024-04-08T04:33:43,Portugalete,Expense,gifts,-374.62,-54314.85
buyer_7,Mar√≠a,56,ES20209524514523730381,TRX_N-01002-47159018,2024-04-12T15:15:29,Basauri,Expense,gifts,-267.37,-54582.22
buyer_7,Mar√≠a,56,ES20209524514523730381,TRX_N-01003-80569324,2024-04-14T08:46:12,Portugalete,Expense,cash,-100.0,-54682.22
buyer_7,Mar√≠a,56,ES20209524514523730381,TRX_N-01004-14553443,2024-04-14T23:38:43,Portugalete,Expense,travel,-1324.08,-56006.3
buyer_7,Mar√≠a,56,ES20209524514523730381,TRX_N-01005-37000641,2024-04-17T09:05:21,Hondarribia,Expense,food,-109.1,-56115.4
buyer_7,Mar√≠a,56,ES20209524514523730381,TRX_N-01006-31941120,2024-04-18T15:31:00,Portugalete,Expense,food,-116.55,-56231.95
buyer_7,Mar√≠a,56,ES20209524514523730381,TRX_N-01007-14726658,2024-04-19T08:55:51,Portugalete,Expense,food,-72.63,-56304.58
buyer_7,Mar√≠a,56,ES20209524514523730381,TRX_N-01008-17956618,2024-04-24T13:39:37,Portugalete,Expense,gifts,-548.07,-56852.65
buyer_7,Mar√≠a,56,ES20209524514523730381,TRX_N-01009-10078999,2024-04-25T21:53:26,Portugalete,Expense,cash,-100.0,-56952.65
buyer_7,Mar√≠a,56,ES20209524514523730381,TRX_N-01010-32241460,2024-04-25T09:24:06,Oy√≥n-Oion,Expense,gifts,-743.85,-57696.5
buyer_7,Mar√≠a,56,ES20209524514523730381,TRX_N-01011-16962287,2024-04-26T12:35:31,Portugalete,Expense,clothing,-47.7,-57744.2
buyer_7,Mar√≠a,56,ES20209524514523730381,TRX_N-01012-22531533,2024-04-26T17:45:19,Portugalete,Expense,repairs,-208.96,-57953.16
buyer_7,Mar√≠a,56,ES20209524514523730381,TRX_N-01013-71095342,2024-04-28T14:31:45,Portugalete,Expense,leisure,-83.01,-58036.17
buyer_7,Mar√≠a,56,ES20209524514523730381,TRX_N-01014-78734258,2024-04-28T08:30:38,Portugalete,Expense,gifts,-128.42,-58164.59
buyer_7,Mar√≠a,56,ES20209524514523730381,TRX_N-01015-46386810,2024-04-29T08:04:59,Portugalete,Expense,food,-117.19,-58281.78
buyer_7,Mar√≠a,56,ES20209524514523730381,TRX_N-01016-16560372,2024-05-01T14:50:37,Portugalete,incomes,salary,1452.4,-56829.38
buyer_7,Mar√≠a,56,ES20209524514523730381,TRX_N-01017-77230219,2024-05-01T14:50:37,Portugalete,incomes,salary_partner,1252.21,-55577.17
buyer_7,Mar√≠a,56,ES20209524514523730381,TRX_N-01018-22466275,2024-05-01T14:50:37,Portugalete,incomes,extra_income,134.71,-55442.46
buyer_7,Mar√≠a,56,ES20209524514523730381,TRX_N-01019-93950945,2024-05-01T16:29:13,Portugalete,Expense,food,-123.52,-55565.98
buyer_7,Mar√≠a,56,ES20209524514523730381,TRX_N-01020-44025060,2024-05-01T19:10:53,Santurtzi,Expense,appliances,-331.7,-55897.68
buyer_7,Mar√≠a,56,ES20209524514523730381,TRX_N-01021-12664534,2024-05-02T22:09:08,Portugalete,Expense,education,-55.91,-55953.59
buyer_7,Mar√≠a,56,ES20209524514523730381,TRX_N-01022-44468616,2024-05-03T10:34:27,Portugalete,Expense,repairs,-126.96,-56080.55
buyer_7,Mar√≠a,56,ES20209524514523730381,TRX_N-01023-05584495,2024-05-04T12:58:32,Portugalete,expenses,mortgage,-786.19,-56866.74
buyer_7,Mar√≠a,56,ES20209524514523730381,TRX_N-01024-70727742,2024-05-05T19:56:12,Portugalete,expenses,electricity,-48.3,-56915.04
buyer_7,Mar√≠a,56,ES20209524514523730381,TRX_N-01025-05106254,2024-05-06T09:25:46,Portugalete,expenses,water,-33.61,-56948.65
buyer_7,Mar√≠a,56,ES20209524514523730381,TRX_N-01026-71552828,2024-05-06T23:37:28,Portugalete,expenses,gas,-113.64,-57062.29
buyer_7,Mar√≠a,56,ES20209524514523730381,TRX_N-01027-62334328,2024-05-07T19:34:44,Llodio,Expense,cash,-100.0,-57162.29
buyer_7,Mar√≠a,56,ES20209524514523730381,TRX_N-01028-88461437,2024-05-08T09:35:17,Portugalete,expenses,phone,-34.43,-57196.72
buyer_7,Mar√≠a,56,ES20209524514523730381,TRX_N-01029-73884489,2024-05-08T22:36:06,Portugalete,expenses,internet,-42.0,-57238.72
buyer_7,Mar√≠a,56,ES20209524514523730381,TRX_N-01030-36177186,2024-05-08T10:06:44,Portugalete,Expense,transport,-73.82,-57312.54
buyer_7,Mar√≠a,56,ES20209524514523730381,TRX_N-01031-51676131,2024-05-11T10:32:27,Portugalete,Expense,leisure,-58.77,-57371.31
buyer_7,Mar√≠a,56,ES20209524514523730381,TRX_N-01032-84781175,2024-05-11T13:24:40,Amurrio,Expense,cash,-100.0,-57471.31
buyer_7,Mar√≠a,56,ES20209524514523730381,TRX_N-01033-60429125,2024-05-11T21:57:35,Portugalete,Expense,repairs,-57.17,-57528.48
buyer_7,Mar√≠a,56,ES20209524514523730381,TRX_N-01034-58547107,2024-05-12T09:30:30,Portugalete,Expense,cash,-100.0,-57628.48
buyer_7,Mar√≠a,56,ES20209524514523730381,TRX_N-01035-63604861,2024-05-13T22:16:22,Portugalete,Expense,leisure,-57.74,-57686.22
buyer_7,Mar√≠a,56,ES20209524514523730381,TRX_N-01036-77653469,2024-05-14T08:59:25,Sopela,Expense,leisure,-47.36,-57733.58
buyer_7,Mar√≠a,56,ES20209524514523730381,TRX_N-01037-24771964,2024-05-15T10:37:56,Elciego,Expense,clothing,-105.75,-57839.33
buyer_7,Mar√≠a,56,ES20209524514523730381,TRX_N-01038-19197741,2024-05-15T16:57:15,Portugalete,Expense,gifts,-384.89,-58224.22
buyer_7,Mar√≠a,56,ES20209524514523730381,TRX_N-01039-95581401,2024-05-16T18:44:01,Portugalete,Expense,transport,-74.98,-58299.2
buyer_7,Mar√≠a,56,ES20209524514523730381,TRX_N-01040-96366755,2024-05-17T01:20:21,Portugalete,Expense,cash,-100.0,-58399.2
buyer_7,Mar√≠a,56,ES20209524514523730381,TRX_N-01041-17598320,2024-05-17T14:52:44,Portugalete,Expense,repairs,-91.35,-58490.55
buyer_7,Mar√≠a,56,ES20209524514523730381,TRX_N-01042-27964466,2024-05-17T15:35:56,Portugalete,expenses,children,-262.52,-58753.07
buyer_7,Mar√≠a,56,ES20209524514523730381,TRX_N-01043-09922527,2024-05-18T17:56:40,Portugalete,Expense,food,-94.97,-58848.04
buyer_7,Mar√≠a,56,ES20209524514523730381,TRX_N-01044-90482479,2024-05-18T12:52:46,Portugalete,Expense,education,-60.61,-58908.65
buyer_7,Mar√≠a,56,ES20209524514523730381,TRX_N-01045-36158060,2024-05-19T02:48:09,Donostia,Expense,cash,-100.0,-59008.65
buyer_7,Mar√≠a,56,ES20209524514523730381,TRX_N-01046-28897949,2024-05-19T13:45:09,Portugalete,Expense,gifts,-388.46,-59397.11
buyer_7,Mar√≠a,56,ES20209524514523730381,TRX_N-01047-18304966,2024-05-20T18:29:28,Portugalete,expenses,children,-85.86,-59482.97
buyer_7,Mar√≠a,56,ES20209524514523730381,TRX_N-01048-34677115,2024-05-22T15:37:46,Portugalete,Expense,cash,-100.0,-59582.97
buyer_7,Mar√≠a,56,ES20209524514523730381,TRX_N-01049-17636864,2024-05-24T18:06:24,Portugalete,Expense,transport,-54.87,-59637.84
buyer_7,Mar√≠a,56,ES20209524514523730381,TRX_N-01050-08859190,2024-05-24T13:47:47,Portugalete,Expense,leisure,-84.56,-59722.4
buyer_7,Mar√≠a,56,ES20209524514523730381,TRX_N-01051-40285930,2024-05-26T19:43:31,Berango,Expense,food,-84.75,-59807.15
buyer_7,Mar√≠a,56,ES20209524514523730381,TRX_N-01052-59887098,2024-05-26T12:12:44,Portugalete,Expense,transport,-81.97,-59889.12
buyer_7,Mar√≠a,56,ES20209524514523730381,TRX_N-01053-53725820,2024-05-26T03:08:09,Portugalete,Expense,cash,-100.0,-59989.12
buyer_7,Mar√≠a,56,ES20209524514523730381,TRX_N-01054-13983579,2024-05-29T13:40:22,Portugalete,Expense,leisure,-66.81,-60055.93
buyer_7,Mar√≠a,56,ES20209524514523730381,TRX_N-01055-38606887,2024-05-29T23:05:12,Portugalete,Expense,gifts,-174.74,-60230.67
buyer_7,Mar√≠a,56,ES20209524514523730381,TRX_N-01056-60750997,2024-05-30T09:39:35,Galdakao,Expense,food,-78.07,-60308.74
buyer_7,Mar√≠a,56,ES20209524514523730381,TRX_N-01057-36462997,2024-05-31T13:33:05,Portugalete,Expense,healthcare,-68.11,-60376.85
buyer_7,Mar√≠a,56,ES20209524514523730381,TRX_N-01058-64305870,2024-06-01T09:44:00,Portugalete,incomes,salary,1452.4,-58924.45
buyer_7,Mar√≠a,56,ES20209524514523730381,TRX_N-01059-35043518,2024-06-01T09:44:00,Portugalete,incomes,salary_partner,1252.21,-57672.24
buyer_7,Mar√≠a,56,ES20209524514523730381,TRX_N-01060-41561908,2024-06-01T09:44:00,Portugalete,incomes,salary_bonus,1037.0,-56635.24
buyer_7,Mar√≠a,56,ES20209524514523730381,TRX_N-01061-65842773,2024-06-01T09:44:00,Portugalete,incomes,salary_partner_bonus,933.02,-55702.22
buyer_7,Mar√≠a,56,ES20209524514523730381,TRX_N-01062-01866160,2024-06-01T10:29:59,Portugalete,expenses,children,-195.12,-55897.34
buyer_7,Mar√≠a,56,ES20209524514523730381,TRX_N-01063-11377407,2024-06-02T10:09:28,Portugalete,Expense,clothing,-113.01,-56010.35
buyer_7,Mar√≠a,56,ES20209524514523730381,TRX_N-01064-73275187,2024-06-02T19:28:12,Portugalete,Expense,cash,-100.0,-56110.35
buyer_7,Mar√≠a,56,ES20209524514523730381,TRX_N-01065-57968177,2024-06-04T13:52:12,Portugalete,expenses,mortgage,-786.19,-56896.54
buyer_7,Mar√≠a,56,ES20209524514523730381,TRX_N-01066-35744933,2024-06-04T16:50:17,Portugalete,Expense,travel,-1325.79,-58222.33
buyer_7,Mar√≠a,56,ES20209524514523730381,TRX_N-01067-34297739,2024-06-05T02:08:03,Portugalete,expenses,internet,-42.0,-58264.33
buyer_7,Mar√≠a,56,ES20209524514523730381,TRX_N-01068-15306182,2024-06-05T18:55:08,Sopela,Expense,food,-68.95,-58333.28
buyer_7,Mar√≠a,56,ES20209524514523730381,TRX_N-01069-39589111,2024-06-06T17:31:52,Portugalete,expenses,water,-31.82,-58365.1
buyer_7,Mar√≠a,56,ES20209524514523730381,TRX_N-01070-08896575,2024-06-06T19:50:13,Portugalete,expenses,electricity,-66.19,-58431.29
buyer_7,Mar√≠a,56,ES20209524514523730381,TRX_N-01071-00840949,2024-06-07T11:29:26,Arrasate,Expense,food,-86.41,-58517.7
buyer_7,Mar√≠a,56,ES20209524514523730381,TRX_N-01072-20447043,2024-06-07T20:52:42,Portugalete,Expense,education,-56.98,-58574.68
buyer_7,Mar√≠a,56,ES20209524514523730381,TRX_N-01073-92564886,2024-06-07T15:06:54,Portugalete,Expense,gifts,-212.83,-58787.51
buyer_7,Mar√≠a,56,ES20209524514523730381,TRX_N-01074-61997872,2024-06-08T20:04:21,Portugalete,expenses,gas,-58.86,-58846.37
buyer_7,Mar√≠a,56,ES20209524514523730381,TRX_N-01075-29201524,2024-06-08T20:20:32,Portugalete,expenses,phone,-43.31,-58889.68
buyer_7,Mar√≠a,56,ES20209524514523730381,TRX_N-01076-70947937,2024-06-08T21:30:17,Portugalete,Expense,food,-90.91,-58980.59
buyer_7,Mar√≠a,56,ES20209524514523730381,TRX_N-01077-62060002,2024-06-10T16:26:39,Portugalete,Expense,cash,-100.0,-59080.59
buyer_7,Mar√≠a,56,ES20209524514523730381,TRX_N-01078-60028229,2024-06-14T20:58:23,Portugalete,Expense,education,-54.33,-59134.92
buyer_7,Mar√≠a,56,ES20209524514523730381,TRX_N-01079-38964435,2024-06-15T21:36:03,Zarautz,Expense,travel,-1445.21,-60580.13
buyer_7,Mar√≠a,56,ES20209524514523730381,TRX_N-01080-47564986,2024-06-16T15:08:28,Portugalete,Expense,food,-77.34,-60657.47
buyer_7,Mar√≠a,56,ES20209524514523730381,TRX_N-01081-32519694,2024-06-17T19:36:10,Portugalete,Expense,healthcare,-56.55,-60714.02
buyer_7,Mar√≠a,56,ES20209524514523730381,TRX_N-01082-58772722,2024-06-19T12:07:16,Portugalete,Expense,leisure,-46.26,-60760.28
buyer_7,Mar√≠a,56,ES20209524514523730381,TRX_N-01083-59351787,2024-06-20T01:30:18,Portugalete,Expense,food,-66.1,-60826.38
buyer_7,Mar√≠a,56,ES20209524514523730381,TRX_N-01084-55686664,2024-06-20T01:48:53,Errenteria,Expense,repairs,-208.71,-61035.09
buyer_7,Mar√≠a,56,ES20209524514523730381,TRX_N-01085-91890381,2024-06-23T08:04:13,Portugalete,Expense,appliances,-179.66,-61214.75
buyer_7,Mar√≠a,56,ES20209524514523730381,TRX_N-01086-73742385,2024-06-25T02:39:57,Portugalete,Expense,appliances,-113.52,-61328.27
buyer_7,Mar√≠a,56,ES20209524514523730381,TRX_N-01087-12829290,2024-06-25T14:18:31,Durango,Expense,repairs,-306.99,-61635.26
buyer_7,Mar√≠a,56,ES20209524514523730381,TRX_N-01088-66265088,2024-06-29T08:53:51,Portugalete,Expense,food,-92.4,-61727.66
buyer_7,Mar√≠a,56,ES20209524514523730381,TRX_N-01089-15235712,2024-06-30T19:41:13,Labastida,Expense,leisure,-43.09,-61770.75
buyer_7,Mar√≠a,56,ES20209524514523730381,TRX_N-01090-55671990,2024-07-01T20:04:00,Portugalete,incomes,salary,1452.4,-60318.35
buyer_7,Mar√≠a,56,ES20209524514523730381,TRX_N-01091-80158732,2024-07-01T20:04:00,Portugalete,incomes,salary_partner,1252.21,-59066.14
buyer_7,Mar√≠a,56,ES20209524514523730381,TRX_N-01092-02828807,2024-07-01T12:08:17,Elciego,Expense,gifts,-677.41,-59743.55
buyer_7,Mar√≠a,56,ES20209524514523730381,TRX_N-01093-11557409,2024-07-02T16:56:27,Portugalete,Expense,transport,-46.2,-59789.75
buyer_7,Mar√≠a,56,ES20209524514523730381,TRX_N-01094-61996875,2024-07-03T17:19:13,Galdakao,Expense,cash,-100.0,-59889.75
buyer_7,Mar√≠a,56,ES20209524514523730381,TRX_N-01095-68052824,2024-07-04T18:05:59,Portugalete,expenses,mortgage,-786.19,-60675.94
buyer_7,Mar√≠a,56,ES20209524514523730381,TRX_N-01096-60925960,2024-07-05T11:16:44,Portugalete,expenses,water,-43.12,-60719.06
buyer_7,Mar√≠a,56,ES20209524514523730381,TRX_N-01097-05588737,2024-07-05T16:35:51,Portugalete,expenses,gas,-80.02,-60799.08
buyer_7,Mar√≠a,56,ES20209524514523730381,TRX_N-01098-92463364,2024-07-05T09:52:52,Portugalete,Expense,food,-106.61,-60905.69
buyer_7,Mar√≠a,56,ES20209524514523730381,TRX_N-01099-29941603,2024-07-05T00:44:15,Portugalete,Expense,cash,-100.0,-61005.69
buyer_7,Mar√≠a,56,ES20209524514523730381,TRX_N-01100-23597782,2024-07-06T17:33:57,Portugalete,expenses,phone,-37.06,-61042.75
buyer_7,Mar√≠a,56,ES20209524514523730381,TRX_N-01101-92650815,2024-07-06T18:55:36,Portugalete,Expense,transport,-57.03,-61099.78
buyer_7,Mar√≠a,56,ES20209524514523730381,TRX_N-01102-64773318,2024-07-07T22:25:28,Portugalete,expenses,internet,-42.0,-61141.78
buyer_7,Mar√≠a,56,ES20209524514523730381,TRX_N-01103-61265622,2024-07-07T10:37:11,Portugalete,Expense,repairs,-218.25,-61360.03
buyer_7,Mar√≠a,56,ES20209524514523730381,TRX_N-01104-73030854,2024-07-08T10:34:59,Portugalete,expenses,electricity,-24.35,-61384.38
buyer_7,Mar√≠a,56,ES20209524514523730381,TRX_N-01105-05057383,2024-07-11T09:05:42,Portugalete,Expense,transport,-47.56,-61431.94
buyer_7,Mar√≠a,56,ES20209524514523730381,TRX_N-01106-21866896,2024-07-13T10:50:21,Leioa,Expense,food,-91.09,-61523.03
buyer_7,Mar√≠a,56,ES20209524514523730381,TRX_N-01107-35916789,2024-07-13T14:49:30,Portugalete,Expense,transport,-81.5,-61604.53
buyer_7,Mar√≠a,56,ES20209524514523730381,TRX_N-01108-33595341,2024-07-13T19:35:57,Portugalete,Expense,gifts,-674.92,-62279.45
buyer_7,Mar√≠a,56,ES20209524514523730381,TRX_N-01109-00307636,2024-07-16T01:29:03,Portugalete,Expense,healthcare,-107.5,-62386.95
buyer_7,Mar√≠a,56,ES20209524514523730381,TRX_N-01110-18342112,2024-07-17T05:12:18,Zarautz,Expense,food,-93.78,-62480.73
buyer_7,Mar√≠a,56,ES20209524514523730381,TRX_N-01111-20712276,2024-07-17T21:43:55,Basauri,Expense,leisure,-31.74,-62512.47
buyer_7,Mar√≠a,56,ES20209524514523730381,TRX_N-01112-22510504,2024-07-17T23:21:17,Portugalete,Expense,travel,-1454.13,-63966.6
buyer_7,Mar√≠a,56,ES20209524514523730381,TRX_N-01113-97567361,2024-07-18T19:44:53,Basauri,Expense,cash,-100.0,-64066.6
buyer_7,Mar√≠a,56,ES20209524514523730381,TRX_N-01114-46831115,2024-07-18T23:40:00,Portugalete,Expense,repairs,-101.69,-64168.29
buyer_7,Mar√≠a,56,ES20209524514523730381,TRX_N-01115-29382966,2024-07-18T17:37:38,Portugalete,Expense,gifts,-729.07,-64897.36
buyer_7,Mar√≠a,56,ES20209524514523730381,TRX_N-01116-93500697,2024-07-19T19:14:10,Portugalete,Expense,food,-113.0,-65010.36
buyer_7,Mar√≠a,56,ES20209524514523730381,TRX_N-01117-99325722,2024-07-19T17:42:29,Portugalete,Expense,clothing,-102.56,-65112.92
buyer_7,Mar√≠a,56,ES20209524514523730381,TRX_N-01118-18143903,2024-07-19T19:53:43,Elciego,Expense,cash,-100.0,-65212.92
buyer_7,Mar√≠a,56,ES20209524514523730381,TRX_N-01119-02805050,2024-07-19T04:04:11,Portugalete,expenses,children,-83.61,-65296.53
buyer_7,Mar√≠a,56,ES20209524514523730381,TRX_N-01120-64224033,2024-07-20T22:00:36,Portugalete,Expense,leisure,-78.73,-65375.26
buyer_7,Mar√≠a,56,ES20209524514523730381,TRX_N-01121-21987326,2024-07-21T19:46:00,Portugalete,expenses,children,-109.04,-65484.3
buyer_7,Mar√≠a,56,ES20209524514523730381,TRX_N-01122-07647250,2024-07-24T10:45:52,Portugalete,Expense,cash,-100.0,-65584.3
buyer_7,Mar√≠a,56,ES20209524514523730381,TRX_N-01123-91040323,2024-07-25T08:56:48,Portugalete,Expense,education,-53.17,-65637.47
buyer_7,Mar√≠a,56,ES20209524514523730381,TRX_N-01124-21900042,2024-07-26T16:16:11,Donostia,Expense,transport,-48.41,-65685.88
buyer_7,Mar√≠a,56,ES20209524514523730381,TRX_N-01125-69946968,2024-07-27T10:32:19,Portugalete,Expense,food,-67.34,-65753.22
buyer_7,Mar√≠a,56,ES20209524514523730381,TRX_N-01126-62661707,2024-07-27T17:33:49,Hondarribia,Expense,healthcare,-113.22,-65866.44
buyer_7,Mar√≠a,56,ES20209524514523730381,TRX_N-01127-82781834,2024-07-28T18:21:39,Portugalete,Expense,food,-105.72,-65972.16
buyer_7,Mar√≠a,56,ES20209524514523730381,TRX_N-01128-43797352,2024-07-28T11:16:56,Portugalete,Expense,healthcare,-188.14,-66160.3
buyer_7,Mar√≠a,56,ES20209524514523730381,TRX_N-01129-62385930,2024-07-29T08:18:19,Getxo,Expense,food,-104.57,-66264.87
buyer_7,Mar√≠a,56,ES20209524514523730381,TRX_N-01130-85942676,2024-07-29T12:30:22,Portugalete,Expense,leisure,-59.57,-66324.44
buyer_7,Mar√≠a,56,ES20209524514523730381,TRX_N-01131-38022815,2024-07-30T12:15:18,Portugalete,Expense,transport,-52.17,-66376.61
buyer_7,Mar√≠a,56,ES20209524514523730381,TRX_N-01132-13717890,2024-07-30T12:59:41,Portugalete,Expense,leisure,-50.47,-66427.08
buyer_7,Mar√≠a,56,ES20209524514523730381,TRX_N-01133-76283198,2024-07-31T14:42:41,Portugalete,Expense,food,-114.92,-66542.0
buyer_7,Mar√≠a,56,ES20209524514523730381,TRX_N-01134-56009601,2024-08-01T12:03:03,Portugalete,incomes,salary,1452.4,-65089.6
buyer_7,Mar√≠a,56,ES20209524514523730381,TRX_N-01135-00380438,2024-08-01T12:03:03,Portugalete,incomes,salary_partner,1252.21,-63837.39
buyer_7,Mar√≠a,56,ES20209524514523730381,TRX_N-01136-11010681,2024-08-02T14:48:20,Portugalete,Expense,leisure,-66.75,-63904.14
buyer_7,Mar√≠a,56,ES20209524514523730381,TRX_N-01137-75817839,2024-08-02T15:42:16,Portugalete,Expense,gifts,-526.07,-64430.21
buyer_7,Mar√≠a,56,ES20209524514523730381,TRX_N-01138-38491574,2024-08-02T08:25:17,Portugalete,expenses,children,-144.47,-64574.68
buyer_7,Mar√≠a,56,ES20209524514523730381,TRX_N-01139-36455717,2024-08-03T09:09:39,Portugalete,Expense,travel,-684.55,-65259.23
buyer_7,Mar√≠a,56,ES20209524514523730381,TRX_N-01140-58345829,2024-08-04T12:58:44,Portugalete,expenses,mortgage,-786.19,-66045.42
buyer_7,Mar√≠a,56,ES20209524514523730381,TRX_N-01141-66464244,2024-08-05T10:42:05,Portugalete,expenses,electricity,-36.72,-66082.14
buyer_7,Mar√≠a,56,ES20209524514523730381,TRX_N-01142-87548526,2024-08-05T15:18:17,Portugalete,expenses,phone,-36.32,-66118.46
buyer_7,Mar√≠a,56,ES20209524514523730381,TRX_N-01143-80718567,2024-08-05T21:44:10,Portugalete,Expense,travel,-1848.55,-67967.01
buyer_7,Mar√≠a,56,ES20209524514523730381,TRX_N-01144-79940433,2024-08-06T17:23:02,Portugalete,expenses,internet,-42.0,-68009.01
buyer_7,Mar√≠a,56,ES20209524514523730381,TRX_N-01145-63406178,2024-08-06T10:51:12,Portugalete,Expense,food,-91.7,-68100.71
buyer_7,Mar√≠a,56,ES20209524514523730381,TRX_N-01146-28408001,2024-08-07T23:15:50,Portugalete,Expense,education,-52.12,-68152.83
buyer_7,Mar√≠a,56,ES20209524514523730381,TRX_N-01147-96481646,2024-08-08T10:29:16,Portugalete,expenses,water,-39.99,-68192.82
buyer_7,Mar√≠a,56,ES20209524514523730381,TRX_N-01148-15486129,2024-08-08T09:29:32,Portugalete,expenses,gas,-59.76,-68252.58
buyer_7,Mar√≠a,56,ES20209524514523730381,TRX_N-01149-53169268,2024-08-10T14:59:30,Portugalete,Expense,transport,-68.11,-68320.69
buyer_7,Mar√≠a,56,ES20209524514523730381,TRX_N-01150-09733765,2024-08-13T18:01:49,Santurtzi,Expense,education,-68.5,-68389.19
buyer_7,Mar√≠a,56,ES20209524514523730381,TRX_N-01151-20659630,2024-08-14T12:52:56,Portugalete,Expense,food,-111.8,-68500.99
buyer_7,Mar√≠a,56,ES20209524514523730381,TRX_N-01152-36425460,2024-08-14T07:09:04,Portugalete,Expense,cash,-100.0,-68600.99
buyer_7,Mar√≠a,56,ES20209524514523730381,TRX_N-01153-52392936,2024-08-14T05:26:57,Portugalete,Expense,gifts,-573.26,-69174.25
buyer_7,Mar√≠a,56,ES20209524514523730381,TRX_N-01154-70238722,2024-08-15T00:48:59,Portugalete,Expense,gifts,-784.91,-69959.16
buyer_7,Mar√≠a,56,ES20209524514523730381,TRX_N-01155-19060248,2024-08-17T15:16:19,Portugalete,Expense,transport,-53.4,-70012.56
buyer_7,Mar√≠a,56,ES20209524514523730381,TRX_N-01156-37844348,2024-08-19T22:41:58,Bilbao,Expense,leisure,-36.25,-70048.81
buyer_7,Mar√≠a,56,ES20209524514523730381,TRX_N-01157-04395200,2024-08-19T11:56:57,Portugalete,Expense,cash,-100.0,-70148.81
buyer_7,Mar√≠a,56,ES20209524514523730381,TRX_N-01158-21596618,2024-08-20T18:07:12,Portugalete,Expense,food,-105.14,-70253.95
buyer_7,Mar√≠a,56,ES20209524514523730381,TRX_N-01159-17103081,2024-08-20T18:34:53,Portugalete,Expense,repairs,-177.63,-70431.58
buyer_7,Mar√≠a,56,ES20209524514523730381,TRX_N-01160-68788479,2024-08-22T09:49:26,Portugalete,Expense,healthcare,-102.03,-70533.61
buyer_7,Mar√≠a,56,ES20209524514523730381,TRX_N-01161-32306662,2024-08-22T09:08:32,Barakaldo,Expense,gifts,-268.58,-70802.19
buyer_7,Mar√≠a,56,ES20209524514523730381,TRX_N-01162-12521063,2024-08-22T23:51:49,Portugalete,expenses,children,-62.5,-70864.69
buyer_7,Mar√≠a,56,ES20209524514523730381,TRX_N-01163-79873959,2024-08-25T14:54:25,Portugalete,Expense,leisure,-38.99,-70903.68
buyer_7,Mar√≠a,56,ES20209524514523730381,TRX_N-01164-48966644,2024-08-25T19:08:47,Portugalete,Expense,cash,-100.0,-71003.68
buyer_7,Mar√≠a,56,ES20209524514523730381,TRX_N-01165-68177105,2024-08-25T15:56:28,Portugalete,Expense,appliances,-299.71,-71303.39
buyer_7,Mar√≠a,56,ES20209524514523730381,TRX_N-01166-07785758,2024-08-26T15:32:24,Vitoria-Gasteiz,Expense,food,-101.84,-71405.23
buyer_7,Mar√≠a,56,ES20209524514523730381,TRX_N-01167-71131201,2024-08-27T17:14:20,Elciego,Expense,food,-114.5,-71519.73
buyer_7,Mar√≠a,56,ES20209524514523730381,TRX_N-01168-67865513,2024-08-27T18:46:46,Portugalete,Expense,transport,-60.92,-71580.65
buyer_7,Mar√≠a,56,ES20209524514523730381,TRX_N-01169-30567476,2024-08-27T20:29:37,Portugalete,Expense,education,-42.19,-71622.84
buyer_7,Mar√≠a,56,ES20209524514523730381,TRX_N-01170-56129928,2024-08-28T10:37:18,Portugalete,Expense,clothing,-131.37,-71754.21
buyer_7,Mar√≠a,56,ES20209524514523730381,TRX_N-01171-63171471,2024-08-29T06:13:35,Portugalete,Expense,leisure,-44.19,-71798.4
buyer_7,Mar√≠a,56,ES20209524514523730381,TRX_N-01172-24558016,2024-08-29T18:56:43,Getxo,Expense,cash,-100.0,-71898.4
buyer_7,Mar√≠a,56,ES20209524514523730381,TRX_N-01173-57661963,2024-08-30T01:01:01,Portugalete,Expense,cash,-100.0,-71998.4
buyer_7,Mar√≠a,56,ES20209524514523730381,TRX_N-01174-40784932,2024-08-31T22:04:56,Portugalete,Expense,leisure,-80.43,-72078.83
buyer_7,Mar√≠a,56,ES20209524514523730381,TRX_N-01175-13562919,2024-08-31T20:20:10,Elciego,Expense,travel,-636.98,-72715.81
buyer_7,Mar√≠a,56,ES20209524514523730381,TRX_N-01176-79747244,2024-08-31T17:06:50,Portugalete,Expense,repairs,-212.61,-72928.42
buyer_7,Mar√≠a,56,ES20209524514523730381,TRX_N-01177-16528170,2024-09-01T14:41:35,Portugalete,incomes,salary,1452.4,-71476.02
buyer_7,Mar√≠a,56,ES20209524514523730381,TRX_N-01178-43741323,2024-09-01T14:41:35,Portugalete,incomes,salary_partner,1252.21,-70223.81
buyer_7,Mar√≠a,56,ES20209524514523730381,TRX_N-01179-96457844,2024-09-01T14:41:35,Portugalete,incomes,extra_income,134.71,-70089.1
buyer_7,Mar√≠a,56,ES20209524514523730381,TRX_N-01180-00485536,2024-09-01T17:00:58,Portugalete,Expense,food,-113.64,-70202.74
buyer_7,Mar√≠a,56,ES20209524514523730381,TRX_N-01181-12650520,2024-09-03T01:20:35,Portugalete,Expense,cash,-100.0,-70302.74
buyer_7,Mar√≠a,56,ES20209524514523730381,TRX_N-01182-05125126,2024-09-04T10:05:19,Portugalete,expenses,mortgage,-786.19,-71088.93
buyer_7,Mar√≠a,56,ES20209524514523730381,TRX_N-01183-96369073,2024-09-04T06:37:51,Basauri,Expense,cash,-100.0,-71188.93
buyer_7,Mar√≠a,56,ES20209524514523730381,TRX_N-01184-83773234,2024-09-05T07:29:25,Portugalete,expenses,electricity,-20.41,-71209.34
buyer_7,Mar√≠a,56,ES20209524514523730381,TRX_N-01185-23588957,2024-09-06T00:59:22,Portugalete,expenses,gas,-93.54,-71302.88
buyer_7,Mar√≠a,56,ES20209524514523730381,TRX_N-01186-91241637,2024-09-06T14:30:04,Portugalete,expenses,internet,-42.0,-71344.88
buyer_7,Mar√≠a,56,ES20209524514523730381,TRX_N-01187-20114155,2024-09-07T10:40:11,Portugalete,expenses,phone,-38.55,-71383.43
buyer_7,Mar√≠a,56,ES20209524514523730381,TRX_N-01188-52724635,2024-09-07T15:01:50,Portugalete,expenses,children,-195.3,-71578.73
buyer_7,Mar√≠a,56,ES20209524514523730381,TRX_N-01189-46898106,2024-09-08T05:18:54,Portugalete,expenses,water,-43.21,-71621.94
buyer_7,Mar√≠a,56,ES20209524514523730381,TRX_N-01190-13215175,2024-09-09T13:30:53,Portugalete,Expense,repairs,-101.59,-71723.53
buyer_7,Mar√≠a,56,ES20209524514523730381,TRX_N-01191-08852657,2024-09-10T18:05:45,Berango,Expense,education,-66.14,-71789.67
buyer_7,Mar√≠a,56,ES20209524514523730381,TRX_N-01192-02230930,2024-09-12T08:02:05,Portugalete,Expense,food,-104.19,-71893.86
buyer_7,Mar√≠a,56,ES20209524514523730381,TRX_N-01193-51395146,2024-09-13T04:25:21,Portugalete,Expense,cash,-100.0,-71993.86
buyer_7,Mar√≠a,56,ES20209524514523730381,TRX_N-01194-66406289,2024-09-14T19:46:07,Portugalete,Expense,cash,-100.0,-72093.86
buyer_7,Mar√≠a,56,ES20209524514523730381,TRX_N-01195-60224593,2024-09-16T12:11:36,Durango,Expense,appliances,-386.47,-72480.33
buyer_7,Mar√≠a,56,ES20209524514523730381,TRX_N-01196-79596194,2024-09-17T14:28:30,Portugalete,Expense,transport,-51.08,-72531.41
buyer_7,Mar√≠a,56,ES20209524514523730381,TRX_N-01197-43876766,2024-09-17T08:36:50,Portugalete,Expense,repairs,-210.23,-72741.64
buyer_7,Mar√≠a,56,ES20209524514523730381,TRX_N-01198-76135090,2024-09-17T22:15:08,Portugalete,expenses,children,-114.43,-72856.07
buyer_7,Mar√≠a,56,ES20209524514523730381,TRX_N-01199-63228827,2024-09-20T14:34:11,Portugalete,Expense,leisure,-52.04,-72908.11
buyer_7,Mar√≠a,56,ES20209524514523730381,TRX_N-01200-71128060,2024-09-20T11:15:38,Portugalete,Expense,cash,-100.0,-73008.11
buyer_7,Mar√≠a,56,ES20209524514523730381,TRX_N-01201-91445757,2024-09-24T18:16:42,Basauri,Expense,transport,-45.76,-73053.87
buyer_7,Mar√≠a,56,ES20209524514523730381,TRX_N-01202-67541726,2024-09-24T00:56:16,Portugalete,Expense,clothing,-98.0,-73151.87
buyer_7,Mar√≠a,56,ES20209524514523730381,TRX_N-01203-25490273,2024-09-26T23:05:51,Portugalete,Expense,cash,-100.0,-73251.87
buyer_7,Mar√≠a,56,ES20209524514523730381,TRX_N-01204-28753740,2024-09-26T13:28:53,Portugalete,Expense,travel,-1683.67,-74935.54
buyer_7,Mar√≠a,56,ES20209524514523730381,TRX_N-01205-01139313,2024-09-27T20:50:44,Portugalete,expenses,children,-178.28,-75113.82
buyer_7,Mar√≠a,56,ES20209524514523730381,TRX_N-01206-49591677,2024-09-28T18:09:26,Portugalete,Expense,repairs,-274.96,-75388.78
buyer_7,Mar√≠a,56,ES20209524514523730381,TRX_N-01207-13867123,2024-09-28T10:51:37,Portugalete,Expense,gifts,-61.03,-75449.81
buyer_7,Mar√≠a,56,ES20209524514523730381,TRX_N-01208-37287664,2024-10-01T14:27:06,Portugalete,incomes,salary,1452.4,-73997.41
buyer_7,Mar√≠a,56,ES20209524514523730381,TRX_N-01209-46521456,2024-10-01T14:27:06,Portugalete,incomes,salary_partner,1252.21,-72745.2
buyer_7,Mar√≠a,56,ES20209524514523730381,TRX_N-01210-44928716,2024-10-01T21:43:42,Portugalete,Expense,food,-107.84,-72853.04
buyer_7,Mar√≠a,56,ES20209524514523730381,TRX_N-01211-94139823,2024-10-01T12:30:30,Portugalete,Expense,leisure,-72.07,-72925.11
buyer_7,Mar√≠a,56,ES20209524514523730381,TRX_N-01212-43521411,2024-10-02T08:12:21,Portugalete,Expense,transport,-88.84,-73013.95
buyer_7,Mar√≠a,56,ES20209524514523730381,TRX_N-01213-01295996,2024-10-02T11:35:58,Portugalete,expenses,children,-191.54,-73205.49
buyer_7,Mar√≠a,56,ES20209524514523730381,TRX_N-01214-32004132,2024-10-04T19:24:55,Portugalete,expenses,mortgage,-786.19,-73991.68
buyer_7,Mar√≠a,56,ES20209524514523730381,TRX_N-01215-88194749,2024-10-05T23:15:37,Portugalete,expenses,water,-26.46,-74018.14
buyer_7,Mar√≠a,56,ES20209524514523730381,TRX_N-01216-90911927,2024-10-05T17:40:29,Portugalete,expenses,phone,-44.21,-74062.35
buyer_7,Mar√≠a,56,ES20209524514523730381,TRX_N-01217-45940000,2024-10-06T00:18:40,Portugalete,expenses,internet,-42.0,-74104.35
buyer_7,Mar√≠a,56,ES20209524514523730381,TRX_N-01218-19939424,2024-10-07T22:05:47,Portugalete,expenses,electricity,-84.1,-74188.45
buyer_7,Mar√≠a,56,ES20209524514523730381,TRX_N-01219-75210384,2024-10-08T23:23:44,Portugalete,expenses,gas,-85.75,-74274.2
buyer_8,Antonio,45,ES45209530357850307003,TRX_N-00001-87005460,2022-01-01T12:19:27,Labastida,incomes,salary,1267.57,2891.26
buyer_8,Antonio,45,ES45209530357850307003,TRX_N-00002-24610452,2022-01-01T12:19:27,Labastida,incomes,salary_partner,1586.78,4478.04
buyer_8,Antonio,45,ES45209530357850307003,TRX_N-00003-17647399,2022-01-01T10:00:56,Labastida,expenses,children,-161.98,4316.06
buyer_8,Antonio,45,ES45209530357850307003,TRX_N-00004-85849664,2022-01-02T05:52:02,Labastida,Expense,transport,-77.63,4238.43
buyer_8,Antonio,45,ES45209530357850307003,TRX_N-00005-70875379,2022-01-03T09:50:28,Labastida,Expense,food,-123.51,4114.92
buyer_8,Antonio,45,ES45209530357850307003,TRX_N-00006-03336258,2022-01-04T08:52:59,Labastida,expenses,mortgage,-887.59,3227.33
buyer_8,Antonio,45,ES45209530357850307003,TRX_N-00007-87334902,2022-01-04T19:18:05,Llodio,Expense,transport,-58.25,3169.08
buyer_8,Antonio,45,ES45209530357850307003,TRX_N-00008-22580625,2022-01-05T08:41:40,Labastida,expenses,internet,-42.0,3127.08
buyer_8,Antonio,45,ES45209530357850307003,TRX_N-00009-50075794,2022-01-05T20:14:44,Labastida,Expense,leisure,-29.71,3097.37
buyer_8,Antonio,45,ES45209530357850307003,TRX_N-00010-44114045,2022-01-05T17:21:17,Labastida,Expense,cash,-100.0,2997.37
buyer_8,Antonio,45,ES45209530357850307003,TRX_N-00011-28044489,2022-01-06T04:56:14,Labastida,Expense,transport,-74.92,2922.45
buyer_8,Antonio,45,ES45209530357850307003,TRX_N-00012-02430299,2022-01-07T20:59:42,Labastida,expenses,electricity,-24.92,2897.53
buyer_8,Antonio,45,ES45209530357850307003,TRX_N-00013-58918930,2022-01-08T17:09:06,Labastida,expenses,water,-26.56,2870.97
buyer_8,Antonio,45,ES45209530357850307003,TRX_N-00014-84514620,2022-01-08T23:09:36,Labastida,expenses,gas,-94.79,2776.18
buyer_8,Antonio,45,ES45209530357850307003,TRX_N-00015-05066689,2022-01-08T11:06:19,Labastida,expenses,phone,-40.68,2735.5
buyer_8,Antonio,45,ES45209530357850307003,TRX_N-00016-01983537,2022-01-08T14:21:28,Labastida,Expense,leisure,-54.63,2680.87
buyer_8,Antonio,45,ES45209530357850307003,TRX_N-00017-56487027,2022-01-08T09:36:55,Labastida,Expense,cash,-100.0,2580.87
buyer_8,Antonio,45,ES45209530357850307003,TRX_N-00018-32885583,2022-01-09T10:17:39,Labastida,Expense,cash,-100.0,2480.87
buyer_8,Antonio,45,ES45209530357850307003,TRX_N-00019-27501314,2022-01-10T19:48:04,Labastida,Expense,clothing,-61.0,2419.87
buyer_8,Antonio,45,ES45209530357850307003,TRX_N-00020-14312701,2022-01-11T15:18:10,Labastida,Expense,cash,-100.0,2319.87
buyer_8,Antonio,45,ES45209530357850307003,TRX_N-00021-80302556,2022-01-14T11:44:32,Labastida,Expense,food,-93.67,2226.2
buyer_8,Antonio,45,ES45209530357850307003,TRX_N-00022-92670343,2022-01-14T10:38:12,Labastida,Expense,cash,-100.0,2126.2
buyer_8,Antonio,45,ES45209530357850307003,TRX_N-00023-94770613,2022-01-16T11:21:52,Labastida,Expense,clothing,-45.78,2080.42
buyer_8,Antonio,45,ES45209530357850307003,TRX_N-00024-10453212,2022-01-17T15:29:18,Berango,Expense,repairs,-92.11,1988.31
buyer_8,Antonio,45,ES45209530357850307003,TRX_N-00025-66297373,2022-01-20T11:58:25,Labastida,Expense,food,-89.32,1898.99
buyer_8,Antonio,45,ES45209530357850307003,TRX_N-00026-78674674,2022-01-20T17:08:40,Labastida,Expense,leisure,-27.6,1871.39
buyer_8,Antonio,45,ES45209530357850307003,TRX_N-00027-04328574,2022-01-20T11:14:56,Labastida,Expense,clothing,-152.92,1718.47
buyer_8,Antonio,45,ES45209530357850307003,TRX_N-00028-52756778,2022-01-21T22:51:01,Portugalete,Expense,cash,-100.0,1618.47
buyer_8,Antonio,45,ES45209530357850307003,TRX_N-00029-25052545,2022-01-22T15:40:46,Labastida,Expense,food,-114.82,1503.65
buyer_8,Antonio,45,ES45209530357850307003,TRX_N-00030-52096092,2022-01-23T11:38:52,Labastida,Expense,food,-114.07,1389.58
buyer_8,Antonio,45,ES45209530357850307003,TRX_N-00031-38535791,2022-01-24T19:39:29,Labastida,Expense,cash,-100.0,1289.58
buyer_8,Antonio,45,ES45209530357850307003,TRX_N-00032-03418501,2022-01-25T22:36:36,Labastida,Expense,food,-102.84,1186.74
buyer_8,Antonio,45,ES45209530357850307003,TRX_N-00033-62426833,2022-01-25T22:03:14,Labastida,Expense,clothing,-127.72,1059.02
buyer_8,Antonio,45,ES45209530357850307003,TRX_N-00034-86657820,2022-01-25T22:30:04,Labastida,Expense,education,-62.38,996.64
buyer_8,Antonio,45,ES45209530357850307003,TRX_N-00035-92210511,2022-01-25T17:57:44,Labastida,Expense,cash,-100.0,896.64
buyer_8,Antonio,45,ES45209530357850307003,TRX_N-00036-86707085,2022-01-25T08:38:24,Irun,Expense,appliances,-319.7,576.94
buyer_8,Antonio,45,ES45209530357850307003,TRX_N-00037-72596302,2022-01-27T20:23:53,Barakaldo,Expense,gifts,-221.81,355.13
buyer_8,Antonio,45,ES45209530357850307003,TRX_N-00038-78029300,2022-01-29T22:42:12,Andoain,Expense,repairs,-181.45,173.68
buyer_8,Antonio,45,ES45209530357850307003,TRX_N-00039-58106781,2022-01-29T16:09:17,Labastida,Expense,gifts,-840.68,-667.0
buyer_8,Antonio,45,ES45209530357850307003,TRX_N-00040-02910722,2022-01-30T18:58:58,Labastida,Expense,clothing,-137.85,-804.85
buyer_8,Antonio,45,ES45209530357850307003,TRX_N-00041-13094780,2022-02-01T19:09:32,Labastida,incomes,salary,1267.57,462.72
buyer_8,Antonio,45,ES45209530357850307003,TRX_N-00042-24990150,2022-02-01T19:09:32,Labastida,incomes,salary_partner,1586.78,2049.5
buyer_8,Antonio,45,ES45209530357850307003,TRX_N-00043-90765014,2022-02-01T09:03:11,Labastida,Expense,repairs,-299.69,1749.81
buyer_8,Antonio,45,ES45209530357850307003,TRX_N-00044-15793721,2022-02-03T16:29:58,Pasaia,Expense,clothing,-65.24,1684.57
buyer_8,Antonio,45,ES45209530357850307003,TRX_N-00045-27256453,2022-02-03T11:10:04,Labastida,Expense,gifts,-147.69,1536.88
buyer_8,Antonio,45,ES45209530357850307003,TRX_N-00046-03473535,2022-02-04T12:59:45,Labastida,expenses,mortgage,-887.59,649.29
buyer_8,Antonio,45,ES45209530357850307003,TRX_N-00047-15864789,2022-02-04T12:48:34,Labastida,Expense,leisure,-41.46,607.83
buyer_8,Antonio,45,ES45209530357850307003,TRX_N-00048-82868972,2022-02-05T21:23:41,Labastida,expenses,electricity,-66.06,541.77
buyer_8,Antonio,45,ES45209530357850307003,TRX_N-00049-58324742,2022-02-05T20:57:23,Labastida,expenses,internet,-42.0,499.77
buyer_8,Antonio,45,ES45209530357850307003,TRX_N-00050-12544065,2022-02-07T14:59:44,Labastida,expenses,water,-32.28,467.49
buyer_8,Antonio,45,ES45209530357850307003,TRX_N-00051-76882473,2022-02-07T12:02:43,Labastida,Expense,cash,-100.0,367.49
buyer_8,Antonio,45,ES45209530357850307003,TRX_N-00052-65877871,2022-02-08T07:28:56,Labastida,expenses,gas,-41.74,325.75
buyer_8,Antonio,45,ES45209530357850307003,TRX_N-00053-22348442,2022-02-08T12:59:11,Labastida,expenses,phone,-33.9,291.85
buyer_8,Antonio,45,ES45209530357850307003,TRX_N-00054-01349842,2022-02-08T18:40:07,Labastida,expenses,children,-196.8,95.05
buyer_8,Antonio,45,ES45209530357850307003,TRX_N-00055-84395870,2022-02-09T14:15:15,Labastida,Expense,leisure,-65.12,29.93
buyer_8,Antonio,45,ES45209530357850307003,TRX_N-00056-74462312,2022-02-09T23:03:23,Barakaldo,Expense,clothing,-128.8,-98.87
buyer_8,Antonio,45,ES45209530357850307003,TRX_N-00057-57154473,2022-02-10T21:16:05,Durango,Expense,transport,-71.8,-170.67
buyer_8,Antonio,45,ES45209530357850307003,TRX_N-00058-61629460,2022-02-10T17:13:56,Labastida,Expense,repairs,-221.24,-391.91
buyer_8,Antonio,45,ES45209530357850307003,TRX_N-00059-60654823,2022-02-11T22:26:42,Labastida,Expense,food,-74.35,-466.26
buyer_8,Antonio,45,ES45209530357850307003,TRX_N-00060-31306035,2022-02-11T17:36:16,Labastida,Expense,cash,-100.0,-566.26
buyer_8,Antonio,45,ES45209530357850307003,TRX_N-00061-88229290,2022-02-13T10:32:32,Labastida,Expense,cash,-100.0,-666.26
buyer_8,Antonio,45,ES45209530357850307003,TRX_N-00062-72024727,2022-02-14T18:10:41,Labastida,Expense,food,-82.38,-748.64
buyer_8,Antonio,45,ES45209530357850307003,TRX_N-00063-27893364,2022-02-14T23:26:34,Labastida,Expense,cash,-100.0,-848.64
buyer_8,Antonio,45,ES45209530357850307003,TRX_N-00064-27840884,2022-02-14T16:29:58,Labastida,Expense,appliances,-175.89,-1024.53
buyer_8,Antonio,45,ES45209530357850307003,TRX_N-00065-65118766,2022-02-15T05:18:14,Labastida,Expense,clothing,-130.37,-1154.9
buyer_8,Antonio,45,ES45209530357850307003,TRX_N-00066-57314897,2022-02-16T09:48:50,Labastida,Expense,healthcare,-38.39,-1193.29
buyer_8,Antonio,45,ES45209530357850307003,TRX_N-00067-23730660,2022-02-17T14:59:44,Labastida,Expense,cash,-100.0,-1293.29
buyer_8,Antonio,45,ES45209530357850307003,TRX_N-00068-18383583,2022-02-19T16:10:39,Labastida,Expense,leisure,-46.73,-1340.02
buyer_8,Antonio,45,ES45209530357850307003,TRX_N-00069-67322899,2022-02-20T08:12:05,Labastida,Expense,leisure,-32.11,-1372.13
buyer_8,Antonio,45,ES45209530357850307003,TRX_N-00070-13546334,2022-02-20T10:41:26,Labastida,expenses,children,-54.44,-1426.57
buyer_8,Antonio,45,ES45209530357850307003,TRX_N-00071-36466466,2022-02-23T13:04:51,Alegr√≠a-Dulantzi,Expense,food,-86.67,-1513.24
buyer_8,Antonio,45,ES45209530357850307003,TRX_N-00072-12418860,2022-02-24T17:43:40,Labastida,Expense,food,-108.69,-1621.93
buyer_8,Antonio,45,ES45209530357850307003,TRX_N-00073-36669640,2022-02-26T11:28:33,Andoain,Expense,food,-83.64,-1705.57
buyer_8,Antonio,45,ES45209530357850307003,TRX_N-00074-69263184,2022-02-27T10:02:11,Labastida,Expense,cash,-100.0,-1805.57
buyer_8,Antonio,45,ES45209530357850307003,TRX_N-00075-35526149,2022-02-28T06:13:08,Labastida,Expense,appliances,-287.97,-2093.54
buyer_8,Antonio,45,ES45209530357850307003,TRX_N-00076-14197728,2022-03-01T09:46:00,Labastida,incomes,salary,1267.57,-825.97
buyer_8,Antonio,45,ES45209530357850307003,TRX_N-00077-39069566,2022-03-01T09:46:00,Labastida,incomes,salary_partner,1586.78,760.81
buyer_8,Antonio,45,ES45209530357850307003,TRX_N-00078-37038453,2022-03-01T12:51:39,Labastida,Expense,cash,-100.0,660.81
buyer_8,Antonio,45,ES45209530357850307003,TRX_N-00079-22071855,2022-03-03T15:11:16,Labastida,Expense,food,-92.84,567.97
buyer_8,Antonio,45,ES45209530357850307003,TRX_N-00080-55215793,2022-03-04T08:31:59,Labastida,expenses,mortgage,-887.59,-319.62
buyer_8,Antonio,45,ES45209530357850307003,TRX_N-00081-82827381,2022-03-04T17:42:13,Labastida,Expense,transport,-55.71,-375.33
buyer_8,Antonio,45,ES45209530357850307003,TRX_N-00082-82894355,2022-03-04T09:40:34,Labastida,Expense,cash,-100.0,-475.33
buyer_8,Antonio,45,ES45209530357850307003,TRX_N-00083-79236157,2022-03-05T08:58:01,Labastida,expenses,phone,-44.2,-519.53
buyer_8,Antonio,45,ES45209530357850307003,TRX_N-00084-27951708,2022-03-05T10:44:18,Labastida,Expense,food,-70.26,-589.79
buyer_8,Antonio,45,ES45209530357850307003,TRX_N-00085-38053259,2022-03-05T17:22:13,Labastida,Expense,cash,-100.0,-689.79
buyer_8,Antonio,45,ES45209530357850307003,TRX_N-00086-96364405,2022-03-05T14:32:43,Labastida,Expense,gifts,-396.05,-1085.84
buyer_8,Antonio,45,ES45209530357850307003,TRX_N-00087-62259769,2022-03-06T14:41:42,Labastida,expenses,water,-39.33,-1125.17
buyer_8,Antonio,45,ES45209530357850307003,TRX_N-00088-13085581,2022-03-06T03:22:54,Labastida,expenses,gas,-108.28,-1233.45
buyer_8,Antonio,45,ES45209530357850307003,TRX_N-00089-76373264,2022-03-06T08:34:11,Labastida,Expense,transport,-52.79,-1286.24
buyer_8,Antonio,45,ES45209530357850307003,TRX_N-00090-95077765,2022-03-08T09:18:11,Labastida,expenses,electricity,-26.59,-1312.83
buyer_8,Antonio,45,ES45209530357850307003,TRX_N-00091-24607912,2022-03-08T12:32:38,Labastida,expenses,internet,-42.0,-1354.83
buyer_8,Antonio,45,ES45209530357850307003,TRX_N-00092-20168536,2022-03-10T08:35:06,Labastida,Expense,food,-121.11,-1475.94
buyer_8,Antonio,45,ES45209530357850307003,TRX_N-00093-83897258,2022-03-12T15:23:22,Labastida,Expense,food,-94.52,-1570.46
buyer_8,Antonio,45,ES45209530357850307003,TRX_N-00094-23378575,2022-03-12T16:04:45,Labastida,Expense,leisure,-61.67,-1632.13
buyer_8,Antonio,45,ES45209530357850307003,TRX_N-00095-42566104,2022-03-14T03:16:42,Labastida,Expense,food,-70.46,-1702.59
buyer_8,Antonio,45,ES45209530357850307003,TRX_N-00096-68279238,2022-03-15T10:17:38,Labastida,Expense,cash,-100.0,-1802.59
buyer_8,Antonio,45,ES45209530357850307003,TRX_N-00097-29260529,2022-03-17T14:44:29,Labastida,Expense,food,-98.08,-1900.67
buyer_8,Antonio,45,ES45209530357850307003,TRX_N-00098-74468758,2022-03-17T16:38:18,Labastida,Expense,leisure,-40.09,-1940.76
buyer_8,Antonio,45,ES45209530357850307003,TRX_N-00099-77623490,2022-03-17T13:45:16,Labastida,Expense,repairs,-212.2,-2152.96
buyer_8,Antonio,45,ES45209530357850307003,TRX_N-00100-35571268,2022-03-18T13:12:34,Labastida,Expense,cash,-100.0,-2252.96
buyer_8,Antonio,45,ES45209530357850307003,TRX_N-00101-80470958,2022-03-20T08:49:07,Labastida,Expense,cash,-100.0,-2352.96
buyer_8,Antonio,45,ES45209530357850307003,TRX_N-00102-71839801,2022-03-21T10:32:30,Labastida,Expense,leisure,-28.49,-2381.45
buyer_8,Antonio,45,ES45209530357850307003,TRX_N-00103-50595598,2022-03-22T18:15:29,Labastida,Expense,food,-64.65,-2446.1
buyer_8,Antonio,45,ES45209530357850307003,TRX_N-00104-31784706,2022-03-25T14:07:16,Labastida,Expense,repairs,-204.22,-2650.32
buyer_8,Antonio,45,ES45209530357850307003,TRX_N-00105-81640747,2022-03-26T18:39:40,Labastida,Expense,food,-82.45,-2732.77
buyer_8,Antonio,45,ES45209530357850307003,TRX_N-00106-58815843,2022-03-26T16:38:57,Labastida,Expense,healthcare,-132.66,-2865.43
buyer_8,Antonio,45,ES45209530357850307003,TRX_N-00107-77917323,2022-03-29T17:14:00,Labastida,Expense,education,-67.38,-2932.81
buyer_8,Antonio,45,ES45209530357850307003,TRX_N-00108-03170582,2022-03-31T10:18:50,Labastida,Expense,leisure,-66.91,-2999.72
buyer_8,Antonio,45,ES45209530357850307003,TRX_N-00109-85056167,2022-04-01T08:07:52,Labastida,incomes,salary,1267.57,-1732.15
buyer_8,Antonio,45,ES45209530357850307003,TRX_N-00110-68229513,2022-04-01T08:07:52,Labastida,incomes,salary_partner,1586.78,-145.37
buyer_8,Antonio,45,ES45209530357850307003,TRX_N-00111-14550290,2022-04-01T08:07:52,Labastida,incomes,extra_income,205.8,60.43
buyer_8,Antonio,45,ES45209530357850307003,TRX_N-00112-24971925,2022-04-01T20:08:02,Amurrio,Expense,leisure,-46.81,13.62
buyer_8,Antonio,45,ES45209530357850307003,TRX_N-00113-27908096,2022-04-02T14:02:01,Labastida,Expense,healthcare,-44.22,-30.6
buyer_8,Antonio,45,ES45209530357850307003,TRX_N-00114-52802023,2022-04-03T12:56:12,Labastida,Expense,gifts,-754.59,-785.19
buyer_8,Antonio,45,ES45209530357850307003,TRX_N-00115-99196782,2022-04-04T08:39:25,Labastida,expenses,mortgage,-887.59,-1672.78
buyer_8,Antonio,45,ES45209530357850307003,TRX_N-00116-05828446,2022-04-04T04:20:51,Labastida,Expense,leisure,-42.17,-1714.95
buyer_8,Antonio,45,ES45209530357850307003,TRX_N-00117-35424613,2022-04-05T16:47:03,Labastida,expenses,electricity,-46.62,-1761.57
buyer_8,Antonio,45,ES45209530357850307003,TRX_N-00118-26684127,2022-04-05T17:40:08,Labastida,expenses,internet,-42.0,-1803.57
buyer_8,Antonio,45,ES45209530357850307003,TRX_N-00119-16568937,2022-04-06T20:22:53,Labastida,Expense,clothing,-93.98,-1897.55
buyer_8,Antonio,45,ES45209530357850307003,TRX_N-00120-93268962,2022-04-06T14:53:20,Leioa,Expense,cash,-100.0,-1997.55
buyer_8,Antonio,45,ES45209530357850307003,TRX_N-00121-82727162,2022-04-07T19:16:16,Labastida,expenses,gas,-54.08,-2051.63
buyer_8,Antonio,45,ES45209530357850307003,TRX_N-00122-24651474,2022-04-08T11:51:13,Labastida,expenses,water,-42.19,-2093.82
buyer_8,Antonio,45,ES45209530357850307003,TRX_N-00123-53734626,2022-04-08T15:12:10,Labastida,expenses,phone,-43.95,-2137.77
buyer_8,Antonio,45,ES45209530357850307003,TRX_N-00124-06564828,2022-04-08T04:03:12,Labastida,Expense,food,-117.82,-2255.59
buyer_8,Antonio,45,ES45209530357850307003,TRX_N-00125-50451092,2022-04-08T23:22:57,Labastida,Expense,clothing,-56.07,-2311.66
buyer_8,Antonio,45,ES45209530357850307003,TRX_N-00126-48814600,2022-04-08T17:05:40,Labastida,Expense,cash,-100.0,-2411.66
buyer_8,Antonio,45,ES45209530357850307003,TRX_N-00127-35477684,2022-04-10T15:21:05,Labastida,expenses,children,-235.18,-2646.84
buyer_8,Antonio,45,ES45209530357850307003,TRX_N-00128-45149879,2022-04-11T12:15:44,Labastida,Expense,food,-105.77,-2752.61
buyer_8,Antonio,45,ES45209530357850307003,TRX_N-00129-40298061,2022-04-11T10:09:47,Labastida,Expense,leisure,-20.56,-2773.17
buyer_8,Antonio,45,ES45209530357850307003,TRX_N-00130-35288309,2022-04-11T20:42:23,Labastida,Expense,cash,-100.0,-2873.17
buyer_8,Antonio,45,ES45209530357850307003,TRX_N-00131-80459994,2022-04-12T22:46:36,Labastida,Expense,education,-65.73,-2938.9
buyer_8,Antonio,45,ES45209530357850307003,TRX_N-00132-02185785,2022-04-12T19:15:29,Sopela,Expense,cash,-100.0,-3038.9
buyer_8,Antonio,45,ES45209530357850307003,TRX_N-00133-11352739,2022-04-13T16:43:15,Labastida,Expense,food,-117.51,-3156.41
buyer_8,Antonio,45,ES45209530357850307003,TRX_N-00134-75616161,2022-04-15T10:44:21,Labastida,Expense,transport,-60.06,-3216.47
buyer_8,Antonio,45,ES45209530357850307003,TRX_N-00135-00803804,2022-04-16T20:26:08,Labastida,Expense,cash,-100.0,-3316.47
buyer_8,Antonio,45,ES45209530357850307003,TRX_N-00136-85275924,2022-04-17T16:51:06,Labastida,Expense,leisure,-75.45,-3391.92
buyer_8,Antonio,45,ES45209530357850307003,TRX_N-00137-26680233,2022-04-19T13:42:39,Labastida,Expense,food,-99.24,-3491.16
buyer_8,Antonio,45,ES45209530357850307003,TRX_N-00138-70508660,2022-04-20T08:40:27,Labastida,Expense,repairs,-239.81,-3730.97
buyer_8,Antonio,45,ES45209530357850307003,TRX_N-00139-87770267,2022-04-21T09:30:20,Iru√±a de Oca,Expense,transport,-55.69,-3786.66
buyer_8,Antonio,45,ES45209530357850307003,TRX_N-00140-89476634,2022-04-23T16:40:51,Labastida,Expense,leisure,-36.11,-3822.77
buyer_8,Antonio,45,ES45209530357850307003,TRX_N-00141-93775697,2022-04-25T08:29:54,Labastida,Expense,education,-49.13,-3871.9
buyer_8,Antonio,45,ES45209530357850307003,TRX_N-00142-49482876,2022-04-25T08:16:00,Labastida,Expense,cash,-100.0,-3971.9
buyer_8,Antonio,45,ES45209530357850307003,TRX_N-00143-35296805,2022-04-25T16:37:05,Labastida,Expense,gifts,-66.65,-4038.55
buyer_8,Antonio,45,ES45209530357850307003,TRX_N-00144-27525664,2022-04-26T09:41:17,Labastida,Expense,food,-121.81,-4160.36
buyer_8,Antonio,45,ES45209530357850307003,TRX_N-00145-26396084,2022-04-26T13:09:03,Labastida,Expense,healthcare,-94.27,-4254.63
buyer_8,Antonio,45,ES45209530357850307003,TRX_N-00146-50011825,2022-04-29T10:10:09,Labastida,Expense,cash,-100.0,-4354.63
buyer_8,Antonio,45,ES45209530357850307003,TRX_N-00147-08181603,2022-04-30T12:53:54,Labastida,Expense,cash,-100.0,-4454.63
buyer_8,Antonio,45,ES45209530357850307003,TRX_N-00148-30173643,2022-05-01T14:05:25,Labastida,incomes,salary,1267.57,-3187.06
buyer_8,Antonio,45,ES45209530357850307003,TRX_N-00149-59504955,2022-05-01T14:05:25,Labastida,incomes,salary_partner,1586.78,-1600.28
buyer_8,Antonio,45,ES45209530357850307003,TRX_N-00150-78155119,2022-05-02T20:12:35,Alegr√≠a-Dulantzi,Expense,cash,-100.0,-1700.28
buyer_8,Antonio,45,ES45209530357850307003,TRX_N-00151-73887216,2022-05-04T14:47:05,Labastida,expenses,mortgage,-887.59,-2587.87
buyer_8,Antonio,45,ES45209530357850307003,TRX_N-00152-58086687,2022-05-04T23:07:35,Labastida,Expense,leisure,-82.76,-2670.63
buyer_8,Antonio,45,ES45209530357850307003,TRX_N-00153-19089269,2022-05-04T11:00:06,Labastida,Expense,repairs,-180.38,-2851.01
buyer_8,Antonio,45,ES45209530357850307003,TRX_N-00154-40133935,2022-05-05T15:29:43,Labastida,expenses,gas,-79.47,-2930.48
buyer_8,Antonio,45,ES45209530357850307003,TRX_N-00155-19015888,2022-05-05T15:01:14,Labastida,expenses,phone,-31.03,-2961.51
buyer_8,Antonio,45,ES45209530357850307003,TRX_N-00156-47795746,2022-05-05T12:06:49,Zarautz,Expense,cash,-100.0,-3061.51
buyer_8,Antonio,45,ES45209530357850307003,TRX_N-00157-98452991,2022-05-06T22:28:24,Labastida,expenses,water,-42.42,-3103.93
buyer_8,Antonio,45,ES45209530357850307003,TRX_N-00158-29144348,2022-05-06T16:18:22,Labastida,expenses,electricity,-80.13,-3184.06
buyer_8,Antonio,45,ES45209530357850307003,TRX_N-00159-96009281,2022-05-06T12:38:01,Labastida,Expense,repairs,-141.11,-3325.17
buyer_8,Antonio,45,ES45209530357850307003,TRX_N-00160-35246582,2022-05-07T16:25:19,Labastida,expenses,internet,-42.0,-3367.17
buyer_8,Antonio,45,ES45209530357850307003,TRX_N-00161-31411795,2022-05-07T15:21:46,Labastida,Expense,cash,-100.0,-3467.17
buyer_8,Antonio,45,ES45209530357850307003,TRX_N-00162-16046205,2022-05-09T20:34:03,Labastida,Expense,leisure,-45.38,-3512.55
buyer_8,Antonio,45,ES45209530357850307003,TRX_N-00163-40520015,2022-05-09T20:39:25,Labastida,Expense,clothing,-154.69,-3667.24
buyer_8,Antonio,45,ES45209530357850307003,TRX_N-00164-88646255,2022-05-09T18:42:13,Labastida,Expense,cash,-100.0,-3767.24
buyer_8,Antonio,45,ES45209530357850307003,TRX_N-00165-19234094,2022-05-10T23:15:50,Labastida,Expense,food,-100.78,-3868.02
buyer_8,Antonio,45,ES45209530357850307003,TRX_N-00166-61262432,2022-05-10T14:48:53,Labastida,Expense,transport,-70.01,-3938.03
buyer_8,Antonio,45,ES45209530357850307003,TRX_N-00167-83149607,2022-05-10T18:01:09,Labastida,Expense,leisure,-47.53,-3985.56
buyer_8,Antonio,45,ES45209530357850307003,TRX_N-00168-16345876,2022-05-10T10:28:33,Zarautz,Expense,cash,-100.0,-4085.56
buyer_8,Antonio,45,ES45209530357850307003,TRX_N-00169-57651329,2022-05-13T22:45:46,Labastida,Expense,healthcare,-175.48,-4261.04
buyer_8,Antonio,45,ES45209530357850307003,TRX_N-00170-92060413,2022-05-13T14:21:14,Labastida,Expense,repairs,-225.28,-4486.32
buyer_8,Antonio,45,ES45209530357850307003,TRX_N-00171-75496544,2022-05-14T19:30:01,Labastida,Expense,gifts,-654.0,-5140.32
buyer_8,Antonio,45,ES45209530357850307003,TRX_N-00172-14159871,2022-05-16T20:38:36,Labastida,Expense,transport,-89.06,-5229.38
buyer_8,Antonio,45,ES45209530357850307003,TRX_N-00173-39279232,2022-05-16T13:34:51,Labastida,Expense,education,-77.07,-5306.45
buyer_8,Antonio,45,ES45209530357850307003,TRX_N-00174-95939469,2022-05-18T22:29:14,Labastida,Expense,education,-68.48,-5374.93
buyer_8,Antonio,45,ES45209530357850307003,TRX_N-00175-32362721,2022-05-18T12:06:13,Portugalete,Expense,travel,-1842.41,-7217.34
buyer_8,Antonio,45,ES45209530357850307003,TRX_N-00176-79470787,2022-05-19T09:15:48,Bermeo,Expense,education,-75.23,-7292.57
buyer_8,Antonio,45,ES45209530357850307003,TRX_N-00177-58025372,2022-05-20T19:01:31,Labastida,Expense,cash,-100.0,-7392.57
buyer_8,Antonio,45,ES45209530357850307003,TRX_N-00178-08634946,2022-05-23T08:39:12,Salvatierra/Agurain,Expense,food,-81.27,-7473.84
buyer_8,Antonio,45,ES45209530357850307003,TRX_N-00179-22864008,2022-05-23T21:57:55,Labastida,Expense,transport,-44.63,-7518.47
buyer_8,Antonio,45,ES45209530357850307003,TRX_N-00180-03578961,2022-05-25T10:23:55,Labastida,Expense,food,-67.56,-7586.03
buyer_8,Antonio,45,ES45209530357850307003,TRX_N-00181-45737456,2022-05-25T18:40:40,Mungia,Expense,travel,-1283.37,-8869.4
buyer_8,Antonio,45,ES45209530357850307003,TRX_N-00182-21419931,2022-05-26T13:28:17,Labastida,Expense,food,-105.67,-8975.07
buyer_8,Antonio,45,ES45209530357850307003,TRX_N-00183-49163122,2022-05-26T23:33:12,Labastida,Expense,cash,-100.0,-9075.07
buyer_8,Antonio,45,ES45209530357850307003,TRX_N-00184-32102142,2022-05-27T12:30:16,Labastida,Expense,education,-60.61,-9135.68
buyer_8,Antonio,45,ES45209530357850307003,TRX_N-00185-00903999,2022-05-29T22:50:44,Labastida,Expense,cash,-100.0,-9235.68
buyer_8,Antonio,45,ES45209530357850307003,TRX_N-00186-33320574,2022-06-01T23:09:48,Labastida,incomes,salary,1267.57,-7968.11
buyer_8,Antonio,45,ES45209530357850307003,TRX_N-00187-55756974,2022-06-01T23:09:48,Labastida,incomes,salary_partner,1586.78,-6381.33
buyer_8,Antonio,45,ES45209530357850307003,TRX_N-00188-41991982,2022-06-01T23:09:48,Labastida,incomes,salary_bonus,1010.78,-5370.55
buyer_8,Antonio,45,ES45209530357850307003,TRX_N-00189-58989476,2022-06-01T23:09:48,Labastida,incomes,salary_partner_bonus,1184.21,-4186.34
buyer_8,Antonio,45,ES45209530357850307003,TRX_N-00190-40596675,2022-06-01T17:50:24,Labastida,Expense,food,-108.61,-4294.95
buyer_8,Antonio,45,ES45209530357850307003,TRX_N-00191-03879983,2022-06-01T09:00:27,Labastida,Expense,cash,-100.0,-4394.95
buyer_8,Antonio,45,ES45209530357850307003,TRX_N-00192-13177578,2022-06-04T23:42:01,Labastida,expenses,mortgage,-887.59,-5282.54
buyer_8,Antonio,45,ES45209530357850307003,TRX_N-00193-78409500,2022-06-04T14:00:51,Labastida,Expense,food,-89.68,-5372.22
buyer_8,Antonio,45,ES45209530357850307003,TRX_N-00194-42051149,2022-06-04T14:56:23,Labastida,Expense,cash,-100.0,-5472.22
buyer_8,Antonio,45,ES45209530357850307003,TRX_N-00195-58115140,2022-06-05T15:55:09,Labastida,expenses,internet,-42.0,-5514.22
buyer_8,Antonio,45,ES45209530357850307003,TRX_N-00196-54012396,2022-06-05T13:40:07,Labastida,expenses,phone,-35.14,-5549.36
buyer_8,Antonio,45,ES45209530357850307003,TRX_N-00197-27478685,2022-06-06T20:52:31,Labastida,Expense,leisure,-41.56,-5590.92
buyer_8,Antonio,45,ES45209530357850307003,TRX_N-00198-86276491,2022-06-07T08:25:27,Labastida,Expense,food,-114.38,-5705.3
buyer_8,Antonio,45,ES45209530357850307003,TRX_N-00199-94377535,2022-06-07T19:47:18,Hondarribia,Expense,cash,-100.0,-5805.3
buyer_8,Antonio,45,ES45209530357850307003,TRX_N-00200-84783135,2022-06-08T12:01:49,Labastida,expenses,water,-23.9,-5829.2
buyer_8,Antonio,45,ES45209530357850307003,TRX_N-00201-73362278,2022-06-08T10:17:26,Labastida,expenses,electricity,-37.83,-5867.03
buyer_8,Antonio,45,ES45209530357850307003,TRX_N-00202-32583454,2022-06-08T19:51:04,Labastida,expenses,gas,-74.77,-5941.8
buyer_8,Antonio,45,ES45209530357850307003,TRX_N-00203-86021591,2022-06-08T18:12:24,Labastida,Expense,repairs,-261.01,-6202.81
buyer_8,Antonio,45,ES45209530357850307003,TRX_N-00204-89076919,2022-06-08T15:34:30,Labastida,expenses,children,-157.34,-6360.15
buyer_8,Antonio,45,ES45209530357850307003,TRX_N-00205-71096631,2022-06-10T12:07:18,Labastida,Expense,transport,-81.67,-6441.82
buyer_8,Antonio,45,ES45209530357850307003,TRX_N-00206-47383518,2022-06-10T03:03:26,Labastida,Expense,travel,-991.58,-7433.4
buyer_8,Antonio,45,ES45209530357850307003,TRX_N-00207-21320699,2022-06-11T19:33:54,Salvatierra/Agurain,Expense,food,-114.69,-7548.09
buyer_8,Antonio,45,ES45209530357850307003,TRX_N-00208-42325671,2022-06-12T15:39:55,Labastida,Expense,food,-110.25,-7658.34
buyer_8,Antonio,45,ES45209530357850307003,TRX_N-00209-07662401,2022-06-12T19:37:03,Sestao,Expense,transport,-55.47,-7713.81
buyer_8,Antonio,45,ES45209530357850307003,TRX_N-00210-74872031,2022-06-15T13:05:56,Labastida,Expense,food,-60.93,-7774.74
buyer_8,Antonio,45,ES45209530357850307003,TRX_N-00211-45117033,2022-06-15T09:32:20,Labastida,Expense,transport,-44.65,-7819.39
buyer_8,Antonio,45,ES45209530357850307003,TRX_N-00212-69490484,2022-06-15T11:50:34,Labastida,Expense,cash,-100.0,-7919.39
buyer_8,Antonio,45,ES45209530357850307003,TRX_N-00213-79143845,2022-06-16T17:33:40,Labastida,Expense,leisure,-19.11,-7938.5
buyer_8,Antonio,45,ES45209530357850307003,TRX_N-00214-33894504,2022-06-17T18:04:31,Labastida,Expense,leisure,-40.46,-7978.96
buyer_8,Antonio,45,ES45209530357850307003,TRX_N-00215-07027197,2022-06-18T15:34:24,Labastida,Expense,transport,-86.98,-8065.94
buyer_8,Antonio,45,ES45209530357850307003,TRX_N-00216-12449073,2022-06-19T13:12:57,Labastida,Expense,cash,-100.0,-8165.94
buyer_8,Antonio,45,ES45209530357850307003,TRX_N-00217-41699068,2022-06-19T12:15:04,Galdakao,Expense,appliances,-362.2,-8528.14
buyer_8,Antonio,45,ES45209530357850307003,TRX_N-00218-76168040,2022-06-21T23:16:09,Labastida,Expense,food,-101.95,-8630.09
buyer_8,Antonio,45,ES45209530357850307003,TRX_N-00219-63074179,2022-06-21T16:34:59,Labastida,Expense,cash,-100.0,-8730.09
buyer_8,Antonio,45,ES45209530357850307003,TRX_N-00220-64528357,2022-06-23T16:10:18,Labastida,Expense,leisure,-31.2,-8761.29
buyer_8,Antonio,45,ES45209530357850307003,TRX_N-00221-18918927,2022-06-23T10:55:57,Labastida,Expense,repairs,-98.99,-8860.28
buyer_8,Antonio,45,ES45209530357850307003,TRX_N-00222-85139868,2022-06-23T13:44:45,Galdakao,Expense,gifts,-174.63,-9034.91
buyer_8,Antonio,45,ES45209530357850307003,TRX_N-00223-75806373,2022-06-25T11:10:46,Labastida,Expense,food,-115.57,-9150.48
buyer_8,Antonio,45,ES45209530357850307003,TRX_N-00224-23569240,2022-06-27T08:06:11,Labastida,Expense,food,-72.58,-9223.06
buyer_8,Antonio,45,ES45209530357850307003,TRX_N-00225-78247734,2022-06-27T11:51:28,Labastida,Expense,leisure,-48.76,-9271.82
buyer_8,Antonio,45,ES45209530357850307003,TRX_N-00226-60811034,2022-06-27T09:32:38,Irun,Expense,repairs,-42.29,-9314.11
buyer_8,Antonio,45,ES45209530357850307003,TRX_N-00227-51294643,2022-06-28T08:50:59,Labastida,Expense,clothing,-118.5,-9432.61
buyer_8,Antonio,45,ES45209530357850307003,TRX_N-00228-00520542,2022-06-29T09:08:32,Labastida,Expense,gifts,-68.61,-9501.22
buyer_8,Antonio,45,ES45209530357850307003,TRX_N-00229-13030681,2022-07-01T18:51:06,Labastida,incomes,salary,1267.57,-8233.65
buyer_8,Antonio,45,ES45209530357850307003,TRX_N-00230-78115498,2022-07-01T18:51:06,Labastida,incomes,salary_partner,1586.78,-6646.87
buyer_8,Antonio,45,ES45209530357850307003,TRX_N-00231-15337264,2022-07-01T18:51:06,Labastida,incomes,extra_income,205.8,-6441.07
buyer_8,Antonio,45,ES45209530357850307003,TRX_N-00232-62527765,2022-07-01T11:45:51,Labastida,Expense,leisure,-47.97,-6489.04
buyer_8,Antonio,45,ES45209530357850307003,TRX_N-00233-69992261,2022-07-02T18:10:13,Labastida,Expense,cash,-100.0,-6589.04
buyer_8,Antonio,45,ES45209530357850307003,TRX_N-00234-56694152,2022-07-03T11:37:31,Labastida,Expense,repairs,-186.97,-6776.01
buyer_8,Antonio,45,ES45209530357850307003,TRX_N-00235-71095438,2022-07-04T14:46:45,Labastida,expenses,mortgage,-887.59,-7663.6
buyer_8,Antonio,45,ES45209530357850307003,TRX_N-00236-42436797,2022-07-05T14:01:10,Labastida,expenses,internet,-42.0,-7705.6
buyer_8,Antonio,45,ES45209530357850307003,TRX_N-00237-03782575,2022-07-05T13:43:16,Labastida,expenses,phone,-33.07,-7738.67
buyer_8,Antonio,45,ES45209530357850307003,TRX_N-00238-72213132,2022-07-06T15:09:21,Labastida,expenses,gas,-51.44,-7790.11
buyer_8,Antonio,45,ES45209530357850307003,TRX_N-00239-94358281,2022-07-08T20:56:34,Labastida,expenses,water,-42.99,-7833.1
buyer_8,Antonio,45,ES45209530357850307003,TRX_N-00240-41125300,2022-07-08T19:12:08,Labastida,expenses,electricity,-38.5,-7871.6
buyer_8,Antonio,45,ES45209530357850307003,TRX_N-00241-70668018,2022-07-08T18:22:50,Labastida,Expense,food,-82.28,-7953.88
buyer_8,Antonio,45,ES45209530357850307003,TRX_N-00242-59345464,2022-07-10T15:00:53,Labastida,Expense,cash,-100.0,-8053.88
buyer_8,Antonio,45,ES45209530357850307003,TRX_N-00243-05766461,2022-07-14T09:51:53,Labastida,Expense,transport,-48.69,-8102.57
buyer_8,Antonio,45,ES45209530357850307003,TRX_N-00244-52601817,2022-07-14T11:27:47,Labastida,Expense,education,-60.03,-8162.6
buyer_8,Antonio,45,ES45209530357850307003,TRX_N-00245-65264130,2022-07-15T02:03:03,Labastida,Expense,repairs,-328.34,-8490.94
buyer_8,Antonio,45,ES45209530357850307003,TRX_N-00246-23873036,2022-07-16T16:45:33,Labastida,Expense,transport,-82.64,-8573.58
buyer_8,Antonio,45,ES45209530357850307003,TRX_N-00247-58871871,2022-07-17T09:45:54,Labastida,Expense,food,-110.84,-8684.42
buyer_8,Antonio,45,ES45209530357850307003,TRX_N-00248-63947077,2022-07-18T17:15:35,Labastida,Expense,education,-48.48,-8732.9
buyer_8,Antonio,45,ES45209530357850307003,TRX_N-00249-28905302,2022-07-18T19:45:23,Labastida,Expense,repairs,-293.96,-9026.86
buyer_8,Antonio,45,ES45209530357850307003,TRX_N-00250-78020718,2022-07-19T12:27:34,Galdakao,Expense,food,-117.58,-9144.44
buyer_8,Antonio,45,ES45209530357850307003,TRX_N-00251-35326050,2022-07-19T06:07:02,Labastida,Expense,cash,-100.0,-9244.44
buyer_8,Antonio,45,ES45209530357850307003,TRX_N-00252-87807285,2022-07-20T10:02:58,Donostia,Expense,food,-88.38,-9332.82
buyer_8,Antonio,45,ES45209530357850307003,TRX_N-00253-20888813,2022-07-20T17:08:26,Labastida,Expense,cash,-100.0,-9432.82
buyer_8,Antonio,45,ES45209530357850307003,TRX_N-00254-81451376,2022-07-21T09:49:44,Labastida,Expense,appliances,-360.37,-9793.19
buyer_8,Antonio,45,ES45209530357850307003,TRX_N-00255-64621443,2022-07-22T17:47:38,Labastida,Expense,cash,-100.0,-9893.19
buyer_8,Antonio,45,ES45209530357850307003,TRX_N-00256-25680289,2022-07-23T16:14:01,Labastida,Expense,repairs,-78.82,-9972.01
buyer_8,Antonio,45,ES45209530357850307003,TRX_N-00257-82660078,2022-07-25T20:22:22,Hondarribia,Expense,transport,-68.07,-10040.08
buyer_8,Antonio,45,ES45209530357850307003,TRX_N-00258-94627947,2022-07-27T21:59:54,Labastida,Expense,leisure,-38.66,-10078.74
buyer_8,Antonio,45,ES45209530357850307003,TRX_N-00259-03346001,2022-07-27T19:06:42,Labastida,Expense,clothing,-93.83,-10172.57
buyer_8,Antonio,45,ES45209530357850307003,TRX_N-00260-04982567,2022-07-27T21:11:20,Labastida,Expense,cash,-100.0,-10272.57
buyer_8,Antonio,45,ES45209530357850307003,TRX_N-00261-17558163,2022-07-31T22:04:06,Amurrio,Expense,leisure,-60.75,-10333.32
buyer_8,Antonio,45,ES45209530357850307003,TRX_N-00262-05007739,2022-07-31T17:33:36,Labastida,Expense,repairs,-222.22,-10555.54
buyer_8,Antonio,45,ES45209530357850307003,TRX_N-00263-37468744,2022-08-01T15:57:12,Labastida,incomes,salary,1267.57,-9287.97
buyer_8,Antonio,45,ES45209530357850307003,TRX_N-00264-21586624,2022-08-01T15:57:12,Labastida,incomes,salary_partner,1586.78,-7701.19
buyer_8,Antonio,45,ES45209530357850307003,TRX_N-00265-64822450,2022-08-01T19:37:15,Labastida,Expense,leisure,-27.59,-7728.78
buyer_8,Antonio,45,ES45209530357850307003,TRX_N-00266-21207531,2022-08-02T08:38:35,Labastida,Expense,transport,-86.3,-7815.08
buyer_8,Antonio,45,ES45209530357850307003,TRX_N-00267-00947388,2022-08-02T14:27:31,Getxo,Expense,repairs,-118.01,-7933.09
buyer_8,Antonio,45,ES45209530357850307003,TRX_N-00268-61318396,2022-08-04T16:44:38,Labastida,expenses,mortgage,-887.59,-8820.68
buyer_8,Antonio,45,ES45209530357850307003,TRX_N-00269-78748340,2022-08-04T22:46:56,Leioa,Expense,food,-103.98,-8924.66
buyer_8,Antonio,45,ES45209530357850307003,TRX_N-00270-63310863,2022-08-05T16:59:19,Labastida,expenses,water,-40.27,-8964.93
buyer_8,Antonio,45,ES45209530357850307003,TRX_N-00271-29569471,2022-08-05T19:35:37,Labastida,expenses,electricity,-72.19,-9037.12
buyer_8,Antonio,45,ES45209530357850307003,TRX_N-00272-44551004,2022-08-05T16:20:13,Labastida,expenses,phone,-32.6,-9069.72
buyer_8,Antonio,45,ES45209530357850307003,TRX_N-00273-18376675,2022-08-06T20:57:40,Labastida,expenses,gas,-92.69,-9162.41
buyer_8,Antonio,45,ES45209530357850307003,TRX_N-00274-96118088,2022-08-06T20:24:15,Oy√≥n-Oion,Expense,food,-83.62,-9246.03
buyer_8,Antonio,45,ES45209530357850307003,TRX_N-00275-53329120,2022-08-06T20:43:58,Labastida,Expense,cash,-100.0,-9346.03
buyer_8,Antonio,45,ES45209530357850307003,TRX_N-00276-45635408,2022-08-08T11:08:08,Labastida,expenses,internet,-42.0,-9388.03
buyer_8,Antonio,45,ES45209530357850307003,TRX_N-00277-67173790,2022-08-11T09:42:43,Labastida,Expense,clothing,-145.63,-9533.66
buyer_8,Antonio,45,ES45209530357850307003,TRX_N-00278-51859039,2022-08-12T17:35:43,Labastida,expenses,children,-190.53,-9724.19
buyer_8,Antonio,45,ES45209530357850307003,TRX_N-00279-51216363,2022-08-15T08:46:29,Labastida,Expense,cash,-100.0,-9824.19
buyer_8,Antonio,45,ES45209530357850307003,TRX_N-00280-37705576,2022-08-16T18:48:44,Labastida,Expense,food,-116.86,-9941.05
buyer_8,Antonio,45,ES45209530357850307003,TRX_N-00281-13805063,2022-08-18T04:13:13,Errenteria,Expense,leisure,-48.31,-9989.36
buyer_8,Antonio,45,ES45209530357850307003,TRX_N-00282-25605475,2022-08-20T11:42:09,Labastida,Expense,food,-119.93,-10109.29
buyer_8,Antonio,45,ES45209530357850307003,TRX_N-00283-59621691,2022-08-20T05:19:43,Labastida,Expense,cash,-100.0,-10209.29
buyer_8,Antonio,45,ES45209530357850307003,TRX_N-00284-48658766,2022-08-21T13:55:58,Labastida,Expense,cash,-100.0,-10309.29
buyer_8,Antonio,45,ES45209530357850307003,TRX_N-00285-45358820,2022-08-21T15:59:27,Labastida,Expense,appliances,-176.8,-10486.09
buyer_8,Antonio,45,ES45209530357850307003,TRX_N-00286-33882024,2022-08-22T23:10:52,Labastida,Expense,repairs,-229.9,-10715.99
buyer_8,Antonio,45,ES45209530357850307003,TRX_N-00287-96912772,2022-08-25T05:59:16,Labastida,Expense,leisure,-41.03,-10757.02
buyer_8,Antonio,45,ES45209530357850307003,TRX_N-00288-43143294,2022-08-26T14:58:02,Labastida,Expense,cash,-100.0,-10857.02
buyer_8,Antonio,45,ES45209530357850307003,TRX_N-00289-31178755,2022-08-27T19:42:21,Labastida,expenses,children,-241.59,-11098.61
buyer_8,Antonio,45,ES45209530357850307003,TRX_N-00290-77041888,2022-08-28T16:01:34,Elciego,Expense,leisure,-71.21,-11169.82
buyer_8,Antonio,45,ES45209530357850307003,TRX_N-00291-23981442,2022-08-31T08:06:14,Irun,Expense,cash,-100.0,-11269.82
buyer_8,Antonio,45,ES45209530357850307003,TRX_N-00292-60791629,2022-08-31T08:30:07,Labastida,Expense,travel,-670.62,-11940.44
buyer_8,Antonio,45,ES45209530357850307003,TRX_N-00293-80901156,2022-09-01T15:22:35,Labastida,incomes,salary,1267.57,-10672.87
buyer_8,Antonio,45,ES45209530357850307003,TRX_N-00294-95481286,2022-09-01T15:22:35,Labastida,incomes,salary_partner,1586.78,-9086.09
buyer_8,Antonio,45,ES45209530357850307003,TRX_N-00295-92069585,2022-09-01T12:34:54,Labastida,Expense,food,-110.41,-9196.5
buyer_8,Antonio,45,ES45209530357850307003,TRX_N-00296-00481445,2022-09-01T09:45:40,Labastida,Expense,repairs,-322.71,-9519.21
buyer_8,Antonio,45,ES45209530357850307003,TRX_N-00297-98390429,2022-09-02T17:45:17,Labastida,Expense,clothing,-86.71,-9605.92
buyer_8,Antonio,45,ES45209530357850307003,TRX_N-00298-30384951,2022-09-03T23:04:41,Labastida,Expense,clothing,-47.86,-9653.78
buyer_8,Antonio,45,ES45209530357850307003,TRX_N-00299-73092002,2022-09-03T20:44:35,Labastida,Expense,repairs,-185.19,-9838.97
buyer_8,Antonio,45,ES45209530357850307003,TRX_N-00300-23057739,2022-09-04T21:46:28,Labastida,expenses,mortgage,-887.59,-10726.56
buyer_8,Antonio,45,ES45209530357850307003,TRX_N-00301-52887103,2022-09-04T18:00:29,Labastida,Expense,leisure,-52.03,-10778.59
buyer_8,Antonio,45,ES45209530357850307003,TRX_N-00302-41054107,2022-09-04T17:38:50,Labastida,Expense,repairs,-313.68,-11092.27
buyer_8,Antonio,45,ES45209530357850307003,TRX_N-00303-59788980,2022-09-05T10:41:15,Labastida,expenses,electricity,-52.32,-11144.59
buyer_8,Antonio,45,ES45209530357850307003,TRX_N-00304-53689324,2022-09-05T21:06:47,Labastida,expenses,gas,-31.26,-11175.85
buyer_8,Antonio,45,ES45209530357850307003,TRX_N-00305-41791031,2022-09-05T12:05:38,Labastida,expenses,phone,-34.48,-11210.33
buyer_8,Antonio,45,ES45209530357850307003,TRX_N-00306-12992146,2022-09-05T15:25:41,Labastida,Expense,cash,-100.0,-11310.33
buyer_8,Antonio,45,ES45209530357850307003,TRX_N-00307-80849439,2022-09-06T10:07:28,Labastida,expenses,water,-41.9,-11352.23
buyer_8,Antonio,45,ES45209530357850307003,TRX_N-00308-71856587,2022-09-06T18:31:55,Labastida,Expense,cash,-100.0,-11452.23
buyer_8,Antonio,45,ES45209530357850307003,TRX_N-00309-06497021,2022-09-08T19:45:55,Labastida,expenses,internet,-42.0,-11494.23
buyer_8,Antonio,45,ES45209530357850307003,TRX_N-00310-81362633,2022-09-08T13:43:43,Labastida,Expense,transport,-51.47,-11545.7
buyer_8,Antonio,45,ES45209530357850307003,TRX_N-00311-19961322,2022-09-12T09:36:14,Basauri,Expense,education,-74.19,-11619.89
buyer_8,Antonio,45,ES45209530357850307003,TRX_N-00312-05866081,2022-09-14T19:04:31,Labastida,Expense,transport,-63.72,-11683.61
buyer_8,Antonio,45,ES45209530357850307003,TRX_N-00313-41130569,2022-09-15T20:18:04,Labastida,Expense,food,-81.33,-11764.94
buyer_8,Antonio,45,ES45209530357850307003,TRX_N-00314-94592535,2022-09-15T22:20:50,Labastida,Expense,transport,-45.11,-11810.05
buyer_8,Antonio,45,ES45209530357850307003,TRX_N-00315-10031304,2022-09-15T20:38:01,Hondarribia,Expense,gifts,-689.68,-12499.73
buyer_8,Antonio,45,ES45209530357850307003,TRX_N-00316-94168918,2022-09-16T11:41:48,Labastida,Expense,food,-68.76,-12568.49
buyer_8,Antonio,45,ES45209530357850307003,TRX_N-00317-77145252,2022-09-16T09:31:07,Labastida,Expense,repairs,-247.28,-12815.77
buyer_8,Antonio,45,ES45209530357850307003,TRX_N-00318-83752505,2022-09-17T19:07:16,Labastida,Expense,food,-87.92,-12903.69
buyer_8,Antonio,45,ES45209530357850307003,TRX_N-00319-40681161,2022-09-17T14:34:56,Berango,Expense,transport,-74.05,-12977.74
buyer_8,Antonio,45,ES45209530357850307003,TRX_N-00320-58054440,2022-09-18T14:30:26,Labastida,Expense,gifts,-279.7,-13257.44
buyer_8,Antonio,45,ES45209530357850307003,TRX_N-00321-46148846,2022-09-19T00:09:08,Labastida,Expense,transport,-44.38,-13301.82
buyer_8,Antonio,45,ES45209530357850307003,TRX_N-00322-50316497,2022-09-19T16:58:45,Labastida,Expense,education,-49.79,-13351.61
buyer_8,Antonio,45,ES45209530357850307003,TRX_N-00323-83474714,2022-09-19T18:56:17,Labastida,Expense,cash,-100.0,-13451.61
buyer_8,Antonio,45,ES45209530357850307003,TRX_N-00324-72656899,2022-09-19T14:50:32,Labastida,Expense,gifts,-566.84,-14018.45
buyer_8,Antonio,45,ES45209530357850307003,TRX_N-00325-69865284,2022-09-22T06:15:38,Labastida,Expense,clothing,-75.33,-14093.78
buyer_8,Antonio,45,ES45209530357850307003,TRX_N-00326-10108827,2022-09-22T14:27:33,Labastida,Expense,healthcare,-80.23,-14174.01
buyer_8,Antonio,45,ES45209530357850307003,TRX_N-00327-59933836,2022-09-23T09:30:32,Labastida,Expense,gifts,-117.66,-14291.67
buyer_8,Antonio,45,ES45209530357850307003,TRX_N-00328-22535864,2022-09-24T09:52:39,Durango,Expense,food,-82.68,-14374.35
buyer_8,Antonio,45,ES45209530357850307003,TRX_N-00329-10206503,2022-09-24T10:00:43,Labastida,Expense,transport,-88.02,-14462.37
buyer_8,Antonio,45,ES45209530357850307003,TRX_N-00330-51161906,2022-09-24T15:38:59,Labastida,Expense,cash,-100.0,-14562.37
buyer_8,Antonio,45,ES45209530357850307003,TRX_N-00331-55260520,2022-09-25T03:31:49,Bilbao,Expense,food,-95.13,-14657.5
buyer_8,Antonio,45,ES45209530357850307003,TRX_N-00332-46507423,2022-09-26T18:37:21,Getxo,Expense,food,-81.71,-14739.21
buyer_8,Antonio,45,ES45209530357850307003,TRX_N-00333-93887773,2022-09-27T16:43:30,Labastida,Expense,education,-52.34,-14791.55
buyer_8,Antonio,45,ES45209530357850307003,TRX_N-00334-71847788,2022-09-27T12:29:56,Labastida,Expense,cash,-100.0,-14891.55
buyer_8,Antonio,45,ES45209530357850307003,TRX_N-00335-17946188,2022-09-28T17:12:49,Labastida,Expense,food,-72.83,-14964.38
buyer_8,Antonio,45,ES45209530357850307003,TRX_N-00336-67958398,2022-09-28T09:08:08,Labastida,Expense,transport,-76.04,-15040.42
buyer_8,Antonio,45,ES45209530357850307003,TRX_N-00337-58233066,2022-09-28T22:12:53,Labastida,expenses,children,-263.1,-15303.52
buyer_8,Antonio,45,ES45209530357850307003,TRX_N-00338-83549657,2022-09-30T09:44:21,Labastida,Expense,cash,-100.0,-15403.52
buyer_8,Antonio,45,ES45209530357850307003,TRX_N-00339-34859344,2022-10-01T09:27:41,Labastida,incomes,salary,1267.57,-14135.95
buyer_8,Antonio,45,ES45209530357850307003,TRX_N-00340-07939810,2022-10-01T09:27:41,Labastida,incomes,salary_partner,1586.78,-12549.17
buyer_8,Antonio,45,ES45209530357850307003,TRX_N-00341-68646921,2022-10-01T09:27:41,Labastida,incomes,extra_income,205.8,-12343.37
buyer_8,Antonio,45,ES45209530357850307003,TRX_N-00342-80077680,2022-10-01T14:29:15,Labastida,Expense,food,-66.14,-12409.51
buyer_8,Antonio,45,ES45209530357850307003,TRX_N-00343-75725652,2022-10-03T15:21:22,Labastida,Expense,food,-94.94,-12504.45
buyer_8,Antonio,45,ES45209530357850307003,TRX_N-00344-35214505,2022-10-03T13:00:47,Labastida,Expense,cash,-100.0,-12604.45
buyer_8,Antonio,45,ES45209530357850307003,TRX_N-00345-17359778,2022-10-04T19:56:42,Labastida,expenses,mortgage,-887.59,-13492.04
buyer_8,Antonio,45,ES45209530357850307003,TRX_N-00346-57757740,2022-10-04T14:08:02,Labastida,Expense,leisure,-23.46,-13515.5
buyer_8,Antonio,45,ES45209530357850307003,TRX_N-00347-13453430,2022-10-05T20:42:05,Labastida,expenses,internet,-42.0,-13557.5
buyer_8,Antonio,45,ES45209530357850307003,TRX_N-00348-52572060,2022-10-05T16:17:39,Labastida,Expense,cash,-100.0,-13657.5
buyer_8,Antonio,45,ES45209530357850307003,TRX_N-00349-43668143,2022-10-07T23:30:26,Labastida,expenses,water,-28.98,-13686.48
buyer_8,Antonio,45,ES45209530357850307003,TRX_N-00350-45429167,2022-10-07T12:50:23,Labastida,expenses,electricity,-48.55,-13735.03
buyer_8,Antonio,45,ES45209530357850307003,TRX_N-00351-88355475,2022-10-07T11:56:57,Labastida,Expense,leisure,-44.64,-13779.67
buyer_8,Antonio,45,ES45209530357850307003,TRX_N-00352-96442975,2022-10-08T09:59:07,Labastida,expenses,gas,-34.77,-13814.44
buyer_8,Antonio,45,ES45209530357850307003,TRX_N-00353-01865380,2022-10-08T12:26:35,Labastida,expenses,phone,-30.29,-13844.73
buyer_8,Antonio,45,ES45209530357850307003,TRX_N-00354-04205548,2022-10-09T14:45:38,Labastida,Expense,leisure,-53.36,-13898.09
buyer_8,Antonio,45,ES45209530357850307003,TRX_N-00355-61348344,2022-10-10T18:05:02,Amurrio,Expense,transport,-61.99,-13960.08
buyer_8,Antonio,45,ES45209530357850307003,TRX_N-00356-14052858,2022-10-10T04:20:06,Labastida,Expense,healthcare,-94.52,-14054.6
buyer_8,Antonio,45,ES45209530357850307003,TRX_N-00357-09056114,2022-10-13T13:40:16,Zarautz,Expense,cash,-100.0,-14154.6
buyer_8,Antonio,45,ES45209530357850307003,TRX_N-00358-32344623,2022-10-13T21:03:10,Labastida,Expense,repairs,-281.37,-14435.97
buyer_8,Antonio,45,ES45209530357850307003,TRX_N-00359-51301959,2022-10-14T03:22:56,Basauri,Expense,leisure,-36.27,-14472.24
buyer_8,Antonio,45,ES45209530357850307003,TRX_N-00360-43323692,2022-10-15T14:53:33,Labastida,Expense,leisure,-18.61,-14490.85
buyer_8,Antonio,45,ES45209530357850307003,TRX_N-00361-38258031,2022-10-16T09:26:13,Labastida,Expense,leisure,-37.91,-14528.76
buyer_8,Antonio,45,ES45209530357850307003,TRX_N-00362-41504557,2022-10-17T18:42:43,Labastida,Expense,food,-61.34,-14590.1
buyer_8,Antonio,45,ES45209530357850307003,TRX_N-00363-01136994,2022-10-17T08:22:25,Labastida,Expense,transport,-88.42,-14678.52
buyer_8,Antonio,45,ES45209530357850307003,TRX_N-00364-31496416,2022-10-18T15:58:58,Eibar,Expense,leisure,-27.81,-14706.33
buyer_8,Antonio,45,ES45209530357850307003,TRX_N-00365-11975502,2022-10-19T17:02:18,Labastida,Expense,food,-107.36,-14813.69
buyer_8,Antonio,45,ES45209530357850307003,TRX_N-00366-13429607,2022-10-19T12:58:31,Labastida,Expense,gifts,-417.19,-15230.88
buyer_8,Antonio,45,ES45209530357850307003,TRX_N-00367-06433499,2022-10-20T14:26:48,Oy√≥n-Oion,Expense,education,-69.12,-15300.0
buyer_8,Antonio,45,ES45209530357850307003,TRX_N-00368-32931048,2022-10-20T13:09:20,Labastida,Expense,cash,-100.0,-15400.0
buyer_8,Antonio,45,ES45209530357850307003,TRX_N-00369-68853457,2022-10-20T10:51:08,Galdakao,Expense,appliances,-366.01,-15766.01
buyer_8,Antonio,45,ES45209530357850307003,TRX_N-00370-22545651,2022-10-21T16:20:23,Labastida,Expense,transport,-84.86,-15850.87
buyer_8,Antonio,45,ES45209530357850307003,TRX_N-00371-09506436,2022-10-21T04:44:29,Sestao,Expense,leisure,-61.36,-15912.23
buyer_8,Antonio,45,ES45209530357850307003,TRX_N-00372-45896422,2022-10-23T06:23:56,Labastida,Expense,leisure,-76.72,-15988.95
buyer_8,Antonio,45,ES45209530357850307003,TRX_N-00373-19378866,2022-10-24T15:53:07,Labastida,Expense,leisure,-71.0,-16059.95
buyer_8,Antonio,45,ES45209530357850307003,TRX_N-00374-47362088,2022-10-24T15:18:04,Bermeo,Expense,gifts,-233.62,-16293.57
buyer_8,Antonio,45,ES45209530357850307003,TRX_N-00375-87573923,2022-10-25T10:54:44,Labastida,Expense,food,-109.05,-16402.62
buyer_8,Antonio,45,ES45209530357850307003,TRX_N-00376-37642533,2022-10-25T13:53:05,Labastida,Expense,cash,-100.0,-16502.62
buyer_8,Antonio,45,ES45209530357850307003,TRX_N-00377-89846485,2022-10-26T16:18:09,Labastida,Expense,leisure,-36.02,-16538.64
buyer_8,Antonio,45,ES45209530357850307003,TRX_N-00378-09047508,2022-10-26T19:15:32,Labastida,Expense,repairs,-325.92,-16864.56
buyer_8,Antonio,45,ES45209530357850307003,TRX_N-00379-01709395,2022-10-28T08:38:15,Labastida,Expense,food,-64.65,-16929.21
buyer_8,Antonio,45,ES45209530357850307003,TRX_N-00380-05098727,2022-10-30T14:29:52,Labastida,Expense,leisure,-44.51,-16973.72
buyer_8,Antonio,45,ES45209530357850307003,TRX_N-00381-22791001,2022-10-31T15:14:51,Labastida,Expense,education,-65.99,-17039.71
buyer_8,Antonio,45,ES45209530357850307003,TRX_N-00382-79703043,2022-11-01T16:39:33,Labastida,incomes,salary,1267.57,-15772.14
buyer_8,Antonio,45,ES45209530357850307003,TRX_N-00383-27661483,2022-11-01T16:39:33,Labastida,incomes,salary_partner,1586.78,-14185.36
buyer_8,Antonio,45,ES45209530357850307003,TRX_N-00384-55403934,2022-11-01T15:36:52,Labastida,Expense,leisure,-46.63,-14231.99
buyer_8,Antonio,45,ES45209530357850307003,TRX_N-00385-69873140,2022-11-02T10:34:07,Labastida,Expense,transport,-54.04,-14286.03
buyer_8,Antonio,45,ES45209530357850307003,TRX_N-00386-00908251,2022-11-03T23:20:33,Labastida,Expense,transport,-89.9,-14375.93
buyer_8,Antonio,45,ES45209530357850307003,TRX_N-00387-76451506,2022-11-03T16:29:46,Labastida,Expense,repairs,-104.58,-14480.51
buyer_8,Antonio,45,ES45209530357850307003,TRX_N-00388-13682496,2022-11-04T16:42:48,Labastida,expenses,mortgage,-887.59,-15368.1
buyer_8,Antonio,45,ES45209530357850307003,TRX_N-00389-60359670,2022-11-04T19:02:07,Labastida,Expense,food,-81.84,-15449.94
buyer_8,Antonio,45,ES45209530357850307003,TRX_N-00390-97348958,2022-11-04T22:07:02,Salvatierra/Agurain,Expense,repairs,-195.02,-15644.96
buyer_8,Antonio,45,ES45209530357850307003,TRX_N-00391-33127719,2022-11-05T15:15:57,Labastida,expenses,gas,-89.5,-15734.46
buyer_8,Antonio,45,ES45209530357850307003,TRX_N-00392-22667419,2022-11-05T18:47:32,Hondarribia,Expense,cash,-100.0,-15834.46
buyer_8,Antonio,45,ES45209530357850307003,TRX_N-00393-53354412,2022-11-06T22:10:26,Labastida,expenses,water,-38.47,-15872.93
buyer_8,Antonio,45,ES45209530357850307003,TRX_N-00394-41195602,2022-11-07T18:04:12,Labastida,expenses,internet,-42.0,-15914.93
buyer_8,Antonio,45,ES45209530357850307003,TRX_N-00395-14017597,2022-11-07T20:56:42,Labastida,Expense,repairs,-196.56,-16111.49
buyer_8,Antonio,45,ES45209530357850307003,TRX_N-00396-14293904,2022-11-08T10:40:18,Labastida,expenses,electricity,-25.03,-16136.52
buyer_8,Antonio,45,ES45209530357850307003,TRX_N-00397-01218116,2022-11-08T16:30:45,Labastida,expenses,phone,-33.95,-16170.47
buyer_8,Antonio,45,ES45209530357850307003,TRX_N-00398-01224096,2022-11-09T16:31:36,Labastida,Expense,leisure,-57.09,-16227.56
buyer_8,Antonio,45,ES45209530357850307003,TRX_N-00399-72583382,2022-11-09T01:42:33,Labastida,Expense,gifts,-202.11,-16429.67
buyer_8,Antonio,45,ES45209530357850307003,TRX_N-00400-43382168,2022-11-13T08:51:37,Labastida,Expense,food,-83.7,-16513.37
buyer_8,Antonio,45,ES45209530357850307003,TRX_N-00401-15327686,2022-11-13T15:20:26,Labastida,Expense,gifts,-712.53,-17225.9
buyer_8,Antonio,45,ES45209530357850307003,TRX_N-00402-57783664,2022-11-14T14:21:15,Labastida,Expense,education,-69.59,-17295.49
buyer_8,Antonio,45,ES45209530357850307003,TRX_N-00403-05117352,2022-11-14T08:27:57,Labastida,Expense,cash,-100.0,-17395.49
buyer_8,Antonio,45,ES45209530357850307003,TRX_N-00404-56168974,2022-11-16T14:49:26,Labastida,Expense,transport,-56.9,-17452.39
buyer_8,Antonio,45,ES45209530357850307003,TRX_N-00405-58705845,2022-11-17T12:56:30,Labastida,Expense,gifts,-767.93,-18220.32
buyer_8,Antonio,45,ES45209530357850307003,TRX_N-00406-23287044,2022-11-18T14:33:04,Labastida,Expense,cash,-100.0,-18320.32
buyer_8,Antonio,45,ES45209530357850307003,TRX_N-00407-81167551,2022-11-21T15:56:29,Labastida,Expense,healthcare,-131.33,-18451.65
buyer_8,Antonio,45,ES45209530357850307003,TRX_N-00408-06036429,2022-11-22T23:56:22,Labastida,Expense,food,-83.77,-18535.42
buyer_8,Antonio,45,ES45209530357850307003,TRX_N-00409-79592802,2022-11-22T19:50:03,Zuia,Expense,education,-50.86,-18586.28
buyer_8,Antonio,45,ES45209530357850307003,TRX_N-00410-28426136,2022-11-25T17:05:02,Labastida,Expense,repairs,-119.11,-18705.39
buyer_8,Antonio,45,ES45209530357850307003,TRX_N-00411-94226312,2022-11-27T08:07:50,Labastida,Expense,travel,-1714.56,-20419.95
buyer_8,Antonio,45,ES45209530357850307003,TRX_N-00412-46983336,2022-11-28T15:37:26,Labastida,Expense,clothing,-88.53,-20508.48
buyer_8,Antonio,45,ES45209530357850307003,TRX_N-00413-02648606,2022-11-28T13:32:07,Oy√≥n-Oion,Expense,cash,-100.0,-20608.48
buyer_8,Antonio,45,ES45209530357850307003,TRX_N-00414-47661121,2022-11-29T16:44:29,Labastida,Expense,food,-99.99,-20708.47
buyer_8,Antonio,45,ES45209530357850307003,TRX_N-00415-00612315,2022-11-29T07:06:04,Arrasate,Expense,transport,-64.07,-20772.54
buyer_8,Antonio,45,ES45209530357850307003,TRX_N-00416-78909940,2022-11-30T12:59:11,Zarautz,Expense,food,-121.01,-20893.55
buyer_8,Antonio,45,ES45209530357850307003,TRX_N-00417-78377828,2022-12-01T19:27:30,Labastida,incomes,salary,1267.57,-19625.98
buyer_8,Antonio,45,ES45209530357850307003,TRX_N-00418-91004391,2022-12-01T19:27:30,Labastida,incomes,salary_partner,1586.78,-18039.2
buyer_8,Antonio,45,ES45209530357850307003,TRX_N-00419-41906710,2022-12-01T19:27:30,Labastida,incomes,salary_bonus,1005.04,-17034.16
buyer_8,Antonio,45,ES45209530357850307003,TRX_N-00420-54110145,2022-12-01T19:27:30,Labastida,incomes,salary_partner_bonus,1218.65,-15815.51
buyer_8,Antonio,45,ES45209530357850307003,TRX_N-00421-12676899,2022-12-01T14:41:21,Labastida,Expense,transport,-41.99,-15857.5
buyer_8,Antonio,45,ES45209530357850307003,TRX_N-00422-34799039,2022-12-01T22:05:41,Labastida,Expense,clothing,-118.66,-15976.16
buyer_8,Antonio,45,ES45209530357850307003,TRX_N-00423-62781337,2022-12-02T10:22:01,Labastida,Expense,transport,-49.6,-16025.76
buyer_8,Antonio,45,ES45209530357850307003,TRX_N-00424-60370840,2022-12-03T09:33:30,Donostia,Expense,transport,-56.83,-16082.59
buyer_8,Antonio,45,ES45209530357850307003,TRX_N-00425-74271807,2022-12-04T18:38:03,Labastida,expenses,mortgage,-887.59,-16970.18
buyer_8,Antonio,45,ES45209530357850307003,TRX_N-00426-60935190,2022-12-05T09:11:45,Alegr√≠a-Dulantzi,Expense,appliances,-109.32,-17079.5
buyer_8,Antonio,45,ES45209530357850307003,TRX_N-00427-75013064,2022-12-06T20:21:25,Labastida,expenses,phone,-39.83,-17119.33
buyer_8,Antonio,45,ES45209530357850307003,TRX_N-00428-19076685,2022-12-06T13:35:59,Labastida,Expense,cash,-100.0,-17219.33
buyer_8,Antonio,45,ES45209530357850307003,TRX_N-00429-13569117,2022-12-07T06:26:37,Labastida,expenses,water,-41.84,-17261.17
buyer_8,Antonio,45,ES45209530357850307003,TRX_N-00430-91240005,2022-12-07T09:27:54,Labastida,expenses,gas,-98.14,-17359.31
buyer_8,Antonio,45,ES45209530357850307003,TRX_N-00431-91120094,2022-12-07T15:20:57,Labastida,Expense,gifts,-267.94,-17627.25
buyer_8,Antonio,45,ES45209530357850307003,TRX_N-00432-22174211,2022-12-08T14:41:25,Labastida,expenses,electricity,-51.79,-17679.04
buyer_8,Antonio,45,ES45209530357850307003,TRX_N-00433-54398227,2022-12-08T21:05:24,Labastida,expenses,internet,-42.0,-17721.04
buyer_8,Antonio,45,ES45209530357850307003,TRX_N-00434-44322013,2022-12-08T23:24:52,Labastida,Expense,food,-113.13,-17834.17
buyer_8,Antonio,45,ES45209530357850307003,TRX_N-00435-70607960,2022-12-09T20:46:04,Labastida,expenses,children,-86.06,-17920.23
buyer_8,Antonio,45,ES45209530357850307003,TRX_N-00436-11661681,2022-12-10T10:54:33,Labastida,Expense,food,-122.15,-18042.38
buyer_8,Antonio,45,ES45209530357850307003,TRX_N-00437-56121425,2022-12-12T10:27:22,Labastida,Expense,transport,-75.06,-18117.44
buyer_8,Antonio,45,ES45209530357850307003,TRX_N-00438-55729759,2022-12-12T17:22:20,Labastida,Expense,education,-71.82,-18189.26
buyer_8,Antonio,45,ES45209530357850307003,TRX_N-00439-77446716,2022-12-13T19:12:09,Labastida,Expense,travel,-849.82,-19039.08
buyer_8,Antonio,45,ES45209530357850307003,TRX_N-00440-51960076,2022-12-15T11:27:07,Errenteria,Expense,transport,-65.72,-19104.8
buyer_8,Antonio,45,ES45209530357850307003,TRX_N-00441-10728860,2022-12-16T08:37:13,Labastida,Expense,travel,-904.15,-20008.95
buyer_8,Antonio,45,ES45209530357850307003,TRX_N-00442-60076076,2022-12-16T11:28:00,Labastida,expenses,children,-101.25,-20110.2
buyer_8,Antonio,45,ES45209530357850307003,TRX_N-00443-26042210,2022-12-18T01:41:57,Labastida,Expense,transport,-50.78,-20160.98
buyer_8,Antonio,45,ES45209530357850307003,TRX_N-00444-87564994,2022-12-23T04:02:07,Labastida,Expense,cash,-100.0,-20260.98
buyer_8,Antonio,45,ES45209530357850307003,TRX_N-00445-94515610,2022-12-26T13:35:27,Labastida,Expense,food,-122.81,-20383.79
buyer_8,Antonio,45,ES45209530357850307003,TRX_N-00446-82702391,2022-12-26T21:55:07,Lasarte-Oria,Expense,cash,-100.0,-20483.79
buyer_8,Antonio,45,ES45209530357850307003,TRX_N-00447-86475787,2022-12-28T08:26:53,Labastida,Expense,transport,-77.02,-20560.81
buyer_8,Antonio,45,ES45209530357850307003,TRX_N-00448-02029466,2022-12-30T21:14:55,Labastida,Expense,gifts,-207.32,-20768.13
buyer_8,Antonio,45,ES45209530357850307003,TRX_N-00449-68891483,2023-01-01T14:41:57,Labastida,incomes,salary,1304.78,-19463.35
buyer_8,Antonio,45,ES45209530357850307003,TRX_N-00450-92946601,2023-01-01T14:41:57,Labastida,incomes,salary_partner,1633.36,-17829.99
buyer_8,Antonio,45,ES45209530357850307003,TRX_N-00451-11150333,2023-01-01T14:41:57,Labastida,incomes,extra_income,205.8,-17624.19
buyer_8,Antonio,45,ES45209530357850307003,TRX_N-00452-54529556,2023-01-01T07:35:24,Labastida,Expense,transport,-70.17,-17694.36
buyer_8,Antonio,45,ES45209530357850307003,TRX_N-00453-67467246,2023-01-01T17:38:57,Labastida,Expense,clothing,-154.03,-17848.39
buyer_8,Antonio,45,ES45209530357850307003,TRX_N-00454-37390522,2023-01-01T20:50:07,Labastida,Expense,cash,-100.0,-17948.39
buyer_8,Antonio,45,ES45209530357850307003,TRX_N-00455-19991730,2023-01-03T20:23:33,Labastida,Expense,leisure,-35.65,-17984.04
buyer_8,Antonio,45,ES45209530357850307003,TRX_N-00456-56548539,2023-01-03T23:13:42,Labastida,Expense,healthcare,-117.9,-18101.94
buyer_8,Antonio,45,ES45209530357850307003,TRX_N-00457-20423826,2023-01-04T11:17:45,Labastida,expenses,mortgage,-887.59,-18989.53
buyer_8,Antonio,45,ES45209530357850307003,TRX_N-00458-84332254,2023-01-07T12:27:08,Labastida,expenses,phone,-33.36,-19022.89
buyer_8,Antonio,45,ES45209530357850307003,TRX_N-00459-41079126,2023-01-07T14:54:56,Andoain,Expense,appliances,-380.64,-19403.53
buyer_8,Antonio,45,ES45209530357850307003,TRX_N-00460-41871642,2023-01-08T18:43:08,Labastida,expenses,electricity,-26.44,-19429.97
buyer_8,Antonio,45,ES45209530357850307003,TRX_N-00461-87158182,2023-01-08T10:14:50,Labastida,expenses,internet,-42.0,-19471.97
buyer_8,Antonio,45,ES45209530357850307003,TRX_N-00462-99452722,2023-01-08T12:49:35,Labastida,expenses,water,-34.91,-19506.88
buyer_8,Antonio,45,ES45209530357850307003,TRX_N-00463-31819498,2023-01-08T02:48:18,Labastida,expenses,gas,-90.02,-19596.9
buyer_8,Antonio,45,ES45209530357850307003,TRX_N-00464-93569148,2023-01-09T22:04:44,Labastida,Expense,transport,-85.79,-19682.69
buyer_8,Antonio,45,ES45209530357850307003,TRX_N-00465-24195198,2023-01-09T17:25:55,Labastida,Expense,clothing,-145.17,-19827.86
buyer_8,Antonio,45,ES45209530357850307003,TRX_N-00466-90285782,2023-01-09T18:47:26,Labastida,Expense,travel,-787.96,-20615.82
buyer_8,Antonio,45,ES45209530357850307003,TRX_N-00467-17832296,2023-01-10T16:34:17,Labastida,Expense,leisure,-76.73,-20692.55
buyer_8,Antonio,45,ES45209530357850307003,TRX_N-00468-31305258,2023-01-11T18:05:09,Labastida,Expense,leisure,-39.1,-20731.65
buyer_8,Antonio,45,ES45209530357850307003,TRX_N-00469-50215951,2023-01-12T14:37:05,Labastida,Expense,cash,-100.0,-20831.65
buyer_8,Antonio,45,ES45209530357850307003,TRX_N-00470-56750753,2023-01-13T17:03:33,Labastida,Expense,transport,-84.72,-20916.37
buyer_8,Antonio,45,ES45209530357850307003,TRX_N-00471-11356551,2023-01-13T10:35:38,Bermeo,Expense,repairs,-109.96,-21026.33
buyer_8,Antonio,45,ES45209530357850307003,TRX_N-00472-57730744,2023-01-15T17:36:00,Labastida,Expense,gifts,-180.99,-21207.32
buyer_8,Antonio,45,ES45209530357850307003,TRX_N-00473-56951951,2023-01-16T11:59:15,Labastida,Expense,food,-79.96,-21287.28
buyer_8,Antonio,45,ES45209530357850307003,TRX_N-00474-22303276,2023-01-17T09:01:54,Labastida,Expense,leisure,-65.79,-21353.07
buyer_8,Antonio,45,ES45209530357850307003,TRX_N-00475-52733649,2023-01-18T09:55:52,Labastida,Expense,leisure,-62.91,-21415.98
buyer_8,Antonio,45,ES45209530357850307003,TRX_N-00476-93997990,2023-01-18T16:54:12,Leioa,Expense,education,-60.85,-21476.83
buyer_8,Antonio,45,ES45209530357850307003,TRX_N-00477-68633406,2023-01-20T12:26:26,Donostia,Expense,clothing,-124.57,-21601.4
buyer_8,Antonio,45,ES45209530357850307003,TRX_N-00478-44620207,2023-01-21T13:07:41,Errenteria,Expense,clothing,-82.59,-21683.99
buyer_8,Antonio,45,ES45209530357850307003,TRX_N-00479-30896173,2023-01-22T19:22:08,Labastida,Expense,transport,-77.5,-21761.49
buyer_8,Antonio,45,ES45209530357850307003,TRX_N-00480-16665425,2023-01-23T22:10:05,Elciego,Expense,food,-102.18,-21863.67
buyer_8,Antonio,45,ES45209530357850307003,TRX_N-00481-22186747,2023-01-24T10:29:03,Labastida,Expense,transport,-87.33,-21951.0
buyer_8,Antonio,45,ES45209530357850307003,TRX_N-00482-82947896,2023-01-25T19:32:36,Labastida,Expense,leisure,-66.75,-22017.75
buyer_8,Antonio,45,ES45209530357850307003,TRX_N-00483-73633794,2023-01-26T18:15:57,Labastida,Expense,food,-77.4,-22095.15
buyer_8,Antonio,45,ES45209530357850307003,TRX_N-00484-39731617,2023-01-27T13:30:23,Labastida,Expense,transport,-87.14,-22182.29
buyer_8,Antonio,45,ES45209530357850307003,TRX_N-00485-74778974,2023-01-27T17:45:35,Labastida,Expense,leisure,-71.55,-22253.84
buyer_8,Antonio,45,ES45209530357850307003,TRX_N-00486-22288158,2023-01-27T20:07:33,Labastida,expenses,children,-56.11,-22309.95
buyer_8,Antonio,45,ES45209530357850307003,TRX_N-00487-69619602,2023-01-29T18:52:12,Labastida,Expense,cash,-100.0,-22409.95
buyer_8,Antonio,45,ES45209530357850307003,TRX_N-00488-96019894,2023-02-01T13:51:33,Labastida,incomes,salary,1304.78,-21105.17
buyer_8,Antonio,45,ES45209530357850307003,TRX_N-00489-89698151,2023-02-01T13:51:33,Labastida,incomes,salary_partner,1633.36,-19471.81
buyer_8,Antonio,45,ES45209530357850307003,TRX_N-00490-74810817,2023-02-02T14:39:45,Labastida,Expense,food,-120.62,-19592.43
buyer_8,Antonio,45,ES45209530357850307003,TRX_N-00491-41143738,2023-02-02T08:30:50,Labastida,Expense,cash,-100.0,-19692.43
buyer_8,Antonio,45,ES45209530357850307003,TRX_N-00492-61555391,2023-02-04T14:04:16,Labastida,expenses,mortgage,-887.59,-20580.02
buyer_8,Antonio,45,ES45209530357850307003,TRX_N-00493-47977431,2023-02-04T17:08:13,Labastida,Expense,food,-67.17,-20647.19
buyer_8,Antonio,45,ES45209530357850307003,TRX_N-00494-38155094,2023-02-04T18:19:26,Labastida,Expense,leisure,-80.16,-20727.35
buyer_8,Antonio,45,ES45209530357850307003,TRX_N-00495-07417340,2023-02-04T07:27:09,Labastida,Expense,repairs,-34.38,-20761.73
buyer_8,Antonio,45,ES45209530357850307003,TRX_N-00496-52387530,2023-02-04T15:24:56,Labastida,expenses,children,-140.43,-20902.16
buyer_8,Antonio,45,ES45209530357850307003,TRX_N-00497-17083027,2023-02-05T10:26:55,Labastida,expenses,phone,-32.17,-20934.33
buyer_8,Antonio,45,ES45209530357850307003,TRX_N-00498-21219781,2023-02-05T16:17:46,Labastida,Expense,education,-45.44,-20979.77
buyer_8,Antonio,45,ES45209530357850307003,TRX_N-00499-94722596,2023-02-06T08:05:33,Labastida,expenses,water,-24.92,-21004.69
buyer_8,Antonio,45,ES45209530357850307003,TRX_N-00500-17291852,2023-02-06T11:41:30,Labastida,expenses,electricity,-39.7,-21044.39
buyer_8,Antonio,45,ES45209530357850307003,TRX_N-00501-65717554,2023-02-06T16:12:56,Labastida,Expense,cash,-100.0,-21144.39
buyer_8,Antonio,45,ES45209530357850307003,TRX_N-00502-88456371,2023-02-07T10:25:55,Labastida,expenses,gas,-76.2,-21220.59
buyer_8,Antonio,45,ES45209530357850307003,TRX_N-00503-06417786,2023-02-07T09:19:36,Labastida,Expense,food,-121.23,-21341.82
buyer_8,Antonio,45,ES45209530357850307003,TRX_N-00504-76984850,2023-02-07T19:17:24,Berango,Expense,leisure,-20.42,-21362.24
buyer_8,Antonio,45,ES45209530357850307003,TRX_N-00505-67613134,2023-02-08T11:54:49,Labastida,expenses,internet,-42.0,-21404.24
buyer_8,Antonio,45,ES45209530357850307003,TRX_N-00506-97787144,2023-02-09T14:42:14,Labastida,expenses,children,-230.23,-21634.47
buyer_8,Antonio,45,ES45209530357850307003,TRX_N-00507-17199271,2023-02-10T08:17:33,Labastida,Expense,food,-83.76,-21718.23
buyer_8,Antonio,45,ES45209530357850307003,TRX_N-00508-94393224,2023-02-10T08:48:41,Andoain,Expense,repairs,-300.09,-22018.32
buyer_8,Antonio,45,ES45209530357850307003,TRX_N-00509-70811348,2023-02-11T08:16:19,Berango,Expense,food,-93.18,-22111.5
buyer_8,Antonio,45,ES45209530357850307003,TRX_N-00510-02737273,2023-02-13T10:27:07,Labastida,Expense,leisure,-75.35,-22186.85
buyer_8,Antonio,45,ES45209530357850307003,TRX_N-00511-46831396,2023-02-13T08:52:19,Labastida,Expense,cash,-100.0,-22286.85
buyer_8,Antonio,45,ES45209530357850307003,TRX_N-00512-14443652,2023-02-16T16:35:19,Berango,Expense,repairs,-29.76,-22316.61
buyer_8,Antonio,45,ES45209530357850307003,TRX_N-00513-70133972,2023-02-17T08:12:19,Labastida,Expense,clothing,-104.17,-22420.78
buyer_8,Antonio,45,ES45209530357850307003,TRX_N-00514-72961550,2023-02-18T13:54:29,Labastida,Expense,cash,-100.0,-22520.78
buyer_8,Antonio,45,ES45209530357850307003,TRX_N-00515-16315477,2023-02-19T09:38:33,Labastida,Expense,gifts,-629.55,-23150.33
buyer_8,Antonio,45,ES45209530357850307003,TRX_N-00516-50355315,2023-02-23T12:40:19,Labastida,Expense,travel,-1566.76,-24717.09
buyer_8,Antonio,45,ES45209530357850307003,TRX_N-00517-95859727,2023-02-27T10:56:12,Labastida,Expense,transport,-51.2,-24768.29
buyer_8,Antonio,45,ES45209530357850307003,TRX_N-00518-68160907,2023-02-27T16:49:49,Labastida,Expense,cash,-100.0,-24868.29
buyer_8,Antonio,45,ES45209530357850307003,TRX_N-00519-99156949,2023-02-28T13:23:42,Leioa,Expense,food,-116.06,-24984.35
buyer_8,Antonio,45,ES45209530357850307003,TRX_N-00520-45475095,2023-02-28T15:23:11,Hondarribia,Expense,repairs,-42.18,-25026.53
buyer_8,Antonio,45,ES45209530357850307003,TRX_N-00521-32514917,2023-03-01T08:41:34,Labastida,incomes,salary,1304.78,-23721.75
buyer_8,Antonio,45,ES45209530357850307003,TRX_N-00522-72097508,2023-03-01T08:41:34,Labastida,incomes,salary_partner,1633.36,-22088.39
buyer_8,Antonio,45,ES45209530357850307003,TRX_N-00523-03969804,2023-03-01T09:16:29,Labastida,Expense,repairs,-274.56,-22362.95
buyer_8,Antonio,45,ES45209530357850307003,TRX_N-00524-55215424,2023-03-04T15:07:00,Labastida,expenses,mortgage,-887.59,-23250.54
buyer_8,Antonio,45,ES45209530357850307003,TRX_N-00525-71591865,2023-03-04T19:53:10,Labastida,Expense,leisure,-20.17,-23270.71
buyer_8,Antonio,45,ES45209530357850307003,TRX_N-00526-01388882,2023-03-04T11:42:55,Labastida,Expense,cash,-100.0,-23370.71
buyer_8,Antonio,45,ES45209530357850307003,TRX_N-00527-07799229,2023-03-05T09:16:01,Labastida,expenses,water,-21.42,-23392.13
buyer_8,Antonio,45,ES45209530357850307003,TRX_N-00528-31150922,2023-03-05T21:31:02,Labastida,expenses,gas,-111.17,-23503.3
buyer_8,Antonio,45,ES45209530357850307003,TRX_N-00529-95699996,2023-03-05T16:13:45,Labastida,Expense,food,-69.32,-23572.62
buyer_8,Antonio,45,ES45209530357850307003,TRX_N-00530-60447118,2023-03-05T09:34:45,Labastida,Expense,leisure,-24.22,-23596.84
buyer_8,Antonio,45,ES45209530357850307003,TRX_N-00531-56757396,2023-03-06T11:24:54,Labastida,expenses,electricity,-85.53,-23682.37
buyer_8,Antonio,45,ES45209530357850307003,TRX_N-00532-06170284,2023-03-06T16:41:37,Labastida,expenses,internet,-42.0,-23724.37
buyer_8,Antonio,45,ES45209530357850307003,TRX_N-00533-90631338,2023-03-06T17:53:06,Labastida,expenses,phone,-42.21,-23766.58
buyer_8,Antonio,45,ES45209530357850307003,TRX_N-00534-40555821,2023-03-06T09:42:59,Labastida,Expense,transport,-45.34,-23811.92
buyer_8,Antonio,45,ES45209530357850307003,TRX_N-00535-71883241,2023-03-08T12:36:06,Labastida,Expense,transport,-60.02,-23871.94
buyer_8,Antonio,45,ES45209530357850307003,TRX_N-00536-34550705,2023-03-08T09:56:28,Labastida,Expense,cash,-100.0,-23971.94
buyer_8,Antonio,45,ES45209530357850307003,TRX_N-00537-36197276,2023-03-10T12:16:00,Labastida,Expense,appliances,-273.42,-24245.36
buyer_8,Antonio,45,ES45209530357850307003,TRX_N-00538-86841317,2023-03-11T08:08:03,Labastida,Expense,leisure,-61.89,-24307.25
buyer_8,Antonio,45,ES45209530357850307003,TRX_N-00539-34924207,2023-03-11T16:55:51,Labastida,Expense,cash,-100.0,-24407.25
buyer_8,Antonio,45,ES45209530357850307003,TRX_N-00540-62813454,2023-03-13T17:25:05,Labastida,Expense,gifts,-596.02,-25003.27
buyer_8,Antonio,45,ES45209530357850307003,TRX_N-00541-07588983,2023-03-14T12:31:11,Llodio,Expense,cash,-100.0,-25103.27
buyer_8,Antonio,45,ES45209530357850307003,TRX_N-00542-09296901,2023-03-15T12:12:04,Labastida,Expense,food,-75.8,-25179.07
buyer_8,Antonio,45,ES45209530357850307003,TRX_N-00543-51138652,2023-03-15T10:21:25,Labastida,Expense,repairs,-198.46,-25377.53
buyer_8,Antonio,45,ES45209530357850307003,TRX_N-00544-05020688,2023-03-16T12:31:41,Labastida,Expense,repairs,-40.53,-25418.06
buyer_8,Antonio,45,ES45209530357850307003,TRX_N-00545-11757242,2023-03-18T05:26:31,Hondarribia,Expense,food,-72.77,-25490.83
buyer_8,Antonio,45,ES45209530357850307003,TRX_N-00546-48844383,2023-03-22T12:51:01,Labastida,Expense,leisure,-32.6,-25523.43
buyer_8,Antonio,45,ES45209530357850307003,TRX_N-00547-93987502,2023-03-25T14:35:27,Labastida,Expense,cash,-100.0,-25623.43
buyer_8,Antonio,45,ES45209530357850307003,TRX_N-00548-74819355,2023-03-25T12:53:31,Labastida,Expense,repairs,-288.37,-25911.8
buyer_8,Antonio,45,ES45209530357850307003,TRX_N-00549-40978833,2023-03-26T08:28:53,Labastida,Expense,clothing,-85.08,-25996.88
buyer_8,Antonio,45,ES45209530357850307003,TRX_N-00550-87986900,2023-03-26T18:14:35,Labastida,Expense,gifts,-34.24,-26031.12
buyer_8,Antonio,45,ES45209530357850307003,TRX_N-00551-91690148,2023-03-27T01:38:15,Andoain,Expense,clothing,-61.91,-26093.03
buyer_8,Antonio,45,ES45209530357850307003,TRX_N-00552-60613765,2023-03-28T19:57:49,Labastida,Expense,cash,-100.0,-26193.03
buyer_8,Antonio,45,ES45209530357850307003,TRX_N-00553-96759257,2023-03-30T08:49:03,Labastida,Expense,cash,-100.0,-26293.03
buyer_8,Antonio,45,ES45209530357850307003,TRX_N-00554-59870077,2023-04-01T11:28:26,Labastida,incomes,salary,1304.78,-24988.25
buyer_8,Antonio,45,ES45209530357850307003,TRX_N-00555-53083949,2023-04-01T11:28:26,Labastida,incomes,salary_partner,1633.36,-23354.89
buyer_8,Antonio,45,ES45209530357850307003,TRX_N-00556-23586933,2023-04-01T11:28:26,Labastida,incomes,extra_income,205.8,-23149.09
buyer_8,Antonio,45,ES45209530357850307003,TRX_N-00557-40766911,2023-04-02T17:31:12,Labastida,Expense,transport,-88.49,-23237.58
buyer_8,Antonio,45,ES45209530357850307003,TRX_N-00558-50671693,2023-04-02T00:00:43,Labastida,Expense,leisure,-80.8,-23318.38
buyer_8,Antonio,45,ES45209530357850307003,TRX_N-00559-53962333,2023-04-02T23:43:17,Labastida,Expense,cash,-100.0,-23418.38
buyer_8,Antonio,45,ES45209530357850307003,TRX_N-00560-16106281,2023-04-04T15:25:20,Labastida,expenses,mortgage,-887.59,-24305.97
buyer_8,Antonio,45,ES45209530357850307003,TRX_N-00561-58022744,2023-04-04T09:29:27,Labastida,Expense,leisure,-80.09,-24386.06
buyer_8,Antonio,45,ES45209530357850307003,TRX_N-00562-23884020,2023-04-05T04:50:19,Labastida,expenses,water,-44.63,-24430.69
buyer_8,Antonio,45,ES45209530357850307003,TRX_N-00563-88650680,2023-04-05T18:37:29,Labastida,expenses,electricity,-33.84,-24464.53
buyer_8,Antonio,45,ES45209530357850307003,TRX_N-00564-05354441,2023-04-05T09:52:47,Labastida,expenses,gas,-55.79,-24520.32
buyer_8,Antonio,45,ES45209530357850307003,TRX_N-00565-05819504,2023-04-05T16:28:28,Labastida,expenses,internet,-42.0,-24562.32
buyer_8,Antonio,45,ES45209530357850307003,TRX_N-00566-72806816,2023-04-05T20:10:27,Labastida,expenses,phone,-38.17,-24600.49
buyer_8,Antonio,45,ES45209530357850307003,TRX_N-00567-98300322,2023-04-06T16:40:31,Labastida,Expense,gifts,-454.83,-25055.32
buyer_8,Antonio,45,ES45209530357850307003,TRX_N-00568-39261629,2023-04-06T12:01:57,Labastida,expenses,children,-70.55,-25125.87
buyer_8,Antonio,45,ES45209530357850307003,TRX_N-00569-82185023,2023-04-08T11:33:29,Labastida,Expense,transport,-52.33,-25178.2
buyer_8,Antonio,45,ES45209530357850307003,TRX_N-00570-02444142,2023-04-08T16:21:17,Vitoria-Gasteiz,Expense,repairs,-136.07,-25314.27
buyer_8,Antonio,45,ES45209530357850307003,TRX_N-00571-72482514,2023-04-13T10:58:48,Labastida,Expense,leisure,-57.31,-25371.58
buyer_8,Antonio,45,ES45209530357850307003,TRX_N-00572-23612940,2023-04-13T03:50:33,Sopela,Expense,cash,-100.0,-25471.58
buyer_8,Antonio,45,ES45209530357850307003,TRX_N-00573-03551064,2023-04-14T18:59:10,Labastida,Expense,food,-98.8,-25570.38
buyer_8,Antonio,45,ES45209530357850307003,TRX_N-00574-01309345,2023-04-15T11:13:11,Labastida,Expense,food,-86.75,-25657.13
buyer_8,Antonio,45,ES45209530357850307003,TRX_N-00575-78642601,2023-04-19T16:49:28,Labastida,expenses,children,-53.6,-25710.73
buyer_8,Antonio,45,ES45209530357850307003,TRX_N-00576-76239444,2023-04-20T19:21:18,Labastida,Expense,food,-74.56,-25785.29
buyer_8,Antonio,45,ES45209530357850307003,TRX_N-00577-29989931,2023-04-20T14:07:33,Labastida,Expense,transport,-63.23,-25848.52
buyer_8,Antonio,45,ES45209530357850307003,TRX_N-00578-14473455,2023-04-20T14:26:28,Labastida,Expense,clothing,-156.0,-26004.52
buyer_8,Antonio,45,ES45209530357850307003,TRX_N-00579-66775634,2023-04-21T20:20:39,Labastida,Expense,food,-91.64,-26096.16
buyer_8,Antonio,45,ES45209530357850307003,TRX_N-00580-42823482,2023-04-23T07:41:22,Labastida,Expense,repairs,-178.29,-26274.45
buyer_8,Antonio,45,ES45209530357850307003,TRX_N-00581-56085893,2023-04-23T10:01:43,Labastida,Expense,gifts,-663.85,-26938.3
buyer_8,Antonio,45,ES45209530357850307003,TRX_N-00582-09673385,2023-04-25T20:09:58,Labastida,Expense,food,-75.2,-27013.5
buyer_8,Antonio,45,ES45209530357850307003,TRX_N-00583-89234032,2023-04-26T16:12:48,Labastida,Expense,education,-71.46,-27084.96
buyer_8,Antonio,45,ES45209530357850307003,TRX_N-00584-98696164,2023-04-27T14:48:57,Erandio,Expense,food,-121.29,-27206.25
buyer_8,Antonio,45,ES45209530357850307003,TRX_N-00585-43128011,2023-04-28T01:07:32,Labastida,Expense,leisure,-58.67,-27264.92
buyer_8,Antonio,45,ES45209530357850307003,TRX_N-00586-59363917,2023-04-28T09:09:53,Labastida,Expense,gifts,-368.07,-27632.99
buyer_8,Antonio,45,ES45209530357850307003,TRX_N-00587-30716340,2023-04-29T13:59:19,Oy√≥n-Oion,Expense,cash,-100.0,-27732.99
buyer_8,Antonio,45,ES45209530357850307003,TRX_N-00588-15844802,2023-04-29T14:26:15,Labastida,Expense,repairs,-118.48,-27851.47
buyer_8,Antonio,45,ES45209530357850307003,TRX_N-00589-67890873,2023-04-30T09:57:33,Labastida,Expense,transport,-80.25,-27931.72
buyer_8,Antonio,45,ES45209530357850307003,TRX_N-00590-25916813,2023-04-30T19:39:40,Labastida,Expense,leisure,-69.6,-28001.32
buyer_8,Antonio,45,ES45209530357850307003,TRX_N-00591-39690409,2023-04-30T16:49:03,Labastida,Expense,cash,-100.0,-28101.32
buyer_8,Antonio,45,ES45209530357850307003,TRX_N-00592-23925307,2023-04-30T22:34:04,Labastida,expenses,children,-128.2,-28229.52
buyer_8,Antonio,45,ES45209530357850307003,TRX_N-00593-60527451,2023-05-01T12:09:48,Labastida,incomes,salary,1304.78,-26924.74
buyer_8,Antonio,45,ES45209530357850307003,TRX_N-00594-04718426,2023-05-01T12:09:48,Labastida,incomes,salary_partner,1633.36,-25291.38
buyer_8,Antonio,45,ES45209530357850307003,TRX_N-00595-12517118,2023-05-01T12:26:09,Labastida,Expense,transport,-67.44,-25358.82
buyer_8,Antonio,45,ES45209530357850307003,TRX_N-00596-31538745,2023-05-01T12:42:11,Labastida,Expense,education,-49.09,-25407.91
buyer_8,Antonio,45,ES45209530357850307003,TRX_N-00597-78361771,2023-05-02T13:40:27,Zuia,Expense,cash,-100.0,-25507.91
buyer_8,Antonio,45,ES45209530357850307003,TRX_N-00598-41264404,2023-05-02T15:34:38,Labastida,Expense,gifts,-283.93,-25791.84
buyer_8,Antonio,45,ES45209530357850307003,TRX_N-00599-85391601,2023-05-03T16:50:13,Labastida,Expense,leisure,-70.71,-25862.55
buyer_8,Antonio,45,ES45209530357850307003,TRX_N-00600-21970833,2023-05-03T11:09:45,Labastida,expenses,children,-121.66,-25984.21
buyer_8,Antonio,45,ES45209530357850307003,TRX_N-00601-90479437,2023-05-04T14:39:37,Labastida,expenses,mortgage,-887.59,-26871.8
buyer_8,Antonio,45,ES45209530357850307003,TRX_N-00602-10557518,2023-05-04T11:23:45,Labastida,Expense,gifts,-533.52,-27405.32
buyer_8,Antonio,45,ES45209530357850307003,TRX_N-00603-65111015,2023-05-05T09:19:17,Labastida,Expense,transport,-52.89,-27458.21
buyer_8,Antonio,45,ES45209530357850307003,TRX_N-00604-93929502,2023-05-06T11:53:43,Labastida,expenses,gas,-69.56,-27527.77
buyer_8,Antonio,45,ES45209530357850307003,TRX_N-00605-14257893,2023-05-06T14:01:11,Labastida,expenses,internet,-42.0,-27569.77
buyer_8,Antonio,45,ES45209530357850307003,TRX_N-00606-24798797,2023-05-06T19:53:11,Labastida,Expense,food,-104.36,-27674.13
buyer_8,Antonio,45,ES45209530357850307003,TRX_N-00607-68161572,2023-05-08T18:31:09,Labastida,expenses,water,-37.7,-27711.83
buyer_8,Antonio,45,ES45209530357850307003,TRX_N-00608-49639061,2023-05-08T10:50:05,Labastida,expenses,electricity,-53.8,-27765.63
buyer_8,Antonio,45,ES45209530357850307003,TRX_N-00609-21945723,2023-05-08T11:59:22,Labastida,expenses,phone,-39.17,-27804.8
buyer_8,Antonio,45,ES45209530357850307003,TRX_N-00610-34145047,2023-05-08T18:40:40,Portugalete,Expense,leisure,-76.24,-27881.04
buyer_8,Antonio,45,ES45209530357850307003,TRX_N-00611-03146407,2023-05-12T08:21:44,Zuia,Expense,transport,-51.55,-27932.59
buyer_8,Antonio,45,ES45209530357850307003,TRX_N-00612-36706662,2023-05-13T22:18:43,Labastida,Expense,leisure,-47.18,-27979.77
buyer_8,Antonio,45,ES45209530357850307003,TRX_N-00613-58251271,2023-05-14T21:36:13,Labastida,Expense,transport,-58.47,-28038.24
buyer_8,Antonio,45,ES45209530357850307003,TRX_N-00614-75221398,2023-05-14T23:32:56,Labastida,Expense,leisure,-62.98,-28101.22
buyer_8,Antonio,45,ES45209530357850307003,TRX_N-00615-96732224,2023-05-14T13:51:31,Labastida,Expense,education,-59.25,-28160.47
buyer_8,Antonio,45,ES45209530357850307003,TRX_N-00616-70377690,2023-05-15T15:45:00,Labastida,Expense,leisure,-41.68,-28202.15
buyer_8,Antonio,45,ES45209530357850307003,TRX_N-00617-50606483,2023-05-16T14:10:59,Labastida,Expense,cash,-100.0,-28302.15
buyer_8,Antonio,45,ES45209530357850307003,TRX_N-00618-93858808,2023-05-18T10:23:17,Labastida,Expense,cash,-100.0,-28402.15
buyer_8,Antonio,45,ES45209530357850307003,TRX_N-00619-95495858,2023-05-18T16:01:56,Labastida,Expense,repairs,-55.65,-28457.8
buyer_8,Antonio,45,ES45209530357850307003,TRX_N-00620-58552515,2023-05-19T21:47:56,Labastida,Expense,food,-87.0,-28544.8
buyer_8,Antonio,45,ES45209530357850307003,TRX_N-00621-60762041,2023-05-23T17:52:06,Labastida,Expense,transport,-64.41,-28609.21
buyer_8,Antonio,45,ES45209530357850307003,TRX_N-00622-82630263,2023-05-23T09:37:10,Labastida,Expense,leisure,-52.78,-28661.99
buyer_8,Antonio,45,ES45209530357850307003,TRX_N-00623-92252447,2023-05-24T15:10:44,Donostia,Expense,clothing,-46.64,-28708.63
buyer_8,Antonio,45,ES45209530357850307003,TRX_N-00624-94566352,2023-05-24T11:05:54,Labastida,Expense,gifts,-284.0,-28992.63
buyer_8,Antonio,45,ES45209530357850307003,TRX_N-00625-09204192,2023-05-26T12:04:23,Labastida,Expense,transport,-87.54,-29080.17
buyer_8,Antonio,45,ES45209530357850307003,TRX_N-00626-21439518,2023-06-01T12:45:34,Labastida,incomes,salary,1304.78,-27775.39
buyer_8,Antonio,45,ES45209530357850307003,TRX_N-00627-64282469,2023-06-01T12:45:34,Labastida,incomes,salary_partner,1633.36,-26142.03
buyer_8,Antonio,45,ES45209530357850307003,TRX_N-00628-21525752,2023-06-01T12:45:34,Labastida,incomes,salary_bonus,1025.97,-25116.06
buyer_8,Antonio,45,ES45209530357850307003,TRX_N-00629-71865127,2023-06-01T12:45:34,Labastida,incomes,salary_partner_bonus,1223.31,-23892.75
buyer_8,Antonio,45,ES45209530357850307003,TRX_N-00630-34031103,2023-06-03T12:05:51,Galdakao,Expense,transport,-84.44,-23977.19
buyer_8,Antonio,45,ES45209530357850307003,TRX_N-00631-20335550,2023-06-04T09:38:06,Labastida,expenses,mortgage,-887.59,-24864.78
buyer_8,Antonio,45,ES45209530357850307003,TRX_N-00632-13777502,2023-06-04T15:55:36,Llodio,Expense,food,-116.11,-24980.89
buyer_8,Antonio,45,ES45209530357850307003,TRX_N-00633-00560736,2023-06-04T19:49:30,Labastida,Expense,transport,-43.86,-25024.75
buyer_8,Antonio,45,ES45209530357850307003,TRX_N-00634-24808346,2023-06-05T14:01:09,Labastida,expenses,children,-242.06,-25266.81
buyer_8,Antonio,45,ES45209530357850307003,TRX_N-00635-35211018,2023-06-06T16:22:25,Labastida,expenses,water,-20.55,-25287.36
buyer_8,Antonio,45,ES45209530357850307003,TRX_N-00636-34911498,2023-06-06T18:59:58,Labastida,expenses,internet,-42.0,-25329.36
buyer_8,Antonio,45,ES45209530357850307003,TRX_N-00637-12049289,2023-06-06T09:46:01,Bermeo,Expense,clothing,-46.5,-25375.86
buyer_8,Antonio,45,ES45209530357850307003,TRX_N-00638-59158406,2023-06-07T15:24:02,Labastida,expenses,phone,-39.84,-25415.7
buyer_8,Antonio,45,ES45209530357850307003,TRX_N-00639-15332613,2023-06-08T10:40:57,Labastida,expenses,electricity,-70.87,-25486.57
buyer_8,Antonio,45,ES45209530357850307003,TRX_N-00640-36191329,2023-06-08T10:38:52,Labastida,expenses,gas,-46.99,-25533.56
buyer_8,Antonio,45,ES45209530357850307003,TRX_N-00641-66022038,2023-06-08T02:36:24,Labastida,Expense,leisure,-19.68,-25553.24
buyer_8,Antonio,45,ES45209530357850307003,TRX_N-00642-10841821,2023-06-10T11:39:24,Labastida,Expense,healthcare,-160.86,-25714.1
buyer_8,Antonio,45,ES45209530357850307003,TRX_N-00643-01377236,2023-06-10T11:46:56,Bilbao,Expense,cash,-100.0,-25814.1
buyer_8,Antonio,45,ES45209530357850307003,TRX_N-00644-08583728,2023-06-11T20:51:01,Labastida,Expense,food,-119.21,-25933.31
buyer_8,Antonio,45,ES45209530357850307003,TRX_N-00645-50043601,2023-06-11T09:22:25,Labastida,Expense,appliances,-403.42,-26336.73
buyer_8,Antonio,45,ES45209530357850307003,TRX_N-00646-91601229,2023-06-12T06:14:20,Labastida,Expense,healthcare,-114.92,-26451.65
buyer_8,Antonio,45,ES45209530357850307003,TRX_N-00647-95053558,2023-06-12T10:45:21,Labastida,Expense,cash,-100.0,-26551.65
buyer_8,Antonio,45,ES45209530357850307003,TRX_N-00648-64235136,2023-06-14T18:59:02,Labastida,Expense,transport,-78.21,-26629.86
buyer_8,Antonio,45,ES45209530357850307003,TRX_N-00649-79199744,2023-06-14T14:24:25,Labastida,Expense,leisure,-26.16,-26656.02
buyer_8,Antonio,45,ES45209530357850307003,TRX_N-00650-57789075,2023-06-16T14:13:23,Labastida,Expense,food,-76.15,-26732.17
buyer_8,Antonio,45,ES45209530357850307003,TRX_N-00651-59899437,2023-06-16T08:09:51,Hondarribia,Expense,leisure,-49.62,-26781.79
buyer_8,Antonio,45,ES45209530357850307003,TRX_N-00652-93746297,2023-06-18T23:58:36,Labastida,Expense,clothing,-154.08,-26935.87
buyer_8,Antonio,45,ES45209530357850307003,TRX_N-00653-14302665,2023-06-19T15:28:48,Labastida,Expense,leisure,-79.28,-27015.15
buyer_8,Antonio,45,ES45209530357850307003,TRX_N-00654-59872406,2023-06-20T20:32:37,Labastida,Expense,food,-77.39,-27092.54
buyer_8,Antonio,45,ES45209530357850307003,TRX_N-00655-47345602,2023-06-21T18:42:10,Labastida,Expense,food,-115.94,-27208.48
buyer_8,Antonio,45,ES45209530357850307003,TRX_N-00656-18611466,2023-06-23T12:55:38,Labastida,Expense,healthcare,-88.28,-27296.76
buyer_8,Antonio,45,ES45209530357850307003,TRX_N-00657-47666971,2023-06-24T13:17:15,Labastida,Expense,appliances,-370.32,-27667.08
buyer_8,Antonio,45,ES45209530357850307003,TRX_N-00658-83882690,2023-06-25T13:56:16,Labastida,Expense,appliances,-419.34,-28086.42
buyer_8,Antonio,45,ES45209530357850307003,TRX_N-00659-08521714,2023-06-25T12:25:51,Labastida,Expense,repairs,-259.33,-28345.75
buyer_8,Antonio,45,ES45209530357850307003,TRX_N-00660-43205825,2023-06-26T08:55:37,Elciego,Expense,leisure,-82.68,-28428.43
buyer_8,Antonio,45,ES45209530357850307003,TRX_N-00661-90998810,2023-06-26T15:39:18,Labastida,Expense,clothing,-117.19,-28545.62
buyer_8,Antonio,45,ES45209530357850307003,TRX_N-00662-45893473,2023-06-26T12:10:52,Portugalete,Expense,gifts,-583.21,-29128.83
buyer_8,Antonio,45,ES45209530357850307003,TRX_N-00663-53147721,2023-06-26T16:50:39,Labastida,expenses,children,-249.61,-29378.44
buyer_8,Antonio,45,ES45209530357850307003,TRX_N-00664-48695096,2023-06-27T13:34:43,Leioa,Expense,food,-116.65,-29495.09
buyer_8,Antonio,45,ES45209530357850307003,TRX_N-00665-55983647,2023-06-27T19:53:03,Labastida,Expense,cash,-100.0,-29595.09
buyer_8,Antonio,45,ES45209530357850307003,TRX_N-00666-26555915,2023-06-28T13:39:55,Labastida,Expense,food,-89.51,-29684.6
buyer_8,Antonio,45,ES45209530357850307003,TRX_N-00667-15325635,2023-06-28T11:44:02,Labastida,Expense,healthcare,-169.57,-29854.17
buyer_8,Antonio,45,ES45209530357850307003,TRX_N-00668-19342630,2023-06-30T18:15:22,Labastida,Expense,transport,-50.04,-29904.21
buyer_8,Antonio,45,ES45209530357850307003,TRX_N-00669-62382054,2023-07-01T18:14:54,Labastida,incomes,salary,1304.78,-28599.43
buyer_8,Antonio,45,ES45209530357850307003,TRX_N-00670-16623268,2023-07-01T18:14:54,Labastida,incomes,salary_partner,1633.36,-26966.07
buyer_8,Antonio,45,ES45209530357850307003,TRX_N-00671-89879321,2023-07-01T14:23:31,Hernani,Expense,travel,-1372.22,-28338.29
buyer_8,Antonio,45,ES45209530357850307003,TRX_N-00672-26001366,2023-07-02T10:21:32,Labastida,Expense,cash,-100.0,-28438.29
buyer_8,Antonio,45,ES45209530357850307003,TRX_N-00673-52404424,2023-07-03T21:35:26,Arrasate,Expense,leisure,-24.19,-28462.48
buyer_8,Antonio,45,ES45209530357850307003,TRX_N-00674-91679313,2023-07-04T08:23:04,Labastida,expenses,mortgage,-887.59,-29350.07
buyer_8,Antonio,45,ES45209530357850307003,TRX_N-00675-57266331,2023-07-05T15:23:07,Labastida,Expense,food,-62.37,-29412.44
buyer_8,Antonio,45,ES45209530357850307003,TRX_N-00676-39396047,2023-07-05T18:00:14,Labastida,Expense,gifts,-526.49,-29938.93
buyer_8,Antonio,45,ES45209530357850307003,TRX_N-00677-70928547,2023-07-06T18:19:43,Labastida,Expense,education,-50.08,-29989.01
buyer_8,Antonio,45,ES45209530357850307003,TRX_N-00678-78796144,2023-07-07T13:08:46,Labastida,expenses,internet,-42.0,-30031.01
buyer_8,Antonio,45,ES45209530357850307003,TRX_N-00679-07622357,2023-07-07T20:24:42,Labastida,Expense,food,-115.81,-30146.82
buyer_8,Antonio,45,ES45209530357850307003,TRX_N-00680-54078324,2023-07-08T19:33:54,Labastida,expenses,water,-40.67,-30187.49
buyer_8,Antonio,45,ES45209530357850307003,TRX_N-00681-52691964,2023-07-08T10:20:37,Labastida,expenses,electricity,-85.28,-30272.77
buyer_8,Antonio,45,ES45209530357850307003,TRX_N-00682-46205505,2023-07-08T06:15:09,Labastida,expenses,gas,-83.81,-30356.58
buyer_8,Antonio,45,ES45209530357850307003,TRX_N-00683-24537343,2023-07-08T09:01:58,Labastida,expenses,phone,-39.33,-30395.91
buyer_8,Antonio,45,ES45209530357850307003,TRX_N-00684-38651965,2023-07-08T11:26:10,Labastida,Expense,food,-119.3,-30515.21
buyer_8,Antonio,45,ES45209530357850307003,TRX_N-00685-72799960,2023-07-08T12:04:10,Labastida,Expense,appliances,-174.3,-30689.51
buyer_8,Antonio,45,ES45209530357850307003,TRX_N-00686-91970230,2023-07-10T13:47:16,Durango,Expense,food,-84.43,-30773.94
buyer_8,Antonio,45,ES45209530357850307003,TRX_N-00687-33272672,2023-07-11T23:49:10,Labastida,Expense,leisure,-22.74,-30796.68
buyer_8,Antonio,45,ES45209530357850307003,TRX_N-00688-99020245,2023-07-13T12:11:23,Labastida,Expense,cash,-100.0,-30896.68
buyer_8,Antonio,45,ES45209530357850307003,TRX_N-00689-71045122,2023-07-13T09:43:34,Labastida,Expense,repairs,-262.34,-31159.02
buyer_8,Antonio,45,ES45209530357850307003,TRX_N-00690-46291747,2023-07-14T09:30:33,Getxo,Expense,education,-65.37,-31224.39
buyer_8,Antonio,45,ES45209530357850307003,TRX_N-00691-97214952,2023-07-15T09:00:30,Labastida,Expense,repairs,-62.45,-31286.84
buyer_8,Antonio,45,ES45209530357850307003,TRX_N-00692-42077639,2023-07-15T14:21:15,Labastida,Expense,gifts,-280.48,-31567.32
buyer_8,Antonio,45,ES45209530357850307003,TRX_N-00693-28415586,2023-07-16T16:32:13,Labastida,Expense,clothing,-55.15,-31622.47
buyer_8,Antonio,45,ES45209530357850307003,TRX_N-00694-85678691,2023-07-16T17:50:27,Berango,Expense,cash,-100.0,-31722.47
buyer_8,Antonio,45,ES45209530357850307003,TRX_N-00695-78271049,2023-07-19T11:49:12,Irun,Expense,transport,-79.53,-31802.0
buyer_8,Antonio,45,ES45209530357850307003,TRX_N-00696-99965596,2023-07-19T03:41:08,Labastida,Expense,leisure,-35.83,-31837.83
buyer_8,Antonio,45,ES45209530357850307003,TRX_N-00697-47962595,2023-07-20T09:21:43,Labastida,Expense,food,-118.54,-31956.37
buyer_8,Antonio,45,ES45209530357850307003,TRX_N-00698-69129169,2023-07-21T15:40:56,Labastida,Expense,transport,-55.08,-32011.45
buyer_8,Antonio,45,ES45209530357850307003,TRX_N-00699-79141940,2023-07-22T18:42:05,Berango,Expense,cash,-100.0,-32111.45
buyer_8,Antonio,45,ES45209530357850307003,TRX_N-00700-79040463,2023-07-22T11:40:59,Labastida,Expense,gifts,-474.52,-32585.97
buyer_8,Antonio,45,ES45209530357850307003,TRX_N-00701-26420055,2023-07-25T13:34:43,Labastida,Expense,food,-110.83,-32696.8
buyer_8,Antonio,45,ES45209530357850307003,TRX_N-00702-75511749,2023-07-25T20:53:16,Labastida,Expense,leisure,-59.4,-32756.2
buyer_8,Antonio,45,ES45209530357850307003,TRX_N-00703-63341224,2023-07-25T03:22:53,Labastida,Expense,cash,-100.0,-32856.2
buyer_8,Antonio,45,ES45209530357850307003,TRX_N-00704-88398419,2023-07-27T13:11:18,Labastida,Expense,leisure,-20.67,-32876.87
buyer_8,Antonio,45,ES45209530357850307003,TRX_N-00705-18452571,2023-07-28T17:33:42,Labastida,Expense,cash,-100.0,-32976.87
buyer_8,Antonio,45,ES45209530357850307003,TRX_N-00706-85779209,2023-07-29T10:13:37,Labastida,Expense,education,-52.73,-33029.6
buyer_8,Antonio,45,ES45209530357850307003,TRX_N-00707-01335369,2023-07-29T13:11:09,Labastida,Expense,cash,-100.0,-33129.6
buyer_8,Antonio,45,ES45209530357850307003,TRX_N-00708-51442292,2023-07-30T19:16:17,Labastida,Expense,food,-73.45,-33203.05
buyer_8,Antonio,45,ES45209530357850307003,TRX_N-00709-18699580,2023-07-31T09:24:21,Erandio,Expense,food,-65.29,-33268.34
buyer_8,Antonio,45,ES45209530357850307003,TRX_N-00710-32475922,2023-07-31T17:10:45,Labastida,Expense,repairs,-258.78,-33527.12
buyer_8,Antonio,45,ES45209530357850307003,TRX_N-00711-02241968,2023-08-01T12:18:28,Labastida,incomes,salary,1304.78,-32222.34
buyer_8,Antonio,45,ES45209530357850307003,TRX_N-00712-07806535,2023-08-01T12:18:28,Labastida,incomes,salary_partner,1633.36,-30588.98
buyer_8,Antonio,45,ES45209530357850307003,TRX_N-00713-49795946,2023-08-01T12:18:28,Labastida,incomes,extra_income,205.8,-30383.18
buyer_8,Antonio,45,ES45209530357850307003,TRX_N-00714-63922383,2023-08-02T19:55:10,Labastida,Expense,education,-62.86,-30446.04
buyer_8,Antonio,45,ES45209530357850307003,TRX_N-00715-37202377,2023-08-03T17:06:56,Labastida,Expense,healthcare,-46.2,-30492.24
buyer_8,Antonio,45,ES45209530357850307003,TRX_N-00716-52960028,2023-08-04T16:52:31,Labastida,expenses,mortgage,-887.59,-31379.83
buyer_8,Antonio,45,ES45209530357850307003,TRX_N-00717-39753523,2023-08-04T12:40:40,Labastida,Expense,repairs,-213.8,-31593.63
buyer_8,Antonio,45,ES45209530357850307003,TRX_N-00718-04495642,2023-08-05T15:19:29,Labastida,expenses,water,-43.65,-31637.28
buyer_8,Antonio,45,ES45209530357850307003,TRX_N-00719-65016288,2023-08-05T15:03:13,Labastida,expenses,gas,-59.68,-31696.96
buyer_8,Antonio,45,ES45209530357850307003,TRX_N-00720-64596205,2023-08-05T15:20:10,Labastida,Expense,clothing,-96.32,-31793.28
buyer_8,Antonio,45,ES45209530357850307003,TRX_N-00721-74600471,2023-08-06T21:04:29,Leioa,Expense,food,-102.89,-31896.17
buyer_8,Antonio,45,ES45209530357850307003,TRX_N-00722-17905167,2023-08-06T14:02:38,Labastida,Expense,clothing,-83.53,-31979.7
buyer_8,Antonio,45,ES45209530357850307003,TRX_N-00723-01168524,2023-08-06T15:49:26,Labastida,Expense,healthcare,-91.34,-32071.04
buyer_8,Antonio,45,ES45209530357850307003,TRX_N-00724-70184297,2023-08-07T09:38:13,Labastida,expenses,internet,-42.0,-32113.04
buyer_8,Antonio,45,ES45209530357850307003,TRX_N-00725-40984748,2023-08-07T19:41:08,Labastida,expenses,phone,-30.68,-32143.72
buyer_8,Antonio,45,ES45209530357850307003,TRX_N-00726-30293320,2023-08-08T15:51:18,Labastida,expenses,electricity,-54.19,-32197.91
buyer_8,Antonio,45,ES45209530357850307003,TRX_N-00727-07010537,2023-08-08T10:05:51,Labastida,Expense,food,-105.78,-32303.69
buyer_8,Antonio,45,ES45209530357850307003,TRX_N-00728-79943156,2023-08-09T19:36:05,Labastida,Expense,repairs,-93.16,-32396.85
buyer_8,Antonio,45,ES45209530357850307003,TRX_N-00729-80165068,2023-08-10T06:18:32,Labastida,Expense,education,-42.35,-32439.2
buyer_8,Antonio,45,ES45209530357850307003,TRX_N-00730-87936070,2023-08-12T20:27:10,Labastida,Expense,repairs,-178.42,-32617.62
buyer_8,Antonio,45,ES45209530357850307003,TRX_N-00731-68676525,2023-08-13T12:41:49,Labastida,Expense,cash,-100.0,-32717.62
buyer_8,Antonio,45,ES45209530357850307003,TRX_N-00732-27845717,2023-08-14T19:21:29,Erandio,Expense,leisure,-42.7,-32760.32
buyer_8,Antonio,45,ES45209530357850307003,TRX_N-00733-66627784,2023-08-17T04:48:25,Donostia,Expense,transport,-62.2,-32822.52
buyer_8,Antonio,45,ES45209530357850307003,TRX_N-00734-58882783,2023-08-20T20:07:42,Labastida,Expense,cash,-100.0,-32922.52
buyer_8,Antonio,45,ES45209530357850307003,TRX_N-00735-57866591,2023-08-21T06:56:55,Labastida,Expense,cash,-100.0,-33022.52
buyer_8,Antonio,45,ES45209530357850307003,TRX_N-00736-78214684,2023-08-23T19:28:02,Labastida,Expense,leisure,-64.81,-33087.33
buyer_8,Antonio,45,ES45209530357850307003,TRX_N-00737-27282839,2023-08-23T15:06:11,Labastida,Expense,cash,-100.0,-33187.33
buyer_8,Antonio,45,ES45209530357850307003,TRX_N-00738-96392454,2023-08-27T18:14:34,Labastida,Expense,leisure,-65.65,-33252.98
buyer_8,Antonio,45,ES45209530357850307003,TRX_N-00739-08573217,2023-08-28T14:48:54,Errenteria,Expense,gifts,-129.74,-33382.72
buyer_8,Antonio,45,ES45209530357850307003,TRX_N-00740-77614869,2023-08-29T21:06:47,Eibar,Expense,leisure,-49.96,-33432.68
buyer_8,Antonio,45,ES45209530357850307003,TRX_N-00741-73247252,2023-08-29T11:44:22,Labastida,Expense,gifts,-441.03,-33873.71
buyer_8,Antonio,45,ES45209530357850307003,TRX_N-00742-22699468,2023-08-30T09:51:45,Lasarte-Oria,Expense,food,-60.55,-33934.26
buyer_8,Antonio,45,ES45209530357850307003,TRX_N-00743-40082531,2023-08-31T20:36:14,Labastida,Expense,gifts,-45.14,-33979.4
buyer_8,Antonio,45,ES45209530357850307003,TRX_N-00744-99639107,2023-09-01T20:38:24,Labastida,incomes,salary,1304.78,-32674.62
buyer_8,Antonio,45,ES45209530357850307003,TRX_N-00745-14777241,2023-09-01T20:38:24,Labastida,incomes,salary_partner,1633.36,-31041.26
buyer_8,Antonio,45,ES45209530357850307003,TRX_N-00746-47841486,2023-09-01T16:40:58,Eibar,Expense,food,-71.46,-31112.72
buyer_8,Antonio,45,ES45209530357850307003,TRX_N-00747-80504107,2023-09-01T19:15:39,Labastida,Expense,transport,-48.71,-31161.43
buyer_8,Antonio,45,ES45209530357850307003,TRX_N-00748-95384652,2023-09-03T15:42:44,Labastida,Expense,cash,-100.0,-31261.43
buyer_8,Antonio,45,ES45209530357850307003,TRX_N-00749-42485248,2023-09-04T18:41:42,Labastida,expenses,mortgage,-887.59,-32149.02
buyer_8,Antonio,45,ES45209530357850307003,TRX_N-00750-34914159,2023-09-04T17:08:32,Labastida,Expense,healthcare,-172.51,-32321.53
buyer_8,Antonio,45,ES45209530357850307003,TRX_N-00751-19959405,2023-09-05T02:09:40,Labastida,expenses,water,-22.3,-32343.83
buyer_8,Antonio,45,ES45209530357850307003,TRX_N-00752-47128831,2023-09-05T15:03:46,Labastida,expenses,phone,-43.82,-32387.65
buyer_8,Antonio,45,ES45209530357850307003,TRX_N-00753-42715516,2023-09-05T22:38:09,Labastida,Expense,leisure,-51.03,-32438.68
buyer_8,Antonio,45,ES45209530357850307003,TRX_N-00754-62658524,2023-09-06T10:01:47,Labastida,expenses,electricity,-87.79,-32526.47
buyer_8,Antonio,45,ES45209530357850307003,TRX_N-00755-55951816,2023-09-06T12:26:39,Labastida,Expense,transport,-84.51,-32610.98
buyer_8,Antonio,45,ES45209530357850307003,TRX_N-00756-42759500,2023-09-07T21:24:10,Labastida,expenses,internet,-42.0,-32652.98
buyer_8,Antonio,45,ES45209530357850307003,TRX_N-00757-83036261,2023-09-07T17:40:07,Labastida,Expense,clothing,-70.23,-32723.21
buyer_8,Antonio,45,ES45209530357850307003,TRX_N-00758-51432592,2023-09-07T14:01:13,Labastida,Expense,education,-69.24,-32792.45
buyer_8,Antonio,45,ES45209530357850307003,TRX_N-00759-84540675,2023-09-08T16:43:09,Labastida,expenses,gas,-111.37,-32903.82
buyer_8,Antonio,45,ES45209530357850307003,TRX_N-00760-44658689,2023-09-09T12:48:02,Labastida,expenses,children,-202.26,-33106.08
buyer_8,Antonio,45,ES45209530357850307003,TRX_N-00761-84428425,2023-09-10T22:23:51,Labastida,Expense,leisure,-44.67,-33150.75
buyer_8,Antonio,45,ES45209530357850307003,TRX_N-00762-95777716,2023-09-12T15:32:14,Labastida,Expense,food,-115.89,-33266.64
buyer_8,Antonio,45,ES45209530357850307003,TRX_N-00763-85467705,2023-09-12T17:32:11,Labastida,Expense,leisure,-53.26,-33319.9
buyer_8,Antonio,45,ES45209530357850307003,TRX_N-00764-46599328,2023-09-13T19:05:49,Galdakao,Expense,transport,-87.45,-33407.35
buyer_8,Antonio,45,ES45209530357850307003,TRX_N-00765-06328362,2023-09-13T05:56:27,Labastida,Expense,cash,-100.0,-33507.35
buyer_8,Antonio,45,ES45209530357850307003,TRX_N-00766-99128329,2023-09-16T18:05:23,Labastida,Expense,transport,-62.24,-33569.59
buyer_8,Antonio,45,ES45209530357850307003,TRX_N-00767-13270064,2023-09-16T10:41:40,Durango,Expense,clothing,-146.37,-33715.96
buyer_8,Antonio,45,ES45209530357850307003,TRX_N-00768-26224350,2023-09-17T18:58:58,Labastida,Expense,cash,-100.0,-33815.96
buyer_8,Antonio,45,ES45209530357850307003,TRX_N-00769-36901334,2023-09-18T12:56:01,Mungia,Expense,clothing,-51.71,-33867.67
buyer_8,Antonio,45,ES45209530357850307003,TRX_N-00770-22900991,2023-09-20T07:20:20,Labastida,Expense,transport,-81.87,-33949.54
buyer_8,Antonio,45,ES45209530357850307003,TRX_N-00771-59206636,2023-09-20T10:22:19,Labastida,Expense,cash,-100.0,-34049.54
buyer_8,Antonio,45,ES45209530357850307003,TRX_N-00772-96345182,2023-09-21T19:42:03,Labastida,Expense,transport,-60.23,-34109.77
buyer_8,Antonio,45,ES45209530357850307003,TRX_N-00773-11712938,2023-09-21T16:47:38,Labastida,Expense,appliances,-348.01,-34457.78
buyer_8,Antonio,45,ES45209530357850307003,TRX_N-00774-17476178,2023-09-22T23:53:08,Labastida,Expense,repairs,-178.87,-34636.65
buyer_8,Antonio,45,ES45209530357850307003,TRX_N-00775-56558758,2023-09-23T16:26:17,Elciego,Expense,cash,-100.0,-34736.65
buyer_8,Antonio,45,ES45209530357850307003,TRX_N-00776-23362958,2023-09-26T13:42:26,Zarautz,Expense,transport,-86.01,-34822.66
buyer_8,Antonio,45,ES45209530357850307003,TRX_N-00777-15169997,2023-09-27T23:14:17,Labastida,Expense,appliances,-291.45,-35114.11
buyer_8,Antonio,45,ES45209530357850307003,TRX_N-00778-92972818,2023-09-30T02:11:10,Leioa,Expense,leisure,-77.37,-35191.48
buyer_8,Antonio,45,ES45209530357850307003,TRX_N-00779-68784505,2023-09-30T17:50:34,Santurtzi,Expense,appliances,-408.88,-35600.36
buyer_8,Antonio,45,ES45209530357850307003,TRX_N-00780-29967486,2023-09-30T16:31:55,Labastida,Expense,gifts,-589.47,-36189.83
buyer_8,Antonio,45,ES45209530357850307003,TRX_N-00781-18589362,2023-10-01T09:33:36,Labastida,incomes,salary,1304.78,-34885.05
buyer_8,Antonio,45,ES45209530357850307003,TRX_N-00782-28179025,2023-10-01T09:33:36,Labastida,incomes,salary_partner,1633.36,-33251.69
buyer_8,Antonio,45,ES45209530357850307003,TRX_N-00783-62180931,2023-10-01T22:34:17,Labastida,Expense,food,-109.58,-33361.27
buyer_8,Antonio,45,ES45209530357850307003,TRX_N-00784-33713023,2023-10-02T17:34:13,Santurtzi,Expense,cash,-100.0,-33461.27
buyer_8,Antonio,45,ES45209530357850307003,TRX_N-00785-89024569,2023-10-04T17:52:11,Labastida,expenses,mortgage,-887.59,-34348.86
buyer_8,Antonio,45,ES45209530357850307003,TRX_N-00786-12007335,2023-10-04T08:56:51,Basauri,Expense,leisure,-50.62,-34399.48
buyer_8,Antonio,45,ES45209530357850307003,TRX_N-00787-82128549,2023-10-05T13:04:18,Labastida,expenses,gas,-73.99,-34473.47
buyer_8,Antonio,45,ES45209530357850307003,TRX_N-00788-63245307,2023-10-05T09:00:01,Portugalete,Expense,food,-106.03,-34579.5
buyer_8,Antonio,45,ES45209530357850307003,TRX_N-00789-29318734,2023-10-05T15:03:37,Labastida,Expense,cash,-100.0,-34679.5
buyer_8,Antonio,45,ES45209530357850307003,TRX_N-00790-22528215,2023-10-06T10:54:04,Labastida,expenses,water,-42.81,-34722.31
buyer_8,Antonio,45,ES45209530357850307003,TRX_N-00791-71517929,2023-10-06T20:40:06,Labastida,Expense,leisure,-59.99,-34782.3
buyer_8,Antonio,45,ES45209530357850307003,TRX_N-00792-42738705,2023-10-06T14:34:28,Hondarribia,Expense,cash,-100.0,-34882.3
buyer_8,Antonio,45,ES45209530357850307003,TRX_N-00793-86478161,2023-10-07T10:35:29,Labastida,expenses,electricity,-26.89,-34909.19
buyer_8,Antonio,45,ES45209530357850307003,TRX_N-00794-51757553,2023-10-07T18:23:09,Llodio,Expense,repairs,-203.68,-35112.87
buyer_8,Antonio,45,ES45209530357850307003,TRX_N-00795-66464521,2023-10-08T18:41:07,Labastida,expenses,internet,-42.0,-35154.87
buyer_8,Antonio,45,ES45209530357850307003,TRX_N-00796-63028279,2023-10-08T12:28:26,Labastida,expenses,phone,-42.14,-35197.01
buyer_8,Antonio,45,ES45209530357850307003,TRX_N-00797-08185608,2023-10-08T18:27:38,Labastida,Expense,cash,-100.0,-35297.01
buyer_8,Antonio,45,ES45209530357850307003,TRX_N-00798-62266202,2023-10-08T18:32:59,Iru√±a de Oca,Expense,gifts,-152.99,-35450.0
buyer_8,Antonio,45,ES45209530357850307003,TRX_N-00799-54407878,2023-10-09T15:54:16,Labastida,Expense,education,-55.08,-35505.08
buyer_8,Antonio,45,ES45209530357850307003,TRX_N-00800-31362555,2023-10-09T19:23:33,Labastida,Expense,cash,-100.0,-35605.08
buyer_8,Antonio,45,ES45209530357850307003,TRX_N-00801-84430216,2023-10-11T21:54:19,Portugalete,Expense,food,-82.94,-35688.02
buyer_8,Antonio,45,ES45209530357850307003,TRX_N-00802-79796802,2023-10-11T10:45:46,Labastida,Expense,gifts,-532.24,-36220.26
buyer_8,Antonio,45,ES45209530357850307003,TRX_N-00803-67827519,2023-10-12T23:50:36,Labastida,Expense,food,-74.89,-36295.15
buyer_8,Antonio,45,ES45209530357850307003,TRX_N-00804-75025974,2023-10-13T16:55:47,Basauri,Expense,cash,-100.0,-36395.15
buyer_8,Antonio,45,ES45209530357850307003,TRX_N-00805-23133357,2023-10-13T20:46:35,Labastida,Expense,gifts,-606.84,-37001.99
buyer_8,Antonio,45,ES45209530357850307003,TRX_N-00806-54552605,2023-10-14T05:39:10,Donostia,Expense,leisure,-76.87,-37078.86
buyer_8,Antonio,45,ES45209530357850307003,TRX_N-00807-36850566,2023-10-14T18:05:05,Labastida,Expense,clothing,-115.85,-37194.71
buyer_8,Antonio,45,ES45209530357850307003,TRX_N-00808-67468913,2023-10-14T22:02:11,Mungia,Expense,appliances,-293.65,-37488.36
buyer_8,Antonio,45,ES45209530357850307003,TRX_N-00809-81411981,2023-10-14T14:11:22,Labastida,expenses,children,-121.9,-37610.26
buyer_8,Antonio,45,ES45209530357850307003,TRX_N-00810-60487806,2023-10-16T16:04:37,Labastida,expenses,children,-247.07,-37857.33
buyer_8,Antonio,45,ES45209530357850307003,TRX_N-00811-99902868,2023-10-17T12:31:13,Labastida,Expense,cash,-100.0,-37957.33
buyer_8,Antonio,45,ES45209530357850307003,TRX_N-00812-80535182,2023-10-18T16:23:13,Labastida,Expense,leisure,-42.87,-38000.2
buyer_8,Antonio,45,ES45209530357850307003,TRX_N-00813-11933835,2023-10-18T21:21:20,Salvatierra/Agurain,Expense,cash,-100.0,-38100.2
buyer_8,Antonio,45,ES45209530357850307003,TRX_N-00814-49003689,2023-10-19T11:20:21,Labastida,Expense,transport,-74.36,-38174.56
buyer_8,Antonio,45,ES45209530357850307003,TRX_N-00815-49996303,2023-10-19T04:36:06,Labastida,Expense,gifts,-770.4,-38944.96
buyer_8,Antonio,45,ES45209530357850307003,TRX_N-00816-78069806,2023-10-22T22:13:48,Labastida,Expense,food,-111.41,-39056.37
buyer_8,Antonio,45,ES45209530357850307003,TRX_N-00817-81836303,2023-10-22T21:37:06,Labastida,Expense,transport,-55.14,-39111.51
buyer_8,Antonio,45,ES45209530357850307003,TRX_N-00818-92362938,2023-10-23T10:31:29,Berango,Expense,transport,-71.08,-39182.59
buyer_8,Antonio,45,ES45209530357850307003,TRX_N-00819-17838868,2023-10-24T14:34:29,Labastida,Expense,transport,-50.35,-39232.94
buyer_8,Antonio,45,ES45209530357850307003,TRX_N-00820-57032833,2023-10-25T14:59:31,Labastida,expenses,children,-85.74,-39318.68
buyer_8,Antonio,45,ES45209530357850307003,TRX_N-00821-89764006,2023-10-26T09:45:02,Labastida,Expense,transport,-77.48,-39396.16
buyer_8,Antonio,45,ES45209530357850307003,TRX_N-00822-87024589,2023-10-29T12:12:44,Labastida,Expense,repairs,-281.78,-39677.94
buyer_8,Antonio,45,ES45209530357850307003,TRX_N-00823-80307744,2023-11-01T17:42:45,Labastida,incomes,salary,1304.78,-38373.16
buyer_8,Antonio,45,ES45209530357850307003,TRX_N-00824-36836806,2023-11-01T17:42:45,Labastida,incomes,salary_partner,1633.36,-36739.8
buyer_8,Antonio,45,ES45209530357850307003,TRX_N-00825-52819418,2023-11-01T17:42:45,Labastida,incomes,extra_income,205.8,-36534.0
buyer_8,Antonio,45,ES45209530357850307003,TRX_N-00826-09640472,2023-11-01T09:21:20,Labastida,Expense,healthcare,-105.26,-36639.26
buyer_8,Antonio,45,ES45209530357850307003,TRX_N-00827-86977980,2023-11-03T20:26:48,Labastida,Expense,gifts,-732.32,-37371.58
buyer_8,Antonio,45,ES45209530357850307003,TRX_N-00828-28176886,2023-11-04T13:59:21,Labastida,expenses,mortgage,-887.59,-38259.17
buyer_8,Antonio,45,ES45209530357850307003,TRX_N-00829-76300885,2023-11-04T08:24:32,Labastida,Expense,cash,-100.0,-38359.17
buyer_8,Antonio,45,ES45209530357850307003,TRX_N-00830-85864473,2023-11-05T05:26:03,Labastida,Expense,cash,-100.0,-38459.17
buyer_8,Antonio,45,ES45209530357850307003,TRX_N-00831-45134876,2023-11-08T15:31:36,Labastida,expenses,water,-35.39,-38494.56
buyer_8,Antonio,45,ES45209530357850307003,TRX_N-00832-81703408,2023-11-08T13:10:05,Labastida,expenses,electricity,-87.62,-38582.18
buyer_8,Antonio,45,ES45209530357850307003,TRX_N-00833-86292087,2023-11-08T11:35:15,Labastida,expenses,gas,-79.99,-38662.17
buyer_8,Antonio,45,ES45209530357850307003,TRX_N-00834-19991722,2023-11-08T12:45:55,Labastida,expenses,internet,-42.0,-38704.17
buyer_8,Antonio,45,ES45209530357850307003,TRX_N-00835-50714126,2023-11-08T09:12:06,Labastida,expenses,phone,-32.91,-38737.08
buyer_8,Antonio,45,ES45209530357850307003,TRX_N-00836-53196179,2023-11-12T20:07:34,Zuia,Expense,clothing,-156.61,-38893.69
buyer_8,Antonio,45,ES45209530357850307003,TRX_N-00837-53344547,2023-11-14T11:34:02,Labastida,Expense,cash,-100.0,-38993.69
buyer_8,Antonio,45,ES45209530357850307003,TRX_N-00838-46480830,2023-11-14T16:55:49,Labastida,Expense,travel,-1502.3,-40495.99
buyer_8,Antonio,45,ES45209530357850307003,TRX_N-00839-18822626,2023-11-16T20:07:38,Labastida,Expense,gifts,-394.25,-40890.24
buyer_8,Antonio,45,ES45209530357850307003,TRX_N-00840-07887931,2023-11-17T06:54:18,Labastida,Expense,food,-65.02,-40955.26
buyer_8,Antonio,45,ES45209530357850307003,TRX_N-00841-93635036,2023-11-20T09:37:30,Labastida,Expense,cash,-100.0,-41055.26
buyer_8,Antonio,45,ES45209530357850307003,TRX_N-00842-58591034,2023-11-20T20:23:18,Labastida,expenses,children,-86.96,-41142.22
buyer_8,Antonio,45,ES45209530357850307003,TRX_N-00843-29325323,2023-11-21T09:27:05,Labastida,Expense,food,-100.15,-41242.37
buyer_8,Antonio,45,ES45209530357850307003,TRX_N-00844-20044927,2023-11-23T21:34:51,Getxo,Expense,healthcare,-75.09,-41317.46
buyer_8,Antonio,45,ES45209530357850307003,TRX_N-00845-45381893,2023-11-24T15:50:25,Labastida,Expense,repairs,-311.03,-41628.49
buyer_8,Antonio,45,ES45209530357850307003,TRX_N-00846-89575471,2023-11-25T00:40:56,Labastida,Expense,education,-47.31,-41675.8
buyer_8,Antonio,45,ES45209530357850307003,TRX_N-00847-88860171,2023-11-27T20:41:10,Labastida,Expense,cash,-100.0,-41775.8
buyer_8,Antonio,45,ES45209530357850307003,TRX_N-00848-30224681,2023-11-28T13:53:57,Labastida,Expense,clothing,-70.12,-41845.92
buyer_8,Antonio,45,ES45209530357850307003,TRX_N-00849-52989822,2023-11-29T21:54:52,Labastida,Expense,cash,-100.0,-41945.92
buyer_8,Antonio,45,ES45209530357850307003,TRX_N-00850-22439815,2023-11-29T19:46:50,Labastida,Expense,repairs,-324.54,-42270.46
buyer_8,Antonio,45,ES45209530357850307003,TRX_N-00851-84103791,2023-12-01T19:16:12,Labastida,incomes,salary,1304.78,-40965.68
buyer_8,Antonio,45,ES45209530357850307003,TRX_N-00852-22012250,2023-12-01T19:16:12,Labastida,incomes,salary_partner,1633.36,-39332.32
buyer_8,Antonio,45,ES45209530357850307003,TRX_N-00853-66996407,2023-12-01T19:16:12,Labastida,incomes,salary_bonus,931.9,-38400.42
buyer_8,Antonio,45,ES45209530357850307003,TRX_N-00854-94819246,2023-12-01T19:16:12,Labastida,incomes,salary_partner_bonus,1266.58,-37133.84
buyer_8,Antonio,45,ES45209530357850307003,TRX_N-00855-47946243,2023-12-01T12:37:09,Labastida,Expense,food,-73.6,-37207.44
buyer_8,Antonio,45,ES45209530357850307003,TRX_N-00856-48617323,2023-12-01T17:52:34,Labastida,Expense,appliances,-367.73,-37575.17
buyer_8,Antonio,45,ES45209530357850307003,TRX_N-00857-74631544,2023-12-02T15:08:23,Labastida,Expense,transport,-72.42,-37647.59
buyer_8,Antonio,45,ES45209530357850307003,TRX_N-00858-21496119,2023-12-03T15:05:32,Labastida,Expense,transport,-55.06,-37702.65
buyer_8,Antonio,45,ES45209530357850307003,TRX_N-00859-07914299,2023-12-04T13:03:46,Labastida,expenses,mortgage,-887.59,-38590.24
buyer_8,Antonio,45,ES45209530357850307003,TRX_N-00860-21131019,2023-12-04T19:58:57,Labastida,Expense,leisure,-36.74,-38626.98
buyer_8,Antonio,45,ES45209530357850307003,TRX_N-00861-87749969,2023-12-05T12:01:14,Labastida,expenses,electricity,-33.47,-38660.45
buyer_8,Antonio,45,ES45209530357850307003,TRX_N-00862-80284165,2023-12-05T04:10:17,Labastida,Expense,food,-121.95,-38782.4
buyer_8,Antonio,45,ES45209530357850307003,TRX_N-00863-90376695,2023-12-05T19:20:39,Labastida,Expense,gifts,-202.41,-38984.81
buyer_8,Antonio,45,ES45209530357850307003,TRX_N-00864-31656482,2023-12-06T08:16:06,Labastida,expenses,gas,-44.23,-39029.04
buyer_8,Antonio,45,ES45209530357850307003,TRX_N-00865-16383200,2023-12-06T11:20:28,Labastida,expenses,phone,-37.04,-39066.08
buyer_8,Antonio,45,ES45209530357850307003,TRX_N-00866-13893556,2023-12-07T12:42:22,Labastida,Expense,education,-66.91,-39132.99
buyer_8,Antonio,45,ES45209530357850307003,TRX_N-00867-56771699,2023-12-07T19:48:35,Labastida,Expense,travel,-1323.1,-40456.09
buyer_8,Antonio,45,ES45209530357850307003,TRX_N-00868-66736071,2023-12-08T14:40:57,Labastida,expenses,internet,-42.0,-40498.09
buyer_8,Antonio,45,ES45209530357850307003,TRX_N-00869-75835783,2023-12-08T10:26:22,Labastida,expenses,water,-41.72,-40539.81
buyer_8,Antonio,45,ES45209530357850307003,TRX_N-00870-43629455,2023-12-08T16:33:47,Labastida,Expense,leisure,-72.86,-40612.67
buyer_8,Antonio,45,ES45209530357850307003,TRX_N-00871-71058600,2023-12-10T11:18:03,Eibar,Expense,transport,-82.49,-40695.16
buyer_8,Antonio,45,ES45209530357850307003,TRX_N-00872-69319780,2023-12-10T10:20:38,Labastida,Expense,repairs,-188.97,-40884.13
buyer_8,Antonio,45,ES45209530357850307003,TRX_N-00873-32237889,2023-12-13T20:46:14,Labastida,Expense,clothing,-123.32,-41007.45
buyer_8,Antonio,45,ES45209530357850307003,TRX_N-00874-15311590,2023-12-14T15:56:50,Labastida,Expense,appliances,-205.92,-41213.37
buyer_8,Antonio,45,ES45209530357850307003,TRX_N-00875-72799496,2023-12-16T08:19:39,Labastida,Expense,leisure,-37.23,-41250.6
buyer_8,Antonio,45,ES45209530357850307003,TRX_N-00876-62250483,2023-12-16T18:56:43,Labastida,Expense,clothing,-103.63,-41354.23
buyer_8,Antonio,45,ES45209530357850307003,TRX_N-00877-87396866,2023-12-16T20:41:14,Labastida,Expense,gifts,-698.84,-42053.07
buyer_8,Antonio,45,ES45209530357850307003,TRX_N-00878-48012990,2023-12-17T14:42:02,Labastida,Expense,repairs,-216.83,-42269.9
buyer_8,Antonio,45,ES45209530357850307003,TRX_N-00879-39377335,2023-12-18T08:09:39,Labastida,Expense,food,-64.04,-42333.94
buyer_8,Antonio,45,ES45209530357850307003,TRX_N-00880-29128184,2023-12-18T16:45:27,Labastida,Expense,transport,-70.0,-42403.94
buyer_8,Antonio,45,ES45209530357850307003,TRX_N-00881-43025909,2023-12-23T14:53:32,Labastida,Expense,education,-47.35,-42451.29
buyer_8,Antonio,45,ES45209530357850307003,TRX_N-00882-41097557,2023-12-26T20:08:21,Labastida,Expense,food,-79.76,-42531.05
buyer_8,Antonio,45,ES45209530357850307003,TRX_N-00883-00492137,2023-12-26T16:31:12,Labastida,Expense,repairs,-153.45,-42684.5
buyer_8,Antonio,45,ES45209530357850307003,TRX_N-00884-64490235,2023-12-27T02:35:11,Lasarte-Oria,Expense,cash,-100.0,-42784.5
buyer_8,Antonio,45,ES45209530357850307003,TRX_N-00885-54805049,2023-12-27T13:10:37,Labastida,Expense,travel,-1008.31,-43792.81
buyer_8,Antonio,45,ES45209530357850307003,TRX_N-00886-69727484,2023-12-30T17:55:30,Labastida,Expense,repairs,-330.18,-44122.99
buyer_8,Antonio,45,ES45209530357850307003,TRX_N-00887-83320654,2023-12-31T19:35:36,Mungia,Expense,cash,-100.0,-44222.99
buyer_8,Antonio,45,ES45209530357850307003,TRX_N-00888-65912949,2024-01-01T11:30:47,Labastida,incomes,salary,1353.48,-42869.51
buyer_8,Antonio,45,ES45209530357850307003,TRX_N-00889-52173716,2024-01-01T11:30:47,Labastida,incomes,salary_partner,1694.33,-41175.18
buyer_8,Antonio,45,ES45209530357850307003,TRX_N-00890-46219227,2024-01-02T09:40:18,Labastida,Expense,healthcare,-147.49,-41322.67
buyer_8,Antonio,45,ES45209530357850307003,TRX_N-00891-80019298,2024-01-02T00:05:58,Labastida,Expense,travel,-456.62,-41779.29
buyer_8,Antonio,45,ES45209530357850307003,TRX_N-00892-90717731,2024-01-02T16:36:04,Labastida,Expense,repairs,-94.27,-41873.56
buyer_8,Antonio,45,ES45209530357850307003,TRX_N-00893-72796445,2024-01-03T18:41:18,Labastida,Expense,transport,-82.78,-41956.34
buyer_8,Antonio,45,ES45209530357850307003,TRX_N-00894-45794835,2024-01-04T15:03:15,Labastida,expenses,mortgage,-887.59,-42843.93
buyer_8,Antonio,45,ES45209530357850307003,TRX_N-00895-39813968,2024-01-05T19:27:16,Labastida,Expense,food,-117.5,-42961.43
buyer_8,Antonio,45,ES45209530357850307003,TRX_N-00896-26910648,2024-01-05T19:57:56,Basauri,Expense,clothing,-127.23,-43088.66
buyer_8,Antonio,45,ES45209530357850307003,TRX_N-00897-40871024,2024-01-05T14:55:52,Labastida,Expense,cash,-100.0,-43188.66
buyer_8,Antonio,45,ES45209530357850307003,TRX_N-00898-64949352,2024-01-07T23:57:47,Labastida,expenses,internet,-42.0,-43230.66
buyer_8,Antonio,45,ES45209530357850307003,TRX_N-00899-01815714,2024-01-08T09:01:14,Labastida,expenses,gas,-97.31,-43327.97
buyer_8,Antonio,45,ES45209530357850307003,TRX_N-00900-85481753,2024-01-08T12:32:23,Labastida,expenses,water,-25.11,-43353.08
buyer_8,Antonio,45,ES45209530357850307003,TRX_N-00901-81736995,2024-01-08T08:46:13,Labastida,expenses,electricity,-30.93,-43384.01
buyer_8,Antonio,45,ES45209530357850307003,TRX_N-00902-25164458,2024-01-08T11:44:23,Labastida,expenses,phone,-33.96,-43417.97
buyer_8,Antonio,45,ES45209530357850307003,TRX_N-00903-59270031,2024-01-08T14:50:01,Labastida,Expense,appliances,-182.93,-43600.9
buyer_8,Antonio,45,ES45209530357850307003,TRX_N-00904-24483462,2024-01-08T10:28:09,Llodio,Expense,repairs,-127.06,-43727.96
buyer_8,Antonio,45,ES45209530357850307003,TRX_N-00905-15396059,2024-01-08T10:19:26,Labastida,expenses,children,-159.56,-43887.52
buyer_8,Antonio,45,ES45209530357850307003,TRX_N-00906-58278641,2024-01-10T15:46:04,Labastida,Expense,food,-115.54,-44003.06
buyer_8,Antonio,45,ES45209530357850307003,TRX_N-00907-53670856,2024-01-10T15:50:29,Labastida,Expense,leisure,-84.28,-44087.34
buyer_8,Antonio,45,ES45209530357850307003,TRX_N-00908-94709940,2024-01-12T21:23:45,Elciego,Expense,travel,-1572.4,-45659.74
buyer_8,Antonio,45,ES45209530357850307003,TRX_N-00909-36010373,2024-01-13T12:06:10,Portugalete,Expense,transport,-64.33,-45724.07
buyer_8,Antonio,45,ES45209530357850307003,TRX_N-00910-30800456,2024-01-13T21:19:30,Labastida,Expense,clothing,-54.66,-45778.73
buyer_8,Antonio,45,ES45209530357850307003,TRX_N-00911-15937464,2024-01-13T12:36:52,Labastida,Expense,cash,-100.0,-45878.73
buyer_8,Antonio,45,ES45209530357850307003,TRX_N-00912-94013134,2024-01-16T05:51:17,Labastida,Expense,cash,-100.0,-45978.73
buyer_8,Antonio,45,ES45209530357850307003,TRX_N-00913-64764271,2024-01-17T21:55:34,Basauri,Expense,food,-73.54,-46052.27
buyer_8,Antonio,45,ES45209530357850307003,TRX_N-00914-73468462,2024-01-18T18:09:26,Amurrio,Expense,leisure,-65.45,-46117.72
buyer_8,Antonio,45,ES45209530357850307003,TRX_N-00915-74359692,2024-01-18T18:15:28,Labastida,Expense,cash,-100.0,-46217.72
buyer_8,Antonio,45,ES45209530357850307003,TRX_N-00916-93117373,2024-01-19T16:16:34,Oy√≥n-Oion,Expense,food,-90.74,-46308.46
buyer_8,Antonio,45,ES45209530357850307003,TRX_N-00917-42821395,2024-01-19T12:50:21,Labastida,Expense,healthcare,-41.57,-46350.03
buyer_8,Antonio,45,ES45209530357850307003,TRX_N-00918-20203448,2024-01-21T15:56:56,Labastida,Expense,leisure,-28.01,-46378.04
buyer_8,Antonio,45,ES45209530357850307003,TRX_N-00919-65485629,2024-01-21T17:31:52,Labastida,Expense,cash,-100.0,-46478.04
buyer_8,Antonio,45,ES45209530357850307003,TRX_N-00920-36337873,2024-01-25T19:22:44,Salvatierra/Agurain,Expense,gifts,-564.08,-47042.12
buyer_8,Antonio,45,ES45209530357850307003,TRX_N-00921-10476278,2024-01-27T08:10:23,Labastida,Expense,transport,-74.38,-47116.5
buyer_8,Antonio,45,ES45209530357850307003,TRX_N-00922-41823157,2024-01-28T09:10:51,Labastida,Expense,clothing,-88.81,-47205.31
buyer_8,Antonio,45,ES45209530357850307003,TRX_N-00923-13479059,2024-01-29T16:38:33,Labastida,Expense,leisure,-26.08,-47231.39
buyer_8,Antonio,45,ES45209530357850307003,TRX_N-00924-10094951,2024-01-30T10:08:17,Labastida,Expense,leisure,-67.13,-47298.52
buyer_8,Antonio,45,ES45209530357850307003,TRX_N-00925-39365377,2024-01-31T12:30:55,Labastida,Expense,food,-73.14,-47371.66
buyer_8,Antonio,45,ES45209530357850307003,TRX_N-00926-20901873,2024-01-31T18:45:48,Labastida,Expense,leisure,-77.91,-47449.57
buyer_8,Antonio,45,ES45209530357850307003,TRX_N-00927-46035641,2024-01-31T05:20:06,Labastida,Expense,healthcare,-145.38,-47594.95
buyer_8,Antonio,45,ES45209530357850307003,TRX_N-00928-11958333,2024-01-31T10:34:08,Labastida,Expense,cash,-100.0,-47694.95
buyer_8,Antonio,45,ES45209530357850307003,TRX_N-00929-37337639,2024-01-31T10:09:50,Labastida,Expense,appliances,-317.76,-48012.71
buyer_8,Antonio,45,ES45209530357850307003,TRX_N-00930-96803979,2024-02-01T11:40:23,Labastida,incomes,salary,1353.48,-46659.23
buyer_8,Antonio,45,ES45209530357850307003,TRX_N-00931-78677490,2024-02-01T11:40:23,Labastida,incomes,salary_partner,1694.33,-44964.9
buyer_8,Antonio,45,ES45209530357850307003,TRX_N-00932-44148497,2024-02-01T19:59:20,Labastida,Expense,leisure,-34.55,-44999.45
buyer_8,Antonio,45,ES45209530357850307003,TRX_N-00933-53549810,2024-02-03T09:54:05,Labastida,Expense,gifts,-790.88,-45790.33
buyer_8,Antonio,45,ES45209530357850307003,TRX_N-00934-32670246,2024-02-04T10:19:18,Labastida,expenses,mortgage,-887.59,-46677.92
buyer_8,Antonio,45,ES45209530357850307003,TRX_N-00935-18717410,2024-02-05T18:32:58,Labastida,expenses,water,-35.23,-46713.15
buyer_8,Antonio,45,ES45209530357850307003,TRX_N-00936-54062815,2024-02-06T05:20:33,Labastida,expenses,electricity,-44.87,-46758.02
buyer_8,Antonio,45,ES45209530357850307003,TRX_N-00937-34346672,2024-02-06T15:58:37,Iru√±a de Oca,Expense,food,-88.05,-46846.07
buyer_8,Antonio,45,ES45209530357850307003,TRX_N-00938-48400971,2024-02-06T11:36:04,Labastida,Expense,cash,-100.0,-46946.07
buyer_8,Antonio,45,ES45209530357850307003,TRX_N-00939-03903222,2024-02-08T10:00:50,Labastida,expenses,gas,-65.68,-47011.75
buyer_8,Antonio,45,ES45209530357850307003,TRX_N-00940-24488015,2024-02-08T16:25:36,Labastida,expenses,internet,-42.0,-47053.75
buyer_8,Antonio,45,ES45209530357850307003,TRX_N-00941-74149263,2024-02-08T08:59:11,Labastida,expenses,phone,-32.61,-47086.36
buyer_8,Antonio,45,ES45209530357850307003,TRX_N-00942-01482257,2024-02-09T16:33:47,Labastida,Expense,leisure,-75.93,-47162.29
buyer_8,Antonio,45,ES45209530357850307003,TRX_N-00943-47833218,2024-02-09T14:08:40,Santurtzi,Expense,clothing,-66.01,-47228.3
buyer_8,Antonio,45,ES45209530357850307003,TRX_N-00944-40934890,2024-02-09T04:58:11,Labastida,Expense,repairs,-309.15,-47537.45
buyer_8,Antonio,45,ES45209530357850307003,TRX_N-00945-55732229,2024-02-12T18:10:56,Labastida,Expense,leisure,-56.05,-47593.5
buyer_8,Antonio,45,ES45209530357850307003,TRX_N-00946-15945996,2024-02-12T11:13:58,Sopela,Expense,repairs,-144.74,-47738.24
buyer_8,Antonio,45,ES45209530357850307003,TRX_N-00947-57349125,2024-02-14T16:13:58,Labastida,Expense,food,-63.4,-47801.64
buyer_8,Antonio,45,ES45209530357850307003,TRX_N-00948-12744280,2024-02-14T21:11:54,Labastida,Expense,leisure,-49.76,-47851.4
buyer_8,Antonio,45,ES45209530357850307003,TRX_N-00949-21421883,2024-02-16T22:22:20,Labastida,expenses,children,-239.13,-48090.53
buyer_8,Antonio,45,ES45209530357850307003,TRX_N-00950-33740116,2024-02-19T16:26:36,Labastida,Expense,food,-94.13,-48184.66
buyer_8,Antonio,45,ES45209530357850307003,TRX_N-00951-07247207,2024-02-20T09:22:53,Labastida,Expense,food,-120.18,-48304.84
buyer_8,Antonio,45,ES45209530357850307003,TRX_N-00952-47702977,2024-02-21T13:59:28,Labastida,Expense,food,-112.1,-48416.94
buyer_8,Antonio,45,ES45209530357850307003,TRX_N-00953-13293977,2024-02-21T10:56:58,Labastida,Expense,repairs,-84.37,-48501.31
buyer_8,Antonio,45,ES45209530357850307003,TRX_N-00954-37080275,2024-02-24T09:47:58,Basauri,Expense,cash,-100.0,-48601.31
buyer_8,Antonio,45,ES45209530357850307003,TRX_N-00955-50168281,2024-02-25T16:11:12,Labastida,Expense,food,-102.88,-48704.19
buyer_8,Antonio,45,ES45209530357850307003,TRX_N-00956-23401591,2024-02-25T20:06:30,Labastida,Expense,leisure,-83.69,-48787.88
buyer_8,Antonio,45,ES45209530357850307003,TRX_N-00957-68273167,2024-02-26T17:07:24,Labastida,Expense,leisure,-42.25,-48830.13
buyer_8,Antonio,45,ES45209530357850307003,TRX_N-00958-13030120,2024-02-27T21:37:56,Labastida,Expense,cash,-100.0,-48930.13
buyer_8,Antonio,45,ES45209530357850307003,TRX_N-00959-19301548,2024-02-28T04:06:06,Labastida,Expense,gifts,-101.11,-49031.24
buyer_8,Antonio,45,ES45209530357850307003,TRX_N-00960-44169015,2024-02-29T19:25:23,Labastida,Expense,transport,-44.2,-49075.44
buyer_8,Antonio,45,ES45209530357850307003,TRX_N-00961-72215801,2024-03-01T12:30:49,Labastida,incomes,salary,1353.48,-47721.96
buyer_8,Antonio,45,ES45209530357850307003,TRX_N-00962-20486588,2024-03-01T12:30:49,Labastida,incomes,salary_partner,1694.33,-46027.63
buyer_8,Antonio,45,ES45209530357850307003,TRX_N-00963-74532344,2024-03-01T12:30:49,Labastida,incomes,extra_income,205.8,-45821.83
buyer_8,Antonio,45,ES45209530357850307003,TRX_N-00964-77808522,2024-03-01T10:30:53,Galdakao,Expense,food,-77.24,-45899.07
buyer_8,Antonio,45,ES45209530357850307003,TRX_N-00965-70602934,2024-03-02T09:27:19,Labastida,Expense,leisure,-59.2,-45958.27
buyer_8,Antonio,45,ES45209530357850307003,TRX_N-00966-50161262,2024-03-02T08:25:05,Labastida,Expense,education,-58.06,-46016.33
buyer_8,Antonio,45,ES45209530357850307003,TRX_N-00967-81356205,2024-03-03T16:16:44,Labastida,Expense,transport,-73.07,-46089.4
buyer_8,Antonio,45,ES45209530357850307003,TRX_N-00968-45316587,2024-03-04T18:27:34,Labastida,expenses,mortgage,-887.59,-46976.99
buyer_8,Antonio,45,ES45209530357850307003,TRX_N-00969-16193106,2024-03-04T13:21:46,Labastida,Expense,cash,-100.0,-47076.99
buyer_8,Antonio,45,ES45209530357850307003,TRX_N-00970-05142859,2024-03-05T08:54:07,Labastida,expenses,gas,-48.22,-47125.21
buyer_8,Antonio,45,ES45209530357850307003,TRX_N-00971-18266969,2024-03-05T15:20:39,Labastida,Expense,appliances,-268.88,-47394.09
buyer_8,Antonio,45,ES45209530357850307003,TRX_N-00972-16995195,2024-03-06T20:27:08,Errenteria,Expense,leisure,-47.47,-47441.56
buyer_8,Antonio,45,ES45209530357850307003,TRX_N-00973-11152448,2024-03-06T20:19:51,Labastida,Expense,healthcare,-69.94,-47511.5
buyer_8,Antonio,45,ES45209530357850307003,TRX_N-00974-51595412,2024-03-06T09:34:56,Labastida,Expense,education,-43.07,-47554.57
buyer_8,Antonio,45,ES45209530357850307003,TRX_N-00975-78324919,2024-03-07T11:53:06,Labastida,expenses,internet,-42.0,-47596.57
buyer_8,Antonio,45,ES45209530357850307003,TRX_N-00976-78454295,2024-03-07T07:50:09,Labastida,expenses,phone,-41.63,-47638.2
buyer_8,Antonio,45,ES45209530357850307003,TRX_N-00977-95684543,2024-03-07T16:31:23,Labastida,Expense,clothing,-137.47,-47775.67
buyer_8,Antonio,45,ES45209530357850307003,TRX_N-00978-43429243,2024-03-07T10:58:25,Labastida,Expense,cash,-100.0,-47875.67
buyer_8,Antonio,45,ES45209530357850307003,TRX_N-00979-01083566,2024-03-08T13:01:14,Labastida,expenses,water,-27.28,-47902.95
buyer_8,Antonio,45,ES45209530357850307003,TRX_N-00980-75039881,2024-03-08T04:00:41,Labastida,expenses,electricity,-23.23,-47926.18
buyer_8,Antonio,45,ES45209530357850307003,TRX_N-00981-04281882,2024-03-09T19:26:41,Basauri,Expense,cash,-100.0,-48026.18
buyer_8,Antonio,45,ES45209530357850307003,TRX_N-00982-03947945,2024-03-10T09:09:56,Lasarte-Oria,Expense,transport,-81.54,-48107.72
buyer_8,Antonio,45,ES45209530357850307003,TRX_N-00983-28183793,2024-03-14T13:40:43,Labastida,Expense,food,-61.19,-48168.91
buyer_8,Antonio,45,ES45209530357850307003,TRX_N-00984-05877574,2024-03-14T12:56:52,Errenteria,Expense,gifts,-806.99,-48975.9
buyer_8,Antonio,45,ES45209530357850307003,TRX_N-00985-65477476,2024-03-16T23:59:30,Erandio,Expense,repairs,-162.61,-49138.51
buyer_8,Antonio,45,ES45209530357850307003,TRX_N-00986-65538418,2024-03-18T22:24:13,Labastida,Expense,healthcare,-124.15,-49262.66
buyer_8,Antonio,45,ES45209530357850307003,TRX_N-00987-42302778,2024-03-19T22:53:24,Labastida,Expense,leisure,-40.61,-49303.27
buyer_8,Antonio,45,ES45209530357850307003,TRX_N-00988-50521776,2024-03-21T10:41:07,Labastida,Expense,transport,-48.05,-49351.32
buyer_8,Antonio,45,ES45209530357850307003,TRX_N-00989-36071327,2024-03-21T11:40:15,Sestao,Expense,gifts,-98.88,-49450.2
buyer_8,Antonio,45,ES45209530357850307003,TRX_N-00990-84813209,2024-03-22T15:47:07,Labastida,Expense,cash,-100.0,-49550.2
buyer_8,Antonio,45,ES45209530357850307003,TRX_N-00991-62911402,2024-03-24T15:07:42,Labastida,Expense,cash,-100.0,-49650.2
buyer_8,Antonio,45,ES45209530357850307003,TRX_N-00992-65506460,2024-03-27T15:36:10,Galdakao,Expense,food,-103.19,-49753.39
buyer_8,Antonio,45,ES45209530357850307003,TRX_N-00993-15996199,2024-03-30T13:31:05,Labastida,Expense,food,-85.26,-49838.65
buyer_8,Antonio,45,ES45209530357850307003,TRX_N-00994-83655092,2024-03-31T21:40:57,Labastida,Expense,food,-61.63,-49900.28
buyer_8,Antonio,45,ES45209530357850307003,TRX_N-00995-73616437,2024-04-01T02:51:47,Labastida,incomes,salary,1353.48,-48546.8
buyer_8,Antonio,45,ES45209530357850307003,TRX_N-00996-38768412,2024-04-01T02:51:47,Labastida,incomes,salary_partner,1694.33,-46852.47
buyer_8,Antonio,45,ES45209530357850307003,TRX_N-00997-83336907,2024-04-01T09:07:41,Labastida,Expense,food,-116.45,-46968.92
buyer_8,Antonio,45,ES45209530357850307003,TRX_N-00998-92606739,2024-04-01T17:40:19,Elciego,Expense,transport,-62.25,-47031.17
buyer_8,Antonio,45,ES45209530357850307003,TRX_N-00999-30305563,2024-04-01T05:05:05,Labastida,Expense,gifts,-722.35,-47753.52
buyer_8,Antonio,45,ES45209530357850307003,TRX_N-01000-89454200,2024-04-02T22:59:11,Labastida,Expense,transport,-52.39,-47805.91
buyer_8,Antonio,45,ES45209530357850307003,TRX_N-01001-06546245,2024-04-04T14:47:36,Labastida,expenses,mortgage,-887.59,-48693.5
buyer_8,Antonio,45,ES45209530357850307003,TRX_N-01002-13872955,2024-04-04T21:52:50,Labastida,Expense,food,-64.36,-48757.86
buyer_8,Antonio,45,ES45209530357850307003,TRX_N-01003-48276570,2024-04-04T19:01:50,Labastida,Expense,cash,-100.0,-48857.86
buyer_8,Antonio,45,ES45209530357850307003,TRX_N-01004-18013768,2024-04-05T08:00:12,Labastida,Expense,food,-100.32,-48958.18
buyer_8,Antonio,45,ES45209530357850307003,TRX_N-01005-50057221,2024-04-05T08:26:11,Salvatierra/Agurain,Expense,leisure,-65.39,-49023.57
buyer_8,Antonio,45,ES45209530357850307003,TRX_N-01006-16298361,2024-04-06T17:56:56,Labastida,expenses,water,-39.62,-49063.19
buyer_8,Antonio,45,ES45209530357850307003,TRX_N-01007-93298754,2024-04-06T12:06:33,Labastida,expenses,electricity,-48.24,-49111.43
buyer_8,Antonio,45,ES45209530357850307003,TRX_N-01008-35926754,2024-04-06T12:41:54,Basauri,Expense,education,-50.54,-49161.97
buyer_8,Antonio,45,ES45209530357850307003,TRX_N-01009-13471148,2024-04-07T16:45:28,Oy√≥n-Oion,Expense,appliances,-105.07,-49267.04
buyer_8,Antonio,45,ES45209530357850307003,TRX_N-01010-70034799,2024-04-08T11:47:13,Labastida,expenses,gas,-60.17,-49327.21
buyer_8,Antonio,45,ES45209530357850307003,TRX_N-01011-86787729,2024-04-08T13:24:44,Labastida,expenses,internet,-42.0,-49369.21
buyer_8,Antonio,45,ES45209530357850307003,TRX_N-01012-07895352,2024-04-08T23:32:58,Labastida,expenses,phone,-42.76,-49411.97
buyer_8,Antonio,45,ES45209530357850307003,TRX_N-01013-33191729,2024-04-08T13:21:45,Labastida,Expense,leisure,-63.77,-49475.74
buyer_8,Antonio,45,ES45209530357850307003,TRX_N-01014-33062493,2024-04-08T16:04:01,Labastida,Expense,cash,-100.0,-49575.74
buyer_8,Antonio,45,ES45209530357850307003,TRX_N-01015-50891474,2024-04-10T09:11:30,Labastida,Expense,leisure,-30.19,-49605.93
buyer_8,Antonio,45,ES45209530357850307003,TRX_N-01016-81022010,2024-04-11T08:47:06,Salvatierra/Agurain,Expense,leisure,-73.7,-49679.63
buyer_8,Antonio,45,ES45209530357850307003,TRX_N-01017-75531681,2024-04-12T10:23:10,Amurrio,Expense,food,-100.06,-49779.69
buyer_8,Antonio,45,ES45209530357850307003,TRX_N-01018-10433278,2024-04-12T15:37:28,Labastida,Expense,cash,-100.0,-49879.69
buyer_8,Antonio,45,ES45209530357850307003,TRX_N-01019-33872653,2024-04-13T11:18:49,Labastida,Expense,leisure,-30.02,-49909.71
buyer_8,Antonio,45,ES45209530357850307003,TRX_N-01020-85118708,2024-04-16T16:58:16,Labastida,Expense,cash,-100.0,-50009.71
buyer_8,Antonio,45,ES45209530357850307003,TRX_N-01021-79612828,2024-04-18T17:58:25,Labastida,Expense,education,-75.81,-50085.52
buyer_8,Antonio,45,ES45209530357850307003,TRX_N-01022-33971453,2024-04-18T14:53:53,Labastida,Expense,travel,-783.27,-50868.79
buyer_8,Antonio,45,ES45209530357850307003,TRX_N-01023-16922988,2024-04-21T01:12:16,Labastida,Expense,cash,-100.0,-50968.79
buyer_8,Antonio,45,ES45209530357850307003,TRX_N-01024-21123457,2024-04-22T11:16:27,Labastida,Expense,food,-60.73,-51029.52
buyer_8,Antonio,45,ES45209530357850307003,TRX_N-01025-44677610,2024-04-22T17:39:58,Labastida,Expense,cash,-100.0,-51129.52
buyer_8,Antonio,45,ES45209530357850307003,TRX_N-01026-74703227,2024-04-24T11:57:27,Labastida,Expense,transport,-86.91,-51216.43
buyer_8,Antonio,45,ES45209530357850307003,TRX_N-01027-32375217,2024-04-26T15:37:38,Barakaldo,Expense,clothing,-116.55,-51332.98
buyer_8,Antonio,45,ES45209530357850307003,TRX_N-01028-00104586,2024-04-27T10:01:16,Labastida,Expense,transport,-67.17,-51400.15
buyer_8,Antonio,45,ES45209530357850307003,TRX_N-01029-63761590,2024-04-27T10:44:50,Lasarte-Oria,Expense,clothing,-58.37,-51458.52
buyer_8,Antonio,45,ES45209530357850307003,TRX_N-01030-85732909,2024-04-28T18:54:18,Labastida,Expense,transport,-87.77,-51546.29
buyer_8,Antonio,45,ES45209530357850307003,TRX_N-01031-53721623,2024-04-28T16:21:50,Vitoria-Gasteiz,Expense,cash,-100.0,-51646.29
buyer_8,Antonio,45,ES45209530357850307003,TRX_N-01032-55126834,2024-04-29T20:32:04,Labastida,Expense,food,-102.68,-51748.97
buyer_8,Antonio,45,ES45209530357850307003,TRX_N-01033-98646473,2024-04-29T08:25:17,Labastida,Expense,leisure,-47.04,-51796.01
buyer_8,Antonio,45,ES45209530357850307003,TRX_N-01034-30593172,2024-05-01T16:38:50,Labastida,incomes,salary,1353.48,-50442.53
buyer_8,Antonio,45,ES45209530357850307003,TRX_N-01035-39799245,2024-05-01T16:38:50,Labastida,incomes,salary_partner,1694.33,-48748.2
buyer_8,Antonio,45,ES45209530357850307003,TRX_N-01036-78765031,2024-05-01T20:13:36,Labastida,Expense,food,-111.33,-48859.53
buyer_8,Antonio,45,ES45209530357850307003,TRX_N-01037-41895274,2024-05-02T14:16:20,Iru√±a de Oca,Expense,clothing,-90.75,-48950.28
buyer_8,Antonio,45,ES45209530357850307003,TRX_N-01038-82977994,2024-05-03T14:26:23,Labastida,Expense,healthcare,-111.76,-49062.04
buyer_8,Antonio,45,ES45209530357850307003,TRX_N-01039-04582512,2024-05-03T06:26:55,Elciego,Expense,cash,-100.0,-49162.04
buyer_8,Antonio,45,ES45209530357850307003,TRX_N-01040-66523145,2024-05-03T12:46:01,Labastida,expenses,children,-207.82,-49369.86
buyer_8,Antonio,45,ES45209530357850307003,TRX_N-01041-46227724,2024-05-04T11:27:30,Labastida,expenses,mortgage,-887.59,-50257.45
buyer_8,Antonio,45,ES45209530357850307003,TRX_N-01042-62295696,2024-05-04T05:15:40,Labastida,Expense,transport,-65.34,-50322.79
buyer_8,Antonio,45,ES45209530357850307003,TRX_N-01043-22128474,2024-05-05T15:28:19,Labastida,expenses,water,-38.61,-50361.4
buyer_8,Antonio,45,ES45209530357850307003,TRX_N-01044-22336215,2024-05-05T20:26:06,Labastida,Expense,cash,-100.0,-50461.4
buyer_8,Antonio,45,ES45209530357850307003,TRX_N-01045-45746029,2024-05-06T12:18:03,Labastida,expenses,gas,-93.83,-50555.23
buyer_8,Antonio,45,ES45209530357850307003,TRX_N-01046-23035127,2024-05-06T13:14:45,Labastida,expenses,internet,-42.0,-50597.23
buyer_8,Antonio,45,ES45209530357850307003,TRX_N-01047-97288977,2024-05-06T05:23:50,Berango,Expense,education,-53.78,-50651.01
buyer_8,Antonio,45,ES45209530357850307003,TRX_N-01048-23959783,2024-05-08T17:25:36,Labastida,expenses,electricity,-45.88,-50696.89
buyer_8,Antonio,45,ES45209530357850307003,TRX_N-01049-98834367,2024-05-08T14:53:18,Labastida,expenses,phone,-30.64,-50727.53
buyer_8,Antonio,45,ES45209530357850307003,TRX_N-01050-80323834,2024-05-09T19:11:30,Labastida,Expense,transport,-74.28,-50801.81
buyer_8,Antonio,45,ES45209530357850307003,TRX_N-01051-51740490,2024-05-10T06:55:34,Labastida,Expense,education,-43.36,-50845.17
buyer_8,Antonio,45,ES45209530357850307003,TRX_N-01052-60515920,2024-05-12T13:03:42,Labastida,Expense,food,-100.98,-50946.15
buyer_8,Antonio,45,ES45209530357850307003,TRX_N-01053-23788867,2024-05-13T18:44:21,Labastida,Expense,food,-80.78,-51026.93
buyer_8,Antonio,45,ES45209530357850307003,TRX_N-01054-06551803,2024-05-13T12:56:42,Amurrio,Expense,cash,-100.0,-51126.93
buyer_8,Antonio,45,ES45209530357850307003,TRX_N-01055-77603277,2024-05-14T10:08:20,Labastida,Expense,cash,-100.0,-51226.93
buyer_8,Antonio,45,ES45209530357850307003,TRX_N-01056-57512131,2024-05-15T23:05:52,Labastida,Expense,cash,-100.0,-51326.93
buyer_8,Antonio,45,ES45209530357850307003,TRX_N-01057-56743149,2024-05-16T21:45:37,Labastida,Expense,food,-86.48,-51413.41
buyer_8,Antonio,45,ES45209530357850307003,TRX_N-01058-09409811,2024-05-16T03:04:09,Barakaldo,Expense,cash,-100.0,-51513.41
buyer_8,Antonio,45,ES45209530357850307003,TRX_N-01059-31992657,2024-05-17T19:56:36,Labastida,Expense,cash,-100.0,-51613.41
buyer_8,Antonio,45,ES45209530357850307003,TRX_N-01060-33865570,2024-05-19T22:02:22,Labastida,Expense,food,-110.65,-51724.06
buyer_8,Antonio,45,ES45209530357850307003,TRX_N-01061-61276347,2024-05-19T13:05:29,Llodio,Expense,cash,-100.0,-51824.06
buyer_8,Antonio,45,ES45209530357850307003,TRX_N-01062-59020512,2024-05-21T12:47:13,Labastida,Expense,food,-72.3,-51896.36
buyer_8,Antonio,45,ES45209530357850307003,TRX_N-01063-74474278,2024-05-21T01:31:01,Elciego,Expense,transport,-43.1,-51939.46
buyer_8,Antonio,45,ES45209530357850307003,TRX_N-01064-15686654,2024-05-21T21:55:32,Labastida,Expense,cash,-100.0,-52039.46
buyer_8,Antonio,45,ES45209530357850307003,TRX_N-01065-15000067,2024-05-22T02:06:33,Labastida,Expense,leisure,-48.83,-52088.29
buyer_8,Antonio,45,ES45209530357850307003,TRX_N-01066-02523495,2024-05-23T19:59:12,Barakaldo,Expense,leisure,-50.83,-52139.12
buyer_8,Antonio,45,ES45209530357850307003,TRX_N-01067-71648282,2024-05-28T10:41:18,Labastida,Expense,food,-83.51,-52222.63
buyer_8,Antonio,45,ES45209530357850307003,TRX_N-01068-06174024,2024-05-28T15:53:02,Labastida,Expense,leisure,-36.59,-52259.22
buyer_8,Antonio,45,ES45209530357850307003,TRX_N-01069-63004641,2024-05-29T13:10:51,Labastida,Expense,food,-65.43,-52324.65
buyer_8,Antonio,45,ES45209530357850307003,TRX_N-01070-02054704,2024-05-29T18:33:09,Labastida,Expense,cash,-100.0,-52424.65
buyer_8,Antonio,45,ES45209530357850307003,TRX_N-01071-48461664,2024-06-01T23:40:28,Labastida,incomes,salary,1353.48,-51071.17
buyer_8,Antonio,45,ES45209530357850307003,TRX_N-01072-37426926,2024-06-01T23:40:28,Labastida,incomes,salary_partner,1694.33,-49376.84
buyer_8,Antonio,45,ES45209530357850307003,TRX_N-01073-18367716,2024-06-01T23:40:28,Labastida,incomes,salary_bonus,1060.51,-48316.33
buyer_8,Antonio,45,ES45209530357850307003,TRX_N-01074-91795825,2024-06-01T23:40:28,Labastida,incomes,salary_partner_bonus,1197.88,-47118.45
buyer_8,Antonio,45,ES45209530357850307003,TRX_N-01075-78234787,2024-06-03T23:49:41,Labastida,Expense,transport,-45.3,-47163.75
buyer_8,Antonio,45,ES45209530357850307003,TRX_N-01076-86837790,2024-06-04T18:45:50,Labastida,expenses,mortgage,-887.59,-48051.34
buyer_8,Antonio,45,ES45209530357850307003,TRX_N-01077-72790880,2024-06-06T06:29:20,Labastida,Expense,food,-69.73,-48121.07
buyer_8,Antonio,45,ES45209530357850307003,TRX_N-01078-97320361,2024-06-06T18:00:31,Labastida,Expense,cash,-100.0,-48221.07
buyer_8,Antonio,45,ES45209530357850307003,TRX_N-01079-27097941,2024-06-07T13:05:00,Labastida,expenses,electricity,-37.57,-48258.64
buyer_8,Antonio,45,ES45209530357850307003,TRX_N-01080-83677686,2024-06-08T09:44:57,Labastida,expenses,water,-31.76,-48290.4
buyer_8,Antonio,45,ES45209530357850307003,TRX_N-01081-23811990,2024-06-08T00:09:58,Labastida,expenses,gas,-31.86,-48322.26
buyer_8,Antonio,45,ES45209530357850307003,TRX_N-01082-70199402,2024-06-08T11:07:37,Labastida,expenses,internet,-42.0,-48364.26
buyer_8,Antonio,45,ES45209530357850307003,TRX_N-01083-41601788,2024-06-08T17:24:27,Labastida,expenses,phone,-41.05,-48405.31
buyer_8,Antonio,45,ES45209530357850307003,TRX_N-01084-28902724,2024-06-15T19:01:18,Labastida,Expense,appliances,-374.68,-48779.99
buyer_8,Antonio,45,ES45209530357850307003,TRX_N-01085-71215168,2024-06-16T19:33:38,Elciego,Expense,transport,-88.15,-48868.14
buyer_8,Antonio,45,ES45209530357850307003,TRX_N-01086-67558272,2024-06-17T15:24:40,Labastida,Expense,food,-117.49,-48985.63
buyer_8,Antonio,45,ES45209530357850307003,TRX_N-01087-10069613,2024-06-17T10:01:17,Labastida,Expense,cash,-100.0,-49085.63
buyer_8,Antonio,45,ES45209530357850307003,TRX_N-01088-80393539,2024-06-19T05:59:53,Portugalete,Expense,healthcare,-131.49,-49217.12
buyer_8,Antonio,45,ES45209530357850307003,TRX_N-01089-50934182,2024-06-19T14:31:35,Galdakao,Expense,gifts,-783.99,-50001.11
buyer_8,Antonio,45,ES45209530357850307003,TRX_N-01090-17789146,2024-06-21T15:28:47,Labastida,expenses,children,-174.7,-50175.81
buyer_8,Antonio,45,ES45209530357850307003,TRX_N-01091-36201032,2024-06-22T09:58:30,Labastida,Expense,appliances,-389.31,-50565.12
buyer_8,Antonio,45,ES45209530357850307003,TRX_N-01092-45411461,2024-06-23T13:31:54,Bilbao,Expense,cash,-100.0,-50665.12
buyer_8,Antonio,45,ES45209530357850307003,TRX_N-01093-40347514,2024-06-24T12:28:26,Labastida,Expense,food,-62.12,-50727.24
buyer_8,Antonio,45,ES45209530357850307003,TRX_N-01094-54695532,2024-06-24T22:11:53,Labastida,Expense,travel,-1162.06,-51889.3
buyer_8,Antonio,45,ES45209530357850307003,TRX_N-01095-91040606,2024-06-25T11:33:35,Labastida,Expense,food,-68.55,-51957.85
buyer_8,Antonio,45,ES45209530357850307003,TRX_N-01096-93340470,2024-06-25T07:35:50,Labastida,Expense,gifts,-651.37,-52609.22
buyer_8,Antonio,45,ES45209530357850307003,TRX_N-01097-49741053,2024-06-28T17:38:53,Labastida,Expense,food,-96.16,-52705.38
buyer_8,Antonio,45,ES45209530357850307003,TRX_N-01098-92987004,2024-06-29T17:55:16,Labastida,Expense,clothing,-46.46,-52751.84
buyer_8,Antonio,45,ES45209530357850307003,TRX_N-01099-72787858,2024-06-30T13:26:26,Arrasate,Expense,cash,-100.0,-52851.84
buyer_8,Antonio,45,ES45209530357850307003,TRX_N-01100-29565420,2024-07-01T16:36:14,Labastida,incomes,salary,1353.48,-51498.36
buyer_8,Antonio,45,ES45209530357850307003,TRX_N-01101-21316190,2024-07-01T16:36:14,Labastida,incomes,salary_partner,1694.33,-49804.03
buyer_8,Antonio,45,ES45209530357850307003,TRX_N-01102-70662651,2024-07-01T16:36:14,Labastida,incomes,extra_income,205.8,-49598.23
buyer_8,Antonio,45,ES45209530357850307003,TRX_N-01103-60594064,2024-07-01T11:24:41,Labastida,Expense,food,-78.72,-49676.95
buyer_8,Antonio,45,ES45209530357850307003,TRX_N-01104-51543414,2024-07-01T12:22:24,Salvatierra/Agurain,Expense,cash,-100.0,-49776.95
buyer_8,Antonio,45,ES45209530357850307003,TRX_N-01105-57706580,2024-07-02T22:24:19,Labastida,Expense,cash,-100.0,-49876.95
buyer_8,Antonio,45,ES45209530357850307003,TRX_N-01106-82820307,2024-07-02T10:15:41,Labastida,expenses,children,-243.52,-50120.47
buyer_8,Antonio,45,ES45209530357850307003,TRX_N-01107-24303044,2024-07-03T20:07:59,Labastida,Expense,food,-83.91,-50204.38
buyer_8,Antonio,45,ES45209530357850307003,TRX_N-01108-06787353,2024-07-04T11:56:41,Labastida,expenses,mortgage,-887.59,-51091.97
buyer_8,Antonio,45,ES45209530357850307003,TRX_N-01109-66955948,2024-07-04T14:20:26,Labastida,Expense,transport,-46.17,-51138.14
buyer_8,Antonio,45,ES45209530357850307003,TRX_N-01110-96496416,2024-07-04T09:57:31,Labastida,Expense,cash,-100.0,-51238.14
buyer_8,Antonio,45,ES45209530357850307003,TRX_N-01111-01048993,2024-07-06T10:41:14,Labastida,expenses,internet,-42.0,-51280.14
buyer_8,Antonio,45,ES45209530357850307003,TRX_N-01112-14666641,2024-07-06T08:16:18,Labastida,Expense,food,-87.77,-51367.91
buyer_8,Antonio,45,ES45209530357850307003,TRX_N-01113-31301639,2024-07-07T08:58:22,Labastida,expenses,electricity,-22.24,-51390.15
buyer_8,Antonio,45,ES45209530357850307003,TRX_N-01114-51623442,2024-07-08T23:27:12,Labastida,expenses,water,-33.42,-51423.57
buyer_8,Antonio,45,ES45209530357850307003,TRX_N-01115-99838754,2024-07-08T15:18:05,Labastida,expenses,gas,-70.53,-51494.1
buyer_8,Antonio,45,ES45209530357850307003,TRX_N-01116-27294563,2024-07-08T11:18:51,Labastida,expenses,phone,-43.38,-51537.48
buyer_8,Antonio,45,ES45209530357850307003,TRX_N-01117-37086367,2024-07-08T22:12:32,Labastida,Expense,food,-74.89,-51612.37
buyer_8,Antonio,45,ES45209530357850307003,TRX_N-01118-99330583,2024-07-09T08:28:00,Labastida,Expense,repairs,-131.59,-51743.96
buyer_8,Antonio,45,ES45209530357850307003,TRX_N-01119-27468141,2024-07-10T04:17:12,Labastida,Expense,cash,-100.0,-51843.96
buyer_8,Antonio,45,ES45209530357850307003,TRX_N-01120-31459754,2024-07-12T10:05:56,Llodio,Expense,repairs,-296.74,-52140.7
buyer_8,Antonio,45,ES45209530357850307003,TRX_N-01121-50921557,2024-07-13T18:42:20,Labastida,Expense,education,-68.67,-52209.37
buyer_8,Antonio,45,ES45209530357850307003,TRX_N-01122-81539244,2024-07-14T08:35:50,Labastida,Expense,food,-115.96,-52325.33
buyer_8,Antonio,45,ES45209530357850307003,TRX_N-01123-66309121,2024-07-14T08:36:37,Labastida,Expense,cash,-100.0,-52425.33
buyer_8,Antonio,45,ES45209530357850307003,TRX_N-01124-97327487,2024-07-15T14:25:08,Labastida,Expense,food,-80.94,-52506.27
buyer_8,Antonio,45,ES45209530357850307003,TRX_N-01125-96744727,2024-07-15T13:22:46,Labastida,Expense,leisure,-28.22,-52534.49
buyer_8,Antonio,45,ES45209530357850307003,TRX_N-01126-35173368,2024-07-15T11:55:21,Labastida,Expense,healthcare,-180.99,-52715.48
buyer_8,Antonio,45,ES45209530357850307003,TRX_N-01127-95718462,2024-07-17T14:45:51,Labastida,Expense,transport,-71.4,-52786.88
buyer_8,Antonio,45,ES45209530357850307003,TRX_N-01128-22624709,2024-07-17T17:12:18,Iru√±a de Oca,Expense,cash,-100.0,-52886.88
buyer_8,Antonio,45,ES45209530357850307003,TRX_N-01129-04311132,2024-07-18T19:05:59,Labastida,Expense,food,-61.97,-52948.85
buyer_8,Antonio,45,ES45209530357850307003,TRX_N-01130-13043025,2024-07-20T05:31:02,Labastida,Expense,leisure,-21.88,-52970.73
buyer_8,Antonio,45,ES45209530357850307003,TRX_N-01131-24342685,2024-07-20T07:03:46,Labastida,Expense,cash,-100.0,-53070.73
buyer_8,Antonio,45,ES45209530357850307003,TRX_N-01132-93168166,2024-07-20T19:43:26,Labastida,Expense,gifts,-823.6,-53894.33
buyer_8,Antonio,45,ES45209530357850307003,TRX_N-01133-52603673,2024-07-23T15:13:15,Bermeo,Expense,gifts,-742.58,-54636.91
buyer_8,Antonio,45,ES45209530357850307003,TRX_N-01134-76612472,2024-07-24T02:07:58,Labastida,expenses,children,-182.62,-54819.53
buyer_8,Antonio,45,ES45209530357850307003,TRX_N-01135-86276897,2024-07-25T11:45:45,Labastida,Expense,cash,-100.0,-54919.53
buyer_8,Antonio,45,ES45209530357850307003,TRX_N-01136-68734997,2024-07-26T22:34:56,Labastida,Expense,leisure,-23.29,-54942.82
buyer_8,Antonio,45,ES45209530357850307003,TRX_N-01137-07652426,2024-07-26T13:50:06,Labastida,Expense,healthcare,-62.82,-55005.64
buyer_8,Antonio,45,ES45209530357850307003,TRX_N-01138-35997459,2024-07-27T19:03:36,Labastida,Expense,healthcare,-105.08,-55110.72
buyer_8,Antonio,45,ES45209530357850307003,TRX_N-01139-15108300,2024-07-28T14:06:46,Lasarte-Oria,Expense,food,-114.67,-55225.39
buyer_8,Antonio,45,ES45209530357850307003,TRX_N-01140-45940500,2024-07-28T20:45:44,Sestao,Expense,leisure,-76.39,-55301.78
buyer_8,Antonio,45,ES45209530357850307003,TRX_N-01141-88082407,2024-07-28T23:43:17,Sopela,Expense,cash,-100.0,-55401.78
buyer_8,Antonio,45,ES45209530357850307003,TRX_N-01142-07103710,2024-07-30T03:05:56,Labastida,Expense,cash,-100.0,-55501.78
buyer_8,Antonio,45,ES45209530357850307003,TRX_N-01143-42800662,2024-08-01T19:16:14,Labastida,incomes,salary,1353.48,-54148.3
buyer_8,Antonio,45,ES45209530357850307003,TRX_N-01144-17920422,2024-08-01T19:16:14,Labastida,incomes,salary_partner,1694.33,-52453.97
buyer_8,Antonio,45,ES45209530357850307003,TRX_N-01145-13261257,2024-08-04T12:23:57,Labastida,expenses,mortgage,-887.59,-53341.56
buyer_8,Antonio,45,ES45209530357850307003,TRX_N-01146-99959064,2024-08-05T09:53:45,Labastida,expenses,water,-34.44,-53376.0
buyer_8,Antonio,45,ES45209530357850307003,TRX_N-01147-18813220,2024-08-05T02:27:42,Labastida,expenses,electricity,-75.53,-53451.53
buyer_8,Antonio,45,ES45209530357850307003,TRX_N-01148-30689592,2024-08-05T10:40:08,Labastida,expenses,gas,-96.69,-53548.22
buyer_8,Antonio,45,ES45209530357850307003,TRX_N-01149-77810106,2024-08-05T19:05:35,Labastida,expenses,phone,-42.54,-53590.76
buyer_8,Antonio,45,ES45209530357850307003,TRX_N-01150-87067963,2024-08-05T16:59:47,Labastida,Expense,cash,-100.0,-53690.76
buyer_8,Antonio,45,ES45209530357850307003,TRX_N-01151-72833264,2024-08-05T09:07:26,Labastida,Expense,repairs,-32.44,-53723.2
buyer_8,Antonio,45,ES45209530357850307003,TRX_N-01152-31357563,2024-08-07T12:07:50,Labastida,expenses,internet,-42.0,-53765.2
buyer_8,Antonio,45,ES45209530357850307003,TRX_N-01153-79652475,2024-08-07T15:30:50,Labastida,Expense,gifts,-464.61,-54229.81
buyer_8,Antonio,45,ES45209530357850307003,TRX_N-01154-06653134,2024-08-09T12:13:14,Labastida,Expense,leisure,-72.53,-54302.34
buyer_8,Antonio,45,ES45209530357850307003,TRX_N-01155-16051468,2024-08-10T08:58:23,Labastida,Expense,leisure,-56.48,-54358.82
buyer_8,Antonio,45,ES45209530357850307003,TRX_N-01156-09655965,2024-08-12T03:16:50,Labastida,expenses,children,-69.81,-54428.63
buyer_8,Antonio,45,ES45209530357850307003,TRX_N-01157-49320942,2024-08-13T16:39:42,Labastida,Expense,clothing,-72.79,-54501.42
buyer_8,Antonio,45,ES45209530357850307003,TRX_N-01158-00297468,2024-08-15T20:16:56,Labastida,Expense,cash,-100.0,-54601.42
buyer_8,Antonio,45,ES45209530357850307003,TRX_N-01159-34030137,2024-08-15T12:47:29,Labastida,Expense,gifts,-822.13,-55423.55
buyer_8,Antonio,45,ES45209530357850307003,TRX_N-01160-01229343,2024-08-16T09:31:03,Labastida,Expense,food,-94.57,-55518.12
buyer_8,Antonio,45,ES45209530357850307003,TRX_N-01161-38861150,2024-08-17T18:49:20,Labastida,Expense,leisure,-28.02,-55546.14
buyer_8,Antonio,45,ES45209530357850307003,TRX_N-01162-29761305,2024-08-22T19:28:13,Labastida,Expense,leisure,-78.86,-55625.0
buyer_8,Antonio,45,ES45209530357850307003,TRX_N-01163-43092276,2024-08-23T12:49:14,Labastida,Expense,food,-118.61,-55743.61
buyer_8,Antonio,45,ES45209530357850307003,TRX_N-01164-57915256,2024-08-23T11:38:20,Labastida,Expense,gifts,-274.9,-56018.51
buyer_8,Antonio,45,ES45209530357850307003,TRX_N-01165-20046028,2024-08-24T12:52:23,Bermeo,Expense,appliances,-176.81,-56195.32
buyer_8,Antonio,45,ES45209530357850307003,TRX_N-01166-57260387,2024-08-25T08:22:02,Labastida,Expense,food,-87.88,-56283.2
buyer_8,Antonio,45,ES45209530357850307003,TRX_N-01167-35310042,2024-09-01T11:49:56,Labastida,incomes,salary,1353.48,-54929.72
buyer_8,Antonio,45,ES45209530357850307003,TRX_N-01168-91970921,2024-09-01T11:49:56,Labastida,incomes,salary_partner,1694.33,-53235.39
buyer_8,Antonio,45,ES45209530357850307003,TRX_N-01169-18550374,2024-09-01T14:49:43,Bilbao,Expense,repairs,-72.19,-53307.58
buyer_8,Antonio,45,ES45209530357850307003,TRX_N-01170-50803382,2024-09-02T02:48:14,Labastida,Expense,cash,-100.0,-53407.58
buyer_8,Antonio,45,ES45209530357850307003,TRX_N-01171-56793485,2024-09-03T23:30:34,Labastida,Expense,transport,-78.0,-53485.58
buyer_8,Antonio,45,ES45209530357850307003,TRX_N-01172-16922138,2024-09-04T18:09:27,Labastida,expenses,mortgage,-887.59,-54373.17
buyer_8,Antonio,45,ES45209530357850307003,TRX_N-01173-01332140,2024-09-04T21:47:52,Hernani,Expense,cash,-100.0,-54473.17
buyer_8,Antonio,45,ES45209530357850307003,TRX_N-01174-15006316,2024-09-05T17:54:18,Labastida,Expense,leisure,-59.13,-54532.3
buyer_8,Antonio,45,ES45209530357850307003,TRX_N-01175-31253212,2024-09-05T17:23:19,Zuia,Expense,clothing,-150.26,-54682.56
buyer_8,Antonio,45,ES45209530357850307003,TRX_N-01176-72304485,2024-09-07T19:00:34,Labastida,expenses,gas,-95.05,-54777.61
buyer_8,Antonio,45,ES45209530357850307003,TRX_N-01177-08998306,2024-09-07T10:04:37,Labastida,Expense,food,-94.58,-54872.19
buyer_8,Antonio,45,ES45209530357850307003,TRX_N-01178-37100594,2024-09-08T09:36:59,Labastida,expenses,water,-30.26,-54902.45
buyer_8,Antonio,45,ES45209530357850307003,TRX_N-01179-53900931,2024-09-08T10:59:42,Labastida,expenses,electricity,-39.89,-54942.34
buyer_8,Antonio,45,ES45209530357850307003,TRX_N-01180-85701445,2024-09-08T13:32:26,Labastida,expenses,internet,-42.0,-54984.34
buyer_8,Antonio,45,ES45209530357850307003,TRX_N-01181-88440039,2024-09-08T16:03:42,Labastida,expenses,phone,-44.95,-55029.29
buyer_8,Antonio,45,ES45209530357850307003,TRX_N-01182-30375408,2024-09-08T20:25:57,Labastida,Expense,food,-79.9,-55109.19
buyer_8,Antonio,45,ES45209530357850307003,TRX_N-01183-64313504,2024-09-09T09:13:32,Hernani,Expense,food,-75.11,-55184.3
buyer_8,Antonio,45,ES45209530357850307003,TRX_N-01184-52533149,2024-09-09T11:07:05,Labastida,Expense,repairs,-101.87,-55286.17
buyer_8,Antonio,45,ES45209530357850307003,TRX_N-01185-42461855,2024-09-10T16:31:10,Labastida,Expense,cash,-100.0,-55386.17
buyer_8,Antonio,45,ES45209530357850307003,TRX_N-01186-07706411,2024-09-12T12:15:52,Labastida,Expense,food,-63.19,-55449.36
buyer_8,Antonio,45,ES45209530357850307003,TRX_N-01187-51556019,2024-09-12T07:07:39,Labastida,Expense,cash,-100.0,-55549.36
buyer_8,Antonio,45,ES45209530357850307003,TRX_N-01188-36388044,2024-09-13T14:46:48,Labastida,Expense,food,-68.12,-55617.48
buyer_8,Antonio,45,ES45209530357850307003,TRX_N-01189-36072159,2024-09-15T20:41:04,Labastida,Expense,cash,-100.0,-55717.48
buyer_8,Antonio,45,ES45209530357850307003,TRX_N-01190-96326007,2024-09-16T15:25:06,Labastida,Expense,repairs,-187.29,-55904.77
buyer_8,Antonio,45,ES45209530357850307003,TRX_N-01191-60889506,2024-09-17T14:29:28,Labastida,Expense,repairs,-107.89,-56012.66
buyer_8,Antonio,45,ES45209530357850307003,TRX_N-01192-32910207,2024-09-17T11:30:15,Labastida,Expense,gifts,-613.84,-56626.5
buyer_8,Antonio,45,ES45209530357850307003,TRX_N-01193-96145320,2024-09-18T12:33:21,Labastida,Expense,clothing,-157.86,-56784.36
buyer_8,Antonio,45,ES45209530357850307003,TRX_N-01194-25102907,2024-09-18T07:31:08,Labastida,Expense,appliances,-249.64,-57034.0
buyer_8,Antonio,45,ES45209530357850307003,TRX_N-01195-84854022,2024-09-19T17:05:01,Elciego,Expense,food,-107.5,-57141.5
buyer_8,Antonio,45,ES45209530357850307003,TRX_N-01196-20352700,2024-09-20T21:36:36,Labastida,Expense,transport,-87.09,-57228.59
buyer_8,Antonio,45,ES45209530357850307003,TRX_N-01197-11931285,2024-09-20T09:42:56,Labastida,Expense,leisure,-49.55,-57278.14
buyer_8,Antonio,45,ES45209530357850307003,TRX_N-01198-55954119,2024-09-21T20:59:12,Labastida,Expense,transport,-50.0,-57328.14
buyer_8,Antonio,45,ES45209530357850307003,TRX_N-01199-85593996,2024-09-26T09:42:16,Labastida,Expense,leisure,-23.25,-57351.39
buyer_8,Antonio,45,ES45209530357850307003,TRX_N-01200-73579848,2024-09-26T12:40:39,Amurrio,Expense,travel,-1885.15,-59236.54
buyer_8,Antonio,45,ES45209530357850307003,TRX_N-01201-97412551,2024-09-26T17:32:16,Labastida,expenses,children,-240.65,-59477.19
buyer_8,Antonio,45,ES45209530357850307003,TRX_N-01202-72821430,2024-09-27T17:39:09,Sestao,Expense,cash,-100.0,-59577.19
buyer_8,Antonio,45,ES45209530357850307003,TRX_N-01203-29804468,2024-09-28T22:11:04,Labastida,Expense,cash,-100.0,-59677.19
buyer_8,Antonio,45,ES45209530357850307003,TRX_N-01204-68344610,2024-09-30T10:46:06,Andoain,Expense,repairs,-306.84,-59984.03
buyer_8,Antonio,45,ES45209530357850307003,TRX_N-01205-40115343,2024-10-01T16:30:19,Labastida,incomes,salary,1353.48,-58630.55
buyer_8,Antonio,45,ES45209530357850307003,TRX_N-01206-94690010,2024-10-01T16:30:19,Labastida,incomes,salary_partner,1694.33,-56936.22
buyer_8,Antonio,45,ES45209530357850307003,TRX_N-01207-77450261,2024-10-01T16:30:19,Labastida,incomes,extra_income,205.8,-56730.42
buyer_8,Antonio,45,ES45209530357850307003,TRX_N-01208-86112057,2024-10-03T13:30:44,Labastida,Expense,transport,-60.15,-56790.57
buyer_8,Antonio,45,ES45209530357850307003,TRX_N-01209-82426310,2024-10-03T08:17:33,Labastida,Expense,cash,-100.0,-56890.57
buyer_8,Antonio,45,ES45209530357850307003,TRX_N-01210-22056132,2024-10-03T11:35:53,Labastida,Expense,travel,-1874.01,-58764.58
buyer_8,Antonio,45,ES45209530357850307003,TRX_N-01211-95694828,2024-10-04T23:35:48,Labastida,expenses,mortgage,-887.59,-59652.17
buyer_8,Antonio,45,ES45209530357850307003,TRX_N-01212-15269265,2024-10-04T06:17:35,Portugalete,Expense,healthcare,-102.09,-59754.26
buyer_8,Antonio,45,ES45209530357850307003,TRX_N-01213-21844524,2024-10-05T10:02:16,Labastida,expenses,water,-35.41,-59789.67
buyer_8,Antonio,45,ES45209530357850307003,TRX_N-01214-08105054,2024-10-05T18:27:48,Labastida,expenses,phone,-30.57,-59820.24
buyer_8,Antonio,45,ES45209530357850307003,TRX_N-01215-76115401,2024-10-05T08:53:49,Donostia,Expense,food,-109.6,-59929.84
buyer_8,Antonio,45,ES45209530357850307003,TRX_N-01216-86472814,2024-10-06T17:18:06,Labastida,Expense,transport,-43.18,-59973.02
buyer_8,Antonio,45,ES45209530357850307003,TRX_N-01217-28070205,2024-10-06T12:49:51,Labastida,Expense,travel,-1533.21,-61506.23
buyer_8,Antonio,45,ES45209530357850307003,TRX_N-01218-95463917,2024-10-07T21:15:31,Labastida,Expense,leisure,-32.17,-61538.4
buyer_8,Antonio,45,ES45209530357850307003,TRX_N-01219-00661646,2024-10-08T09:37:51,Labastida,expenses,electricity,-44.05,-61582.45
buyer_8,Antonio,45,ES45209530357850307003,TRX_N-01220-58026239,2024-10-08T15:24:31,Labastida,expenses,gas,-60.66,-61643.11
buyer_8,Antonio,45,ES45209530357850307003,TRX_N-01221-93791079,2024-10-08T17:04:44,Labastida,expenses,internet,-42.0,-61685.11
buyer_8,Antonio,45,ES45209530357850307003,TRX_N-01222-69943648,2024-10-08T18:59:13,Labastida,Expense,food,-107.98,-61793.09
buyer_8,Antonio,45,ES45209530357850307003,TRX_N-01223-00322272,2024-10-08T20:34:46,Labastida,Expense,repairs,-51.29,-61844.38
